C행정구역별(읍면동),행정구역별(읍면동),C연령별,연령별,시점,총인구(명),총인구_남자(명),총인구_여자(명),총인구_성비,내국인(명),내국인_남자(명),내국인_여자(명),내국인_성비
00,전국,000,합계,2017,51422507,25768055,25654452,100.4,49943260,24922392,25020868,99.6
00,전국,005,0~4세,2017,2102959,1077714,1025245,105.1,2075937,1064016,1011921,105.1
00,전국,005001, 0세,2017,367077,188797,178280,105.9,361295,185833,175462,105.9
00,전국,005002, 1세,2017,418017,213949,204068,104.8,411750,210720,201030,104.8
00,전국,005003, 2세,2017,439985,225537,214448,105.2,434651,222812,211839,105.2
00,전국,005004, 3세,2017,435934,223091,212843,104.8,430782,220536,210246,104.9
00,전국,005005, 4세,2017,441946,226340,215606,105,437459,224115,213344,105
00,전국,010,5~9세,2017,2303030,1185280,1117750,106,2287878,1177479,1110399,106
00,전국,010001, 5세,2017,479301,246188,233113,105.6,475197,244106,231091,105.6
00,전국,010002, 6세,2017,471397,242236,229161,105.7,468232,240565,227667,105.7
00,전국,010003, 7세,2017,452411,233377,219034,106.5,449586,231907,217679,106.5
00,전국,010004, 8세,2017,437961,225813,212148,106.4,435362,224511,210851,106.5
00,전국,010005, 9세,2017,461960,237666,224294,106,459501,236390,223111,106
00,전국,015,10~14세,2017,2276763,1178964,1097799,107.4,2267947,1174461,1093486,107.4
00,전국,015001, 10세,2017,472799,243452,229347,106.2,470616,242351,228265,106.2
00,전국,015002, 11세,2017,433812,224633,209179,107.4,431981,223697,208284,107.4
00,전국,015003, 12세,2017,427912,221535,206377,107.3,426244,220660,205584,107.3
00,전국,015004, 13세,2017,466571,242116,224455,107.9,464891,241256,223635,107.9
00,전국,015005, 14세,2017,475669,247228,228441,108.2,474215,246497,227718,108.2
00,전국,020,15~19세,2017,2922140,1523741,1398399,109,2891577,1509599,1381978,109.2
00,전국,020001, 15세,2017,491112,256223,234889,109.1,489518,255407,234111,109.1
00,전국,020002, 16세,2017,561698,292899,268799,109,559908,291950,267958,109
00,전국,020003, 17세,2017,620343,323657,296686,109.1,617269,322126,295143,109.1
00,전국,020004, 18세,2017,607488,317296,290192,109.3,600299,313946,286353,109.6
00,전국,020005, 19세,2017,641499,333666,307833,108.4,624583,326170,298413,109.3
00,전국,025,20~24세,2017,3517690,1872652,1645038,113.8,3355986,1786645,1569341,113.8
00,전국,025001, 20세,2017,671671,349554,322117,108.5,648406,339444,308962,109.9
00,전국,025002, 21세,2017,694248,370070,324178,114.2,666287,356165,310122,114.8
00,전국,025003, 22세,2017,707385,379092,328293,115.5,674761,361783,312978,115.6
00,전국,025004, 23세,2017,719175,385804,333371,115.7,682616,365327,317289,115.1
00,전국,025005, 24세,2017,725211,388132,337079,115.1,683916,363926,319990,113.7
00,전국,030,25~29세,2017,3407757,1815686,1592071,114,3164039,1665093,1498946,111.1
00,전국,030001, 25세,2017,736945,392793,344152,114.1,692142,365363,326779,111.8
00,전국,030002, 26세,2017,698153,371753,326400,113.9,651838,343127,308711,111.1
00,전국,030003, 27세,2017,673106,359968,313138,115,621835,328521,293314,112
00,전국,030004, 28세,2017,655332,350255,305077,114.8,605251,318966,286285,111.4
00,전국,030005, 29세,2017,644221,340917,303304,112.4,592973,309116,283857,108.9
00,전국,035,30~34세,2017,3447773,1804860,1642913,109.9,3216057,1657296,1558761,106.3
00,전국,035001, 30세,2017,650106,340873,309233,110.2,597897,308128,289769,106.3
00,전국,035002, 31세,2017,660085,348231,311854,111.7,610552,317089,293463,108.1
00,전국,035003, 32세,2017,668356,350967,317389,110.6,622249,321489,300760,106.9
00,전국,035004, 33세,2017,700537,365916,334621,109.4,657254,337926,319328,105.8
00,전국,035005, 34세,2017,768689,398873,369816,107.9,728105,372664,355441,104.8
00,전국,040,35~39세,2017,4070681,2100211,1970470,106.6,3904372,1992903,1911469,104.3
00,전국,040001, 35세,2017,835094,431512,403582,106.9,795282,405874,389408,104.2
00,전국,040002, 36세,2017,835257,434585,400672,108.5,801179,412451,388728,106.1
00,전국,040003, 37세,2017,851779,437511,414268,105.6,819468,416622,402846,103.4
00,전국,040004, 38세,2017,807679,414878,392801,105.6,775942,394417,381525,103.4
00,전국,040005, 39세,2017,740872,381725,359147,106.3,712501,363539,348962,104.2
00,전국,045,40~44세,2017,4037048,2060634,1976414,104.3,3916382,1986538,1929844,102.9
00,전국,045001, 40세,2017,763409,390541,372868,104.7,738080,374430,363650,103
00,전국,045002, 41세,2017,751762,387551,364211,106.4,726866,371862,355004,104.7
00,전국,045003, 42세,2017,788903,401512,387391,103.6,765847,387390,378457,102.4
00,전국,045004, 43세,2017,860326,439806,420520,104.6,837242,425919,411323,103.5
00,전국,045005, 44세,2017,872648,441224,431424,102.3,848347,426937,421410,101.3
00,전국,050,45~49세,2017,4532957,2295736,2237221,102.6,4404427,2224798,2179629,102.1
00,전국,050001, 45세,2017,875529,449511,426018,105.5,850114,434734,415380,104.7
00,전국,050002, 46세,2017,932096,474773,457323,103.8,905877,460109,445768,103.2
00,전국,050003, 47세,2017,901715,457166,444549,102.8,874906,442415,432491,102.3
00,전국,050004, 48세,2017,912997,459751,453246,101.4,887960,446319,441641,101.1
00,전국,050005, 49세,2017,910620,454535,456085,99.7,885570,441221,444349,99.3
00,전국,055,50~54세,2017,4122551,2082358,2040193,102.1,4000764,2020278,1980486,102
00,전국,055001, 50세,2017,833618,414657,418961,99,812642,403692,408950,98.7
00,전국,055002, 51세,2017,819726,420443,399283,105.3,796713,408602,388111,105.3
00,전국,055003, 52세,2017,842454,422279,420175,100.5,817379,409510,407869,100.4
00,전국,055004, 53세,2017,791128,400460,390668,102.5,766725,388126,378599,102.5
00,전국,055005, 54세,2017,835625,424519,411106,103.3,807305,410348,396957,103.4
00,전국,060,55~59세,2017,4258232,2120781,2137451,99.2,4167356,2076215,2091141,99.3
00,전국,060001, 55세,2017,857020,434479,422541,102.8,834947,423545,411402,103
00,전국,060002, 56세,2017,915745,454377,461368,98.5,901129,447338,453791,98.6
00,전국,060003, 57세,2017,907960,446962,460998,97,887330,436856,450474,97
00,전국,060004, 58세,2017,811723,401991,409732,98.1,795184,393870,401314,98.1
00,전국,060005, 59세,2017,765784,382972,382812,100,748766,374606,374160,100.1
00,전국,065,60~64세,2017,3251699,1596954,1654745,96.5,3175172,1558672,1616500,96.4
00,전국,065001, 60세,2017,750829,373522,377307,99,731847,363922,367925,98.9
00,전국,065002, 61세,2017,690062,341214,348848,97.8,673656,333045,340611,97.8
00,전국,065003, 62세,2017,701449,340613,360836,94.4,685612,332635,352977,94.2
00,전국,065004, 63세,2017,592099,290853,301246,96.5,578129,283946,294183,96.5
00,전국,065005, 64세,2017,517260,250752,266508,94.1,505928,245124,260804,94
00,전국,070,65~69세,2017,2315195,1113374,1201821,92.6,2282138,1097501,1184637,92.6
00,전국,070001, 65세,2017,560946,272199,288747,94.3,551256,267481,283775,94.3
00,전국,070002, 66세,2017,416217,200753,215464,93.2,408483,196970,211513,93.1
00,전국,070003, 67세,2017,447023,214746,232277,92.5,440575,211630,228945,92.4
00,전국,070004, 68세,2017,452448,216473,235975,91.7,446921,213869,233052,91.8
00,전국,070005, 69세,2017,438561,209203,229358,91.2,434903,207551,227352,91.3
00,전국,075,70~74세,2017,1756166,802127,954039,84.1,1745402,797640,947762,84.2
00,전국,075001, 70세,2017,433601,202983,230618,88,430354,201554,228800,88.1
00,전국,075002, 71세,2017,328297,154113,174184,88.5,325776,153029,172747,88.6
00,전국,075003, 72세,2017,324192,148294,175898,84.3,322335,147516,174819,84.4
00,전국,075004, 73세,2017,329988,146862,183126,80.2,328313,146188,182125,80.3
00,전국,075005, 74세,2017,340088,149875,190213,78.8,338624,149353,189271,78.9
00,전국,080,75~79세,2017,1543849,643508,900341,71.5,1537367,641422,895945,71.6
00,전국,080001, 75세,2017,394939,172506,222433,77.6,393511,172000,221511,77.6
00,전국,080002, 76세,2017,317864,135253,182611,74.1,316467,134802,181665,74.2
00,전국,080003, 77세,2017,289491,119360,170131,70.2,288186,118939,169247,70.3
00,전국,080004, 78세,2017,286564,116143,170421,68.2,285369,115770,169599,68.3
00,전국,080005, 79세,2017,254991,100246,154745,64.8,253834,99911,153923,64.9
00,전국,085,80~84세,2017,943418,335345,608073,55.1,939787,334274,605513,55.2
00,전국,085001, 80세,2017,232002,88781,143221,62,231021,88479,142542,62.1
00,전국,085002, 81세,2017,209753,77267,132486,58.3,208930,77020,131910,58.4
00,전국,085003, 82세,2017,196614,68826,127788,53.9,195903,68616,127287,53.9
00,전국,085004, 83세,2017,165905,55986,109919,50.9,165309,55820,109489,51
00,전국,085005, 84세,2017,139144,44485,94659,47,138624,44339,94285,47
00,전국,090,85~89세,2017,434947,119540,315407,37.9,433550,119129,314421,37.9
00,전국,090001, 85세,2017,122044,37025,85019,43.5,121676,36914,84762,43.6
00,전국,090002, 86세,2017,94181,26566,67615,39.3,93853,26471,67382,39.3
00,전국,090003, 87세,2017,87064,22439,64625,34.7,86754,22349,64405,34.7
00,전국,090004, 88세,2017,72827,19310,53517,36.1,72605,19250,53355,36.1
00,전국,090005, 89세,2017,58831,14200,44631,31.8,58662,14145,44517,31.8
00,전국,095,90~94세,2017,141555,31590,109965,28.7,141169,31488,109681,28.7
00,전국,095001, 90세,2017,46301,10754,35547,30.3,46181,10724,35457,30.2
00,전국,095002, 91세,2017,31776,7045,24731,28.5,31683,7016,24667,28.4
00,전국,095003, 92세,2017,26648,5637,21011,26.8,26577,5623,20954,26.8
00,전국,095004, 93세,2017,18645,4253,14392,29.6,18597,4240,14357,29.5
00,전국,095005, 94세,2017,18185,3901,14284,27.3,18131,3885,14246,27.3
00,전국,100,95~99세,2017,32154,6435,25719,25,32045,6395,25650,24.9
00,전국,100001, 95세,2017,12739,2633,10106,26.1,12699,2623,10076,26
00,전국,100002, 96세,2017,8000,1610,6390,25.2,7987,1603,6384,25.1
00,전국,100003, 97세,2017,5570,1082,4488,24.1,5552,1076,4476,24
00,전국,100004, 98세,2017,3553,742,2811,26.4,3534,734,2800,26.2
00,전국,100005, 99세,2017,2292,368,1924,19.1,2273,359,1914,18.8
00,전국,101,100세이상,2017,3943,565,3378,16.7,3908,550,3358,16.4
00,전국,102,15세미만,2017,6682752,3441958,3240794,106.2,6631762,3415956,3215806,106.2
00,전국,103,15~64세,2017,37568528,19273613,18294915,105.3,36196132,18478037,17718095,104.3
00,전국,104,65세이상,2017,7171227,3052484,4118743,74.1,7115366,3028399,4086967,74.1
00,전국,086,85세이상,2017,612599,158130,454469,34.8,610672,157562,453110,34.8
00,전국,126,평균연령,2017,41.3,40.1,42.5,,41.4,40.2,42.6,
00,전국,127,중위연령,2017,42.2,40.8,43.5,,42.4,41.2,43.7,
04,읍부,000,합계,2017,4794377,2456558,2337819,105.1,4625994,2347613,2278381,103
04,읍부,005,0~4세,2017,221651,113569,108082,105.1,219516,112485,107031,105.1
04,읍부,005001, 0세,2017,38116,19532,18584,105.1,37665,19300,18365,105.1
04,읍부,005002, 1세,2017,43680,22349,21331,104.8,43191,22100,21091,104.8
04,읍부,005003, 2세,2017,46489,23896,22593,105.8,46068,23669,22399,105.7
04,읍부,005004, 3세,2017,46149,23573,22576,104.4,45737,23376,22361,104.5
04,읍부,005005, 4세,2017,47217,24219,22998,105.3,46855,24040,22815,105.4
04,읍부,010,5~9세,2017,245733,126546,119187,106.2,244499,125930,118569,106.2
04,읍부,010001, 5세,2017,51361,26408,24953,105.8,51041,26251,24790,105.9
04,읍부,010002, 6세,2017,50935,26175,24760,105.7,50692,26059,24633,105.8
04,읍부,010003, 7세,2017,48160,24901,23259,107.1,47928,24776,23152,107
04,읍부,010004, 8세,2017,46393,23843,22550,105.7,46165,23733,22432,105.8
04,읍부,010005, 9세,2017,48884,25219,23665,106.6,48673,25111,23562,106.6
04,읍부,015,10~14세,2017,230801,119896,110905,108.1,230031,119497,110534,108.1
04,읍부,015001, 10세,2017,49169,25273,23896,105.8,48976,25186,23790,105.9
04,읍부,015002, 11세,2017,44998,23407,21591,108.4,44840,23317,21523,108.3
04,읍부,015003, 12세,2017,44082,22898,21184,108.1,43922,22816,21106,108.1
04,읍부,015004, 13세,2017,46218,24102,22116,109,46084,24025,22059,108.9
04,읍부,015005, 14세,2017,46334,24216,22118,109.5,46209,24153,22056,109.5
04,읍부,020,15~19세,2017,282010,148406,133604,111.1,279503,147162,132341,111.2
04,읍부,020001, 15세,2017,48545,25302,23243,108.9,48419,25247,23172,109
04,읍부,020002, 16세,2017,56281,29166,27115,107.6,56117,29072,27045,107.5
04,읍부,020003, 17세,2017,61462,31861,29601,107.6,61204,31732,29472,107.7
04,읍부,020004, 18세,2017,57687,30509,27178,112.3,57064,30191,26873,112.3
04,읍부,020005, 19세,2017,58035,31568,26467,119.3,56699,30920,25779,119.9
04,읍부,025,20~24세,2017,296297,167892,128405,130.8,277651,155618,122033,127.5
04,읍부,025001, 20세,2017,60025,32762,27263,120.2,58019,31691,26328,120.4
04,읍부,025002, 21세,2017,59999,33716,26283,128.3,57242,32033,25209,127.1
04,읍부,025003, 22세,2017,59626,33895,25731,131.7,55870,31429,24441,128.6
04,읍부,025004, 23세,2017,58738,34018,24720,137.6,54165,30865,23300,132.5
04,읍부,025005, 24세,2017,57909,33501,24408,137.3,52355,29600,22755,130.1
04,읍부,030,25~29세,2017,273146,155312,117834,131.8,240135,131934,108201,121.9
04,읍부,030001, 25세,2017,58166,33410,24756,135,52000,28981,23019,125.9
04,읍부,030002, 26세,2017,54824,31292,23532,133,48436,26758,21678,123.4
04,읍부,030003, 27세,2017,53784,30647,23137,132.5,46831,25787,21044,122.5
04,읍부,030004, 28세,2017,53208,30258,22950,131.8,46459,25482,20977,121.5
04,읍부,030005, 29세,2017,53164,29705,23459,126.6,46409,24926,21483,116
04,읍부,035,30~34세,2017,304552,164650,139902,117.7,273223,142532,130691,109.1
04,읍부,035001, 30세,2017,55527,30379,25148,120.8,48491,25507,22984,111
04,읍부,035002, 31세,2017,57079,31278,25801,121.2,50493,26666,23827,111.9
04,읍부,035003, 32세,2017,58809,32046,26763,119.7,52464,27557,24907,110.6
04,읍부,035004, 33세,2017,63148,33848,29300,115.5,57273,29644,27629,107.3
04,읍부,035005, 34세,2017,69989,37099,32890,112.8,64502,33158,31344,105.8
04,읍부,040,35~39세,2017,387555,204315,183240,111.5,365362,188629,176733,106.7
04,읍부,040001, 35세,2017,77927,41146,36781,111.9,72641,37353,35288,105.9
04,읍부,040002, 36세,2017,78542,42097,36445,115.5,73788,38688,35100,110.2
04,읍부,040003, 37세,2017,81677,42743,38934,109.8,77315,39702,37613,105.6
04,읍부,040004, 38세,2017,77174,40427,36747,110,73124,37600,35524,105.8
04,읍부,040005, 39세,2017,72235,37902,34333,110.4,68494,35286,33208,106.3
04,읍부,045,40~44세,2017,386407,204514,181893,112.4,371646,194858,176788,110.2
04,읍부,045001, 40세,2017,74009,38930,35079,111,70774,36695,34079,107.7
04,읍부,045002, 41세,2017,72534,38558,33976,113.5,69271,36386,32885,110.6
04,읍부,045003, 42세,2017,75639,39869,35770,111.5,72795,38001,34794,109.2
04,읍부,045004, 43세,2017,82026,43720,38306,114.1,79317,42002,37315,112.6
04,읍부,045005, 44세,2017,82199,43437,38762,112.1,79489,41774,37715,110.8
04,읍부,050,45~49세,2017,412234,220028,192206,114.5,398620,212179,186441,113.8
04,읍부,050001, 45세,2017,80922,43463,37459,116,78129,41774,36355,114.9
04,읍부,050002, 46세,2017,85659,45978,39681,115.9,82861,44317,38544,115
04,읍부,050003, 47세,2017,81484,43549,37935,114.8,78647,41945,36702,114.3
04,읍부,050004, 48세,2017,82191,43707,38484,113.6,79593,42245,37348,113.1
04,읍부,050005, 49세,2017,81978,43331,38647,112.1,79390,41898,37492,111.8
04,읍부,055,50~54세,2017,365604,193279,172325,112.2,354364,187234,167130,112
04,읍부,055001, 50세,2017,74160,38832,35328,109.9,72114,37722,34392,109.7
04,읍부,055002, 51세,2017,73920,39785,34135,116.6,71692,38580,33112,116.5
04,읍부,055003, 52세,2017,74433,39002,35431,110.1,72087,37738,34349,109.9
04,읍부,055004, 53세,2017,70041,37191,32850,113.2,67772,35967,31805,113.1
04,읍부,055005, 54세,2017,73050,38469,34581,111.2,70699,37227,33472,111.2
04,읍부,060,55~59세,2017,377475,193949,183526,105.7,369852,190033,179819,105.7
04,읍부,060001, 55세,2017,76481,40361,36120,111.7,74576,39365,35211,111.8
04,읍부,060002, 56세,2017,81698,42020,39678,105.9,80383,41357,39026,106
04,읍부,060003, 57세,2017,79683,40500,39183,103.4,77957,39606,38351,103.3
04,읍부,060004, 58세,2017,71618,36363,35255,103.1,70293,35699,34594,103.2
04,읍부,060005, 59세,2017,67995,34705,33290,104.3,66643,34006,32637,104.2
04,읍부,065,60~64세,2017,289761,144371,145390,99.3,284398,141507,142891,99
04,읍부,065001, 60세,2017,66362,33793,32569,103.8,64988,33031,31957,103.4
04,읍부,065002, 61세,2017,61519,30978,30541,101.4,60333,30354,29979,101.3
04,읍부,065003, 62세,2017,61960,30444,31516,96.6,60913,29875,31038,96.3
04,읍부,065004, 63세,2017,53509,26308,27201,96.7,52531,25814,26717,96.6
04,읍부,065005, 64세,2017,46411,22848,23563,97,45633,22433,23200,96.7
04,읍부,070,65~69세,2017,214945,103472,111473,92.8,212701,102344,110357,92.7
04,읍부,070001, 65세,2017,51183,24976,26207,95.3,50555,24663,25892,95.3
04,읍부,070002, 66세,2017,38958,18792,20166,93.2,38452,18522,19930,92.9
04,읍부,070003, 67세,2017,41205,19680,21525,91.4,40752,19458,21294,91.4
04,읍부,070004, 68세,2017,42479,20337,22142,91.8,42089,20139,21950,91.7
04,읍부,070005, 69세,2017,41120,19687,21433,91.9,40853,19562,21291,91.9
04,읍부,075,70~74세,2017,170212,77370,92842,83.3,169342,76981,92361,83.3
04,읍부,075001, 70세,2017,41095,19611,21484,91.3,40824,19491,21333,91.4
04,읍부,075002, 71세,2017,31312,14817,16495,89.8,31114,14725,16389,89.8
04,읍부,075003, 72세,2017,31525,14385,17140,83.9,31371,14317,17054,84
04,읍부,075004, 73세,2017,32163,13982,18181,76.9,32033,13921,18112,76.9
04,읍부,075005, 74세,2017,34117,14575,19542,74.6,34000,14527,19473,74.6
04,읍부,080,75~79세,2017,162249,65508,96741,67.7,161787,65348,96439,67.8
04,읍부,080001, 75세,2017,40029,16949,23080,73.4,39912,16900,23012,73.4
04,읍부,080002, 76세,2017,32935,13508,19427,69.5,32824,13466,19358,69.6
04,읍부,080003, 77세,2017,30589,12318,18271,67.4,30501,12290,18211,67.5
04,읍부,080004, 78세,2017,31053,12115,18938,64,30978,12091,18887,64
04,읍부,080005, 79세,2017,27643,10618,17025,62.4,27572,10601,16971,62.5
04,읍부,085,80~84세,2017,104402,36284,68118,53.3,104157,36192,67965,53.3
04,읍부,085001, 80세,2017,25073,9356,15717,59.5,24989,9318,15671,59.5
04,읍부,085002, 81세,2017,23324,8454,14870,56.9,23288,8443,14845,56.9
04,읍부,085003, 82세,2017,21764,7402,14362,51.5,21714,7386,14328,51.5
04,읍부,085004, 83세,2017,18618,6164,12454,49.5,18580,6150,12430,49.5
04,읍부,085005, 84세,2017,15623,4908,10715,45.8,15586,4895,10691,45.8
04,읍부,090,85~89세,2017,49235,13011,36224,35.9,49140,12974,36166,35.9
04,읍부,090001, 85세,2017,13977,4019,9958,40.4,13956,4011,9945,40.3
04,읍부,090002, 86세,2017,10583,2893,7690,37.6,10557,2884,7673,37.6
04,읍부,090003, 87세,2017,9961,2496,7465,33.4,9938,2486,7452,33.4
04,읍부,090004, 88세,2017,8211,2113,6098,34.7,8195,2108,6087,34.6
04,읍부,090005, 89세,2017,6503,1490,5013,29.7,6494,1485,5009,29.6
04,읍부,095,90~94세,2017,15940,3385,12555,27,15907,3378,12529,27
04,읍부,095001, 90세,2017,5142,1124,4018,28,5128,1122,4006,28
04,읍부,095002, 91세,2017,3550,743,2807,26.5,3543,740,2803,26.4
04,읍부,095003, 92세,2017,2984,631,2353,26.8,2979,631,2348,26.9
04,읍부,095004, 93세,2017,2095,482,1613,29.9,2093,481,1612,29.8
04,읍부,095005, 94세,2017,2169,405,1764,23,2164,404,1760,23
04,읍부,100,95~99세,2017,3724,751,2973,25.3,3716,748,2968,25.2
04,읍부,100001, 95세,2017,1499,302,1197,25.2,1496,301,1195,25.2
04,읍부,100002, 96세,2017,925,202,723,27.9,925,202,723,27.9
04,읍부,100003, 97세,2017,592,113,479,23.6,589,111,478,23.2
04,읍부,100004, 98세,2017,422,88,334,26.3,420,88,332,26.5
04,읍부,100005, 99세,2017,286,46,240,19.2,286,46,240,19.2
04,읍부,101,100세이상,2017,444,50,394,12.7,444,50,394,12.7
04,읍부,102,15세미만,2017,698185,360011,338174,106.5,694046,357912,336134,106.5
04,읍부,103,15~64세,2017,3375041,1796716,1578325,113.8,3214754,1691686,1523068,111.1
04,읍부,104,65세이상,2017,721151,299831,421320,71.2,717194,298015,419179,71.1
04,읍부,086,85세이상,2017,69343,17197,52146,33,69207,17150,52057,32.9
04,읍부,126,평균연령,2017,41.3,39.9,42.8,,41.5,40.1,42.9,
04,읍부,127,중위연령,2017,42.1,40.7,43.6,,42.6,41.4,43.8,
05,면부,000,합계,2017,4835090,2498157,2336933,106.9,4592308,2324414,2267894,102.5
05,면부,005,0~4세,2017,138155,70974,67181,105.6,137001,70378,66623,105.6
05,면부,005001, 0세,2017,24810,12759,12051,105.9,24548,12628,11920,105.9
05,면부,005002, 1세,2017,27641,14192,13449,105.5,27365,14049,13316,105.5
05,면부,005003, 2세,2017,28588,14693,13895,105.7,28371,14583,13788,105.8
05,면부,005004, 3세,2017,28457,14489,13968,103.7,28244,14367,13877,103.5
05,면부,005005, 4세,2017,28659,14841,13818,107.4,28473,14751,13722,107.5
05,면부,010,5~9세,2017,145411,75375,70036,107.6,144630,75004,69626,107.7
05,면부,010001, 5세,2017,30717,15812,14905,106.1,30508,15707,14801,106.1
05,면부,010002, 6세,2017,29653,15460,14193,108.9,29497,15387,14110,109.1
05,면부,010003, 7세,2017,28341,14739,13602,108.4,28205,14677,13528,108.5
05,면부,010004, 8세,2017,27675,14366,13309,107.9,27539,14306,13233,108.1
05,면부,010005, 9세,2017,29025,14998,14027,106.9,28881,14927,13954,107
05,면부,015,10~14세,2017,137862,72423,65439,110.7,137364,72185,65179,110.7
05,면부,015001, 10세,2017,29054,15058,13996,107.6,28936,14993,13943,107.5
05,면부,015002, 11세,2017,26462,13841,12621,109.7,26362,13797,12565,109.8
05,면부,015003, 12세,2017,25570,13401,12169,110.1,25490,13360,12130,110.1
05,면부,015004, 13세,2017,28172,14954,13218,113.1,28062,14903,13159,113.3
05,면부,015005, 14세,2017,28604,15169,13435,112.9,28514,15132,13382,113.1
05,면부,020,15~19세,2017,201955,108645,93310,116.4,199365,107270,92095,116.5
05,면부,020001, 15세,2017,30826,16481,14345,114.9,30710,16412,14298,114.8
05,면부,020002, 16세,2017,37191,19645,17546,112,37062,19582,17480,112
05,면부,020003, 17세,2017,41343,21772,19571,111.2,41077,21605,19472,111
05,면부,020004, 18세,2017,43279,23205,20074,115.6,42745,22931,19814,115.7
05,면부,020005, 19세,2017,49316,27542,21774,126.5,47771,26740,21031,127.1
05,면부,025,20~24세,2017,264404,157696,106708,147.8,232394,135198,97196,139.1
05,면부,025001, 20세,2017,49947,27715,22232,124.7,47149,26178,20971,124.8
05,면부,025002, 21세,2017,51696,29866,21830,136.8,46875,26704,20171,132.4
05,면부,025003, 22세,2017,53453,32013,21440,149.3,46870,27387,19483,140.6
05,면부,025004, 23세,2017,53941,33384,20557,162.4,46028,27588,18440,149.6
05,면부,025005, 24세,2017,55367,34718,20649,168.1,45472,27341,18131,150.8
05,면부,030,25~29세,2017,262289,163808,98481,166.3,204607,119829,84778,141.3
05,면부,030001, 25세,2017,55918,34739,21179,164,44839,26350,18489,142.5
05,면부,030002, 26세,2017,53011,32858,20153,163,41770,24290,17480,139
05,면부,030003, 27세,2017,52637,32987,19650,167.9,40479,23783,16696,142.4
05,면부,030004, 28세,2017,50371,31765,18606,170.7,38876,22890,15986,143.2
05,면부,030005, 29세,2017,50352,31459,18893,166.5,38643,22516,16127,139.6
05,면부,035,30~34세,2017,253858,154195,99663,154.7,203938,115423,88515,130.4
05,면부,035001, 30세,2017,49969,30807,19162,160.8,38740,22120,16620,133.1
05,면부,035002, 31세,2017,49889,30872,19017,162.3,39275,22667,16608,136.5
05,면부,035003, 32세,2017,49333,30207,19126,157.9,39186,22277,16909,131.7
05,면부,035004, 33세,2017,50617,30464,20153,151.2,41345,23221,18124,128.1
05,면부,035005, 34세,2017,54050,31845,22205,143.4,45392,25138,20254,124.1
05,면부,040,35~39세,2017,274227,161670,112557,143.6,240742,135994,104748,129.8
05,면부,040001, 35세,2017,57720,34000,23720,143.3,49517,27692,21825,126.9
05,면부,040002, 36세,2017,56180,33144,23036,143.9,49088,27674,21414,129.2
05,면부,040003, 37세,2017,56892,33239,23653,140.5,50204,28123,22081,127.4
05,면부,040004, 38세,2017,53447,31527,21920,143.8,47321,26826,20495,130.9
05,면부,040005, 39세,2017,49988,29760,20228,147.1,44612,25679,18933,135.6
05,면부,045,40~44세,2017,269971,158656,111315,142.5,250115,144491,105624,136.8
05,면부,045001, 40세,2017,50766,29772,20994,141.8,46045,26229,19816,132.4
05,면부,045002, 41세,2017,50564,30191,20373,148.2,46161,26969,19192,140.5
05,면부,045003, 42세,2017,52209,30690,21519,142.6,48421,27999,20422,137.1
05,면부,045004, 43세,2017,57384,33800,23584,143.3,53779,31331,22448,139.6
05,면부,045005, 44세,2017,59048,34203,24845,137.7,55709,31963,23746,134.6
05,면부,050,45~49세,2017,325595,184887,140708,131.4,309670,174828,134842,129.7
05,면부,050001, 45세,2017,58454,34250,24204,141.5,54964,31971,22993,139
05,면부,050002, 46세,2017,64276,37267,27009,138,60989,35139,25850,135.9
05,면부,050003, 47세,2017,63632,36218,27414,132.1,60320,34148,26172,130.5
05,면부,050004, 48세,2017,67991,37991,30000,126.6,65041,36192,28849,125.5
05,면부,050005, 49세,2017,71242,39161,32081,122.1,68356,37378,30978,120.7
05,면부,055,50~54세,2017,366921,198137,168784,117.4,354556,191081,163475,116.9
05,면부,055001, 50세,2017,68364,36895,31469,117.2,65894,35467,30427,116.6
05,면부,055002, 51세,2017,70736,39120,31616,123.7,68345,37733,30612,123.3
05,면부,055003, 52세,2017,75937,41002,34935,117.4,73349,39520,33829,116.8
05,면부,055004, 53세,2017,72928,39006,33922,115,70602,37690,32912,114.5
05,면부,055005, 54세,2017,78956,42114,36842,114.3,76366,40671,35695,113.9
05,면부,060,55~59세,2017,467423,241012,226411,106.4,459447,236612,222835,106.2
05,면부,060001, 55세,2017,87019,46074,40945,112.5,85025,44974,40051,112.3
05,면부,060002, 56세,2017,98744,50816,47928,106,97285,50054,47231,106
05,면부,060003, 57세,2017,100232,50834,49398,102.9,98459,49833,48626,102.5
05,면부,060004, 58세,2017,92097,47093,45004,104.6,90705,46335,44370,104.4
05,면부,060005, 59세,2017,89331,46195,43136,107.1,87973,45416,42557,106.7
05,면부,065,60~64세,2017,412375,209263,203112,103,407361,206428,200933,102.7
05,면부,065001, 60세,2017,89949,46429,43520,106.7,88646,45686,42960,106.3
05,면부,065002, 61세,2017,86459,44442,42017,105.8,85392,43822,41570,105.4
05,면부,065003, 62세,2017,88483,44493,43990,101.1,87454,43921,43533,100.9
05,면부,065004, 63세,2017,78345,39405,38940,101.2,77449,38911,38538,101
05,면부,065005, 64세,2017,69139,34494,34645,99.6,68420,34088,34332,99.3
05,면부,070,65~69세,2017,338600,167272,171328,97.6,336533,166169,170364,97.5
05,면부,070001, 65세,2017,78439,38963,39476,98.7,77858,38650,39208,98.6
05,면부,070002, 66세,2017,60422,29658,30764,96.4,59989,29419,30570,96.2
05,면부,070003, 67세,2017,65628,32184,33444,96.2,65201,31955,33246,96.1
05,면부,070004, 68세,2017,67579,33554,34025,98.6,67217,33369,33848,98.6
05,면부,070005, 69세,2017,66532,32913,33619,97.9,66268,32776,33492,97.9
05,면부,075,70~74세,2017,288962,131003,157959,82.9,288215,130645,157570,82.9
05,면부,075001, 70세,2017,67093,32386,34707,93.3,66868,32278,34590,93.3
05,면부,075002, 71세,2017,50638,24233,26405,91.8,50453,24148,26305,91.8
05,면부,075003, 72세,2017,53328,24017,29311,81.9,53193,23948,29245,81.9
05,면부,075004, 73세,2017,56312,24173,32139,75.2,56207,24127,32080,75.2
05,면부,075005, 74세,2017,61591,26194,35397,74,61494,26144,35350,74
05,면부,080,75~79세,2017,319697,128011,191686,66.8,319287,127857,191430,66.8
05,면부,080001, 75세,2017,77402,32481,44921,72.3,77307,32445,44862,72.3
05,면부,080002, 76세,2017,63513,26147,37366,70,63426,26109,37317,70
05,면부,080003, 77세,2017,59845,23761,36084,65.8,59758,23725,36033,65.8
05,면부,080004, 78세,2017,62438,24304,38134,63.7,62374,24276,38098,63.7
05,면부,080005, 79세,2017,56499,21318,35181,60.6,56422,21302,35120,60.7
05,면부,085,80~84세,2017,222552,77454,145098,53.4,222373,77387,144986,53.4
05,면부,085001, 80세,2017,52861,19733,33128,59.6,52806,19715,33091,59.6
05,면부,085002, 81세,2017,48742,17790,30952,57.5,48700,17776,30924,57.5
05,면부,085003, 82세,2017,46807,15901,30906,51.4,46778,15890,30888,51.4
05,면부,085004, 83세,2017,40332,13422,26910,49.9,40303,13407,26896,49.8
05,면부,085005, 84세,2017,33810,10608,23202,45.7,33786,10599,23187,45.7
05,면부,090,85~89세,2017,103719,28502,75217,37.9,103629,28472,75157,37.9
05,면부,090001, 85세,2017,29318,8892,20426,43.5,29300,8888,20412,43.5
05,면부,090002, 86세,2017,22760,6351,16409,38.7,22740,6344,16396,38.7
05,면부,090003, 87세,2017,20876,5380,15496,34.7,20851,5372,15479,34.7
05,면부,090004, 88세,2017,17040,4486,12554,35.7,17024,4480,12544,35.7
05,면부,090005, 89세,2017,13725,3393,10332,32.8,13714,3388,10326,32.8
05,면부,095,90~94세,2017,32804,7666,25138,30.5,32782,7660,25122,30.5
05,면부,095001, 90세,2017,10690,2586,8104,31.9,10679,2584,8095,31.9
05,면부,095002, 91세,2017,7434,1757,5677,30.9,7431,1756,5675,30.9
05,면부,095003, 92세,2017,6196,1437,4759,30.2,6196,1437,4759,30.2
05,면부,095004, 93세,2017,4271,1003,3268,30.7,4268,1002,3266,30.7
05,면부,095005, 94세,2017,4213,883,3330,26.5,4208,881,3327,26.5
05,면부,100,95~99세,2017,7455,1386,6069,22.8,7446,1383,6063,22.8
05,면부,100001, 95세,2017,2965,584,2381,24.5,2963,584,2379,24.5
05,면부,100002, 96세,2017,1825,348,1477,23.6,1825,348,1477,23.6
05,면부,100003, 97세,2017,1323,224,1099,20.4,1321,223,1098,20.3
05,면부,100004, 98세,2017,807,150,657,22.8,804,149,655,22.7
05,면부,100005, 99세,2017,535,80,455,17.6,533,79,454,17.4
05,면부,101,100세이상,2017,855,122,733,16.6,853,120,733,16.4
05,면부,102,15세미만,2017,421428,218772,202656,108,418995,217567,201428,108
05,면부,103,15~64세,2017,3099018,1737969,1361049,127.7,2862195,1567154,1295041,121
05,면부,104,65세이상,2017,1314644,541416,773228,70,1311118,539693,771425,70
05,면부,086,85세이상,2017,144833,37676,107157,35.2,144710,37635,107075,35.1
05,면부,126,평균연령,2017,49,46.4,51.8,,49.8,47.3,52.3,
05,면부,127,중위연령,2017,52.1,48.5,55.8,,53.4,50.3,56.4,
03,동부,000,합계,2017,41793040,20813340,20979700,99.2,40724958,20250365,20474593,98.9
03,동부,005,0~4세,2017,1743153,893171,849982,105.1,1719420,881153,838267,105.1
03,동부,005001, 0세,2017,304151,156506,147645,106,299082,153905,145177,106
03,동부,005002, 1세,2017,346696,177408,169288,104.8,341194,174571,166623,104.8
03,동부,005003, 2세,2017,364908,186948,177960,105.1,360212,184560,175652,105.1
03,동부,005004, 3세,2017,361328,185029,176299,105,356801,182793,174008,105
03,동부,005005, 4세,2017,366070,187280,178790,104.7,362131,185324,176807,104.8
03,동부,010,5~9세,2017,1911886,983359,928527,105.9,1898749,976545,922204,105.9
03,동부,010001, 5세,2017,397223,203968,193255,105.5,393648,202148,191500,105.6
03,동부,010002, 6세,2017,390809,200601,190208,105.5,388043,199119,188924,105.4
03,동부,010003, 7세,2017,375910,193737,182173,106.3,373453,192454,180999,106.3
03,동부,010004, 8세,2017,363893,187604,176289,106.4,361658,186472,175186,106.4
03,동부,010005, 9세,2017,384051,197449,186602,105.8,381947,196352,185595,105.8
03,동부,015,10~14세,2017,1908100,986645,921455,107.1,1900552,982779,917773,107.1
03,동부,015001, 10세,2017,394576,203121,191455,106.1,392704,202172,190532,106.1
03,동부,015002, 11세,2017,362352,187385,174967,107.1,360779,186583,174196,107.1
03,동부,015003, 12세,2017,358260,185236,173024,107.1,356832,184484,172348,107
03,동부,015004, 13세,2017,392181,203060,189121,107.4,390745,202328,188417,107.4
03,동부,015005, 14세,2017,400731,207843,192888,107.8,399492,207212,192280,107.8
03,동부,020,15~19세,2017,2438175,1266690,1171485,108.1,2412709,1255167,1157542,108.4
03,동부,020001, 15세,2017,411741,214440,197301,108.7,410389,213748,196641,108.7
03,동부,020002, 16세,2017,468226,244088,224138,108.9,466729,243296,223433,108.9
03,동부,020003, 17세,2017,517538,270024,247514,109.1,514988,268789,246199,109.2
03,동부,020004, 18세,2017,506522,263582,242940,108.5,500490,260824,239666,108.8
03,동부,020005, 19세,2017,534148,274556,259592,105.8,520113,268510,251603,106.7
03,동부,025,20~24세,2017,2956989,1547064,1409925,109.7,2845941,1495829,1350112,110.8
03,동부,025001, 20세,2017,561699,289077,272622,106,543238,281575,261663,107.6
03,동부,025002, 21세,2017,582553,306488,276065,111,562170,297428,264742,112.3
03,동부,025003, 22세,2017,594306,313184,281122,111.4,572021,302967,269054,112.6
03,동부,025004, 23세,2017,606496,318402,288094,110.5,582423,306874,275549,111.4
03,동부,025005, 24세,2017,611935,319913,292022,109.6,586089,306985,279104,110
03,동부,030,25~29세,2017,2872322,1496566,1375756,108.8,2719297,1413330,1305967,108.2
03,동부,030001, 25세,2017,622861,324644,298217,108.9,595303,310032,285271,108.7
03,동부,030002, 26세,2017,590318,307603,282715,108.8,561632,292079,269553,108.4
03,동부,030003, 27세,2017,566685,296334,270351,109.6,534525,278951,255574,109.1
03,동부,030004, 28세,2017,551753,288232,263521,109.4,519916,270594,249322,108.5
03,동부,030005, 29세,2017,540705,279753,260952,107.2,507921,261674,246247,106.3
03,동부,035,30~34세,2017,2889363,1486015,1403348,105.9,2738896,1399341,1339555,104.5
03,동부,035001, 30세,2017,544610,279687,264923,105.6,510666,260501,250165,104.1
03,동부,035002, 31세,2017,553117,286081,267036,107.1,520784,267756,253028,105.8
03,동부,035003, 32세,2017,560214,288714,271500,106.3,530599,271655,258944,104.9
03,동부,035004, 33세,2017,586772,301604,285168,105.8,558636,285061,273575,104.2
03,동부,035005, 34세,2017,644650,329929,314721,104.8,618211,314368,303843,103.5
03,동부,040,35~39세,2017,3408899,1734226,1674673,103.6,3298268,1668280,1629988,102.3
03,동부,040001, 35세,2017,699447,356366,343081,103.9,673124,340829,332295,102.6
03,동부,040002, 36세,2017,700535,359344,341191,105.3,678303,346089,332214,104.2
03,동부,040003, 37세,2017,713210,361529,351681,102.8,691949,348797,343152,101.6
03,동부,040004, 38세,2017,677058,342924,334134,102.6,655497,329991,325506,101.4
03,동부,040005, 39세,2017,618649,314063,304586,103.1,599395,302574,296821,101.9
03,동부,045,40~44세,2017,3380670,1697464,1683206,100.8,3294621,1647189,1647432,100
03,동부,045001, 40세,2017,638634,321839,316795,101.6,621261,311506,309755,100.6
03,동부,045002, 41세,2017,628664,318802,309862,102.9,611434,308507,302927,101.8
03,동부,045003, 42세,2017,661055,330953,330102,100.3,644631,321390,323241,99.4
03,동부,045004, 43세,2017,720916,362286,358630,101,704146,352586,351560,100.3
03,동부,045005, 44세,2017,731401,363584,367817,98.8,713149,353200,359949,98.1
03,동부,050,45~49세,2017,3795128,1890821,1904307,99.3,3696137,1837791,1858346,98.9
03,동부,050001, 45세,2017,736153,371798,364355,102,717021,360989,356032,101.4
03,동부,050002, 46세,2017,782161,391528,390633,100.2,762027,380653,381374,99.8
03,동부,050003, 47세,2017,756599,377399,379200,99.5,735939,366322,369617,99.1
03,동부,050004, 48세,2017,762815,378053,384762,98.3,743326,367882,375444,98
03,동부,050005, 49세,2017,757400,372043,385357,96.5,737824,361945,375879,96.3
03,동부,055,50~54세,2017,3390026,1690942,1699084,99.5,3291844,1641963,1649881,99.5
03,동부,055001, 50세,2017,691094,338930,352164,96.2,674634,330503,344131,96
03,동부,055002, 51세,2017,675070,341538,333532,102.4,656676,332289,324387,102.4
03,동부,055003, 52세,2017,692084,342275,349809,97.8,671943,332252,339691,97.8
03,동부,055004, 53세,2017,648159,324263,323896,100.1,628351,314469,313882,100.2
03,동부,055005, 54세,2017,683619,343936,339683,101.3,660240,332450,327790,101.4
03,동부,060,55~59세,2017,3413334,1685820,1727514,97.6,3338057,1649570,1688487,97.7
03,동부,060001, 55세,2017,693520,348044,345476,100.7,675346,339206,336140,100.9
03,동부,060002, 56세,2017,735303,361541,373762,96.7,723461,355927,367534,96.8
03,동부,060003, 57세,2017,728045,355628,372417,95.5,710914,347417,363497,95.6
03,동부,060004, 58세,2017,648008,318535,329473,96.7,634186,311836,322350,96.7
03,동부,060005, 59세,2017,608458,302072,306386,98.6,594150,295184,298966,98.7
03,동부,065,60~64세,2017,2549563,1243320,1306243,95.2,2483413,1210737,1272676,95.1
03,동부,065001, 60세,2017,594518,293300,301218,97.4,578213,285205,293008,97.3
03,동부,065002, 61세,2017,542084,265794,276290,96.2,527931,258869,269062,96.2
03,동부,065003, 62세,2017,551006,265676,285330,93.1,537245,258839,278406,93
03,동부,065004, 63세,2017,460245,225140,235105,95.8,448149,219221,228928,95.8
03,동부,065005, 64세,2017,401710,193410,208300,92.9,391875,188603,203272,92.8
03,동부,070,65~69세,2017,1761650,842630,919020,91.7,1732904,828988,903916,91.7
03,동부,070001, 65세,2017,431324,208260,223064,93.4,422843,204168,218675,93.4
03,동부,070002, 66세,2017,316837,152303,164534,92.6,310042,149029,161013,92.6
03,동부,070003, 67세,2017,340190,162882,177308,91.9,334622,160217,174405,91.9
03,동부,070004, 68세,2017,342390,162582,179808,90.4,337615,160361,177254,90.5
03,동부,070005, 69세,2017,330909,156603,174306,89.8,327782,155213,172569,89.9
03,동부,075,70~74세,2017,1296992,593754,703238,84.4,1287845,590014,697831,84.5
03,동부,075001, 70세,2017,325413,150986,174427,86.6,322662,149785,172877,86.6
03,동부,075002, 71세,2017,246347,115063,131284,87.6,244209,114156,130053,87.8
03,동부,075003, 72세,2017,239339,109892,129447,84.9,237771,109251,128520,85
03,동부,075004, 73세,2017,241513,108707,132806,81.9,240073,108140,131933,82
03,동부,075005, 74세,2017,244380,109106,135274,80.7,243130,108682,134448,80.8
03,동부,080,75~79세,2017,1061903,449989,611914,73.5,1056293,448217,608076,73.7
03,동부,080001, 75세,2017,277508,123076,154432,79.7,276292,122655,153637,79.8
03,동부,080002, 76세,2017,221416,95598,125818,76,220217,95227,124990,76.2
03,동부,080003, 77세,2017,199057,83281,115776,71.9,197927,82924,115003,72.1
03,동부,080004, 78세,2017,193073,79724,113349,70.3,192017,79403,112614,70.5
03,동부,080005, 79세,2017,170849,68310,102539,66.6,169840,68008,101832,66.8
03,동부,085,80~84세,2017,616464,221607,394857,56.1,613257,220695,392562,56.2
03,동부,085001, 80세,2017,154068,59692,94376,63.2,153226,59446,93780,63.4
03,동부,085002, 81세,2017,137687,51023,86664,58.9,136942,50801,86141,59
03,동부,085003, 82세,2017,128043,45523,82520,55.2,127411,45340,82071,55.2
03,동부,085004, 83세,2017,106955,36400,70555,51.6,106426,36263,70163,51.7
03,동부,085005, 84세,2017,89711,28969,60742,47.7,89252,28845,60407,47.8
03,동부,090,85~89세,2017,281993,78027,203966,38.3,280781,77683,203098,38.2
03,동부,090001, 85세,2017,78749,24114,54635,44.1,78420,24015,54405,44.1
03,동부,090002, 86세,2017,60838,17322,43516,39.8,60556,17243,43313,39.8
03,동부,090003, 87세,2017,56227,14563,41664,35,55965,14491,41474,34.9
03,동부,090004, 88세,2017,47576,12711,34865,36.5,47386,12662,34724,36.5
03,동부,090005, 89세,2017,38603,9317,29286,31.8,38454,9272,29182,31.8
03,동부,095,90~94세,2017,92811,20539,72272,28.4,92480,20450,72030,28.4
03,동부,095001, 90세,2017,30469,7044,23425,30.1,30374,7018,23356,30
03,동부,095002, 91세,2017,20792,4545,16247,28,20709,4520,16189,27.9
03,동부,095003, 92세,2017,17468,3569,13899,25.7,17402,3555,13847,25.7
03,동부,095004, 93세,2017,12279,2768,9511,29.1,12236,2757,9479,29.1
03,동부,095005, 94세,2017,11803,2613,9190,28.4,11759,2600,9159,28.4
03,동부,100,95~99세,2017,20975,4298,16677,25.8,20883,4264,16619,25.7
03,동부,100001, 95세,2017,8275,1747,6528,26.8,8240,1738,6502,26.7
03,동부,100002, 96세,2017,5250,1060,4190,25.3,5237,1053,4184,25.2
03,동부,100003, 97세,2017,3655,745,2910,25.6,3642,742,2900,25.6
03,동부,100004, 98세,2017,2324,504,1820,27.7,2310,497,1813,27.4
03,동부,100005, 99세,2017,1471,242,1229,19.7,1454,234,1220,19.2
03,동부,101,100세이상,2017,2644,393,2251,17.5,2611,380,2231,17
03,동부,102,15세미만,2017,5563139,2863175,2699964,106,5518721,2840477,2678244,106.1
03,동부,103,15~64세,2017,31094469,15738928,15355541,102.5,30119183,15219197,14899986,102.1
03,동부,104,65세이상,2017,5135432,2211237,2924195,75.6,5087054,2190691,2896363,75.6
03,동부,086,85세이상,2017,398423,103257,295166,35,396755,102777,293978,35
03,동부,126,평균연령,2017,40.5,39.4,41.5,,40.5,39.4,41.5,
03,동부,127,중위연령,2017,41.2,40,42.4,,41.3,40.2,42.5,
11,서울특별시,000,합계,2017,9741871,4757642,4984229,95.5,9397944,4592393,4805551,95.6
11,서울특별시,005,0~4세,2017,354174,181170,173004,104.7,346711,177401,169310,104.8
11,서울특별시,005001, 0세,2017,65737,33634,32103,104.8,64193,32845,31348,104.8
11,서울특별시,005002, 1세,2017,72202,36939,35263,104.8,70486,36051,34435,104.7
11,서울특별시,005003, 2세,2017,73567,37667,35900,104.9,72078,36921,35157,105
11,서울특별시,005004, 3세,2017,71537,36503,35034,104.2,70110,35806,34304,104.4
11,서울특별시,005005, 4세,2017,71131,36427,34704,105,69844,35778,34066,105
11,서울특별시,010,5~9세,2017,363637,186597,177040,105.4,359066,184234,174832,105.4
11,서울특별시,010001, 5세,2017,76130,39091,37039,105.5,74917,38462,36455,105.5
11,서울특별시,010002, 6세,2017,73686,37714,35972,104.8,72731,37201,35530,104.7
11,서울특별시,010003, 7세,2017,71328,36647,34681,105.7,70469,36208,34261,105.7
11,서울특별시,010004, 8세,2017,68903,35293,33610,105,68113,34899,33214,105.1
11,서울특별시,010005, 9세,2017,73590,37852,35738,105.9,72836,37464,35372,105.9
11,서울특별시,015,10~14세,2017,371556,191682,179874,106.6,368747,190196,178551,106.5
11,서울특별시,015001, 10세,2017,75652,38881,36771,105.7,74976,38536,36440,105.8
11,서울특별시,015002, 11세,2017,70243,36274,33969,106.8,69672,35980,33692,106.8
11,서울특별시,015003, 12세,2017,69997,36332,33665,107.9,69441,36023,33418,107.8
11,서울특별시,015004, 13세,2017,77298,39834,37464,106.3,76736,39536,37200,106.3
11,서울특별시,015005, 14세,2017,78366,40361,38005,106.2,77922,40121,37801,106.1
11,서울특별시,020,15~19세,2017,496075,251735,244340,103,486459,247939,238520,103.9
11,서울특별시,020001, 15세,2017,81199,41934,39265,106.8,80723,41686,39037,106.8
11,서울특별시,020002, 16세,2017,91139,47224,43915,107.5,90640,46960,43680,107.5
11,서울특별시,020003, 17세,2017,102022,52730,49292,107,101089,52276,48813,107.1
11,서울특별시,020004, 18세,2017,103754,52763,50991,103.5,101469,51878,49591,104.6
11,서울특별시,020005, 19세,2017,117961,57084,60877,93.8,112538,55139,57399,96.1
11,서울특별시,025,20~24세,2017,699945,338539,361406,93.7,661569,325097,336472,96.6
11,서울특별시,025001, 20세,2017,127096,60377,66719,90.5,119725,58005,61720,94
11,서울특별시,025002, 21세,2017,131656,63565,68091,93.4,124307,61038,63269,96.5
11,서울특별시,025003, 22세,2017,138450,67669,70781,95.6,130703,64960,65743,98.8
11,서울특별시,025004, 23세,2017,147970,71777,76193,94.2,140014,68930,71084,97
11,서울특별시,025005, 24세,2017,154773,75151,79622,94.4,146820,72164,74656,96.7
11,서울특별시,030,25~29세,2017,777218,383505,393713,97.4,735323,364581,370742,98.3
11,서울특별시,030001, 25세,2017,162197,79173,83024,95.4,154223,75848,78375,96.8
11,서울특별시,030002, 26세,2017,158876,78312,80564,97.2,151035,74845,76190,98.2
11,서울특별시,030003, 27세,2017,154824,76729,78095,98.3,145954,72751,73203,99.4
11,서울특별시,030004, 28세,2017,151477,75257,76220,98.7,142955,71275,71680,99.4
11,서울특별시,030005, 29세,2017,149844,74034,75810,97.7,141156,69862,71294,98
11,서울특별시,035,30~34세,2017,766607,384052,382555,100.4,727683,363965,363718,100.1
11,서울특별시,035001, 30세,2017,149343,73632,75711,97.3,140431,69240,71191,97.3
11,서울특별시,035002, 31세,2017,150410,75295,75115,100.2,141871,70874,70997,99.8
11,서울특별시,035003, 32세,2017,149863,75069,74794,100.4,142351,71188,71163,100
11,서울특별시,035004, 33세,2017,153410,77392,76018,101.8,146218,73592,72626,101.3
11,서울특별시,035005, 34세,2017,163581,82664,80917,102.2,156812,79071,77741,101.7
11,서울특별시,040,35~39세,2017,806213,407731,398482,102.3,777632,391846,385786,101.6
11,서울특별시,040001, 35세,2017,171720,86561,85159,101.6,165029,82948,82081,101.1
11,서울특별시,040002, 36세,2017,168694,86257,82437,104.6,163135,83226,79909,104.2
11,서울특별시,040003, 37세,2017,167727,84672,83055,101.9,162334,81665,80669,101.2
11,서울특별시,040004, 38세,2017,157742,79475,78267,101.5,152026,76224,75802,100.6
11,서울특별시,040005, 39세,2017,140330,70766,69564,101.7,135108,67783,67325,100.7
11,서울특별시,045,40~44세,2017,756546,378503,378043,100.1,732028,364563,367465,99.2
11,서울특별시,045001, 40세,2017,144919,72435,72484,99.9,140296,69778,70518,99
11,서울특별시,045002, 41세,2017,142008,71693,70315,102,137241,68954,68287,101
11,서울특별시,045003, 42세,2017,146969,73412,73557,99.8,142525,70914,71611,99
11,서울특별시,045004, 43세,2017,159739,80126,79613,100.6,154714,77263,77451,99.8
11,서울특별시,045005, 44세,2017,162911,80837,82074,98.5,157252,77654,79598,97.6
11,서울특별시,050,45~49세,2017,847475,419571,427904,98.1,814828,402561,412267,97.6
11,서울특별시,050001, 45세,2017,166315,83634,82681,101.2,160288,80330,79958,100.5
11,서울특별시,050002, 46세,2017,176488,87884,88604,99.2,170016,84496,85520,98.8
11,서울특별시,050003, 47세,2017,169747,83994,85753,97.9,162892,80425,82467,97.5
11,서울특별시,050004, 48세,2017,169403,83491,85912,97.2,162857,80141,82716,96.9
11,서울특별시,050005, 49세,2017,165522,80568,84954,94.8,158775,77169,81606,94.6
11,서울특별시,055,50~54세,2017,756194,370127,386067,95.9,719563,352153,367410,95.8
11,서울특별시,055001, 50세,2017,151129,73058,78071,93.6,145408,70169,75239,93.3
11,서울특별시,055002, 51세,2017,146607,73262,73345,99.9,139964,69974,69990,100
11,서울특별시,055003, 52세,2017,154133,74710,79423,94.1,146651,71051,75600,94
11,서울특별시,055004, 53세,2017,148418,72717,75701,96.1,140761,68998,71763,96.1
11,서울특별시,055005, 54세,2017,155907,76380,79527,96,146779,71961,74818,96.2
11,서울특별시,060,55~59세,2017,790279,378648,411631,92,760079,364292,395787,92
11,서울특별시,060001, 55세,2017,156614,77042,79572,96.8,149378,73529,75849,96.9
11,서울특별시,060002, 56세,2017,164085,78075,86010,90.8,159536,75995,83541,91
11,서울특별시,060003, 57세,2017,168530,79347,89183,89,161631,76068,85563,88.9
11,서울특별시,060004, 58세,2017,153373,73158,80215,91.2,147748,70437,77311,91.1
11,서울특별시,060005, 59세,2017,147677,71026,76651,92.7,141786,68263,73523,92.8
11,서울특별시,065,60~64세,2017,645887,306492,339395,90.3,617823,292599,325224,90
11,서울특별시,065001, 60세,2017,146621,70068,76553,91.5,139643,66565,73078,91.1
11,서울특별시,065002, 61세,2017,135785,64566,71219,90.7,129787,61639,68148,90.4
11,서울특별시,065003, 62세,2017,140559,65921,74638,88.3,134719,63012,71707,87.9
11,서울특별시,065004, 63세,2017,118327,56432,61895,91.2,113144,53893,59251,91
11,서울특별시,065005, 64세,2017,104595,49505,55090,89.9,100530,47490,53040,89.5
11,서울특별시,070,65~69세,2017,458490,216809,241681,89.7,446771,211180,235591,89.6
11,서울특별시,070001, 65세,2017,111119,52901,58218,90.9,107600,51156,56444,90.6
11,서울특별시,070002, 66세,2017,80683,38264,42419,90.2,77924,36914,41010,90
11,서울특별시,070003, 67세,2017,89582,42466,47116,90.1,87332,41367,45965,90
11,서울특별시,070004, 68세,2017,90110,42175,47935,88,88198,41284,46914,88
11,서울특별시,070005, 69세,2017,86996,41003,45993,89.2,85717,40459,45258,89.4
11,서울특별시,075,70~74세,2017,346471,160386,186085,86.2,342908,158941,183967,86.4
11,서울특별시,075001, 70세,2017,87354,40382,46972,86,86267,39925,46342,86.2
11,서울특별시,075002, 71세,2017,67727,31339,36388,86.1,66887,30970,35917,86.2
11,서울특별시,075003, 72세,2017,64591,30064,34527,87.1,63994,29826,34168,87.3
11,서울특별시,075004, 73세,2017,63448,29213,34235,85.3,62904,29001,33903,85.5
11,서울특별시,075005, 74세,2017,63351,29388,33963,86.5,62856,29219,33637,86.9
11,서울특별시,080,75~79세,2017,268057,120169,147888,81.3,265755,119498,146257,81.7
11,서울특별시,080001, 75세,2017,71740,33348,38392,86.9,71243,33199,38044,87.3
11,서울특별시,080002, 76세,2017,56700,25929,30771,84.3,56226,25795,30431,84.8
11,서울특별시,080003, 77세,2017,50050,22181,27869,79.6,49585,22041,27544,80
11,서울특별시,080004, 78세,2017,47893,20972,26921,77.9,47430,20839,26591,78.4
11,서울특별시,080005, 79세,2017,41674,17739,23935,74.1,41271,17624,23647,74.5
11,서울특별시,085,80~84세,2017,145012,55768,89244,62.5,143708,55411,88297,62.8
11,서울특별시,085001, 80세,2017,37306,15309,21997,69.6,36954,15209,21745,69.9
11,서울특별시,085002, 81세,2017,32556,12944,19612,66,32253,12854,19399,66.3
11,서울특별시,085003, 82세,2017,30182,11487,18695,61.4,29929,11414,18515,61.6
11,서울특별시,085004, 83세,2017,24522,8912,15610,57.1,24327,8866,15461,57.3
11,서울특별시,085005, 84세,2017,20446,7116,13330,53.4,20245,7068,13177,53.6
11,서울특별시,090,85~89세,2017,64679,19627,45052,43.6,64162,19476,44686,43.6
11,서울특별시,090001, 85세,2017,17916,6006,11910,50.4,17777,5963,11814,50.5
11,서울특별시,090002, 86세,2017,13845,4302,9543,45.1,13725,4271,9454,45.2
11,서울특별시,090003, 87세,2017,12822,3675,9147,40.2,12700,3642,9058,40.2
11,서울특별시,090004, 88세,2017,11087,3262,7825,41.7,11012,3239,7773,41.7
11,서울특별시,090005, 89세,2017,9009,2382,6627,35.9,8948,2361,6587,35.8
11,서울특별시,095,90~94세,2017,21748,5267,16481,32,21586,5219,16367,31.9
11,서울특별시,095001, 90세,2017,7051,1747,5304,32.9,7001,1735,5266,32.9
11,서울특별시,095002, 91세,2017,4935,1141,3794,30.1,4898,1126,3772,29.9
11,서울특별시,095003, 92세,2017,3960,889,3071,28.9,3932,884,3048,29
11,서울특별시,095004, 93세,2017,2996,769,2227,34.5,2972,762,2210,34.5
11,서울특별시,095005, 94세,2017,2806,721,2085,34.6,2783,712,2071,34.4
11,서울특별시,100,95~99세,2017,4943,1142,3801,30,4900,1126,3774,29.8
11,서울특별시,100001, 95세,2017,1930,432,1498,28.8,1915,430,1485,29
11,서울특별시,100002, 96세,2017,1236,307,929,33,1228,303,925,32.8
11,서울특별시,100003, 97세,2017,883,214,669,32,878,213,665,32
11,서울특별시,100004, 98세,2017,550,126,424,29.7,542,122,420,29
11,서울특별시,100005, 99세,2017,344,63,281,22.4,337,58,279,20.8
11,서울특별시,101,100세이상,2017,665,122,543,22.5,643,115,528,21.8
11,서울특별시,102,15세미만,2017,1089367,559449,529918,105.6,1074524,551831,522693,105.6
11,서울특별시,103,15~64세,2017,7342439,3618903,3723536,97.2,7032987,3469596,3563391,97.4
11,서울특별시,104,65세이상,2017,1310065,579290,730775,79.3,1290433,570966,719467,79.4
11,서울특별시,086,85세이상,2017,92035,26158,65877,39.7,91291,25936,65355,39.7
11,서울특별시,126,평균연령,2017,41.5,40.6,42.2,,41.5,40.6,42.3,
11,서울특별시,127,중위연령,2017,41.6,40.7,42.5,,41.7,40.7,42.6,
11010, 종로구,000,합계,2017,157277,76670,80607,95.1,146298,71757,74541,96.3
11010, 종로구,005,0~4세,2017,4137,2099,2038,103,4011,2039,1972,103.4
11010, 종로구,005001, 0세,2017,694,336,358,93.9,675,327,348,94
11010, 종로구,005002, 1세,2017,836,429,407,105.4,805,412,393,104.8
11010, 종로구,005003, 2세,2017,878,459,419,109.5,850,447,403,110.9
11010, 종로구,005004, 3세,2017,879,435,444,98,856,424,432,98.1
11010, 종로구,005005, 4세,2017,850,440,410,107.3,825,429,396,108.3
11010, 종로구,010,5~9세,2017,4594,2365,2229,106.1,4511,2319,2192,105.8
11010, 종로구,010001, 5세,2017,982,513,469,109.4,961,499,462,108
11010, 종로구,010002, 6세,2017,890,457,433,105.5,872,448,424,105.7
11010, 종로구,010003, 7세,2017,888,437,451,96.9,877,432,445,97.1
11010, 종로구,010004, 8세,2017,890,454,436,104.1,879,450,429,104.9
11010, 종로구,010005, 9세,2017,944,504,440,114.5,922,490,432,113.4
11010, 종로구,015,10~14세,2017,5002,2567,2435,105.4,4935,2532,2403,105.4
11010, 종로구,015001, 10세,2017,985,507,478,106.1,975,501,474,105.7
11010, 종로구,015002, 11세,2017,943,499,444,112.4,931,492,439,112.1
11010, 종로구,015003, 12세,2017,934,484,450,107.6,918,473,445,106.3
11010, 종로구,015004, 13세,2017,1023,510,513,99.4,1010,505,505,100
11010, 종로구,015005, 14세,2017,1117,567,550,103.1,1101,561,540,103.9
11010, 종로구,020,15~19세,2017,10198,5267,4931,106.8,9358,4960,4398,112.8
11010, 종로구,020001, 15세,2017,1208,622,586,106.1,1196,614,582,105.5
11010, 종로구,020002, 16세,2017,1708,1020,688,148.3,1691,1010,681,148.3
11010, 종로구,020003, 17세,2017,2303,1379,924,149.2,2265,1360,905,150.3
11010, 종로구,020004, 18세,2017,2084,990,1094,90.5,1859,917,942,97.3
11010, 종로구,020005, 19세,2017,2895,1256,1639,76.6,2347,1059,1288,82.2
11010, 종로구,025,20~24세,2017,15098,6848,8250,83,12341,5908,6433,91.8
11010, 종로구,025001, 20세,2017,2969,1258,1711,73.5,2309,1047,1262,83
11010, 종로구,025002, 21세,2017,2942,1288,1654,77.9,2328,1084,1244,87.1
11010, 종로구,025003, 22세,2017,3029,1403,1626,86.3,2445,1195,1250,95.6
11010, 종로구,025004, 23세,2017,3020,1383,1637,84.5,2545,1218,1327,91.8
11010, 종로구,025005, 24세,2017,3138,1516,1622,93.5,2714,1364,1350,101
11010, 종로구,030,25~29세,2017,13584,7156,6428,111.3,12180,6519,5661,115.2
11010, 종로구,030001, 25세,2017,3016,1611,1405,114.7,2656,1465,1191,123
11010, 종로구,030002, 26세,2017,2952,1565,1387,112.8,2685,1442,1243,116
11010, 종로구,030003, 27세,2017,2728,1405,1323,106.2,2440,1282,1158,110.7
11010, 종로구,030004, 28세,2017,2447,1278,1169,109.3,2219,1165,1054,110.5
11010, 종로구,030005, 29세,2017,2441,1297,1144,113.4,2180,1165,1015,114.8
11010, 종로구,035,30~34세,2017,11100,5615,5485,102.4,10004,5054,4950,102.1
11010, 종로구,035001, 30세,2017,2371,1159,1212,95.6,2117,1038,1079,96.2
11010, 종로구,035002, 31세,2017,2219,1141,1078,105.8,1976,1012,964,105
11010, 종로구,035003, 32세,2017,2180,1117,1063,105.1,1986,1026,960,106.9
11010, 종로구,035004, 33세,2017,2145,1093,1052,103.9,1929,975,954,102.2
11010, 종로구,035005, 34세,2017,2185,1105,1080,102.3,1996,1003,993,101
11010, 종로구,040,35~39세,2017,10661,5347,5314,100.6,9855,4884,4971,98.2
11010, 종로구,040001, 35세,2017,2200,1111,1089,102,2018,1010,1008,100.2
11010, 종로구,040002, 36세,2017,2288,1155,1133,101.9,2129,1058,1071,98.8
11010, 종로구,040003, 37세,2017,2199,1086,1113,97.6,2034,999,1035,96.5
11010, 종로구,040004, 38세,2017,2069,1034,1035,99.9,1926,948,978,96.9
11010, 종로구,040005, 39세,2017,1905,961,944,101.8,1748,869,879,98.9
11010, 종로구,045,40~44세,2017,10810,5251,5559,94.5,10138,4866,5272,92.3
11010, 종로구,045001, 40세,2017,1967,923,1044,88.4,1836,851,985,86.4
11010, 종로구,045002, 41세,2017,2020,1018,1002,101.6,1879,929,950,97.8
11010, 종로구,045003, 42세,2017,2072,1023,1049,97.5,1946,953,993,96
11010, 종로구,045004, 43세,2017,2335,1134,1201,94.4,2205,1060,1145,92.6
11010, 종로구,045005, 44세,2017,2416,1153,1263,91.3,2272,1073,1199,89.5
11010, 종로구,050,45~49세,2017,13404,6598,6806,96.9,12604,6176,6428,96.1
11010, 종로구,050001, 45세,2017,2625,1345,1280,105.1,2451,1247,1204,103.6
11010, 종로구,050002, 46세,2017,2808,1428,1380,103.5,2643,1338,1305,102.5
11010, 종로구,050003, 47세,2017,2703,1315,1388,94.7,2534,1226,1308,93.7
11010, 종로구,050004, 48세,2017,2651,1266,1385,91.4,2506,1188,1318,90.1
11010, 종로구,050005, 49세,2017,2617,1244,1373,90.6,2470,1177,1293,91
11010, 종로구,055,50~54세,2017,12413,6134,6279,97.7,11645,5768,5877,98.1
11010, 종로구,055001, 50세,2017,2446,1182,1264,93.5,2312,1113,1199,92.8
11010, 종로구,055002, 51세,2017,2408,1160,1248,92.9,2255,1085,1170,92.7
11010, 종로구,055003, 52세,2017,2494,1222,1272,96.1,2332,1154,1178,98
11010, 종로구,055004, 53세,2017,2514,1267,1247,101.6,2361,1193,1168,102.1
11010, 종로구,055005, 54세,2017,2551,1303,1248,104.4,2385,1223,1162,105.2
11010, 종로구,060,55~59세,2017,12560,6237,6323,98.6,11922,5948,5974,99.6
11010, 종로구,060001, 55세,2017,2533,1314,1219,107.8,2370,1236,1134,109
11010, 종로구,060002, 56세,2017,2634,1281,1353,94.7,2557,1241,1316,94.3
11010, 종로구,060003, 57세,2017,2626,1221,1405,86.9,2495,1167,1328,87.9
11010, 종로구,060004, 58세,2017,2434,1251,1183,105.7,2302,1197,1105,108.3
11010, 종로구,060005, 59세,2017,2333,1170,1163,100.6,2198,1107,1091,101.5
11010, 종로구,065,60~64세,2017,10042,4918,5124,96,9530,4693,4837,97
11010, 종로구,065001, 60세,2017,2246,1099,1147,95.8,2106,1034,1072,96.5
11010, 종로구,065002, 61세,2017,2127,1056,1071,98.6,2029,1011,1018,99.3
11010, 종로구,065003, 62세,2017,2131,1027,1104,93,2042,986,1056,93.4
11010, 종로구,065004, 63세,2017,1903,957,946,101.2,1797,914,883,103.5
11010, 종로구,065005, 64세,2017,1635,779,856,91,1556,748,808,92.6
11010, 종로구,070,65~69세,2017,7154,3331,3823,87.1,6928,3228,3700,87.2
11010, 종로구,070001, 65세,2017,1710,842,868,97,1652,812,840,96.7
11010, 종로구,070002, 66세,2017,1215,551,664,83,1154,527,627,84.1
11010, 종로구,070003, 67세,2017,1406,645,761,84.8,1353,624,729,85.6
11010, 종로구,070004, 68세,2017,1393,643,750,85.7,1363,625,738,84.7
11010, 종로구,070005, 69세,2017,1430,650,780,83.3,1406,640,766,83.6
11010, 종로구,075,70~74세,2017,6076,2665,3411,78.1,5995,2635,3360,78.4
11010, 종로구,075001, 70세,2017,1451,650,801,81.1,1423,637,786,81
11010, 종로구,075002, 71세,2017,1134,496,638,77.7,1122,494,628,78.7
11010, 종로구,075003, 72세,2017,1132,492,640,76.9,1114,486,628,77.4
11010, 종로구,075004, 73세,2017,1146,467,679,68.8,1133,462,671,68.9
11010, 종로구,075005, 74세,2017,1213,560,653,85.8,1203,556,647,85.9
11010, 종로구,080,75~79세,2017,5380,2371,3009,78.8,5326,2351,2975,79
11010, 종로구,080001, 75세,2017,1383,621,762,81.5,1369,616,753,81.8
11010, 종로구,080002, 76세,2017,1152,520,632,82.3,1141,514,627,82
11010, 종로구,080003, 77세,2017,1011,455,556,81.8,1002,453,549,82.5
11010, 종로구,080004, 78세,2017,996,429,567,75.7,988,426,562,75.8
11010, 종로구,080005, 79세,2017,838,346,492,70.3,826,342,484,70.7
11010, 종로구,085,80~84세,2017,3025,1223,1802,67.9,2998,1211,1787,67.8
11010, 종로구,085001, 80세,2017,751,324,427,75.9,744,321,423,75.9
11010, 종로구,085002, 81세,2017,682,286,396,72.2,678,286,392,73
11010, 종로구,085003, 82세,2017,631,255,376,67.8,623,249,374,66.6
11010, 종로구,085004, 83세,2017,534,205,329,62.3,532,204,328,62.2
11010, 종로구,085005, 84세,2017,427,153,274,55.8,421,151,270,55.9
11010, 종로구,090,85~89세,2017,1412,488,924,52.8,1396,481,915,52.6
11010, 종로구,090001, 85세,2017,374,139,235,59.1,370,137,233,58.8
11010, 종로구,090002, 86세,2017,336,113,223,50.7,332,112,220,50.9
11010, 종로구,090003, 87세,2017,281,92,189,48.7,278,90,188,47.9
11010, 종로구,090004, 88세,2017,230,89,141,63.1,228,87,141,61.7
11010, 종로구,090005, 89세,2017,191,55,136,40.4,188,55,133,41.4
11010, 종로구,095,90~94세,2017,476,152,324,46.9,472,149,323,46.1
11010, 종로구,095001, 90세,2017,152,51,101,50.5,150,50,100,50
11010, 종로구,095002, 91세,2017,114,34,80,42.5,113,33,80,41.3
11010, 종로구,095003, 92세,2017,91,29,62,46.8,91,29,62,46.8
11010, 종로구,095004, 93세,2017,60,17,43,39.5,60,17,43,39.5
11010, 종로구,095005, 94세,2017,59,21,38,55.3,58,20,38,52.6
11010, 종로구,100,95~99세,2017,127,32,95,33.7,126,31,95,32.6
11010, 종로구,100001, 95세,2017,53,17,36,47.2,53,17,36,47.2
11010, 종로구,100002, 96세,2017,29,6,23,26.1,28,5,23,21.7
11010, 종로구,100003, 97세,2017,24,X,20,20,24,X,20,20
11010, 종로구,100004, 98세,2017,10,X,6,66.7,10,X,6,66.7
11010, 종로구,100005, 99세,2017,11,X,10,10,11,X,10,10
11010, 종로구,101,100세이상,2017,24,6,18,33.3,23,5,18,27.8
11010, 종로구,102,15세미만,2017,13733,7031,6702,104.9,13457,6890,6567,104.9
11010, 종로구,103,15~64세,2017,119870,59371,60499,98.1,109577,54776,54801,100
11010, 종로구,104,65세이상,2017,23674,10268,13406,76.6,23264,10091,13173,76.6
11010, 종로구,086,85세이상,2017,2039,678,1361,49.8,2017,666,1351,49.3
11010, 종로구,126,평균연령,2017,42.1,41.3,42.9,,42.6,41.6,43.6,
11010, 종로구,127,중위연령,2017,42.1,41.1,43.1,,43.1,41.9,44.2,
11020, 중구,000,합계,2017,127896,62195,65701,94.7,117631,57391,60240,95.3
11020, 중구,005,0~4세,2017,4206,2145,2061,104.1,4001,2024,1977,102.4
11020, 중구,005001, 0세,2017,807,400,407,98.3,763,376,387,97.2
11020, 중구,005002, 1세,2017,883,472,411,114.8,830,441,389,113.4
11020, 중구,005003, 2세,2017,874,444,430,103.3,830,421,409,102.9
11020, 중구,005004, 3세,2017,844,421,423,99.5,821,405,416,97.4
11020, 중구,005005, 4세,2017,798,408,390,104.6,757,381,376,101.3
11020, 중구,010,5~9세,2017,3682,1864,1818,102.5,3536,1787,1749,102.2
11020, 중구,010001, 5세,2017,826,437,389,112.3,795,420,375,112
11020, 중구,010002, 6세,2017,798,387,411,94.2,761,369,392,94.1
11020, 중구,010003, 7세,2017,712,372,340,109.4,688,359,329,109.1
11020, 중구,010004, 8세,2017,640,326,314,103.8,613,309,304,101.6
11020, 중구,010005, 9세,2017,706,342,364,94,679,330,349,94.6
11020, 중구,015,10~14세,2017,3147,1595,1552,102.8,3028,1523,1505,101.2
11020, 중구,015001, 10세,2017,724,371,353,105.1,693,349,344,101.5
11020, 중구,015002, 11세,2017,578,301,277,108.7,556,288,268,107.5
11020, 중구,015003, 12세,2017,579,291,288,101,555,280,275,101.8
11020, 중구,015004, 13세,2017,645,318,327,97.2,615,299,316,94.6
11020, 중구,015005, 14세,2017,621,314,307,102.3,609,307,302,101.7
11020, 중구,020,15~19세,2017,5739,2574,3165,81.3,5316,2415,2901,83.2
11020, 중구,020001, 15세,2017,711,359,352,102,694,347,347,100
11020, 중구,020002, 16세,2017,1065,422,643,65.6,1047,418,629,66.5
11020, 중구,020003, 17세,2017,1045,491,554,88.6,1011,474,537,88.3
11020, 중구,020004, 18세,2017,1132,547,585,93.5,1037,513,524,97.9
11020, 중구,020005, 19세,2017,1786,755,1031,73.2,1527,663,864,76.7
11020, 중구,025,20~24세,2017,10343,4813,5530,87,8861,4269,4592,93
11020, 중구,025001, 20세,2017,1987,814,1173,69.4,1698,718,980,73.3
11020, 중구,025002, 21세,2017,1914,819,1095,74.8,1626,721,905,79.7
11020, 중구,025003, 22세,2017,1928,929,999,93,1622,801,821,97.6
11020, 중구,025004, 23세,2017,2235,1111,1124,98.8,1934,1002,932,107.5
11020, 중구,025005, 24세,2017,2279,1140,1139,100.1,1981,1027,954,107.7
11020, 중구,030,25~29세,2017,11113,5609,5504,101.9,9743,4956,4787,103.5
11020, 중구,030001, 25세,2017,2418,1233,1185,104.1,2117,1105,1012,109.2
11020, 중구,030002, 26세,2017,2297,1161,1136,102.2,2043,1036,1007,102.9
11020, 중구,030003, 27세,2017,2165,1091,1074,101.6,1883,959,924,103.8
11020, 중구,030004, 28세,2017,2131,1102,1029,107.1,1867,964,903,106.8
11020, 중구,030005, 29세,2017,2102,1022,1080,94.6,1833,892,941,94.8
11020, 중구,035,30~34세,2017,10666,5373,5293,101.5,9548,4779,4769,100.2
11020, 중구,035001, 30세,2017,2127,1102,1025,107.5,1863,971,892,108.9
11020, 중구,035002, 31세,2017,2068,1025,1043,98.3,1834,898,936,95.9
11020, 중구,035003, 32세,2017,2038,1009,1029,98.1,1825,899,926,97.1
11020, 중구,035004, 33세,2017,2169,1072,1097,97.7,1952,952,1000,95.2
11020, 중구,035005, 34세,2017,2264,1165,1099,106,2074,1059,1015,104.3
11020, 중구,040,35~39세,2017,10498,5424,5074,106.9,9596,4911,4685,104.8
11020, 중구,040001, 35세,2017,2254,1129,1125,100.4,2061,1025,1036,98.9
11020, 중구,040002, 36세,2017,2231,1148,1083,106,2045,1045,1000,104.5
11020, 중구,040003, 37세,2017,2254,1184,1070,110.7,2068,1074,994,108
11020, 중구,040004, 38세,2017,2014,1044,970,107.6,1856,952,904,105.3
11020, 중구,040005, 39세,2017,1745,919,826,111.3,1566,815,751,108.5
11020, 중구,045,40~44세,2017,9144,4713,4431,106.4,8398,4310,4088,105.4
11020, 중구,045001, 40세,2017,1775,925,850,108.8,1639,853,786,108.5
11020, 중구,045002, 41세,2017,1744,899,845,106.4,1585,799,786,101.7
11020, 중구,045003, 42세,2017,1822,932,890,104.7,1686,860,826,104.1
11020, 중구,045004, 43세,2017,1892,988,904,109.3,1728,906,822,110.2
11020, 중구,045005, 44세,2017,1911,969,942,102.9,1760,892,868,102.8
11020, 중구,050,45~49세,2017,10406,5285,5121,103.2,9531,4850,4681,103.6
11020, 중구,050001, 45세,2017,1982,1025,957,107.1,1832,940,892,105.4
11020, 중구,050002, 46세,2017,2141,1103,1038,106.3,1976,1019,957,106.5
11020, 중구,050003, 47세,2017,2039,1006,1033,97.4,1858,919,939,97.9
11020, 중구,050004, 48세,2017,2095,1111,984,112.9,1908,1024,884,115.8
11020, 중구,050005, 49세,2017,2149,1040,1109,93.8,1957,948,1009,94
11020, 중구,055,50~54세,2017,9926,4863,5063,96,9026,4468,4558,98
11020, 중구,055001, 50세,2017,1926,950,976,97.3,1773,893,880,101.5
11020, 중구,055002, 51세,2017,1827,920,907,101.4,1665,847,818,103.5
11020, 중구,055003, 52세,2017,1999,935,1064,87.9,1829,856,973,88
11020, 중구,055004, 53세,2017,2036,992,1044,95,1837,897,940,95.4
11020, 중구,055005, 54세,2017,2138,1066,1072,99.4,1922,975,947,103
11020, 중구,060,55~59세,2017,10810,5264,5546,94.9,10029,4945,5084,97.3
11020, 중구,060001, 55세,2017,2137,1058,1079,98.1,1969,983,986,99.7
11020, 중구,060002, 56세,2017,2216,1080,1136,95.1,2111,1035,1076,96.2
11020, 중구,060003, 57세,2017,2320,1111,1209,91.9,2148,1039,1109,93.7
11020, 중구,060004, 58세,2017,2062,1014,1048,96.8,1904,957,947,101.1
11020, 중구,060005, 59세,2017,2075,1001,1074,93.2,1897,931,966,96.4
11020, 중구,065,60~64세,2017,9004,4414,4590,96.2,8326,4122,4204,98
11020, 중구,065001, 60세,2017,2066,1038,1028,101,1893,965,928,104
11020, 중구,065002, 61세,2017,1973,966,1007,95.9,1850,920,930,98.9
11020, 중구,065003, 62세,2017,1928,927,1001,92.6,1785,862,923,93.4
11020, 중구,065004, 63세,2017,1627,803,824,97.5,1490,741,749,98.9
11020, 중구,065005, 64세,2017,1410,680,730,93.2,1308,634,674,94.1
11020, 중구,070,65~69세,2017,6287,3000,3287,91.3,5979,2862,3117,91.8
11020, 중구,070001, 65세,2017,1494,699,795,87.9,1396,657,739,88.9
11020, 중구,070002, 66세,2017,1098,529,569,93,1026,495,531,93.2
11020, 중구,070003, 67세,2017,1264,620,644,96.3,1202,592,610,97
11020, 중구,070004, 68세,2017,1220,579,641,90.3,1165,551,614,89.7
11020, 중구,070005, 69세,2017,1211,573,638,89.8,1190,567,623,91
11020, 중구,075,70~74세,2017,4900,2204,2696,81.8,4802,2154,2648,81.3
11020, 중구,075001, 70세,2017,1213,547,666,82.1,1177,530,647,81.9
11020, 중구,075002, 71세,2017,889,378,511,74,870,368,502,73.3
11020, 중구,075003, 72세,2017,946,446,500,89.2,936,441,495,89.1
11020, 중구,075004, 73세,2017,927,422,505,83.6,905,408,497,82.1
11020, 중구,075005, 74세,2017,925,411,514,80,914,407,507,80.3
11020, 중구,080,75~79세,2017,4139,1732,2407,72,4078,1707,2371,72
11020, 중구,080001, 75세,2017,1110,478,632,75.6,1098,474,624,76
11020, 중구,080002, 76세,2017,888,366,522,70.1,874,362,512,70.7
11020, 중구,080003, 77세,2017,748,310,438,70.8,739,304,435,69.9
11020, 중구,080004, 78세,2017,758,331,427,77.5,743,326,417,78.2
11020, 중구,080005, 79세,2017,635,247,388,63.7,624,241,383,62.9
11020, 중구,085,80~84세,2017,2338,846,1492,56.7,2305,837,1468,57
11020, 중구,085001, 80세,2017,570,212,358,59.2,558,208,350,59.4
11020, 중구,085002, 81세,2017,546,212,334,63.5,541,212,329,64.4
11020, 중구,085003, 82세,2017,468,175,293,59.7,462,173,289,59.9
11020, 중구,085004, 83세,2017,391,131,260,50.4,384,129,255,50.6
11020, 중구,085005, 84세,2017,363,116,247,47,360,115,245,46.9
11020, 중구,090,85~89세,2017,1098,346,752,46,1087,343,744,46.1
11020, 중구,090001, 85세,2017,282,81,201,40.3,280,81,199,40.7
11020, 중구,090002, 86세,2017,227,74,153,48.4,227,74,153,48.4
11020, 중구,090003, 87세,2017,225,78,147,53.1,219,76,143,53.1
11020, 중구,090004, 88세,2017,190,66,124,53.2,188,65,123,52.8
11020, 중구,090005, 89세,2017,174,47,127,37,173,47,126,37.3
11020, 중구,095,90~94세,2017,357,103,254,40.6,351,101,250,40.4
11020, 중구,095001, 90세,2017,129,38,91,41.8,126,37,89,41.6
11020, 중구,095002, 91세,2017,84,22,62,35.5,84,22,62,35.5
11020, 중구,095003, 92세,2017,53,12,41,29.3,53,12,41,29.3
11020, 중구,095004, 93세,2017,53,21,32,65.6,52,21,31,67.7
11020, 중구,095005, 94세,2017,38,10,28,35.7,36,9,27,33.3
11020, 중구,100,95~99세,2017,77,25,52,48.1,75,25,50,50
11020, 중구,100001, 95세,2017,38,13,25,52,37,13,24,54.2
11020, 중구,100002, 96세,2017,17,X,13,30.8,17,X,13,30.8
11020, 중구,100003, 97세,2017,8,X,6,33.3,8,X,6,33.3
11020, 중구,100004, 98세,2017,X,X,X,33.3,X,X,X,33.3
11020, 중구,100005, 99세,2017,10,5,5,100,9,5,X,125
11020, 중구,101,100세이상,2017,16,X,13,23.1,15,X,12,25
11020, 중구,102,15세미만,2017,11035,5604,5431,103.2,10565,5334,5231,102
11020, 중구,103,15~64세,2017,97649,48332,49317,98,88374,44025,44349,99.3
11020, 중구,104,65세이상,2017,19212,8259,10953,75.4,18692,8032,10660,75.3
11020, 중구,086,85세이상,2017,1548,477,1071,44.5,1528,472,1056,44.7
11020, 중구,126,평균연령,2017,42.8,42.1,43.5,,43.2,42.4,43.9,
11020, 중구,127,중위연령,2017,42.6,41.9,43.3,,43.2,42.4,43.9,
11030, 용산구,000,합계,2017,223898,108471,115427,94,207893,99759,108134,92.3
11030, 용산구,005,0~4세,2017,7975,4101,3874,105.9,7304,3763,3541,106.3
11030, 용산구,005001, 0세,2017,1496,738,758,97.4,1368,682,686,99.4
11030, 용산구,005002, 1세,2017,1654,864,790,109.4,1520,792,728,108.8
11030, 용산구,005003, 2세,2017,1644,867,777,111.6,1508,801,707,113.3
11030, 용산구,005004, 3세,2017,1602,823,779,105.6,1453,746,707,105.5
11030, 용산구,005005, 4세,2017,1579,809,770,105.1,1455,742,713,104.1
11030, 용산구,010,5~9세,2017,7791,3929,3862,101.7,7145,3605,3540,101.8
11030, 용산구,010001, 5세,2017,1699,846,853,99.2,1560,783,777,100.8
11030, 용산구,010002, 6세,2017,1591,842,749,112.4,1449,765,684,111.8
11030, 용산구,010003, 7세,2017,1493,762,731,104.2,1367,699,668,104.6
11030, 용산구,010004, 8세,2017,1484,725,759,95.5,1358,655,703,93.2
11030, 용산구,010005, 9세,2017,1524,754,770,97.9,1411,703,708,99.3
11030, 용산구,015,10~14세,2017,7448,3829,3619,105.8,6970,3570,3400,105
11030, 용산구,015001, 10세,2017,1609,818,791,103.4,1497,760,737,103.1
11030, 용산구,015002, 11세,2017,1421,724,697,103.9,1321,668,653,102.3
11030, 용산구,015003, 12세,2017,1407,746,661,112.9,1314,689,625,110.2
11030, 용산구,015004, 13세,2017,1512,796,716,111.2,1420,747,673,111
11030, 용산구,015005, 14세,2017,1499,745,754,98.8,1418,706,712,99.2
11030, 용산구,020,15~19세,2017,9587,4771,4816,99.1,9174,4559,4615,98.8
11030, 용산구,020001, 15세,2017,1597,836,761,109.9,1534,808,726,111.3
11030, 용산구,020002, 16세,2017,1750,916,834,109.8,1697,892,805,110.8
11030, 용산구,020003, 17세,2017,1932,1000,932,107.3,1851,955,896,106.6
11030, 용산구,020004, 18세,2017,1978,990,988,100.2,1891,938,953,98.4
11030, 용산구,020005, 19세,2017,2330,1029,1301,79.1,2201,966,1235,78.2
11030, 용산구,025,20~24세,2017,14643,6465,8178,79.1,13441,5872,7569,77.6
11030, 용산구,025001, 20세,2017,2516,1110,1406,78.9,2307,1035,1272,81.4
11030, 용산구,025002, 21세,2017,2604,1181,1423,83,2423,1091,1332,81.9
11030, 용산구,025003, 22세,2017,3014,1291,1723,74.9,2768,1174,1594,73.7
11030, 용산구,025004, 23세,2017,3194,1414,1780,79.4,2930,1264,1666,75.9
11030, 용산구,025005, 24세,2017,3315,1469,1846,79.6,3013,1308,1705,76.7
11030, 용산구,030,25~29세,2017,18471,9078,9393,96.6,16515,7990,8525,93.7
11030, 용산구,030001, 25세,2017,3654,1681,1973,85.2,3274,1490,1784,83.5
11030, 용산구,030002, 26세,2017,3708,1791,1917,93.4,3368,1603,1765,90.8
11030, 용산구,030003, 27세,2017,3621,1813,1808,100.3,3255,1606,1649,97.4
11030, 용산구,030004, 28세,2017,3698,1881,1817,103.5,3284,1642,1642,100
11030, 용산구,030005, 29세,2017,3790,1912,1878,101.8,3334,1649,1685,97.9
11030, 용산구,035,30~34세,2017,19518,10032,9486,105.8,17308,8694,8614,100.9
11030, 용산구,035001, 30세,2017,3745,1868,1877,99.5,3328,1626,1702,95.5
11030, 용산구,035002, 31세,2017,3921,2039,1882,108.3,3460,1753,1707,102.7
11030, 용산구,035003, 32세,2017,3748,1937,1811,107,3307,1662,1645,101
11030, 용산구,035004, 33세,2017,3982,2076,1906,108.9,3510,1792,1718,104.3
11030, 용산구,035005, 34세,2017,4122,2112,2010,105.1,3703,1861,1842,101
11030, 용산구,040,35~39세,2017,19833,10020,9813,102.1,17798,8836,8962,98.6
11030, 용산구,040001, 35세,2017,4188,2096,2092,100.2,3776,1850,1926,96.1
11030, 용산구,040002, 36세,2017,4212,2150,2062,104.3,3821,1938,1883,102.9
11030, 용산구,040003, 37세,2017,4197,2109,2088,101,3738,1839,1899,96.8
11030, 용산구,040004, 38세,2017,3796,1914,1882,101.7,3388,1677,1711,98
11030, 용산구,040005, 39세,2017,3440,1751,1689,103.7,3075,1532,1543,99.3
11030, 용산구,045,40~44세,2017,17767,8904,8863,100.5,16118,7943,8175,97.2
11030, 용산구,045001, 40세,2017,3417,1667,1750,95.3,3058,1462,1596,91.6
11030, 용산구,045002, 41세,2017,3344,1690,1654,102.2,2988,1486,1502,98.9
11030, 용산구,045003, 42세,2017,3470,1743,1727,100.9,3148,1558,1590,98
11030, 용산구,045004, 43세,2017,3763,1893,1870,101.2,3456,1708,1748,97.7
11030, 용산구,045005, 44세,2017,3773,1911,1862,102.6,3468,1729,1739,99.4
11030, 용산구,050,45~49세,2017,19810,9994,9816,101.8,18347,9152,9195,99.5
11030, 용산구,050001, 45세,2017,4039,2066,1973,104.7,3733,1902,1831,103.9
11030, 용산구,050002, 46세,2017,4090,2084,2006,103.9,3804,1924,1880,102.3
11030, 용산구,050003, 47세,2017,3923,1961,1962,99.9,3626,1788,1838,97.3
11030, 용산구,050004, 48세,2017,3957,1982,1975,100.4,3673,1807,1866,96.8
11030, 용산구,050005, 49세,2017,3801,1901,1900,100.1,3511,1731,1780,97.2
11030, 용산구,055,50~54세,2017,16923,8306,8617,96.4,15758,7735,8023,96.4
11030, 용산구,055001, 50세,2017,3361,1626,1735,93.7,3128,1500,1628,92.1
11030, 용산구,055002, 51세,2017,3222,1623,1599,101.5,3017,1521,1496,101.7
11030, 용산구,055003, 52세,2017,3457,1690,1767,95.6,3218,1580,1638,96.5
11030, 용산구,055004, 53세,2017,3354,1650,1704,96.8,3126,1547,1579,98
11030, 용산구,055005, 54세,2017,3529,1717,1812,94.8,3269,1587,1682,94.4
11030, 용산구,060,55~59세,2017,17326,8411,8915,94.3,16535,8022,8513,94.2
11030, 용산구,060001, 55세,2017,3548,1785,1763,101.2,3373,1692,1681,100.7
11030, 용산구,060002, 56세,2017,3553,1701,1852,91.8,3408,1629,1779,91.6
11030, 용산구,060003, 57세,2017,3623,1691,1932,87.5,3458,1618,1840,87.9
11030, 용산구,060004, 58세,2017,3376,1603,1773,90.4,3223,1533,1690,90.7
11030, 용산구,060005, 59세,2017,3226,1631,1595,102.3,3073,1550,1523,101.8
11030, 용산구,065,60~64세,2017,14249,6838,7411,92.3,13555,6527,7028,92.9
11030, 용산구,065001, 60세,2017,3216,1534,1682,91.2,3045,1466,1579,92.8
11030, 용산구,065002, 61세,2017,3107,1537,1570,97.9,2954,1473,1481,99.5
11030, 용산구,065003, 62세,2017,3060,1415,1645,86,2924,1353,1571,86.1
11030, 용산구,065004, 63세,2017,2588,1265,1323,95.6,2468,1201,1267,94.8
11030, 용산구,065005, 64세,2017,2278,1087,1191,91.3,2164,1034,1130,91.5
11030, 용산구,070,65~69세,2017,10103,4667,5436,85.9,9774,4508,5266,85.6
11030, 용산구,070001, 65세,2017,2348,1042,1306,79.8,2252,1004,1248,80.4
11030, 용산구,070002, 66세,2017,1708,800,908,88.1,1641,769,872,88.2
11030, 용산구,070003, 67세,2017,2028,953,1075,88.7,1965,918,1047,87.7
11030, 용산구,070004, 68세,2017,2001,940,1061,88.6,1943,906,1037,87.4
11030, 용산구,070005, 69세,2017,2018,932,1086,85.8,1973,911,1062,85.8
11030, 용산구,075,70~74세,2017,8127,3552,4575,77.6,8003,3489,4514,77.3
11030, 용산구,075001, 70세,2017,1930,813,1117,72.8,1893,801,1092,73.4
11030, 용산구,075002, 71세,2017,1547,661,886,74.6,1517,644,873,73.8
11030, 용산구,075003, 72세,2017,1519,700,819,85.5,1503,687,816,84.2
11030, 용산구,075004, 73세,2017,1545,656,889,73.8,1526,645,881,73.2
11030, 용산구,075005, 74세,2017,1586,722,864,83.6,1564,712,852,83.6
11030, 용산구,080,75~79세,2017,7311,3086,4225,73,7226,3047,4179,72.9
11030, 용산구,080001, 75세,2017,1881,840,1041,80.7,1865,832,1033,80.5
11030, 용산구,080002, 76세,2017,1519,654,865,75.6,1498,647,851,76
11030, 용산구,080003, 77세,2017,1334,559,775,72.1,1314,548,766,71.5
11030, 용산구,080004, 78세,2017,1332,557,775,71.9,1313,547,766,71.4
11030, 용산구,080005, 79세,2017,1245,476,769,61.9,1236,473,763,62
11030, 용산구,085,80~84세,2017,4268,1609,2659,60.5,4212,1582,2630,60.2
11030, 용산구,085001, 80세,2017,1092,430,662,65,1079,427,652,65.5
11030, 용산구,085002, 81세,2017,995,362,633,57.2,982,354,628,56.4
11030, 용산구,085003, 82세,2017,863,340,523,65,851,333,518,64.3
11030, 용산구,085004, 83세,2017,720,255,465,54.8,712,252,460,54.8
11030, 용산구,085005, 84세,2017,598,222,376,59,588,216,372,58.1
11030, 용산구,090,85~89세,2017,1949,654,1295,50.5,1921,644,1277,50.4
11030, 용산구,090001, 85세,2017,532,197,335,58.8,527,197,330,59.7
11030, 용산구,090002, 86세,2017,412,152,260,58.5,408,151,257,58.8
11030, 용산구,090003, 87세,2017,399,142,257,55.3,390,138,252,54.8
11030, 용산구,090004, 88세,2017,342,94,248,37.9,338,94,244,38.5
11030, 용산구,090005, 89세,2017,264,69,195,35.4,258,64,194,33
11030, 용산구,095,90~94세,2017,633,178,455,39.1,625,174,451,38.6
11030, 용산구,095001, 90세,2017,192,44,148,29.7,191,43,148,29.1
11030, 용산구,095002, 91세,2017,143,38,105,36.2,141,36,105,34.3
11030, 용산구,095003, 92세,2017,114,36,78,46.2,112,35,77,45.5
11030, 용산구,095004, 93세,2017,104,33,71,46.5,103,33,70,47.1
11030, 용산구,095005, 94세,2017,80,27,53,50.9,78,27,51,52.9
11030, 용산구,100,95~99세,2017,148,41,107,38.3,147,41,106,38.7
11030, 용산구,100001, 95세,2017,67,15,52,28.8,67,15,52,28.8
11030, 용산구,100002, 96세,2017,32,11,21,52.4,32,11,21,52.4
11030, 용산구,100003, 97세,2017,24,8,16,50,24,8,16,50
11030, 용산구,100004, 98세,2017,16,6,10,60,15,6,9,66.7
11030, 용산구,100005, 99세,2017,9,X,8,12.5,9,X,8,12.5
11030, 용산구,101,100세이상,2017,18,6,12,50,17,6,11,54.5
11030, 용산구,102,15세미만,2017,23214,11859,11355,104.4,21419,10938,10481,104.4
11030, 용산구,103,15~64세,2017,168127,82819,85308,97.1,154549,75330,79219,95.1
11030, 용산구,104,65세이상,2017,32557,13793,18764,73.5,31925,13491,18434,73.2
11030, 용산구,086,85세이상,2017,2748,879,1869,47,2710,865,1845,46.9
11030, 용산구,126,평균연령,2017,42.2,41.4,43,,42.7,41.8,43.5,
11030, 용산구,127,중위연령,2017,42,41.2,42.7,,42.7,42,43.4,
11040, 성동구,000,합계,2017,302367,149060,153307,97.2,291931,144018,147913,97.4
11040, 성동구,005,0~4세,2017,12554,6330,6224,101.7,12359,6236,6123,101.8
11040, 성동구,005001, 0세,2017,2490,1275,1215,104.9,2455,1257,1198,104.9
11040, 성동구,005002, 1세,2017,2557,1261,1296,97.3,2513,1240,1273,97.4
11040, 성동구,005003, 2세,2017,2594,1296,1298,99.8,2550,1276,1274,100.2
11040, 성동구,005004, 3세,2017,2502,1264,1238,102.1,2465,1244,1221,101.9
11040, 성동구,005005, 4세,2017,2411,1234,1177,104.8,2376,1219,1157,105.4
11040, 성동구,010,5~9세,2017,10457,5353,5104,104.9,10349,5293,5056,104.7
11040, 성동구,010001, 5세,2017,2337,1201,1136,105.7,2307,1184,1123,105.4
11040, 성동구,010002, 6세,2017,2152,1104,1048,105.3,2135,1093,1042,104.9
11040, 성동구,010003, 7세,2017,2010,1022,988,103.4,1981,1010,971,104
11040, 성동구,010004, 8세,2017,1882,961,921,104.3,1866,951,915,103.9
11040, 성동구,010005, 9세,2017,2076,1065,1011,105.3,2060,1055,1005,105
11040, 성동구,015,10~14세,2017,9617,4798,4819,99.6,9548,4763,4785,99.5
11040, 성동구,015001, 10세,2017,2086,1059,1027,103.1,2075,1052,1023,102.8
11040, 성동구,015002, 11세,2017,1831,947,884,107.1,1819,941,878,107.2
11040, 성동구,015003, 12세,2017,1826,921,905,101.8,1812,913,899,101.6
11040, 성동구,015004, 13세,2017,1957,986,971,101.5,1941,980,961,102
11040, 성동구,015005, 14세,2017,1917,885,1032,85.8,1901,877,1024,85.6
11040, 성동구,020,15~19세,2017,13662,6800,6862,99.1,13332,6646,6686,99.4
11040, 성동구,020001, 15세,2017,2090,1002,1088,92.1,2078,995,1083,91.9
11040, 성동구,020002, 16세,2017,2302,1188,1114,106.6,2290,1181,1109,106.5
11040, 성동구,020003, 17세,2017,2565,1293,1272,101.7,2536,1278,1258,101.6
11040, 성동구,020004, 18세,2017,2917,1450,1467,98.8,2839,1411,1428,98.8
11040, 성동구,020005, 19세,2017,3788,1867,1921,97.2,3589,1781,1808,98.5
11040, 성동구,025,20~24세,2017,23650,11828,11822,100.1,21831,11109,10722,103.6
11040, 성동구,025001, 20세,2017,4250,2037,2213,92,3936,1925,2011,95.7
11040, 성동구,025002, 21세,2017,4401,2127,2274,93.5,4044,1993,2051,97.2
11040, 성동구,025003, 22세,2017,4634,2345,2289,102.4,4243,2177,2066,105.4
11040, 성동구,025004, 23세,2017,5053,2512,2541,98.9,4669,2367,2302,102.8
11040, 성동구,025005, 24세,2017,5312,2807,2505,112.1,4939,2647,2292,115.5
11040, 성동구,030,25~29세,2017,25791,13208,12583,105,24379,12507,11872,105.3
11040, 성동구,030001, 25세,2017,5561,2916,2645,110.2,5243,2776,2467,112.5
11040, 성동구,030002, 26세,2017,5229,2788,2441,114.2,4968,2655,2313,114.8
11040, 성동구,030003, 27세,2017,5202,2645,2557,103.4,4908,2506,2402,104.3
11040, 성동구,030004, 28세,2017,4869,2440,2429,100.5,4602,2299,2303,99.8
11040, 성동구,030005, 29세,2017,4930,2419,2511,96.3,4658,2271,2387,95.1
11040, 성동구,035,30~34세,2017,25514,12623,12891,97.9,24285,11972,12313,97.2
11040, 성동구,035001, 30세,2017,4830,2383,2447,97.4,4536,2227,2309,96.4
11040, 성동구,035002, 31세,2017,4931,2456,2475,99.2,4674,2324,2350,98.9
11040, 성동구,035003, 32세,2017,5191,2525,2666,94.7,4950,2397,2553,93.9
11040, 성동구,035004, 33세,2017,5110,2520,2590,97.3,4881,2396,2485,96.4
11040, 성동구,035005, 34세,2017,5452,2739,2713,101,5244,2628,2616,100.5
11040, 성동구,040,35~39세,2017,26612,13594,13018,104.4,25740,13094,12646,103.5
11040, 성동구,040001, 35세,2017,5813,2986,2827,105.6,5586,2857,2729,104.7
11040, 성동구,040002, 36세,2017,5596,2841,2755,103.1,5409,2727,2682,101.7
11040, 성동구,040003, 37세,2017,5671,2877,2794,103,5509,2789,2720,102.5
11040, 성동구,040004, 38세,2017,5024,2556,2468,103.6,4878,2474,2404,102.9
11040, 성동구,040005, 39세,2017,4508,2334,2174,107.4,4358,2247,2111,106.4
11040, 성동구,045,40~44세,2017,23193,11931,11262,105.9,22488,11555,10933,105.7
11040, 성동구,045001, 40세,2017,4547,2326,2221,104.7,4412,2256,2156,104.6
11040, 성동구,045002, 41세,2017,4430,2316,2114,109.6,4299,2239,2060,108.7
11040, 성동구,045003, 42세,2017,4448,2246,2202,102,4301,2162,2139,101.1
11040, 성동구,045004, 43세,2017,4841,2499,2342,106.7,4723,2440,2283,106.9
11040, 성동구,045005, 44세,2017,4927,2544,2383,106.8,4753,2458,2295,107.1
11040, 성동구,050,45~49세,2017,25178,12563,12615,99.6,24294,12116,12178,99.5
11040, 성동구,050001, 45세,2017,4859,2451,2408,101.8,4683,2361,2322,101.7
11040, 성동구,050002, 46세,2017,5168,2589,2579,100.4,5002,2503,2499,100.2
11040, 성동구,050003, 47세,2017,5159,2623,2536,103.4,4965,2522,2443,103.2
11040, 성동구,050004, 48세,2017,5017,2439,2578,94.6,4852,2367,2485,95.3
11040, 성동구,050005, 49세,2017,4975,2461,2514,97.9,4792,2363,2429,97.3
11040, 성동구,055,50~54세,2017,23297,11500,11797,97.5,22376,11054,11322,97.6
11040, 성동구,055001, 50세,2017,4512,2188,2324,94.1,4382,2119,2263,93.6
11040, 성동구,055002, 51세,2017,4520,2252,2268,99.3,4320,2158,2162,99.8
11040, 성동구,055003, 52세,2017,4785,2359,2426,97.2,4556,2240,2316,96.7
11040, 성동구,055004, 53세,2017,4606,2298,2308,99.6,4442,2226,2216,100.5
11040, 성동구,055005, 54세,2017,4874,2403,2471,97.2,4676,2311,2365,97.7
11040, 성동구,060,55~59세,2017,24448,12179,12269,99.3,23670,11830,11840,99.9
11040, 성동구,060001, 55세,2017,4970,2519,2451,102.8,4791,2437,2354,103.5
11040, 성동구,060002, 56세,2017,5083,2529,2554,99,4952,2476,2476,100
11040, 성동구,060003, 57세,2017,5211,2551,2660,95.9,5056,2494,2562,97.3
11040, 성동구,060004, 58세,2017,4732,2344,2388,98.2,4585,2264,2321,97.5
11040, 성동구,060005, 59세,2017,4452,2236,2216,100.9,4286,2159,2127,101.5
11040, 성동구,065,60~64세,2017,18958,9216,9742,94.6,18284,8891,9393,94.7
11040, 성동구,065001, 60세,2017,4420,2172,2248,96.6,4262,2092,2170,96.4
11040, 성동구,065002, 61세,2017,4014,1946,2068,94.1,3863,1871,1992,93.9
11040, 성동구,065003, 62세,2017,4074,1930,2144,90,3937,1868,2069,90.3
11040, 성동구,065004, 63세,2017,3522,1708,1814,94.2,3390,1648,1742,94.6
11040, 성동구,065005, 64세,2017,2928,1460,1468,99.5,2832,1412,1420,99.4
11040, 성동구,070,65~69세,2017,13163,6201,6962,89.1,12880,6069,6811,89.1
11040, 성동구,070001, 65세,2017,3109,1493,1616,92.4,3029,1452,1577,92.1
11040, 성동구,070002, 66세,2017,2360,1115,1245,89.6,2291,1087,1204,90.3
11040, 성동구,070003, 67세,2017,2587,1223,1364,89.7,2529,1189,1340,88.7
11040, 성동구,070004, 68세,2017,2600,1187,1413,84,2552,1166,1386,84.1
11040, 성동구,070005, 69세,2017,2507,1183,1324,89.4,2479,1175,1304,90.1
11040, 성동구,075,70~74세,2017,10480,4710,5770,81.6,10407,4680,5727,81.7
11040, 성동구,075001, 70세,2017,2588,1164,1424,81.7,2568,1157,1411,82
11040, 성동구,075002, 71세,2017,2024,924,1100,84,2002,914,1088,84
11040, 성동구,075003, 72세,2017,1939,853,1086,78.5,1931,851,1080,78.8
11040, 성동구,075004, 73세,2017,1973,895,1078,83,1962,889,1073,82.9
11040, 성동구,075005, 74세,2017,1956,874,1082,80.8,1944,869,1075,80.8
11040, 성동구,080,75~79세,2017,8476,3703,4773,77.6,8435,3692,4743,77.8
11040, 성동구,080001, 75세,2017,2296,1044,1252,83.4,2285,1042,1243,83.8
11040, 성동구,080002, 76세,2017,1800,815,985,82.7,1793,813,980,83
11040, 성동구,080003, 77세,2017,1560,647,913,70.9,1550,644,906,71.1
11040, 성동구,080004, 78세,2017,1498,666,832,80,1489,664,825,80.5
11040, 성동구,080005, 79세,2017,1322,531,791,67.1,1318,529,789,67
11040, 성동구,085,80~84세,2017,4595,1755,2840,61.8,4568,1749,2819,62
11040, 성동구,085001, 80세,2017,1203,486,717,67.8,1199,485,714,67.9
11040, 성동구,085002, 81세,2017,1042,386,656,58.8,1034,385,649,59.3
11040, 성동구,085003, 82세,2017,899,353,546,64.7,893,352,541,65.1
11040, 성동구,085004, 83세,2017,833,323,510,63.3,828,322,506,63.6
11040, 성동구,085005, 84세,2017,618,207,411,50.4,614,205,409,50.1
11040, 성동구,090,85~89세,2017,1915,566,1349,42,1906,563,1343,41.9
11040, 성동구,090001, 85세,2017,546,181,365,49.6,543,179,364,49.2
11040, 성동구,090002, 86세,2017,412,122,290,42.1,409,121,288,42
11040, 성동구,090003, 87세,2017,384,99,285,34.7,381,99,282,35.1
11040, 성동구,090004, 88세,2017,330,100,230,43.5,330,100,230,43.5
11040, 성동구,090005, 89세,2017,243,64,179,35.8,243,64,179,35.8
11040, 성동구,095,90~94세,2017,631,161,470,34.3,628,160,468,34.2
11040, 성동구,095001, 90세,2017,206,57,149,38.3,205,57,148,38.5
11040, 성동구,095002, 91세,2017,143,33,110,30,143,33,110,30
11040, 성동구,095003, 92세,2017,109,24,85,28.2,109,24,85,28.2
11040, 성동구,095004, 93세,2017,87,20,67,29.9,87,20,67,29.9
11040, 성동구,095005, 94세,2017,86,27,59,45.8,84,26,58,44.8
11040, 성동구,100,95~99세,2017,154,36,118,30.5,153,36,117,30.8
11040, 성동구,100001, 95세,2017,57,13,44,29.5,56,13,43,30.2
11040, 성동구,100002, 96세,2017,49,12,37,32.4,49,12,37,32.4
11040, 성동구,100003, 97세,2017,26,6,20,30,26,6,20,30
11040, 성동구,100004, 98세,2017,15,X,12,25,15,X,12,25
11040, 성동구,100005, 99세,2017,7,X,5,40,7,X,5,40
11040, 성동구,101,100세이상,2017,22,5,17,29.4,19,X,16,18.8
11040, 성동구,102,15세미만,2017,32628,16481,16147,102.1,32256,16292,15964,102.1
11040, 성동구,103,15~64세,2017,230303,115442,114861,100.5,220679,110774,109905,100.8
11040, 성동구,104,65세이상,2017,39436,17137,22299,76.9,38996,16952,22044,76.9
11040, 성동구,086,85세이상,2017,2722,768,1954,39.3,2706,762,1944,39.2
11040, 성동구,126,평균연령,2017,41.2,40.4,41.9,,41.3,40.5,42.1,
11040, 성동구,127,중위연령,2017,40.7,40,41.5,,40.9,40.2,41.8,
11050, 광진구,000,합계,2017,363934,177156,186778,94.8,345535,168833,176702,95.5
11050, 광진구,005,0~4세,2017,12176,6251,5925,105.5,11779,6045,5734,105.4
11050, 광진구,005001, 0세,2017,2366,1223,1143,107,2283,1174,1109,105.9
11050, 광진구,005002, 1세,2017,2528,1301,1227,106,2438,1256,1182,106.3
11050, 광진구,005003, 2세,2017,2568,1291,1277,101.1,2495,1254,1241,101
11050, 광진구,005004, 3세,2017,2347,1216,1131,107.5,2253,1170,1083,108
11050, 광진구,005005, 4세,2017,2367,1220,1147,106.4,2310,1191,1119,106.4
11050, 광진구,010,5~9세,2017,11857,6136,5721,107.3,11664,6035,5629,107.2
11050, 광진구,010001, 5세,2017,2483,1273,1210,105.2,2424,1240,1184,104.7
11050, 광진구,010002, 6세,2017,2386,1201,1185,101.4,2350,1180,1170,100.9
11050, 광진구,010003, 7세,2017,2383,1267,1116,113.5,2344,1247,1097,113.7
11050, 광진구,010004, 8세,2017,2194,1137,1057,107.6,2158,1121,1037,108.1
11050, 광진구,010005, 9세,2017,2411,1258,1153,109.1,2388,1247,1141,109.3
11050, 광진구,015,10~14세,2017,12507,6404,6103,104.9,12399,6337,6062,104.5
11050, 광진구,015001, 10세,2017,2569,1288,1281,100.5,2539,1271,1268,100.2
11050, 광진구,015002, 11세,2017,2348,1180,1168,101,2327,1168,1159,100.8
11050, 광진구,015003, 12세,2017,2366,1212,1154,105,2349,1198,1151,104.1
11050, 광진구,015004, 13세,2017,2593,1356,1237,109.6,2568,1342,1226,109.5
11050, 광진구,015005, 14세,2017,2631,1368,1263,108.3,2616,1358,1258,107.9
11050, 광진구,020,15~19세,2017,18401,9292,9109,102,17758,9059,8699,104.1
11050, 광진구,020001, 15세,2017,2703,1389,1314,105.7,2679,1379,1300,106.1
11050, 광진구,020002, 16세,2017,3001,1594,1407,113.3,2972,1582,1390,113.8
11050, 광진구,020003, 17세,2017,3516,1799,1717,104.8,3466,1779,1687,105.5
11050, 광진구,020004, 18세,2017,3968,2003,1965,101.9,3811,1957,1854,105.6
11050, 광진구,020005, 19세,2017,5213,2507,2706,92.6,4830,2362,2468,95.7
11050, 광진구,025,20~24세,2017,31434,14641,16793,87.2,28480,13589,14891,91.3
11050, 광진구,025001, 20세,2017,5477,2493,2984,83.5,4908,2294,2614,87.8
11050, 광진구,025002, 21세,2017,5830,2599,3231,80.4,5216,2389,2827,84.5
11050, 광진구,025003, 22세,2017,6180,2914,3266,89.2,5559,2679,2880,93
11050, 광진구,025004, 23세,2017,6773,3169,3604,87.9,6165,2962,3203,92.5
11050, 광진구,025005, 24세,2017,7174,3466,3708,93.5,6632,3265,3367,97
11050, 광진구,030,25~29세,2017,35083,17143,17940,95.6,32623,16073,16550,97.1
11050, 광진구,030001, 25세,2017,7412,3590,3822,93.9,6921,3408,3513,97
11050, 광진구,030002, 26세,2017,7251,3622,3629,99.8,6760,3403,3357,101.4
11050, 광진구,030003, 27세,2017,6941,3412,3529,96.7,6384,3186,3198,99.6
11050, 광진구,030004, 28세,2017,6780,3248,3532,92,6313,3033,3280,92.5
11050, 광진구,030005, 29세,2017,6699,3271,3428,95.4,6245,3043,3202,95
11050, 광진구,035,30~34세,2017,32152,16052,16100,99.7,30285,15118,15167,99.7
11050, 광진구,035001, 30세,2017,6637,3266,3371,96.9,6177,3027,3150,96.1
11050, 광진구,035002, 31세,2017,6385,3142,3243,96.9,5992,2949,3043,96.9
11050, 광진구,035003, 32세,2017,6248,3123,3125,99.9,5882,2959,2923,101.2
11050, 광진구,035004, 33세,2017,6197,3109,3088,100.7,5882,2937,2945,99.7
11050, 광진구,035005, 34세,2017,6685,3412,3273,104.2,6352,3246,3106,104.5
11050, 광진구,040,35~39세,2017,29867,15103,14764,102.3,28627,14450,14177,101.9
11050, 광진구,040001, 35세,2017,6693,3313,3380,98,6392,3159,3233,97.7
11050, 광진구,040002, 36세,2017,6310,3215,3095,103.9,6062,3085,2977,103.6
11050, 광진구,040003, 37세,2017,6096,3089,3007,102.7,5871,2976,2895,102.8
11050, 광진구,040004, 38세,2017,5758,2904,2854,101.8,5523,2783,2740,101.6
11050, 광진구,040005, 39세,2017,5010,2582,2428,106.3,4779,2447,2332,104.9
11050, 광진구,045,40~44세,2017,26972,13467,13505,99.7,25886,12871,13015,98.9
11050, 광진구,045001, 40세,2017,5359,2692,2667,100.9,5150,2566,2584,99.3
11050, 광진구,045002, 41세,2017,5073,2583,2490,103.7,4881,2477,2404,103
11050, 광진구,045003, 42세,2017,5230,2612,2618,99.8,5037,2505,2532,98.9
11050, 광진구,045004, 43세,2017,5565,2794,2771,100.8,5337,2669,2668,100
11050, 광진구,045005, 44세,2017,5745,2786,2959,94.2,5481,2654,2827,93.9
11050, 광진구,050,45~49세,2017,30806,15009,15797,95,29250,14275,14975,95.3
11050, 광진구,050001, 45세,2017,5999,3052,2947,103.6,5714,2913,2801,104
11050, 광진구,050002, 46세,2017,6333,3091,3242,95.3,6017,2937,3080,95.4
11050, 광진구,050003, 47세,2017,6184,2970,3214,92.4,5875,2828,3047,92.8
11050, 광진구,050004, 48세,2017,6072,2884,3188,90.5,5757,2737,3020,90.6
11050, 광진구,050005, 49세,2017,6218,3012,3206,93.9,5887,2860,3027,94.5
11050, 광진구,055,50~54세,2017,28389,13860,14529,95.4,26424,12954,13470,96.2
11050, 광진구,055001, 50세,2017,5585,2715,2870,94.6,5298,2582,2716,95.1
11050, 광진구,055002, 51세,2017,5545,2658,2887,92.1,5208,2511,2697,93.1
11050, 광진구,055003, 52세,2017,5847,2849,2998,95,5445,2662,2783,95.7
11050, 광진구,055004, 53세,2017,5502,2734,2768,98.8,5082,2533,2549,99.4
11050, 광진구,055005, 54세,2017,5910,2904,3006,96.6,5391,2666,2725,97.8
11050, 광진구,060,55~59세,2017,29092,13815,15277,90.4,27432,13092,14340,91.3
11050, 광진구,060001, 55세,2017,5861,2855,3006,95,5469,2690,2779,96.8
11050, 광진구,060002, 56세,2017,6011,2803,3208,87.4,5751,2697,3054,88.3
11050, 광진구,060003, 57세,2017,6239,2966,3273,90.6,5860,2794,3066,91.1
11050, 광진구,060004, 58세,2017,5547,2580,2967,87,5243,2438,2805,86.9
11050, 광진구,060005, 59세,2017,5434,2611,2823,92.5,5109,2473,2636,93.8
11050, 광진구,065,60~64세,2017,22623,10923,11700,93.4,21229,10244,10985,93.3
11050, 광진구,065001, 60세,2017,5204,2539,2665,95.3,4841,2362,2479,95.3
11050, 광진구,065002, 61세,2017,4813,2300,2513,91.5,4533,2171,2362,91.9
11050, 광진구,065003, 62세,2017,4941,2352,2589,90.8,4649,2207,2442,90.4
11050, 광진구,065004, 63세,2017,4073,2005,2068,97,3811,1874,1937,96.7
11050, 광진구,065005, 64세,2017,3592,1727,1865,92.6,3395,1630,1765,92.4
11050, 광진구,070,65~69세,2017,15146,7191,7955,90.4,14588,6939,7649,90.7
11050, 광진구,070001, 65세,2017,3822,1852,1970,94,3663,1774,1889,93.9
11050, 광진구,070002, 66세,2017,2688,1240,1448,85.6,2551,1185,1366,86.7
11050, 광진구,070003, 67세,2017,2843,1337,1506,88.8,2732,1285,1447,88.8
11050, 광진구,070004, 68세,2017,2907,1399,1508,92.8,2814,1359,1455,93.4
11050, 광진구,070005, 69세,2017,2886,1363,1523,89.5,2828,1336,1492,89.5
11050, 광진구,075,70~74세,2017,11323,5303,6020,88.1,11171,5237,5934,88.3
11050, 광진구,075001, 70세,2017,2810,1263,1547,81.6,2766,1244,1522,81.7
11050, 광진구,075002, 71세,2017,2252,1088,1164,93.5,2210,1069,1141,93.7
11050, 광진구,075003, 72세,2017,2089,1014,1075,94.3,2067,1007,1060,95
11050, 광진구,075004, 73세,2017,2139,973,1166,83.4,2115,960,1155,83.1
11050, 광진구,075005, 74세,2017,2033,965,1068,90.4,2013,957,1056,90.6
11050, 광진구,080,75~79세,2017,8694,3995,4699,85,8612,3967,4645,85.4
11050, 광진구,080001, 75세,2017,2300,1077,1223,88.1,2271,1063,1208,88
11050, 광진구,080002, 76세,2017,1812,840,972,86.4,1804,836,968,86.4
11050, 광진구,080003, 77세,2017,1643,767,876,87.6,1630,763,867,88
11050, 광진구,080004, 78세,2017,1529,692,837,82.7,1518,690,828,83.3
11050, 광진구,080005, 79세,2017,1410,619,791,78.3,1389,615,774,79.5
11050, 광진구,085,80~84세,2017,4509,1726,2783,62,4449,1709,2740,62.4
11050, 광진구,085001, 80세,2017,1183,508,675,75.3,1166,504,662,76.1
11050, 광진구,085002, 81세,2017,977,365,612,59.6,962,359,603,59.5
11050, 광진구,085003, 82세,2017,948,347,601,57.7,940,346,594,58.2
11050, 광진구,085004, 83세,2017,759,287,472,60.8,748,282,466,60.5
11050, 광진구,085005, 84세,2017,642,219,423,51.8,633,218,415,52.5
11050, 광진구,090,85~89세,2017,2053,641,1412,45.4,2037,637,1400,45.5
11050, 광진구,090001, 85세,2017,605,201,404,49.8,602,201,401,50.1
11050, 광진구,090002, 86세,2017,430,137,293,46.8,427,137,290,47.2
11050, 광진구,090003, 87세,2017,380,114,266,42.9,375,111,264,42
11050, 광진구,090004, 88세,2017,349,110,239,46,346,109,237,46
11050, 광진구,090005, 89세,2017,289,79,210,37.6,287,79,208,38
11050, 광진구,095,90~94세,2017,646,158,488,32.4,642,158,484,32.6
11050, 광진구,095001, 90세,2017,211,53,158,33.5,208,53,155,34.2
11050, 광진구,095002, 91세,2017,143,30,113,26.5,143,30,113,26.5
11050, 광진구,095003, 92세,2017,116,31,85,36.5,115,31,84,36.9
11050, 광진구,095004, 93세,2017,93,30,63,47.6,93,30,63,47.6
11050, 광진구,095005, 94세,2017,83,14,69,20.3,83,14,69,20.3
11050, 광진구,100,95~99세,2017,179,42,137,30.7,176,40,136,29.4
11050, 광진구,100001, 95세,2017,66,13,53,24.5,65,13,52,25
11050, 광진구,100002, 96세,2017,50,14,36,38.9,49,13,36,36.1
11050, 광진구,100003, 97세,2017,28,X,24,16.7,28,X,24,16.7
11050, 광진구,100004, 98세,2017,19,9,10,90,18,8,10,80
11050, 광진구,100005, 99세,2017,16,X,14,14.3,16,X,14,14.3
11050, 광진구,101,100세이상,2017,25,X,21,19,24,X,20,20
11050, 광진구,102,15세미만,2017,36540,18791,17749,105.9,35842,18417,17425,105.7
11050, 광진구,103,15~64세,2017,284819,139305,145514,95.7,267994,131725,136269,96.7
11050, 광진구,104,65세이상,2017,42575,19060,23515,81.1,41699,18691,23008,81.2
11050, 광진구,086,85세이상,2017,2903,845,2058,41.1,2879,839,2040,41.1
11050, 광진구,126,평균연령,2017,40.6,39.9,41.1,,40.6,40,41.3,
11050, 광진구,127,중위연령,2017,39.7,39.1,40.4,,39.8,39.1,40.6,
11060, 동대문구,000,합계,2017,357380,176460,180920,97.5,339438,168977,170461,99.1
11060, 동대문구,005,0~4세,2017,11675,6049,5626,107.5,11435,5939,5496,108.1
11060, 동대문구,005001, 0세,2017,2095,1098,997,110.1,2061,1081,980,110.3
11060, 동대문구,005002, 1세,2017,2346,1194,1152,103.6,2278,1166,1112,104.9
11060, 동대문구,005003, 2세,2017,2487,1274,1213,105,2425,1250,1175,106.4
11060, 동대문구,005004, 3세,2017,2370,1234,1136,108.6,2335,1215,1120,108.5
11060, 동대문구,005005, 4세,2017,2377,1249,1128,110.7,2336,1227,1109,110.6
11060, 동대문구,010,5~9세,2017,11753,5988,5765,103.9,11638,5921,5717,103.6
11060, 동대문구,010001, 5세,2017,2457,1236,1221,101.2,2427,1220,1207,101.1
11060, 동대문구,010002, 6세,2017,2420,1234,1186,104,2392,1212,1180,102.7
11060, 동대문구,010003, 7세,2017,2280,1177,1103,106.7,2263,1167,1096,106.5
11060, 동대문구,010004, 8세,2017,2197,1131,1066,106.1,2176,1120,1056,106.1
11060, 동대문구,010005, 9세,2017,2399,1210,1189,101.8,2380,1202,1178,102
11060, 동대문구,015,10~14세,2017,11421,5871,5550,105.8,11337,5832,5505,105.9
11060, 동대문구,015001, 10세,2017,2376,1232,1144,107.7,2352,1220,1132,107.8
11060, 동대문구,015002, 11세,2017,2244,1151,1093,105.3,2223,1143,1080,105.8
11060, 동대문구,015003, 12세,2017,2142,1106,1036,106.8,2124,1100,1024,107.4
11060, 동대문구,015004, 13세,2017,2276,1159,1117,103.8,2265,1152,1113,103.5
11060, 동대문구,015005, 14세,2017,2383,1223,1160,105.4,2373,1217,1156,105.3
11060, 동대문구,020,15~19세,2017,18280,8842,9438,93.7,16726,8289,8437,98.2
11060, 동대문구,020001, 15세,2017,2444,1238,1206,102.7,2427,1233,1194,103.3
11060, 동대문구,020002, 16세,2017,2721,1397,1324,105.5,2706,1391,1315,105.8
11060, 동대문구,020003, 17세,2017,3167,1587,1580,100.4,3093,1556,1537,101.2
11060, 동대문구,020004, 18세,2017,3880,1896,1984,95.6,3510,1769,1741,101.6
11060, 동대문구,020005, 19세,2017,6068,2724,3344,81.5,4990,2340,2650,88.3
11060, 동대문구,025,20~24세,2017,34493,16090,18403,87.4,29059,14308,14751,97
11060, 동대문구,025001, 20세,2017,6500,2767,3733,74.1,5283,2390,2893,82.6
11060, 동대문구,025002, 21세,2017,6536,2781,3755,74.1,5337,2379,2958,80.4
11060, 동대문구,025003, 22세,2017,6802,3142,3660,85.8,5684,2784,2900,96
11060, 동대문구,025004, 23세,2017,7347,3620,3727,97.1,6348,3291,3057,107.7
11060, 동대문구,025005, 24세,2017,7308,3780,3528,107.1,6407,3464,2943,117.7
11060, 동대문구,030,25~29세,2017,31196,16567,14629,113.2,28361,15437,12924,119.4
11060, 동대문구,030001, 25세,2017,7336,3871,3465,111.7,6589,3600,2989,120.4
11060, 동대문구,030002, 26세,2017,6638,3609,3029,119.1,6028,3364,2664,126.3
11060, 동대문구,030003, 27세,2017,6105,3272,2833,115.5,5555,3027,2528,119.7
11060, 동대문구,030004, 28세,2017,5660,3019,2641,114.3,5184,2829,2355,120.1
11060, 동대문구,030005, 29세,2017,5457,2796,2661,105.1,5005,2617,2388,109.6
11060, 동대문구,035,30~34세,2017,26038,13567,12471,108.8,24450,12775,11675,109.4
11060, 동대문구,035001, 30세,2017,5190,2756,2434,113.2,4764,2553,2211,115.5
11060, 동대문구,035002, 31세,2017,5135,2702,2433,111.1,4771,2503,2268,110.4
11060, 동대문구,035003, 32세,2017,5005,2585,2420,106.8,4713,2442,2271,107.5
11060, 동대문구,035004, 33세,2017,5110,2661,2449,108.7,4858,2526,2332,108.3
11060, 동대문구,035005, 34세,2017,5598,2863,2735,104.7,5344,2751,2593,106.1
11060, 동대문구,040,35~39세,2017,27379,14170,13209,107.3,26337,13612,12725,107
11060, 동대문구,040001, 35세,2017,5786,2970,2816,105.5,5527,2837,2690,105.5
11060, 동대문구,040002, 36세,2017,5763,2978,2785,106.9,5574,2880,2694,106.9
11060, 동대문구,040003, 37세,2017,5691,2965,2726,108.8,5479,2848,2631,108.2
11060, 동대문구,040004, 38세,2017,5344,2761,2583,106.9,5150,2655,2495,106.4
11060, 동대문구,040005, 39세,2017,4795,2496,2299,108.6,4607,2392,2215,108
11060, 동대문구,045,40~44세,2017,25441,13164,12277,107.2,24603,12726,11877,107.1
11060, 동대문구,045001, 40세,2017,4980,2565,2415,106.2,4808,2477,2331,106.3
11060, 동대문구,045002, 41세,2017,4815,2507,2308,108.6,4646,2420,2226,108.7
11060, 동대문구,045003, 42세,2017,5013,2615,2398,109,4868,2527,2341,107.9
11060, 동대문구,045004, 43세,2017,5277,2763,2514,109.9,5100,2670,2430,109.9
11060, 동대문구,045005, 44세,2017,5356,2714,2642,102.7,5181,2632,2549,103.3
11060, 동대문구,050,45~49세,2017,28231,14413,13818,104.3,27222,13875,13347,104
11060, 동대문구,050001, 45세,2017,5625,2974,2651,112.2,5428,2853,2575,110.8
11060, 동대문구,050002, 46세,2017,5909,3081,2828,108.9,5717,2987,2730,109.4
11060, 동대문구,050003, 47세,2017,5614,2825,2789,101.3,5399,2701,2698,100.1
11060, 동대문구,050004, 48세,2017,5595,2795,2800,99.8,5379,2685,2694,99.7
11060, 동대문구,050005, 49세,2017,5488,2738,2750,99.6,5299,2649,2650,100
11060, 동대문구,055,50~54세,2017,26057,13006,13051,99.7,24991,12515,12476,100.3
11060, 동대문구,055001, 50세,2017,5096,2458,2638,93.2,4932,2392,2540,94.2
11060, 동대문구,055002, 51세,2017,5106,2654,2452,108.2,4901,2563,2338,109.6
11060, 동대문구,055003, 52세,2017,5353,2643,2710,97.5,5129,2537,2592,97.9
11060, 동대문구,055004, 53세,2017,5115,2549,2566,99.3,4892,2446,2446,100
11060, 동대문구,055005, 54세,2017,5387,2702,2685,100.6,5137,2577,2560,100.7
11060, 동대문구,060,55~59세,2017,28445,13773,14672,93.9,27620,13391,14229,94.1
11060, 동대문구,060001, 55세,2017,5526,2723,2803,97.1,5304,2626,2678,98.1
11060, 동대문구,060002, 56세,2017,5861,2843,3018,94.2,5752,2782,2970,93.7
11060, 동대문구,060003, 57세,2017,6062,2871,3191,90,5860,2778,3082,90.1
11060, 동대문구,060004, 58세,2017,5562,2672,2890,92.5,5418,2603,2815,92.5
11060, 동대문구,060005, 59세,2017,5434,2664,2770,96.2,5286,2602,2684,96.9
11060, 동대문구,065,60~64세,2017,23936,11558,12378,93.4,23207,11218,11989,93.6
11060, 동대문구,065001, 60세,2017,5321,2572,2749,93.6,5127,2475,2652,93.3
11060, 동대문구,065002, 61세,2017,5003,2443,2560,95.4,4870,2376,2494,95.3
11060, 동대문구,065003, 62세,2017,5171,2487,2684,92.7,5007,2414,2593,93.1
11060, 동대문구,065004, 63세,2017,4480,2165,2315,93.5,4361,2107,2254,93.5
11060, 동대문구,065005, 64세,2017,3961,1891,2070,91.4,3842,1846,1996,92.5
11060, 동대문구,070,65~69세,2017,17514,8231,9283,88.7,17160,8054,9106,88.4
11060, 동대문구,070001, 65세,2017,4147,1910,2237,85.4,4052,1863,2189,85.1
11060, 동대문구,070002, 66세,2017,3137,1489,1648,90.4,3055,1448,1607,90.1
11060, 동대문구,070003, 67세,2017,3442,1690,1752,96.5,3375,1655,1720,96.2
11060, 동대문구,070004, 68세,2017,3398,1608,1790,89.8,3334,1575,1759,89.5
11060, 동대문구,070005, 69세,2017,3390,1534,1856,82.7,3344,1513,1831,82.6
11060, 동대문구,075,70~74세,2017,14314,6523,7791,83.7,14209,6473,7736,83.7
11060, 동대문구,075001, 70세,2017,3466,1574,1892,83.2,3429,1555,1874,83
11060, 동대문구,075002, 71세,2017,2754,1270,1484,85.6,2727,1256,1471,85.4
11060, 동대문구,075003, 72세,2017,2716,1231,1485,82.9,2700,1227,1473,83.3
11060, 동대문구,075004, 73세,2017,2620,1151,1469,78.4,2608,1146,1462,78.4
11060, 동대문구,075005, 74세,2017,2758,1297,1461,88.8,2745,1289,1456,88.5
11060, 동대문구,080,75~79세,2017,11573,5154,6419,80.3,11514,5138,6376,80.6
11060, 동대문구,080001, 75세,2017,3094,1395,1699,82.1,3081,1393,1688,82.5
11060, 동대문구,080002, 76세,2017,2399,1118,1281,87.3,2390,1113,1277,87.2
11060, 동대문구,080003, 77세,2017,2169,935,1234,75.8,2146,929,1217,76.3
11060, 동대문구,080004, 78세,2017,2069,906,1163,77.9,2063,905,1158,78.2
11060, 동대문구,080005, 79세,2017,1842,800,1042,76.8,1834,798,1036,77
11060, 동대문구,085,80~84세,2017,6117,2417,3700,65.3,6070,2402,3668,65.5
11060, 동대문구,085001, 80세,2017,1577,657,920,71.4,1563,654,909,71.9
11060, 동대문구,085002, 81세,2017,1379,575,804,71.5,1373,573,800,71.6
11060, 동대문구,085003, 82세,2017,1268,504,764,66,1255,501,754,66.4
11060, 동대문구,085004, 83세,2017,1051,386,665,58,1047,383,664,57.7
11060, 동대문구,085005, 84세,2017,842,295,547,53.9,832,291,541,53.8
11060, 동대문구,090,85~89세,2017,2500,826,1674,49.3,2485,822,1663,49.4
11060, 동대문구,090001, 85세,2017,743,281,462,60.8,738,279,459,60.8
11060, 동대문구,090002, 86세,2017,523,169,354,47.7,518,168,350,48
11060, 동대문구,090003, 87세,2017,494,153,341,44.9,491,152,339,44.8
11060, 동대문구,090004, 88세,2017,415,125,290,43.1,414,125,289,43.3
11060, 동대문구,090005, 89세,2017,325,98,227,43.2,324,98,226,43.4
11060, 동대문구,095,90~94세,2017,818,204,614,33.2,816,203,613,33.1
11060, 동대문구,095001, 90세,2017,278,75,203,36.9,278,75,203,36.9
11060, 동대문구,095002, 91세,2017,178,38,140,27.1,177,37,140,26.4
11060, 동대문구,095003, 92세,2017,145,36,109,33,144,36,108,33.3
11060, 동대문구,095004, 93세,2017,101,21,80,26.3,101,21,80,26.3
11060, 동대문구,095005, 94세,2017,116,34,82,41.5,116,34,82,41.5
11060, 동대문구,100,95~99세,2017,174,40,134,29.9,173,40,133,30.1
11060, 동대문구,100001, 95세,2017,65,14,51,27.5,65,14,51,27.5
11060, 동대문구,100002, 96세,2017,43,8,35,22.9,43,8,35,22.9
11060, 동대문구,100003, 97세,2017,36,10,26,38.5,35,10,25,40
11060, 동대문구,100004, 98세,2017,15,6,9,66.7,15,6,9,66.7
11060, 동대문구,100005, 99세,2017,15,X,13,15.4,15,X,13,15.4
11060, 동대문구,101,100세이상,2017,25,7,18,38.9,25,7,18,38.9
11060, 동대문구,102,15세미만,2017,34849,17908,16941,105.7,34410,17692,16718,105.8
11060, 동대문구,103,15~64세,2017,269496,135150,134346,100.6,252576,128146,124430,103
11060, 동대문구,104,65세이상,2017,53035,23402,29633,79,52452,23139,29313,78.9
11060, 동대문구,086,85세이상,2017,3517,1077,2440,44.1,3499,1072,2427,44.2
11060, 동대문구,126,평균연령,2017,41.8,41,42.6,,42.3,41.3,43.2,
11060, 동대문구,127,중위연령,2017,41.3,40.4,42.3,,42.2,41,43.5,
11070, 중랑구,000,합계,2017,396892,196346,200546,97.9,390879,193871,197008,98.4
11070, 중랑구,005,0~4세,2017,14249,7300,6949,105.1,14088,7216,6872,105
11070, 중랑구,005001, 0세,2017,2701,1371,1330,103.1,2661,1353,1308,103.4
11070, 중랑구,005002, 1세,2017,2877,1458,1419,102.7,2843,1440,1403,102.6
11070, 중랑구,005003, 2세,2017,2994,1579,1415,111.6,2967,1565,1402,111.6
11070, 중랑구,005004, 3세,2017,2823,1422,1401,101.5,2789,1403,1386,101.2
11070, 중랑구,005005, 4세,2017,2854,1470,1384,106.2,2828,1455,1373,106
11070, 중랑구,010,5~9세,2017,13641,6949,6692,103.8,13541,6901,6640,103.9
11070, 중랑구,010001, 5세,2017,3006,1554,1452,107,2980,1541,1439,107.1
11070, 중랑구,010002, 6세,2017,2833,1462,1371,106.6,2813,1449,1364,106.2
11070, 중랑구,010003, 7세,2017,2651,1347,1304,103.3,2631,1338,1293,103.5
11070, 중랑구,010004, 8세,2017,2486,1260,1226,102.8,2469,1256,1213,103.5
11070, 중랑구,010005, 9세,2017,2665,1326,1339,99,2648,1317,1331,98.9
11070, 중랑구,015,10~14세,2017,13302,6837,6465,105.8,13256,6818,6438,105.9
11070, 중랑구,015001, 10세,2017,2718,1380,1338,103.1,2709,1375,1334,103.1
11070, 중랑구,015002, 11세,2017,2537,1368,1169,117,2529,1365,1164,117.3
11070, 중랑구,015003, 12세,2017,2471,1297,1174,110.5,2461,1293,1168,110.7
11070, 중랑구,015004, 13세,2017,2696,1342,1354,99.1,2683,1338,1345,99.5
11070, 중랑구,015005, 14세,2017,2880,1450,1430,101.4,2874,1447,1427,101.4
11070, 중랑구,020,15~19세,2017,18148,9417,8731,107.9,18047,9377,8670,108.2
11070, 중랑구,020001, 15세,2017,2909,1529,1380,110.8,2897,1521,1376,110.5
11070, 중랑구,020002, 16세,2017,3395,1779,1616,110.1,3384,1774,1610,110.2
11070, 중랑구,020003, 17세,2017,3942,1974,1968,100.3,3922,1971,1951,101
11070, 중랑구,020004, 18세,2017,3900,2010,1890,106.3,3883,2000,1883,106.2
11070, 중랑구,020005, 19세,2017,4002,2125,1877,113.2,3961,2111,1850,114.1
11070, 중랑구,025,20~24세,2017,26324,13412,12912,103.9,25915,13249,12666,104.6
11070, 중랑구,025001, 20세,2017,4610,2401,2209,108.7,4541,2375,2166,109.6
11070, 중랑구,025002, 21세,2017,4996,2638,2358,111.9,4941,2609,2332,111.9
11070, 중랑구,025003, 22세,2017,5284,2745,2539,108.1,5198,2711,2487,109
11070, 중랑구,025004, 23세,2017,5556,2718,2838,95.8,5487,2696,2791,96.6
11070, 중랑구,025005, 24세,2017,5878,2910,2968,98,5748,2858,2890,98.9
11070, 중랑구,030,25~29세,2017,30101,14778,15323,96.4,29262,14451,14811,97.6
11070, 중랑구,030001, 25세,2017,6395,3135,3260,96.2,6251,3071,3180,96.6
11070, 중랑구,030002, 26세,2017,6037,2934,3103,94.6,5896,2880,3016,95.5
11070, 중랑구,030003, 27세,2017,5984,2930,3054,95.9,5803,2862,2941,97.3
11070, 중랑구,030004, 28세,2017,5841,2869,2972,96.5,5638,2793,2845,98.2
11070, 중랑구,030005, 29세,2017,5844,2910,2934,99.2,5674,2845,2829,100.6
11070, 중랑구,035,30~34세,2017,30372,15532,14840,104.7,29599,15217,14382,105.8
11070, 중랑구,035001, 30세,2017,5777,2900,2877,100.8,5602,2824,2778,101.7
11070, 중랑구,035002, 31세,2017,6021,3093,2928,105.6,5848,3026,2822,107.2
11070, 중랑구,035003, 32세,2017,5947,3029,2918,103.8,5805,2965,2840,104.4
11070, 중랑구,035004, 33세,2017,6118,3125,2993,104.4,5971,3061,2910,105.2
11070, 중랑구,035005, 34세,2017,6509,3385,3124,108.4,6373,3341,3032,110.2
11070, 중랑구,040,35~39세,2017,32189,16954,15235,111.3,31601,16699,14902,112.1
11070, 중랑구,040001, 35세,2017,6869,3553,3316,107.1,6744,3503,3241,108.1
11070, 중랑구,040002, 36세,2017,6837,3616,3221,112.3,6701,3568,3133,113.9
11070, 중랑구,040003, 37세,2017,6842,3596,3246,110.8,6732,3544,3188,111.2
11070, 중랑구,040004, 38세,2017,6252,3304,2948,112.1,6133,3250,2883,112.7
11070, 중랑구,040005, 39세,2017,5389,2885,2504,115.2,5291,2834,2457,115.3
11070, 중랑구,045,40~44세,2017,28473,14695,13778,106.7,28024,14509,13515,107.4
11070, 중랑구,045001, 40세,2017,5553,2914,2639,110.4,5479,2882,2597,111
11070, 중랑구,045002, 41세,2017,5336,2811,2525,111.3,5232,2767,2465,112.3
11070, 중랑구,045003, 42세,2017,5459,2802,2657,105.5,5379,2771,2608,106.3
11070, 중랑구,045004, 43세,2017,5979,3070,2909,105.5,5893,3037,2856,106.3
11070, 중랑구,045005, 44세,2017,6146,3098,3048,101.6,6041,3052,2989,102.1
11070, 중랑구,050,45~49세,2017,33718,16716,17002,98.3,33087,16450,16637,98.9
11070, 중랑구,050001, 45세,2017,6258,3131,3127,100.1,6135,3084,3051,101.1
11070, 중랑구,050002, 46세,2017,6886,3520,3366,104.6,6763,3467,3296,105.2
11070, 중랑구,050003, 47세,2017,6621,3295,3326,99.1,6480,3234,3246,99.6
11070, 중랑구,050004, 48세,2017,6953,3441,3512,98,6820,3383,3437,98.4
11070, 중랑구,050005, 49세,2017,7000,3329,3671,90.7,6889,3282,3607,91
11070, 중랑구,055,50~54세,2017,33371,16206,17165,94.4,32723,15948,16775,95.1
11070, 중랑구,055001, 50세,2017,6549,3113,3436,90.6,6448,3070,3378,90.9
11070, 중랑구,055002, 51세,2017,6455,3189,3266,97.6,6320,3135,3185,98.4
11070, 중랑구,055003, 52세,2017,6868,3311,3557,93.1,6732,3269,3463,94.4
11070, 중랑구,055004, 53세,2017,6645,3248,3397,95.6,6499,3181,3318,95.9
11070, 중랑구,055005, 54세,2017,6854,3345,3509,95.3,6724,3293,3431,96
11070, 중랑구,060,55~59세,2017,36858,18044,18814,95.9,36361,17845,18516,96.4
11070, 중랑구,060001, 55세,2017,7333,3705,3628,102.1,7203,3649,3554,102.7
11070, 중랑구,060002, 56세,2017,7935,3794,4141,91.6,7864,3766,4098,91.9
11070, 중랑구,060003, 57세,2017,7861,3824,4037,94.7,7750,3781,3969,95.3
11070, 중랑구,060004, 58세,2017,6963,3390,3573,94.9,6868,3358,3510,95.7
11070, 중랑구,060005, 59세,2017,6766,3331,3435,97,6676,3291,3385,97.2
11070, 중랑구,065,60~64세,2017,28897,14007,14890,94.1,28478,13826,14652,94.4
11070, 중랑구,065001, 60세,2017,6561,3183,3378,94.2,6455,3144,3311,95
11070, 중랑구,065002, 61세,2017,6076,2970,3106,95.6,5998,2936,3062,95.9
11070, 중랑구,065003, 62세,2017,6319,2999,3320,90.3,6230,2958,3272,90.4
11070, 중랑구,065004, 63세,2017,5337,2634,2703,97.4,5260,2601,2659,97.8
11070, 중랑구,065005, 64세,2017,4604,2221,2383,93.2,4535,2187,2348,93.1
11070, 중랑구,070,65~69세,2017,20449,9818,10631,92.4,20234,9720,10514,92.4
11070, 중랑구,070001, 65세,2017,5004,2440,2564,95.2,4938,2407,2531,95.1
11070, 중랑구,070002, 66세,2017,3645,1732,1913,90.5,3599,1711,1888,90.6
11070, 중랑구,070003, 67세,2017,3922,1919,2003,95.8,3890,1908,1982,96.3
11070, 중랑구,070004, 68세,2017,4001,1909,2092,91.3,3961,1889,2072,91.2
11070, 중랑구,070005, 69세,2017,3877,1818,2059,88.3,3846,1805,2041,88.4
11070, 중랑구,075,70~74세,2017,15447,7127,8320,85.7,15370,7107,8263,86
11070, 중랑구,075001, 70세,2017,3912,1817,2095,86.7,3892,1811,2081,87
11070, 중랑구,075002, 71세,2017,3001,1402,1599,87.7,2980,1396,1584,88.1
11070, 중랑구,075003, 72세,2017,2840,1302,1538,84.7,2826,1298,1528,84.9
11070, 중랑구,075004, 73세,2017,2859,1295,1564,82.8,2847,1293,1554,83.2
11070, 중랑구,075005, 74세,2017,2835,1311,1524,86,2825,1309,1516,86.3
11070, 중랑구,080,75~79세,2017,11731,5304,6427,82.5,11704,5296,6408,82.6
11070, 중랑구,080001, 75세,2017,3262,1501,1761,85.2,3257,1500,1757,85.4
11070, 중랑구,080002, 76세,2017,2526,1179,1347,87.5,2520,1178,1342,87.8
11070, 중랑구,080003, 77세,2017,2162,958,1204,79.6,2152,954,1198,79.6
11070, 중랑구,080004, 78세,2017,2039,925,1114,83,2036,924,1112,83.1
11070, 중랑구,080005, 79세,2017,1742,741,1001,74,1739,740,999,74.1
11070, 중랑구,085,80~84세,2017,5988,2318,3670,63.2,5969,2314,3655,63.3
11070, 중랑구,085001, 80세,2017,1536,660,876,75.3,1530,659,871,75.7
11070, 중랑구,085002, 81세,2017,1382,563,819,68.7,1379,562,817,68.8
11070, 중랑구,085003, 82세,2017,1253,454,799,56.8,1249,453,796,56.9
11070, 중랑구,085004, 83세,2017,1016,372,644,57.8,1013,371,642,57.8
11070, 중랑구,085005, 84세,2017,801,269,532,50.6,798,269,529,50.9
11070, 중랑구,090,85~89세,2017,2576,700,1876,37.3,2566,697,1869,37.3
11070, 중랑구,090001, 85세,2017,687,240,447,53.7,683,238,445,53.5
11070, 중랑구,090002, 86세,2017,589,157,432,36.3,586,156,430,36.3
11070, 중랑구,090003, 87세,2017,506,123,383,32.1,504,123,381,32.3
11070, 중랑구,090004, 88세,2017,417,100,317,31.5,417,100,317,31.5
11070, 중랑구,090005, 89세,2017,377,80,297,26.9,376,80,296,27
11070, 중랑구,095,90~94세,2017,835,191,644,29.7,831,190,641,29.6
11070, 중랑구,095001, 90세,2017,265,67,198,33.8,264,67,197,34
11070, 중랑구,095002, 91세,2017,189,42,147,28.6,188,42,146,28.8
11070, 중랑구,095003, 92세,2017,159,28,131,21.4,159,28,131,21.4
11070, 중랑구,095004, 93세,2017,110,26,84,31,108,25,83,30.1
11070, 중랑구,095005, 94세,2017,112,28,84,33.3,112,28,84,33.3
11070, 중랑구,100,95~99세,2017,195,39,156,25,195,39,156,25
11070, 중랑구,100001, 95세,2017,74,13,61,21.3,74,13,61,21.3
11070, 중랑구,100002, 96세,2017,48,13,35,37.1,48,13,35,37.1
11070, 중랑구,100003, 97세,2017,38,8,30,26.7,38,8,30,26.7
11070, 중랑구,100004, 98세,2017,23,X,19,21.1,23,X,19,21.1
11070, 중랑구,100005, 99세,2017,12,X,11,9.1,12,X,11,9.1
11070, 중랑구,101,100세이상,2017,28,X,26,7.7,28,X,26,7.7
11070, 중랑구,102,15세미만,2017,41192,21086,20106,104.9,40885,20935,19950,104.9
11070, 중랑구,103,15~64세,2017,298451,149761,148690,100.7,293097,147571,145526,101.4
11070, 중랑구,104,65세이상,2017,57249,25499,31750,80.3,56897,25365,31532,80.4
11070, 중랑구,086,85세이상,2017,3634,932,2702,34.5,3620,928,2692,34.5
11070, 중랑구,126,평균연령,2017,42.7,41.8,43.5,,42.7,41.8,43.6,
11070, 중랑구,127,중위연령,2017,43.6,42.5,44.8,,43.7,42.5,44.9,
11080, 성북구,000,합계,2017,445417,215068,230349,93.4,432226,209374,222852,94
11080, 성북구,005,0~4세,2017,15518,7872,7646,103,15304,7767,7537,103.1
11080, 성북구,005001, 0세,2017,2725,1375,1350,101.9,2676,1349,1327,101.7
11080, 성북구,005002, 1세,2017,3081,1553,1528,101.6,3036,1532,1504,101.9
11080, 성북구,005003, 2세,2017,3258,1680,1578,106.5,3218,1661,1557,106.7
11080, 성북구,005004, 3세,2017,3183,1623,1560,104,3143,1603,1540,104.1
11080, 성북구,005005, 4세,2017,3271,1641,1630,100.7,3231,1622,1609,100.8
11080, 성북구,010,5~9세,2017,17566,9074,8492,106.9,17464,9018,8446,106.8
11080, 성북구,010001, 5세,2017,3601,1894,1707,111,3581,1882,1699,110.8
11080, 성북구,010002, 6세,2017,3598,1846,1752,105.4,3577,1837,1740,105.6
11080, 성북구,010003, 7세,2017,3497,1754,1743,100.6,3473,1743,1730,100.8
11080, 성북구,010004, 8세,2017,3311,1715,1596,107.5,3294,1704,1590,107.2
11080, 성북구,010005, 9세,2017,3559,1865,1694,110.1,3539,1852,1687,109.8
11080, 성북구,015,10~14세,2017,17842,9222,8620,107,17773,9182,8591,106.9
11080, 성북구,015001, 10세,2017,3768,1971,1797,109.7,3752,1963,1789,109.7
11080, 성북구,015002, 11세,2017,3376,1697,1679,101.1,3359,1687,1672,100.9
11080, 성북구,015003, 12세,2017,3316,1741,1575,110.5,3308,1737,1571,110.6
11080, 성북구,015004, 13세,2017,3707,1912,1795,106.5,3687,1899,1788,106.2
11080, 성북구,015005, 14세,2017,3675,1901,1774,107.2,3667,1896,1771,107.1
11080, 성북구,020,15~19세,2017,25484,12354,13130,94.1,24365,11931,12434,96
11080, 성북구,020001, 15세,2017,3744,1887,1857,101.6,3735,1881,1854,101.5
11080, 성북구,020002, 16세,2017,4080,2045,2035,100.5,4065,2038,2027,100.5
11080, 성북구,020003, 17세,2017,4500,2294,2206,104,4446,2267,2179,104
11080, 성북구,020004, 18세,2017,5314,2588,2726,94.9,5043,2496,2547,98
11080, 성북구,020005, 19세,2017,7846,3540,4306,82.2,7076,3249,3827,84.9
11080, 성북구,025,20~24세,2017,40893,18432,22461,82.1,36691,16927,19764,85.6
11080, 성북구,025001, 20세,2017,8260,3329,4931,67.5,7221,3010,4211,71.5
11080, 성북구,025002, 21세,2017,7917,3368,4549,74,6974,3035,3939,77.1
11080, 성북구,025003, 22세,2017,8129,3631,4498,80.7,7241,3315,3926,84.4
11080, 성북구,025004, 23세,2017,8375,4012,4363,92,7648,3727,3921,95.1
11080, 성북구,025005, 24세,2017,8212,4092,4120,99.3,7607,3840,3767,101.9
11080, 성북구,030,25~29세,2017,34231,17424,16807,103.7,32220,16541,15679,105.5
11080, 성북구,030001, 25세,2017,7981,4013,3968,101.1,7486,3780,3706,102
11080, 성북구,030002, 26세,2017,7387,3851,3536,108.9,6977,3680,3297,111.6
11080, 성북구,030003, 27세,2017,6627,3359,3268,102.8,6224,3196,3028,105.5
11080, 성북구,030004, 28세,2017,6228,3200,3028,105.7,5858,3025,2833,106.8
11080, 성북구,030005, 29세,2017,6008,3001,3007,99.8,5675,2860,2815,101.6
11080, 성북구,035,30~34세,2017,29965,14952,15013,99.6,28623,14295,14328,99.8
11080, 성북구,035001, 30세,2017,5890,2970,2920,101.7,5585,2820,2765,102
11080, 성북구,035002, 31세,2017,5958,2975,2983,99.7,5653,2824,2829,99.8
11080, 성북구,035003, 32세,2017,5691,2786,2905,95.9,5437,2667,2770,96.3
11080, 성북구,035004, 33세,2017,5940,3002,2938,102.2,5694,2874,2820,101.9
11080, 성북구,035005, 34세,2017,6486,3219,3267,98.5,6254,3110,3144,98.9
11080, 성북구,040,35~39세,2017,33708,16815,16893,99.5,32785,16355,16430,99.5
11080, 성북구,040001, 35세,2017,6866,3387,3479,97.4,6677,3293,3384,97.3
11080, 성북구,040002, 36세,2017,7084,3636,3448,105.5,6890,3532,3358,105.2
11080, 성북구,040003, 37세,2017,6952,3410,3542,96.3,6787,3330,3457,96.3
11080, 성북구,040004, 38세,2017,6820,3407,3413,99.8,6641,3310,3331,99.4
11080, 성북구,040005, 39세,2017,5986,2975,3011,98.8,5790,2890,2900,99.7
11080, 성북구,045,40~44세,2017,34766,17273,17493,98.7,34060,16893,17167,98.4
11080, 성북구,045001, 40세,2017,6281,3111,3170,98.1,6147,3036,3111,97.6
11080, 성북구,045002, 41세,2017,6471,3223,3248,99.2,6336,3148,3188,98.7
11080, 성북구,045003, 42세,2017,6883,3406,3477,98,6753,3343,3410,98
11080, 성북구,045004, 43세,2017,7497,3747,3750,99.9,7367,3676,3691,99.6
11080, 성북구,045005, 44세,2017,7634,3786,3848,98.4,7457,3690,3767,98
11080, 성북구,050,45~49세,2017,38673,19441,19232,101.1,37904,19056,18848,101.1
11080, 성북구,050001, 45세,2017,7777,3959,3818,103.7,7624,3882,3742,103.7
11080, 성북구,050002, 46세,2017,8101,4083,4018,101.6,7936,3994,3942,101.3
11080, 성북구,050003, 47세,2017,7711,3837,3874,99,7558,3758,3800,98.9
11080, 성북구,050004, 48세,2017,7669,3862,3807,101.4,7518,3793,3725,101.8
11080, 성북구,050005, 49세,2017,7415,3700,3715,99.6,7268,3629,3639,99.7
11080, 성북구,055,50~54세,2017,32333,15774,16559,95.3,31693,15464,16229,95.3
11080, 성북구,055001, 50세,2017,6645,3276,3369,97.2,6509,3214,3295,97.5
11080, 성북구,055002, 51세,2017,6291,3124,3167,98.6,6178,3069,3109,98.7
11080, 성북구,055003, 52세,2017,6519,3182,3337,95.4,6398,3126,3272,95.5
11080, 성북구,055004, 53세,2017,6357,3064,3293,93,6233,2997,3236,92.6
11080, 성북구,055005, 54세,2017,6521,3128,3393,92.2,6375,3058,3317,92.2
11080, 성북구,060,55~59세,2017,33547,16083,17464,92.1,33123,15900,17223,92.3
11080, 성북구,060001, 55세,2017,6585,3191,3394,94,6490,3151,3339,94.4
11080, 성북구,060002, 56세,2017,6968,3341,3627,92.1,6887,3308,3579,92.4
11080, 성북구,060003, 57세,2017,7147,3328,3819,87.1,7049,3283,3766,87.2
11080, 성북구,060004, 58세,2017,6553,3188,3365,94.7,6471,3153,3318,95
11080, 성북구,060005, 59세,2017,6294,3035,3259,93.1,6226,3005,3221,93.3
11080, 성북구,065,60~64세,2017,27688,13051,14637,89.2,27337,12885,14452,89.2
11080, 성북구,065001, 60세,2017,6253,2919,3334,87.6,6161,2873,3288,87.4
11080, 성북구,065002, 61세,2017,5888,2798,3090,90.6,5813,2761,3052,90.5
11080, 성북구,065003, 62세,2017,5986,2783,3203,86.9,5911,2751,3160,87.1
11080, 성북구,065004, 63세,2017,5053,2430,2623,92.6,4999,2405,2594,92.7
11080, 성북구,065005, 64세,2017,4508,2121,2387,88.9,4453,2095,2358,88.8
11080, 성북구,070,65~69세,2017,20367,9356,11011,85,20193,9275,10918,85
11080, 성북구,070001, 65세,2017,4882,2298,2584,88.9,4836,2276,2560,88.9
11080, 성북구,070002, 66세,2017,3431,1607,1824,88.1,3401,1589,1812,87.7
11080, 성북구,070003, 67세,2017,4030,1864,2166,86.1,3986,1843,2143,86
11080, 성북구,070004, 68세,2017,4113,1859,2254,82.5,4082,1849,2233,82.8
11080, 성북구,070005, 69세,2017,3911,1728,2183,79.2,3888,1718,2170,79.2
11080, 성북구,075,70~74세,2017,16886,7540,9346,80.7,16821,7507,9314,80.6
11080, 성북구,075001, 70세,2017,4126,1847,2279,81,4112,1840,2272,81
11080, 성북구,075002, 71세,2017,3240,1424,1816,78.4,3223,1413,1810,78.1
11080, 성북구,075003, 72세,2017,3096,1388,1708,81.3,3090,1386,1704,81.3
11080, 성북구,075004, 73세,2017,3197,1410,1787,78.9,3177,1401,1776,78.9
11080, 성북구,075005, 74세,2017,3227,1471,1756,83.8,3219,1467,1752,83.7
11080, 성북구,080,75~79세,2017,14003,6172,7831,78.8,13966,6158,7808,78.9
11080, 성북구,080001, 75세,2017,3703,1685,2018,83.5,3697,1683,2014,83.6
11080, 성북구,080002, 76세,2017,2964,1360,1604,84.8,2958,1359,1599,85
11080, 성북구,080003, 77세,2017,2620,1114,1506,74,2613,1110,1503,73.9
11080, 성북구,080004, 78세,2017,2522,1085,1437,75.5,2509,1079,1430,75.5
11080, 성북구,080005, 79세,2017,2194,928,1266,73.3,2189,927,1262,73.5
11080, 성북구,085,80~84세,2017,7477,2940,4537,64.8,7448,2932,4516,64.9
11080, 성북구,085001, 80세,2017,1936,772,1164,66.3,1930,770,1160,66.4
11080, 성북구,085002, 81세,2017,1702,681,1021,66.7,1692,678,1014,66.9
11080, 성북구,085003, 82세,2017,1584,619,965,64.1,1582,619,963,64.3
11080, 성북구,085004, 83세,2017,1230,475,755,62.9,1225,473,752,62.9
11080, 성북구,085005, 84세,2017,1025,393,632,62.2,1019,392,627,62.5
11080, 성북구,090,85~89세,2017,3172,969,2203,44,3166,967,2199,44
11080, 성북구,090001, 85세,2017,857,282,575,49,854,281,573,49
11080, 성북구,090002, 86세,2017,722,233,489,47.6,721,232,489,47.4
11080, 성북구,090003, 87세,2017,628,184,444,41.4,627,184,443,41.5
11080, 성북구,090004, 88세,2017,528,147,381,38.6,527,147,380,38.7
11080, 성북구,090005, 89세,2017,437,123,314,39.2,437,123,314,39.2
11080, 성북구,095,90~94세,2017,1038,252,786,32.1,1033,250,783,31.9
11080, 성북구,095001, 90세,2017,357,88,269,32.7,357,88,269,32.7
11080, 성북구,095002, 91세,2017,256,62,194,32,252,60,192,31.3
11080, 성북구,095003, 92세,2017,175,36,139,25.9,175,36,139,25.9
11080, 성북구,095004, 93세,2017,121,33,88,37.5,121,33,88,37.5
11080, 성북구,095005, 94세,2017,129,33,96,34.4,128,33,95,34.7
11080, 성북구,100,95~99세,2017,237,65,172,37.8,236,64,172,37.2
11080, 성북구,100001, 95세,2017,95,29,66,43.9,95,29,66,43.9
11080, 성북구,100002, 96세,2017,56,15,41,36.6,56,15,41,36.6
11080, 성북구,100003, 97세,2017,39,7,32,21.9,39,7,32,21.9
11080, 성북구,100004, 98세,2017,33,11,22,50,33,11,22,50
11080, 성북구,100005, 99세,2017,14,X,11,27.3,13,X,11,18.2
11080, 성북구,101,100세이상,2017,23,7,16,43.8,21,7,14,50
11080, 성북구,102,15세미만,2017,50926,26168,24758,105.7,50541,25967,24574,105.7
11080, 성북구,103,15~64세,2017,331288,161599,169689,95.2,318801,156247,162554,96.1
11080, 성북구,104,65세이상,2017,63203,27301,35902,76,62884,27160,35724,76
11080, 성북구,086,85세이상,2017,4470,1293,3177,40.7,4456,1288,3168,40.7
11080, 성북구,126,평균연령,2017,41.1,40.3,41.8,,41.4,40.5,42.2,
11080, 성북구,127,중위연령,2017,41.2,40.4,41.9,,41.7,40.9,42.6,
11090, 강북구,000,합계,2017,313698,152464,161234,94.6,309255,150745,158510,95.1
11090, 강북구,005,0~4세,2017,9670,4919,4751,103.5,9609,4886,4723,103.5
11090, 강북구,005001, 0세,2017,1763,875,888,98.5,1749,869,880,98.8
11090, 강북구,005002, 1세,2017,1934,965,969,99.6,1923,959,964,99.5
11090, 강북구,005003, 2세,2017,1956,993,963,103.1,1943,987,956,103.2
11090, 강북구,005004, 3세,2017,1971,1005,966,104,1961,999,962,103.8
11090, 강북구,005005, 4세,2017,2046,1081,965,112,2033,1072,961,111.6
11090, 강북구,010,5~9세,2017,10514,5387,5127,105.1,10484,5378,5106,105.3
11090, 강북구,010001, 5세,2017,2168,1145,1023,111.9,2153,1138,1015,112.1
11090, 강북구,010002, 6세,2017,2130,1064,1066,99.8,2127,1064,1063,100.1
11090, 강북구,010003, 7세,2017,2076,1078,998,108,2070,1077,993,108.5
11090, 강북구,010004, 8세,2017,2053,1054,999,105.5,2051,1054,997,105.7
11090, 강북구,010005, 9세,2017,2087,1046,1041,100.5,2083,1045,1038,100.7
11090, 강북구,015,10~14세,2017,10846,5566,5280,105.4,10823,5555,5268,105.4
11090, 강북구,015001, 10세,2017,2128,1097,1031,106.4,2122,1094,1028,106.4
11090, 강북구,015002, 11세,2017,2079,1073,1006,106.7,2077,1072,1005,106.7
11090, 강북구,015003, 12세,2017,2065,1049,1016,103.2,2061,1049,1012,103.7
11090, 강북구,015004, 13세,2017,2184,1096,1088,100.7,2181,1095,1086,100.8
11090, 강북구,015005, 14세,2017,2390,1251,1139,109.8,2382,1245,1137,109.5
11090, 강북구,020,15~19세,2017,14891,7595,7296,104.1,14811,7564,7247,104.4
11090, 강북구,020001, 15세,2017,2379,1260,1119,112.6,2377,1259,1118,112.6
11090, 강북구,020002, 16세,2017,2767,1448,1319,109.8,2761,1446,1315,110
11090, 강북구,020003, 17세,2017,3141,1697,1444,117.5,3128,1690,1438,117.5
11090, 강북구,020004, 18세,2017,3110,1544,1566,98.6,3094,1540,1554,99.1
11090, 강북구,020005, 19세,2017,3494,1646,1848,89.1,3451,1629,1822,89.4
11090, 강북구,025,20~24세,2017,21210,10357,10853,95.4,20756,10215,10541,96.9
11090, 강북구,025001, 20세,2017,3890,1838,2052,89.6,3826,1814,2012,90.2
11090, 강북구,025002, 21세,2017,4110,2013,2097,96,4038,1993,2045,97.5
11090, 강북구,025003, 22세,2017,4242,2067,2175,95,4147,2039,2108,96.7
11090, 강북구,025004, 23세,2017,4469,2188,2281,95.9,4349,2150,2199,97.8
11090, 강북구,025005, 24세,2017,4499,2251,2248,100.1,4396,2219,2177,101.9
11090, 강북구,030,25~29세,2017,21689,10731,10958,97.9,20989,10487,10502,99.9
11090, 강북구,030001, 25세,2017,4745,2308,2437,94.7,4610,2259,2351,96.1
11090, 강북구,030002, 26세,2017,4547,2175,2372,91.7,4412,2125,2287,92.9
11090, 강북구,030003, 27세,2017,4208,2112,2096,100.8,4053,2056,1997,103
11090, 강북구,030004, 28세,2017,4203,2136,2067,103.3,4073,2094,1979,105.8
11090, 강북구,030005, 29세,2017,3986,2000,1986,100.7,3841,1953,1888,103.4
11090, 강북구,035,30~34세,2017,20727,10807,9920,108.9,20169,10603,9566,110.8
11090, 강북구,035001, 30세,2017,3853,1989,1864,106.7,3730,1946,1784,109.1
11090, 강북구,035002, 31세,2017,4079,2141,1938,110.5,3947,2093,1854,112.9
11090, 강북구,035003, 32세,2017,4040,2075,1965,105.6,3940,2043,1897,107.7
11090, 강북구,035004, 33세,2017,4238,2274,1964,115.8,4131,2234,1897,117.8
11090, 강북구,035005, 34세,2017,4517,2328,2189,106.3,4421,2287,2134,107.2
11090, 강북구,040,35~39세,2017,23655,12352,11303,109.3,23263,12179,11084,109.9
11090, 강북구,040001, 35세,2017,4921,2545,2376,107.1,4811,2497,2314,107.9
11090, 강북구,040002, 36세,2017,4877,2652,2225,119.2,4801,2619,2182,120
11090, 강북구,040003, 37세,2017,4995,2614,2381,109.8,4918,2577,2341,110.1
11090, 강북구,040004, 38세,2017,4705,2439,2266,107.6,4650,2416,2234,108.1
11090, 강북구,040005, 39세,2017,4157,2102,2055,102.3,4083,2070,2013,102.8
11090, 강북구,045,40~44세,2017,23507,12023,11484,104.7,23179,11886,11293,105.3
11090, 강북구,045001, 40세,2017,4410,2280,2130,107,4350,2255,2095,107.6
11090, 강북구,045002, 41세,2017,4297,2245,2052,109.4,4239,2222,2017,110.2
11090, 강북구,045003, 42세,2017,4570,2342,2228,105.1,4508,2321,2187,106.1
11090, 강북구,045004, 43세,2017,5033,2555,2478,103.1,4971,2526,2445,103.3
11090, 강북구,045005, 44세,2017,5197,2601,2596,100.2,5111,2562,2549,100.5
11090, 강북구,050,45~49세,2017,27238,13510,13728,98.4,26840,13337,13503,98.8
11090, 강북구,050001, 45세,2017,5297,2765,2532,109.2,5229,2737,2492,109.8
11090, 강북구,050002, 46세,2017,5598,2793,2805,99.6,5515,2757,2758,100
11090, 강북구,050003, 47세,2017,5431,2697,2734,98.6,5355,2669,2686,99.4
11090, 강북구,050004, 48세,2017,5497,2652,2845,93.2,5413,2613,2800,93.3
11090, 강북구,050005, 49세,2017,5415,2603,2812,92.6,5328,2561,2767,92.6
11090, 강북구,055,50~54세,2017,25061,12178,12883,94.5,24648,12021,12627,95.2
11090, 강북구,055001, 50세,2017,4976,2380,2596,91.7,4909,2356,2553,92.3
11090, 강북구,055002, 51세,2017,4773,2345,2428,96.6,4694,2314,2380,97.2
11090, 강북구,055003, 52세,2017,5124,2412,2712,88.9,5035,2374,2661,89.2
11090, 강북구,055004, 53세,2017,4918,2408,2510,95.9,4830,2382,2448,97.3
11090, 강북구,055005, 54세,2017,5270,2633,2637,99.8,5180,2595,2585,100.4
11090, 강북구,060,55~59세,2017,27541,12965,14576,88.9,27170,12820,14350,89.3
11090, 강북구,060001, 55세,2017,5241,2559,2682,95.4,5164,2533,2631,96.3
11090, 강북구,060002, 56세,2017,5790,2679,3111,86.1,5723,2653,3070,86.4
11090, 강북구,060003, 57세,2017,5931,2718,3213,84.6,5841,2686,3155,85.1
11090, 강북구,060004, 58세,2017,5374,2547,2827,90.1,5295,2512,2783,90.3
11090, 강북구,060005, 59세,2017,5205,2462,2743,89.8,5147,2436,2711,89.9
11090, 강북구,065,60~64세,2017,22863,10709,12154,88.1,22526,10561,11965,88.3
11090, 강북구,065001, 60세,2017,5081,2481,2600,95.4,4999,2441,2558,95.4
11090, 강북구,065002, 61세,2017,4779,2260,2519,89.7,4731,2238,2493,89.8
11090, 강북구,065003, 62세,2017,5021,2320,2701,85.9,4934,2289,2645,86.5
11090, 강북구,065004, 63세,2017,4283,1970,2313,85.2,4217,1938,2279,85
11090, 강북구,065005, 64세,2017,3699,1678,2021,83,3645,1655,1990,83.2
11090, 강북구,070,65~69세,2017,17988,8031,9957,80.7,17821,7962,9859,80.8
11090, 강북구,070001, 65세,2017,4192,1915,2277,84.1,4146,1896,2250,84.3
11090, 강북구,070002, 66세,2017,3146,1429,1717,83.2,3107,1413,1694,83.4
11090, 강북구,070003, 67세,2017,3388,1459,1929,75.6,3351,1446,1905,75.9
11090, 강북구,070004, 68세,2017,3681,1634,2047,79.8,3659,1623,2036,79.7
11090, 강북구,070005, 69세,2017,3581,1594,1987,80.2,3558,1584,1974,80.2
11090, 강북구,075,70~74세,2017,14915,6552,8363,78.3,14851,6529,8322,78.5
11090, 강북구,075001, 70세,2017,3644,1617,2027,79.8,3629,1613,2016,80
11090, 강북구,075002, 71세,2017,2807,1216,1591,76.4,2787,1209,1578,76.6
11090, 강북구,075003, 72세,2017,2812,1188,1624,73.2,2799,1185,1614,73.4
11090, 강북구,075004, 73세,2017,2792,1283,1509,85,2781,1276,1505,84.8
11090, 강북구,075005, 74세,2017,2860,1248,1612,77.4,2855,1246,1609,77.4
11090, 강북구,080,75~79세,2017,12074,5393,6681,80.7,12041,5382,6659,80.8
11090, 강북구,080001, 75세,2017,3318,1538,1780,86.4,3312,1536,1776,86.5
11090, 강북구,080002, 76세,2017,2630,1201,1429,84,2621,1198,1423,84.2
11090, 강북구,080003, 77세,2017,2197,990,1207,82,2191,988,1203,82.1
11090, 강북구,080004, 78세,2017,2102,881,1221,72.2,2096,878,1218,72.1
11090, 강북구,080005, 79세,2017,1827,783,1044,75,1821,782,1039,75.3
11090, 강북구,085,80~84세,2017,5939,2428,3511,69.2,5924,2424,3500,69.3
11090, 강북구,085001, 80세,2017,1562,680,882,77.1,1557,679,878,77.3
11090, 강북구,085002, 81세,2017,1460,608,852,71.4,1458,608,850,71.5
11090, 강북구,085003, 82세,2017,1191,482,709,68,1188,481,707,68
11090, 강북구,085004, 83세,2017,957,371,586,63.3,955,370,585,63.2
11090, 강북구,085005, 84세,2017,769,287,482,59.5,766,286,480,59.6
11090, 강북구,090,85~89세,2017,2382,731,1651,44.3,2370,729,1641,44.4
11090, 강북구,090001, 85세,2017,684,233,451,51.7,683,233,450,51.8
11090, 강북구,090002, 86세,2017,471,148,323,45.8,469,147,322,45.7
11090, 강북구,090003, 87세,2017,462,123,339,36.3,460,123,337,36.5
11090, 강북구,090004, 88세,2017,435,130,305,42.6,431,129,302,42.7
11090, 강북구,090005, 89세,2017,330,97,233,41.6,327,97,230,42.2
11090, 강북구,095,90~94세,2017,778,190,588,32.3,773,188,585,32.1
11090, 강북구,095001, 90세,2017,229,66,163,40.5,229,66,163,40.5
11090, 강북구,095002, 91세,2017,183,40,143,28,182,39,143,27.3
11090, 강북구,095003, 92세,2017,145,32,113,28.3,142,31,111,27.9
11090, 강북구,095004, 93세,2017,120,21,99,21.2,120,21,99,21.2
11090, 강북구,095005, 94세,2017,101,31,70,44.3,100,31,69,44.9
11090, 강북구,100,95~99세,2017,185,35,150,23.3,184,34,150,22.7
11090, 강북구,100001, 95세,2017,75,16,59,27.1,75,16,59,27.1
11090, 강북구,100002, 96세,2017,50,10,40,25,50,10,40,25
11090, 강북구,100003, 97세,2017,29,5,24,20.8,29,5,24,20.8
11090, 강북구,100004, 98세,2017,19,X,18,5.6,19,X,18,5.6
11090, 강북구,100005, 99세,2017,12,X,9,33.3,11,X,9,22.2
11090, 강북구,101,100세이상,2017,25,5,20,25,24,5,19,26.3
11090, 강북구,102,15세미만,2017,31030,15872,15158,104.7,30916,15819,15097,104.8
11090, 강북구,103,15~64세,2017,228382,113227,115155,98.3,224351,111673,112678,99.1
11090, 강북구,104,65세이상,2017,54286,23365,30921,75.6,53988,23253,30735,75.7
11090, 강북구,086,85세이상,2017,3370,961,2409,39.9,3351,956,2395,39.9
11090, 강북구,126,평균연령,2017,43.9,42.8,45,,43.9,42.8,45,
11090, 강북구,127,중위연령,2017,45,43.6,46.4,,45.1,43.7,46.5,
11100, 도봉구,000,합계,2017,332586,161944,170642,94.9,329957,160885,169072,95.2
11100, 도봉구,005,0~4세,2017,11070,5676,5394,105.2,11021,5651,5370,105.2
11100, 도봉구,005001, 0세,2017,1931,972,959,101.4,1918,967,951,101.7
11100, 도봉구,005002, 1세,2017,2216,1133,1083,104.6,2203,1127,1076,104.7
11100, 도봉구,005003, 2세,2017,2362,1217,1145,106.3,2352,1210,1142,106
11100, 도봉구,005004, 3세,2017,2329,1182,1147,103.1,2323,1178,1145,102.9
11100, 도봉구,005005, 4세,2017,2232,1172,1060,110.6,2225,1169,1056,110.7
11100, 도봉구,010,5~9세,2017,12029,6217,5812,107,12011,6206,5805,106.9
11100, 도봉구,010001, 5세,2017,2508,1310,1198,109.3,2504,1308,1196,109.4
11100, 도봉구,010002, 6세,2017,2450,1249,1201,104,2444,1245,1199,103.8
11100, 도봉구,010003, 7세,2017,2394,1222,1172,104.3,2391,1220,1171,104.2
11100, 도봉구,010004, 8세,2017,2313,1198,1115,107.4,2310,1195,1115,107.2
11100, 도봉구,010005, 9세,2017,2364,1238,1126,109.9,2362,1238,1124,110.1
11100, 도봉구,015,10~14세,2017,12821,6596,6225,106,12804,6588,6216,106
11100, 도봉구,015001, 10세,2017,2696,1400,1296,108,2692,1398,1294,108
11100, 도봉구,015002, 11세,2017,2377,1236,1141,108.3,2375,1235,1140,108.3
11100, 도봉구,015003, 12세,2017,2284,1151,1133,101.6,2279,1148,1131,101.5
11100, 도봉구,015004, 13세,2017,2763,1426,1337,106.7,2762,1426,1336,106.7
11100, 도봉구,015005, 14세,2017,2701,1383,1318,104.9,2696,1381,1315,105
11100, 도봉구,020,15~19세,2017,17489,8832,8657,102,17417,8810,8607,102.4
11100, 도봉구,020001, 15세,2017,2910,1487,1423,104.5,2908,1485,1423,104.4
11100, 도봉구,020002, 16세,2017,3305,1753,1552,113,3300,1751,1549,113
11100, 도봉구,020003, 17세,2017,3695,1885,1810,104.1,3690,1883,1807,104.2
11100, 도봉구,020004, 18세,2017,3730,1912,1818,105.2,3708,1904,1804,105.5
11100, 도봉구,020005, 19세,2017,3849,1795,2054,87.4,3811,1787,2024,88.3
11100, 도봉구,025,20~24세,2017,22740,11402,11338,100.6,22468,11314,11154,101.4
11100, 도봉구,025001, 20세,2017,4383,2182,2201,99.1,4338,2171,2167,100.2
11100, 도봉구,025002, 21세,2017,4440,2257,2183,103.4,4391,2243,2148,104.4
11100, 도봉구,025003, 22세,2017,4500,2291,2209,103.7,4455,2276,2179,104.5
11100, 도봉구,025004, 23세,2017,4566,2265,2301,98.4,4504,2242,2262,99.1
11100, 도봉구,025005, 24세,2017,4851,2407,2444,98.5,4780,2382,2398,99.3
11100, 도봉구,030,25~29세,2017,22184,11030,11154,98.9,21805,10891,10914,99.8
11100, 도봉구,030001, 25세,2017,4834,2340,2494,93.8,4765,2323,2442,95.1
11100, 도봉구,030002, 26세,2017,4579,2296,2283,100.6,4511,2269,2242,101.2
11100, 도봉구,030003, 27세,2017,4356,2174,2182,99.6,4280,2146,2134,100.6
11100, 도봉구,030004, 28세,2017,4240,2121,2119,100.1,4157,2088,2069,100.9
11100, 도봉구,030005, 29세,2017,4175,2099,2076,101.1,4092,2065,2027,101.9
11100, 도봉구,035,30~34세,2017,21428,11080,10348,107.1,21075,10942,10133,108
11100, 도봉구,035001, 30세,2017,4020,2047,1973,103.8,3953,2032,1921,105.8
11100, 도봉구,035002, 31세,2017,4173,2170,2003,108.3,4097,2128,1969,108.1
11100, 도봉구,035003, 32세,2017,4234,2151,2083,103.3,4157,2124,2033,104.5
11100, 도봉구,035004, 33세,2017,4340,2233,2107,106,4269,2206,2063,106.9
11100, 도봉구,035005, 34세,2017,4661,2479,2182,113.6,4599,2452,2147,114.2
11100, 도봉구,040,35~39세,2017,24202,12215,11987,101.9,23935,12096,11839,102.2
11100, 도봉구,040001, 35세,2017,5077,2567,2510,102.3,5016,2535,2481,102.2
11100, 도봉구,040002, 36세,2017,5011,2529,2482,101.9,4953,2506,2447,102.4
11100, 도봉구,040003, 37세,2017,5035,2530,2505,101,4994,2515,2479,101.5
11100, 도봉구,040004, 38세,2017,4776,2421,2355,102.8,4725,2397,2328,103
11100, 도봉구,040005, 39세,2017,4303,2168,2135,101.5,4247,2143,2104,101.9
11100, 도봉구,045,40~44세,2017,24265,12011,12254,98,24064,11925,12139,98.2
11100, 도봉구,045001, 40세,2017,4480,2277,2203,103.4,4444,2259,2185,103.4
11100, 도봉구,045002, 41세,2017,4435,2228,2207,101,4388,2211,2177,101.6
11100, 도봉구,045003, 42세,2017,4720,2294,2426,94.6,4685,2281,2404,94.9
11100, 도봉구,045004, 43세,2017,5148,2577,2571,100.2,5105,2559,2546,100.5
11100, 도봉구,045005, 44세,2017,5482,2635,2847,92.6,5442,2615,2827,92.5
11100, 도봉구,050,45~49세,2017,29293,14148,15145,93.4,29051,14044,15007,93.6
11100, 도봉구,050001, 45세,2017,5532,2770,2762,100.3,5481,2740,2741,100
11100, 도봉구,050002, 46세,2017,5970,2872,3098,92.7,5918,2849,3069,92.8
11100, 도봉구,050003, 47세,2017,5878,2883,2995,96.3,5835,2868,2967,96.7
11100, 도봉구,050004, 48세,2017,5897,2779,3118,89.1,5853,2758,3095,89.1
11100, 도봉구,050005, 49세,2017,6016,2844,3172,89.7,5964,2829,3135,90.2
11100, 도봉구,055,50~54세,2017,27485,13182,14303,92.2,27267,13083,14184,92.2
11100, 도봉구,055001, 50세,2017,5479,2559,2920,87.6,5443,2541,2902,87.6
11100, 도봉구,055002, 51세,2017,5438,2659,2779,95.7,5394,2647,2747,96.4
11100, 도봉구,055003, 52세,2017,5553,2608,2945,88.6,5501,2582,2919,88.5
11100, 도봉구,055004, 53세,2017,5338,2564,2774,92.4,5299,2542,2757,92.2
11100, 도봉구,055005, 54세,2017,5677,2792,2885,96.8,5630,2771,2859,96.9
11100, 도봉구,060,55~59세,2017,30631,14379,16252,88.5,30457,14312,16145,88.6
11100, 도봉구,060001, 55세,2017,5945,2837,3108,91.3,5907,2826,3081,91.7
11100, 도봉구,060002, 56세,2017,6351,2943,3408,86.4,6320,2931,3389,86.5
11100, 도봉구,060003, 57세,2017,6560,3055,3505,87.2,6516,3031,3485,87
11100, 도봉구,060004, 58세,2017,5989,2817,3172,88.8,5960,2810,3150,89.2
11100, 도봉구,060005, 59세,2017,5786,2727,3059,89.1,5754,2714,3040,89.3
11100, 도봉구,065,60~64세,2017,24878,12106,12772,94.8,24690,12026,12664,95
11100, 도봉구,065001, 60세,2017,5825,2862,2963,96.6,5778,2840,2938,96.7
11100, 도봉구,065002, 61세,2017,5265,2512,2753,91.2,5221,2492,2729,91.3
11100, 도봉구,065003, 62세,2017,5467,2601,2866,90.8,5433,2587,2846,90.9
11100, 도봉구,065004, 63세,2017,4463,2209,2254,98,4426,2196,2230,98.5
11100, 도봉구,065005, 64세,2017,3858,1922,1936,99.3,3832,1911,1921,99.5
11100, 도봉구,070,65~69세,2017,17270,8338,8932,93.3,17177,8295,8882,93.4
11100, 도봉구,070001, 65세,2017,4251,2068,2183,94.7,4217,2052,2165,94.8
11100, 도봉구,070002, 66세,2017,3047,1450,1597,90.8,3026,1445,1581,91.4
11100, 도봉구,070003, 67세,2017,3340,1608,1732,92.8,3324,1597,1727,92.5
11100, 도봉구,070004, 68세,2017,3289,1589,1700,93.5,3276,1582,1694,93.4
11100, 도봉구,070005, 69세,2017,3343,1623,1720,94.4,3334,1619,1715,94.4
11100, 도봉구,075,70~74세,2017,13504,6225,7279,85.5,13462,6210,7252,85.6
11100, 도봉구,075001, 70세,2017,3328,1533,1795,85.4,3317,1528,1789,85.4
11100, 도봉구,075002, 71세,2017,2565,1207,1358,88.9,2559,1205,1354,89
11100, 도봉구,075003, 72세,2017,2540,1178,1362,86.5,2528,1173,1355,86.6
11100, 도봉구,075004, 73세,2017,2500,1151,1349,85.3,2493,1149,1344,85.5
11100, 도봉구,075005, 74세,2017,2571,1156,1415,81.7,2565,1155,1410,81.9
11100, 도봉구,080,75~79세,2017,11178,5002,6176,81,11154,4992,6162,81
11100, 도봉구,080001, 75세,2017,2955,1384,1571,88.1,2953,1383,1570,88.1
11100, 도봉구,080002, 76세,2017,2391,1109,1282,86.5,2384,1106,1278,86.5
11100, 도봉구,080003, 77세,2017,2055,896,1159,77.3,2051,894,1157,77.3
11100, 도봉구,080004, 78세,2017,2038,869,1169,74.3,2034,868,1166,74.4
11100, 도봉구,080005, 79세,2017,1739,744,995,74.8,1732,741,991,74.8
11100, 도봉구,085,80~84세,2017,6059,2317,3742,61.9,6050,2315,3735,62
11100, 도봉구,085001, 80세,2017,1548,632,916,69,1545,631,914,69
11100, 도봉구,085002, 81세,2017,1350,535,815,65.6,1348,534,814,65.6
11100, 도봉구,085003, 82세,2017,1245,481,764,63,1242,481,761,63.2
11100, 도봉구,085004, 83세,2017,1019,357,662,53.9,1018,357,661,54
11100, 도봉구,085005, 84세,2017,897,312,585,53.3,897,312,585,53.3
11100, 도봉구,090,85~89세,2017,2862,884,1978,44.7,2858,884,1974,44.8
11100, 도봉구,090001, 85세,2017,809,252,557,45.2,809,252,557,45.2
11100, 도봉구,090002, 86세,2017,623,203,420,48.3,621,203,418,48.6
11100, 도봉구,090003, 87세,2017,532,158,374,42.2,531,158,373,42.4
11100, 도봉구,090004, 88세,2017,499,158,341,46.3,498,158,340,46.5
11100, 도봉구,090005, 89세,2017,399,113,286,39.5,399,113,286,39.5
11100, 도봉구,095,90~94세,2017,967,256,711,36,963,255,708,36
11100, 도봉구,095001, 90세,2017,322,102,220,46.4,322,102,220,46.4
11100, 도봉구,095002, 91세,2017,208,60,148,40.5,206,60,146,41.1
11100, 도봉구,095003, 92세,2017,180,31,149,20.8,179,31,148,20.9
11100, 도봉구,095004, 93세,2017,122,28,94,29.8,122,28,94,29.8
11100, 도봉구,095005, 94세,2017,135,35,100,35,134,34,100,34
11100, 도봉구,100,95~99세,2017,202,43,159,27,200,42,158,26.6
11100, 도봉구,100001, 95세,2017,79,15,64,23.4,79,15,64,23.4
11100, 도봉구,100002, 96세,2017,57,16,41,39,56,16,40,40
11100, 도봉구,100003, 97세,2017,34,X,31,9.7,34,X,31,9.7
11100, 도봉구,100004, 98세,2017,19,6,13,46.2,19,6,13,46.2
11100, 도봉구,100005, 99세,2017,13,X,10,30,12,X,10,20
11100, 도봉구,101,100세이상,2017,29,5,24,20.8,28,X,24,16.7
11100, 도봉구,102,15세미만,2017,35920,18489,17431,106.1,35836,18445,17391,106.1
11100, 도봉구,103,15~64세,2017,244595,120385,124210,96.9,242229,119443,122786,97.3
11100, 도봉구,104,65세이상,2017,52071,23070,29001,79.5,51892,22997,28895,79.6
11100, 도봉구,086,85세이상,2017,4060,1188,2872,41.4,4049,1185,2864,41.4
11100, 도봉구,126,평균연령,2017,43.2,42.2,44.1,,43.2,42.2,44.2,
11100, 도봉구,127,중위연령,2017,44.6,43.4,45.8,,44.7,43.5,45.9,
11110, 노원구,000,합계,2017,543499,263655,279844,94.2,538768,261563,277205,94.4
11110, 노원구,005,0~4세,2017,19139,9783,9356,104.6,19081,9757,9324,104.6
11110, 노원구,005001, 0세,2017,3497,1747,1750,99.8,3483,1741,1742,99.9
11110, 노원구,005002, 1세,2017,3877,2013,1864,108,3867,2005,1862,107.7
11110, 노원구,005003, 2세,2017,4024,2075,1949,106.5,4014,2073,1941,106.8
11110, 노원구,005004, 3세,2017,3891,1991,1900,104.8,3877,1986,1891,105
11110, 노원구,005005, 4세,2017,3850,1957,1893,103.4,3840,1952,1888,103.4
11110, 노원구,010,5~9세,2017,21520,11022,10498,105,21484,10999,10485,104.9
11110, 노원구,010001, 5세,2017,4241,2182,2059,106,4231,2177,2054,106
11110, 노원구,010002, 6세,2017,4176,2114,2062,102.5,4169,2110,2059,102.5
11110, 노원구,010003, 7세,2017,4221,2174,2047,106.2,4214,2169,2045,106.1
11110, 노원구,010004, 8세,2017,4162,2126,2036,104.4,4154,2120,2034,104.2
11110, 노원구,010005, 9세,2017,4720,2426,2294,105.8,4716,2423,2293,105.7
11110, 노원구,015,10~14세,2017,26318,13689,12629,108.4,26299,13681,12618,108.4
11110, 노원구,015001, 10세,2017,4974,2562,2412,106.2,4970,2559,2411,106.1
11110, 노원구,015002, 11세,2017,4800,2528,2272,111.3,4796,2527,2269,111.4
11110, 노원구,015003, 12세,2017,5056,2620,2436,107.6,5053,2619,2434,107.6
11110, 노원구,015004, 13세,2017,5676,2933,2743,106.9,5672,2932,2740,107
11110, 노원구,015005, 14세,2017,5812,3046,2766,110.1,5808,3044,2764,110.1
11110, 노원구,020,15~19세,2017,36663,18949,17714,107,36391,18822,17569,107.1
11110, 노원구,020001, 15세,2017,6143,3159,2984,105.9,6139,3158,2981,105.9
11110, 노원구,020002, 16세,2017,6856,3623,3233,112.1,6847,3615,3232,111.9
11110, 노원구,020003, 17세,2017,7610,4046,3564,113.5,7577,4032,3545,113.7
11110, 노원구,020004, 18세,2017,7605,3901,3704,105.3,7519,3858,3661,105.4
11110, 노원구,020005, 19세,2017,8449,4220,4229,99.8,8309,4159,4150,100.2
11110, 노원구,025,20~24세,2017,42863,21916,20947,104.6,41938,21508,20430,105.3
11110, 노원구,025001, 20세,2017,8579,4133,4446,93,8355,4041,4314,93.7
11110, 노원구,025002, 21세,2017,8348,4118,4230,97.4,8167,4032,4135,97.5
11110, 노원구,025003, 22세,2017,8781,4509,4272,105.5,8615,4442,4173,106.4
11110, 노원구,025004, 23세,2017,8675,4586,4089,112.2,8490,4512,3978,113.4
11110, 노원구,025005, 24세,2017,8480,4570,3910,116.9,8311,4481,3830,117
11110, 노원구,030,25~29세,2017,34403,17717,16686,106.2,33640,17391,16249,107
11110, 노원구,030001, 25세,2017,7985,4284,3701,115.8,7831,4213,3618,116.4
11110, 노원구,030002, 26세,2017,7288,3767,3521,107,7114,3690,3424,107.8
11110, 노원구,030003, 27세,2017,6689,3464,3225,107.4,6530,3396,3134,108.4
11110, 노원구,030004, 28세,2017,6307,3182,3125,101.8,6168,3126,3042,102.8
11110, 노원구,030005, 29세,2017,6134,3020,3114,97,5997,2966,3031,97.9
11110, 노원구,035,30~34세,2017,33386,16484,16902,97.5,32828,16251,16577,98
11110, 노원구,035001, 30세,2017,6145,3046,3099,98.3,6007,2996,3011,99.5
11110, 노원구,035002, 31세,2017,6440,3135,3305,94.9,6318,3083,3235,95.3
11110, 노원구,035003, 32세,2017,6535,3244,3291,98.6,6422,3199,3223,99.3
11110, 노원구,035004, 33세,2017,6742,3322,3420,97.1,6654,3280,3374,97.2
11110, 노원구,035005, 34세,2017,7524,3737,3787,98.7,7427,3693,3734,98.9
11110, 노원구,040,35~39세,2017,39805,19797,20008,98.9,39392,19615,19777,99.2
11110, 노원구,040001, 35세,2017,8065,4020,4045,99.4,7971,3982,3989,99.8
11110, 노원구,040002, 36세,2017,8108,4129,3979,103.8,8017,4089,3928,104.1
11110, 노원구,040003, 37세,2017,8317,4072,4245,95.9,8237,4039,4198,96.2
11110, 노원구,040004, 38세,2017,7975,3956,4019,98.4,7903,3925,3978,98.7
11110, 노원구,040005, 39세,2017,7340,3620,3720,97.3,7264,3580,3684,97.2
11110, 노원구,045,40~44세,2017,43094,20522,22572,90.9,42746,20352,22394,90.9
11110, 노원구,045001, 40세,2017,7748,3688,4060,90.8,7681,3656,4025,90.8
11110, 노원구,045002, 41세,2017,7624,3697,3927,94.1,7560,3666,3894,94.1
11110, 노원구,045003, 42세,2017,8489,3967,4522,87.7,8411,3925,4486,87.5
11110, 노원구,045004, 43세,2017,9383,4475,4908,91.2,9315,4442,4873,91.2
11110, 노원구,045005, 44세,2017,9850,4695,5155,91.1,9779,4663,5116,91.1
11110, 노원구,050,45~49세,2017,52511,25197,27314,92.2,52124,25008,27116,92.2
11110, 노원구,050001, 45세,2017,10069,4766,5303,89.9,9995,4724,5271,89.6
11110, 노원구,050002, 46세,2017,11096,5303,5793,91.5,11022,5267,5755,91.5
11110, 노원구,050003, 47세,2017,10618,5079,5539,91.7,10532,5037,5495,91.7
11110, 노원구,050004, 48세,2017,10513,5126,5387,95.2,10437,5092,5345,95.3
11110, 노원구,050005, 49세,2017,10215,4923,5292,93,10138,4888,5250,93.1
11110, 노원구,055,50~54세,2017,43850,21467,22383,95.9,43495,21315,22180,96.1
11110, 노원구,055001, 50세,2017,9257,4522,4735,95.5,9182,4483,4699,95.4
11110, 노원구,055002, 51세,2017,8754,4390,4364,100.6,8682,4353,4329,100.6
11110, 노원구,055003, 52세,2017,8840,4269,4571,93.4,8771,4243,4528,93.7
11110, 노원구,055004, 53세,2017,8293,4136,4157,99.5,8220,4105,4115,99.8
11110, 노원구,055005, 54세,2017,8706,4150,4556,91.1,8640,4131,4509,91.6
11110, 노원구,060,55~59세,2017,43849,20965,22884,91.6,43629,20882,22747,91.8
11110, 노원구,060001, 55세,2017,8779,4308,4471,96.4,8723,4287,4436,96.6
11110, 노원구,060002, 56세,2017,9274,4478,4796,93.4,9232,4466,4766,93.7
11110, 노원구,060003, 57세,2017,9348,4382,4966,88.2,9301,4365,4936,88.4
11110, 노원구,060004, 58세,2017,8357,3928,4429,88.7,8319,3915,4404,88.9
11110, 노원구,060005, 59세,2017,8091,3869,4222,91.6,8054,3849,4205,91.5
11110, 노원구,065,60~64세,2017,34479,16310,18169,89.8,34290,16230,18060,89.9
11110, 노원구,065001, 60세,2017,7932,3770,4162,90.6,7885,3743,4142,90.4
11110, 노원구,065002, 61세,2017,7284,3420,3864,88.5,7247,3410,3837,88.9
11110, 노원구,065003, 62세,2017,7521,3476,4045,85.9,7482,3462,4020,86.1
11110, 노원구,065004, 63세,2017,6324,3024,3300,91.6,6284,3007,3277,91.8
11110, 노원구,065005, 64세,2017,5418,2620,2798,93.6,5392,2608,2784,93.7
11110, 노원구,070,65~69세,2017,23815,11113,12702,87.5,23726,11071,12655,87.5
11110, 노원구,070001, 65세,2017,5948,2845,3103,91.7,5912,2829,3083,91.8
11110, 노원구,070002, 66세,2017,4175,1953,2222,87.9,4156,1944,2212,87.9
11110, 노원구,070003, 67세,2017,4623,2161,2462,87.8,4612,2157,2455,87.9
11110, 노원구,070004, 68세,2017,4637,2118,2519,84.1,4620,2108,2512,83.9
11110, 노원구,070005, 69세,2017,4432,2036,2396,85,4426,2033,2393,85
11110, 노원구,075,70~74세,2017,17972,7850,10122,77.6,17927,7828,10099,77.5
11110, 노원구,075001, 70세,2017,4466,1979,2487,79.6,4455,1973,2482,79.5
11110, 노원구,075002, 71세,2017,3499,1515,1984,76.4,3489,1508,1981,76.1
11110, 노원구,075003, 72세,2017,3276,1472,1804,81.6,3270,1470,1800,81.7
11110, 노원구,075004, 73세,2017,3292,1399,1893,73.9,3282,1394,1888,73.8
11110, 노원구,075005, 74세,2017,3439,1485,1954,76,3431,1483,1948,76.1
11110, 노원구,080,75~79세,2017,15167,6239,8928,69.9,15140,6230,8910,69.9
11110, 노원구,080001, 75세,2017,3918,1703,2215,76.9,3910,1699,2211,76.8
11110, 노원구,080002, 76세,2017,3116,1253,1863,67.3,3113,1253,1860,67.4
11110, 노원구,080003, 77세,2017,2896,1233,1663,74.1,2889,1230,1659,74.1
11110, 노원구,080004, 78세,2017,2747,1114,1633,68.2,2743,1114,1629,68.4
11110, 노원구,080005, 79세,2017,2490,936,1554,60.2,2485,934,1551,60.2
11110, 노원구,085,80~84세,2017,8840,3034,5806,52.3,8828,3029,5799,52.2
11110, 노원구,085001, 80세,2017,2249,837,1412,59.3,2247,836,1411,59.2
11110, 노원구,085002, 81세,2017,1907,684,1223,55.9,1904,683,1221,55.9
11110, 노원구,085003, 82세,2017,1867,600,1267,47.4,1865,599,1266,47.3
11110, 노원구,085004, 83세,2017,1544,498,1046,47.6,1541,497,1044,47.6
11110, 노원구,085005, 84세,2017,1273,415,858,48.4,1271,414,857,48.3
11110, 노원구,090,85~89세,2017,4126,1233,2893,42.6,4115,1227,2888,42.5
11110, 노원구,090001, 85세,2017,1150,368,782,47.1,1145,366,779,47
11110, 노원구,090002, 86세,2017,902,268,634,42.3,901,268,633,42.3
11110, 노원구,090003, 87세,2017,848,249,599,41.6,848,249,599,41.6
11110, 노원구,090004, 88세,2017,667,202,465,43.4,664,199,465,42.8
11110, 노원구,090005, 89세,2017,559,146,413,35.4,557,145,412,35.2
11110, 노원구,095,90~94세,2017,1336,289,1047,27.6,1335,289,1046,27.6
11110, 노원구,095001, 90세,2017,418,89,329,27.1,417,89,328,27.1
11110, 노원구,095002, 91세,2017,322,66,256,25.8,322,66,256,25.8
11110, 노원구,095003, 92세,2017,242,54,188,28.7,242,54,188,28.7
11110, 노원구,095004, 93세,2017,193,44,149,29.5,193,44,149,29.5
11110, 노원구,095005, 94세,2017,161,36,125,28.8,161,36,125,28.8
11110, 노원구,100,95~99세,2017,324,76,248,30.6,323,75,248,30.2
11110, 노원구,100001, 95세,2017,114,27,87,31,114,27,87,31
11110, 노원구,100002, 96세,2017,82,18,64,28.1,81,17,64,26.6
11110, 노원구,100003, 97세,2017,66,22,44,50,66,22,44,50
11110, 노원구,100004, 98세,2017,40,9,31,29,40,9,31,29
11110, 노원구,100005, 99세,2017,22,X,22,0,22,X,22,0
11110, 노원구,101,100세이상,2017,39,X,36,8.3,37,X,34,8.8
11110, 노원구,102,15세미만,2017,66977,34494,32483,106.2,66864,34437,32427,106.2
11110, 노원구,103,15~64세,2017,404903,199324,205579,97,400473,197374,203099,97.2
11110, 노원구,104,65세이상,2017,71619,29837,41782,71.4,71431,29752,41679,71.4
11110, 노원구,086,85세이상,2017,5825,1601,4224,37.9,5810,1594,4216,37.8
11110, 노원구,126,평균연령,2017,41,39.7,42.2,,41.1,39.8,42.3,
11110, 노원구,127,중위연령,2017,42.3,40.7,43.5,,42.4,40.8,43.7,
11120, 은평구,000,합계,2017,466243,225813,240430,93.9,460651,223388,237263,94.2
11120, 은평구,005,0~4세,2017,16641,8554,8087,105.8,16539,8510,8029,106
11120, 은평구,005001, 0세,2017,2954,1515,1439,105.3,2930,1503,1427,105.3
11120, 은평구,005002, 1세,2017,3354,1723,1631,105.6,3334,1713,1621,105.7
11120, 은평구,005003, 2세,2017,3538,1771,1767,100.2,3521,1764,1757,100.4
11120, 은평구,005004, 3세,2017,3363,1736,1627,106.7,3343,1730,1613,107.3
11120, 은평구,005005, 4세,2017,3432,1809,1623,111.5,3411,1800,1611,111.7
11120, 은평구,010,5~9세,2017,18184,9382,8802,106.6,18122,9347,8775,106.5
11120, 은평구,010001, 5세,2017,3796,1979,1817,108.9,3773,1964,1809,108.6
11120, 은평구,010002, 6세,2017,3633,1849,1784,103.6,3626,1847,1779,103.8
11120, 은평구,010003, 7세,2017,3558,1836,1722,106.6,3549,1829,1720,106.3
11120, 은평구,010004, 8세,2017,3549,1832,1717,106.7,3539,1828,1711,106.8
11120, 은평구,010005, 9세,2017,3648,1886,1762,107,3635,1879,1756,107
11120, 은평구,015,10~14세,2017,18750,9735,9015,108,18693,9706,8987,108
11120, 은평구,015001, 10세,2017,3853,2030,1823,111.4,3845,2025,1820,111.3
11120, 은평구,015002, 11세,2017,3586,1833,1753,104.6,3580,1831,1749,104.7
11120, 은평구,015003, 12세,2017,3377,1787,1590,112.4,3373,1785,1588,112.4
11120, 은평구,015004, 13세,2017,3895,1987,1908,104.1,3882,1979,1903,104
11120, 은평구,015005, 14세,2017,4039,2098,1941,108.1,4013,2086,1927,108.3
11120, 은평구,020,15~19세,2017,24306,12337,11969,103.1,24104,12241,11863,103.2
11120, 은평구,020001, 15세,2017,4192,2143,2049,104.6,4159,2126,2033,104.6
11120, 은평구,020002, 16세,2017,4619,2327,2292,101.5,4583,2313,2270,101.9
11120, 은평구,020003, 17세,2017,5486,2800,2686,104.2,5443,2772,2671,103.8
11120, 은평구,020004, 18세,2017,5176,2661,2515,105.8,5133,2638,2495,105.7
11120, 은평구,020005, 19세,2017,4833,2406,2427,99.1,4786,2392,2394,99.9
11120, 은평구,025,20~24세,2017,29105,14604,14501,100.7,28702,14448,14254,101.4
11120, 은평구,025001, 20세,2017,5333,2694,2639,102.1,5299,2685,2614,102.7
11120, 은평구,025002, 21세,2017,5610,2898,2712,106.9,5562,2885,2677,107.8
11120, 은평구,025003, 22세,2017,5820,2996,2824,106.1,5739,2969,2770,107.2
11120, 은평구,025004, 23세,2017,5990,2942,3048,96.5,5870,2885,2985,96.6
11120, 은평구,025005, 24세,2017,6352,3074,3278,93.8,6232,3024,3208,94.3
11120, 은평구,030,25~29세,2017,31789,15396,16393,93.9,31074,15114,15960,94.7
11120, 은평구,030001, 25세,2017,6635,3198,3437,93,6510,3143,3367,93.3
11120, 은평구,030002, 26세,2017,6577,3207,3370,95.2,6442,3156,3286,96
11120, 은평구,030003, 27세,2017,6359,3044,3315,91.8,6207,2991,3216,93
11120, 은평구,030004, 28세,2017,6153,2987,3166,94.3,6017,2937,3080,95.4
11120, 은평구,030005, 29세,2017,6065,2960,3105,95.3,5898,2887,3011,95.9
11120, 은평구,035,30~34세,2017,32755,16126,16629,97,32003,15808,16195,97.6
11120, 은평구,035001, 30세,2017,6151,3002,3149,95.3,5978,2926,3052,95.9
11120, 은평구,035002, 31세,2017,6210,3003,3207,93.6,6047,2932,3115,94.1
11120, 은평구,035003, 32세,2017,6393,3140,3253,96.5,6247,3082,3165,97.4
11120, 은평구,035004, 33세,2017,6650,3279,3371,97.3,6519,3222,3297,97.7
11120, 은평구,035005, 34세,2017,7351,3702,3649,101.5,7212,3646,3566,102.2
11120, 은평구,040,35~39세,2017,38384,19389,18995,102.1,37804,19124,18680,102.4
11120, 은평구,040001, 35세,2017,7975,4066,3909,104,7838,3998,3840,104.1
11120, 은평구,040002, 36세,2017,8023,4047,3976,101.8,7907,3996,3911,102.2
11120, 은평구,040003, 37세,2017,8193,4198,3995,105.1,8080,4150,3930,105.6
11120, 은평구,040004, 38세,2017,7552,3799,3753,101.2,7423,3740,3683,101.5
11120, 은평구,040005, 39세,2017,6641,3279,3362,97.5,6556,3240,3316,97.7
11120, 은평구,045,40~44세,2017,37557,18844,18713,100.7,37111,18617,18494,100.7
11120, 은평구,045001, 40세,2017,7121,3579,3542,101,7039,3537,3502,101
11120, 은평구,045002, 41세,2017,6979,3509,3470,101.1,6888,3463,3425,101.1
11120, 은평구,045003, 42세,2017,7284,3638,3646,99.8,7182,3589,3593,99.9
11120, 은평구,045004, 43세,2017,7987,3995,3992,100.1,7908,3955,3953,100.1
11120, 은평구,045005, 44세,2017,8186,4123,4063,101.5,8094,4073,4021,101.3
11120, 은평구,050,45~49세,2017,41393,20279,21114,96,40877,20053,20824,96.3
11120, 은평구,050001, 45세,2017,8266,4123,4143,99.5,8171,4077,4094,99.6
11120, 은평구,050002, 46세,2017,8735,4301,4434,97,8633,4260,4373,97.4
11120, 은평구,050003, 47세,2017,8160,3947,4213,93.7,8055,3897,4158,93.7
11120, 은평구,050004, 48세,2017,8230,4055,4175,97.1,8127,4005,4122,97.2
11120, 은평구,050005, 49세,2017,8002,3853,4149,92.9,7891,3814,4077,93.5
11120, 은평구,055,50~54세,2017,35903,17241,18662,92.4,35413,17032,18381,92.7
11120, 은평구,055001, 50세,2017,7288,3503,3785,92.5,7213,3469,3744,92.7
11120, 은평구,055002, 51세,2017,7050,3437,3613,95.1,6968,3402,3566,95.4
11120, 은평구,055003, 52세,2017,7212,3387,3825,88.5,7115,3347,3768,88.8
11120, 은평구,055004, 53세,2017,7018,3401,3617,94,6910,3357,3553,94.5
11120, 은평구,055005, 54세,2017,7335,3513,3822,91.9,7207,3457,3750,92.2
11120, 은평구,060,55~59세,2017,38659,18223,20436,89.2,38208,18027,20181,89.3
11120, 은평구,060001, 55세,2017,7571,3681,3890,94.6,7471,3631,3840,94.6
11120, 은평구,060002, 56세,2017,8007,3764,4243,88.7,7928,3734,4194,89
11120, 은평구,060003, 57세,2017,8235,3772,4463,84.5,8146,3733,4413,84.6
11120, 은평구,060004, 58세,2017,7660,3617,4043,89.5,7557,3571,3986,89.6
11120, 은평구,060005, 59세,2017,7186,3389,3797,89.3,7106,3358,3748,89.6
11120, 은평구,065,60~64세,2017,31708,14733,16975,86.8,31289,14560,16729,87
11120, 은평구,065001, 60세,2017,7079,3283,3796,86.5,6983,3249,3734,87
11120, 은평구,065002, 61세,2017,6702,3176,3526,90.1,6610,3140,3470,90.5
11120, 은평구,065003, 62세,2017,6819,3215,3604,89.2,6734,3178,3556,89.4
11120, 은평구,065004, 63세,2017,5885,2691,3194,84.3,5804,2657,3147,84.4
11120, 은평구,065005, 64세,2017,5223,2368,2855,82.9,5158,2336,2822,82.8
11120, 은평구,070,65~69세,2017,23512,10810,12702,85.1,23297,10715,12582,85.2
11120, 은평구,070001, 65세,2017,5446,2596,2850,91.1,5372,2562,2810,91.2
11120, 은평구,070002, 66세,2017,4101,1850,2251,82.2,4061,1830,2231,82
11120, 은평구,070003, 67세,2017,4584,2111,2473,85.4,4554,2102,2452,85.7
11120, 은평구,070004, 68세,2017,4699,2120,2579,82.2,4662,2104,2558,82.3
11120, 은평구,070005, 69세,2017,4682,2133,2549,83.7,4648,2117,2531,83.6
11120, 은평구,075,70~74세,2017,19087,8498,10589,80.3,19016,8465,10551,80.2
11120, 은평구,075001, 70세,2017,4693,2122,2571,82.5,4677,2113,2564,82.4
11120, 은평구,075002, 71세,2017,3651,1640,2011,81.6,3639,1631,2008,81.2
11120, 은평구,075003, 72세,2017,3557,1580,1977,79.9,3542,1573,1969,79.9
11120, 은평구,075004, 73세,2017,3521,1563,1958,79.8,3508,1560,1948,80.1
11120, 은평구,075005, 74세,2017,3665,1593,2072,76.9,3650,1588,2062,77
11120, 은평구,080,75~79세,2017,15499,6941,8558,81.1,15435,6918,8517,81.2
11120, 은평구,080001, 75세,2017,4185,1890,2295,82.4,4167,1886,2281,82.7
11120, 은평구,080002, 76세,2017,3246,1495,1751,85.4,3237,1491,1746,85.4
11120, 은평구,080003, 77세,2017,2898,1331,1567,84.9,2888,1327,1561,85
11120, 은평구,080004, 78세,2017,2769,1197,1572,76.1,2757,1193,1564,76.3
11120, 은평구,080005, 79세,2017,2401,1028,1373,74.9,2386,1021,1365,74.8
11120, 은평구,085,80~84세,2017,8184,3292,4892,67.3,8158,3283,4875,67.3
11120, 은평구,085001, 80세,2017,2217,943,1274,74,2206,939,1267,74.1
11120, 은평구,085002, 81세,2017,1882,752,1130,66.5,1879,752,1127,66.7
11120, 은평구,085003, 82세,2017,1686,678,1008,67.3,1682,675,1007,67
11120, 은평구,085004, 83세,2017,1323,529,794,66.6,1319,527,792,66.5
11120, 은평구,085005, 84세,2017,1076,390,686,56.9,1072,390,682,57.2
11120, 은평구,090,85~89세,2017,3430,1098,2332,47.1,3415,1091,2324,46.9
11120, 은평구,090001, 85세,2017,974,345,629,54.8,968,341,627,54.4
11120, 은평구,090002, 86세,2017,751,233,518,45,749,233,516,45.2
11120, 은평구,090003, 87세,2017,630,193,437,44.2,627,191,436,43.8
11120, 은평구,090004, 88세,2017,608,188,420,44.8,606,187,419,44.6
11120, 은평구,090005, 89세,2017,467,139,328,42.4,465,139,326,42.6
11120, 은평구,095,90~94세,2017,1158,284,874,32.5,1152,282,870,32.4
11120, 은평구,095001, 90세,2017,377,84,293,28.7,373,83,290,28.6
11120, 은평구,095002, 91세,2017,261,70,191,36.6,260,69,191,36.1
11120, 은평구,095003, 92세,2017,215,44,171,25.7,215,44,171,25.7
11120, 은평구,095004, 93세,2017,172,50,122,41,172,50,122,41
11120, 은평구,095005, 94세,2017,133,36,97,37.1,132,36,96,37.5
11120, 은평구,100,95~99세,2017,213,46,167,27.5,213,46,167,27.5
11120, 은평구,100001, 95세,2017,87,18,69,26.1,87,18,69,26.1
11120, 은평구,100002, 96세,2017,50,11,39,28.2,50,11,39,28.2
11120, 은평구,100003, 97세,2017,36,9,27,33.3,36,9,27,33.3
11120, 은평구,100004, 98세,2017,27,6,21,28.6,27,6,21,28.6
11120, 은평구,100005, 99세,2017,13,X,11,18.2,13,X,11,18.2
11120, 은평구,101,100세이상,2017,26,X,25,4,26,X,25,4
11120, 은평구,102,15세미만,2017,53575,27671,25904,106.8,53354,27563,25791,106.9
11120, 은평구,103,15~64세,2017,341559,167172,174387,95.9,336585,165024,171561,96.2
11120, 은평구,104,65세이상,2017,71109,30970,40139,77.2,70712,30801,39911,77.2
11120, 은평구,086,85세이상,2017,4827,1429,3398,42.1,4806,1420,3386,41.9
11120, 은평구,126,평균연령,2017,42.4,41.4,43.4,,42.5,41.4,43.5,
11120, 은평구,127,중위연령,2017,43.2,42.1,44.3,,43.3,42.1,44.4,
11130, 서대문구,000,합계,2017,321345,151132,170213,88.8,308193,146320,161873,90.4
11130, 서대문구,005,0~4세,2017,10712,5458,5254,103.9,10532,5368,5164,104
11130, 서대문구,005001, 0세,2017,2004,1036,968,107,1978,1022,956,106.9
11130, 서대문구,005002, 1세,2017,2211,1133,1078,105.1,2164,1111,1053,105.5
11130, 서대문구,005003, 2세,2017,2176,1090,1086,100.4,2135,1069,1066,100.3
11130, 서대문구,005004, 3세,2017,2232,1118,1114,100.4,2198,1105,1093,101.1
11130, 서대문구,005005, 4세,2017,2089,1081,1008,107.2,2057,1061,996,106.5
11130, 서대문구,010,5~9세,2017,10558,5338,5220,102.3,10417,5265,5152,102.2
11130, 서대문구,010001, 5세,2017,2222,1119,1103,101.5,2189,1106,1083,102.1
11130, 서대문구,010002, 6세,2017,2084,1033,1051,98.3,2058,1018,1040,97.9
11130, 서대문구,010003, 7세,2017,2070,1077,993,108.5,2046,1062,984,107.9
11130, 서대문구,010004, 8세,2017,2145,1075,1070,100.5,2118,1061,1057,100.4
11130, 서대문구,010005, 9세,2017,2037,1034,1003,103.1,2006,1018,988,103
11130, 서대문구,015,10~14세,2017,11067,5599,5468,102.4,10914,5521,5393,102.4
11130, 서대문구,015001, 10세,2017,2144,1074,1070,100.4,2119,1064,1055,100.9
11130, 서대문구,015002, 11세,2017,2132,1086,1046,103.8,2101,1069,1032,103.6
11130, 서대문구,015003, 12세,2017,2061,1043,1018,102.5,2035,1028,1007,102.1
11130, 서대문구,015004, 13세,2017,2303,1172,1131,103.6,2260,1152,1108,104
11130, 서대문구,015005, 14세,2017,2427,1224,1203,101.7,2399,1208,1191,101.4
11130, 서대문구,020,15~19세,2017,17558,8120,9438,86,16662,7846,8816,89
11130, 서대문구,020001, 15세,2017,2467,1267,1200,105.6,2433,1245,1188,104.8
11130, 서대문구,020002, 16세,2017,2978,1560,1418,110,2929,1529,1400,109.2
11130, 서대문구,020003, 17세,2017,3300,1770,1530,115.7,3223,1736,1487,116.7
11130, 서대문구,020004, 18세,2017,3520,1612,1908,84.5,3320,1551,1769,87.7
11130, 서대문구,020005, 19세,2017,5293,1911,3382,56.5,4757,1785,2972,60.1
11130, 서대문구,025,20~24세,2017,33583,13410,20173,66.5,29569,12476,17093,73
11130, 서대문구,025001, 20세,2017,6372,2175,4197,51.8,5548,1994,3554,56.1
11130, 서대문구,025002, 21세,2017,6587,2371,4216,56.2,5749,2204,3545,62.2
11130, 서대문구,025003, 22세,2017,6805,2729,4076,67,5970,2542,3428,74.2
11130, 서대문구,025004, 23세,2017,6813,2938,3875,75.8,6065,2739,3326,82.4
11130, 서대문구,025005, 24세,2017,7006,3197,3809,83.9,6237,2997,3240,92.5
11130, 서대문구,030,25~29세,2017,28244,13759,14485,95,26104,13030,13074,99.7
11130, 서대문구,030001, 25세,2017,6608,3151,3457,91.1,6026,2980,3046,97.8
11130, 서대문구,030002, 26세,2017,6217,2987,3230,92.5,5796,2845,2951,96.4
11130, 서대문구,030003, 27세,2017,5602,2709,2893,93.6,5151,2565,2586,99.2
11130, 서대문구,030004, 28세,2017,5145,2596,2549,101.8,4767,2461,2306,106.7
11130, 서대문구,030005, 29세,2017,4672,2316,2356,98.3,4364,2179,2185,99.7
11130, 서대문구,035,30~34세,2017,22711,11197,11514,97.2,21431,10652,10779,98.8
11130, 서대문구,035001, 30세,2017,4606,2247,2359,95.3,4299,2135,2164,98.7
11130, 서대문구,035002, 31세,2017,4404,2211,2193,100.8,4119,2087,2032,102.7
11130, 서대문구,035003, 32세,2017,4495,2181,2314,94.3,4224,2066,2158,95.7
11130, 서대문구,035004, 33세,2017,4435,2150,2285,94.1,4231,2064,2167,95.2
11130, 서대문구,035005, 34세,2017,4771,2408,2363,101.9,4558,2300,2258,101.9
11130, 서대문구,040,35~39세,2017,23594,11761,11833,99.4,22756,11374,11382,99.9
11130, 서대문구,040001, 35세,2017,5013,2442,2571,95,4807,2348,2459,95.5
11130, 서대문구,040002, 36세,2017,5003,2528,2475,102.1,4827,2445,2382,102.6
11130, 서대문구,040003, 37세,2017,4921,2449,2472,99.1,4773,2379,2394,99.4
11130, 서대문구,040004, 38세,2017,4496,2252,2244,100.4,4346,2188,2158,101.4
11130, 서대문구,040005, 39세,2017,4161,2090,2071,100.9,4003,2014,1989,101.3
11130, 서대문구,045,40~44세,2017,22856,11358,11498,98.8,22205,11018,11187,98.5
11130, 서대문구,045001, 40세,2017,4336,2190,2146,102.1,4192,2102,2090,100.6
11130, 서대문구,045002, 41세,2017,4285,2166,2119,102.2,4164,2108,2056,102.5
11130, 서대문구,045003, 42세,2017,4445,2245,2200,102,4331,2190,2141,102.3
11130, 서대문구,045004, 43세,2017,4907,2417,2490,97.1,4767,2341,2426,96.5
11130, 서대문구,045005, 44세,2017,4883,2340,2543,92,4751,2277,2474,92
11130, 서대문구,050,45~49세,2017,26656,13141,13515,97.2,25905,12756,13149,97
11130, 서대문구,050001, 45세,2017,5267,2673,2594,103,5096,2583,2513,102.8
11130, 서대문구,050002, 46세,2017,5635,2828,2807,100.7,5458,2740,2718,100.8
11130, 서대문구,050003, 47세,2017,5324,2601,2723,95.5,5187,2527,2660,95
11130, 서대문구,050004, 48세,2017,5243,2542,2701,94.1,5111,2474,2637,93.8
11130, 서대문구,050005, 49세,2017,5187,2497,2690,92.8,5053,2432,2621,92.8
11130, 서대문구,055,50~54세,2017,23546,11393,12153,93.7,22925,11087,11838,93.7
11130, 서대문구,055001, 50세,2017,4751,2224,2527,88,4649,2169,2480,87.5
11130, 서대문구,055002, 51세,2017,4599,2378,2221,107.1,4470,2321,2149,108
11130, 서대문구,055003, 52세,2017,4782,2253,2529,89.1,4650,2185,2465,88.6
11130, 서대문구,055004, 53세,2017,4592,2182,2410,90.5,4477,2124,2353,90.3
11130, 서대문구,055005, 54세,2017,4822,2356,2466,95.5,4679,2288,2391,95.7
11130, 서대문구,060,55~59세,2017,24373,11716,12657,92.6,23806,11460,12346,92.8
11130, 서대문구,060001, 55세,2017,4884,2400,2484,96.6,4753,2337,2416,96.7
11130, 서대문구,060002, 56세,2017,5143,2468,2675,92.3,5020,2415,2605,92.7
11130, 서대문구,060003, 57세,2017,5116,2380,2736,87,5010,2331,2679,87
11130, 서대문구,060004, 58세,2017,4684,2245,2439,92,4592,2206,2386,92.5
11130, 서대문구,060005, 59세,2017,4546,2223,2323,95.7,4431,2171,2260,96.1
11130, 서대문구,065,60~64세,2017,19322,9139,10183,89.7,18853,8907,9946,89.6
11130, 서대문구,065001, 60세,2017,4372,2084,2288,91.1,4256,2021,2235,90.4
11130, 서대문구,065002, 61세,2017,4066,1935,2131,90.8,3978,1894,2084,90.9
11130, 서대문구,065003, 62세,2017,4210,1981,2229,88.9,4104,1930,2174,88.8
11130, 서대문구,065004, 63세,2017,3510,1663,1847,90,3422,1625,1797,90.4
11130, 서대문구,065005, 64세,2017,3164,1476,1688,87.4,3093,1437,1656,86.8
11130, 서대문구,070,65~69세,2017,14230,6398,7832,81.7,14017,6295,7722,81.5
11130, 서대문구,070001, 65세,2017,3297,1504,1793,83.9,3238,1483,1755,84.5
11130, 서대문구,070002, 66세,2017,2515,1196,1319,90.7,2473,1167,1306,89.4
11130, 서대문구,070003, 67세,2017,2798,1222,1576,77.5,2761,1204,1557,77.3
11130, 서대문구,070004, 68세,2017,2839,1239,1600,77.4,2800,1220,1580,77.2
11130, 서대문구,070005, 69세,2017,2781,1237,1544,80.1,2745,1221,1524,80.1
11130, 서대문구,075,70~74세,2017,12221,5341,6880,77.6,12130,5306,6824,77.8
11130, 서대문구,075001, 70세,2017,3009,1335,1674,79.7,2983,1324,1659,79.8
11130, 서대문구,075002, 71세,2017,2333,1044,1289,81,2308,1033,1275,81
11130, 서대문구,075003, 72세,2017,2319,1003,1316,76.2,2301,995,1306,76.2
11130, 서대문구,075004, 73세,2017,2248,964,1284,75.1,2235,962,1273,75.6
11130, 서대문구,075005, 74세,2017,2312,995,1317,75.6,2303,992,1311,75.7
11130, 서대문구,080,75~79세,2017,10699,4629,6070,76.3,10637,4613,6024,76.6
11130, 서대문구,080001, 75세,2017,2736,1226,1510,81.2,2727,1223,1504,81.3
11130, 서대문구,080002, 76세,2017,2180,963,1217,79.1,2160,957,1203,79.6
11130, 서대문구,080003, 77세,2017,2041,873,1168,74.7,2031,871,1160,75.1
11130, 서대문구,080004, 78세,2017,2045,861,1184,72.7,2029,857,1172,73.1
11130, 서대문구,080005, 79세,2017,1697,706,991,71.2,1690,705,985,71.6
11130, 서대문구,085,80~84세,2017,6000,2357,3643,64.7,5951,2340,3611,64.8
11130, 서대문구,085001, 80세,2017,1526,626,900,69.6,1511,623,888,70.2
11130, 서대문구,085002, 81세,2017,1375,568,807,70.4,1358,559,799,70
11130, 서대문구,085003, 82세,2017,1271,505,766,65.9,1266,503,763,65.9
11130, 서대문구,085004, 83세,2017,1015,375,640,58.6,1007,373,634,58.8
11130, 서대문구,085005, 84세,2017,813,283,530,53.4,809,282,527,53.5
11130, 서대문구,090,85~89세,2017,2441,788,1653,47.7,2419,782,1637,47.8
11130, 서대문구,090001, 85세,2017,654,228,426,53.5,652,227,425,53.4
11130, 서대문구,090002, 86세,2017,505,155,350,44.3,496,154,342,45
11130, 서대문구,090003, 87세,2017,523,166,357,46.5,521,166,355,46.8
11130, 서대문구,090004, 88세,2017,422,144,278,51.8,415,141,274,51.5
11130, 서대문구,090005, 89세,2017,337,95,242,39.3,335,94,241,39
11130, 서대문구,095,90~94세,2017,789,195,594,32.8,779,192,587,32.7
11130, 서대문구,095001, 90세,2017,258,62,196,31.6,256,61,195,31.3
11130, 서대문구,095002, 91세,2017,178,49,129,38,177,49,128,38.3
11130, 서대문구,095003, 92세,2017,141,34,107,31.8,138,34,104,32.7
11130, 서대문구,095004, 93세,2017,123,28,95,29.5,121,27,94,28.7
11130, 서대문구,095005, 94세,2017,89,22,67,32.8,87,21,66,31.8
11130, 서대문구,100,95~99세,2017,160,27,133,20.3,157,25,132,18.9
11130, 서대문구,100001, 95세,2017,75,13,62,21,74,13,61,21.3
11130, 서대문구,100002, 96세,2017,38,X,34,11.8,38,X,34,11.8
11130, 서대문구,100003, 97세,2017,23,6,17,35.3,23,6,17,35.3
11130, 서대문구,100004, 98세,2017,17,X,14,21.4,16,X,14,14.3
11130, 서대문구,100005, 99세,2017,7,X,6,16.7,6,X,6,0
11130, 서대문구,101,100세이상,2017,25,8,17,47.1,24,7,17,41.2
11130, 서대문구,102,15세미만,2017,32337,16395,15942,102.8,31863,16154,15709,102.8
11130, 서대문구,103,15~64세,2017,242443,114994,127449,90.2,230216,110606,119610,92.5
11130, 서대문구,104,65세이상,2017,46565,19743,26822,73.6,46114,19560,26554,73.7
11130, 서대문구,086,85세이상,2017,3415,1018,2397,42.5,3379,1006,2373,42.4
11130, 서대문구,126,평균연령,2017,41.3,40.8,41.7,,41.6,40.9,42.2,
11130, 서대문구,127,중위연령,2017,40.6,40.4,40.8,,41.4,40.8,42,
11140, 마포구,000,합계,2017,368841,175326,193515,90.6,356881,170311,186570,91.3
11140, 마포구,005,0~4세,2017,14424,7373,7051,104.6,14247,7288,6959,104.7
11140, 마포구,005001, 0세,2017,2938,1559,1379,113.1,2905,1548,1357,114.1
11140, 마포구,005002, 1세,2017,3032,1544,1488,103.8,2999,1525,1474,103.5
11140, 마포구,005003, 2세,2017,2933,1489,1444,103.1,2888,1467,1421,103.2
11140, 마포구,005004, 3세,2017,2794,1411,1383,102,2762,1398,1364,102.5
11140, 마포구,005005, 4세,2017,2727,1370,1357,101,2693,1350,1343,100.5
11140, 마포구,010,5~9세,2017,13927,7072,6855,103.2,13781,6999,6782,103.2
11140, 마포구,010001, 5세,2017,2846,1437,1409,102,2808,1416,1392,101.7
11140, 마포구,010002, 6세,2017,2826,1429,1397,102.3,2800,1415,1385,102.2
11140, 마포구,010003, 7세,2017,2710,1357,1353,100.3,2688,1350,1338,100.9
11140, 마포구,010004, 8세,2017,2683,1391,1292,107.7,2654,1376,1278,107.7
11140, 마포구,010005, 9세,2017,2862,1458,1404,103.8,2831,1442,1389,103.8
11140, 마포구,015,10~14세,2017,13642,6969,6673,104.4,13537,6909,6628,104.2
11140, 마포구,015001, 10세,2017,2873,1459,1414,103.2,2857,1449,1408,102.9
11140, 마포구,015002, 11세,2017,2603,1304,1299,100.4,2579,1288,1291,99.8
11140, 마포구,015003, 12세,2017,2608,1347,1261,106.8,2586,1333,1253,106.4
11140, 마포구,015004, 13세,2017,2779,1380,1399,98.6,2753,1368,1385,98.8
11140, 마포구,015005, 14세,2017,2779,1479,1300,113.8,2762,1471,1291,113.9
11140, 마포구,020,15~19세,2017,16795,8230,8565,96.1,16324,8093,8231,98.3
11140, 마포구,020001, 15세,2017,2771,1381,1390,99.4,2755,1372,1383,99.2
11140, 마포구,020002, 16세,2017,2970,1538,1432,107.4,2955,1530,1425,107.4
11140, 마포구,020003, 17세,2017,3301,1633,1668,97.9,3268,1619,1649,98.2
11140, 마포구,020004, 18세,2017,3500,1729,1771,97.6,3384,1698,1686,100.7
11140, 마포구,020005, 19세,2017,4253,1949,2304,84.6,3962,1874,2088,89.8
11140, 마포구,025,20~24세,2017,28444,12948,15496,83.6,26116,12297,13819,89
11140, 마포구,025001, 20세,2017,4916,2188,2728,80.2,4494,2078,2416,86
11140, 마포구,025002, 21세,2017,5170,2327,2843,81.9,4757,2213,2544,87
11140, 마포구,025003, 22세,2017,5616,2503,3113,80.4,5141,2386,2755,86.6
11140, 마포구,025004, 23세,2017,6192,2891,3301,87.6,5649,2726,2923,93.3
11140, 마포구,025005, 24세,2017,6550,3039,3511,86.6,6075,2894,3181,91
11140, 마포구,030,25~29세,2017,33369,15336,18033,85,31331,14646,16685,87.8
11140, 마포구,030001, 25세,2017,6983,3168,3815,83,6551,3045,3506,86.9
11140, 마포구,030002, 26세,2017,6803,3187,3616,88.1,6381,3054,3327,91.8
11140, 마포구,030003, 27세,2017,6676,3051,3625,84.2,6258,2916,3342,87.3
11140, 마포구,030004, 28세,2017,6437,2979,3458,86.1,6060,2832,3228,87.7
11140, 마포구,030005, 29세,2017,6470,2951,3519,83.9,6081,2799,3282,85.3
11140, 마포구,035,30~34세,2017,33864,15963,17901,89.2,32290,15199,17091,88.9
11140, 마포구,035001, 30세,2017,6566,2930,3636,80.6,6218,2779,3439,80.8
11140, 마포구,035002, 31세,2017,6658,3055,3603,84.8,6324,2891,3433,84.2
11140, 마포구,035003, 32세,2017,6679,3176,3503,90.7,6384,3037,3347,90.7
11140, 마포구,035004, 33세,2017,6893,3370,3523,95.7,6568,3205,3363,95.3
11140, 마포구,035005, 34세,2017,7068,3432,3636,94.4,6796,3287,3509,93.7
11140, 마포구,040,35~39세,2017,33593,16643,16950,98.2,32531,16054,16477,97.4
11140, 마포구,040001, 35세,2017,7492,3680,3812,96.5,7254,3553,3701,96
11140, 마포구,040002, 36세,2017,7101,3569,3532,101,6891,3452,3439,100.4
11140, 마포구,040003, 37세,2017,6794,3362,3432,98,6592,3247,3345,97.1
11140, 마포구,040004, 38세,2017,6403,3128,3275,95.5,6171,3003,3168,94.8
11140, 마포구,040005, 39세,2017,5803,2904,2899,100.2,5623,2799,2824,99.1
11140, 마포구,045,40~44세,2017,30884,15126,15758,96,30079,14690,15389,95.5
11140, 마포구,045001, 40세,2017,5997,2869,3128,91.7,5830,2783,3047,91.3
11140, 마포구,045002, 41세,2017,5971,2919,3052,95.6,5798,2821,2977,94.8
11140, 마포구,045003, 42세,2017,6089,3046,3043,100.1,5923,2953,2970,99.4
11140, 마포구,045004, 43세,2017,6346,3178,3168,100.3,6213,3105,3108,99.9
11140, 마포구,045005, 44세,2017,6481,3114,3367,92.5,6315,3028,3287,92.1
11140, 마포구,050,45~49세,2017,31485,15634,15851,98.6,30665,15218,15447,98.5
11140, 마포구,050001, 45세,2017,6517,3302,3215,102.7,6362,3217,3145,102.3
11140, 마포구,050002, 46세,2017,6720,3336,3384,98.6,6557,3253,3304,98.5
11140, 마포구,050003, 47세,2017,6259,3121,3138,99.5,6084,3041,3043,99.9
11140, 마포구,050004, 48세,2017,6159,3092,3067,100.8,6000,3003,2997,100.2
11140, 마포구,050005, 49세,2017,5830,2783,3047,91.3,5662,2704,2958,91.4
11140, 마포구,055,50~54세,2017,25708,12548,13160,95.3,24940,12196,12744,95.7
11140, 마포구,055001, 50세,2017,5238,2535,2703,93.8,5084,2450,2634,93
11140, 마포구,055002, 51세,2017,4956,2491,2465,101.1,4807,2424,2383,101.7
11140, 마포구,055003, 52세,2017,5363,2569,2794,91.9,5211,2506,2705,92.6
11140, 마포구,055004, 53세,2017,4977,2429,2548,95.3,4825,2360,2465,95.7
11140, 마포구,055005, 54세,2017,5174,2524,2650,95.2,5013,2456,2557,96.1
11140, 마포구,060,55~59세,2017,25771,12361,13410,92.2,25135,12080,13055,92.5
11140, 마포구,060001, 55세,2017,5149,2491,2658,93.7,4986,2416,2570,94
11140, 마포구,060002, 56세,2017,5398,2615,2783,94,5309,2574,2735,94.1
11140, 마포구,060003, 57세,2017,5584,2675,2909,92,5451,2618,2833,92.4
11140, 마포구,060004, 58세,2017,5018,2390,2628,90.9,4895,2332,2563,91
11140, 마포구,060005, 59세,2017,4622,2190,2432,90,4494,2140,2354,90.9
11140, 마포구,065,60~64세,2017,20172,9371,10801,86.8,19656,9123,10533,86.6
11140, 마포구,065001, 60세,2017,4655,2183,2472,88.3,4549,2119,2430,87.2
11140, 마포구,065002, 61세,2017,4275,1977,2298,86,4171,1934,2237,86.5
11140, 마포구,065003, 62세,2017,4442,2086,2356,88.5,4336,2040,2296,88.9
11140, 마포구,065004, 63세,2017,3627,1670,1957,85.3,3519,1622,1897,85.5
11140, 마포구,065005, 64세,2017,3173,1455,1718,84.7,3081,1408,1673,84.2
11140, 마포구,070,65~69세,2017,14744,6529,8215,79.5,14481,6390,8091,79
11140, 마포구,070001, 65세,2017,3503,1610,1893,85.1,3411,1563,1848,84.6
11140, 마포구,070002, 66세,2017,2476,1112,1364,81.5,2426,1085,1341,80.9
11140, 마포구,070003, 67세,2017,2881,1286,1595,80.6,2823,1251,1572,79.6
11140, 마포구,070004, 68세,2017,2944,1256,1688,74.4,2914,1239,1675,74
11140, 마포구,070005, 69세,2017,2940,1265,1675,75.5,2907,1252,1655,75.6
11140, 마포구,075,70~74세,2017,12324,5297,7027,75.4,12211,5247,6964,75.3
11140, 마포구,075001, 70세,2017,2978,1280,1698,75.4,2945,1267,1678,75.5
11140, 마포구,075002, 71세,2017,2302,969,1333,72.7,2275,957,1318,72.6
11140, 마포구,075003, 72세,2017,2374,1011,1363,74.2,2358,1002,1356,73.9
11140, 마포구,075004, 73세,2017,2351,1005,1346,74.7,2326,993,1333,74.5
11140, 마포구,075005, 74세,2017,2319,1032,1287,80.2,2307,1028,1279,80.4
11140, 마포구,080,75~79세,2017,10309,4488,5821,77.1,10247,4470,5777,77.4
11140, 마포구,080001, 75세,2017,2736,1215,1521,79.9,2720,1212,1508,80.4
11140, 마포구,080002, 76세,2017,2138,953,1185,80.4,2123,947,1176,80.5
11140, 마포구,080003, 77세,2017,1995,847,1148,73.8,1981,841,1140,73.8
11140, 마포구,080004, 78세,2017,1850,799,1051,76,1842,797,1045,76.3
11140, 마포구,080005, 79세,2017,1590,674,916,73.6,1581,673,908,74.1
11140, 마포구,085,80~84세,2017,5941,2328,3613,64.4,5899,2311,3588,64.4
11140, 마포구,085001, 80세,2017,1574,649,925,70.2,1564,646,918,70.4
11140, 마포구,085002, 81세,2017,1333,536,797,67.3,1318,530,788,67.3
11140, 마포구,085003, 82세,2017,1253,477,776,61.5,1247,473,774,61.1
11140, 마포구,085004, 83세,2017,944,328,616,53.2,939,326,613,53.2
11140, 마포구,085005, 84세,2017,837,338,499,67.7,831,336,495,67.9
11140, 마포구,090,85~89세,2017,2485,842,1643,51.2,2464,836,1628,51.4
11140, 마포구,090001, 85세,2017,696,246,450,54.7,689,244,445,54.8
11140, 마포구,090002, 86세,2017,530,184,346,53.2,526,183,343,53.4
11140, 마포구,090003, 87세,2017,497,162,335,48.4,489,160,329,48.6
11140, 마포구,090004, 88세,2017,426,148,278,53.2,424,147,277,53.1
11140, 마포구,090005, 89세,2017,336,102,234,43.6,336,102,234,43.6
11140, 마포구,095,90~94세,2017,743,213,530,40.2,736,211,525,40.2
11140, 마포구,095001, 90세,2017,244,72,172,41.9,241,71,170,41.8
11140, 마포구,095002, 91세,2017,168,46,122,37.7,166,45,121,37.2
11140, 마포구,095003, 92세,2017,128,35,93,37.6,127,35,92,38
11140, 마포구,095004, 93세,2017,108,33,75,44,108,33,75,44
11140, 마포구,095005, 94세,2017,95,27,68,39.7,94,27,67,40.3
11140, 마포구,100,95~99세,2017,188,49,139,35.3,183,48,135,35.6
11140, 마포구,100001, 95세,2017,73,15,58,25.9,71,15,56,26.8
11140, 마포구,100002, 96세,2017,45,19,26,73.1,43,18,25,72
11140, 마포구,100003, 97세,2017,30,8,22,36.4,30,8,22,36.4
11140, 마포구,100004, 98세,2017,23,5,18,27.8,22,5,17,29.4
11140, 마포구,100005, 99세,2017,17,X,15,13.3,17,X,15,13.3
11140, 마포구,101,100세이상,2017,29,6,23,26.1,28,6,22,27.3
11140, 마포구,102,15세미만,2017,41993,21414,20579,104.1,41565,21196,20369,104.1
11140, 마포구,103,15~64세,2017,280085,134160,145925,91.9,269067,129596,139471,92.9
11140, 마포구,104,65세이상,2017,46763,19752,27011,73.1,46249,19519,26730,73
11140, 마포구,086,85세이상,2017,3445,1110,2335,47.5,3411,1101,2310,47.7
11140, 마포구,126,평균연령,2017,40.4,39.7,41,,40.5,39.7,41.3,
11140, 마포구,127,중위연령,2017,39.4,39,39.7,,39.7,39.2,40.2,
11150, 양천구,000,합계,2017,452111,222503,229608,96.9,446643,220035,226608,97.1
11150, 양천구,005,0~4세,2017,16004,8198,7806,105,15908,8149,7759,105
11150, 양천구,005001, 0세,2017,2855,1469,1386,106,2839,1462,1377,106.2
11150, 양천구,005002, 1세,2017,3210,1588,1622,97.9,3189,1578,1611,98
11150, 양천구,005003, 2세,2017,3212,1681,1531,109.8,3194,1668,1526,109.3
11150, 양천구,005004, 3세,2017,3308,1679,1629,103.1,3286,1669,1617,103.2
11150, 양천구,005005, 4세,2017,3419,1781,1638,108.7,3400,1772,1628,108.8
11150, 양천구,010,5~9세,2017,19991,10334,9657,107,19926,10306,9620,107.1
11150, 양천구,010001, 5세,2017,3726,1909,1817,105.1,3710,1902,1808,105.2
11150, 양천구,010002, 6세,2017,3856,2015,1841,109.5,3842,2011,1831,109.8
11150, 양천구,010003, 7세,2017,4007,2053,1954,105.1,3994,2046,1948,105
11150, 양천구,010004, 8세,2017,3953,2066,1887,109.5,3945,2062,1883,109.5
11150, 양천구,010005, 9세,2017,4449,2291,2158,106.2,4435,2285,2150,106.3
11150, 양천구,015,10~14세,2017,24346,12733,11613,109.6,24311,12712,11599,109.6
11150, 양천구,015001, 10세,2017,4649,2388,2261,105.6,4640,2382,2258,105.5
11150, 양천구,015002, 11세,2017,4375,2271,2104,107.9,4369,2266,2103,107.8
11150, 양천구,015003, 12세,2017,4787,2539,2248,112.9,4782,2536,2246,112.9
11150, 양천구,015004, 13세,2017,5241,2804,2437,115.1,5232,2799,2433,115
11150, 양천구,015005, 14세,2017,5294,2731,2563,106.6,5288,2729,2559,106.6
11150, 양천구,020,15~19세,2017,29457,15378,14079,109.2,29410,15358,14052,109.3
11150, 양천구,020001, 15세,2017,5493,2848,2645,107.7,5487,2844,2643,107.6
11150, 양천구,020002, 16세,2017,5904,3119,2785,112,5893,3113,2780,112
11150, 양천구,020003, 17세,2017,6252,3292,2960,111.2,6241,3288,2953,111.3
11150, 양천구,020004, 18세,2017,6302,3295,3007,109.6,6291,3291,3000,109.7
11150, 양천구,020005, 19세,2017,5506,2824,2682,105.3,5498,2822,2676,105.5
11150, 양천구,025,20~24세,2017,29424,15445,13979,110.5,29167,15355,13812,111.2
11150, 양천구,025001, 20세,2017,5724,3087,2637,117.1,5695,3074,2621,117.3
11150, 양천구,025002, 21세,2017,5902,3224,2678,120.4,5870,3218,2652,121.3
11150, 양천구,025003, 22세,2017,5848,3145,2703,116.4,5797,3129,2668,117.3
11150, 양천구,025004, 23세,2017,5993,3031,2962,102.3,5931,3008,2923,102.9
11150, 양천구,025005, 24세,2017,5957,2958,2999,98.6,5874,2926,2948,99.3
11150, 양천구,030,25~29세,2017,28246,13901,14345,96.9,27628,13656,13972,97.7
11150, 양천구,030001, 25세,2017,5919,2885,3034,95.1,5822,2848,2974,95.8
11150, 양천구,030002, 26세,2017,5913,2891,3022,95.7,5799,2851,2948,96.7
11150, 양천구,030003, 27세,2017,5514,2806,2708,103.6,5390,2760,2630,104.9
11150, 양천구,030004, 28세,2017,5487,2664,2823,94.4,5357,2605,2752,94.7
11150, 양천구,030005, 29세,2017,5413,2655,2758,96.3,5260,2592,2668,97.2
11150, 양천구,035,30~34세,2017,28954,14445,14509,99.6,28286,14151,14135,100.1
11150, 양천구,035001, 30세,2017,5435,2657,2778,95.6,5286,2592,2694,96.2
11150, 양천구,035002, 31세,2017,5543,2780,2763,100.6,5401,2719,2682,101.4
11150, 양천구,035003, 32세,2017,5623,2785,2838,98.1,5506,2734,2772,98.6
11150, 양천구,035004, 33세,2017,5930,2997,2933,102.2,5797,2942,2855,103
11150, 양천구,035005, 34세,2017,6423,3226,3197,100.9,6296,3164,3132,101
11150, 양천구,040,35~39세,2017,34044,16667,17377,95.9,33486,16383,17103,95.8
11150, 양천구,040001, 35세,2017,6904,3456,3448,100.2,6784,3397,3387,100.3
11150, 양천구,040002, 36세,2017,6916,3429,3487,98.3,6818,3375,3443,98
11150, 양천구,040003, 37세,2017,7021,3470,3551,97.7,6906,3403,3503,97.1
11150, 양천구,040004, 38세,2017,6843,3315,3528,94,6727,3264,3463,94.3
11150, 양천구,040005, 39세,2017,6360,2997,3363,89.1,6251,2944,3307,89
11150, 양천구,045,40~44세,2017,37249,17561,19688,89.2,36781,17337,19444,89.2
11150, 양천구,045001, 40세,2017,6599,3123,3476,89.8,6500,3080,3420,90.1
11150, 양천구,045002, 41세,2017,6771,3229,3542,91.2,6672,3188,3484,91.5
11150, 양천구,045003, 42세,2017,7262,3360,3902,86.1,7186,3318,3868,85.8
11150, 양천구,045004, 43세,2017,8164,3901,4263,91.5,8065,3855,4210,91.6
11150, 양천구,045005, 44세,2017,8453,3948,4505,87.6,8358,3896,4462,87.3
11150, 양천구,050,45~49세,2017,45814,22187,23627,93.9,45242,21920,23322,94
11150, 양천구,050001, 45세,2017,8721,4100,4621,88.7,8595,4039,4556,88.7
11150, 양천구,050002, 46세,2017,9606,4652,4954,93.9,9497,4600,4897,93.9
11150, 양천구,050003, 47세,2017,9283,4472,4811,93,9155,4416,4739,93.2
11150, 양천구,050004, 48세,2017,9336,4578,4758,96.2,9232,4526,4706,96.2
11150, 양천구,050005, 49세,2017,8868,4385,4483,97.8,8763,4339,4424,98.1
11150, 양천구,055,50~54세,2017,39133,19523,19610,99.6,38478,19234,19244,99.9
11150, 양천구,055001, 50세,2017,8165,3997,4168,95.9,8049,3934,4115,95.6
11150, 양천구,055002, 51세,2017,7824,3938,3886,101.3,7706,3891,3815,102
11150, 양천구,055003, 52세,2017,7969,3920,4049,96.8,7855,3868,3987,97
11150, 양천구,055004, 53세,2017,7447,3753,3694,101.6,7317,3702,3615,102.4
11150, 양천구,055005, 54세,2017,7728,3915,3813,102.7,7551,3839,3712,103.4
11150, 양천구,060,55~59세,2017,37455,18393,19062,96.5,36948,18140,18808,96.4
11150, 양천구,060001, 55세,2017,7621,3861,3760,102.7,7506,3797,3709,102.4
11150, 양천구,060002, 56세,2017,7943,3882,4061,95.6,7880,3854,4026,95.7
11150, 양천구,060003, 57세,2017,7942,3884,4058,95.7,7820,3828,3992,95.9
11150, 양천구,060004, 58세,2017,7145,3479,3666,94.9,7039,3419,3620,94.4
11150, 양천구,060005, 59세,2017,6804,3287,3517,93.5,6703,3242,3461,93.7
11150, 양천구,065,60~64세,2017,28974,14032,14942,93.9,28477,13806,14671,94.1
11150, 양천구,065001, 60세,2017,6587,3167,3420,92.6,6482,3129,3353,93.3
11150, 양천구,065002, 61세,2017,6084,2936,3148,93.3,5974,2884,3090,93.3
11150, 양천구,065003, 62세,2017,6412,3087,3325,92.8,6303,3030,3273,92.6
11150, 양천구,065004, 63세,2017,5219,2568,2651,96.9,5116,2526,2590,97.5
11150, 양천구,065005, 64세,2017,4672,2274,2398,94.8,4602,2237,2365,94.6
11150, 양천구,070,65~69세,2017,19790,9770,10020,97.5,19534,9658,9876,97.8
11150, 양천구,070001, 65세,2017,4938,2407,2531,95.1,4855,2367,2488,95.1
11150, 양천구,070002, 66세,2017,3536,1751,1785,98.1,3485,1731,1754,98.7
11150, 양천구,070003, 67세,2017,3923,1970,1953,100.9,3874,1946,1928,100.9
11150, 양천구,070004, 68세,2017,3777,1859,1918,96.9,3735,1841,1894,97.2
11150, 양천구,070005, 69세,2017,3616,1783,1833,97.3,3585,1773,1812,97.8
11150, 양천구,075,70~74세,2017,13582,6544,7038,93,13510,6510,7000,93
11150, 양천구,075001, 70세,2017,3548,1750,1798,97.3,3527,1735,1792,96.8
11150, 양천구,075002, 71세,2017,2683,1299,1384,93.9,2665,1291,1374,94
11150, 양천구,075003, 72세,2017,2492,1184,1308,90.5,2482,1180,1302,90.6
11150, 양천구,075004, 73세,2017,2449,1152,1297,88.8,2437,1148,1289,89.1
11150, 양천구,075005, 74세,2017,2410,1159,1251,92.6,2399,1156,1243,93
11150, 양천구,080,75~79세,2017,9974,4352,5622,77.4,9927,4336,5591,77.6
11150, 양천구,080001, 75세,2017,2632,1204,1428,84.3,2626,1203,1423,84.5
11150, 양천구,080002, 76세,2017,2146,989,1157,85.5,2138,986,1152,85.6
11150, 양천구,080003, 77세,2017,1841,767,1074,71.4,1829,764,1065,71.7
11150, 양천구,080004, 78세,2017,1787,734,1053,69.7,1776,729,1047,69.6
11150, 양천구,080005, 79세,2017,1568,658,910,72.3,1558,654,904,72.3
11150, 양천구,085,80~84세,2017,5786,2009,3777,53.2,5752,1999,3753,53.3
11150, 양천구,085001, 80세,2017,1516,553,963,57.4,1507,549,958,57.3
11150, 양천구,085002, 81세,2017,1285,462,823,56.1,1276,460,816,56.4
11150, 양천구,085003, 82세,2017,1159,397,762,52.1,1151,395,756,52.2
11150, 양천구,085004, 83세,2017,977,321,656,48.9,972,320,652,49.1
11150, 양천구,085005, 84세,2017,849,276,573,48.2,846,275,571,48.2
11150, 양천구,090,85~89세,2017,2798,782,2016,38.8,2788,778,2010,38.7
11150, 양천구,090001, 85세,2017,769,226,543,41.6,766,225,541,41.6
11150, 양천구,090002, 86세,2017,602,171,431,39.7,598,169,429,39.4
11150, 양천구,090003, 87세,2017,558,140,418,33.5,557,140,417,33.6
11150, 양천구,090004, 88세,2017,490,144,346,41.6,489,144,345,41.7
11150, 양천구,090005, 89세,2017,379,101,278,36.3,378,100,278,36
11150, 양천구,095,90~94세,2017,867,196,671,29.2,862,195,667,29.2
11150, 양천구,095001, 90세,2017,253,65,188,34.6,252,65,187,34.8
11150, 양천구,095002, 91세,2017,205,41,164,25,201,40,161,24.8
11150, 양천구,095003, 92세,2017,172,36,136,26.5,172,36,136,26.5
11150, 양천구,095004, 93세,2017,103,22,81,27.2,103,22,81,27.2
11150, 양천구,095005, 94세,2017,134,32,102,31.4,134,32,102,31.4
11150, 양천구,100,95~99세,2017,196,49,147,33.3,196,49,147,33.3
11150, 양천구,100001, 95세,2017,77,14,63,22.2,77,14,63,22.2
11150, 양천구,100002, 96세,2017,54,13,41,31.7,54,13,41,31.7
11150, 양천구,100003, 97세,2017,30,11,19,57.9,30,11,19,57.9
11150, 양천구,100004, 98세,2017,25,7,18,38.9,25,7,18,38.9
11150, 양천구,100005, 99세,2017,10,X,6,66.7,10,X,6,66.7
11150, 양천구,101,100세이상,2017,27,X,23,17.4,26,X,23,13
11150, 양천구,102,15세미만,2017,60341,31265,29076,107.5,60145,31167,28978,107.6
11150, 양천구,103,15~64세,2017,338750,167532,171218,97.8,333903,165340,168563,98.1
11150, 양천구,104,65세이상,2017,53020,23706,29314,80.9,52595,23528,29067,80.9
11150, 양천구,086,85세이상,2017,3888,1031,2857,36.1,3872,1025,2847,36
11150, 양천구,126,평균연령,2017,40.6,39.7,41.5,,40.6,39.7,41.4,
11150, 양천구,127,중위연령,2017,42.3,41.3,43.1,,42.3,41.3,43.1,
11160, 강서구,000,합계,2017,581675,282678,298997,94.5,572993,278564,294429,94.6
11160, 강서구,005,0~4세,2017,25259,12817,12442,103,25045,12707,12338,103
11160, 강서구,005001, 0세,2017,4738,2450,2288,107.1,4684,2417,2267,106.6
11160, 강서구,005002, 1세,2017,5395,2758,2637,104.6,5349,2739,2610,104.9
11160, 강서구,005003, 2세,2017,5189,2618,2571,101.8,5145,2593,2552,101.6
11160, 강서구,005004, 3세,2017,5031,2537,2494,101.7,4986,2513,2473,101.6
11160, 강서구,005005, 4세,2017,4906,2454,2452,100.1,4881,2445,2436,100.4
11160, 강서구,010,5~9세,2017,23175,11881,11294,105.2,23070,11824,11246,105.1
11160, 강서구,010001, 5세,2017,5202,2666,2536,105.1,5176,2651,2525,105
11160, 강서구,010002, 6세,2017,4803,2457,2346,104.7,4779,2444,2335,104.7
11160, 강서구,010003, 7세,2017,4378,2271,2107,107.8,4360,2260,2100,107.6
11160, 강서구,010004, 8세,2017,4196,2181,2015,108.2,4177,2172,2005,108.3
11160, 강서구,010005, 9세,2017,4596,2306,2290,100.7,4578,2297,2281,100.7
11160, 강서구,015,10~14세,2017,21866,11162,10704,104.3,21829,11146,10683,104.3
11160, 강서구,015001, 10세,2017,4512,2305,2207,104.4,4503,2302,2201,104.6
11160, 강서구,015002, 11세,2017,4174,2145,2029,105.7,4164,2141,2023,105.8
11160, 강서구,015003, 12세,2017,4065,2050,2015,101.7,4059,2049,2010,101.9
11160, 강서구,015004, 13세,2017,4533,2325,2208,105.3,4530,2322,2208,105.2
11160, 강서구,015005, 14세,2017,4582,2337,2245,104.1,4573,2332,2241,104.1
11160, 강서구,020,15~19세,2017,26958,13645,13313,102.5,26858,13608,13250,102.7
11160, 강서구,020001, 15세,2017,4726,2421,2305,105,4717,2417,2300,105.1
11160, 강서구,020002, 16세,2017,5346,2659,2687,99,5338,2656,2682,99
11160, 강서구,020003, 17세,2017,5940,2952,2988,98.8,5915,2945,2970,99.2
11160, 강서구,020004, 18세,2017,5504,2819,2685,105,5471,2805,2666,105.2
11160, 강서구,020005, 19세,2017,5442,2794,2648,105.5,5417,2785,2632,105.8
11160, 강서구,025,20~24세,2017,35728,17506,18222,96.1,35310,17344,17966,96.5
11160, 강서구,025001, 20세,2017,6194,3147,3047,103.3,6168,3141,3027,103.8
11160, 강서구,025002, 21세,2017,6545,3425,3120,109.8,6483,3393,3090,109.8
11160, 강서구,025003, 22세,2017,7082,3548,3534,100.4,7004,3520,3484,101
11160, 강서구,025004, 23세,2017,7528,3526,4002,88.1,7431,3491,3940,88.6
11160, 강서구,025005, 24세,2017,8379,3860,4519,85.4,8224,3799,4425,85.9
11160, 강서구,030,25~29세,2017,46711,21874,24837,88.1,45649,21418,24231,88.4
11160, 강서구,030001, 25세,2017,9114,4170,4944,84.3,8962,4107,4855,84.6
11160, 강서구,030002, 26세,2017,9290,4259,5031,84.7,9116,4189,4927,85
11160, 강서구,030003, 27세,2017,9415,4398,5017,87.7,9155,4279,4876,87.8
11160, 강서구,030004, 28세,2017,9279,4442,4837,91.8,9051,4354,4697,92.7
11160, 강서구,030005, 29세,2017,9613,4605,5008,92,9365,4489,4876,92.1
11160, 강서구,035,30~34세,2017,51685,25909,25776,100.5,50399,25320,25079,101
11160, 강서구,035001, 30세,2017,9619,4620,4999,92.4,9328,4490,4838,92.8
11160, 강서구,035002, 31세,2017,10014,4948,5066,97.7,9756,4842,4914,98.5
11160, 강서구,035003, 32세,2017,10263,5220,5043,103.5,9996,5083,4913,103.5
11160, 강서구,035004, 33세,2017,10470,5277,5193,101.6,10218,5163,5055,102.1
11160, 강서구,035005, 34세,2017,11319,5844,5475,106.7,11101,5742,5359,107.1
11160, 강서구,040,35~39세,2017,54141,27878,26263,106.1,53218,27413,25805,106.2
11160, 강서구,040001, 35세,2017,11751,5997,5754,104.2,11531,5884,5647,104.2
11160, 강서구,040002, 36세,2017,11391,6020,5371,112.1,11202,5935,5267,112.7
11160, 강서구,040003, 37세,2017,11390,5808,5582,104,11200,5718,5482,104.3
11160, 강서구,040004, 38세,2017,10518,5404,5114,105.7,10347,5317,5030,105.7
11160, 강서구,040005, 39세,2017,9091,4649,4442,104.7,8938,4559,4379,104.1
11160, 강서구,045,40~44세,2017,46258,23485,22773,103.1,45601,23114,22487,102.8
11160, 강서구,045001, 40세,2017,9185,4649,4536,102.5,9050,4573,4477,102.1
11160, 강서구,045002, 41세,2017,8699,4434,4265,104,8568,4353,4215,103.3
11160, 강서구,045003, 42세,2017,8975,4549,4426,102.8,8866,4496,4370,102.9
11160, 강서구,045004, 43세,2017,9746,4881,4865,100.3,9621,4801,4820,99.6
11160, 강서구,045005, 44세,2017,9653,4972,4681,106.2,9496,4891,4605,106.2
11160, 강서구,050,45~49세,2017,46565,23048,23517,98,45775,22646,23129,97.9
11160, 강서구,050001, 45세,2017,9394,4751,4643,102.3,9238,4677,4561,102.5
11160, 강서구,050002, 46세,2017,9692,4841,4851,99.8,9537,4747,4790,99.1
11160, 강서구,050003, 47세,2017,9188,4525,4663,97,9017,4434,4583,96.7
11160, 강서구,050004, 48세,2017,9208,4554,4654,97.9,9058,4488,4570,98.2
11160, 강서구,050005, 49세,2017,9083,4377,4706,93,8925,4300,4625,93
11160, 강서구,055,50~54세,2017,42510,20145,22365,90.1,41592,19706,21886,90
11160, 강서구,055001, 50세,2017,8326,3935,4391,89.6,8177,3858,4319,89.3
11160, 강서구,055002, 51세,2017,8181,3905,4276,91.3,8015,3827,4188,91.4
11160, 강서구,055003, 52세,2017,8673,4122,4551,90.6,8486,4024,4462,90.2
11160, 강서구,055004, 53세,2017,8301,3879,4422,87.7,8099,3790,4309,88
11160, 강서구,055005, 54세,2017,9029,4304,4725,91.1,8815,4207,4608,91.3
11160, 강서구,060,55~59세,2017,48091,22554,25537,88.3,47282,22159,25123,88.2
11160, 강서구,060001, 55세,2017,9240,4422,4818,91.8,9032,4313,4719,91.4
11160, 강서구,060002, 56세,2017,10114,4700,5414,86.8,9991,4637,5354,86.6
11160, 강서구,060003, 57세,2017,10200,4702,5498,85.5,10037,4618,5419,85.2
11160, 강서구,060004, 58세,2017,9557,4548,5009,90.8,9398,4476,4922,90.9
11160, 강서구,060005, 59세,2017,8980,4182,4798,87.2,8824,4115,4709,87.4
11160, 강서구,065,60~64세,2017,39422,18332,21090,86.9,38642,17953,20689,86.8
11160, 강서구,065001, 60세,2017,9180,4309,4871,88.5,9005,4223,4782,88.3
11160, 강서구,065002, 61세,2017,8157,3768,4389,85.9,7989,3687,4302,85.7
11160, 강서구,065003, 62세,2017,8630,3910,4720,82.8,8469,3833,4636,82.7
11160, 강서구,065004, 63세,2017,7083,3291,3792,86.8,6934,3224,3710,86.9
11160, 강서구,065005, 64세,2017,6372,3054,3318,92,6245,2986,3259,91.6
11160, 강서구,070,65~69세,2017,27324,13119,14205,92.4,27002,12974,14028,92.5
11160, 강서구,070001, 65세,2017,6783,3244,3539,91.7,6674,3193,3481,91.7
11160, 강서구,070002, 66세,2017,4731,2258,2473,91.3,4659,2226,2433,91.5
11160, 강서구,070003, 67세,2017,5402,2589,2813,92,5338,2560,2778,92.2
11160, 강서구,070004, 68세,2017,5384,2570,2814,91.3,5333,2548,2785,91.5
11160, 강서구,070005, 69세,2017,5024,2458,2566,95.8,4998,2447,2551,95.9
11160, 강서구,075,70~74세,2017,18967,9180,9787,93.8,18842,9129,9713,94
11160, 강서구,075001, 70세,2017,5110,2488,2622,94.9,5077,2474,2603,95
11160, 강서구,075002, 71세,2017,3773,1857,1916,96.9,3751,1848,1903,97.1
11160, 강서구,075003, 72세,2017,3532,1716,1816,94.5,3502,1703,1799,94.7
11160, 강서구,075004, 73세,2017,3344,1638,1706,96,3325,1631,1694,96.3
11160, 강서구,075005, 74세,2017,3208,1481,1727,85.8,3187,1473,1714,85.9
11160, 강서구,080,75~79세,2017,13805,5989,7816,76.6,13725,5967,7758,76.9
11160, 강서구,080001, 75세,2017,3651,1715,1936,88.6,3629,1707,1922,88.8
11160, 강서구,080002, 76세,2017,2865,1249,1616,77.3,2857,1245,1612,77.2
11160, 강서구,080003, 77세,2017,2639,1154,1485,77.7,2619,1147,1472,77.9
11160, 강서구,080004, 78세,2017,2515,1003,1512,66.3,2498,1000,1498,66.8
11160, 강서구,080005, 79세,2017,2135,868,1267,68.5,2122,868,1254,69.2
11160, 강서구,085,80~84세,2017,7700,2708,4992,54.2,7666,2696,4970,54.2
11160, 강서구,085001, 80세,2017,1873,685,1188,57.7,1866,682,1184,57.6
11160, 강서구,085002, 81세,2017,1644,597,1047,57,1636,594,1042,57
11160, 강서구,085003, 82세,2017,1667,591,1076,54.9,1663,589,1074,54.8
11160, 강서구,085004, 83세,2017,1345,450,895,50.3,1337,448,889,50.4
11160, 강서구,085005, 84세,2017,1171,385,786,49,1164,383,781,49
11160, 강서구,090,85~89세,2017,3868,1059,2809,37.7,3852,1055,2797,37.7
11160, 강서구,090001, 85세,2017,1028,310,718,43.2,1025,310,715,43.4
11160, 강서구,090002, 86세,2017,802,232,570,40.7,796,229,567,40.4
11160, 강서구,090003, 87세,2017,802,210,592,35.5,797,209,588,35.5
11160, 강서구,090004, 88세,2017,688,178,510,34.9,686,178,508,35
11160, 강서구,090005, 89세,2017,548,129,419,30.8,548,129,419,30.8
11160, 강서구,095,90~94세,2017,1315,313,1002,31.2,1310,311,999,31.1
11160, 강서구,095001, 90세,2017,428,99,329,30.1,427,99,328,30.2
11160, 강서구,095002, 91세,2017,298,65,233,27.9,296,64,232,27.6
11160, 강서구,095003, 92세,2017,249,57,192,29.7,249,57,192,29.7
11160, 강서구,095004, 93세,2017,191,58,133,43.6,189,57,132,43.2
11160, 강서구,095005, 94세,2017,149,34,115,29.6,149,34,115,29.6
11160, 강서구,100,95~99세,2017,293,70,223,31.4,292,70,222,31.5
11160, 강서구,100001, 95세,2017,125,26,99,26.3,124,26,98,26.5
11160, 강서구,100002, 96세,2017,64,16,48,33.3,64,16,48,33.3
11160, 강서구,100003, 97세,2017,48,14,34,41.2,48,14,34,41.2
11160, 강서구,100004, 98세,2017,41,7,34,20.6,41,7,34,20.6
11160, 강서구,100005, 99세,2017,15,7,8,87.5,15,7,8,87.5
11160, 강서구,101,100세이상,2017,34,X,30,13.3,34,X,30,13.3
11160, 강서구,102,15세미만,2017,70300,35860,34440,104.1,69944,35677,34267,104.1
11160, 강서구,103,15~64세,2017,438069,214376,223693,95.8,430326,210681,219645,95.9
11160, 강서구,104,65세이상,2017,73306,32442,40864,79.4,72723,32206,40517,79.5
11160, 강서구,086,85세이상,2017,5510,1446,4064,35.6,5488,1440,4048,35.6
11160, 강서구,126,평균연령,2017,41,40.1,41.8,,40.9,40.1,41.7,
11160, 강서구,127,중위연령,2017,40.6,39.7,41.5,,40.6,39.7,41.5,
11170, 구로구,000,합계,2017,436869,218428,218441,100,394962,195772,199190,98.3
11170, 구로구,005,0~4세,2017,18025,9174,8851,103.6,16969,8637,8332,103.7
11170, 구로구,005001, 0세,2017,3318,1696,1622,104.6,3076,1568,1508,104
11170, 구로구,005002, 1세,2017,3608,1866,1742,107.1,3374,1742,1632,106.7
11170, 구로구,005003, 2세,2017,3777,1897,1880,100.9,3575,1806,1769,102.1
11170, 구로구,005004, 3세,2017,3597,1834,1763,104,3419,1740,1679,103.6
11170, 구로구,005005, 4세,2017,3725,1881,1844,102,3525,1781,1744,102.1
11170, 구로구,010,5~9세,2017,17196,8674,8522,101.8,16632,8373,8259,101.4
11170, 구로구,010001, 5세,2017,3768,1881,1887,99.7,3610,1801,1809,99.6
11170, 구로구,010002, 6세,2017,3574,1810,1764,102.6,3462,1748,1714,102
11170, 구로구,010003, 7세,2017,3425,1752,1673,104.7,3315,1690,1625,104
11170, 구로구,010004, 8세,2017,3157,1580,1577,100.2,3064,1536,1528,100.5
11170, 구로구,010005, 9세,2017,3272,1651,1621,101.9,3181,1598,1583,100.9
11170, 구로구,015,10~14세,2017,14708,7581,7127,106.4,14389,7422,6967,106.5
11170, 구로구,015001, 10세,2017,3263,1622,1641,98.8,3156,1574,1582,99.5
11170, 구로구,015002, 11세,2017,2939,1541,1398,110.2,2881,1516,1365,111.1
11170, 구로구,015003, 12세,2017,2683,1443,1240,116.4,2623,1405,1218,115.4
11170, 구로구,015004, 13세,2017,2924,1513,1411,107.2,2876,1487,1389,107.1
11170, 구로구,015005, 14세,2017,2899,1462,1437,101.7,2853,1440,1413,101.9
11170, 구로구,020,15~19세,2017,18416,9772,8644,113,18081,9584,8497,112.8
11170, 구로구,020001, 15세,2017,3099,1627,1472,110.5,3061,1602,1459,109.8
11170, 구로구,020002, 16세,2017,3596,1966,1630,120.6,3549,1935,1614,119.9
11170, 구로구,020003, 17세,2017,3954,2101,1853,113.4,3886,2062,1824,113
11170, 구로구,020004, 18세,2017,3826,2016,1810,111.4,3757,1976,1781,110.9
11170, 구로구,020005, 19세,2017,3941,2062,1879,109.7,3828,2009,1819,110.4
11170, 구로구,025,20~24세,2017,24989,12505,12484,100.2,23850,12001,11849,101.3
11170, 구로구,025001, 20세,2017,4342,2228,2114,105.4,4194,2162,2032,106.4
11170, 구로구,025002, 21세,2017,4608,2382,2226,107,4457,2302,2155,106.8
11170, 구로구,025003, 22세,2017,4891,2461,2430,101.3,4680,2364,2316,102.1
11170, 구로구,025004, 23세,2017,5459,2744,2715,101.1,5172,2616,2556,102.3
11170, 구로구,025005, 24세,2017,5689,2690,2999,89.7,5347,2557,2790,91.6
11170, 구로구,030,25~29세,2017,31989,15766,16223,97.2,28269,13788,14481,95.2
11170, 구로구,030001, 25세,2017,6226,3002,3224,93.1,5701,2743,2958,92.7
11170, 구로구,030002, 26세,2017,6359,3125,3234,96.6,5711,2777,2934,94.6
11170, 구로구,030003, 27세,2017,6475,3228,3247,99.4,5678,2794,2884,96.9
11170, 구로구,030004, 28세,2017,6406,3186,3220,98.9,5556,2736,2820,97
11170, 구로구,030005, 29세,2017,6523,3225,3298,97.8,5623,2738,2885,94.9
11170, 구로구,035,30~34세,2017,35596,18131,17465,103.8,31195,15720,15475,101.6
11170, 구로구,035001, 30세,2017,6873,3379,3494,96.7,5884,2881,3003,95.9
11170, 구로구,035002, 31세,2017,6813,3485,3328,104.7,5852,2953,2899,101.9
11170, 구로구,035003, 32세,2017,6909,3534,3375,104.7,6056,3054,3002,101.7
11170, 구로구,035004, 33세,2017,7250,3704,3546,104.5,6421,3239,3182,101.8
11170, 구로구,035005, 34세,2017,7751,4029,3722,108.2,6982,3593,3389,106
11170, 구로구,040,35~39세,2017,38727,20264,18463,109.8,35435,18253,17182,106.2
11170, 구로구,040001, 35세,2017,8226,4265,3961,107.7,7407,3785,3622,104.5
11170, 구로구,040002, 36세,2017,8015,4156,3859,107.7,7433,3793,3640,104.2
11170, 구로구,040003, 37세,2017,7992,4181,3811,109.7,7381,3810,3571,106.7
11170, 구로구,040004, 38세,2017,7682,4073,3609,112.9,7022,3647,3375,108.1
11170, 구로구,040005, 39세,2017,6812,3589,3223,111.4,6192,3218,2974,108.2
11170, 구로구,045,40~44세,2017,34919,18532,16387,113.1,31730,16504,15226,108.4
11170, 구로구,045001, 40세,2017,6880,3661,3219,113.7,6299,3280,3019,108.6
11170, 구로구,045002, 41세,2017,6762,3595,3167,113.5,6176,3204,2972,107.8
11170, 구로구,045003, 42세,2017,6570,3489,3081,113.2,6022,3145,2877,109.3
11170, 구로구,045004, 43세,2017,7275,3841,3434,111.9,6599,3414,3185,107.2
11170, 구로구,045005, 44세,2017,7432,3946,3486,113.2,6634,3461,3173,109.1
11170, 구로구,050,45~49세,2017,36693,18823,17870,105.3,31851,16081,15770,102
11170, 구로구,050001, 45세,2017,7241,3870,3371,114.8,6404,3367,3037,110.9
11170, 구로구,050002, 46세,2017,7544,3916,3628,107.9,6624,3417,3207,106.5
11170, 구로구,050003, 47세,2017,7398,3785,3613,104.8,6317,3184,3133,101.6
11170, 구로구,050004, 48세,2017,7352,3753,3599,104.3,6350,3164,3186,99.3
11170, 구로구,050005, 49세,2017,7158,3499,3659,95.6,6156,2949,3207,92
11170, 구로구,055,50~54세,2017,35343,17768,17575,101.1,29388,14561,14827,98.2
11170, 구로구,055001, 50세,2017,6763,3432,3331,103,5904,2962,2942,100.7
11170, 구로구,055002, 51세,2017,6776,3437,3339,102.9,5699,2820,2879,98
11170, 구로구,055003, 52세,2017,7267,3671,3596,102.1,6026,3007,3019,99.6
11170, 구로구,055004, 53세,2017,7040,3523,3517,100.2,5767,2845,2922,97.4
11170, 구로구,055005, 54세,2017,7497,3705,3792,97.7,5992,2927,3065,95.5
11170, 구로구,060,55~59세,2017,37716,18271,19445,94,32759,15700,17059,92
11170, 구로구,060001, 55세,2017,7584,3747,3837,97.7,6376,3138,3238,96.9
11170, 구로구,060002, 56세,2017,7523,3635,3888,93.5,6817,3293,3524,93.4
11170, 구로구,060003, 57세,2017,8170,3897,4273,91.2,7016,3271,3745,87.3
11170, 구로구,060004, 58세,2017,7249,3472,3777,91.9,6365,2989,3376,88.5
11170, 구로구,060005, 59세,2017,7190,3520,3670,95.9,6185,3009,3176,94.7
11170, 구로구,065,60~64세,2017,32837,15760,17077,92.3,27844,13085,14759,88.7
11170, 구로구,065001, 60세,2017,7412,3593,3819,94.1,6159,2909,3250,89.5
11170, 구로구,065002, 61세,2017,6879,3255,3624,89.8,5806,2691,3115,86.4
11170, 구로구,065003, 62세,2017,7060,3430,3630,94.5,6049,2875,3174,90.6
11170, 구로구,065004, 63세,2017,6086,2891,3195,90.5,5138,2405,2733,88
11170, 구로구,065005, 64세,2017,5400,2591,2809,92.2,4692,2205,2487,88.7
11170, 구로구,070,65~69세,2017,22595,11035,11560,95.5,20627,10050,10577,95
11170, 구로구,070001, 65세,2017,5415,2626,2789,94.2,4833,2324,2509,92.6
11170, 구로구,070002, 66세,2017,4118,2003,2115,94.7,3646,1767,1879,94
11170, 구로구,070003, 67세,2017,4545,2215,2330,95.1,4136,2001,2135,93.7
11170, 구로구,070004, 68세,2017,4419,2143,2276,94.2,4129,2008,2121,94.7
11170, 구로구,070005, 69세,2017,4098,2048,2050,99.9,3883,1950,1933,100.9
11170, 구로구,075,70~74세,2017,15958,7783,8175,95.2,15400,7561,7839,96.5
11170, 구로구,075001, 70세,2017,4230,2113,2117,99.8,4030,2019,2011,100.4
11170, 구로구,075002, 71세,2017,3109,1495,1614,92.6,2978,1440,1538,93.6
11170, 구로구,075003, 72세,2017,2955,1439,1516,94.9,2870,1411,1459,96.7
11170, 구로구,075004, 73세,2017,2832,1382,1450,95.3,2755,1351,1404,96.2
11170, 구로구,075005, 74세,2017,2832,1354,1478,91.6,2767,1340,1427,93.9
11170, 구로구,080,75~79세,2017,11733,5330,6403,83.2,11376,5243,6133,85.5
11170, 구로구,080001, 75세,2017,3190,1500,1690,88.8,3112,1482,1630,90.9
11170, 구로구,080002, 76세,2017,2407,1139,1268,89.8,2336,1124,1212,92.7
11170, 구로구,080003, 77세,2017,2186,946,1240,76.3,2107,932,1175,79.3
11170, 구로구,080004, 78세,2017,2073,929,1144,81.2,2008,911,1097,83
11170, 구로구,080005, 79세,2017,1877,816,1061,76.9,1813,794,1019,77.9
11170, 구로구,085,80~84세,2017,6007,2347,3660,64.1,5837,2314,3523,65.7
11170, 구로구,085001, 80세,2017,1535,659,876,75.2,1489,650,839,77.5
11170, 구로구,085002, 81세,2017,1351,553,798,69.3,1308,546,762,71.7
11170, 구로구,085003, 82세,2017,1283,476,807,59,1250,468,782,59.8
11170, 구로구,085004, 83세,2017,982,347,635,54.6,958,344,614,56
11170, 구로구,085005, 84세,2017,856,312,544,57.4,832,306,526,58.2
11170, 구로구,090,85~89세,2017,2441,714,1727,41.3,2368,700,1668,42
11170, 구로구,090001, 85세,2017,677,231,446,51.8,658,226,432,52.3
11170, 구로구,090002, 86세,2017,528,158,370,42.7,510,154,356,43.3
11170, 구로구,090003, 87세,2017,504,139,365,38.1,487,137,350,39.1
11170, 구로구,090004, 88세,2017,399,112,287,39,389,112,277,40.4
11170, 구로구,090005, 89세,2017,333,74,259,28.6,324,71,253,28.1
11170, 구로구,095,90~94세,2017,792,164,628,26.1,774,161,613,26.3
11170, 구로구,095001, 90세,2017,275,60,215,27.9,271,60,211,28.4
11170, 구로구,095002, 91세,2017,192,42,150,28,187,40,147,27.2
11170, 구로구,095003, 92세,2017,125,17,108,15.7,122,17,105,16.2
11170, 구로구,095004, 93세,2017,100,23,77,29.9,96,23,73,31.5
11170, 구로구,095005, 94세,2017,100,22,78,28.2,98,21,77,27.3
11170, 구로구,100,95~99세,2017,173,32,141,22.7,172,32,140,22.9
11170, 구로구,100001, 95세,2017,72,15,57,26.3,72,15,57,26.3
11170, 구로구,100002, 96세,2017,43,6,37,16.2,42,6,36,16.7
11170, 구로구,100003, 97세,2017,34,9,25,36,34,9,25,36
11170, 구로구,100004, 98세,2017,12,X,10,20,12,X,10,20
11170, 구로구,100005, 99세,2017,12,X,12,0,12,X,12,0
11170, 구로구,101,100세이상,2017,16,X,14,14.3,16,X,14,14.3
11170, 구로구,102,15세미만,2017,49929,25429,24500,103.8,47990,24432,23558,103.7
11170, 구로구,103,15~64세,2017,327225,165592,161633,102.4,290402,145277,145125,100.1
11170, 구로구,104,65세이상,2017,59715,27407,32308,84.8,56570,26063,30507,85.4
11170, 구로구,086,85세이상,2017,3422,912,2510,36.3,3330,895,2435,36.8
11170, 구로구,126,평균연령,2017,42.2,41.5,42.8,,41.8,41.1,42.5,
11170, 구로구,127,중위연령,2017,42.8,42,43.6,,42,41.3,42.9,
11180, 금천구,000,합계,2017,249930,127252,122678,103.7,224487,113579,110908,102.4
11180, 금천구,005,0~4세,2017,8449,4370,4079,107.1,7771,4015,3756,106.9
11180, 금천구,005001, 0세,2017,1612,859,753,114.1,1454,766,688,111.3
11180, 금천구,005002, 1세,2017,1780,913,867,105.3,1612,824,788,104.6
11180, 금천구,005003, 2세,2017,1816,937,879,106.6,1699,875,824,106.2
11180, 금천구,005004, 3세,2017,1670,869,801,108.5,1542,808,734,110.1
11180, 금천구,005005, 4세,2017,1571,792,779,101.7,1464,742,722,102.8
11180, 금천구,010,5~9세,2017,7730,3970,3760,105.6,7341,3771,3570,105.6
11180, 금천구,010001, 5세,2017,1811,926,885,104.6,1684,865,819,105.6
11180, 금천구,010002, 6세,2017,1569,789,780,101.2,1481,745,736,101.2
11180, 금천구,010003, 7세,2017,1496,786,710,110.7,1422,744,678,109.7
11180, 금천구,010004, 8세,2017,1420,722,698,103.4,1366,696,670,103.9
11180, 금천구,010005, 9세,2017,1434,747,687,108.7,1388,721,667,108.1
11180, 금천구,015,10~14세,2017,7414,3729,3685,101.2,7281,3654,3627,100.7
11180, 금천구,015001, 10세,2017,1497,745,752,99.1,1458,720,738,97.6
11180, 금천구,015002, 11세,2017,1422,701,721,97.2,1394,685,709,96.6
11180, 금천구,015003, 12세,2017,1429,738,691,106.8,1397,719,678,106
11180, 금천구,015004, 13세,2017,1482,745,737,101.1,1463,738,725,101.8
11180, 금천구,015005, 14세,2017,1584,800,784,102,1569,792,777,101.9
11180, 금천구,020,15~19세,2017,10411,5297,5114,103.6,10260,5232,5028,104.1
11180, 금천구,020001, 15세,2017,1711,896,815,109.9,1690,886,804,110.2
11180, 금천구,020002, 16세,2017,1918,937,981,95.5,1900,929,971,95.7
11180, 금천구,020003, 17세,2017,2212,1085,1127,96.3,2178,1070,1108,96.6
11180, 금천구,020004, 18세,2017,2284,1194,1090,109.5,2248,1176,1072,109.7
11180, 금천구,020005, 19세,2017,2286,1185,1101,107.6,2244,1171,1073,109.1
11180, 금천구,025,20~24세,2017,15321,7821,7500,104.3,14677,7534,7143,105.5
11180, 금천구,025001, 20세,2017,2544,1323,1221,108.4,2479,1290,1189,108.5
11180, 금천구,025002, 21세,2017,2819,1456,1363,106.8,2727,1413,1314,107.5
11180, 금천구,025003, 22세,2017,2921,1529,1392,109.8,2830,1495,1335,112
11180, 금천구,025004, 23세,2017,3405,1708,1697,100.6,3230,1633,1597,102.3
11180, 금천구,025005, 24세,2017,3632,1805,1827,98.8,3411,1703,1708,99.7
11180, 금천구,030,25~29세,2017,20347,10625,9722,109.3,18110,9487,8623,110
11180, 금천구,030001, 25세,2017,3959,2001,1958,102.2,3659,1842,1817,101.4
11180, 금천구,030002, 26세,2017,4119,2098,2021,103.8,3741,1905,1836,103.8
11180, 금천구,030003, 27세,2017,4203,2213,1990,111.2,3692,1956,1736,112.7
11180, 금천구,030004, 28세,2017,4120,2170,1950,111.3,3621,1923,1698,113.3
11180, 금천구,030005, 29세,2017,3946,2143,1803,118.9,3397,1861,1536,121.2
11180, 금천구,035,30~34세,2017,20375,11216,9159,122.5,17723,9752,7971,122.3
11180, 금천구,035001, 30세,2017,4169,2240,1929,116.1,3600,1939,1661,116.7
11180, 금천구,035002, 31세,2017,4127,2313,1814,127.5,3509,1969,1540,127.9
11180, 금천구,035003, 32세,2017,3919,2156,1763,122.3,3420,1874,1546,121.2
11180, 금천구,035004, 33세,2017,4086,2293,1793,127.9,3579,2003,1576,127.1
11180, 금천구,035005, 34세,2017,4074,2214,1860,119,3615,1967,1648,119.4
11180, 금천구,040,35~39세,2017,19608,10738,8870,121.1,17573,9504,8069,117.8
11180, 금천구,040001, 35세,2017,4364,2416,1948,124,3895,2134,1761,121.2
11180, 금천구,040002, 36세,2017,4014,2217,1797,123.4,3624,1982,1642,120.7
11180, 금천구,040003, 37세,2017,4008,2207,1801,122.5,3631,1979,1652,119.8
11180, 금천구,040004, 38세,2017,3803,2070,1733,119.4,3405,1824,1581,115.4
11180, 금천구,040005, 39세,2017,3419,1828,1591,114.9,3018,1585,1433,110.6
11180, 금천구,045,40~44세,2017,18218,9835,8383,117.3,16171,8551,7620,112.2
11180, 금천구,045001, 40세,2017,3423,1932,1491,129.6,3077,1708,1369,124.8
11180, 금천구,045002, 41세,2017,3378,1798,1580,113.8,2997,1549,1448,107
11180, 금천구,045003, 42세,2017,3500,1853,1647,112.5,3134,1635,1499,109.1
11180, 금천구,045004, 43세,2017,3862,2086,1776,117.5,3444,1824,1620,112.6
11180, 금천구,045005, 44세,2017,4055,2166,1889,114.7,3519,1835,1684,109
11180, 금천구,050,45~49세,2017,22053,11369,10684,106.4,19002,9652,9350,103.2
11180, 금천구,050001, 45세,2017,4051,2134,1917,111.3,3557,1844,1713,107.6
11180, 금천구,050002, 46세,2017,4436,2329,2107,110.5,3820,1975,1845,107
11180, 금천구,050003, 47세,2017,4437,2288,2149,106.5,3808,1929,1879,102.7
11180, 금천구,050004, 48세,2017,4488,2281,2207,103.4,3842,1944,1898,102.4
11180, 금천구,050005, 49세,2017,4641,2337,2304,101.4,3975,1960,2015,97.3
11180, 금천구,055,50~54세,2017,23002,11611,11391,101.9,19370,9651,9719,99.3
11180, 금천구,055001, 50세,2017,4166,2018,2148,93.9,3633,1727,1906,90.6
11180, 금천구,055002, 51세,2017,4507,2342,2165,108.2,3852,1970,1882,104.7
11180, 금천구,055003, 52세,2017,4734,2373,2361,100.5,3995,1956,2039,95.9
11180, 금천구,055004, 53세,2017,4639,2361,2278,103.6,3888,1958,1930,101.5
11180, 금천구,055005, 54세,2017,4956,2517,2439,103.2,4002,2040,1962,104
11180, 금천구,060,55~59세,2017,23723,11838,11885,99.6,20773,10299,10474,98.3
11180, 금천구,060001, 55세,2017,4881,2483,2398,103.5,4132,2074,2058,100.8
11180, 금천구,060002, 56세,2017,4861,2374,2487,95.5,4439,2162,2277,94.9
11180, 금천구,060003, 57세,2017,5098,2561,2537,100.9,4392,2195,2197,99.9
11180, 금천구,060004, 58세,2017,4592,2273,2319,98,4067,1984,2083,95.2
11180, 금천구,060005, 59세,2017,4291,2147,2144,100.1,3743,1884,1859,101.3
11180, 금천구,065,60~64세,2017,19029,9366,9663,96.9,16078,7813,8265,94.5
11180, 금천구,065001, 60세,2017,4248,2124,2124,100,3499,1739,1760,98.8
11180, 금천구,065002, 61세,2017,4080,2075,2005,103.5,3474,1742,1732,100.6
11180, 금천구,065003, 62세,2017,4095,1967,2128,92.4,3477,1635,1842,88.8
11180, 금천구,065004, 63세,2017,3610,1756,1854,94.7,3059,1459,1600,91.2
11180, 금천구,065005, 64세,2017,2996,1444,1552,93,2569,1238,1331,93
11180, 금천구,070,65~69세,2017,12976,6350,6626,95.8,11759,5747,6012,95.6
11180, 금천구,070001, 65세,2017,3201,1579,1622,97.3,2833,1386,1447,95.8
11180, 금천구,070002, 66세,2017,2427,1226,1201,102.1,2140,1075,1065,100.9
11180, 금천구,070003, 67세,2017,2636,1277,1359,94,2402,1177,1225,96.1
11180, 금천구,070004, 68세,2017,2468,1175,1293,90.9,2266,1073,1193,89.9
11180, 금천구,070005, 69세,2017,2244,1093,1151,95,2118,1036,1082,95.7
11180, 금천구,075,70~74세,2017,9087,4301,4786,89.9,8757,4177,4580,91.2
11180, 금천구,075001, 70세,2017,2335,1109,1226,90.5,2241,1073,1168,91.9
11180, 금천구,075002, 71세,2017,1741,812,929,87.4,1668,786,882,89.1
11180, 금천구,075003, 72세,2017,1751,836,915,91.4,1693,811,882,92
11180, 금천구,075004, 73세,2017,1623,738,885,83.4,1576,721,855,84.3
11180, 금천구,075005, 74세,2017,1637,806,831,97,1579,786,793,99.1
11180, 금천구,080,75~79세,2017,6775,3026,3749,80.7,6564,2976,3588,82.9
11180, 금천구,080001, 75세,2017,1824,852,972,87.7,1787,839,948,88.5
11180, 금천구,080002, 76세,2017,1457,656,801,81.9,1414,646,768,84.1
11180, 금천구,080003, 77세,2017,1253,555,698,79.5,1210,547,663,82.5
11180, 금천구,080004, 78세,2017,1231,538,693,77.6,1184,529,655,80.8
11180, 금천구,080005, 79세,2017,1010,425,585,72.6,969,415,554,74.9
11180, 금천구,085,80~84세,2017,3356,1257,2099,59.9,3254,1235,2019,61.2
11180, 금천구,085001, 80세,2017,833,341,492,69.3,805,337,468,72
11180, 금천구,085002, 81세,2017,760,296,464,63.8,742,291,451,64.5
11180, 금천구,085003, 82세,2017,704,248,456,54.4,684,243,441,55.1
11180, 금천구,085004, 83세,2017,590,211,379,55.7,567,207,360,57.5
11180, 금천구,085005, 84세,2017,469,161,308,52.3,456,157,299,52.5
11180, 금천구,090,85~89세,2017,1450,420,1030,40.8,1425,417,1008,41.4
11180, 금천구,090001, 85세,2017,436,144,292,49.3,428,143,285,50.2
11180, 금천구,090002, 86세,2017,324,111,213,52.1,319,109,210,51.9
11180, 금천구,090003, 87세,2017,278,73,205,35.6,273,73,200,36.5
11180, 금천구,090004, 88세,2017,206,50,156,32.1,204,50,154,32.5
11180, 금천구,090005, 89세,2017,206,42,164,25.6,201,42,159,26.4
11180, 금천구,095,90~94세,2017,466,88,378,23.3,461,87,374,23.3
11180, 금천구,095001, 90세,2017,168,29,139,20.9,167,29,138,21
11180, 금천구,095002, 91세,2017,89,13,76,17.1,88,13,75,17.3
11180, 금천구,095003, 92세,2017,93,15,78,19.2,93,15,78,19.2
11180, 금천구,095004, 93세,2017,58,12,46,26.1,55,11,44,25
11180, 금천구,095005, 94세,2017,58,19,39,48.7,58,19,39,48.7
11180, 금천구,100,95~99세,2017,124,24,100,24,122,24,98,24.5
11180, 금천구,100001, 95세,2017,50,11,39,28.2,48,11,37,29.7
11180, 금천구,100002, 96세,2017,23,X,19,21.1,23,X,19,21.1
11180, 금천구,100003, 97세,2017,27,5,22,22.7,27,5,22,22.7
11180, 금천구,100004, 98세,2017,14,X,12,16.7,14,X,12,16.7
11180, 금천구,100005, 99세,2017,10,X,8,25,10,X,8,25
11180, 금천구,101,100세이상,2017,16,X,15,6.7,15,X,14,7.1
11180, 금천구,102,15세미만,2017,23593,12069,11524,104.7,22393,11440,10953,104.4
11180, 금천구,103,15~64세,2017,192087,99716,92371,108,169737,87475,82262,106.3
11180, 금천구,104,65세이상,2017,34250,15467,18783,82.3,32357,14664,17693,82.9
11180, 금천구,086,85세이상,2017,2056,533,1523,35,2023,529,1494,35.4
11180, 금천구,126,평균연령,2017,43,42.2,43.9,,42.7,41.9,43.6,
11180, 금천구,127,중위연령,2017,44.3,43.1,45.6,,43.7,42.4,45,
11190, 영등포구,000,합계,2017,393560,196929,196631,100.2,346852,172220,174632,98.6
11190, 영등포구,005,0~4세,2017,15410,7961,7449,106.9,14233,7372,6861,107.4
11190, 영등포구,005001, 0세,2017,2954,1539,1415,108.8,2722,1434,1288,111.3
11190, 영등포구,005002, 1세,2017,3318,1720,1598,107.6,3032,1561,1471,106.1
11190, 영등포구,005003, 2세,2017,3257,1681,1576,106.7,3027,1552,1475,105.2
11190, 영등포구,005004, 3세,2017,3053,1546,1507,102.6,2813,1440,1373,104.9
11190, 영등포구,005005, 4세,2017,2828,1475,1353,109,2639,1385,1254,110.4
11190, 영등포구,010,5~9세,2017,12867,6504,6363,102.2,12205,6171,6034,102.3
11190, 영등포구,010001, 5세,2017,2901,1429,1472,97.1,2726,1343,1383,97.1
11190, 영등포구,010002, 6세,2017,2663,1312,1351,97.1,2520,1238,1282,96.6
11190, 영등포구,010003, 7세,2017,2441,1234,1207,102.2,2311,1169,1142,102.4
11190, 영등포구,010004, 8세,2017,2370,1232,1138,108.3,2260,1180,1080,109.3
11190, 영등포구,010005, 9세,2017,2492,1297,1195,108.5,2388,1241,1147,108.2
11190, 영등포구,015,10~14세,2017,11592,6176,5416,114,11226,5978,5248,113.9
11190, 영등포구,015001, 10세,2017,2490,1303,1187,109.8,2402,1264,1138,111.1
11190, 영등포구,015002, 11세,2017,2311,1208,1103,109.5,2225,1164,1061,109.7
11190, 영등포구,015003, 12세,2017,2117,1126,991,113.6,2031,1083,948,114.2
11190, 영등포구,015004, 13세,2017,2360,1264,1096,115.3,2294,1221,1073,113.8
11190, 영등포구,015005, 14세,2017,2314,1275,1039,122.7,2274,1246,1028,121.2
11190, 영등포구,020,15~19세,2017,14536,7530,7006,107.5,14209,7358,6851,107.4
11190, 영등포구,020001, 15세,2017,2435,1289,1146,112.5,2388,1266,1122,112.8
11190, 영등포구,020002, 16세,2017,2714,1407,1307,107.7,2662,1375,1287,106.8
11190, 영등포구,020003, 17세,2017,3024,1564,1460,107.1,2957,1523,1434,106.2
11190, 영등포구,020004, 18세,2017,3046,1620,1426,113.6,2981,1586,1395,113.7
11190, 영등포구,020005, 19세,2017,3317,1650,1667,99,3221,1608,1613,99.7
11190, 영등포구,025,20~24세,2017,22180,10710,11470,93.4,20975,10187,10788,94.4
11190, 영등포구,025001, 20세,2017,3616,1848,1768,104.5,3501,1796,1705,105.3
11190, 영등포구,025002, 21세,2017,3899,1953,1946,100.4,3740,1886,1854,101.7
11190, 영등포구,025003, 22세,2017,4380,2144,2236,95.9,4159,2057,2102,97.9
11190, 영등포구,025004, 23세,2017,4772,2271,2501,90.8,4469,2145,2324,92.3
11190, 영등포구,025005, 24세,2017,5513,2494,3019,82.6,5106,2303,2803,82.2
11190, 영등포구,030,25~29세,2017,33701,16352,17349,94.3,29522,14215,15307,92.9
11190, 영등포구,030001, 25세,2017,6245,2928,3317,88.3,5670,2636,3034,86.9
11190, 영등포구,030002, 26세,2017,6653,3072,3581,85.8,5911,2704,3207,84.3
11190, 영등포구,030003, 27세,2017,6720,3295,3425,96.2,5804,2836,2968,95.6
11190, 영등포구,030004, 28세,2017,7026,3554,3472,102.4,6070,3042,3028,100.5
11190, 영등포구,030005, 29세,2017,7057,3503,3554,98.6,6067,2997,3070,97.6
11190, 영등포구,035,30~34세,2017,36396,18803,17593,106.9,31595,16090,15505,103.8
11190, 영등포구,035001, 30세,2017,7335,3660,3675,99.6,6201,3047,3154,96.6
11190, 영등포구,035002, 31세,2017,7241,3717,3524,105.5,6172,3122,3050,102.4
11190, 영등포구,035003, 32세,2017,7198,3762,3436,109.5,6311,3258,3053,106.7
11190, 영등포구,035004, 33세,2017,7223,3824,3399,112.5,6363,3331,3032,109.9
11190, 영등포구,035005, 34세,2017,7399,3840,3559,107.9,6548,3332,3216,103.6
11190, 영등포구,040,35~39세,2017,34494,18285,16209,112.8,30837,16082,14755,109
11190, 영등포구,040001, 35세,2017,7671,4038,3633,111.1,6825,3556,3269,108.8
11190, 영등포구,040002, 36세,2017,7286,3924,3362,116.7,6621,3550,3071,115.6
11190, 영등포구,040003, 37세,2017,7086,3732,3354,111.3,6444,3333,3111,107.1
11190, 영등포구,040004, 38세,2017,6676,3533,3143,112.4,5874,3026,2848,106.3
11190, 영등포구,040005, 39세,2017,5775,3058,2717,112.6,5073,2617,2456,106.6
11190, 영등포구,045,40~44세,2017,30149,16048,14101,113.8,26659,13845,12814,108
11190, 영등포구,045001, 40세,2017,5993,3160,2833,111.5,5397,2778,2619,106.1
11190, 영등포구,045002, 41세,2017,5782,3023,2759,109.6,5149,2629,2520,104.3
11190, 영등포구,045003, 42세,2017,5733,3079,2654,116,5131,2704,2427,111.4
11190, 영등포구,045004, 43세,2017,6216,3377,2839,119,5449,2890,2559,112.9
11190, 영등포구,045005, 44세,2017,6425,3409,3016,113,5533,2844,2689,105.8
11190, 영등포구,050,45~49세,2017,33595,17351,16244,106.8,27977,14304,13673,104.6
11190, 영등포구,050001, 45세,2017,6455,3429,3026,113.3,5484,2872,2612,110
11190, 영등포구,050002, 46세,2017,6932,3570,3362,106.2,5854,2979,2875,103.6
11190, 영등포구,050003, 47세,2017,6770,3542,3228,109.7,5549,2877,2672,107.7
11190, 영등포구,050004, 48세,2017,6801,3415,3386,100.9,5679,2839,2840,100
11190, 영등포구,050005, 49세,2017,6637,3395,3242,104.7,5411,2737,2674,102.4
11190, 영등포구,055,50~54세,2017,32787,16609,16178,102.7,25894,13029,12865,101.3
11190, 영등포구,055001, 50세,2017,6098,3049,3049,100,5111,2506,2605,96.2
11190, 영등포구,055002, 51세,2017,6235,3192,3043,104.9,5027,2555,2472,103.4
11190, 영등포구,055003, 52세,2017,6613,3305,3308,99.9,5231,2604,2627,99.1
11190, 영등포구,055004, 53세,2017,6709,3369,3340,100.9,5206,2615,2591,100.9
11190, 영등포구,055005, 54세,2017,7132,3694,3438,107.4,5319,2749,2570,107
11190, 영등포구,060,55~59세,2017,33878,16598,17280,96.1,28248,13780,14468,95.2
11190, 영등포구,060001, 55세,2017,6840,3451,3389,101.8,5513,2799,2714,103.1
11190, 영등포구,060002, 56세,2017,6761,3235,3526,91.7,5933,2817,3116,90.4
11190, 영등포구,060003, 57세,2017,7313,3497,3816,91.6,6003,2852,3151,90.5
11190, 영등포구,060004, 58세,2017,6592,3253,3339,97.4,5525,2700,2825,95.6
11190, 영등포구,060005, 59세,2017,6372,3162,3210,98.5,5274,2612,2662,98.1
11190, 영등포구,065,60~64세,2017,28389,13976,14413,97,23012,11197,11815,94.8
11190, 영등포구,065001, 60세,2017,6556,3261,3295,99,5233,2572,2661,96.7
11190, 영등포구,065002, 61세,2017,6049,3012,3037,99.2,4854,2388,2466,96.8
11190, 영등포구,065003, 62세,2017,6169,2973,3196,93,5030,2384,2646,90.1
11190, 영등포구,065004, 63세,2017,5158,2558,2600,98.4,4197,2074,2123,97.7
11190, 영등포구,065005, 64세,2017,4457,2172,2285,95.1,3698,1779,1919,92.7
11190, 영등포구,070,65~69세,2017,19363,9369,9994,93.7,17279,8318,8961,92.8
11190, 영등포구,070001, 65세,2017,4724,2343,2381,98.4,4078,1992,2086,95.5
11190, 영등포구,070002, 66세,2017,3525,1716,1809,94.9,3005,1446,1559,92.8
11190, 영등포구,070003, 67세,2017,3825,1787,2038,87.7,3442,1597,1845,86.6
11190, 영등포구,070004, 68세,2017,3783,1825,1958,93.2,3448,1671,1777,94
11190, 영등포구,070005, 69세,2017,3506,1698,1808,93.9,3306,1612,1694,95.2
11190, 영등포구,075,70~74세,2017,13614,6367,7247,87.9,13092,6172,6920,89.2
11190, 영등포구,075001, 70세,2017,3418,1622,1796,90.3,3258,1561,1697,92
11190, 영등포구,075002, 71세,2017,2708,1302,1406,92.6,2585,1252,1333,93.9
11190, 영등포구,075003, 72세,2017,2547,1232,1315,93.7,2461,1197,1264,94.7
11190, 영등포구,075004, 73세,2017,2459,1102,1357,81.2,2388,1080,1308,82.6
11190, 영등포구,075005, 74세,2017,2482,1109,1373,80.8,2400,1082,1318,82.1
11190, 영등포구,080,75~79세,2017,10839,4786,6053,79.1,10450,4692,5758,81.5
11190, 영등포구,080001, 75세,2017,2892,1292,1600,80.8,2820,1273,1547,82.3
11190, 영등포구,080002, 76세,2017,2240,992,1248,79.5,2146,972,1174,82.8
11190, 영등포구,080003, 77세,2017,2020,875,1145,76.4,1947,852,1095,77.8
11190, 영등포구,080004, 78세,2017,1987,887,1100,80.6,1895,866,1029,84.2
11190, 영등포구,080005, 79세,2017,1700,740,960,77.1,1642,729,913,79.8
11190, 영등포구,085,80~84세,2017,6200,2461,3739,65.8,5972,2413,3559,67.8
11190, 영등포구,085001, 80세,2017,1575,657,918,71.6,1511,637,874,72.9
11190, 영등포구,085002, 81세,2017,1409,582,827,70.4,1358,570,788,72.3
11190, 영등포구,085003, 82세,2017,1296,558,738,75.6,1247,550,697,78.9
11190, 영등포구,085004, 83세,2017,1024,366,658,55.6,999,363,636,57.1
11190, 영등포구,085005, 84세,2017,896,298,598,49.8,857,293,564,52
11190, 영등포구,090,85~89세,2017,2492,772,1720,44.9,2417,754,1663,45.3
11190, 영등포구,090001, 85세,2017,709,248,461,53.8,681,239,442,54.1
11190, 영등포구,090002, 86세,2017,542,164,378,43.4,524,162,362,44.8
11190, 영등포구,090003, 87세,2017,488,145,343,42.3,473,141,332,42.5
11190, 영등포구,090004, 88세,2017,409,114,295,38.6,401,112,289,38.8
11190, 영등포구,090005, 89세,2017,344,101,243,41.6,338,100,238,42
11190, 영등포구,095,90~94세,2017,863,214,649,33,839,207,632,32.8
11190, 영등포구,095001, 90세,2017,286,70,216,32.4,275,68,207,32.9
11190, 영등포구,095002, 91세,2017,177,37,140,26.4,172,36,136,26.5
11190, 영등포구,095003, 92세,2017,150,35,115,30.4,146,34,112,30.4
11190, 영등포구,095004, 93세,2017,126,36,90,40,124,35,89,39.3
11190, 영등포구,095005, 94세,2017,124,36,88,40.9,122,34,88,38.6
11190, 영등포구,100,95~99세,2017,195,52,143,36.4,191,51,140,36.4
11190, 영등포구,100001, 95세,2017,75,21,54,38.9,72,20,52,38.5
11190, 영등포구,100002, 96세,2017,52,15,37,40.5,52,15,37,40.5
11190, 영등포구,100003, 97세,2017,35,10,25,40,34,10,24,41.7
11190, 영등포구,100004, 98세,2017,20,X,17,17.6,20,X,17,17.6
11190, 영등포구,100005, 99세,2017,13,X,10,30,13,X,10,30
11190, 영등포구,101,100세이상,2017,20,5,15,33.3,20,5,15,33.3
11190, 영등포구,102,15세미만,2017,39869,20641,19228,107.3,37664,19521,18143,107.6
11190, 영등포구,103,15~64세,2017,300105,152262,147843,103,258928,130087,128841,101
11190, 영등포구,104,65세이상,2017,53586,24026,29560,81.3,50260,22612,27648,81.8
11190, 영등포구,086,85세이상,2017,3570,1043,2527,41.3,3467,1017,2450,41.5
11190, 영등포구,126,평균연령,2017,42.5,41.8,43.1,,42,41.3,42.8,
11190, 영등포구,127,중위연령,2017,42.7,42,43.4,,41.6,41,42.3,
11200, 동작구,000,합계,2017,400236,195253,204983,95.3,384227,187799,196428,95.6
11200, 동작구,005,0~4세,2017,14705,7491,7214,103.8,14462,7371,7091,103.9
11200, 동작구,005001, 0세,2017,2747,1377,1370,100.5,2698,1343,1355,99.1
11200, 동작구,005002, 1세,2017,3000,1562,1438,108.6,2948,1533,1415,108.3
11200, 동작구,005003, 2세,2017,3153,1603,1550,103.4,3106,1585,1521,104.2
11200, 동작구,005004, 3세,2017,2910,1496,1414,105.8,2865,1474,1391,106
11200, 동작구,005005, 4세,2017,2895,1453,1442,100.8,2845,1436,1409,101.9
11200, 동작구,010,5~9세,2017,14130,7307,6823,107.1,14011,7242,6769,107
11200, 동작구,010001, 5세,2017,3024,1589,1435,110.7,2997,1571,1426,110.2
11200, 동작구,010002, 6세,2017,2931,1478,1453,101.7,2896,1458,1438,101.4
11200, 동작구,010003, 7세,2017,2764,1468,1296,113.3,2744,1459,1285,113.5
11200, 동작구,010004, 8세,2017,2707,1367,1340,102,2688,1358,1330,102.1
11200, 동작구,010005, 9세,2017,2704,1405,1299,108.2,2686,1396,1290,108.2
11200, 동작구,015,10~14세,2017,13293,6914,6379,108.4,13236,6891,6345,108.6
11200, 동작구,015001, 10세,2017,2786,1490,1296,115,2769,1484,1285,115.5
11200, 동작구,015002, 11세,2017,2565,1319,1246,105.9,2551,1312,1239,105.9
11200, 동작구,015003, 12세,2017,2534,1298,1236,105,2523,1293,1230,105.1
11200, 동작구,015004, 13세,2017,2688,1385,1303,106.3,2679,1382,1297,106.6
11200, 동작구,015005, 14세,2017,2720,1422,1298,109.6,2714,1420,1294,109.7
11200, 동작구,020,15~19세,2017,18338,9220,9118,101.1,17873,9045,8828,102.5
11200, 동작구,020001, 15세,2017,2742,1383,1359,101.8,2733,1377,1356,101.5
11200, 동작구,020002, 16세,2017,3031,1562,1469,106.3,3018,1555,1463,106.3
11200, 동작구,020003, 17세,2017,3254,1682,1572,107,3229,1671,1558,107.3
11200, 동작구,020004, 18세,2017,3831,1941,1890,102.7,3713,1900,1813,104.8
11200, 동작구,020005, 19세,2017,5480,2652,2828,93.8,5180,2542,2638,96.4
11200, 동작구,025,20~24세,2017,33201,16039,17162,93.5,30587,15138,15449,98
11200, 동작구,025001, 20세,2017,5752,2619,3133,83.6,5209,2443,2766,88.3
11200, 동작구,025002, 21세,2017,6032,2805,3227,86.9,5515,2615,2900,90.2
11200, 동작구,025003, 22세,2017,6595,3218,3377,95.3,6038,3015,3023,99.7
11200, 동작구,025004, 23세,2017,7325,3665,3660,100.1,6798,3487,3311,105.3
11200, 동작구,025005, 24세,2017,7497,3732,3765,99.1,7027,3578,3449,103.7
11200, 동작구,030,25~29세,2017,36477,18447,18030,102.3,34470,17511,16959,103.3
11200, 동작구,030001, 25세,2017,7728,4000,3728,107.3,7320,3816,3504,108.9
11200, 동작구,030002, 26세,2017,7539,3772,3767,100.1,7176,3606,3570,101
11200, 동작구,030003, 27세,2017,7381,3759,3622,103.8,6934,3550,3384,104.9
11200, 동작구,030004, 28세,2017,6938,3447,3491,98.7,6549,3263,3286,99.3
11200, 동작구,030005, 29세,2017,6891,3469,3422,101.4,6491,3276,3215,101.9
11200, 동작구,035,30~34세,2017,33916,16997,16919,100.5,32315,16169,16146,100.1
11200, 동작구,035001, 30세,2017,6793,3421,3372,101.5,6420,3235,3185,101.6
11200, 동작구,035002, 31세,2017,6806,3357,3449,97.3,6425,3164,3261,97
11200, 동작구,035003, 32세,2017,6684,3349,3335,100.4,6363,3180,3183,99.9
11200, 동작구,035004, 33세,2017,6553,3306,3247,101.8,6281,3164,3117,101.5
11200, 동작구,035005, 34세,2017,7080,3564,3516,101.4,6826,3426,3400,100.8
11200, 동작구,040,35~39세,2017,33602,17152,16450,104.3,32557,16543,16014,103.3
11200, 동작구,040001, 35세,2017,7190,3648,3542,103,6944,3511,3433,102.3
11200, 동작구,040002, 36세,2017,6973,3650,3323,109.8,6795,3541,3254,108.8
11200, 동작구,040003, 37세,2017,7025,3575,3450,103.6,6838,3462,3376,102.5
11200, 동작구,040004, 38세,2017,6581,3375,3206,105.3,6353,3249,3104,104.7
11200, 동작구,040005, 39세,2017,5833,2904,2929,99.1,5627,2780,2847,97.6
11200, 동작구,045,40~44세,2017,29917,15268,14649,104.2,29028,14790,14238,103.9
11200, 동작구,045001, 40세,2017,5865,2919,2946,99.1,5710,2834,2876,98.5
11200, 동작구,045002, 41세,2017,5759,2974,2785,106.8,5581,2875,2706,106.2
11200, 동작구,045003, 42세,2017,5856,2984,2872,103.9,5694,2890,2804,103.1
11200, 동작구,045004, 43세,2017,6333,3329,3004,110.8,6144,3228,2916,110.7
11200, 동작구,045005, 44세,2017,6104,3062,3042,100.7,5899,2963,2936,100.9
11200, 동작구,050,45~49세,2017,31354,15590,15764,98.9,29951,14872,15079,98.6
11200, 동작구,050001, 45세,2017,6166,3225,2941,109.7,5926,3089,2837,108.9
11200, 동작구,050002, 46세,2017,6533,3244,3289,98.6,6257,3108,3149,98.7
11200, 동작구,050003, 47세,2017,6198,3137,3061,102.5,5927,3013,2914,103.4
11200, 동작구,050004, 48세,2017,6348,3090,3258,94.8,6044,2931,3113,94.2
11200, 동작구,050005, 49세,2017,6109,2894,3215,90,5797,2731,3066,89.1
11200, 동작구,055,50~54세,2017,28774,13739,15035,91.4,27035,12921,14114,91.5
11200, 동작구,055001, 50세,2017,5644,2652,2992,88.6,5389,2539,2850,89.1
11200, 동작구,055002, 51세,2017,5513,2680,2833,94.6,5204,2546,2658,95.8
11200, 동작구,055003, 52세,2017,5761,2716,3045,89.2,5418,2552,2866,89
11200, 동작구,055004, 53세,2017,5830,2814,3016,93.3,5455,2631,2824,93.2
11200, 동작구,055005, 54세,2017,6026,2877,3149,91.4,5569,2653,2916,91
11200, 동작구,060,55~59세,2017,31300,14575,16725,87.1,29757,13861,15896,87.2
11200, 동작구,060001, 55세,2017,6139,2968,3171,93.6,5775,2779,2996,92.8
11200, 동작구,060002, 56세,2017,6360,2967,3393,87.4,6162,2888,3274,88.2
11200, 동작구,060003, 57세,2017,6788,3132,3656,85.7,6406,2951,3455,85.4
11200, 동작구,060004, 58세,2017,6099,2805,3294,85.2,5802,2678,3124,85.7
11200, 동작구,060005, 59세,2017,5914,2703,3211,84.2,5612,2565,3047,84.2
11200, 동작구,065,60~64세,2017,26019,12189,13830,88.1,24577,11472,13105,87.5
11200, 동작구,065001, 60세,2017,5970,2811,3159,89,5572,2617,2955,88.6
11200, 동작구,065002, 61세,2017,5341,2464,2877,85.6,5026,2308,2718,84.9
11200, 동작구,065003, 62세,2017,5683,2687,2996,89.7,5406,2551,2855,89.4
11200, 동작구,065004, 63세,2017,4726,2217,2509,88.4,4473,2081,2392,87
11200, 동작구,065005, 64세,2017,4299,2010,2289,87.8,4100,1915,2185,87.6
11200, 동작구,070,65~69세,2017,19025,8673,10352,83.8,18504,8425,10079,83.6
11200, 동작구,070001, 65세,2017,4464,2064,2400,86,4309,1993,2316,86.1
11200, 동작구,070002, 66세,2017,3416,1540,1876,82.1,3285,1476,1809,81.6
11200, 동작구,070003, 67세,2017,3700,1745,1955,89.3,3602,1697,1905,89.1
11200, 동작구,070004, 68세,2017,3761,1648,2113,78,3667,1600,2067,77.4
11200, 동작구,070005, 69세,2017,3684,1676,2008,83.5,3641,1659,1982,83.7
11200, 동작구,075,70~74세,2017,14768,6784,7984,85,14627,6718,7909,84.9
11200, 동작구,075001, 70세,2017,3680,1650,2030,81.3,3635,1630,2005,81.3
11200, 동작구,075002, 71세,2017,2935,1283,1652,77.7,2903,1264,1639,77.1
11200, 동작구,075003, 72세,2017,2770,1259,1511,83.3,2743,1244,1499,83
11200, 동작구,075004, 73세,2017,2691,1259,1432,87.9,2672,1255,1417,88.6
11200, 동작구,075005, 74세,2017,2692,1333,1359,98.1,2674,1325,1349,98.2
11200, 동작구,080,75~79세,2017,11534,5307,6227,85.2,11447,5291,6156,85.9
11200, 동작구,080001, 75세,2017,3106,1507,1599,94.2,3089,1506,1583,95.1
11200, 동작구,080002, 76세,2017,2425,1121,1304,86,2404,1117,1287,86.8
11200, 동작구,080003, 77세,2017,2188,999,1189,84,2173,998,1175,84.9
11200, 동작구,080004, 78세,2017,2057,913,1144,79.8,2040,907,1133,80.1
11200, 동작구,080005, 79세,2017,1758,767,991,77.4,1741,763,978,78
11200, 동작구,085,80~84세,2017,6170,2452,3718,65.9,6107,2440,3667,66.5
11200, 동작구,085001, 80세,2017,1592,652,940,69.4,1576,648,928,69.8
11200, 동작구,085002, 81세,2017,1392,560,832,67.3,1370,555,815,68.1
11200, 동작구,085003, 82세,2017,1252,496,756,65.6,1239,493,746,66.1
11200, 동작구,085004, 83세,2017,1073,422,651,64.8,1067,422,645,65.4
11200, 동작구,085005, 84세,2017,861,322,539,59.7,855,322,533,60.4
11200, 동작구,090,85~89세,2017,2626,838,1788,46.9,2606,830,1776,46.7
11200, 동작구,090001, 85세,2017,731,225,506,44.5,727,224,503,44.5
11200, 동작구,090002, 86세,2017,551,192,359,53.5,547,191,356,53.7
11200, 동작구,090003, 87세,2017,515,161,354,45.5,508,159,349,45.6
11200, 동작구,090004, 88세,2017,461,159,302,52.6,458,157,301,52.2
11200, 동작구,090005, 89세,2017,368,101,267,37.8,366,99,267,37.1
11200, 동작구,095,90~94세,2017,854,218,636,34.3,849,218,631,34.5
11200, 동작구,095001, 90세,2017,275,64,211,30.3,272,64,208,30.8
11200, 동작구,095002, 91세,2017,197,54,143,37.8,197,54,143,37.8
11200, 동작구,095003, 92세,2017,152,37,115,32.2,151,37,114,32.5
11200, 동작구,095004, 93세,2017,127,34,93,36.6,127,34,93,36.6
11200, 동작구,095005, 94세,2017,103,29,74,39.2,102,29,73,39.7
11200, 동작구,100,95~99세,2017,207,48,159,30.2,204,47,157,29.9
11200, 동작구,100001, 95세,2017,78,18,60,30,78,18,60,30
11200, 동작구,100002, 96세,2017,49,10,39,25.6,48,10,38,26.3
11200, 동작구,100003, 97세,2017,40,12,28,42.9,40,12,28,42.9
11200, 동작구,100004, 98세,2017,23,X,20,15,22,X,19,15.8
11200, 동작구,100005, 99세,2017,17,5,12,41.7,16,X,12,33.3
11200, 동작구,101,100세이상,2017,26,5,21,23.8,24,X,20,20
11200, 동작구,102,15세미만,2017,42128,21712,20416,106.3,41709,21504,20205,106.4
11200, 동작구,103,15~64세,2017,302898,149216,153682,97.1,288150,142322,145828,97.6
11200, 동작구,104,65세이상,2017,55210,24325,30885,78.8,54368,23973,30395,78.9
11200, 동작구,086,85세이상,2017,3713,1109,2604,42.6,3683,1099,2584,42.5
11200, 동작구,126,평균연령,2017,41.3,40.4,42.2,,41.3,40.3,42.2,
11200, 동작구,127,중위연령,2017,40.4,39.3,41.5,,40.5,39.3,41.6,
11210, 관악구,000,합계,2017,511222,256857,254365,101,486747,245391,241356,101.7
11210, 관악구,005,0~4세,2017,15506,7897,7609,103.8,14937,7614,7323,104
11210, 관악구,005001, 0세,2017,3023,1532,1491,102.7,2906,1471,1435,102.5
11210, 관악구,005002, 1세,2017,3212,1618,1594,101.5,3066,1548,1518,102
11210, 관악구,005003, 2세,2017,3227,1667,1560,106.9,3117,1615,1502,107.5
11210, 관악구,005004, 3세,2017,3089,1569,1520,103.2,2987,1514,1473,102.8
11210, 관악구,005005, 4세,2017,2955,1511,1444,104.6,2861,1466,1395,105.1
11210, 관악구,010,5~9세,2017,14264,7333,6931,105.8,13988,7192,6796,105.8
11210, 관악구,010001, 5세,2017,3063,1568,1495,104.9,2978,1524,1454,104.8
11210, 관악구,010002, 6세,2017,3019,1546,1473,105,2973,1522,1451,104.9
11210, 관악구,010003, 7세,2017,2733,1384,1349,102.6,2681,1355,1326,102.2
11210, 관악구,010004, 8세,2017,2635,1365,1270,107.5,2586,1342,1244,107.9
11210, 관악구,010005, 9세,2017,2814,1470,1344,109.4,2770,1449,1321,109.7
11210, 관악구,015,10~14세,2017,13817,7077,6740,105,13671,7008,6663,105.2
11210, 관악구,015001, 10세,2017,2839,1453,1386,104.8,2808,1438,1370,105
11210, 관악구,015002, 11세,2017,2678,1398,1280,109.2,2647,1386,1261,109.9
11210, 관악구,015003, 12세,2017,2625,1299,1326,98,2592,1284,1308,98.2
11210, 관악구,015004, 13세,2017,2815,1445,1370,105.5,2785,1432,1353,105.8
11210, 관악구,015005, 14세,2017,2860,1482,1378,107.5,2839,1468,1371,107.1
11210, 관악구,020,15~19세,2017,20537,10500,10037,104.6,20215,10369,9846,105.3
11210, 관악구,020001, 15세,2017,3071,1594,1477,107.9,3049,1586,1463,108.4
11210, 관악구,020002, 16세,2017,3437,1702,1735,98.1,3418,1686,1732,97.3
11210, 관악구,020003, 17세,2017,4002,2045,1957,104.5,3952,2026,1926,105.2
11210, 관악구,020004, 18세,2017,4305,2210,2095,105.5,4225,2180,2045,106.6
11210, 관악구,020005, 19세,2017,5722,2949,2773,106.3,5571,2891,2680,107.9
11210, 관악구,025,20~24세,2017,41742,19863,21879,90.8,40008,19280,20728,93
11210, 관악구,025001, 20세,2017,6177,3009,3168,95,5980,2937,3043,96.5
11210, 관악구,025002, 21세,2017,6885,3219,3666,87.8,6651,3141,3510,89.5
11210, 관악구,025003, 22세,2017,7678,3650,4028,90.6,7372,3549,3823,92.8
11210, 관악구,025004, 23세,2017,9881,4684,5197,90.1,9406,4537,4869,93.2
11210, 관악구,025005, 24세,2017,11121,5301,5820,91.1,10599,5116,5483,93.3
11210, 관악구,030,25~29세,2017,62595,32518,30077,108.1,59154,31073,28081,110.7
11210, 관악구,030001, 25세,2017,12817,6298,6519,96.6,12196,6061,6135,98.8
11210, 관악구,030002, 26세,2017,12922,6645,6277,105.9,12269,6400,5869,109
11210, 관악구,030003, 27세,2017,12759,6723,6036,111.4,12010,6392,5618,113.8
11210, 관악구,030004, 28세,2017,12375,6571,5804,113.2,11642,6255,5387,116.1
11210, 관악구,030005, 29세,2017,11722,6281,5441,115.4,11037,5965,5072,117.6
11210, 관악구,035,30~34세,2017,50792,27640,23152,119.4,47891,26191,21700,120.7
11210, 관악구,035001, 30세,2017,11116,5963,5153,115.7,10388,5610,4778,117.4
11210, 관악구,035002, 31세,2017,10579,5825,4754,122.5,9940,5514,4426,124.6
11210, 관악구,035003, 32세,2017,9749,5341,4408,121.2,9197,5062,4135,122.4
11210, 관악구,035004, 33세,2017,9661,5193,4468,116.2,9169,4953,4216,117.5
11210, 관악구,035005, 34세,2017,9687,5318,4369,121.7,9197,5052,4145,121.9
11210, 관악구,040,35~39세,2017,43810,23805,20005,119,41938,22761,19177,118.7
11210, 관악구,040001, 35세,2017,10054,5411,4643,116.5,9579,5161,4418,116.8
11210, 관악구,040002, 36세,2017,9370,5203,4167,124.9,9015,5006,4009,124.9
11210, 관악구,040003, 37세,2017,9102,4903,4199,116.8,8768,4720,4048,116.6
11210, 관악구,040004, 38세,2017,8087,4444,3643,122,7683,4204,3479,120.8
11210, 관악구,040005, 39세,2017,7197,3844,3353,114.6,6893,3670,3223,113.9
11210, 관악구,045,40~44세,2017,36460,19793,16667,118.8,34849,18901,15948,118.5
11210, 관악구,045001, 40세,2017,7129,3829,3300,116,6824,3649,3175,114.9
11210, 관악구,045002, 41세,2017,7061,3895,3166,123,6760,3735,3025,123.5
11210, 관악구,045003, 42세,2017,7085,3849,3236,118.9,6803,3688,3115,118.4
11210, 관악구,045004, 43세,2017,7606,4065,3541,114.8,7263,3884,3379,114.9
11210, 관악구,045005, 44세,2017,7579,4155,3424,121.3,7199,3945,3254,121.2
11210, 관악구,050,45~49세,2017,38050,19697,18353,107.3,35696,18554,17142,108.2
11210, 관악구,050001, 45세,2017,7665,4154,3511,118.3,7242,3928,3314,118.5
11210, 관악구,050002, 46세,2017,8075,4282,3793,112.9,7574,4031,3543,113.8
11210, 관악구,050003, 47세,2017,7572,3931,3641,108,7096,3704,3392,109.2
11210, 관악구,050004, 48세,2017,7381,3741,3640,102.8,6919,3525,3394,103.9
11210, 관악구,050005, 49세,2017,7357,3589,3768,95.2,6865,3366,3499,96.2
11210, 관악구,055,50~54세,2017,35173,17258,17915,96.3,32194,15881,16313,97.4
11210, 관악구,055001, 50세,2017,6802,3258,3544,91.9,6353,3054,3299,92.6
11210, 관악구,055002, 51세,2017,6762,3472,3290,105.5,6263,3221,3042,105.9
11210, 관악구,055003, 52세,2017,7293,3540,3753,94.3,6678,3276,3402,96.3
11210, 관악구,055004, 53세,2017,6835,3363,3472,96.9,6220,3088,3132,98.6
11210, 관악구,055005, 54세,2017,7481,3625,3856,94,6680,3242,3438,94.3
11210, 관악구,060,55~59세,2017,38070,17990,20080,89.6,35583,16818,18765,89.6
11210, 관악구,060001, 55세,2017,7531,3646,3885,93.8,6917,3355,3562,94.2
11210, 관악구,060002, 56세,2017,7740,3657,4083,89.6,7354,3483,3871,90
11210, 관악구,060003, 57세,2017,8225,3807,4418,86.2,7656,3545,4111,86.2
11210, 관악구,060004, 58세,2017,7440,3435,4005,85.8,7005,3227,3778,85.4
11210, 관악구,060005, 59세,2017,7134,3445,3689,93.4,6651,3208,3443,93.2
11210, 관악구,065,60~64세,2017,32221,14760,17461,84.5,29925,13630,16295,83.6
11210, 관악구,065001, 60세,2017,6999,3234,3765,85.9,6442,2950,3492,84.5
11210, 관악구,065002, 61세,2017,6868,3162,3706,85.3,6337,2918,3419,85.3
11210, 관악구,065003, 62세,2017,7006,3208,3798,84.5,6519,2956,3563,83
11210, 관악구,065004, 63세,2017,6030,2793,3237,86.3,5608,2580,3028,85.2
11210, 관악구,065005, 64세,2017,5318,2363,2955,80,5019,2226,2793,79.7
11210, 관악구,070,65~69세,2017,24910,11632,13278,87.6,24020,11208,12812,87.5
11210, 관악구,070001, 65세,2017,5822,2722,3100,87.8,5573,2601,2972,87.5
11210, 관악구,070002, 66세,2017,4479,2077,2402,86.5,4251,1962,2289,85.7
11210, 관악구,070003, 67세,2017,4877,2331,2546,91.6,4720,2253,2467,91.3
11210, 관악구,070004, 68세,2017,4982,2304,2678,86,4823,2236,2587,86.4
11210, 관악구,070005, 69세,2017,4750,2198,2552,86.1,4653,2156,2497,86.3
11210, 관악구,075,70~74세,2017,18806,8720,10086,86.5,18544,8624,9920,86.9
11210, 관악구,075001, 70세,2017,4685,2145,2540,84.4,4614,2117,2497,84.8
11210, 관악구,075002, 71세,2017,3644,1651,1993,82.8,3577,1622,1955,83
11210, 관악구,075003, 72세,2017,3497,1637,1860,88,3450,1623,1827,88.8
11210, 관악구,075004, 73세,2017,3489,1638,1851,88.5,3448,1625,1823,89.1
11210, 관악구,075005, 74세,2017,3491,1649,1842,89.5,3455,1637,1818,90
11210, 관악구,080,75~79세,2017,14137,6666,7471,89.2,13959,6619,7340,90.2
11210, 관악구,080001, 75세,2017,3929,1875,2054,91.3,3889,1863,2026,92
11210, 관악구,080002, 76세,2017,3049,1476,1573,93.8,3015,1468,1547,94.9
11210, 관악구,080003, 77세,2017,2547,1164,1383,84.2,2519,1159,1360,85.2
11210, 관악구,080004, 78세,2017,2514,1192,1322,90.2,2473,1182,1291,91.6
11210, 관악구,080005, 79세,2017,2098,959,1139,84.2,2063,947,1116,84.9
11210, 관악구,085,80~84세,2017,6546,2656,3890,68.3,6453,2632,3821,68.9
11210, 관악구,085001, 80세,2017,1755,752,1003,75,1731,743,988,75.2
11210, 관악구,085002, 81세,2017,1496,634,862,73.5,1475,625,850,73.5
11210, 관악구,085003, 82세,2017,1379,545,834,65.3,1360,543,817,66.5
11210, 관악구,085004, 83세,2017,1053,409,644,63.5,1038,407,631,64.5
11210, 관악구,085005, 84세,2017,863,316,547,57.8,849,314,535,58.7
11210, 관악구,090,85~89세,2017,2681,819,1862,44,2631,806,1825,44.2
11210, 관악구,090001, 85세,2017,728,269,459,58.6,717,265,452,58.6
11210, 관악구,090002, 86세,2017,595,185,410,45.1,583,182,401,45.4
11210, 관악구,090003, 87세,2017,566,162,404,40.1,554,160,394,40.6
11210, 관악구,090004, 88세,2017,444,115,329,35,437,114,323,35.3
11210, 관악구,090005, 89세,2017,348,88,260,33.8,340,85,255,33.3
11210, 관악구,095,90~94세,2017,878,190,688,27.6,865,188,677,27.8
11210, 관악구,095001, 90세,2017,295,73,222,32.9,292,72,220,32.7
11210, 관악구,095002, 91세,2017,209,36,173,20.8,206,36,170,21.2
11210, 관악구,095003, 92세,2017,141,32,109,29.4,139,32,107,29.9
11210, 관악구,095004, 93세,2017,110,25,85,29.4,106,24,82,29.3
11210, 관악구,095005, 94세,2017,123,24,99,24.2,122,24,98,24.5
11210, 관악구,100,95~99세,2017,196,39,157,24.8,195,38,157,24.2
11210, 관악구,100001, 95세,2017,80,16,64,25,80,16,64,25
11210, 관악구,100002, 96세,2017,48,11,37,29.7,48,11,37,29.7
11210, 관악구,100003, 97세,2017,32,7,25,28,32,7,25,28
11210, 관악구,100004, 98세,2017,19,X,16,18.8,18,X,16,12.5
11210, 관악구,100005, 99세,2017,17,X,15,13.3,17,X,15,13.3
11210, 관악구,101,100세이상,2017,31,X,27,14.8,31,X,27,14.8
11210, 관악구,102,15세미만,2017,43587,22307,21280,104.8,42596,21814,20782,105
11210, 관악구,103,15~64세,2017,399450,203824,195626,104.2,377453,193458,183995,105.1
11210, 관악구,104,65세이상,2017,68185,30726,37459,82,66698,30119,36579,82.3
11210, 관악구,086,85세이상,2017,3786,1052,2734,38.5,3722,1036,2686,38.6
11210, 관악구,126,평균연령,2017,41.2,40.3,42,,41.1,40.2,42,
11210, 관악구,127,중위연령,2017,39,38,40.2,,38.8,37.8,40.1,
11220, 서초구,000,합계,2017,414550,198241,216309,91.6,408012,195073,212939,91.6
11220, 서초구,005,0~4세,2017,16876,8616,8260,104.3,16698,8524,8174,104.3
11220, 서초구,005001, 0세,2017,2935,1493,1442,103.5,2900,1478,1422,103.9
11220, 서초구,005002, 1세,2017,3221,1606,1615,99.4,3190,1598,1592,100.4
11220, 서초구,005003, 2세,2017,3392,1731,1661,104.2,3353,1704,1649,103.3
11220, 서초구,005004, 3세,2017,3548,1847,1701,108.6,3512,1828,1684,108.6
11220, 서초구,005005, 4세,2017,3780,1939,1841,105.3,3743,1916,1827,104.9
11220, 서초구,010,5~9세,2017,20537,10510,10027,104.8,20364,10420,9944,104.8
11220, 서초구,010001, 5세,2017,4059,2102,1957,107.4,4016,2077,1939,107.1
11220, 서초구,010002, 6세,2017,4252,2211,2041,108.3,4216,2193,2023,108.4
11220, 서초구,010003, 7세,2017,4084,2073,2011,103.1,4060,2060,2000,103
11220, 서초구,010004, 8세,2017,3954,2005,1949,102.9,3912,1984,1928,102.9
11220, 서초구,010005, 9세,2017,4188,2119,2069,102.4,4160,2106,2054,102.5
11220, 서초구,015,10~14세,2017,20713,10569,10144,104.2,20582,10497,10085,104.1
11220, 서초구,015001, 10세,2017,4233,2127,2106,101,4200,2109,2091,100.9
11220, 서초구,015002, 11세,2017,3860,1994,1866,106.9,3832,1982,1850,107.1
11220, 서초구,015003, 12세,2017,3958,2074,1884,110.1,3939,2062,1877,109.9
11220, 서초구,015004, 13세,2017,4469,2263,2206,102.6,4439,2245,2194,102.3
11220, 서초구,015005, 14세,2017,4193,2111,2082,101.4,4172,2099,2073,101.3
11220, 서초구,020,15~19세,2017,22810,11488,11322,101.5,22680,11422,11258,101.5
11220, 서초구,020001, 15세,2017,4306,2189,2117,103.4,4285,2177,2108,103.3
11220, 서초구,020002, 16세,2017,4426,2247,2179,103.1,4414,2242,2172,103.2
11220, 서초구,020003, 17세,2017,4748,2416,2332,103.6,4724,2401,2323,103.4
11220, 서초구,020004, 18세,2017,4592,2307,2285,101,4574,2295,2279,100.7
11220, 서초구,020005, 19세,2017,4738,2329,2409,96.7,4683,2307,2376,97.1
11220, 서초구,025,20~24세,2017,24647,11953,12694,94.2,24203,11739,12464,94.2
11220, 서초구,025001, 20세,2017,4747,2336,2411,96.9,4645,2297,2348,97.8
11220, 서초구,025002, 21세,2017,4841,2428,2413,100.6,4753,2377,2376,100
11220, 서초구,025003, 22세,2017,4810,2363,2447,96.6,4749,2326,2423,96
11220, 서초구,025004, 23세,2017,4976,2409,2567,93.8,4876,2365,2511,94.2
11220, 서초구,025005, 24세,2017,5273,2417,2856,84.6,5180,2374,2806,84.6
11220, 서초구,030,25~29세,2017,29095,13500,15595,86.6,28354,13146,15208,86.4
11220, 서초구,030001, 25세,2017,5643,2613,3030,86.2,5530,2559,2971,86.1
11220, 서초구,030002, 26세,2017,5780,2682,3098,86.6,5657,2626,3031,86.6
11220, 서초구,030003, 27세,2017,5672,2659,3013,88.3,5542,2587,2955,87.5
11220, 서초구,030004, 28세,2017,6057,2800,3257,86,5860,2710,3150,86
11220, 서초구,030005, 29세,2017,5943,2746,3197,85.9,5765,2664,3101,85.9
11220, 서초구,035,30~34세,2017,31651,14576,17075,85.4,30705,14057,16648,84.4
11220, 서초구,035001, 30세,2017,6004,2679,3325,80.6,5812,2570,3242,79.3
11220, 서초구,035002, 31세,2017,6119,2819,3300,85.4,5926,2718,3208,84.7
11220, 서초구,035003, 32세,2017,6104,2803,3301,84.9,5917,2704,3213,84.2
11220, 서초구,035004, 33세,2017,6371,2982,3389,88,6182,2877,3305,87
11220, 서초구,035005, 34세,2017,7053,3293,3760,87.6,6868,3188,3680,86.6
11220, 서초구,040,35~39세,2017,36196,16818,19378,86.8,35362,16367,18995,86.2
11220, 서초구,040001, 35세,2017,7414,3484,3930,88.7,7222,3379,3843,87.9
11220, 서초구,040002, 36세,2017,7408,3415,3993,85.5,7220,3317,3903,85
11220, 서초구,040003, 37세,2017,7528,3469,4059,85.5,7388,3385,4003,84.6
11220, 서초구,040004, 38세,2017,7249,3403,3846,88.5,7080,3307,3773,87.6
11220, 서초구,040005, 39세,2017,6597,3047,3550,85.8,6452,2979,3473,85.8
11220, 서초구,045,40~44세,2017,36933,17303,19630,88.1,36283,16954,19329,87.7
11220, 서초구,045001, 40세,2017,7131,3287,3844,85.5,6996,3209,3787,84.7
11220, 서초구,045002, 41세,2017,6946,3121,3825,81.6,6812,3057,3755,81.4
11220, 서초구,045003, 42세,2017,7077,3431,3646,94.1,6948,3363,3585,93.8
11220, 서초구,045004, 43세,2017,7775,3656,4119,88.8,7648,3590,4058,88.5
11220, 서초구,045005, 44세,2017,8004,3808,4196,90.8,7879,3735,4144,90.1
11220, 서초구,050,45~49세,2017,39656,19427,20229,96,39035,19134,19901,96.1
11220, 서초구,050001, 45세,2017,8135,3935,4200,93.7,7997,3865,4132,93.5
11220, 서초구,050002, 46세,2017,8362,4025,4337,92.8,8224,3962,4262,93
11220, 서초구,050003, 47세,2017,8143,4014,4129,97.2,7999,3937,4062,96.9
11220, 서초구,050004, 48세,2017,7779,3890,3889,100,7674,3848,3826,100.6
11220, 서초구,050005, 49세,2017,7237,3563,3674,97,7141,3522,3619,97.3
11220, 서초구,055,50~54세,2017,30772,15051,15721,95.7,30214,14819,15395,96.3
11220, 서초구,055001, 50세,2017,6638,3223,3415,94.4,6511,3161,3350,94.4
11220, 서초구,055002, 51세,2017,5742,2868,2874,99.8,5648,2831,2817,100.5
11220, 서초구,055003, 52세,2017,6313,3106,3207,96.9,6206,3069,3137,97.8
11220, 서초구,055004, 53세,2017,6007,2912,3095,94.1,5898,2862,3036,94.3
11220, 서초구,055005, 54세,2017,6072,2942,3130,94,5951,2896,3055,94.8
11220, 서초구,060,55~59세,2017,29565,14018,15547,90.2,29112,13838,15274,90.6
11220, 서초구,060001, 55세,2017,5845,2842,3003,94.6,5733,2790,2943,94.8
11220, 서초구,060002, 56세,2017,6062,2873,3189,90.1,5982,2843,3139,90.6
11220, 서초구,060003, 57세,2017,6140,2899,3241,89.4,6050,2862,3188,89.8
11220, 서초구,060004, 58세,2017,5791,2654,3137,84.6,5711,2622,3089,84.9
11220, 서초구,060005, 59세,2017,5727,2750,2977,92.4,5636,2721,2915,93.3
11220, 서초구,065,60~64세,2017,25177,11572,13605,85.1,24822,11445,13377,85.6
11220, 서초구,065001, 60세,2017,5664,2607,3057,85.3,5566,2575,2991,86.1
11220, 서초구,065002, 61세,2017,5151,2421,2730,88.7,5073,2388,2685,88.9
11220, 서초구,065003, 62세,2017,5487,2484,3003,82.7,5410,2455,2955,83.1
11220, 서초구,065004, 63세,2017,4577,2128,2449,86.9,4521,2109,2412,87.4
11220, 서초구,065005, 64세,2017,4298,1932,2366,81.7,4252,1918,2334,82.2
11220, 서초구,070,65~69세,2017,18241,8474,9767,86.8,18074,8404,9670,86.9
11220, 서초구,070001, 65세,2017,4334,1974,2360,83.6,4280,1954,2326,84
11220, 서초구,070002, 66세,2017,3138,1500,1638,91.6,3103,1484,1619,91.7
11220, 서초구,070003, 67세,2017,3552,1652,1900,86.9,3516,1636,1880,87
11220, 서초구,070004, 68세,2017,3638,1659,1979,83.8,3616,1648,1968,83.7
11220, 서초구,070005, 69세,2017,3579,1689,1890,89.4,3559,1682,1877,89.6
11220, 서초구,075,70~74세,2017,13748,6614,7134,92.7,13686,6592,7094,92.9
11220, 서초구,075001, 70세,2017,3447,1605,1842,87.1,3432,1601,1831,87.4
11220, 서초구,075002, 71세,2017,2905,1375,1530,89.9,2890,1369,1521,90
11220, 서초구,075003, 72세,2017,2561,1234,1327,93,2548,1228,1320,93
11220, 서초구,075004, 73세,2017,2456,1212,1244,97.4,2443,1208,1235,97.8
11220, 서초구,075005, 74세,2017,2379,1188,1191,99.7,2373,1186,1187,99.9
11220, 서초구,080,75~79세,2017,9179,4543,4636,98,9133,4524,4609,98.2
11220, 서초구,080001, 75세,2017,2437,1262,1175,107.4,2429,1259,1170,107.6
11220, 서초구,080002, 76세,2017,2009,993,1016,97.7,1995,987,1008,97.9
11220, 서초구,080003, 77세,2017,1750,847,903,93.8,1740,840,900,93.3
11220, 서초구,080004, 78세,2017,1584,769,815,94.4,1576,767,809,94.8
11220, 서초구,080005, 79세,2017,1399,672,727,92.4,1393,671,722,92.9
11220, 서초구,085,80~84세,2017,5085,2114,2971,71.2,5063,2105,2958,71.2
11220, 서초구,085001, 80세,2017,1322,565,757,74.6,1315,561,754,74.4
11220, 서초구,085002, 81세,2017,1079,488,591,82.6,1075,487,588,82.8
11220, 서초구,085003, 82세,2017,1092,463,629,73.6,1086,461,625,73.8
11220, 서초구,085004, 83세,2017,884,333,551,60.4,881,331,550,60.2
11220, 서초구,085005, 84세,2017,708,265,443,59.8,706,265,441,60.1
11220, 서초구,090,85~89세,2017,2457,787,1670,47.1,2442,783,1659,47.2
11220, 서초구,090001, 85세,2017,677,265,412,64.3,674,264,410,64.4
11220, 서초구,090002, 86세,2017,479,159,320,49.7,476,158,318,49.7
11220, 서초구,090003, 87세,2017,469,128,341,37.5,466,127,339,37.5
11220, 서초구,090004, 88세,2017,441,142,299,47.5,437,141,296,47.6
11220, 서초구,090005, 89세,2017,391,93,298,31.2,389,93,296,31.4
11220, 서초구,095,90~94세,2017,976,257,719,35.7,969,254,715,35.5
11220, 서초구,095001, 90세,2017,319,87,232,37.5,316,85,231,36.8
11220, 서초구,095002, 91세,2017,198,56,142,39.4,198,56,142,39.4
11220, 서초구,095003, 92세,2017,182,43,139,30.9,181,42,139,30.2
11220, 서초구,095004, 93세,2017,144,35,109,32.1,142,35,107,32.7
11220, 서초구,095005, 94세,2017,133,36,97,37.1,132,36,96,37.5
11220, 서초구,100,95~99세,2017,202,42,160,26.3,197,40,157,25.5
11220, 서초구,100001, 95세,2017,79,16,63,25.4,78,16,62,25.8
11220, 서초구,100002, 96세,2017,47,8,39,20.5,47,8,39,20.5
11220, 서초구,100003, 97세,2017,31,8,23,34.8,29,7,22,31.8
11220, 서초구,100004, 98세,2017,29,5,24,20.8,27,X,23,17.4
11220, 서초구,100005, 99세,2017,16,5,11,45.5,16,5,11,45.5
11220, 서초구,101,100세이상,2017,34,9,25,36,34,9,25,36
11220, 서초구,102,15세미만,2017,58126,29695,28431,104.4,57644,29441,28203,104.4
11220, 서초구,103,15~64세,2017,306502,145706,160796,90.6,300770,142921,157849,90.5
11220, 서초구,104,65세이상,2017,49922,22840,27082,84.3,49598,22711,26887,84.5
11220, 서초구,086,85세이상,2017,3669,1095,2574,42.5,3642,1086,2556,42.5
11220, 서초구,126,평균연령,2017,40.1,39.5,40.6,,40.1,39.5,40.6,
11220, 서초구,127,중위연령,2017,40.7,40.3,41,,40.7,40.4,41,
11230, 강남구,000,합계,2017,522514,250087,272427,91.8,514859,246381,268478,91.8
11230, 강남구,005,0~4세,2017,17657,8990,8667,103.7,17547,8931,8616,103.7
11230, 강남구,005001, 0세,2017,3243,1645,1598,102.9,3220,1632,1588,102.8
11230, 강남구,005002, 1세,2017,3399,1709,1690,101.1,3371,1693,1678,100.9
11230, 강남구,005003, 2세,2017,3505,1792,1713,104.6,3481,1778,1703,104.4
11230, 강남구,005004, 3세,2017,3660,1893,1767,107.1,3639,1885,1754,107.5
11230, 강남구,005005, 4세,2017,3850,1951,1899,102.7,3836,1943,1893,102.6
11230, 강남구,010,5~9세,2017,21156,11011,10145,108.5,21073,10963,10110,108.4
11230, 강남구,010001, 5세,2017,4111,2142,1969,108.8,4088,2126,1962,108.4
11230, 강남구,010002, 6세,2017,4225,2227,1998,111.5,4209,2217,1992,111.3
11230, 강남구,010003, 7세,2017,4108,2108,2000,105.4,4100,2105,1995,105.5
11230, 강남구,010004, 8세,2017,4090,2109,1981,106.5,4071,2100,1971,106.5
11230, 강남구,010005, 9세,2017,4622,2425,2197,110.4,4605,2415,2190,110.3
11230, 강남구,015,10~14세,2017,25032,13093,11939,109.7,24947,13043,11904,109.6
11230, 강남구,015001, 10세,2017,4717,2396,2321,103.2,4702,2390,2312,103.4
11230, 강남구,015002, 11세,2017,4474,2348,2126,110.4,4461,2341,2120,110.4
11230, 강남구,015003, 12세,2017,4890,2579,2311,111.6,4871,2566,2305,111.3
11230, 강남구,015004, 13세,2017,5436,2898,2538,114.2,5416,2886,2530,114.1
11230, 강남구,015005, 14세,2017,5515,2872,2643,108.7,5497,2860,2637,108.5
11230, 강남구,020,15~19세,2017,31983,16774,15209,110.3,31849,16697,15152,110.2
11230, 강남구,020001, 15세,2017,5561,2957,2604,113.6,5534,2942,2592,113.5
11230, 강남구,020002, 16세,2017,6296,3268,3028,107.9,6283,3259,3024,107.8
11230, 강남구,020003, 17세,2017,7058,3728,3330,112,7036,3712,3324,111.7
11230, 강남구,020004, 18세,2017,6748,3560,3188,111.7,6718,3541,3177,111.5
11230, 강남구,020005, 19세,2017,6320,3261,3059,106.6,6278,3243,3035,106.9
11230, 강남구,025,20~24세,2017,32035,15890,16145,98.4,31487,15703,15784,99.5
11230, 강남구,025001, 20세,2017,6040,3042,2998,101.5,5973,3017,2956,102.1
11230, 강남구,025002, 21세,2017,6126,3183,2943,108.2,6061,3164,2897,109.2
11230, 강남구,025003, 22세,2017,6282,3170,3112,101.9,6176,3124,3052,102.4
11230, 강남구,025004, 23세,2017,6622,3223,3399,94.8,6492,3186,3306,96.4
11230, 강남구,025005, 24세,2017,6965,3272,3693,88.6,6785,3212,3573,89.9
11230, 강남구,030,25~29세,2017,39203,17969,21234,84.6,38008,17423,20585,84.6
11230, 강남구,030001, 25세,2017,7533,3380,4153,81.4,7343,3299,4044,81.6
11230, 강남구,030002, 26세,2017,7510,3437,4073,84.4,7298,3348,3950,84.8
11230, 강남구,030003, 27세,2017,7904,3641,4263,85.4,7658,3535,4123,85.7
11230, 강남구,030004, 28세,2017,8179,3831,4348,88.1,7920,3707,4213,88
11230, 강남구,030005, 29세,2017,8077,3680,4397,83.7,7789,3534,4255,83.1
11230, 강남구,035,30~34세,2017,41971,19435,22536,86.2,40628,18680,21948,85.1
11230, 강남구,035001, 30세,2017,8043,3660,4383,83.5,7758,3515,4243,82.8
11230, 강남구,035002, 31세,2017,8140,3792,4348,87.2,7857,3630,4227,85.9
11230, 강남구,035003, 32세,2017,8272,3907,4365,89.5,7996,3738,4258,87.8
11230, 강남구,035004, 33세,2017,8554,3922,4632,84.7,8293,3775,4518,83.6
11230, 강남구,035005, 34세,2017,8962,4154,4808,86.4,8724,4022,4702,85.5
11230, 강남구,040,35~39세,2017,45288,21051,24237,86.9,44344,20533,23811,86.2
11230, 강남구,040001, 35세,2017,9485,4326,5159,83.9,9258,4214,5044,83.5
11230, 강남구,040002, 36세,2017,9434,4376,5058,86.5,9248,4281,4967,86.2
11230, 강남구,040003, 37세,2017,9174,4317,4857,88.9,8976,4210,4766,88.3
11230, 강남구,040004, 38세,2017,9109,4149,4960,83.6,8908,4032,4876,82.7
11230, 강남구,040005, 39세,2017,8086,3883,4203,92.4,7954,3796,4158,91.3
11230, 강남구,045,40~44세,2017,43898,20100,23798,84.5,43226,19732,23494,84
11230, 강남구,045001, 40세,2017,8364,3817,4547,83.9,8229,3759,4470,84.1
11230, 강남구,045002, 41세,2017,8167,3767,4400,85.6,8027,3690,4337,85.1
11230, 강남구,045003, 42세,2017,8576,3911,4665,83.8,8453,3840,4613,83.2
11230, 강남구,045004, 43세,2017,9329,4272,5057,84.5,9177,4181,4996,83.7
11230, 강남구,045005, 44세,2017,9462,4333,5129,84.5,9340,4262,5078,83.9
11230, 강남구,050,45~49세,2017,52081,24902,27179,91.6,51430,24567,26863,91.5
11230, 강남구,050001, 45세,2017,10077,4652,5425,85.8,9930,4581,5349,85.6
11230, 강남구,050002, 46세,2017,10830,5172,5658,91.4,10693,5095,5598,91
11230, 강남구,050003, 47세,2017,10743,5095,5648,90.2,10607,5025,5582,90
11230, 강남구,050004, 48세,2017,10576,5151,5425,94.9,10445,5084,5361,94.8
11230, 강남구,050005, 49세,2017,9855,4832,5023,96.2,9755,4782,4973,96.2
11230, 강남구,055,50~54세,2017,41390,20511,20879,98.2,40837,20282,20555,98.7
11230, 강남구,055001, 50세,2017,8907,4290,4617,92.9,8794,4237,4557,93
11230, 강남구,055002, 51세,2017,8005,4109,3896,105.5,7894,4066,3828,106.2
11230, 강남구,055003, 52세,2017,8502,4245,4257,99.7,8395,4197,4198,100
11230, 강남구,055004, 53세,2017,7911,3899,4012,97.2,7815,3860,3955,97.6
11230, 강남구,055005, 54세,2017,8065,3968,4097,96.9,7939,3922,4017,97.6
11230, 강남구,060,55~59세,2017,37315,17772,19543,90.9,36801,17569,19232,91.4
11230, 강남구,060001, 55세,2017,7455,3739,3716,100.6,7339,3680,3659,100.6
11230, 강남구,060002, 56세,2017,7837,3714,4123,90.1,7746,3678,4068,90.4
11230, 강남구,060003, 57세,2017,7811,3665,4146,88.4,7691,3624,4067,89.1
11230, 강남구,060004, 58세,2017,7143,3369,3774,89.3,7049,3338,3711,89.9
11230, 강남구,060005, 59세,2017,7069,3285,3784,86.8,6976,3249,3727,87.2
11230, 강남구,065,60~64세,2017,31799,14496,17303,83.8,31386,14348,17038,84.2
11230, 강남구,065001, 60세,2017,7099,3316,3783,87.7,6992,3276,3716,88.2
11230, 강남구,065002, 61세,2017,6559,3026,3533,85.6,6465,2993,3472,86.2
11230, 강남구,065003, 62세,2017,6880,3039,3841,79.1,6802,3010,3792,79.4
11230, 강남구,065004, 63세,2017,5841,2682,3159,84.9,5760,2661,3099,85.9
11230, 강남구,065005, 64세,2017,5420,2433,2987,81.5,5367,2408,2959,81.4
11230, 강남구,070,65~69세,2017,23045,10828,12217,88.6,22851,10749,12102,88.8
11230, 강남구,070001, 65세,2017,5656,2600,3056,85.1,5589,2571,3018,85.2
11230, 강남구,070002, 66세,2017,3859,1835,2024,90.7,3821,1820,2001,91
11230, 강남구,070003, 67세,2017,4486,2072,2414,85.8,4459,2058,2401,85.7
11230, 강남구,070004, 68세,2017,4578,2167,2411,89.9,4541,2157,2384,90.5
11230, 강남구,070005, 69세,2017,4466,2154,2312,93.2,4441,2143,2298,93.3
11230, 강남구,075,70~74세,2017,16823,8121,8702,93.3,16739,8084,8655,93.4
11230, 강남구,075001, 70세,2017,4305,1958,2347,83.4,4276,1945,2331,83.4
11230, 강남구,075002, 71세,2017,3543,1707,1836,93,3527,1698,1829,92.8
11230, 강남구,075003, 72세,2017,3134,1558,1576,98.9,3116,1548,1568,98.7
11230, 강남구,075004, 73세,2017,3024,1511,1513,99.9,3012,1507,1505,100.1
11230, 강남구,075005, 74세,2017,2817,1387,1430,97,2808,1386,1422,97.5
11230, 강남구,080,75~79세,2017,11151,5397,5754,93.8,11085,5363,5722,93.7
11230, 강남구,080001, 75세,2017,2968,1513,1455,104,2950,1506,1444,104.3
11230, 강남구,080002, 76세,2017,2450,1171,1279,91.6,2438,1166,1272,91.7
11230, 강남구,080003, 77세,2017,2133,1019,1114,91.5,2124,1013,1111,91.2
11230, 강남구,080004, 78세,2017,1892,922,970,95.1,1875,911,964,94.5
11230, 강남구,080005, 79세,2017,1708,772,936,82.5,1698,767,931,82.4
11230, 강남구,085,80~84세,2017,6057,2444,3613,67.6,6018,2427,3591,67.6
11230, 강남구,085001, 80세,2017,1570,719,851,84.5,1559,714,845,84.5
11230, 강남구,085002, 81세,2017,1320,573,747,76.7,1313,570,743,76.7
11230, 강남구,085003, 82세,2017,1241,482,759,63.5,1233,476,757,62.9
11230, 강남구,085004, 83세,2017,1050,383,667,57.4,1044,381,663,57.5
11230, 강남구,085005, 84세,2017,876,287,589,48.7,869,286,583,49.1
11230, 강남구,090,85~89세,2017,3083,918,2165,42.4,3066,905,2161,41.9
11230, 강남구,090001, 85세,2017,848,298,550,54.2,844,295,549,53.7
11230, 강남구,090002, 86세,2017,638,186,452,41.2,636,185,451,41
11230, 강남구,090003, 87세,2017,606,156,450,34.7,602,153,449,34.1
11230, 강남구,090004, 88세,2017,558,161,397,40.6,555,159,396,40.2
11230, 강남구,090005, 89세,2017,433,117,316,37,429,113,316,35.8
11230, 강남구,095,90~94세,2017,1209,302,907,33.3,1204,300,904,33.2
11230, 강남구,095001, 90세,2017,377,91,286,31.8,376,91,285,31.9
11230, 강남구,095002, 91세,2017,257,59,198,29.8,256,58,198,29.3
11230, 강남구,095003, 92세,2017,251,75,176,42.6,249,75,174,43.1
11230, 강남구,095004, 93세,2017,173,39,134,29.1,172,38,134,28.4
11230, 강남구,095005, 94세,2017,151,38,113,33.6,151,38,113,33.6
11230, 강남구,100,95~99세,2017,301,75,226,33.2,298,74,224,33
11230, 강남구,100001, 95세,2017,102,24,78,30.8,100,23,77,29.9
11230, 강남구,100002, 96세,2017,78,26,52,50,78,26,52,50
11230, 강남구,100003, 97세,2017,72,17,55,30.9,72,17,55,30.9
11230, 강남구,100004, 98세,2017,25,5,20,25,25,5,20,25
11230, 강남구,100005, 99세,2017,24,X,21,14.3,23,X,20,15
11230, 강남구,101,100세이상,2017,37,8,29,27.6,35,8,27,29.6
11230, 강남구,102,15세미만,2017,63845,33094,30751,107.6,63567,32937,30630,107.5
11230, 강남구,103,15~64세,2017,396963,188900,208063,90.8,389996,185534,204462,90.7
11230, 강남구,104,65세이상,2017,61706,28093,33613,83.6,61296,27910,33386,83.6
11230, 강남구,086,85세이상,2017,4630,1303,3327,39.2,4603,1287,3316,38.8
11230, 강남구,126,평균연령,2017,40.4,39.7,41.1,,40.5,39.7,41.1,
11230, 강남구,127,중위연령,2017,40.8,40.2,41.4,,40.9,40.3,41.4,
11240, 송파구,000,합계,2017,633953,307723,326230,94.3,624535,303247,321288,94.4
11240, 송파구,005,0~4세,2017,25911,13451,12460,108,25714,13347,12367,107.9
11240, 송파구,005001, 0세,2017,4874,2538,2336,108.6,4837,2520,2317,108.8
11240, 송파구,005002, 1세,2017,5391,2851,2540,112.2,5345,2822,2523,111.9
11240, 송파구,005003, 2세,2017,5401,2818,2583,109.1,5355,2795,2560,109.2
11240, 송파구,005004, 3세,2017,5103,2609,2494,104.6,5067,2594,2473,104.9
11240, 송파구,005005, 4세,2017,5142,2635,2507,105.1,5110,2616,2494,104.9
11240, 송파구,010,5~9세,2017,27314,14010,13304,105.3,27176,13946,13230,105.4
11240, 송파구,010001, 5세,2017,5719,2899,2820,102.8,5682,2878,2804,102.6
11240, 송파구,010002, 6세,2017,5434,2831,2603,108.8,5403,2814,2589,108.7
11240, 송파구,010003, 7세,2017,5464,2793,2671,104.6,5435,2784,2651,105
11240, 송파구,010004, 8세,2017,5202,2645,2557,103.4,5183,2638,2545,103.7
11240, 송파구,010005, 9세,2017,5495,2842,2653,107.1,5473,2832,2641,107.2
11240, 송파구,015,10~14세,2017,27706,14228,13478,105.6,27651,14198,13453,105.5
11240, 송파구,015001, 10세,2017,5575,2882,2693,107,5560,2873,2687,106.9
11240, 송파구,015002, 11세,2017,5312,2692,2620,102.7,5302,2686,2616,102.7
11240, 송파구,015003, 12세,2017,5288,2732,2556,106.9,5277,2727,2550,106.9
11240, 송파구,015004, 13세,2017,5711,2924,2787,104.9,5700,2918,2782,104.9
11240, 송파구,015005, 14세,2017,5820,2998,2822,106.2,5812,2994,2818,106.2
11240, 송파구,020,15~19세,2017,33486,17148,16338,105,33353,17078,16275,104.9
11240, 송파구,020001, 15세,2017,5947,3080,2867,107.4,5934,3077,2857,107.7
11240, 송파구,020002, 16세,2017,6628,3405,3223,105.6,6619,3401,3218,105.7
11240, 송파구,020003, 17세,2017,7301,3712,3589,103.4,7287,3705,3582,103.4
11240, 송파구,020004, 18세,2017,6867,3536,3331,106.2,6841,3517,3324,105.8
11240, 송파구,020005, 19세,2017,6743,3415,3328,102.6,6672,3378,3294,102.6
11240, 송파구,025,20~24세,2017,39619,19918,19701,101.1,39152,19720,19432,101.5
11240, 송파구,025001, 20세,2017,7247,3782,3465,109.1,7174,3744,3430,109.2
11240, 송파구,025002, 21세,2017,7533,3964,3569,111.1,7471,3933,3538,111.2
11240, 송파구,025003, 22세,2017,7871,4084,3787,107.8,7800,4056,3744,108.3
11240, 송파구,025004, 23세,2017,8359,4055,4304,94.2,8217,3994,4223,94.6
11240, 송파구,025005, 24세,2017,8609,4033,4576,88.1,8490,3993,4497,88.8
11240, 송파구,030,25~29세,2017,47355,22427,24928,90,46295,21927,24368,90
11240, 송파구,030001, 25세,2017,9266,4319,4947,87.3,9119,4255,4864,87.5
11240, 송파구,030002, 26세,2017,9262,4377,4885,89.6,9071,4280,4791,89.3
11240, 송파구,030003, 27세,2017,9505,4499,5006,89.9,9272,4391,4881,90
11240, 송파구,030004, 28세,2017,9528,4559,4969,91.7,9299,4456,4843,92
11240, 송파구,030005, 29세,2017,9794,4673,5121,91.3,9534,4545,4989,91.1
11240, 송파구,035,30~34세,2017,52977,25358,27619,91.8,51666,24691,26975,91.5
11240, 송파구,035001, 30세,2017,10012,4708,5304,88.8,9725,4564,5161,88.4
11240, 송파구,035002, 31세,2017,10328,4910,5418,90.6,10049,4770,5279,90.4
11240, 송파구,035003, 32세,2017,10377,4948,5429,91.1,10115,4818,5297,91
11240, 송파구,035004, 33세,2017,10621,5214,5407,96.4,10368,5090,5278,96.4
11240, 송파구,035005, 34세,2017,11639,5578,6061,92,11409,5449,5960,91.4
11240, 송파구,040,35~39세,2017,56234,27246,28988,94,55324,26756,28568,93.7
11240, 송파구,040001, 35세,2017,11934,5860,6074,96.5,11719,5745,5974,96.2
11240, 송파구,040002, 36세,2017,11907,5852,6055,96.6,11700,5736,5964,96.2
11240, 송파구,040003, 37세,2017,11729,5616,6113,91.9,11582,5541,6041,91.7
11240, 송파구,040004, 38세,2017,11046,5212,5834,89.3,10859,5113,5746,89
11240, 송파구,040005, 39세,2017,9618,4706,4912,95.8,9464,4621,4843,95.4
11240, 송파구,045,40~44세,2017,51053,24841,26212,94.8,50317,24457,25860,94.6
11240, 송파구,045001, 40세,2017,9949,4827,5122,94.2,9814,4757,5057,94.1
11240, 송파구,045002, 41세,2017,9652,4859,4793,101.4,9511,4778,4733,101
11240, 송파구,045003, 42세,2017,10016,4826,5190,93,9883,4764,5119,93.1
11240, 송파구,045004, 43세,2017,10690,5229,5461,95.8,10519,5142,5377,95.6
11240, 송파구,045005, 44세,2017,10746,5100,5646,90.3,10590,5016,5574,90
11240, 송파구,050,45~49세,2017,56199,27146,29053,93.4,55202,26676,28526,93.5
11240, 송파구,050001, 45세,2017,11160,5406,5754,94,10965,5296,5669,93.4
11240, 송파구,050002, 46세,2017,11872,5707,6165,92.6,11691,5617,6074,92.5
11240, 송파구,050003, 47세,2017,11093,5473,5620,97.4,10901,5377,5524,97.3
11240, 송파구,050004, 48세,2017,11268,5452,5816,93.7,11076,5368,5708,94
11240, 송파구,050005, 49세,2017,10806,5108,5698,89.6,10569,5018,5551,90.4
11240, 송파구,055,50~54세,2017,49206,23884,25322,94.3,48105,23378,24727,94.5
11240, 송파구,055001, 50세,2017,9872,4802,5070,94.7,9695,4715,4980,94.7
11240, 송파구,055002, 51세,2017,9589,4763,4826,98.7,9371,4671,4700,99.4
11240, 송파구,055003, 52세,2017,10003,4796,5207,92.1,9776,4684,5092,92
11240, 송파구,055004, 53세,2017,9629,4657,4972,93.7,9409,4559,4850,94
11240, 송파구,055005, 54세,2017,10113,4866,5247,92.7,9854,4749,5105,93
11240, 송파구,060,55~59세,2017,51300,24198,27102,89.3,50417,23833,26584,89.7
11240, 송파구,060001, 55세,2017,9981,4806,5175,92.9,9782,4722,5060,93.3
11240, 송파구,060002, 56세,2017,10754,5016,5738,87.4,10608,4962,5646,87.9
11240, 송파구,060003, 57세,2017,10894,4998,5896,84.8,10678,4911,5767,85.2
11240, 송파구,060004, 58세,2017,10014,4788,5226,91.6,9850,4719,5131,92
11240, 송파구,060005, 59세,2017,9657,4590,5067,90.6,9499,4519,4980,90.7
11240, 송파구,065,60~64세,2017,42261,19954,22307,89.5,41458,19574,21884,89.4
11240, 송파구,065001, 60세,2017,9648,4525,5123,88.3,9454,4420,5034,87.8
11240, 송파구,065002, 61세,2017,8653,4074,4579,89,8469,3997,4472,89.4
11240, 송파구,065003, 62세,2017,9345,4380,4965,88.2,9171,4301,4870,88.3
11240, 송파구,065004, 63세,2017,7672,3653,4019,90.9,7534,3589,3945,91
11240, 송파구,065005, 64세,2017,6943,3322,3621,91.7,6830,3267,3563,91.7
11240, 송파구,070,65~69세,2017,28422,14125,14297,98.8,28064,13967,14097,99.1
11240, 송파구,070001, 65세,2017,7295,3633,3662,99.2,7208,3589,3619,99.2
11240, 송파구,070002, 66세,2017,5063,2501,2562,97.6,4979,2466,2513,98.1
11240, 송파구,070003, 67세,2017,5490,2744,2746,99.9,5422,2706,2716,99.6
11240, 송파구,070004, 68세,2017,5487,2724,2763,98.6,5417,2697,2720,99.2
11240, 송파구,070005, 69세,2017,5087,2523,2564,98.4,5038,2509,2529,99.2
11240, 송파구,075,70~74세,2017,19301,9577,9724,98.5,19171,9527,9644,98.8
11240, 송파구,075001, 70세,2017,5231,2608,2623,99.4,5188,2594,2594,100
11240, 송파구,075002, 71세,2017,3875,1913,1962,97.5,3841,1900,1941,97.9
11240, 송파구,075003, 72세,2017,3552,1775,1777,99.9,3525,1765,1760,100.3
11240, 송파구,075004, 73세,2017,3403,1686,1717,98.2,3392,1680,1712,98.1
11240, 송파구,075005, 74세,2017,3240,1595,1645,97,3225,1588,1637,97
11240, 송파구,080,75~79세,2017,12918,6001,6917,86.8,12837,5976,6861,87.1
11240, 송파구,080001, 75세,2017,3564,1719,1845,93.2,3540,1710,1830,93.4
11240, 송파구,080002, 76세,2017,2757,1291,1466,88.1,2739,1286,1453,88.5
11240, 송파구,080003, 77세,2017,2397,1123,1274,88.1,2380,1117,1263,88.4
11240, 송파구,080004, 78세,2017,2244,1015,1229,82.6,2238,1014,1224,82.8
11240, 송파구,080005, 79세,2017,1956,853,1103,77.3,1940,849,1091,77.8
11240, 송파구,085,80~84세,2017,7405,2804,4601,60.9,7363,2794,4569,61.2
11240, 송파구,085001, 80세,2017,1852,785,1067,73.6,1845,784,1061,73.9
11240, 송파구,085002, 81세,2017,1617,625,992,63,1605,621,984,63.1
11240, 송파구,085003, 82세,2017,1526,580,946,61.3,1521,578,943,61.3
11240, 송파구,085004, 83세,2017,1264,473,791,59.8,1256,473,783,60.4
11240, 송파구,085005, 84세,2017,1146,341,805,42.4,1136,338,798,42.4
11240, 송파구,090,85~89세,2017,3641,1034,2607,39.7,3629,1030,2599,39.6
11240, 송파구,090001, 85세,2017,1008,311,697,44.6,1005,311,694,44.8
11240, 송파구,090002, 86세,2017,773,237,536,44.2,770,235,535,43.9
11240, 송파구,090003, 87세,2017,687,180,507,35.5,684,179,505,35.4
11240, 송파구,090004, 88세,2017,647,163,484,33.7,645,162,483,33.5
11240, 송파구,090005, 89세,2017,526,143,383,37.3,525,143,382,37.4
11240, 송파구,095,90~94세,2017,1331,303,1028,29.5,1328,302,1026,29.4
11240, 송파구,095001, 90세,2017,425,98,327,30,424,97,327,29.7
11240, 송파구,095002, 91세,2017,308,63,245,25.7,308,63,245,25.7
11240, 송파구,095003, 92세,2017,252,55,197,27.9,251,55,196,28.1
11240, 송파구,095004, 93세,2017,173,48,125,38.4,173,48,125,38.4
11240, 송파구,095005, 94세,2017,173,39,134,29.1,172,39,133,29.3
11240, 송파구,100,95~99세,2017,279,64,215,29.8,278,64,214,29.9
11240, 송파구,100001, 95세,2017,101,22,79,27.8,101,22,79,27.8
11240, 송파구,100002, 96세,2017,76,20,56,35.7,76,20,56,35.7
11240, 송파구,100003, 97세,2017,52,10,42,23.8,51,10,41,24.4
11240, 송파구,100004, 98세,2017,32,10,22,45.5,32,10,22,45.5
11240, 송파구,100005, 99세,2017,18,X,16,12.5,18,X,16,12.5
11240, 송파구,101,100세이상,2017,35,6,29,20.7,35,6,29,20.7
11240, 송파구,102,15세미만,2017,80931,41689,39242,106.2,80541,41491,39050,106.3
11240, 송파구,103,15~64세,2017,479690,232120,247570,93.8,471289,228090,243199,93.8
11240, 송파구,104,65세이상,2017,73332,33914,39418,86,72705,33666,39039,86.2
11240, 송파구,086,85세이상,2017,5286,1407,3879,36.3,5270,1402,3868,36.2
11240, 송파구,126,평균연령,2017,40.4,39.7,41.1,,40.4,39.7,41,
11240, 송파구,127,중위연령,2017,40.6,40,41.2,,40.6,40,41.2,
11250, 강동구,000,합계,2017,423978,209931,214047,98.1,418091,207140,210951,98.2
11250, 강동구,005,0~4세,2017,16226,8295,7931,104.6,16117,8245,7872,104.7
11250, 강동구,005001, 0세,2017,2977,1516,1461,103.8,2952,1505,1447,104
11250, 강동구,005002, 1세,2017,3282,1705,1577,108.1,3257,1694,1563,108.4
11250, 강동구,005003, 2세,2017,3352,1717,1635,105,3330,1705,1625,104.9
11250, 강동구,005004, 3세,2017,3438,1743,1695,102.8,3415,1735,1680,103.3
11250, 강동구,005005, 4세,2017,3177,1614,1563,103.3,3163,1606,1557,103.1
11250, 강동구,010,5~9세,2017,17204,8987,8217,109.4,17133,8953,8180,109.4
11250, 강동구,010001, 5세,2017,3574,1854,1720,107.8,3557,1846,1711,107.9
11250, 강동구,010002, 6세,2017,3393,1767,1626,108.7,3377,1759,1618,108.7
11250, 강동구,010003, 7세,2017,3485,1843,1642,112.2,3465,1834,1631,112.4
11250, 강동구,010004, 8세,2017,3230,1636,1594,102.6,3222,1631,1591,102.5
11250, 강동구,010005, 9세,2017,3522,1887,1635,115.4,3512,1883,1629,115.6
11250, 강동구,015,10~14세,2017,17339,9143,8196,111.6,17308,9130,8178,111.6
11250, 강동구,015001, 10세,2017,3588,1922,1666,115.4,3581,1920,1661,115.6
11250, 강동구,015002, 11세,2017,3278,1730,1548,111.8,3273,1727,1546,111.7
11250, 강동구,015003, 12세,2017,3129,1659,1470,112.9,3119,1654,1465,112.9
11250, 강동구,015004, 13세,2017,3630,1895,1735,109.2,3623,1892,1731,109.3
11250, 강동구,015005, 14세,2017,3714,1937,1777,109,3712,1937,1775,109.1
11250, 강동구,020,15~19세,2017,21942,11603,10339,112.2,21886,11576,10310,112.3
11250, 강동구,020001, 15세,2017,3840,2091,1749,119.6,3834,2089,1745,119.7
11250, 강동구,020002, 16세,2017,4326,2342,1984,118,4319,2339,1980,118.1
11250, 강동구,020003, 17세,2017,4774,2505,2269,110.4,4765,2501,2264,110.5
11250, 강동구,020004, 18세,2017,4635,2432,2203,110.4,4619,2421,2198,110.1
11250, 강동구,020005, 19세,2017,4367,2233,2134,104.6,4349,2226,2123,104.9
11250, 강동구,025,20~24세,2017,26236,13723,12513,109.7,25985,13607,12378,109.9
11250, 강동구,025001, 20세,2017,4671,2537,2134,118.9,4644,2527,2117,119.4
11250, 강동구,025002, 21세,2017,5061,2741,2320,118.1,5026,2725,2301,118.4
11250, 강동구,025003, 22세,2017,5328,2862,2466,116.1,5271,2835,2436,116.4
11250, 강동구,025004, 23세,2017,5392,2712,2680,101.2,5339,2687,2652,101.3
11250, 강동구,025005, 24세,2017,5784,2871,2913,98.6,5705,2833,2872,98.6
11250, 강동구,030,25~29세,2017,30251,15194,15057,100.9,29638,14904,14734,101.2
11250, 강동구,030001, 25세,2017,6184,3078,3106,99.1,6071,3024,3047,99.2
11250, 강동구,030002, 26세,2017,6019,3014,3005,100.3,5905,2957,2948,100.3
11250, 강동구,030003, 27세,2017,6013,3027,2986,101.4,5888,2977,2911,102.3
11250, 강동구,030004, 28세,2017,5943,2995,2948,101.6,5823,2936,2887,101.7
11250, 강동구,030005, 29세,2017,6092,3080,3012,102.3,5951,3010,2941,102.3
11250, 강동구,035,30~34세,2017,32098,16139,15959,101.1,31382,15785,15597,101.2
11250, 강동구,035001, 30세,2017,6036,2980,3056,97.5,5872,2897,2975,97.4
11250, 강동구,035002, 31세,2017,6098,3061,3037,100.8,5924,2970,2954,100.5
11250, 강동구,035003, 32세,2017,6341,3186,3155,101,6195,3115,3080,101.1
11250, 강동구,035004, 33세,2017,6622,3394,3228,105.1,6498,3331,3167,105.2
11250, 강동구,035005, 34세,2017,7001,3518,3483,101,6893,3472,3421,101.5
11250, 강동구,040,35~39세,2017,36089,18243,17846,102.2,35538,17968,17570,102.3
11250, 강동구,040001, 35세,2017,7515,3795,3720,102,7387,3735,3652,102.3
11250, 강동구,040002, 36세,2017,7536,3822,3714,102.9,7432,3770,3662,102.9
11250, 강동구,040003, 37세,2017,7515,3853,3662,105.2,7408,3798,3610,105.2
11250, 강동구,040004, 38세,2017,7164,3578,3586,99.8,7055,3523,3532,99.7
11250, 강동구,040005, 39세,2017,6359,3195,3164,101,6256,3142,3114,100.9
11250, 강동구,045,40~44세,2017,32763,16455,16308,100.9,32284,16217,16067,100.9
11250, 강동구,045001, 40세,2017,6430,3225,3205,100.6,6335,3176,3159,100.5
11250, 강동구,045002, 41세,2017,6207,3187,3020,105.5,6105,3140,2965,105.9
11250, 강동구,045003, 42세,2017,6325,3170,3155,100.5,6247,3133,3114,100.6
11250, 강동구,045004, 43세,2017,6790,3404,3386,100.5,6697,3360,3337,100.7
11250, 강동구,045005, 44세,2017,7011,3469,3542,97.9,6900,3408,3492,97.6
11250, 강동구,050,45~49세,2017,36613,18103,18510,97.8,35966,17789,18177,97.9
11250, 강동구,050001, 45세,2017,7138,3576,3562,100.4,7016,3512,3504,100.2
11250, 강동구,050002, 46세,2017,7416,3734,3682,101.4,7284,3670,3614,101.5
11250, 강동구,050003, 47세,2017,7298,3572,3726,95.9,7173,3514,3659,96
11250, 강동구,050004, 48세,2017,7318,3560,3758,94.7,7184,3495,3689,94.7
11250, 강동구,050005, 49세,2017,7443,3661,3782,96.8,7309,3598,3711,97
11250, 강동구,055,50~54세,2017,33842,16370,17472,93.7,33132,16051,17081,94
11250, 강동구,055001, 50세,2017,6639,3171,3468,91.4,6530,3125,3405,91.8
11250, 강동구,055002, 51세,2017,6529,3276,3253,100.7,6406,3226,3180,101.4
11250, 강동구,055003, 52세,2017,6809,3227,3582,90.1,6663,3153,3510,89.8
11250, 강동구,055004, 53세,2017,6805,3265,3540,92.2,6654,3198,3456,92.5
11250, 강동구,055005, 54세,2017,7060,3431,3629,94.5,6879,3349,3530,94.9
11250, 강동구,060,55~59세,2017,37956,18026,19930,90.4,37302,17741,19561,90.7
11250, 강동구,060001, 55세,2017,7435,3651,3784,96.5,7300,3588,3712,96.7
11250, 강동구,060002, 56세,2017,7906,3703,4203,88.1,7810,3671,4139,88.7
11250, 강동구,060003, 57세,2017,8086,3760,4326,86.9,7941,3693,4248,86.9
11250, 강동구,060004, 58세,2017,7440,3496,3944,88.6,7305,3436,3869,88.8
11250, 강동구,060005, 59세,2017,7089,3416,3673,93,6946,3353,3593,93.3
11250, 강동구,065,60~64세,2017,30940,14762,16178,91.2,30352,14463,15889,91
11250, 강동구,065001, 60세,2017,7027,3402,3625,93.8,6899,3331,3568,93.4
11250, 강동구,065002, 61세,2017,6592,3077,3515,87.5,6452,3016,3436,87.8
11250, 강동구,065003, 62세,2017,6702,3157,3545,89.1,6575,3097,3478,89
11250, 강동구,065004, 63세,2017,5650,2701,2949,91.6,5556,2649,2907,91.1
11250, 강동구,065005, 64세,2017,4969,2425,2544,95.3,4870,2370,2500,94.8
11250, 강동구,070,65~69세,2017,21057,10420,10637,98,20802,10297,10505,98
11250, 강동구,070001, 65세,2017,5334,2595,2739,94.7,5254,2556,2698,94.7
11250, 강동구,070002, 66세,2017,3649,1804,1845,97.8,3583,1766,1817,97.2
11250, 강동구,070003, 67세,2017,4010,1986,2024,98.1,3964,1965,1999,98.3
11250, 강동구,070004, 68세,2017,4111,2021,2090,96.7,4078,2009,2069,97.1
11250, 강동구,070005, 69세,2017,3953,2014,1939,103.9,3923,2001,1922,104.1
11250, 강동구,075,70~74세,2017,14241,7008,7233,96.9,14165,6980,7185,97.1
11250, 강동구,075001, 70세,2017,3751,1793,1958,91.6,3723,1783,1940,91.9
11250, 강동구,075002, 71세,2017,2813,1411,1402,100.6,2794,1403,1391,100.9
11250, 강동구,075003, 72세,2017,2645,1336,1309,102.1,2639,1335,1304,102.4
11250, 강동구,075004, 73세,2017,2568,1261,1307,96.5,2558,1257,1301,96.6
11250, 강동구,075005, 74세,2017,2464,1207,1257,96,2451,1202,1249,96.2
11250, 강동구,080,75~79세,2017,9779,4563,5216,87.5,9737,4550,5187,87.7
11250, 강동구,080001, 75세,2017,2670,1312,1358,96.6,2660,1309,1351,96.9
11250, 강동구,080002, 76세,2017,2134,1026,1108,92.6,2128,1024,1104,92.8
11250, 강동구,080003, 77세,2017,1767,817,950,86,1760,816,944,86.4
11250, 강동구,080004, 78세,2017,1715,758,957,79.2,1707,755,952,79.3
11250, 강동구,080005, 79세,2017,1493,650,843,77.1,1482,646,836,77.3
11250, 강동구,085,80~84세,2017,5420,1926,3494,55.1,5394,1918,3476,55.2
11250, 강동구,085001, 80세,2017,1359,525,834,62.9,1351,522,829,63
11250, 강동구,085002, 81세,2017,1191,461,730,63.2,1189,460,729,63.1
11250, 강동구,085003, 82세,2017,1156,381,775,49.2,1150,380,770,49.4
11250, 강동구,085004, 83세,2017,944,305,639,47.7,940,304,636,47.8
11250, 강동구,085005, 84세,2017,770,254,516,49.2,764,252,512,49.2
11250, 강동구,090,85~89세,2017,2741,718,2023,35.5,2733,715,2018,35.4
11250, 강동구,090001, 85세,2017,712,205,507,40.4,709,205,504,40.7
11250, 강동구,090002, 86세,2017,578,159,419,37.9,576,158,418,37.8
11250, 강동구,090003, 87세,2017,560,145,415,34.9,558,144,414,34.8
11250, 강동구,090004, 88세,2017,486,123,363,33.9,485,122,363,33.6
11250, 강동구,090005, 89세,2017,405,86,319,27,405,86,319,27
11250, 강동구,095,90~94세,2017,992,196,796,24.6,989,194,795,24.4
11250, 강동구,095001, 90세,2017,312,63,249,25.3,312,63,249,25.3
11250, 강동구,095002, 91세,2017,235,45,190,23.7,235,45,190,23.7
11250, 강동구,095003, 92세,2017,180,25,155,16.1,178,24,154,15.6
11250, 강동구,095004, 93세,2017,124,32,92,34.8,124,32,92,34.8
11250, 강동구,095005, 94세,2017,141,31,110,28.2,140,30,110,27.3
11250, 강동구,100,95~99세,2017,214,51,163,31.3,214,51,163,31.3
11250, 강동구,100001, 95세,2017,73,18,55,32.7,73,18,55,32.7
11250, 강동구,100002, 96세,2017,56,17,39,43.6,56,17,39,43.6
11250, 강동구,100003, 97세,2017,41,9,32,28.1,41,9,32,28.1
11250, 강동구,100004, 98세,2017,30,5,25,20,30,5,25,20
11250, 강동구,100005, 99세,2017,14,X,12,16.7,14,X,12,16.7
11250, 강동구,101,100세이상,2017,35,6,29,20.7,34,6,28,21.4
11250, 강동구,102,15세미만,2017,50769,26425,24344,108.5,50558,26328,24230,108.7
11250, 강동구,103,15~64세,2017,318730,158618,160112,99.1,313465,156101,157364,99.2
11250, 강동구,104,65세이상,2017,54479,24888,29591,84.1,54068,24711,29357,84.2
11250, 강동구,086,85세이상,2017,3982,971,3011,32.2,3970,966,3004,32.2
11250, 강동구,126,평균연령,2017,41.6,40.6,42.5,,41.5,40.6,42.5,
11250, 강동구,127,중위연령,2017,42.3,41.1,43.5,,42.3,41.1,43.4,
21,부산광역시,000,합계,2017,3416918,1680933,1735985,96.8,3368110,1652803,1715307,96.4
21,부산광역시,005,0~4세,2017,124080,63735,60345,105.6,123600,63501,60099,105.7
21,부산광역시,005001, 0세,2017,21705,11159,10546,105.8,21604,11104,10500,105.8
21,부산광역시,005002, 1세,2017,24822,12695,12127,104.7,24715,12646,12069,104.8
21,부산광역시,005003, 2세,2017,26164,13434,12730,105.5,26066,13389,12677,105.6
21,부산광역시,005004, 3세,2017,25703,13299,12404,107.2,25610,13259,12351,107.4
21,부산광역시,005005, 4세,2017,25686,13148,12538,104.9,25605,13103,12502,104.8
21,부산광역시,010,5~9세,2017,131344,67540,63804,105.9,131043,67393,63650,105.9
21,부산광역시,010001, 5세,2017,27845,14390,13455,106.9,27764,14354,13410,107
21,부산광역시,010002, 6세,2017,27370,13942,13428,103.8,27323,13916,13407,103.8
21,부산광역시,010003, 7세,2017,25764,13303,12461,106.8,25695,13275,12420,106.9
21,부산광역시,010004, 8세,2017,24618,12687,11931,106.3,24560,12656,11904,106.3
21,부산광역시,010005, 9세,2017,25747,13218,12529,105.5,25701,13192,12509,105.5
21,부산광역시,015,10~14세,2017,129597,67142,62455,107.5,129336,67018,62318,107.5
21,부산광역시,015001, 10세,2017,26389,13545,12844,105.5,26349,13530,12819,105.5
21,부산광역시,015002, 11세,2017,24232,12579,11653,107.9,24181,12554,11627,108
21,부산광역시,015003, 12세,2017,24339,12611,11728,107.5,24287,12587,11700,107.6
21,부산광역시,015004, 13세,2017,26827,13888,12939,107.3,26766,13853,12913,107.3
21,부산광역시,015005, 14세,2017,27810,14519,13291,109.2,27753,14494,13259,109.3
21,부산광역시,020,15~19세,2017,182238,95018,87220,108.9,180155,94050,86105,109.2
21,부산광역시,020001, 15세,2017,28681,14890,13791,108,28615,14860,13755,108
21,부산광역시,020002, 16세,2017,33470,17678,15792,111.9,33387,17629,15758,111.9
21,부산광역시,020003, 17세,2017,37492,19796,17696,111.9,37305,19718,17587,112.1
21,부산광역시,020004, 18세,2017,38075,19991,18084,110.5,37590,19745,17845,110.6
21,부산광역시,020005, 19세,2017,44520,22663,21857,103.7,43258,22098,21160,104.4
21,부산광역시,025,20~24세,2017,240049,126463,113586,111.3,231153,122182,108971,112.1
21,부산광역시,025001, 20세,2017,45010,22471,22539,99.7,43345,21777,21568,101
21,부산광역시,025002, 21세,2017,47570,24777,22793,108.7,45808,23972,21836,109.8
21,부산광역시,025003, 22세,2017,48626,25889,22737,113.9,46866,25062,21804,114.9
21,부산광역시,025004, 23세,2017,49652,26668,22984,116,47842,25742,22100,116.5
21,부산광역시,025005, 24세,2017,49191,26658,22533,118.3,47292,25629,21663,118.3
21,부산광역시,030,25~29세,2017,218670,115467,103203,111.9,209493,109902,99591,110.4
21,부산광역시,030001, 25세,2017,49415,26559,22856,116.2,47596,25494,22102,115.3
21,부산광역시,030002, 26세,2017,45437,24206,21231,114,43617,23098,20519,112.6
21,부산광역시,030003, 27세,2017,42655,22444,20211,111,40740,21297,19443,109.5
21,부산광역시,030004, 28세,2017,41640,21770,19870,109.6,39811,20640,19171,107.7
21,부산광역시,030005, 29세,2017,39523,20488,19035,107.6,37729,19373,18356,105.5
21,부산광역시,035,30~34세,2017,208550,107923,100627,107.3,200554,102627,97927,104.8
21,부산광역시,035001, 30세,2017,39489,20326,19163,106.1,37654,19156,18498,103.6
21,부산광역시,035002, 31세,2017,39546,20710,18836,109.9,37839,19598,18241,107.4
21,부산광역시,035003, 32세,2017,40204,20845,19359,107.7,38601,19760,18841,104.9
21,부산광역시,035004, 33세,2017,42418,21968,20450,107.4,40921,20941,19980,104.8
21,부산광역시,035005, 34세,2017,46893,24074,22819,105.5,45539,23172,22367,103.6
21,부산광역시,040,35~39세,2017,255424,131196,124228,105.6,249880,127445,122435,104.1
21,부산광역시,040001, 35세,2017,51512,26537,24975,106.3,50118,25586,24532,104.3
21,부산광역시,040002, 36세,2017,52901,27246,25655,106.2,51785,26508,25277,104.9
21,부산광역시,040003, 37세,2017,54117,27779,26338,105.5,53030,27031,25999,104
21,부산광역시,040004, 38세,2017,50775,25819,24956,103.5,49744,25124,24620,102
21,부산광역시,040005, 39세,2017,46119,23815,22304,106.8,45203,23196,22007,105.4
21,부산광역시,045,40~44세,2017,244934,123941,120993,102.4,240997,121441,119556,101.6
21,부산광역시,045001, 40세,2017,46100,23613,22487,105,45231,23043,22188,103.9
21,부산광역시,045002, 41세,2017,44757,22916,21841,104.9,43953,22403,21550,104
21,부산광역시,045003, 42세,2017,48336,24378,23958,101.8,47567,23871,23696,100.7
21,부산광역시,045004, 43세,2017,52312,26402,25910,101.9,51562,25947,25615,101.3
21,부산광역시,045005, 44세,2017,53429,26632,26797,99.4,52684,26177,26507,98.8
21,부산광역시,050,45~49세,2017,282671,139262,143409,97.1,279391,137409,141982,96.8
21,부산광역시,050001, 45세,2017,54192,27337,26855,101.8,53511,26921,26590,101.2
21,부산광역시,050002, 46세,2017,57277,28316,28961,97.8,56579,27904,28675,97.3
21,부산광역시,050003, 47세,2017,56540,27895,28645,97.4,55849,27512,28337,97.1
21,부산광역시,050004, 48세,2017,56924,27752,29172,95.1,56266,27387,28879,94.8
21,부산광역시,050005, 49세,2017,57738,27962,29776,93.9,57186,27685,29501,93.8
21,부산광역시,055,50~54세,2017,270775,130892,139883,93.6,268165,129522,138643,93.4
21,부산광역시,055001, 50세,2017,54595,26027,28568,91.1,54087,25736,28351,90.8
21,부산광역시,055002, 51세,2017,53372,26337,27035,97.4,52822,26047,26775,97.3
21,부산광역시,055003, 52세,2017,53918,25715,28203,91.2,53410,25459,27951,91.1
21,부산광역시,055004, 53세,2017,51847,25198,26649,94.6,51337,24944,26393,94.5
21,부산광역시,055005, 54세,2017,57043,27615,29428,93.8,56509,27336,29173,93.7
21,부산광역시,060,55~59세,2017,313603,149182,164421,90.7,311816,148322,163494,90.7
21,부산광역시,060001, 55세,2017,60778,29319,31459,93.2,60329,29090,31239,93.1
21,부산광역시,060002, 56세,2017,66216,31134,35082,88.7,65878,30968,34910,88.7
21,부산광역시,060003, 57세,2017,66870,31443,35427,88.8,66474,31255,35219,88.7
21,부산광역시,060004, 58세,2017,60777,28891,31886,90.6,60488,28758,31730,90.6
21,부산광역시,060005, 59세,2017,58962,28395,30567,92.9,58647,28251,30396,92.9
21,부산광역시,065,60~64세,2017,264249,125995,138254,91.1,262942,125336,137606,91.1
21,부산광역시,065001, 60세,2017,59262,28305,30957,91.4,58950,28141,30809,91.3
21,부산광역시,065002, 61세,2017,55462,26539,28923,91.8,55190,26404,28786,91.7
21,부산광역시,065003, 62세,2017,57828,27078,30750,88.1,57557,26939,30618,88
21,부산광역시,065004, 63세,2017,48508,23772,24736,96.1,48258,23646,24612,96.1
21,부산광역시,065005, 64세,2017,43189,20301,22888,88.7,42987,20206,22781,88.7
21,부산광역시,070,65~69세,2017,195683,92502,103181,89.7,195072,92216,102856,89.7
21,부산광역시,070001, 65세,2017,46007,21843,24164,90.4,45838,21768,24070,90.4
21,부산광역시,070002, 66세,2017,37083,17587,19496,90.2,36947,17519,19428,90.2
21,부산광역시,070003, 67세,2017,37373,17800,19573,90.9,37245,17741,19504,91
21,부산광역시,070004, 68세,2017,38243,17917,20326,88.1,38138,17865,20273,88.1
21,부산광역시,070005, 69세,2017,36977,17355,19622,88.4,36904,17323,19581,88.5
21,부산광역시,075,70~74세,2017,140072,64728,75344,85.9,139845,64611,75234,85.9
21,부산광역시,075001, 70세,2017,34815,16143,18672,86.5,34748,16109,18639,86.4
21,부산광역시,075002, 71세,2017,25966,12310,13656,90.1,25913,12279,13634,90.1
21,부산광역시,075003, 72세,2017,25462,11818,13644,86.6,25428,11800,13628,86.6
21,부산광역시,075004, 73세,2017,26620,12148,14472,83.9,26579,12128,14451,83.9
21,부산광역시,075005, 74세,2017,27209,12309,14900,82.6,27177,12295,14882,82.6
21,부산광역시,080,75~79세,2017,113527,48153,65374,73.7,113363,48088,65275,73.7
21,부산광역시,080001, 75세,2017,29162,13086,16076,81.4,29130,13069,16061,81.4
21,부산광역시,080002, 76세,2017,24302,10444,13858,75.4,24260,10428,13832,75.4
21,부산광역시,080003, 77세,2017,21878,9163,12715,72.1,21847,9155,12692,72.1
21,부산광역시,080004, 78세,2017,20783,8492,12291,69.1,20759,8477,12282,69
21,부산광역시,080005, 79세,2017,17402,6968,10434,66.8,17367,6959,10408,66.9
21,부산광역시,085,80~84세,2017,62714,22357,40357,55.4,62634,22327,40307,55.4
21,부산광역시,085001, 80세,2017,16144,6233,9911,62.9,16124,6226,9898,62.9
21,부산광역시,085002, 81세,2017,14001,5176,8825,58.7,13981,5167,8814,58.6
21,부산광역시,085003, 82세,2017,12924,4503,8421,53.5,12915,4499,8416,53.5
21,부산광역시,085004, 83세,2017,10758,3585,7173,50,10747,3581,7166,50
21,부산광역시,085005, 84세,2017,8887,2860,6027,47.5,8867,2854,6013,47.5
21,부산광역시,090,85~89세,2017,27890,7375,20515,35.9,27851,7359,20492,35.9
21,부산광역시,090001, 85세,2017,7923,2343,5580,42,7909,2338,5571,42
21,부산광역시,090002, 86세,2017,6151,1704,4447,38.3,6146,1701,4445,38.3
21,부산광역시,090003, 87세,2017,5268,1305,3963,32.9,5260,1300,3960,32.8
21,부산광역시,090004, 88세,2017,4658,1189,3469,34.3,4653,1187,3466,34.2
21,부산광역시,090005, 89세,2017,3890,834,3056,27.3,3883,833,3050,27.3
21,부산광역시,095,90~94세,2017,8855,1711,7144,24,8837,1708,7129,24
21,부산광역시,095001, 90세,2017,3044,616,2428,25.4,3041,616,2425,25.4
21,부산광역시,095002, 91세,2017,1963,388,1575,24.6,1958,387,1571,24.6
21,부산광역시,095003, 92세,2017,1697,301,1396,21.6,1694,299,1395,21.4
21,부산광역시,095004, 93세,2017,1115,211,904,23.3,1114,211,903,23.4
21,부산광역시,095005, 94세,2017,1036,195,841,23.2,1030,195,835,23.4
21,부산광역시,100,95~99세,2017,1785,331,1454,22.8,1776,327,1449,22.6
21,부산광역시,100001, 95세,2017,695,136,559,24.3,691,134,557,24.1
21,부산광역시,100002, 96세,2017,462,74,388,19.1,460,73,387,18.9
21,부산광역시,100003, 97세,2017,319,61,258,23.6,318,60,258,23.3
21,부산광역시,100004, 98세,2017,187,42,145,29,186,42,144,29.2
21,부산광역시,100005, 99세,2017,122,18,104,17.3,121,18,103,17.5
21,부산광역시,101,100세이상,2017,208,20,188,10.6,207,19,188,10.1
21,부산광역시,102,15세미만,2017,385021,198417,186604,106.3,383979,197912,186067,106.4
21,부산광역시,103,15~64세,2017,2481163,1245339,1235824,100.8,2434546,1218236,1216310,100.2
21,부산광역시,104,65세이상,2017,550734,237177,313557,75.6,549585,236655,312930,75.6
21,부산광역시,086,85세이상,2017,38738,9437,29301,32.2,38671,9413,29258,32.2
21,부산광역시,126,평균연령,2017,43.1,41.7,44.4,,43.2,41.8,44.5,
21,부산광역시,127,중위연령,2017,44.5,42.8,46.2,,44.8,43.1,46.4,
21004, 읍부,000,합계,2017,139734,69140,70594,97.9,137619,67633,69986,96.6
21004, 읍부,005,0~4세,2017,9508,4835,4673,103.5,9494,4827,4667,103.4
21004, 읍부,005001, 0세,2017,1563,821,742,110.6,1562,820,742,110.5
21004, 읍부,005002, 1세,2017,1862,911,951,95.8,1861,910,951,95.7
21004, 읍부,005003, 2세,2017,2017,1023,994,102.9,2011,1020,991,102.9
21004, 읍부,005004, 3세,2017,2026,1040,986,105.5,2021,1037,984,105.4
21004, 읍부,005005, 4세,2017,2040,1040,1000,104,2039,1040,999,104.1
21004, 읍부,010,5~9세,2017,9420,4830,4590,105.2,9413,4827,4586,105.3
21004, 읍부,010001, 5세,2017,2124,1107,1017,108.8,2121,1106,1015,109
21004, 읍부,010002, 6세,2017,2070,1061,1009,105.2,2068,1060,1008,105.2
21004, 읍부,010003, 7세,2017,1832,919,913,100.7,1831,918,913,100.5
21004, 읍부,010004, 8세,2017,1677,836,841,99.4,1676,836,840,99.5
21004, 읍부,010005, 9세,2017,1717,907,810,112,1717,907,810,112
21004, 읍부,015,10~14세,2017,7558,3981,3577,111.3,7552,3977,3575,111.2
21004, 읍부,015001, 10세,2017,1726,910,816,111.5,1726,910,816,111.5
21004, 읍부,015002, 11세,2017,1431,745,686,108.6,1428,743,685,108.5
21004, 읍부,015003, 12세,2017,1439,768,671,114.5,1438,768,670,114.6
21004, 읍부,015004, 13세,2017,1519,810,709,114.2,1518,809,709,114.1
21004, 읍부,015005, 14세,2017,1443,748,695,107.6,1442,747,695,107.5
21004, 읍부,020,15~19세,2017,6981,3596,3385,106.2,6956,3577,3379,105.9
21004, 읍부,020001, 15세,2017,1438,762,676,112.7,1435,761,674,112.9
21004, 읍부,020002, 16세,2017,1496,760,736,103.3,1490,754,736,102.4
21004, 읍부,020003, 17세,2017,1586,766,820,93.4,1582,763,819,93.2
21004, 읍부,020004, 18세,2017,1363,722,641,112.6,1355,716,639,112.1
21004, 읍부,020005, 19세,2017,1098,586,512,114.5,1094,583,511,114.1
21004, 읍부,025,20~24세,2017,6157,3393,2764,122.8,5928,3235,2693,120.1
21004, 읍부,025001, 20세,2017,1183,685,498,137.6,1169,680,489,139.1
21004, 읍부,025002, 21세,2017,1219,700,519,134.9,1198,684,514,133.1
21004, 읍부,025003, 22세,2017,1219,667,552,120.8,1173,635,538,118
21004, 읍부,025004, 23세,2017,1241,651,590,110.3,1173,603,570,105.8
21004, 읍부,025005, 24세,2017,1295,690,605,114,1215,633,582,108.8
21004, 읍부,030,25~29세,2017,6810,3648,3162,115.4,6305,3250,3055,106.4
21004, 읍부,030001, 25세,2017,1292,715,577,123.9,1201,642,559,114.8
21004, 읍부,030002, 26세,2017,1372,725,647,112.1,1281,652,629,103.7
21004, 읍부,030003, 27세,2017,1310,717,593,120.9,1202,641,561,114.3
21004, 읍부,030004, 28세,2017,1338,702,636,110.4,1253,631,622,101.4
21004, 읍부,030005, 29세,2017,1498,789,709,111.3,1368,684,684,100
21004, 읍부,035,30~34세,2017,9888,4796,5092,94.2,9413,4438,4975,89.2
21004, 읍부,035001, 30세,2017,1539,734,805,91.2,1441,664,777,85.5
21004, 읍부,035002, 31세,2017,1725,819,906,90.4,1624,739,885,83.5
21004, 읍부,035003, 32세,2017,1850,928,922,100.7,1760,860,900,95.6
21004, 읍부,035004, 33세,2017,2217,1090,1127,96.7,2117,1015,1102,92.1
21004, 읍부,035005, 34세,2017,2557,1225,1332,92,2471,1160,1311,88.5
21004, 읍부,040,35~39세,2017,15527,7738,7789,99.3,15210,7496,7714,97.2
21004, 읍부,040001, 35세,2017,3035,1498,1537,97.5,2956,1439,1517,94.9
21004, 읍부,040002, 36세,2017,3156,1577,1579,99.9,3081,1521,1560,97.5
21004, 읍부,040003, 37세,2017,3362,1661,1701,97.6,3306,1614,1692,95.4
21004, 읍부,040004, 38세,2017,3130,1586,1544,102.7,3073,1544,1529,101
21004, 읍부,040005, 39세,2017,2844,1416,1428,99.2,2794,1378,1416,97.3
21004, 읍부,045,40~44세,2017,13422,6846,6576,104.1,13240,6728,6512,103.3
21004, 읍부,045001, 40세,2017,2757,1451,1306,111.1,2716,1422,1294,109.9
21004, 읍부,045002, 41세,2017,2602,1322,1280,103.3,2572,1298,1274,101.9
21004, 읍부,045003, 42세,2017,2687,1358,1329,102.2,2659,1342,1317,101.9
21004, 읍부,045004, 43세,2017,2747,1392,1355,102.7,2711,1373,1338,102.6
21004, 읍부,045005, 44세,2017,2629,1323,1306,101.3,2582,1293,1289,100.3
21004, 읍부,050,45~49세,2017,11538,6057,5481,110.5,11394,5976,5418,110.3
21004, 읍부,050001, 45세,2017,2542,1346,1196,112.5,2510,1326,1184,112
21004, 읍부,050002, 46세,2017,2496,1354,1142,118.6,2462,1331,1131,117.7
21004, 읍부,050003, 47세,2017,2303,1230,1073,114.6,2271,1217,1054,115.5
21004, 읍부,050004, 48세,2017,2196,1108,1088,101.8,2173,1097,1076,102
21004, 읍부,050005, 49세,2017,2001,1019,982,103.8,1978,1005,973,103.3
21004, 읍부,055,50~54세,2017,8561,4349,4212,103.3,8469,4294,4175,102.9
21004, 읍부,055001, 50세,2017,1833,932,901,103.4,1821,924,897,103
21004, 읍부,055002, 51세,2017,1746,933,813,114.8,1718,917,801,114.5
21004, 읍부,055003, 52세,2017,1704,824,880,93.6,1680,809,871,92.9
21004, 읍부,055004, 53세,2017,1571,819,752,108.9,1563,814,749,108.7
21004, 읍부,055005, 54세,2017,1707,841,866,97.1,1687,830,857,96.8
21004, 읍부,060,55~59세,2017,8983,4256,4727,90,8940,4233,4707,89.9
21004, 읍부,060001, 55세,2017,1786,869,917,94.8,1776,862,914,94.3
21004, 읍부,060002, 56세,2017,1816,867,949,91.4,1810,863,947,91.1
21004, 읍부,060003, 57세,2017,1917,894,1023,87.4,1910,890,1020,87.3
21004, 읍부,060004, 58세,2017,1826,857,969,88.4,1817,855,962,88.9
21004, 읍부,060005, 59세,2017,1638,769,869,88.5,1627,763,864,88.3
21004, 읍부,065,60~64세,2017,7776,3528,4248,83.1,7738,3509,4229,83
21004, 읍부,065001, 60세,2017,1731,768,963,79.8,1721,765,956,80
21004, 읍부,065002, 61세,2017,1614,734,880,83.4,1604,730,874,83.5
21004, 읍부,065003, 62세,2017,1670,761,909,83.7,1666,758,908,83.5
21004, 읍부,065004, 63세,2017,1430,668,762,87.7,1420,662,758,87.3
21004, 읍부,065005, 64세,2017,1331,597,734,81.3,1327,594,733,81
21004, 읍부,070,65~69세,2017,5972,2774,3198,86.7,5954,2764,3190,86.6
21004, 읍부,070001, 65세,2017,1407,642,765,83.9,1402,640,762,84
21004, 읍부,070002, 66세,2017,1144,539,605,89.1,1143,538,605,88.9
21004, 읍부,070003, 67세,2017,1120,510,610,83.6,1114,507,607,83.5
21004, 읍부,070004, 68세,2017,1146,533,613,86.9,1142,531,611,86.9
21004, 읍부,070005, 69세,2017,1155,550,605,90.9,1153,548,605,90.6
21004, 읍부,075,70~74세,2017,4441,2024,2417,83.7,4428,2017,2411,83.7
21004, 읍부,075001, 70세,2017,1091,525,566,92.8,1088,524,564,92.9
21004, 읍부,075002, 71세,2017,814,369,445,82.9,808,365,443,82.4
21004, 읍부,075003, 72세,2017,817,365,452,80.8,816,364,452,80.5
21004, 읍부,075004, 73세,2017,886,385,501,76.8,884,384,500,76.8
21004, 읍부,075005, 74세,2017,833,380,453,83.9,832,380,452,84.1
21004, 읍부,080,75~79세,2017,3517,1429,2088,68.4,3517,1429,2088,68.4
21004, 읍부,080001, 75세,2017,877,385,492,78.3,877,385,492,78.3
21004, 읍부,080002, 76세,2017,713,295,418,70.6,713,295,418,70.6
21004, 읍부,080003, 77세,2017,688,272,416,65.4,688,272,416,65.4
21004, 읍부,080004, 78세,2017,684,266,418,63.6,684,266,418,63.6
21004, 읍부,080005, 79세,2017,555,211,344,61.3,555,211,344,61.3
21004, 읍부,085,80~84세,2017,2149,711,1438,49.4,2147,711,1436,49.5
21004, 읍부,085001, 80세,2017,517,175,342,51.2,517,175,342,51.2
21004, 읍부,085002, 81세,2017,476,158,318,49.7,475,158,317,49.8
21004, 읍부,085003, 82세,2017,440,161,279,57.7,440,161,279,57.7
21004, 읍부,085004, 83세,2017,386,117,269,43.5,386,117,269,43.5
21004, 읍부,085005, 84세,2017,330,100,230,43.5,329,100,229,43.7
21004, 읍부,090,85~89세,2017,1053,281,772,36.4,1051,279,772,36.1
21004, 읍부,090001, 85세,2017,302,98,204,48,301,97,204,47.5
21004, 읍부,090002, 86세,2017,254,74,180,41.1,253,73,180,40.6
21004, 읍부,090003, 87세,2017,198,49,149,32.9,198,49,149,32.9
21004, 읍부,090004, 88세,2017,160,34,126,27,160,34,126,27
21004, 읍부,090005, 89세,2017,139,26,113,23,139,26,113,23
21004, 읍부,095,90~94세,2017,371,50,321,15.6,370,50,320,15.6
21004, 읍부,095001, 90세,2017,133,18,115,15.7,133,18,115,15.7
21004, 읍부,095002, 91세,2017,70,10,60,16.7,70,10,60,16.7
21004, 읍부,095003, 92세,2017,79,10,69,14.5,79,10,69,14.5
21004, 읍부,095004, 93세,2017,40,6,34,17.6,39,6,33,18.2
21004, 읍부,095005, 94세,2017,49,6,43,14,49,6,43,14
21004, 읍부,100,95~99세,2017,92,18,74,24.3,90,16,74,21.6
21004, 읍부,100001, 95세,2017,36,10,26,38.5,35,9,26,34.6
21004, 읍부,100002, 96세,2017,23,X,21,9.5,23,X,21,9.5
21004, 읍부,100003, 97세,2017,16,X,13,23.1,15,X,13,15.4
21004, 읍부,100004, 98세,2017,9,X,7,28.6,9,X,7,28.6
21004, 읍부,100005, 99세,2017,8,X,7,14.3,8,X,7,14.3
21004, 읍부,101,100세이상,2017,10,X,10,0,10,X,10,0
21004, 읍부,102,15세미만,2017,26486,13646,12840,106.3,26459,13631,12828,106.3
21004, 읍부,103,15~64세,2017,95643,48207,47436,101.6,93593,46736,46857,99.7
21004, 읍부,104,65세이상,2017,17605,7287,10318,70.6,17567,7266,10301,70.5
21004, 읍부,086,85세이상,2017,1526,349,1177,29.7,1521,345,1176,29.3
21004, 읍부,126,평균연령,2017,38.8,37.4,40.1,,38.8,37.5,40.1,
21004, 읍부,127,중위연령,2017,39.3,38.5,40.2,,39.5,38.7,40.3,
21005, 면부,000,합계,2017,16827,8447,8380,100.8,16555,8263,8292,99.7
21005, 면부,005,0~4세,2017,563,298,265,112.5,562,297,265,112.1
21005, 면부,005001, 0세,2017,96,44,52,84.6,95,43,52,82.7
21005, 면부,005002, 1세,2017,121,62,59,105.1,121,62,59,105.1
21005, 면부,005003, 2세,2017,110,64,46,139.1,110,64,46,139.1
21005, 면부,005004, 3세,2017,133,75,58,129.3,133,75,58,129.3
21005, 면부,005005, 4세,2017,103,53,50,106,103,53,50,106
21005, 면부,010,5~9세,2017,479,238,241,98.8,479,238,241,98.8
21005, 면부,010001, 5세,2017,102,55,47,117,102,55,47,117
21005, 면부,010002, 6세,2017,112,57,55,103.6,112,57,55,103.6
21005, 면부,010003, 7세,2017,99,52,47,110.6,99,52,47,110.6
21005, 면부,010004, 8세,2017,77,41,36,113.9,77,41,36,113.9
21005, 면부,010005, 9세,2017,89,33,56,58.9,89,33,56,58.9
21005, 면부,015,10~14세,2017,401,216,185,116.8,399,215,184,116.8
21005, 면부,015001, 10세,2017,74,36,38,94.7,74,36,38,94.7
21005, 면부,015002, 11세,2017,93,50,43,116.3,93,50,43,116.3
21005, 면부,015003, 12세,2017,73,40,33,121.2,73,40,33,121.2
21005, 면부,015004, 13세,2017,80,50,30,166.7,79,49,30,163.3
21005, 면부,015005, 14세,2017,81,40,41,97.6,80,40,40,100
21005, 면부,020,15~19세,2017,553,345,208,165.9,552,344,208,165.4
21005, 면부,020001, 15세,2017,81,49,32,153.1,81,49,32,153.1
21005, 면부,020002, 16세,2017,88,60,28,214.3,88,60,28,214.3
21005, 면부,020003, 17세,2017,102,70,32,218.8,102,70,32,218.8
21005, 면부,020004, 18세,2017,140,76,64,118.8,139,75,64,117.2
21005, 면부,020005, 19세,2017,142,90,52,173.1,142,90,52,173.1
21005, 면부,025,20~24세,2017,876,533,343,155.4,851,516,335,154
21005, 면부,025001, 20세,2017,138,81,57,142.1,137,80,57,140.4
21005, 면부,025002, 21세,2017,172,100,72,138.9,168,98,70,140
21005, 면부,025003, 22세,2017,166,102,64,159.4,162,99,63,157.1
21005, 면부,025004, 23세,2017,197,120,77,155.8,192,116,76,152.6
21005, 면부,025005, 24세,2017,203,130,73,178.1,192,123,69,178.3
21005, 면부,030,25~29세,2017,907,506,401,126.2,851,471,380,123.9
21005, 면부,030001, 25세,2017,192,108,84,128.6,179,104,75,138.7
21005, 면부,030002, 26세,2017,182,102,80,127.5,171,94,77,122.1
21005, 면부,030003, 27세,2017,181,97,84,115.5,173,93,80,116.3
21005, 면부,030004, 28세,2017,173,98,75,130.7,160,88,72,122.2
21005, 면부,030005, 29세,2017,179,101,78,129.5,168,92,76,121.1
21005, 면부,035,30~34세,2017,910,510,400,127.5,848,464,384,120.8
21005, 면부,035001, 30세,2017,158,86,72,119.4,148,78,70,111.4
21005, 면부,035002, 31세,2017,181,91,90,101.1,168,85,83,102.4
21005, 면부,035003, 32세,2017,184,101,83,121.7,170,89,81,109.9
21005, 면부,035004, 33세,2017,184,109,75,145.3,170,98,72,136.1
21005, 면부,035005, 34세,2017,203,123,80,153.8,192,114,78,146.2
21005, 면부,040,35~39세,2017,1025,558,467,119.5,973,517,456,113.4
21005, 면부,040001, 35세,2017,209,119,90,132.2,198,110,88,125
21005, 면부,040002, 36세,2017,222,116,106,109.4,209,105,104,101
21005, 면부,040003, 37세,2017,233,132,101,130.7,217,120,97,123.7
21005, 면부,040004, 38세,2017,198,100,98,102,190,94,96,97.9
21005, 면부,040005, 39세,2017,163,91,72,126.4,159,88,71,123.9
21005, 면부,045,40~44세,2017,976,574,402,142.8,957,559,398,140.5
21005, 면부,045001, 40세,2017,177,94,83,113.3,175,92,83,110.8
21005, 면부,045002, 41세,2017,196,127,69,184.1,192,124,68,182.4
21005, 면부,045003, 42세,2017,196,121,75,161.3,190,116,74,156.8
21005, 면부,045004, 43세,2017,203,118,85,138.8,199,114,85,134.1
21005, 면부,045005, 44세,2017,204,114,90,126.7,201,113,88,128.4
21005, 면부,050,45~49세,2017,1133,592,541,109.4,1120,583,537,108.6
21005, 면부,050001, 45세,2017,214,110,104,105.8,214,110,104,105.8
21005, 면부,050002, 46세,2017,226,123,103,119.4,219,120,99,121.2
21005, 면부,050003, 47세,2017,234,110,124,88.7,231,107,124,86.3
21005, 면부,050004, 48세,2017,226,126,100,126,223,123,100,123
21005, 면부,050005, 49세,2017,233,123,110,111.8,233,123,110,111.8
21005, 면부,055,50~54세,2017,1323,621,702,88.5,1305,613,692,88.6
21005, 면부,055001, 50세,2017,262,120,142,84.5,259,118,141,83.7
21005, 면부,055002, 51세,2017,250,118,132,89.4,248,117,131,89.3
21005, 면부,055003, 52세,2017,250,120,130,92.3,245,117,128,91.4
21005, 면부,055004, 53세,2017,256,119,137,86.9,250,118,132,89.4
21005, 면부,055005, 54세,2017,305,144,161,89.4,303,143,160,89.4
21005, 면부,060,55~59세,2017,1781,838,943,88.9,1769,832,937,88.8
21005, 면부,060001, 55세,2017,324,164,160,102.5,322,162,160,101.3
21005, 면부,060002, 56세,2017,373,171,202,84.7,372,170,202,84.2
21005, 면부,060003, 57세,2017,380,184,196,93.9,376,183,193,94.8
21005, 면부,060004, 58세,2017,334,147,187,78.6,331,146,185,78.9
21005, 면부,060005, 59세,2017,370,172,198,86.9,368,171,197,86.8
21005, 면부,065,60~64세,2017,1698,807,891,90.6,1694,806,888,90.8
21005, 면부,065001, 60세,2017,373,177,196,90.3,372,177,195,90.8
21005, 면부,065002, 61세,2017,361,170,191,89,361,170,191,89
21005, 면부,065003, 62세,2017,363,183,180,101.7,362,183,179,102.2
21005, 면부,065004, 63세,2017,331,150,181,82.9,330,149,181,82.3
21005, 면부,065005, 64세,2017,270,127,143,88.8,269,127,142,89.4
21005, 면부,070,65~69세,2017,1409,671,738,90.9,1406,670,736,91
21005, 면부,070001, 65세,2017,311,138,173,79.8,310,137,173,79.2
21005, 면부,070002, 66세,2017,300,141,159,88.7,298,141,157,89.8
21005, 면부,070003, 67세,2017,243,123,120,102.5,243,123,120,102.5
21005, 면부,070004, 68세,2017,287,146,141,103.5,287,146,141,103.5
21005, 면부,070005, 69세,2017,268,123,145,84.8,268,123,145,84.8
21005, 면부,075,70~74세,2017,1064,521,543,95.9,1063,521,542,96.1
21005, 면부,075001, 70세,2017,278,132,146,90.4,278,132,146,90.4
21005, 면부,075002, 71세,2017,189,91,98,92.9,189,91,98,92.9
21005, 면부,075003, 72세,2017,193,95,98,96.9,193,95,98,96.9
21005, 면부,075004, 73세,2017,198,106,92,115.2,197,106,91,116.5
21005, 면부,075005, 74세,2017,206,97,109,89,206,97,109,89
21005, 면부,080,75~79세,2017,878,354,524,67.6,875,352,523,67.3
21005, 면부,080001, 75세,2017,218,84,134,62.7,218,84,134,62.7
21005, 면부,080002, 76세,2017,167,73,94,77.7,166,72,94,76.6
21005, 면부,080003, 77세,2017,177,63,114,55.3,175,62,113,54.9
21005, 면부,080004, 78세,2017,162,67,95,70.5,162,67,95,70.5
21005, 면부,080005, 79세,2017,154,67,87,77,154,67,87,77
21005, 면부,085,80~84세,2017,516,179,337,53.1,516,179,337,53.1
21005, 면부,085001, 80세,2017,136,63,73,86.3,136,63,73,86.3
21005, 면부,085002, 81세,2017,108,45,63,71.4,108,45,63,71.4
21005, 면부,085003, 82세,2017,103,31,72,43.1,103,31,72,43.1
21005, 면부,085004, 83세,2017,100,20,80,25,100,20,80,25
21005, 면부,085005, 84세,2017,69,20,49,40.8,69,20,49,40.8
21005, 면부,090,85~89세,2017,247,72,175,41.1,247,72,175,41.1
21005, 면부,090001, 85세,2017,75,27,48,56.3,75,27,48,56.3
21005, 면부,090002, 86세,2017,53,16,37,43.2,53,16,37,43.2
21005, 면부,090003, 87세,2017,48,7,41,17.1,48,7,41,17.1
21005, 면부,090004, 88세,2017,29,7,22,31.8,29,7,22,31.8
21005, 면부,090005, 89세,2017,42,15,27,55.6,42,15,27,55.6
21005, 면부,095,90~94세,2017,63,11,52,21.2,63,11,52,21.2
21005, 면부,095001, 90세,2017,16,X,12,33.3,16,X,12,33.3
21005, 면부,095002, 91세,2017,7,X,7,0,7,X,7,0
21005, 면부,095003, 92세,2017,13,X,12,8.3,13,X,12,8.3
21005, 면부,095004, 93세,2017,12,X,10,20,12,X,10,20
21005, 면부,095005, 94세,2017,15,X,11,36.4,15,X,11,36.4
21005, 면부,100,95~99세,2017,22,X,19,15.8,22,X,19,15.8
21005, 면부,100001, 95세,2017,8,X,7,14.3,8,X,7,14.3
21005, 면부,100002, 96세,2017,7,X,5,40,7,X,5,40
21005, 면부,100003, 97세,2017,X,X,X,0,X,X,X,0
21005, 면부,100004, 98세,2017,X,X,X,0,X,X,X,0
21005, 면부,100005, 99세,2017,X,X,X,0,X,X,X,0
21005, 면부,101,100세이상,2017,X,X,X,0,X,X,X,0
21005, 면부,102,15세미만,2017,1443,752,691,108.8,1440,750,690,108.7
21005, 면부,103,15~64세,2017,11182,5884,5298,111.1,10920,5705,5215,109.4
21005, 면부,104,65세이상,2017,4202,1811,2391,75.7,4195,1808,2387,75.7
21005, 면부,086,85세이상,2017,335,86,249,34.5,335,86,249,34.5
21005, 면부,126,평균연령,2017,48.6,46.3,50.9,,48.8,46.5,51.1,
21005, 면부,127,중위연령,2017,52.3,48.8,55.2,,52.7,49.4,55.4,
21003, 동부,000,합계,2017,3260357,1603346,1657011,96.8,3213936,1576907,1637029,96.3
21003, 동부,005,0~4세,2017,114009,58602,55407,105.8,113544,58377,55167,105.8
21003, 동부,005001, 0세,2017,20046,10294,9752,105.6,19947,10241,9706,105.5
21003, 동부,005002, 1세,2017,22839,11722,11117,105.4,22733,11674,11059,105.6
21003, 동부,005003, 2세,2017,24037,12347,11690,105.6,23945,12305,11640,105.7
21003, 동부,005004, 3세,2017,23544,12184,11360,107.3,23456,12147,11309,107.4
21003, 동부,005005, 4세,2017,23543,12055,11488,104.9,23463,12010,11453,104.9
21003, 동부,010,5~9세,2017,121445,62472,58973,105.9,121151,62328,58823,106
21003, 동부,010001, 5세,2017,25619,13228,12391,106.8,25541,13193,12348,106.8
21003, 동부,010002, 6세,2017,25188,12824,12364,103.7,25143,12799,12344,103.7
21003, 동부,010003, 7세,2017,23833,12332,11501,107.2,23765,12305,11460,107.4
21003, 동부,010004, 8세,2017,22864,11810,11054,106.8,22807,11779,11028,106.8
21003, 동부,010005, 9세,2017,23941,12278,11663,105.3,23895,12252,11643,105.2
21003, 동부,015,10~14세,2017,121638,62945,58693,107.2,121385,62826,58559,107.3
21003, 동부,015001, 10세,2017,24589,12599,11990,105.1,24549,12584,11965,105.2
21003, 동부,015002, 11세,2017,22708,11784,10924,107.9,22660,11761,10899,107.9
21003, 동부,015003, 12세,2017,22827,11803,11024,107.1,22776,11779,10997,107.1
21003, 동부,015004, 13세,2017,25228,13028,12200,106.8,25169,12995,12174,106.7
21003, 동부,015005, 14세,2017,26286,13731,12555,109.4,26231,13707,12524,109.4
21003, 동부,020,15~19세,2017,174704,91077,83627,108.9,172647,90129,82518,109.2
21003, 동부,020001, 15세,2017,27162,14079,13083,107.6,27099,14050,13049,107.7
21003, 동부,020002, 16세,2017,31886,16858,15028,112.2,31809,16815,14994,112.1
21003, 동부,020003, 17세,2017,35804,18960,16844,112.6,35621,18885,16736,112.8
21003, 동부,020004, 18세,2017,36572,19193,17379,110.4,36096,18954,17142,110.6
21003, 동부,020005, 19세,2017,43280,21987,21293,103.3,42022,21425,20597,104
21003, 동부,025,20~24세,2017,233016,122537,110479,110.9,224374,118431,105943,111.8
21003, 동부,025001, 20세,2017,43689,21705,21984,98.7,42039,21017,21022,100
21003, 동부,025002, 21세,2017,46179,23977,22202,108,44442,23190,21252,109.1
21003, 동부,025003, 22세,2017,47241,25120,22121,113.6,45531,24328,21203,114.7
21003, 동부,025004, 23세,2017,48214,25897,22317,116,46477,25023,21454,116.6
21003, 동부,025005, 24세,2017,47693,25838,21855,118.2,45885,24873,21012,118.4
21003, 동부,030,25~29세,2017,210953,111313,99640,111.7,202337,106181,96156,110.4
21003, 동부,030001, 25세,2017,47931,25736,22195,116,46216,24748,21468,115.3
21003, 동부,030002, 26세,2017,43883,23379,20504,114,42165,22352,19813,112.8
21003, 동부,030003, 27세,2017,41164,21630,19534,110.7,39365,20563,18802,109.4
21003, 동부,030004, 28세,2017,40129,20970,19159,109.5,38398,19921,18477,107.8
21003, 동부,030005, 29세,2017,37846,19598,18248,107.4,36193,18597,17596,105.7
21003, 동부,035,30~34세,2017,197752,102617,95135,107.9,190293,97725,92568,105.6
21003, 동부,035001, 30세,2017,37792,19506,18286,106.7,36065,18414,17651,104.3
21003, 동부,035002, 31세,2017,37640,19800,17840,111,36047,18774,17273,108.7
21003, 동부,035003, 32세,2017,38170,19816,18354,108,36671,18811,17860,105.3
21003, 동부,035004, 33세,2017,40017,20769,19248,107.9,38634,19828,18806,105.4
21003, 동부,035005, 34세,2017,44133,22726,21407,106.2,42876,21898,20978,104.4
21003, 동부,040,35~39세,2017,238872,122900,115972,106,233697,119432,114265,104.5
21003, 동부,040001, 35세,2017,48268,24920,23348,106.7,46964,24037,22927,104.8
21003, 동부,040002, 36세,2017,49523,25553,23970,106.6,48495,24882,23613,105.4
21003, 동부,040003, 37세,2017,50522,25986,24536,105.9,49507,25297,24210,104.5
21003, 동부,040004, 38세,2017,47447,24133,23314,103.5,46481,23486,22995,102.1
21003, 동부,040005, 39세,2017,43112,22308,20804,107.2,42250,21730,20520,105.9
21003, 동부,045,40~44세,2017,230536,116521,114015,102.2,226800,114154,112646,101.3
21003, 동부,045001, 40세,2017,43166,22068,21098,104.6,42340,21529,20811,103.5
21003, 동부,045002, 41세,2017,41959,21467,20492,104.8,41189,20981,20208,103.8
21003, 동부,045003, 42세,2017,45453,22899,22554,101.5,44718,22413,22305,100.5
21003, 동부,045004, 43세,2017,49362,24892,24470,101.7,48652,24460,24192,101.1
21003, 동부,045005, 44세,2017,50596,25195,25401,99.2,49901,24771,25130,98.6
21003, 동부,050,45~49세,2017,270000,132613,137387,96.5,266877,130850,136027,96.2
21003, 동부,050001, 45세,2017,51436,25881,25555,101.3,50787,25485,25302,100.7
21003, 동부,050002, 46세,2017,54555,26839,27716,96.8,53898,26453,27445,96.4
21003, 동부,050003, 47세,2017,54003,26555,27448,96.7,53347,26188,27159,96.4
21003, 동부,050004, 48세,2017,54502,26518,27984,94.8,53870,26167,27703,94.5
21003, 동부,050005, 49세,2017,55504,26820,28684,93.5,54975,26557,28418,93.5
21003, 동부,055,50~54세,2017,260891,125922,134969,93.3,258391,124615,133776,93.2
21003, 동부,055001, 50세,2017,52500,24975,27525,90.7,52007,24694,27313,90.4
21003, 동부,055002, 51세,2017,51376,25286,26090,96.9,50856,25013,25843,96.8
21003, 동부,055003, 52세,2017,51964,24771,27193,91.1,51485,24533,26952,91
21003, 동부,055004, 53세,2017,50020,24260,25760,94.2,49524,24012,25512,94.1
21003, 동부,055005, 54세,2017,55031,26630,28401,93.8,54519,26363,28156,93.6
21003, 동부,060,55~59세,2017,302839,144088,158751,90.8,301107,143257,157850,90.8
21003, 동부,060001, 55세,2017,58668,28286,30382,93.1,58231,28066,30165,93
21003, 동부,060002, 56세,2017,64027,30096,33931,88.7,63696,29935,33761,88.7
21003, 동부,060003, 57세,2017,64573,30365,34208,88.8,64188,30182,34006,88.8
21003, 동부,060004, 58세,2017,58617,27887,30730,90.7,58340,27757,30583,90.8
21003, 동부,060005, 59세,2017,56954,27454,29500,93.1,56652,27317,29335,93.1
21003, 동부,065,60~64세,2017,254775,121660,133115,91.4,253510,121021,132489,91.3
21003, 동부,065001, 60세,2017,57158,27360,29798,91.8,56857,27199,29658,91.7
21003, 동부,065002, 61세,2017,53487,25635,27852,92,53225,25504,27721,92
21003, 동부,065003, 62세,2017,55795,26134,29661,88.1,55529,25998,29531,88
21003, 동부,065004, 63세,2017,46747,22954,23793,96.5,46508,22835,23673,96.5
21003, 동부,065005, 64세,2017,41588,19577,22011,88.9,41391,19485,21906,88.9
21003, 동부,070,65~69세,2017,188302,89057,99245,89.7,187712,88782,98930,89.7
21003, 동부,070001, 65세,2017,44289,21063,23226,90.7,44126,20991,23135,90.7
21003, 동부,070002, 66세,2017,35639,16907,18732,90.3,35506,16840,18666,90.2
21003, 동부,070003, 67세,2017,36010,17167,18843,91.1,35888,17111,18777,91.1
21003, 동부,070004, 68세,2017,36810,17238,19572,88.1,36709,17188,19521,88
21003, 동부,070005, 69세,2017,35554,16682,18872,88.4,35483,16652,18831,88.4
21003, 동부,075,70~74세,2017,134567,62183,72384,85.9,134354,62073,72281,85.9
21003, 동부,075001, 70세,2017,33446,15486,17960,86.2,33382,15453,17929,86.2
21003, 동부,075002, 71세,2017,24963,11850,13113,90.4,24916,11823,13093,90.3
21003, 동부,075003, 72세,2017,24452,11358,13094,86.7,24419,11341,13078,86.7
21003, 동부,075004, 73세,2017,25536,11657,13879,84,25498,11638,13860,84
21003, 동부,075005, 74세,2017,26170,11832,14338,82.5,26139,11818,14321,82.5
21003, 동부,080,75~79세,2017,109132,46370,62762,73.9,108971,46307,62664,73.9
21003, 동부,080001, 75세,2017,28067,12617,15450,81.7,28035,12600,15435,81.6
21003, 동부,080002, 76세,2017,23422,10076,13346,75.5,23381,10061,13320,75.5
21003, 동부,080003, 77세,2017,21013,8828,12185,72.4,20984,8821,12163,72.5
21003, 동부,080004, 78세,2017,19937,8159,11778,69.3,19913,8144,11769,69.2
21003, 동부,080005, 79세,2017,16693,6690,10003,66.9,16658,6681,9977,67
21003, 동부,085,80~84세,2017,60049,21467,38582,55.6,59971,21437,38534,55.6
21003, 동부,085001, 80세,2017,15491,5995,9496,63.1,15471,5988,9483,63.1
21003, 동부,085002, 81세,2017,13417,4973,8444,58.9,13398,4964,8434,58.9
21003, 동부,085003, 82세,2017,12381,4311,8070,53.4,12372,4307,8065,53.4
21003, 동부,085004, 83세,2017,10272,3448,6824,50.5,10261,3444,6817,50.5
21003, 동부,085005, 84세,2017,8488,2740,5748,47.7,8469,2734,5735,47.7
21003, 동부,090,85~89세,2017,26590,7022,19568,35.9,26553,7008,19545,35.9
21003, 동부,090001, 85세,2017,7546,2218,5328,41.6,7533,2214,5319,41.6
21003, 동부,090002, 86세,2017,5844,1614,4230,38.2,5840,1612,4228,38.1
21003, 동부,090003, 87세,2017,5022,1249,3773,33.1,5014,1244,3770,33
21003, 동부,090004, 88세,2017,4469,1148,3321,34.6,4464,1146,3318,34.5
21003, 동부,090005, 89세,2017,3709,793,2916,27.2,3702,792,2910,27.2
21003, 동부,095,90~94세,2017,8421,1650,6771,24.4,8404,1647,6757,24.4
21003, 동부,095001, 90세,2017,2895,594,2301,25.8,2892,594,2298,25.8
21003, 동부,095002, 91세,2017,1886,378,1508,25.1,1881,377,1504,25.1
21003, 동부,095003, 92세,2017,1605,290,1315,22.1,1602,288,1314,21.9
21003, 동부,095004, 93세,2017,1063,203,860,23.6,1063,203,860,23.6
21003, 동부,095005, 94세,2017,972,185,787,23.5,966,185,781,23.7
21003, 동부,100,95~99세,2017,1671,310,1361,22.8,1664,308,1356,22.7
21003, 동부,100001, 95세,2017,651,125,526,23.8,648,124,524,23.7
21003, 동부,100002, 96세,2017,432,70,362,19.3,430,69,361,19.1
21003, 동부,100003, 97세,2017,301,58,243,23.9,301,58,243,23.9
21003, 동부,100004, 98세,2017,177,40,137,29.2,176,40,136,29.4
21003, 동부,100005, 99세,2017,110,17,93,18.3,109,17,92,18.5
21003, 동부,101,100세이상,2017,195,20,175,11.4,194,19,175,10.9
21003, 동부,102,15세미만,2017,357092,184019,173073,106.3,356080,183531,172549,106.4
21003, 동부,103,15~64세,2017,2374338,1191248,1183090,100.7,2330033,1165795,1164238,100.1
21003, 동부,104,65세이상,2017,528927,228079,300848,75.8,527823,227581,300242,75.8
21003, 동부,086,85세이상,2017,36877,9002,27875,32.3,36815,8982,27833,32.3
21003, 동부,126,평균연령,2017,43.2,41.9,44.5,,43.4,42,44.7,
21003, 동부,127,중위연령,2017,44.7,43,46.4,,45,43.3,46.6,
21010, 중구,000,합계,2017,43799,21696,22103,98.2,41969,20451,21518,95
21010, 중구,005,0~4세,2017,891,472,419,112.6,879,463,416,111.3
21010, 중구,005001, 0세,2017,168,86,82,104.9,164,82,82,100
21010, 중구,005002, 1세,2017,158,91,67,135.8,153,88,65,135.4
21010, 중구,005003, 2세,2017,203,115,88,130.7,202,114,88,129.5
21010, 중구,005004, 3세,2017,184,96,88,109.1,184,96,88,109.1
21010, 중구,005005, 4세,2017,178,84,94,89.4,176,83,93,89.2
21010, 중구,010,5~9세,2017,973,508,465,109.2,964,504,460,109.6
21010, 중구,010001, 5세,2017,203,105,98,107.1,201,105,96,109.4
21010, 중구,010002, 6세,2017,209,114,95,120,206,112,94,119.1
21010, 중구,010003, 7세,2017,198,90,108,83.3,197,90,107,84.1
21010, 중구,010004, 8세,2017,177,101,76,132.9,175,99,76,130.3
21010, 중구,010005, 9세,2017,186,98,88,111.4,185,98,87,112.6
21010, 중구,015,10~14세,2017,1000,458,542,84.5,987,452,535,84.5
21010, 중구,015001, 10세,2017,191,70,121,57.9,190,69,121,57
21010, 중구,015002, 11세,2017,187,90,97,92.8,184,89,95,93.7
21010, 중구,015003, 12세,2017,189,94,95,98.9,185,93,92,101.1
21010, 중구,015004, 13세,2017,207,93,114,81.6,206,92,114,80.7
21010, 중구,015005, 14세,2017,226,111,115,96.5,222,109,113,96.5
21010, 중구,020,15~19세,2017,1677,862,815,105.8,1594,823,771,106.7
21010, 중구,020001, 15세,2017,263,145,118,122.9,259,143,116,123.3
21010, 중구,020002, 16세,2017,286,160,126,127,283,158,125,126.4
21010, 중구,020003, 17세,2017,344,157,187,84,337,154,183,84.2
21010, 중구,020004, 18세,2017,387,198,189,104.8,354,182,172,105.8
21010, 중구,020005, 19세,2017,397,202,195,103.6,361,186,175,106.3
21010, 중구,025,20~24세,2017,2694,1364,1330,102.6,2474,1263,1211,104.3
21010, 중구,025001, 20세,2017,458,240,218,110.1,418,220,198,111.1
21010, 중구,025002, 21세,2017,484,237,247,96,441,223,218,102.3
21010, 중구,025003, 22세,2017,524,292,232,125.9,487,272,215,126.5
21010, 중구,025004, 23세,2017,607,302,305,99,556,281,275,102.2
21010, 중구,025005, 24세,2017,621,293,328,89.3,572,267,305,87.5
21010, 중구,030,25~29세,2017,3151,1722,1429,120.5,2864,1516,1348,112.5
21010, 중구,030001, 25세,2017,753,398,355,112.1,693,355,338,105
21010, 중구,030002, 26세,2017,655,356,299,119.1,595,313,282,111
21010, 중구,030003, 27세,2017,608,330,278,118.7,550,288,262,109.9
21010, 중구,030004, 28세,2017,566,322,244,132,511,284,227,125.1
21010, 중구,030005, 29세,2017,569,316,253,124.9,515,276,239,115.5
21010, 중구,035,30~34세,2017,2699,1552,1147,135.3,2398,1304,1094,119.2
21010, 중구,035001, 30세,2017,541,303,238,127.3,486,260,226,115
21010, 중구,035002, 31세,2017,534,309,225,137.3,469,251,218,115.1
21010, 중구,035003, 32세,2017,562,333,229,145.4,498,280,218,128.4
21010, 중구,035004, 33세,2017,518,301,217,138.7,455,251,204,123
21010, 중구,035005, 34세,2017,544,306,238,128.6,490,262,228,114.9
21010, 중구,040,35~39세,2017,2903,1628,1275,127.7,2644,1424,1220,116.7
21010, 중구,040001, 35세,2017,599,345,254,135.8,537,296,241,122.8
21010, 중구,040002, 36세,2017,623,352,271,129.9,569,314,255,123.1
21010, 중구,040003, 37세,2017,601,336,265,126.8,551,293,258,113.6
21010, 중구,040004, 38세,2017,549,292,257,113.6,499,252,247,102
21010, 중구,040005, 39세,2017,531,303,228,132.9,488,269,219,122.8
21010, 중구,045,40~44세,2017,2950,1641,1309,125.4,2735,1471,1264,116.4
21010, 중구,045001, 40세,2017,517,303,214,141.6,474,265,209,126.8
21010, 중구,045002, 41세,2017,526,308,218,141.3,476,267,209,127.8
21010, 중구,045003, 42세,2017,632,340,292,116.4,594,309,285,108.4
21010, 중구,045004, 43세,2017,633,339,294,115.3,588,305,283,107.8
21010, 중구,045005, 44세,2017,642,351,291,120.6,603,325,278,116.9
21010, 중구,050,45~49세,2017,3530,1828,1702,107.4,3381,1729,1652,104.7
21010, 중구,050001, 45세,2017,699,404,295,136.9,667,376,291,129.2
21010, 중구,050002, 46세,2017,737,362,375,96.5,698,336,362,92.8
21010, 중구,050003, 47세,2017,676,334,342,97.7,645,314,331,94.9
21010, 중구,050004, 48세,2017,718,387,331,116.9,695,373,322,115.8
21010, 중구,050005, 49세,2017,700,341,359,95,676,330,346,95.4
21010, 중구,055,50~54세,2017,3409,1715,1694,101.2,3306,1651,1655,99.8
21010, 중구,055001, 50세,2017,661,347,314,110.5,638,330,308,107.1
21010, 중구,055002, 51세,2017,682,356,326,109.2,658,340,318,106.9
21010, 중구,055003, 52세,2017,685,326,359,90.8,670,316,354,89.3
21010, 중구,055004, 53세,2017,636,324,312,103.8,610,309,301,102.7
21010, 중구,055005, 54세,2017,745,362,383,94.5,730,356,374,95.2
21010, 중구,060,55~59세,2017,4285,2032,2253,90.2,4222,2002,2220,90.2
21010, 중구,060001, 55세,2017,817,405,412,98.3,799,394,405,97.3
21010, 중구,060002, 56세,2017,833,368,465,79.1,825,366,459,79.7
21010, 중구,060003, 57세,2017,904,438,466,94,890,432,458,94.3
21010, 중구,060004, 58세,2017,845,404,441,91.6,835,398,437,91.1
21010, 중구,060005, 59세,2017,886,417,469,88.9,873,412,461,89.4
21010, 중구,065,60~64세,2017,4057,1932,2125,90.9,3999,1898,2101,90.3
21010, 중구,065001, 60세,2017,901,408,493,82.8,895,405,490,82.7
21010, 중구,065002, 61세,2017,786,375,411,91.2,775,369,406,90.9
21010, 중구,065003, 62세,2017,891,427,464,92,879,419,460,91.1
21010, 중구,065004, 63세,2017,781,409,372,109.9,762,397,365,108.8
21010, 중구,065005, 64세,2017,698,313,385,81.3,688,308,380,81.1
21010, 중구,070,65~69세,2017,3158,1423,1735,82,3129,1408,1721,81.8
21010, 중구,070001, 65세,2017,700,325,375,86.7,692,321,371,86.5
21010, 중구,070002, 66세,2017,567,260,307,84.7,561,255,306,83.3
21010, 중구,070003, 67세,2017,634,294,340,86.5,627,290,337,86.1
21010, 중구,070004, 68세,2017,624,273,351,77.8,619,271,348,77.9
21010, 중구,070005, 69세,2017,633,271,362,74.9,630,271,359,75.5
21010, 중구,075,70~74세,2017,2476,1122,1354,82.9,2466,1114,1352,82.4
21010, 중구,075001, 70세,2017,558,248,310,80,556,247,309,79.9
21010, 중구,075002, 71세,2017,488,219,269,81.4,487,218,269,81
21010, 중구,075003, 72세,2017,458,199,259,76.8,456,197,259,76.1
21010, 중구,075004, 73세,2017,476,226,250,90.4,473,224,249,90
21010, 중구,075005, 74세,2017,496,230,266,86.5,494,228,266,85.7
21010, 중구,080,75~79세,2017,2090,879,1211,72.6,2081,875,1206,72.6
21010, 중구,080001, 75세,2017,528,225,303,74.3,527,224,303,73.9
21010, 중구,080002, 76세,2017,452,192,260,73.8,451,192,259,74.1
21010, 중구,080003, 77세,2017,387,169,218,77.5,384,168,216,77.8
21010, 중구,080004, 78세,2017,396,161,235,68.5,394,159,235,67.7
21010, 중구,080005, 79세,2017,327,132,195,67.7,325,132,193,68.4
21010, 중구,085,80~84세,2017,1084,376,708,53.1,1078,373,705,52.9
21010, 중구,085001, 80세,2017,276,96,180,53.3,274,95,179,53.1
21010, 중구,085002, 81세,2017,240,93,147,63.3,240,93,147,63.3
21010, 중구,085003, 82세,2017,226,76,150,50.7,225,75,150,50
21010, 중구,085004, 83세,2017,184,64,120,53.3,184,64,120,53.3
21010, 중구,085005, 84세,2017,158,47,111,42.3,155,46,109,42.2
21010, 중구,090,85~89세,2017,529,137,392,34.9,528,136,392,34.7
21010, 중구,090001, 85세,2017,161,46,115,40,161,46,115,40
21010, 중구,090002, 86세,2017,86,32,54,59.3,86,32,54,59.3
21010, 중구,090003, 87세,2017,114,26,88,29.5,113,25,88,28.4
21010, 중구,090004, 88세,2017,93,21,72,29.2,93,21,72,29.2
21010, 중구,090005, 89세,2017,75,12,63,19,75,12,63,19
21010, 중구,095,90~94세,2017,198,33,165,20,195,33,162,20.4
21010, 중구,095001, 90세,2017,67,11,56,19.6,66,11,55,20
21010, 중구,095002, 91세,2017,48,6,42,14.3,47,6,41,14.6
21010, 중구,095003, 92세,2017,36,7,29,24.1,36,7,29,24.1
21010, 중구,095004, 93세,2017,20,7,13,53.8,20,7,13,53.8
21010, 중구,095005, 94세,2017,27,X,25,8,26,X,24,8.3
21010, 중구,100,95~99세,2017,38,11,27,40.7,38,11,27,40.7
21010, 중구,100001, 95세,2017,18,X,16,12.5,18,X,16,12.5
21010, 중구,100002, 96세,2017,5,X,X,25,5,X,X,25
21010, 중구,100003, 97세,2017,8,X,5,60,8,X,5,60
21010, 중구,100004, 98세,2017,7,5,X,250,7,5,X,250
21010, 중구,100005, 99세,2017,X,X,X,,X,X,X,
21010, 중구,101,100세이상,2017,7,X,6,16.7,7,X,6,16.7
21010, 중구,102,15세미만,2017,2864,1438,1426,100.8,2830,1419,1411,100.6
21010, 중구,103,15~64세,2017,31355,16276,15079,107.9,29617,15081,14536,103.7
21010, 중구,104,65세이상,2017,9580,3982,5598,71.1,9522,3951,5571,70.9
21010, 중구,086,85세이상,2017,772,182,590,30.8,768,181,587,30.8
21010, 중구,126,평균연령,2017,47.5,45.7,49.2,,47.9,46.3,49.6,
21010, 중구,127,중위연령,2017,49.2,46.7,51.9,,50.1,47.9,52.5,
21020, 서구,000,합계,2017,106924,52450,54474,96.3,105050,51209,53841,95.1
21020, 서구,005,0~4세,2017,2667,1404,1263,111.2,2654,1396,1258,111
21020, 서구,005001, 0세,2017,478,257,221,116.3,470,250,220,113.6
21020, 서구,005002, 1세,2017,544,284,260,109.2,544,284,260,109.2
21020, 서구,005003, 2세,2017,559,291,268,108.6,556,291,265,109.8
21020, 서구,005004, 3세,2017,540,269,271,99.3,539,268,271,98.9
21020, 서구,005005, 4세,2017,546,303,243,124.7,545,303,242,125.2
21020, 서구,010,5~9세,2017,3065,1554,1511,102.8,3055,1550,1505,103
21020, 서구,010001, 5세,2017,613,311,302,103,610,310,300,103.3
21020, 서구,010002, 6세,2017,648,344,304,113.2,645,342,303,112.9
21020, 서구,010003, 7세,2017,624,305,319,95.6,622,305,317,96.2
21020, 서구,010004, 8세,2017,580,311,269,115.6,579,311,268,116
21020, 서구,010005, 9세,2017,600,283,317,89.3,599,282,317,89
21020, 서구,015,10~14세,2017,3374,1726,1648,104.7,3364,1722,1642,104.9
21020, 서구,015001, 10세,2017,668,346,322,107.5,666,344,322,106.8
21020, 서구,015002, 11세,2017,608,299,309,96.8,605,298,307,97.1
21020, 서구,015003, 12세,2017,614,302,312,96.8,611,301,310,97.1
21020, 서구,015004, 13세,2017,739,370,369,100.3,738,370,368,100.5
21020, 서구,015005, 14세,2017,745,409,336,121.7,744,409,335,122.1
21020, 서구,020,15~19세,2017,5011,2553,2458,103.9,4965,2537,2428,104.5
21020, 서구,020001, 15세,2017,739,382,357,107,737,381,356,107
21020, 서구,020002, 16세,2017,894,453,441,102.7,890,452,438,103.2
21020, 서구,020003, 17세,2017,1002,525,477,110.1,997,523,474,110.3
21020, 서구,020004, 18세,2017,1098,588,510,115.3,1089,583,506,115.2
21020, 서구,020005, 19세,2017,1278,605,673,89.9,1252,598,654,91.4
21020, 서구,025,20~24세,2017,7198,3700,3498,105.8,6955,3563,3392,105
21020, 서구,025001, 20세,2017,1232,630,602,104.7,1207,618,589,104.9
21020, 서구,025002, 21세,2017,1390,727,663,109.7,1334,696,638,109.1
21020, 서구,025003, 22세,2017,1431,749,682,109.8,1385,728,657,110.8
21020, 서구,025004, 23세,2017,1534,772,762,101.3,1484,739,745,99.2
21020, 서구,025005, 24세,2017,1611,822,789,104.2,1545,782,763,102.5
21020, 서구,030,25~29세,2017,6724,3558,3166,112.4,6425,3359,3066,109.6
21020, 서구,030001, 25세,2017,1557,808,749,107.9,1501,773,728,106.2
21020, 서구,030002, 26세,2017,1395,721,674,107,1345,692,653,106
21020, 서구,030003, 27세,2017,1303,686,617,111.2,1244,642,602,106.6
21020, 서구,030004, 28세,2017,1224,662,562,117.8,1157,618,539,114.7
21020, 서구,030005, 29세,2017,1245,681,564,120.7,1178,634,544,116.5
21020, 서구,035,30~34세,2017,5597,2980,2617,113.9,5267,2743,2524,108.7
21020, 서구,035001, 30세,2017,1083,576,507,113.6,1016,526,490,107.3
21020, 서구,035002, 31세,2017,1073,589,484,121.7,1004,540,464,116.4
21020, 서구,035003, 32세,2017,1055,560,495,113.1,985,511,474,107.8
21020, 서구,035004, 33세,2017,1107,570,537,106.1,1038,524,514,101.9
21020, 서구,035005, 34세,2017,1279,685,594,115.3,1224,642,582,110.3
21020, 서구,040,35~39세,2017,6827,3690,3137,117.6,6535,3456,3079,112.2
21020, 서구,040001, 35세,2017,1360,727,633,114.8,1299,681,618,110.2
21020, 서구,040002, 36세,2017,1409,734,675,108.7,1364,700,664,105.4
21020, 서구,040003, 37세,2017,1444,807,637,126.7,1388,764,624,122.4
21020, 서구,040004, 38세,2017,1367,764,603,126.7,1299,706,593,119.1
21020, 서구,040005, 39세,2017,1247,658,589,111.7,1185,605,580,104.3
21020, 서구,045,40~44세,2017,6839,3652,3187,114.6,6627,3486,3141,111
21020, 서구,045001, 40세,2017,1198,638,560,113.9,1153,602,551,109.3
21020, 서구,045002, 41세,2017,1198,657,541,121.4,1149,619,530,116.8
21020, 서구,045003, 42세,2017,1321,701,620,113.1,1274,662,612,108.2
21020, 서구,045004, 43세,2017,1499,798,701,113.8,1462,770,692,111.3
21020, 서구,045005, 44세,2017,1623,858,765,112.2,1589,833,756,110.2
21020, 서구,050,45~49세,2017,8175,4323,3852,112.2,8018,4203,3815,110.2
21020, 서구,050001, 45세,2017,1565,857,708,121,1525,824,701,117.5
21020, 서구,050002, 46세,2017,1624,842,782,107.7,1592,817,775,105.4
21020, 서구,050003, 47세,2017,1664,901,763,118.1,1630,871,759,114.8
21020, 서구,050004, 48세,2017,1658,861,797,108,1622,838,784,106.9
21020, 서구,050005, 49세,2017,1664,862,802,107.5,1649,853,796,107.2
21020, 서구,055,50~54세,2017,8222,4145,4077,101.7,8119,4100,4019,102
21020, 서구,055001, 50세,2017,1591,831,760,109.3,1568,820,748,109.6
21020, 서구,055002, 51세,2017,1574,781,793,98.5,1549,772,777,99.4
21020, 서구,055003, 52세,2017,1635,794,841,94.4,1619,784,835,93.9
21020, 서구,055004, 53세,2017,1614,813,801,101.5,1597,808,789,102.4
21020, 서구,055005, 54세,2017,1808,926,882,105,1786,916,870,105.3
21020, 서구,060,55~59세,2017,10485,5010,5475,91.5,10418,4979,5439,91.5
21020, 서구,060001, 55세,2017,1883,949,934,101.6,1869,939,930,101
21020, 서구,060002, 56세,2017,2181,1013,1168,86.7,2166,1007,1159,86.9
21020, 서구,060003, 57세,2017,2310,1110,1200,92.5,2295,1105,1190,92.9
21020, 서구,060004, 58세,2017,2087,964,1123,85.8,2075,959,1116,85.9
21020, 서구,060005, 59세,2017,2024,974,1050,92.8,2013,969,1044,92.8
21020, 서구,065,60~64세,2017,9306,4363,4943,88.3,9270,4347,4923,88.3
21020, 서구,065001, 60세,2017,2024,954,1070,89.2,2017,952,1065,89.4
21020, 서구,065002, 61세,2017,1898,932,966,96.5,1890,929,961,96.7
21020, 서구,065003, 62세,2017,2031,893,1138,78.5,2021,889,1132,78.5
21020, 서구,065004, 63세,2017,1835,887,948,93.6,1829,884,945,93.5
21020, 서구,065005, 64세,2017,1518,697,821,84.9,1513,693,820,84.5
21020, 서구,070,65~69세,2017,7630,3542,4088,86.6,7602,3531,4071,86.7
21020, 서구,070001, 65세,2017,1725,801,924,86.7,1717,798,919,86.8
21020, 서구,070002, 66세,2017,1460,681,779,87.4,1453,678,775,87.5
21020, 서구,070003, 67세,2017,1496,701,795,88.2,1490,697,793,87.9
21020, 서구,070004, 68세,2017,1517,698,819,85.2,1511,697,814,85.6
21020, 서구,070005, 69세,2017,1432,661,771,85.7,1431,661,770,85.8
21020, 서구,075,70~74세,2017,5951,2634,3317,79.4,5938,2628,3310,79.4
21020, 서구,075001, 70세,2017,1468,659,809,81.5,1465,658,807,81.5
21020, 서구,075002, 71세,2017,1077,497,580,85.7,1076,496,580,85.5
21020, 서구,075003, 72세,2017,1052,467,585,79.8,1049,465,584,79.6
21020, 서구,075004, 73세,2017,1124,502,622,80.7,1120,500,620,80.6
21020, 서구,075005, 74세,2017,1230,509,721,70.6,1228,509,719,70.8
21020, 서구,080,75~79세,2017,5143,2100,3043,69,5133,2095,3038,69
21020, 서구,080001, 75세,2017,1272,570,702,81.2,1271,569,702,81.1
21020, 서구,080002, 76세,2017,1102,449,653,68.8,1100,448,652,68.7
21020, 서구,080003, 77세,2017,990,385,605,63.6,989,385,604,63.7
21020, 서구,080004, 78세,2017,979,383,596,64.3,978,382,596,64.1
21020, 서구,080005, 79세,2017,800,313,487,64.3,795,311,484,64.3
21020, 서구,085,80~84세,2017,2906,1068,1838,58.1,2904,1067,1837,58.1
21020, 서구,085001, 80세,2017,727,294,433,67.9,725,293,432,67.8
21020, 서구,085002, 81세,2017,675,261,414,63,675,261,414,63
21020, 서구,085003, 82세,2017,605,211,394,53.6,605,211,394,53.6
21020, 서구,085004, 83세,2017,476,177,299,59.2,476,177,299,59.2
21020, 서구,085005, 84세,2017,423,125,298,41.9,423,125,298,41.9
21020, 서구,090,85~89세,2017,1281,339,942,36,1279,339,940,36.1
21020, 서구,090001, 85세,2017,370,122,248,49.2,369,122,247,49.4
21020, 서구,090002, 86세,2017,296,78,218,35.8,295,78,217,35.9
21020, 서구,090003, 87세,2017,210,47,163,28.8,210,47,163,28.8
21020, 서구,090004, 88세,2017,215,56,159,35.2,215,56,159,35.2
21020, 서구,090005, 89세,2017,190,36,154,23.4,190,36,154,23.4
21020, 서구,095,90~94세,2017,415,81,334,24.3,415,81,334,24.3
21020, 서구,095001, 90세,2017,152,24,128,18.8,152,24,128,18.8
21020, 서구,095002, 91세,2017,77,15,62,24.2,77,15,62,24.2
21020, 서구,095003, 92세,2017,75,20,55,36.4,75,20,55,36.4
21020, 서구,095004, 93세,2017,57,10,47,21.3,57,10,47,21.3
21020, 서구,095005, 94세,2017,54,12,42,28.6,54,12,42,28.6
21020, 서구,100,95~99세,2017,101,27,74,36.5,100,26,74,35.1
21020, 서구,100001, 95세,2017,44,11,33,33.3,44,11,33,33.3
21020, 서구,100002, 96세,2017,24,7,17,41.2,23,6,17,35.3
21020, 서구,100003, 97세,2017,22,7,15,46.7,22,7,15,46.7
21020, 서구,100004, 98세,2017,6,X,5,20,6,X,5,20
21020, 서구,100005, 99세,2017,5,X,X,25,5,X,X,25
21020, 서구,101,100세이상,2017,7,X,6,16.7,7,X,6,16.7
21020, 서구,102,15세미만,2017,9106,4684,4422,105.9,9073,4668,4405,106
21020, 서구,103,15~64세,2017,74384,37974,36410,104.3,72599,36773,35826,102.6
21020, 서구,104,65세이상,2017,23434,9792,13642,71.8,23378,9768,13610,71.8
21020, 서구,086,85세이상,2017,1804,448,1356,33,1801,447,1354,33
21020, 서구,126,평균연령,2017,46.6,44.9,48.2,,46.8,45.1,48.4,
21020, 서구,127,중위연령,2017,48.8,46.7,51.2,,49.2,47.2,51.4,
21030, 동구,000,합계,2017,86106,42082,44024,95.6,84244,41272,42972,96
21030, 동구,005,0~4세,2017,2060,1065,995,107,2033,1052,981,107.2
21030, 동구,005001, 0세,2017,384,204,180,113.3,382,203,179,113.4
21030, 동구,005002, 1세,2017,408,208,200,104,400,205,195,105.1
21030, 동구,005003, 2세,2017,441,239,202,118.3,437,237,200,118.5
21030, 동구,005004, 3세,2017,416,201,215,93.5,413,200,213,93.9
21030, 동구,005005, 4세,2017,411,213,198,107.6,401,207,194,106.7
21030, 동구,010,5~9세,2017,2171,1107,1064,104,2142,1091,1051,103.8
21030, 동구,010001, 5세,2017,500,260,240,108.3,496,258,238,108.4
21030, 동구,010002, 6세,2017,444,235,209,112.4,438,232,206,112.6
21030, 동구,010003, 7세,2017,430,214,216,99.1,423,208,215,96.7
21030, 동구,010004, 8세,2017,389,186,203,91.6,381,182,199,91.5
21030, 동구,010005, 9세,2017,408,212,196,108.2,404,211,193,109.3
21030, 동구,015,10~14세,2017,2299,1203,1096,109.8,2272,1191,1081,110.2
21030, 동구,015001, 10세,2017,476,242,234,103.4,474,241,233,103.4
21030, 동구,015002, 11세,2017,420,208,212,98.1,414,205,209,98.1
21030, 동구,015003, 12세,2017,396,207,189,109.5,392,205,187,109.6
21030, 동구,015004, 13세,2017,481,264,217,121.7,475,262,213,123
21030, 동구,015005, 14세,2017,526,282,244,115.6,517,278,239,116.3
21030, 동구,020,15~19세,2017,3673,1891,1782,106.1,3636,1871,1765,106
21030, 동구,020001, 15세,2017,569,306,263,116.3,563,303,260,116.5
21030, 동구,020002, 16세,2017,771,379,392,96.7,767,377,390,96.7
21030, 동구,020003, 17세,2017,815,415,400,103.8,807,411,396,103.8
21030, 동구,020004, 18세,2017,732,367,365,100.5,726,363,363,100
21030, 동구,020005, 19세,2017,786,424,362,117.1,773,417,356,117.1
21030, 동구,025,20~24세,2017,4825,2532,2293,110.4,4665,2483,2182,113.8
21030, 동구,025001, 20세,2017,809,423,386,109.6,790,419,371,112.9
21030, 동구,025002, 21세,2017,940,498,442,112.7,919,493,426,115.7
21030, 동구,025003, 22세,2017,941,503,438,114.8,911,490,421,116.4
21030, 동구,025004, 23세,2017,1073,555,518,107.1,1033,542,491,110.4
21030, 동구,025005, 24세,2017,1062,553,509,108.6,1012,539,473,114
21030, 동구,030,25~29세,2017,5218,2671,2547,104.9,4957,2568,2389,107.5
21030, 동구,030001, 25세,2017,1196,623,573,108.7,1141,602,539,111.7
21030, 동구,030002, 26세,2017,1044,515,529,97.4,1000,498,502,99.2
21030, 동구,030003, 27세,2017,1014,517,497,104,964,502,462,108.7
21030, 동구,030004, 28세,2017,1003,511,492,103.9,952,488,464,105.2
21030, 동구,030005, 29세,2017,961,505,456,110.7,900,478,422,113.3
21030, 동구,035,30~34세,2017,4834,2607,2227,117.1,4567,2490,2077,119.9
21030, 동구,035001, 30세,2017,973,535,438,122.1,917,512,405,126.4
21030, 동구,035002, 31세,2017,906,472,434,108.8,852,447,405,110.4
21030, 동구,035003, 32세,2017,952,510,442,115.4,898,481,417,115.3
21030, 동구,035004, 33세,2017,980,517,463,111.7,923,493,430,114.7
21030, 동구,035005, 34세,2017,1023,573,450,127.3,977,557,420,132.6
21030, 동구,040,35~39세,2017,5573,3045,2528,120.5,5345,2936,2409,121.9
21030, 동구,040001, 35세,2017,1144,615,529,116.3,1085,589,496,118.8
21030, 동구,040002, 36세,2017,1104,625,479,130.5,1056,603,453,133.1
21030, 동구,040003, 37세,2017,1159,637,522,122,1112,616,496,124.2
21030, 동구,040004, 38세,2017,1138,617,521,118.4,1096,595,501,118.8
21030, 동구,040005, 39세,2017,1028,551,477,115.5,996,533,463,115.1
21030, 동구,045,40~44세,2017,5453,2937,2516,116.7,5275,2860,2415,118.4
21030, 동구,045001, 40세,2017,997,539,458,117.7,957,528,429,123.1
21030, 동구,045002, 41세,2017,965,507,458,110.7,925,490,435,112.6
21030, 동구,045003, 42세,2017,1103,639,464,137.7,1071,623,448,139.1
21030, 동구,045004, 43세,2017,1168,599,569,105.3,1135,583,552,105.6
21030, 동구,045005, 44세,2017,1220,653,567,115.2,1187,636,551,115.4
21030, 동구,050,45~49세,2017,6733,3569,3164,112.8,6575,3498,3077,113.7
21030, 동구,050001, 45세,2017,1276,699,577,121.1,1244,686,558,122.9
21030, 동구,050002, 46세,2017,1373,730,643,113.5,1333,705,628,112.3
21030, 동구,050003, 47세,2017,1307,727,580,125.3,1274,711,563,126.3
21030, 동구,050004, 48세,2017,1425,733,692,105.9,1398,725,673,107.7
21030, 동구,050005, 49세,2017,1352,680,672,101.2,1326,671,655,102.4
21030, 동구,055,50~54세,2017,6464,3288,3176,103.5,6319,3215,3104,103.6
21030, 동구,055001, 50세,2017,1302,637,665,95.8,1272,618,654,94.5
21030, 동구,055002, 51세,2017,1232,627,605,103.6,1202,614,588,104.4
21030, 동구,055003, 52세,2017,1285,668,617,108.3,1259,655,604,108.4
21030, 동구,055004, 53세,2017,1254,667,587,113.6,1228,654,574,113.9
21030, 동구,055005, 54세,2017,1391,689,702,98.1,1358,674,684,98.5
21030, 동구,060,55~59세,2017,8419,4003,4416,90.6,8312,3955,4357,90.8
21030, 동구,060001, 55세,2017,1577,755,822,91.8,1557,750,807,92.9
21030, 동구,060002, 56세,2017,1721,794,927,85.7,1702,785,917,85.6
21030, 동구,060003, 57세,2017,1825,848,977,86.8,1797,836,961,87
21030, 동구,060004, 58세,2017,1657,775,882,87.9,1636,766,870,88
21030, 동구,060005, 59세,2017,1639,831,808,102.8,1620,818,802,102
21030, 동구,065,60~64세,2017,7913,3717,4196,88.6,7799,3668,4131,88.8
21030, 동구,065001, 60세,2017,1721,839,882,95.1,1700,831,869,95.6
21030, 동구,065002, 61세,2017,1675,791,884,89.5,1655,783,872,89.8
21030, 동구,065003, 62세,2017,1679,750,929,80.7,1656,737,919,80.2
21030, 동구,065004, 63세,2017,1489,714,775,92.1,1458,700,758,92.3
21030, 동구,065005, 64세,2017,1349,623,726,85.8,1330,617,713,86.5
21030, 동구,070,65~69세,2017,6637,3071,3566,86.1,6564,3036,3528,86.1
21030, 동구,070001, 65세,2017,1490,681,809,84.2,1466,670,796,84.2
21030, 동구,070002, 66세,2017,1263,594,669,88.8,1249,588,661,89
21030, 동구,070003, 67세,2017,1245,582,663,87.8,1226,575,651,88.3
21030, 동구,070004, 68세,2017,1346,603,743,81.2,1335,596,739,80.6
21030, 동구,070005, 69세,2017,1293,611,682,89.6,1288,607,681,89.1
21030, 동구,075,70~74세,2017,5144,2229,2915,76.5,5121,2218,2903,76.4
21030, 동구,075001, 70세,2017,1234,524,710,73.8,1224,519,705,73.6
21030, 동구,075002, 71세,2017,925,436,489,89.2,919,433,486,89.1
21030, 동구,075003, 72세,2017,952,405,547,74,949,403,546,73.8
21030, 동구,075004, 73세,2017,1007,418,589,71,1006,418,588,71.1
21030, 동구,075005, 74세,2017,1026,446,580,76.9,1023,445,578,77
21030, 동구,080,75~79세,2017,4603,1834,2769,66.2,4588,1829,2759,66.3
21030, 동구,080001, 75세,2017,1185,516,669,77.1,1183,515,668,77.1
21030, 동구,080002, 76세,2017,987,386,601,64.2,981,382,599,63.8
21030, 동구,080003, 77세,2017,860,325,535,60.7,856,325,531,61.2
21030, 동구,080004, 78세,2017,855,330,525,62.9,854,330,524,63
21030, 동구,080005, 79세,2017,716,277,439,63.1,714,277,437,63.4
21030, 동구,085,80~84세,2017,2571,929,1642,56.6,2566,928,1638,56.7
21030, 동구,085001, 80세,2017,676,274,402,68.2,675,274,401,68.3
21030, 동구,085002, 81세,2017,624,242,382,63.4,622,241,381,63.3
21030, 동구,085003, 82세,2017,504,166,338,49.1,504,166,338,49.1
21030, 동구,085004, 83세,2017,400,117,283,41.3,399,117,282,41.5
21030, 동구,085005, 84세,2017,367,130,237,54.9,366,130,236,55.1
21030, 동구,090,85~89세,2017,1068,284,784,36.2,1063,283,780,36.3
21030, 동구,090001, 85세,2017,331,88,243,36.2,329,88,241,36.5
21030, 동구,090002, 86세,2017,214,61,153,39.9,214,61,153,39.9
21030, 동구,090003, 87세,2017,185,49,136,36,183,48,135,35.6
21030, 동구,090004, 88세,2017,184,47,137,34.3,184,47,137,34.3
21030, 동구,090005, 89세,2017,154,39,115,33.9,153,39,114,34.2
21030, 동구,095,90~94세,2017,365,81,284,28.5,363,81,282,28.7
21030, 동구,095001, 90세,2017,138,31,107,29,138,31,107,29
21030, 동구,095002, 91세,2017,95,17,78,21.8,94,17,77,22.1
21030, 동구,095003, 92세,2017,61,22,39,56.4,61,22,39,56.4
21030, 동구,095004, 93세,2017,43,8,35,22.9,43,8,35,22.9
21030, 동구,095005, 94세,2017,28,X,25,12,27,X,24,12.5
21030, 동구,100,95~99세,2017,71,18,53,34,70,18,52,34.6
21030, 동구,100001, 95세,2017,31,12,19,63.2,31,12,19,63.2
21030, 동구,100002, 96세,2017,19,X,17,11.8,18,X,16,12.5
21030, 동구,100003, 97세,2017,9,X,7,28.6,9,X,7,28.6
21030, 동구,100004, 98세,2017,9,X,7,28.6,9,X,7,28.6
21030, 동구,100005, 99세,2017,X,X,X,0,X,X,X,0
21030, 동구,101,100세이상,2017,12,X,11,9.1,12,X,11,9.1
21030, 동구,102,15세미만,2017,6530,3375,3155,107,6447,3334,3113,107.1
21030, 동구,103,15~64세,2017,59105,30260,28845,104.9,57450,29544,27906,105.9
21030, 동구,104,65세이상,2017,20471,8447,12024,70.3,20347,8394,11953,70.2
21030, 동구,086,85세이상,2017,1516,384,1132,33.9,1508,383,1125,34
21030, 동구,126,평균연령,2017,47.9,46.1,49.7,,48.1,46.2,49.9,
21030, 동구,127,중위연령,2017,50.2,47.8,52.9,,50.5,48,53.4,
21040, 영도구,000,합계,2017,123531,62131,61400,101.2,121749,60980,60769,100.3
21040, 영도구,005,0~4세,2017,2922,1495,1427,104.8,2900,1484,1416,104.8
21040, 영도구,005001, 0세,2017,478,238,240,99.2,475,236,239,98.7
21040, 영도구,005002, 1세,2017,588,299,289,103.5,585,297,288,103.1
21040, 영도구,005003, 2세,2017,589,312,277,112.6,582,307,275,111.6
21040, 영도구,005004, 3세,2017,644,328,316,103.8,639,328,311,105.5
21040, 영도구,005005, 4세,2017,623,318,305,104.3,619,316,303,104.3
21040, 영도구,010,5~9세,2017,3444,1760,1684,104.5,3435,1754,1681,104.3
21040, 영도구,010001, 5세,2017,694,369,325,113.5,690,367,323,113.6
21040, 영도구,010002, 6세,2017,729,353,376,93.9,725,350,375,93.3
21040, 영도구,010003, 7세,2017,714,368,346,106.4,713,367,346,106.1
21040, 영도구,010004, 8세,2017,619,310,309,100.3,619,310,309,100.3
21040, 영도구,010005, 9세,2017,688,360,328,109.8,688,360,328,109.8
21040, 영도구,015,10~14세,2017,3660,1896,1764,107.5,3650,1889,1761,107.3
21040, 영도구,015001, 10세,2017,737,396,341,116.1,737,396,341,116.1
21040, 영도구,015002, 11세,2017,682,339,343,98.8,680,337,343,98.3
21040, 영도구,015003, 12세,2017,664,332,332,100,661,330,331,99.7
21040, 영도구,015004, 13세,2017,764,387,377,102.7,762,385,377,102.1
21040, 영도구,015005, 14세,2017,813,442,371,119.1,810,441,369,119.5
21040, 영도구,020,15~19세,2017,6889,3829,3060,125.1,6863,3817,3046,125.3
21040, 영도구,020001, 15세,2017,899,470,429,109.6,898,469,429,109.3
21040, 영도구,020002, 16세,2017,1178,666,512,130.1,1175,664,511,129.9
21040, 영도구,020003, 17세,2017,1257,698,559,124.9,1254,696,558,124.7
21040, 영도구,020004, 18세,2017,1354,729,625,116.6,1351,728,623,116.9
21040, 영도구,020005, 19세,2017,2201,1266,935,135.4,2185,1260,925,136.2
21040, 영도구,025,20~24세,2017,9898,5840,4058,143.9,9741,5757,3984,144.5
21040, 영도구,025001, 20세,2017,2083,1167,916,127.4,2065,1165,900,129.4
21040, 영도구,025002, 21세,2017,2012,1144,868,131.8,1987,1130,857,131.9
21040, 영도구,025003, 22세,2017,2104,1234,870,141.8,2073,1219,854,142.7
21040, 영도구,025004, 23세,2017,1995,1253,742,168.9,1951,1228,723,169.8
21040, 영도구,025005, 24세,2017,1704,1042,662,157.4,1665,1015,650,156.2
21040, 영도구,030,25~29세,2017,6962,4024,2938,137,6631,3812,2819,135.2
21040, 영도구,030001, 25세,2017,1713,1066,647,164.8,1648,1026,622,165
21040, 영도구,030002, 26세,2017,1433,807,626,128.9,1381,776,605,128.3
21040, 영도구,030003, 27세,2017,1298,762,536,142.2,1221,709,512,138.5
21040, 영도구,030004, 28세,2017,1278,716,562,127.4,1211,673,538,125.1
21040, 영도구,030005, 29세,2017,1240,673,567,118.7,1170,628,542,115.9
21040, 영도구,035,30~34세,2017,6100,3475,2625,132.4,5762,3217,2545,126.4
21040, 영도구,035001, 30세,2017,1156,671,485,138.4,1091,623,468,133.1
21040, 영도구,035002, 31세,2017,1201,721,480,150.2,1117,660,457,144.4
21040, 영도구,035003, 32세,2017,1197,661,536,123.3,1130,608,522,116.5
21040, 영도구,035004, 33세,2017,1239,702,537,130.7,1173,652,521,125.1
21040, 영도구,035005, 34세,2017,1307,720,587,122.7,1251,674,577,116.8
21040, 영도구,040,35~39세,2017,7352,3930,3422,114.8,7123,3753,3370,111.4
21040, 영도구,040001, 35세,2017,1376,748,628,119.1,1330,713,617,115.6
21040, 영도구,040002, 36세,2017,1523,814,709,114.8,1489,790,699,113
21040, 영도구,040003, 37세,2017,1599,840,759,110.7,1544,793,751,105.6
21040, 영도구,040004, 38세,2017,1469,771,698,110.5,1420,733,687,106.7
21040, 영도구,040005, 39세,2017,1385,757,628,120.5,1340,724,616,117.5
21040, 영도구,045,40~44세,2017,7773,4124,3649,113,7572,3979,3593,110.7
21040, 영도구,045001, 40세,2017,1338,709,629,112.7,1295,681,614,110.9
21040, 영도구,045002, 41세,2017,1388,744,644,115.5,1348,715,633,113
21040, 영도구,045003, 42세,2017,1606,864,742,116.4,1561,832,729,114.1
21040, 영도구,045004, 43세,2017,1677,890,787,113.1,1641,862,779,110.7
21040, 영도구,045005, 44세,2017,1764,917,847,108.3,1727,889,838,106.1
21040, 영도구,050,45~49세,2017,9184,4802,4382,109.6,9011,4696,4315,108.8
21040, 영도구,050001, 45세,2017,1775,951,824,115.4,1736,929,807,115.1
21040, 영도구,050002, 46세,2017,1864,999,865,115.5,1826,976,850,114.8
21040, 영도구,050003, 47세,2017,1858,990,868,114.1,1825,968,857,113
21040, 영도구,050004, 48세,2017,1790,907,883,102.7,1751,880,871,101
21040, 영도구,050005, 49세,2017,1897,955,942,101.4,1873,943,930,101.4
21040, 영도구,055,50~54세,2017,9324,4751,4573,103.9,9210,4694,4516,103.9
21040, 영도구,055001, 50세,2017,1859,963,896,107.5,1832,951,881,107.9
21040, 영도구,055002, 51세,2017,1873,1032,841,122.7,1857,1022,835,122.4
21040, 영도구,055003, 52세,2017,1843,873,970,90,1821,868,953,91.1
21040, 영도구,055004, 53세,2017,1745,865,880,98.3,1719,849,870,97.6
21040, 영도구,055005, 54세,2017,2004,1018,986,103.2,1981,1004,977,102.8
21040, 영도구,060,55~59세,2017,11947,5731,6216,92.2,11871,5698,6173,92.3
21040, 영도구,060001, 55세,2017,2228,1057,1171,90.3,2203,1043,1160,89.9
21040, 영도구,060002, 56세,2017,2460,1181,1279,92.3,2446,1175,1271,92.4
21040, 영도구,060003, 57세,2017,2533,1217,1316,92.5,2518,1211,1307,92.7
21040, 영도구,060004, 58세,2017,2378,1113,1265,88,2372,1111,1261,88.1
21040, 영도구,060005, 59세,2017,2348,1163,1185,98.1,2332,1158,1174,98.6
21040, 영도구,065,60~64세,2017,11181,5284,5897,89.6,11129,5255,5874,89.5
21040, 영도구,065001, 60세,2017,2381,1136,1245,91.2,2368,1126,1242,90.7
21040, 영도구,065002, 61세,2017,2365,1139,1226,92.9,2353,1133,1220,92.9
21040, 영도구,065003, 62세,2017,2526,1148,1378,83.3,2516,1144,1372,83.4
21040, 영도구,065004, 63세,2017,2109,1019,1090,93.5,2098,1014,1084,93.5
21040, 영도구,065005, 64세,2017,1800,842,958,87.9,1794,838,956,87.7
21040, 영도구,070,65~69세,2017,8959,4146,4813,86.1,8939,4138,4801,86.2
21040, 영도구,070001, 65세,2017,2018,957,1061,90.2,2014,956,1058,90.4
21040, 영도구,070002, 66세,2017,1712,779,933,83.5,1706,776,930,83.4
21040, 영도구,070003, 67세,2017,1688,785,903,86.9,1682,782,900,86.9
21040, 영도구,070004, 68세,2017,1854,851,1003,84.8,1853,851,1002,84.9
21040, 영도구,070005, 69세,2017,1687,774,913,84.8,1684,773,911,84.9
21040, 영도구,075,70~74세,2017,7142,3118,4024,77.5,7132,3114,4018,77.5
21040, 영도구,075001, 70세,2017,1759,790,969,81.5,1756,789,967,81.6
21040, 영도구,075002, 71세,2017,1307,588,719,81.8,1305,587,718,81.8
21040, 영도구,075003, 72세,2017,1282,548,734,74.7,1280,547,733,74.6
21040, 영도구,075004, 73세,2017,1331,552,779,70.9,1329,552,777,71
21040, 영도구,075005, 74세,2017,1463,640,823,77.8,1462,639,823,77.6
21040, 영도구,080,75~79세,2017,5978,2430,3548,68.5,5969,2429,3540,68.6
21040, 영도구,080001, 75세,2017,1527,658,869,75.7,1526,658,868,75.8
21040, 영도구,080002, 76세,2017,1298,543,755,71.9,1297,543,754,72
21040, 영도구,080003, 77세,2017,1165,440,725,60.7,1164,440,724,60.8
21040, 영도구,080004, 78세,2017,1126,427,699,61.1,1123,427,696,61.4
21040, 영도구,080005, 79세,2017,862,362,500,72.4,859,361,498,72.5
21040, 영도구,085,80~84세,2017,3090,1092,1998,54.7,3088,1091,1997,54.6
21040, 영도구,085001, 80세,2017,807,284,523,54.3,807,284,523,54.3
21040, 영도구,085002, 81세,2017,724,271,453,59.8,724,271,453,59.8
21040, 영도구,085003, 82세,2017,627,228,399,57.1,626,227,399,56.9
21040, 영도구,085004, 83세,2017,522,189,333,56.8,522,189,333,56.8
21040, 영도구,085005, 84세,2017,410,120,290,41.4,409,120,289,41.5
21040, 영도구,090,85~89세,2017,1273,320,953,33.6,1271,319,952,33.5
21040, 영도구,090001, 85세,2017,376,108,268,40.3,375,107,268,39.9
21040, 영도구,090002, 86세,2017,271,85,186,45.7,271,85,186,45.7
21040, 영도구,090003, 87세,2017,228,51,177,28.8,228,51,177,28.8
21040, 영도구,090004, 88세,2017,230,53,177,29.9,230,53,177,29.9
21040, 영도구,090005, 89세,2017,168,23,145,15.9,167,23,144,16
21040, 영도구,095,90~94세,2017,380,67,313,21.4,379,67,312,21.5
21040, 영도구,095001, 90세,2017,143,26,117,22.2,142,26,116,22.4
21040, 영도구,095002, 91세,2017,79,12,67,17.9,79,12,67,17.9
21040, 영도구,095003, 92세,2017,55,9,46,19.6,55,9,46,19.6
21040, 영도구,095004, 93세,2017,45,9,36,25,45,9,36,25
21040, 영도구,095005, 94세,2017,58,11,47,23.4,58,11,47,23.4
21040, 영도구,100,95~99세,2017,64,15,49,30.6,64,15,49,30.6
21040, 영도구,100001, 95세,2017,21,5,16,31.3,21,5,16,31.3
21040, 영도구,100002, 96세,2017,19,6,13,46.2,19,6,13,46.2
21040, 영도구,100003, 97세,2017,7,X,6,16.7,7,X,6,16.7
21040, 영도구,100004, 98세,2017,13,X,10,30,13,X,10,30
21040, 영도구,100005, 99세,2017,X,X,X,0,X,X,X,0
21040, 영도구,101,100세이상,2017,9,X,7,28.6,9,X,7,28.6
21040, 영도구,102,15세미만,2017,10026,5151,4875,105.7,9985,5127,4858,105.5
21040, 영도구,103,15~64세,2017,86610,45790,40820,112.2,84913,44678,40235,111
21040, 영도구,104,65세이상,2017,26895,11190,15705,71.3,26851,11175,15676,71.3
21040, 영도구,086,85세이상,2017,1726,404,1322,30.6,1723,403,1320,30.5
21040, 영도구,126,평균연령,2017,46.3,44.1,48.5,,46.4,44.3,48.6,
21040, 영도구,127,중위연령,2017,48.7,45.7,51.9,,49,46.1,52.1,
21050, 부산진구,000,합계,2017,366492,177345,189147,93.8,363897,176304,187593,94
21050, 부산진구,005,0~4세,2017,12419,6372,6047,105.4,12382,6348,6034,105.2
21050, 부산진구,005001, 0세,2017,2267,1166,1101,105.9,2263,1163,1100,105.7
21050, 부산진구,005002, 1세,2017,2522,1299,1223,106.2,2517,1296,1221,106.1
21050, 부산진구,005003, 2세,2017,2581,1311,1270,103.2,2574,1307,1267,103.2
21050, 부산진구,005004, 3세,2017,2561,1342,1219,110.1,2553,1337,1216,110
21050, 부산진구,005005, 4세,2017,2488,1254,1234,101.6,2475,1245,1230,101.2
21050, 부산진구,010,5~9세,2017,12496,6339,6157,103,12478,6332,6146,103
21050, 부산진구,010001, 5세,2017,2685,1343,1342,100.1,2680,1342,1338,100.3
21050, 부산진구,010002, 6세,2017,2630,1296,1334,97.2,2628,1294,1334,97
21050, 부산진구,010003, 7세,2017,2413,1260,1153,109.3,2409,1259,1150,109.5
21050, 부산진구,010004, 8세,2017,2332,1201,1131,106.2,2329,1200,1129,106.3
21050, 부산진구,010005, 9세,2017,2436,1239,1197,103.5,2432,1237,1195,103.5
21050, 부산진구,015,10~14세,2017,12086,6185,5901,104.8,12074,6177,5897,104.7
21050, 부산진구,015001, 10세,2017,2474,1245,1229,101.3,2471,1245,1226,101.5
21050, 부산진구,015002, 11세,2017,2302,1164,1138,102.3,2302,1164,1138,102.3
21050, 부산진구,015003, 12세,2017,2202,1094,1108,98.7,2199,1091,1108,98.5
21050, 부산진구,015004, 13세,2017,2511,1336,1175,113.7,2509,1334,1175,113.5
21050, 부산진구,015005, 14세,2017,2597,1346,1251,107.6,2593,1343,1250,107.4
21050, 부산진구,020,15~19세,2017,18621,9247,9374,98.6,18508,9204,9304,98.9
21050, 부산진구,020001, 15세,2017,2731,1380,1351,102.1,2729,1378,1351,102
21050, 부산진구,020002, 16세,2017,3219,1654,1565,105.7,3203,1647,1556,105.8
21050, 부산진구,020003, 17세,2017,3715,1871,1844,101.5,3703,1867,1836,101.7
21050, 부산진구,020004, 18세,2017,3877,1982,1895,104.6,3848,1970,1878,104.9
21050, 부산진구,020005, 19세,2017,5079,2360,2719,86.8,5025,2342,2683,87.3
21050, 부산진구,025,20~24세,2017,27305,13484,13821,97.6,26954,13383,13571,98.6
21050, 부산진구,025001, 20세,2017,4977,2197,2780,79,4914,2184,2730,80
21050, 부산진구,025002, 21세,2017,5256,2527,2729,92.6,5183,2508,2675,93.8
21050, 부산진구,025003, 22세,2017,5619,2870,2749,104.4,5551,2849,2702,105.4
21050, 부산진구,025004, 23세,2017,5702,2913,2789,104.4,5630,2892,2738,105.6
21050, 부산진구,025005, 24세,2017,5751,2977,2774,107.3,5676,2950,2726,108.2
21050, 부산진구,030,25~29세,2017,26752,13289,13463,98.7,26298,13132,13166,99.7
21050, 부산진구,030001, 25세,2017,5921,2999,2922,102.6,5846,2972,2874,103.4
21050, 부산진구,030002, 26세,2017,5582,2769,2813,98.4,5491,2739,2752,99.5
21050, 부산진구,030003, 27세,2017,5316,2650,2666,99.4,5229,2621,2608,100.5
21050, 부산진구,030004, 28세,2017,5109,2497,2612,95.6,4997,2459,2538,96.9
21050, 부산진구,030005, 29세,2017,4824,2374,2450,96.9,4735,2341,2394,97.8
21050, 부산진구,035,30~34세,2017,24740,12524,12216,102.5,24347,12382,11965,103.5
21050, 부산진구,035001, 30세,2017,4882,2378,2504,95,4792,2348,2444,96.1
21050, 부산진구,035002, 31세,2017,4741,2385,2356,101.2,4663,2362,2301,102.7
21050, 부산진구,035003, 32세,2017,4856,2499,2357,106,4790,2471,2319,106.6
21050, 부산진구,035004, 33세,2017,4852,2526,2326,108.6,4792,2499,2293,109
21050, 부산진구,035005, 34세,2017,5409,2736,2673,102.4,5310,2702,2608,103.6
21050, 부산진구,040,35~39세,2017,27309,14138,13171,107.3,27062,14023,13039,107.5
21050, 부산진구,040001, 35세,2017,5706,2940,2766,106.3,5652,2913,2739,106.4
21050, 부산진구,040002, 36세,2017,5650,2931,2719,107.8,5606,2913,2693,108.2
21050, 부산진구,040003, 37세,2017,5748,2978,2770,107.5,5703,2960,2743,107.9
21050, 부산진구,040004, 38세,2017,5405,2747,2658,103.3,5354,2722,2632,103.4
21050, 부산진구,040005, 39세,2017,4800,2542,2258,112.6,4747,2515,2232,112.7
21050, 부산진구,045,40~44세,2017,25430,12941,12489,103.6,25207,12841,12366,103.8
21050, 부산진구,045001, 40세,2017,4763,2423,2340,103.5,4722,2410,2312,104.2
21050, 부산진구,045002, 41세,2017,4693,2361,2332,101.2,4640,2338,2302,101.6
21050, 부산진구,045003, 42세,2017,4900,2482,2418,102.6,4862,2468,2394,103.1
21050, 부산진구,045004, 43세,2017,5601,2907,2694,107.9,5558,2883,2675,107.8
21050, 부산진구,045005, 44세,2017,5473,2768,2705,102.3,5425,2742,2683,102.2
21050, 부산진구,050,45~49세,2017,28821,14244,14577,97.7,28606,14150,14456,97.9
21050, 부산진구,050001, 45세,2017,5691,2907,2784,104.4,5650,2885,2765,104.3
21050, 부산진구,050002, 46세,2017,5829,2830,2999,94.4,5791,2817,2974,94.7
21050, 부산진구,050003, 47세,2017,5697,2860,2837,100.8,5651,2843,2808,101.2
21050, 부산진구,050004, 48세,2017,5707,2830,2877,98.4,5661,2803,2858,98.1
21050, 부산진구,050005, 49세,2017,5897,2817,3080,91.5,5853,2802,3051,91.8
21050, 부산진구,055,50~54세,2017,27886,13431,14455,92.9,27720,13346,14374,92.8
21050, 부산진구,055001, 50세,2017,5473,2575,2898,88.9,5441,2555,2886,88.5
21050, 부산진구,055002, 51세,2017,5505,2677,2828,94.7,5470,2658,2812,94.5
21050, 부산진구,055003, 52세,2017,5601,2684,2917,92,5570,2667,2903,91.9
21050, 부산진구,055004, 53세,2017,5389,2649,2740,96.7,5364,2638,2726,96.8
21050, 부산진구,055005, 54세,2017,5918,2846,3072,92.6,5875,2828,3047,92.8
21050, 부산진구,060,55~59세,2017,33193,15502,17691,87.6,33047,15445,17602,87.7
21050, 부산진구,060001, 55세,2017,6404,3090,3314,93.2,6361,3072,3289,93.4
21050, 부산진구,060002, 56세,2017,7026,3252,3774,86.2,6998,3242,3756,86.3
21050, 부산진구,060003, 57세,2017,6986,3183,3803,83.7,6961,3174,3787,83.8
21050, 부산진구,060004, 58세,2017,6490,3019,3471,87,6470,3010,3460,87
21050, 부산진구,060005, 59세,2017,6287,2958,3329,88.9,6257,2947,3310,89
21050, 부산진구,065,60~64세,2017,28447,13452,14995,89.7,28312,13385,14927,89.7
21050, 부산진구,065001, 60세,2017,6344,2978,3366,88.5,6315,2963,3352,88.4
21050, 부산진구,065002, 61세,2017,5996,2884,3112,92.7,5964,2868,3096,92.6
21050, 부산진구,065003, 62세,2017,6233,2921,3312,88.2,6203,2906,3297,88.1
21050, 부산진구,065004, 63세,2017,5212,2558,2654,96.4,5192,2547,2645,96.3
21050, 부산진구,065005, 64세,2017,4662,2111,2551,82.8,4638,2101,2537,82.8
21050, 부산진구,070,65~69세,2017,21471,10137,11334,89.4,21431,10116,11315,89.4
21050, 부산진구,070001, 65세,2017,5007,2392,2615,91.5,4996,2388,2608,91.6
21050, 부산진구,070002, 66세,2017,4073,1936,2137,90.6,4064,1932,2132,90.6
21050, 부산진구,070003, 67세,2017,4015,1947,2068,94.1,4007,1941,2066,93.9
21050, 부산진구,070004, 68세,2017,4241,1956,2285,85.6,4235,1953,2282,85.6
21050, 부산진구,070005, 69세,2017,4135,1906,2229,85.5,4129,1902,2227,85.4
21050, 부산진구,075,70~74세,2017,15479,7021,8458,83,15454,7007,8447,83
21050, 부산진구,075001, 70세,2017,3800,1769,2031,87.1,3792,1764,2028,87
21050, 부산진구,075002, 71세,2017,2821,1248,1573,79.3,2815,1244,1571,79.2
21050, 부산진구,075003, 72세,2017,2775,1224,1551,78.9,2772,1223,1549,79
21050, 부산진구,075004, 73세,2017,2996,1374,1622,84.7,2993,1372,1621,84.6
21050, 부산진구,075005, 74세,2017,3087,1406,1681,83.6,3082,1404,1678,83.7
21050, 부산진구,080,75~79세,2017,13108,5451,7657,71.2,13096,5446,7650,71.2
21050, 부산진구,080001, 75세,2017,3378,1461,1917,76.2,3376,1461,1915,76.3
21050, 부산진구,080002, 76세,2017,2784,1206,1578,76.4,2782,1204,1578,76.3
21050, 부산진구,080003, 77세,2017,2555,1050,1505,69.8,2554,1050,1504,69.8
21050, 부산진구,080004, 78세,2017,2451,978,1473,66.4,2450,977,1473,66.3
21050, 부산진구,080005, 79세,2017,1940,756,1184,63.9,1934,754,1180,63.9
21050, 부산진구,085,80~84세,2017,7013,2567,4446,57.7,7010,2566,4444,57.7
21050, 부산진구,085001, 80세,2017,1885,723,1162,62.2,1885,723,1162,62.2
21050, 부산진구,085002, 81세,2017,1530,559,971,57.6,1530,559,971,57.6
21050, 부산진구,085003, 82세,2017,1450,495,955,51.8,1450,495,955,51.8
21050, 부산진구,085004, 83세,2017,1159,452,707,63.9,1158,451,707,63.8
21050, 부산진구,085005, 84세,2017,989,338,651,51.9,987,338,649,52.1
21050, 부산진구,090,85~89세,2017,2899,824,2075,39.7,2899,824,2075,39.7
21050, 부산진구,090001, 85세,2017,867,273,594,46,867,273,594,46
21050, 부산진구,090002, 86세,2017,635,173,462,37.4,635,173,462,37.4
21050, 부산진구,090003, 87세,2017,540,156,384,40.6,540,156,384,40.6
21050, 부산진구,090004, 88세,2017,465,138,327,42.2,465,138,327,42.2
21050, 부산진구,090005, 89세,2017,392,84,308,27.3,392,84,308,27.3
21050, 부산진구,095,90~94세,2017,829,168,661,25.4,825,168,657,25.6
21050, 부산진구,095001, 90세,2017,306,62,244,25.4,305,62,243,25.5
21050, 부산진구,095002, 91세,2017,178,35,143,24.5,177,35,142,24.6
21050, 부산진구,095003, 92세,2017,152,26,126,20.6,152,26,126,20.6
21050, 부산진구,095004, 93세,2017,97,21,76,27.6,97,21,76,27.6
21050, 부산진구,095005, 94세,2017,96,24,72,33.3,94,24,70,34.3
21050, 부산진구,100,95~99세,2017,171,28,143,19.6,170,28,142,19.7
21050, 부산진구,100001, 95세,2017,72,12,60,20,72,12,60,20
21050, 부산진구,100002, 96세,2017,48,8,40,20,48,8,40,20
21050, 부산진구,100003, 97세,2017,27,X,23,17.4,27,X,23,17.4
21050, 부산진구,100004, 98세,2017,17,X,14,21.4,16,X,13,23.1
21050, 부산진구,100005, 99세,2017,7,X,6,16.7,7,X,6,16.7
21050, 부산진구,101,100세이상,2017,17,X,16,6.3,17,X,16,6.3
21050, 부산진구,102,15세미만,2017,37001,18896,18105,104.4,36934,18857,18077,104.3
21050, 부산진구,103,15~64세,2017,268504,132252,136252,97.1,266061,131291,134770,97.4
21050, 부산진구,104,65세이상,2017,60987,26197,34790,75.3,60902,26156,34746,75.3
21050, 부산진구,086,85세이상,2017,3916,1021,2895,35.3,3911,1021,2890,35.3
21050, 부산진구,126,평균연령,2017,43.3,42.2,44.4,,43.4,42.2,44.5,
21050, 부산진구,127,중위연령,2017,44.3,42.9,45.7,,44.4,43,45.8,
21060, 동래구,000,합계,2017,261671,127795,133876,95.5,260562,127327,133235,95.6
21060, 동래구,005,0~4세,2017,8903,4605,4298,107.1,8889,4599,4290,107.2
21060, 동래구,005001, 0세,2017,1492,756,736,102.7,1489,755,734,102.9
21060, 동래구,005002, 1세,2017,1736,886,850,104.2,1730,884,846,104.5
21060, 동래구,005003, 2세,2017,1875,987,888,111.1,1874,987,887,111.3
21060, 동래구,005004, 3세,2017,1843,971,872,111.4,1842,970,872,111.2
21060, 동래구,005005, 4세,2017,1957,1005,952,105.6,1954,1003,951,105.5
21060, 동래구,010,5~9세,2017,10803,5661,5142,110.1,10798,5659,5139,110.1
21060, 동래구,010001, 5세,2017,2181,1145,1036,110.5,2180,1145,1035,110.6
21060, 동래구,010002, 6세,2017,2125,1090,1035,105.3,2125,1090,1035,105.3
21060, 동래구,010003, 7세,2017,2258,1205,1053,114.4,2256,1204,1052,114.4
21060, 동래구,010004, 8세,2017,2051,1083,968,111.9,2051,1083,968,111.9
21060, 동래구,010005, 9세,2017,2188,1138,1050,108.4,2186,1137,1049,108.4
21060, 동래구,015,10~14세,2017,11527,6024,5503,109.5,11522,6023,5499,109.5
21060, 동래구,015001, 10세,2017,2347,1227,1120,109.6,2346,1226,1120,109.5
21060, 동래구,015002, 11세,2017,2138,1097,1041,105.4,2137,1097,1040,105.5
21060, 동래구,015003, 12세,2017,2123,1155,968,119.3,2123,1155,968,119.3
21060, 동래구,015004, 13세,2017,2427,1263,1164,108.5,2425,1263,1162,108.7
21060, 동래구,015005, 14세,2017,2492,1282,1210,106,2491,1282,1209,106
21060, 동래구,020,15~19세,2017,14143,7461,6682,111.7,14122,7456,6666,111.9
21060, 동래구,020001, 15세,2017,2520,1292,1228,105.2,2518,1291,1227,105.2
21060, 동래구,020002, 16세,2017,2788,1470,1318,111.5,2785,1468,1317,111.5
21060, 동래구,020003, 17세,2017,3073,1629,1444,112.8,3071,1629,1442,113
21060, 동래구,020004, 18세,2017,3004,1613,1391,116,2998,1612,1386,116.3
21060, 동래구,020005, 19세,2017,2758,1457,1301,112,2750,1456,1294,112.5
21060, 동래구,025,20~24세,2017,16217,8822,7395,119.3,16125,8792,7333,119.9
21060, 동래구,025001, 20세,2017,3054,1698,1356,125.2,3043,1693,1350,125.4
21060, 동래구,025002, 21세,2017,3265,1820,1445,126,3252,1818,1434,126.8
21060, 동래구,025003, 22세,2017,3259,1734,1525,113.7,3241,1728,1513,114.2
21060, 동래구,025004, 23세,2017,3256,1773,1483,119.6,3234,1763,1471,119.9
21060, 동래구,025005, 24세,2017,3383,1797,1586,113.3,3355,1790,1565,114.4
21060, 동래구,030,25~29세,2017,15509,8027,7482,107.3,15301,7945,7356,108
21060, 동래구,030001, 25세,2017,3433,1786,1647,108.4,3403,1775,1628,109
21060, 동래구,030002, 26세,2017,3118,1632,1486,109.8,3084,1620,1464,110.7
21060, 동래구,030003, 27세,2017,3074,1597,1477,108.1,3019,1579,1440,109.7
21060, 동래구,030004, 28세,2017,3047,1574,1473,106.9,2997,1550,1447,107.1
21060, 동래구,030005, 29세,2017,2837,1438,1399,102.8,2798,1421,1377,103.2
21060, 동래구,035,30~34세,2017,14652,7498,7154,104.8,14477,7417,7060,105.1
21060, 동래구,035001, 30세,2017,2740,1399,1341,104.3,2710,1389,1321,105.1
21060, 동래구,035002, 31세,2017,2760,1449,1311,110.5,2715,1437,1278,112.4
21060, 동래구,035003, 32세,2017,2774,1437,1337,107.5,2743,1417,1326,106.9
21060, 동래구,035004, 33세,2017,2987,1491,1496,99.7,2949,1470,1479,99.4
21060, 동래구,035005, 34세,2017,3391,1722,1669,103.2,3360,1704,1656,102.9
21060, 동래구,040,35~39세,2017,19076,9453,9623,98.2,18928,9377,9551,98.2
21060, 동래구,040001, 35세,2017,3745,1839,1906,96.5,3702,1815,1887,96.2
21060, 동래구,040002, 36세,2017,3796,1918,1878,102.1,3769,1904,1865,102.1
21060, 동래구,040003, 37세,2017,4136,2084,2052,101.6,4111,2069,2042,101.3
21060, 동래구,040004, 38세,2017,3821,1843,1978,93.2,3795,1833,1962,93.4
21060, 동래구,040005, 39세,2017,3578,1769,1809,97.8,3551,1756,1795,97.8
21060, 동래구,045,40~44세,2017,19808,9496,10312,92.1,19698,9454,10244,92.3
21060, 동래구,045001, 40세,2017,3594,1762,1832,96.2,3568,1750,1818,96.3
21060, 동래구,045002, 41세,2017,3614,1688,1926,87.6,3594,1683,1911,88.1
21060, 동래구,045003, 42세,2017,3990,1899,2091,90.8,3970,1892,2078,91
21060, 동래구,045004, 43세,2017,4264,2054,2210,92.9,4242,2045,2197,93.1
21060, 동래구,045005, 44세,2017,4346,2093,2253,92.9,4324,2084,2240,93
21060, 동래구,050,45~49세,2017,22878,11175,11703,95.5,22787,11137,11650,95.6
21060, 동래구,050001, 45세,2017,4431,2216,2215,100,4409,2206,2203,100.1
21060, 동래구,050002, 46세,2017,4677,2259,2418,93.4,4662,2255,2407,93.7
21060, 동래구,050003, 47세,2017,4582,2236,2346,95.3,4561,2226,2335,95.3
21060, 동래구,050004, 48세,2017,4601,2212,2389,92.6,4582,2202,2380,92.5
21060, 동래구,050005, 49세,2017,4587,2252,2335,96.4,4573,2248,2325,96.7
21060, 동래구,055,50~54세,2017,21092,9904,11188,88.5,21014,9866,11148,88.5
21060, 동래구,055001, 50세,2017,4419,2066,2353,87.8,4405,2059,2346,87.8
21060, 동래구,055002, 51세,2017,4175,2029,2146,94.5,4154,2019,2135,94.6
21060, 동래구,055003, 52세,2017,4201,1950,2251,86.6,4193,1944,2249,86.4
21060, 동래구,055004, 53세,2017,4010,1859,2151,86.4,3994,1852,2142,86.5
21060, 동래구,055005, 54세,2017,4287,2000,2287,87.5,4268,1992,2276,87.5
21060, 동래구,060,55~59세,2017,24320,11400,12920,88.2,24249,11369,12880,88.3
21060, 동래구,060001, 55세,2017,4716,2212,2504,88.3,4706,2206,2500,88.2
21060, 동래구,060002, 56세,2017,5143,2388,2755,86.7,5125,2381,2744,86.8
21060, 동래구,060003, 57세,2017,5172,2338,2834,82.5,5158,2333,2825,82.6
21060, 동래구,060004, 58세,2017,4697,2246,2451,91.6,4682,2240,2442,91.7
21060, 동래구,060005, 59세,2017,4592,2216,2376,93.3,4578,2209,2369,93.2
21060, 동래구,065,60~64세,2017,20669,9710,10959,88.6,20623,9692,10931,88.7
21060, 동래구,065001, 60세,2017,4560,2190,2370,92.4,4549,2185,2364,92.4
21060, 동래구,065002, 61세,2017,4291,1991,2300,86.6,4285,1987,2298,86.5
21060, 동래구,065003, 62세,2017,4562,2087,2475,84.3,4551,2083,2468,84.4
21060, 동래구,065004, 63세,2017,3765,1833,1932,94.9,3759,1832,1927,95.1
21060, 동래구,065005, 64세,2017,3491,1609,1882,85.5,3479,1605,1874,85.6
21060, 동래구,070,65~69세,2017,15437,7294,8143,89.6,15410,7283,8127,89.6
21060, 동래구,070001, 65세,2017,3630,1694,1936,87.5,3622,1689,1933,87.4
21060, 동래구,070002, 66세,2017,3004,1409,1595,88.3,2998,1408,1590,88.6
21060, 동래구,070003, 67세,2017,2958,1413,1545,91.5,2951,1410,1541,91.5
21060, 동래구,070004, 68세,2017,2932,1395,1537,90.8,2928,1394,1534,90.9
21060, 동래구,070005, 69세,2017,2913,1383,1530,90.4,2911,1382,1529,90.4
21060, 동래구,075,70~74세,2017,10659,5165,5494,94,10650,5160,5490,94
21060, 동래구,075001, 70세,2017,2638,1270,1368,92.8,2636,1270,1366,93
21060, 동래구,075002, 71세,2017,2015,1018,997,102.1,2012,1016,996,102
21060, 동래구,075003, 72세,2017,1932,964,968,99.6,1931,964,967,99.7
21060, 동래구,075004, 73세,2017,2077,981,1096,89.5,2076,980,1096,89.4
21060, 동래구,075005, 74세,2017,1997,932,1065,87.5,1995,930,1065,87.3
21060, 동래구,080,75~79세,2017,8331,3639,4692,77.6,8327,3638,4689,77.6
21060, 동래구,080001, 75세,2017,2174,975,1199,81.3,2172,975,1197,81.5
21060, 동래구,080002, 76세,2017,1813,801,1012,79.2,1813,801,1012,79.2
21060, 동래구,080003, 77세,2017,1602,697,905,77,1601,697,904,77.1
21060, 동래구,080004, 78세,2017,1486,636,850,74.8,1485,635,850,74.7
21060, 동래구,080005, 79세,2017,1256,530,726,73,1256,530,726,73
21060, 동래구,085,80~84세,2017,4627,1734,2893,59.9,4624,1733,2891,59.9
21060, 동래구,085001, 80세,2017,1143,459,684,67.1,1142,459,683,67.2
21060, 동래구,085002, 81세,2017,1061,447,614,72.8,1060,447,613,72.9
21060, 동래구,085003, 82세,2017,987,362,625,57.9,987,362,625,57.9
21060, 동래구,085004, 83세,2017,785,257,528,48.7,785,257,528,48.7
21060, 동래구,085005, 84세,2017,651,209,442,47.3,650,208,442,47.1
21060, 동래구,090,85~89세,2017,2145,560,1585,35.3,2144,560,1584,35.4
21060, 동래구,090001, 85세,2017,593,175,418,41.9,592,175,417,42
21060, 동래구,090002, 86세,2017,485,141,344,41,485,141,344,41
21060, 동래구,090003, 87세,2017,426,105,321,32.7,426,105,321,32.7
21060, 동래구,090004, 88세,2017,349,81,268,30.2,349,81,268,30.2
21060, 동래구,090005, 89세,2017,292,58,234,24.8,292,58,234,24.8
21060, 동래구,095,90~94세,2017,704,142,562,25.3,704,142,562,25.3
21060, 동래구,095001, 90세,2017,226,53,173,30.6,226,53,173,30.6
21060, 동래구,095002, 91세,2017,176,37,139,26.6,176,37,139,26.6
21060, 동래구,095003, 92세,2017,124,21,103,20.4,124,21,103,20.4
21060, 동래구,095004, 93세,2017,88,14,74,18.9,88,14,74,18.9
21060, 동래구,095005, 94세,2017,90,17,73,23.3,90,17,73,23.3
21060, 동래구,100,95~99세,2017,148,22,126,17.5,147,22,125,17.6
21060, 동래구,100001, 95세,2017,50,7,43,16.3,49,7,42,16.7
21060, 동래구,100002, 96세,2017,42,8,34,23.5,42,8,34,23.5
21060, 동래구,100003, 97세,2017,34,6,28,21.4,34,6,28,21.4
21060, 동래구,100004, 98세,2017,13,X,12,8.3,13,X,12,8.3
21060, 동래구,100005, 99세,2017,9,X,9,0,9,X,9,0
21060, 동래구,101,100세이상,2017,23,X,20,15,23,X,20,15
21060, 동래구,102,15세미만,2017,31233,16290,14943,109,31209,16281,14928,109.1
21060, 동래구,103,15~64세,2017,188364,92946,95418,97.4,187324,92505,94819,97.6
21060, 동래구,104,65세이상,2017,42074,18559,23515,78.9,42029,18541,23488,78.9
21060, 동래구,086,85세이상,2017,3020,727,2293,31.7,3018,727,2291,31.7
21060, 동래구,126,평균연령,2017,43.2,41.8,44.5,,43.2,41.9,44.6,
21060, 동래구,127,중위연령,2017,45,43.5,46.5,,45.1,43.5,46.5,
21070, 남구,000,합계,2017,275941,135757,140184,96.8,270609,133071,137538,96.8
21070, 남구,005,0~4세,2017,8652,4459,4193,106.3,8604,4442,4162,106.7
21070, 남구,005001, 0세,2017,1426,722,704,102.6,1412,716,696,102.9
21070, 남구,005002, 1세,2017,1680,849,831,102.2,1666,846,820,103.2
21070, 남구,005003, 2세,2017,1839,975,864,112.8,1832,973,859,113.3
21070, 남구,005004, 3세,2017,1797,928,869,106.8,1789,924,865,106.8
21070, 남구,005005, 4세,2017,1910,985,925,106.5,1905,983,922,106.6
21070, 남구,010,5~9세,2017,10495,5288,5207,101.6,10469,5273,5196,101.5
21070, 남구,010001, 5세,2017,2074,1054,1020,103.3,2064,1049,1015,103.3
21070, 남구,010002, 6세,2017,2148,1050,1098,95.6,2146,1049,1097,95.6
21070, 남구,010003, 7세,2017,2165,1130,1035,109.2,2162,1127,1035,108.9
21070, 남구,010004, 8세,2017,1997,989,1008,98.1,1991,985,1006,97.9
21070, 남구,010005, 9세,2017,2111,1065,1046,101.8,2106,1063,1043,101.9
21070, 남구,015,10~14세,2017,10904,5661,5243,108,10882,5651,5231,108
21070, 남구,015001, 10세,2017,2235,1189,1046,113.7,2231,1186,1045,113.5
21070, 남구,015002, 11세,2017,2042,1057,985,107.3,2039,1056,983,107.4
21070, 남구,015003, 12세,2017,2083,1094,989,110.6,2076,1092,984,111
21070, 남구,015004, 13세,2017,2232,1156,1076,107.4,2228,1154,1074,107.4
21070, 남구,015005, 14세,2017,2312,1165,1147,101.6,2308,1163,1145,101.6
21070, 남구,020,15~19세,2017,17009,8897,8112,109.7,16335,8569,7766,110.3
21070, 남구,020001, 15세,2017,2371,1260,1111,113.4,2363,1255,1108,113.3
21070, 남구,020002, 16세,2017,2678,1431,1247,114.8,2674,1427,1247,114.4
21070, 남구,020003, 17세,2017,3201,1699,1502,113.1,3159,1685,1474,114.3
21070, 남구,020004, 18세,2017,3626,1903,1723,110.4,3472,1819,1653,110
21070, 남구,020005, 19세,2017,5133,2604,2529,103,4667,2383,2284,104.3
21070, 남구,025,20~24세,2017,23254,12091,11163,108.3,21447,11220,10227,109.7
21070, 남구,025001, 20세,2017,4560,2110,2450,86.1,4134,1900,2234,85
21070, 남구,025002, 21세,2017,4598,2169,2429,89.3,4197,1961,2236,87.7
21070, 남구,025003, 22세,2017,4873,2607,2266,115,4493,2425,2068,117.3
21070, 남구,025004, 23세,2017,4703,2593,2110,122.9,4386,2444,1942,125.8
21070, 남구,025005, 24세,2017,4520,2612,1908,136.9,4237,2490,1747,142.5
21070, 남구,030,25~29세,2017,17479,9613,7866,122.2,16576,9180,7396,124.1
21070, 남구,030001, 25세,2017,4388,2494,1894,131.7,4178,2395,1783,134.3
21070, 남구,030002, 26세,2017,3734,2096,1638,128,3525,1994,1531,130.2
21070, 남구,030003, 27세,2017,3327,1781,1546,115.2,3142,1691,1451,116.5
21070, 남구,030004, 28세,2017,3147,1727,1420,121.6,2997,1657,1340,123.7
21070, 남구,030005, 29세,2017,2883,1515,1368,110.7,2734,1443,1291,111.8
21070, 남구,035,30~34세,2017,14667,7621,7046,108.2,14171,7358,6813,108
21070, 남구,035001, 30세,2017,2845,1481,1364,108.6,2716,1426,1290,110.5
21070, 남구,035002, 31세,2017,2826,1494,1332,112.2,2709,1425,1284,111
21070, 남구,035003, 32세,2017,2721,1399,1322,105.8,2629,1351,1278,105.7
21070, 남구,035004, 33세,2017,3006,1554,1452,107,2917,1506,1411,106.7
21070, 남구,035005, 34세,2017,3269,1693,1576,107.4,3200,1650,1550,106.5
21070, 남구,040,35~39세,2017,18960,9558,9402,101.7,18630,9363,9267,101
21070, 남구,040001, 35세,2017,3677,1895,1782,106.3,3607,1849,1758,105.2
21070, 남구,040002, 36세,2017,3803,1945,1858,104.7,3726,1899,1827,103.9
21070, 남구,040003, 37세,2017,3966,1985,1981,100.2,3898,1949,1949,100
21070, 남구,040004, 38세,2017,3923,1927,1996,96.5,3860,1890,1970,95.9
21070, 남구,040005, 39세,2017,3591,1806,1785,101.2,3539,1776,1763,100.7
21070, 남구,045,40~44세,2017,20133,10144,9989,101.6,19855,9984,9871,101.1
21070, 남구,045001, 40세,2017,3691,1791,1900,94.3,3639,1762,1877,93.9
21070, 남구,045002, 41세,2017,3573,1787,1786,100.1,3513,1746,1767,98.8
21070, 남구,045003, 42세,2017,3988,2079,1909,108.9,3938,2050,1888,108.6
21070, 남구,045004, 43세,2017,4334,2192,2142,102.3,4284,2163,2121,102
21070, 남구,045005, 44세,2017,4547,2295,2252,101.9,4481,2263,2218,102
21070, 남구,050,45~49세,2017,23040,11533,11507,100.2,22799,11386,11413,99.8
21070, 남구,050001, 45세,2017,4477,2286,2191,104.3,4426,2257,2169,104.1
21070, 남구,050002, 46세,2017,4775,2383,2392,99.6,4714,2342,2372,98.7
21070, 남구,050003, 47세,2017,4565,2260,2305,98,4521,2230,2291,97.3
21070, 남구,050004, 48세,2017,4626,2330,2296,101.5,4581,2304,2277,101.2
21070, 남구,050005, 49세,2017,4597,2274,2323,97.9,4557,2253,2304,97.8
21070, 남구,055,50~54세,2017,20387,9958,10429,95.5,20194,9865,10329,95.5
21070, 남구,055001, 50세,2017,4183,2061,2122,97.1,4136,2042,2094,97.5
21070, 남구,055002, 51세,2017,4092,2019,2073,97.4,4055,1999,2056,97.2
21070, 남구,055003, 52세,2017,3962,1917,2045,93.7,3926,1901,2025,93.9
21070, 남구,055004, 53세,2017,3939,1959,1980,98.9,3896,1934,1962,98.6
21070, 남구,055005, 54세,2017,4211,2002,2209,90.6,4181,1989,2192,90.7
21070, 남구,060,55~59세,2017,23493,10970,12523,87.6,23349,10896,12453,87.5
21070, 남구,060001, 55세,2017,4434,2136,2298,93,4399,2117,2282,92.8
21070, 남구,060002, 56세,2017,4753,2198,2555,86,4725,2180,2545,85.7
21070, 남구,060003, 57세,2017,5161,2356,2805,84,5128,2339,2789,83.9
21070, 남구,060004, 58세,2017,4617,2150,2467,87.2,4594,2143,2451,87.4
21070, 남구,060005, 59세,2017,4528,2130,2398,88.8,4503,2117,2386,88.7
21070, 남구,065,60~64세,2017,20967,9797,11170,87.7,20880,9751,11129,87.6
21070, 남구,065001, 60세,2017,4682,2230,2452,90.9,4662,2219,2443,90.8
21070, 남구,065002, 61세,2017,4404,1991,2413,82.5,4385,1981,2404,82.4
21070, 남구,065003, 62세,2017,4582,2117,2465,85.9,4564,2108,2456,85.8
21070, 남구,065004, 63세,2017,3902,1866,2036,91.7,3883,1856,2027,91.6
21070, 남구,065005, 64세,2017,3397,1593,1804,88.3,3386,1587,1799,88.2
21070, 남구,070,65~69세,2017,16474,7582,8892,85.3,16431,7561,8870,85.2
21070, 남구,070001, 65세,2017,3772,1752,2020,86.7,3762,1747,2015,86.7
21070, 남구,070002, 66세,2017,3094,1439,1655,86.9,3086,1433,1653,86.7
21070, 남구,070003, 67세,2017,3221,1478,1743,84.8,3212,1475,1737,84.9
21070, 남구,070004, 68세,2017,3283,1511,1772,85.3,3275,1507,1768,85.2
21070, 남구,070005, 69세,2017,3104,1402,1702,82.4,3096,1399,1697,82.4
21070, 남구,075,70~74세,2017,12422,5641,6781,83.2,12409,5637,6772,83.2
21070, 남구,075001, 70세,2017,2992,1374,1618,84.9,2988,1372,1616,84.9
21070, 남구,075002, 71세,2017,2260,1037,1223,84.8,2258,1037,1221,84.9
21070, 남구,075003, 72세,2017,2264,1040,1224,85,2261,1039,1222,85
21070, 남구,075004, 73세,2017,2399,1086,1313,82.7,2398,1085,1313,82.6
21070, 남구,075005, 74세,2017,2507,1104,1403,78.7,2504,1104,1400,78.9
21070, 남구,080,75~79세,2017,9734,4326,5408,80,9722,4324,5398,80.1
21070, 남구,080001, 75세,2017,2549,1186,1363,87,2547,1185,1362,87
21070, 남구,080002, 76세,2017,2022,908,1114,81.5,2019,908,1111,81.7
21070, 남구,080003, 77세,2017,1939,835,1104,75.6,1937,835,1102,75.8
21070, 남구,080004, 78세,2017,1729,764,965,79.2,1727,763,964,79.1
21070, 남구,080005, 79세,2017,1495,633,862,73.4,1492,633,859,73.7
21070, 남구,085,80~84세,2017,5026,1894,3132,60.5,5020,1890,3130,60.4
21070, 남구,085001, 80세,2017,1315,539,776,69.5,1312,537,775,69.3
21070, 남구,085002, 81세,2017,1143,422,721,58.5,1142,421,721,58.4
21070, 남구,085003, 82세,2017,1029,407,622,65.4,1029,407,622,65.4
21070, 남구,085004, 83세,2017,873,294,579,50.8,872,294,578,50.9
21070, 남구,085005, 84세,2017,666,232,434,53.5,665,231,434,53.2
21070, 남구,090,85~89세,2017,2095,581,1514,38.4,2089,579,1510,38.3
21070, 남구,090001, 85세,2017,638,195,443,44,636,194,442,43.9
21070, 남구,090002, 86세,2017,440,131,309,42.4,439,131,308,42.5
21070, 남구,090003, 87세,2017,391,103,288,35.8,390,102,288,35.4
21070, 남구,090004, 88세,2017,329,85,244,34.8,328,85,243,35
21070, 남구,090005, 89세,2017,297,67,230,29.1,296,67,229,29.3
21070, 남구,095,90~94세,2017,619,120,499,24,616,119,497,23.9
21070, 남구,095001, 90세,2017,225,34,191,17.8,225,34,191,17.8
21070, 남구,095002, 91세,2017,145,30,115,26.1,143,29,114,25.4
21070, 남구,095003, 92세,2017,130,28,102,27.5,130,28,102,27.5
21070, 남구,095004, 93세,2017,61,15,46,32.6,61,15,46,32.6
21070, 남구,095005, 94세,2017,58,13,45,28.9,57,13,44,29.5
21070, 남구,100,95~99세,2017,117,22,95,23.2,117,22,95,23.2
21070, 남구,100001, 95세,2017,50,7,43,16.3,50,7,43,16.3
21070, 남구,100002, 96세,2017,28,X,25,12,28,X,25,12
21070, 남구,100003, 97세,2017,14,X,12,16.7,14,X,12,16.7
21070, 남구,100004, 98세,2017,12,5,7,71.4,12,5,7,71.4
21070, 남구,100005, 99세,2017,13,5,8,62.5,13,5,8,62.5
21070, 남구,101,100세이상,2017,14,X,13,7.7,14,X,13,7.7
21070, 남구,102,15세미만,2017,30051,15408,14643,105.2,29955,15366,14589,105.3
21070, 남구,103,15~64세,2017,199389,100182,99207,101,194236,97572,96664,100.9
21070, 남구,104,65세이상,2017,46501,20167,26334,76.6,46418,20133,26285,76.6
21070, 남구,086,85세이상,2017,2845,724,2121,34.1,2836,721,2115,34.1
21070, 남구,126,평균연령,2017,42.9,41.5,44.2,,43.2,41.8,44.5,
21070, 남구,127,중위연령,2017,44.2,42.5,45.9,,44.6,43,46.3,
21080, 북구,000,합계,2017,296945,146861,150084,97.9,294857,145976,148881,98
21080, 북구,005,0~4세,2017,11408,5815,5593,104,11395,5810,5585,104
21080, 북구,005001, 0세,2017,2093,1076,1017,105.8,2090,1074,1016,105.7
21080, 북구,005002, 1세,2017,2306,1162,1144,101.6,2305,1162,1143,101.7
21080, 북구,005003, 2세,2017,2396,1238,1158,106.9,2391,1236,1155,107
21080, 북구,005004, 3세,2017,2320,1164,1156,100.7,2317,1163,1154,100.8
21080, 북구,005005, 4세,2017,2293,1175,1118,105.1,2292,1175,1117,105.2
21080, 북구,010,5~9세,2017,11302,5820,5482,106.2,11296,5817,5479,106.2
21080, 북구,010001, 5세,2017,2394,1274,1120,113.8,2392,1272,1120,113.6
21080, 북구,010002, 6세,2017,2305,1179,1126,104.7,2303,1179,1124,104.9
21080, 북구,010003, 7세,2017,2164,1125,1039,108.3,2162,1124,1038,108.3
21080, 북구,010004, 8세,2017,2205,1096,1109,98.8,2205,1096,1109,98.8
21080, 북구,010005, 9세,2017,2234,1146,1088,105.3,2234,1146,1088,105.3
21080, 북구,015,10~14세,2017,11645,6078,5567,109.2,11635,6075,5560,109.3
21080, 북구,015001, 10세,2017,2217,1126,1091,103.2,2216,1126,1090,103.3
21080, 북구,015002, 11세,2017,2206,1174,1032,113.8,2205,1173,1032,113.7
21080, 북구,015003, 12세,2017,2279,1203,1076,111.8,2276,1203,1073,112.1
21080, 북구,015004, 13세,2017,2392,1241,1151,107.8,2389,1239,1150,107.7
21080, 북구,015005, 14세,2017,2551,1334,1217,109.6,2549,1334,1215,109.8
21080, 북구,020,15~19세,2017,16554,8781,7773,113,16383,8704,7679,113.3
21080, 북구,020001, 15세,2017,2630,1353,1277,106,2628,1353,1275,106.1
21080, 북구,020002, 16세,2017,3051,1581,1470,107.6,3049,1580,1469,107.6
21080, 북구,020003, 17세,2017,3564,1886,1678,112.4,3557,1883,1674,112.5
21080, 북구,020004, 18세,2017,3483,1886,1597,118.1,3453,1871,1582,118.3
21080, 북구,020005, 19세,2017,3826,2075,1751,118.5,3696,2017,1679,120.1
21080, 북구,025,20~24세,2017,21917,11924,9993,119.3,21319,11612,9707,119.6
21080, 북구,025001, 20세,2017,4096,2232,1864,119.7,3936,2150,1786,120.4
21080, 북구,025002, 21세,2017,4390,2415,1975,122.3,4252,2332,1920,121.5
21080, 북구,025003, 22세,2017,4471,2437,2034,119.8,4380,2394,1986,120.5
21080, 북구,025004, 23세,2017,4493,2415,2078,116.2,4383,2356,2027,116.2
21080, 북구,025005, 24세,2017,4467,2425,2042,118.8,4368,2380,1988,119.7
21080, 북구,030,25~29세,2017,19781,10359,9422,109.9,19479,10256,9223,111.2
21080, 북구,030001, 25세,2017,4550,2398,2152,111.4,4486,2372,2114,112.2
21080, 북구,030002, 26세,2017,4120,2260,1860,121.5,4063,2238,1825,122.6
21080, 북구,030003, 27세,2017,3863,2021,1842,109.7,3795,2000,1795,111.4
21080, 북구,030004, 28세,2017,3716,1929,1787,107.9,3662,1909,1753,108.9
21080, 북구,030005, 29세,2017,3532,1751,1781,98.3,3473,1737,1736,100.1
21080, 북구,035,30~34세,2017,17663,8970,8693,103.2,17443,8906,8537,104.3
21080, 북구,035001, 30세,2017,3443,1740,1703,102.2,3387,1722,1665,103.4
21080, 북구,035002, 31세,2017,3324,1719,1605,107.1,3289,1709,1580,108.2
21080, 북구,035003, 32세,2017,3466,1734,1732,100.1,3419,1725,1694,101.8
21080, 북구,035004, 33세,2017,3527,1807,1720,105.1,3493,1795,1698,105.7
21080, 북구,035005, 34세,2017,3903,1970,1933,101.9,3855,1955,1900,102.9
21080, 북구,040,35~39세,2017,20812,10666,10146,105.1,20665,10603,10062,105.4
21080, 북구,040001, 35세,2017,4242,2148,2094,102.6,4201,2137,2064,103.5
21080, 북구,040002, 36세,2017,4351,2242,2109,106.3,4331,2231,2100,106.2
21080, 북구,040003, 37세,2017,4320,2231,2089,106.8,4296,2218,2078,106.7
21080, 북구,040004, 38세,2017,4194,2117,2077,101.9,4164,2108,2056,102.5
21080, 북구,040005, 39세,2017,3705,1928,1777,108.5,3673,1909,1764,108.2
21080, 북구,045,40~44세,2017,20358,10078,10280,98,20240,10039,10201,98.4
21080, 북구,045001, 40세,2017,3825,1969,1856,106.1,3803,1962,1841,106.6
21080, 북구,045002, 41세,2017,3666,1878,1788,105,3640,1871,1769,105.8
21080, 북구,045003, 42세,2017,4093,2020,2073,97.4,4069,2009,2060,97.5
21080, 북구,045004, 43세,2017,4215,2066,2149,96.1,4197,2064,2133,96.8
21080, 북구,045005, 44세,2017,4559,2145,2414,88.9,4531,2133,2398,88.9
21080, 북구,050,45~49세,2017,25629,11920,13709,87,25481,11862,13619,87.1
21080, 북구,050001, 45세,2017,4587,2188,2399,91.2,4560,2175,2385,91.2
21080, 북구,050002, 46세,2017,4956,2328,2628,88.6,4931,2318,2613,88.7
21080, 북구,050003, 47세,2017,5123,2377,2746,86.6,5088,2367,2721,87
21080, 북구,050004, 48세,2017,5381,2492,2889,86.3,5354,2485,2869,86.6
21080, 북구,050005, 49세,2017,5582,2535,3047,83.2,5548,2517,3031,83
21080, 북구,055,50~54세,2017,27111,12850,14261,90.1,26978,12792,14186,90.2
21080, 북구,055001, 50세,2017,5410,2473,2937,84.2,5386,2464,2922,84.3
21080, 북구,055002, 51세,2017,5365,2556,2809,91,5334,2542,2792,91
21080, 북구,055003, 52세,2017,5431,2546,2885,88.2,5411,2537,2874,88.3
21080, 북구,055004, 53세,2017,5145,2453,2692,91.1,5119,2442,2677,91.2
21080, 북구,055005, 54세,2017,5760,2822,2938,96.1,5728,2807,2921,96.1
21080, 북구,060,55~59세,2017,30025,14912,15113,98.7,29929,14869,15060,98.7
21080, 북구,060001, 55세,2017,5976,2951,3025,97.6,5949,2937,3012,97.5
21080, 북구,060002, 56세,2017,6642,3272,3370,97.1,6622,3264,3358,97.2
21080, 북구,060003, 57세,2017,6423,3206,3217,99.7,6401,3196,3205,99.7
21080, 북구,060004, 58세,2017,5683,2830,2853,99.2,5672,2824,2848,99.2
21080, 북구,060005, 59세,2017,5301,2653,2648,100.2,5285,2648,2637,100.4
21080, 북구,065,60~64세,2017,22326,11082,11244,98.6,22262,11051,11211,98.6
21080, 북구,065001, 60세,2017,5239,2652,2587,102.5,5222,2642,2580,102.4
21080, 북구,065002, 61세,2017,4720,2370,2350,100.9,4706,2363,2343,100.9
21080, 북구,065003, 62세,2017,4929,2372,2557,92.8,4916,2365,2551,92.7
21080, 북구,065004, 63세,2017,4021,2002,2019,99.2,4008,1998,2010,99.4
21080, 북구,065005, 64세,2017,3417,1686,1731,97.4,3410,1683,1727,97.5
21080, 북구,070,65~69세,2017,15060,7448,7612,97.8,15027,7438,7589,98
21080, 북구,070001, 65세,2017,3677,1865,1812,102.9,3670,1863,1807,103.1
21080, 북구,070002, 66세,2017,2851,1406,1445,97.3,2846,1404,1442,97.4
21080, 북구,070003, 67세,2017,2987,1506,1481,101.7,2982,1504,1478,101.8
21080, 북구,070004, 68세,2017,2814,1360,1454,93.5,2805,1356,1449,93.6
21080, 북구,070005, 69세,2017,2731,1311,1420,92.3,2724,1311,1413,92.8
21080, 북구,075,70~74세,2017,10054,4732,5322,88.9,10046,4727,5319,88.9
21080, 북구,075001, 70세,2017,2558,1220,1338,91.2,2555,1217,1338,91
21080, 북구,075002, 71세,2017,1899,931,968,96.2,1898,931,967,96.3
21080, 북구,075003, 72세,2017,1768,844,924,91.3,1768,844,924,91.3
21080, 북구,075004, 73세,2017,1869,840,1029,81.6,1865,838,1027,81.6
21080, 북구,075005, 74세,2017,1960,897,1063,84.4,1960,897,1063,84.4
21080, 북구,080,75~79세,2017,8064,3326,4738,70.2,8050,3318,4732,70.1
21080, 북구,080001, 75세,2017,2116,937,1179,79.5,2112,935,1177,79.4
21080, 북구,080002, 76세,2017,1677,707,970,72.9,1675,706,969,72.9
21080, 북구,080003, 77세,2017,1552,642,910,70.5,1549,640,909,70.4
21080, 북구,080004, 78세,2017,1446,559,887,63,1443,557,886,62.9
21080, 북구,080005, 79세,2017,1273,481,792,60.7,1271,480,791,60.7
21080, 북구,085,80~84세,2017,4468,1506,2962,50.8,4463,1505,2958,50.9
21080, 북구,085001, 80세,2017,1083,411,672,61.2,1083,411,672,61.2
21080, 북구,085002, 81세,2017,980,332,648,51.2,979,332,647,51.3
21080, 북구,085003, 82세,2017,955,313,642,48.8,953,313,640,48.9
21080, 북구,085004, 83세,2017,790,235,555,42.3,788,234,554,42.2
21080, 북구,085005, 84세,2017,660,215,445,48.3,660,215,445,48.3
21080, 북구,090,85~89세,2017,1996,447,1549,28.9,1995,446,1549,28.8
21080, 북구,090001, 85세,2017,593,136,457,29.8,593,136,457,29.8
21080, 북구,090002, 86세,2017,457,103,354,29.1,457,103,354,29.1
21080, 북구,090003, 87세,2017,351,74,277,26.7,351,74,277,26.7
21080, 북구,090004, 88세,2017,316,77,239,32.2,315,76,239,31.8
21080, 북구,090005, 89세,2017,279,57,222,25.7,279,57,222,25.7
21080, 북구,095,90~94세,2017,629,129,500,25.8,629,129,500,25.8
21080, 북구,095001, 90세,2017,212,48,164,29.3,212,48,164,29.3
21080, 북구,095002, 91세,2017,142,30,112,26.8,142,30,112,26.8
21080, 북구,095003, 92세,2017,119,17,102,16.7,119,17,102,16.7
21080, 북구,095004, 93세,2017,72,19,53,35.8,72,19,53,35.8
21080, 북구,095005, 94세,2017,84,15,69,21.7,84,15,69,21.7
21080, 북구,100,95~99세,2017,128,15,113,13.3,128,15,113,13.3
21080, 북구,100001, 95세,2017,40,X,36,11.1,40,X,36,11.1
21080, 북구,100002, 96세,2017,32,X,31,3.2,32,X,31,3.2
21080, 북구,100003, 97세,2017,31,8,23,34.8,31,8,23,34.8
21080, 북구,100004, 98세,2017,15,X,13,15.4,15,X,13,15.4
21080, 북구,100005, 99세,2017,10,X,10,0,10,X,10,0
21080, 북구,101,100세이상,2017,15,X,12,25,14,X,12,16.7
21080, 북구,102,15세미만,2017,34355,17713,16642,106.4,34326,17702,16624,106.5
21080, 북구,103,15~64세,2017,222176,111542,110634,100.8,220179,110694,109485,101.1
21080, 북구,104,65세이상,2017,40414,17606,22808,77.2,40352,17580,22772,77.2
21080, 북구,086,85세이상,2017,2768,594,2174,27.3,2766,592,2174,27.2
21080, 북구,126,평균연령,2017,42.3,41,43.4,,42.3,41.1,43.5,
21080, 북구,127,중위연령,2017,44.3,42.6,45.9,,44.5,42.7,46,
21090, 해운대구,000,합계,2017,399363,193784,205579,94.3,395260,191645,203615,94.1
21090, 해운대구,005,0~4세,2017,14332,7503,6829,109.9,14234,7453,6781,109.9
21090, 해운대구,005001, 0세,2017,2342,1223,1119,109.3,2331,1219,1112,109.6
21090, 해운대구,005002, 1세,2017,2808,1453,1355,107.2,2780,1436,1344,106.8
21090, 해운대구,005003, 2세,2017,3013,1552,1461,106.2,2994,1544,1450,106.5
21090, 해운대구,005004, 3세,2017,2983,1574,1409,111.7,2959,1563,1396,112
21090, 해운대구,005005, 4세,2017,3186,1701,1485,114.5,3170,1691,1479,114.3
21090, 해운대구,010,5~9세,2017,17230,8942,8288,107.9,17144,8904,8240,108.1
21090, 해운대구,010001, 5세,2017,3474,1818,1656,109.8,3452,1808,1644,110
21090, 해운대구,010002, 6세,2017,3503,1833,1670,109.8,3493,1830,1663,110
21090, 해운대구,010003, 7세,2017,3366,1740,1626,107,3347,1735,1612,107.6
21090, 해운대구,010004, 8세,2017,3308,1707,1601,106.6,3288,1696,1592,106.5
21090, 해운대구,010005, 9세,2017,3579,1844,1735,106.3,3564,1835,1729,106.1
21090, 해운대구,015,10~14세,2017,18581,9536,9045,105.4,18505,9502,9003,105.5
21090, 해운대구,015001, 10세,2017,3665,1846,1819,101.5,3655,1843,1812,101.7
21090, 해운대구,015002, 11세,2017,3500,1806,1694,106.6,3484,1797,1687,106.5
21090, 해운대구,015003, 12세,2017,3548,1821,1727,105.4,3535,1814,1721,105.4
21090, 해운대구,015004, 13세,2017,3848,1963,1885,104.1,3826,1952,1874,104.2
21090, 해운대구,015005, 14세,2017,4020,2100,1920,109.4,4005,2096,1909,109.8
21090, 해운대구,020,15~19세,2017,24458,13140,11318,116.1,24314,13069,11245,116.2
21090, 해운대구,020001, 15세,2017,4169,2183,1986,109.9,4157,2176,1981,109.8
21090, 해운대구,020002, 16세,2017,5047,2738,2309,118.6,5033,2731,2302,118.6
21090, 해운대구,020003, 17세,2017,5583,3069,2514,122.1,5557,3060,2497,122.5
21090, 해운대구,020004, 18세,2017,5091,2706,2385,113.5,5064,2690,2374,113.3
21090, 해운대구,020005, 19세,2017,4568,2444,2124,115.1,4503,2412,2091,115.4
21090, 해운대구,025,20~24세,2017,24956,13412,11544,116.2,24414,13144,11270,116.6
21090, 해운대구,025001, 20세,2017,4714,2511,2203,114,4644,2473,2171,113.9
21090, 해운대구,025002, 21세,2017,5217,2921,2296,127.2,5137,2885,2252,128.1
21090, 해운대구,025003, 22세,2017,4907,2651,2256,117.5,4783,2595,2188,118.6
21090, 해운대구,025004, 23세,2017,5077,2718,2359,115.2,4954,2653,2301,115.3
21090, 해운대구,025005, 24세,2017,5041,2611,2430,107.4,4896,2538,2358,107.6
21090, 해운대구,030,25~29세,2017,22540,11491,11049,104,21923,11166,10757,103.8
21090, 해운대구,030001, 25세,2017,5111,2650,2461,107.7,4971,2575,2396,107.5
21090, 해운대구,030002, 26세,2017,4742,2396,2346,102.1,4625,2328,2297,101.3
21090, 해운대구,030003, 27세,2017,4359,2208,2151,102.6,4226,2135,2091,102.1
21090, 해운대구,030004, 28세,2017,4318,2207,2111,104.5,4202,2158,2044,105.6
21090, 해운대구,030005, 29세,2017,4010,2030,1980,102.5,3899,1970,1929,102.1
21090, 해운대구,035,30~34세,2017,21601,10422,11179,93.2,21042,10130,10912,92.8
21090, 해운대구,035001, 30세,2017,4084,1962,2122,92.5,3942,1890,2052,92.1
21090, 해운대구,035002, 31세,2017,4081,1974,2107,93.7,3943,1907,2036,93.7
21090, 해운대구,035003, 32세,2017,4123,2026,2097,96.6,4032,1969,2063,95.4
21090, 해운대구,035004, 33세,2017,4410,2161,2249,96.1,4309,2107,2202,95.7
21090, 해운대구,035005, 34세,2017,4903,2299,2604,88.3,4816,2257,2559,88.2
21090, 해운대구,040,35~39세,2017,29331,13965,15366,90.9,28863,13718,15145,90.6
21090, 해운대구,040001, 35세,2017,5601,2715,2886,94.1,5477,2642,2835,93.2
21090, 해운대구,040002, 36세,2017,5922,2841,3081,92.2,5834,2797,3037,92.1
21090, 해운대구,040003, 37세,2017,6277,2932,3345,87.7,6176,2888,3288,87.8
21090, 해운대구,040004, 38세,2017,5924,2754,3170,86.9,5845,2710,3135,86.4
21090, 해운대구,040005, 39세,2017,5607,2723,2884,94.4,5531,2681,2850,94.1
21090, 해운대구,045,40~44세,2017,31765,15166,16599,91.4,31389,14949,16440,90.9
21090, 해운대구,045001, 40세,2017,5901,2898,3003,96.5,5827,2855,2972,96.1
21090, 해운대구,045002, 41세,2017,5816,2851,2965,96.2,5732,2798,2934,95.4
21090, 해운대구,045003, 42세,2017,6201,2882,3319,86.8,6130,2836,3294,86.1
21090, 해운대구,045004, 43세,2017,6876,3206,3670,87.4,6800,3170,3630,87.3
21090, 해운대구,045005, 44세,2017,6971,3329,3642,91.4,6900,3290,3610,91.1
21090, 해운대구,050,45~49세,2017,38286,18248,20038,91.1,37968,18070,19898,90.8
21090, 해운대구,050001, 45세,2017,7458,3538,3920,90.3,7397,3500,3897,89.8
21090, 해운대구,050002, 46세,2017,7809,3687,4122,89.4,7740,3649,4091,89.2
21090, 해운대구,050003, 47세,2017,7806,3708,4098,90.5,7736,3669,4067,90.2
21090, 해운대구,050004, 48세,2017,7529,3627,3902,93,7471,3595,3876,92.8
21090, 해운대구,050005, 49세,2017,7684,3688,3996,92.3,7624,3657,3967,92.2
21090, 해운대구,055,50~54세,2017,34099,16325,17774,91.8,33805,16177,17628,91.8
21090, 해운대구,055001, 50세,2017,7071,3346,3725,89.8,7016,3311,3705,89.4
21090, 해운대구,055002, 51세,2017,6731,3252,3479,93.5,6683,3228,3455,93.4
21090, 해운대구,055003, 52세,2017,6709,3190,3519,90.7,6643,3166,3477,91.1
21090, 해운대구,055004, 53세,2017,6485,3102,3383,91.7,6424,3072,3352,91.6
21090, 해운대구,055005, 54세,2017,7103,3435,3668,93.6,7039,3400,3639,93.4
21090, 해운대구,060,55~59세,2017,35498,17077,18421,92.7,35285,16962,18323,92.6
21090, 해운대구,060001, 55세,2017,7074,3444,3630,94.9,7020,3415,3605,94.7
21090, 해운대구,060002, 56세,2017,7620,3649,3971,91.9,7573,3623,3950,91.7
21090, 해운대구,060003, 57세,2017,7484,3543,3941,89.9,7438,3520,3918,89.8
21090, 해운대구,060004, 58세,2017,6727,3278,3449,95,6691,3254,3437,94.7
21090, 해운대구,060005, 59세,2017,6593,3163,3430,92.2,6563,3150,3413,92.3
21090, 해운대구,065,60~64세,2017,28641,13792,14849,92.9,28484,13718,14766,92.9
21090, 해운대구,065001, 60세,2017,6457,3038,3419,88.9,6424,3024,3400,88.9
21090, 해운대구,065002, 61세,2017,6182,3067,3115,98.5,6148,3054,3094,98.7
21090, 해운대구,065003, 62세,2017,6266,2943,3323,88.6,6228,2922,3306,88.4
21090, 해운대구,065004, 63세,2017,5103,2565,2538,101.1,5075,2552,2523,101.1
21090, 해운대구,065005, 64세,2017,4633,2179,2454,88.8,4609,2166,2443,88.7
21090, 해운대구,070,65~69세,2017,20477,9516,10961,86.8,20401,9473,10928,86.7
21090, 해운대구,070001, 65세,2017,4968,2293,2675,85.7,4939,2276,2663,85.5
21090, 해운대구,070002, 66세,2017,3774,1782,1992,89.5,3758,1774,1984,89.4
21090, 해운대구,070003, 67세,2017,3844,1776,2068,85.9,3829,1768,2061,85.8
21090, 해운대구,070004, 68세,2017,4004,1826,2178,83.8,3994,1819,2175,83.6
21090, 해운대구,070005, 69세,2017,3887,1839,2048,89.8,3881,1836,2045,89.8
21090, 해운대구,075,70~74세,2017,14580,6669,7911,84.3,14553,6655,7898,84.3
21090, 해운대구,075001, 70세,2017,3638,1685,1953,86.3,3629,1681,1948,86.3
21090, 해운대구,075002, 71세,2017,2592,1200,1392,86.2,2587,1196,1391,86
21090, 해운대구,075003, 72세,2017,2729,1289,1440,89.5,2725,1286,1439,89.4
21090, 해운대구,075004, 73세,2017,2814,1296,1518,85.4,2806,1294,1512,85.6
21090, 해운대구,075005, 74세,2017,2807,1199,1608,74.6,2806,1198,1608,74.5
21090, 해운대구,080,75~79세,2017,12054,5021,7033,71.4,12029,5008,7021,71.3
21090, 해운대구,080001, 75세,2017,3010,1287,1723,74.7,3005,1283,1722,74.5
21090, 해운대구,080002, 76세,2017,2573,1073,1500,71.5,2565,1071,1494,71.7
21090, 해운대구,080003, 77세,2017,2319,993,1326,74.9,2316,991,1325,74.8
21090, 해운대구,080004, 78세,2017,2263,919,1344,68.4,2255,914,1341,68.2
21090, 해운대구,080005, 79세,2017,1889,749,1140,65.7,1888,749,1139,65.8
21090, 해운대구,085,80~84세,2017,6878,2490,4388,56.7,6860,2482,4378,56.7
21090, 해운대구,085001, 80세,2017,1752,674,1078,62.5,1746,672,1074,62.6
21090, 해운대구,085002, 81세,2017,1572,574,998,57.5,1568,570,998,57.1
21090, 해운대구,085003, 82세,2017,1415,496,919,54,1413,496,917,54.1
21090, 해운대구,085004, 83세,2017,1169,427,742,57.5,1167,426,741,57.5
21090, 해운대구,085005, 84세,2017,970,319,651,49,966,318,648,49.1
21090, 해운대구,090,85~89세,2017,2980,812,2168,37.5,2971,808,2163,37.4
21090, 해운대구,090001, 85세,2017,837,251,586,42.8,834,250,584,42.8
21090, 해운대구,090002, 86세,2017,670,186,484,38.4,670,186,484,38.4
21090, 해운대구,090003, 87세,2017,564,142,422,33.6,562,141,421,33.5
21090, 해운대구,090004, 88세,2017,505,145,360,40.3,502,144,358,40.2
21090, 해운대구,090005, 89세,2017,404,88,316,27.8,403,87,316,27.5
21090, 해운대구,095,90~94세,2017,911,213,698,30.5,911,213,698,30.5
21090, 해운대구,095001, 90세,2017,315,81,234,34.6,315,81,234,34.6
21090, 해운대구,095002, 91세,2017,216,49,167,29.3,216,49,167,29.3
21090, 해운대구,095003, 92세,2017,171,33,138,23.9,171,33,138,23.9
21090, 해운대구,095004, 93세,2017,111,23,88,26.1,111,23,88,26.1
21090, 해운대구,095005, 94세,2017,98,27,71,38,98,27,71,38
21090, 해운대구,100,95~99세,2017,153,41,112,36.6,153,41,112,36.6
21090, 해운대구,100001, 95세,2017,66,20,46,43.5,66,20,46,43.5
21090, 해운대구,100002, 96세,2017,39,8,31,25.8,39,8,31,25.8
21090, 해운대구,100003, 97세,2017,22,6,16,37.5,22,6,16,37.5
21090, 해운대구,100004, 98세,2017,16,5,11,45.5,16,5,11,45.5
21090, 해운대구,100005, 99세,2017,10,X,8,25,10,X,8,25
21090, 해운대구,101,100세이상,2017,12,X,9,33.3,12,X,9,33.3
21090, 해운대구,102,15세미만,2017,50143,25981,24162,107.5,49883,25859,24024,107.6
21090, 해운대구,103,15~64세,2017,291175,143038,148137,96.6,287487,141103,146384,96.4
21090, 해운대구,104,65세이상,2017,58045,24765,33280,74.4,57890,24683,33207,74.3
21090, 해운대구,086,85세이상,2017,4056,1069,2987,35.8,4047,1065,2982,35.7
21090, 해운대구,126,평균연령,2017,42.3,41,43.5,,42.4,41,43.6,
21090, 해운대구,127,중위연령,2017,44.3,42.9,45.4,,44.4,43.1,45.5,
21100, 사하구,000,합계,2017,330293,164623,165670,99.4,325397,161530,163867,98.6
21100, 사하구,005,0~4세,2017,11898,6124,5774,106.1,11866,6107,5759,106
21100, 사하구,005001, 0세,2017,2084,1108,976,113.5,2077,1104,973,113.5
21100, 사하구,005002, 1세,2017,2411,1231,1180,104.3,2403,1230,1173,104.9
21100, 사하구,005003, 2세,2017,2499,1302,1197,108.8,2491,1296,1195,108.5
21100, 사하구,005004, 3세,2017,2472,1255,1217,103.1,2468,1253,1215,103.1
21100, 사하구,005005, 4세,2017,2432,1228,1204,102,2427,1224,1203,101.7
21100, 사하구,010,5~9세,2017,12795,6549,6246,104.9,12781,6543,6238,104.9
21100, 사하구,010001, 5세,2017,2731,1402,1329,105.5,2729,1402,1327,105.7
21100, 사하구,010002, 6세,2017,2704,1356,1348,100.6,2701,1354,1347,100.5
21100, 사하구,010003, 7세,2017,2416,1227,1189,103.2,2412,1227,1185,103.5
21100, 사하구,010004, 8세,2017,2437,1279,1158,110.4,2434,1277,1157,110.4
21100, 사하구,010005, 9세,2017,2507,1285,1222,105.2,2505,1283,1222,105
21100, 사하구,015,10~14세,2017,12553,6464,6089,106.2,12535,6458,6077,106.3
21100, 사하구,015001, 10세,2017,2563,1328,1235,107.5,2560,1328,1232,107.8
21100, 사하구,015002, 11세,2017,2269,1169,1100,106.3,2266,1168,1098,106.4
21100, 사하구,015003, 12세,2017,2377,1203,1174,102.5,2373,1202,1171,102.6
21100, 사하구,015004, 13세,2017,2581,1299,1282,101.3,2576,1296,1280,101.3
21100, 사하구,015005, 14세,2017,2763,1465,1298,112.9,2760,1464,1296,113
21100, 사하구,020,15~19세,2017,18989,9903,9086,109,18925,9875,9050,109.1
21100, 사하구,020001, 15세,2017,2952,1569,1383,113.4,2945,1568,1377,113.9
21100, 사하구,020002, 16세,2017,3575,1932,1643,117.6,3572,1930,1642,117.5
21100, 사하구,020003, 17세,2017,3917,2094,1823,114.9,3901,2087,1814,115
21100, 사하구,020004, 18세,2017,3908,2043,1865,109.5,3898,2038,1860,109.6
21100, 사하구,020005, 19세,2017,4637,2265,2372,95.5,4609,2252,2357,95.5
21100, 사하구,025,20~24세,2017,23460,12411,11049,112.3,22907,12086,10821,111.7
21100, 사하구,025001, 20세,2017,4558,2223,2335,95.2,4493,2192,2301,95.3
21100, 사하구,025002, 21세,2017,4653,2488,2165,114.9,4562,2437,2125,114.7
21100, 사하구,025003, 22세,2017,4742,2546,2196,115.9,4631,2488,2143,116.1
21100, 사하구,025004, 23세,2017,4817,2580,2237,115.3,4689,2502,2187,114.4
21100, 사하구,025005, 24세,2017,4690,2574,2116,121.6,4532,2467,2065,119.5
21100, 사하구,030,25~29세,2017,20902,11245,9657,116.4,19917,10577,9340,113.2
21100, 사하구,030001, 25세,2017,4665,2475,2190,113,4481,2361,2120,111.4
21100, 사하구,030002, 26세,2017,4370,2402,1968,122.1,4139,2247,1892,118.8
21100, 사하구,030003, 27세,2017,4075,2237,1838,121.7,3873,2095,1778,117.8
21100, 사하구,030004, 28세,2017,3984,2105,1879,112,3787,1965,1822,107.8
21100, 사하구,030005, 29세,2017,3808,2026,1782,113.7,3637,1909,1728,110.5
21100, 사하구,035,30~34세,2017,20556,10996,9560,115,19604,10342,9262,111.7
21100, 사하구,035001, 30세,2017,3757,2007,1750,114.7,3545,1858,1687,110.1
21100, 사하구,035002, 31세,2017,3831,2101,1730,121.4,3642,1979,1663,119
21100, 사하구,035003, 32세,2017,4056,2173,1883,115.4,3848,2035,1813,112.2
21100, 사하구,035004, 33세,2017,4232,2250,1982,113.5,4044,2109,1935,109
21100, 사하구,035005, 34세,2017,4680,2465,2215,111.3,4525,2361,2164,109.1
21100, 사하구,040,35~39세,2017,24739,13231,11508,115,24049,12728,11321,112.4
21100, 사하구,040001, 35세,2017,5030,2678,2352,113.9,4861,2552,2309,110.5
21100, 사하구,040002, 36세,2017,5304,2823,2481,113.8,5154,2710,2444,110.9
21100, 사하구,040003, 37세,2017,5243,2816,2427,116,5113,2718,2395,113.5
21100, 사하구,040004, 38세,2017,4777,2572,2205,116.6,4642,2483,2159,115
21100, 사하구,040005, 39세,2017,4385,2342,2043,114.6,4279,2265,2014,112.5
21100, 사하구,045,40~44세,2017,23262,11930,11332,105.3,22799,11620,11179,103.9
21100, 사하구,045001, 40세,2017,4386,2332,2054,113.5,4282,2257,2025,111.5
21100, 사하구,045002, 41세,2017,4162,2142,2020,106,4076,2084,1992,104.6
21100, 사하구,045003, 42세,2017,4565,2325,2240,103.8,4464,2260,2204,102.5
21100, 사하구,045004, 43세,2017,5020,2533,2487,101.8,4929,2472,2457,100.6
21100, 사하구,045005, 44세,2017,5129,2598,2531,102.6,5048,2547,2501,101.8
21100, 사하구,050,45~49세,2017,27564,13590,13974,97.3,27182,13377,13805,96.9
21100, 사하구,050001, 45세,2017,5056,2538,2518,100.8,4976,2487,2489,99.9
21100, 사하구,050002, 46세,2017,5651,2852,2799,101.9,5576,2804,2772,101.2
21100, 사하구,050003, 47세,2017,5541,2705,2836,95.4,5461,2663,2798,95.2
21100, 사하구,050004, 48세,2017,5632,2687,2945,91.2,5548,2646,2902,91.2
21100, 사하구,050005, 49세,2017,5684,2808,2876,97.6,5621,2777,2844,97.6
21100, 사하구,055,50~54세,2017,26914,13077,13837,94.5,26612,12919,13693,94.3
21100, 사하구,055001, 50세,2017,5353,2572,2781,92.5,5295,2547,2748,92.7
21100, 사하구,055002, 51세,2017,5307,2637,2670,98.8,5247,2605,2642,98.6
21100, 사하구,055003, 52세,2017,5397,2558,2839,90.1,5333,2522,2811,89.7
21100, 사하구,055004, 53세,2017,5164,2525,2639,95.7,5109,2502,2607,96
21100, 사하구,055005, 54세,2017,5693,2785,2908,95.8,5628,2743,2885,95.1
21100, 사하구,060,55~59세,2017,31405,15154,16251,93.2,31201,15063,16138,93.3
21100, 사하구,060001, 55세,2017,6176,3008,3168,94.9,6125,2987,3138,95.2
21100, 사하구,060002, 56세,2017,6617,3153,3464,91,6579,3133,3446,90.9
21100, 사하구,060003, 57세,2017,6790,3256,3534,92.1,6741,3237,3504,92.4
21100, 사하구,060004, 58세,2017,5949,2848,3101,91.8,5918,2834,3084,91.9
21100, 사하구,060005, 59세,2017,5873,2889,2984,96.8,5838,2872,2966,96.8
21100, 사하구,065,60~64세,2017,25842,12531,13311,94.1,25707,12460,13247,94.1
21100, 사하구,065001, 60세,2017,5979,2873,3106,92.5,5933,2846,3087,92.2
21100, 사하구,065002, 61세,2017,5366,2578,2788,92.5,5348,2568,2780,92.4
21100, 사하구,065003, 62세,2017,5559,2668,2891,92.3,5537,2659,2878,92.4
21100, 사하구,065004, 63세,2017,4712,2368,2344,101,4685,2353,2332,100.9
21100, 사하구,065005, 64세,2017,4226,2044,2182,93.7,4204,2034,2170,93.7
21100, 사하구,070,65~69세,2017,18086,8758,9328,93.9,18031,8733,9298,93.9
21100, 사하구,070001, 65세,2017,4303,2140,2163,98.9,4291,2134,2157,98.9
21100, 사하구,070002, 66세,2017,3437,1652,1785,92.5,3421,1644,1777,92.5
21100, 사하구,070003, 67세,2017,3450,1667,1783,93.5,3437,1661,1776,93.5
21100, 사하구,070004, 68세,2017,3480,1683,1797,93.7,3471,1679,1792,93.7
21100, 사하구,070005, 69세,2017,3416,1616,1800,89.8,3411,1615,1796,89.9
21100, 사하구,075,70~74세,2017,12479,5846,6633,88.1,12455,5837,6618,88.2
21100, 사하구,075001, 70세,2017,3136,1425,1711,83.3,3130,1423,1707,83.4
21100, 사하구,075002, 71세,2017,2416,1172,1244,94.2,2412,1171,1241,94.4
21100, 사하구,075003, 72세,2017,2362,1148,1214,94.6,2358,1145,1213,94.4
21100, 사하구,075004, 73세,2017,2260,1029,1231,83.6,2253,1026,1227,83.6
21100, 사하구,075005, 74세,2017,2305,1072,1233,86.9,2302,1072,1230,87.2
21100, 사하구,080,75~79세,2017,9870,4169,5701,73.1,9857,4164,5693,73.1
21100, 사하구,080001, 75세,2017,2606,1187,1419,83.7,2603,1185,1418,83.6
21100, 사하구,080002, 76세,2017,2105,901,1204,74.8,2101,901,1200,75.1
21100, 사하구,080003, 77세,2017,1837,787,1050,75,1834,787,1047,75.2
21100, 사하구,080004, 78세,2017,1814,730,1084,67.3,1812,728,1084,67.2
21100, 사하구,080005, 79세,2017,1508,564,944,59.7,1507,563,944,59.6
21100, 사하구,085,80~84세,2017,5404,1832,3572,51.3,5399,1831,3568,51.3
21100, 사하구,085001, 80세,2017,1476,555,921,60.3,1476,555,921,60.3
21100, 사하구,085002, 81세,2017,1145,379,766,49.5,1144,379,765,49.5
21100, 사하구,085003, 82세,2017,1084,370,714,51.8,1083,369,714,51.7
21100, 사하구,085004, 83세,2017,927,294,633,46.4,925,294,631,46.6
21100, 사하구,085005, 84세,2017,772,234,538,43.5,771,234,537,43.6
21100, 사하구,090,85~89세,2017,2520,648,1872,34.6,2517,646,1871,34.5
21100, 사하구,090001, 85세,2017,640,190,450,42.2,639,190,449,42.3
21100, 사하구,090002, 86세,2017,533,140,393,35.6,532,139,393,35.4
21100, 사하구,090003, 87세,2017,516,112,404,27.7,515,111,404,27.5
21100, 사하구,090004, 88세,2017,463,118,345,34.2,463,118,345,34.2
21100, 사하구,090005, 89세,2017,368,88,280,31.4,368,88,280,31.4
21100, 사하구,095,90~94세,2017,882,140,742,18.9,880,139,741,18.8
21100, 사하구,095001, 90세,2017,296,53,243,21.8,296,53,243,21.8
21100, 사하구,095002, 91세,2017,171,31,140,22.1,171,31,140,22.1
21100, 사하구,095003, 92세,2017,176,18,158,11.4,174,17,157,10.8
21100, 사하구,095004, 93세,2017,131,21,110,19.1,131,21,110,19.1
21100, 사하구,095005, 94세,2017,108,17,91,18.7,108,17,91,18.7
21100, 사하구,100,95~99세,2017,156,24,132,18.2,156,24,132,18.2
21100, 사하구,100001, 95세,2017,59,11,48,22.9,59,11,48,22.9
21100, 사하구,100002, 96세,2017,40,X,36,11.1,40,X,36,11.1
21100, 사하구,100003, 97세,2017,33,6,27,22.2,33,6,27,22.2
21100, 사하구,100004, 98세,2017,16,X,14,14.3,16,X,14,14.3
21100, 사하구,100005, 99세,2017,8,X,7,14.3,8,X,7,14.3
21100, 사하구,101,100세이상,2017,17,X,16,6.3,17,X,16,6.3
21100, 사하구,102,15세미만,2017,37246,19137,18109,105.7,37182,19108,18074,105.7
21100, 사하구,103,15~64세,2017,243633,124068,119565,103.8,238903,121047,117856,102.7
21100, 사하구,104,65세이상,2017,49414,21418,27996,76.5,49312,21375,27937,76.5
21100, 사하구,086,85세이상,2017,3575,813,2762,29.4,3570,810,2760,29.3
21100, 사하구,126,평균연령,2017,42.7,41.4,44,,42.8,41.5,44,
21100, 사하구,127,중위연령,2017,44.2,42.4,46,,44.5,42.8,46.1,
21110, 금정구,000,합계,2017,246891,120805,126086,95.8,242192,118714,123478,96.1
21110, 금정구,005,0~4세,2017,6924,3587,3337,107.5,6882,3574,3308,108
21110, 금정구,005001, 0세,2017,1208,619,589,105.1,1198,615,583,105.5
21110, 금정구,005002, 1세,2017,1287,707,580,121.9,1277,705,572,123.3
21110, 금정구,005003, 2세,2017,1503,736,767,96,1493,733,760,96.4
21110, 금정구,005004, 3세,2017,1470,777,693,112.1,1461,774,687,112.7
21110, 금정구,005005, 4세,2017,1456,748,708,105.6,1453,747,706,105.8
21110, 금정구,010,5~9세,2017,7878,4142,3736,110.9,7858,4132,3726,110.9
21110, 금정구,010001, 5세,2017,1576,816,760,107.4,1571,814,757,107.5
21110, 금정구,010002, 6세,2017,1664,859,805,106.7,1662,857,805,106.5
21110, 금정구,010003, 7세,2017,1534,801,733,109.3,1528,799,729,109.6
21110, 금정구,010004, 8세,2017,1543,834,709,117.6,1538,831,707,117.5
21110, 금정구,010005, 9세,2017,1561,832,729,114.1,1559,831,728,114.1
21110, 금정구,015,10~14세,2017,8458,4414,4044,109.1,8447,4407,4040,109.1
21110, 금정구,015001, 10세,2017,1698,866,832,104.1,1696,865,831,104.1
21110, 금정구,015002, 11세,2017,1569,854,715,119.4,1567,853,714,119.5
21110, 금정구,015003, 12세,2017,1538,801,737,108.7,1535,799,736,108.6
21110, 금정구,015004, 13세,2017,1752,888,864,102.8,1750,887,863,102.8
21110, 금정구,015005, 14세,2017,1901,1005,896,112.2,1899,1003,896,111.9
21110, 금정구,020,15~19세,2017,14495,7339,7156,102.6,14145,7195,6950,103.5
21110, 금정구,020001, 15세,2017,1970,1002,968,103.5,1966,1001,965,103.7
21110, 금정구,020002, 16세,2017,2312,1148,1164,98.6,2305,1145,1160,98.7
21110, 금정구,020003, 17세,2017,2738,1484,1254,118.3,2707,1471,1236,119
21110, 금정구,020004, 18세,2017,3068,1573,1495,105.2,2965,1524,1441,105.8
21110, 금정구,020005, 19세,2017,4407,2132,2275,93.7,4202,2054,2148,95.6
21110, 금정구,025,20~24세,2017,23705,11959,11746,101.8,21983,11387,10596,107.5
21110, 금정구,025001, 20세,2017,4496,1978,2518,78.6,4182,1883,2299,81.9
21110, 금정구,025002, 21세,2017,4628,2081,2547,81.7,4225,1970,2255,87.4
21110, 금정구,025003, 22세,2017,4857,2457,2400,102.4,4478,2330,2148,108.5
21110, 금정구,025004, 23세,2017,5025,2785,2240,124.3,4686,2660,2026,131.3
21110, 금정구,025005, 24세,2017,4699,2658,2041,130.2,4412,2544,1868,136.2
21110, 금정구,030,25~29세,2017,17357,9795,7562,129.5,16481,9343,7138,130.9
21110, 금정구,030001, 25세,2017,4349,2569,1780,144.3,4137,2471,1666,148.3
21110, 금정구,030002, 26세,2017,3784,2198,1586,138.6,3604,2099,1505,139.5
21110, 금정구,030003, 27세,2017,3318,1836,1482,123.9,3132,1751,1381,126.8
21110, 금정구,030004, 28세,2017,3040,1607,1433,112.1,2879,1518,1361,111.5
21110, 금정구,030005, 29세,2017,2866,1585,1281,123.7,2729,1504,1225,122.8
21110, 금정구,035,30~34세,2017,13212,7005,6207,112.9,12714,6720,5994,112.1
21110, 금정구,035001, 30세,2017,2706,1429,1277,111.9,2585,1358,1227,110.7
21110, 금정구,035002, 31세,2017,2601,1435,1166,123.1,2493,1370,1123,122
21110, 금정구,035003, 32세,2017,2489,1332,1157,115.1,2389,1274,1115,114.3
21110, 금정구,035004, 33세,2017,2550,1342,1208,111.1,2456,1292,1164,111
21110, 금정구,035005, 34세,2017,2866,1467,1399,104.9,2791,1426,1365,104.5
21110, 금정구,040,35~39세,2017,15694,8020,7674,104.5,15413,7865,7548,104.2
21110, 금정구,040001, 35세,2017,3096,1594,1502,106.1,3020,1551,1469,105.6
21110, 금정구,040002, 36세,2017,3258,1661,1597,104,3200,1631,1569,104
21110, 금정구,040003, 37세,2017,3304,1665,1639,101.6,3257,1639,1618,101.3
21110, 금정구,040004, 38세,2017,3103,1600,1503,106.5,3057,1572,1485,105.9
21110, 금정구,040005, 39세,2017,2933,1500,1433,104.7,2879,1472,1407,104.6
21110, 금정구,045,40~44세,2017,15401,7718,7683,100.5,15183,7593,7590,100
21110, 금정구,045001, 40세,2017,2859,1462,1397,104.7,2818,1436,1382,103.9
21110, 금정구,045002, 41세,2017,2735,1408,1327,106.1,2691,1388,1303,106.5
21110, 금정구,045003, 42세,2017,2961,1456,1505,96.7,2919,1430,1489,96
21110, 금정구,045004, 43세,2017,3331,1691,1640,103.1,3288,1667,1621,102.8
21110, 금정구,045005, 44세,2017,3515,1701,1814,93.8,3467,1672,1795,93.1
21110, 금정구,050,45~49세,2017,19401,9268,10133,91.5,19169,9165,10004,91.6
21110, 금정구,050001, 45세,2017,3548,1713,1835,93.4,3500,1692,1808,93.6
21110, 금정구,050002, 46세,2017,3908,1863,2045,91.1,3858,1840,2018,91.2
21110, 금정구,050003, 47세,2017,3815,1839,1976,93.1,3768,1818,1950,93.2
21110, 금정구,050004, 48세,2017,4043,1891,2152,87.9,3995,1866,2129,87.6
21110, 금정구,050005, 49세,2017,4087,1962,2125,92.3,4048,1949,2099,92.9
21110, 금정구,055,50~54세,2017,19952,9403,10549,89.1,19755,9306,10449,89.1
21110, 금정구,055001, 50세,2017,3894,1763,2131,82.7,3864,1746,2118,82.4
21110, 금정구,055002, 51세,2017,3899,1876,2023,92.7,3861,1862,1999,93.1
21110, 금정구,055003, 52세,2017,3961,1876,2085,90,3921,1855,2066,89.8
21110, 금정구,055004, 53세,2017,3883,1837,2046,89.8,3836,1809,2027,89.2
21110, 금정구,055005, 54세,2017,4315,2051,2264,90.6,4273,2034,2239,90.8
21110, 금정구,060,55~59세,2017,23329,10938,12391,88.3,23209,10878,12331,88.2
21110, 금정구,060001, 55세,2017,4628,2189,2439,89.7,4605,2176,2429,89.6
21110, 금정구,060002, 56세,2017,4932,2298,2634,87.2,4908,2285,2623,87.1
21110, 금정구,060003, 57세,2017,4866,2237,2629,85.1,4834,2222,2612,85.1
21110, 금정구,060004, 58세,2017,4580,2156,2424,88.9,4559,2146,2413,88.9
21110, 금정구,060005, 59세,2017,4323,2058,2265,90.9,4303,2049,2254,90.9
21110, 금정구,065,60~64세,2017,19534,9257,10277,90.1,19454,9215,10239,90
21110, 금정구,065001, 60세,2017,4368,2114,2254,93.8,4350,2105,2245,93.8
21110, 금정구,065002, 61세,2017,4029,1930,2099,91.9,4011,1918,2093,91.6
21110, 금정구,065003, 62세,2017,4343,2017,2326,86.7,4322,2006,2316,86.6
21110, 금정구,065004, 63세,2017,3500,1674,1826,91.7,3487,1668,1819,91.7
21110, 금정구,065005, 64세,2017,3294,1522,1772,85.9,3284,1518,1766,86
21110, 금정구,070,65~69세,2017,14627,6913,7714,89.6,14604,6902,7702,89.6
21110, 금정구,070001, 65세,2017,3458,1631,1827,89.3,3453,1629,1824,89.3
21110, 금정구,070002, 66세,2017,2735,1289,1446,89.1,2726,1285,1441,89.2
21110, 금정구,070003, 67세,2017,2792,1345,1447,93,2790,1345,1445,93.1
21110, 금정구,070004, 68세,2017,2877,1318,1559,84.5,2872,1315,1557,84.5
21110, 금정구,070005, 69세,2017,2765,1330,1435,92.7,2763,1328,1435,92.5
21110, 금정구,075,70~74세,2017,10382,4901,5481,89.4,10370,4893,5477,89.3
21110, 금정구,075001, 70세,2017,2508,1171,1337,87.6,2503,1168,1335,87.5
21110, 금정구,075002, 71세,2017,1932,918,1014,90.5,1928,916,1012,90.5
21110, 금정구,075003, 72세,2017,1917,905,1012,89.4,1917,905,1012,89.4
21110, 금정구,075004, 73세,2017,1987,933,1054,88.5,1986,932,1054,88.4
21110, 금정구,075005, 74세,2017,2038,974,1064,91.5,2036,972,1064,91.4
21110, 금정구,080,75~79세,2017,8383,3596,4787,75.1,8379,3594,4785,75.1
21110, 금정구,080001, 75세,2017,2127,958,1169,82,2127,958,1169,82
21110, 금정구,080002, 76세,2017,1826,809,1017,79.5,1825,808,1017,79.4
21110, 금정구,080003, 77세,2017,1609,662,947,69.9,1609,662,947,69.9
21110, 금정구,080004, 78세,2017,1487,616,871,70.7,1487,616,871,70.7
21110, 금정구,080005, 79세,2017,1334,551,783,70.4,1331,550,781,70.4
21110, 금정구,085,80~84세,2017,4943,1777,3166,56.1,4933,1773,3160,56.1
21110, 금정구,085001, 80세,2017,1214,485,729,66.5,1212,485,727,66.7
21110, 금정구,085002, 81세,2017,1069,386,683,56.5,1065,384,681,56.4
21110, 금정구,085003, 82세,2017,1046,367,679,54.1,1046,367,679,54.1
21110, 금정구,085004, 83세,2017,919,308,611,50.4,918,307,611,50.2
21110, 금정구,085005, 84세,2017,695,231,464,49.8,692,230,462,49.8
21110, 금정구,090,85~89세,2017,2270,604,1666,36.3,2267,603,1664,36.2
21110, 금정구,090001, 85세,2017,616,189,427,44.3,614,188,426,44.1
21110, 금정구,090002, 86세,2017,529,135,394,34.3,529,135,394,34.3
21110, 금정구,090003, 87세,2017,439,116,323,35.9,439,116,323,35.9
21110, 금정구,090004, 88세,2017,359,84,275,30.5,359,84,275,30.5
21110, 금정구,090005, 89세,2017,327,80,247,32.4,326,80,246,32.5
21110, 금정구,095,90~94세,2017,767,143,624,22.9,767,143,624,22.9
21110, 금정구,095001, 90세,2017,234,45,189,23.8,234,45,189,23.8
21110, 금정구,095002, 91세,2017,172,38,134,28.4,172,38,134,28.4
21110, 금정구,095003, 92세,2017,165,25,140,17.9,165,25,140,17.9
21110, 금정구,095004, 93세,2017,104,17,87,19.5,104,17,87,19.5
21110, 금정구,095005, 94세,2017,92,18,74,24.3,92,18,74,24.3
21110, 금정구,100,95~99세,2017,157,25,132,18.9,157,25,132,18.9
21110, 금정구,100001, 95세,2017,69,7,62,11.3,69,7,62,11.3
21110, 금정구,100002, 96세,2017,36,7,29,24.1,36,7,29,24.1
21110, 금정구,100003, 97세,2017,24,5,19,26.3,24,5,19,26.3
21110, 금정구,100004, 98세,2017,15,X,12,25,15,X,12,25
21110, 금정구,100005, 99세,2017,13,X,10,30,13,X,10,30
21110, 금정구,101,100세이상,2017,22,X,21,4.8,22,X,21,4.8
21110, 금정구,102,15세미만,2017,23260,12143,11117,109.2,23187,12113,11074,109.4
21110, 금정구,103,15~64세,2017,182080,90702,91378,99.3,177506,88667,88839,99.8
21110, 금정구,104,65세이상,2017,41551,17960,23591,76.1,41499,17934,23565,76.1
21110, 금정구,086,85세이상,2017,3216,773,2443,31.6,3213,772,2441,31.6
21110, 금정구,126,평균연령,2017,43.5,42,44.9,,43.7,42.2,45.2,
21110, 금정구,127,중위연령,2017,45.1,42.9,47,,45.6,43.3,47.5,
21120, 강서구,000,합계,2017,116702,61825,54877,112.7,110580,56563,54017,104.7
21120, 강서구,005,0~4세,2017,9604,4910,4694,104.6,9574,4897,4677,104.7
21120, 강서구,005001, 0세,2017,1787,898,889,101,1777,894,883,101.2
21120, 강서구,005002, 1세,2017,2021,1030,991,103.9,2018,1028,990,103.8
21120, 강서구,005003, 2세,2017,2034,1024,1010,101.4,2028,1023,1005,101.8
21120, 강서구,005004, 3세,2017,1975,1036,939,110.3,1970,1034,936,110.5
21120, 강서구,005005, 4세,2017,1787,922,865,106.6,1781,918,863,106.4
21120, 강서구,010,5~9세,2017,7736,3988,3748,106.4,7714,3969,3745,106
21120, 강서구,010001, 5세,2017,1894,991,903,109.7,1885,983,902,109
21120, 강서구,010002, 6세,2017,1693,855,838,102,1690,852,838,101.7
21120, 강서구,010003, 7세,2017,1521,785,736,106.7,1519,783,736,106.4
21120, 강서구,010004, 8세,2017,1355,712,643,110.7,1351,709,642,110.4
21120, 강서구,010005, 9세,2017,1273,645,628,102.7,1269,642,627,102.4
21120, 강서구,015,10~14세,2017,4571,2346,2225,105.4,4561,2341,2220,105.5
21120, 강서구,015001, 10세,2017,1102,532,570,93.3,1098,531,567,93.7
21120, 강서구,015002, 11세,2017,912,468,444,105.4,909,467,442,105.7
21120, 강서구,015003, 12세,2017,882,455,427,106.6,882,455,427,106.6
21120, 강서구,015004, 13세,2017,907,482,425,113.4,905,480,425,112.9
21120, 강서구,015005, 14세,2017,768,409,359,113.9,767,408,359,113.6
21120, 강서구,020,15~19세,2017,3907,2046,1861,109.9,3871,2020,1851,109.1
21120, 강서구,020001, 15세,2017,757,367,390,94.1,755,366,389,94.1
21120, 강서구,020002, 16세,2017,846,428,418,102.4,841,425,416,102.2
21120, 강서구,020003, 17세,2017,812,450,362,124.3,809,447,362,123.5
21120, 강서구,020004, 18세,2017,747,401,346,115.9,739,395,344,114.8
21120, 강서구,020005, 19세,2017,745,400,345,115.9,727,387,340,113.8
21120, 강서구,025,20~24세,2017,4968,2927,2041,143.4,4370,2402,1968,122.1
21120, 강서구,025001, 20세,2017,753,444,309,143.7,728,423,305,138.7
21120, 강서구,025002, 21세,2017,924,537,387,138.8,845,475,370,128.4
21120, 강서구,025003, 22세,2017,979,598,381,157,857,493,364,135.4
21120, 강서구,025004, 23세,2017,1054,627,427,146.8,902,489,413,118.4
21120, 강서구,025005, 24세,2017,1258,721,537,134.3,1038,522,516,101.2
21120, 강서구,030,25~29세,2017,7838,4538,3300,137.5,6193,3085,3108,99.3
21120, 강서구,030001, 25세,2017,1359,804,555,144.9,1072,556,516,107.8
21120, 강서구,030002, 26세,2017,1380,805,575,140,1082,540,542,99.6
21120, 강서구,030003, 27세,2017,1528,903,625,144.5,1185,599,586,102.2
21120, 강서구,030004, 28세,2017,1750,995,755,131.8,1386,669,717,93.3
21120, 강서구,030005, 29세,2017,1821,1031,790,130.5,1468,721,747,96.5
21120, 강서구,035,30~34세,2017,12381,6801,5580,121.9,10757,5333,5424,98.3
21120, 강서구,035001, 30세,2017,2069,1159,910,127.4,1693,815,878,92.8
21120, 강서구,035002, 31세,2017,2165,1186,979,121.1,1829,884,945,93.5
21120, 강서구,035003, 32세,2017,2390,1310,1080,121.3,2042,998,1044,95.6
21120, 강서구,035004, 33세,2017,2735,1483,1252,118.5,2434,1207,1227,98.4
21120, 강서구,035005, 34세,2017,3022,1663,1359,122.4,2759,1429,1330,107.4
21120, 강서구,040,35~39세,2017,14781,8205,6576,124.8,13807,7341,6466,113.5
21120, 강서구,040001, 35세,2017,3317,1861,1456,127.8,3058,1623,1435,113.1
21120, 강서구,040002, 36세,2017,3225,1725,1500,115,3026,1550,1476,105
21120, 강서구,040003, 37세,2017,3055,1686,1369,123.2,2861,1515,1346,112.6
21120, 강서구,040004, 38세,2017,2790,1553,1237,125.5,2611,1394,1217,114.5
21120, 강서구,040005, 39세,2017,2394,1380,1014,136.1,2251,1259,992,126.9
21120, 강서구,045,40~44세,2017,9587,5555,4032,137.8,9081,5130,3951,129.8
21120, 강서구,045001, 40세,2017,2188,1256,932,134.8,2046,1130,916,123.4
21120, 강서구,045002, 41세,2017,1895,1128,767,147.1,1787,1033,754,137
21120, 강서구,045003, 42세,2017,1954,1121,833,134.6,1843,1027,816,125.9
21120, 강서구,045004, 43세,2017,1830,1088,742,146.6,1755,1028,727,141.4
21120, 강서구,045005, 44세,2017,1720,962,758,126.9,1650,912,738,123.6
21120, 강서구,050,45~49세,2017,7486,4137,3349,123.5,7212,3921,3291,119.1
21120, 강서구,050001, 45세,2017,1557,909,648,140.3,1492,856,636,134.6
21120, 강서구,050002, 46세,2017,1602,912,690,132.2,1545,868,677,128.2
21120, 강서구,050003, 47세,2017,1477,782,695,112.5,1423,744,679,109.6
21120, 강서구,050004, 48세,2017,1439,800,639,125.2,1384,756,628,120.4
21120, 강서구,050005, 49세,2017,1411,734,677,108.4,1368,697,671,103.9
21120, 강서구,055,50~54세,2017,6791,3488,3303,105.6,6610,3365,3245,103.7
21120, 강서구,055001, 50세,2017,1332,668,664,100.6,1292,636,656,97
21120, 강서구,055002, 51세,2017,1322,711,611,116.4,1274,678,596,113.8
21120, 강서구,055003, 52세,2017,1335,688,647,106.3,1304,671,633,106
21120, 강서구,055004, 53세,2017,1322,649,673,96.4,1295,632,663,95.3
21120, 강서구,055005, 54세,2017,1480,772,708,109,1445,748,697,107.3
21120, 강서구,060,55~59세,2017,8330,4047,4283,94.5,8222,3983,4239,94
21120, 강서구,060001, 55세,2017,1619,776,843,92.1,1591,756,835,90.5
21120, 강서구,060002, 56세,2017,1730,826,904,91.4,1707,812,895,90.7
21120, 강서구,060003, 57세,2017,1752,854,898,95.1,1727,836,891,93.8
21120, 강서구,060004, 58세,2017,1589,764,825,92.6,1571,759,812,93.5
21120, 강서구,060005, 59세,2017,1640,827,813,101.7,1626,820,806,101.7
21120, 강서구,065,60~64세,2017,6868,3421,3447,99.2,6798,3379,3419,98.8
21120, 강서구,065001, 60세,2017,1577,767,810,94.7,1560,754,806,93.5
21120, 강서구,065002, 61세,2017,1445,709,736,96.3,1432,701,731,95.9
21120, 강서구,065003, 62세,2017,1503,777,726,107,1486,768,718,107
21120, 강서구,065004, 63세,2017,1232,615,617,99.7,1222,608,614,99
21120, 강서구,065005, 64세,2017,1111,553,558,99.1,1098,548,550,99.6
21120, 강서구,070,65~69세,2017,4454,2281,2173,105,4424,2268,2156,105.2
21120, 강서구,070001, 65세,2017,1075,553,522,105.9,1067,550,517,106.4
21120, 강서구,070002, 66세,2017,936,491,445,110.3,929,489,440,111.1
21120, 강서구,070003, 67세,2017,838,448,390,114.9,835,447,388,115.2
21120, 강서구,070004, 68세,2017,837,404,433,93.3,829,399,430,92.8
21120, 강서구,070005, 69세,2017,768,385,383,100.5,764,383,381,100.5
21120, 강서구,075,70~74세,2017,2918,1452,1466,99,2910,1447,1463,98.9
21120, 강서구,075001, 70세,2017,738,395,343,115.2,737,394,343,114.9
21120, 강서구,075002, 71세,2017,577,292,285,102.5,574,290,284,102.1
21120, 강서구,075003, 72세,2017,519,252,267,94.4,518,252,266,94.7
21120, 강서구,075004, 73세,2017,558,276,282,97.9,557,275,282,97.5
21120, 강서구,075005, 74세,2017,526,237,289,82,524,236,288,81.9
21120, 강서구,080,75~79세,2017,2336,1021,1315,77.6,2333,1021,1312,77.8
21120, 강서구,080001, 75세,2017,598,281,317,88.6,598,281,317,88.6
21120, 강서구,080002, 76세,2017,511,239,272,87.9,510,239,271,88.2
21120, 강서구,080003, 77세,2017,448,194,254,76.4,448,194,254,76.4
21120, 강서구,080004, 78세,2017,428,177,251,70.5,428,177,251,70.5
21120, 강서구,080005, 79세,2017,351,130,221,58.8,349,130,219,59.4
21120, 강서구,085,80~84세,2017,1285,453,832,54.4,1283,453,830,54.6
21120, 강서구,085001, 80세,2017,332,138,194,71.1,331,138,193,71.5
21120, 강서구,085002, 81세,2017,268,79,189,41.8,268,79,189,41.8
21120, 강서구,085003, 82세,2017,266,89,177,50.3,266,89,177,50.3
21120, 강서구,085004, 83세,2017,239,82,157,52.2,239,82,157,52.2
21120, 강서구,085005, 84세,2017,180,65,115,56.5,179,65,114,57
21120, 강서구,090,85~89세,2017,635,164,471,34.8,635,164,471,34.8
21120, 강서구,090001, 85세,2017,178,51,127,40.2,178,51,127,40.2
21120, 강서구,090002, 86세,2017,134,39,95,41.1,134,39,95,41.1
21120, 강서구,090003, 87세,2017,130,30,100,30,130,30,100,30
21120, 강서구,090004, 88세,2017,118,30,88,34.1,118,30,88,34.1
21120, 강서구,090005, 89세,2017,75,14,61,23,75,14,61,23
21120, 강서구,095,90~94세,2017,182,34,148,23,181,33,148,22.3
21120, 강서구,095001, 90세,2017,67,12,55,21.8,67,12,55,21.8
21120, 강서구,095002, 91세,2017,34,5,29,17.2,34,5,29,17.2
21120, 강서구,095003, 92세,2017,40,8,32,25,39,7,32,21.9
21120, 강서구,095004, 93세,2017,23,5,18,27.8,23,5,18,27.8
21120, 강서구,095005, 94세,2017,18,X,14,28.6,18,X,14,28.6
21120, 강서구,100,95~99세,2017,40,11,29,37.9,40,11,29,37.9
21120, 강서구,100001, 95세,2017,17,5,12,41.7,17,5,12,41.7
21120, 강서구,100002, 96세,2017,8,X,6,33.3,8,X,6,33.3
21120, 강서구,100003, 97세,2017,10,X,9,11.1,10,X,9,11.1
21120, 강서구,100004, 98세,2017,X,X,X,,X,X,X,
21120, 강서구,100005, 99세,2017,X,X,X,50,X,X,X,50
21120, 강서구,101,100세이상,2017,X,X,X,0,X,X,X,0
21120, 강서구,102,15세미만,2017,21911,11244,10667,105.4,21849,11207,10642,105.3
21120, 강서구,103,15~64세,2017,82937,45165,37772,119.6,76921,39959,36962,108.1
21120, 강서구,104,65세이상,2017,11854,5416,6438,84.1,11810,5397,6413,84.2
21120, 강서구,086,85세이상,2017,861,209,652,32.1,860,208,652,31.9
21120, 강서구,126,평균연령,2017,37.6,36.9,38.4,,37.8,37.2,38.5,
21120, 강서구,127,중위연령,2017,37.3,36.9,37.8,,37.8,37.7,37.8,
21130, 연제구,000,합계,2017,201053,97219,103834,93.6,200146,96845,103301,93.8
21130, 연제구,005,0~4세,2017,7515,3810,3705,102.8,7502,3805,3697,102.9
21130, 연제구,005001, 0세,2017,1298,683,615,111.1,1294,681,613,111.1
21130, 연제구,005002, 1세,2017,1581,796,785,101.4,1579,795,784,101.4
21130, 연제구,005003, 2세,2017,1572,788,784,100.5,1571,788,783,100.6
21130, 연제구,005004, 3세,2017,1562,810,752,107.7,1560,810,750,108
21130, 연제구,005005, 4세,2017,1502,733,769,95.3,1498,731,767,95.3
21130, 연제구,010,5~9세,2017,7822,4003,3819,104.8,7818,4002,3816,104.9
21130, 연제구,010001, 5세,2017,1683,834,849,98.2,1683,834,849,98.2
21130, 연제구,010002, 6세,2017,1625,850,775,109.7,1625,850,775,109.7
21130, 연제구,010003, 7세,2017,1557,787,770,102.2,1554,787,767,102.6
21130, 연제구,010004, 8세,2017,1427,750,677,110.8,1427,750,677,110.8
21130, 연제구,010005, 9세,2017,1530,782,748,104.5,1529,781,748,104.4
21130, 연제구,015,10~14세,2017,7808,4041,3767,107.3,7804,4039,3765,107.3
21130, 연제구,015001, 10세,2017,1620,853,767,111.2,1620,853,767,111.2
21130, 연제구,015002, 11세,2017,1460,769,691,111.3,1460,769,691,111.3
21130, 연제구,015003, 12세,2017,1474,760,714,106.4,1473,759,714,106.3
21130, 연제구,015004, 13세,2017,1555,789,766,103,1554,789,765,103.1
21130, 연제구,015005, 14세,2017,1699,870,829,104.9,1697,869,828,105
21130, 연제구,020,15~19세,2017,10068,5243,4825,108.7,10051,5232,4819,108.6
21130, 연제구,020001, 15세,2017,1666,841,825,101.9,1664,840,824,101.9
21130, 연제구,020002, 16세,2017,1878,1015,863,117.6,1877,1014,863,117.5
21130, 연제구,020003, 17세,2017,2076,1074,1002,107.2,2073,1073,1000,107.3
21130, 연제구,020004, 18세,2017,2080,1089,991,109.9,2078,1087,991,109.7
21130, 연제구,020005, 19세,2017,2368,1224,1144,107,2359,1218,1141,106.7
21130, 연제구,025,20~24세,2017,12923,6761,6162,109.7,12840,6735,6105,110.3
21130, 연제구,025001, 20세,2017,2390,1233,1157,106.6,2384,1231,1153,106.8
21130, 연제구,025002, 21세,2017,2683,1442,1241,116.2,2668,1440,1228,117.3
21130, 연제구,025003, 22세,2017,2568,1322,1246,106.1,2552,1318,1234,106.8
21130, 연제구,025004, 23세,2017,2629,1369,1260,108.7,2609,1359,1250,108.7
21130, 연제구,025005, 24세,2017,2653,1395,1258,110.9,2627,1387,1240,111.9
21130, 연제구,030,25~29세,2017,12356,6193,6163,100.5,12199,6146,6053,101.5
21130, 연제구,030001, 25세,2017,2709,1413,1296,109,2687,1404,1283,109.4
21130, 연제구,030002, 26세,2017,2568,1286,1282,100.3,2534,1278,1256,101.8
21130, 연제구,030003, 27세,2017,2409,1180,1229,96,2381,1170,1211,96.6
21130, 연제구,030004, 28세,2017,2455,1250,1205,103.7,2418,1238,1180,104.9
21130, 연제구,030005, 29세,2017,2215,1064,1151,92.4,2179,1056,1123,94
21130, 연제구,035,30~34세,2017,12422,6285,6137,102.4,12282,6223,6059,102.7
21130, 연제구,035001, 30세,2017,2268,1167,1101,106,2231,1151,1080,106.6
21130, 연제구,035002, 31세,2017,2395,1226,1169,104.9,2363,1213,1150,105.5
21130, 연제구,035003, 32세,2017,2377,1156,1221,94.7,2352,1145,1207,94.9
21130, 연제구,035004, 33세,2017,2596,1327,1269,104.6,2573,1321,1252,105.5
21130, 연제구,035005, 34세,2017,2786,1409,1377,102.3,2763,1393,1370,101.7
21130, 연제구,040,35~39세,2017,15494,7634,7860,97.1,15373,7589,7784,97.5
21130, 연제구,040001, 35세,2017,3111,1550,1561,99.3,3075,1538,1537,100.1
21130, 연제구,040002, 36세,2017,3249,1641,1608,102.1,3227,1636,1591,102.8
21130, 연제구,040003, 37세,2017,3319,1633,1686,96.9,3297,1624,1673,97.1
21130, 연제구,040004, 38세,2017,3067,1503,1564,96.1,3050,1495,1555,96.1
21130, 연제구,040005, 39세,2017,2748,1307,1441,90.7,2724,1296,1428,90.8
21130, 연제구,045,40~44세,2017,14686,7266,7420,97.9,14588,7216,7372,97.9
21130, 연제구,045001, 40세,2017,2725,1326,1399,94.8,2706,1316,1390,94.7
21130, 연제구,045002, 41세,2017,2754,1387,1367,101.5,2740,1382,1358,101.8
21130, 연제구,045003, 42세,2017,2808,1398,1410,99.1,2791,1387,1404,98.8
21130, 연제구,045004, 43세,2017,3211,1605,1606,99.9,3187,1594,1593,100.1
21130, 연제구,045005, 44세,2017,3188,1550,1638,94.6,3164,1537,1627,94.5
21130, 연제구,050,45~49세,2017,16795,8102,8693,93.2,16715,8067,8648,93.3
21130, 연제구,050001, 45세,2017,3289,1637,1652,99.1,3277,1630,1647,99
21130, 연제구,050002, 46세,2017,3396,1652,1744,94.7,3384,1644,1740,94.5
21130, 연제구,050003, 47세,2017,3325,1605,1720,93.3,3310,1601,1709,93.7
21130, 연제구,050004, 48세,2017,3297,1555,1742,89.3,3273,1545,1728,89.4
21130, 연제구,050005, 49세,2017,3488,1653,1835,90.1,3471,1647,1824,90.3
21130, 연제구,055,50~54세,2017,15701,7435,8266,89.9,15620,7399,8221,90
21130, 연제구,055001, 50세,2017,3325,1553,1772,87.6,3306,1543,1763,87.5
21130, 연제구,055002, 51세,2017,3093,1520,1573,96.6,3083,1514,1569,96.5
21130, 연제구,055003, 52세,2017,3142,1469,1673,87.8,3125,1460,1665,87.7
21130, 연제구,055004, 53세,2017,2907,1405,1502,93.5,2888,1400,1488,94.1
21130, 연제구,055005, 54세,2017,3234,1488,1746,85.2,3218,1482,1736,85.4
21130, 연제구,060,55~59세,2017,18332,8431,9901,85.2,18291,8408,9883,85.1
21130, 연제구,060001, 55세,2017,3493,1645,1848,89,3486,1640,1846,88.8
21130, 연제구,060002, 56세,2017,3883,1761,2122,83,3875,1758,2117,83
21130, 연제구,060003, 57세,2017,3891,1769,2122,83.4,3881,1763,2118,83.2
21130, 연제구,060004, 58세,2017,3552,1615,1937,83.4,3544,1609,1935,83.2
21130, 연제구,060005, 59세,2017,3513,1641,1872,87.7,3505,1638,1867,87.7
21130, 연제구,065,60~64세,2017,16069,7578,8491,89.2,16033,7564,8469,89.3
21130, 연제구,065001, 60세,2017,3584,1677,1907,87.9,3576,1674,1902,88
21130, 연제구,065002, 61세,2017,3414,1604,1810,88.6,3401,1598,1803,88.6
21130, 연제구,065003, 62세,2017,3493,1616,1877,86.1,3490,1615,1875,86.1
21130, 연제구,065004, 63세,2017,2930,1433,1497,95.7,2921,1431,1490,96
21130, 연제구,065005, 64세,2017,2648,1248,1400,89.1,2645,1246,1399,89.1
21130, 연제구,070,65~69세,2017,11817,5512,6305,87.4,11798,5501,6297,87.4
21130, 연제구,070001, 65세,2017,2792,1264,1528,82.7,2785,1261,1524,82.7
21130, 연제구,070002, 66세,2017,2204,1032,1172,88.1,2201,1031,1170,88.1
21130, 연제구,070003, 67세,2017,2234,1085,1149,94.4,2234,1085,1149,94.4
21130, 연제구,070004, 68세,2017,2334,1100,1234,89.1,2331,1098,1233,89.1
21130, 연제구,070005, 69세,2017,2253,1031,1222,84.4,2247,1026,1221,84
21130, 연제구,075,70~74세,2017,8463,3964,4499,88.1,8458,3961,4497,88.1
21130, 연제구,075001, 70세,2017,2144,982,1162,84.5,2143,981,1162,84.4
21130, 연제구,075002, 71세,2017,1553,770,783,98.3,1550,768,782,98.2
21130, 연제구,075003, 72세,2017,1529,728,801,90.9,1528,728,800,91
21130, 연제구,075004, 73세,2017,1551,702,849,82.7,1551,702,849,82.7
21130, 연제구,075005, 74세,2017,1686,782,904,86.5,1686,782,904,86.5
21130, 연제구,080,75~79세,2017,6740,3036,3704,82,6733,3033,3700,82
21130, 연제구,080001, 75세,2017,1731,841,890,94.5,1727,839,888,94.5
21130, 연제구,080002, 76세,2017,1512,658,854,77,1511,657,854,76.9
21130, 연제구,080003, 77세,2017,1278,561,717,78.2,1277,561,716,78.4
21130, 연제구,080004, 78세,2017,1230,544,686,79.3,1230,544,686,79.3
21130, 연제구,080005, 79세,2017,989,432,557,77.6,988,432,556,77.7
21130, 연제구,085,80~84세,2017,3707,1363,2344,58.1,3707,1363,2344,58.1
21130, 연제구,085001, 80세,2017,978,382,596,64.1,978,382,596,64.1
21130, 연제구,085002, 81세,2017,851,344,507,67.9,851,344,507,67.9
21130, 연제구,085003, 82세,2017,748,274,474,57.8,748,274,474,57.8
21130, 연제구,085004, 83세,2017,632,198,434,45.6,632,198,434,45.6
21130, 연제구,085005, 84세,2017,498,165,333,49.5,498,165,333,49.5
21130, 연제구,090,85~89세,2017,1684,438,1246,35.2,1683,438,1245,35.2
21130, 연제구,090001, 85세,2017,475,130,345,37.7,475,130,345,37.7
21130, 연제구,090002, 86세,2017,387,102,285,35.8,387,102,285,35.8
21130, 연제구,090003, 87세,2017,321,85,236,36,320,85,235,36.2
21130, 연제구,090004, 88세,2017,285,77,208,37,285,77,208,37
21130, 연제구,090005, 89세,2017,216,44,172,25.6,216,44,172,25.6
21130, 연제구,095,90~94세,2017,515,103,412,25,515,103,412,25
21130, 연제구,095001, 90세,2017,175,37,138,26.8,175,37,138,26.8
21130, 연제구,095002, 91세,2017,107,23,84,27.4,107,23,84,27.4
21130, 연제구,095003, 92세,2017,101,21,80,26.3,101,21,80,26.3
21130, 연제구,095004, 93세,2017,74,13,61,21.3,74,13,61,21.3
21130, 연제구,095005, 94세,2017,58,9,49,18.4,58,9,49,18.4
21130, 연제구,100,95~99세,2017,117,19,98,19.4,117,19,98,19.4
21130, 연제구,100001, 95세,2017,41,7,34,20.6,41,7,34,20.6
21130, 연제구,100002, 96세,2017,36,6,30,20,36,6,30,20
21130, 연제구,100003, 97세,2017,22,X,18,22.2,22,X,18,22.2
21130, 연제구,100004, 98세,2017,11,X,10,10,11,X,10,10
21130, 연제구,100005, 99세,2017,7,X,6,16.7,7,X,6,16.7
21130, 연제구,101,100세이상,2017,19,X,17,11.8,19,X,17,11.8
21130, 연제구,102,15세미만,2017,23145,11854,11291,105,23124,11846,11278,105
21130, 연제구,103,15~64세,2017,144846,70928,73918,96,143992,70579,73413,96.1
21130, 연제구,104,65세이상,2017,33062,14437,18625,77.5,33030,14420,18610,77.5
21130, 연제구,086,85세이상,2017,2335,562,1773,31.7,2334,562,1772,31.7
21130, 연제구,126,평균연령,2017,43.3,42.1,44.5,,43.4,42.1,44.6,
21130, 연제구,127,중위연령,2017,44.8,43.3,46.2,,44.9,43.4,46.3,
21140, 수영구,000,합계,2017,173059,82221,90838,90.5,171570,81499,90071,90.5
21140, 수영구,005,0~4세,2017,5822,2936,2886,101.7,5794,2922,2872,101.7
21140, 수영구,005001, 0세,2017,1105,526,579,90.8,1097,524,573,91.4
21140, 수영구,005002, 1세,2017,1194,601,593,101.3,1191,599,592,101.2
21140, 수영구,005003, 2세,2017,1251,635,616,103.1,1244,628,616,101.9
21140, 수영구,005004, 3세,2017,1153,601,552,108.9,1145,598,547,109.3
21140, 수영구,005005, 4세,2017,1119,573,546,104.9,1117,573,544,105.3
21140, 수영구,010,5~9세,2017,5409,2816,2593,108.6,5394,2810,2584,108.7
21140, 수영구,010001, 5세,2017,1176,617,559,110.4,1174,616,558,110.4
21140, 수영구,010002, 6세,2017,1134,580,554,104.7,1130,578,552,104.7
21140, 수영구,010003, 7세,2017,989,535,454,117.8,984,533,451,118.2
21140, 수영구,010004, 8세,2017,1026,522,504,103.6,1024,522,502,104
21140, 수영구,010005, 9세,2017,1084,562,522,107.7,1082,561,521,107.7
21140, 수영구,015,10~14세,2017,5561,2911,2650,109.8,5555,2907,2648,109.8
21140, 수영구,015001, 10세,2017,1105,546,559,97.7,1104,546,558,97.8
21140, 수영구,015002, 11세,2017,983,529,454,116.5,983,529,454,116.5
21140, 수영구,015003, 12세,2017,1083,574,509,112.8,1082,573,509,112.6
21140, 수영구,015004, 13세,2017,1209,645,564,114.4,1208,644,564,114.2
21140, 수영구,015005, 14세,2017,1181,617,564,109.4,1178,615,563,109.2
21140, 수영구,020,15~19세,2017,7280,3773,3507,107.6,7261,3759,3502,107.3
21140, 수영구,020001, 15세,2017,1223,615,608,101.2,1223,615,608,101.2
21140, 수영구,020002, 16세,2017,1391,715,676,105.8,1388,712,676,105.3
21140, 수영구,020003, 17세,2017,1531,778,753,103.3,1526,773,753,102.7
21140, 수영구,020004, 18세,2017,1542,799,743,107.5,1536,796,740,107.6
21140, 수영구,020005, 19세,2017,1593,866,727,119.1,1588,863,725,119
21140, 수영구,025,20~24세,2017,10475,5364,5111,105,10342,5309,5033,105.5
21140, 수영구,025001, 20세,2017,1789,929,860,108,1777,924,853,108.3
21140, 수영구,025002, 21세,2017,2002,1117,885,126.2,1988,1111,877,126.7
21140, 수영구,025003, 22세,2017,2041,1049,992,105.7,2017,1040,977,106.4
21140, 수영구,025004, 23세,2017,2240,1077,1163,92.6,2212,1066,1146,93
21140, 수영구,025005, 24세,2017,2403,1192,1211,98.4,2348,1168,1180,99
21140, 수영구,030,25~29세,2017,12009,5840,6169,94.7,11756,5740,6016,95.4
21140, 수영구,030001, 25세,2017,2500,1198,1302,92,2457,1178,1279,92.1
21140, 수영구,030002, 26세,2017,2523,1247,1276,97.7,2454,1213,1241,97.7
21140, 수영구,030003, 27세,2017,2434,1162,1272,91.4,2391,1152,1239,93
21140, 수영구,030004, 28세,2017,2418,1211,1207,100.3,2369,1191,1178,101.1
21140, 수영구,030005, 29세,2017,2134,1022,1112,91.9,2085,1006,1079,93.2
21140, 수영구,035,30~34세,2017,11805,5854,5951,98.4,11525,5715,5810,98.4
21140, 수영구,035001, 30세,2017,2258,1106,1152,96,2181,1075,1106,97.2
21140, 수영구,035002, 31세,2017,2333,1135,1198,94.7,2280,1104,1176,93.9
21140, 수영구,035003, 32세,2017,2280,1156,1124,102.8,2226,1130,1096,103.1
21140, 수영구,035004, 33세,2017,2360,1175,1185,99.2,2314,1150,1164,98.8
21140, 수영구,035005, 34세,2017,2574,1282,1292,99.2,2524,1256,1268,99.1
21140, 수영구,040,35~39세,2017,13311,6743,6568,102.7,13126,6639,6487,102.3
21140, 수영구,040001, 35세,2017,2747,1389,1358,102.3,2708,1370,1338,102.4
21140, 수영구,040002, 36세,2017,2769,1403,1366,102.7,2732,1383,1349,102.5
21140, 수영구,040003, 37세,2017,2807,1433,1374,104.3,2766,1409,1357,103.8
21140, 수영구,040004, 38세,2017,2661,1332,1329,100.2,2629,1315,1314,100.1
21140, 수영구,040005, 39세,2017,2327,1186,1141,103.9,2291,1162,1129,102.9
21140, 수영구,045,40~44세,2017,11873,5797,6076,95.4,11712,5710,6002,95.1
21140, 수영구,045001, 40세,2017,2302,1127,1175,95.9,2257,1104,1153,95.8
21140, 수영구,045002, 41세,2017,2145,1081,1064,101.6,2117,1068,1049,101.8
21140, 수영구,045003, 42세,2017,2329,1124,1205,93.3,2300,1108,1192,93
21140, 수영구,045004, 43세,2017,2526,1234,1292,95.5,2492,1213,1279,94.8
21140, 수영구,045005, 44세,2017,2571,1231,1340,91.9,2546,1217,1329,91.6
21140, 수영구,050,45~49세,2017,13762,6584,7178,91.7,13650,6524,7126,91.6
21140, 수영구,050001, 45세,2017,2675,1333,1342,99.3,2654,1321,1333,99.1
21140, 수영구,050002, 46세,2017,2830,1349,1481,91.1,2803,1336,1467,91.1
21140, 수영구,050003, 47세,2017,2812,1342,1470,91.3,2789,1326,1463,90.6
21140, 수영구,050004, 48세,2017,2712,1276,1436,88.9,2687,1264,1423,88.8
21140, 수영구,050005, 49세,2017,2733,1284,1449,88.6,2717,1277,1440,88.7
21140, 수영구,055,50~54세,2017,12894,5910,6984,84.6,12802,5860,6942,84.4
21140, 수영구,055001, 50세,2017,2585,1190,1395,85.3,2567,1179,1388,84.9
21140, 수영구,055002, 51세,2017,2469,1171,1298,90.2,2457,1165,1292,90.2
21140, 수영구,055003, 52세,2017,2555,1184,1371,86.4,2530,1171,1359,86.2
21140, 수영구,055004, 53세,2017,2467,1106,1361,81.3,2452,1098,1354,81.1
21140, 수영구,055005, 54세,2017,2818,1259,1559,80.8,2796,1247,1549,80.5
21140, 수영구,060,55~59세,2017,15851,6987,8864,78.8,15777,6955,8822,78.8
21140, 수영구,060001, 55세,2017,2939,1304,1635,79.8,2918,1296,1622,79.9
21140, 수영구,060002, 56세,2017,3276,1416,1860,76.1,3264,1407,1857,75.8
21140, 수영구,060003, 57세,2017,3320,1463,1857,78.8,3307,1459,1848,79
21140, 수영구,060004, 58세,2017,3186,1424,1762,80.8,3176,1419,1757,80.8
21140, 수영구,060005, 59세,2017,3130,1380,1750,78.9,3112,1374,1738,79.1
21140, 수영구,065,60~64세,2017,14717,6678,8039,83.1,14644,6646,7998,83.1
21140, 수영구,065001, 60세,2017,3183,1423,1760,80.9,3161,1412,1749,80.7
21140, 수영구,065002, 61세,2017,3023,1365,1658,82.3,3006,1359,1647,82.5
21140, 수영구,065003, 62세,2017,3244,1453,1791,81.1,3231,1445,1786,80.9
21140, 수영구,065004, 63세,2017,2784,1305,1479,88.2,2777,1303,1474,88.4
21140, 수영구,065005, 64세,2017,2483,1132,1351,83.8,2469,1127,1342,84
21140, 수영구,070,65~69세,2017,11333,5200,6133,84.8,11300,5187,6113,84.9
21140, 수영구,070001, 65세,2017,2653,1224,1429,85.7,2646,1223,1423,85.9
21140, 수영구,070002, 66세,2017,2024,924,1100,84,2014,918,1096,83.8
21140, 수영구,070003, 67세,2017,2194,954,1240,76.9,2189,953,1236,77.1
21140, 수영구,070004, 68세,2017,2252,1087,1165,93.3,2244,1082,1162,93.1
21140, 수영구,070005, 69세,2017,2210,1011,1199,84.3,2207,1011,1196,84.5
21140, 수영구,075,70~74세,2017,8263,3869,4394,88.1,8255,3864,4391,88
21140, 수영구,075001, 70세,2017,2153,966,1187,81.4,2152,966,1186,81.5
21140, 수영구,075002, 71세,2017,1604,790,814,97.1,1600,787,813,96.8
21140, 수영구,075003, 72세,2017,1424,675,749,90.1,1423,675,748,90.2
21140, 수영구,075004, 73세,2017,1548,720,828,87,1547,719,828,86.8
21140, 수영구,075005, 74세,2017,1534,718,816,88,1533,717,816,87.9
21140, 수영구,080,75~79세,2017,6504,2905,3599,80.7,6494,2901,3593,80.7
21140, 수영구,080001, 75세,2017,1688,784,904,86.7,1686,783,903,86.7
21140, 수영구,080002, 76세,2017,1366,604,762,79.3,1362,603,759,79.4
21140, 수영구,080003, 77세,2017,1270,575,695,82.7,1267,573,694,82.6
21140, 수영구,080004, 78세,2017,1178,512,666,76.9,1178,512,666,76.9
21140, 수영구,080005, 79세,2017,1002,430,572,75.2,1001,430,571,75.3
21140, 수영구,085,80~84세,2017,3691,1366,2325,58.8,3686,1363,2323,58.7
21140, 수영구,085001, 80세,2017,948,377,571,66,946,376,570,66
21140, 수영구,085002, 81세,2017,801,335,466,71.9,800,334,466,71.7
21140, 수영구,085003, 82세,2017,750,260,490,53.1,749,260,489,53.2
21140, 수영구,085004, 83세,2017,638,212,426,49.8,638,212,426,49.8
21140, 수영구,085005, 84세,2017,554,182,372,48.9,553,181,372,48.7
21140, 수영구,090,85~89세,2017,1813,532,1281,41.5,1813,532,1281,41.5
21140, 수영구,090001, 85세,2017,487,152,335,45.4,487,152,335,45.4
21140, 수영구,090002, 86세,2017,410,132,278,47.5,410,132,278,47.5
21140, 수영구,090003, 87세,2017,323,90,233,38.6,323,90,233,38.6
21140, 수영구,090004, 88세,2017,307,92,215,42.8,307,92,215,42.8
21140, 수영구,090005, 89세,2017,286,66,220,30,286,66,220,30
21140, 수영구,095,90~94세,2017,569,134,435,30.8,568,134,434,30.9
21140, 수영구,095001, 90세,2017,190,53,137,38.7,190,53,137,38.7
21140, 수영구,095002, 91세,2017,143,36,107,33.6,143,36,107,33.6
21140, 수영구,095003, 92세,2017,107,22,85,25.9,107,22,85,25.9
21140, 수영구,095004, 93세,2017,70,12,58,20.7,70,12,58,20.7
21140, 수영구,095005, 94세,2017,59,11,48,22.9,58,11,47,23.4
21140, 수영구,100,95~99세,2017,107,22,85,25.9,106,22,84,26.2
21140, 수영구,100001, 95세,2017,36,8,28,28.6,36,8,28,28.6
21140, 수영구,100002, 96세,2017,27,5,22,22.7,27,5,22,22.7
21140, 수영구,100003, 97세,2017,23,X,20,15,23,X,20,15
21140, 수영구,100004, 98세,2017,10,X,6,66.7,10,X,6,66.7
21140, 수영구,100005, 99세,2017,11,X,9,22.2,10,X,8,25
21140, 수영구,101,100세이상,2017,10,X,10,0,10,X,10,0
21140, 수영구,102,15세미만,2017,16792,8663,8129,106.6,16743,8639,8104,106.6
21140, 수영구,103,15~64세,2017,123977,59530,64447,92.4,122595,58857,63738,92.3
21140, 수영구,104,65세이상,2017,32290,14028,18262,76.8,32232,14003,18229,76.8
21140, 수영구,086,85세이상,2017,2499,688,1811,38,2497,688,1809,38
21140, 수영구,126,평균연령,2017,44.8,43.4,46.1,,44.9,43.5,46.2,
21140, 수영구,127,중위연령,2017,46.1,44.2,47.7,,46.2,44.4,47.9,
21150, 사상구,000,합계,2017,231587,116752,114835,101.7,225854,113521,112333,101.1
21150, 사상구,005,0~4세,2017,7992,4045,3947,102.5,7956,4025,3931,102.4
21150, 사상구,005001, 0세,2017,1436,732,704,104,1428,725,703,103.1
21150, 사상구,005002, 1세,2017,1595,826,769,107.4,1585,819,766,106.9
21150, 사상구,005003, 2세,2017,1682,842,840,100.2,1676,841,835,100.7
21150, 사상구,005004, 3세,2017,1624,832,792,105.1,1617,829,788,105.2
21150, 사상구,005005, 4세,2017,1655,813,842,96.6,1650,811,839,96.7
21150, 사상구,010,5~9세,2017,7826,3995,3831,104.3,7805,3988,3817,104.5
21150, 사상구,010001, 5세,2017,1741,889,852,104.3,1734,888,846,105
21150, 사상구,010002, 6세,2017,1627,830,797,104.1,1626,830,796,104.3
21150, 사상구,010003, 7세,2017,1484,760,724,105,1477,757,720,105.1
21150, 사상구,010004, 8세,2017,1418,729,689,105.8,1415,728,687,106
21150, 사상구,010005, 9세,2017,1556,787,769,102.3,1553,785,768,102.2
21150, 사상구,015,10~14세,2017,7611,4002,3609,110.9,7592,3992,3600,110.9
21150, 사상구,015001, 10세,2017,1491,787,704,111.8,1485,785,700,112.1
21150, 사상구,015002, 11세,2017,1430,761,669,113.8,1425,759,666,114
21150, 사상구,015003, 12세,2017,1375,708,667,106.1,1373,707,666,106.2
21150, 사상구,015004, 13세,2017,1623,852,771,110.5,1618,848,770,110.1
21150, 사상구,015005, 14세,2017,1692,894,798,112,1691,893,798,111.9
21150, 사상구,020,15~19세,2017,11930,6112,5818,105.1,11674,5998,5676,105.7
21150, 사상구,020001, 15세,2017,1703,914,789,115.8,1694,911,783,116.3
21150, 사상구,020002, 16세,2017,1972,1088,884,123.1,1967,1085,882,123
21150, 사상구,020003, 17세,2017,2176,1131,1045,108.2,2163,1126,1037,108.6
21150, 사상구,020004, 18세,2017,2575,1316,1259,104.5,2525,1296,1229,105.5
21150, 사상구,020005, 19세,2017,3504,1663,1841,90.3,3325,1580,1745,90.5
21150, 사상구,025,20~24세,2017,19221,9946,9275,107.2,17838,9295,8543,108.8
21150, 사상구,025001, 20세,2017,3720,1690,2030,83.3,3324,1542,1782,86.5
21150, 사상구,025002, 21세,2017,3737,1854,1883,98.5,3452,1711,1741,98.3
21150, 사상구,025003, 22세,2017,3925,2071,1854,111.7,3692,1959,1733,113
21150, 사상구,025004, 23세,2017,4009,2165,1844,117.4,3768,2049,1719,119.2
21150, 사상구,025005, 24세,2017,3830,2166,1664,130.2,3602,2034,1568,129.7
21150, 사상구,030,25~29세,2017,16375,8948,7427,120.5,15337,8356,6981,119.7
21150, 사상구,030001, 25세,2017,3727,2055,1672,122.9,3515,1933,1582,122.2
21150, 사상구,030002, 26세,2017,3435,1889,1546,122.2,3243,1777,1466,121.2
21150, 사상구,030003, 27세,2017,3238,1760,1478,119.1,3013,1629,1384,117.7
21150, 사상구,030004, 28세,2017,3074,1657,1417,116.9,2873,1544,1329,116.2
21150, 사상구,030005, 29세,2017,2901,1587,1314,120.8,2693,1473,1220,120.7
21150, 사상구,035,30~34세,2017,14823,8027,6796,118.1,13937,7445,6492,114.7
21150, 사상구,035001, 30세,2017,2987,1593,1394,114.3,2773,1461,1312,111.4
21150, 사상구,035002, 31세,2017,2869,1605,1264,127,2679,1486,1193,124.6
21150, 사상구,035003, 32세,2017,2872,1530,1342,114,2690,1416,1274,111.1
21150, 사상구,035004, 33세,2017,2918,1563,1355,115.4,2764,1452,1312,110.7
21150, 사상구,035005, 34세,2017,3177,1736,1441,120.5,3031,1630,1401,116.3
21150, 사상구,040,35~39세,2017,16710,8994,7716,116.6,16134,8617,7517,114.6
21150, 사상구,040001, 35세,2017,3517,1876,1641,114.3,3352,1768,1584,111.6
21150, 사상구,040002, 36세,2017,3537,1898,1639,115.8,3412,1821,1591,114.5
21150, 사상구,040003, 37세,2017,3544,1923,1621,118.6,3434,1842,1592,115.7
21150, 사상구,040004, 38세,2017,3259,1741,1518,114.7,3160,1678,1482,113.2
21150, 사상구,040005, 39세,2017,2853,1556,1297,120,2776,1508,1268,118.9
21150, 사상구,045,40~44세,2017,15218,8076,7142,113.1,14839,7822,7017,111.5
21150, 사상구,045001, 40세,2017,2882,1533,1349,113.6,2793,1471,1322,111.3
21150, 사상구,045002, 41세,2017,2829,1540,1289,119.5,2761,1499,1262,118.8
21150, 사상구,045003, 42세,2017,3002,1569,1433,109.5,2932,1520,1412,107.6
21150, 사상구,045004, 43세,2017,3177,1690,1487,113.7,3094,1641,1453,112.9
21150, 사상구,045005, 44세,2017,3328,1744,1584,110.1,3259,1691,1568,107.8
21150, 사상구,050,45~49세,2017,18716,9290,9426,98.6,18323,9065,9258,97.9
21150, 사상구,050001, 45세,2017,3352,1705,1647,103.5,3274,1661,1613,103
21150, 사상구,050002, 46세,2017,3524,1791,1733,103.3,3445,1746,1699,102.8
21150, 사상구,050003, 47세,2017,3755,1889,1866,101.2,3665,1837,1828,100.5
21150, 사상구,050004, 48세,2017,3944,1930,2014,95.8,3868,1885,1983,95.1
21150, 사상구,050005, 49세,2017,4141,1975,2166,91.2,4071,1936,2135,90.7
21150, 사상구,055,50~54세,2017,20645,10242,10403,98.5,20327,10060,10267,98
21150, 사상구,055001, 50세,2017,4042,1930,2112,91.4,3989,1893,2096,90.3
21150, 사상구,055002, 51세,2017,4057,2042,2015,101.3,3972,1995,1977,100.9
21150, 사상구,055003, 52세,2017,4222,2048,2174,94.2,4160,2016,2144,94
21150, 사상구,055004, 53세,2017,4060,2047,2013,101.7,3993,2013,1980,101.7
21150, 사상구,055005, 54세,2017,4264,2175,2089,104.1,4213,2143,2070,103.5
21150, 사상구,060,55~59세,2017,23927,11894,12033,98.8,23725,11795,11930,98.9
21150, 사상구,060001, 55세,2017,4704,2365,2339,101.1,4643,2338,2305,101.4
21150, 사상구,060002, 56세,2017,5210,2527,2683,94.2,5181,2517,2664,94.5
21150, 사상구,060003, 57세,2017,5156,2547,2609,97.6,5112,2519,2593,97.1
21150, 사상구,060004, 58세,2017,4580,2301,2279,101,4545,2285,2260,101.1
21150, 사상구,060005, 59세,2017,4277,2154,2123,101.5,4244,2136,2108,101.3
21150, 사상구,065,60~64세,2017,18238,9066,9172,98.8,18116,8992,9124,98.6
21150, 사상구,065001, 60세,2017,4158,2081,2077,100.2,4125,2061,2064,99.9
21150, 사상구,065002, 61세,2017,3893,1909,1984,96.2,3866,1893,1973,95.9
21150, 사상구,065003, 62세,2017,3954,1945,2009,96.8,3929,1932,1997,96.7
21150, 사상구,065004, 63세,2017,3372,1706,1666,102.4,3352,1692,1660,101.9
21150, 사상구,065005, 64세,2017,2861,1425,1436,99.2,2844,1414,1430,98.9
21150, 사상구,070,65~69세,2017,12682,6234,6448,96.7,12621,6207,6414,96.8
21150, 사상구,070001, 65세,2017,3021,1491,1530,97.5,3006,1486,1520,97.8
21150, 사상구,070002, 66세,2017,2505,1233,1272,96.9,2494,1225,1269,96.5
21150, 사상구,070003, 67세,2017,2414,1186,1228,96.6,2397,1178,1219,96.6
21150, 사상구,070004, 68세,2017,2415,1173,1242,94.4,2407,1171,1236,94.7
21150, 사상구,070005, 69세,2017,2327,1151,1176,97.9,2317,1147,1170,98
21150, 사상구,075,70~74세,2017,8155,3820,4335,88.1,8137,3811,4326,88.1
21150, 사상구,075001, 70세,2017,2122,1008,1114,90.5,2116,1004,1112,90.3
21150, 사상구,075002, 71세,2017,1497,734,763,96.2,1495,733,762,96.2
21150, 사상구,075003, 72세,2017,1489,670,819,81.8,1484,668,816,81.9
21150, 사상구,075004, 73세,2017,1539,722,817,88.4,1538,721,817,88.2
21150, 사상구,075005, 74세,2017,1508,686,822,83.5,1504,685,819,83.6
21150, 사상구,080,75~79세,2017,6194,2637,3557,74.1,6180,2632,3548,74.2
21150, 사상구,080001, 75세,2017,1578,751,827,90.8,1575,749,826,90.7
21150, 사상구,080002, 76세,2017,1394,600,794,75.6,1389,598,791,75.6
21150, 사상구,080003, 77세,2017,1202,513,689,74.5,1199,513,686,74.8
21150, 사상구,080004, 78세,2017,1069,423,646,65.5,1069,423,646,65.5
21150, 사상구,080005, 79세,2017,951,350,601,58.2,948,349,599,58.3
21150, 사상구,085,80~84세,2017,3356,1020,2336,43.7,3350,1019,2331,43.7
21150, 사상구,085001, 80세,2017,879,304,575,52.9,879,304,575,52.9
21150, 사상구,085002, 81세,2017,734,249,485,51.3,730,249,481,51.8
21150, 사상구,085003, 82세,2017,689,197,492,40,688,196,492,39.8
21150, 사상구,085004, 83세,2017,559,142,417,34.1,558,142,416,34.1
21150, 사상구,085005, 84세,2017,495,128,367,34.9,495,128,367,34.9
21150, 사상구,090,85~89세,2017,1402,332,1070,31,1399,331,1068,31
21150, 사상구,090001, 85세,2017,384,112,272,41.2,384,112,272,41.2
21150, 사상구,090002, 86세,2017,297,76,221,34.4,296,75,221,33.9
21150, 사상구,090003, 87세,2017,284,63,221,28.5,284,63,221,28.5
21150, 사상구,090004, 88세,2017,251,44,207,21.3,251,44,207,21.3
21150, 사상구,090005, 89세,2017,186,37,149,24.8,184,37,147,25.2
21150, 사상구,095,90~94세,2017,456,62,394,15.7,456,62,394,15.7
21150, 사상구,095001, 90세,2017,149,24,125,19.2,149,24,125,19.2
21150, 사상구,095002, 91세,2017,103,14,89,15.7,103,14,89,15.7
21150, 사상구,095003, 92세,2017,93,13,80,16.3,93,13,80,16.3
21150, 사상구,095004, 93세,2017,67,9,58,15.5,67,9,58,15.5
21150, 사상구,095005, 94세,2017,44,X,42,4.8,44,X,42,4.8
21150, 사상구,100,95~99세,2017,103,10,93,10.8,101,9,92,9.8
21150, 사상구,100001, 95세,2017,37,7,30,23.3,35,6,29,20.7
21150, 사상구,100002, 96세,2017,29,X,27,7.4,29,X,27,7.4
21150, 사상구,100003, 97세,2017,15,X,15,0,15,X,15,0
21150, 사상구,100004, 98세,2017,15,X,14,7.1,15,X,14,7.1
21150, 사상구,100005, 99세,2017,7,X,7,0,7,X,7,0
21150, 사상구,101,100세이상,2017,7,X,7,0,7,X,7,0
21150, 사상구,102,15세미만,2017,23429,12042,11387,105.8,23353,12005,11348,105.8
21150, 사상구,103,15~64세,2017,175803,90595,85208,106.3,170250,87445,82805,105.6
21150, 사상구,104,65세이상,2017,32355,14115,18240,77.4,32251,14071,18180,77.4
21150, 사상구,086,85세이상,2017,1968,404,1564,25.8,1963,402,1561,25.8
21150, 사상구,126,평균연령,2017,42.7,41.6,43.8,,42.9,41.8,44,
21150, 사상구,127,중위연령,2017,44.4,42.8,46.1,,44.9,43.3,46.6,
21310, 기장군,000,합계,2017,156561,77587,78974,98.2,154174,75896,78278,97
21310, 기장군,005,0~4세,2017,10071,5133,4938,103.9,10056,5124,4932,103.9
21310, 기장군,005001, 0세,2017,1659,865,794,108.9,1657,863,794,108.7
21310, 기장군,005002, 1세,2017,1983,973,1010,96.3,1982,972,1010,96.2
21310, 기장군,005003, 2세,2017,2127,1087,1040,104.5,2121,1084,1037,104.5
21310, 기장군,005004, 3세,2017,2159,1115,1044,106.8,2154,1112,1042,106.7
21310, 기장군,005005, 4세,2017,2143,1093,1050,104.1,2142,1093,1049,104.2
21310, 기장군,010,5~9세,2017,9899,5068,4831,104.9,9892,5065,4827,104.9
21310, 기장군,010001, 5세,2017,2226,1162,1064,109.2,2223,1161,1062,109.3
21310, 기장군,010002, 6세,2017,2182,1118,1064,105.1,2180,1117,1063,105.1
21310, 기장군,010003, 7세,2017,1931,971,960,101.1,1930,970,960,101
21310, 기장군,010004, 8세,2017,1754,877,877,100,1753,877,876,100.1
21310, 기장군,010005, 9세,2017,1806,940,866,108.5,1806,940,866,108.5
21310, 기장군,015,10~14세,2017,7959,4197,3762,111.6,7951,4192,3759,111.5
21310, 기장군,015001, 10세,2017,1800,946,854,110.8,1800,946,854,110.8
21310, 기장군,015002, 11세,2017,1524,795,729,109.1,1521,793,728,108.9
21310, 기장군,015003, 12세,2017,1512,808,704,114.8,1511,808,703,114.9
21310, 기장군,015004, 13세,2017,1599,860,739,116.4,1597,858,739,116.1
21310, 기장군,015005, 14세,2017,1524,788,736,107.1,1522,787,735,107.1
21310, 기장군,020,15~19세,2017,7534,3941,3593,109.7,7508,3921,3587,109.3
21310, 기장군,020001, 15세,2017,1519,811,708,114.5,1516,810,706,114.7
21310, 기장군,020002, 16세,2017,1584,820,764,107.3,1578,814,764,106.5
21310, 기장군,020003, 17세,2017,1688,836,852,98.1,1684,833,851,97.9
21310, 기장군,020004, 18세,2017,1503,798,705,113.2,1494,791,703,112.5
21310, 기장군,020005, 19세,2017,1240,676,564,119.9,1236,673,563,119.5
21310, 기장군,025,20~24세,2017,7033,3926,3107,126.4,6779,3751,3028,123.9
21310, 기장군,025001, 20세,2017,1321,766,555,138,1306,760,546,139.2
21310, 기장군,025002, 21세,2017,1391,800,591,135.4,1366,782,584,133.9
21310, 기장군,025003, 22세,2017,1385,769,616,124.8,1335,734,601,122.1
21310, 기장군,025004, 23세,2017,1438,771,667,115.6,1365,719,646,111.3
21310, 기장군,025005, 24세,2017,1498,820,678,120.9,1407,756,651,116.1
21310, 기장군,030,25~29세,2017,7717,4154,3563,116.6,7156,3721,3435,108.3
21310, 기장군,030001, 25세,2017,1484,823,661,124.5,1380,746,634,117.7
21310, 기장군,030002, 26세,2017,1554,827,727,113.8,1452,746,706,105.7
21310, 기장군,030003, 27세,2017,1491,814,677,120.2,1375,734,641,114.5
21310, 기장군,030004, 28세,2017,1511,800,711,112.5,1413,719,694,103.6
21310, 기장군,030005, 29세,2017,1677,890,787,113.1,1536,776,760,102.1
21310, 기장군,035,30~34세,2017,10798,5306,5492,96.6,10261,4902,5359,91.5
21310, 기장군,035001, 30세,2017,1697,820,877,93.5,1589,742,847,87.6
21310, 기장군,035002, 31세,2017,1906,910,996,91.4,1792,824,968,85.1
21310, 기장군,035003, 32세,2017,2034,1029,1005,102.4,1930,949,981,96.7
21310, 기장군,035004, 33세,2017,2401,1199,1202,99.8,2287,1113,1174,94.8
21310, 기장군,035005, 34세,2017,2760,1348,1412,95.5,2663,1274,1389,91.7
21310, 기장군,040,35~39세,2017,16552,8296,8256,100.5,16183,8013,8170,98.1
21310, 기장군,040001, 35세,2017,3244,1617,1627,99.4,3154,1549,1605,96.5
21310, 기장군,040002, 36세,2017,3378,1693,1685,100.5,3290,1626,1664,97.7
21310, 기장군,040003, 37세,2017,3595,1793,1802,99.5,3523,1734,1789,96.9
21310, 기장군,040004, 38세,2017,3328,1686,1642,102.7,3263,1638,1625,100.8
21310, 기장군,040005, 39세,2017,3007,1507,1500,100.5,2953,1466,1487,98.6
21310, 기장군,045,40~44세,2017,14398,7420,6978,106.3,14197,7287,6910,105.5
21310, 기장군,045001, 40세,2017,2934,1545,1389,111.2,2891,1514,1377,109.9
21310, 기장군,045002, 41세,2017,2798,1449,1349,107.4,2764,1422,1342,106
21310, 기장군,045003, 42세,2017,2883,1479,1404,105.3,2849,1458,1391,104.8
21310, 기장군,045004, 43세,2017,2950,1510,1440,104.9,2910,1487,1423,104.5
21310, 기장군,045005, 44세,2017,2833,1437,1396,102.9,2783,1406,1377,102.1
21310, 기장군,050,45~49세,2017,12671,6649,6022,110.4,12514,6559,5955,110.1
21310, 기장군,050001, 45세,2017,2756,1456,1300,112,2724,1436,1288,111.5
21310, 기장군,050002, 46세,2017,2722,1477,1245,118.6,2681,1451,1230,118
21310, 기장군,050003, 47세,2017,2537,1340,1197,111.9,2502,1324,1178,112.4
21310, 기장군,050004, 48세,2017,2422,1234,1188,103.9,2396,1220,1176,103.7
21310, 기장군,050005, 49세,2017,2234,1142,1092,104.6,2211,1128,1083,104.2
21310, 기장군,055,50~54세,2017,9884,4970,4914,101.1,9774,4907,4867,100.8
21310, 기장군,055001, 50세,2017,2095,1052,1043,100.9,2080,1042,1038,100.4
21310, 기장군,055002, 51세,2017,1996,1051,945,111.2,1966,1034,932,110.9
21310, 기장군,055003, 52세,2017,1954,944,1010,93.5,1925,926,999,92.7
21310, 기장군,055004, 53세,2017,1827,938,889,105.5,1813,932,881,105.8
21310, 기장군,055005, 54세,2017,2012,985,1027,95.9,1990,973,1017,95.7
21310, 기장군,060,55~59세,2017,10764,5094,5670,89.8,10709,5065,5644,89.7
21310, 기장군,060001, 55세,2017,2110,1033,1077,95.9,2098,1024,1074,95.3
21310, 기장군,060002, 56세,2017,2189,1038,1151,90.2,2182,1033,1149,89.9
21310, 기장군,060003, 57세,2017,2297,1078,1219,88.4,2286,1073,1213,88.5
21310, 기장군,060004, 58세,2017,2160,1004,1156,86.9,2148,1001,1147,87.3
21310, 기장군,060005, 59세,2017,2008,941,1067,88.2,1995,934,1061,88
21310, 기장군,065,60~64세,2017,9474,4335,5139,84.4,9432,4315,5117,84.3
21310, 기장군,065001, 60세,2017,2104,945,1159,81.5,2093,942,1151,81.8
21310, 기장군,065002, 61세,2017,1975,904,1071,84.4,1965,900,1065,84.5
21310, 기장군,065003, 62세,2017,2033,944,1089,86.7,2028,941,1087,86.6
21310, 기장군,065004, 63세,2017,1761,818,943,86.7,1750,811,939,86.4
21310, 기장군,065005, 64세,2017,1601,724,877,82.6,1596,721,875,82.4
21310, 기장군,070,65~69세,2017,7381,3445,3936,87.5,7360,3434,3926,87.5
21310, 기장군,070001, 65세,2017,1718,780,938,83.2,1712,777,935,83.1
21310, 기장군,070002, 66세,2017,1444,680,764,89,1441,679,762,89.1
21310, 기장군,070003, 67세,2017,1363,633,730,86.7,1357,630,727,86.7
21310, 기장군,070004, 68세,2017,1433,679,754,90.1,1429,677,752,90
21310, 기장군,070005, 69세,2017,1423,673,750,89.7,1421,671,750,89.5
21310, 기장군,075,70~74세,2017,5505,2545,2960,86,5491,2538,2953,85.9
21310, 기장군,075001, 70세,2017,1369,657,712,92.3,1366,656,710,92.4
21310, 기장군,075002, 71세,2017,1003,460,543,84.7,997,456,541,84.3
21310, 기장군,075003, 72세,2017,1010,460,550,83.6,1009,459,550,83.5
21310, 기장군,075004, 73세,2017,1084,491,593,82.8,1081,490,591,82.9
21310, 기장군,075005, 74세,2017,1039,477,562,84.9,1038,477,561,85
21310, 기장군,080,75~79세,2017,4395,1783,2612,68.3,4392,1781,2611,68.2
21310, 기장군,080001, 75세,2017,1095,469,626,74.9,1095,469,626,74.9
21310, 기장군,080002, 76세,2017,880,368,512,71.9,879,367,512,71.7
21310, 기장군,080003, 77세,2017,865,335,530,63.2,863,334,529,63.1
21310, 기장군,080004, 78세,2017,846,333,513,64.9,846,333,513,64.9
21310, 기장군,080005, 79세,2017,709,278,431,64.5,709,278,431,64.5
21310, 기장군,085,80~84세,2017,2665,890,1775,50.1,2663,890,1773,50.2
21310, 기장군,085001, 80세,2017,653,238,415,57.3,653,238,415,57.3
21310, 기장군,085002, 81세,2017,584,203,381,53.3,583,203,380,53.4
21310, 기장군,085003, 82세,2017,543,192,351,54.7,543,192,351,54.7
21310, 기장군,085004, 83세,2017,486,137,349,39.3,486,137,349,39.3
21310, 기장군,085005, 84세,2017,399,120,279,43,398,120,278,43.2
21310, 기장군,090,85~89세,2017,1300,353,947,37.3,1298,351,947,37.1
21310, 기장군,090001, 85세,2017,377,125,252,49.6,376,124,252,49.2
21310, 기장군,090002, 86세,2017,307,90,217,41.5,306,89,217,41
21310, 기장군,090003, 87세,2017,246,56,190,29.5,246,56,190,29.5
21310, 기장군,090004, 88세,2017,189,41,148,27.7,189,41,148,27.7
21310, 기장군,090005, 89세,2017,181,41,140,29.3,181,41,140,29.3
21310, 기장군,095,90~94세,2017,434,61,373,16.4,433,61,372,16.4
21310, 기장군,095001, 90세,2017,149,22,127,17.3,149,22,127,17.3
21310, 기장군,095002, 91세,2017,77,10,67,14.9,77,10,67,14.9
21310, 기장군,095003, 92세,2017,92,11,81,13.6,92,11,81,13.6
21310, 기장군,095004, 93세,2017,52,8,44,18.2,51,8,43,18.6
21310, 기장군,095005, 94세,2017,64,10,54,18.5,64,10,54,18.5
21310, 기장군,100,95~99세,2017,114,21,93,22.6,112,19,93,20.4
21310, 기장군,100001, 95세,2017,44,11,33,33.3,43,10,33,30.3
21310, 기장군,100002, 96세,2017,30,X,26,15.4,30,X,26,15.4
21310, 기장군,100003, 97세,2017,18,X,15,20,17,X,15,13.3
21310, 기장군,100004, 98세,2017,10,X,8,25,10,X,8,25
21310, 기장군,100005, 99세,2017,12,X,11,9.1,12,X,11,9.1
21310, 기장군,101,100세이상,2017,13,X,13,0,13,X,13,0
21310, 기장군,102,15세미만,2017,27929,14398,13531,106.4,27899,14381,13518,106.4
21310, 기장군,103,15~64세,2017,106825,54091,52734,102.6,104513,52441,52072,100.7
21310, 기장군,104,65세이상,2017,21807,9098,12709,71.6,21762,9074,12688,71.5
21310, 기장군,086,85세이상,2017,1861,435,1426,30.5,1856,431,1425,30.2
21310, 기장군,126,평균연령,2017,39.8,38.4,41.2,,39.9,38.5,41.3,
21310, 기장군,127,중위연령,2017,40.2,39.2,41.4,,40.4,39.5,41.5,
22,대구광역시,000,합계,2017,2453041,1218326,1234715,98.7,2421676,1200214,1221462,98.3
22,대구광역시,005,0~4세,2017,94482,48279,46203,104.5,94077,48089,45988,104.6
22,대구광역시,005001, 0세,2017,16328,8415,7913,106.3,16244,8376,7868,106.5
22,대구광역시,005002, 1세,2017,18889,9658,9231,104.6,18800,9607,9193,104.5
22,대구광역시,005003, 2세,2017,19652,10046,9606,104.6,19566,10006,9560,104.7
22,대구광역시,005004, 3세,2017,19634,9966,9668,103.1,19551,9934,9617,103.3
22,대구광역시,005005, 4세,2017,19979,10194,9785,104.2,19916,10166,9750,104.3
22,대구광역시,010,5~9세,2017,105630,54539,51091,106.7,105400,54433,50967,106.8
22,대구광역시,010001, 5세,2017,21865,11186,10679,104.7,21806,11157,10649,104.8
22,대구광역시,010002, 6세,2017,21432,11036,10396,106.2,21378,11011,10367,106.2
22,대구광역시,010003, 7세,2017,20771,10707,10064,106.4,20736,10687,10049,106.3
22,대구광역시,010004, 8세,2017,20127,10483,9644,108.7,20082,10465,9617,108.8
22,대구광역시,010005, 9세,2017,21435,11127,10308,107.9,21398,11113,10285,108.1
22,대구광역시,015,10~14세,2017,110571,57854,52717,109.7,110428,57777,52651,109.7
22,대구광역시,015001, 10세,2017,22140,11336,10804,104.9,22096,11313,10783,104.9
22,대구광역시,015002, 11세,2017,20535,10770,9765,110.3,20515,10757,9758,110.2
22,대구광역시,015003, 12세,2017,20913,10961,9952,110.1,20881,10950,9931,110.3
22,대구광역시,015004, 13세,2017,22851,11982,10869,110.2,22825,11966,10859,110.2
22,대구광역시,015005, 14세,2017,24132,12805,11327,113,24111,12791,11320,113
22,대구광역시,020,15~19세,2017,147500,77903,69597,111.9,146783,77582,69201,112.1
22,대구광역시,020001, 15세,2017,24549,13065,11484,113.8,24510,13045,11465,113.8
22,대구광역시,020002, 16세,2017,28612,15026,13586,110.6,28585,15012,13573,110.6
22,대구광역시,020003, 17세,2017,31968,16994,14974,113.5,31906,16968,14938,113.6
22,대구광역시,020004, 18세,2017,30685,16179,14506,111.5,30530,16104,14426,111.6
22,대구광역시,020005, 19세,2017,31686,16639,15047,110.6,31252,16453,14799,111.2
22,대구광역시,025,20~24세,2017,174218,94590,79628,118.8,170185,92441,77744,118.9
22,대구광역시,025001, 20세,2017,33704,17773,15931,111.6,33130,17503,15627,112
22,대구광역시,025002, 21세,2017,35210,19188,16022,119.8,34486,18823,15663,120.2
22,대구광역시,025003, 22세,2017,35403,19252,16151,119.2,34595,18818,15777,119.3
22,대구광역시,025004, 23세,2017,35266,19375,15891,121.9,34370,18880,15490,121.9
22,대구광역시,025005, 24세,2017,34635,19002,15633,121.6,33604,18417,15187,121.3
22,대구광역시,030,25~29세,2017,155003,85155,69848,121.9,148739,81412,67327,120.9
22,대구광역시,030001, 25세,2017,34780,19053,15727,121.1,33632,18361,15271,120.2
22,대구광역시,030002, 26세,2017,32313,17831,14482,123.1,31084,17098,13986,122.3
22,대구광역시,030003, 27세,2017,30906,17033,13873,122.8,29641,16285,13356,121.9
22,대구광역시,030004, 28세,2017,29465,16161,13304,121.5,28172,15383,12789,120.3
22,대구광역시,030005, 29세,2017,27539,15077,12462,121,26210,14285,11925,119.8
22,대구광역시,035,30~34세,2017,146261,76811,69450,110.6,140523,73219,67304,108.8
22,대구광역시,035001, 30세,2017,28006,14988,13018,115.1,26661,14161,12500,113.3
22,대구광역시,035002, 31세,2017,27930,14999,12931,116,26695,14239,12456,114.3
22,대구광역시,035003, 32세,2017,27901,14809,13092,113.1,26751,14102,12649,111.5
22,대구광역시,035004, 33세,2017,29346,15237,14109,108,28347,14577,13770,105.9
22,대구광역시,035005, 34세,2017,33078,16778,16300,102.9,32069,16140,15929,101.3
22,대구광역시,040,35~39세,2017,180724,90576,90148,100.5,176914,88152,88762,99.3
22,대구광역시,040001, 35세,2017,36476,18276,18200,100.4,35546,17682,17864,99
22,대구광역시,040002, 36세,2017,36818,18520,18298,101.2,36064,18049,18015,100.2
22,대구광역시,040003, 37세,2017,38012,19058,18954,100.5,37285,18586,18699,99.4
22,대구광역시,040004, 38세,2017,36062,17933,18129,98.9,35340,17476,17864,97.8
22,대구광역시,040005, 39세,2017,33356,16789,16567,101.3,32679,16359,16320,100.2
22,대구광역시,045,40~44세,2017,191103,94604,96499,98,188438,92955,95483,97.4
22,대구광역시,045001, 40세,2017,35079,17477,17602,99.3,34499,17113,17386,98.4
22,대구광역시,045002, 41세,2017,35347,17847,17500,102,34779,17476,17303,101
22,대구광역시,045003, 42세,2017,37488,18359,19129,96,36995,18071,18924,95.5
22,대구광역시,045004, 43세,2017,41245,20425,20820,98.1,40725,20127,20598,97.7
22,대구광역시,045005, 44세,2017,41944,20496,21448,95.6,41440,20168,21272,94.8
22,대구광역시,050,45~49세,2017,224449,110254,114195,96.5,221947,108823,113124,96.2
22,대구광역시,050001, 45세,2017,42865,21113,21752,97.1,42360,20793,21567,96.4
22,대구광역시,050002, 46세,2017,45348,22371,22977,97.4,44819,22068,22751,97
22,대구광역시,050003, 47세,2017,44755,21879,22876,95.6,44224,21597,22627,95.4
22,대구광역시,050004, 48세,2017,45106,22026,23080,95.4,44632,21756,22876,95.1
22,대구광역시,050005, 49세,2017,46375,22865,23510,97.3,45912,22609,23303,97
22,대구광역시,055,50~54세,2017,208698,102629,106069,96.8,206711,101602,105109,96.7
22,대구광역시,055001, 50세,2017,43181,20907,22274,93.9,42793,20709,22084,93.8
22,대구광역시,055002, 51세,2017,41549,20787,20762,100.1,41160,20601,20559,100.2
22,대구광역시,055003, 52세,2017,42244,20490,21754,94.2,41824,20252,21572,93.9
22,대구광역시,055004, 53세,2017,39980,19731,20249,97.4,39578,19524,20054,97.4
22,대구광역시,055005, 54세,2017,41744,20714,21030,98.5,41356,20516,20840,98.4
22,대구광역시,060,55~59세,2017,211613,103733,107880,96.2,210341,103094,107247,96.1
22,대구광역시,060001, 55세,2017,43487,21579,21908,98.5,43162,21413,21749,98.5
22,대구광역시,060002, 56세,2017,46600,22722,23878,95.2,46401,22623,23778,95.1
22,대구광역시,060003, 57세,2017,45027,21788,23239,93.8,44722,21639,23083,93.7
22,대구광역시,060004, 58세,2017,40897,19872,21025,94.5,40675,19763,20912,94.5
22,대구광역시,060005, 59세,2017,35602,17772,17830,99.7,35381,17656,17725,99.6
22,대구광역시,065,60~64세,2017,160684,77547,83137,93.3,159839,77126,82713,93.2
22,대구광역시,065001, 60세,2017,36785,18170,18615,97.6,36589,18069,18520,97.6
22,대구광역시,065002, 61세,2017,34128,16727,17401,96.1,33962,16643,17319,96.1
22,대구광역시,065003, 62세,2017,34121,16124,17997,89.6,33959,16045,17914,89.6
22,대구광역시,065004, 63세,2017,28377,13803,14574,94.7,28198,13715,14483,94.7
22,대구광역시,065005, 64세,2017,27273,12723,14550,87.4,27131,12654,14477,87.4
22,대구광역시,070,65~69세,2017,118727,55699,63028,88.4,118314,55506,62808,88.4
22,대구광역시,070001, 65세,2017,28779,13528,15251,88.7,28668,13477,15191,88.7
22,대구광역시,070002, 66세,2017,21932,10357,11575,89.5,21823,10304,11519,89.5
22,대구광역시,070003, 67세,2017,22148,10575,11573,91.4,22076,10547,11529,91.5
22,대구광역시,070004, 68세,2017,23674,10983,12691,86.5,23602,10947,12655,86.5
22,대구광역시,070005, 69세,2017,22194,10256,11938,85.9,22145,10231,11914,85.9
22,대구광역시,075,70~74세,2017,82570,36689,45881,80,82415,36611,45804,79.9
22,대구광역시,075001, 70세,2017,20590,9324,11266,82.8,20550,9307,11243,82.8
22,대구광역시,075002, 71세,2017,13967,6468,7499,86.3,13921,6443,7478,86.2
22,대구광역시,075003, 72세,2017,14400,6348,8052,78.8,14375,6334,8041,78.8
22,대구광역시,075004, 73세,2017,16442,7057,9385,75.2,16417,7042,9375,75.1
22,대구광역시,075005, 74세,2017,17171,7492,9679,77.4,17152,7485,9667,77.4
22,대구광역시,080,75~79세,2017,72619,29691,42928,69.2,72534,29663,42871,69.2
22,대구광역시,080001, 75세,2017,18579,8045,10534,76.4,18564,8039,10525,76.4
22,대구광역시,080002, 76세,2017,15119,6278,8841,71,15096,6270,8826,71
22,대구광역시,080003, 77세,2017,13743,5418,8325,65.1,13726,5413,8313,65.1
22,대구광역시,080004, 78세,2017,13475,5439,8036,67.7,13458,5432,8026,67.7
22,대구광역시,080005, 79세,2017,11703,4511,7192,62.7,11690,4509,7181,62.8
22,대구광역시,085,80~84세,2017,42997,15264,27733,55,42934,15238,27696,55
22,대구광역시,085001, 80세,2017,10638,4013,6625,60.6,10626,4010,6616,60.6
22,대구광역시,085002, 81세,2017,9664,3494,6170,56.6,9649,3487,6162,56.6
22,대구광역시,085003, 82세,2017,8923,3179,5744,55.3,8913,3176,5737,55.4
22,대구광역시,085004, 83세,2017,7666,2635,5031,52.4,7655,2628,5027,52.3
22,대구광역시,085005, 84세,2017,6106,1943,4163,46.7,6091,1937,4154,46.6
22,대구광역시,090,85~89세,2017,18456,5082,13374,38,18433,5067,13366,37.9
22,대구광역시,090001, 85세,2017,5496,1737,3759,46.2,5488,1731,3757,46.1
22,대구광역시,090002, 86세,2017,4186,1170,3016,38.8,4182,1168,3014,38.8
22,대구광역시,090003, 87세,2017,3478,844,2634,32,3474,841,2633,31.9
22,대구광역시,090004, 88세,2017,2909,739,2170,34.1,2905,737,2168,34
22,대구광역시,090005, 89세,2017,2387,592,1795,33,2384,590,1794,32.9
22,대구광역시,095,90~94세,2017,5490,1200,4290,28,5479,1198,4281,28
22,대구광역시,095001, 90세,2017,1912,443,1469,30.2,1910,442,1468,30.1
22,대구광역시,095002, 91세,2017,1197,261,936,27.9,1194,261,933,28
22,대구광역시,095003, 92세,2017,1130,245,885,27.7,1127,245,882,27.8
22,대구광역시,095004, 93세,2017,699,137,562,24.4,697,136,561,24.2
22,대구광역시,095005, 94세,2017,552,114,438,26,551,114,437,26.1
22,대구광역시,100,95~99세,2017,1105,206,899,22.9,1102,205,897,22.9
22,대구광역시,100001, 95세,2017,460,91,369,24.7,460,91,369,24.7
22,대구광역시,100002, 96세,2017,270,48,222,21.6,270,48,222,21.6
22,대구광역시,100003, 97세,2017,186,33,153,21.6,186,33,153,21.6
22,대구광역시,100004, 98세,2017,125,25,100,25,125,25,100,25
22,대구광역시,100005, 99세,2017,64,9,55,16.4,61,8,53,15.1
22,대구광역시,101,100세이상,2017,141,21,120,17.5,140,21,119,17.6
22,대구광역시,102,15세미만,2017,310683,160672,150011,107.1,309905,160299,149606,107.1
22,대구광역시,103,15~64세,2017,1800253,913802,886451,103.1,1770420,896406,874014,102.6
22,대구광역시,104,65세이상,2017,342105,143852,198253,72.6,341351,143509,197842,72.5
22,대구광역시,086,85세이상,2017,25192,6509,18683,34.8,25154,6491,18663,34.8
22,대구광역시,126,평균연령,2017,41.6,40.2,43,,41.7,40.3,43,
22,대구광역시,127,중위연령,2017,43.1,41.3,44.6,,43.3,41.6,44.8,
22004, 읍부,000,합계,2017,152160,77773,74387,104.6,147625,74751,72874,102.6
22004, 읍부,005,0~4세,2017,8851,4465,4386,101.8,8774,4437,4337,102.3
22004, 읍부,005001, 0세,2017,1566,788,778,101.3,1550,781,769,101.6
22004, 읍부,005002, 1세,2017,1821,907,914,99.2,1803,899,904,99.4
22004, 읍부,005003, 2세,2017,1859,914,945,96.7,1841,908,933,97.3
22004, 읍부,005004, 3세,2017,1776,900,876,102.7,1761,898,863,104.1
22004, 읍부,005005, 4세,2017,1829,956,873,109.5,1819,951,868,109.6
22004, 읍부,010,5~9세,2017,8684,4431,4253,104.2,8636,4409,4227,104.3
22004, 읍부,010001, 5세,2017,1873,972,901,107.9,1865,970,895,108.4
22004, 읍부,010002, 6세,2017,1894,957,937,102.1,1877,950,927,102.5
22004, 읍부,010003, 7세,2017,1700,859,841,102.1,1694,853,841,101.4
22004, 읍부,010004, 8세,2017,1576,796,780,102.1,1567,792,775,102.2
22004, 읍부,010005, 9세,2017,1641,847,794,106.7,1633,844,789,107
22004, 읍부,015,10~14세,2017,7467,3882,3585,108.3,7435,3866,3569,108.3
22004, 읍부,015001, 10세,2017,1581,781,800,97.6,1572,779,793,98.2
22004, 읍부,015002, 11세,2017,1430,755,675,111.9,1424,751,673,111.6
22004, 읍부,015003, 12세,2017,1479,778,701,111,1469,773,696,111.1
22004, 읍부,015004, 13세,2017,1462,752,710,105.9,1458,749,709,105.6
22004, 읍부,015005, 14세,2017,1515,816,699,116.7,1512,814,698,116.6
22004, 읍부,020,15~19세,2017,8430,4523,3907,115.8,8390,4501,3889,115.7
22004, 읍부,020001, 15세,2017,1516,824,692,119.1,1511,820,691,118.7
22004, 읍부,020002, 16세,2017,1729,906,823,110.1,1723,903,820,110.1
22004, 읍부,020003, 17세,2017,1868,977,891,109.7,1863,975,888,109.8
22004, 읍부,020004, 18세,2017,1749,945,804,117.5,1739,939,800,117.4
22004, 읍부,020005, 19세,2017,1568,871,697,125,1554,864,690,125.2
22004, 읍부,025,20~24세,2017,9207,5232,3975,131.6,8891,5028,3863,130.2
22004, 읍부,025001, 20세,2017,1767,1009,758,133.1,1747,999,748,133.6
22004, 읍부,025002, 21세,2017,1840,1082,758,142.7,1804,1068,736,145.1
22004, 읍부,025003, 22세,2017,1818,1058,760,139.2,1763,1017,746,136.3
22004, 읍부,025004, 23세,2017,1895,1023,872,117.3,1802,964,838,115
22004, 읍부,025005, 24세,2017,1887,1060,827,128.2,1775,980,795,123.3
22004, 읍부,030,25~29세,2017,9636,5340,4296,124.3,8741,4708,4033,116.7
22004, 읍부,030001, 25세,2017,2006,1099,907,121.2,1867,1005,862,116.6
22004, 읍부,030002, 26세,2017,1910,1097,813,134.9,1724,963,761,126.5
22004, 읍부,030003, 27세,2017,1924,1062,862,123.2,1751,944,807,117
22004, 읍부,030004, 28세,2017,1884,1024,860,119.1,1699,896,803,111.6
22004, 읍부,030005, 29세,2017,1912,1058,854,123.9,1700,900,800,112.5
22004, 읍부,035,30~34세,2017,11425,5970,5455,109.4,10437,5228,5209,100.4
22004, 읍부,035001, 30세,2017,2024,1049,975,107.6,1816,905,911,99.3
22004, 읍부,035002, 31세,2017,2146,1163,983,118.3,1924,993,931,106.7
22004, 읍부,035003, 32세,2017,2214,1193,1021,116.8,2012,1039,973,106.8
22004, 읍부,035004, 33세,2017,2348,1210,1138,106.3,2170,1066,1104,96.6
22004, 읍부,035005, 34세,2017,2693,1355,1338,101.3,2515,1225,1290,95
22004, 읍부,040,35~39세,2017,14417,7477,6940,107.7,13724,6976,6748,103.4
22004, 읍부,040001, 35세,2017,2998,1569,1429,109.8,2826,1441,1385,104
22004, 읍부,040002, 36세,2017,2942,1534,1408,108.9,2809,1439,1370,105
22004, 읍부,040003, 37세,2017,3102,1577,1525,103.4,2977,1486,1491,99.7
22004, 읍부,040004, 38세,2017,2802,1477,1325,111.5,2670,1381,1289,107.1
22004, 읍부,040005, 39세,2017,2573,1320,1253,105.3,2442,1229,1213,101.3
22004, 읍부,045,40~44세,2017,13371,6997,6374,109.8,12929,6715,6214,108.1
22004, 읍부,045001, 40세,2017,2618,1369,1249,109.6,2526,1313,1213,108.2
22004, 읍부,045002, 41세,2017,2581,1363,1218,111.9,2482,1297,1185,109.5
22004, 읍부,045003, 42세,2017,2676,1389,1287,107.9,2599,1337,1262,105.9
22004, 읍부,045004, 43세,2017,2796,1470,1326,110.9,2712,1421,1291,110.1
22004, 읍부,045005, 44세,2017,2700,1406,1294,108.7,2610,1347,1263,106.7
22004, 읍부,050,45~49세,2017,13731,6913,6818,101.4,13333,6669,6664,100.1
22004, 읍부,050001, 45세,2017,2705,1435,1270,113,2616,1372,1244,110.3
22004, 읍부,050002, 46세,2017,2744,1399,1345,104,2671,1353,1318,102.7
22004, 읍부,050003, 47세,2017,2758,1377,1381,99.7,2683,1337,1346,99.3
22004, 읍부,050004, 48세,2017,2756,1345,1411,95.3,2668,1291,1377,93.8
22004, 읍부,050005, 49세,2017,2768,1357,1411,96.2,2695,1316,1379,95.4
22004, 읍부,055,50~54세,2017,12573,6178,6395,96.6,12300,6023,6277,96
22004, 읍부,055001, 50세,2017,2592,1229,1363,90.2,2534,1201,1333,90.1
22004, 읍부,055002, 51세,2017,2573,1300,1273,102.1,2516,1266,1250,101.3
22004, 읍부,055003, 52세,2017,2583,1247,1336,93.3,2526,1210,1316,91.9
22004, 읍부,055004, 53세,2017,2382,1197,1185,101,2328,1166,1162,100.3
22004, 읍부,055005, 54세,2017,2443,1205,1238,97.3,2396,1180,1216,97
22004, 읍부,060,55~59세,2017,12099,6237,5862,106.4,11923,6138,5785,106.1
22004, 읍부,060001, 55세,2017,2647,1355,1292,104.9,2607,1334,1273,104.8
22004, 읍부,060002, 56세,2017,2775,1435,1340,107.1,2740,1417,1323,107.1
22004, 읍부,060003, 57세,2017,2487,1257,1230,102.2,2450,1238,1212,102.1
22004, 읍부,060004, 58세,2017,2254,1179,1075,109.7,2218,1156,1062,108.9
22004, 읍부,060005, 59세,2017,1936,1011,925,109.3,1908,993,915,108.5
22004, 읍부,065,60~64세,2017,7918,4001,3917,102.1,7822,3951,3871,102.1
22004, 읍부,065001, 60세,2017,1930,1006,924,108.9,1895,984,911,108
22004, 읍부,065002, 61세,2017,1711,904,807,112,1696,898,798,112.5
22004, 읍부,065003, 62세,2017,1644,773,871,88.7,1627,768,859,89.4
22004, 읍부,065004, 63세,2017,1309,670,639,104.9,1291,659,632,104.3
22004, 읍부,065005, 64세,2017,1324,648,676,95.9,1313,642,671,95.7
22004, 읍부,070,65~69세,2017,5363,2631,2732,96.3,5326,2614,2712,96.4
22004, 읍부,070001, 65세,2017,1347,657,690,95.2,1339,654,685,95.5
22004, 읍부,070002, 66세,2017,1020,502,518,96.9,1008,498,510,97.6
22004, 읍부,070003, 67세,2017,1016,514,502,102.4,1007,511,496,103
22004, 읍부,070004, 68세,2017,1038,508,530,95.8,1033,504,529,95.3
22004, 읍부,070005, 69세,2017,942,450,492,91.5,939,447,492,90.9
22004, 읍부,075,70~74세,2017,3421,1592,1829,87,3406,1587,1819,87.2
22004, 읍부,075001, 70세,2017,835,398,437,91.1,831,398,433,91.9
22004, 읍부,075002, 71세,2017,612,296,316,93.7,606,294,312,94.2
22004, 읍부,075003, 72세,2017,589,279,310,90,586,277,309,89.6
22004, 읍부,075004, 73세,2017,693,322,371,86.8,693,322,371,86.8
22004, 읍부,075005, 74세,2017,692,297,395,75.2,690,296,394,75.1
22004, 읍부,080,75~79세,2017,2852,1094,1758,62.2,2849,1094,1755,62.3
22004, 읍부,080001, 75세,2017,733,314,419,74.9,733,314,419,74.9
22004, 읍부,080002, 76세,2017,595,218,377,57.8,594,218,376,58
22004, 읍부,080003, 77세,2017,535,185,350,52.9,535,185,350,52.9
22004, 읍부,080004, 78세,2017,511,193,318,60.7,511,193,318,60.7
22004, 읍부,080005, 79세,2017,478,184,294,62.6,476,184,292,63
22004, 읍부,085,80~84세,2017,1682,574,1108,51.8,1677,571,1106,51.6
22004, 읍부,085001, 80세,2017,419,159,260,61.2,419,159,260,61.2
22004, 읍부,085002, 81세,2017,355,129,226,57.1,352,127,225,56.4
22004, 읍부,085003, 82세,2017,331,111,220,50.5,331,111,220,50.5
22004, 읍부,085004, 83세,2017,314,96,218,44,313,95,218,43.6
22004, 읍부,085005, 84세,2017,263,79,184,42.9,262,79,183,43.2
22004, 읍부,090,85~89세,2017,764,193,571,33.8,763,193,570,33.9
22004, 읍부,090001, 85세,2017,219,67,152,44.1,219,67,152,44.1
22004, 읍부,090002, 86세,2017,174,52,122,42.6,174,52,122,42.6
22004, 읍부,090003, 87세,2017,161,33,128,25.8,161,33,128,25.8
22004, 읍부,090004, 88세,2017,110,20,90,22.2,109,20,89,22.5
22004, 읍부,090005, 89세,2017,100,21,79,26.6,100,21,79,26.6
22004, 읍부,095,90~94세,2017,220,32,188,17,220,32,188,17
22004, 읍부,095001, 90세,2017,88,15,73,20.5,88,15,73,20.5
22004, 읍부,095002, 91세,2017,46,6,40,15,46,6,40,15
22004, 읍부,095003, 92세,2017,32,X,28,14.3,32,X,28,14.3
22004, 읍부,095004, 93세,2017,24,X,21,14.3,24,X,21,14.3
22004, 읍부,095005, 94세,2017,30,X,26,15.4,30,X,26,15.4
22004, 읍부,100,95~99세,2017,39,8,31,25.8,39,8,31,25.8
22004, 읍부,100001, 95세,2017,20,7,13,53.8,20,7,13,53.8
22004, 읍부,100002, 96세,2017,9,X,9,0,9,X,9,0
22004, 읍부,100003, 97세,2017,5,X,5,0,5,X,5,0
22004, 읍부,100004, 98세,2017,X,X,X,0,X,X,X,0
22004, 읍부,100005, 99세,2017,X,X,X,50,X,X,X,50
22004, 읍부,101,100세이상,2017,10,X,7,42.9,10,X,7,42.9
22004, 읍부,102,15세미만,2017,25002,12778,12224,104.5,24845,12712,12133,104.8
22004, 읍부,103,15~64세,2017,112807,58868,53939,109.1,108490,55937,52553,106.4
22004, 읍부,104,65세이상,2017,14351,6127,8224,74.5,14290,6102,8188,74.5
22004, 읍부,086,85세이상,2017,1033,236,797,29.6,1032,236,796,29.6
22004, 읍부,126,평균연령,2017,38.4,37.5,39.3,,38.4,37.5,39.4,
22004, 읍부,127,중위연령,2017,39.2,38.2,40.3,,39.5,38.6,40.5,
22005, 면부,000,합계,2017,87080,45021,42059,107,84746,43382,41364,104.9
22005, 면부,005,0~4세,2017,6259,3200,3059,104.6,6231,3191,3040,105
22005, 면부,005001, 0세,2017,1238,643,595,108.1,1231,641,590,108.6
22005, 면부,005002, 1세,2017,1349,693,656,105.6,1340,689,651,105.8
22005, 면부,005003, 2세,2017,1300,666,634,105,1298,666,632,105.4
22005, 면부,005004, 3세,2017,1249,620,629,98.6,1244,619,625,99
22005, 면부,005005, 4세,2017,1123,578,545,106.1,1118,576,542,106.3
22005, 면부,010,5~9세,2017,4911,2546,2365,107.7,4907,2544,2363,107.7
22005, 면부,010001, 5세,2017,1185,587,598,98.2,1185,587,598,98.2
22005, 면부,010002, 6세,2017,1077,553,524,105.5,1075,551,524,105.2
22005, 면부,010003, 7세,2017,984,522,462,113,984,522,462,113
22005, 면부,010004, 8세,2017,816,429,387,110.9,814,429,385,111.4
22005, 면부,010005, 9세,2017,849,455,394,115.5,849,455,394,115.5
22005, 면부,015,10~14세,2017,3279,1693,1586,106.7,3273,1692,1581,107
22005, 면부,015001, 10세,2017,790,402,388,103.6,788,402,386,104.1
22005, 면부,015002, 11세,2017,642,345,297,116.2,642,345,297,116.2
22005, 면부,015003, 12세,2017,641,325,316,102.8,640,325,315,103.2
22005, 면부,015004, 13세,2017,610,298,312,95.5,609,297,312,95.2
22005, 면부,015005, 14세,2017,596,323,273,118.3,594,323,271,119.2
22005, 면부,020,15~19세,2017,3391,1834,1557,117.8,3379,1830,1549,118.1
22005, 면부,020001, 15세,2017,547,289,258,112,547,289,258,112
22005, 면부,020002, 16세,2017,727,378,349,108.3,727,378,349,108.3
22005, 면부,020003, 17세,2017,758,395,363,108.8,755,394,361,109.1
22005, 면부,020004, 18세,2017,620,328,292,112.3,619,327,292,112
22005, 면부,020005, 19세,2017,739,444,295,150.5,731,442,289,152.9
22005, 면부,025,20~24세,2017,4347,2646,1701,155.6,4117,2467,1650,149.5
22005, 면부,025001, 20세,2017,874,547,327,167.3,863,543,320,169.7
22005, 면부,025002, 21세,2017,905,595,310,191.9,875,575,300,191.7
22005, 면부,025003, 22세,2017,876,532,344,154.7,832,498,334,149.1
22005, 면부,025004, 23세,2017,778,456,322,141.6,718,407,311,130.9
22005, 면부,025005, 24세,2017,914,516,398,129.6,829,444,385,115.3
22005, 면부,030,25~29세,2017,5913,3426,2487,137.8,5315,2977,2338,127.3
22005, 면부,030001, 25세,2017,1086,624,462,135.1,996,551,445,123.8
22005, 면부,030002, 26세,2017,1126,655,471,139.1,1011,565,446,126.7
22005, 면부,030003, 27세,2017,1185,689,496,138.9,1062,603,459,131.4
22005, 면부,030004, 28세,2017,1237,739,498,148.4,1093,633,460,137.6
22005, 면부,030005, 29세,2017,1279,719,560,128.4,1153,625,528,118.4
22005, 면부,035,30~34세,2017,8200,4501,3699,121.7,7671,4117,3554,115.8
22005, 면부,035001, 30세,2017,1422,786,636,123.6,1291,686,605,113.4
22005, 면부,035002, 31세,2017,1549,861,688,125.1,1433,779,654,119.1
22005, 면부,035003, 32세,2017,1582,876,706,124.1,1485,806,679,118.7
22005, 면부,035004, 33세,2017,1721,970,751,129.2,1625,899,726,123.8
22005, 면부,035005, 34세,2017,1926,1008,918,109.8,1837,947,890,106.4
22005, 면부,040,35~39세,2017,9367,4999,4368,114.4,9030,4755,4275,111.2
22005, 면부,040001, 35세,2017,2077,1068,1009,105.8,1996,1007,989,101.8
22005, 면부,040002, 36세,2017,2003,1082,921,117.5,1932,1029,903,114
22005, 면부,040003, 37세,2017,1964,1063,901,118,1908,1025,883,116.1
22005, 면부,040004, 38세,2017,1770,910,860,105.8,1710,866,844,102.6
22005, 면부,040005, 39세,2017,1553,876,677,129.4,1484,828,656,126.2
22005, 면부,045,40~44세,2017,6530,3654,2876,127.1,6349,3523,2826,124.7
22005, 면부,045001, 40세,2017,1480,826,654,126.3,1443,800,643,124.4
22005, 면부,045002, 41세,2017,1255,706,549,128.6,1216,677,539,125.6
22005, 면부,045003, 42세,2017,1261,700,561,124.8,1229,674,555,121.4
22005, 면부,045004, 43세,2017,1332,766,566,135.3,1299,742,557,133.2
22005, 면부,045005, 44세,2017,1202,656,546,120.1,1162,630,532,118.4
22005, 면부,050,45~49세,2017,6018,3189,2829,112.7,5870,3093,2777,111.4
22005, 면부,050001, 45세,2017,1194,641,553,115.9,1172,632,540,117
22005, 면부,050002, 46세,2017,1225,667,558,119.5,1188,641,547,117.2
22005, 면부,050003, 47세,2017,1200,658,542,121.4,1164,634,530,119.6
22005, 면부,050004, 48세,2017,1169,587,582,100.9,1145,569,576,98.8
22005, 면부,050005, 49세,2017,1230,636,594,107.1,1201,617,584,105.7
22005, 면부,055,50~54세,2017,5720,2943,2777,106,5590,2876,2714,106
22005, 면부,055001, 50세,2017,1144,581,563,103.2,1114,566,548,103.3
22005, 면부,055002, 51세,2017,1126,569,557,102.2,1105,558,547,102
22005, 면부,055003, 52세,2017,1154,596,558,106.8,1124,583,541,107.8
22005, 면부,055004, 53세,2017,1095,584,511,114.3,1075,572,503,113.7
22005, 면부,055005, 54세,2017,1201,613,588,104.3,1172,597,575,103.8
22005, 면부,060,55~59세,2017,6419,3086,3333,92.6,6369,3058,3311,92.4
22005, 면부,060001, 55세,2017,1278,641,637,100.6,1265,631,634,99.5
22005, 면부,060002, 56세,2017,1336,626,710,88.2,1329,622,707,88
22005, 면부,060003, 57세,2017,1305,629,676,93,1294,625,669,93.4
22005, 면부,060004, 58세,2017,1323,621,702,88.5,1314,616,698,88.3
22005, 면부,060005, 59세,2017,1177,569,608,93.6,1167,564,603,93.5
22005, 면부,065,60~64세,2017,5075,2496,2579,96.8,5034,2471,2563,96.4
22005, 면부,065001, 60세,2017,1151,565,586,96.4,1136,556,580,95.9
22005, 면부,065002, 61세,2017,1115,544,571,95.3,1109,540,569,94.9
22005, 면부,065003, 62세,2017,1077,536,541,99.1,1071,532,539,98.7
22005, 면부,065004, 63세,2017,900,453,447,101.3,891,448,443,101.1
22005, 면부,065005, 64세,2017,832,398,434,91.7,827,395,432,91.4
22005, 면부,070,65~69세,2017,3806,1876,1930,97.2,3779,1862,1917,97.1
22005, 면부,070001, 65세,2017,949,469,480,97.7,941,465,476,97.7
22005, 면부,070002, 66세,2017,692,337,355,94.9,684,332,352,94.3
22005, 면부,070003, 67세,2017,724,356,368,96.7,722,356,366,97.3
22005, 면부,070004, 68세,2017,740,370,370,100,736,368,368,100
22005, 면부,070005, 69세,2017,701,344,357,96.4,696,341,355,96.1
22005, 면부,075,70~74세,2017,2504,1150,1354,84.9,2496,1144,1352,84.6
22005, 면부,075001, 70세,2017,654,315,339,92.9,652,315,337,93.5
22005, 면부,075002, 71세,2017,418,209,209,100,415,206,209,98.6
22005, 면부,075003, 72세,2017,452,204,248,82.3,450,202,248,81.5
22005, 면부,075004, 73세,2017,488,221,267,82.8,487,220,267,82.4
22005, 면부,075005, 74세,2017,492,201,291,69.1,492,201,291,69.1
22005, 면부,080,75~79세,2017,2491,916,1575,58.2,2487,916,1571,58.3
22005, 면부,080001, 75세,2017,592,236,356,66.3,591,236,355,66.5
22005, 면부,080002, 76세,2017,485,190,295,64.4,484,190,294,64.6
22005, 면부,080003, 77세,2017,474,154,320,48.1,474,154,320,48.1
22005, 면부,080004, 78세,2017,507,179,328,54.6,506,179,327,54.7
22005, 면부,080005, 79세,2017,433,157,276,56.9,432,157,275,57.1
22005, 면부,085,80~84세,2017,1695,550,1145,48,1694,550,1144,48.1
22005, 면부,085001, 80세,2017,403,134,269,49.8,402,134,268,50
22005, 면부,085002, 81세,2017,349,124,225,55.1,349,124,225,55.1
22005, 면부,085003, 82세,2017,386,117,269,43.5,386,117,269,43.5
22005, 면부,085004, 83세,2017,321,94,227,41.4,321,94,227,41.4
22005, 면부,085005, 84세,2017,236,81,155,52.3,236,81,155,52.3
22005, 면부,090,85~89세,2017,846,234,612,38.2,846,234,612,38.2
22005, 면부,090001, 85세,2017,245,82,163,50.3,245,82,163,50.3
22005, 면부,090002, 86세,2017,198,52,146,35.6,198,52,146,35.6
22005, 면부,090003, 87세,2017,160,44,116,37.9,160,44,116,37.9
22005, 면부,090004, 88세,2017,129,25,104,24,129,25,104,24
22005, 면부,090005, 89세,2017,114,31,83,37.3,114,31,83,37.3
22005, 면부,095,90~94세,2017,246,68,178,38.2,246,68,178,38.2
22005, 면부,095001, 90세,2017,85,22,63,34.9,85,22,63,34.9
22005, 면부,095002, 91세,2017,63,19,44,43.2,63,19,44,43.2
22005, 면부,095003, 92세,2017,53,15,38,39.5,53,15,38,39.5
22005, 면부,095004, 93세,2017,24,7,17,41.2,24,7,17,41.2
22005, 면부,095005, 94세,2017,21,5,16,31.3,21,5,16,31.3
22005, 면부,100,95~99세,2017,58,14,44,31.8,58,14,44,31.8
22005, 면부,100001, 95세,2017,23,X,19,21.1,23,X,19,21.1
22005, 면부,100002, 96세,2017,12,X,9,33.3,12,X,9,33.3
22005, 면부,100003, 97세,2017,10,X,6,66.7,10,X,6,66.7
22005, 면부,100004, 98세,2017,8,X,5,60,8,X,5,60
22005, 면부,100005, 99세,2017,5,X,5,0,5,X,5,0
22005, 면부,101,100세이상,2017,5,X,5,0,5,X,5,0
22005, 면부,102,15세미만,2017,14449,7439,7010,106.1,14411,7427,6984,106.3
22005, 면부,103,15~64세,2017,60980,32774,28206,116.2,58724,31167,27557,113.1
22005, 면부,104,65세이상,2017,11651,4808,6843,70.3,11611,4788,6823,70.2
22005, 면부,086,85세이상,2017,1155,316,839,37.7,1155,316,839,37.7
22005, 면부,126,평균연령,2017,39.6,38.1,41.3,,39.8,38.2,41.4,
22005, 면부,127,중위연령,2017,38.7,37.5,40.3,,39,37.8,40.5,
22003, 동부,000,합계,2017,2213801,1095532,1118269,98,2189305,1082081,1107224,97.7
22003, 동부,005,0~4세,2017,79372,40614,38758,104.8,79072,40461,38611,104.8
22003, 동부,005001, 0세,2017,13524,6984,6540,106.8,13463,6954,6509,106.8
22003, 동부,005002, 1세,2017,15719,8058,7661,105.2,15657,8019,7638,105
22003, 동부,005003, 2세,2017,16493,8466,8027,105.5,16427,8432,7995,105.5
22003, 동부,005004, 3세,2017,16609,8446,8163,103.5,16546,8417,8129,103.5
22003, 동부,005005, 4세,2017,17027,8660,8367,103.5,16979,8639,8340,103.6
22003, 동부,010,5~9세,2017,92035,47562,44473,106.9,91857,47480,44377,107
22003, 동부,010001, 5세,2017,18807,9627,9180,104.9,18756,9600,9156,104.8
22003, 동부,010002, 6세,2017,18461,9526,8935,106.6,18426,9510,8916,106.7
22003, 동부,010003, 7세,2017,18087,9326,8761,106.4,18058,9312,8746,106.5
22003, 동부,010004, 8세,2017,17735,9258,8477,109.2,17701,9244,8457,109.3
22003, 동부,010005, 9세,2017,18945,9825,9120,107.7,18916,9814,9102,107.8
22003, 동부,015,10~14세,2017,99825,52279,47546,110,99720,52219,47501,109.9
22003, 동부,015001, 10세,2017,19769,10153,9616,105.6,19736,10132,9604,105.5
22003, 동부,015002, 11세,2017,18463,9670,8793,110,18449,9661,8788,109.9
22003, 동부,015003, 12세,2017,18793,9858,8935,110.3,18772,9852,8920,110.4
22003, 동부,015004, 13세,2017,20779,10932,9847,111,20758,10920,9838,111
22003, 동부,015005, 14세,2017,22021,11666,10355,112.7,22005,11654,10351,112.6
22003, 동부,020,15~19세,2017,135679,71546,64133,111.6,135014,71251,63763,111.7
22003, 동부,020001, 15세,2017,22486,11952,10534,113.5,22452,11936,10516,113.5
22003, 동부,020002, 16세,2017,26156,13742,12414,110.7,26135,13731,12404,110.7
22003, 동부,020003, 17세,2017,29342,15622,13720,113.9,29288,15599,13689,114
22003, 동부,020004, 18세,2017,28316,14906,13410,111.2,28172,14838,13334,111.3
22003, 동부,020005, 19세,2017,29379,15324,14055,109,28967,15147,13820,109.6
22003, 동부,025,20~24세,2017,160664,86712,73952,117.3,157177,84946,72231,117.6
22003, 동부,025001, 20세,2017,31063,16217,14846,109.2,30520,15961,14559,109.6
22003, 동부,025002, 21세,2017,32465,17511,14954,117.1,31807,17180,14627,117.5
22003, 동부,025003, 22세,2017,32709,17662,15047,117.4,32000,17303,14697,117.7
22003, 동부,025004, 23세,2017,32593,17896,14697,121.8,31850,17509,14341,122.1
22003, 동부,025005, 24세,2017,31834,17426,14408,120.9,31000,16993,14007,121.3
22003, 동부,030,25~29세,2017,139454,76389,63065,121.1,134683,73727,60956,121
22003, 동부,030001, 25세,2017,31688,17330,14358,120.7,30769,16805,13964,120.3
22003, 동부,030002, 26세,2017,29277,16079,13198,121.8,28349,15570,12779,121.8
22003, 동부,030003, 27세,2017,27797,15282,12515,122.1,26828,14738,12090,121.9
22003, 동부,030004, 28세,2017,26344,14398,11946,120.5,25380,13854,11526,120.2
22003, 동부,030005, 29세,2017,24348,13300,11048,120.4,23357,12760,10597,120.4
22003, 동부,035,30~34세,2017,126636,66340,60296,110,122415,63874,58541,109.1
22003, 동부,035001, 30세,2017,24560,13153,11407,115.3,23554,12570,10984,114.4
22003, 동부,035002, 31세,2017,24235,12975,11260,115.2,23338,12467,10871,114.7
22003, 동부,035003, 32세,2017,24105,12740,11365,112.1,23254,12257,10997,111.5
22003, 동부,035004, 33세,2017,25277,13057,12220,106.8,24552,12612,11940,105.6
22003, 동부,035005, 34세,2017,28459,14415,14044,102.6,27717,13968,13749,101.6
22003, 동부,040,35~39세,2017,156940,78100,78840,99.1,154160,76421,77739,98.3
22003, 동부,040001, 35세,2017,31401,15639,15762,99.2,30724,15234,15490,98.3
22003, 동부,040002, 36세,2017,31873,15904,15969,99.6,31323,15581,15742,99
22003, 동부,040003, 37세,2017,32946,16418,16528,99.3,32400,16075,16325,98.5
22003, 동부,040004, 38세,2017,31490,15546,15944,97.5,30960,15229,15731,96.8
22003, 동부,040005, 39세,2017,29230,14593,14637,99.7,28753,14302,14451,99
22003, 동부,045,40~44세,2017,171202,83953,87249,96.2,169160,82717,86443,95.7
22003, 동부,045001, 40세,2017,30981,15282,15699,97.3,30530,15000,15530,96.6
22003, 동부,045002, 41세,2017,31511,15778,15733,100.3,31081,15502,15579,99.5
22003, 동부,045003, 42세,2017,33551,16270,17281,94.1,33167,16060,17107,93.9
22003, 동부,045004, 43세,2017,37117,18189,18928,96.1,36714,17964,18750,95.8
22003, 동부,045005, 44세,2017,38042,18434,19608,94,37668,18191,19477,93.4
22003, 동부,050,45~49세,2017,204700,100152,104548,95.8,202744,99061,103683,95.5
22003, 동부,050001, 45세,2017,38966,19037,19929,95.5,38572,18789,19783,95
22003, 동부,050002, 46세,2017,41379,20305,21074,96.4,40960,20074,20886,96.1
22003, 동부,050003, 47세,2017,40797,19844,20953,94.7,40377,19626,20751,94.6
22003, 동부,050004, 48세,2017,41181,20094,21087,95.3,40819,19896,20923,95.1
22003, 동부,050005, 49세,2017,42377,20872,21505,97.1,42016,20676,21340,96.9
22003, 동부,055,50~54세,2017,190405,93508,96897,96.5,188821,92703,96118,96.4
22003, 동부,055001, 50세,2017,39445,19097,20348,93.9,39145,18942,20203,93.8
22003, 동부,055002, 51세,2017,37850,18918,18932,99.9,37539,18777,18762,100.1
22003, 동부,055003, 52세,2017,38507,18647,19860,93.9,38174,18459,19715,93.6
22003, 동부,055004, 53세,2017,36503,17950,18553,96.7,36175,17786,18389,96.7
22003, 동부,055005, 54세,2017,38100,18896,19204,98.4,37788,18739,19049,98.4
22003, 동부,060,55~59세,2017,193095,94410,98685,95.7,192049,93898,98151,95.7
22003, 동부,060001, 55세,2017,39562,19583,19979,98,39290,19448,19842,98
22003, 동부,060002, 56세,2017,42489,20661,21828,94.7,42332,20584,21748,94.6
22003, 동부,060003, 57세,2017,41235,19902,21333,93.3,40978,19776,21202,93.3
22003, 동부,060004, 58세,2017,37320,18072,19248,93.9,37143,17991,19152,93.9
22003, 동부,060005, 59세,2017,32489,16192,16297,99.4,32306,16099,16207,99.3
22003, 동부,065,60~64세,2017,147691,71050,76641,92.7,146983,70704,76279,92.7
22003, 동부,065001, 60세,2017,33704,16599,17105,97,33558,16529,17029,97.1
22003, 동부,065002, 61세,2017,31302,15279,16023,95.4,31157,15205,15952,95.3
22003, 동부,065003, 62세,2017,31400,14815,16585,89.3,31261,14745,16516,89.3
22003, 동부,065004, 63세,2017,26168,12680,13488,94,26016,12608,13408,94
22003, 동부,065005, 64세,2017,25117,11677,13440,86.9,24991,11617,13374,86.9
22003, 동부,070,65~69세,2017,109558,51192,58366,87.7,109209,51030,58179,87.7
22003, 동부,070001, 65세,2017,26483,12402,14081,88.1,26388,12358,14030,88.1
22003, 동부,070002, 66세,2017,20220,9518,10702,88.9,20131,9474,10657,88.9
22003, 동부,070003, 67세,2017,20408,9705,10703,90.7,20347,9680,10667,90.7
22003, 동부,070004, 68세,2017,21896,10105,11791,85.7,21833,10075,11758,85.7
22003, 동부,070005, 69세,2017,20551,9462,11089,85.3,20510,9443,11067,85.3
22003, 동부,075,70~74세,2017,76645,33947,42698,79.5,76513,33880,42633,79.5
22003, 동부,075001, 70세,2017,19101,8611,10490,82.1,19067,8594,10473,82.1
22003, 동부,075002, 71세,2017,12937,5963,6974,85.5,12900,5943,6957,85.4
22003, 동부,075003, 72세,2017,13359,5865,7494,78.3,13339,5855,7484,78.2
22003, 동부,075004, 73세,2017,15261,6514,8747,74.5,15237,6500,8737,74.4
22003, 동부,075005, 74세,2017,15987,6994,8993,77.8,15970,6988,8982,77.8
22003, 동부,080,75~79세,2017,67276,27681,39595,69.9,67198,27653,39545,69.9
22003, 동부,080001, 75세,2017,17254,7495,9759,76.8,17240,7489,9751,76.8
22003, 동부,080002, 76세,2017,14039,5870,8169,71.9,14018,5862,8156,71.9
22003, 동부,080003, 77세,2017,12734,5079,7655,66.3,12717,5074,7643,66.4
22003, 동부,080004, 78세,2017,12457,5067,7390,68.6,12441,5060,7381,68.6
22003, 동부,080005, 79세,2017,10792,4170,6622,63,10782,4168,6614,63
22003, 동부,085,80~84세,2017,39620,14140,25480,55.5,39563,14117,25446,55.5
22003, 동부,085001, 80세,2017,9816,3720,6096,61,9805,3717,6088,61.1
22003, 동부,085002, 81세,2017,8960,3241,5719,56.7,8948,3236,5712,56.7
22003, 동부,085003, 82세,2017,8206,2951,5255,56.2,8196,2948,5248,56.2
22003, 동부,085004, 83세,2017,7031,2445,4586,53.3,7021,2439,4582,53.2
22003, 동부,085005, 84세,2017,5607,1783,3824,46.6,5593,1777,3816,46.6
22003, 동부,090,85~89세,2017,16846,4655,12191,38.2,16824,4640,12184,38.1
22003, 동부,090001, 85세,2017,5032,1588,3444,46.1,5024,1582,3442,46
22003, 동부,090002, 86세,2017,3814,1066,2748,38.8,3810,1064,2746,38.7
22003, 동부,090003, 87세,2017,3157,767,2390,32.1,3153,764,2389,32
22003, 동부,090004, 88세,2017,2670,694,1976,35.1,2667,692,1975,35
22003, 동부,090005, 89세,2017,2173,540,1633,33.1,2170,538,1632,33
22003, 동부,095,90~94세,2017,5024,1100,3924,28,5013,1098,3915,28
22003, 동부,095001, 90세,2017,1739,406,1333,30.5,1737,405,1332,30.4
22003, 동부,095002, 91세,2017,1088,236,852,27.7,1085,236,849,27.8
22003, 동부,095003, 92세,2017,1045,226,819,27.6,1042,226,816,27.7
22003, 동부,095004, 93세,2017,651,127,524,24.2,649,126,523,24.1
22003, 동부,095005, 94세,2017,501,105,396,26.5,500,105,395,26.6
22003, 동부,100,95~99세,2017,1008,184,824,22.3,1005,183,822,22.3
22003, 동부,100001, 95세,2017,417,80,337,23.7,417,80,337,23.7
22003, 동부,100002, 96세,2017,249,45,204,22.1,249,45,204,22.1
22003, 동부,100003, 97세,2017,171,29,142,20.4,171,29,142,20.4
22003, 동부,100004, 98세,2017,115,22,93,23.7,115,22,93,23.7
22003, 동부,100005, 99세,2017,56,8,48,16.7,53,7,46,15.2
22003, 동부,101,100세이상,2017,126,18,108,16.7,125,18,107,16.8
22003, 동부,102,15세미만,2017,271232,140455,130777,107.4,270649,140160,130489,107.4
22003, 동부,103,15~64세,2017,1626466,822160,804306,102.2,1603206,809302,793904,101.9
22003, 동부,104,65세이상,2017,316103,132917,183186,72.6,315450,132619,182831,72.5
22003, 동부,086,85세이상,2017,23004,5957,17047,34.9,22967,5939,17028,34.9
22003, 동부,126,평균연령,2017,41.9,40.5,43.3,,42,40.5,43.3,
22003, 동부,127,중위연령,2017,43.5,41.8,45,,43.7,42,45.2,
22010, 중구,000,합계,2017,75324,36422,38902,93.6,74501,36029,38472,93.6
22010, 중구,005,0~4세,2017,2828,1464,1364,107.3,2815,1457,1358,107.3
22010, 중구,005001, 0세,2017,552,299,253,118.2,549,296,253,117
22010, 중구,005002, 1세,2017,615,319,296,107.8,612,317,295,107.5
22010, 중구,005003, 2세,2017,561,282,279,101.1,558,281,277,101.4
22010, 중구,005004, 3세,2017,543,290,253,114.6,542,290,252,115.1
22010, 중구,005005, 4세,2017,557,274,283,96.8,554,273,281,97.2
22010, 중구,010,5~9세,2017,2569,1345,1224,109.9,2564,1341,1223,109.6
22010, 중구,010001, 5세,2017,579,321,258,124.4,579,321,258,124.4
22010, 중구,010002, 6세,2017,561,282,279,101.1,559,280,279,100.4
22010, 중구,010003, 7세,2017,499,255,244,104.5,498,254,244,104.1
22010, 중구,010004, 8세,2017,470,264,206,128.2,470,264,206,128.2
22010, 중구,010005, 9세,2017,460,223,237,94.1,458,222,236,94.1
22010, 중구,015,10~14세,2017,2237,1182,1055,112,2236,1181,1055,111.9
22010, 중구,015001, 10세,2017,465,270,195,138.5,464,269,195,137.9
22010, 중구,015002, 11세,2017,444,227,217,104.6,444,227,217,104.6
22010, 중구,015003, 12세,2017,403,221,182,121.4,403,221,182,121.4
22010, 중구,015004, 13세,2017,445,209,236,88.6,445,209,236,88.6
22010, 중구,015005, 14세,2017,480,255,225,113.3,480,255,225,113.3
22010, 중구,020,15~19세,2017,2984,1464,1520,96.3,2974,1459,1515,96.3
22010, 중구,020001, 15세,2017,507,260,247,105.3,506,259,247,104.9
22010, 중구,020002, 16세,2017,591,286,305,93.8,590,286,304,94.1
22010, 중구,020003, 17세,2017,629,302,327,92.4,627,301,326,92.3
22010, 중구,020004, 18세,2017,642,314,328,95.7,641,313,328,95.4
22010, 중구,020005, 19세,2017,615,302,313,96.5,610,300,310,96.8
22010, 중구,025,20~24세,2017,4873,2384,2489,95.8,4800,2344,2456,95.4
22010, 중구,025001, 20세,2017,725,376,349,107.7,714,370,344,107.6
22010, 중구,025002, 21세,2017,874,451,423,106.6,863,444,419,106
22010, 중구,025003, 22세,2017,967,457,510,89.6,950,446,504,88.5
22010, 중구,025004, 23세,2017,1109,537,572,93.9,1096,530,566,93.6
22010, 중구,025005, 24세,2017,1198,563,635,88.7,1177,554,623,88.9
22010, 중구,030,25~29세,2017,5948,3095,2853,108.5,5809,3026,2783,108.7
22010, 중구,030001, 25세,2017,1307,651,656,99.2,1276,638,638,100
22010, 중구,030002, 26세,2017,1262,672,590,113.9,1242,664,578,114.9
22010, 중구,030003, 27세,2017,1238,641,597,107.4,1205,622,583,106.7
22010, 중구,030004, 28세,2017,1116,574,542,105.9,1093,564,529,106.6
22010, 중구,030005, 29세,2017,1025,557,468,119,993,538,455,118.2
22010, 중구,035,30~34세,2017,5322,2668,2654,100.5,5198,2608,2590,100.7
22010, 중구,035001, 30세,2017,1021,512,509,100.6,994,502,492,102
22010, 중구,035002, 31세,2017,1027,513,514,99.8,1003,503,500,100.6
22010, 중구,035003, 32세,2017,1038,552,486,113.6,1011,535,476,112.4
22010, 중구,035004, 33세,2017,1036,519,517,100.4,1007,501,506,99
22010, 중구,035005, 34세,2017,1200,572,628,91.1,1183,567,616,92
22010, 중구,040,35~39세,2017,5660,2915,2745,106.2,5580,2880,2700,106.7
22010, 중구,040001, 35세,2017,1269,638,631,101.1,1239,628,611,102.8
22010, 중구,040002, 36세,2017,1230,645,585,110.3,1222,641,581,110.3
22010, 중구,040003, 37세,2017,1167,610,557,109.5,1147,598,549,108.9
22010, 중구,040004, 38세,2017,1087,552,535,103.2,1076,548,528,103.8
22010, 중구,040005, 39세,2017,907,470,437,107.6,896,465,431,107.9
22010, 중구,045,40~44세,2017,5211,2716,2495,108.9,5157,2694,2463,109.4
22010, 중구,045001, 40세,2017,983,511,472,108.3,970,508,462,110
22010, 중구,045002, 41세,2017,1022,548,474,115.6,1014,546,468,116.7
22010, 중구,045003, 42세,2017,1011,532,479,111.1,996,527,469,112.4
22010, 중구,045004, 43세,2017,1119,578,541,106.8,1110,574,536,107.1
22010, 중구,045005, 44세,2017,1076,547,529,103.4,1067,539,528,102.1
22010, 중구,050,45~49세,2017,5806,2958,2848,103.9,5737,2919,2818,103.6
22010, 중구,050001, 45세,2017,1134,590,544,108.5,1123,580,543,106.8
22010, 중구,050002, 46세,2017,1220,618,602,102.7,1200,608,592,102.7
22010, 중구,050003, 47세,2017,1167,579,588,98.5,1155,573,582,98.5
22010, 중구,050004, 48세,2017,1087,549,538,102,1075,543,532,102.1
22010, 중구,050005, 49세,2017,1198,622,576,108,1184,615,569,108.1
22010, 중구,055,50~54세,2017,5468,2682,2786,96.3,5390,2638,2752,95.9
22010, 중구,055001, 50세,2017,1103,528,575,91.8,1093,521,572,91.1
22010, 중구,055002, 51세,2017,1041,499,542,92.1,1026,494,532,92.9
22010, 중구,055003, 52세,2017,1121,556,565,98.4,1097,540,557,96.9
22010, 중구,055004, 53세,2017,1114,562,552,101.8,1099,556,543,102.4
22010, 중구,055005, 54세,2017,1089,537,552,97.3,1075,527,548,96.2
22010, 중구,060,55~59세,2017,6221,2996,3225,92.9,6154,2971,3183,93.3
22010, 중구,060001, 55세,2017,1245,613,632,97,1228,606,622,97.4
22010, 중구,060002, 56세,2017,1279,600,679,88.4,1267,597,670,89.1
22010, 중구,060003, 57세,2017,1346,656,690,95.1,1325,645,680,94.9
22010, 중구,060004, 58세,2017,1234,567,667,85,1230,566,664,85.2
22010, 중구,060005, 59세,2017,1117,560,557,100.5,1104,557,547,101.8
22010, 중구,065,60~64세,2017,5450,2526,2924,86.4,5403,2508,2895,86.6
22010, 중구,065001, 60세,2017,1200,561,639,87.8,1189,557,632,88.1
22010, 중구,065002, 61세,2017,1196,566,630,89.8,1186,561,625,89.8
22010, 중구,065003, 62세,2017,1150,532,618,86.1,1145,531,614,86.5
22010, 중구,065004, 63세,2017,999,477,522,91.4,988,471,517,91.1
22010, 중구,065005, 64세,2017,905,390,515,75.7,895,388,507,76.5
22010, 중구,070,65~69세,2017,4571,1983,2588,76.6,4544,1973,2571,76.7
22010, 중구,070001, 65세,2017,1039,450,589,76.4,1034,448,586,76.5
22010, 중구,070002, 66세,2017,796,348,448,77.7,789,345,444,77.7
22010, 중구,070003, 67세,2017,860,387,473,81.8,855,387,468,82.7
22010, 중구,070004, 68세,2017,928,384,544,70.6,923,381,542,70.3
22010, 중구,070005, 69세,2017,948,414,534,77.5,943,412,531,77.6
22010, 중구,075,70~74세,2017,3775,1610,2165,74.4,3764,1605,2159,74.3
22010, 중구,075001, 70세,2017,837,342,495,69.1,836,342,494,69.2
22010, 중구,075002, 71세,2017,653,280,373,75.1,651,279,372,75
22010, 중구,075003, 72세,2017,659,280,379,73.9,658,279,379,73.6
22010, 중구,075004, 73세,2017,804,338,466,72.5,799,335,464,72.2
22010, 중구,075005, 74세,2017,822,370,452,81.9,820,370,450,82.2
22010, 중구,080,75~79세,2017,3291,1374,1917,71.7,3285,1373,1912,71.8
22010, 중구,080001, 75세,2017,847,374,473,79.1,846,374,472,79.2
22010, 중구,080002, 76세,2017,633,274,359,76.3,633,274,359,76.3
22010, 중구,080003, 77세,2017,642,258,384,67.2,641,257,384,66.9
22010, 중구,080004, 78세,2017,613,248,365,67.9,613,248,365,67.9
22010, 중구,080005, 79세,2017,556,220,336,65.5,552,220,332,66.3
22010, 중구,085,80~84세,2017,1888,717,1171,61.2,1873,712,1161,61.3
22010, 중구,085001, 80세,2017,474,187,287,65.2,471,186,285,65.3
22010, 중구,085002, 81세,2017,441,174,267,65.2,438,173,265,65.3
22010, 중구,085003, 82세,2017,384,160,224,71.4,383,160,223,71.7
22010, 중구,085004, 83세,2017,329,121,208,58.2,326,120,206,58.3
22010, 중구,085005, 84세,2017,260,75,185,40.5,255,73,182,40.1
22010, 중구,090,85~89세,2017,878,269,609,44.2,874,266,608,43.8
22010, 중구,090001, 85세,2017,256,87,169,51.5,255,86,169,50.9
22010, 중구,090002, 86세,2017,195,62,133,46.6,194,62,132,47
22010, 중구,090003, 87세,2017,156,41,115,35.7,155,40,115,34.8
22010, 중구,090004, 88세,2017,143,40,103,38.8,142,39,103,37.9
22010, 중구,090005, 89세,2017,128,39,89,43.8,128,39,89,43.8
22010, 중구,095,90~94세,2017,272,61,211,28.9,272,61,211,28.9
22010, 중구,095001, 90세,2017,106,26,80,32.5,106,26,80,32.5
22010, 중구,095002, 91세,2017,56,13,43,30.2,56,13,43,30.2
22010, 중구,095003, 92세,2017,51,6,45,13.3,51,6,45,13.3
22010, 중구,095004, 93세,2017,32,11,21,52.4,32,11,21,52.4
22010, 중구,095005, 94세,2017,27,5,22,22.7,27,5,22,22.7
22010, 중구,100,95~99세,2017,67,12,55,21.8,67,12,55,21.8
22010, 중구,100001, 95세,2017,25,X,24,4.2,25,X,24,4.2
22010, 중구,100002, 96세,2017,22,X,18,22.2,22,X,18,22.2
22010, 중구,100003, 97세,2017,14,5,9,55.6,14,5,9,55.6
22010, 중구,100004, 98세,2017,5,X,X,66.7,5,X,X,66.7
22010, 중구,100005, 99세,2017,X,X,X,0,X,X,X,0
22010, 중구,101,100세이상,2017,5,X,X,25,5,X,X,25
22010, 중구,102,15세미만,2017,7634,3991,3643,109.6,7615,3979,3636,109.4
22010, 중구,103,15~64세,2017,52943,26404,26539,99.5,52202,26047,26155,99.6
22010, 중구,104,65세이상,2017,14747,6027,8720,69.1,14684,6003,8681,69.2
22010, 중구,086,85세이상,2017,1222,343,879,39,1218,340,878,38.7
22010, 중구,126,평균연령,2017,44.4,42.9,45.9,,44.5,42.9,46,
22010, 중구,127,중위연령,2017,45,43.2,46.8,,45.1,43.2,46.9,
22020, 동구,000,합계,2017,340396,167950,172446,97.4,338334,167173,171161,97.7
22020, 동구,005,0~4세,2017,14327,7293,7034,103.7,14299,7278,7021,103.7
22020, 동구,005001, 0세,2017,2537,1317,1220,108,2533,1315,1218,108
22020, 동구,005002, 1세,2017,2784,1372,1412,97.2,2781,1370,1411,97.1
22020, 동구,005003, 2세,2017,3051,1565,1486,105.3,3043,1559,1484,105.1
22020, 동구,005004, 3세,2017,2984,1520,1464,103.8,2978,1518,1460,104
22020, 동구,005005, 4세,2017,2971,1519,1452,104.6,2964,1516,1448,104.7
22020, 동구,010,5~9세,2017,14732,7628,7104,107.4,14714,7620,7094,107.4
22020, 동구,010001, 5세,2017,3222,1667,1555,107.2,3219,1665,1554,107.1
22020, 동구,010002, 6세,2017,2987,1565,1422,110.1,2981,1563,1418,110.2
22020, 동구,010003, 7세,2017,2912,1517,1395,108.7,2910,1516,1394,108.8
22020, 동구,010004, 8세,2017,2782,1455,1327,109.6,2780,1454,1326,109.7
22020, 동구,010005, 9세,2017,2829,1424,1405,101.4,2824,1422,1402,101.4
22020, 동구,015,10~14세,2017,13137,6874,6263,109.8,13118,6863,6255,109.7
22020, 동구,015001, 10세,2017,2811,1456,1355,107.5,2810,1456,1354,107.5
22020, 동구,015002, 11세,2017,2471,1301,1170,111.2,2467,1298,1169,111
22020, 동구,015003, 12세,2017,2472,1328,1144,116.1,2467,1326,1141,116.2
22020, 동구,015004, 13세,2017,2622,1361,1261,107.9,2619,1361,1258,108.2
22020, 동구,015005, 14세,2017,2761,1428,1333,107.1,2755,1422,1333,106.7
22020, 동구,020,15~19세,2017,15919,8601,7318,117.5,15879,8590,7289,117.8
22020, 동구,020001, 15세,2017,2741,1461,1280,114.1,2735,1458,1277,114.2
22020, 동구,020002, 16세,2017,3052,1621,1431,113.3,3049,1619,1430,113.2
22020, 동구,020003, 17세,2017,3481,1924,1557,123.6,3476,1923,1553,123.8
22020, 동구,020004, 18세,2017,3336,1779,1557,114.3,3328,1779,1549,114.8
22020, 동구,020005, 19세,2017,3309,1816,1493,121.6,3291,1811,1480,122.4
22020, 동구,025,20~24세,2017,20410,11064,9346,118.4,20223,11024,9199,119.8
22020, 동구,025001, 20세,2017,3747,1991,1756,113.4,3723,1985,1738,114.2
22020, 동구,025002, 21세,2017,4004,2208,1796,122.9,3973,2202,1771,124.3
22020, 동구,025003, 22세,2017,4141,2265,1876,120.7,4109,2259,1850,122.1
22020, 동구,025004, 23세,2017,4256,2309,1947,118.6,4206,2294,1912,120
22020, 동구,025005, 24세,2017,4262,2291,1971,116.2,4212,2284,1928,118.5
22020, 동구,030,25~29세,2017,20666,11121,9545,116.5,20306,11001,9305,118.2
22020, 동구,030001, 25세,2017,4415,2355,2060,114.3,4342,2325,2017,115.3
22020, 동구,030002, 26세,2017,4198,2263,1935,117,4148,2249,1899,118.4
22020, 동구,030003, 27세,2017,4141,2295,1846,124.3,4062,2270,1792,126.7
22020, 동구,030004, 28세,2017,4043,2170,1873,115.9,3963,2144,1819,117.9
22020, 동구,030005, 29세,2017,3869,2038,1831,111.3,3791,2013,1778,113.2
22020, 동구,035,30~34세,2017,21237,11001,10236,107.5,20948,10909,10039,108.7
22020, 동구,035001, 30세,2017,4095,2130,1965,108.4,4028,2105,1923,109.5
22020, 동구,035002, 31세,2017,3958,2096,1862,112.6,3895,2075,1820,114
22020, 동구,035003, 32세,2017,4062,2110,1952,108.1,4005,2093,1912,109.5
22020, 동구,035004, 33세,2017,4322,2232,2090,106.8,4272,2216,2056,107.8
22020, 동구,035005, 34세,2017,4800,2433,2367,102.8,4748,2420,2328,104
22020, 동구,040,35~39세,2017,27011,13698,13313,102.9,26759,13608,13151,103.5
22020, 동구,040001, 35세,2017,5431,2689,2742,98.1,5367,2669,2698,98.9
22020, 동구,040002, 36세,2017,5650,2851,2799,101.9,5602,2835,2767,102.5
22020, 동구,040003, 37세,2017,5746,2926,2820,103.8,5697,2907,2790,104.2
22020, 동구,040004, 38세,2017,5336,2681,2655,101,5286,2663,2623,101.5
22020, 동구,040005, 39세,2017,4848,2551,2297,111.1,4807,2534,2273,111.5
22020, 동구,045,40~44세,2017,25629,13405,12224,109.7,25454,13326,12128,109.9
22020, 동구,045001, 40세,2017,4991,2557,2434,105.1,4945,2536,2409,105.3
22020, 동구,045002, 41세,2017,4881,2612,2269,115.1,4848,2594,2254,115.1
22020, 동구,045003, 42세,2017,5082,2696,2386,113,5047,2680,2367,113.2
22020, 동구,045004, 43세,2017,5360,2791,2569,108.6,5320,2778,2542,109.3
22020, 동구,045005, 44세,2017,5315,2749,2566,107.1,5294,2738,2556,107.1
22020, 동구,050,45~49세,2017,27447,13856,13591,101.9,27258,13775,13483,102.2
22020, 동구,050001, 45세,2017,5325,2789,2536,110,5293,2773,2520,110
22020, 동구,050002, 46세,2017,5543,2895,2648,109.3,5506,2877,2629,109.4
22020, 동구,050003, 47세,2017,5414,2715,2699,100.6,5377,2704,2673,101.2
22020, 동구,050004, 48세,2017,5483,2684,2799,95.9,5441,2662,2779,95.8
22020, 동구,050005, 49세,2017,5682,2773,2909,95.3,5641,2759,2882,95.7
22020, 동구,055,50~54세,2017,26851,12950,13901,93.2,26654,12870,13784,93.4
22020, 동구,055001, 50세,2017,5290,2507,2783,90.1,5259,2498,2761,90.5
22020, 동구,055002, 51세,2017,5268,2583,2685,96.2,5223,2563,2660,96.4
22020, 동구,055003, 52세,2017,5440,2597,2843,91.3,5403,2580,2823,91.4
22020, 동구,055004, 53세,2017,5329,2586,2743,94.3,5288,2570,2718,94.6
22020, 동구,055005, 54세,2017,5524,2677,2847,94,5481,2659,2822,94.2
22020, 동구,060,55~59세,2017,30083,14241,15842,89.9,29950,14177,15773,89.9
22020, 동구,060001, 55세,2017,5882,2829,3053,92.7,5858,2816,3042,92.6
22020, 동구,060002, 56세,2017,6520,3088,3432,90,6498,3076,3422,89.9
22020, 동구,060003, 57세,2017,6437,2995,3442,87,6406,2983,3423,87.1
22020, 동구,060004, 58세,2017,5889,2718,3171,85.7,5865,2708,3157,85.8
22020, 동구,060005, 59세,2017,5355,2611,2744,95.2,5323,2594,2729,95.1
22020, 동구,065,60~64세,2017,25328,11851,13477,87.9,25238,11804,13434,87.9
22020, 동구,065001, 60세,2017,5593,2645,2948,89.7,5574,2636,2938,89.7
22020, 동구,065002, 61세,2017,5357,2541,2816,90.2,5338,2530,2808,90.1
22020, 동구,065003, 62세,2017,5460,2513,2947,85.3,5442,2504,2938,85.2
22020, 동구,065004, 63세,2017,4581,2144,2437,88,4565,2136,2429,87.9
22020, 동구,065005, 64세,2017,4337,2008,2329,86.2,4319,1998,2321,86.1
22020, 동구,070,65~69세,2017,19994,9332,10662,87.5,19949,9312,10637,87.5
22020, 동구,070001, 65세,2017,4700,2222,2478,89.7,4688,2218,2470,89.8
22020, 동구,070002, 66세,2017,3701,1723,1978,87.1,3688,1718,1970,87.2
22020, 동구,070003, 67세,2017,3720,1750,1970,88.8,3710,1745,1965,88.8
22020, 동구,070004, 68세,2017,4105,1891,2214,85.4,4098,1886,2212,85.3
22020, 동구,070005, 69세,2017,3768,1746,2022,86.4,3765,1745,2020,86.4
22020, 동구,075,70~74세,2017,14126,6261,7865,79.6,14103,6249,7854,79.6
22020, 동구,075001, 70세,2017,3468,1590,1878,84.7,3462,1588,1874,84.7
22020, 동구,075002, 71세,2017,2381,1086,1295,83.9,2372,1079,1293,83.4
22020, 동구,075003, 72세,2017,2526,1089,1437,75.8,2523,1086,1437,75.6
22020, 동구,075004, 73세,2017,2794,1192,1602,74.4,2790,1192,1598,74.6
22020, 동구,075005, 74세,2017,2957,1304,1653,78.9,2956,1304,1652,78.9
22020, 동구,080,75~79세,2017,12368,5105,7263,70.3,12361,5104,7257,70.3
22020, 동구,080001, 75세,2017,3106,1330,1776,74.9,3105,1329,1776,74.8
22020, 동구,080002, 76세,2017,2642,1122,1520,73.8,2639,1122,1517,74
22020, 동구,080003, 77세,2017,2374,975,1399,69.7,2373,975,1398,69.7
22020, 동구,080004, 78세,2017,2293,955,1338,71.4,2291,955,1336,71.5
22020, 동구,080005, 79세,2017,1953,723,1230,58.8,1953,723,1230,58.8
22020, 동구,085,80~84세,2017,7151,2607,4544,57.4,7144,2604,4540,57.4
22020, 동구,085001, 80세,2017,1802,714,1088,65.6,1801,714,1087,65.7
22020, 동구,085002, 81세,2017,1620,598,1022,58.5,1619,597,1022,58.4
22020, 동구,085003, 82세,2017,1485,549,936,58.7,1483,549,934,58.8
22020, 동구,085004, 83세,2017,1252,442,810,54.6,1250,440,810,54.3
22020, 동구,085005, 84세,2017,992,304,688,44.2,991,304,687,44.3
22020, 동구,090,85~89세,2017,2882,833,2049,40.7,2879,830,2049,40.5
22020, 동구,090001, 85세,2017,870,279,591,47.2,869,278,591,47
22020, 동구,090002, 86세,2017,653,193,460,42,653,193,460,42
22020, 동구,090003, 87세,2017,532,140,392,35.7,532,140,392,35.7
22020, 동구,090004, 88세,2017,456,121,335,36.1,455,120,335,35.8
22020, 동구,090005, 89세,2017,371,100,271,36.9,370,99,271,36.5
22020, 동구,095,90~94세,2017,885,186,699,26.6,885,186,699,26.6
22020, 동구,095001, 90세,2017,316,76,240,31.7,316,76,240,31.7
22020, 동구,095002, 91세,2017,176,34,142,23.9,176,34,142,23.9
22020, 동구,095003, 92세,2017,188,37,151,24.5,188,37,151,24.5
22020, 동구,095004, 93세,2017,124,25,99,25.3,124,25,99,25.3
22020, 동구,095005, 94세,2017,81,14,67,20.9,81,14,67,20.9
22020, 동구,100,95~99세,2017,190,39,151,25.8,190,39,151,25.8
22020, 동구,100001, 95세,2017,84,16,68,23.5,84,16,68,23.5
22020, 동구,100002, 96세,2017,44,13,31,41.9,44,13,31,41.9
22020, 동구,100003, 97세,2017,26,X,23,13,26,X,23,13
22020, 동구,100004, 98세,2017,25,6,19,31.6,25,6,19,31.6
22020, 동구,100005, 99세,2017,11,X,10,10,11,X,10,10
22020, 동구,101,100세이상,2017,23,X,19,21.1,23,X,19,21.1
22020, 동구,102,15세미만,2017,42196,21795,20401,106.8,42131,21761,20370,106.8
22020, 동구,103,15~64세,2017,240581,121788,118793,102.5,238669,121084,117585,103
22020, 동구,104,65세이상,2017,57619,24367,33252,73.3,57534,24328,33206,73.3
22020, 동구,086,85세이상,2017,3980,1062,2918,36.4,3977,1059,2918,36.3
22020, 동구,126,평균연령,2017,43.2,41.6,44.7,,43.2,41.6,44.8,
22020, 동구,127,중위연령,2017,44.5,42.6,46.5,,44.5,42.6,46.6,
22030, 서구,000,합계,2017,191414,96275,95139,101.2,188540,94631,93909,100.8
22030, 서구,005,0~4세,2017,5002,2534,2468,102.7,4971,2522,2449,103
22030, 서구,005001, 0세,2017,873,442,431,102.6,865,440,425,103.5
22030, 서구,005002, 1세,2017,1036,535,501,106.8,1029,531,498,106.6
22030, 서구,005003, 2세,2017,1001,521,480,108.5,994,519,475,109.3
22030, 서구,005004, 3세,2017,1027,512,515,99.4,1019,509,510,99.8
22030, 서구,005005, 4세,2017,1065,524,541,96.9,1064,523,541,96.7
22030, 서구,010,5~9세,2017,5221,2669,2552,104.6,5197,2657,2540,104.6
22030, 서구,010001, 5세,2017,1134,581,553,105.1,1126,578,548,105.5
22030, 서구,010002, 6세,2017,1100,561,539,104.1,1096,558,538,103.7
22030, 서구,010003, 7세,2017,964,494,470,105.1,960,491,469,104.7
22030, 서구,010004, 8세,2017,1000,500,500,100,996,499,497,100.4
22030, 서구,010005, 9세,2017,1023,533,490,108.8,1019,531,488,108.8
22030, 서구,015,10~14세,2017,5635,2942,2693,109.2,5623,2934,2689,109.1
22030, 서구,015001, 10세,2017,1077,528,549,96.2,1072,524,548,95.6
22030, 서구,015002, 11세,2017,1058,535,523,102.3,1058,535,523,102.3
22030, 서구,015003, 12세,2017,1007,527,480,109.8,1004,527,477,110.5
22030, 서구,015004, 13세,2017,1165,643,522,123.2,1163,641,522,122.8
22030, 서구,015005, 14세,2017,1328,709,619,114.5,1326,707,619,114.2
22030, 서구,020,15~19세,2017,9353,5065,4288,118.1,9316,5046,4270,118.2
22030, 서구,020001, 15세,2017,1448,777,671,115.8,1442,774,668,115.9
22030, 서구,020002, 16세,2017,1821,979,842,116.3,1818,976,842,115.9
22030, 서구,020003, 17세,2017,2104,1126,978,115.1,2098,1122,976,115
22030, 서구,020004, 18세,2017,1939,1041,898,115.9,1932,1036,896,115.6
22030, 서구,020005, 19세,2017,2041,1142,899,127,2026,1138,888,128.2
22030, 서구,025,20~24세,2017,13141,7378,5763,128,12897,7244,5653,128.1
22030, 서구,025001, 20세,2017,2306,1275,1031,123.7,2285,1260,1025,122.9
22030, 서구,025002, 21세,2017,2490,1396,1094,127.6,2459,1377,1082,127.3
22030, 서구,025003, 22세,2017,2741,1532,1209,126.7,2695,1509,1186,127.2
22030, 서구,025004, 23세,2017,2775,1567,1208,129.7,2710,1535,1175,130.6
22030, 서구,025005, 24세,2017,2829,1608,1221,131.7,2748,1563,1185,131.9
22030, 서구,030,25~29세,2017,12739,7219,5520,130.8,12229,6943,5286,131.3
22030, 서구,030001, 25세,2017,2956,1646,1310,125.6,2865,1598,1267,126.1
22030, 서구,030002, 26세,2017,2684,1480,1204,122.9,2592,1427,1165,122.5
22030, 서구,030003, 27세,2017,2492,1429,1063,134.4,2394,1377,1017,135.4
22030, 서구,030004, 28세,2017,2413,1375,1038,132.5,2304,1317,987,133.4
22030, 서구,030005, 29세,2017,2194,1289,905,142.4,2074,1224,850,144
22030, 서구,035,30~34세,2017,10809,6057,4752,127.5,10288,5744,4544,126.4
22030, 서구,035001, 30세,2017,2174,1245,929,134,2044,1165,879,132.5
22030, 서구,035002, 31세,2017,2167,1212,955,126.9,2063,1148,915,125.5
22030, 서구,035003, 32세,2017,2026,1128,898,125.6,1920,1074,846,127
22030, 서구,035004, 33세,2017,2057,1154,903,127.8,1975,1099,876,125.5
22030, 서구,035005, 34세,2017,2385,1318,1067,123.5,2286,1258,1028,122.4
22030, 서구,040,35~39세,2017,12059,6582,5477,120.2,11669,6332,5337,118.6
22030, 서구,040001, 35세,2017,2480,1334,1146,116.4,2409,1287,1122,114.7
22030, 서구,040002, 36세,2017,2481,1409,1072,131.4,2410,1362,1048,130
22030, 서구,040003, 37세,2017,2531,1360,1171,116.1,2453,1305,1148,113.7
22030, 서구,040004, 38세,2017,2437,1336,1101,121.3,2343,1281,1062,120.6
22030, 서구,040005, 39세,2017,2130,1143,987,115.8,2054,1097,957,114.6
22030, 서구,045,40~44세,2017,12429,6815,5614,121.4,12141,6640,5501,120.7
22030, 서구,045001, 40세,2017,2238,1246,992,125.6,2157,1192,965,123.5
22030, 서구,045002, 41세,2017,2239,1241,998,124.3,2176,1197,979,122.3
22030, 서구,045003, 42세,2017,2484,1348,1136,118.7,2440,1325,1115,118.8
22030, 서구,045004, 43세,2017,2639,1464,1175,124.6,2584,1434,1150,124.7
22030, 서구,045005, 44세,2017,2829,1516,1313,115.5,2784,1492,1292,115.5
22030, 서구,050,45~49세,2017,16023,8178,7845,104.2,15754,8009,7745,103.4
22030, 서구,050001, 45세,2017,2827,1483,1344,110.3,2768,1442,1326,108.7
22030, 서구,050002, 46세,2017,3093,1606,1487,108,3035,1575,1460,107.9
22030, 서구,050003, 47세,2017,3217,1629,1588,102.6,3162,1595,1567,101.8
22030, 서구,050004, 48세,2017,3358,1682,1676,100.4,3304,1644,1660,99
22030, 서구,050005, 49세,2017,3528,1778,1750,101.6,3485,1753,1732,101.2
22030, 서구,055,50~54세,2017,17899,8926,8973,99.5,17668,8807,8861,99.4
22030, 서구,055001, 50세,2017,3399,1684,1715,98.2,3358,1664,1694,98.2
22030, 서구,055002, 51세,2017,3555,1814,1741,104.2,3512,1792,1720,104.2
22030, 서구,055003, 52세,2017,3728,1838,1890,97.2,3677,1810,1867,96.9
22030, 서구,055004, 53세,2017,3587,1794,1793,100.1,3543,1770,1773,99.8
22030, 서구,055005, 54세,2017,3630,1796,1834,97.9,3578,1771,1807,98
22030, 서구,060,55~59세,2017,20047,9700,10347,93.7,19910,9631,10279,93.7
22030, 서구,060001, 55세,2017,4084,1997,2087,95.7,4047,1981,2066,95.9
22030, 서구,060002, 56세,2017,4405,2148,2257,95.2,4381,2132,2249,94.8
22030, 서구,060003, 57세,2017,4267,2053,2214,92.7,4235,2037,2198,92.7
22030, 서구,060004, 58세,2017,3923,1868,2055,90.9,3899,1857,2042,90.9
22030, 서구,060005, 59세,2017,3368,1634,1734,94.2,3348,1624,1724,94.2
22030, 서구,065,60~64세,2017,16217,7615,8602,88.5,16121,7559,8562,88.3
22030, 서구,065001, 60세,2017,3579,1731,1848,93.7,3558,1719,1839,93.5
22030, 서구,065002, 61세,2017,3391,1594,1797,88.7,3375,1585,1790,88.5
22030, 서구,065003, 62세,2017,3414,1545,1869,82.7,3396,1532,1864,82.2
22030, 서구,065004, 63세,2017,2924,1387,1537,90.2,2903,1375,1528,90
22030, 서구,065005, 64세,2017,2909,1358,1551,87.6,2889,1348,1541,87.5
22030, 서구,070,65~69세,2017,12620,5897,6723,87.7,12567,5877,6690,87.8
22030, 서구,070001, 65세,2017,3151,1418,1733,81.8,3140,1414,1726,81.9
22030, 서구,070002, 66세,2017,2324,1088,1236,88,2309,1082,1227,88.2
22030, 서구,070003, 67세,2017,2270,1132,1138,99.5,2261,1129,1132,99.7
22030, 서구,070004, 68세,2017,2494,1181,1313,89.9,2485,1177,1308,90
22030, 서구,070005, 69세,2017,2381,1078,1303,82.7,2372,1075,1297,82.9
22030, 서구,075,70~74세,2017,8570,3807,4763,79.9,8558,3802,4756,79.9
22030, 서구,075001, 70세,2017,2153,956,1197,79.9,2150,955,1195,79.9
22030, 서구,075002, 71세,2017,1403,623,780,79.9,1400,621,779,79.7
22030, 서구,075003, 72세,2017,1457,684,773,88.5,1454,684,770,88.8
22030, 서구,075004, 73세,2017,1747,733,1014,72.3,1745,731,1014,72.1
22030, 서구,075005, 74세,2017,1810,811,999,81.2,1809,811,998,81.3
22030, 서구,080,75~79세,2017,7280,3009,4271,70.5,7272,3007,4265,70.5
22030, 서구,080001, 75세,2017,1931,834,1097,76,1929,833,1096,76
22030, 서구,080002, 76세,2017,1531,658,873,75.4,1529,657,872,75.3
22030, 서구,080003, 77세,2017,1331,523,808,64.7,1328,523,805,65
22030, 서구,080004, 78세,2017,1363,555,808,68.7,1363,555,808,68.7
22030, 서구,080005, 79세,2017,1124,439,685,64.1,1123,439,684,64.2
22030, 서구,085,80~84세,2017,4031,1394,2637,52.9,4027,1392,2635,52.8
22030, 서구,085001, 80세,2017,1046,365,681,53.6,1046,365,681,53.6
22030, 서구,085002, 81세,2017,949,345,604,57.1,947,344,603,57
22030, 서구,085003, 82세,2017,783,269,514,52.3,783,269,514,52.3
22030, 서구,085004, 83세,2017,723,256,467,54.8,723,256,467,54.8
22030, 서구,085005, 84세,2017,530,159,371,42.9,528,158,370,42.7
22030, 서구,090,85~89세,2017,1670,387,1283,30.2,1666,384,1282,30
22030, 서구,090001, 85세,2017,488,122,366,33.3,487,121,366,33.1
22030, 서구,090002, 86세,2017,384,100,284,35.2,384,100,284,35.2
22030, 서구,090003, 87세,2017,310,59,251,23.5,309,58,251,23.1
22030, 서구,090004, 88세,2017,254,53,201,26.4,254,53,201,26.4
22030, 서구,090005, 89세,2017,234,53,181,29.3,232,52,180,28.9
22030, 서구,095,90~94세,2017,548,87,461,18.9,547,87,460,18.9
22030, 서구,095001, 90세,2017,177,29,148,19.6,177,29,148,19.6
22030, 서구,095002, 91세,2017,126,23,103,22.3,125,23,102,22.5
22030, 서구,095003, 92세,2017,98,14,84,16.7,98,14,84,16.7
22030, 서구,095004, 93세,2017,83,12,71,16.9,83,12,71,16.9
22030, 서구,095005, 94세,2017,64,9,55,16.4,64,9,55,16.4
22030, 서구,100,95~99세,2017,102,13,89,14.6,100,13,87,14.9
22030, 서구,100001, 95세,2017,39,5,34,14.7,39,5,34,14.7
22030, 서구,100002, 96세,2017,32,X,29,10.3,32,X,29,10.3
22030, 서구,100003, 97세,2017,16,X,13,23.1,16,X,13,23.1
22030, 서구,100004, 98세,2017,9,X,7,28.6,9,X,7,28.6
22030, 서구,100005, 99세,2017,6,X,6,0,X,X,X,0
22030, 서구,101,100세이상,2017,19,X,18,5.6,19,X,18,5.6
22030, 서구,102,15세미만,2017,15858,8145,7713,105.6,15791,8113,7678,105.7
22030, 서구,103,15~64세,2017,140716,73535,67181,109.5,137993,71955,66038,109
22030, 서구,104,65세이상,2017,34840,14595,20245,72.1,34756,14563,20193,72.1
22030, 서구,086,85세이상,2017,2339,488,1851,26.4,2332,485,1847,26.3
22030, 서구,126,평균연령,2017,45.5,43.7,47.3,,45.6,43.8,47.4,
22030, 서구,127,중위연령,2017,48.1,45.6,50.3,,48.3,45.9,50.6,
22040, 남구,000,합계,2017,152785,73530,79255,92.8,151577,73050,78527,93
22040, 남구,005,0~4세,2017,3979,2036,1943,104.8,3972,2033,1939,104.8
22040, 남구,005001, 0세,2017,717,378,339,111.5,715,376,339,110.9
22040, 남구,005002, 1세,2017,805,403,402,100.2,802,403,399,101
22040, 남구,005003, 2세,2017,804,411,393,104.6,803,411,392,104.8
22040, 남구,005004, 3세,2017,813,406,407,99.8,813,406,407,99.8
22040, 남구,005005, 4세,2017,840,438,402,109,839,437,402,108.7
22040, 남구,010,5~9세,2017,4131,2144,1987,107.9,4124,2141,1983,108
22040, 남구,010001, 5세,2017,884,449,435,103.2,879,448,431,103.9
22040, 남구,010002, 6세,2017,811,427,384,111.2,811,427,384,111.2
22040, 남구,010003, 7세,2017,799,413,386,107,799,413,386,107
22040, 남구,010004, 8세,2017,787,393,394,99.7,786,392,394,99.5
22040, 남구,010005, 9세,2017,850,462,388,119.1,849,461,388,118.8
22040, 남구,015,10~14세,2017,4573,2404,2169,110.8,4562,2397,2165,110.7
22040, 남구,015001, 10세,2017,898,463,435,106.4,894,460,434,106
22040, 남구,015002, 11세,2017,857,465,392,118.6,857,465,392,118.6
22040, 남구,015003, 12세,2017,820,440,380,115.8,819,439,380,115.5
22040, 남구,015004, 13세,2017,949,479,470,101.9,946,477,469,101.7
22040, 남구,015005, 14세,2017,1049,557,492,113.2,1046,556,490,113.5
22040, 남구,020,15~19세,2017,7434,3595,3839,93.6,7406,3583,3823,93.7
22040, 남구,020001, 15세,2017,1092,569,523,108.8,1091,569,522,109
22040, 남구,020002, 16세,2017,1386,640,746,85.8,1384,640,744,86
22040, 남구,020003, 17세,2017,1538,718,820,87.6,1533,716,817,87.6
22040, 남구,020004, 18세,2017,1574,759,815,93.1,1569,757,812,93.2
22040, 남구,020005, 19세,2017,1844,909,935,97.2,1829,901,928,97.1
22040, 남구,025,20~24세,2017,11130,5753,5377,107,11005,5714,5291,108
22040, 남구,025001, 20세,2017,2047,998,1049,95.1,2030,991,1039,95.4
22040, 남구,025002, 21세,2017,2299,1190,1109,107.3,2271,1179,1092,108
22040, 남구,025003, 22세,2017,2313,1179,1134,104,2292,1172,1120,104.6
22040, 남구,025004, 23세,2017,2292,1256,1036,121.2,2260,1250,1010,123.8
22040, 남구,025005, 24세,2017,2179,1130,1049,107.7,2152,1122,1030,108.9
22040, 남구,030,25~29세,2017,10123,5281,4842,109.1,9923,5215,4708,110.8
22040, 남구,030001, 25세,2017,2295,1192,1103,108.1,2272,1187,1085,109.4
22040, 남구,030002, 26세,2017,2083,1072,1011,106,2041,1057,984,107.4
22040, 남구,030003, 27세,2017,2018,1043,975,107,1976,1024,952,107.6
22040, 남구,030004, 28세,2017,1924,1047,877,119.4,1873,1029,844,121.9
22040, 남구,030005, 29세,2017,1803,927,876,105.8,1761,918,843,108.9
22040, 남구,035,30~34세,2017,9135,4834,4301,112.4,8970,4776,4194,113.9
22040, 남구,035001, 30세,2017,1731,955,776,123.1,1693,938,755,124.2
22040, 남구,035002, 31세,2017,1787,965,822,117.4,1754,954,800,119.3
22040, 남구,035003, 32세,2017,1860,983,877,112.1,1823,975,848,115
22040, 남구,035004, 33세,2017,1780,906,874,103.7,1760,901,859,104.9
22040, 남구,035005, 34세,2017,1977,1025,952,107.7,1940,1008,932,108.2
22040, 남구,040,35~39세,2017,10240,5196,5044,103,10139,5159,4980,103.6
22040, 남구,040001, 35세,2017,2130,1063,1067,99.6,2112,1055,1057,99.8
22040, 남구,040002, 36세,2017,2159,1082,1077,100.5,2135,1074,1061,101.2
22040, 남구,040003, 37세,2017,2130,1101,1029,107,2105,1093,1012,108
22040, 남구,040004, 38세,2017,1931,962,969,99.3,1922,958,964,99.4
22040, 남구,040005, 39세,2017,1890,988,902,109.5,1865,979,886,110.5
22040, 남구,045,40~44세,2017,10195,5161,5034,102.5,10084,5109,4975,102.7
22040, 남구,045001, 40세,2017,1876,955,921,103.7,1859,950,909,104.5
22040, 남구,045002, 41세,2017,1864,956,908,105.3,1837,943,894,105.5
22040, 남구,045003, 42세,2017,1982,974,1008,96.6,1961,965,996,96.9
22040, 남구,045004, 43세,2017,2131,1096,1035,105.9,2109,1083,1026,105.6
22040, 남구,045005, 44세,2017,2342,1180,1162,101.5,2318,1168,1150,101.6
22040, 남구,050,45~49세,2017,12203,6155,6048,101.8,12105,6113,5992,102
22040, 남구,050001, 45세,2017,2297,1156,1141,101.3,2282,1148,1134,101.2
22040, 남구,050002, 46세,2017,2438,1250,1188,105.2,2424,1246,1178,105.8
22040, 남구,050003, 47세,2017,2484,1214,1270,95.6,2453,1201,1252,95.9
22040, 남구,050004, 48세,2017,2436,1240,1196,103.7,2420,1237,1183,104.6
22040, 남구,050005, 49세,2017,2548,1295,1253,103.4,2526,1281,1245,102.9
22040, 남구,055,50~54세,2017,11934,5717,6217,92,11821,5667,6154,92.1
22040, 남구,055001, 50세,2017,2461,1167,1294,90.2,2439,1161,1278,90.8
22040, 남구,055002, 51세,2017,2290,1162,1128,103,2264,1149,1115,103
22040, 남구,055003, 52세,2017,2379,1142,1237,92.3,2358,1127,1231,91.6
22040, 남구,055004, 53세,2017,2321,1062,1259,84.4,2294,1052,1242,84.7
22040, 남구,055005, 54세,2017,2483,1184,1299,91.1,2466,1178,1288,91.5
22040, 남구,060,55~59세,2017,14170,6642,7528,88.2,14076,6600,7476,88.3
22040, 남구,060001, 55세,2017,2752,1339,1413,94.8,2736,1330,1406,94.6
22040, 남구,060002, 56세,2017,2970,1424,1546,92.1,2957,1419,1538,92.3
22040, 남구,060003, 57세,2017,2973,1339,1634,81.9,2947,1329,1618,82.1
22040, 남구,060004, 58세,2017,2878,1304,1574,82.8,2862,1299,1563,83.1
22040, 남구,060005, 59세,2017,2597,1236,1361,90.8,2574,1223,1351,90.5
22040, 남구,065,60~64세,2017,12420,5761,6659,86.5,12353,5730,6623,86.5
22040, 남구,065001, 60세,2017,2680,1275,1405,90.7,2667,1269,1398,90.8
22040, 남구,065002, 61세,2017,2564,1201,1363,88.1,2543,1192,1351,88.2
22040, 남구,065003, 62세,2017,2750,1273,1477,86.2,2739,1268,1471,86.2
22040, 남구,065004, 63세,2017,2246,1055,1191,88.6,2234,1048,1186,88.4
22040, 남구,065005, 64세,2017,2180,957,1223,78.3,2170,953,1217,78.3
22040, 남구,070,65~69세,2017,10012,4547,5465,83.2,9975,4527,5448,83.1
22040, 남구,070001, 65세,2017,2346,1083,1263,85.7,2336,1077,1259,85.5
22040, 남구,070002, 66세,2017,1848,809,1039,77.9,1839,802,1037,77.3
22040, 남구,070003, 67세,2017,1817,869,948,91.7,1813,868,945,91.9
22040, 남구,070004, 68세,2017,2049,912,1137,80.2,2038,906,1132,80
22040, 남구,070005, 69세,2017,1952,874,1078,81.1,1949,874,1075,81.3
22040, 남구,075,70~74세,2017,7510,3248,4262,76.2,7490,3237,4253,76.1
22040, 남구,075001, 70세,2017,1853,826,1027,80.4,1849,823,1026,80.2
22040, 남구,075002, 71세,2017,1309,579,730,79.3,1300,574,726,79.1
22040, 남구,075003, 72세,2017,1270,530,740,71.6,1267,528,739,71.4
22040, 남구,075004, 73세,2017,1465,632,833,75.9,1462,631,831,75.9
22040, 남구,075005, 74세,2017,1613,681,932,73.1,1612,681,931,73.1
22040, 남구,080,75~79세,2017,6783,2822,3961,71.2,6771,2819,3952,71.3
22040, 남구,080001, 75세,2017,1691,764,927,82.4,1688,763,925,82.5
22040, 남구,080002, 76세,2017,1473,603,870,69.3,1471,603,868,69.5
22040, 남구,080003, 77세,2017,1274,506,768,65.9,1272,506,766,66.1
22040, 남구,080004, 78세,2017,1253,524,729,71.9,1249,522,727,71.8
22040, 남구,080005, 79세,2017,1092,425,667,63.7,1091,425,666,63.8
22040, 남구,085,80~84세,2017,4188,1534,2654,57.8,4182,1532,2650,57.8
22040, 남구,085001, 80세,2017,1036,394,642,61.4,1036,394,642,61.4
22040, 남구,085002, 81세,2017,929,334,595,56.1,927,333,594,56.1
22040, 남구,085003, 82세,2017,868,323,545,59.3,866,323,543,59.5
22040, 남구,085004, 83세,2017,741,266,475,56,739,265,474,55.9
22040, 남구,085005, 84세,2017,614,217,397,54.7,614,217,397,54.7
22040, 남구,090,85~89세,2017,1930,564,1366,41.3,1926,562,1364,41.2
22040, 남구,090001, 85세,2017,544,191,353,54.1,543,191,352,54.3
22040, 남구,090002, 86세,2017,449,117,332,35.2,447,115,332,34.6
22040, 남구,090003, 87세,2017,365,102,263,38.8,365,102,263,38.8
22040, 남구,090004, 88세,2017,315,77,238,32.4,314,77,237,32.5
22040, 남구,090005, 89세,2017,257,77,180,42.8,257,77,180,42.8
22040, 남구,095,90~94세,2017,574,115,459,25.1,572,115,457,25.2
22040, 남구,095001, 90세,2017,207,43,164,26.2,207,43,164,26.2
22040, 남구,095002, 91세,2017,124,26,98,26.5,123,26,97,26.8
22040, 남구,095003, 92세,2017,102,23,79,29.1,101,23,78,29.5
22040, 남구,095004, 93세,2017,79,10,69,14.5,79,10,69,14.5
22040, 남구,095005, 94세,2017,62,13,49,26.5,62,13,49,26.5
22040, 남구,100,95~99세,2017,110,18,92,19.6,110,18,92,19.6
22040, 남구,100001, 95세,2017,39,7,32,21.9,39,7,32,21.9
22040, 남구,100002, 96세,2017,25,X,22,13.6,25,X,22,13.6
22040, 남구,100003, 97세,2017,27,X,23,17.4,27,X,23,17.4
22040, 남구,100004, 98세,2017,10,X,7,42.9,10,X,7,42.9
22040, 남구,100005, 99세,2017,9,X,8,12.5,9,X,8,12.5
22040, 남구,101,100세이상,2017,11,X,8,37.5,11,X,8,37.5
22040, 남구,102,15세미만,2017,12683,6584,6099,108,12658,6571,6087,108
22040, 남구,103,15~64세,2017,108984,54095,54889,98.6,107882,53666,54216,99
22040, 남구,104,65세이상,2017,31118,12851,18267,70.4,31037,12813,18224,70.3
22040, 남구,086,85세이상,2017,2625,700,1925,36.4,2619,698,1921,36.3
22040, 남구,126,평균연령,2017,45.8,44.1,47.3,,45.8,44.1,47.4,
22040, 남구,127,중위연령,2017,47.3,45.3,49.2,,47.4,45.3,49.4,
22050, 북구,000,합계,2017,445293,222709,222584,100.1,439676,219765,219911,99.9
22050, 북구,005,0~4세,2017,18201,9257,8944,103.5,18120,9213,8907,103.4
22050, 북구,005001, 0세,2017,3105,1542,1563,98.7,3085,1532,1553,98.6
22050, 북구,005002, 1세,2017,3670,1868,1802,103.7,3655,1857,1798,103.3
22050, 북구,005003, 2세,2017,3814,1970,1844,106.8,3800,1964,1836,107
22050, 북구,005004, 3세,2017,3754,1890,1864,101.4,3737,1879,1858,101.1
22050, 북구,005005, 4세,2017,3858,1987,1871,106.2,3843,1981,1862,106.4
22050, 북구,010,5~9세,2017,20014,10354,9660,107.2,19981,10339,9642,107.2
22050, 북구,010001, 5세,2017,4143,2127,2016,105.5,4137,2124,2013,105.5
22050, 북구,010002, 6세,2017,4065,2111,1954,108,4056,2107,1949,108.1
22050, 북구,010003, 7세,2017,3912,2043,1869,109.3,3903,2039,1864,109.4
22050, 북구,010004, 8세,2017,3778,1932,1846,104.7,3771,1928,1843,104.6
22050, 북구,010005, 9세,2017,4116,2141,1975,108.4,4114,2141,1973,108.5
22050, 북구,015,10~14세,2017,21551,11255,10296,109.3,21527,11242,10285,109.3
22050, 북구,015001, 10세,2017,4344,2237,2107,106.2,4335,2230,2105,105.9
22050, 북구,015002, 11세,2017,3975,2068,1907,108.4,3974,2067,1907,108.4
22050, 북구,015003, 12세,2017,4035,2087,1948,107.1,4028,2085,1943,107.3
22050, 북구,015004, 13세,2017,4456,2376,2080,114.2,4452,2374,2078,114.2
22050, 북구,015005, 14세,2017,4741,2487,2254,110.3,4738,2486,2252,110.4
22050, 북구,020,15~19세,2017,29339,15318,14021,109.3,29131,15221,13910,109.4
22050, 북구,020001, 15세,2017,4780,2555,2225,114.8,4778,2553,2225,114.7
22050, 북구,020002, 16세,2017,5313,2802,2511,111.6,5312,2801,2511,111.5
22050, 북구,020003, 17세,2017,5933,3160,2773,114,5920,3154,2766,114
22050, 북구,020004, 18세,2017,5987,3098,2889,107.2,5938,3073,2865,107.3
22050, 북구,020005, 19세,2017,7326,3703,3623,102.2,7183,3640,3543,102.7
22050, 북구,025,20~24세,2017,37378,20056,17322,115.8,36140,19451,16689,116.5
22050, 북구,025001, 20세,2017,7628,3731,3897,95.7,7409,3635,3774,96.3
22050, 북구,025002, 21세,2017,7488,3818,3670,104,7254,3705,3549,104.4
22050, 북구,025003, 22세,2017,7541,4049,3492,116,7272,3921,3351,117
22050, 북구,025004, 23세,2017,7559,4331,3228,134.2,7322,4205,3117,134.9
22050, 북구,025005, 24세,2017,7162,4127,3035,136,6883,3985,2898,137.5
22050, 북구,030,25~29세,2017,28415,15884,12531,126.8,27327,15330,11997,127.8
22050, 북구,030001, 25세,2017,6635,3829,2806,136.5,6395,3706,2689,137.8
22050, 북구,030002, 26세,2017,6019,3362,2657,126.5,5805,3263,2542,128.4
22050, 북구,030003, 27세,2017,5545,3124,2421,129,5316,2999,2317,129.4
22050, 북구,030004, 28세,2017,5259,2853,2406,118.6,5068,2753,2315,118.9
22050, 북구,030005, 29세,2017,4957,2716,2241,121.2,4743,2609,2134,122.3
22050, 북구,035,30~34세,2017,26220,13691,12529,109.3,25314,13186,12128,108.7
22050, 북구,035001, 30세,2017,5058,2703,2355,114.8,4849,2579,2270,113.6
22050, 북구,035002, 31세,2017,5039,2708,2331,116.2,4830,2610,2220,117.6
22050, 북구,035003, 32세,2017,4906,2603,2303,113,4730,2496,2234,111.7
22050, 북구,035004, 33세,2017,5294,2727,2567,106.2,5133,2627,2506,104.8
22050, 북구,035005, 34세,2017,5923,2950,2973,99.2,5772,2874,2898,99.2
22050, 북구,040,35~39세,2017,32696,16292,16404,99.3,32180,15978,16202,98.6
22050, 북구,040001, 35세,2017,6501,3266,3235,101,6380,3190,3190,100
22050, 북구,040002, 36세,2017,6736,3327,3409,97.6,6618,3256,3362,96.8
22050, 북구,040003, 37세,2017,6886,3426,3460,99,6784,3365,3419,98.4
22050, 북구,040004, 38세,2017,6482,3240,3242,99.9,6387,3182,3205,99.3
22050, 북구,040005, 39세,2017,6091,3033,3058,99.2,6011,2985,3026,98.6
22050, 북구,045,40~44세,2017,36566,17924,18642,96.1,36170,17695,18475,95.8
22050, 북구,045001, 40세,2017,6542,3210,3332,96.3,6471,3168,3303,95.9
22050, 북구,045002, 41세,2017,6622,3295,3327,99,6530,3234,3296,98.1
22050, 북구,045003, 42세,2017,7290,3541,3749,94.5,7211,3504,3707,94.5
22050, 북구,045004, 43세,2017,8026,3927,4099,95.8,7937,3879,4058,95.6
22050, 북구,045005, 44세,2017,8086,3951,4135,95.6,8021,3910,4111,95.1
22050, 북구,050,45~49세,2017,42307,20982,21325,98.4,41924,20790,21134,98.4
22050, 북구,050001, 45세,2017,8302,4091,4211,97.2,8220,4042,4178,96.7
22050, 북구,050002, 46세,2017,8547,4217,4330,97.4,8465,4174,4291,97.3
22050, 북구,050003, 47세,2017,8469,4176,4293,97.3,8389,4142,4247,97.5
22050, 북구,050004, 48세,2017,8434,4179,4255,98.2,8366,4150,4216,98.4
22050, 북구,050005, 49세,2017,8555,4319,4236,102,8484,4282,4202,101.9
22050, 북구,055,50~54세,2017,37321,18625,18696,99.6,37017,18475,18542,99.6
22050, 북구,055001, 50세,2017,7905,3911,3994,97.9,7848,3882,3966,97.9
22050, 북구,055002, 51세,2017,7622,3898,3724,104.7,7558,3869,3689,104.9
22050, 북구,055003, 52세,2017,7574,3710,3864,96,7510,3675,3835,95.8
22050, 북구,055004, 53세,2017,6896,3431,3465,99,6839,3403,3436,99
22050, 북구,055005, 54세,2017,7324,3675,3649,100.7,7262,3646,3616,100.8
22050, 북구,060,55~59세,2017,36064,18127,17937,101.1,35871,18023,17848,101
22050, 북구,060001, 55세,2017,7569,3854,3715,103.7,7508,3822,3686,103.7
22050, 북구,060002, 56세,2017,8099,4016,4083,98.4,8080,4007,4073,98.4
22050, 북구,060003, 57세,2017,7633,3772,3861,97.7,7591,3748,3843,97.5
22050, 북구,060004, 58세,2017,6746,3400,3346,101.6,6706,3376,3330,101.4
22050, 북구,060005, 59세,2017,6017,3085,2932,105.2,5986,3070,2916,105.3
22050, 북구,065,60~64세,2017,25607,12616,12991,97.1,25471,12547,12924,97.1
22050, 북구,065001, 60세,2017,5921,3034,2887,105.1,5896,3021,2875,105.1
22050, 북구,065002, 61세,2017,5494,2743,2751,99.7,5465,2726,2739,99.5
22050, 북구,065003, 62세,2017,5361,2584,2777,93.1,5335,2574,2761,93.2
22050, 북구,065004, 63세,2017,4557,2245,2312,97.1,4523,2229,2294,97.2
22050, 북구,065005, 64세,2017,4274,2010,2264,88.8,4252,1997,2255,88.6
22050, 북구,070,65~69세,2017,18688,8726,9962,87.6,18627,8692,9935,87.5
22050, 북구,070001, 65세,2017,4451,2149,2302,93.4,4430,2136,2294,93.1
22050, 북구,070002, 66세,2017,3449,1637,1812,90.3,3434,1630,1804,90.4
22050, 북구,070003, 67세,2017,3478,1630,1848,88.2,3469,1625,1844,88.1
22050, 북구,070004, 68세,2017,3769,1710,2059,83.1,3759,1705,2054,83
22050, 북구,070005, 69세,2017,3541,1600,1941,82.4,3535,1596,1939,82.3
22050, 북구,075,70~74세,2017,13019,5660,7359,76.9,12995,5648,7347,76.9
22050, 북구,075001, 70세,2017,3183,1444,1739,83,3179,1442,1737,83
22050, 북구,075002, 71세,2017,2203,995,1208,82.4,2194,993,1201,82.7
22050, 북구,075003, 72세,2017,2311,1005,1306,77,2307,1002,1305,76.8
22050, 북구,075004, 73세,2017,2617,1049,1568,66.9,2615,1047,1568,66.8
22050, 북구,075005, 74세,2017,2705,1167,1538,75.9,2700,1164,1536,75.8
22050, 북구,080,75~79세,2017,11763,4816,6947,69.3,11751,4812,6939,69.3
22050, 북구,080001, 75세,2017,3097,1369,1728,79.2,3096,1369,1727,79.3
22050, 북구,080002, 76세,2017,2440,992,1448,68.5,2435,990,1445,68.5
22050, 북구,080003, 77세,2017,2257,885,1372,64.5,2252,884,1368,64.6
22050, 북구,080004, 78세,2017,2166,863,1303,66.2,2165,862,1303,66.2
22050, 북구,080005, 79세,2017,1803,707,1096,64.5,1803,707,1096,64.5
22050, 북구,085,80~84세,2017,6547,2252,4295,52.4,6537,2249,4288,52.4
22050, 북구,085001, 80세,2017,1623,601,1022,58.8,1618,600,1018,58.9
22050, 북구,085002, 81세,2017,1448,523,925,56.5,1447,522,925,56.4
22050, 북구,085003, 82세,2017,1364,461,903,51.1,1363,460,903,50.9
22050, 북구,085004, 83세,2017,1187,369,818,45.1,1186,369,817,45.2
22050, 북구,085005, 84세,2017,925,298,627,47.5,923,298,625,47.7
22050, 북구,090,85~89세,2017,2634,697,1937,36,2632,697,1935,36
22050, 북구,090001, 85세,2017,798,252,546,46.2,797,252,545,46.2
22050, 북구,090002, 86세,2017,584,149,435,34.3,583,149,434,34.3
22050, 북구,090003, 87세,2017,519,110,409,26.9,519,110,409,26.9
22050, 북구,090004, 88세,2017,399,110,289,38.1,399,110,289,38.1
22050, 북구,090005, 89세,2017,334,76,258,29.5,334,76,258,29.5
22050, 북구,095,90~94세,2017,774,146,628,23.2,773,146,627,23.3
22050, 북구,095001, 90세,2017,269,62,207,30,269,62,207,30
22050, 북구,095002, 91세,2017,170,29,141,20.6,170,29,141,20.6
22050, 북구,095003, 92세,2017,170,35,135,25.9,170,35,135,25.9
22050, 북구,095004, 93세,2017,86,11,75,14.7,86,11,75,14.7
22050, 북구,095005, 94세,2017,79,9,70,12.9,78,9,69,13
22050, 북구,100,95~99세,2017,170,30,140,21.4,170,30,140,21.4
22050, 북구,100001, 95세,2017,75,17,58,29.3,75,17,58,29.3
22050, 북구,100002, 96세,2017,34,X,30,13.3,34,X,30,13.3
22050, 북구,100003, 97세,2017,33,5,28,17.9,33,5,28,17.9
22050, 북구,100004, 98세,2017,18,X,15,20,18,X,15,20
22050, 북구,100005, 99세,2017,10,X,9,11.1,10,X,9,11.1
22050, 북구,101,100세이상,2017,19,X,18,5.6,18,X,17,5.9
22050, 북구,102,15세미만,2017,59766,30866,28900,106.8,59628,30794,28834,106.8
22050, 북구,103,15~64세,2017,331913,169515,162398,104.4,326545,166696,159849,104.3
22050, 북구,104,65세이상,2017,53614,22328,31286,71.4,53503,22275,31228,71.3
22050, 북구,086,85세이상,2017,3597,874,2723,32.1,3593,874,2719,32.1
22050, 북구,126,평균연령,2017,40.1,38.8,41.3,,40.2,38.9,41.4,
22050, 북구,127,중위연령,2017,41.3,39.8,42.8,,41.6,40,43,
22060, 수성구,000,합계,2017,425546,207706,217840,95.3,423722,206908,216814,95.4
22060, 수성구,005,0~4세,2017,13155,6759,6396,105.7,13143,6753,6390,105.7
22060, 수성구,005001, 0세,2017,2062,1049,1013,103.6,2061,1049,1012,103.7
22060, 수성구,005002, 1세,2017,2474,1290,1184,109,2471,1288,1183,108.9
22060, 수성구,005003, 2세,2017,2621,1357,1264,107.4,2619,1355,1264,107.2
22060, 수성구,005004, 3세,2017,2908,1493,1415,105.5,2903,1491,1412,105.6
22060, 수성구,005005, 4세,2017,3090,1570,1520,103.3,3089,1570,1519,103.4
22060, 수성구,010,5~9세,2017,19580,10086,9494,106.2,19567,10083,9484,106.3
22060, 수성구,010001, 5세,2017,3563,1804,1759,102.6,3560,1802,1758,102.5
22060, 수성구,010002, 6세,2017,3783,1934,1849,104.6,3780,1934,1846,104.8
22060, 수성구,010003, 7세,2017,3855,1974,1881,104.9,3853,1974,1879,105.1
22060, 수성구,010004, 8세,2017,3930,2067,1863,111,3927,2066,1861,111
22060, 수성구,010005, 9세,2017,4449,2307,2142,107.7,4447,2307,2140,107.8
22060, 수성구,015,10~14세,2017,25351,13459,11892,113.2,25336,13451,11885,113.2
22060, 수성구,015001, 10세,2017,4721,2452,2269,108.1,4718,2450,2268,108
22060, 수성구,015002, 11세,2017,4595,2445,2150,113.7,4590,2443,2147,113.8
22060, 수성구,015003, 12세,2017,4880,2571,2309,111.3,4879,2571,2308,111.4
22060, 수성구,015004, 13세,2017,5416,2867,2549,112.5,5411,2864,2547,112.4
22060, 수성구,015005, 14세,2017,5739,3124,2615,119.5,5738,3123,2615,119.4
22060, 수성구,020,15~19세,2017,31803,17091,14712,116.2,31738,17065,14673,116.3
22060, 수성구,020001, 15세,2017,5728,3068,2660,115.3,5724,3067,2657,115.4
22060, 수성구,020002, 16세,2017,6582,3563,3019,118,6577,3561,3016,118.1
22060, 수성구,020003, 17세,2017,7122,3834,3288,116.6,7116,3832,3284,116.7
22060, 수성구,020004, 18세,2017,6644,3590,3054,117.6,6638,3588,3050,117.6
22060, 수성구,020005, 19세,2017,5727,3036,2691,112.8,5683,3017,2666,113.2
22060, 수성구,025,20~24세,2017,28873,15947,12926,123.4,28696,15883,12813,124
22060, 수성구,025001, 20세,2017,5894,3294,2600,126.7,5862,3278,2584,126.9
22060, 수성구,025002, 21세,2017,6103,3460,2643,130.9,6081,3453,2628,131.4
22060, 수성구,025003, 22세,2017,5881,3236,2645,122.3,5852,3221,2631,122.4
22060, 수성구,025004, 23세,2017,5698,3096,2602,119,5654,3082,2572,119.8
22060, 수성구,025005, 24세,2017,5297,2861,2436,117.4,5247,2849,2398,118.8
22060, 수성구,030,25~29세,2017,22844,12233,10611,115.3,22501,12104,10397,116.4
22060, 수성구,030001, 25세,2017,5280,2834,2446,115.9,5209,2805,2404,116.7
22060, 수성구,030002, 26세,2017,4978,2672,2306,115.9,4901,2642,2259,117
22060, 수성구,030003, 27세,2017,4601,2401,2200,109.1,4538,2383,2155,110.6
22060, 수성구,030004, 28세,2017,4228,2302,1926,119.5,4158,2279,1879,121.3
22060, 수성구,030005, 29세,2017,3757,2024,1733,116.8,3695,1995,1700,117.4
22060, 수성구,035,30~34세,2017,19269,9684,9585,101,18989,9562,9427,101.4
22060, 수성구,035001, 30세,2017,3689,1917,1772,108.2,3624,1894,1730,109.5
22060, 수성구,035002, 31세,2017,3629,1879,1750,107.4,3574,1852,1722,107.5
22060, 수성구,035003, 32세,2017,3626,1860,1766,105.3,3571,1833,1738,105.5
22060, 수성구,035004, 33세,2017,3908,1932,1976,97.8,3857,1910,1947,98.1
22060, 수성구,035005, 34세,2017,4417,2096,2321,90.3,4363,2073,2290,90.5
22060, 수성구,040,35~39세,2017,26841,12293,14548,84.5,26648,12205,14443,84.5
22060, 수성구,040001, 35세,2017,5009,2354,2655,88.7,4960,2332,2628,88.7
22060, 수성구,040002, 36세,2017,5189,2369,2820,84,5146,2353,2793,84.2
22060, 수성구,040003, 37세,2017,5584,2582,3002,86,5554,2567,2987,85.9
22060, 수성구,040004, 38세,2017,5660,2562,3098,82.7,5625,2542,3083,82.5
22060, 수성구,040005, 39세,2017,5399,2426,2973,81.6,5363,2411,2952,81.7
22060, 수성구,045,40~44세,2017,35268,15620,19648,79.5,35122,15538,19584,79.3
22060, 수성구,045001, 40세,2017,5955,2675,3280,81.6,5925,2660,3265,81.5
22060, 수성구,045002, 41세,2017,6361,2869,3492,82.2,6327,2850,3477,82
22060, 수성구,045003, 42세,2017,6931,3018,3913,77.1,6905,3003,3902,77
22060, 수성구,045004, 43세,2017,7843,3442,4401,78.2,7819,3430,4389,78.1
22060, 수성구,045005, 44세,2017,8178,3616,4562,79.3,8146,3595,4551,79
22060, 수성구,050,45~49세,2017,45122,21205,23917,88.7,44954,21130,23824,88.7
22060, 수성구,050001, 45세,2017,8615,3944,4671,84.4,8580,3929,4651,84.5
22060, 수성구,050002, 46세,2017,9256,4321,4935,87.6,9226,4309,4917,87.6
22060, 수성구,050003, 47세,2017,9105,4201,4904,85.7,9070,4184,4886,85.6
22060, 수성구,050004, 48세,2017,8981,4283,4698,91.2,8942,4266,4676,91.2
22060, 수성구,050005, 49세,2017,9165,4456,4709,94.6,9136,4442,4694,94.6
22060, 수성구,055,50~54세,2017,38341,18978,19363,98,38195,18910,19285,98.1
22060, 수성구,055001, 50세,2017,8342,4063,4279,95,8311,4045,4266,94.8
22060, 수성구,055002, 51세,2017,7584,3838,3746,102.5,7559,3830,3729,102.7
22060, 수성구,055003, 52세,2017,7706,3762,3944,95.4,7672,3745,3927,95.4
22060, 수성구,055004, 53세,2017,7302,3664,3638,100.7,7270,3649,3621,100.8
22060, 수성구,055005, 54세,2017,7407,3651,3756,97.2,7383,3641,3742,97.3
22060, 수성구,060,55~59세,2017,34918,17169,17749,96.7,34805,17115,17690,96.7
22060, 수성구,060001, 55세,2017,7265,3582,3683,97.3,7238,3566,3672,97.1
22060, 수성구,060002, 56세,2017,7578,3712,3866,96,7558,3703,3855,96.1
22060, 수성구,060003, 57세,2017,7495,3679,3816,96.4,7473,3670,3803,96.5
22060, 수성구,060004, 58세,2017,6755,3319,3436,96.6,6726,3307,3419,96.7
22060, 수성구,060005, 59세,2017,5825,2877,2948,97.6,5810,2869,2941,97.6
22060, 수성구,065,60~64세,2017,26524,12748,13776,92.5,26443,12710,13733,92.6
22060, 수성구,065001, 60세,2017,6167,3018,3149,95.8,6144,3009,3135,96
22060, 수성구,065002, 61세,2017,5607,2710,2897,93.5,5590,2702,2888,93.6
22060, 수성구,065003, 62세,2017,5590,2673,2917,91.6,5579,2665,2914,91.5
22060, 수성구,065004, 63세,2017,4610,2250,2360,95.3,4592,2242,2350,95.4
22060, 수성구,065005, 64세,2017,4550,2097,2453,85.5,4538,2092,2446,85.5
22060, 수성구,070,65~69세,2017,19175,8913,10262,86.9,19138,8897,10241,86.9
22060, 수성구,070001, 65세,2017,4587,2174,2413,90.1,4578,2170,2408,90.1
22060, 수성구,070002, 66세,2017,3510,1642,1868,87.9,3502,1638,1864,87.9
22060, 수성구,070003, 67세,2017,3685,1729,1956,88.4,3675,1725,1950,88.5
22060, 수성구,070004, 68세,2017,3820,1752,2068,84.7,3814,1750,2064,84.8
22060, 수성구,070005, 69세,2017,3573,1616,1957,82.6,3569,1614,1955,82.6
22060, 수성구,075,70~74세,2017,13859,6186,7673,80.6,13840,6176,7664,80.6
22060, 수성구,075001, 70세,2017,3472,1547,1925,80.4,3464,1543,1921,80.3
22060, 수성구,075002, 71세,2017,2280,1070,1210,88.4,2279,1069,1210,88.3
22060, 수성구,075003, 72세,2017,2405,1059,1346,78.7,2403,1059,1344,78.8
22060, 수성구,075004, 73세,2017,2742,1225,1517,80.8,2737,1221,1516,80.5
22060, 수성구,075005, 74세,2017,2960,1285,1675,76.7,2957,1284,1673,76.7
22060, 수성구,080,75~79세,2017,12248,5140,7108,72.3,12243,5138,7105,72.3
22060, 수성구,080001, 75세,2017,3057,1343,1714,78.4,3055,1343,1712,78.4
22060, 수성구,080002, 76세,2017,2554,1088,1466,74.2,2552,1087,1465,74.2
22060, 수성구,080003, 77세,2017,2311,940,1371,68.6,2310,939,1371,68.5
22060, 수성구,080004, 78세,2017,2258,956,1302,73.4,2258,956,1302,73.4
22060, 수성구,080005, 79세,2017,2068,813,1255,64.8,2068,813,1255,64.8
22060, 수성구,085,80~84세,2017,7741,2877,4864,59.1,7734,2873,4861,59.1
22060, 수성구,085001, 80세,2017,1834,720,1114,64.6,1834,720,1114,64.6
22060, 수성구,085002, 81세,2017,1717,634,1083,58.5,1715,634,1081,58.6
22060, 수성구,085003, 82세,2017,1649,612,1037,59,1648,611,1037,58.9
22060, 수성구,085004, 83세,2017,1389,513,876,58.6,1388,512,876,58.4
22060, 수성구,085005, 84세,2017,1152,398,754,52.8,1149,396,753,52.6
22060, 수성구,090,85~89세,2017,3411,1000,2411,41.5,3410,999,2411,41.4
22060, 수성구,090001, 85세,2017,1041,348,693,50.2,1041,348,693,50.2
22060, 수성구,090002, 86세,2017,794,235,559,42,794,235,559,42
22060, 수성구,090003, 87세,2017,591,156,435,35.9,590,155,435,35.6
22060, 수성구,090004, 88세,2017,559,155,404,38.4,559,155,404,38.4
22060, 수성구,090005, 89세,2017,426,106,320,33.1,426,106,320,33.1
22060, 수성구,095,90~94세,2017,1010,275,735,37.4,1008,274,734,37.3
22060, 수성구,095001, 90세,2017,342,90,252,35.7,340,89,251,35.5
22060, 수성구,095002, 91세,2017,239,70,169,41.4,239,70,169,41.4
22060, 수성구,095003, 92세,2017,217,60,157,38.2,217,60,157,38.2
22060, 수성구,095004, 93세,2017,115,23,92,25,115,23,92,25
22060, 수성구,095005, 94세,2017,97,32,65,49.2,97,32,65,49.2
22060, 수성구,100,95~99세,2017,185,37,148,25,184,36,148,24.3
22060, 수성구,100001, 95세,2017,72,15,57,26.3,72,15,57,26.3
22060, 수성구,100002, 96세,2017,43,10,33,30.3,43,10,33,30.3
22060, 수성구,100003, 97세,2017,36,5,31,16.1,36,5,31,16.1
22060, 수성구,100004, 98세,2017,23,5,18,27.8,23,5,18,27.8
22060, 수성구,100005, 99세,2017,11,X,9,22.2,10,X,9,11.1
22060, 수성구,101,100세이상,2017,28,6,22,27.3,28,6,22,27.3
22060, 수성구,102,15세미만,2017,58086,30304,27782,109.1,58046,30287,27759,109.1
22060, 수성구,103,15~64세,2017,309803,152968,156835,97.5,308091,152222,155869,97.7
22060, 수성구,104,65세이상,2017,57657,24434,33223,73.5,57585,24399,33186,73.5
22060, 수성구,086,85세이상,2017,4634,1318,3316,39.7,4630,1315,3315,39.7
22060, 수성구,126,평균연령,2017,41.3,39.9,42.7,,41.3,39.9,42.7,
22060, 수성구,127,중위연령,2017,43.7,42.3,44.8,,43.8,42.3,44.8,
22070, 달서구,000,합계,2017,583043,290940,292103,99.6,572955,284525,288430,98.6
22070, 달서구,005,0~4세,2017,21880,11271,10609,106.2,21752,11205,10547,106.2
22070, 달서구,005001, 0세,2017,3678,1957,1721,113.7,3655,1946,1709,113.9
22070, 달서구,005002, 1세,2017,4335,2271,2064,110,4307,2253,2054,109.7
22070, 달서구,005003, 2세,2017,4641,2360,2281,103.5,4610,2343,2267,103.4
22070, 달서구,005004, 3세,2017,4580,2335,2245,104,4554,2324,2230,104.2
22070, 달서구,005005, 4세,2017,4646,2348,2298,102.2,4626,2339,2287,102.3
22070, 달서구,010,5~9세,2017,25788,13336,12452,107.1,25710,13299,12411,107.2
22070, 달서구,010001, 5세,2017,5282,2678,2604,102.8,5256,2662,2594,102.6
22070, 달서구,010002, 6세,2017,5154,2646,2508,105.5,5143,2641,2502,105.6
22070, 달서구,010003, 7세,2017,5146,2630,2516,104.5,5135,2625,2510,104.6
22070, 달서구,010004, 8세,2017,4988,2647,2341,113.1,4971,2641,2330,113.3
22070, 달서구,010005, 9세,2017,5218,2735,2483,110.1,5205,2730,2475,110.3
22070, 달서구,015,10~14세,2017,27341,14163,13178,107.5,27318,14151,13167,107.5
22070, 달서구,015001, 10세,2017,5453,2747,2706,101.5,5443,2743,2700,101.6
22070, 달서구,015002, 11세,2017,5063,2629,2434,108,5059,2626,2433,107.9
22070, 달서구,015003, 12세,2017,5176,2684,2492,107.7,5172,2683,2489,107.8
22070, 달서구,015004, 13세,2017,5726,2997,2729,109.8,5722,2994,2728,109.8
22070, 달서구,015005, 14세,2017,5923,3106,2817,110.3,5922,3105,2817,110.2
22070, 달서구,020,15~19세,2017,38847,20412,18435,110.7,38570,20287,18283,111
22070, 달서구,020001, 15세,2017,6190,3262,2928,111.4,6176,3256,2920,111.5
22070, 달서구,020002, 16세,2017,7411,3851,3560,108.2,7405,3848,3557,108.2
22070, 달서구,020003, 17세,2017,8535,4558,3977,114.6,8518,4551,3967,114.7
22070, 달서구,020004, 18세,2017,8194,4325,3869,111.8,8126,4292,3834,111.9
22070, 달서구,020005, 19세,2017,8517,4416,4101,107.7,8345,4340,4005,108.4
22070, 달서구,025,20~24세,2017,44859,24130,20729,116.4,43416,23286,20130,115.7
22070, 달서구,025001, 20세,2017,8716,4552,4164,109.3,8497,4442,4055,109.5
22070, 달서구,025002, 21세,2017,9207,4988,4219,118.2,8906,4820,4086,118
22070, 달서구,025003, 22세,2017,9125,4944,4181,118.2,8830,4775,4055,117.8
22070, 달서구,025004, 23세,2017,8904,4800,4104,117,8602,4613,3989,115.6
22070, 달서구,025005, 24세,2017,8907,4846,4061,119.3,8581,4636,3945,117.5
22070, 달서구,030,25~29세,2017,38719,21556,17163,125.6,36588,20108,16480,122
22070, 달서구,030001, 25세,2017,8800,4823,3977,121.3,8410,4546,3864,117.7
22070, 달서구,030002, 26세,2017,8053,4558,3495,130.4,7620,4268,3352,127.3
22070, 달서구,030003, 27세,2017,7762,4349,3413,127.4,7337,4063,3274,124.1
22070, 달서구,030004, 28세,2017,7361,4077,3284,124.1,6921,3768,3153,119.5
22070, 달서구,030005, 29세,2017,6743,3749,2994,125.2,6300,3463,2837,122.1
22070, 달서구,035,30~34세,2017,34644,18405,16239,113.3,32708,17089,15619,109.4
22070, 달서구,035001, 30세,2017,6792,3691,3101,119,6322,3387,2935,115.4
22070, 달서구,035002, 31세,2017,6628,3602,3026,119,6219,3325,2894,114.9
22070, 달서구,035003, 32세,2017,6587,3504,3083,113.7,6194,3251,2943,110.5
22070, 달서구,035004, 33세,2017,6880,3587,3293,108.9,6548,3358,3190,105.3
22070, 달서구,035005, 34세,2017,7757,4021,3736,107.6,7425,3768,3657,103
22070, 달서구,040,35~39세,2017,42433,21124,21309,99.1,41185,20259,20926,96.8
22070, 달서구,040001, 35세,2017,8581,4295,4286,100.2,8257,4073,4184,97.3
22070, 달서구,040002, 36세,2017,8428,4221,4207,100.3,8190,4060,4130,98.3
22070, 달서구,040003, 37세,2017,8902,4413,4489,98.3,8660,4240,4420,95.9
22070, 달서구,040004, 38세,2017,8557,4213,4344,97,8321,4055,4266,95.1
22070, 달서구,040005, 39세,2017,7965,3982,3983,100,7757,3831,3926,97.6
22070, 달서구,045,40~44세,2017,45904,22312,23592,94.6,45032,21715,23317,93.1
22070, 달서구,045001, 40세,2017,8396,4128,4268,96.7,8203,3986,4217,94.5
22070, 달서구,045002, 41세,2017,8522,4257,4265,99.8,8349,4138,4211,98.3
22070, 달서구,045003, 42세,2017,8771,4161,4610,90.3,8607,4056,4551,89.1
22070, 달서구,045004, 43세,2017,9999,4891,5108,95.8,9835,4786,5049,94.8
22070, 달서구,045005, 44세,2017,10216,4875,5341,91.3,10038,4749,5289,89.8
22070, 달서구,050,45~49세,2017,55792,26818,28974,92.6,55012,26325,28687,91.8
22070, 달서구,050001, 45세,2017,10466,4984,5482,90.9,10306,4875,5431,89.8
22070, 달서구,050002, 46세,2017,11282,5398,5884,91.7,11104,5285,5819,90.8
22070, 달서구,050003, 47세,2017,10941,5330,5611,95,10771,5227,5544,94.3
22070, 달서구,050004, 48세,2017,11402,5477,5925,92.4,11271,5394,5877,91.8
22070, 달서구,050005, 49세,2017,11701,5629,6072,92.7,11560,5544,6016,92.2
22070, 달서구,055,50~54세,2017,52591,25630,26961,95.1,52076,25336,26740,94.7
22070, 달서구,055001, 50세,2017,10945,5237,5708,91.7,10837,5171,5666,91.3
22070, 달서구,055002, 51세,2017,10490,5124,5366,95.5,10397,5080,5317,95.5
22070, 달서구,055003, 52세,2017,10559,5042,5517,91.4,10457,4982,5475,91
22070, 달서구,055004, 53세,2017,9954,4851,5103,95.1,9842,4786,5056,94.7
22070, 달서구,055005, 54세,2017,10643,5376,5267,102.1,10543,5317,5226,101.7
22070, 달서구,060,55~59세,2017,51592,25535,26057,98,51283,25381,25902,98
22070, 달서구,060001, 55세,2017,10765,5369,5396,99.5,10675,5327,5348,99.6
22070, 달서구,060002, 56세,2017,11638,5673,5965,95.1,11591,5650,5941,95.1
22070, 달서구,060003, 57세,2017,11084,5408,5676,95.3,11001,5364,5637,95.2
22070, 달서구,060004, 58세,2017,9895,4896,4999,97.9,9855,4878,4977,98
22070, 달서구,060005, 59세,2017,8210,4189,4021,104.2,8161,4162,3999,104.1
22070, 달서구,065,60~64세,2017,36145,17933,18212,98.5,35954,17846,18108,98.6
22070, 달서구,065001, 60세,2017,8564,4335,4229,102.5,8530,4318,4212,102.5
22070, 달서구,065002, 61세,2017,7693,3924,3769,104.1,7660,3909,3751,104.2
22070, 달서구,065003, 62세,2017,7675,3695,3980,92.8,7625,3671,3954,92.8
22070, 달서구,065004, 63세,2017,6251,3122,3129,99.8,6211,3107,3104,100.1
22070, 달서구,065005, 64세,2017,5962,2857,3105,92,5928,2841,3087,92
22070, 달서구,070,65~69세,2017,24498,11794,12704,92.8,24409,11752,12657,92.8
22070, 달서구,070001, 65세,2017,6209,2906,3303,88,6182,2895,3287,88.1
22070, 달서구,070002, 66세,2017,4592,2271,2321,97.8,4570,2259,2311,97.7
22070, 달서구,070003, 67세,2017,4578,2208,2370,93.2,4564,2201,2363,93.1
22070, 달서구,070004, 68세,2017,4731,2275,2456,92.6,4716,2270,2446,92.8
22070, 달서구,070005, 69세,2017,4388,2134,2254,94.7,4377,2127,2250,94.5
22070, 달서구,075,70~74세,2017,15786,7175,8611,83.3,15763,7163,8600,83.3
22070, 달서구,075001, 70세,2017,4135,1906,2229,85.5,4127,1901,2226,85.4
22070, 달서구,075002, 71세,2017,2708,1330,1378,96.5,2704,1328,1376,96.5
22070, 달서구,075003, 72세,2017,2731,1218,1513,80.5,2727,1217,1510,80.6
22070, 달서구,075004, 73세,2017,3092,1345,1747,77,3089,1343,1746,76.9
22070, 달서구,075005, 74세,2017,3120,1376,1744,78.9,3116,1374,1742,78.9
22070, 달서구,080,75~79세,2017,13543,5415,8128,66.6,13515,5400,8115,66.5
22070, 달서구,080001, 75세,2017,3525,1481,2044,72.5,3521,1478,2043,72.3
22070, 달서구,080002, 76세,2017,2766,1133,1633,69.4,2759,1129,1630,69.3
22070, 달서구,080003, 77세,2017,2545,992,1553,63.9,2541,990,1551,63.8
22070, 달서구,080004, 78세,2017,2511,966,1545,62.5,2502,962,1540,62.5
22070, 달서구,080005, 79세,2017,2196,843,1353,62.3,2192,841,1351,62.3
22070, 달서구,085,80~84세,2017,8074,2759,5315,51.9,8066,2755,5311,51.9
22070, 달서구,085001, 80세,2017,2001,739,1262,58.6,1999,738,1261,58.5
22070, 달서구,085002, 81세,2017,1856,633,1223,51.8,1855,633,1222,51.8
22070, 달서구,085003, 82세,2017,1673,577,1096,52.6,1670,576,1094,52.7
22070, 달서구,085004, 83세,2017,1410,478,932,51.3,1409,477,932,51.2
22070, 달서구,085005, 84세,2017,1134,332,802,41.4,1133,331,802,41.3
22070, 달서구,090,85~89세,2017,3441,905,2536,35.7,3437,902,2535,35.6
22070, 달서구,090001, 85세,2017,1035,309,726,42.6,1032,306,726,42.1
22070, 달서구,090002, 86세,2017,755,210,545,38.5,755,210,545,38.5
22070, 달서구,090003, 87세,2017,684,159,525,30.3,683,159,524,30.3
22070, 달서구,090004, 88세,2017,544,138,406,34,544,138,406,34
22070, 달서구,090005, 89세,2017,423,89,334,26.6,423,89,334,26.6
22070, 달서구,095,90~94세,2017,961,230,731,31.5,956,229,727,31.5
22070, 달서구,095001, 90세,2017,322,80,242,33.1,322,80,242,33.1
22070, 달서구,095002, 91세,2017,197,41,156,26.3,196,41,155,26.5
22070, 달서구,095003, 92세,2017,219,51,168,30.4,217,51,166,30.7
22070, 달서구,095004, 93세,2017,132,35,97,36.1,130,34,96,35.4
22070, 달서구,095005, 94세,2017,91,23,68,33.8,91,23,68,33.8
22070, 달서구,100,95~99세,2017,184,35,149,23.5,184,35,149,23.5
22070, 달서구,100001, 95세,2017,83,19,64,29.7,83,19,64,29.7
22070, 달서구,100002, 96세,2017,49,8,41,19.5,49,8,41,19.5
22070, 달서구,100003, 97세,2017,19,X,15,26.7,19,X,15,26.7
22070, 달서구,100004, 98세,2017,25,X,24,4.2,25,X,24,4.2
22070, 달서구,100005, 99세,2017,8,X,5,60,8,X,5,60
22070, 달서구,101,100세이상,2017,21,X,19,10.5,21,X,19,10.5
22070, 달서구,102,15세미만,2017,75009,38770,36239,107,74780,38655,36125,107
22070, 달서구,103,15~64세,2017,441526,223855,217671,102.8,431824,217632,214192,101.6
22070, 달서구,104,65세이상,2017,66508,28315,38193,74.1,66351,28238,38113,74.1
22070, 달서구,086,85세이상,2017,4607,1172,3435,34.1,4598,1168,3430,34.1
22070, 달서구,126,평균연령,2017,40.4,39.2,41.6,,40.5,39.3,41.7,
22070, 달서구,127,중위연령,2017,42,40.3,43.5,,42.3,40.6,43.7,
22310, 달성군,000,합계,2017,239240,122794,116446,105.5,232371,118133,114238,103.4
22310, 달성군,005,0~4세,2017,15110,7665,7445,103,15005,7628,7377,103.4
22310, 달성군,005001, 0세,2017,2804,1431,1373,104.2,2781,1422,1359,104.6
22310, 달성군,005002, 1세,2017,3170,1600,1570,101.9,3143,1588,1555,102.1
22310, 달성군,005003, 2세,2017,3159,1580,1579,100.1,3139,1574,1565,100.6
22310, 달성군,005004, 3세,2017,3025,1520,1505,101,3005,1517,1488,101.9
22310, 달성군,005005, 4세,2017,2952,1534,1418,108.2,2937,1527,1410,108.3
22310, 달성군,010,5~9세,2017,13595,6977,6618,105.4,13543,6953,6590,105.5
22310, 달성군,010001, 5세,2017,3058,1559,1499,104,3050,1557,1493,104.3
22310, 달성군,010002, 6세,2017,2971,1510,1461,103.4,2952,1501,1451,103.4
22310, 달성군,010003, 7세,2017,2684,1381,1303,106,2678,1375,1303,105.5
22310, 달성군,010004, 8세,2017,2392,1225,1167,105,2381,1221,1160,105.3
22310, 달성군,010005, 9세,2017,2490,1302,1188,109.6,2482,1299,1183,109.8
22310, 달성군,015,10~14세,2017,10746,5575,5171,107.8,10708,5558,5150,107.9
22310, 달성군,015001, 10세,2017,2371,1183,1188,99.6,2360,1181,1179,100.2
22310, 달성군,015002, 11세,2017,2072,1100,972,113.2,2066,1096,970,113
22310, 달성군,015003, 12세,2017,2120,1103,1017,108.5,2109,1098,1011,108.6
22310, 달성군,015004, 13세,2017,2072,1050,1022,102.7,2067,1046,1021,102.4
22310, 달성군,015005, 14세,2017,2111,1139,972,117.2,2106,1137,969,117.3
22310, 달성군,020,15~19세,2017,11821,6357,5464,116.3,11769,6331,5438,116.4
22310, 달성군,020001, 15세,2017,2063,1113,950,117.2,2058,1109,949,116.9
22310, 달성군,020002, 16세,2017,2456,1284,1172,109.6,2450,1281,1169,109.6
22310, 달성군,020003, 17세,2017,2626,1372,1254,109.4,2618,1369,1249,109.6
22310, 달성군,020004, 18세,2017,2369,1273,1096,116.1,2358,1266,1092,115.9
22310, 달성군,020005, 19세,2017,2307,1315,992,132.6,2285,1306,979,133.4
22310, 달성군,025,20~24세,2017,13554,7878,5676,138.8,13008,7495,5513,136
22310, 달성군,025001, 20세,2017,2641,1556,1085,143.4,2610,1542,1068,144.4
22310, 달성군,025002, 21세,2017,2745,1677,1068,157,2679,1643,1036,158.6
22310, 달성군,025003, 22세,2017,2694,1590,1104,144,2595,1515,1080,140.3
22310, 달성군,025004, 23세,2017,2673,1479,1194,123.9,2520,1371,1149,119.3
22310, 달성군,025005, 24세,2017,2801,1576,1225,128.7,2604,1424,1180,120.7
22310, 달성군,030,25~29세,2017,15549,8766,6783,129.2,14056,7685,6371,120.6
22310, 달성군,030001, 25세,2017,3092,1723,1369,125.9,2863,1556,1307,119.1
22310, 달성군,030002, 26세,2017,3036,1752,1284,136.4,2735,1528,1207,126.6
22310, 달성군,030003, 27세,2017,3109,1751,1358,128.9,2813,1547,1266,122.2
22310, 달성군,030004, 28세,2017,3121,1763,1358,129.8,2792,1529,1263,121.1
22310, 달성군,030005, 29세,2017,3191,1777,1414,125.7,2853,1525,1328,114.8
22310, 달성군,035,30~34세,2017,19625,10471,9154,114.4,18108,9345,8763,106.6
22310, 달성군,035001, 30세,2017,3446,1835,1611,113.9,3107,1591,1516,104.9
22310, 달성군,035002, 31세,2017,3695,2024,1671,121.1,3357,1772,1585,111.8
22310, 달성군,035003, 32세,2017,3796,2069,1727,119.8,3497,1845,1652,111.7
22310, 달성군,035004, 33세,2017,4069,2180,1889,115.4,3795,1965,1830,107.4
22310, 달성군,035005, 34세,2017,4619,2363,2256,104.7,4352,2172,2180,99.6
22310, 달성군,040,35~39세,2017,23784,12476,11308,110.3,22754,11731,11023,106.4
22310, 달성군,040001, 35세,2017,5075,2637,2438,108.2,4822,2448,2374,103.1
22310, 달성군,040002, 36세,2017,4945,2616,2329,112.3,4741,2468,2273,108.6
22310, 달성군,040003, 37세,2017,5066,2640,2426,108.8,4885,2511,2374,105.8
22310, 달성군,040004, 38세,2017,4572,2387,2185,109.2,4380,2247,2133,105.3
22310, 달성군,040005, 39세,2017,4126,2196,1930,113.8,3926,2057,1869,110.1
22310, 달성군,045,40~44세,2017,19901,10651,9250,115.1,19278,10238,9040,113.3
22310, 달성군,045001, 40세,2017,4098,2195,1903,115.3,3969,2113,1856,113.8
22310, 달성군,045002, 41세,2017,3836,2069,1767,117.1,3698,1974,1724,114.5
22310, 달성군,045003, 42세,2017,3937,2089,1848,113,3828,2011,1817,110.7
22310, 달성군,045004, 43세,2017,4128,2236,1892,118.2,4011,2163,1848,117
22310, 달성군,045005, 44세,2017,3902,2062,1840,112.1,3772,1977,1795,110.1
22310, 달성군,050,45~49세,2017,19749,10102,9647,104.7,19203,9762,9441,103.4
22310, 달성군,050001, 45세,2017,3899,2076,1823,113.9,3788,2004,1784,112.3
22310, 달성군,050002, 46세,2017,3969,2066,1903,108.6,3859,1994,1865,106.9
22310, 달성군,050003, 47세,2017,3958,2035,1923,105.8,3847,1971,1876,105.1
22310, 달성군,050004, 48세,2017,3925,1932,1993,96.9,3813,1860,1953,95.2
22310, 달성군,050005, 49세,2017,3998,1993,2005,99.4,3896,1933,1963,98.5
22310, 달성군,055,50~54세,2017,18293,9121,9172,99.4,17890,8899,8991,99
22310, 달성군,055001, 50세,2017,3736,1810,1926,94,3648,1767,1881,93.9
22310, 달성군,055002, 51세,2017,3699,1869,1830,102.1,3621,1824,1797,101.5
22310, 달성군,055003, 52세,2017,3737,1843,1894,97.3,3650,1793,1857,96.6
22310, 달성군,055004, 53세,2017,3477,1781,1696,105,3403,1738,1665,104.4
22310, 달성군,055005, 54세,2017,3644,1818,1826,99.6,3568,1777,1791,99.2
22310, 달성군,060,55~59세,2017,18518,9323,9195,101.4,18292,9196,9096,101.1
22310, 달성군,060001, 55세,2017,3925,1996,1929,103.5,3872,1965,1907,103
22310, 달성군,060002, 56세,2017,4111,2061,2050,100.5,4069,2039,2030,100.4
22310, 달성군,060003, 57세,2017,3792,1886,1906,99,3744,1863,1881,99
22310, 달성군,060004, 58세,2017,3577,1800,1777,101.3,3532,1772,1760,100.7
22310, 달성군,060005, 59세,2017,3113,1580,1533,103.1,3075,1557,1518,102.6
22310, 달성군,065,60~64세,2017,12993,6497,6496,100,12856,6422,6434,99.8
22310, 달성군,065001, 60세,2017,3081,1571,1510,104,3031,1540,1491,103.3
22310, 달성군,065002, 61세,2017,2826,1448,1378,105.1,2805,1438,1367,105.2
22310, 달성군,065003, 62세,2017,2721,1309,1412,92.7,2698,1300,1398,93
22310, 달성군,065004, 63세,2017,2209,1123,1086,103.4,2182,1107,1075,103
22310, 달성군,065005, 64세,2017,2156,1046,1110,94.2,2140,1037,1103,94
22310, 달성군,070,65~69세,2017,9169,4507,4662,96.7,9105,4476,4629,96.7
22310, 달성군,070001, 65세,2017,2296,1126,1170,96.2,2280,1119,1161,96.4
22310, 달성군,070002, 66세,2017,1712,839,873,96.1,1692,830,862,96.3
22310, 달성군,070003, 67세,2017,1740,870,870,100,1729,867,862,100.6
22310, 달성군,070004, 68세,2017,1778,878,900,97.6,1769,872,897,97.2
22310, 달성군,070005, 69세,2017,1643,794,849,93.5,1635,788,847,93
22310, 달성군,075,70~74세,2017,5925,2742,3183,86.1,5902,2731,3171,86.1
22310, 달성군,075001, 70세,2017,1489,713,776,91.9,1483,713,770,92.6
22310, 달성군,075002, 71세,2017,1030,505,525,96.2,1021,500,521,96
22310, 달성군,075003, 72세,2017,1041,483,558,86.6,1036,479,557,86
22310, 달성군,075004, 73세,2017,1181,543,638,85.1,1180,542,638,85
22310, 달성군,075005, 74세,2017,1184,498,686,72.6,1182,497,685,72.6
22310, 달성군,080,75~79세,2017,5343,2010,3333,60.3,5336,2010,3326,60.4
22310, 달성군,080001, 75세,2017,1325,550,775,71,1324,550,774,71.1
22310, 달성군,080002, 76세,2017,1080,408,672,60.7,1078,408,670,60.9
22310, 달성군,080003, 77세,2017,1009,339,670,50.6,1009,339,670,50.6
22310, 달성군,080004, 78세,2017,1018,372,646,57.6,1017,372,645,57.7
22310, 달성군,080005, 79세,2017,911,341,570,59.8,908,341,567,60.1
22310, 달성군,085,80~84세,2017,3377,1124,2253,49.9,3371,1121,2250,49.8
22310, 달성군,085001, 80세,2017,822,293,529,55.4,821,293,528,55.5
22310, 달성군,085002, 81세,2017,704,253,451,56.1,701,251,450,55.8
22310, 달성군,085003, 82세,2017,717,228,489,46.6,717,228,489,46.6
22310, 달성군,085004, 83세,2017,635,190,445,42.7,634,189,445,42.5
22310, 달성군,085005, 84세,2017,499,160,339,47.2,498,160,338,47.3
22310, 달성군,090,85~89세,2017,1610,427,1183,36.1,1609,427,1182,36.1
22310, 달성군,090001, 85세,2017,464,149,315,47.3,464,149,315,47.3
22310, 달성군,090002, 86세,2017,372,104,268,38.8,372,104,268,38.8
22310, 달성군,090003, 87세,2017,321,77,244,31.6,321,77,244,31.6
22310, 달성군,090004, 88세,2017,239,45,194,23.2,238,45,193,23.3
22310, 달성군,090005, 89세,2017,214,52,162,32.1,214,52,162,32.1
22310, 달성군,095,90~94세,2017,466,100,366,27.3,466,100,366,27.3
22310, 달성군,095001, 90세,2017,173,37,136,27.2,173,37,136,27.2
22310, 달성군,095002, 91세,2017,109,25,84,29.8,109,25,84,29.8
22310, 달성군,095003, 92세,2017,85,19,66,28.8,85,19,66,28.8
22310, 달성군,095004, 93세,2017,48,10,38,26.3,48,10,38,26.3
22310, 달성군,095005, 94세,2017,51,9,42,21.4,51,9,42,21.4
22310, 달성군,100,95~99세,2017,97,22,75,29.3,97,22,75,29.3
22310, 달성군,100001, 95세,2017,43,11,32,34.4,43,11,32,34.4
22310, 달성군,100002, 96세,2017,21,X,18,16.7,21,X,18,16.7
22310, 달성군,100003, 97세,2017,15,X,11,36.4,15,X,11,36.4
22310, 달성군,100004, 98세,2017,10,X,7,42.9,10,X,7,42.9
22310, 달성군,100005, 99세,2017,8,X,7,14.3,8,X,7,14.3
22310, 달성군,101,100세이상,2017,15,X,12,25,15,X,12,25
22310, 달성군,102,15세미만,2017,39451,20217,19234,105.1,39256,20139,19117,105.3
22310, 달성군,103,15~64세,2017,173787,91642,82145,111.6,167214,87104,80110,108.7
22310, 달성군,104,65세이상,2017,26002,10935,15067,72.6,25901,10890,15011,72.5
22310, 달성군,086,85세이상,2017,2188,552,1636,33.7,2187,552,1635,33.8
22310, 달성군,126,평균연령,2017,38.8,37.7,40,,38.9,37.8,40.1,
22310, 달성군,127,중위연령,2017,39,37.9,40.3,,39.3,38.3,40.5,
23,인천광역시,000,합계,2017,2925967,1472081,1453886,101.3,2846797,1426308,1420489,100.4
23,인천광역시,005,0~4세,2017,124268,63515,60753,104.5,122106,62414,59692,104.6
23,인천광역시,005001, 0세,2017,21344,10930,10414,105,20897,10700,10197,104.9
23,인천광역시,005002, 1세,2017,24670,12562,12108,103.7,24145,12290,11855,103.7
23,인천광역시,005003, 2세,2017,26188,13378,12810,104.4,25768,13172,12596,104.6
23,인천광역시,005004, 3세,2017,25846,13284,12562,105.7,25417,13062,12355,105.7
23,인천광역시,005005, 4세,2017,26220,13361,12859,103.9,25879,13190,12689,103.9
23,인천광역시,010,5~9세,2017,136093,69818,66275,105.3,134886,69171,65715,105.3
23,인천광역시,010001, 5세,2017,28262,14489,13773,105.2,27963,14337,13626,105.2
23,인천광역시,010002, 6세,2017,28085,14562,13523,107.7,27821,14419,13402,107.6
23,인천광역시,010003, 7세,2017,26715,13709,13006,105.4,26510,13602,12908,105.4
23,인천광역시,010004, 8세,2017,25959,13293,12666,105,25736,13174,12562,104.9
23,인천광역시,010005, 9세,2017,27072,13765,13307,103.4,26856,13639,13217,103.2
23,인천광역시,015,10~14세,2017,131586,67772,63814,106.2,130818,67360,63458,106.1
23,인천광역시,015001, 10세,2017,27870,14382,13488,106.6,27686,14285,13401,106.6
23,인천광역시,015002, 11세,2017,25136,13011,12125,107.3,24987,12920,12067,107.1
23,인천광역시,015003, 12세,2017,24507,12583,11924,105.5,24353,12502,11851,105.5
23,인천광역시,015004, 13세,2017,26602,13661,12941,105.6,26464,13594,12870,105.6
23,인천광역시,015005, 14세,2017,27471,14135,13336,106,27328,14059,13269,106
23,인천광역시,020,15~19세,2017,162955,84290,78665,107.2,161436,83538,77898,107.2
23,인천광역시,020001, 15세,2017,27947,14524,13423,108.2,27807,14447,13360,108.1
23,인천광역시,020002, 16세,2017,31771,16386,15385,106.5,31628,16313,15315,106.5
23,인천광역시,020003, 17세,2017,35000,18041,16959,106.4,34788,17927,16861,106.3
23,인천광역시,020004, 18세,2017,33936,17680,16256,108.8,33548,17498,16050,109
23,인천광역시,020005, 19세,2017,34301,17659,16642,106.1,33665,17353,16312,106.4
23,인천광역시,025,20~24세,2017,197084,104667,92417,113.3,190964,101150,89814,112.6
23,인천광역시,025001, 20세,2017,36595,19372,17223,112.5,35767,18982,16785,113.1
23,인천광역시,025002, 21세,2017,38086,20754,17332,119.7,37086,20215,16871,119.8
23,인천광역시,025003, 22세,2017,39340,21169,18171,116.5,38124,20468,17656,115.9
23,인천광역시,025004, 23세,2017,40669,21383,19286,110.9,39254,20520,18734,109.5
23,인천광역시,025005, 24세,2017,42394,21989,20405,107.8,40733,20965,19768,106.1
23,인천광역시,030,25~29세,2017,204316,107177,97139,110.3,192289,99678,92611,107.6
23,인천광역시,030001, 25세,2017,44175,22836,21339,107,42195,21597,20598,104.8
23,인천광역시,030002, 26세,2017,42545,22331,20214,110.5,40329,20978,19351,108.4
23,인천광역시,030003, 27세,2017,40428,21344,19084,111.8,37912,19797,18115,109.3
23,인천광역시,030004, 28세,2017,39014,20617,18397,112.1,36517,19044,17473,109
23,인천광역시,030005, 29세,2017,38154,20049,18105,110.7,35336,18262,17074,107
23,인천광역시,035,30~34세,2017,204842,107338,97504,110.1,191132,98538,92594,106.4
23,인천광역시,035001, 30세,2017,38335,20004,18331,109.1,35364,18156,17208,105.5
23,인천광역시,035002, 31세,2017,39112,20642,18470,111.8,36223,18820,17403,108.1
23,인천광역시,035003, 32세,2017,39703,20958,18745,111.8,36962,19194,17768,108
23,인천광역시,035004, 33세,2017,41619,21806,19813,110.1,39019,20110,18909,106.4
23,인천광역시,035005, 34세,2017,46073,23928,22145,108.1,43564,22258,21306,104.5
23,인천광역시,040,35~39세,2017,245608,127772,117836,108.4,235463,121144,114319,106
23,인천광역시,040001, 35세,2017,50206,26117,24089,108.4,47781,24500,23281,105.2
23,인천광역시,040002, 36세,2017,50736,26621,24115,110.4,48628,25236,23392,107.9
23,인천광역시,040003, 37세,2017,51350,26572,24778,107.2,49382,25287,24095,104.9
23,인천광역시,040004, 38세,2017,48714,25432,23282,109.2,46771,24168,22603,106.9
23,인천광역시,040005, 39세,2017,44602,23030,21572,106.8,42901,21953,20948,104.8
23,인천광역시,045,40~44세,2017,236594,121708,114886,105.9,229666,117476,112190,104.7
23,인천광역시,045001, 40세,2017,45109,23314,21795,107,43636,22390,21246,105.4
23,인천광역시,045002, 41세,2017,43736,22711,21025,108,42306,21829,20477,106.6
23,인천광역시,045003, 42세,2017,46572,24060,22512,106.9,45230,23241,21989,105.7
23,인천광역시,045004, 43세,2017,50177,25972,24205,107.3,48864,25147,23717,106
23,인천광역시,045005, 44세,2017,51000,25651,25349,101.2,49630,24869,24761,100.4
23,인천광역시,050,45~49세,2017,264819,132593,132226,100.3,257927,128857,129070,99.8
23,인천광역시,050001, 45세,2017,51226,26131,25095,104.1,49847,25365,24482,103.6
23,인천광역시,050002, 46세,2017,53828,27266,26562,102.7,52408,26497,25911,102.3
23,인천광역시,050003, 47세,2017,52492,26463,26029,101.7,51039,25654,25385,101.1
23,인천광역시,050004, 48세,2017,53591,26503,27088,97.8,52286,25806,26480,97.5
23,인천광역시,050005, 49세,2017,53682,26230,27452,95.5,52347,25535,26812,95.2
23,인천광역시,055,50~54세,2017,248976,124334,124642,99.8,242952,121264,121688,99.7
23,인천광역시,055001, 50세,2017,48979,24077,24902,96.7,47957,23519,24438,96.2
23,인천광역시,055002, 51세,2017,48666,24388,24278,100.5,47545,23815,23730,100.4
23,인천광역시,055003, 52세,2017,51603,25616,25987,98.6,50352,24982,25370,98.5
23,인천광역시,055004, 53세,2017,48584,24318,24266,100.2,47328,23693,23635,100.2
23,인천광역시,055005, 54세,2017,51144,25935,25209,102.9,49770,25255,24515,103
23,인천광역시,060,55~59세,2017,253235,127747,125488,101.8,248726,125516,123210,101.9
23,인천광역시,060001, 55세,2017,52022,26269,25753,102,50991,25756,25235,102.1
23,인천광역시,060002, 56세,2017,54955,27754,27201,102,54197,27391,26806,102.2
23,인천광역시,060003, 57세,2017,54034,27210,26824,101.4,52967,26694,26273,101.6
23,인천광역시,060004, 58세,2017,47454,23839,23615,100.9,46631,23425,23206,100.9
23,인천광역시,060005, 59세,2017,44770,22675,22095,102.6,43940,22250,21690,102.6
23,인천광역시,065,60~64세,2017,175988,87511,88477,98.9,172207,85743,86464,99.2
23,인천광역시,065001, 60세,2017,42310,21321,20989,101.6,41407,20891,20516,101.8
23,인천광역시,065002, 61세,2017,37832,18869,18963,99.5,37093,18523,18570,99.7
23,인천광역시,065003, 62세,2017,38083,18778,19305,97.3,37273,18405,18868,97.5
23,인천광역시,065004, 63세,2017,31110,15351,15759,97.4,30384,15025,15359,97.8
23,인천광역시,065005, 64세,2017,26653,13192,13461,98,26050,12899,13151,98.1
23,인천광역시,070,65~69세,2017,114342,56188,58154,96.6,112431,55316,57115,96.9
23,인천광역시,070001, 65세,2017,28928,14331,14597,98.2,28395,14091,14304,98.5
23,인천광역시,070002, 66세,2017,19351,9486,9865,96.2,18894,9259,9635,96.1
23,인천광역시,070003, 67세,2017,22053,10928,11125,98.2,21671,10759,10912,98.6
23,인천광역시,070004, 68세,2017,22458,10919,11539,94.6,22116,10760,11356,94.8
23,인천광역시,070005, 69세,2017,21552,10524,11028,95.4,21355,10447,10908,95.8
23,인천광역시,075,70~74세,2017,85084,39244,45840,85.6,84419,38986,45433,85.8
23,인천광역시,075001, 70세,2017,21659,10157,11502,88.3,21476,10076,11400,88.4
23,인천광역시,075002, 71세,2017,16599,7779,8820,88.2,16445,7714,8731,88.4
23,인천광역시,075003, 72세,2017,15573,7210,8363,86.2,15441,7158,8283,86.4
23,인천광역시,075004, 73세,2017,15382,7039,8343,84.4,15274,7008,8266,84.8
23,인천광역시,075005, 74세,2017,15871,7059,8812,80.1,15783,7030,8753,80.3
23,인천광역시,080,75~79세,2017,69168,28614,40554,70.6,68744,28466,40278,70.7
23,인천광역시,080001, 75세,2017,17909,7801,10108,77.2,17824,7761,10063,77.1
23,인천광역시,080002, 76세,2017,14270,6058,8212,73.8,14176,6026,8150,73.9
23,인천광역시,080003, 77세,2017,12698,5201,7497,69.4,12614,5171,7443,69.5
23,인천광역시,080004, 78세,2017,12701,5035,7666,65.7,12620,5011,7609,65.9
23,인천광역시,080005, 79세,2017,11590,4519,7071,63.9,11510,4497,7013,64.1
23,인천광역시,085,80~84세,2017,41984,14539,27445,53,41734,14475,27259,53.1
23,인천광역시,085001, 80세,2017,10020,3730,6290,59.3,9958,3709,6249,59.4
23,인천광역시,085002, 81세,2017,9523,3417,6106,56,9463,3399,6064,56.1
23,인천광역시,085003, 82세,2017,8867,3082,5785,53.3,8815,3069,5746,53.4
23,인천광역시,085004, 83세,2017,7214,2340,4874,48,7170,2333,4837,48.2
23,인천광역시,085005, 84세,2017,6360,1970,4390,44.9,6328,1965,4363,45
23,인천광역시,090,85~89세,2017,20262,5320,14942,35.6,20163,5294,14869,35.6
23,인천광역시,090001, 85세,2017,5540,1575,3965,39.7,5517,1569,3948,39.7
23,인천광역시,090002, 86세,2017,4330,1179,3151,37.4,4300,1171,3129,37.4
23,인천광역시,090003, 87세,2017,4068,985,3083,31.9,4044,980,3064,32
23,인천광역시,090004, 88세,2017,3533,908,2625,34.6,3523,904,2619,34.5
23,인천광역시,090005, 89세,2017,2791,673,2118,31.8,2779,670,2109,31.8
23,인천광역시,095,90~94세,2017,6951,1536,5415,28.4,6931,1531,5400,28.4
23,인천광역시,095001, 90세,2017,2210,497,1713,29,2205,495,1710,28.9
23,인천광역시,095002, 91세,2017,1529,316,1213,26.1,1521,314,1207,26
23,인천광역시,095003, 92세,2017,1352,264,1088,24.3,1350,263,1087,24.2
23,인천광역시,095004, 93세,2017,967,216,751,28.8,963,216,747,28.9
23,인천광역시,095005, 94세,2017,893,243,650,37.4,892,243,649,37.4
23,인천광역시,100,95~99세,2017,1607,363,1244,29.2,1600,358,1242,28.8
23,인천광역시,100001, 95세,2017,594,125,469,26.7,590,123,467,26.3
23,인천광역시,100002, 96세,2017,407,94,313,30,406,93,313,29.7
23,인천광역시,100003, 97세,2017,272,71,201,35.3,272,71,201,35.3
23,인천광역시,100004, 98세,2017,204,51,153,33.3,203,50,153,32.7
23,인천광역시,100005, 99세,2017,130,22,108,20.4,129,21,108,19.4
23,인천광역시,101,100세이상,2017,205,35,170,20.6,203,33,170,19.4
23,인천광역시,102,15세미만,2017,391947,201105,190842,105.4,387810,198945,188865,105.3
23,인천광역시,103,15~64세,2017,2194417,1125137,1069280,105.2,2122762,1082904,1039858,104.1
23,인천광역시,104,65세이상,2017,339603,145839,193764,75.3,336225,144459,191766,75.3
23,인천광역시,086,85세이상,2017,29025,7254,21771,33.3,28897,7216,21681,33.3
23,인천광역시,126,평균연령,2017,40.4,39.4,41.4,,40.5,39.5,41.4,
23,인천광역시,127,중위연령,2017,41.3,40.2,42.4,,41.5,40.5,42.6,
23004, 읍부,000,합계,2017,21519,10658,10861,98.1,21250,10544,10706,98.5
23004, 읍부,005,0~4세,2017,652,313,339,92.3,649,312,337,92.6
23004, 읍부,005001, 0세,2017,107,56,51,109.8,106,56,50,112
23004, 읍부,005002, 1세,2017,122,65,57,114,122,65,57,114
23004, 읍부,005003, 2세,2017,134,64,70,91.4,134,64,70,91.4
23004, 읍부,005004, 3세,2017,139,53,86,61.6,138,52,86,60.5
23004, 읍부,005005, 4세,2017,150,75,75,100,149,75,74,101.4
23004, 읍부,010,5~9세,2017,847,403,444,90.8,844,402,442,91
23004, 읍부,010001, 5세,2017,148,69,79,87.3,147,69,78,88.5
23004, 읍부,010002, 6세,2017,181,88,93,94.6,181,88,93,94.6
23004, 읍부,010003, 7세,2017,175,93,82,113.4,174,93,81,114.8
23004, 읍부,010004, 8세,2017,158,78,80,97.5,158,78,80,97.5
23004, 읍부,010005, 9세,2017,185,75,110,68.2,184,74,110,67.3
23004, 읍부,015,10~14세,2017,1023,525,498,105.4,1022,524,498,105.2
23004, 읍부,015001, 10세,2017,178,92,86,107,178,92,86,107
23004, 읍부,015002, 11세,2017,202,98,104,94.2,202,98,104,94.2
23004, 읍부,015003, 12세,2017,191,91,100,91,191,91,100,91
23004, 읍부,015004, 13세,2017,200,104,96,108.3,199,103,96,107.3
23004, 읍부,015005, 14세,2017,252,140,112,125,252,140,112,125
23004, 읍부,020,15~19세,2017,1661,816,845,96.6,1657,814,843,96.6
23004, 읍부,020001, 15세,2017,277,136,141,96.5,275,135,140,96.4
23004, 읍부,020002, 16세,2017,378,144,234,61.5,378,144,234,61.5
23004, 읍부,020003, 17세,2017,502,266,236,112.7,502,266,236,112.7
23004, 읍부,020004, 18세,2017,324,176,148,118.9,323,176,147,119.7
23004, 읍부,020005, 19세,2017,180,94,86,109.3,179,93,86,108.1
23004, 읍부,025,20~24세,2017,1065,635,430,147.7,1045,626,419,149.4
23004, 읍부,025001, 20세,2017,207,127,80,158.8,207,127,80,158.8
23004, 읍부,025002, 21세,2017,217,139,78,178.2,212,138,74,186.5
23004, 읍부,025003, 22세,2017,225,138,87,158.6,222,136,86,158.1
23004, 읍부,025004, 23세,2017,213,122,91,134.1,209,119,90,132.2
23004, 읍부,025005, 24세,2017,203,109,94,116,195,106,89,119.1
23004, 읍부,030,25~29세,2017,1003,531,472,112.5,959,513,446,115
23004, 읍부,030001, 25세,2017,203,115,88,130.7,190,112,78,143.6
23004, 읍부,030002, 26세,2017,222,111,111,100,213,108,105,102.9
23004, 읍부,030003, 27세,2017,203,114,89,128.1,192,108,84,128.6
23004, 읍부,030004, 28세,2017,200,104,96,108.3,196,102,94,108.5
23004, 읍부,030005, 29세,2017,175,87,88,98.9,168,83,85,97.6
23004, 읍부,035,30~34세,2017,939,508,431,117.9,894,483,411,117.5
23004, 읍부,035001, 30세,2017,185,103,82,125.6,173,97,76,127.6
23004, 읍부,035002, 31세,2017,143,78,65,120,136,75,61,123
23004, 읍부,035003, 32세,2017,182,102,80,127.5,174,96,78,123.1
23004, 읍부,035004, 33세,2017,198,99,99,100,187,93,94,98.9
23004, 읍부,035005, 34세,2017,231,126,105,120,224,122,102,119.6
23004, 읍부,040,35~39세,2017,1230,625,605,103.3,1206,615,591,104.1
23004, 읍부,040001, 35세,2017,268,136,132,103,260,131,129,101.6
23004, 읍부,040002, 36세,2017,255,131,124,105.6,252,131,121,108.3
23004, 읍부,040003, 37세,2017,251,132,119,110.9,246,129,117,110.3
23004, 읍부,040004, 38세,2017,243,120,123,97.6,240,119,121,98.3
23004, 읍부,040005, 39세,2017,213,106,107,99.1,208,105,103,101.9
23004, 읍부,045,40~44세,2017,1490,753,737,102.2,1477,747,730,102.3
23004, 읍부,045001, 40세,2017,271,142,129,110.1,267,141,126,111.9
23004, 읍부,045002, 41세,2017,245,120,125,96,242,118,124,95.2
23004, 읍부,045003, 42세,2017,291,142,149,95.3,291,142,149,95.3
23004, 읍부,045004, 43세,2017,330,172,158,108.9,326,171,155,110.3
23004, 읍부,045005, 44세,2017,353,177,176,100.6,351,175,176,99.4
23004, 읍부,050,45~49세,2017,1792,945,847,111.6,1761,932,829,112.4
23004, 읍부,050001, 45세,2017,328,161,167,96.4,323,157,166,94.6
23004, 읍부,050002, 46세,2017,378,203,175,116,370,201,169,118.9
23004, 읍부,050003, 47세,2017,373,217,156,139.1,368,216,152,142.1
23004, 읍부,050004, 48세,2017,365,191,174,109.8,360,189,171,110.5
23004, 읍부,050005, 49세,2017,348,173,175,98.9,340,169,171,98.8
23004, 읍부,055,50~54세,2017,1666,836,830,100.7,1638,827,811,102
23004, 읍부,055001, 50세,2017,330,166,164,101.2,328,166,162,102.5
23004, 읍부,055002, 51세,2017,325,178,147,121.1,323,177,146,121.2
23004, 읍부,055003, 52세,2017,350,172,178,96.6,342,169,173,97.7
23004, 읍부,055004, 53세,2017,320,151,169,89.3,310,148,162,91.4
23004, 읍부,055005, 54세,2017,341,169,172,98.3,335,167,168,99.4
23004, 읍부,060,55~59세,2017,1992,988,1004,98.4,1971,982,989,99.3
23004, 읍부,060001, 55세,2017,390,201,189,106.3,386,201,185,108.6
23004, 읍부,060002, 56세,2017,434,205,229,89.5,432,205,227,90.3
23004, 읍부,060003, 57세,2017,383,197,186,105.9,379,194,185,104.9
23004, 읍부,060004, 58세,2017,383,193,190,101.6,378,191,187,102.1
23004, 읍부,060005, 59세,2017,402,192,210,91.4,396,191,205,93.2
23004, 읍부,065,60~64세,2017,1669,824,845,97.5,1657,819,838,97.7
23004, 읍부,065001, 60세,2017,363,190,173,109.8,359,188,171,109.9
23004, 읍부,065002, 61세,2017,332,164,168,97.6,330,163,167,97.6
23004, 읍부,065003, 62세,2017,350,174,176,98.9,349,174,175,99.4
23004, 읍부,065004, 63세,2017,310,145,165,87.9,307,144,163,88.3
23004, 읍부,065005, 64세,2017,314,151,163,92.6,312,150,162,92.6
23004, 읍부,070,65~69세,2017,1255,594,661,89.9,1248,592,656,90.2
23004, 읍부,070001, 65세,2017,306,151,155,97.4,304,151,153,98.7
23004, 읍부,070002, 66세,2017,188,85,103,82.5,187,85,102,83.3
23004, 읍부,070003, 67세,2017,228,111,117,94.9,227,111,116,95.7
23004, 읍부,070004, 68세,2017,266,119,147,81,263,117,146,80.1
23004, 읍부,070005, 69세,2017,267,128,139,92.1,267,128,139,92.1
23004, 읍부,075,70~74세,2017,1177,542,635,85.4,1172,539,633,85.2
23004, 읍부,075001, 70세,2017,307,138,169,81.7,305,136,169,80.5
23004, 읍부,075002, 71세,2017,198,88,110,80,198,88,110,80
23004, 읍부,075003, 72세,2017,222,102,120,85,219,101,118,85.6
23004, 읍부,075004, 73세,2017,214,102,112,91.1,214,102,112,91.1
23004, 읍부,075005, 74세,2017,236,112,124,90.3,236,112,124,90.3
23004, 읍부,080,75~79세,2017,1008,438,570,76.8,1005,437,568,76.9
23004, 읍부,080001, 75세,2017,246,109,137,79.6,246,109,137,79.6
23004, 읍부,080002, 76세,2017,220,99,121,81.8,219,98,121,81
23004, 읍부,080003, 77세,2017,171,65,106,61.3,170,65,105,61.9
23004, 읍부,080004, 78세,2017,185,82,103,79.6,184,82,102,80.4
23004, 읍부,080005, 79세,2017,186,83,103,80.6,186,83,103,80.6
23004, 읍부,085,80~84세,2017,671,261,410,63.7,667,259,408,63.5
23004, 읍부,085001, 80세,2017,152,74,78,94.9,151,74,77,96.1
23004, 읍부,085002, 81세,2017,148,57,91,62.6,148,57,91,62.6
23004, 읍부,085003, 82세,2017,157,57,100,57,155,56,99,56.6
23004, 읍부,085004, 83세,2017,117,40,77,51.9,116,39,77,50.6
23004, 읍부,085005, 84세,2017,97,33,64,51.6,97,33,64,51.6
23004, 읍부,090,85~89세,2017,287,90,197,45.7,287,90,197,45.7
23004, 읍부,090001, 85세,2017,87,27,60,45,87,27,60,45
23004, 읍부,090002, 86세,2017,58,23,35,65.7,58,23,35,65.7
23004, 읍부,090003, 87세,2017,51,16,35,45.7,51,16,35,45.7
23004, 읍부,090004, 88세,2017,47,14,33,42.4,47,14,33,42.4
23004, 읍부,090005, 89세,2017,44,10,34,29.4,44,10,34,29.4
23004, 읍부,095,90~94세,2017,76,21,55,38.2,75,21,54,38.9
23004, 읍부,095001, 90세,2017,21,5,16,31.3,21,5,16,31.3
23004, 읍부,095002, 91세,2017,16,X,12,33.3,15,X,11,36.4
23004, 읍부,095003, 92세,2017,22,8,14,57.1,22,8,14,57.1
23004, 읍부,095004, 93세,2017,10,X,9,11.1,10,X,9,11.1
23004, 읍부,095005, 94세,2017,7,X,X,75,7,X,X,75
23004, 읍부,100,95~99세,2017,15,9,6,150,15,9,6,150
23004, 읍부,100001, 95세,2017,X,X,X,200,X,X,X,200
23004, 읍부,100002, 96세,2017,6,X,X,50,6,X,X,50
23004, 읍부,100003, 97세,2017,X,X,X,200,X,X,X,200
23004, 읍부,100004, 98세,2017,X,X,X,,X,X,X,
23004, 읍부,100005, 99세,2017,X,X,X,,X,X,X,
23004, 읍부,101,100세이상,2017,X,X,X,,X,X,X,
23004, 읍부,102,15세미만,2017,2522,1241,1281,96.9,2515,1238,1277,96.9
23004, 읍부,103,15~64세,2017,14507,7461,7046,105.9,14265,7358,6907,106.5
23004, 읍부,104,65세이상,2017,4490,1956,2534,77.2,4470,1948,2522,77.2
23004, 읍부,086,85세이상,2017,379,121,258,46.9,378,121,257,47.1
23004, 읍부,126,평균연령,2017,45.1,43.9,46.2,,45.1,43.9,46.2,
23004, 읍부,127,중위연령,2017,47.4,46.3,48.8,,47.5,46.4,48.9,
23005, 면부,000,합계,2017,61512,32371,29141,111.1,60585,31727,28858,109.9
23005, 면부,005,0~4세,2017,1400,705,695,101.4,1399,705,694,101.6
23005, 면부,005001, 0세,2017,237,115,122,94.3,237,115,122,94.3
23005, 면부,005002, 1세,2017,292,149,143,104.2,292,149,143,104.2
23005, 면부,005003, 2세,2017,280,144,136,105.9,280,144,136,105.9
23005, 면부,005004, 3세,2017,302,152,150,101.3,301,152,149,102
23005, 면부,005005, 4세,2017,289,145,144,100.7,289,145,144,100.7
23005, 면부,010,5~9세,2017,1665,885,780,113.5,1665,885,780,113.5
23005, 면부,010001, 5세,2017,340,183,157,116.6,340,183,157,116.6
23005, 면부,010002, 6세,2017,339,189,150,126,339,189,150,126
23005, 면부,010003, 7세,2017,316,167,149,112.1,316,167,149,112.1
23005, 면부,010004, 8세,2017,326,180,146,123.3,326,180,146,123.3
23005, 면부,010005, 9세,2017,344,166,178,93.3,344,166,178,93.3
23005, 면부,015,10~14세,2017,1609,836,773,108.2,1608,835,773,108
23005, 면부,015001, 10세,2017,348,191,157,121.7,348,191,157,121.7
23005, 면부,015002, 11세,2017,310,163,147,110.9,310,163,147,110.9
23005, 면부,015003, 12세,2017,291,154,137,112.4,291,154,137,112.4
23005, 면부,015004, 13세,2017,322,159,163,97.5,321,158,163,96.9
23005, 면부,015005, 14세,2017,338,169,169,100,338,169,169,100
23005, 면부,020,15~19세,2017,1688,957,731,130.9,1687,956,731,130.8
23005, 면부,020001, 15세,2017,309,173,136,127.2,309,173,136,127.2
23005, 면부,020002, 16세,2017,361,207,154,134.4,361,207,154,134.4
23005, 면부,020003, 17세,2017,361,193,168,114.9,360,192,168,114.3
23005, 면부,020004, 18세,2017,346,178,168,106,346,178,168,106
23005, 면부,020005, 19세,2017,311,206,105,196.2,311,206,105,196.2
23005, 면부,025,20~24세,2017,2747,1919,828,231.8,2638,1835,803,228.5
23005, 면부,025001, 20세,2017,405,284,121,234.7,402,283,119,237.8
23005, 면부,025002, 21세,2017,498,361,137,263.5,481,349,132,264.4
23005, 면부,025003, 22세,2017,548,391,157,249,532,379,153,247.7
23005, 면부,025004, 23세,2017,654,451,203,222.2,622,427,195,219
23005, 면부,025005, 24세,2017,642,432,210,205.7,601,397,204,194.6
23005, 면부,030,25~29세,2017,2945,1942,1003,193.6,2719,1771,948,186.8
23005, 면부,030001, 25세,2017,634,422,212,199.1,599,396,203,195.1
23005, 면부,030002, 26세,2017,631,407,224,181.7,597,385,212,181.6
23005, 면부,030003, 27세,2017,592,397,195,203.6,547,363,184,197.3
23005, 면부,030004, 28세,2017,566,385,181,212.7,511,341,170,200.6
23005, 면부,030005, 29세,2017,522,331,191,173.3,465,286,179,159.8
23005, 면부,035,30~34세,2017,2501,1506,995,151.4,2287,1334,953,140
23005, 면부,035001, 30세,2017,529,335,194,172.7,482,300,182,164.8
23005, 면부,035002, 31세,2017,498,316,182,173.6,446,271,175,154.9
23005, 면부,035003, 32세,2017,458,267,191,139.8,416,229,187,122.5
23005, 면부,035004, 33세,2017,471,261,210,124.3,437,236,201,117.4
23005, 면부,035005, 34세,2017,545,327,218,150,506,298,208,143.3
23005, 면부,040,35~39세,2017,2878,1657,1221,135.7,2771,1579,1192,132.5
23005, 면부,040001, 35세,2017,587,337,250,134.8,562,318,244,130.3
23005, 면부,040002, 36세,2017,566,327,239,136.8,540,307,233,131.8
23005, 면부,040003, 37세,2017,584,328,256,128.1,563,313,250,125.2
23005, 면부,040004, 38세,2017,563,320,243,131.7,546,308,238,129.4
23005, 면부,040005, 39세,2017,578,345,233,148.1,560,333,227,146.7
23005, 면부,045,40~44세,2017,3142,1889,1253,150.8,3065,1841,1224,150.4
23005, 면부,045001, 40세,2017,566,327,239,136.8,550,315,235,134
23005, 면부,045002, 41세,2017,579,341,238,143.3,561,330,231,142.9
23005, 면부,045003, 42세,2017,595,363,232,156.5,580,353,227,155.5
23005, 면부,045004, 43세,2017,675,423,252,167.9,660,415,245,169.4
23005, 면부,045005, 44세,2017,727,435,292,149,714,428,286,149.7
23005, 면부,050,45~49세,2017,3800,2173,1627,133.6,3746,2148,1598,134.4
23005, 면부,050001, 45세,2017,680,433,247,175.3,669,428,241,177.6
23005, 면부,050002, 46세,2017,739,429,310,138.4,728,422,306,137.9
23005, 면부,050003, 47세,2017,720,419,301,139.2,708,415,293,141.6
23005, 면부,050004, 48세,2017,790,430,360,119.4,784,427,357,119.6
23005, 면부,050005, 49세,2017,871,462,409,113,857,456,401,113.7
23005, 면부,055,50~54세,2017,4811,2571,2240,114.8,4770,2550,2220,114.9
23005, 면부,055001, 50세,2017,826,452,374,120.9,817,447,370,120.8
23005, 면부,055002, 51세,2017,888,479,409,117.1,878,475,403,117.9
23005, 면부,055003, 52세,2017,993,523,470,111.3,986,518,468,110.7
23005, 면부,055004, 53세,2017,1009,540,469,115.1,1001,535,466,114.8
23005, 면부,055005, 54세,2017,1095,577,518,111.4,1088,575,513,112.1
23005, 면부,060,55~59세,2017,6983,3564,3419,104.2,6953,3554,3399,104.6
23005, 면부,060001, 55세,2017,1286,665,621,107.1,1279,663,616,107.6
23005, 면부,060002, 56세,2017,1437,751,686,109.5,1434,749,685,109.3
23005, 면부,060003, 57세,2017,1470,744,726,102.5,1466,743,723,102.8
23005, 면부,060004, 58세,2017,1469,728,741,98.2,1457,724,733,98.8
23005, 면부,060005, 59세,2017,1321,676,645,104.8,1317,675,642,105.1
23005, 면부,065,60~64세,2017,6294,3185,3109,102.4,6261,3171,3090,102.6
23005, 면부,065001, 60세,2017,1332,696,636,109.4,1327,693,634,109.3
23005, 면부,065002, 61세,2017,1346,671,675,99.4,1343,670,673,99.6
23005, 면부,065003, 62세,2017,1394,693,701,98.9,1379,688,691,99.6
23005, 면부,065004, 63세,2017,1123,552,571,96.7,1116,549,567,96.8
23005, 면부,065005, 64세,2017,1099,573,526,108.9,1096,571,525,108.8
23005, 면부,070,65~69세,2017,4934,2505,2429,103.1,4921,2498,2423,103.1
23005, 면부,070001, 65세,2017,1165,582,583,99.8,1162,580,582,99.7
23005, 면부,070002, 66세,2017,747,356,391,91,746,356,390,91.3
23005, 면부,070003, 67세,2017,1019,525,494,106.3,1017,524,493,106.3
23005, 면부,070004, 68세,2017,1031,554,477,116.1,1025,550,475,115.8
23005, 면부,070005, 69세,2017,972,488,484,100.8,971,488,483,101
23005, 면부,075,70~74세,2017,4657,2267,2390,94.9,4648,2263,2385,94.9
23005, 면부,075001, 70세,2017,1159,582,577,100.9,1156,581,575,101
23005, 면부,075002, 71세,2017,922,437,485,90.1,920,436,484,90.1
23005, 면부,075003, 72세,2017,831,414,417,99.3,830,414,416,99.5
23005, 면부,075004, 73세,2017,813,377,436,86.5,812,376,436,86.2
23005, 면부,075005, 74세,2017,932,457,475,96.2,930,456,474,96.2
23005, 면부,080,75~79세,2017,4094,1917,2177,88.1,4088,1912,2176,87.9
23005, 면부,080001, 75세,2017,970,464,506,91.7,968,463,505,91.7
23005, 면부,080002, 76세,2017,859,408,451,90.5,857,406,451,90
23005, 면부,080003, 77세,2017,768,366,402,91,767,365,402,90.8
23005, 면부,080004, 78세,2017,770,338,432,78.2,770,338,432,78.2
23005, 면부,080005, 79세,2017,727,341,386,88.3,726,340,386,88.1
23005, 면부,085,80~84세,2017,3075,1261,1814,69.5,3073,1261,1812,69.6
23005, 면부,085001, 80세,2017,677,290,387,74.9,677,290,387,74.9
23005, 면부,085002, 81세,2017,742,309,433,71.4,741,309,432,71.5
23005, 면부,085003, 82세,2017,625,261,364,71.7,625,261,364,71.7
23005, 면부,085004, 83세,2017,537,207,330,62.7,537,207,330,62.7
23005, 면부,085005, 84세,2017,494,194,300,64.7,493,194,299,64.9
23005, 면부,090,85~89세,2017,1581,460,1121,41,1579,458,1121,40.9
23005, 면부,090001, 85세,2017,441,133,308,43.2,441,133,308,43.2
23005, 면부,090002, 86세,2017,363,111,252,44,362,110,252,43.7
23005, 면부,090003, 87세,2017,303,85,218,39,303,85,218,39
23005, 면부,090004, 88세,2017,262,75,187,40.1,261,74,187,39.6
23005, 면부,090005, 89세,2017,212,56,156,35.9,212,56,156,35.9
23005, 면부,095,90~94세,2017,554,131,423,31,553,130,423,30.7
23005, 면부,095001, 90세,2017,164,40,124,32.3,163,39,124,31.5
23005, 면부,095002, 91세,2017,124,30,94,31.9,124,30,94,31.9
23005, 면부,095003, 92세,2017,116,24,92,26.1,116,24,92,26.1
23005, 면부,095004, 93세,2017,82,20,62,32.3,82,20,62,32.3
23005, 면부,095005, 94세,2017,68,17,51,33.3,68,17,51,33.3
23005, 면부,100,95~99세,2017,134,37,97,38.1,134,37,97,38.1
23005, 면부,100001, 95세,2017,50,10,40,25,50,10,40,25
23005, 면부,100002, 96세,2017,33,12,21,57.1,33,12,21,57.1
23005, 면부,100003, 97세,2017,25,9,16,56.3,25,9,16,56.3
23005, 면부,100004, 98세,2017,15,X,13,15.4,15,X,13,15.4
23005, 면부,100005, 99세,2017,11,X,7,57.1,11,X,7,57.1
23005, 면부,101,100세이상,2017,20,X,16,25,20,X,16,25
23005, 면부,102,15세미만,2017,4674,2426,2248,107.9,4672,2425,2247,107.9
23005, 면부,103,15~64세,2017,37789,21363,16426,130.1,36897,20739,16158,128.4
23005, 면부,104,65세이상,2017,19049,8582,10467,82,19016,8563,10453,81.9
23005, 면부,086,85세이상,2017,2289,632,1657,38.1,2286,629,1657,38
23005, 면부,126,평균연령,2017,52.1,49.7,54.8,,52.3,50,54.9,
23005, 면부,127,중위연령,2017,56.2,53.5,58.5,,56.5,54,58.7,
23003, 동부,000,합계,2017,2842936,1429052,1413884,101.1,2764962,1384037,1380925,100.2
23003, 동부,005,0~4세,2017,122216,62497,59719,104.7,120058,61397,58661,104.7
23003, 동부,005001, 0세,2017,21000,10759,10241,105.1,20554,10529,10025,105
23003, 동부,005002, 1세,2017,24256,12348,11908,103.7,23731,12076,11655,103.6
23003, 동부,005003, 2세,2017,25774,13170,12604,104.5,25354,12964,12390,104.6
23003, 동부,005004, 3세,2017,25405,13079,12326,106.1,24978,12858,12120,106.1
23003, 동부,005005, 4세,2017,25781,13141,12640,104,25441,12970,12471,104
23003, 동부,010,5~9세,2017,133581,68530,65051,105.3,132377,67884,64493,105.3
23003, 동부,010001, 5세,2017,27774,14237,13537,105.2,27476,14085,13391,105.2
23003, 동부,010002, 6세,2017,27565,14285,13280,107.6,27301,14142,13159,107.5
23003, 동부,010003, 7세,2017,26224,13449,12775,105.3,26020,13342,12678,105.2
23003, 동부,010004, 8세,2017,25475,13035,12440,104.8,25252,12916,12336,104.7
23003, 동부,010005, 9세,2017,26543,13524,13019,103.9,26328,13399,12929,103.6
23003, 동부,015,10~14세,2017,128954,66411,62543,106.2,128188,66001,62187,106.1
23003, 동부,015001, 10세,2017,27344,14099,13245,106.4,27160,14002,13158,106.4
23003, 동부,015002, 11세,2017,24624,12750,11874,107.4,24475,12659,11816,107.1
23003, 동부,015003, 12세,2017,24025,12338,11687,105.6,23871,12257,11614,105.5
23003, 동부,015004, 13세,2017,26080,13398,12682,105.6,25944,13333,12611,105.7
23003, 동부,015005, 14세,2017,26881,13826,13055,105.9,26738,13750,12988,105.9
23003, 동부,020,15~19세,2017,159606,82517,77089,107,158092,81768,76324,107.1
23003, 동부,020001, 15세,2017,27361,14215,13146,108.1,27223,14139,13084,108.1
23003, 동부,020002, 16세,2017,31032,16035,14997,106.9,30889,15962,14927,106.9
23003, 동부,020003, 17세,2017,34137,17582,16555,106.2,33926,17469,16457,106.1
23003, 동부,020004, 18세,2017,33266,17326,15940,108.7,32879,17144,15735,109
23003, 동부,020005, 19세,2017,33810,17359,16451,105.5,33175,17054,16121,105.8
23003, 동부,025,20~24세,2017,193272,102113,91159,112,187281,98689,88592,111.4
23003, 동부,025001, 20세,2017,35983,18961,17022,111.4,35158,18572,16586,112
23003, 동부,025002, 21세,2017,37371,20254,17117,118.3,36393,19728,16665,118.4
23003, 동부,025003, 22세,2017,38567,20640,17927,115.1,37370,19953,17417,114.6
23003, 동부,025004, 23세,2017,39802,20810,18992,109.6,38423,19974,18449,108.3
23003, 동부,025005, 24세,2017,41549,21448,20101,106.7,39937,20462,19475,105.1
23003, 동부,030,25~29세,2017,200368,104704,95664,109.4,188611,97394,91217,106.8
23003, 동부,030001, 25세,2017,43338,22299,21039,106,41406,21089,20317,103.8
23003, 동부,030002, 26세,2017,41692,21813,19879,109.7,39519,20485,19034,107.6
23003, 동부,030003, 27세,2017,39633,20833,18800,110.8,37173,19326,17847,108.3
23003, 동부,030004, 28세,2017,38248,20128,18120,111.1,35810,18601,17209,108.1
23003, 동부,030005, 29세,2017,37457,19631,17826,110.1,34703,17893,16810,106.4
23003, 동부,035,30~34세,2017,201402,105324,96078,109.6,187951,96721,91230,106
23003, 동부,035001, 30세,2017,37621,19566,18055,108.4,34709,17759,16950,104.8
23003, 동부,035002, 31세,2017,38471,20248,18223,111.1,35641,18474,17167,107.6
23003, 동부,035003, 32세,2017,39063,20589,18474,111.4,36372,18869,17503,107.8
23003, 동부,035004, 33세,2017,40950,21446,19504,110,38395,19781,18614,106.3
23003, 동부,035005, 34세,2017,45297,23475,21822,107.6,42834,21838,20996,104
23003, 동부,040,35~39세,2017,241500,125490,116010,108.2,231486,118950,112536,105.7
23003, 동부,040001, 35세,2017,49351,25644,23707,108.2,46959,24051,22908,105
23003, 동부,040002, 36세,2017,49915,26163,23752,110.2,47836,24798,23038,107.6
23003, 동부,040003, 37세,2017,50515,26112,24403,107,48573,24845,23728,104.7
23003, 동부,040004, 38세,2017,47908,24992,22916,109.1,45985,23741,22244,106.7
23003, 동부,040005, 39세,2017,43811,22579,21232,106.3,42133,21515,20618,104.4
23003, 동부,045,40~44세,2017,231962,119066,112896,105.5,225124,114888,110236,104.2
23003, 동부,045001, 40세,2017,44272,22845,21427,106.6,42819,21934,20885,105
23003, 동부,045002, 41세,2017,42912,22250,20662,107.7,41503,21381,20122,106.3
23003, 동부,045003, 42세,2017,45686,23555,22131,106.4,44359,22746,21613,105.2
23003, 동부,045004, 43세,2017,49172,25377,23795,106.6,47878,24561,23317,105.3
23003, 동부,045005, 44세,2017,49920,25039,24881,100.6,48565,24266,24299,99.9
23003, 동부,050,45~49세,2017,259227,129475,129752,99.8,252420,125777,126643,99.3
23003, 동부,050001, 45세,2017,50218,25537,24681,103.5,48855,24780,24075,102.9
23003, 동부,050002, 46세,2017,52711,26634,26077,102.1,51310,25874,25436,101.7
23003, 동부,050003, 47세,2017,51399,25827,25572,101,49963,25023,24940,100.3
23003, 동부,050004, 48세,2017,52436,25882,26554,97.5,51142,25190,25952,97.1
23003, 동부,050005, 49세,2017,52463,25595,26868,95.3,51150,24910,26240,94.9
23003, 동부,055,50~54세,2017,242499,120927,121572,99.5,236544,117887,118657,99.4
23003, 동부,055001, 50세,2017,47823,23459,24364,96.3,46812,22906,23906,95.8
23003, 동부,055002, 51세,2017,47453,23731,23722,100,46344,23163,23181,99.9
23003, 동부,055003, 52세,2017,50260,24921,25339,98.4,49024,24295,24729,98.2
23003, 동부,055004, 53세,2017,47255,23627,23628,100,46017,23010,23007,100
23003, 동부,055005, 54세,2017,49708,25189,24519,102.7,48347,24513,23834,102.8
23003, 동부,060,55~59세,2017,244260,123195,121065,101.8,239802,120980,118822,101.8
23003, 동부,060001, 55세,2017,50346,25403,24943,101.8,49326,24892,24434,101.9
23003, 동부,060002, 56세,2017,53084,26798,26286,101.9,52331,26437,25894,102.1
23003, 동부,060003, 57세,2017,52181,26269,25912,101.4,51122,25757,25365,101.5
23003, 동부,060004, 58세,2017,45602,22918,22684,101,44796,22510,22286,101
23003, 동부,060005, 59세,2017,43047,21807,21240,102.7,42227,21384,20843,102.6
23003, 동부,065,60~64세,2017,168025,83502,84523,98.8,164289,81753,82536,99.1
23003, 동부,065001, 60세,2017,40615,20435,20180,101.3,39721,20010,19711,101.5
23003, 동부,065002, 61세,2017,36154,18034,18120,99.5,35420,17690,17730,99.8
23003, 동부,065003, 62세,2017,36339,17911,18428,97.2,35545,17543,18002,97.5
23003, 동부,065004, 63세,2017,29677,14654,15023,97.5,28961,14332,14629,98
23003, 동부,065005, 64세,2017,25240,12468,12772,97.6,24642,12178,12464,97.7
23003, 동부,070,65~69세,2017,108153,53089,55064,96.4,106262,52226,54036,96.7
23003, 동부,070001, 65세,2017,27457,13598,13859,98.1,26929,13360,13569,98.5
23003, 동부,070002, 66세,2017,18416,9045,9371,96.5,17961,8818,9143,96.4
23003, 동부,070003, 67세,2017,20806,10292,10514,97.9,20427,10124,10303,98.3
23003, 동부,070004, 68세,2017,21161,10246,10915,93.9,20828,10093,10735,94
23003, 동부,070005, 69세,2017,20313,9908,10405,95.2,20117,9831,10286,95.6
23003, 동부,075,70~74세,2017,79250,36435,42815,85.1,78599,36184,42415,85.3
23003, 동부,075001, 70세,2017,20193,9437,10756,87.7,20015,9359,10656,87.8
23003, 동부,075002, 71세,2017,15479,7254,8225,88.2,15327,7190,8137,88.4
23003, 동부,075003, 72세,2017,14520,6694,7826,85.5,14392,6643,7749,85.7
23003, 동부,075004, 73세,2017,14355,6560,7795,84.2,14248,6530,7718,84.6
23003, 동부,075005, 74세,2017,14703,6490,8213,79,14617,6462,8155,79.2
23003, 동부,080,75~79세,2017,64066,26259,37807,69.5,63651,26117,37534,69.6
23003, 동부,080001, 75세,2017,16693,7228,9465,76.4,16610,7189,9421,76.3
23003, 동부,080002, 76세,2017,13191,5551,7640,72.7,13100,5522,7578,72.9
23003, 동부,080003, 77세,2017,11759,4770,6989,68.3,11677,4741,6936,68.4
23003, 동부,080004, 78세,2017,11746,4615,7131,64.7,11666,4591,7075,64.9
23003, 동부,080005, 79세,2017,10677,4095,6582,62.2,10598,4074,6524,62.4
23003, 동부,085,80~84세,2017,38238,13017,25221,51.6,37994,12955,25039,51.7
23003, 동부,085001, 80세,2017,9191,3366,5825,57.8,9130,3345,5785,57.8
23003, 동부,085002, 81세,2017,8633,3051,5582,54.7,8574,3033,5541,54.7
23003, 동부,085003, 82세,2017,8085,2764,5321,51.9,8035,2752,5283,52.1
23003, 동부,085004, 83세,2017,6560,2093,4467,46.9,6517,2087,4430,47.1
23003, 동부,085005, 84세,2017,5769,1743,4026,43.3,5738,1738,4000,43.5
23003, 동부,090,85~89세,2017,18394,4770,13624,35,18297,4746,13551,35
23003, 동부,090001, 85세,2017,5012,1415,3597,39.3,4989,1409,3580,39.4
23003, 동부,090002, 86세,2017,3909,1045,2864,36.5,3880,1038,2842,36.5
23003, 동부,090003, 87세,2017,3714,884,2830,31.2,3690,879,2811,31.3
23003, 동부,090004, 88세,2017,3224,819,2405,34.1,3215,816,2399,34
23003, 동부,090005, 89세,2017,2535,607,1928,31.5,2523,604,1919,31.5
23003, 동부,095,90~94세,2017,6321,1384,4937,28,6303,1380,4923,28
23003, 동부,095001, 90세,2017,2025,452,1573,28.7,2021,451,1570,28.7
23003, 동부,095002, 91세,2017,1389,282,1107,25.5,1382,280,1102,25.4
23003, 동부,095003, 92세,2017,1214,232,982,23.6,1212,231,981,23.5
23003, 동부,095004, 93세,2017,875,195,680,28.7,871,195,676,28.8
23003, 동부,095005, 94세,2017,818,223,595,37.5,817,223,594,37.5
23003, 동부,100,95~99세,2017,1458,317,1141,27.8,1451,312,1139,27.4
23003, 동부,100001, 95세,2017,541,113,428,26.4,537,111,426,26.1
23003, 동부,100002, 96세,2017,368,80,288,27.8,367,79,288,27.4
23003, 동부,100003, 97세,2017,244,60,184,32.6,244,60,184,32.6
23003, 동부,100004, 98세,2017,187,47,140,33.6,186,46,140,32.9
23003, 동부,100005, 99세,2017,118,17,101,16.8,117,16,101,15.8
23003, 동부,101,100세이상,2017,184,30,154,19.5,182,28,154,18.2
23003, 동부,102,15세미만,2017,384751,197438,187313,105.4,380623,195282,185341,105.4
23003, 동부,103,15~64세,2017,2142121,1096313,1045808,104.8,2071600,1054807,1016793,103.7
23003, 동부,104,65세이상,2017,316064,135301,180763,74.8,312739,133948,178791,74.9
23003, 동부,086,85세이상,2017,26357,6501,19856,32.7,26233,6466,19767,32.7
23003, 동부,126,평균연령,2017,40.1,39.2,41.1,,40.2,39.2,41.1,
23003, 동부,127,중위연령,2017,40.9,39.9,42.1,,41.1,40.1,42.2,
23010, 중구,000,합계,2017,115153,59415,55738,106.6,110770,57112,53658,106.4
23010, 중구,005,0~4세,2017,5056,2565,2491,103,4971,2523,2448,103.1
23010, 중구,005001, 0세,2017,824,408,416,98.1,807,398,409,97.3
23010, 중구,005002, 1세,2017,972,488,484,100.8,954,477,477,100
23010, 중구,005003, 2세,2017,1087,567,520,109,1068,561,507,110.7
23010, 중구,005004, 3세,2017,1057,526,531,99.1,1044,523,521,100.4
23010, 중구,005005, 4세,2017,1116,576,540,106.7,1098,564,534,105.6
23010, 중구,010,5~9세,2017,5695,2864,2831,101.2,5638,2832,2806,100.9
23010, 중구,010001, 5세,2017,1212,583,629,92.7,1201,578,623,92.8
23010, 중구,010002, 6세,2017,1170,615,555,110.8,1157,608,549,110.7
23010, 중구,010003, 7세,2017,1130,580,550,105.5,1121,573,548,104.6
23010, 중구,010004, 8세,2017,1044,527,517,101.9,1028,518,510,101.6
23010, 중구,010005, 9세,2017,1139,559,580,96.4,1131,555,576,96.4
23010, 중구,015,10~14세,2017,5567,2909,2658,109.4,5491,2869,2622,109.4
23010, 중구,015001, 10세,2017,1215,638,577,110.6,1202,631,571,110.5
23010, 중구,015002, 11세,2017,1075,554,521,106.3,1060,545,515,105.8
23010, 중구,015003, 12세,2017,1033,544,489,111.2,1019,535,484,110.5
23010, 중구,015004, 13세,2017,1136,590,546,108.1,1122,584,538,108.6
23010, 중구,015005, 14세,2017,1108,583,525,111,1088,574,514,111.7
23010, 중구,020,15~19세,2017,6607,3539,3068,115.4,6515,3491,3024,115.4
23010, 중구,020001, 15세,2017,1107,576,531,108.5,1088,571,517,110.4
23010, 중구,020002, 16세,2017,1545,810,735,110.2,1532,806,726,111
23010, 중구,020003, 17세,2017,1828,1017,811,125.4,1802,1001,801,125
23010, 중구,020004, 18세,2017,1202,649,553,117.4,1187,640,547,117
23010, 중구,020005, 19세,2017,925,487,438,111.2,906,473,433,109.2
23010, 중구,025,20~24세,2017,5756,2978,2778,107.2,5525,2862,2663,107.5
23010, 중구,025001, 20세,2017,963,518,445,116.4,937,503,434,115.9
23010, 중구,025002, 21세,2017,1045,548,497,110.3,1018,535,483,110.8
23010, 중구,025003, 22세,2017,1100,558,542,103,1053,540,513,105.3
23010, 중구,025004, 23세,2017,1228,640,588,108.8,1172,607,565,107.4
23010, 중구,025005, 24세,2017,1420,714,706,101.1,1345,677,668,101.3
23010, 중구,030,25~29세,2017,7274,3927,3347,117.3,6754,3636,3118,116.6
23010, 중구,030001, 25세,2017,1466,742,724,102.5,1364,689,675,102.1
23010, 중구,030002, 26세,2017,1494,800,694,115.3,1412,751,661,113.6
23010, 중구,030003, 27세,2017,1474,848,626,135.5,1360,784,576,136.1
23010, 중구,030004, 28세,2017,1413,779,634,122.9,1309,721,588,122.6
23010, 중구,030005, 29세,2017,1427,758,669,113.3,1309,691,618,111.8
23010, 중구,035,30~34세,2017,8035,4358,3677,118.5,7403,3996,3407,117.3
23010, 중구,035001, 30세,2017,1518,851,667,127.6,1365,757,608,124.5
23010, 중구,035002, 31세,2017,1460,768,692,111,1322,696,626,111.2
23010, 중구,035003, 32세,2017,1523,799,724,110.4,1418,738,680,108.5
23010, 중구,035004, 33세,2017,1636,904,732,123.5,1514,843,671,125.6
23010, 중구,035005, 34세,2017,1898,1036,862,120.2,1784,962,822,117
23010, 중구,040,35~39세,2017,10516,5590,4926,113.5,9971,5280,4691,112.6
23010, 중구,040001, 35세,2017,2126,1099,1027,107,1995,1027,968,106.1
23010, 중구,040002, 36세,2017,2093,1133,960,118,1983,1070,913,117.2
23010, 중구,040003, 37세,2017,2191,1182,1009,117.1,2088,1115,973,114.6
23010, 중구,040004, 38세,2017,2043,1083,960,112.8,1942,1028,914,112.5
23010, 중구,040005, 39세,2017,2063,1093,970,112.7,1963,1040,923,112.7
23010, 중구,045,40~44세,2017,10238,5596,4642,120.6,9832,5358,4474,119.8
23010, 중구,045001, 40세,2017,1978,1059,919,115.2,1897,1012,885,114.4
23010, 중구,045002, 41세,2017,1972,1082,890,121.6,1910,1050,860,122.1
23010, 중구,045003, 42세,2017,1954,1069,885,120.8,1878,1020,858,118.9
23010, 중구,045004, 43세,2017,2175,1224,951,128.7,2078,1167,911,128.1
23010, 중구,045005, 44세,2017,2159,1162,997,116.5,2069,1109,960,115.5
23010, 중구,050,45~49세,2017,10318,5688,4630,122.9,9891,5465,4426,123.5
23010, 중구,050001, 45세,2017,2155,1172,983,119.2,2066,1124,942,119.3
23010, 중구,050002, 46세,2017,2196,1237,959,129,2116,1194,922,129.5
23010, 중구,050003, 47세,2017,2074,1164,910,127.9,1976,1112,864,128.7
23010, 중구,050004, 48세,2017,1935,1048,887,118.2,1858,1009,849,118.8
23010, 중구,050005, 49세,2017,1958,1067,891,119.8,1875,1026,849,120.8
23010, 중구,055,50~54세,2017,8287,4565,3722,122.6,7923,4394,3529,124.5
23010, 중구,055001, 50세,2017,1641,953,688,138.5,1591,926,665,139.2
23010, 중구,055002, 51세,2017,1672,922,750,122.9,1598,890,708,125.7
23010, 중구,055003, 52세,2017,1669,927,742,124.9,1598,896,702,127.6
23010, 중구,055004, 53세,2017,1619,884,735,120.3,1542,840,702,119.7
23010, 중구,055005, 54세,2017,1686,879,807,108.9,1594,842,752,112
23010, 중구,060,55~59세,2017,8622,4356,4266,102.1,8275,4199,4076,103
23010, 중구,060001, 55세,2017,1718,883,835,105.7,1626,843,783,107.7
23010, 중구,060002, 56세,2017,1776,891,885,100.7,1718,868,850,102.1
23010, 중구,060003, 57세,2017,1755,902,853,105.7,1685,867,818,106
23010, 중구,060004, 58세,2017,1677,821,856,95.9,1600,784,816,96.1
23010, 중구,060005, 59세,2017,1696,859,837,102.6,1646,837,809,103.5
23010, 중구,065,60~64세,2017,7274,3565,3709,96.1,6997,3431,3566,96.2
23010, 중구,065001, 60세,2017,1585,795,790,100.6,1525,767,758,101.2
23010, 중구,065002, 61세,2017,1558,785,773,101.6,1492,750,742,101.1
23010, 중구,065003, 62세,2017,1621,761,860,88.5,1564,736,828,88.9
23010, 중구,065004, 63세,2017,1397,680,717,94.8,1341,655,686,95.5
23010, 중구,065005, 64세,2017,1113,544,569,95.6,1075,523,552,94.7
23010, 중구,070,65~69세,2017,5263,2480,2783,89.1,5079,2398,2681,89.4
23010, 중구,070001, 65세,2017,1273,618,655,94.4,1220,591,629,94
23010, 중구,070002, 66세,2017,805,374,431,86.8,767,357,410,87.1
23010, 중구,070003, 67세,2017,1028,501,527,95.1,992,486,506,96
23010, 중구,070004, 68세,2017,1111,474,637,74.4,1073,460,613,75
23010, 중구,070005, 69세,2017,1046,513,533,96.2,1027,504,523,96.4
23010, 중구,075,70~74세,2017,4199,2010,2189,91.8,4139,1982,2157,91.9
23010, 중구,075001, 70세,2017,1082,528,554,95.3,1062,516,546,94.5
23010, 중구,075002, 71세,2017,829,376,453,83,819,371,448,82.8
23010, 중구,075003, 72세,2017,756,361,395,91.4,740,357,383,93.2
23010, 중구,075004, 73세,2017,783,392,391,100.3,775,388,387,100.3
23010, 중구,075005, 74세,2017,749,353,396,89.1,743,350,393,89.1
23010, 중구,080,75~79세,2017,3294,1386,1908,72.6,3248,1368,1880,72.8
23010, 중구,080001, 75세,2017,889,377,512,73.6,879,374,505,74.1
23010, 중구,080002, 76세,2017,673,308,365,84.4,658,302,356,84.8
23010, 중구,080003, 77세,2017,586,251,335,74.9,575,244,331,73.7
23010, 중구,080004, 78세,2017,611,242,369,65.6,608,242,366,66.1
23010, 중구,080005, 79세,2017,535,208,327,63.6,528,206,322,64
23010, 중구,085,80~84세,2017,1778,670,1108,60.5,1758,665,1093,60.8
23010, 중구,085001, 80세,2017,430,184,246,74.8,422,179,243,73.7
23010, 중구,085002, 81세,2017,396,168,228,73.7,393,168,225,74.7
23010, 중구,085003, 82세,2017,387,137,250,54.8,383,137,246,55.7
23010, 중구,085004, 83세,2017,307,95,212,44.8,303,95,208,45.7
23010, 중구,085005, 84세,2017,258,86,172,50,257,86,171,50.3
23010, 중구,090,85~89세,2017,921,245,676,36.2,911,242,669,36.2
23010, 중구,090001, 85세,2017,268,80,188,42.6,267,80,187,42.8
23010, 중구,090002, 86세,2017,205,57,148,38.5,202,57,145,39.3
23010, 중구,090003, 87세,2017,166,36,130,27.7,163,35,128,27.3
23010, 중구,090004, 88세,2017,163,42,121,34.7,162,41,121,33.9
23010, 중구,090005, 89세,2017,119,30,89,33.7,117,29,88,33
23010, 중구,095,90~94세,2017,342,89,253,35.2,341,88,253,34.8
23010, 중구,095001, 90세,2017,106,29,77,37.7,106,29,77,37.7
23010, 중구,095002, 91세,2017,74,19,55,34.5,74,19,55,34.5
23010, 중구,095003, 92세,2017,69,13,56,23.2,68,12,56,21.4
23010, 중구,095004, 93세,2017,55,16,39,41,55,16,39,41
23010, 중구,095005, 94세,2017,38,12,26,46.2,38,12,26,46.2
23010, 중구,100,95~99세,2017,103,31,72,43.1,100,29,71,40.8
23010, 중구,100001, 95세,2017,43,10,33,30.3,42,10,32,31.3
23010, 중구,100002, 96세,2017,16,6,10,60,16,6,10,60
23010, 중구,100003, 97세,2017,19,5,14,35.7,19,5,14,35.7
23010, 중구,100004, 98세,2017,15,7,8,87.5,14,6,8,75
23010, 중구,100005, 99세,2017,10,X,7,42.9,9,X,7,28.6
23010, 중구,101,100세이상,2017,8,X,X,100,8,X,X,100
23010, 중구,102,15세미만,2017,16318,8338,7980,104.5,16100,8224,7876,104.4
23010, 중구,103,15~64세,2017,82927,44162,38765,113.9,79086,42112,36974,113.9
23010, 중구,104,65세이상,2017,15908,6915,8993,76.9,15584,6776,8808,76.9
23010, 중구,086,85세이상,2017,1374,369,1005,36.7,1360,363,997,36.4
23010, 중구,126,평균연령,2017,41,40.1,41.9,,41,40.1,41.9,
23010, 중구,127,중위연령,2017,41.6,40.9,42.3,,41.6,41.1,42.4,
23020, 동구,000,합계,2017,68171,34284,33887,101.2,67066,33677,33389,100.9
23020, 동구,005,0~4세,2017,2611,1365,1246,109.6,2588,1352,1236,109.4
23020, 동구,005001, 0세,2017,415,203,212,95.8,411,202,209,96.7
23020, 동구,005002, 1세,2017,552,303,249,121.7,544,297,247,120.2
23020, 동구,005003, 2세,2017,557,301,256,117.6,557,301,256,117.6
23020, 동구,005004, 3세,2017,533,284,249,114.1,527,280,247,113.4
23020, 동구,005005, 4세,2017,554,274,280,97.9,549,272,277,98.2
23020, 동구,010,5~9세,2017,2886,1472,1414,104.1,2879,1470,1409,104.3
23020, 동구,010001, 5세,2017,627,327,300,109,627,327,300,109
23020, 동구,010002, 6세,2017,587,306,281,108.9,586,305,281,108.5
23020, 동구,010003, 7세,2017,588,295,293,100.7,585,295,290,101.7
23020, 동구,010004, 8세,2017,530,259,271,95.6,528,259,269,96.3
23020, 동구,010005, 9세,2017,554,285,269,105.9,553,284,269,105.6
23020, 동구,015,10~14세,2017,2688,1380,1308,105.5,2676,1378,1298,106.2
23020, 동구,015001, 10세,2017,624,307,317,96.8,620,307,313,98.1
23020, 동구,015002, 11세,2017,482,262,220,119.1,480,262,218,120.2
23020, 동구,015003, 12세,2017,504,261,243,107.4,502,260,242,107.4
23020, 동구,015004, 13세,2017,544,283,261,108.4,541,282,259,108.9
23020, 동구,015005, 14세,2017,534,267,267,100,533,267,266,100.4
23020, 동구,020,15~19세,2017,3174,1669,1505,110.9,3151,1658,1493,111.1
23020, 동구,020001, 15세,2017,571,307,264,116.3,567,305,262,116.4
23020, 동구,020002, 16세,2017,574,310,264,117.4,569,306,263,116.3
23020, 동구,020003, 17세,2017,682,352,330,106.7,679,351,328,107
23020, 동구,020004, 18세,2017,660,353,307,115,654,350,304,115.1
23020, 동구,020005, 19세,2017,687,347,340,102.1,682,346,336,103
23020, 동구,025,20~24세,2017,3640,1946,1694,114.9,3568,1900,1668,113.9
23020, 동구,025001, 20세,2017,749,379,370,102.4,745,377,368,102.4
23020, 동구,025002, 21세,2017,725,400,325,123.1,714,394,320,123.1
23020, 동구,025003, 22세,2017,721,387,334,115.9,701,373,328,113.7
23020, 동구,025004, 23세,2017,700,396,304,130.3,681,382,299,127.8
23020, 동구,025005, 24세,2017,745,384,361,106.4,727,374,353,105.9
23020, 동구,030,25~29세,2017,3557,1896,1661,114.1,3420,1810,1610,112.4
23020, 동구,030001, 25세,2017,759,384,375,102.4,737,372,365,101.9
23020, 동구,030002, 26세,2017,748,398,350,113.7,725,382,343,111.4
23020, 동구,030003, 27세,2017,718,386,332,116.3,689,369,320,115.3
23020, 동구,030004, 28세,2017,648,356,292,121.9,621,337,284,118.7
23020, 동구,030005, 29세,2017,684,372,312,119.2,648,350,298,117.4
23020, 동구,035,30~34세,2017,4278,2304,1974,116.7,4103,2195,1908,115
23020, 동구,035001, 30세,2017,772,419,353,118.7,733,393,340,115.6
23020, 동구,035002, 31세,2017,815,444,371,119.7,786,428,358,119.6
23020, 동구,035003, 32세,2017,816,418,398,105,780,398,382,104.2
23020, 동구,035004, 33세,2017,847,483,364,132.7,810,457,353,129.5
23020, 동구,035005, 34세,2017,1028,540,488,110.7,994,519,475,109.3
23020, 동구,040,35~39세,2017,5664,3010,2654,113.4,5519,2926,2593,112.8
23020, 동구,040001, 35세,2017,1054,528,526,100.4,1019,504,515,97.9
23020, 동구,040002, 36세,2017,1156,621,535,116.1,1129,603,526,114.6
23020, 동구,040003, 37세,2017,1199,622,577,107.8,1169,609,560,108.8
23020, 동구,040004, 38세,2017,1187,650,537,121,1159,635,524,121.2
23020, 동구,040005, 39세,2017,1068,589,479,123,1043,575,468,122.9
23020, 동구,045,40~44세,2017,5344,2879,2465,116.8,5243,2821,2422,116.5
23020, 동구,045001, 40세,2017,1005,558,447,124.8,978,541,437,123.8
23020, 동구,045002, 41세,2017,1008,550,458,120.1,984,535,449,119.2
23020, 동구,045003, 42세,2017,1089,592,497,119.1,1070,583,487,119.7
23020, 동구,045004, 43세,2017,1098,562,536,104.9,1085,555,530,104.7
23020, 동구,045005, 44세,2017,1144,617,527,117.1,1126,607,519,117
23020, 동구,050,45~49세,2017,5549,3010,2539,118.6,5448,2954,2494,118.4
23020, 동구,050001, 45세,2017,1160,631,529,119.3,1144,624,520,120
23020, 동구,050002, 46세,2017,1127,617,510,121,1111,609,502,121.3
23020, 동구,050003, 47세,2017,1100,622,478,130.1,1071,600,471,127.4
23020, 동구,050004, 48세,2017,1049,544,505,107.7,1030,533,497,107.2
23020, 동구,050005, 49세,2017,1113,596,517,115.3,1092,588,504,116.7
23020, 동구,055,50~54세,2017,4938,2583,2355,109.7,4833,2527,2306,109.6
23020, 동구,055001, 50세,2017,964,500,464,107.8,944,489,455,107.5
23020, 동구,055002, 51세,2017,936,500,436,114.7,920,490,430,114
23020, 동구,055003, 52세,2017,1041,528,513,102.9,1020,518,502,103.2
23020, 동구,055004, 53세,2017,977,518,459,112.9,955,509,446,114.1
23020, 동구,055005, 54세,2017,1020,537,483,111.2,994,521,473,110.1
23020, 동구,060,55~59세,2017,5929,2936,2993,98.1,5850,2902,2948,98.4
23020, 동구,060001, 55세,2017,1111,569,542,105,1093,563,530,106.2
23020, 동구,060002, 56세,2017,1175,592,583,101.5,1159,583,576,101.2
23020, 동구,060003, 57세,2017,1290,634,656,96.6,1268,626,642,97.5
23020, 동구,060004, 58세,2017,1169,560,609,92,1157,556,601,92.5
23020, 동구,060005, 59세,2017,1184,581,603,96.4,1173,574,599,95.8
23020, 동구,065,60~64세,2017,5161,2516,2645,95.1,5098,2495,2603,95.9
23020, 동구,065001, 60세,2017,1152,560,592,94.6,1137,555,582,95.4
23020, 동구,065002, 61세,2017,1096,532,564,94.3,1083,531,552,96.2
23020, 동구,065003, 62세,2017,1139,548,591,92.7,1129,544,585,93
23020, 동구,065004, 63세,2017,952,478,474,100.8,940,473,467,101.3
23020, 동구,065005, 64세,2017,822,398,424,93.9,809,392,417,94
23020, 동구,070,65~69세,2017,4020,1836,2184,84.1,3978,1817,2161,84.1
23020, 동구,070001, 65세,2017,979,463,516,89.7,965,457,508,90
23020, 동구,070002, 66세,2017,662,275,387,71.1,654,270,384,70.3
23020, 동구,070003, 67세,2017,792,379,413,91.8,786,378,408,92.6
23020, 동구,070004, 68세,2017,783,351,432,81.3,773,345,428,80.6
23020, 동구,070005, 69세,2017,804,368,436,84.4,800,367,433,84.8
23020, 동구,075,70~74세,2017,3359,1517,1842,82.4,3353,1513,1840,82.2
23020, 동구,075001, 70세,2017,811,364,447,81.4,808,362,446,81.2
23020, 동구,075002, 71세,2017,669,304,365,83.3,669,304,365,83.3
23020, 동구,075003, 72세,2017,639,306,333,91.9,638,306,332,92.2
23020, 동구,075004, 73세,2017,623,276,347,79.5,622,275,347,79.3
23020, 동구,075005, 74세,2017,617,267,350,76.3,616,266,350,76
23020, 동구,080,75~79세,2017,2765,1166,1599,72.9,2762,1165,1597,72.9
23020, 동구,080001, 75세,2017,740,332,408,81.4,740,332,408,81.4
23020, 동구,080002, 76세,2017,575,242,333,72.7,572,241,331,72.8
23020, 동구,080003, 77세,2017,489,220,269,81.8,489,220,269,81.8
23020, 동구,080004, 78세,2017,537,212,325,65.2,537,212,325,65.2
23020, 동구,080005, 79세,2017,424,160,264,60.6,424,160,264,60.6
23020, 동구,085,80~84세,2017,1552,512,1040,49.2,1545,509,1036,49.1
23020, 동구,085001, 80세,2017,377,145,232,62.5,376,144,232,62.1
23020, 동구,085002, 81세,2017,365,136,229,59.4,365,136,229,59.4
23020, 동구,085003, 82세,2017,324,97,227,42.7,321,95,226,42
23020, 동구,085004, 83세,2017,264,77,187,41.2,262,77,185,41.6
23020, 동구,085005, 84세,2017,222,57,165,34.5,221,57,164,34.8
23020, 동구,090,85~89세,2017,759,212,547,38.8,755,210,545,38.5
23020, 동구,090001, 85세,2017,231,67,164,40.9,230,66,164,40.2
23020, 동구,090002, 86세,2017,161,47,114,41.2,159,46,113,40.7
23020, 동구,090003, 87세,2017,144,37,107,34.6,143,37,106,34.9
23020, 동구,090004, 88세,2017,119,36,83,43.4,119,36,83,43.4
23020, 동구,090005, 89세,2017,104,25,79,31.6,104,25,79,31.6
23020, 동구,095,90~94세,2017,244,60,184,32.6,244,60,184,32.6
23020, 동구,095001, 90세,2017,96,26,70,37.1,96,26,70,37.1
23020, 동구,095002, 91세,2017,46,9,37,24.3,46,9,37,24.3
23020, 동구,095003, 92세,2017,27,X,23,17.4,27,X,23,17.4
23020, 동구,095004, 93세,2017,43,9,34,26.5,43,9,34,26.5
23020, 동구,095005, 94세,2017,32,12,20,60,32,12,20,60
23020, 동구,100,95~99세,2017,46,14,32,43.8,46,14,32,43.8
23020, 동구,100001, 95세,2017,12,X,9,33.3,12,X,9,33.3
23020, 동구,100002, 96세,2017,17,5,12,41.7,17,5,12,41.7
23020, 동구,100003, 97세,2017,7,X,X,75,7,X,X,75
23020, 동구,100004, 98세,2017,6,X,5,20,6,X,5,20
23020, 동구,100005, 99세,2017,X,X,X,100,X,X,X,100
23020, 동구,101,100세이상,2017,7,X,6,16.7,7,X,6,16.7
23020, 동구,102,15세미만,2017,8185,4217,3968,106.3,8143,4200,3943,106.5
23020, 동구,103,15~64세,2017,47234,24749,22485,110.1,46233,24188,22045,109.7
23020, 동구,104,65세이상,2017,12752,5318,7434,71.5,12690,5289,7401,71.5
23020, 동구,086,85세이상,2017,1056,287,769,37.3,1052,285,767,37.2
23020, 동구,126,평균연령,2017,44.2,42.7,45.7,,44.2,42.7,45.8,
23020, 동구,127,중위연령,2017,45.2,43.7,47,,45.3,43.9,47.1,
23030, 남구,000,합계,2017,421851,213845,208006,102.8,411539,208501,203038,102.7
23030, 남구,005,0~4세,2017,16487,8400,8087,103.9,16204,8250,7954,103.7
23030, 남구,005001, 0세,2017,3037,1553,1484,104.6,2971,1518,1453,104.5
23030, 남구,005002, 1세,2017,3332,1676,1656,101.2,3262,1642,1620,101.4
23030, 남구,005003, 2세,2017,3487,1815,1672,108.6,3443,1791,1652,108.4
23030, 남구,005004, 3세,2017,3304,1648,1656,99.5,3249,1619,1630,99.3
23030, 남구,005005, 4세,2017,3327,1708,1619,105.5,3279,1680,1599,105.1
23030, 남구,010,5~9세,2017,16466,8462,8004,105.7,16334,8392,7942,105.7
23030, 남구,010001, 5세,2017,3531,1820,1711,106.4,3488,1795,1693,106
23030, 남구,010002, 6세,2017,3444,1806,1638,110.3,3415,1794,1621,110.7
23030, 남구,010003, 7세,2017,3175,1612,1563,103.1,3147,1599,1548,103.3
23030, 남구,010004, 8세,2017,3074,1568,1506,104.1,3057,1557,1500,103.8
23030, 남구,010005, 9세,2017,3242,1656,1586,104.4,3227,1647,1580,104.2
23030, 남구,015,10~14세,2017,15386,8009,7377,108.6,15303,7960,7343,108.4
23030, 남구,015001, 10세,2017,3252,1727,1525,113.2,3230,1713,1517,112.9
23030, 남구,015002, 11세,2017,2896,1499,1397,107.3,2878,1487,1391,106.9
23030, 남구,015003, 12세,2017,2839,1451,1388,104.5,2825,1443,1382,104.4
23030, 남구,015004, 13세,2017,3095,1621,1474,110,3080,1615,1465,110.2
23030, 남구,015005, 14세,2017,3304,1711,1593,107.4,3290,1702,1588,107.2
23030, 남구,020,15~19세,2017,21398,11156,10242,108.9,20991,10942,10049,108.9
23030, 남구,020001, 15세,2017,3314,1726,1588,108.7,3297,1717,1580,108.7
23030, 남구,020002, 16세,2017,3783,1919,1864,103,3760,1903,1857,102.5
23030, 남구,020003, 17세,2017,4238,2228,2010,110.8,4204,2210,1994,110.8
23030, 남구,020004, 18세,2017,4564,2387,2177,109.6,4443,2326,2117,109.9
23030, 남구,020005, 19세,2017,5499,2896,2603,111.3,5287,2786,2501,111.4
23030, 남구,025,20~24세,2017,31844,17275,14569,118.6,30399,16555,13844,119.6
23030, 남구,025001, 20세,2017,5884,3022,2862,105.6,5606,2897,2709,106.9
23030, 남구,025002, 21세,2017,6204,3274,2930,111.7,5881,3110,2771,112.2
23030, 남구,025003, 22세,2017,6366,3539,2827,125.2,6026,3353,2673,125.4
23030, 남구,025004, 23세,2017,6676,3682,2994,123,6414,3565,2849,125.1
23030, 남구,025005, 24세,2017,6714,3758,2956,127.1,6472,3630,2842,127.7
23030, 남구,030,25~29세,2017,30826,16850,13976,120.6,29436,16109,13327,120.9
23030, 남구,030001, 25세,2017,6899,3778,3121,121.1,6654,3648,3006,121.4
23030, 남구,030002, 26세,2017,6410,3544,2866,123.7,6141,3404,2737,124.4
23030, 남구,030003, 27세,2017,6068,3315,2753,120.4,5777,3162,2615,120.9
23030, 남구,030004, 28세,2017,5876,3200,2676,119.6,5585,3052,2533,120.5
23030, 남구,030005, 29세,2017,5573,3013,2560,117.7,5279,2843,2436,116.7
23030, 남구,035,30~34세,2017,30077,16143,13934,115.9,28561,15292,13269,115.2
23030, 남구,035001, 30세,2017,5691,3072,2619,117.3,5343,2877,2466,116.7
23030, 남구,035002, 31세,2017,5649,3051,2598,117.4,5351,2893,2458,117.7
23030, 남구,035003, 32세,2017,5909,3199,2710,118,5564,3005,2559,117.4
23030, 남구,035004, 33세,2017,6148,3297,2851,115.6,5890,3146,2744,114.7
23030, 남구,035005, 34세,2017,6680,3524,3156,111.7,6413,3371,3042,110.8
23030, 남구,040,35~39세,2017,34647,18664,15983,116.8,33545,18034,15511,116.3
23030, 남구,040001, 35세,2017,7133,3844,3289,116.9,6861,3685,3176,116
23030, 남구,040002, 36세,2017,7307,3919,3388,115.7,7083,3786,3297,114.8
23030, 남구,040003, 37세,2017,7187,3873,3314,116.9,6968,3751,3217,116.6
23030, 남구,040004, 38세,2017,6872,3764,3108,121.1,6672,3645,3027,120.4
23030, 남구,040005, 39세,2017,6148,3264,2884,113.2,5961,3167,2794,113.4
23030, 남구,045,40~44세,2017,31583,16812,14771,113.8,30793,16378,14415,113.6
23030, 남구,045001, 40세,2017,5932,3178,2754,115.4,5776,3095,2681,115.4
23030, 남구,045002, 41세,2017,5784,3038,2746,110.6,5645,2960,2685,110.2
23030, 남구,045003, 42세,2017,6292,3403,2889,117.8,6134,3316,2818,117.7
23030, 남구,045004, 43세,2017,6686,3574,3112,114.8,6523,3490,3033,115.1
23030, 남구,045005, 44세,2017,6889,3619,3270,110.7,6715,3517,3198,110
23030, 남구,050,45~49세,2017,35377,18198,17179,105.9,34521,17753,16768,105.9
23030, 남구,050001, 45세,2017,7069,3757,3312,113.4,6907,3666,3241,113.1
23030, 남구,050002, 46세,2017,7080,3635,3445,105.5,6897,3537,3360,105.3
23030, 남구,050003, 47세,2017,6991,3535,3456,102.3,6811,3443,3368,102.2
23030, 남구,050004, 48세,2017,7165,3723,3442,108.2,6996,3642,3354,108.6
23030, 남구,050005, 49세,2017,7072,3548,3524,100.7,6910,3465,3445,100.6
23030, 남구,055,50~54세,2017,33259,16570,16689,99.3,32504,16217,16287,99.6
23030, 남구,055001, 50세,2017,6492,3191,3301,96.7,6367,3123,3244,96.3
23030, 남구,055002, 51세,2017,6322,3196,3126,102.2,6189,3132,3057,102.5
23030, 남구,055003, 52세,2017,6925,3405,3520,96.7,6766,3333,3433,97.1
23030, 남구,055004, 53세,2017,6514,3242,3272,99.1,6369,3172,3197,99.2
23030, 남구,055005, 54세,2017,7006,3536,3470,101.9,6813,3457,3356,103
23030, 남구,060,55~59세,2017,36341,17721,18620,95.2,35750,17454,18296,95.4
23030, 남구,060001, 55세,2017,7136,3551,3585,99.1,6993,3491,3502,99.7
23030, 남구,060002, 56세,2017,7609,3657,3952,92.5,7523,3618,3905,92.7
23030, 남구,060003, 57세,2017,7727,3762,3965,94.9,7580,3696,3884,95.2
23030, 남구,060004, 58세,2017,7143,3498,3645,96,7040,3447,3593,95.9
23030, 남구,060005, 59세,2017,6726,3253,3473,93.7,6614,3202,3412,93.8
23030, 남구,065,60~64세,2017,28390,13640,14750,92.5,27865,13388,14477,92.5
23030, 남구,065001, 60세,2017,6606,3218,3388,95,6487,3163,3324,95.2
23030, 남구,065002, 61세,2017,6136,2955,3181,92.9,6020,2900,3120,92.9
23030, 남구,065003, 62세,2017,6154,2933,3221,91.1,6042,2880,3162,91.1
23030, 남구,065004, 63세,2017,5087,2408,2679,89.9,4989,2368,2621,90.3
23030, 남구,065005, 64세,2017,4407,2126,2281,93.2,4327,2077,2250,92.3
23030, 남구,070,65~69세,2017,20068,9596,10472,91.6,19853,9505,10348,91.9
23030, 남구,070001, 65세,2017,4884,2332,2552,91.4,4818,2308,2510,92
23030, 남구,070002, 66세,2017,3329,1600,1729,92.5,3283,1579,1704,92.7
23030, 남구,070003, 67세,2017,3910,1882,2028,92.8,3872,1866,2006,93
23030, 남구,070004, 68세,2017,4072,1941,2131,91.1,4033,1918,2115,90.7
23030, 남구,070005, 69세,2017,3873,1841,2032,90.6,3847,1834,2013,91.1
23030, 남구,075,70~74세,2017,15657,7222,8435,85.6,15562,7190,8372,85.9
23030, 남구,075001, 70세,2017,3995,1875,2120,88.4,3971,1863,2108,88.4
23030, 남구,075002, 71세,2017,3008,1397,1611,86.7,2983,1390,1593,87.3
23030, 남구,075003, 72세,2017,2937,1371,1566,87.5,2919,1364,1555,87.7
23030, 남구,075004, 73세,2017,2840,1275,1565,81.5,2823,1271,1552,81.9
23030, 남구,075005, 74세,2017,2877,1304,1573,82.9,2866,1302,1564,83.2
23030, 남구,080,75~79세,2017,12534,5386,7148,75.3,12473,5365,7108,75.5
23030, 남구,080001, 75세,2017,3348,1505,1843,81.7,3340,1499,1841,81.4
23030, 남구,080002, 76세,2017,2562,1100,1462,75.2,2551,1097,1454,75.4
23030, 남구,080003, 77세,2017,2301,989,1312,75.4,2291,987,1304,75.7
23030, 남구,080004, 78세,2017,2259,947,1312,72.2,2240,942,1298,72.6
23030, 남구,080005, 79세,2017,2064,845,1219,69.3,2051,840,1211,69.4
23030, 남구,085,80~84세,2017,6952,2524,4428,57,6907,2507,4400,57
23030, 남구,085001, 80세,2017,1752,683,1069,63.9,1736,678,1058,64.1
23030, 남구,085002, 81세,2017,1537,603,934,64.6,1529,598,931,64.2
23030, 남구,085003, 82세,2017,1483,551,932,59.1,1472,547,925,59.1
23030, 남구,085004, 83세,2017,1194,395,799,49.4,1188,393,795,49.4
23030, 남구,085005, 84세,2017,986,292,694,42.1,982,291,691,42.1
23030, 남구,090,85~89세,2017,3208,900,2308,39,3193,896,2297,39
23030, 남구,090001, 85세,2017,884,261,623,41.9,883,261,622,42
23030, 남구,090002, 86세,2017,676,208,468,44.4,672,208,464,44.8
23030, 남구,090003, 87세,2017,649,167,482,34.6,644,166,478,34.7
23030, 남구,090004, 88세,2017,565,151,414,36.5,562,150,412,36.4
23030, 남구,090005, 89세,2017,434,113,321,35.2,432,111,321,34.6
23030, 남구,095,90~94세,2017,1060,243,817,29.7,1058,243,815,29.8
23030, 남구,095001, 90세,2017,341,83,258,32.2,341,83,258,32.2
23030, 남구,095002, 91세,2017,228,46,182,25.3,226,46,180,25.6
23030, 남구,095003, 92세,2017,222,48,174,27.6,222,48,174,27.6
23030, 남구,095004, 93세,2017,141,31,110,28.2,141,31,110,28.2
23030, 남구,095005, 94세,2017,128,35,93,37.6,128,35,93,37.6
23030, 남구,100,95~99세,2017,251,64,187,34.2,248,62,186,33.3
23030, 남구,100001, 95세,2017,88,22,66,33.3,86,21,65,32.3
23030, 남구,100002, 96세,2017,67,19,48,39.6,66,18,48,37.5
23030, 남구,100003, 97세,2017,41,10,31,32.3,41,10,31,32.3
23030, 남구,100004, 98세,2017,37,12,25,48,37,12,25,48
23030, 남구,100005, 99세,2017,18,X,17,5.9,18,X,17,5.9
23030, 남구,101,100세이상,2017,40,10,30,33.3,39,9,30,30
23030, 남구,102,15세미만,2017,48339,24871,23468,106,47841,24602,23239,105.9
23030, 남구,103,15~64세,2017,313742,163029,150713,108.2,304365,158122,146243,108.1
23030, 남구,104,65세이상,2017,59770,25945,33825,76.7,59333,25777,33556,76.8
23030, 남구,086,85세이상,2017,4559,1217,3342,36.4,4538,1210,3328,36.4
23030, 남구,126,평균연령,2017,41.8,40.6,43.1,,41.9,40.7,43.2,
23030, 남구,127,중위연령,2017,42.3,40.6,44.1,,42.6,40.9,44.3,
23040, 연수구,000,합계,2017,337595,168613,168982,99.8,325673,162312,163361,99.4
23040, 연수구,005,0~4세,2017,15352,7757,7595,102.1,14803,7483,7320,102.2
23040, 연수구,005001, 0세,2017,2580,1288,1292,99.7,2483,1245,1238,100.6
23040, 연수구,005002, 1세,2017,2910,1430,1480,96.6,2796,1370,1426,96.1
23040, 연수구,005003, 2세,2017,3219,1637,1582,103.5,3103,1581,1522,103.9
23040, 연수구,005004, 3세,2017,3229,1667,1562,106.7,3110,1606,1504,106.8
23040, 연수구,005005, 4세,2017,3414,1735,1679,103.3,3311,1681,1630,103.1
23040, 연수구,010,5~9세,2017,18185,9376,8809,106.4,17764,9149,8615,106.2
23040, 연수구,010001, 5세,2017,3609,1863,1746,106.7,3514,1818,1696,107.2
23040, 연수구,010002, 6세,2017,3689,1903,1786,106.6,3592,1855,1737,106.8
23040, 연수구,010003, 7세,2017,3573,1851,1722,107.5,3508,1815,1693,107.2
23040, 연수구,010004, 8세,2017,3591,1873,1718,109,3511,1828,1683,108.6
23040, 연수구,010005, 9세,2017,3723,1886,1837,102.7,3639,1833,1806,101.5
23040, 연수구,015,10~14세,2017,18240,9313,8927,104.3,17954,9156,8798,104.1
23040, 연수구,015001, 10세,2017,3807,1945,1862,104.5,3747,1909,1838,103.9
23040, 연수구,015002, 11세,2017,3468,1785,1683,106.1,3408,1747,1661,105.2
23040, 연수구,015003, 12세,2017,3469,1769,1700,104.1,3413,1741,1672,104.1
23040, 연수구,015004, 13세,2017,3792,1947,1845,105.5,3744,1923,1821,105.6
23040, 연수구,015005, 14세,2017,3704,1867,1837,101.6,3642,1836,1806,101.7
23040, 연수구,020,15~19세,2017,23321,12091,11230,107.7,22848,11877,10971,108.3
23040, 연수구,020001, 15세,2017,3782,1992,1790,111.3,3739,1964,1775,110.6
23040, 연수구,020002, 16세,2017,4162,2208,1954,113,4128,2190,1938,113
23040, 연수구,020003, 17세,2017,4434,2297,2137,107.5,4375,2261,2114,107
23040, 연수구,020004, 18세,2017,4851,2532,2319,109.2,4730,2492,2238,111.3
23040, 연수구,020005, 19세,2017,6092,3062,3030,101.1,5876,2970,2906,102.2
23040, 연수구,025,20~24세,2017,24847,12956,11891,109,23724,12418,11306,109.8
23040, 연수구,025001, 20세,2017,5381,2769,2612,106,5147,2672,2475,108
23040, 연수구,025002, 21세,2017,4918,2642,2276,116.1,4718,2543,2175,116.9
23040, 연수구,025003, 22세,2017,4839,2530,2309,109.6,4643,2442,2201,110.9
23040, 연수구,025004, 23세,2017,4766,2463,2303,106.9,4515,2334,2181,107
23040, 연수구,025005, 24세,2017,4943,2552,2391,106.7,4701,2427,2274,106.7
23040, 연수구,030,25~29세,2017,23974,12493,11481,108.8,22241,11560,10681,108.2
23040, 연수구,030001, 25세,2017,5184,2675,2509,106.6,4906,2524,2382,106
23040, 연수구,030002, 26세,2017,5059,2632,2427,108.4,4735,2466,2269,108.7
23040, 연수구,030003, 27세,2017,4768,2505,2263,110.7,4398,2304,2094,110
23040, 연수구,030004, 28세,2017,4533,2354,2179,108,4182,2165,2017,107.3
23040, 연수구,030005, 29세,2017,4430,2327,2103,110.7,4020,2101,1919,109.5
23040, 연수구,035,30~34세,2017,22393,11293,11100,101.7,20476,10193,10283,99.1
23040, 연수구,035001, 30세,2017,4229,2113,2116,99.9,3827,1898,1929,98.4
23040, 연수구,035002, 31세,2017,4268,2169,2099,103.3,3845,1938,1907,101.6
23040, 연수구,035003, 32세,2017,4320,2238,2082,107.5,3951,2025,1926,105.1
23040, 연수구,035004, 33세,2017,4565,2299,2266,101.5,4209,2086,2123,98.3
23040, 연수구,035005, 34세,2017,5011,2474,2537,97.5,4644,2246,2398,93.7
23040, 연수구,040,35~39세,2017,27672,13667,14005,97.6,26141,12791,13350,95.8
23040, 연수구,040001, 35세,2017,5453,2713,2740,99,5122,2508,2614,95.9
23040, 연수구,040002, 36세,2017,5676,2766,2910,95.1,5370,2591,2779,93.2
23040, 연수구,040003, 37세,2017,5690,2838,2852,99.5,5393,2670,2723,98.1
23040, 연수구,040004, 38세,2017,5597,2764,2833,97.6,5295,2603,2692,96.7
23040, 연수구,040005, 39세,2017,5256,2586,2670,96.9,4961,2419,2542,95.2
23040, 연수구,045,40~44세,2017,29020,14079,14941,94.2,27856,13436,14420,93.2
23040, 연수구,045001, 40세,2017,5331,2624,2707,96.9,5068,2482,2586,96
23040, 연수구,045002, 41세,2017,5311,2624,2687,97.7,5072,2485,2587,96.1
23040, 연수구,045003, 42세,2017,5762,2813,2949,95.4,5523,2676,2847,94
23040, 연수구,045004, 43세,2017,6229,3032,3197,94.8,6031,2914,3117,93.5
23040, 연수구,045005, 44세,2017,6387,2986,3401,87.8,6162,2879,3283,87.7
23040, 연수구,050,45~49세,2017,32645,15949,16696,95.5,31648,15431,16217,95.2
23040, 연수구,050001, 45세,2017,6406,3130,3276,95.5,6184,3013,3171,95
23040, 연수구,050002, 46세,2017,6793,3346,3447,97.1,6594,3245,3349,96.9
23040, 연수구,050003, 47세,2017,6469,3174,3295,96.3,6270,3068,3202,95.8
23040, 연수구,050004, 48세,2017,6612,3205,3407,94.1,6438,3111,3327,93.5
23040, 연수구,050005, 49세,2017,6365,3094,3271,94.6,6162,2994,3168,94.5
23040, 연수구,055,50~54세,2017,29339,14536,14803,98.2,28628,14176,14452,98.1
23040, 연수구,055001, 50세,2017,5787,2829,2958,95.6,5666,2765,2901,95.3
23040, 연수구,055002, 51세,2017,5777,2834,2943,96.3,5623,2761,2862,96.5
23040, 연수구,055003, 52세,2017,5968,2935,3033,96.8,5827,2856,2971,96.1
23040, 연수구,055004, 53세,2017,5715,2830,2885,98.1,5578,2767,2811,98.4
23040, 연수구,055005, 54세,2017,6092,3108,2984,104.2,5934,3027,2907,104.1
23040, 연수구,060,55~59세,2017,27546,14376,13170,109.2,27096,14143,12953,109.2
23040, 연수구,060001, 55세,2017,5950,3008,2942,102.2,5850,2953,2897,101.9
23040, 연수구,060002, 56세,2017,6095,3179,2916,109,6009,3129,2880,108.6
23040, 연수구,060003, 57세,2017,5892,3080,2812,109.5,5778,3015,2763,109.1
23040, 연수구,060004, 58세,2017,5005,2631,2374,110.8,4943,2607,2336,111.6
23040, 연수구,060005, 59세,2017,4604,2478,2126,116.6,4516,2439,2077,117.4
23040, 연수구,065,60~64세,2017,16584,8622,7962,108.3,16275,8494,7781,109.2
23040, 연수구,065001, 60세,2017,4217,2201,2016,109.2,4141,2168,1973,109.9
23040, 연수구,065002, 61세,2017,3650,1884,1766,106.7,3582,1860,1722,108
23040, 연수구,065003, 62세,2017,3544,1833,1711,107.1,3472,1805,1667,108.3
23040, 연수구,065004, 63세,2017,2854,1534,1320,116.2,2802,1506,1296,116.2
23040, 연수구,065005, 64세,2017,2319,1170,1149,101.8,2278,1155,1123,102.8
23040, 연수구,070,65~69세,2017,9445,4715,4730,99.7,9298,4658,4640,100.4
23040, 연수구,070001, 65세,2017,2541,1344,1197,112.3,2507,1332,1175,113.4
23040, 연수구,070002, 66세,2017,1542,770,772,99.7,1508,755,753,100.3
23040, 연수구,070003, 67세,2017,1752,873,879,99.3,1721,862,859,100.3
23040, 연수구,070004, 68세,2017,1825,890,935,95.2,1794,875,919,95.2
23040, 연수구,070005, 69세,2017,1785,838,947,88.5,1768,834,934,89.3
23040, 연수구,075,70~74세,2017,6909,3182,3727,85.4,6850,3157,3693,85.5
23040, 연수구,075001, 70세,2017,1765,792,973,81.4,1747,786,961,81.8
23040, 연수구,075002, 71세,2017,1386,672,714,94.1,1365,661,704,93.9
23040, 연수구,075003, 72세,2017,1200,568,632,89.9,1193,564,629,89.7
23040, 연수구,075004, 73세,2017,1214,559,655,85.3,1205,556,649,85.7
23040, 연수구,075005, 74세,2017,1344,591,753,78.5,1340,590,750,78.7
23040, 연수구,080,75~79세,2017,5768,2322,3446,67.4,5738,2309,3429,67.3
23040, 연수구,080001, 75세,2017,1433,608,825,73.7,1424,604,820,73.7
23040, 연수구,080002, 76세,2017,1190,527,663,79.5,1185,523,662,79
23040, 연수구,080003, 77세,2017,1061,415,646,64.2,1053,412,641,64.3
23040, 연수구,080004, 78세,2017,1091,400,691,57.9,1086,398,688,57.8
23040, 연수구,080005, 79세,2017,993,372,621,59.9,990,372,618,60.2
23040, 연수구,085,80~84세,2017,3618,1190,2428,49,3606,1188,2418,49.1
23040, 연수구,085001, 80세,2017,882,312,570,54.7,880,311,569,54.7
23040, 연수구,085002, 81세,2017,766,264,502,52.6,762,264,498,53
23040, 연수구,085003, 82세,2017,761,251,510,49.2,760,251,509,49.3
23040, 연수구,085004, 83세,2017,639,198,441,44.9,637,198,439,45.1
23040, 연수구,085005, 84세,2017,570,165,405,40.7,567,164,403,40.7
23040, 연수구,090,85~89세,2017,1898,500,1398,35.8,1890,497,1393,35.7
23040, 연수구,090001, 85세,2017,524,145,379,38.3,522,144,378,38.1
23040, 연수구,090002, 86세,2017,403,98,305,32.1,401,97,304,31.9
23040, 연수구,090003, 87세,2017,387,106,281,37.7,385,105,280,37.5
23040, 연수구,090004, 88세,2017,321,84,237,35.4,320,84,236,35.6
23040, 연수구,090005, 89세,2017,263,67,196,34.2,262,67,195,34.4
23040, 연수구,095,90~94세,2017,673,162,511,31.7,671,162,509,31.8
23040, 연수구,095001, 90세,2017,216,62,154,40.3,215,62,153,40.5
23040, 연수구,095002, 91세,2017,160,32,128,25,159,32,127,25.2
23040, 연수구,095003, 92세,2017,130,20,110,18.2,130,20,110,18.2
23040, 연수구,095004, 93세,2017,91,25,66,37.9,91,25,66,37.9
23040, 연수구,095005, 94세,2017,76,23,53,43.4,76,23,53,43.4
23040, 연수구,100,95~99세,2017,153,33,120,27.5,153,33,120,27.5
23040, 연수구,100001, 95세,2017,61,11,50,22,61,11,50,22
23040, 연수구,100002, 96세,2017,40,8,32,25,40,8,32,25
23040, 연수구,100003, 97세,2017,22,7,15,46.7,22,7,15,46.7
23040, 연수구,100004, 98세,2017,25,7,18,38.9,25,7,18,38.9
23040, 연수구,100005, 99세,2017,5,X,5,0,5,X,5,0
23040, 연수구,101,100세이상,2017,13,X,12,8.3,13,X,12,8.3
23040, 연수구,102,15세미만,2017,51777,26446,25331,104.4,50521,25788,24733,104.3
23040, 연수구,103,15~64세,2017,257341,130062,127279,102.2,246933,124519,122414,101.7
23040, 연수구,104,65세이상,2017,28477,12105,16372,73.9,28219,12005,16214,74
23040, 연수구,086,85세이상,2017,2737,696,2041,34.1,2727,693,2034,34.1
23040, 연수구,126,평균연령,2017,38.1,37.4,38.8,,38.2,37.5,39,
23040, 연수구,127,중위연령,2017,39,38.3,39.8,,39.4,38.6,40.1,
23050, 남동구,000,합계,2017,534050,268108,265942,100.8,519064,257948,261116,98.8
23050, 남동구,005,0~4세,2017,24035,12339,11696,105.5,23783,12203,11580,105.4
23050, 남동구,005001, 0세,2017,4095,2137,1958,109.1,4037,2105,1932,109
23050, 남동구,005002, 1세,2017,4680,2410,2270,106.2,4619,2380,2239,106.3
23050, 남동구,005003, 2세,2017,5031,2531,2500,101.2,4984,2506,2478,101.1
23050, 남동구,005004, 3세,2017,5035,2626,2409,109,4996,2603,2393,108.8
23050, 남동구,005005, 4세,2017,5194,2635,2559,103,5147,2609,2538,102.8
23050, 남동구,010,5~9세,2017,26802,13710,13092,104.7,26660,13632,13028,104.6
23050, 남동구,010001, 5세,2017,5621,2891,2730,105.9,5588,2874,2714,105.9
23050, 남동구,010002, 6세,2017,5527,2875,2652,108.4,5498,2856,2642,108.1
23050, 남동구,010003, 7세,2017,5289,2690,2599,103.5,5266,2676,2590,103.3
23050, 남동구,010004, 8세,2017,5180,2633,2547,103.4,5150,2620,2530,103.6
23050, 남동구,010005, 9세,2017,5185,2621,2564,102.2,5158,2606,2552,102.1
23050, 남동구,015,10~14세,2017,24438,12575,11863,106,24346,12525,11821,106
23050, 남동구,015001, 10세,2017,5229,2709,2520,107.5,5211,2701,2510,107.6
23050, 남동구,015002, 11세,2017,4779,2490,2289,108.8,4764,2481,2283,108.7
23050, 남동구,015003, 12세,2017,4560,2311,2249,102.8,4541,2302,2239,102.8
23050, 남동구,015004, 13세,2017,4813,2447,2366,103.4,4792,2435,2357,103.3
23050, 남동구,015005, 14세,2017,5057,2618,2439,107.3,5038,2606,2432,107.2
23050, 남동구,020,15~19세,2017,28448,14521,13927,104.3,28311,14446,13865,104.2
23050, 남동구,020001, 15세,2017,5068,2594,2474,104.9,5050,2586,2464,105
23050, 남동구,020002, 16세,2017,5906,3009,2897,103.9,5888,2999,2889,103.8
23050, 남동구,020003, 17세,2017,6212,3091,3121,99,6188,3076,3112,98.8
23050, 남동구,020004, 18세,2017,5884,3031,2853,106.2,5854,3012,2842,106
23050, 남동구,020005, 19세,2017,5378,2796,2582,108.3,5331,2773,2558,108.4
23050, 남동구,025,20~24세,2017,33921,18079,15842,114.1,32882,17323,15559,111.3
23050, 남동구,025001, 20세,2017,5897,3206,2691,119.1,5814,3158,2656,118.9
23050, 남동구,025002, 21세,2017,6421,3593,2828,127.1,6298,3503,2795,125.3
23050, 남동구,025003, 22세,2017,6840,3612,3228,111.9,6631,3468,3163,109.6
23050, 남동구,025004, 23세,2017,7052,3657,3395,107.7,6771,3441,3330,103.3
23050, 남동구,025005, 24세,2017,7711,4011,3700,108.4,7368,3753,3615,103.8
23050, 남동구,030,25~29세,2017,37259,19508,17751,109.9,34607,17559,17048,103
23050, 남동구,030001, 25세,2017,7984,4099,3885,105.5,7572,3794,3778,100.4
23050, 남동구,030002, 26세,2017,7670,4033,3637,110.9,7177,3674,3503,104.9
23050, 남동구,030003, 27세,2017,7414,3896,3518,110.7,6851,3477,3374,103.1
23050, 남동구,030004, 28세,2017,7071,3706,3365,110.1,6496,3287,3209,102.4
23050, 남동구,030005, 29세,2017,7120,3774,3346,112.8,6511,3327,3184,104.5
23050, 남동구,035,30~34세,2017,38827,20610,18217,113.1,35719,18286,17433,104.9
23050, 남동구,035001, 30세,2017,7076,3752,3324,112.9,6439,3288,3151,104.3
23050, 남동구,035002, 31세,2017,7390,3941,3449,114.3,6744,3468,3276,105.9
23050, 남동구,035003, 32세,2017,7477,4010,3467,115.7,6869,3547,3322,106.8
23050, 남동구,035004, 33세,2017,7959,4257,3702,115,7331,3785,3546,106.7
23050, 남동구,035005, 34세,2017,8925,4650,4275,108.8,8336,4198,4138,101.4
23050, 남동구,040,35~39세,2017,48007,24948,23059,108.2,45720,23205,22515,103.1
23050, 남동구,040001, 35세,2017,9769,5119,4650,110.1,9221,4696,4525,103.8
23050, 남동구,040002, 36세,2017,9851,5168,4683,110.4,9371,4807,4564,105.3
23050, 남동구,040003, 37세,2017,10103,5191,4912,105.7,9648,4847,4801,101
23050, 남동구,040004, 38세,2017,9535,4963,4572,108.6,9076,4615,4461,103.5
23050, 남동구,040005, 39세,2017,8749,4507,4242,106.2,8404,4240,4164,101.8
23050, 남동구,045,40~44세,2017,44881,23314,21567,108.1,43475,22321,21154,105.5
23050, 남동구,045001, 40세,2017,8825,4569,4256,107.4,8517,4345,4172,104.1
23050, 남동구,045002, 41세,2017,8402,4480,3922,114.2,8099,4263,3836,111.1
23050, 남동구,045003, 42세,2017,8861,4653,4208,110.6,8578,4454,4124,108
23050, 남동구,045004, 43세,2017,9405,4909,4496,109.2,9142,4712,4430,106.4
23050, 남동구,045005, 44세,2017,9388,4703,4685,100.4,9139,4547,4592,99
23050, 남동구,050,45~49세,2017,48222,24054,24168,99.5,47059,23361,23698,98.6
23050, 남동구,050001, 45세,2017,9312,4759,4553,104.5,9092,4632,4460,103.9
23050, 남동구,050002, 46세,2017,9873,5008,4865,102.9,9623,4855,4768,101.8
23050, 남동구,050003, 47세,2017,9644,4864,4780,101.8,9396,4706,4690,100.3
23050, 남동구,050004, 48세,2017,9701,4719,4982,94.7,9468,4590,4878,94.1
23050, 남동구,050005, 49세,2017,9692,4704,4988,94.3,9480,4578,4902,93.4
23050, 남동구,055,50~54세,2017,44015,21691,22324,97.2,43018,21129,21889,96.5
23050, 남동구,055001, 50세,2017,8745,4261,4484,95,8563,4153,4410,94.2
23050, 남동구,055002, 51세,2017,8600,4233,4367,96.9,8405,4119,4286,96.1
23050, 남동구,055003, 52세,2017,9242,4545,4697,96.8,9030,4418,4612,95.8
23050, 남동구,055004, 53세,2017,8513,4238,4275,99.1,8303,4132,4171,99.1
23050, 남동구,055005, 54세,2017,8915,4414,4501,98.1,8717,4307,4410,97.7
23050, 남동구,060,55~59세,2017,45523,22511,23012,97.8,44849,22149,22700,97.6
23050, 남동구,060001, 55세,2017,9287,4656,4631,100.5,9132,4565,4567,100
23050, 남동구,060002, 56세,2017,9980,4924,5056,97.4,9853,4864,4989,97.5
23050, 남동구,060003, 57세,2017,9654,4811,4843,99.3,9497,4729,4768,99.2
23050, 남동구,060004, 58세,2017,8480,4134,4346,95.1,8371,4072,4299,94.7
23050, 남동구,060005, 59세,2017,8122,3986,4136,96.4,7996,3919,4077,96.1
23050, 남동구,065,60~64세,2017,31441,15373,16068,95.7,30921,15139,15782,95.9
23050, 남동구,065001, 60세,2017,7496,3742,3754,99.7,7359,3670,3689,99.5
23050, 남동구,065002, 61세,2017,6567,3207,3360,95.4,6474,3162,3312,95.5
23050, 남동구,065003, 62세,2017,6847,3350,3497,95.8,6745,3311,3434,96.4
23050, 남동구,065004, 63세,2017,5651,2706,2945,91.9,5549,2662,2887,92.2
23050, 남동구,065005, 64세,2017,4880,2368,2512,94.3,4794,2334,2460,94.9
23050, 남동구,070,65~69세,2017,20492,10053,10439,96.3,20201,9924,10277,96.6
23050, 남동구,070001, 65세,2017,5275,2575,2700,95.4,5178,2536,2642,96
23050, 남동구,070002, 66세,2017,3484,1721,1763,97.6,3416,1687,1729,97.6
23050, 남동구,070003, 67세,2017,3977,1967,2010,97.9,3917,1941,1976,98.2
23050, 남동구,070004, 68세,2017,3973,1962,2011,97.6,3933,1944,1989,97.7
23050, 남동구,070005, 69세,2017,3783,1828,1955,93.5,3757,1816,1941,93.6
23050, 남동구,075,70~74세,2017,14670,6742,7928,85,14557,6698,7859,85.2
23050, 남동구,075001, 70세,2017,3764,1794,1970,91.1,3733,1777,1956,90.8
23050, 남동구,075002, 71세,2017,2917,1369,1548,88.4,2893,1361,1532,88.8
23050, 남동구,075003, 72세,2017,2648,1214,1434,84.7,2629,1207,1422,84.9
23050, 남동구,075004, 73세,2017,2699,1245,1454,85.6,2676,1236,1440,85.8
23050, 남동구,075005, 74세,2017,2642,1120,1522,73.6,2626,1117,1509,74
23050, 남동구,080,75~79세,2017,11437,4672,6765,69.1,11375,4652,6723,69.2
23050, 남동구,080001, 75세,2017,3031,1305,1726,75.6,3015,1299,1716,75.7
23050, 남동구,080002, 76세,2017,2363,972,1391,69.9,2343,966,1377,70.2
23050, 남동구,080003, 77세,2017,2109,844,1265,66.7,2100,842,1258,66.9
23050, 남동구,080004, 78세,2017,2073,830,1243,66.8,2069,829,1240,66.9
23050, 남동구,080005, 79세,2017,1861,721,1140,63.2,1848,716,1132,63.3
23050, 남동구,085,80~84세,2017,6748,2316,4432,52.3,6716,2309,4407,52.4
23050, 남동구,085001, 80세,2017,1615,608,1007,60.4,1611,608,1003,60.6
23050, 남동구,085002, 81세,2017,1580,537,1043,51.5,1567,534,1033,51.7
23050, 남동구,085003, 82세,2017,1417,492,925,53.2,1410,490,920,53.3
23050, 남동구,085004, 83세,2017,1140,362,778,46.5,1135,361,774,46.6
23050, 남동구,085005, 84세,2017,996,317,679,46.7,993,316,677,46.7
23050, 남동구,090,85~89세,2017,3407,812,2595,31.3,3390,807,2583,31.2
23050, 남동구,090001, 85세,2017,891,242,649,37.3,886,239,647,36.9
23050, 남동구,090002, 86세,2017,715,155,560,27.7,711,154,557,27.6
23050, 남동구,090003, 87세,2017,704,151,553,27.3,699,150,549,27.3
23050, 남동구,090004, 88세,2017,624,163,461,35.4,623,163,460,35.4
23050, 남동구,090005, 89세,2017,473,101,372,27.2,471,101,370,27.3
23050, 남동구,095,90~94세,2017,1174,233,941,24.8,1172,233,939,24.8
23050, 남동구,095001, 90세,2017,372,72,300,24,372,72,300,24
23050, 남동구,095002, 91세,2017,252,47,205,22.9,252,47,205,22.9
23050, 남동구,095003, 92세,2017,224,44,180,24.4,224,44,180,24.4
23050, 남동구,095004, 93세,2017,159,31,128,24.2,158,31,127,24.4
23050, 남동구,095005, 94세,2017,167,39,128,30.5,166,39,127,30.7
23050, 남동구,100,95~99세,2017,272,43,229,18.8,272,43,229,18.8
23050, 남동구,100001, 95세,2017,106,14,92,15.2,106,14,92,15.2
23050, 남동구,100002, 96세,2017,60,10,50,20,60,10,50,20
23050, 남동구,100003, 97세,2017,51,6,45,13.3,51,6,45,13.3
23050, 남동구,100004, 98세,2017,39,9,30,30,39,9,30,30
23050, 남동구,100005, 99세,2017,16,X,12,33.3,16,X,12,33.3
23050, 남동구,101,100세이상,2017,31,X,27,14.8,31,X,27,14.8
23050, 남동구,102,15세미만,2017,75275,38624,36651,105.4,74789,38360,36429,105.3
23050, 남동구,103,15~64세,2017,400544,204609,195935,104.4,386561,194918,191643,101.7
23050, 남동구,104,65세이상,2017,58231,24875,33356,74.6,57714,24670,33044,74.7
23050, 남동구,086,85세이상,2017,4884,1092,3792,28.8,4865,1087,3778,28.8
23050, 남동구,126,평균연령,2017,39.9,38.9,40.9,,40,39,41,
23050, 남동구,127,중위연령,2017,40.6,39.5,41.8,,40.9,40,41.9,
23060, 부평구,000,합계,2017,538236,266995,271241,98.4,522227,258824,263403,98.3
23060, 부평구,005,0~4세,2017,21906,11207,10699,104.7,21287,10885,10402,104.6
23060, 부평구,005001, 0세,2017,3980,2084,1896,109.9,3835,2000,1835,109
23060, 부평구,005002, 1세,2017,4492,2300,2192,104.9,4321,2211,2110,104.8
23060, 부평구,005003, 2세,2017,4637,2340,2297,101.9,4516,2282,2234,102.1
23060, 부평구,005004, 3세,2017,4522,2322,2200,105.5,4409,2260,2149,105.2
23060, 부평구,005005, 4세,2017,4275,2161,2114,102.2,4206,2132,2074,102.8
23060, 부평구,010,5~9세,2017,22029,11298,10731,105.3,21773,11171,10602,105.4
23060, 부평구,010001, 5세,2017,4592,2304,2288,100.7,4521,2267,2254,100.6
23060, 부평구,010002, 6세,2017,4534,2345,2189,107.1,4476,2312,2164,106.8
23060, 부평구,010003, 7세,2017,4255,2222,2033,109.3,4211,2204,2007,109.8
23060, 부평구,010004, 8세,2017,4250,2145,2105,101.9,4204,2123,2081,102
23060, 부평구,010005, 9세,2017,4398,2282,2116,107.8,4361,2265,2096,108.1
23060, 부평구,015,10~14세,2017,22231,11539,10692,107.9,22121,11480,10641,107.9
23060, 부평구,015001, 10세,2017,4683,2441,2242,108.9,4654,2425,2229,108.8
23060, 부평구,015002, 11세,2017,4149,2156,1993,108.2,4129,2144,1985,108
23060, 부평구,015003, 12세,2017,4126,2109,2017,104.6,4101,2096,2005,104.5
23060, 부평구,015004, 13세,2017,4491,2331,2160,107.9,4471,2320,2151,107.9
23060, 부평구,015005, 14세,2017,4782,2502,2280,109.7,4766,2495,2271,109.9
23060, 부평구,020,15~19세,2017,28690,14790,13900,106.4,28520,14713,13807,106.6
23060, 부평구,020001, 15세,2017,4989,2558,2431,105.2,4973,2549,2424,105.2
23060, 부평구,020002, 16세,2017,5600,2873,2727,105.4,5573,2863,2710,105.6
23060, 부평구,020003, 17세,2017,6315,3196,3119,102.5,6283,3181,3102,102.5
23060, 부평구,020004, 18세,2017,6034,3212,2822,113.8,5989,3192,2797,114.1
23060, 부평구,020005, 19세,2017,5752,2951,2801,105.4,5702,2928,2774,105.6
23060, 부평구,025,20~24세,2017,36534,18985,17549,108.2,35894,18681,17213,108.5
23060, 부평구,025001, 20세,2017,6495,3442,3053,112.7,6428,3417,3011,113.5
23060, 부평구,025002, 21세,2017,6918,3726,3192,116.7,6813,3681,3132,117.5
23060, 부평구,025003, 22세,2017,7385,3979,3406,116.8,7265,3910,3355,116.5
23060, 부평구,025004, 23세,2017,7686,3893,3793,102.6,7539,3823,3716,102.9
23060, 부평구,025005, 24세,2017,8050,3945,4105,96.1,7849,3850,3999,96.3
23060, 부평구,030,25~29세,2017,39892,20076,19816,101.3,37942,19099,18843,101.4
23060, 부평구,030001, 25세,2017,8459,4222,4237,99.6,8190,4096,4094,100
23060, 부평구,030002, 26세,2017,8153,4103,4050,101.3,7827,3949,3878,101.8
23060, 부평구,030003, 27세,2017,7874,3950,3924,100.7,7474,3748,3726,100.6
23060, 부평구,030004, 28세,2017,7782,3987,3795,105.1,7362,3768,3594,104.8
23060, 부평구,030005, 29세,2017,7624,3814,3810,100.1,7089,3538,3551,99.6
23060, 부평구,035,30~34세,2017,39693,20452,19241,106.3,37267,19208,18059,106.4
23060, 부평구,035001, 30세,2017,7659,3879,3780,102.6,7123,3632,3491,104
23060, 부평구,035002, 31세,2017,7797,4023,3774,106.6,7253,3735,3518,106.2
23060, 부평구,035003, 32세,2017,7691,3991,3700,107.9,7202,3750,3452,108.6
23060, 부평구,035004, 33세,2017,8078,4170,3908,106.7,7635,3927,3708,105.9
23060, 부평구,035005, 34세,2017,8468,4389,4079,107.6,8054,4164,3890,107
23060, 부평구,040,35~39세,2017,44191,22932,21259,107.9,42555,21978,20577,106.8
23060, 부평구,040001, 35세,2017,9476,4822,4654,103.6,9058,4582,4476,102.4
23060, 부평구,040002, 36세,2017,9284,4902,4382,111.9,8937,4709,4228,111.4
23060, 부평구,040003, 37세,2017,9204,4784,4420,108.2,8901,4601,4300,107
23060, 부평구,040004, 38세,2017,8462,4429,4033,109.8,8177,4257,3920,108.6
23060, 부평구,040005, 39세,2017,7765,3995,3770,106,7482,3829,3653,104.8
23060, 부평구,045,40~44세,2017,41021,20868,20153,103.5,39843,20191,19652,102.7
23060, 부평구,045001, 40세,2017,7916,4112,3804,108.1,7682,3966,3716,106.7
23060, 부평구,045002, 41세,2017,7551,3909,3642,107.3,7298,3761,3537,106.3
23060, 부평구,045003, 42세,2017,7970,3939,4031,97.7,7764,3830,3934,97.4
23060, 부평구,045004, 43세,2017,8668,4408,4260,103.5,8451,4276,4175,102.4
23060, 부평구,045005, 44세,2017,8916,4500,4416,101.9,8648,4358,4290,101.6
23060, 부평구,050,45~49세,2017,48084,23343,24741,94.3,46488,22518,23970,93.9
23060, 부평구,050001, 45세,2017,9108,4520,4588,98.5,8821,4364,4457,97.9
23060, 부평구,050002, 46세,2017,9515,4684,4831,97,9186,4513,4673,96.6
23060, 부평구,050003, 47세,2017,9566,4702,4864,96.7,9221,4519,4702,96.1
23060, 부평구,050004, 48세,2017,9915,4761,5154,92.4,9610,4609,5001,92.2
23060, 부평구,050005, 49세,2017,9980,4676,5304,88.2,9650,4513,5137,87.9
23060, 부평구,055,50~54세,2017,47610,23423,24187,96.8,45934,22590,23344,96.8
23060, 부평구,055001, 50세,2017,9168,4399,4769,92.2,8908,4262,4646,91.7
23060, 부평구,055002, 51세,2017,9311,4590,4721,97.2,9027,4446,4581,97.1
23060, 부평구,055003, 52세,2017,9835,4790,5045,94.9,9479,4621,4858,95.1
23060, 부평구,055004, 53세,2017,9540,4744,4796,98.9,9165,4560,4605,99
23060, 부평구,055005, 54세,2017,9756,4900,4856,100.9,9355,4701,4654,101
23060, 부평구,060,55~59세,2017,48682,24329,24353,99.9,47296,23615,23681,99.7
23060, 부평구,060001, 55세,2017,9940,4918,5022,97.9,9644,4770,4874,97.9
23060, 부평구,060002, 56세,2017,10478,5301,5177,102.4,10264,5199,5065,102.6
23060, 부평구,060003, 57세,2017,10489,5214,5275,98.8,10167,5059,5108,99
23060, 부평구,060004, 58세,2017,9118,4547,4571,99.5,8846,4397,4449,98.8
23060, 부평구,060005, 59세,2017,8657,4349,4308,101,8375,4190,4185,100.1
23060, 부평구,065,60~64세,2017,34187,16685,17502,95.3,32856,16054,16802,95.5
23060, 부평구,065001, 60세,2017,8347,4090,4257,96.1,8035,3944,4091,96.4
23060, 부평구,065002, 61세,2017,7252,3563,3689,96.6,7015,3449,3566,96.7
23060, 부평구,065003, 62세,2017,7395,3595,3800,94.6,7084,3443,3641,94.6
23060, 부평구,065004, 63세,2017,6043,2877,3166,90.9,5787,2764,3023,91.4
23060, 부평구,065005, 64세,2017,5150,2560,2590,98.8,4935,2454,2481,98.9
23060, 부평구,070,65~69세,2017,21867,10763,11104,96.9,21250,10456,10794,96.9
23060, 부평구,070001, 65세,2017,5493,2709,2784,97.3,5328,2631,2697,97.6
23060, 부평구,070002, 66세,2017,3899,1936,1963,98.6,3729,1844,1885,97.8
23060, 부평구,070003, 67세,2017,4177,2082,2095,99.4,4061,2023,2038,99.3
23060, 부평구,070004, 68세,2017,4212,2019,2193,92.1,4109,1969,2140,92
23060, 부평구,070005, 69세,2017,4086,2017,2069,97.5,4023,1989,2034,97.8
23060, 부평구,075,70~74세,2017,15670,7117,8553,83.2,15496,7060,8436,83.7
23060, 부평구,075001, 70세,2017,3968,1825,2143,85.2,3924,1811,2113,85.7
23060, 부평구,075002, 71세,2017,3044,1416,1628,87,3007,1401,1606,87.2
23060, 부평구,075003, 72세,2017,2826,1274,1552,82.1,2786,1258,1528,82.3
23060, 부평구,075004, 73세,2017,2838,1281,1557,82.3,2810,1278,1532,83.4
23060, 부평구,075005, 74세,2017,2994,1321,1673,79,2969,1312,1657,79.2
23060, 부평구,080,75~79세,2017,12857,5194,7663,67.8,12731,5155,7576,68
23060, 부평구,080001, 75세,2017,3282,1416,1866,75.9,3257,1404,1853,75.8
23060, 부평구,080002, 76세,2017,2649,1097,1552,70.7,2625,1091,1534,71.1
23060, 부평구,080003, 77세,2017,2375,958,1417,67.6,2344,948,1396,67.9
23060, 부평구,080004, 78세,2017,2377,918,1459,62.9,2352,911,1441,63.2
23060, 부평구,080005, 79세,2017,2174,805,1369,58.8,2153,801,1352,59.2
23060, 부평구,085,80~84세,2017,7948,2702,5246,51.5,7863,2683,5180,51.8
23060, 부평구,085001, 80세,2017,1891,650,1241,52.4,1874,645,1229,52.5
23060, 부평구,085002, 81세,2017,1784,631,1153,54.7,1763,624,1139,54.8
23060, 부평구,085003, 82세,2017,1706,583,1123,51.9,1692,580,1112,52.2
23060, 부평구,085004, 83세,2017,1330,447,883,50.6,1313,445,868,51.3
23060, 부평구,085005, 84세,2017,1237,391,846,46.2,1221,389,832,46.8
23060, 부평구,090,85~89세,2017,3613,963,2650,36.3,3586,959,2627,36.5
23060, 부평구,090001, 85세,2017,1001,289,712,40.6,992,289,703,41.1
23060, 부평구,090002, 86세,2017,773,224,549,40.8,764,222,542,41
23060, 부평구,090003, 87세,2017,717,170,547,31.1,713,169,544,31.1
23060, 부평구,090004, 88세,2017,615,160,455,35.2,613,159,454,35
23060, 부평구,090005, 89세,2017,507,120,387,31,504,120,384,31.3
23060, 부평구,095,90~94세,2017,1211,262,949,27.6,1205,261,944,27.6
23060, 부평구,095001, 90세,2017,375,76,299,25.4,375,76,299,25.4
23060, 부평구,095002, 91세,2017,275,58,217,26.7,273,57,216,26.4
23060, 부평구,095003, 92세,2017,228,45,183,24.6,227,45,182,24.7
23060, 부평구,095004, 93세,2017,173,39,134,29.1,170,39,131,29.8
23060, 부평구,095005, 94세,2017,160,44,116,37.9,160,44,116,37.9
23060, 부평구,100,95~99세,2017,288,64,224,28.6,288,64,224,28.6
23060, 부평구,100001, 95세,2017,114,34,80,42.5,114,34,80,42.5
23060, 부평구,100002, 96세,2017,75,14,61,23,75,14,61,23
23060, 부평구,100003, 97세,2017,40,8,32,25,40,8,32,25
23060, 부평구,100004, 98세,2017,26,7,19,36.8,26,7,19,36.8
23060, 부평구,100005, 99세,2017,33,X,32,3.1,33,X,32,3.1
23060, 부평구,101,100세이상,2017,32,X,29,10.3,32,X,29,10.3
23060, 부평구,102,15세미만,2017,66166,34044,32122,106,65181,33536,31645,106
23060, 부평구,103,15~64세,2017,408584,205883,202701,101.6,394595,198647,195948,101.4
23060, 부평구,104,65세이상,2017,63486,27068,36418,74.3,62451,26641,35810,74.4
23060, 부평구,086,85세이상,2017,5144,1292,3852,33.5,5111,1287,3824,33.7
23060, 부평구,126,평균연령,2017,40.9,39.9,41.9,,40.9,39.9,41.9,
23060, 부평구,127,중위연령,2017,41.8,40.5,43.1,,41.8,40.6,43.1,
23070, 계양구,000,합계,2017,318104,158179,159925,98.9,314224,156413,157811,99.1
23070, 계양구,005,0~4세,2017,11722,5992,5730,104.6,11643,5957,5686,104.8
23070, 계양구,005001, 0세,2017,1985,1002,983,101.9,1970,996,974,102.3
23070, 계양구,005002, 1세,2017,2361,1184,1177,100.6,2345,1177,1168,100.8
23070, 계양구,005003, 2세,2017,2421,1228,1193,102.9,2402,1222,1180,103.6
23070, 계양구,005004, 3세,2017,2491,1296,1195,108.5,2470,1283,1187,108.1
23070, 계양구,005005, 4세,2017,2464,1282,1182,108.5,2456,1279,1177,108.7
23070, 계양구,010,5~9세,2017,13464,6853,6611,103.7,13438,6838,6600,103.6
23070, 계양구,010001, 5세,2017,2694,1351,1343,100.6,2686,1347,1339,100.6
23070, 계양구,010002, 6세,2017,2773,1402,1371,102.3,2770,1401,1369,102.3
23070, 계양구,010003, 7세,2017,2674,1367,1307,104.6,2670,1363,1307,104.3
23070, 계양구,010004, 8세,2017,2587,1327,1260,105.3,2585,1325,1260,105.2
23070, 계양구,010005, 9세,2017,2736,1406,1330,105.7,2727,1402,1325,105.8
23070, 계양구,015,10~14세,2017,13791,7056,6735,104.8,13770,7045,6725,104.8
23070, 계양구,015001, 10세,2017,2887,1483,1404,105.6,2878,1479,1399,105.7
23070, 계양구,015002, 11세,2017,2577,1330,1247,106.7,2574,1327,1247,106.4
23070, 계양구,015003, 12세,2017,2463,1258,1205,104.4,2458,1255,1203,104.3
23070, 계양구,015004, 13세,2017,2850,1465,1385,105.8,2848,1465,1383,105.9
23070, 계양구,015005, 14세,2017,3014,1520,1494,101.7,3012,1519,1493,101.7
23070, 계양구,020,15~19세,2017,18736,9648,9088,106.2,18678,9626,9052,106.3
23070, 계양구,020001, 15세,2017,3082,1648,1434,114.9,3080,1647,1433,114.9
23070, 계양구,020002, 16세,2017,3560,1873,1687,111,3556,1872,1684,111.2
23070, 계양구,020003, 17세,2017,3966,2058,1908,107.9,3959,2057,1902,108.1
23070, 계양구,020004, 18세,2017,4107,2097,2010,104.3,4093,2089,2004,104.2
23070, 계양구,020005, 19세,2017,4021,1972,2049,96.2,3990,1961,2029,96.6
23070, 계양구,025,20~24세,2017,24228,12525,11703,107,23868,12366,11502,107.5
23070, 계양구,025001, 20세,2017,4545,2392,2153,111.1,4504,2373,2131,111.4
23070, 계양구,025002, 21세,2017,4772,2566,2206,116.3,4712,2545,2167,117.4
23070, 계양구,025003, 22세,2017,4817,2505,2312,108.3,4742,2477,2265,109.4
23070, 계양구,025004, 23세,2017,4977,2561,2416,106,4899,2517,2382,105.7
23070, 계양구,025005, 24세,2017,5117,2501,2616,95.6,5011,2454,2557,96
23070, 계양구,030,25~29세,2017,23678,11983,11695,102.5,23093,11706,11387,102.8
23070, 계양구,030001, 25세,2017,5298,2624,2674,98.1,5192,2570,2622,98
23070, 계양구,030002, 26세,2017,5014,2511,2503,100.3,4896,2454,2442,100.5
23070, 계양구,030003, 27세,2017,4759,2451,2308,106.2,4638,2399,2239,107.1
23070, 계양구,030004, 28세,2017,4416,2232,2184,102.2,4302,2174,2128,102.2
23070, 계양구,030005, 29세,2017,4191,2165,2026,106.9,4065,2109,1956,107.8
23070, 계양구,035,30~34세,2017,21201,10910,10291,106,20583,10620,9963,106.6
23070, 계양구,035001, 30세,2017,4049,2070,1979,104.6,3942,2015,1927,104.6
23070, 계양구,035002, 31세,2017,4121,2161,1960,110.3,3983,2091,1892,110.5
23070, 계양구,035003, 32세,2017,4150,2144,2006,106.9,4014,2083,1931,107.9
23070, 계양구,035004, 33세,2017,4133,2126,2007,105.9,4013,2071,1942,106.6
23070, 계양구,035005, 34세,2017,4748,2409,2339,103,4631,2360,2271,103.9
23070, 계양구,040,35~39세,2017,24039,12277,11762,104.4,23617,12062,11555,104.4
23070, 계양구,040001, 35세,2017,4909,2513,2396,104.9,4810,2464,2346,105
23070, 계양구,040002, 36세,2017,4950,2581,2369,108.9,4870,2533,2337,108.4
23070, 계양구,040003, 37세,2017,5112,2544,2568,99.1,5029,2511,2518,99.7
23070, 계양구,040004, 38세,2017,4778,2454,2324,105.6,4689,2407,2282,105.5
23070, 계양구,040005, 39세,2017,4290,2185,2105,103.8,4219,2147,2072,103.6
23070, 계양구,045,40~44세,2017,24467,12291,12176,100.9,24137,12142,11995,101.2
23070, 계양구,045001, 40세,2017,4558,2327,2231,104.3,4502,2307,2195,105.1
23070, 계양구,045002, 41세,2017,4384,2224,2160,103,4316,2193,2123,103.3
23070, 계양구,045003, 42세,2017,4732,2384,2348,101.5,4677,2363,2314,102.1
23070, 계양구,045004, 43세,2017,5256,2706,2550,106.1,5186,2668,2518,106
23070, 계양구,045005, 44세,2017,5537,2650,2887,91.8,5456,2611,2845,91.8
23070, 계양구,050,45~49세,2017,30161,14523,15638,92.9,29783,14353,15430,93
23070, 계양구,050001, 45세,2017,5399,2697,2702,99.8,5337,2667,2670,99.9
23070, 계양구,050002, 46세,2017,5980,2902,3078,94.3,5891,2865,3026,94.7
23070, 계양구,050003, 47세,2017,6006,2919,3087,94.6,5939,2888,3051,94.7
23070, 계양구,050004, 48세,2017,6258,2960,3298,89.8,6178,2924,3254,89.9
23070, 계양구,050005, 49세,2017,6518,3045,3473,87.7,6438,3009,3429,87.8
23070, 계양구,055,50~54세,2017,31437,15293,16144,94.7,31099,15155,15944,95.1
23070, 계양구,055001, 50세,2017,6150,2872,3278,87.6,6102,2857,3245,88
23070, 계양구,055002, 51세,2017,6103,2941,3162,93,6039,2918,3121,93.5
23070, 계양구,055003, 52세,2017,6476,3163,3313,95.5,6402,3135,3267,96
23070, 계양구,055004, 53세,2017,6063,2928,3135,93.4,5989,2895,3094,93.6
23070, 계양구,055005, 54세,2017,6645,3389,3256,104.1,6567,3350,3217,104.1
23070, 계양구,060,55~59세,2017,31216,15939,15277,104.3,30955,15828,15127,104.6
23070, 계양구,060001, 55세,2017,6736,3391,3345,101.4,6680,3366,3314,101.6
23070, 계양구,060002, 56세,2017,7043,3548,3495,101.5,7002,3535,3467,102
23070, 계양구,060003, 57세,2017,6677,3401,3276,103.8,6600,3369,3231,104.3
23070, 계양구,060004, 58세,2017,5621,2910,2711,107.3,5571,2886,2685,107.5
23070, 계양구,060005, 59세,2017,5139,2689,2450,109.8,5102,2672,2430,110
23070, 계양구,065,60~64세,2017,18463,9631,8832,109,18258,9539,8719,109.4
23070, 계양구,065001, 60세,2017,4681,2506,2175,115.2,4631,2490,2141,116.3
23070, 계양구,065002, 61세,2017,4093,2103,1990,105.7,4048,2083,1965,106
23070, 계양구,065003, 62세,2017,3986,2033,1953,104.1,3953,2018,1935,104.3
23070, 계양구,065004, 63세,2017,3116,1669,1447,115.3,3076,1644,1432,114.8
23070, 계양구,065005, 64세,2017,2587,1320,1267,104.2,2550,1304,1246,104.7
23070, 계양구,070,65~69세,2017,10661,5428,5233,103.7,10551,5382,5169,104.1
23070, 계양구,070001, 65세,2017,2822,1423,1399,101.7,2798,1411,1387,101.7
23070, 계양구,070002, 66세,2017,1842,950,892,106.5,1817,938,879,106.7
23070, 계양구,070003, 67세,2017,2006,1024,982,104.3,1981,1012,969,104.4
23070, 계양구,070004, 68세,2017,2028,1026,1002,102.4,2004,1020,984,103.7
23070, 계양구,070005, 69세,2017,1963,1005,958,104.9,1951,1001,950,105.4
23070, 계양구,075,70~74세,2017,7490,3353,4137,81,7448,3331,4117,80.9
23070, 계양구,075001, 70세,2017,1894,878,1016,86.4,1883,871,1012,86.1
23070, 계양구,075002, 71세,2017,1437,669,768,87.1,1424,661,763,86.6
23070, 계양구,075003, 72세,2017,1407,626,781,80.2,1403,624,779,80.1
23070, 계양구,075004, 73세,2017,1366,599,767,78.1,1360,597,763,78.2
23070, 계양구,075005, 74세,2017,1386,581,805,72.2,1378,578,800,72.3
23070, 계양구,080,75~79세,2017,6497,2513,3984,63.1,6470,2504,3966,63.1
23070, 계양구,080001, 75세,2017,1640,674,966,69.8,1636,672,964,69.7
23070, 계양구,080002, 76세,2017,1361,537,824,65.2,1357,536,821,65.3
23070, 계양구,080003, 77세,2017,1222,467,755,61.9,1217,464,753,61.6
23070, 계양구,080004, 78세,2017,1191,434,757,57.3,1181,431,750,57.5
23070, 계양구,080005, 79세,2017,1083,401,682,58.8,1079,401,678,59.1
23070, 계양구,085,80~84세,2017,4090,1295,2795,46.3,4077,1292,2785,46.4
23070, 계양구,085001, 80세,2017,940,327,613,53.3,934,325,609,53.4
23070, 계양구,085002, 81세,2017,944,284,660,43,942,283,659,42.9
23070, 계양구,085003, 82세,2017,876,296,580,51,874,296,578,51.2
23070, 계양구,085004, 83세,2017,710,208,502,41.4,709,208,501,41.5
23070, 계양구,085005, 84세,2017,620,180,440,40.9,618,180,438,41.1
23070, 계양구,090,85~89세,2017,1912,480,1432,33.5,1908,480,1428,33.6
23070, 계양구,090001, 85세,2017,500,136,364,37.4,500,136,364,37.4
23070, 계양구,090002, 86세,2017,422,116,306,37.9,421,116,305,38
23070, 계양구,090003, 87세,2017,405,91,314,29,403,91,312,29.2
23070, 계양구,090004, 88세,2017,316,74,242,30.6,316,74,242,30.6
23070, 계양구,090005, 89세,2017,269,63,206,30.6,268,63,205,30.7
23070, 계양구,095,90~94세,2017,679,156,523,29.8,677,155,522,29.7
23070, 계양구,095001, 90세,2017,213,45,168,26.8,212,45,167,26.9
23070, 계양구,095002, 91세,2017,174,38,136,27.9,173,37,136,27.2
23070, 계양구,095003, 92세,2017,117,23,94,24.5,117,23,94,24.5
23070, 계양구,095004, 93세,2017,88,23,65,35.4,88,23,65,35.4
23070, 계양구,095005, 94세,2017,87,27,60,45,87,27,60,45
23070, 계양구,100,95~99세,2017,151,29,122,23.8,150,28,122,23
23070, 계양구,100001, 95세,2017,47,9,38,23.7,46,8,38,21.1
23070, 계양구,100002, 96세,2017,47,12,35,34.3,47,12,35,34.3
23070, 계양구,100003, 97세,2017,27,7,20,35,27,7,20,35
23070, 계양구,100004, 98세,2017,17,X,16,6.3,17,X,16,6.3
23070, 계양구,100005, 99세,2017,13,X,13,0,13,X,13,0
23070, 계양구,101,100세이상,2017,21,X,17,23.5,21,X,17,23.5
23070, 계양구,102,15세미만,2017,38977,19901,19076,104.3,38851,19840,19011,104.4
23070, 계양구,103,15~64세,2017,247626,125020,122606,102,244071,123397,120674,102.3
23070, 계양구,104,65세이상,2017,31501,13258,18243,72.7,31302,13176,18126,72.7
23070, 계양구,086,85세이상,2017,2763,669,2094,31.9,2756,667,2089,31.9
23070, 계양구,126,평균연령,2017,40.3,39.5,41.2,,40.4,39.5,41.2,
23070, 계양구,127,중위연령,2017,41.8,40.8,42.8,,41.9,40.9,42.9,
23080, 서구,000,합계,2017,509776,259613,250163,103.8,494399,249250,245149,101.7
23080, 서구,005,0~4세,2017,25047,12872,12175,105.7,24779,12744,12035,105.9
23080, 서구,005001, 0세,2017,4084,2084,2000,104.2,4040,2065,1975,104.6
23080, 서구,005002, 1세,2017,4957,2557,2400,106.5,4890,2522,2368,106.5
23080, 서구,005003, 2세,2017,5335,2751,2584,106.5,5281,2720,2561,106.2
23080, 서구,005004, 3세,2017,5234,2710,2524,107.4,5173,2684,2489,107.8
23080, 서구,005005, 4세,2017,5437,2770,2667,103.9,5395,2753,2642,104.2
23080, 서구,010,5~9세,2017,28054,14495,13559,106.9,27891,14400,13491,106.7
23080, 서구,010001, 5세,2017,5888,3098,2790,111,5851,3079,2772,111.1
23080, 서구,010002, 6세,2017,5841,3033,2808,108,5807,3011,2796,107.7
23080, 서구,010003, 7세,2017,5540,2832,2708,104.6,5512,2817,2695,104.5
23080, 서구,010004, 8세,2017,5219,2703,2516,107.4,5189,2686,2503,107.3
23080, 서구,010005, 9세,2017,5566,2829,2737,103.4,5532,2807,2725,103
23080, 서구,015,10~14세,2017,26613,13630,12983,105,26527,13588,12939,105
23080, 서구,015001, 10세,2017,5647,2849,2798,101.8,5618,2837,2781,102
23080, 서구,015002, 11세,2017,5198,2674,2524,105.9,5182,2666,2516,106
23080, 서구,015003, 12세,2017,5031,2635,2396,110,5012,2625,2387,110
23080, 서구,015004, 13세,2017,5359,2714,2645,102.6,5346,2709,2637,102.7
23080, 서구,015005, 14세,2017,5378,2758,2620,105.3,5369,2751,2618,105.1
23080, 서구,020,15~19세,2017,29232,15103,14129,106.9,29078,15015,14063,106.8
23080, 서구,020001, 15세,2017,5448,2814,2634,106.8,5429,2800,2629,106.5
23080, 서구,020002, 16세,2017,5902,3033,2869,105.7,5883,3023,2860,105.7
23080, 서구,020003, 17세,2017,6462,3343,3119,107.2,6436,3332,3104,107.3
23080, 서구,020004, 18세,2017,5964,3065,2899,105.7,5929,3043,2886,105.4
23080, 서구,020005, 19세,2017,5456,2848,2608,109.2,5401,2817,2584,109
23080, 서구,025,20~24세,2017,32502,17369,15133,114.8,31421,16584,14837,111.8
23080, 서구,025001, 20세,2017,6069,3233,2836,114,5977,3175,2802,113.3
23080, 서구,025002, 21세,2017,6368,3505,2863,122.4,6239,3417,2822,121.1
23080, 서구,025003, 22세,2017,6499,3530,2969,118.9,6309,3390,2919,116.1
23080, 서구,025004, 23세,2017,6717,3518,3199,110,6432,3305,3127,105.7
23080, 서구,025005, 24세,2017,6849,3583,3266,109.7,6464,3297,3167,104.1
23080, 서구,030,25~29세,2017,33908,17971,15937,112.8,31118,15915,15203,104.7
23080, 서구,030001, 25세,2017,7289,3775,3514,107.4,6791,3396,3395,100
23080, 서구,030002, 26세,2017,7144,3792,3352,113.1,6606,3405,3201,106.4
23080, 서구,030003, 27세,2017,6558,3482,3076,113.2,5986,3083,2903,106.2
23080, 서구,030004, 28세,2017,6509,3514,2995,117.3,5953,3097,2856,108.4
23080, 서구,030005, 29세,2017,6408,3408,3000,113.6,5782,2934,2848,103
23080, 서구,035,30~34세,2017,36898,19254,17644,109.1,33839,16931,16908,100.1
23080, 서구,035001, 30세,2017,6627,3410,3217,106,5937,2899,3038,95.4
23080, 서구,035002, 31세,2017,6971,3691,3280,112.5,6357,3225,3132,103
23080, 서구,035003, 32세,2017,7177,3790,3387,111.9,6574,3323,3251,102.2
23080, 서구,035004, 33세,2017,7584,3910,3674,106.4,6993,3466,3527,98.3
23080, 서구,035005, 34세,2017,8539,4453,4086,109,7978,4018,3960,101.5
23080, 서구,040,35~39세,2017,46764,24402,22362,109.1,44418,22674,21744,104.3
23080, 서구,040001, 35세,2017,9431,5006,4425,113.1,8873,4585,4288,106.9
23080, 서구,040002, 36세,2017,9598,5073,4525,112.1,9093,4699,4394,106.9
23080, 서구,040003, 37세,2017,9829,5078,4751,106.9,9377,4741,4636,102.3
23080, 서구,040004, 38세,2017,9434,4885,4549,107.4,8975,4551,4424,102.9
23080, 서구,040005, 39세,2017,8472,4360,4112,106,8100,4098,4002,102.4
23080, 서구,045,40~44세,2017,45408,23227,22181,104.7,43945,22241,21704,102.5
23080, 서구,045001, 40세,2017,8727,4418,4309,102.5,8399,4186,4213,99.4
23080, 서구,045002, 41세,2017,8500,4343,4157,104.5,8179,4134,4045,102.2
23080, 서구,045003, 42세,2017,9026,4702,4324,108.7,8735,4504,4231,106.5
23080, 서구,045004, 43세,2017,9655,4962,4693,105.7,9382,4779,4603,103.8
23080, 서구,045005, 44세,2017,9500,4802,4698,102.2,9250,4638,4612,100.6
23080, 서구,050,45~49세,2017,48871,24710,24161,102.3,47582,23942,23640,101.3
23080, 서구,050001, 45세,2017,9609,4871,4738,102.8,9304,4690,4614,101.6
23080, 서구,050002, 46세,2017,10147,5205,4942,105.3,9892,5056,4836,104.5
23080, 서구,050003, 47세,2017,9549,4847,4702,103.1,9279,4687,4592,102.1
23080, 서구,050004, 48세,2017,9801,4922,4879,100.9,9564,4772,4792,99.6
23080, 서구,050005, 49세,2017,9765,4865,4900,99.3,9543,4737,4806,98.6
23080, 서구,055,50~54세,2017,43614,22266,21348,104.3,42605,21699,20906,103.8
23080, 서구,055001, 50세,2017,8876,4454,4422,100.7,8671,4331,4340,99.8
23080, 서구,055002, 51세,2017,8732,4515,4217,107.1,8543,4407,4136,106.6
23080, 서구,055003, 52세,2017,9104,4628,4476,103.4,8902,4518,4384,103.1
23080, 서구,055004, 53세,2017,8314,4243,4071,104.2,8116,4135,3981,103.9
23080, 서구,055005, 54세,2017,8588,4426,4162,106.3,8373,4308,4065,106
23080, 서구,060,55~59세,2017,40401,21027,19374,108.5,39731,20690,19041,108.7
23080, 서구,060001, 55세,2017,8468,4427,4041,109.6,8308,4341,3967,109.4
23080, 서구,060002, 56세,2017,8928,4706,4222,111.5,8803,4641,4162,111.5
23080, 서구,060003, 57세,2017,8697,4465,4232,105.5,8547,4396,4151,105.9
23080, 서구,060004, 58세,2017,7389,3817,3572,106.9,7268,3761,3507,107.2
23080, 서구,060005, 59세,2017,6919,3612,3307,109.2,6805,3551,3254,109.1
23080, 서구,065,60~64세,2017,26525,13470,13055,103.2,26019,13213,12806,103.2
23080, 서구,065001, 60세,2017,6531,3323,3208,103.6,6406,3253,3153,103.2
23080, 서구,065002, 61세,2017,5802,3005,2797,107.4,5706,2955,2751,107.4
23080, 서구,065003, 62세,2017,5653,2858,2795,102.3,5556,2806,2750,102
23080, 서구,065004, 63세,2017,4577,2302,2275,101.2,4477,2260,2217,101.9
23080, 서구,065005, 64세,2017,3962,1982,1980,100.1,3874,1939,1935,100.2
23080, 서구,070,65~69세,2017,16337,8218,8119,101.2,16052,8086,7966,101.5
23080, 서구,070001, 65세,2017,4190,2134,2056,103.8,4115,2094,2021,103.6
23080, 서구,070002, 66세,2017,2853,1419,1434,99,2787,1388,1399,99.2
23080, 서구,070003, 67세,2017,3164,1584,1580,100.3,3097,1556,1541,101
23080, 서구,070004, 68세,2017,3157,1583,1574,100.6,3109,1562,1547,101
23080, 서구,070005, 69세,2017,2973,1498,1475,101.6,2944,1486,1458,101.9
23080, 서구,075,70~74세,2017,11296,5292,6004,88.1,11194,5253,5941,88.4
23080, 서구,075001, 70세,2017,2914,1381,1533,90.1,2887,1373,1514,90.7
23080, 서구,075002, 71세,2017,2189,1051,1138,92.4,2167,1041,1126,92.5
23080, 서구,075003, 72세,2017,2107,974,1133,86,2084,963,1121,85.9
23080, 서구,075004, 73세,2017,1992,933,1059,88.1,1977,929,1048,88.6
23080, 서구,075005, 74세,2017,2094,953,1141,83.5,2079,947,1132,83.7
23080, 서구,080,75~79세,2017,8914,3620,5294,68.4,8854,3599,5255,68.5
23080, 서구,080001, 75세,2017,2330,1011,1319,76.6,2319,1005,1314,76.5
23080, 서구,080002, 76세,2017,1818,768,1050,73.1,1809,766,1043,73.4
23080, 서구,080003, 77세,2017,1616,626,990,63.2,1608,624,984,63.4
23080, 서구,080004, 78세,2017,1607,632,975,64.8,1593,626,967,64.7
23080, 서구,080005, 79세,2017,1543,583,960,60.7,1525,578,947,61
23080, 서구,085,80~84세,2017,5552,1808,3744,48.3,5522,1802,3720,48.4
23080, 서구,085001, 80세,2017,1304,457,847,54,1297,455,842,54
23080, 서구,085002, 81세,2017,1261,428,833,51.4,1253,426,827,51.5
23080, 서구,085003, 82세,2017,1131,357,774,46.1,1123,356,767,46.4
23080, 서구,085004, 83세,2017,976,311,665,46.8,970,310,660,47
23080, 서구,085005, 84세,2017,880,255,625,40.8,879,255,624,40.9
23080, 서구,090,85~89세,2017,2676,658,2018,32.6,2664,655,2009,32.6
23080, 서구,090001, 85세,2017,713,195,518,37.6,709,194,515,37.7
23080, 서구,090002, 86세,2017,554,140,414,33.8,550,138,412,33.5
23080, 서구,090003, 87세,2017,542,126,416,30.3,540,126,414,30.4
23080, 서구,090004, 88세,2017,501,109,392,27.8,500,109,391,27.9
23080, 서구,090005, 89세,2017,366,88,278,31.7,365,88,277,31.8
23080, 서구,095,90~94세,2017,938,179,759,23.6,935,178,757,23.5
23080, 서구,095001, 90세,2017,306,59,247,23.9,304,58,246,23.6
23080, 서구,095002, 91세,2017,180,33,147,22.4,179,33,146,22.6
23080, 서구,095003, 92세,2017,197,35,162,21.6,197,35,162,21.6
23080, 서구,095004, 93세,2017,125,21,104,20.2,125,21,104,20.2
23080, 서구,095005, 94세,2017,130,31,99,31.3,130,31,99,31.3
23080, 서구,100,95~99세,2017,194,39,155,25.2,194,39,155,25.2
23080, 서구,100001, 95세,2017,70,10,60,16.7,70,10,60,16.7
23080, 서구,100002, 96세,2017,46,6,40,15,46,6,40,15
23080, 서구,100003, 97세,2017,37,14,23,60.9,37,14,23,60.9
23080, 서구,100004, 98세,2017,22,X,19,15.8,22,X,19,15.8
23080, 서구,100005, 99세,2017,19,6,13,46.2,19,6,13,46.2
23080, 서구,101,100세이상,2017,32,X,29,10.3,31,X,29,6.9
23080, 서구,102,15세미만,2017,79714,40997,38717,105.9,79197,40732,38465,105.9
23080, 서구,103,15~64세,2017,384123,198799,185324,107.3,369756,188904,180852,104.5
23080, 서구,104,65세이상,2017,45939,19817,26122,75.9,45446,19614,25832,75.9
23080, 서구,086,85세이상,2017,3840,879,2961,29.7,3824,874,2950,29.6
23080, 서구,126,평균연령,2017,38.6,37.8,39.3,,38.6,37.9,39.3,
23080, 서구,127,중위연령,2017,39.5,38.8,40.3,,39.8,39.2,40.3,
23310, 강화군,000,합계,2017,63737,32025,31712,101,62753,31416,31337,100.3
23310, 강화군,005,0~4세,2017,1427,713,714,99.9,1423,712,711,100.1
23310, 강화군,005001, 0세,2017,239,128,111,115.3,238,128,110,116.4
23310, 강화군,005002, 1세,2017,281,149,132,112.9,281,149,132,112.9
23310, 강화군,005003, 2세,2017,292,142,150,94.7,292,142,150,94.7
23310, 강화군,005004, 3세,2017,312,148,164,90.2,310,147,163,90.2
23310, 강화군,005005, 4세,2017,303,146,157,93,302,146,156,93.6
23310, 강화군,010,5~9세,2017,1937,989,948,104.3,1934,988,946,104.4
23310, 강화군,010001, 5세,2017,368,191,177,107.9,367,191,176,108.5
23310, 강화군,010002, 6세,2017,389,200,189,105.8,389,200,189,105.8
23310, 강화군,010003, 7세,2017,375,202,173,116.8,374,202,172,117.4
23310, 강화군,010004, 8세,2017,382,202,180,112.2,382,202,180,112.2
23310, 강화군,010005, 9세,2017,423,194,229,84.7,422,193,229,84.3
23310, 강화군,015,10~14세,2017,2087,1083,1004,107.9,2085,1081,1004,107.7
23310, 강화군,015001, 10세,2017,395,219,176,124.4,395,219,176,124.4
23310, 강화군,015002, 11세,2017,414,211,203,103.9,414,211,203,103.9
23310, 강화군,015003, 12세,2017,388,190,198,96,388,190,198,96
23310, 강화군,015004, 13세,2017,407,207,200,103.5,405,205,200,102.5
23310, 강화군,015005, 14세,2017,483,256,227,112.8,483,256,227,112.8
23310, 강화군,020,15~19세,2017,2788,1446,1342,107.7,2784,1444,1340,107.8
23310, 강화군,020001, 15세,2017,473,245,228,107.5,471,244,227,107.5
23310, 강화군,020002, 16세,2017,609,276,333,82.9,609,276,333,82.9
23310, 강화군,020003, 17세,2017,720,375,345,108.7,720,375,345,108.7
23310, 강화군,020004, 18세,2017,563,301,262,114.9,562,301,261,115.3
23310, 강화군,020005, 19세,2017,423,249,174,143.1,422,248,174,142.5
23310, 강화군,025,20~24세,2017,2613,1566,1047,149.6,2513,1499,1014,147.8
23310, 강화군,025001, 20세,2017,494,315,179,176,491,314,177,177.4
23310, 강화군,025002, 21세,2017,498,317,181,175.1,480,307,173,177.5
23310, 강화군,025003, 22세,2017,533,319,214,149.1,520,311,209,148.8
23310, 강화군,025004, 23세,2017,553,312,241,129.5,524,291,233,124.9
23310, 강화군,025005, 24세,2017,535,303,232,130.6,498,276,222,124.3
23310, 강화군,030,25~29세,2017,2657,1553,1104,140.7,2433,1401,1032,135.8
23310, 강화군,030001, 25세,2017,529,315,214,147.2,491,293,198,148
23310, 강화군,030002, 26세,2017,567,316,251,125.9,531,296,235,126
23310, 강화군,030003, 27세,2017,544,332,212,156.6,499,300,199,150.8
23310, 강화군,030004, 28세,2017,522,310,212,146.2,474,274,200,137
23310, 강화군,030005, 29세,2017,495,280,215,130.2,438,238,200,119
23310, 강화군,035,30~34세,2017,2391,1347,1044,129,2180,1190,990,120.2
23310, 강화군,035001, 30세,2017,466,267,199,134.2,422,239,183,130.6
23310, 강화군,035002, 31세,2017,433,257,176,146,382,216,166,130.1
23310, 강화군,035003, 32세,2017,456,254,202,125.7,416,220,196,112.2
23310, 강화군,035004, 33세,2017,477,250,227,110.1,440,223,217,102.8
23310, 강화군,035005, 34세,2017,559,319,240,132.9,520,292,228,128.1
23310, 강화군,040,35~39세,2017,2877,1538,1339,114.9,2768,1468,1300,112.9
23310, 강화군,040001, 35세,2017,600,317,283,112,575,300,275,109.1
23310, 강화군,040002, 36세,2017,584,315,269,117.1,561,300,261,114.9
23310, 강화군,040003, 37세,2017,573,307,266,115.4,552,293,259,113.1
23310, 강화군,040004, 38세,2017,558,293,265,110.6,539,281,258,108.9
23310, 강화군,040005, 39세,2017,562,306,256,119.5,541,294,247,119
23310, 강화군,045,40~44세,2017,3473,1893,1580,119.8,3402,1849,1553,119.1
23310, 강화군,045001, 40세,2017,612,331,281,117.8,598,321,277,115.9
23310, 강화군,045002, 41세,2017,633,336,297,113.1,616,325,291,111.7
23310, 강화군,045003, 42세,2017,650,347,303,114.5,636,338,298,113.4
23310, 강화군,045004, 43세,2017,756,435,321,135.5,741,428,313,136.7
23310, 강화군,045005, 44세,2017,822,444,378,117.5,811,437,374,116.8
23310, 강화군,050,45~49세,2017,4309,2314,1995,116,4239,2283,1956,116.7
23310, 강화군,050001, 45세,2017,763,424,339,125.1,750,415,335,123.9
23310, 강화군,050002, 46세,2017,859,474,385,123.1,842,467,375,124.5
23310, 강화군,050003, 47세,2017,834,467,367,127.2,823,464,359,129.2
23310, 강화군,050004, 48세,2017,919,474,445,106.5,910,471,439,107.3
23310, 강화군,050005, 49세,2017,934,475,459,103.5,914,466,448,104
23310, 강화군,055,50~54세,2017,4891,2509,2382,105.3,4830,2482,2348,105.7
23310, 강화군,055001, 50세,2017,858,439,419,104.8,849,435,414,105.1
23310, 강화군,055002, 51세,2017,927,489,438,111.6,916,484,432,112
23310, 강화군,055003, 52세,2017,1021,523,498,105,1008,516,492,104.9
23310, 강화군,055004, 53세,2017,1017,519,498,104.2,1000,512,488,104.9
23310, 강화군,055005, 54세,2017,1068,539,529,101.9,1057,535,522,102.5
23310, 강화군,060,55~59세,2017,6942,3406,3536,96.3,6898,3392,3506,96.7
23310, 강화군,060001, 55세,2017,1276,630,646,97.5,1269,629,640,98.3
23310, 강화군,060002, 56세,2017,1421,701,720,97.4,1416,699,717,97.5
23310, 강화군,060003, 57세,2017,1437,703,734,95.8,1430,699,731,95.6
23310, 강화군,060004, 58세,2017,1454,709,745,95.2,1439,704,735,95.8
23310, 강화군,060005, 59세,2017,1354,663,691,95.9,1344,661,683,96.8
23310, 강화군,065,60~64세,2017,6184,3076,3108,99,6151,3060,3091,99
23310, 강화군,065001, 60세,2017,1315,673,642,104.8,1309,669,640,104.5
23310, 강화군,065002, 61세,2017,1278,635,643,98.8,1274,633,641,98.8
23310, 강화군,065003, 62세,2017,1328,654,674,97,1317,650,667,97.5
23310, 강화군,065004, 63세,2017,1123,545,578,94.3,1115,542,573,94.6
23310, 강화군,065005, 64세,2017,1140,569,571,99.6,1136,566,570,99.3
23310, 강화군,070,65~69세,2017,4935,2454,2481,98.9,4918,2445,2473,98.9
23310, 강화군,070001, 65세,2017,1153,573,580,98.8,1148,571,577,99
23310, 강화군,070002, 66세,2017,749,357,392,91.1,748,357,391,91.3
23310, 강화군,070003, 67세,2017,966,473,493,95.9,964,472,492,95.9
23310, 강화군,070004, 68세,2017,1032,529,503,105.2,1024,523,501,104.4
23310, 강화군,070005, 69세,2017,1035,522,513,101.8,1034,522,512,102
23310, 강화군,075,70~74세,2017,4708,2265,2443,92.7,4696,2260,2436,92.8
23310, 강화군,075001, 70세,2017,1156,574,582,98.6,1152,572,580,98.6
23310, 강화군,075002, 71세,2017,895,417,478,87.2,893,416,477,87.2
23310, 강화군,075003, 72세,2017,830,404,426,94.8,826,403,423,95.3
23310, 강화군,075004, 73세,2017,855,392,463,84.7,854,391,463,84.4
23310, 강화군,075005, 74세,2017,972,478,494,96.8,971,478,493,97
23310, 강화군,080,75~79세,2017,4236,1966,2270,86.6,4227,1960,2267,86.5
23310, 강화군,080001, 75세,2017,996,473,523,90.4,994,472,522,90.4
23310, 강화군,080002, 76세,2017,899,419,480,87.3,896,416,480,86.7
23310, 강화군,080003, 77세,2017,777,347,430,80.7,775,346,429,80.7
23310, 강화군,080004, 78세,2017,801,363,438,82.9,800,363,437,83.1
23310, 강화군,080005, 79세,2017,763,364,399,91.2,762,363,399,91
23310, 강화군,085,80~84세,2017,3125,1283,1842,69.7,3119,1281,1838,69.7
23310, 강화군,085001, 80세,2017,684,306,378,81,683,306,377,81.2
23310, 강화군,085002, 81세,2017,744,314,430,73,743,314,429,73.2
23310, 강화군,085003, 82세,2017,665,274,391,70.1,663,273,390,70
23310, 강화군,085004, 83세,2017,540,206,334,61.7,539,205,334,61.4
23310, 강화군,085005, 84세,2017,492,183,309,59.2,491,183,308,59.4
23310, 강화군,090,85~89세,2017,1526,463,1063,43.6,1524,461,1063,43.4
23310, 강화군,090001, 85세,2017,439,135,304,44.4,439,135,304,44.4
23310, 강화군,090002, 86세,2017,340,114,226,50.4,339,113,226,50
23310, 강화군,090003, 87세,2017,292,92,200,46,292,92,200,46
23310, 강화군,090004, 88세,2017,243,66,177,37.3,242,65,177,36.7
23310, 강화군,090005, 89세,2017,212,56,156,35.9,212,56,156,35.9
23310, 강화군,095,90~94세,2017,500,123,377,32.6,498,122,376,32.4
23310, 강화군,095001, 90세,2017,141,35,106,33,140,34,106,32.1
23310, 강화군,095002, 91세,2017,117,28,89,31.5,116,28,88,31.8
23310, 강화군,095003, 92세,2017,105,25,80,31.3,105,25,80,31.3
23310, 강화군,095004, 93세,2017,75,18,57,31.6,75,18,57,31.6
23310, 강화군,095005, 94세,2017,62,17,45,37.8,62,17,45,37.8
23310, 강화군,100,95~99세,2017,116,35,81,43.2,116,35,81,43.2
23310, 강화군,100001, 95세,2017,37,9,28,32.1,37,9,28,32.1
23310, 강화군,100002, 96세,2017,30,10,20,50,30,10,20,50
23310, 강화군,100003, 97세,2017,22,8,14,57.1,22,8,14,57.1
23310, 강화군,100004, 98세,2017,16,X,12,33.3,16,X,12,33.3
23310, 강화군,100005, 99세,2017,11,X,7,57.1,11,X,7,57.1
23310, 강화군,101,100세이상,2017,15,X,12,25,15,X,12,25
23310, 강화군,102,15세미만,2017,5451,2785,2666,104.5,5442,2781,2661,104.5
23310, 강화군,103,15~64세,2017,39125,20648,18477,111.7,38198,20068,18130,110.7
23310, 강화군,104,65세이상,2017,19161,8592,10569,81.3,19113,8567,10546,81.2
23310, 강화군,086,85세이상,2017,2157,624,1533,40.7,2153,621,1532,40.5
23310, 강화군,126,평균연령,2017,51.1,49.4,52.9,,51.3,49.6,53,
23310, 강화군,127,중위연령,2017,55.3,53.2,57,,55.6,53.7,57.2,
23320, 옹진군,000,합계,2017,19294,11004,8290,132.7,19082,10855,8227,131.9
23320, 옹진군,005,0~4세,2017,625,305,320,95.3,625,305,320,95.3
23320, 옹진군,005001, 0세,2017,105,43,62,69.4,105,43,62,69.4
23320, 옹진군,005002, 1세,2017,133,65,68,95.6,133,65,68,95.6
23320, 옹진군,005003, 2세,2017,122,66,56,117.9,122,66,56,117.9
23320, 옹진군,005004, 3세,2017,129,57,72,79.2,129,57,72,79.2
23320, 옹진군,005005, 4세,2017,136,74,62,119.4,136,74,62,119.4
23320, 옹진군,010,5~9세,2017,575,299,276,108.3,575,299,276,108.3
23320, 옹진군,010001, 5세,2017,120,61,59,103.4,120,61,59,103.4
23320, 옹진군,010002, 6세,2017,131,77,54,142.6,131,77,54,142.6
23320, 옹진군,010003, 7세,2017,116,58,58,100,116,58,58,100
23320, 옹진군,010004, 8세,2017,102,56,46,121.7,102,56,46,121.7
23320, 옹진군,010005, 9세,2017,106,47,59,79.7,106,47,59,79.7
23320, 옹진군,015,10~14세,2017,545,278,267,104.1,545,278,267,104.1
23320, 옹진군,015001, 10세,2017,131,64,67,95.5,131,64,67,95.5
23320, 옹진군,015002, 11세,2017,98,50,48,104.2,98,50,48,104.2
23320, 옹진군,015003, 12세,2017,94,55,39,141,94,55,39,141
23320, 옹진군,015004, 13세,2017,115,56,59,94.9,115,56,59,94.9
23320, 옹진군,015005, 14세,2017,107,53,54,98.1,107,53,54,98.1
23320, 옹진군,020,15~19세,2017,561,327,234,139.7,560,326,234,139.3
23320, 옹진군,020001, 15세,2017,113,64,49,130.6,113,64,49,130.6
23320, 옹진군,020002, 16세,2017,130,75,55,136.4,130,75,55,136.4
23320, 옹진군,020003, 17세,2017,143,84,59,142.4,142,83,59,140.7
23320, 옹진군,020004, 18세,2017,107,53,54,98.1,107,53,54,98.1
23320, 옹진군,020005, 19세,2017,68,51,17,300,68,51,17,300
23320, 옹진군,025,20~24세,2017,1199,988,211,468.2,1170,962,208,462.5
23320, 옹진군,025001, 20세,2017,118,96,22,436.4,118,96,22,436.4
23320, 옹진군,025002, 21세,2017,217,183,34,538.2,213,180,33,545.5
23320, 옹진군,025003, 22세,2017,240,210,30,700,234,204,30,680
23320, 옹진군,025004, 23세,2017,314,261,53,492.5,307,255,52,490.4
23320, 옹진군,025005, 24세,2017,310,238,72,330.6,298,227,71,319.7
23320, 옹진군,030,25~29세,2017,1291,920,371,248,1245,883,362,243.9
23320, 옹진군,030001, 25세,2017,308,222,86,258.1,298,215,83,259
23320, 옹진군,030002, 26세,2017,286,202,84,240.5,279,197,82,240.2
23320, 옹진군,030003, 27세,2017,251,179,72,248.6,240,171,69,247.8
23320, 옹진군,030004, 28세,2017,244,179,65,275.4,233,169,64,264.1
23320, 옹진군,030005, 29세,2017,202,138,64,215.6,195,131,64,204.7
23320, 옹진군,035,30~34세,2017,1049,667,382,174.6,1001,627,374,167.6
23320, 옹진군,035001, 30세,2017,248,171,77,222.1,233,158,75,210.7
23320, 옹진군,035002, 31세,2017,208,137,71,193,200,130,70,185.7
23320, 옹진군,035003, 32세,2017,184,115,69,166.7,174,105,69,152.2
23320, 옹진군,035004, 33세,2017,192,110,82,134.1,184,106,78,135.9
23320, 옹진군,035005, 34세,2017,217,134,83,161.4,210,128,82,156.1
23320, 옹진군,040,35~39세,2017,1231,744,487,152.8,1209,726,483,150.3
23320, 옹진군,040001, 35세,2017,255,156,99,157.6,247,149,98,152
23320, 옹진군,040002, 36세,2017,237,143,94,152.1,231,138,93,148.4
23320, 옹진군,040003, 37세,2017,262,153,109,140.4,257,149,108,138
23320, 옹진군,040004, 38세,2017,248,147,101,145.5,247,146,101,144.6
23320, 옹진군,040005, 39세,2017,229,145,84,172.6,227,144,83,173.5
23320, 옹진군,045,40~44세,2017,1159,749,410,182.7,1140,739,401,184.3
23320, 옹진군,045001, 40세,2017,225,138,87,158.6,219,135,84,160.7
23320, 옹진군,045002, 41세,2017,191,125,66,189.4,187,123,64,192.2
23320, 옹진군,045003, 42세,2017,236,158,78,202.6,235,157,78,201.3
23320, 옹진군,045004, 43세,2017,249,160,89,179.8,245,158,87,181.6
23320, 옹진군,045005, 44세,2017,258,168,90,186.7,254,166,88,188.6
23320, 옹진군,050,45~49세,2017,1283,804,479,167.8,1268,797,471,169.2
23320, 옹진군,050001, 45세,2017,245,170,75,226.7,242,170,72,236.1
23320, 옹진군,050002, 46세,2017,258,158,100,158,256,156,100,156
23320, 옹진군,050003, 47세,2017,259,169,90,187.8,253,167,86,194.2
23320, 옹진군,050004, 48세,2017,236,147,89,165.2,234,145,89,162.9
23320, 옹진군,050005, 49세,2017,285,160,125,128,283,159,124,128.2
23320, 옹진군,055,50~54세,2017,1586,898,688,130.5,1578,895,683,131
23320, 옹진군,055001, 50세,2017,298,179,119,150.4,296,178,118,150.8
23320, 옹진군,055002, 51세,2017,286,168,118,142.4,285,168,117,143.6
23320, 옹진군,055003, 52세,2017,322,172,150,114.7,320,171,149,114.8
23320, 옹진군,055004, 53세,2017,312,172,140,122.9,311,171,140,122.1
23320, 옹진군,055005, 54세,2017,368,207,161,128.6,366,207,159,130.2
23320, 옹진군,060,55~59세,2017,2033,1146,887,129.2,2026,1144,882,129.7
23320, 옹진군,060001, 55세,2017,400,236,164,143.9,396,235,161,146
23320, 옹진군,060002, 56세,2017,450,255,195,130.8,450,255,195,130.8
23320, 옹진군,060003, 57세,2017,416,238,178,133.7,415,238,177,134.5
23320, 옹진군,060004, 58세,2017,398,212,186,114,396,211,185,114.1
23320, 옹진군,060005, 59세,2017,369,205,164,125,369,205,164,125
23320, 옹진군,065,60~64세,2017,1779,933,846,110.3,1767,930,837,111.1
23320, 옹진군,065001, 60세,2017,380,213,167,127.5,377,212,165,128.5
23320, 옹진군,065002, 61세,2017,400,200,200,100,399,200,199,100.5
23320, 옹진군,065003, 62세,2017,416,213,203,104.9,411,212,199,106.5
23320, 옹진군,065004, 63세,2017,310,152,158,96.2,308,151,157,96.2
23320, 옹진군,065005, 64세,2017,273,155,118,131.4,272,155,117,132.5
23320, 옹진군,070,65~69세,2017,1254,645,609,105.9,1251,645,606,106.4
23320, 옹진군,070001, 65세,2017,318,160,158,101.3,318,160,158,101.3
23320, 옹진군,070002, 66세,2017,186,84,102,82.4,185,84,101,83.2
23320, 옹진군,070003, 67세,2017,281,163,118,138.1,280,163,117,139.3
23320, 옹진군,070004, 68세,2017,265,144,121,119,264,144,120,120
23320, 옹진군,070005, 69세,2017,204,94,110,85.5,204,94,110,85.5
23320, 옹진군,075,70~74세,2017,1126,544,582,93.5,1124,542,582,93.1
23320, 옹진군,075001, 70세,2017,310,146,164,89,309,145,164,88.4
23320, 옹진군,075002, 71세,2017,225,108,117,92.3,225,108,117,92.3
23320, 옹진군,075003, 72세,2017,223,112,111,100.9,223,112,111,100.9
23320, 옹진군,075004, 73세,2017,172,87,85,102.4,172,87,85,102.4
23320, 옹진군,075005, 74세,2017,196,91,105,86.7,195,90,105,85.7
23320, 옹진군,080,75~79세,2017,866,389,477,81.6,866,389,477,81.6
23320, 옹진군,080001, 75세,2017,220,100,120,83.3,220,100,120,83.3
23320, 옹진군,080002, 76세,2017,180,88,92,95.7,180,88,92,95.7
23320, 옹진군,080003, 77세,2017,162,84,78,107.7,162,84,78,107.7
23320, 옹진군,080004, 78세,2017,154,57,97,58.8,154,57,97,58.8
23320, 옹진군,080005, 79세,2017,150,60,90,66.7,150,60,90,66.7
23320, 옹진군,085,80~84세,2017,621,239,382,62.6,621,239,382,62.6
23320, 옹진군,085001, 80세,2017,145,58,87,66.7,145,58,87,66.7
23320, 옹진군,085002, 81세,2017,146,52,94,55.3,146,52,94,55.3
23320, 옹진군,085003, 82세,2017,117,44,73,60.3,117,44,73,60.3
23320, 옹진군,085004, 83세,2017,114,41,73,56.2,114,41,73,56.2
23320, 옹진군,085005, 84세,2017,99,44,55,80,99,44,55,80
23320, 옹진군,090,85~89세,2017,342,87,255,34.1,342,87,255,34.1
23320, 옹진군,090001, 85세,2017,89,25,64,39.1,89,25,64,39.1
23320, 옹진군,090002, 86세,2017,81,20,61,32.8,81,20,61,32.8
23320, 옹진군,090003, 87세,2017,62,9,53,17,62,9,53,17
23320, 옹진군,090004, 88세,2017,66,23,43,53.5,66,23,43,53.5
23320, 옹진군,090005, 89세,2017,44,10,34,29.4,44,10,34,29.4
23320, 옹진군,095,90~94세,2017,130,29,101,28.7,130,29,101,28.7
23320, 옹진군,095001, 90세,2017,44,10,34,29.4,44,10,34,29.4
23320, 옹진군,095002, 91세,2017,23,6,17,35.3,23,6,17,35.3
23320, 옹진군,095003, 92세,2017,33,7,26,26.9,33,7,26,26.9
23320, 옹진군,095004, 93세,2017,17,X,14,21.4,17,X,14,21.4
23320, 옹진군,095005, 94세,2017,13,X,10,30,13,X,10,30
23320, 옹진군,100,95~99세,2017,33,11,22,50,33,11,22,50
23320, 옹진군,100001, 95세,2017,16,X,13,23.1,16,X,13,23.1
23320, 옹진군,100002, 96세,2017,9,X,5,80,9,X,5,80
23320, 옹진군,100003, 97세,2017,6,X,X,100,6,X,X,100
23320, 옹진군,100004, 98세,2017,X,X,X,0,X,X,X,0
23320, 옹진군,100005, 99세,2017,X,X,X,,X,X,X,
23320, 옹진군,101,100세이상,2017,6,X,X,50,6,X,X,50
23320, 옹진군,102,15세미만,2017,1745,882,863,102.2,1745,882,863,102.2
23320, 옹진군,103,15~64세,2017,13171,8176,4995,163.7,12964,8029,4935,162.7
23320, 옹진군,104,65세이상,2017,4378,1946,2432,80,4373,1944,2429,80
23320, 옹진군,086,85세이상,2017,511,129,382,33.8,511,129,382,33.8
23320, 옹진군,126,평균연령,2017,47.5,44.9,50.9,,47.6,45.1,50.9,
23320, 옹진군,127,중위연령,2017,50.4,46.3,55.1,,50.7,46.7,55.2,
24,광주광역시,000,합계,2017,1496172,745122,751050,99.2,1470120,730590,739530,98.8
24,광주광역시,005,0~4세,2017,62390,32071,30319,105.8,61966,31851,30115,105.8
24,광주광역시,005001, 0세,2017,10496,5473,5023,109,10401,5428,4973,109.1
24,광주광역시,005002, 1세,2017,12051,6116,5935,103,11968,6071,5897,103
24,광주광역시,005003, 2세,2017,12994,6729,6265,107.4,12908,6682,6226,107.3
24,광주광역시,005004, 3세,2017,13352,6789,6563,103.4,13263,6739,6524,103.3
24,광주광역시,005005, 4세,2017,13497,6964,6533,106.6,13426,6931,6495,106.7
24,광주광역시,010,5~9세,2017,73720,38125,35595,107.1,73463,37996,35467,107.1
24,광주광역시,010001, 5세,2017,15116,7866,7250,108.5,15040,7826,7214,108.5
24,광주광역시,010002, 6세,2017,14960,7738,7222,107.1,14899,7703,7196,107
24,광주광역시,010003, 7세,2017,14549,7485,7064,106,14500,7462,7038,106
24,광주광역시,010004, 8세,2017,14210,7312,6898,106,14179,7301,6878,106.2
24,광주광역시,010005, 9세,2017,14885,7724,7161,107.9,14845,7704,7141,107.9
24,광주광역시,015,10~14세,2017,76924,40081,36843,108.8,76739,39989,36750,108.8
24,광주광역시,015001, 10세,2017,15794,8209,7585,108.2,15762,8195,7567,108.3
24,광주광역시,015002, 11세,2017,14529,7558,6971,108.4,14481,7534,6947,108.4
24,광주광역시,015003, 12세,2017,14338,7426,6912,107.4,14305,7408,6897,107.4
24,광주광역시,015004, 13세,2017,15657,8140,7517,108.3,15628,8120,7508,108.2
24,광주광역시,015005, 14세,2017,16606,8748,7858,111.3,16563,8732,7831,111.5
24,광주광역시,020,15~19세,2017,101974,52426,49548,105.8,101208,52003,49205,105.7
24,광주광역시,020001, 15세,2017,16945,8787,8158,107.7,16913,8766,8147,107.6
24,광주광역시,020002, 16세,2017,19217,9939,9278,107.1,19168,9911,9257,107.1
24,광주광역시,020003, 17세,2017,21458,11190,10268,109,21396,11167,10229,109.2
24,광주광역시,020004, 18세,2017,21569,11092,10477,105.9,21381,10984,10397,105.6
24,광주광역시,020005, 19세,2017,22785,11418,11367,100.4,22350,11175,11175,100
24,광주광역시,025,20~24세,2017,119367,62113,57254,108.5,114650,59629,55021,108.4
24,광주광역시,025001, 20세,2017,23550,11969,11581,103.4,22861,11646,11215,103.8
24,광주광역시,025002, 21세,2017,24449,12707,11742,108.2,23528,12225,11303,108.2
24,광주광역시,025003, 22세,2017,24497,12471,12026,103.7,23515,11970,11545,103.7
24,광주광역시,025004, 23세,2017,23903,12712,11191,113.6,22844,12129,10715,113.2
24,광주광역시,025005, 24세,2017,22968,12254,10714,114.4,21902,11659,10243,113.8
24,광주광역시,030,25~29세,2017,97045,50937,46108,110.5,91856,47859,43997,108.8
24,광주광역시,030001, 25세,2017,22549,11916,10633,112.1,21476,11268,10208,110.4
24,광주광역시,030002, 26세,2017,20139,10587,9552,110.8,19097,9978,9119,109.4
24,광주광역시,030003, 27세,2017,19018,10036,8982,111.7,17932,9404,8528,110.3
24,광주광역시,030004, 28세,2017,18071,9448,8623,109.6,17026,8814,8212,107.3
24,광주광역시,030005, 29세,2017,17268,8950,8318,107.6,16325,8395,7930,105.9
24,광주광역시,035,30~34세,2017,95426,49153,46273,106.2,91459,46800,44659,104.8
24,광주광역시,035001, 30세,2017,17718,9098,8620,105.5,16721,8498,8223,103.3
24,광주광역시,035002, 31세,2017,17922,9183,8739,105.1,17125,8723,8402,103.8
24,광주광역시,035003, 32세,2017,18075,9359,8716,107.4,17303,8897,8406,105.8
24,광주광역시,035004, 33세,2017,19793,10230,9563,107,19066,9809,9257,106
24,광주광역시,035005, 34세,2017,21918,11283,10635,106.1,21244,10873,10371,104.8
24,광주광역시,040,35~39세,2017,118159,59325,58834,100.8,115375,57623,57752,99.8
24,광주광역시,040001, 35세,2017,24333,12372,11961,103.4,23669,11953,11716,102
24,광주광역시,040002, 36세,2017,23393,11844,11549,102.6,22817,11488,11329,101.4
24,광주광역시,040003, 37세,2017,24445,12131,12314,98.5,23910,11808,12102,97.6
24,광주광역시,040004, 38세,2017,23999,11933,12066,98.9,23490,11620,11870,97.9
24,광주광역시,040005, 39세,2017,21989,11045,10944,100.9,21489,10754,10735,100.2
24,광주광역시,045,40~44세,2017,122387,61443,60944,100.8,120315,60271,60044,100.4
24,광주광역시,045001, 40세,2017,23053,11560,11493,100.6,22626,11310,11316,99.9
24,광주광역시,045002, 41세,2017,23033,11663,11370,102.6,22585,11408,11177,102.1
24,광주광역시,045003, 42세,2017,23488,11791,11697,100.8,23074,11562,11512,100.4
24,광주광역시,045004, 43세,2017,26569,13437,13132,102.3,26177,13226,12951,102.1
24,광주광역시,045005, 44세,2017,26244,12992,13252,98,25853,12765,13088,97.5
24,광주광역시,050,45~49세,2017,135394,67815,67579,100.3,133468,66749,66719,100
24,광주광역시,050001, 45세,2017,26616,13327,13289,100.3,26202,13085,13117,99.8
24,광주광역시,050002, 46세,2017,28076,14030,14046,99.9,27674,13805,13869,99.5
24,광주광역시,050003, 47세,2017,26984,13559,13425,101,26600,13352,13248,100.8
24,광주광역시,050004, 48세,2017,26426,13338,13088,101.9,26065,13132,12933,101.5
24,광주광역시,050005, 49세,2017,27292,13561,13731,98.8,26927,13375,13552,98.7
24,광주광역시,055,50~54세,2017,118620,59695,58925,101.3,117057,58950,58107,101.5
24,광주광역시,055001, 50세,2017,24528,12211,12317,99.1,24215,12057,12158,99.2
24,광주광역시,055002, 51세,2017,24625,12502,12123,103.1,24311,12356,11955,103.4
24,광주광역시,055003, 52세,2017,23910,11911,11999,99.3,23591,11752,11839,99.3
24,광주광역시,055004, 53세,2017,22041,11153,10888,102.4,21715,10995,10720,102.6
24,광주광역시,055005, 54세,2017,23516,11918,11598,102.8,23225,11790,11435,103.1
24,광주광역시,060,55~59세,2017,112903,55781,57122,97.7,111863,55259,56604,97.6
24,광주광역시,060001, 55세,2017,22285,11229,11056,101.6,22038,11107,10931,101.6
24,광주광역시,060002, 56세,2017,23834,11863,11971,99.1,23642,11772,11870,99.2
24,광주광역시,060003, 57세,2017,24895,12205,12690,96.2,24662,12088,12574,96.1
24,광주광역시,060004, 58세,2017,22070,10801,11269,95.8,21889,10704,11185,95.7
24,광주광역시,060005, 59세,2017,19819,9683,10136,95.5,19632,9588,10044,95.5
24,광주광역시,065,60~64세,2017,79969,38949,41020,95,79317,38624,40693,94.9
24,광주광역시,065001, 60세,2017,19249,9481,9768,97.1,19080,9396,9684,97
24,광주광역시,065002, 61세,2017,16526,8213,8313,98.8,16373,8136,8237,98.8
24,광주광역시,065003, 62세,2017,17509,8435,9074,93,17375,8368,9007,92.9
24,광주광역시,065004, 63세,2017,14096,6839,7257,94.2,13991,6787,7204,94.2
24,광주광역시,065005, 64세,2017,12589,5981,6608,90.5,12498,5937,6561,90.5
24,광주광역시,070,65~69세,2017,60530,28669,31861,90,60235,28534,31701,90
24,광주광역시,070001, 65세,2017,13773,6604,7169,92.1,13674,6559,7115,92.2
24,광주광역시,070002, 66세,2017,11386,5410,5976,90.5,11323,5387,5936,90.8
24,광주광역시,070003, 67세,2017,11793,5595,6198,90.3,11739,5570,6169,90.3
24,광주광역시,070004, 68세,2017,12288,5757,6531,88.1,12240,5730,6510,88
24,광주광역시,070005, 69세,2017,11290,5303,5987,88.6,11259,5288,5971,88.6
24,광주광역시,075,70~74세,2017,45550,20888,24662,84.7,45436,20841,24595,84.7
24,광주광역시,075001, 70세,2017,11692,5383,6309,85.3,11655,5368,6287,85.4
24,광주광역시,075002, 71세,2017,8923,4213,4710,89.4,8897,4202,4695,89.5
24,광주광역시,075003, 72세,2017,8607,3921,4686,83.7,8590,3917,4673,83.8
24,광주광역시,075004, 73세,2017,8151,3701,4450,83.2,8131,3691,4440,83.1
24,광주광역시,075005, 74세,2017,8177,3670,4507,81.4,8163,3663,4500,81.4
24,광주광역시,080,75~79세,2017,38509,16167,22342,72.4,38448,16141,22307,72.4
24,광주광역시,080001, 75세,2017,10590,4726,5864,80.6,10579,4724,5855,80.7
24,광주광역시,080002, 76세,2017,7987,3372,4615,73.1,7973,3366,4607,73.1
24,광주광역시,080003, 77세,2017,7014,2832,4182,67.7,7000,2826,4174,67.7
24,광주광역시,080004, 78세,2017,6795,2801,3994,70.1,6787,2796,3991,70.1
24,광주광역시,080005, 79세,2017,6123,2436,3687,66.1,6109,2429,3680,66
24,광주광역시,085,80~84세,2017,22271,7798,14473,53.9,22247,7791,14456,53.9
24,광주광역시,085001, 80세,2017,5590,2130,3460,61.6,5587,2130,3457,61.6
24,광주광역시,085002, 81세,2017,4742,1703,3039,56,4739,1703,3036,56.1
24,광주광역시,085003, 82세,2017,4596,1616,2980,54.2,4589,1614,2975,54.3
24,광주광역시,085004, 83세,2017,4112,1358,2754,49.3,4104,1354,2750,49.2
24,광주광역시,085005, 84세,2017,3231,991,2240,44.2,3228,990,2238,44.2
24,광주광역시,090,85~89세,2017,10576,2841,7735,36.7,10565,2835,7730,36.7
24,광주광역시,090001, 85세,2017,2830,848,1982,42.8,2826,845,1981,42.7
24,광주광역시,090002, 86세,2017,2274,610,1664,36.7,2271,609,1662,36.6
24,광주광역시,090003, 87세,2017,2305,554,1751,31.6,2304,553,1751,31.6
24,광주광역시,090004, 88세,2017,1773,487,1286,37.9,1772,487,1285,37.9
24,광주광역시,090005, 89세,2017,1394,342,1052,32.5,1392,341,1051,32.4
24,광주광역시,095,90~94세,2017,3562,728,2834,25.7,3558,728,2830,25.7
24,광주광역시,095001, 90세,2017,1125,241,884,27.3,1124,241,883,27.3
24,광주광역시,095002, 91세,2017,828,179,649,27.6,828,179,649,27.6
24,광주광역시,095003, 92세,2017,678,127,551,23,676,127,549,23.1
24,광주광역시,095004, 93세,2017,405,89,316,28.2,405,89,316,28.2
24,광주광역시,095005, 94세,2017,526,92,434,21.2,525,92,433,21.2
24,광주광역시,100,95~99세,2017,804,109,695,15.7,803,109,694,15.7
24,광주광역시,100001, 95세,2017,315,50,265,18.9,315,50,265,18.9
24,광주광역시,100002, 96세,2017,202,22,180,12.2,202,22,180,12.2
24,광주광역시,100003, 97세,2017,135,16,119,13.4,135,16,119,13.4
24,광주광역시,100004, 98세,2017,97,17,80,21.3,96,17,79,21.5
24,광주광역시,100005, 99세,2017,55,X,51,7.8,55,X,51,7.8
24,광주광역시,101,100세이상,2017,92,8,84,9.5,92,8,84,9.5
24,광주광역시,102,15세미만,2017,213034,110277,102757,107.3,212168,109836,102332,107.3
24,광주광역시,103,15~64세,2017,1101244,557637,543607,102.6,1076568,543767,532801,102.1
24,광주광역시,104,65세이상,2017,181894,77208,104686,73.8,181384,76987,104397,73.7
24,광주광역시,086,85세이상,2017,15034,3686,11348,32.5,15018,3680,11338,32.5
24,광주광역시,126,평균연령,2017,39.6,38.5,40.7,,39.7,38.6,40.8,
24,광주광역시,127,중위연령,2017,40.1,38.9,41.3,,40.4,39.2,41.5,
24010, 동구,000,합계,2017,100914,50531,50383,100.3,99346,49730,49616,100.2
24010, 동구,005,0~4세,2017,3127,1632,1495,109.2,3115,1625,1490,109.1
24010, 동구,005001, 0세,2017,557,295,262,112.6,553,293,260,112.7
24010, 동구,005002, 1세,2017,580,294,286,102.8,578,292,286,102.1
24010, 동구,005003, 2세,2017,664,358,306,117,661,356,305,116.7
24010, 동구,005004, 3세,2017,676,356,320,111.3,675,356,319,111.6
24010, 동구,005005, 4세,2017,650,329,321,102.5,648,328,320,102.5
24010, 동구,010,5~9세,2017,3003,1537,1466,104.8,2999,1533,1466,104.6
24010, 동구,010001, 5세,2017,653,336,317,106,650,333,317,105
24010, 동구,010002, 6세,2017,675,337,338,99.7,675,337,338,99.7
24010, 동구,010003, 7세,2017,583,307,276,111.2,583,307,276,111.2
24010, 동구,010004, 8세,2017,522,270,252,107.1,522,270,252,107.1
24010, 동구,010005, 9세,2017,570,287,283,101.4,569,286,283,101.1
24010, 동구,015,10~14세,2017,3024,1601,1423,112.5,3020,1600,1420,112.7
24010, 동구,015001, 10세,2017,592,312,280,111.4,592,312,280,111.4
24010, 동구,015002, 11세,2017,571,296,275,107.6,569,296,273,108.4
24010, 동구,015003, 12세,2017,542,289,253,114.2,540,288,252,114.3
24010, 동구,015004, 13세,2017,643,327,316,103.5,643,327,316,103.5
24010, 동구,015005, 14세,2017,676,377,299,126.1,676,377,299,126.1
24010, 동구,020,15~19세,2017,5742,3039,2703,112.4,5675,3004,2671,112.5
24010, 동구,020001, 15세,2017,736,374,362,103.3,733,372,361,103
24010, 동구,020002, 16세,2017,875,467,408,114.5,873,467,406,115
24010, 동구,020003, 17세,2017,1052,580,472,122.9,1044,577,467,123.6
24010, 동구,020004, 18세,2017,1235,641,594,107.9,1223,637,586,108.7
24010, 동구,020005, 19세,2017,1844,977,867,112.7,1802,951,851,111.8
24010, 동구,025,20~24세,2017,9398,4780,4618,103.5,8981,4607,4374,105.3
24010, 동구,025001, 20세,2017,1739,821,918,89.4,1657,785,872,90
24010, 동구,025002, 21세,2017,1773,827,946,87.4,1688,792,896,88.4
24010, 동구,025003, 22세,2017,2005,1013,992,102.1,1923,985,938,105
24010, 동구,025004, 23세,2017,2025,1081,944,114.5,1937,1041,896,116.2
24010, 동구,025005, 24세,2017,1856,1038,818,126.9,1776,1004,772,130.1
24010, 동구,030,25~29세,2017,7335,3999,3336,119.9,7007,3813,3194,119.4
24010, 동구,030001, 25세,2017,1827,1020,807,126.4,1740,972,768,126.6
24010, 동구,030002, 26세,2017,1487,820,667,122.9,1424,790,634,124.6
24010, 동구,030003, 27세,2017,1373,742,631,117.6,1316,711,605,117.5
24010, 동구,030004, 28세,2017,1405,761,644,118.2,1331,714,617,115.7
24010, 동구,030005, 29세,2017,1243,656,587,111.8,1196,626,570,109.8
24010, 동구,035,30~34세,2017,6240,3328,2912,114.3,6039,3225,2814,114.6
24010, 동구,035001, 30세,2017,1256,623,633,98.4,1207,596,611,97.5
24010, 동구,035002, 31세,2017,1221,663,558,118.8,1174,639,535,119.4
24010, 동구,035003, 32세,2017,1214,656,558,117.6,1174,639,535,119.4
24010, 동구,035004, 33세,2017,1249,689,560,123,1215,672,543,123.8
24010, 동구,035005, 34세,2017,1300,697,603,115.6,1269,679,590,115.1
24010, 동구,040,35~39세,2017,6479,3536,2943,120.1,6349,3456,2893,119.5
24010, 동구,040001, 35세,2017,1413,753,660,114.1,1381,735,646,113.8
24010, 동구,040002, 36세,2017,1363,768,595,129.1,1331,747,584,127.9
24010, 동구,040003, 37세,2017,1279,680,599,113.5,1257,665,592,112.3
24010, 동구,040004, 38세,2017,1268,693,575,120.5,1246,682,564,120.9
24010, 동구,040005, 39세,2017,1156,642,514,124.9,1134,627,507,123.7
24010, 동구,045,40~44세,2017,6094,3300,2794,118.1,6009,3251,2758,117.9
24010, 동구,045001, 40세,2017,1184,653,531,123,1169,646,523,123.5
24010, 동구,045002, 41세,2017,1142,627,515,121.7,1130,621,509,122
24010, 동구,045003, 42세,2017,1144,622,522,119.2,1120,609,511,119.2
24010, 동구,045004, 43세,2017,1265,689,576,119.6,1252,681,571,119.3
24010, 동구,045005, 44세,2017,1359,709,650,109.1,1338,694,644,107.8
24010, 동구,050,45~49세,2017,7107,3724,3383,110.1,7019,3670,3349,109.6
24010, 동구,050001, 45세,2017,1336,722,614,117.6,1316,707,609,116.1
24010, 동구,050002, 46세,2017,1478,777,701,110.8,1456,765,691,110.7
24010, 동구,050003, 47세,2017,1416,739,677,109.2,1404,729,675,108
24010, 동구,050004, 48세,2017,1401,738,663,111.3,1388,734,654,112.2
24010, 동구,050005, 49세,2017,1476,748,728,102.7,1455,735,720,102.1
24010, 동구,055,50~54세,2017,7150,3582,3568,100.4,7052,3541,3511,100.9
24010, 동구,055001, 50세,2017,1355,714,641,111.4,1335,708,627,112.9
24010, 동구,055002, 51세,2017,1430,717,713,100.6,1419,711,708,100.4
24010, 동구,055003, 52세,2017,1432,699,733,95.4,1412,689,723,95.3
24010, 동구,055004, 53세,2017,1354,675,679,99.4,1333,666,667,99.9
24010, 동구,055005, 54세,2017,1579,777,802,96.9,1553,767,786,97.6
24010, 동구,060,55~59세,2017,8462,4099,4363,93.9,8399,4067,4332,93.9
24010, 동구,060001, 55세,2017,1506,747,759,98.4,1495,741,754,98.3
24010, 동구,060002, 56세,2017,1722,828,894,92.6,1713,823,890,92.5
24010, 동구,060003, 57세,2017,1860,874,986,88.6,1848,870,978,89
24010, 동구,060004, 58세,2017,1711,827,884,93.6,1696,819,877,93.4
24010, 동구,060005, 59세,2017,1663,823,840,98,1647,814,833,97.7
24010, 동구,065,60~64세,2017,7376,3537,3839,92.1,7343,3522,3821,92.2
24010, 동구,065001, 60세,2017,1637,817,820,99.6,1631,814,817,99.6
24010, 동구,065002, 61세,2017,1483,708,775,91.4,1477,706,771,91.6
24010, 동구,065003, 62세,2017,1626,762,864,88.2,1619,759,860,88.3
24010, 동구,065004, 63세,2017,1407,677,730,92.7,1400,673,727,92.6
24010, 동구,065005, 64세,2017,1223,573,650,88.2,1216,570,646,88.2
24010, 동구,070,65~69세,2017,6088,2807,3281,85.6,6074,2796,3278,85.3
24010, 동구,070001, 65세,2017,1348,623,725,85.9,1343,619,724,85.5
24010, 동구,070002, 66세,2017,1097,503,594,84.7,1096,503,593,84.8
24010, 동구,070003, 67세,2017,1173,544,629,86.5,1170,542,628,86.3
24010, 동구,070004, 68세,2017,1295,597,698,85.5,1294,596,698,85.4
24010, 동구,070005, 69세,2017,1175,540,635,85,1171,536,635,84.4
24010, 동구,075,70~74세,2017,5104,2299,2805,82,5093,2294,2799,82
24010, 동구,075001, 70세,2017,1281,559,722,77.4,1279,559,720,77.6
24010, 동구,075002, 71세,2017,999,439,560,78.4,995,437,558,78.3
24010, 동구,075003, 72세,2017,974,433,541,80,971,431,540,79.8
24010, 동구,075004, 73세,2017,934,460,474,97,932,459,473,97
24010, 동구,075005, 74세,2017,916,408,508,80.3,916,408,508,80.3
24010, 동구,080,75~79세,2017,4657,2117,2540,83.3,4651,2115,2536,83.4
24010, 동구,080001, 75세,2017,1260,569,691,82.3,1258,569,689,82.6
24010, 동구,080002, 76세,2017,988,450,538,83.6,987,450,537,83.8
24010, 동구,080003, 77세,2017,867,394,473,83.3,866,393,473,83.1
24010, 동구,080004, 78세,2017,792,349,443,78.8,791,348,443,78.6
24010, 동구,080005, 79세,2017,750,355,395,89.9,749,355,394,90.1
24010, 동구,085,80~84세,2017,2686,1096,1590,68.9,2681,1095,1586,69
24010, 동구,085001, 80세,2017,653,280,373,75.1,652,280,372,75.3
24010, 동구,085002, 81세,2017,610,259,351,73.8,608,259,349,74.2
24010, 동구,085003, 82세,2017,513,207,306,67.6,513,207,306,67.6
24010, 동구,085004, 83세,2017,507,198,309,64.1,505,197,308,64
24010, 동구,085005, 84세,2017,403,152,251,60.6,403,152,251,60.6
24010, 동구,090,85~89세,2017,1264,393,871,45.1,1262,391,871,44.9
24010, 동구,090001, 85세,2017,340,111,229,48.5,340,111,229,48.5
24010, 동구,090002, 86세,2017,266,89,177,50.3,265,88,177,49.7
24010, 동구,090003, 87세,2017,274,79,195,40.5,273,78,195,40
24010, 동구,090004, 88세,2017,207,59,148,39.9,207,59,148,39.9
24010, 동구,090005, 89세,2017,177,55,122,45.1,177,55,122,45.1
24010, 동구,095,90~94세,2017,469,109,360,30.3,469,109,360,30.3
24010, 동구,095001, 90세,2017,147,29,118,24.6,147,29,118,24.6
24010, 동구,095002, 91세,2017,103,29,74,39.2,103,29,74,39.2
24010, 동구,095003, 92세,2017,87,19,68,27.9,87,19,68,27.9
24010, 동구,095004, 93세,2017,66,19,47,40.4,66,19,47,40.4
24010, 동구,095005, 94세,2017,66,13,53,24.5,66,13,53,24.5
24010, 동구,100,95~99세,2017,97,16,81,19.8,97,16,81,19.8
24010, 동구,100001, 95세,2017,34,X,30,13.3,34,X,30,13.3
24010, 동구,100002, 96세,2017,22,X,19,15.8,22,X,19,15.8
24010, 동구,100003, 97세,2017,14,X,10,40,14,X,10,40
24010, 동구,100004, 98세,2017,21,5,16,31.3,21,5,16,31.3
24010, 동구,100005, 99세,2017,6,X,6,0,6,X,6,0
24010, 동구,101,100세이상,2017,12,X,12,0,12,X,12,0
24010, 동구,102,15세미만,2017,9154,4770,4384,108.8,9134,4758,4376,108.7
24010, 동구,103,15~64세,2017,71383,36924,34459,107.2,69873,36156,33717,107.2
24010, 동구,104,65세이상,2017,20377,8837,11540,76.6,20339,8816,11523,76.5
24010, 동구,086,85세이상,2017,1842,518,1324,39.1,1840,516,1324,39
24010, 동구,126,평균연령,2017,44.3,42.9,45.8,,44.5,43,46,
24010, 동구,127,중위연령,2017,45,42.9,47.3,,45.4,43.2,47.6,
24020, 서구,000,합계,2017,306054,151371,154683,97.9,304048,150450,153598,98
24020, 서구,005,0~4세,2017,11841,6094,5747,106,11814,6080,5734,106
24020, 서구,005001, 0세,2017,2058,1100,958,114.8,2052,1098,954,115.1
24020, 서구,005002, 1세,2017,2292,1168,1124,103.9,2283,1162,1121,103.7
24020, 서구,005003, 2세,2017,2363,1222,1141,107.1,2359,1219,1140,106.9
24020, 서구,005004, 3세,2017,2505,1250,1255,99.6,2500,1248,1252,99.7
24020, 서구,005005, 4세,2017,2623,1354,1269,106.7,2620,1353,1267,106.8
24020, 서구,010,5~9세,2017,14226,7393,6833,108.2,14211,7380,6831,108
24020, 서구,010001, 5세,2017,2851,1493,1358,109.9,2842,1485,1357,109.4
24020, 서구,010002, 6세,2017,2903,1507,1396,108,2900,1505,1395,107.9
24020, 서구,010003, 7세,2017,2738,1430,1308,109.3,2735,1427,1308,109.1
24020, 서구,010004, 8세,2017,2808,1452,1356,107.1,2808,1452,1356,107.1
24020, 서구,010005, 9세,2017,2926,1511,1415,106.8,2926,1511,1415,106.8
24020, 서구,015,10~14세,2017,15936,8344,7592,109.9,15928,8341,7587,109.9
24020, 서구,015001, 10세,2017,3227,1669,1558,107.1,3226,1669,1557,107.2
24020, 서구,015002, 11세,2017,2990,1591,1399,113.7,2987,1590,1397,113.8
24020, 서구,015003, 12세,2017,2983,1524,1459,104.5,2983,1524,1459,104.5
24020, 서구,015004, 13세,2017,3251,1713,1538,111.4,3250,1712,1538,111.3
24020, 서구,015005, 14세,2017,3485,1847,1638,112.8,3482,1846,1636,112.8
24020, 서구,020,15~19세,2017,20396,10698,9698,110.3,20383,10691,9692,110.3
24020, 서구,020001, 15세,2017,3688,1990,1698,117.2,3687,1990,1697,117.3
24020, 서구,020002, 16세,2017,4025,2027,1998,101.5,4022,2025,1997,101.4
24020, 서구,020003, 17세,2017,4463,2328,2135,109,4461,2327,2134,109
24020, 서구,020004, 18세,2017,4398,2338,2060,113.5,4394,2335,2059,113.4
24020, 서구,020005, 19세,2017,3822,2015,1807,111.5,3819,2014,1805,111.6
24020, 서구,025,20~24세,2017,22467,11798,10669,110.6,22223,11701,10522,111.2
24020, 서구,025001, 20세,2017,4301,2359,1942,121.5,4286,2351,1935,121.5
24020, 서구,025002, 21세,2017,4549,2536,2013,126,4520,2526,1994,126.7
24020, 서구,025003, 22세,2017,4563,2336,2227,104.9,4507,2315,2192,105.6
24020, 서구,025004, 23세,2017,4577,2312,2265,102.1,4520,2290,2230,102.7
24020, 서구,025005, 24세,2017,4477,2255,2222,101.5,4390,2219,2171,102.2
24020, 서구,030,25~29세,2017,20147,10169,9978,101.9,19783,10019,9764,102.6
24020, 서구,030001, 25세,2017,4537,2181,2356,92.6,4459,2151,2308,93.2
24020, 서구,030002, 26세,2017,4188,2102,2086,100.8,4113,2076,2037,101.9
24020, 서구,030003, 27세,2017,4016,2131,1885,113.1,3943,2096,1847,113.5
24020, 서구,030004, 28세,2017,3839,1928,1911,100.9,3767,1899,1868,101.7
24020, 서구,030005, 29세,2017,3567,1827,1740,105,3501,1797,1704,105.5
24020, 서구,035,30~34세,2017,19496,9801,9695,101.1,19205,9650,9555,101
24020, 서구,035001, 30세,2017,3607,1811,1796,100.8,3527,1770,1757,100.7
24020, 서구,035002, 31세,2017,3768,1880,1888,99.6,3705,1852,1853,99.9
24020, 서구,035003, 32세,2017,3707,1871,1836,101.9,3655,1846,1809,102
24020, 서구,035004, 33세,2017,3981,2000,1981,101,3929,1974,1955,101
24020, 서구,035005, 34세,2017,4433,2239,2194,102.1,4389,2208,2181,101.2
24020, 서구,040,35~39세,2017,23570,11558,12012,96.2,23345,11446,11899,96.2
24020, 서구,040001, 35세,2017,4845,2448,2397,102.1,4798,2426,2372,102.3
24020, 서구,040002, 36세,2017,4638,2336,2302,101.5,4591,2312,2279,101.4
24020, 서구,040003, 37세,2017,4868,2303,2565,89.8,4824,2284,2540,89.9
24020, 서구,040004, 38세,2017,4781,2312,2469,93.6,4727,2283,2444,93.4
24020, 서구,040005, 39세,2017,4438,2159,2279,94.7,4405,2141,2264,94.6
24020, 서구,045,40~44세,2017,25535,12488,13047,95.7,25380,12411,12969,95.7
24020, 서구,045001, 40세,2017,4703,2342,2361,99.2,4667,2321,2346,98.9
24020, 서구,045002, 41세,2017,4756,2330,2426,96,4727,2319,2408,96.3
24020, 서구,045003, 42세,2017,4890,2396,2494,96.1,4862,2384,2478,96.2
24020, 서구,045004, 43세,2017,5682,2777,2905,95.6,5652,2763,2889,95.6
24020, 서구,045005, 44세,2017,5504,2643,2861,92.4,5472,2624,2848,92.1
24020, 서구,050,45~49세,2017,29579,14565,15014,97,29365,14468,14897,97.1
24020, 서구,050001, 45세,2017,5716,2706,3010,89.9,5671,2688,2983,90.1
24020, 서구,050002, 46세,2017,6097,2982,3115,95.7,6046,2960,3086,95.9
24020, 서구,050003, 47세,2017,5879,2952,2927,100.9,5834,2931,2903,101
24020, 서구,050004, 48세,2017,5909,2942,2967,99.2,5873,2922,2951,99
24020, 서구,050005, 49세,2017,5978,2983,2995,99.6,5941,2967,2974,99.8
24020, 서구,055,50~54세,2017,25402,12694,12708,99.9,25225,12612,12613,100
24020, 서구,055001, 50세,2017,5322,2636,2686,98.1,5284,2618,2666,98.2
24020, 서구,055002, 51세,2017,5190,2621,2569,102,5158,2604,2554,102
24020, 서구,055003, 52세,2017,5071,2526,2545,99.3,5030,2509,2521,99.5
24020, 서구,055004, 53세,2017,4801,2403,2398,100.2,4770,2387,2383,100.2
24020, 서구,055005, 54세,2017,5018,2508,2510,99.9,4983,2494,2489,100.2
24020, 서구,060,55~59세,2017,23878,11626,12252,94.9,23748,11569,12179,95
24020, 서구,060001, 55세,2017,4786,2365,2421,97.7,4755,2348,2407,97.5
24020, 서구,060002, 56세,2017,5018,2479,2539,97.6,4988,2470,2518,98.1
24020, 서구,060003, 57세,2017,5254,2565,2689,95.4,5228,2554,2674,95.5
24020, 서구,060004, 58세,2017,4683,2254,2429,92.8,4662,2243,2419,92.7
24020, 서구,060005, 59세,2017,4137,1963,2174,90.3,4115,1954,2161,90.4
24020, 서구,065,60~64세,2017,16959,8277,8682,95.3,16892,8249,8643,95.4
24020, 서구,065001, 60세,2017,4156,2043,2113,96.7,4136,2037,2099,97
24020, 서구,065002, 61세,2017,3495,1733,1762,98.4,3477,1723,1754,98.2
24020, 서구,065003, 62세,2017,3746,1813,1933,93.8,3734,1808,1926,93.9
24020, 서구,065004, 63세,2017,2896,1422,1474,96.5,2889,1418,1471,96.4
24020, 서구,065005, 64세,2017,2666,1266,1400,90.4,2656,1263,1393,90.7
24020, 서구,070,65~69세,2017,12594,5985,6609,90.6,12549,5965,6584,90.6
24020, 서구,070001, 65세,2017,2916,1399,1517,92.2,2902,1393,1509,92.3
24020, 서구,070002, 66세,2017,2344,1141,1203,94.8,2329,1134,1195,94.9
24020, 서구,070003, 67세,2017,2473,1173,1300,90.2,2470,1171,1299,90.1
24020, 서구,070004, 68세,2017,2550,1201,1349,89,2542,1197,1345,89
24020, 서구,070005, 69세,2017,2311,1071,1240,86.4,2306,1070,1236,86.6
24020, 서구,075,70~74세,2017,9413,4363,5050,86.4,9399,4356,5043,86.4
24020, 서구,075001, 70세,2017,2418,1116,1302,85.7,2414,1114,1300,85.7
24020, 서구,075002, 71세,2017,1830,859,971,88.5,1826,857,969,88.4
24020, 서구,075003, 72세,2017,1822,865,957,90.4,1821,865,956,90.5
24020, 서구,075004, 73세,2017,1647,735,912,80.6,1643,732,911,80.4
24020, 서구,075005, 74세,2017,1696,788,908,86.8,1695,788,907,86.9
24020, 서구,080,75~79세,2017,7593,3245,4348,74.6,7586,3242,4344,74.6
24020, 서구,080001, 75세,2017,2056,910,1146,79.4,2056,910,1146,79.4
24020, 서구,080002, 76세,2017,1578,718,860,83.5,1575,716,859,83.4
24020, 서구,080003, 77세,2017,1394,583,811,71.9,1393,583,810,72
24020, 서구,080004, 78세,2017,1392,557,835,66.7,1391,556,835,66.6
24020, 서구,080005, 79세,2017,1173,477,696,68.5,1171,477,694,68.7
24020, 서구,085,80~84세,2017,4253,1552,2701,57.5,4245,1550,2695,57.5
24020, 서구,085001, 80세,2017,1068,417,651,64.1,1067,417,650,64.2
24020, 서구,085002, 81세,2017,908,335,573,58.5,908,335,573,58.5
24020, 서구,085003, 82세,2017,879,352,527,66.8,877,351,526,66.7
24020, 서구,085004, 83세,2017,769,251,518,48.5,766,250,516,48.4
24020, 서구,085005, 84세,2017,629,197,432,45.6,627,197,430,45.8
24020, 서구,090,85~89세,2017,1967,561,1406,39.9,1966,560,1406,39.8
24020, 서구,090001, 85세,2017,552,170,382,44.5,551,169,382,44.2
24020, 서구,090002, 86세,2017,413,120,293,41,413,120,293,41
24020, 서구,090003, 87세,2017,395,89,306,29.1,395,89,306,29.1
24020, 서구,090004, 88세,2017,352,112,240,46.7,352,112,240,46.7
24020, 서구,090005, 89세,2017,255,70,185,37.8,255,70,185,37.8
24020, 서구,095,90~94세,2017,633,138,495,27.9,632,138,494,27.9
24020, 서구,095001, 90세,2017,190,47,143,32.9,190,47,143,32.9
24020, 서구,095002, 91세,2017,157,32,125,25.6,157,32,125,25.6
24020, 서구,095003, 92세,2017,113,20,93,21.5,113,20,93,21.5
24020, 서구,095004, 93세,2017,74,18,56,32.1,74,18,56,32.1
24020, 서구,095005, 94세,2017,99,21,78,26.9,98,21,77,27.3
24020, 서구,100,95~99세,2017,147,21,126,16.7,147,21,126,16.7
24020, 서구,100001, 95세,2017,48,10,38,26.3,48,10,38,26.3
24020, 서구,100002, 96세,2017,40,5,35,14.3,40,5,35,14.3
24020, 서구,100003, 97세,2017,25,X,23,8.7,25,X,23,8.7
24020, 서구,100004, 98세,2017,22,X,19,15.8,22,X,19,15.8
24020, 서구,100005, 99세,2017,12,X,11,9.1,12,X,11,9.1
24020, 서구,101,100세이상,2017,22,X,21,4.8,22,X,21,4.8
24020, 서구,102,15세미만,2017,42003,21831,20172,108.2,41953,21801,20152,108.2
24020, 서구,103,15~64세,2017,227429,113674,113755,99.9,225549,112816,112733,100.1
24020, 서구,104,65세이상,2017,36622,15866,20756,76.4,36546,15833,20713,76.4
24020, 서구,086,85세이상,2017,2769,721,2048,35.2,2767,720,2047,35.2
24020, 서구,126,평균연령,2017,40,38.9,41,,40,38.9,41,
24020, 서구,127,중위연령,2017,41.1,39.9,42.1,,41.1,40,42.2,
24030, 남구,000,합계,2017,219256,106202,113054,93.9,217638,105561,112077,94.2
24030, 남구,005,0~4세,2017,8212,4221,3991,105.8,8193,4213,3980,105.9
24030, 남구,005001, 0세,2017,1315,716,599,119.5,1312,715,597,119.8
24030, 남구,005002, 1세,2017,1473,730,743,98.3,1470,729,741,98.4
24030, 남구,005003, 2세,2017,1776,891,885,100.7,1773,890,883,100.8
24030, 남구,005004, 3세,2017,1837,955,882,108.3,1832,952,880,108.2
24030, 남구,005005, 4세,2017,1811,929,882,105.3,1806,927,879,105.5
24030, 남구,010,5~9세,2017,10154,5220,4934,105.8,10148,5217,4931,105.8
24030, 남구,010001, 5세,2017,2090,1090,1000,109,2088,1090,998,109.2
24030, 남구,010002, 6세,2017,2024,1030,994,103.6,2023,1030,993,103.7
24030, 남구,010003, 7세,2017,2056,1044,1012,103.2,2056,1044,1012,103.2
24030, 남구,010004, 8세,2017,1949,997,952,104.7,1949,997,952,104.7
24030, 남구,010005, 9세,2017,2035,1059,976,108.5,2032,1056,976,108.2
24030, 남구,015,10~14세,2017,10519,5372,5147,104.4,10508,5365,5143,104.3
24030, 남구,015001, 10세,2017,2150,1086,1064,102.1,2149,1085,1064,102
24030, 남구,015002, 11세,2017,2020,1012,1008,100.4,2017,1010,1007,100.3
24030, 남구,015003, 12세,2017,1957,1008,949,106.2,1956,1007,949,106.1
24030, 남구,015004, 13세,2017,2189,1120,1069,104.8,2187,1118,1069,104.6
24030, 남구,015005, 14세,2017,2203,1146,1057,108.4,2199,1145,1054,108.6
24030, 남구,020,15~19세,2017,14836,7396,7440,99.4,14767,7363,7404,99.4
24030, 남구,020001, 15세,2017,2493,1256,1237,101.5,2491,1255,1236,101.5
24030, 남구,020002, 16세,2017,2831,1439,1392,103.4,2824,1436,1388,103.5
24030, 남구,020003, 17세,2017,2975,1486,1489,99.8,2965,1480,1485,99.7
24030, 남구,020004, 18세,2017,3135,1525,1610,94.7,3122,1518,1604,94.6
24030, 남구,020005, 19세,2017,3402,1690,1712,98.7,3365,1674,1691,99
24030, 남구,025,20~24세,2017,16327,8408,7919,106.2,15997,8301,7696,107.9
24030, 남구,025001, 20세,2017,3197,1646,1551,106.1,3152,1633,1519,107.5
24030, 남구,025002, 21세,2017,3294,1687,1607,105,3217,1656,1561,106.1
24030, 남구,025003, 22세,2017,3432,1689,1743,96.9,3355,1662,1693,98.2
24030, 남구,025004, 23세,2017,3259,1733,1526,113.6,3189,1710,1479,115.6
24030, 남구,025005, 24세,2017,3145,1653,1492,110.8,3084,1640,1444,113.6
24030, 남구,030,25~29세,2017,12554,6401,6153,104,12316,6323,5993,105.5
24030, 남구,030001, 25세,2017,2891,1492,1399,106.6,2830,1478,1352,109.3
24030, 남구,030002, 26세,2017,2645,1320,1325,99.6,2594,1303,1291,100.9
24030, 남구,030003, 27세,2017,2520,1261,1259,100.2,2472,1242,1230,101
24030, 남구,030004, 28세,2017,2297,1199,1098,109.2,2269,1188,1081,109.9
24030, 남구,030005, 29세,2017,2201,1129,1072,105.3,2151,1112,1039,107
24030, 남구,035,30~34세,2017,12444,6194,6250,99.1,12258,6122,6136,99.8
24030, 남구,035001, 30세,2017,2217,1106,1111,99.5,2177,1093,1084,100.8
24030, 남구,035002, 31세,2017,2281,1150,1131,101.7,2236,1127,1109,101.6
24030, 남구,035003, 32세,2017,2368,1162,1206,96.4,2332,1151,1181,97.5
24030, 남구,035004, 33세,2017,2609,1295,1314,98.6,2569,1282,1287,99.6
24030, 남구,035005, 34세,2017,2969,1481,1488,99.5,2944,1469,1475,99.6
24030, 남구,040,35~39세,2017,16004,7916,8088,97.9,15876,7863,8013,98.1
24030, 남구,040001, 35세,2017,3276,1596,1680,95,3251,1584,1667,95
24030, 남구,040002, 36세,2017,3294,1630,1664,98,3268,1621,1647,98.4
24030, 남구,040003, 37세,2017,3262,1618,1644,98.4,3241,1612,1629,99
24030, 남구,040004, 38세,2017,3213,1619,1594,101.6,3186,1606,1580,101.6
24030, 남구,040005, 39세,2017,2959,1453,1506,96.5,2930,1440,1490,96.6
24030, 남구,045,40~44세,2017,16398,8128,8270,98.3,16265,8073,8192,98.5
24030, 남구,045001, 40세,2017,3148,1540,1608,95.8,3124,1531,1593,96.1
24030, 남구,045002, 41세,2017,3126,1574,1552,101.4,3096,1563,1533,102
24030, 남구,045003, 42세,2017,3129,1529,1600,95.6,3103,1519,1584,95.9
24030, 남구,045004, 43세,2017,3495,1780,1715,103.8,3467,1769,1698,104.2
24030, 남구,045005, 44세,2017,3500,1705,1795,95,3475,1691,1784,94.8
24030, 남구,050,45~49세,2017,18465,8934,9531,93.7,18322,8866,9456,93.8
24030, 남구,050001, 45세,2017,3707,1849,1858,99.5,3672,1830,1842,99.3
24030, 남구,050002, 46세,2017,3781,1828,1953,93.6,3754,1819,1935,94
24030, 남구,050003, 47세,2017,3651,1710,1941,88.1,3630,1702,1928,88.3
24030, 남구,050004, 48세,2017,3566,1745,1821,95.8,3537,1727,1810,95.4
24030, 남구,050005, 49세,2017,3760,1802,1958,92,3729,1788,1941,92.1
24030, 남구,055,50~54세,2017,17185,8297,8888,93.4,17019,8229,8790,93.6
24030, 남구,055001, 50세,2017,3435,1672,1763,94.8,3403,1658,1745,95
24030, 남구,055002, 51세,2017,3507,1705,1802,94.6,3470,1692,1778,95.2
24030, 남구,055003, 52세,2017,3460,1648,1812,90.9,3430,1632,1798,90.8
24030, 남구,055004, 53세,2017,3206,1537,1669,92.1,3172,1521,1651,92.1
24030, 남구,055005, 54세,2017,3577,1735,1842,94.2,3544,1726,1818,94.9
24030, 남구,060,55~59세,2017,18237,8544,9693,88.1,18150,8503,9647,88.1
24030, 남구,060001, 55세,2017,3473,1611,1862,86.5,3456,1603,1853,86.5
24030, 남구,060002, 56세,2017,3753,1766,1987,88.9,3733,1760,1973,89.2
24030, 남구,060003, 57세,2017,3982,1843,2139,86.2,3962,1833,2129,86.1
24030, 남구,060004, 58세,2017,3586,1691,1895,89.2,3572,1684,1888,89.2
24030, 남구,060005, 59세,2017,3443,1633,1810,90.2,3427,1623,1804,90
24030, 남구,065,60~64세,2017,14178,6703,7475,89.7,14118,6673,7445,89.6
24030, 남구,065001, 60세,2017,3342,1554,1788,86.9,3326,1549,1777,87.2
24030, 남구,065002, 61세,2017,2910,1420,1490,95.3,2895,1411,1484,95.1
24030, 남구,065003, 62세,2017,3064,1428,1636,87.3,3053,1422,1631,87.2
24030, 남구,065004, 63세,2017,2524,1180,1344,87.8,2516,1175,1341,87.6
24030, 남구,065005, 64세,2017,2338,1121,1217,92.1,2328,1116,1212,92.1
24030, 남구,070,65~69세,2017,11309,5273,6036,87.4,11290,5264,6026,87.4
24030, 남구,070001, 65세,2017,2537,1219,1318,92.5,2530,1214,1316,92.2
24030, 남구,070002, 66세,2017,2118,972,1146,84.8,2113,971,1142,85
24030, 남구,070003, 67세,2017,2196,1017,1179,86.3,2193,1017,1176,86.5
24030, 남구,070004, 68세,2017,2330,1075,1255,85.7,2327,1073,1254,85.6
24030, 남구,070005, 69세,2017,2128,990,1138,87,2127,989,1138,86.9
24030, 남구,075,70~74세,2017,8539,3990,4549,87.7,8525,3983,4542,87.7
24030, 남구,075001, 70세,2017,2223,1017,1206,84.3,2219,1016,1203,84.5
24030, 남구,075002, 71세,2017,1619,768,851,90.2,1616,766,850,90.1
24030, 남구,075003, 72세,2017,1619,767,852,90,1615,765,850,90
24030, 남구,075004, 73세,2017,1575,736,839,87.7,1573,735,838,87.7
24030, 남구,075005, 74세,2017,1503,702,801,87.6,1502,701,801,87.5
24030, 남구,080,75~79세,2017,7084,3073,4011,76.6,7080,3073,4007,76.7
24030, 남구,080001, 75세,2017,1919,900,1019,88.3,1918,900,1018,88.4
24030, 남구,080002, 76세,2017,1478,620,858,72.3,1477,620,857,72.3
24030, 남구,080003, 77세,2017,1305,549,756,72.6,1303,549,754,72.8
24030, 남구,080004, 78세,2017,1264,563,701,80.3,1264,563,701,80.3
24030, 남구,080005, 79세,2017,1118,441,677,65.1,1118,441,677,65.1
24030, 남구,085,80~84세,2017,4060,1420,2640,53.8,4057,1418,2639,53.7
24030, 남구,085001, 80세,2017,1034,385,649,59.3,1034,385,649,59.3
24030, 남구,085002, 81세,2017,860,330,530,62.3,860,330,530,62.3
24030, 남구,085003, 82세,2017,818,274,544,50.4,817,274,543,50.5
24030, 남구,085004, 83세,2017,751,240,511,47,750,239,511,46.8
24030, 남구,085005, 84세,2017,597,191,406,47,596,190,406,46.8
24030, 남구,090,85~89세,2017,1916,545,1371,39.8,1915,545,1370,39.8
24030, 남구,090001, 85세,2017,516,168,348,48.3,516,168,348,48.3
24030, 남구,090002, 86세,2017,392,102,290,35.2,392,102,290,35.2
24030, 남구,090003, 87세,2017,439,130,309,42.1,439,130,309,42.1
24030, 남구,090004, 88세,2017,324,92,232,39.7,324,92,232,39.7
24030, 남구,090005, 89세,2017,245,53,192,27.6,244,53,191,27.7
24030, 남구,095,90~94세,2017,678,141,537,26.3,677,141,536,26.3
24030, 남구,095001, 90세,2017,228,49,179,27.4,228,49,179,27.4
24030, 남구,095002, 91세,2017,154,39,115,33.9,154,39,115,33.9
24030, 남구,095003, 92세,2017,127,24,103,23.3,126,24,102,23.5
24030, 남구,095004, 93세,2017,71,15,56,26.8,71,15,56,26.8
24030, 남구,095005, 94세,2017,98,14,84,16.7,98,14,84,16.7
24030, 남구,100,95~99세,2017,139,22,117,18.8,139,22,117,18.8
24030, 남구,100001, 95세,2017,56,11,45,24.4,56,11,45,24.4
24030, 남구,100002, 96세,2017,35,5,30,16.7,35,5,30,16.7
24030, 남구,100003, 97세,2017,21,X,19,10.5,21,X,19,10.5
24030, 남구,100004, 98세,2017,18,X,15,20,18,X,15,20
24030, 남구,100005, 99세,2017,9,X,8,12.5,9,X,8,12.5
24030, 남구,101,100세이상,2017,18,X,14,28.6,18,X,14,28.6
24030, 남구,102,15세미만,2017,28885,14813,14072,105.3,28849,14795,14054,105.3
24030, 남구,103,15~64세,2017,156628,76921,79707,96.5,155088,76316,78772,96.9
24030, 남구,104,65세이상,2017,33743,14468,19275,75.1,33701,14450,19251,75.1
24030, 남구,086,85세이상,2017,2751,712,2039,34.9,2749,712,2037,35
24030, 남구,126,평균연령,2017,41.6,40.4,42.8,,41.6,40.4,42.8,
24030, 남구,127,중위연령,2017,42.7,41.3,44.1,,42.8,41.3,44.2,
24040, 북구,000,합계,2017,450323,224448,225875,99.4,444731,221759,222972,99.5
24040, 북구,005,0~4세,2017,17763,9119,8644,105.5,17685,9085,8600,105.6
24040, 북구,005001, 0세,2017,3060,1562,1498,104.3,3039,1552,1487,104.4
24040, 북구,005002, 1세,2017,3541,1777,1764,100.7,3524,1770,1754,100.9
24040, 북구,005003, 2세,2017,3747,1955,1792,109.1,3732,1949,1783,109.3
24040, 북구,005004, 3세,2017,3751,1878,1873,100.3,3736,1870,1866,100.2
24040, 북구,005005, 4세,2017,3664,1947,1717,113.4,3654,1944,1710,113.7
24040, 북구,010,5~9세,2017,19910,10370,9540,108.7,19863,10352,9511,108.8
24040, 북구,010001, 5세,2017,4123,2139,1984,107.8,4107,2132,1975,107.9
24040, 북구,010002, 6세,2017,4022,2055,1967,104.5,4008,2047,1961,104.4
24040, 북구,010003, 7세,2017,3922,2023,1899,106.5,3917,2023,1894,106.8
24040, 북구,010004, 8세,2017,3854,2067,1787,115.7,3848,2066,1782,115.9
24040, 북구,010005, 9세,2017,3989,2086,1903,109.6,3983,2084,1899,109.7
24040, 북구,015,10~14세,2017,20852,11040,9812,112.5,20839,11034,9805,112.5
24040, 북구,015001, 10세,2017,4212,2233,1979,112.8,4212,2233,1979,112.8
24040, 북구,015002, 11세,2017,3846,2020,1826,110.6,3841,2018,1823,110.7
24040, 북구,015003, 12세,2017,3878,2049,1829,112,3873,2046,1827,112
24040, 북구,015004, 13세,2017,4267,2258,2009,112.4,4265,2257,2008,112.4
24040, 북구,015005, 14세,2017,4649,2480,2169,114.3,4648,2480,2168,114.4
24040, 북구,020,15~19세,2017,29949,15541,14408,107.9,29691,15398,14293,107.7
24040, 북구,020001, 15세,2017,4738,2482,2256,110,4736,2480,2256,109.9
24040, 북구,020002, 16세,2017,5500,2933,2567,114.3,5495,2930,2565,114.2
24040, 북구,020003, 17세,2017,6264,3321,2943,112.8,6251,3319,2932,113.2
24040, 북구,020004, 18세,2017,6402,3309,3093,107,6313,3257,3056,106.6
24040, 북구,020005, 19세,2017,7045,3496,3549,98.5,6896,3412,3484,97.9
24040, 북구,025,20~24세,2017,38067,19918,18149,109.7,36847,19356,17491,110.7
24040, 북구,025001, 20세,2017,7448,3767,3681,102.3,7210,3651,3559,102.6
24040, 북구,025002, 21세,2017,7773,4027,3746,107.5,7547,3920,3627,108.1
24040, 북구,025003, 22세,2017,7838,4028,3810,105.7,7618,3931,3687,106.6
24040, 북구,025004, 23세,2017,7634,4150,3484,119.1,7363,4029,3334,120.8
24040, 북구,025005, 24세,2017,7374,3946,3428,115.1,7109,3825,3284,116.5
24040, 북구,030,25~29세,2017,30925,16316,14609,111.7,29746,15725,14021,112.2
24040, 북구,030001, 25세,2017,7300,3881,3419,113.5,7049,3740,3309,113
24040, 북구,030002, 26세,2017,6409,3422,2987,114.6,6166,3301,2865,115.2
24040, 북구,030003, 27세,2017,6020,3181,2839,112,5766,3059,2707,113
24040, 북구,030004, 28세,2017,5689,2965,2724,108.8,5440,2847,2593,109.8
24040, 북구,030005, 29세,2017,5507,2867,2640,108.6,5325,2778,2547,109.1
24040, 북구,035,30~34세,2017,28956,15053,13903,108.3,28191,14692,13499,108.8
24040, 북구,035001, 30세,2017,5472,2754,2718,101.3,5270,2658,2612,101.8
24040, 북구,035002, 31세,2017,5480,2824,2656,106.3,5307,2748,2559,107.4
24040, 북구,035003, 32세,2017,5514,2903,2611,111.2,5378,2834,2544,111.4
24040, 북구,035004, 33세,2017,5983,3174,2809,113,5860,3113,2747,113.3
24040, 북구,035005, 34세,2017,6507,3398,3109,109.3,6376,3339,3037,109.9
24040, 북구,040,35~39세,2017,33693,17155,16538,103.7,33242,16923,16319,103.7
24040, 북구,040001, 35세,2017,7002,3646,3356,108.6,6881,3576,3305,108.2
24040, 북구,040002, 36세,2017,6620,3320,3300,100.6,6531,3278,3253,100.8
24040, 북구,040003, 37세,2017,7007,3565,3442,103.6,6926,3525,3401,103.6
24040, 북구,040004, 38세,2017,6834,3441,3393,101.4,6746,3391,3355,101.1
24040, 북구,040005, 39세,2017,6230,3183,3047,104.5,6158,3153,3005,104.9
24040, 북구,045,40~44세,2017,33870,17122,16748,102.2,33532,16968,16564,102.4
24040, 북구,045001, 40세,2017,6214,3089,3125,98.8,6149,3062,3087,99.2
24040, 북구,045002, 41세,2017,6351,3270,3081,106.1,6281,3243,3038,106.7
24040, 북구,045003, 42세,2017,6547,3336,3211,103.9,6476,3301,3175,104
24040, 북구,045004, 43세,2017,7481,3830,3651,104.9,7425,3802,3623,104.9
24040, 북구,045005, 44세,2017,7277,3597,3680,97.7,7201,3560,3641,97.8
24040, 북구,050,45~49세,2017,39003,19277,19726,97.7,38642,19097,19545,97.7
24040, 북구,050001, 45세,2017,7478,3712,3766,98.6,7404,3672,3732,98.4
24040, 북구,050002, 46세,2017,7925,3898,4027,96.8,7853,3862,3991,96.8
24040, 북구,050003, 47세,2017,7746,3795,3951,96.1,7675,3760,3915,96
24040, 북구,050004, 48세,2017,7713,3846,3867,99.5,7640,3806,3834,99.3
24040, 북구,050005, 49세,2017,8141,4026,4115,97.8,8070,3997,4073,98.1
24040, 북구,055,50~54세,2017,36965,18194,18771,96.9,36620,18048,18572,97.2
24040, 북구,055001, 50세,2017,7502,3604,3898,92.5,7438,3574,3864,92.5
24040, 북구,055002, 51세,2017,7577,3848,3729,103.2,7513,3818,3695,103.3
24040, 북구,055003, 52세,2017,7444,3641,3803,95.7,7365,3614,3751,96.3
24040, 북구,055004, 53세,2017,6994,3464,3530,98.1,6916,3430,3486,98.4
24040, 북구,055005, 54세,2017,7448,3637,3811,95.4,7388,3612,3776,95.7
24040, 북구,060,55~59세,2017,36988,18004,18984,94.8,36736,17879,18857,94.8
24040, 북구,060001, 55세,2017,7161,3559,3602,98.8,7090,3525,3565,98.9
24040, 북구,060002, 56세,2017,7815,3799,4016,94.6,7769,3781,3988,94.8
24040, 북구,060003, 57세,2017,8255,3990,4265,93.6,8205,3966,4239,93.6
24040, 북구,060004, 58세,2017,7355,3547,3808,93.1,7309,3519,3790,92.8
24040, 북구,060005, 59세,2017,6402,3109,3293,94.4,6363,3088,3275,94.3
24040, 북구,065,60~64세,2017,26080,12768,13312,95.9,25945,12697,13248,95.8
24040, 북구,065001, 60세,2017,6239,3068,3171,96.8,6211,3050,3161,96.5
24040, 북구,065002, 61세,2017,5403,2716,2687,101.1,5379,2707,2672,101.3
24040, 북구,065003, 62세,2017,5756,2789,2967,94,5720,2771,2949,94
24040, 북구,065004, 63세,2017,4649,2271,2378,95.5,4617,2253,2364,95.3
24040, 북구,065005, 64세,2017,4033,1924,2109,91.2,4018,1916,2102,91.2
24040, 북구,070,65~69세,2017,19715,9528,10187,93.5,19627,9487,10140,93.6
24040, 북구,070001, 65세,2017,4495,2167,2328,93.1,4467,2156,2311,93.3
24040, 북구,070002, 66세,2017,3749,1829,1920,95.3,3735,1821,1914,95.1
24040, 북구,070003, 67세,2017,3866,1893,1973,95.9,3846,1883,1963,95.9
24040, 북구,070004, 68세,2017,3958,1881,2077,90.6,3939,1871,2068,90.5
24040, 북구,070005, 69세,2017,3647,1758,1889,93.1,3640,1756,1884,93.2
24040, 북구,075,70~74세,2017,14259,6561,7698,85.2,14230,6550,7680,85.3
24040, 북구,075001, 70세,2017,3630,1724,1906,90.5,3619,1720,1899,90.6
24040, 북구,075002, 71세,2017,2832,1355,1477,91.7,2827,1352,1475,91.7
24040, 북구,075003, 72세,2017,2698,1199,1499,80,2695,1199,1496,80.1
24040, 북구,075004, 73세,2017,2543,1140,1403,81.3,2539,1140,1399,81.5
24040, 북구,075005, 74세,2017,2556,1143,1413,80.9,2550,1139,1411,80.7
24040, 북구,080,75~79세,2017,11896,5016,6880,72.9,11874,5005,6869,72.9
24040, 북구,080001, 75세,2017,3368,1541,1827,84.3,3363,1539,1824,84.4
24040, 북구,080002, 76세,2017,2434,1013,1421,71.3,2429,1011,1418,71.3
24040, 북구,080003, 77세,2017,2125,842,1283,65.6,2121,840,1281,65.6
24040, 북구,080004, 78세,2017,2074,875,1199,73,2071,874,1197,73
24040, 북구,080005, 79세,2017,1895,745,1150,64.8,1890,741,1149,64.5
24040, 북구,085,80~84세,2017,6782,2356,4426,53.2,6777,2355,4422,53.3
24040, 북구,085001, 80세,2017,1706,663,1043,63.6,1705,663,1042,63.6
24040, 북구,085002, 81세,2017,1443,510,933,54.7,1443,510,933,54.7
24040, 북구,085003, 82세,2017,1403,474,929,51,1400,473,927,51
24040, 북구,085004, 83세,2017,1264,424,840,50.5,1263,424,839,50.5
24040, 북구,085005, 84세,2017,966,285,681,41.9,966,285,681,41.9
24040, 북구,090,85~89세,2017,3291,854,2437,35,3288,852,2436,35
24040, 북구,090001, 85세,2017,865,255,610,41.8,863,253,610,41.5
24040, 북구,090002, 86세,2017,741,193,548,35.2,740,193,547,35.3
24040, 북구,090003, 87세,2017,709,161,548,29.4,709,161,548,29.4
24040, 북구,090004, 88세,2017,537,146,391,37.3,537,146,391,37.3
24040, 북구,090005, 89세,2017,439,99,340,29.1,439,99,340,29.1
24040, 북구,095,90~94세,2017,1080,223,857,26,1078,223,855,26.1
24040, 북구,095001, 90세,2017,366,78,288,27.1,365,78,287,27.2
24040, 북구,095002, 91세,2017,260,54,206,26.2,260,54,206,26.2
24040, 북구,095003, 92세,2017,189,41,148,27.7,188,41,147,27.9
24040, 북구,095004, 93세,2017,113,19,94,20.2,113,19,94,20.2
24040, 북구,095005, 94세,2017,152,31,121,25.6,152,31,121,25.6
24040, 북구,100,95~99세,2017,256,31,225,13.8,255,31,224,13.8
24040, 북구,100001, 95세,2017,100,12,88,13.6,100,12,88,13.6
24040, 북구,100002, 96세,2017,61,5,56,8.9,61,5,56,8.9
24040, 북구,100003, 97세,2017,51,7,44,15.9,51,7,44,15.9
24040, 북구,100004, 98세,2017,27,6,21,28.6,26,6,20,30
24040, 북구,100005, 99세,2017,17,X,16,6.3,17,X,16,6.3
24040, 북구,101,100세이상,2017,23,X,21,9.5,23,X,21,9.5
24040, 북구,102,15세미만,2017,58525,30529,27996,109,58387,30471,27916,109.2
24040, 북구,103,15~64세,2017,334496,169348,165148,102.5,329192,166783,162409,102.7
24040, 북구,104,65세이상,2017,57302,24571,32731,75.1,57152,24505,32647,75.1
24040, 북구,086,85세이상,2017,4650,1110,3540,31.4,4644,1108,3536,31.3
24040, 북구,126,평균연령,2017,40.3,39.1,41.5,,40.3,39.1,41.5,
24040, 북구,127,중위연령,2017,40.8,39.3,42.4,,41,39.5,42.6,
24050, 광산구,000,합계,2017,419625,212570,207055,102.7,404357,203090,201267,100.9
24050, 광산구,005,0~4세,2017,21447,11005,10442,105.4,21159,10848,10311,105.2
24050, 광산구,005001, 0세,2017,3506,1800,1706,105.5,3445,1770,1675,105.7
24050, 광산구,005002, 1세,2017,4165,2147,2018,106.4,4113,2118,1995,106.2
24050, 광산구,005003, 2세,2017,4444,2303,2141,107.6,4383,2268,2115,107.2
24050, 광산구,005004, 3세,2017,4583,2350,2233,105.2,4520,2313,2207,104.8
24050, 광산구,005005, 4세,2017,4749,2405,2344,102.6,4698,2379,2319,102.6
24050, 광산구,010,5~9세,2017,26427,13605,12822,106.1,26242,13514,12728,106.2
24050, 광산구,010001, 5세,2017,5399,2808,2591,108.4,5353,2786,2567,108.5
24050, 광산구,010002, 6세,2017,5336,2809,2527,111.2,5293,2784,2509,111
24050, 광산구,010003, 7세,2017,5250,2681,2569,104.4,5209,2661,2548,104.4
24050, 광산구,010004, 8세,2017,5077,2526,2551,99,5052,2516,2536,99.2
24050, 광산구,010005, 9세,2017,5365,2781,2584,107.6,5335,2767,2568,107.7
24050, 광산구,015,10~14세,2017,26593,13724,12869,106.6,26444,13649,12795,106.7
24050, 광산구,015001, 10세,2017,5613,2909,2704,107.6,5583,2896,2687,107.8
24050, 광산구,015002, 11세,2017,5102,2639,2463,107.1,5067,2620,2447,107.1
24050, 광산구,015003, 12세,2017,4978,2556,2422,105.5,4953,2543,2410,105.5
24050, 광산구,015004, 13세,2017,5307,2722,2585,105.3,5283,2706,2577,105
24050, 광산구,015005, 14세,2017,5593,2898,2695,107.5,5558,2884,2674,107.9
24050, 광산구,020,15~19세,2017,31051,15752,15299,103,30692,15547,15145,102.7
24050, 광산구,020001, 15세,2017,5290,2685,2605,103.1,5266,2669,2597,102.8
24050, 광산구,020002, 16세,2017,5986,3073,2913,105.5,5954,3053,2901,105.2
24050, 광산구,020003, 17세,2017,6704,3475,3229,107.6,6675,3464,3211,107.9
24050, 광산구,020004, 18세,2017,6399,3279,3120,105.1,6329,3237,3092,104.7
24050, 광산구,020005, 19세,2017,6672,3240,3432,94.4,6468,3124,3344,93.4
24050, 광산구,025,20~24세,2017,33108,17209,15899,108.2,30602,15664,14938,104.9
24050, 광산구,025001, 20세,2017,6865,3376,3489,96.8,6556,3226,3330,96.9
24050, 광산구,025002, 21세,2017,7060,3630,3430,105.8,6556,3331,3225,103.3
24050, 광산구,025003, 22세,2017,6659,3405,3254,104.6,6112,3077,3035,101.4
24050, 광산구,025004, 23세,2017,6408,3436,2972,115.6,5835,3059,2776,110.2
24050, 광산구,025005, 24세,2017,6116,3362,2754,122.1,5543,2971,2572,115.5
24050, 광산구,030,25~29세,2017,26084,14052,12032,116.8,23004,11979,11025,108.7
24050, 광산구,030001, 25세,2017,5994,3342,2652,126,5398,2927,2471,118.5
24050, 광산구,030002, 26세,2017,5410,2923,2487,117.5,4800,2508,2292,109.4
24050, 광산구,030003, 27세,2017,5089,2721,2368,114.9,4435,2296,2139,107.3
24050, 광산구,030004, 28세,2017,4841,2595,2246,115.5,4219,2166,2053,105.5
24050, 광산구,030005, 29세,2017,4750,2471,2279,108.4,4152,2082,2070,100.6
24050, 광산구,035,30~34세,2017,28290,14777,13513,109.4,25766,13111,12655,103.6
24050, 광산구,035001, 30세,2017,5166,2804,2362,118.7,4540,2381,2159,110.3
24050, 광산구,035002, 31세,2017,5172,2666,2506,106.4,4703,2357,2346,100.5
24050, 광산구,035003, 32세,2017,5272,2767,2505,110.5,4764,2427,2337,103.9
24050, 광산구,035004, 33세,2017,5971,3072,2899,106,5493,2768,2725,101.6
24050, 광산구,035005, 34세,2017,6709,3468,3241,107,6266,3178,3088,102.9
24050, 광산구,040,35~39세,2017,38413,19160,19253,99.5,36563,17935,18628,96.3
24050, 광산구,040001, 35세,2017,7797,3929,3868,101.6,7358,3632,3726,97.5
24050, 광산구,040002, 36세,2017,7478,3790,3688,102.8,7096,3530,3566,99
24050, 광산구,040003, 37세,2017,8029,3965,4064,97.6,7662,3722,3940,94.5
24050, 광산구,040004, 38세,2017,7903,3868,4035,95.9,7585,3658,3927,93.1
24050, 광산구,040005, 39세,2017,7206,3608,3598,100.3,6862,3393,3469,97.8
24050, 광산구,045,40~44세,2017,40490,20405,20085,101.6,39129,19568,19561,100
24050, 광산구,045001, 40세,2017,7804,3936,3868,101.8,7517,3750,3767,99.5
24050, 광산구,045002, 41세,2017,7658,3862,3796,101.7,7351,3662,3689,99.3
24050, 광산구,045003, 42세,2017,7778,3908,3870,101,7513,3749,3764,99.6
24050, 광산구,045004, 43세,2017,8646,4361,4285,101.8,8381,4211,4170,101
24050, 광산구,045005, 44세,2017,8604,4338,4266,101.7,8367,4196,4171,100.6
24050, 광산구,050,45~49세,2017,41240,21315,19925,107,40120,20648,19472,106
24050, 광산구,050001, 45세,2017,8379,4338,4041,107.3,8139,4188,3951,106
24050, 광산구,050002, 46세,2017,8795,4545,4250,106.9,8565,4399,4166,105.6
24050, 광산구,050003, 47세,2017,8292,4363,3929,111,8057,4230,3827,110.5
24050, 광산구,050004, 48세,2017,7837,4067,3770,107.9,7627,3943,3684,107
24050, 광산구,050005, 49세,2017,7937,4002,3935,101.7,7732,3888,3844,101.1
24050, 광산구,055,50~54세,2017,31918,16928,14990,112.9,31141,16520,14621,113
24050, 광산구,055001, 50세,2017,6914,3585,3329,107.7,6755,3499,3256,107.5
24050, 광산구,055002, 51세,2017,6921,3611,3310,109.1,6751,3531,3220,109.7
24050, 광산구,055003, 52세,2017,6503,3397,3106,109.4,6354,3308,3046,108.6
24050, 광산구,055004, 53세,2017,5686,3074,2612,117.7,5524,2991,2533,118.1
24050, 광산구,055005, 54세,2017,5894,3261,2633,123.9,5757,3191,2566,124.4
24050, 광산구,060,55~59세,2017,25338,13508,11830,114.2,24830,13241,11589,114.3
24050, 광산구,060001, 55세,2017,5359,2947,2412,122.2,5242,2890,2352,122.9
24050, 광산구,060002, 56세,2017,5526,2991,2535,118,5439,2938,2501,117.5
24050, 광산구,060003, 57세,2017,5544,2933,2611,112.3,5419,2865,2554,112.2
24050, 광산구,060004, 58세,2017,4735,2482,2253,110.2,4650,2439,2211,110.3
24050, 광산구,060005, 59세,2017,4174,2155,2019,106.7,4080,2109,1971,107
24050, 광산구,065,60~64세,2017,15376,7664,7712,99.4,15019,7483,7536,99.3
24050, 광산구,065001, 60세,2017,3875,1999,1876,106.6,3776,1946,1830,106.3
24050, 광산구,065002, 61세,2017,3235,1636,1599,102.3,3145,1589,1556,102.1
24050, 광산구,065003, 62세,2017,3317,1643,1674,98.1,3249,1608,1641,98
24050, 광산구,065004, 63세,2017,2620,1289,1331,96.8,2569,1268,1301,97.5
24050, 광산구,065005, 64세,2017,2329,1097,1232,89,2280,1072,1208,88.7
24050, 광산구,070,65~69세,2017,10824,5076,5748,88.3,10695,5022,5673,88.5
24050, 광산구,070001, 65세,2017,2477,1196,1281,93.4,2432,1177,1255,93.8
24050, 광산구,070002, 66세,2017,2078,965,1113,86.7,2050,958,1092,87.7
24050, 광산구,070003, 67세,2017,2085,968,1117,86.7,2060,957,1103,86.8
24050, 광산구,070004, 68세,2017,2155,1003,1152,87.1,2138,993,1145,86.7
24050, 광산구,070005, 69세,2017,2029,944,1085,87,2015,937,1078,86.9
24050, 광산구,075,70~74세,2017,8235,3675,4560,80.6,8189,3658,4531,80.7
24050, 광산구,075001, 70세,2017,2140,967,1173,82.4,2124,959,1165,82.3
24050, 광산구,075002, 71세,2017,1643,792,851,93.1,1633,790,843,93.7
24050, 광산구,075003, 72세,2017,1494,657,837,78.5,1488,657,831,79.1
24050, 광산구,075004, 73세,2017,1452,630,822,76.6,1444,625,819,76.3
24050, 광산구,075005, 74세,2017,1506,629,877,71.7,1500,627,873,71.8
24050, 광산구,080,75~79세,2017,7279,2716,4563,59.5,7257,2706,4551,59.5
24050, 광산구,080001, 75세,2017,1987,806,1181,68.2,1984,806,1178,68.4
24050, 광산구,080002, 76세,2017,1509,571,938,60.9,1505,569,936,60.8
24050, 광산구,080003, 77세,2017,1323,464,859,54,1317,461,856,53.9
24050, 광산구,080004, 78세,2017,1273,457,816,56,1270,455,815,55.8
24050, 광산구,080005, 79세,2017,1187,418,769,54.4,1181,415,766,54.2
24050, 광산구,085,80~84세,2017,4490,1374,3116,44.1,4487,1373,3114,44.1
24050, 광산구,085001, 80세,2017,1129,385,744,51.7,1129,385,744,51.7
24050, 광산구,085002, 81세,2017,921,269,652,41.3,920,269,651,41.3
24050, 광산구,085003, 82세,2017,983,309,674,45.8,982,309,673,45.9
24050, 광산구,085004, 83세,2017,821,245,576,42.5,820,244,576,42.4
24050, 광산구,085005, 84세,2017,636,166,470,35.3,636,166,470,35.3
24050, 광산구,090,85~89세,2017,2138,488,1650,29.6,2134,487,1647,29.6
24050, 광산구,090001, 85세,2017,557,144,413,34.9,556,144,412,35
24050, 광산구,090002, 86세,2017,462,106,356,29.8,461,106,355,29.9
24050, 광산구,090003, 87세,2017,488,95,393,24.2,488,95,393,24.2
24050, 광산구,090004, 88세,2017,353,78,275,28.4,352,78,274,28.5
24050, 광산구,090005, 89세,2017,278,65,213,30.5,277,64,213,30
24050, 광산구,095,90~94세,2017,702,117,585,20,702,117,585,20
24050, 광산구,095001, 90세,2017,194,38,156,24.4,194,38,156,24.4
24050, 광산구,095002, 91세,2017,154,25,129,19.4,154,25,129,19.4
24050, 광산구,095003, 92세,2017,162,23,139,16.5,162,23,139,16.5
24050, 광산구,095004, 93세,2017,81,18,63,28.6,81,18,63,28.6
24050, 광산구,095005, 94세,2017,111,13,98,13.3,111,13,98,13.3
24050, 광산구,100,95~99세,2017,165,19,146,13,165,19,146,13
24050, 광산구,100001, 95세,2017,77,13,64,20.3,77,13,64,20.3
24050, 광산구,100002, 96세,2017,44,X,40,10,44,X,40,10
24050, 광산구,100003, 97세,2017,24,X,23,4.3,24,X,23,4.3
24050, 광산구,100004, 98세,2017,9,X,9,0,9,X,9,0
24050, 광산구,100005, 99세,2017,11,X,10,10,11,X,10,10
24050, 광산구,101,100세이상,2017,17,X,16,6.3,17,X,16,6.3
24050, 광산구,102,15세미만,2017,74467,38334,36133,106.1,73845,38011,35834,106.1
24050, 광산구,103,15~64세,2017,311308,160770,150538,106.8,296866,151696,145170,104.5
24050, 광산구,104,65세이상,2017,33850,13466,20384,66.1,33646,13383,20263,66
24050, 광산구,086,85세이상,2017,3022,625,2397,26.1,3018,624,2394,26.1
24050, 광산구,126,평균연령,2017,36.3,35.5,37.1,,36.4,35.6,37.2,
24050, 광산구,127,중위연령,2017,37.2,36.6,37.8,,37.5,37,38,
25,대전광역시,000,합계,2017,1525849,765718,760131,100.7,1505315,756015,749300,100.9
25,대전광역시,005,0~4세,2017,64234,33069,31165,106.1,63859,32879,30980,106.1
25,대전광역시,005001, 0세,2017,11084,5677,5407,105,11012,5642,5370,105.1
25,대전광역시,005002, 1세,2017,12751,6643,6108,108.8,12657,6593,6064,108.7
25,대전광역시,005003, 2세,2017,13495,6950,6545,106.2,13421,6910,6511,106.1
25,대전광역시,005004, 3세,2017,13177,6805,6372,106.8,13106,6773,6333,106.9
25,대전광역시,005005, 4세,2017,13727,6994,6733,103.9,13663,6961,6702,103.9
25,대전광역시,010,5~9세,2017,70900,36547,34353,106.4,70702,36443,34259,106.4
25,대전광역시,010001, 5세,2017,14456,7505,6951,108,14405,7484,6921,108.1
25,대전광역시,010002, 6세,2017,14565,7499,7066,106.1,14520,7471,7049,106
25,대전광역시,010003, 7세,2017,13883,7121,6762,105.3,13855,7107,6748,105.3
25,대전광역시,010004, 8세,2017,13538,7000,6538,107.1,13503,6981,6522,107
25,대전광역시,010005, 9세,2017,14458,7422,7036,105.5,14419,7400,7019,105.4
25,대전광역시,015,10~14세,2017,72938,37702,35236,107,72834,37650,35184,107
25,대전광역시,015001, 10세,2017,14998,7671,7327,104.7,14977,7662,7315,104.7
25,대전광역시,015002, 11세,2017,13779,7125,6654,107.1,13753,7113,6640,107.1
25,대전광역시,015003, 12세,2017,13663,7148,6515,109.7,13643,7137,6506,109.7
25,대전광역시,015004, 13세,2017,15194,7906,7288,108.5,15179,7897,7282,108.4
25,대전광역시,015005, 14세,2017,15304,7852,7452,105.4,15282,7841,7441,105.4
25,대전광역시,020,15~19세,2017,100929,53119,47810,111.1,99918,52627,47291,111.3
25,대전광역시,020001, 15세,2017,15799,8383,7416,113,15781,8375,7406,113.1
25,대전광역시,020002, 16세,2017,17957,9443,8514,110.9,17929,9425,8504,110.8
25,대전광역시,020003, 17세,2017,19635,10316,9319,110.7,19550,10270,9280,110.7
25,대전광역시,020004, 18세,2017,21418,11324,10094,112.2,21176,11201,9975,112.3
25,대전광역시,020005, 19세,2017,26120,13653,12467,109.5,25482,13356,12126,110.1
25,대전광역시,025,20~24세,2017,129500,68272,61228,111.5,124742,66189,58553,113
25,대전광역시,025001, 20세,2017,25608,12567,13041,96.4,24674,12163,12511,97.2
25,대전광역시,025002, 21세,2017,25662,12682,12980,97.7,24619,12204,12415,98.3
25,대전광역시,025003, 22세,2017,26439,14088,12351,114.1,25405,13649,11756,116.1
25,대전광역시,025004, 23세,2017,26518,14720,11798,124.8,25598,14333,11265,127.2
25,대전광역시,025005, 24세,2017,25273,14215,11058,128.5,24446,13840,10606,130.5
25,대전광역시,030,25~29세,2017,107541,58575,48966,119.6,104070,57006,47064,121.1
25,대전광역시,030001, 25세,2017,24594,13513,11081,121.9,23848,13191,10657,123.8
25,대전광역시,030002, 26세,2017,22308,12054,10254,117.6,21627,11744,9883,118.8
25,대전광역시,030003, 27세,2017,20987,11514,9473,121.5,20274,11211,9063,123.7
25,대전광역시,030004, 28세,2017,19973,10922,9051,120.7,19293,10602,8691,122
25,대전광역시,030005, 29세,2017,19679,10572,9107,116.1,19028,10258,8770,117
25,대전광역시,035,30~34세,2017,99955,51950,48005,108.2,97389,50697,46692,108.6
25,대전광역시,035001, 30세,2017,19162,10040,9122,110.1,18580,9756,8824,110.6
25,대전광역시,035002, 31세,2017,19383,10176,9207,110.5,18792,9897,8895,111.3
25,대전광역시,035003, 32세,2017,19391,10119,9272,109.1,18914,9899,9015,109.8
25,대전광역시,035004, 33세,2017,19848,10238,9610,106.5,19373,9985,9388,106.4
25,대전광역시,035005, 34세,2017,22171,11377,10794,105.4,21730,11160,10570,105.6
25,대전광역시,040,35~39세,2017,117258,58975,58283,101.2,115339,58000,57339,101.2
25,대전광역시,040001, 35세,2017,23742,11981,11761,101.9,23304,11766,11538,102
25,대전광역시,040002, 36세,2017,24177,12233,11944,102.4,23761,12029,11732,102.5
25,대전광역시,040003, 37세,2017,24419,12279,12140,101.1,24004,12069,11935,101.1
25,대전광역시,040004, 38세,2017,23071,11578,11493,100.7,22736,11410,11326,100.7
25,대전광역시,040005, 39세,2017,21849,10904,10945,99.6,21534,10726,10808,99.2
25,대전광역시,045,40~44세,2017,119963,59653,60310,98.9,118619,58968,59651,98.9
25,대전광역시,045001, 40세,2017,22467,11138,11329,98.3,22189,11001,11188,98.3
25,대전광역시,045002, 41세,2017,22228,11049,11179,98.8,21948,10912,11036,98.9
25,대전광역시,045003, 42세,2017,23290,11635,11655,99.8,23028,11501,11527,99.8
25,대전광역시,045004, 43세,2017,25700,12840,12860,99.8,25447,12708,12739,99.8
25,대전광역시,045005, 44세,2017,26278,12991,13287,97.8,26007,12846,13161,97.6
25,대전광역시,050,45~49세,2017,135868,67710,68158,99.3,134391,66964,67427,99.3
25,대전광역시,050001, 45세,2017,25612,12917,12695,101.7,25300,12751,12549,101.6
25,대전광역시,050002, 46세,2017,28035,14018,14017,100,27734,13878,13856,100.2
25,대전광역시,050003, 47세,2017,26667,13363,13304,100.4,26370,13215,13155,100.5
25,대전광역시,050004, 48세,2017,27851,13830,14021,98.6,27547,13672,13875,98.5
25,대전광역시,050005, 49세,2017,27703,13582,14121,96.2,27440,13448,13992,96.1
25,대전광역시,055,50~54세,2017,116530,58423,58107,100.5,115320,57849,57471,100.7
25,대전광역시,055001, 50세,2017,24493,12126,12367,98.1,24258,12013,12245,98.1
25,대전광역시,055002, 51세,2017,22935,11675,11260,103.7,22672,11548,11124,103.8
25,대전광역시,055003, 52세,2017,24084,11960,12124,98.6,23867,11852,12015,98.6
25,대전광역시,055004, 53세,2017,22261,11110,11151,99.6,22033,11017,11016,100
25,대전광역시,055005, 54세,2017,22757,11552,11205,103.1,22490,11419,11071,103.1
25,대전광역시,060,55~59세,2017,120940,59704,61236,97.5,120051,59304,60747,97.6
25,대전광역시,060001, 55세,2017,24636,12408,12228,101.5,24433,12319,12114,101.7
25,대전광역시,060002, 56세,2017,26894,13260,13634,97.3,26731,13186,13545,97.3
25,대전광역시,060003, 57세,2017,25742,12494,13248,94.3,25536,12398,13138,94.4
25,대전광역시,060004, 58세,2017,22600,11091,11509,96.4,22451,11024,11427,96.5
25,대전광역시,060005, 59세,2017,21068,10451,10617,98.4,20900,10377,10523,98.6
25,대전광역시,065,60~64세,2017,89692,44318,45374,97.7,89008,43969,45039,97.6
25,대전광역시,065001, 60세,2017,20883,10491,10392,101,20734,10421,10313,101
25,대전광역시,065002, 61세,2017,19456,9689,9767,99.2,19312,9623,9689,99.3
25,대전광역시,065003, 62세,2017,19304,9414,9890,95.2,19166,9340,9826,95.1
25,대전광역시,065004, 63세,2017,16432,7971,8461,94.2,16297,7893,8404,93.9
25,대전광역시,065005, 64세,2017,13617,6753,6864,98.4,13499,6692,6807,98.3
25,대전광역시,070,65~69세,2017,60862,29617,31245,94.8,60569,29491,31078,94.9
25,대전광역시,070001, 65세,2017,14611,7139,7472,95.5,14530,7105,7425,95.7
25,대전광역시,070002, 66세,2017,10919,5364,5555,96.6,10849,5335,5514,96.8
25,대전광역시,070003, 67세,2017,12291,5945,6346,93.7,12235,5920,6315,93.7
25,대전광역시,070004, 68세,2017,11810,5751,6059,94.9,11749,5724,6025,95
25,대전광역시,070005, 69세,2017,11231,5418,5813,93.2,11206,5407,5799,93.2
25,대전광역시,075,70~74세,2017,43445,20060,23385,85.8,43332,20004,23328,85.8
25,대전광역시,075001, 70세,2017,10483,4913,5570,88.2,10449,4896,5553,88.2
25,대전광역시,075002, 71세,2017,8137,3926,4211,93.2,8109,3917,4192,93.4
25,대전광역시,075003, 72세,2017,8125,3764,4361,86.3,8108,3753,4355,86.2
25,대전광역시,075004, 73세,2017,8411,3787,4624,81.9,8393,3775,4618,81.7
25,대전광역시,075005, 74세,2017,8289,3670,4619,79.5,8273,3663,4610,79.5
25,대전광역시,080,75~79세,2017,37257,15793,21464,73.6,37190,15767,21423,73.6
25,대전광역시,080001, 75세,2017,10009,4485,5524,81.2,9998,4482,5516,81.3
25,대전광역시,080002, 76세,2017,7522,3194,4328,73.8,7507,3187,4320,73.8
25,대전광역시,080003, 77세,2017,6588,2781,3807,73,6571,2773,3798,73
25,대전광역시,080004, 78세,2017,6869,2784,4085,68.2,6852,2779,4073,68.2
25,대전광역시,080005, 79세,2017,6269,2549,3720,68.5,6262,2546,3716,68.5
25,대전광역시,085,80~84세,2017,22715,8174,14541,56.2,22681,8160,14521,56.2
25,대전광역시,085001, 80세,2017,5500,2179,3321,65.6,5491,2175,3316,65.6
25,대전광역시,085002, 81세,2017,5111,1822,3289,55.4,5105,1820,3285,55.4
25,대전광역시,085003, 82세,2017,4655,1668,2987,55.8,4648,1665,2983,55.8
25,대전광역시,085004, 83세,2017,4033,1389,2644,52.5,4026,1386,2640,52.5
25,대전광역시,085005, 84세,2017,3416,1116,2300,48.5,3411,1114,2297,48.5
25,대전광역시,090,85~89세,2017,10780,3012,7768,38.8,10766,3007,7759,38.8
25,대전광역시,090001, 85세,2017,3028,939,2089,44.9,3027,938,2089,44.9
25,대전광역시,090002, 86세,2017,2295,662,1633,40.5,2292,662,1630,40.6
25,대전광역시,090003, 87세,2017,2147,573,1574,36.4,2147,573,1574,36.4
25,대전광역시,090004, 88세,2017,1777,451,1326,34,1771,448,1323,33.9
25,대전광역시,090005, 89세,2017,1533,387,1146,33.8,1529,386,1143,33.8
25,대전광역시,095,90~94세,2017,3631,851,2780,30.6,3626,848,2778,30.5
25,대전광역시,095001, 90세,2017,1229,319,910,35.1,1225,316,909,34.8
25,대전광역시,095002, 91세,2017,774,203,571,35.6,773,203,570,35.6
25,대전광역시,095003, 92세,2017,667,139,528,26.3,667,139,528,26.3
25,대전광역시,095004, 93세,2017,483,105,378,27.8,483,105,378,27.8
25,대전광역시,095005, 94세,2017,478,85,393,21.6,478,85,393,21.6
25,대전광역시,100,95~99세,2017,797,169,628,26.9,795,168,627,26.8
25,대전광역시,100001, 95세,2017,320,71,249,28.5,320,71,249,28.5
25,대전광역시,100002, 96세,2017,205,53,152,34.9,205,53,152,34.9
25,대전광역시,100003, 97세,2017,131,23,108,21.3,129,22,107,20.6
25,대전광역시,100004, 98세,2017,87,17,70,24.3,87,17,70,24.3
25,대전광역시,100005, 99세,2017,54,5,49,10.2,54,5,49,10.2
25,대전광역시,101,100세이상,2017,114,25,89,28.1,114,25,89,28.1
25,대전광역시,102,15세미만,2017,208072,107318,100754,106.5,207395,106972,100423,106.5
25,대전광역시,103,15~64세,2017,1138176,580699,557477,104.2,1118847,571573,547274,104.4
25,대전광역시,104,65세이상,2017,179601,77701,101900,76.3,179073,77470,101603,76.2
25,대전광역시,086,85세이상,2017,15322,4057,11265,36,15301,4048,11253,36
25,대전광역시,126,평균연령,2017,39.6,38.6,40.7,,39.7,38.6,40.8,
25,대전광역시,127,중위연령,2017,40,38.6,41.3,,40.2,38.8,41.6,
25010, 동구,000,합계,2017,239752,121017,118735,101.9,234986,118821,116165,102.3
25010, 동구,005,0~4세,2017,8624,4442,4182,106.2,8585,4418,4167,106
25010, 동구,005001, 0세,2017,1441,742,699,106.2,1435,739,696,106.2
25010, 동구,005002, 1세,2017,1623,860,763,112.7,1616,856,760,112.6
25010, 동구,005003, 2세,2017,1818,960,858,111.9,1810,955,855,111.7
25010, 동구,005004, 3세,2017,1818,928,890,104.3,1806,920,886,103.8
25010, 동구,005005, 4세,2017,1924,952,972,97.9,1918,948,970,97.7
25010, 동구,010,5~9세,2017,9967,5097,4870,104.7,9947,5084,4863,104.5
25010, 동구,010001, 5세,2017,2011,1029,982,104.8,2005,1025,980,104.6
25010, 동구,010002, 6세,2017,2043,1014,1029,98.5,2039,1011,1028,98.3
25010, 동구,010003, 7세,2017,1921,993,928,107,1921,993,928,107
25010, 동구,010004, 8세,2017,1899,1014,885,114.6,1896,1011,885,114.2
25010, 동구,010005, 9세,2017,2093,1047,1046,100.1,2086,1044,1042,100.2
25010, 동구,015,10~14세,2017,9801,5047,4754,106.2,9784,5037,4747,106.1
25010, 동구,015001, 10세,2017,2071,1067,1004,106.3,2070,1066,1004,106.2
25010, 동구,015002, 11세,2017,1887,954,933,102.3,1883,953,930,102.5
25010, 동구,015003, 12세,2017,1831,981,850,115.4,1826,977,849,115.1
25010, 동구,015004, 13세,2017,2012,1020,992,102.8,2010,1018,992,102.6
25010, 동구,015005, 14세,2017,2000,1025,975,105.1,1995,1023,972,105.2
25010, 동구,020,15~19세,2017,16374,8701,7673,113.4,15903,8473,7430,114
25010, 동구,020001, 15세,2017,2080,1135,945,120.1,2077,1134,943,120.3
25010, 동구,020002, 16세,2017,2533,1406,1127,124.8,2527,1403,1124,124.8
25010, 동구,020003, 17세,2017,2983,1718,1265,135.8,2942,1699,1243,136.7
25010, 동구,020004, 18세,2017,3319,1740,1579,110.2,3204,1682,1522,110.5
25010, 동구,020005, 19세,2017,5459,2702,2757,98,5153,2555,2598,98.3
25010, 동구,025,20~24세,2017,23446,12246,11200,109.3,21695,11473,10222,112.2
25010, 동구,025001, 20세,2017,4930,2143,2787,76.9,4478,1942,2536,76.6
25010, 동구,025002, 21세,2017,4720,2088,2632,79.3,4246,1873,2373,78.9
25010, 동구,025003, 22세,2017,4945,2691,2254,119.4,4573,2534,2039,124.3
25010, 동구,025004, 23세,2017,4701,2780,1921,144.7,4451,2670,1781,149.9
25010, 동구,025005, 24세,2017,4150,2544,1606,158.4,3947,2454,1493,164.4
25010, 동구,030,25~29세,2017,15087,8552,6535,130.9,14563,8325,6238,133.5
25010, 동구,030001, 25세,2017,3684,2136,1548,138,3559,2088,1471,141.9
25010, 동구,030002, 26세,2017,3241,1832,1409,130,3135,1781,1354,131.5
25010, 동구,030003, 27세,2017,2867,1639,1228,133.5,2762,1593,1169,136.3
25010, 동구,030004, 28세,2017,2633,1440,1193,120.7,2537,1396,1141,122.3
25010, 동구,030005, 29세,2017,2662,1505,1157,130.1,2570,1467,1103,133
25010, 동구,035,30~34세,2017,13451,7129,6322,112.8,13082,6988,6094,114.7
25010, 동구,035001, 30세,2017,2499,1369,1130,121.2,2424,1337,1087,123
25010, 동구,035002, 31세,2017,2622,1391,1231,113,2535,1358,1177,115.4
25010, 동구,035003, 32세,2017,2602,1384,1218,113.6,2531,1359,1172,116
25010, 동구,035004, 33세,2017,2686,1406,1280,109.8,2618,1380,1238,111.5
25010, 동구,035005, 34세,2017,3042,1579,1463,107.9,2974,1554,1420,109.4
25010, 동구,040,35~39세,2017,17019,8809,8210,107.3,16668,8659,8009,108.1
25010, 동구,040001, 35세,2017,3450,1800,1650,109.1,3375,1767,1608,109.9
25010, 동구,040002, 36세,2017,3489,1811,1678,107.9,3427,1791,1636,109.5
25010, 동구,040003, 37세,2017,3577,1869,1708,109.4,3495,1835,1660,110.5
25010, 동구,040004, 38세,2017,3294,1656,1638,101.1,3225,1625,1600,101.6
25010, 동구,040005, 39세,2017,3209,1673,1536,108.9,3146,1641,1505,109
25010, 동구,045,40~44세,2017,17421,9191,8230,111.7,17128,9043,8085,111.8
25010, 동구,045001, 40세,2017,3226,1664,1562,106.5,3165,1634,1531,106.7
25010, 동구,045002, 41세,2017,3199,1669,1530,109.1,3136,1635,1501,108.9
25010, 동구,045003, 42세,2017,3435,1828,1607,113.8,3376,1800,1576,114.2
25010, 동구,045004, 43세,2017,3777,2023,1754,115.3,3726,2002,1724,116.1
25010, 동구,045005, 44세,2017,3784,2007,1777,112.9,3725,1972,1753,112.5
25010, 동구,050,45~49세,2017,18713,9759,8954,109,18430,9604,8826,108.8
25010, 동구,050001, 45세,2017,3572,1892,1680,112.6,3513,1860,1653,112.5
25010, 동구,050002, 46세,2017,3838,2030,1808,112.3,3774,1994,1780,112
25010, 동구,050003, 47세,2017,3593,1905,1688,112.9,3536,1876,1660,113
25010, 동구,050004, 48세,2017,3858,1998,1860,107.4,3803,1973,1830,107.8
25010, 동구,050005, 49세,2017,3852,1934,1918,100.8,3804,1901,1903,99.9
25010, 동구,055,50~54세,2017,17180,8752,8428,103.8,16948,8641,8307,104
25010, 동구,055001, 50세,2017,3451,1752,1699,103.1,3408,1734,1674,103.6
25010, 동구,055002, 51세,2017,3365,1720,1645,104.6,3310,1693,1617,104.7
25010, 동구,055003, 52세,2017,3582,1800,1782,101,3545,1778,1767,100.6
25010, 동구,055004, 53세,2017,3334,1713,1621,105.7,3281,1692,1589,106.5
25010, 동구,055005, 54세,2017,3448,1767,1681,105.1,3404,1744,1660,105.1
25010, 동구,060,55~59세,2017,19759,9659,10100,95.6,19570,9568,10002,95.7
25010, 동구,060001, 55세,2017,3884,1996,1888,105.7,3842,1981,1861,106.4
25010, 동구,060002, 56세,2017,4301,2090,2211,94.5,4258,2067,2191,94.3
25010, 동구,060003, 57세,2017,4318,2058,2260,91.1,4282,2042,2240,91.2
25010, 동구,060004, 58세,2017,3732,1782,1950,91.4,3700,1763,1937,91
25010, 동구,060005, 59세,2017,3524,1733,1791,96.8,3488,1715,1773,96.7
25010, 동구,065,60~64세,2017,16009,7832,8177,95.8,15876,7761,8115,95.6
25010, 동구,065001, 60세,2017,3577,1789,1788,100.1,3555,1773,1782,99.5
25010, 동구,065002, 61세,2017,3504,1720,1784,96.4,3484,1714,1770,96.8
25010, 동구,065003, 62세,2017,3400,1647,1753,94,3359,1624,1735,93.6
25010, 동구,065004, 63세,2017,3019,1474,1545,95.4,2994,1457,1537,94.8
25010, 동구,065005, 64세,2017,2509,1202,1307,92,2484,1193,1291,92.4
25010, 동구,070,65~69세,2017,11961,5717,6244,91.6,11902,5683,6219,91.4
25010, 동구,070001, 65세,2017,2781,1352,1429,94.6,2766,1344,1422,94.5
25010, 동구,070002, 66세,2017,2144,1058,1086,97.4,2127,1046,1081,96.8
25010, 동구,070003, 67세,2017,2460,1131,1329,85.1,2447,1127,1320,85.4
25010, 동구,070004, 68세,2017,2322,1092,1230,88.8,2312,1085,1227,88.4
25010, 동구,070005, 69세,2017,2254,1084,1170,92.6,2250,1081,1169,92.5
25010, 동구,075,70~74세,2017,9216,4235,4981,85,9195,4222,4973,84.9
25010, 동구,075001, 70세,2017,2135,960,1175,81.7,2129,955,1174,81.3
25010, 동구,075002, 71세,2017,1662,791,871,90.8,1658,791,867,91.2
25010, 동구,075003, 72세,2017,1746,819,927,88.3,1744,818,926,88.3
25010, 동구,075004, 73세,2017,1826,830,996,83.3,1821,826,995,83
25010, 동구,075005, 74세,2017,1847,835,1012,82.5,1843,832,1011,82.3
25010, 동구,080,75~79세,2017,7926,3287,4639,70.9,7921,3284,4637,70.8
25010, 동구,080001, 75세,2017,2136,951,1185,80.3,2136,951,1185,80.3
25010, 동구,080002, 76세,2017,1644,682,962,70.9,1643,682,961,71
25010, 동구,080003, 77세,2017,1413,580,833,69.6,1411,579,832,69.6
25010, 동구,080004, 78세,2017,1426,569,857,66.4,1425,568,857,66.3
25010, 동구,080005, 79세,2017,1307,505,802,63,1306,504,802,62.8
25010, 동구,085,80~84세,2017,4698,1733,2965,58.4,4695,1731,2964,58.4
25010, 동구,085001, 80세,2017,1143,456,687,66.4,1142,455,687,66.2
25010, 동구,085002, 81세,2017,1079,390,689,56.6,1079,390,689,56.6
25010, 동구,085003, 82세,2017,964,357,607,58.8,964,357,607,58.8
25010, 동구,085004, 83세,2017,832,307,525,58.5,832,307,525,58.5
25010, 동구,085005, 84세,2017,680,223,457,48.8,678,222,456,48.7
25010, 동구,090,85~89세,2017,2170,624,1546,40.4,2166,623,1543,40.4
25010, 동구,090001, 85세,2017,602,195,407,47.9,602,195,407,47.9
25010, 동구,090002, 86세,2017,463,140,323,43.3,461,140,321,43.6
25010, 동구,090003, 87세,2017,446,123,323,38.1,446,123,323,38.1
25010, 동구,090004, 88세,2017,350,84,266,31.6,349,83,266,31.2
25010, 동구,090005, 89세,2017,309,82,227,36.1,308,82,226,36.3
25010, 동구,095,90~94세,2017,746,163,583,28,746,163,583,28
25010, 동구,095001, 90세,2017,257,56,201,27.9,257,56,201,27.9
25010, 동구,095002, 91세,2017,159,39,120,32.5,159,39,120,32.5
25010, 동구,095003, 92세,2017,140,32,108,29.6,140,32,108,29.6
25010, 동구,095004, 93세,2017,102,21,81,25.9,102,21,81,25.9
25010, 동구,095005, 94세,2017,88,15,73,20.5,88,15,73,20.5
25010, 동구,100,95~99세,2017,162,37,125,29.6,160,36,124,29
25010, 동구,100001, 95세,2017,61,11,50,22,61,11,50,22
25010, 동구,100002, 96세,2017,45,15,30,50,45,15,30,50
25010, 동구,100003, 97세,2017,28,6,22,27.3,26,5,21,23.8
25010, 동구,100004, 98세,2017,18,X,14,28.6,18,X,14,28.6
25010, 동구,100005, 99세,2017,10,X,9,11.1,10,X,9,11.1
25010, 동구,101,100세이상,2017,22,5,17,29.4,22,5,17,29.4
25010, 동구,102,15세미만,2017,28392,14586,13806,105.6,28316,14539,13777,105.5
25010, 동구,103,15~64세,2017,174459,90630,83829,108.1,169863,88535,81328,108.9
25010, 동구,104,65세이상,2017,36901,15801,21100,74.9,36807,15747,21060,74.8
25010, 동구,086,85세이상,2017,3100,829,2271,36.5,3094,827,2267,36.5
25010, 동구,126,평균연령,2017,41.5,40.2,42.8,,41.7,40.3,43.1,
25010, 동구,127,중위연령,2017,41.9,40.3,43.5,,42.3,40.6,44,
25020, 중구,000,합계,2017,243540,120356,123184,97.7,241733,119658,122075,98
25020, 중구,005,0~4세,2017,8776,4541,4235,107.2,8751,4525,4226,107.1
25020, 중구,005001, 0세,2017,1451,741,710,104.4,1446,739,707,104.5
25020, 중구,005002, 1세,2017,1715,874,841,103.9,1707,869,838,103.7
25020, 중구,005003, 2세,2017,1845,978,867,112.8,1842,975,867,112.5
25020, 중구,005004, 3세,2017,1831,922,909,101.4,1827,920,907,101.4
25020, 중구,005005, 4세,2017,1934,1026,908,113,1929,1022,907,112.7
25020, 중구,010,5~9세,2017,10451,5353,5098,105,10443,5347,5096,104.9
25020, 중구,010001, 5세,2017,2092,1061,1031,102.9,2090,1060,1030,102.9
25020, 중구,010002, 6세,2017,2120,1085,1035,104.8,2118,1083,1035,104.6
25020, 중구,010003, 7세,2017,2029,1022,1007,101.5,2028,1021,1007,101.4
25020, 중구,010004, 8세,2017,1973,1016,957,106.2,1972,1015,957,106.1
25020, 중구,010005, 9세,2017,2237,1169,1068,109.5,2235,1168,1067,109.5
25020, 중구,015,10~14세,2017,10961,5639,5322,106,10956,5637,5319,106
25020, 중구,015001, 10세,2017,2245,1185,1060,111.8,2244,1185,1059,111.9
25020, 중구,015002, 11세,2017,2024,1010,1014,99.6,2023,1010,1013,99.7
25020, 중구,015003, 12세,2017,2093,1057,1036,102,2093,1057,1036,102
25020, 중구,015004, 13세,2017,2226,1145,1081,105.9,2225,1145,1080,106
25020, 중구,015005, 14세,2017,2373,1242,1131,109.8,2371,1240,1131,109.6
25020, 중구,020,15~19세,2017,14084,7568,6516,116.1,14057,7556,6501,116.2
25020, 중구,020001, 15세,2017,2493,1331,1162,114.5,2492,1331,1161,114.6
25020, 중구,020002, 16세,2017,2875,1549,1326,116.8,2868,1544,1324,116.6
25020, 중구,020003, 17세,2017,3091,1652,1439,114.8,3086,1650,1436,114.9
25020, 중구,020004, 18세,2017,2982,1605,1377,116.6,2978,1604,1374,116.7
25020, 중구,020005, 19세,2017,2643,1431,1212,118.1,2633,1427,1206,118.3
25020, 중구,025,20~24세,2017,16173,8393,7780,107.9,16025,8340,7685,108.5
25020, 중구,025001, 20세,2017,2984,1612,1372,117.5,2973,1606,1367,117.5
25020, 중구,025002, 21세,2017,3265,1754,1511,116.1,3243,1744,1499,116.3
25020, 중구,025003, 22세,2017,3279,1654,1625,101.8,3249,1645,1604,102.6
25020, 중구,025004, 23세,2017,3368,1694,1674,101.2,3331,1682,1649,102
25020, 중구,025005, 24세,2017,3277,1679,1598,105.1,3229,1663,1566,106.2
25020, 중구,030,25~29세,2017,14799,7725,7074,109.2,14487,7632,6855,111.3
25020, 중구,030001, 25세,2017,3270,1692,1578,107.2,3204,1675,1529,109.5
25020, 중구,030002, 26세,2017,3165,1617,1548,104.5,3108,1597,1511,105.7
25020, 중구,030003, 27세,2017,2885,1512,1373,110.1,2826,1496,1330,112.5
25020, 중구,030004, 28세,2017,2758,1484,1274,116.5,2691,1469,1222,120.2
25020, 중구,030005, 29세,2017,2721,1420,1301,109.1,2658,1395,1263,110.5
25020, 중구,035,30~34세,2017,13762,7020,6742,104.1,13522,6940,6582,105.4
25020, 중구,035001, 30세,2017,2691,1362,1329,102.5,2630,1341,1289,104
25020, 중구,035002, 31세,2017,2628,1344,1284,104.7,2574,1327,1247,106.4
25020, 중구,035003, 32세,2017,2592,1308,1284,101.9,2554,1294,1260,102.7
25020, 중구,035004, 33세,2017,2751,1422,1329,107,2716,1407,1309,107.5
25020, 중구,035005, 34세,2017,3100,1584,1516,104.5,3048,1571,1477,106.4
25020, 중구,040,35~39세,2017,17664,8867,8797,100.8,17490,8801,8689,101.3
25020, 중구,040001, 35세,2017,3388,1688,1700,99.3,3344,1670,1674,99.8
25020, 중구,040002, 36세,2017,3604,1794,1810,99.1,3566,1779,1787,99.6
25020, 중구,040003, 37세,2017,3755,1896,1859,102,3712,1885,1827,103.2
25020, 중구,040004, 38세,2017,3638,1828,1810,101,3611,1818,1793,101.4
25020, 중구,040005, 39세,2017,3279,1661,1618,102.7,3257,1649,1608,102.5
25020, 중구,045,40~44세,2017,18749,9445,9304,101.5,18614,9389,9225,101.8
25020, 중구,045001, 40세,2017,3497,1723,1774,97.1,3466,1711,1755,97.5
25020, 중구,045002, 41세,2017,3466,1733,1733,100,3439,1722,1717,100.3
25020, 중구,045003, 42세,2017,3599,1821,1778,102.4,3574,1810,1764,102.6
25020, 중구,045004, 43세,2017,4024,2091,1933,108.2,4000,2081,1919,108.4
25020, 중구,045005, 44세,2017,4163,2077,2086,99.6,4135,2065,2070,99.8
25020, 중구,050,45~49세,2017,21501,10850,10651,101.9,21304,10776,10528,102.4
25020, 중구,050001, 45세,2017,4098,2107,1991,105.8,4060,2093,1967,106.4
25020, 중구,050002, 46세,2017,4367,2225,2142,103.9,4336,2217,2119,104.6
25020, 중구,050003, 47세,2017,4191,2127,2064,103.1,4148,2114,2034,103.9
25020, 중구,050004, 48세,2017,4491,2279,2212,103,4437,2254,2183,103.3
25020, 중구,050005, 49세,2017,4354,2112,2242,94.2,4323,2098,2225,94.3
25020, 중구,055,50~54세,2017,18838,9497,9341,101.7,18665,9414,9251,101.8
25020, 중구,055001, 50세,2017,3946,1953,1993,98,3912,1936,1976,98
25020, 중구,055002, 51세,2017,3724,1928,1796,107.3,3690,1912,1778,107.5
25020, 중구,055003, 52세,2017,3909,1961,1948,100.7,3875,1942,1933,100.5
25020, 중구,055004, 53세,2017,3640,1862,1778,104.7,3611,1850,1761,105.1
25020, 중구,055005, 54세,2017,3619,1793,1826,98.2,3577,1774,1803,98.4
25020, 중구,060,55~59세,2017,20544,9939,10605,93.7,20401,9890,10511,94.1
25020, 중구,060001, 55세,2017,4163,2074,2089,99.3,4122,2062,2060,100.1
25020, 중구,060002, 56세,2017,4385,2136,2249,95,4358,2126,2232,95.3
25020, 중구,060003, 57세,2017,4341,2052,2289,89.6,4315,2040,2275,89.7
25020, 중구,060004, 58세,2017,3889,1865,2024,92.1,3864,1856,2008,92.4
25020, 중구,060005, 59세,2017,3766,1812,1954,92.7,3742,1806,1936,93.3
25020, 중구,065,60~64세,2017,17135,8147,8988,90.6,16997,8077,8920,90.5
25020, 중구,065001, 60세,2017,3764,1859,1905,97.6,3732,1847,1885,98
25020, 중구,065002, 61세,2017,3610,1706,1904,89.6,3577,1689,1888,89.5
25020, 중구,065003, 62세,2017,3719,1759,1960,89.7,3693,1746,1947,89.7
25020, 중구,065004, 63세,2017,3300,1504,1796,83.7,3275,1491,1784,83.6
25020, 중구,065005, 64세,2017,2742,1319,1423,92.7,2720,1304,1416,92.1
25020, 중구,070,65~69세,2017,13117,6206,6911,89.8,13076,6186,6890,89.8
25020, 중구,070001, 65세,2017,3016,1430,1586,90.2,3007,1425,1582,90.1
25020, 중구,070002, 66세,2017,2267,1093,1174,93.1,2256,1088,1168,93.2
25020, 중구,070003, 67세,2017,2589,1180,1409,83.7,2581,1175,1406,83.6
25020, 중구,070004, 68세,2017,2696,1272,1424,89.3,2687,1268,1419,89.4
25020, 중구,070005, 69세,2017,2549,1231,1318,93.4,2545,1230,1315,93.5
25020, 중구,075,70~74세,2017,9924,4562,5362,85.1,9905,4552,5353,85
25020, 중구,075001, 70세,2017,2351,1081,1270,85.1,2343,1077,1266,85.1
25020, 중구,075002, 71세,2017,1945,934,1011,92.4,1937,930,1007,92.4
25020, 중구,075003, 72세,2017,1852,844,1008,83.7,1851,843,1008,83.6
25020, 중구,075004, 73세,2017,1921,879,1042,84.4,1920,878,1042,84.3
25020, 중구,075005, 74세,2017,1855,824,1031,79.9,1854,824,1030,80
25020, 중구,080,75~79세,2017,8545,3722,4823,77.2,8536,3719,4817,77.2
25020, 중구,080001, 75세,2017,2295,1010,1285,78.6,2293,1009,1284,78.6
25020, 중구,080002, 76세,2017,1695,744,951,78.2,1693,743,950,78.2
25020, 중구,080003, 77세,2017,1511,652,859,75.9,1510,652,858,76
25020, 중구,080004, 78세,2017,1567,684,883,77.5,1564,683,881,77.5
25020, 중구,080005, 79세,2017,1477,632,845,74.8,1476,632,844,74.9
25020, 중구,085,80~84세,2017,5127,1930,3197,60.4,5117,1927,3190,60.4
25020, 중구,085001, 80세,2017,1265,510,755,67.5,1262,509,753,67.6
25020, 중구,085002, 81세,2017,1169,454,715,63.5,1168,454,714,63.6
25020, 중구,085003, 82세,2017,1030,390,640,60.9,1028,389,639,60.9
25020, 중구,085004, 83세,2017,890,313,577,54.2,887,312,575,54.3
25020, 중구,085005, 84세,2017,773,263,510,51.6,772,263,509,51.7
25020, 중구,090,85~89세,2017,2395,708,1687,42,2392,706,1686,41.9
25020, 중구,090001, 85세,2017,666,218,448,48.7,665,217,448,48.4
25020, 중구,090002, 86세,2017,538,169,369,45.8,537,169,368,45.9
25020, 중구,090003, 87세,2017,492,130,362,35.9,492,130,362,35.9
25020, 중구,090004, 88세,2017,380,108,272,39.7,380,108,272,39.7
25020, 중구,090005, 89세,2017,319,83,236,35.2,318,82,236,34.7
25020, 중구,095,90~94세,2017,807,197,610,32.3,807,197,610,32.3
25020, 중구,095001, 90세,2017,277,78,199,39.2,277,78,199,39.2
25020, 중구,095002, 91세,2017,169,39,130,30,169,39,130,30
25020, 중구,095003, 92세,2017,152,40,112,35.7,152,40,112,35.7
25020, 중구,095004, 93세,2017,113,23,90,25.6,113,23,90,25.6
25020, 중구,095005, 94세,2017,96,17,79,21.5,96,17,79,21.5
25020, 중구,100,95~99세,2017,163,44,119,37,163,44,119,37
25020, 중구,100001, 95세,2017,64,18,46,39.1,64,18,46,39.1
25020, 중구,100002, 96세,2017,50,18,32,56.3,50,18,32,56.3
25020, 중구,100003, 97세,2017,28,5,23,21.7,28,5,23,21.7
25020, 중구,100004, 98세,2017,13,X,11,18.2,13,X,11,18.2
25020, 중구,100005, 99세,2017,8,X,7,14.3,8,X,7,14.3
25020, 중구,101,100세이상,2017,25,X,22,13.6,25,X,22,13.6
25020, 중구,102,15세미만,2017,30188,15533,14655,106,30150,15509,14641,105.9
25020, 중구,103,15~64세,2017,173249,87451,85798,101.9,171562,86815,84747,102.4
25020, 중구,104,65세이상,2017,40103,17372,22731,76.4,40021,17334,22687,76.4
25020, 중구,086,85세이상,2017,3390,952,2438,39,3387,950,2437,39
25020, 중구,126,평균연령,2017,42.7,41.5,44,,42.8,41.5,44,
25020, 중구,127,중위연령,2017,44.1,42.9,45.4,,44.2,42.9,45.4,
25030, 서구,000,합계,2017,487449,239928,247521,96.9,483493,238247,245246,97.1
25030, 서구,005,0~4세,2017,20450,10567,9883,106.9,20388,10537,9851,107
25030, 서구,005001, 0세,2017,3547,1825,1722,106,3536,1820,1716,106.1
25030, 서구,005002, 1세,2017,4127,2181,1946,112.1,4111,2173,1938,112.1
25030, 서구,005003, 2세,2017,4244,2168,2076,104.4,4233,2163,2070,104.5
25030, 서구,005004, 3세,2017,4128,2144,1984,108.1,4116,2137,1979,108
25030, 서구,005005, 4세,2017,4404,2249,2155,104.4,4392,2244,2148,104.5
25030, 서구,010,5~9세,2017,22548,11613,10935,106.2,22512,11600,10912,106.3
25030, 서구,010001, 5세,2017,4572,2393,2179,109.8,4560,2390,2170,110.1
25030, 서구,010002, 6세,2017,4609,2349,2260,103.9,4605,2347,2258,103.9
25030, 서구,010003, 7세,2017,4480,2276,2204,103.3,4472,2273,2199,103.4
25030, 서구,010004, 8세,2017,4323,2264,2059,110,4315,2260,2055,110
25030, 서구,010005, 9세,2017,4564,2331,2233,104.4,4560,2330,2230,104.5
25030, 서구,015,10~14세,2017,24537,12580,11957,105.2,24525,12574,11951,105.2
25030, 서구,015001, 10세,2017,4870,2468,2402,102.7,4868,2466,2402,102.7
25030, 서구,015002, 11세,2017,4551,2342,2209,106,4549,2341,2208,106
25030, 서구,015003, 12세,2017,4622,2415,2207,109.4,4618,2414,2204,109.5
25030, 서구,015004, 13세,2017,5233,2696,2537,106.3,5231,2696,2535,106.4
25030, 서구,015005, 14세,2017,5261,2659,2602,102.2,5259,2657,2602,102.1
25030, 서구,020,15~19세,2017,32922,16833,16089,104.6,32810,16785,16025,104.7
25030, 서구,020001, 15세,2017,5363,2851,2512,113.5,5360,2851,2509,113.6
25030, 서구,020002, 16세,2017,6043,3111,2932,106.1,6042,3111,2931,106.1
25030, 서구,020003, 17세,2017,6732,3376,3356,100.6,6724,3370,3354,100.5
25030, 서구,020004, 18세,2017,7010,3582,3428,104.5,6981,3565,3416,104.4
25030, 서구,020005, 19세,2017,7774,3913,3861,101.3,7703,3888,3815,101.9
25030, 서구,025,20~24세,2017,40588,20735,19853,104.4,39811,20486,19325,106
25030, 서구,025001, 20세,2017,7895,3820,4075,93.7,7779,3782,3997,94.6
25030, 서구,025002, 21세,2017,7933,3850,4083,94.3,7796,3805,3991,95.3
25030, 서구,025003, 22세,2017,8330,4309,4021,107.2,8159,4256,3903,109
25030, 서구,025004, 23세,2017,8409,4455,3954,112.7,8209,4389,3820,114.9
25030, 서구,025005, 24세,2017,8021,4301,3720,115.6,7868,4254,3614,117.7
25030, 서구,030,25~29세,2017,35548,18250,17298,105.5,34836,17967,16869,106.5
25030, 서구,030001, 25세,2017,8072,4157,3915,106.2,7930,4108,3822,107.5
25030, 서구,030002, 26세,2017,7268,3676,3592,102.3,7129,3622,3507,103.3
25030, 서구,030003, 27세,2017,7007,3600,3407,105.7,6858,3552,3306,107.4
25030, 서구,030004, 28세,2017,6704,3484,3220,108.2,6560,3414,3146,108.5
25030, 서구,030005, 29세,2017,6497,3333,3164,105.3,6359,3271,3088,105.9
25030, 서구,035,30~34세,2017,33134,16739,16395,102.1,32631,16521,16110,102.6
25030, 서구,035001, 30세,2017,6367,3174,3193,99.4,6247,3117,3130,99.6
25030, 서구,035002, 31세,2017,6450,3316,3134,105.8,6347,3281,3066,107
25030, 서구,035003, 32세,2017,6515,3332,3183,104.7,6419,3291,3128,105.2
25030, 서구,035004, 33세,2017,6592,3276,3316,98.8,6485,3225,3260,98.9
25030, 서구,035005, 34세,2017,7210,3641,3569,102,7133,3607,3526,102.3
25030, 서구,040,35~39세,2017,37437,18507,18930,97.8,37041,18317,18724,97.8
25030, 서구,040001, 35세,2017,7721,3820,3901,97.9,7623,3776,3847,98.2
25030, 서구,040002, 36세,2017,7573,3809,3764,101.2,7479,3767,3712,101.5
25030, 서구,040003, 37세,2017,7802,3823,3979,96.1,7729,3789,3940,96.2
25030, 서구,040004, 38세,2017,7400,3676,3724,98.7,7336,3642,3694,98.6
25030, 서구,040005, 39세,2017,6941,3379,3562,94.9,6874,3343,3531,94.7
25030, 서구,045,40~44세,2017,38832,18558,20274,91.5,38538,18417,20121,91.5
25030, 서구,045001, 40세,2017,7183,3450,3733,92.4,7124,3424,3700,92.5
25030, 서구,045002, 41세,2017,7151,3420,3731,91.7,7087,3395,3692,92
25030, 서구,045003, 42세,2017,7523,3630,3893,93.2,7464,3598,3866,93.1
25030, 서구,045004, 43세,2017,8397,3932,4465,88.1,8339,3903,4436,88
25030, 서구,045005, 44세,2017,8578,4126,4452,92.7,8524,4097,4427,92.5
25030, 서구,050,45~49세,2017,45276,21846,23430,93.2,44948,21675,23273,93.1
25030, 서구,050001, 45세,2017,8481,4132,4349,95,8403,4089,4314,94.8
25030, 서구,050002, 46세,2017,9457,4544,4913,92.5,9390,4509,4881,92.4
25030, 서구,050003, 47세,2017,8828,4327,4501,96.1,8772,4297,4475,96
25030, 서구,050004, 48세,2017,9289,4429,4860,91.1,9228,4395,4833,90.9
25030, 서구,050005, 49세,2017,9221,4414,4807,91.8,9155,4385,4770,91.9
25030, 서구,055,50~54세,2017,38121,18565,19556,94.9,37844,18440,19404,95
25030, 서구,055001, 50세,2017,8118,3878,4240,91.5,8071,3856,4215,91.5
25030, 서구,055002, 51세,2017,7447,3629,3818,95,7386,3604,3782,95.3
25030, 서구,055003, 52세,2017,7894,3858,4036,95.6,7836,3832,4004,95.7
25030, 서구,055004, 53세,2017,7238,3479,3759,92.6,7187,3453,3734,92.5
25030, 서구,055005, 54세,2017,7424,3721,3703,100.5,7364,3695,3669,100.7
25030, 서구,060,55~59세,2017,38796,19016,19780,96.1,38612,18929,19683,96.2
25030, 서구,060001, 55세,2017,7912,3940,3972,99.2,7870,3919,3951,99.2
25030, 서구,060002, 56세,2017,8772,4250,4522,94,8737,4235,4502,94.1
25030, 서구,060003, 57세,2017,8239,3978,4261,93.4,8191,3956,4235,93.4
25030, 서구,060004, 58세,2017,7206,3532,3674,96.1,7184,3525,3659,96.3
25030, 서구,060005, 59세,2017,6667,3316,3351,99,6630,3294,3336,98.7
25030, 서구,065,60~64세,2017,27808,13674,14134,96.7,27672,13601,14071,96.7
25030, 서구,065001, 60세,2017,6577,3244,3333,97.3,6551,3233,3318,97.4
25030, 서구,065002, 61세,2017,6055,3023,3032,99.7,6021,3006,3015,99.7
25030, 서구,065003, 62세,2017,5991,2891,3100,93.3,5961,2871,3090,92.9
25030, 서구,065004, 63세,2017,5007,2432,2575,94.4,4979,2414,2565,94.1
25030, 서구,065005, 64세,2017,4178,2084,2094,99.5,4160,2077,2083,99.7
25030, 서구,070,65~69세,2017,18091,8861,9230,96,18010,8830,9180,96.2
25030, 서구,070001, 65세,2017,4385,2158,2227,96.9,4362,2150,2212,97.2
25030, 서구,070002, 66세,2017,3307,1592,1715,92.8,3290,1586,1704,93.1
25030, 서구,070003, 67세,2017,3732,1851,1881,98.4,3716,1842,1874,98.3
25030, 서구,070004, 68세,2017,3422,1715,1707,100.5,3404,1710,1694,100.9
25030, 서구,070005, 69세,2017,3245,1545,1700,90.9,3238,1542,1696,90.9
25030, 서구,075,70~74세,2017,12305,5706,6599,86.5,12283,5698,6585,86.5
25030, 서구,075001, 70세,2017,3066,1479,1587,93.2,3061,1476,1585,93.1
25030, 서구,075002, 71세,2017,2382,1143,1239,92.3,2373,1141,1232,92.6
25030, 서구,075003, 72세,2017,2285,1064,1221,87.1,2282,1062,1220,87
25030, 서구,075004, 73세,2017,2341,1024,1317,77.8,2338,1023,1315,77.8
25030, 서구,075005, 74세,2017,2231,996,1235,80.6,2229,996,1233,80.8
25030, 서구,080,75~79세,2017,10409,4478,5931,75.5,10398,4474,5924,75.5
25030, 서구,080001, 75세,2017,2813,1307,1506,86.8,2811,1307,1504,86.9
25030, 서구,080002, 76세,2017,2082,915,1167,78.4,2077,912,1165,78.3
25030, 서구,080003, 77세,2017,1821,784,1037,75.6,1820,784,1036,75.7
25030, 서구,080004, 78세,2017,1977,782,1195,65.4,1975,781,1194,65.4
25030, 서구,080005, 79세,2017,1716,690,1026,67.3,1715,690,1025,67.3
25030, 서구,085,80~84세,2017,6316,2277,4039,56.4,6310,2275,4035,56.4
25030, 서구,085001, 80세,2017,1508,605,903,67,1507,605,902,67.1
25030, 서구,085002, 81세,2017,1398,489,909,53.8,1397,488,909,53.7
25030, 서구,085003, 82세,2017,1308,479,829,57.8,1306,479,827,57.9
25030, 서구,085004, 83세,2017,1152,387,765,50.6,1150,386,764,50.5
25030, 서구,085005, 84세,2017,950,317,633,50.1,950,317,633,50.1
25030, 서구,090,85~89세,2017,3011,817,2194,37.2,3007,816,2191,37.2
25030, 서구,090001, 85세,2017,862,276,586,47.1,862,276,586,47.1
25030, 서구,090002, 86세,2017,614,160,454,35.2,614,160,454,35.2
25030, 서구,090003, 87세,2017,603,157,446,35.2,603,157,446,35.2
25030, 서구,090004, 88세,2017,501,120,381,31.5,497,119,378,31.5
25030, 서구,090005, 89세,2017,431,104,327,31.8,431,104,327,31.8
25030, 서구,095,90~94세,2017,1050,249,801,31.1,1047,248,799,31
25030, 서구,095001, 90세,2017,333,91,242,37.6,331,90,241,37.3
25030, 서구,095002, 91세,2017,220,63,157,40.1,219,63,156,40.4
25030, 서구,095003, 92세,2017,202,31,171,18.1,202,31,171,18.1
25030, 서구,095004, 93세,2017,144,34,110,30.9,144,34,110,30.9
25030, 서구,095005, 94세,2017,151,30,121,24.8,151,30,121,24.8
25030, 서구,100,95~99세,2017,230,46,184,25,230,46,184,25
25030, 서구,100001, 95세,2017,100,24,76,31.6,100,24,76,31.6
25030, 서구,100002, 96세,2017,44,11,33,33.3,44,11,33,33.3
25030, 서구,100003, 97세,2017,37,X,33,12.1,37,X,33,12.1
25030, 서구,100004, 98세,2017,29,6,23,26.1,29,6,23,26.1
25030, 서구,100005, 99세,2017,20,X,19,5.3,20,X,19,5.3
25030, 서구,101,100세이상,2017,40,11,29,37.9,40,11,29,37.9
25030, 서구,102,15세미만,2017,67535,34760,32775,106.1,67425,34711,32714,106.1
25030, 서구,103,15~64세,2017,368462,182723,185739,98.4,364743,181138,183605,98.7
25030, 서구,104,65세이상,2017,51452,22445,29007,77.4,51325,22398,28927,77.4
25030, 서구,086,85세이상,2017,4331,1123,3208,35,4324,1121,3203,35
25030, 서구,126,평균연령,2017,39.1,38.2,40,,39.1,38.2,40,
25030, 서구,127,중위연령,2017,39.5,38.3,40.6,,39.6,38.4,40.8,
25040, 유성구,000,합계,2017,366639,188954,177685,106.3,359459,185285,174174,106.4
25040, 유성구,005,0~4세,2017,19833,10189,9644,105.7,19608,10080,9528,105.8
25040, 유성구,005001, 0세,2017,3526,1791,1735,103.2,3480,1768,1712,103.3
25040, 유성구,005002, 1세,2017,4015,2103,1912,110,3959,2074,1885,110
25040, 유성구,005003, 2세,2017,4236,2143,2093,102.4,4188,2118,2070,102.3
25040, 유성구,005004, 3세,2017,4010,2101,1909,110.1,3971,2086,1885,110.7
25040, 유성구,005005, 4세,2017,4046,2051,1995,102.8,4010,2034,1976,102.9
25040, 유성구,010,5~9세,2017,20260,10493,9767,107.4,20141,10431,9710,107.4
25040, 유성구,010001, 5세,2017,4273,2239,2034,110.1,4244,2227,2017,110.4
25040, 유성구,010002, 6세,2017,4234,2243,1991,112.7,4201,2223,1978,112.4
25040, 유성구,010003, 7세,2017,3970,2032,1938,104.9,3953,2023,1930,104.8
25040, 유성구,010004, 8세,2017,3793,1899,1894,100.3,3773,1891,1882,100.5
25040, 유성구,010005, 9세,2017,3990,2080,1910,108.9,3970,2067,1903,108.6
25040, 유성구,015,10~14세,2017,19099,9996,9103,109.8,19041,9966,9075,109.8
25040, 유성구,015001, 10세,2017,4060,2039,2021,100.9,4047,2035,2012,101.1
25040, 유성구,015002, 11세,2017,3762,2002,1760,113.8,3745,1993,1752,113.8
25040, 유성구,015003, 12세,2017,3574,1909,1665,114.7,3565,1904,1661,114.6
25040, 유성구,015004, 13세,2017,3891,2053,1838,111.7,3882,2046,1836,111.4
25040, 유성구,015005, 14세,2017,3812,1993,1819,109.6,3802,1988,1814,109.6
25040, 유성구,020,15~19세,2017,25197,13611,11586,117.5,24862,13438,11424,117.6
25040, 유성구,020001, 15세,2017,3926,2091,1835,114,3919,2087,1832,113.9
25040, 유성구,020002, 16세,2017,4221,2194,2027,108.2,4211,2187,2024,108.1
25040, 유성구,020003, 17세,2017,4514,2360,2154,109.6,4490,2345,2145,109.3
25040, 유성구,020004, 18세,2017,5379,2943,2436,120.8,5296,2901,2395,121.1
25040, 유성구,020005, 19세,2017,7157,4023,3134,128.4,6946,3918,3028,129.4
25040, 유성구,025,20~24세,2017,33192,18426,14766,124.8,31529,17643,13886,127.1
25040, 유성구,025001, 20세,2017,6518,3381,3137,107.8,6243,3254,2989,108.9
25040, 유성구,025002, 21세,2017,6451,3327,3124,106.5,6120,3156,2964,106.5
25040, 유성구,025003, 22세,2017,6577,3717,2860,130,6192,3541,2651,133.6
25040, 유성구,025004, 23세,2017,6854,4038,2816,143.4,6507,3896,2611,149.2
25040, 유성구,025005, 24세,2017,6792,3963,2829,140.1,6467,3796,2671,142.1
25040, 유성구,030,25~29세,2017,29758,17143,12615,135.9,28359,16437,11922,137.9
25040, 유성구,030001, 25세,2017,6673,3917,2756,142.1,6365,3773,2592,145.6
25040, 유성구,030002, 26세,2017,6047,3468,2579,134.5,5763,3328,2435,136.7
25040, 유성구,030003, 27세,2017,5800,3376,2424,139.3,5510,3234,2276,142.1
25040, 유성구,030004, 28세,2017,5685,3285,2400,136.9,5418,3146,2272,138.5
25040, 유성구,030005, 29세,2017,5553,3097,2456,126.1,5303,2956,2347,125.9
25040, 유성구,035,30~34세,2017,28872,15302,13570,112.8,27843,14718,13125,112.1
25040, 유성구,035001, 30세,2017,5526,2979,2547,117,5279,2838,2441,116.3
25040, 유성구,035002, 31세,2017,5603,3015,2588,116.5,5353,2879,2474,116.4
25040, 유성구,035003, 32세,2017,5630,3011,2619,115,5443,2905,2538,114.5
25040, 유성구,035004, 33세,2017,5679,2997,2682,111.7,5502,2890,2612,110.6
25040, 유성구,035005, 34세,2017,6434,3300,3134,105.3,6266,3206,3060,104.8
25040, 유성구,040,35~39세,2017,32175,16048,16127,99.5,31495,15675,15820,99.1
25040, 유성구,040001, 35세,2017,6681,3385,3296,102.7,6521,3304,3217,102.7
25040, 유성구,040002, 36세,2017,6813,3403,3410,99.8,6665,3325,3340,99.6
25040, 유성구,040003, 37세,2017,6643,3334,3309,100.8,6496,3244,3252,99.8
25040, 유성구,040004, 38세,2017,6115,3012,3103,97.1,5994,2950,3044,96.9
25040, 유성구,040005, 39세,2017,5923,2914,3009,96.8,5819,2852,2967,96.1
25040, 유성구,045,40~44세,2017,30737,15226,15511,98.2,30338,15006,15332,97.9
25040, 유성구,045001, 40세,2017,5984,2989,2995,99.8,5895,2939,2956,99.4
25040, 유성구,045002, 41세,2017,5833,2926,2907,100.7,5763,2889,2874,100.5
25040, 유성구,045003, 42세,2017,5999,2996,3003,99.8,5923,2955,2968,99.6
25040, 유성구,045004, 43세,2017,6395,3157,3238,97.5,6310,3109,3201,97.1
25040, 유성구,045005, 44세,2017,6526,3158,3368,93.8,6447,3114,3333,93.4
25040, 유성구,050,45~49세,2017,32426,16256,16170,100.5,32013,16031,15982,100.3
25040, 유성구,050001, 45세,2017,6356,3229,3127,103.3,6273,3176,3097,102.6
25040, 유성구,050002, 46세,2017,6744,3419,3325,102.8,6658,3378,3280,103
25040, 유성구,050003, 47세,2017,6509,3209,3300,97.2,6418,3165,3253,97.3
25040, 유성구,050004, 48세,2017,6398,3185,3213,99.1,6322,3141,3181,98.7
25040, 유성구,050005, 49세,2017,6419,3214,3205,100.3,6342,3171,3171,100
25040, 유성구,055,50~54세,2017,26239,13341,12898,103.4,25912,13183,12729,103.6
25040, 유성구,055001, 50세,2017,5579,2813,2766,101.7,5510,2781,2729,101.9
25040, 유성구,055002, 51세,2017,5216,2756,2460,112,5141,2719,2422,112.3
25040, 유성구,055003, 52세,2017,5351,2625,2726,96.3,5298,2600,2698,96.4
25040, 유성구,055004, 53세,2017,4946,2490,2456,101.4,4891,2466,2425,101.7
25040, 유성구,055005, 54세,2017,5147,2657,2490,106.7,5072,2617,2455,106.6
25040, 유성구,060,55~59세,2017,24818,12505,12313,101.6,24597,12408,12189,101.8
25040, 유성구,060001, 55세,2017,5201,2653,2548,104.1,5154,2631,2523,104.3
25040, 유성구,060002, 56세,2017,5589,2826,2763,102.3,5558,2810,2748,102.3
25040, 유성구,060003, 57세,2017,5213,2590,2623,98.7,5164,2567,2597,98.8
25040, 유성구,060004, 58세,2017,4654,2378,2276,104.5,4604,2357,2247,104.9
25040, 유성구,060005, 59세,2017,4161,2058,2103,97.9,4117,2043,2074,98.5
25040, 유성구,065,60~64세,2017,16556,8624,7932,108.7,16386,8536,7850,108.7
25040, 유성구,065001, 60세,2017,4059,2117,1942,109,4013,2098,1915,109.6
25040, 유성구,065002, 61세,2017,3618,1873,1745,107.3,3585,1858,1727,107.6
25040, 유성구,065003, 62세,2017,3567,1831,1736,105.5,3543,1818,1725,105.4
25040, 유성구,065004, 63세,2017,2914,1512,1402,107.8,2878,1490,1388,107.3
25040, 유성구,065005, 64세,2017,2398,1291,1107,116.6,2367,1272,1095,116.2
25040, 유성구,070,65~69세,2017,9521,4797,4724,101.5,9451,4769,4682,101.9
25040, 유성구,070001, 65세,2017,2434,1223,1211,101,2413,1213,1200,101.1
25040, 유성구,070002, 66세,2017,1702,844,858,98.4,1687,841,846,99.4
25040, 유성구,070003, 67세,2017,1896,958,938,102.1,1883,952,931,102.3
25040, 유성구,070004, 68세,2017,1801,932,869,107.2,1786,926,860,107.7
25040, 유성구,070005, 69세,2017,1688,840,848,99.1,1682,837,845,99.1
25040, 유성구,075,70~74세,2017,6197,2878,3319,86.7,6170,2865,3305,86.7
25040, 유성구,075001, 70세,2017,1494,729,765,95.3,1489,727,762,95.4
25040, 유성구,075002, 71세,2017,1136,552,584,94.5,1130,550,580,94.8
25040, 유성구,075003, 72세,2017,1184,539,645,83.6,1180,537,643,83.5
25040, 유성구,075004, 73세,2017,1229,566,663,85.4,1223,563,660,85.3
25040, 유성구,075005, 74세,2017,1154,492,662,74.3,1148,488,660,73.9
25040, 유성구,080,75~79세,2017,5410,2215,3195,69.3,5381,2204,3177,69.4
25040, 유성구,080001, 75세,2017,1406,628,778,80.7,1401,627,774,81
25040, 유성구,080002, 76세,2017,1100,438,662,66.2,1095,436,659,66.2
25040, 유성구,080003, 77세,2017,971,403,568,71,961,398,563,70.7
25040, 유성구,080004, 78세,2017,1000,394,606,65,994,393,601,65.4
25040, 유성구,080005, 79세,2017,933,352,581,60.6,930,350,580,60.3
25040, 유성구,085,80~84세,2017,3625,1195,2430,49.2,3612,1188,2424,49
25040, 유성구,085001, 80세,2017,841,329,512,64.3,838,327,511,64
25040, 유성구,085002, 81세,2017,817,259,558,46.4,814,258,556,46.4
25040, 유성구,085003, 82세,2017,727,214,513,41.7,724,212,512,41.4
25040, 유성구,085004, 83세,2017,655,216,439,49.2,653,215,438,49.1
25040, 유성구,085005, 84세,2017,585,177,408,43.4,583,176,407,43.2
25040, 유성구,090,85~89세,2017,1912,522,1390,37.6,1910,521,1389,37.5
25040, 유성구,090001, 85세,2017,527,143,384,37.2,527,143,384,37.2
25040, 유성구,090002, 86세,2017,397,112,285,39.3,397,112,285,39.3
25040, 유성구,090003, 87세,2017,370,99,271,36.5,370,99,271,36.5
25040, 유성구,090004, 88세,2017,320,87,233,37.3,319,86,233,36.9
25040, 유성구,090005, 89세,2017,298,81,217,37.3,297,81,216,37.5
25040, 유성구,095,90~94세,2017,653,156,497,31.4,652,155,497,31.2
25040, 유성구,095001, 90세,2017,211,54,157,34.4,210,53,157,33.8
25040, 유성구,095002, 91세,2017,141,40,101,39.6,141,40,101,39.6
25040, 유성구,095003, 92세,2017,128,28,100,28,128,28,100,28
25040, 유성구,095004, 93세,2017,83,18,65,27.7,83,18,65,27.7
25040, 유성구,095005, 94세,2017,90,16,74,21.6,90,16,74,21.6
25040, 유성구,100,95~99세,2017,144,28,116,24.1,144,28,116,24.1
25040, 유성구,100001, 95세,2017,60,11,49,22.4,60,11,49,22.4
25040, 유성구,100002, 96세,2017,30,5,25,20,30,5,25,20
25040, 유성구,100003, 97세,2017,25,6,19,31.6,25,6,19,31.6
25040, 유성구,100004, 98세,2017,18,X,14,28.6,18,X,14,28.6
25040, 유성구,100005, 99세,2017,11,X,9,22.2,11,X,9,22.2
25040, 유성구,101,100세이상,2017,15,X,12,25,15,X,12,25
25040, 유성구,102,15세미만,2017,59192,30678,28514,107.6,58790,30477,28313,107.6
25040, 유성구,103,15~64세,2017,279970,146482,133488,109.7,273334,143075,130259,109.8
25040, 유성구,104,65세이상,2017,27477,11794,15683,75.2,27335,11733,15602,75.2
25040, 유성구,086,85세이상,2017,2724,709,2015,35.2,2721,707,2014,35.1
25040, 유성구,126,평균연령,2017,36.3,35.4,37.3,,36.4,35.5,37.4,
25040, 유성구,127,중위연령,2017,36.1,34.8,37.3,,36.3,35,37.6,
25050, 대덕구,000,합계,2017,188469,95463,93006,102.6,185644,94004,91640,102.6
25050, 대덕구,005,0~4세,2017,6551,3330,3221,103.4,6527,3319,3208,103.5
25050, 대덕구,005001, 0세,2017,1119,578,541,106.8,1115,576,539,106.9
25050, 대덕구,005002, 1세,2017,1271,625,646,96.7,1264,621,643,96.6
25050, 대덕구,005003, 2세,2017,1352,701,651,107.7,1348,699,649,107.7
25050, 대덕구,005004, 3세,2017,1390,710,680,104.4,1386,710,676,105
25050, 대덕구,005005, 4세,2017,1419,716,703,101.8,1414,713,701,101.7
25050, 대덕구,010,5~9세,2017,7674,3991,3683,108.4,7659,3981,3678,108.2
25050, 대덕구,010001, 5세,2017,1508,783,725,108,1506,782,724,108
25050, 대덕구,010002, 6세,2017,1559,808,751,107.6,1557,807,750,107.6
25050, 대덕구,010003, 7세,2017,1483,798,685,116.5,1481,797,684,116.5
25050, 대덕구,010004, 8세,2017,1550,807,743,108.6,1547,804,743,108.2
25050, 대덕구,010005, 9세,2017,1574,795,779,102.1,1568,791,777,101.8
25050, 대덕구,015,10~14세,2017,8540,4440,4100,108.3,8528,4436,4092,108.4
25050, 대덕구,015001, 10세,2017,1752,912,840,108.6,1748,910,838,108.6
25050, 대덕구,015002, 11세,2017,1555,817,738,110.7,1553,816,737,110.7
25050, 대덕구,015003, 12세,2017,1543,786,757,103.8,1541,785,756,103.8
25050, 대덕구,015004, 13세,2017,1832,992,840,118.1,1831,992,839,118.2
25050, 대덕구,015005, 14세,2017,1858,933,925,100.9,1855,933,922,101.2
25050, 대덕구,020,15~19세,2017,12352,6406,5946,107.7,12286,6375,5911,107.8
25050, 대덕구,020001, 15세,2017,1937,975,962,101.4,1933,972,961,101.1
25050, 대덕구,020002, 16세,2017,2285,1183,1102,107.4,2281,1180,1101,107.2
25050, 대덕구,020003, 17세,2017,2315,1210,1105,109.5,2308,1206,1102,109.4
25050, 대덕구,020004, 18세,2017,2728,1454,1274,114.1,2717,1449,1268,114.3
25050, 대덕구,020005, 19세,2017,3087,1584,1503,105.4,3047,1568,1479,106
25050, 대덕구,025,20~24세,2017,16101,8472,7629,111,15682,8247,7435,110.9
25050, 대덕구,025001, 20세,2017,3281,1611,1670,96.5,3201,1579,1622,97.3
25050, 대덕구,025002, 21세,2017,3293,1663,1630,102,3214,1626,1588,102.4
25050, 대덕구,025003, 22세,2017,3308,1717,1591,107.9,3232,1673,1559,107.3
25050, 대덕구,025004, 23세,2017,3186,1753,1433,122.3,3100,1696,1404,120.8
25050, 대덕구,025005, 24세,2017,3033,1728,1305,132.4,2935,1673,1262,132.6
25050, 대덕구,030,25~29세,2017,12349,6905,5444,126.8,11825,6645,5180,128.3
25050, 대덕구,030001, 25세,2017,2895,1611,1284,125.5,2790,1547,1243,124.5
25050, 대덕구,030002, 26세,2017,2587,1461,1126,129.8,2492,1416,1076,131.6
25050, 대덕구,030003, 27세,2017,2428,1387,1041,133.2,2318,1336,982,136
25050, 대덕구,030004, 28세,2017,2193,1229,964,127.5,2087,1177,910,129.3
25050, 대덕구,030005, 29세,2017,2246,1217,1029,118.3,2138,1169,969,120.6
25050, 대덕구,035,30~34세,2017,10736,5760,4976,115.8,10311,5530,4781,115.7
25050, 대덕구,035001, 30세,2017,2079,1156,923,125.2,2000,1123,877,128.1
25050, 대덕구,035002, 31세,2017,2080,1110,970,114.4,1983,1052,931,113
25050, 대덕구,035003, 32세,2017,2052,1084,968,112,1967,1050,917,114.5
25050, 대덕구,035004, 33세,2017,2140,1137,1003,113.4,2052,1083,969,111.8
25050, 대덕구,035005, 34세,2017,2385,1273,1112,114.5,2309,1222,1087,112.4
25050, 대덕구,040,35~39세,2017,12963,6744,6219,108.4,12645,6548,6097,107.4
25050, 대덕구,040001, 35세,2017,2502,1288,1214,106.1,2441,1249,1192,104.8
25050, 대덕구,040002, 36세,2017,2698,1416,1282,110.5,2624,1367,1257,108.8
25050, 대덕구,040003, 37세,2017,2642,1357,1285,105.6,2572,1316,1256,104.8
25050, 대덕구,040004, 38세,2017,2624,1406,1218,115.4,2570,1375,1195,115.1
25050, 대덕구,040005, 39세,2017,2497,1277,1220,104.7,2438,1241,1197,103.7
25050, 대덕구,045,40~44세,2017,14224,7233,6991,103.5,14001,7113,6888,103.3
25050, 대덕구,045001, 40세,2017,2577,1312,1265,103.7,2539,1293,1246,103.8
25050, 대덕구,045002, 41세,2017,2579,1301,1278,101.8,2523,1271,1252,101.5
25050, 대덕구,045003, 42세,2017,2734,1360,1374,99,2691,1338,1353,98.9
25050, 대덕구,045004, 43세,2017,3107,1637,1470,111.4,3072,1613,1459,110.6
25050, 대덕구,045005, 44세,2017,3227,1623,1604,101.2,3176,1598,1578,101.3
25050, 대덕구,050,45~49세,2017,17952,8999,8953,100.5,17696,8878,8818,100.7
25050, 대덕구,050001, 45세,2017,3105,1557,1548,100.6,3051,1533,1518,101
25050, 대덕구,050002, 46세,2017,3629,1800,1829,98.4,3576,1780,1796,99.1
25050, 대덕구,050003, 47세,2017,3546,1795,1751,102.5,3496,1763,1733,101.7
25050, 대덕구,050004, 48세,2017,3815,1939,1876,103.4,3757,1909,1848,103.3
25050, 대덕구,050005, 49세,2017,3857,1908,1949,97.9,3816,1893,1923,98.4
25050, 대덕구,055,50~54세,2017,16152,8268,7884,104.9,15951,8171,7780,105
25050, 대덕구,055001, 50세,2017,3399,1730,1669,103.7,3357,1706,1651,103.3
25050, 대덕구,055002, 51세,2017,3183,1642,1541,106.6,3145,1620,1525,106.2
25050, 대덕구,055003, 52세,2017,3348,1716,1632,105.1,3313,1700,1613,105.4
25050, 대덕구,055004, 53세,2017,3103,1566,1537,101.9,3063,1556,1507,103.3
25050, 대덕구,055005, 54세,2017,3119,1614,1505,107.2,3073,1589,1484,107.1
25050, 대덕구,060,55~59세,2017,17023,8585,8438,101.7,16871,8509,8362,101.8
25050, 대덕구,060001, 55세,2017,3476,1745,1731,100.8,3445,1726,1719,100.4
25050, 대덕구,060002, 56세,2017,3847,1958,1889,103.7,3820,1948,1872,104.1
25050, 대덕구,060003, 57세,2017,3631,1816,1815,100.1,3584,1793,1791,100.1
25050, 대덕구,060004, 58세,2017,3119,1534,1585,96.8,3099,1523,1576,96.6
25050, 대덕구,060005, 59세,2017,2950,1532,1418,108,2923,1519,1404,108.2
25050, 대덕구,065,60~64세,2017,12184,6041,6143,98.3,12077,5994,6083,98.5
25050, 대덕구,065001, 60세,2017,2906,1482,1424,104.1,2883,1470,1413,104
25050, 대덕구,065002, 61세,2017,2669,1367,1302,105,2645,1356,1289,105.2
25050, 대덕구,065003, 62세,2017,2627,1286,1341,95.9,2610,1281,1329,96.4
25050, 대덕구,065004, 63세,2017,2192,1049,1143,91.8,2171,1041,1130,92.1
25050, 대덕구,065005, 64세,2017,1790,857,933,91.9,1768,846,922,91.8
25050, 대덕구,070,65~69세,2017,8172,4036,4136,97.6,8130,4023,4107,98
25050, 대덕구,070001, 65세,2017,1995,976,1019,95.8,1982,973,1009,96.4
25050, 대덕구,070002, 66세,2017,1499,777,722,107.6,1489,774,715,108.3
25050, 대덕구,070003, 67세,2017,1614,825,789,104.6,1608,824,784,105.1
25050, 대덕구,070004, 68세,2017,1569,740,829,89.3,1560,735,825,89.1
25050, 대덕구,070005, 69세,2017,1495,718,777,92.4,1491,717,774,92.6
25050, 대덕구,075,70~74세,2017,5803,2679,3124,85.8,5779,2667,3112,85.7
25050, 대덕구,075001, 70세,2017,1437,664,773,85.9,1427,661,766,86.3
25050, 대덕구,075002, 71세,2017,1012,506,506,100,1011,505,506,99.8
25050, 대덕구,075003, 72세,2017,1058,498,560,88.9,1051,493,558,88.4
25050, 대덕구,075004, 73세,2017,1094,488,606,80.5,1091,485,606,80
25050, 대덕구,075005, 74세,2017,1202,523,679,77,1199,523,676,77.4
25050, 대덕구,080,75~79세,2017,4967,2091,2876,72.7,4954,2086,2868,72.7
25050, 대덕구,080001, 75세,2017,1359,589,770,76.5,1357,588,769,76.5
25050, 대덕구,080002, 76세,2017,1001,415,586,70.8,999,414,585,70.8
25050, 대덕구,080003, 77세,2017,872,362,510,71,869,360,509,70.7
25050, 대덕구,080004, 78세,2017,899,355,544,65.3,894,354,540,65.6
25050, 대덕구,080005, 79세,2017,836,370,466,79.4,835,370,465,79.6
25050, 대덕구,085,80~84세,2017,2949,1039,1910,54.4,2947,1039,1908,54.5
25050, 대덕구,085001, 80세,2017,743,279,464,60.1,742,279,463,60.3
25050, 대덕구,085002, 81세,2017,648,230,418,55,647,230,417,55.2
25050, 대덕구,085003, 82세,2017,626,228,398,57.3,626,228,398,57.3
25050, 대덕구,085004, 83세,2017,504,166,338,49.1,504,166,338,49.1
25050, 대덕구,085005, 84세,2017,428,136,292,46.6,428,136,292,46.6
25050, 대덕구,090,85~89세,2017,1292,341,951,35.9,1291,341,950,35.9
25050, 대덕구,090001, 85세,2017,371,107,264,40.5,371,107,264,40.5
25050, 대덕구,090002, 86세,2017,283,81,202,40.1,283,81,202,40.1
25050, 대덕구,090003, 87세,2017,236,64,172,37.2,236,64,172,37.2
25050, 대덕구,090004, 88세,2017,226,52,174,29.9,226,52,174,29.9
25050, 대덕구,090005, 89세,2017,176,37,139,26.6,175,37,138,26.8
25050, 대덕구,095,90~94세,2017,375,86,289,29.8,374,85,289,29.4
25050, 대덕구,095001, 90세,2017,151,40,111,36,150,39,111,35.1
25050, 대덕구,095002, 91세,2017,85,22,63,34.9,85,22,63,34.9
25050, 대덕구,095003, 92세,2017,45,8,37,21.6,45,8,37,21.6
25050, 대덕구,095004, 93세,2017,41,9,32,28.1,41,9,32,28.1
25050, 대덕구,095005, 94세,2017,53,7,46,15.2,53,7,46,15.2
25050, 대덕구,100,95~99세,2017,98,14,84,16.7,98,14,84,16.7
25050, 대덕구,100001, 95세,2017,35,7,28,25,35,7,28,25
25050, 대덕구,100002, 96세,2017,36,X,32,12.5,36,X,32,12.5
25050, 대덕구,100003, 97세,2017,13,X,11,18.2,13,X,11,18.2
25050, 대덕구,100004, 98세,2017,9,X,8,12.5,9,X,8,12.5
25050, 대덕구,100005, 99세,2017,5,X,5,0,5,X,5,0
25050, 대덕구,101,100세이상,2017,12,X,9,33.3,12,X,9,33.3
25050, 대덕구,102,15세미만,2017,22765,11761,11004,106.9,22714,11736,10978,106.9
25050, 대덕구,103,15~64세,2017,142036,73413,68623,107,139345,72010,67335,106.9
25050, 대덕구,104,65세이상,2017,23668,10289,13379,76.9,23585,10258,13327,77
25050, 대덕구,086,85세이상,2017,1777,444,1333,33.3,1775,443,1332,33.3
25050, 대덕구,126,평균연령,2017,41,40,42.1,,41.1,40.1,42.2,
25050, 대덕구,127,중위연령,2017,42.7,41.3,43.9,,42.9,41.5,44.1,
26,울산광역시,000,합계,2017,1157077,600093,556984,107.7,1130476,583739,546737,106.8
26,울산광역시,005,0~4세,2017,54853,28223,26630,106,54349,27960,26389,106
26,울산광역시,005001, 0세,2017,9603,4986,4617,108,9491,4932,4559,108.2
26,울산광역시,005002, 1세,2017,10941,5642,5299,106.5,10844,5593,5251,106.5
26,울산광역시,005003, 2세,2017,11498,5954,5544,107.4,11388,5891,5497,107.2
26,울산광역시,005004, 3세,2017,11435,5835,5600,104.2,11331,5775,5556,103.9
26,울산광역시,005005, 4세,2017,11376,5806,5570,104.2,11295,5769,5526,104.4
26,울산광역시,010,5~9세,2017,57688,29930,27758,107.8,57415,29781,27634,107.8
26,울산광역시,010001, 5세,2017,12139,6259,5880,106.4,12062,6222,5840,106.5
26,울산광역시,010002, 6세,2017,11819,6140,5679,108.1,11764,6106,5658,107.9
26,울산광역시,010003, 7세,2017,11378,5959,5419,110,11334,5939,5395,110.1
26,울산광역시,010004, 8세,2017,10892,5667,5225,108.5,10847,5639,5208,108.3
26,울산광역시,010005, 9세,2017,11460,5905,5555,106.3,11408,5875,5533,106.2
26,울산광역시,015,10~14세,2017,54576,28766,25810,111.5,54428,28702,25726,111.6
26,울산광역시,015001, 10세,2017,11555,6066,5489,110.5,11512,6044,5468,110.5
26,울산광역시,015002, 11세,2017,10401,5399,5002,107.9,10377,5390,4987,108.1
26,울산광역시,015003, 12세,2017,10242,5408,4834,111.9,10205,5391,4814,112
26,울산광역시,015004, 13세,2017,11045,5858,5187,112.9,11022,5848,5174,113
26,울산광역시,015005, 14세,2017,11333,6035,5298,113.9,11312,6029,5283,114.1
26,울산광역시,020,15~19세,2017,67585,36583,31002,118,67201,36365,30836,117.9
26,울산광역시,020001, 15세,2017,11743,6154,5589,110.1,11715,6140,5575,110.1
26,울산광역시,020002, 16세,2017,13767,7360,6407,114.9,13732,7343,6389,114.9
26,울산광역시,020003, 17세,2017,15890,8411,7479,112.5,15848,8387,7461,112.4
26,울산광역시,020004, 18세,2017,14119,7642,6477,118,14024,7582,6442,117.7
26,울산광역시,020005, 19세,2017,12066,7016,5050,138.9,11882,6913,4969,139.1
26,울산광역시,025,20~24세,2017,75679,44291,31388,141.1,73591,43112,30479,141.4
26,울산광역시,025001, 20세,2017,14194,8673,5521,157.1,13938,8539,5399,158.2
26,울산광역시,025002, 21세,2017,14978,9119,5859,155.6,14653,8957,5696,157.3
26,울산광역시,025003, 22세,2017,15205,8796,6409,137.2,14824,8579,6245,137.4
26,울산광역시,025004, 23세,2017,15413,8728,6685,130.6,14895,8425,6470,130.2
26,울산광역시,025005, 24세,2017,15889,8975,6914,129.8,15281,8612,6669,129.1
26,울산광역시,030,25~29세,2017,76201,43260,32941,131.3,71788,40371,31417,128.5
26,울산광역시,030001, 25세,2017,16171,9241,6930,133.3,15452,8758,6694,130.8
26,울산광역시,030002, 26세,2017,15707,8738,6969,125.4,14817,8156,6661,122.4
26,울산광역시,030003, 27세,2017,15040,8588,6452,133.1,14096,7983,6113,130.6
26,울산광역시,030004, 28세,2017,14891,8531,6360,134.1,13972,7916,6056,130.7
26,울산광역시,030005, 29세,2017,14392,8162,6230,131,13451,7558,5893,128.3
26,울산광역시,035,30~34세,2017,79461,42926,36535,117.5,74938,39845,35093,113.5
26,울산광역시,035001, 30세,2017,14535,7995,6540,122.2,13563,7358,6205,118.6
26,울산광역시,035002, 31세,2017,14974,8192,6782,120.8,14003,7540,6463,116.7
26,울산광역시,035003, 32세,2017,15297,8244,7053,116.9,14409,7644,6765,113
26,울산광역시,035004, 33세,2017,16446,8863,7583,116.9,15566,8255,7311,112.9
26,울산광역시,035005, 34세,2017,18209,9632,8577,112.3,17397,9048,8349,108.4
26,울산광역시,040,35~39세,2017,97287,51408,45879,112.1,94144,49327,44817,110.1
26,울산광역시,040001, 35세,2017,19817,10393,9424,110.3,19101,9915,9186,107.9
26,울산광역시,040002, 36세,2017,20050,10734,9316,115.2,19387,10265,9122,112.5
26,울산광역시,040003, 37세,2017,20760,10899,9861,110.5,20162,10511,9651,108.9
26,울산광역시,040004, 38세,2017,19048,10024,9024,111.1,18452,9633,8819,109.2
26,울산광역시,040005, 39세,2017,17612,9358,8254,113.4,17042,9003,8039,112
26,울산광역시,045,40~44세,2017,92872,47481,45391,104.6,90518,45947,44571,103.1
26,울산광역시,045001, 40세,2017,17974,9370,8604,108.9,17476,9048,8428,107.4
26,울산광역시,045002, 41세,2017,16977,8923,8054,110.8,16511,8609,7902,108.9
26,울산광역시,045003, 42세,2017,18211,9269,8942,103.7,17752,8968,8784,102.1
26,울산광역시,045004, 43세,2017,19567,9845,9722,101.3,19109,9550,9559,99.9
26,울산광역시,045005, 44세,2017,20143,10074,10069,100,19670,9772,9898,98.7
26,울산광역시,050,45~49세,2017,109101,54251,54850,98.9,106307,52596,53711,97.9
26,울산광역시,050001, 45세,2017,20303,10166,10137,100.3,19781,9854,9927,99.3
26,울산광역시,050002, 46세,2017,21998,10995,11003,99.9,21414,10640,10774,98.8
26,울산광역시,050003, 47세,2017,21676,10702,10974,97.5,21100,10364,10736,96.5
26,울산광역시,050004, 48세,2017,22303,11092,11211,98.9,21760,10778,10982,98.1
26,울산광역시,050005, 49세,2017,22821,11296,11525,98,22252,10960,11292,97.1
26,울산광역시,055,50~54세,2017,105196,54224,50972,106.4,102638,52771,49867,105.8
26,울산광역시,055001, 50세,2017,21415,10525,10890,96.6,20993,10290,10703,96.1
26,울산광역시,055002, 51세,2017,21611,11341,10270,110.4,21082,11027,10055,109.7
26,울산광역시,055003, 52세,2017,21722,11291,10431,108.2,21201,11000,10201,107.8
26,울산광역시,055004, 53세,2017,19763,10261,9502,108,19252,9959,9293,107.2
26,울산광역시,055005, 54세,2017,20685,10806,9879,109.4,20110,10495,9615,109.2
26,울산광역시,060,55~59세,2017,101675,52379,49296,106.3,100119,51507,48612,106
26,울산광역시,060001, 55세,2017,21089,11062,10027,110.3,20696,10855,9841,110.3
26,울산광역시,060002, 56세,2017,22577,11585,10992,105.4,22311,11436,10875,105.2
26,울산광역시,060003, 57세,2017,21182,10722,10460,102.5,20844,10529,10315,102.1
26,울산광역시,060004, 58세,2017,19088,9848,9240,106.6,18802,9680,9122,106.1
26,울산광역시,060005, 59세,2017,17739,9162,8577,106.8,17466,9007,8459,106.5
26,울산광역시,065,60~64세,2017,70485,35647,34838,102.3,69437,35073,34364,102.1
26,울산광역시,065001, 60세,2017,16753,8523,8230,103.6,16510,8379,8131,103.1
26,울산광역시,065002, 61세,2017,15258,7723,7535,102.5,15034,7599,7435,102.2
26,울산광역시,065003, 62세,2017,15026,7512,7514,100,14812,7393,7419,99.6
26,울산광역시,065004, 63세,2017,12403,6330,6073,104.2,12196,6222,5974,104.2
26,울산광역시,065005, 64세,2017,11045,5559,5486,101.3,10885,5480,5405,101.4
26,울산광역시,070,65~69세,2017,44638,22744,21894,103.9,44176,22514,21662,103.9
26,울산광역시,070001, 65세,2017,11158,5686,5472,103.9,11030,5620,5410,103.9
26,울산광역시,070002, 66세,2017,8666,4447,4219,105.4,8550,4388,4162,105.4
26,울산광역시,070003, 67세,2017,8516,4334,4182,103.6,8425,4292,4133,103.8
26,울산광역시,070004, 68세,2017,8254,4220,4034,104.6,8176,4184,3992,104.8
26,울산광역시,070005, 69세,2017,8044,4057,3987,101.8,7995,4030,3965,101.6
26,울산광역시,075,70~74세,2017,27754,13296,14458,92,27599,13234,14365,92.1
26,울산광역시,075001, 70세,2017,7192,3592,3600,99.8,7145,3576,3569,100.2
26,울산광역시,075002, 71세,2017,4997,2481,2516,98.6,4967,2469,2498,98.8
26,울산광역시,075003, 72세,2017,5032,2425,2607,93,4998,2408,2590,93
26,울산광역시,075004, 73세,2017,5098,2321,2777,83.6,5077,2314,2763,83.7
26,울산광역시,075005, 74세,2017,5435,2477,2958,83.7,5412,2467,2945,83.8
26,울산광역시,080,75~79세,2017,21672,9052,12620,71.7,21566,9015,12551,71.8
26,울산광역시,080001, 75세,2017,5809,2605,3204,81.3,5778,2595,3183,81.5
26,울산광역시,080002, 76세,2017,4367,1879,2488,75.5,4339,1866,2473,75.5
26,울산광역시,080003, 77세,2017,4166,1696,2470,68.7,4144,1688,2456,68.7
26,울산광역시,080004, 78세,2017,3909,1620,2289,70.8,3895,1616,2279,70.9
26,울산광역시,080005, 79세,2017,3421,1252,2169,57.7,3410,1250,2160,57.9
26,울산광역시,085,80~84세,2017,12441,4006,8435,47.5,12381,4000,8381,47.7
26,울산광역시,085001, 80세,2017,3048,1059,1989,53.2,3030,1059,1971,53.7
26,울산광역시,085002, 81세,2017,2751,882,1869,47.2,2738,879,1859,47.3
26,울산광역시,085003, 82세,2017,2496,789,1707,46.2,2484,788,1696,46.5
26,울산광역시,085004, 83세,2017,2238,708,1530,46.3,2231,708,1523,46.5
26,울산광역시,085005, 84세,2017,1908,568,1340,42.4,1898,566,1332,42.5
26,울산광역시,090,85~89세,2017,5619,1293,4326,29.9,5593,1288,4305,29.9
26,울산광역시,090001, 85세,2017,1605,419,1186,35.3,1601,418,1183,35.3
26,울산광역시,090002, 86세,2017,1255,289,966,29.9,1248,287,961,29.9
26,울산광역시,090003, 87세,2017,1061,241,820,29.4,1052,241,811,29.7
26,울산광역시,090004, 88세,2017,939,213,726,29.3,936,212,724,29.3
26,울산광역시,090005, 89세,2017,759,131,628,20.9,756,130,626,20.8
26,울산광역시,095,90~94세,2017,1864,275,1589,17.3,1860,274,1586,17.3
26,울산광역시,095001, 90세,2017,614,103,511,20.2,612,102,510,20
26,울산광역시,095002, 91세,2017,419,58,361,16.1,418,58,360,16.1
26,울산광역시,095003, 92세,2017,360,52,308,16.9,359,52,307,16.9
26,울산광역시,095004, 93세,2017,238,27,211,12.8,238,27,211,12.8
26,울산광역시,095005, 94세,2017,233,35,198,17.7,233,35,198,17.7
26,울산광역시,100,95~99세,2017,385,56,329,17,383,55,328,16.8
26,울산광역시,100001, 95세,2017,149,21,128,16.4,148,21,127,16.5
26,울산광역시,100002, 96세,2017,97,14,83,16.9,97,14,83,16.9
26,울산광역시,100003, 97세,2017,71,11,60,18.3,71,11,60,18.3
26,울산광역시,100004, 98세,2017,40,7,33,21.2,40,7,33,21.2
26,울산광역시,100005, 99세,2017,28,X,25,12,27,X,25,8
26,울산광역시,101,100세이상,2017,45,X,43,4.7,45,X,43,4.7
26,울산광역시,102,15세미만,2017,167117,86919,80198,108.4,166192,86443,79749,108.4
26,울산광역시,103,15~64세,2017,875542,462450,413092,111.9,850681,446914,403767,110.7
26,울산광역시,104,65세이상,2017,114418,50724,63694,79.6,113603,50382,63221,79.7
26,울산광역시,086,85세이상,2017,7913,1626,6287,25.9,7881,1619,6262,25.9
26,울산광역시,126,평균연령,2017,39.6,38.6,40.6,,39.6,38.6,40.7,
26,울산광역시,127,중위연령,2017,40.8,39.4,42.4,,41,39.6,42.5,
26004, 읍부,000,합계,2017,152775,80370,72405,111,146362,76197,70165,108.6
26004, 읍부,005,0~4세,2017,7229,3724,3505,106.2,7074,3647,3427,106.4
26004, 읍부,005001, 0세,2017,1207,652,555,117.5,1171,632,539,117.3
26004, 읍부,005002, 1세,2017,1364,696,668,104.2,1340,684,656,104.3
26004, 읍부,005003, 2세,2017,1494,776,718,108.1,1455,757,698,108.5
26004, 읍부,005004, 3세,2017,1576,800,776,103.1,1545,786,759,103.6
26004, 읍부,005005, 4세,2017,1588,800,788,101.5,1563,788,775,101.7
26004, 읍부,010,5~9세,2017,8743,4453,4290,103.8,8666,4409,4257,103.6
26004, 읍부,010001, 5세,2017,1810,911,899,101.3,1789,901,888,101.5
26004, 읍부,010002, 6세,2017,1746,902,844,106.9,1732,895,837,106.9
26004, 읍부,010003, 7세,2017,1759,885,874,101.3,1748,881,867,101.6
26004, 읍부,010004, 8세,2017,1608,815,793,102.8,1593,805,788,102.2
26004, 읍부,010005, 9세,2017,1820,940,880,106.8,1804,927,877,105.7
26004, 읍부,015,10~14세,2017,8838,4636,4202,110.3,8798,4617,4181,110.4
26004, 읍부,015001, 10세,2017,1818,967,851,113.6,1807,959,848,113.1
26004, 읍부,015002, 11세,2017,1685,902,783,115.2,1677,900,777,115.8
26004, 읍부,015003, 12세,2017,1719,891,828,107.6,1710,888,822,108
26004, 읍부,015004, 13세,2017,1784,931,853,109.1,1780,928,852,108.9
26004, 읍부,015005, 14세,2017,1832,945,887,106.5,1824,942,882,106.8
26004, 읍부,020,15~19세,2017,9845,5420,4425,122.5,9711,5328,4383,121.6
26004, 읍부,020001, 15세,2017,1786,912,874,104.3,1779,910,869,104.7
26004, 읍부,020002, 16세,2017,2038,1077,961,112.1,2027,1070,957,111.8
26004, 읍부,020003, 17세,2017,2150,1163,987,117.8,2133,1150,983,117
26004, 읍부,020004, 18세,2017,2080,1144,936,122.2,2046,1117,929,120.2
26004, 읍부,020005, 19세,2017,1791,1124,667,168.5,1726,1081,645,167.6
26004, 읍부,025,20~24세,2017,11031,6716,4315,155.6,10556,6402,4154,154.1
26004, 읍부,025001, 20세,2017,2131,1351,780,173.2,2059,1303,756,172.4
26004, 읍부,025002, 21세,2017,2123,1328,795,167,2036,1272,764,166.5
26004, 읍부,025003, 22세,2017,2266,1350,916,147.4,2173,1286,887,145
26004, 읍부,025004, 23세,2017,2295,1343,952,141.1,2185,1269,916,138.5
26004, 읍부,025005, 24세,2017,2216,1344,872,154.1,2103,1272,831,153.1
26004, 읍부,030,25~29세,2017,9227,5430,3797,143,8323,4800,3523,136.2
26004, 읍부,030001, 25세,2017,2201,1326,875,151.5,2052,1214,838,144.9
26004, 읍부,030002, 26세,2017,2067,1223,844,144.9,1891,1104,787,140.3
26004, 읍부,030003, 27세,2017,1752,1036,716,144.7,1562,904,658,137.4
26004, 읍부,030004, 28세,2017,1704,998,706,141.4,1507,859,648,132.6
26004, 읍부,030005, 29세,2017,1503,847,656,129.1,1311,719,592,121.5
26004, 읍부,035,30~34세,2017,9025,4924,4101,120.1,8011,4195,3816,109.9
26004, 읍부,035001, 30세,2017,1639,911,728,125.1,1420,754,666,113.2
26004, 읍부,035002, 31세,2017,1670,943,727,129.7,1434,777,657,118.3
26004, 읍부,035003, 32세,2017,1692,925,767,120.6,1472,772,700,110.3
26004, 읍부,035004, 33세,2017,1904,1004,900,111.6,1737,885,852,103.9
26004, 읍부,035005, 34세,2017,2120,1141,979,116.5,1948,1007,941,107
26004, 읍부,040,35~39세,2017,12520,6426,6094,105.4,11828,5959,5869,101.5
26004, 읍부,040001, 35세,2017,2378,1246,1132,110.1,2236,1147,1089,105.3
26004, 읍부,040002, 36세,2017,2524,1353,1171,115.5,2376,1246,1130,110.3
26004, 읍부,040003, 37세,2017,2668,1295,1373,94.3,2539,1206,1333,90.5
26004, 읍부,040004, 38세,2017,2565,1313,1252,104.9,2431,1228,1203,102.1
26004, 읍부,040005, 39세,2017,2385,1219,1166,104.5,2246,1132,1114,101.6
26004, 읍부,045,40~44세,2017,14255,7181,7074,101.5,13628,6748,6880,98.1
26004, 읍부,045001, 40세,2017,2638,1295,1343,96.4,2533,1228,1305,94.1
26004, 읍부,045002, 41세,2017,2663,1375,1288,106.8,2539,1287,1252,102.8
26004, 읍부,045003, 42세,2017,2808,1389,1419,97.9,2683,1304,1379,94.6
26004, 읍부,045004, 43세,2017,3032,1541,1491,103.4,2909,1453,1456,99.8
26004, 읍부,045005, 44세,2017,3114,1581,1533,103.1,2964,1476,1488,99.2
26004, 읍부,050,45~49세,2017,16115,8360,7755,107.8,15355,7907,7448,106.2
26004, 읍부,050001, 45세,2017,3128,1613,1515,106.5,2989,1531,1458,105
26004, 읍부,050002, 46세,2017,3393,1738,1655,105,3241,1641,1600,102.6
26004, 읍부,050003, 47세,2017,3180,1614,1566,103.1,3011,1522,1489,102.2
26004, 읍부,050004, 48세,2017,3211,1691,1520,111.3,3056,1600,1456,109.9
26004, 읍부,050005, 49세,2017,3203,1704,1499,113.7,3058,1613,1445,111.6
26004, 읍부,055,50~54세,2017,13468,7306,6162,118.6,12718,6838,5880,116.3
26004, 읍부,055001, 50세,2017,2896,1500,1396,107.4,2776,1423,1353,105.2
26004, 읍부,055002, 51세,2017,2795,1509,1286,117.3,2655,1421,1234,115.2
26004, 읍부,055003, 52세,2017,2789,1546,1243,124.4,2623,1439,1184,121.5
26004, 읍부,055004, 53세,2017,2474,1362,1112,122.5,2314,1259,1055,119.3
26004, 읍부,055005, 54세,2017,2514,1389,1125,123.5,2350,1296,1054,123
26004, 읍부,060,55~59세,2017,11491,6185,5306,116.6,11095,5943,5152,115.4
26004, 읍부,060001, 55세,2017,2469,1364,1105,123.4,2363,1298,1065,121.9
26004, 읍부,060002, 56세,2017,2607,1400,1207,116,2540,1359,1181,115.1
26004, 읍부,060003, 57세,2017,2341,1289,1052,122.5,2261,1240,1021,121.4
26004, 읍부,060004, 58세,2017,2119,1125,994,113.2,2042,1082,960,112.7
26004, 읍부,060005, 59세,2017,1955,1007,948,106.2,1889,964,925,104.2
26004, 읍부,065,60~64세,2017,7623,3971,3652,108.7,7391,3833,3558,107.7
26004, 읍부,065001, 60세,2017,1812,958,854,112.2,1769,930,839,110.8
26004, 읍부,065002, 61세,2017,1679,872,807,108.1,1608,828,780,106.2
26004, 읍부,065003, 62세,2017,1657,847,810,104.6,1619,825,794,103.9
26004, 읍부,065004, 63세,2017,1326,701,625,112.2,1277,673,604,111.4
26004, 읍부,065005, 64세,2017,1149,593,556,106.7,1118,577,541,106.7
26004, 읍부,070,65~69세,2017,4741,2417,2324,104,4650,2366,2284,103.6
26004, 읍부,070001, 65세,2017,1164,609,555,109.7,1141,596,545,109.4
26004, 읍부,070002, 66세,2017,919,475,444,107,900,465,435,106.9
26004, 읍부,070003, 67세,2017,922,483,439,110,897,467,430,108.6
26004, 읍부,070004, 68세,2017,870,427,443,96.4,858,420,438,95.9
26004, 읍부,070005, 69세,2017,866,423,443,95.5,854,418,436,95.9
26004, 읍부,075,70~74세,2017,3107,1432,1675,85.5,3083,1425,1658,85.9
26004, 읍부,075001, 70세,2017,809,401,408,98.3,802,399,403,99
26004, 읍부,075002, 71세,2017,531,253,278,91,525,252,273,92.3
26004, 읍부,075003, 72세,2017,526,253,273,92.7,521,250,271,92.3
26004, 읍부,075004, 73세,2017,577,233,344,67.7,577,233,344,67.7
26004, 읍부,075005, 74세,2017,664,292,372,78.5,658,291,367,79.3
26004, 읍부,080,75~79세,2017,2783,1078,1705,63.2,2759,1071,1688,63.4
26004, 읍부,080001, 75세,2017,719,304,415,73.3,710,300,410,73.2
26004, 읍부,080002, 76세,2017,563,217,346,62.7,560,216,344,62.8
26004, 읍부,080003, 77세,2017,517,200,317,63.1,513,199,314,63.4
26004, 읍부,080004, 78세,2017,504,178,326,54.6,501,177,324,54.6
26004, 읍부,080005, 79세,2017,480,179,301,59.5,475,179,296,60.5
26004, 읍부,085,80~84세,2017,1622,505,1117,45.2,1613,504,1109,45.4
26004, 읍부,085001, 80세,2017,380,122,258,47.3,376,122,254,48
26004, 읍부,085002, 81세,2017,363,117,246,47.6,361,117,244,48
26004, 읍부,085003, 82세,2017,339,103,236,43.6,338,103,235,43.8
26004, 읍부,085004, 83세,2017,292,80,212,37.7,291,80,211,37.9
26004, 읍부,085005, 84세,2017,248,83,165,50.3,247,82,165,49.7
26004, 읍부,090,85~89세,2017,815,168,647,26,808,167,641,26.1
26004, 읍부,090001, 85세,2017,222,52,170,30.6,220,52,168,31
26004, 읍부,090002, 86세,2017,188,38,150,25.3,185,37,148,25
26004, 읍부,090003, 87세,2017,160,32,128,25,158,32,126,25.4
26004, 읍부,090004, 88세,2017,138,28,110,25.5,138,28,110,25.5
26004, 읍부,090005, 89세,2017,107,18,89,20.2,107,18,89,20.2
26004, 읍부,095,90~94세,2017,239,32,207,15.5,238,32,206,15.5
26004, 읍부,095001, 90세,2017,78,10,68,14.7,77,10,67,14.9
26004, 읍부,095002, 91세,2017,57,8,49,16.3,57,8,49,16.3
26004, 읍부,095003, 92세,2017,43,5,38,13.2,43,5,38,13.2
26004, 읍부,095004, 93세,2017,29,X,26,11.5,29,X,26,11.5
26004, 읍부,095005, 94세,2017,32,6,26,23.1,32,6,26,23.1
26004, 읍부,100,95~99세,2017,49,6,43,14,48,6,42,14.3
26004, 읍부,100001, 95세,2017,22,X,21,4.8,21,X,20,5
26004, 읍부,100002, 96세,2017,12,X,9,33.3,12,X,9,33.3
26004, 읍부,100003, 97세,2017,6,X,5,20,6,X,5,20
26004, 읍부,100004, 98세,2017,5,X,5,0,5,X,5,0
26004, 읍부,100005, 99세,2017,X,X,X,33.3,X,X,X,33.3
26004, 읍부,101,100세이상,2017,9,X,9,0,9,X,9,0
26004, 읍부,102,15세미만,2017,24810,12813,11997,106.8,24538,12673,11865,106.8
26004, 읍부,103,15~64세,2017,114600,61919,52681,117.5,108616,57953,50663,114.4
26004, 읍부,104,65세이상,2017,13365,5638,7727,73,13208,5571,7637,72.9
26004, 읍부,086,85세이상,2017,1112,206,906,22.7,1103,205,898,22.8
26004, 읍부,126,평균연령,2017,38.2,37.3,39.2,,38.2,37.2,39.2,
26004, 읍부,127,중위연령,2017,40,38.8,41.1,,40.1,38.9,41.1,
26005, 면부,000,합계,2017,69389,36262,33127,109.5,66134,33725,32409,104.1
26005, 면부,005,0~4세,2017,2299,1176,1123,104.7,2284,1169,1115,104.8
26005, 면부,005001, 0세,2017,441,230,211,109,437,228,209,109.1
26005, 면부,005002, 1세,2017,461,242,219,110.5,460,242,218,111
26005, 면부,005003, 2세,2017,477,247,230,107.4,475,246,229,107.4
26005, 면부,005004, 3세,2017,472,253,219,115.5,468,249,219,113.7
26005, 면부,005005, 4세,2017,448,204,244,83.6,444,204,240,85
26005, 면부,010,5~9세,2017,2118,1083,1035,104.6,2104,1078,1026,105.1
26005, 면부,010001, 5세,2017,436,208,228,91.2,432,207,225,92
26005, 면부,010002, 6세,2017,437,225,212,106.1,435,224,211,106.2
26005, 면부,010003, 7세,2017,401,219,182,120.3,399,219,180,121.7
26005, 면부,010004, 8세,2017,414,208,206,101,410,206,204,101
26005, 면부,010005, 9세,2017,430,223,207,107.7,428,222,206,107.8
26005, 면부,015,10~14세,2017,2174,1133,1041,108.8,2167,1130,1037,109
26005, 면부,015001, 10세,2017,463,238,225,105.8,463,238,225,105.8
26005, 면부,015002, 11세,2017,407,199,208,95.7,406,199,207,96.1
26005, 면부,015003, 12세,2017,403,218,185,117.8,400,216,184,117.4
26005, 면부,015004, 13세,2017,467,248,219,113.2,466,247,219,112.8
26005, 면부,015005, 14세,2017,434,230,204,112.7,432,230,202,113.9
26005, 면부,020,15~19세,2017,2926,1544,1382,111.7,2908,1534,1374,111.6
26005, 면부,020001, 15세,2017,523,264,259,101.9,523,264,259,101.9
26005, 면부,020002, 16세,2017,497,255,242,105.4,495,254,241,105.4
26005, 면부,020003, 17세,2017,614,325,289,112.5,614,325,289,112.5
26005, 면부,020004, 18세,2017,644,354,290,122.1,640,352,288,122.2
26005, 면부,020005, 19세,2017,648,346,302,114.6,636,339,297,114.1
26005, 면부,025,20~24세,2017,4113,2436,1677,145.3,3827,2192,1635,134.1
26005, 면부,025001, 20세,2017,743,403,340,118.5,731,394,337,116.9
26005, 면부,025002, 21세,2017,787,473,314,150.6,759,452,307,147.2
26005, 면부,025003, 22세,2017,870,499,371,134.5,818,455,363,125.3
26005, 면부,025004, 23세,2017,829,510,319,159.9,740,431,309,139.5
26005, 면부,025005, 24세,2017,884,551,333,165.5,779,460,319,144.2
26005, 면부,030,25~29세,2017,4369,2768,1601,172.9,3547,2063,1484,139
26005, 면부,030001, 25세,2017,923,561,362,155,773,432,341,126.7
26005, 면부,030002, 26세,2017,906,558,348,160.3,744,418,326,128.2
26005, 면부,030003, 27세,2017,843,545,298,182.9,656,383,273,140.3
26005, 면부,030004, 28세,2017,836,547,289,189.3,676,416,260,160
26005, 면부,030005, 29세,2017,861,557,304,183.2,698,414,284,145.8
26005, 면부,035,30~34세,2017,4441,2681,1760,152.3,3686,2041,1645,124.1
26005, 면부,035001, 30세,2017,857,514,343,149.9,681,370,311,119
26005, 면부,035002, 31세,2017,887,532,355,149.9,731,402,329,122.2
26005, 면부,035003, 32세,2017,896,547,349,156.7,750,423,327,129.4
26005, 면부,035004, 33세,2017,912,551,361,152.6,755,411,344,119.5
26005, 면부,035005, 34세,2017,889,537,352,152.6,769,435,334,130.2
26005, 면부,040,35~39세,2017,4639,2734,1905,143.5,4193,2371,1822,130.1
26005, 면부,040001, 35세,2017,1011,594,417,142.4,900,502,398,126.1
26005, 면부,040002, 36세,2017,979,573,406,141.1,883,492,391,125.8
26005, 면부,040003, 37세,2017,976,600,376,159.6,891,532,359,148.2
26005, 면부,040004, 38세,2017,852,495,357,138.7,772,434,338,128.4
26005, 면부,040005, 39세,2017,821,472,349,135.2,747,411,336,122.3
26005, 면부,045,40~44세,2017,4504,2462,2042,120.6,4248,2276,1972,115.4
26005, 면부,045001, 40세,2017,830,482,348,138.5,773,436,337,129.4
26005, 면부,045002, 41세,2017,814,464,350,132.6,754,420,334,125.7
26005, 면부,045003, 42세,2017,908,484,424,114.2,854,444,410,108.3
26005, 면부,045004, 43세,2017,941,506,435,116.3,895,477,418,114.1
26005, 면부,045005, 44세,2017,1011,526,485,108.5,972,499,473,105.5
26005, 면부,050,45~49세,2017,5568,2895,2673,108.3,5346,2760,2586,106.7
26005, 면부,050001, 45세,2017,972,510,462,110.4,925,479,446,107.4
26005, 면부,050002, 46세,2017,1125,601,524,114.7,1072,569,503,113.1
26005, 면부,050003, 47세,2017,1107,589,518,113.7,1062,562,500,112.4
26005, 면부,050004, 48세,2017,1149,590,559,105.5,1117,575,542,106.1
26005, 면부,050005, 49세,2017,1215,605,610,99.2,1170,575,595,96.6
26005, 면부,055,50~54세,2017,6138,3204,2934,109.2,5959,3103,2856,108.6
26005, 면부,055001, 50세,2017,1148,580,568,102.1,1112,564,548,102.9
26005, 면부,055002, 51세,2017,1216,664,552,120.3,1167,633,534,118.5
26005, 면부,055003, 52세,2017,1239,668,571,117,1206,651,555,117.3
26005, 면부,055004, 53세,2017,1245,631,614,102.8,1220,613,607,101
26005, 면부,055005, 54세,2017,1290,661,629,105.1,1254,642,612,104.9
26005, 면부,060,55~59세,2017,6940,3559,3381,105.3,6838,3494,3344,104.5
26005, 면부,060001, 55세,2017,1349,728,621,117.2,1326,713,613,116.3
26005, 면부,060002, 56세,2017,1454,724,730,99.2,1443,716,727,98.5
26005, 면부,060003, 57세,2017,1424,704,720,97.8,1401,691,710,97.3
26005, 면부,060004, 58세,2017,1370,715,655,109.2,1345,701,644,108.9
26005, 면부,060005, 59세,2017,1343,688,655,105,1323,673,650,103.5
26005, 면부,065,60~64세,2017,5820,2934,2886,101.7,5751,2894,2857,101.3
26005, 면부,065001, 60세,2017,1289,655,634,103.3,1275,647,628,103
26005, 면부,065002, 61세,2017,1239,649,590,110,1223,641,582,110.1
26005, 면부,065003, 62세,2017,1220,603,617,97.7,1203,593,610,97.2
26005, 면부,065004, 63세,2017,1078,557,521,106.9,1066,549,517,106.2
26005, 면부,065005, 64세,2017,994,470,524,89.7,984,464,520,89.2
26005, 면부,070,65~69세,2017,4248,2134,2114,100.9,4210,2113,2097,100.8
26005, 면부,070001, 65세,2017,1008,475,533,89.1,997,466,531,87.8
26005, 면부,070002, 66세,2017,805,402,403,99.8,795,397,398,99.7
26005, 면부,070003, 67세,2017,841,434,407,106.6,834,432,402,107.5
26005, 면부,070004, 68세,2017,808,397,411,96.6,803,395,408,96.8
26005, 면부,070005, 69세,2017,786,426,360,118.3,781,423,358,118.2
26005, 면부,075,70~74세,2017,3061,1449,1612,89.9,3050,1444,1606,89.9
26005, 면부,075001, 70세,2017,719,377,342,110.2,716,376,340,110.6
26005, 면부,075002, 71세,2017,532,258,274,94.2,531,258,273,94.5
26005, 면부,075003, 72세,2017,602,280,322,87,599,278,321,86.6
26005, 면부,075004, 73세,2017,573,252,321,78.5,569,250,319,78.4
26005, 면부,075005, 74세,2017,635,282,353,79.9,635,282,353,79.9
26005, 면부,080,75~79세,2017,2834,1125,1709,65.8,2827,1122,1705,65.8
26005, 면부,080001, 75세,2017,699,287,412,69.7,696,286,410,69.8
26005, 면부,080002, 76세,2017,556,225,331,68,555,225,330,68.2
26005, 면부,080003, 77세,2017,562,221,341,64.8,560,220,340,64.7
26005, 면부,080004, 78세,2017,531,212,319,66.5,530,211,319,66.1
26005, 면부,080005, 79세,2017,486,180,306,58.8,486,180,306,58.8
26005, 면부,085,80~84세,2017,1852,610,1242,49.1,1847,608,1239,49.1
26005, 면부,085001, 80세,2017,440,164,276,59.4,439,164,275,59.6
26005, 면부,085002, 81세,2017,379,134,245,54.7,378,134,244,54.9
26005, 면부,085003, 82세,2017,376,131,245,53.5,375,130,245,53.1
26005, 면부,085004, 83세,2017,367,115,252,45.6,367,115,252,45.6
26005, 면부,085005, 84세,2017,290,66,224,29.5,288,65,223,29.1
26005, 면부,090,85~89세,2017,961,258,703,36.7,959,257,702,36.6
26005, 면부,090001, 85세,2017,272,78,194,40.2,272,78,194,40.2
26005, 면부,090002, 86세,2017,218,63,155,40.6,218,63,155,40.6
26005, 면부,090003, 87세,2017,172,39,133,29.3,171,39,132,29.5
26005, 면부,090004, 88세,2017,160,42,118,35.6,160,42,118,35.6
26005, 면부,090005, 89세,2017,139,36,103,35,138,35,103,34
26005, 면부,095,90~94세,2017,325,65,260,25,325,65,260,25
26005, 면부,095001, 90세,2017,114,29,85,34.1,114,29,85,34.1
26005, 면부,095002, 91세,2017,72,12,60,20,72,12,60,20
26005, 면부,095003, 92세,2017,61,10,51,19.6,61,10,51,19.6
26005, 면부,095004, 93세,2017,43,X,39,10.3,43,X,39,10.3
26005, 면부,095005, 94세,2017,35,10,25,40,35,10,25,40
26005, 면부,100,95~99세,2017,54,11,43,25.6,53,10,43,23.3
26005, 면부,100001, 95세,2017,19,6,13,46.2,19,6,13,46.2
26005, 면부,100002, 96세,2017,15,X,14,7.1,15,X,14,7.1
26005, 면부,100003, 97세,2017,8,X,7,14.3,8,X,7,14.3
26005, 면부,100004, 98세,2017,7,X,5,40,7,X,5,40
26005, 면부,100005, 99세,2017,5,X,X,25,X,X,X,0
26005, 면부,101,100세이상,2017,5,X,X,25,5,X,X,25
26005, 면부,102,15세미만,2017,6591,3392,3199,106,6555,3377,3178,106.3
26005, 면부,103,15~64세,2017,49458,27217,22241,122.4,46303,24728,21575,114.6
26005, 면부,104,65세이상,2017,13340,5653,7687,73.5,13276,5620,7656,73.4
26005, 면부,086,85세이상,2017,1345,335,1010,33.2,1342,333,1009,33
26005, 면부,126,평균연령,2017,45.7,43.8,47.8,,46.2,44.4,48,
26005, 면부,127,중위연령,2017,47.9,45.2,50.6,,48.9,46.9,50.9,
26003, 동부,000,합계,2017,934913,483461,451452,107.1,917980,473817,444163,106.7
26003, 동부,005,0~4세,2017,45325,23323,22002,106,44991,23144,21847,105.9
26003, 동부,005001, 0세,2017,7955,4104,3851,106.6,7883,4072,3811,106.8
26003, 동부,005002, 1세,2017,9116,4704,4412,106.6,9044,4667,4377,106.6
26003, 동부,005003, 2세,2017,9527,4931,4596,107.3,9458,4888,4570,107
26003, 동부,005004, 3세,2017,9387,4782,4605,103.8,9318,4740,4578,103.5
26003, 동부,005005, 4세,2017,9340,4802,4538,105.8,9288,4777,4511,105.9
26003, 동부,010,5~9세,2017,46827,24394,22433,108.7,46645,24294,22351,108.7
26003, 동부,010001, 5세,2017,9893,5140,4753,108.1,9841,5114,4727,108.2
26003, 동부,010002, 6세,2017,9636,5013,4623,108.4,9597,4987,4610,108.2
26003, 동부,010003, 7세,2017,9218,4855,4363,111.3,9187,4839,4348,111.3
26003, 동부,010004, 8세,2017,8870,4644,4226,109.9,8844,4628,4216,109.8
26003, 동부,010005, 9세,2017,9210,4742,4468,106.1,9176,4726,4450,106.2
26003, 동부,015,10~14세,2017,43564,22997,20567,111.8,43463,22955,20508,111.9
26003, 동부,015001, 10세,2017,9274,4861,4413,110.2,9242,4847,4395,110.3
26003, 동부,015002, 11세,2017,8309,4298,4011,107.2,8294,4291,4003,107.2
26003, 동부,015003, 12세,2017,8120,4299,3821,112.5,8095,4287,3808,112.6
26003, 동부,015004, 13세,2017,8794,4679,4115,113.7,8776,4673,4103,113.9
26003, 동부,015005, 14세,2017,9067,4860,4207,115.5,9056,4857,4199,115.7
26003, 동부,020,15~19세,2017,54814,29619,25195,117.6,54582,29503,25079,117.6
26003, 동부,020001, 15세,2017,9434,4978,4456,111.7,9413,4966,4447,111.7
26003, 동부,020002, 16세,2017,11232,6028,5204,115.8,11210,6019,5191,116
26003, 동부,020003, 17세,2017,13126,6923,6203,111.6,13101,6912,6189,111.7
26003, 동부,020004, 18세,2017,11395,6144,5251,117,11338,6113,5225,117
26003, 동부,020005, 19세,2017,9627,5546,4081,135.9,9520,5493,4027,136.4
26003, 동부,025,20~24세,2017,60535,35139,25396,138.4,59208,34518,24690,139.8
26003, 동부,025001, 20세,2017,11320,6919,4401,157.2,11148,6842,4306,158.9
26003, 동부,025002, 21세,2017,12068,7318,4750,154.1,11858,7233,4625,156.4
26003, 동부,025003, 22세,2017,12069,6947,5122,135.6,11833,6838,4995,136.9
26003, 동부,025004, 23세,2017,12289,6875,5414,127,11970,6725,5245,128.2
26003, 동부,025005, 24세,2017,12789,7080,5709,124,12399,6880,5519,124.7
26003, 동부,030,25~29세,2017,62605,35062,27543,127.3,59918,33508,26410,126.9
26003, 동부,030001, 25세,2017,13047,7354,5693,129.2,12627,7112,5515,129
26003, 동부,030002, 26세,2017,12734,6957,5777,120.4,12182,6634,5548,119.6
26003, 동부,030003, 27세,2017,12445,7007,5438,128.9,11878,6696,5182,129.2
26003, 동부,030004, 28세,2017,12351,6986,5365,130.2,11789,6641,5148,129
26003, 동부,030005, 29세,2017,12028,6758,5270,128.2,11442,6425,5017,128.1
26003, 동부,035,30~34세,2017,65995,35321,30674,115.1,63241,33609,29632,113.4
26003, 동부,035001, 30세,2017,12039,6570,5469,120.1,11462,6234,5228,119.2
26003, 동부,035002, 31세,2017,12417,6717,5700,117.8,11838,6361,5477,116.1
26003, 동부,035003, 32세,2017,12709,6772,5937,114.1,12187,6449,5738,112.4
26003, 동부,035004, 33세,2017,13630,7308,6322,115.6,13074,6959,6115,113.8
26003, 동부,035005, 34세,2017,15200,7954,7246,109.8,14680,7606,7074,107.5
26003, 동부,040,35~39세,2017,80128,42248,37880,111.5,78123,40997,37126,110.4
26003, 동부,040001, 35세,2017,16428,8553,7875,108.6,15965,8266,7699,107.4
26003, 동부,040002, 36세,2017,16547,8808,7739,113.8,16128,8527,7601,112.2
26003, 동부,040003, 37세,2017,17116,9004,8112,111,16732,8773,7959,110.2
26003, 동부,040004, 38세,2017,15631,8216,7415,110.8,15249,7971,7278,109.5
26003, 동부,040005, 39세,2017,14406,7667,6739,113.8,14049,7460,6589,113.2
26003, 동부,045,40~44세,2017,74113,37838,36275,104.3,72642,36923,35719,103.4
26003, 동부,045001, 40세,2017,14506,7593,6913,109.8,14170,7384,6786,108.8
26003, 동부,045002, 41세,2017,13500,7084,6416,110.4,13218,6902,6316,109.3
26003, 동부,045003, 42세,2017,14495,7396,7099,104.2,14215,7220,6995,103.2
26003, 동부,045004, 43세,2017,15594,7798,7796,100,15305,7620,7685,99.2
26003, 동부,045005, 44세,2017,16018,7967,8051,99,15734,7797,7937,98.2
26003, 동부,050,45~49세,2017,87418,42996,44422,96.8,85606,41929,43677,96
26003, 동부,050001, 45세,2017,16203,8043,8160,98.6,15867,7844,8023,97.8
26003, 동부,050002, 46세,2017,17480,8656,8824,98.1,17101,8430,8671,97.2
26003, 동부,050003, 47세,2017,17389,8499,8890,95.6,17027,8280,8747,94.7
26003, 동부,050004, 48세,2017,17943,8811,9132,96.5,17587,8603,8984,95.8
26003, 동부,050005, 49세,2017,18403,8987,9416,95.4,18024,8772,9252,94.8
26003, 동부,055,50~54세,2017,85590,43714,41876,104.4,83961,42830,41131,104.1
26003, 동부,055001, 50세,2017,17371,8445,8926,94.6,17105,8303,8802,94.3
26003, 동부,055002, 51세,2017,17600,9168,8432,108.7,17260,8973,8287,108.3
26003, 동부,055003, 52세,2017,17694,9077,8617,105.3,17372,8910,8462,105.3
26003, 동부,055004, 53세,2017,16044,8268,7776,106.3,15718,8087,7631,106
26003, 동부,055005, 54세,2017,16881,8756,8125,107.8,16506,8557,7949,107.6
26003, 동부,060,55~59세,2017,83244,42635,40609,105,82186,42070,40116,104.9
26003, 동부,060001, 55세,2017,17271,8970,8301,108.1,17007,8844,8163,108.3
26003, 동부,060002, 56세,2017,18516,9461,9055,104.5,18328,9361,8967,104.4
26003, 동부,060003, 57세,2017,17417,8729,8688,100.5,17182,8598,8584,100.2
26003, 동부,060004, 58세,2017,15599,8008,7591,105.5,15415,7897,7518,105
26003, 동부,060005, 59세,2017,14441,7467,6974,107.1,14254,7370,6884,107.1
26003, 동부,065,60~64세,2017,57042,28742,28300,101.6,56295,28346,27949,101.4
26003, 동부,065001, 60세,2017,13652,6910,6742,102.5,13466,6802,6664,102.1
26003, 동부,065002, 61세,2017,12340,6202,6138,101,12203,6130,6073,100.9
26003, 동부,065003, 62세,2017,12149,6062,6087,99.6,11990,5975,6015,99.3
26003, 동부,065004, 63세,2017,9999,5072,4927,102.9,9853,5000,4853,103
26003, 동부,065005, 64세,2017,8902,4496,4406,102,8783,4439,4344,102.2
26003, 동부,070,65~69세,2017,35649,18193,17456,104.2,35316,18035,17281,104.4
26003, 동부,070001, 65세,2017,8986,4602,4384,105,8892,4558,4334,105.2
26003, 동부,070002, 66세,2017,6942,3570,3372,105.9,6855,3526,3329,105.9
26003, 동부,070003, 67세,2017,6753,3417,3336,102.4,6694,3393,3301,102.8
26003, 동부,070004, 68세,2017,6576,3396,3180,106.8,6515,3369,3146,107.1
26003, 동부,070005, 69세,2017,6392,3208,3184,100.8,6360,3189,3171,100.6
26003, 동부,075,70~74세,2017,21586,10415,11171,93.2,21466,10365,11101,93.4
26003, 동부,075001, 70세,2017,5664,2814,2850,98.7,5627,2801,2826,99.1
26003, 동부,075002, 71세,2017,3934,1970,1964,100.3,3911,1959,1952,100.4
26003, 동부,075003, 72세,2017,3904,1892,2012,94,3878,1880,1998,94.1
26003, 동부,075004, 73세,2017,3948,1836,2112,86.9,3931,1831,2100,87.2
26003, 동부,075005, 74세,2017,4136,1903,2233,85.2,4119,1894,2225,85.1
26003, 동부,080,75~79세,2017,16055,6849,9206,74.4,15980,6822,9158,74.5
26003, 동부,080001, 75세,2017,4391,2014,2377,84.7,4372,2009,2363,85
26003, 동부,080002, 76세,2017,3248,1437,1811,79.3,3224,1425,1799,79.2
26003, 동부,080003, 77세,2017,3087,1275,1812,70.4,3071,1269,1802,70.4
26003, 동부,080004, 78세,2017,2874,1230,1644,74.8,2864,1228,1636,75.1
26003, 동부,080005, 79세,2017,2455,893,1562,57.2,2449,891,1558,57.2
26003, 동부,085,80~84세,2017,8967,2891,6076,47.6,8921,2888,6033,47.9
26003, 동부,085001, 80세,2017,2228,773,1455,53.1,2215,773,1442,53.6
26003, 동부,085002, 81세,2017,2009,631,1378,45.8,1999,628,1371,45.8
26003, 동부,085003, 82세,2017,1781,555,1226,45.3,1771,555,1216,45.6
26003, 동부,085004, 83세,2017,1579,513,1066,48.1,1573,513,1060,48.4
26003, 동부,085005, 84세,2017,1370,419,951,44.1,1363,419,944,44.4
26003, 동부,090,85~89세,2017,3843,867,2976,29.1,3826,864,2962,29.2
26003, 동부,090001, 85세,2017,1111,289,822,35.2,1109,288,821,35.1
26003, 동부,090002, 86세,2017,849,188,661,28.4,845,187,658,28.4
26003, 동부,090003, 87세,2017,729,170,559,30.4,723,170,553,30.7
26003, 동부,090004, 88세,2017,641,143,498,28.7,638,142,496,28.6
26003, 동부,090005, 89세,2017,513,77,436,17.7,511,77,434,17.7
26003, 동부,095,90~94세,2017,1300,178,1122,15.9,1297,177,1120,15.8
26003, 동부,095001, 90세,2017,422,64,358,17.9,421,63,358,17.6
26003, 동부,095002, 91세,2017,290,38,252,15.1,289,38,251,15.1
26003, 동부,095003, 92세,2017,256,37,219,16.9,255,37,218,17
26003, 동부,095004, 93세,2017,166,20,146,13.7,166,20,146,13.7
26003, 동부,095005, 94세,2017,166,19,147,12.9,166,19,147,12.9
26003, 동부,100,95~99세,2017,282,39,243,16,282,39,243,16
26003, 동부,100001, 95세,2017,108,14,94,14.9,108,14,94,14.9
26003, 동부,100002, 96세,2017,70,10,60,16.7,70,10,60,16.7
26003, 동부,100003, 97세,2017,57,9,48,18.8,57,9,48,18.8
26003, 동부,100004, 98세,2017,28,5,23,21.7,28,5,23,21.7
26003, 동부,100005, 99세,2017,19,X,18,5.6,19,X,18,5.6
26003, 동부,101,100세이상,2017,31,X,30,3.3,31,X,30,3.3
26003, 동부,102,15세미만,2017,135716,70714,65002,108.8,135099,70393,64706,108.8
26003, 동부,103,15~64세,2017,711484,373314,338170,110.4,695762,364233,331529,109.9
26003, 동부,104,65세이상,2017,87713,39433,48280,81.7,87119,39191,47928,81.8
26003, 동부,086,85세이상,2017,5456,1085,4371,24.8,5436,1081,4355,24.8
26003, 동부,126,평균연령,2017,39.3,38.4,40.3,,39.3,38.4,40.3,
26003, 동부,127,중위연령,2017,40.5,39.2,42.1,,40.6,39.2,42.2,
26010, 중구,000,합계,2017,233343,118977,114366,104,230436,117671,112765,104.4
26010, 중구,005,0~4세,2017,10360,5358,5002,107.1,10298,5326,4972,107.1
26010, 중구,005001, 0세,2017,1814,940,874,107.6,1807,939,868,108.2
26010, 중구,005002, 1세,2017,2064,1069,995,107.4,2048,1062,986,107.7
26010, 중구,005003, 2세,2017,2095,1080,1015,106.4,2078,1068,1010,105.7
26010, 중구,005004, 3세,2017,2189,1132,1057,107.1,2177,1124,1053,106.7
26010, 중구,005005, 4세,2017,2198,1137,1061,107.2,2188,1133,1055,107.4
26010, 중구,010,5~9세,2017,10834,5747,5087,113,10811,5729,5082,112.7
26010, 중구,010001, 5세,2017,2285,1243,1042,119.3,2279,1237,1042,118.7
26010, 중구,010002, 6세,2017,2308,1206,1102,109.4,2304,1203,1101,109.3
26010, 중구,010003, 7세,2017,2156,1151,1005,114.5,2155,1150,1005,114.4
26010, 중구,010004, 8세,2017,2029,1087,942,115.4,2020,1082,938,115.4
26010, 중구,010005, 9세,2017,2056,1060,996,106.4,2053,1057,996,106.1
26010, 중구,015,10~14세,2017,10042,5342,4700,113.7,10023,5332,4691,113.7
26010, 중구,015001, 10세,2017,2142,1123,1019,110.2,2137,1119,1018,109.9
26010, 중구,015002, 11세,2017,1876,992,884,112.2,1874,990,884,112
26010, 중구,015003, 12세,2017,1838,976,862,113.2,1835,975,860,113.4
26010, 중구,015004, 13세,2017,2015,1083,932,116.2,2010,1081,929,116.4
26010, 중구,015005, 14세,2017,2171,1168,1003,116.5,2167,1167,1000,116.7
26010, 중구,020,15~19세,2017,12857,6979,5878,118.7,12823,6963,5860,118.8
26010, 중구,020001, 15세,2017,2217,1160,1057,109.7,2210,1156,1054,109.7
26010, 중구,020002, 16세,2017,2641,1410,1231,114.5,2635,1408,1227,114.8
26010, 중구,020003, 17세,2017,3146,1641,1505,109,3141,1639,1502,109.1
26010, 중구,020004, 18세,2017,2619,1457,1162,125.4,2611,1451,1160,125.1
26010, 중구,020005, 19세,2017,2234,1311,923,142,2226,1309,917,142.7
26010, 중구,025,20~24세,2017,14685,8580,6105,140.5,14526,8545,5981,142.9
26010, 중구,025001, 20세,2017,2685,1700,985,172.6,2666,1696,970,174.8
26010, 중구,025002, 21세,2017,2873,1823,1050,173.6,2849,1817,1032,176.1
26010, 중구,025003, 22세,2017,2947,1669,1278,130.6,2910,1662,1248,133.2
26010, 중구,025004, 23세,2017,3041,1683,1358,123.9,3001,1672,1329,125.8
26010, 중구,025005, 24세,2017,3139,1705,1434,118.9,3100,1698,1402,121.1
26010, 중구,030,25~29세,2017,14754,8001,6753,118.5,14400,7884,6516,121
26010, 중구,030001, 25세,2017,3036,1673,1363,122.7,2987,1657,1330,124.6
26010, 중구,030002, 26세,2017,3047,1617,1430,113.1,2971,1587,1384,114.7
26010, 중구,030003, 27세,2017,2990,1629,1361,119.7,2909,1602,1307,122.6
26010, 중구,030004, 28세,2017,2895,1588,1307,121.5,2822,1569,1253,125.2
26010, 중구,030005, 29세,2017,2786,1494,1292,115.6,2711,1469,1242,118.3
26010, 중구,035,30~34세,2017,14873,7739,7134,108.5,14497,7575,6922,109.4
26010, 중구,035001, 30세,2017,2690,1427,1263,113,2603,1391,1212,114.8
26010, 중구,035002, 31세,2017,2768,1485,1283,115.7,2682,1445,1237,116.8
26010, 중구,035003, 32세,2017,2819,1411,1408,100.2,2761,1389,1372,101.2
26010, 중구,035004, 33세,2017,3115,1631,1484,109.9,3026,1593,1433,111.2
26010, 중구,035005, 34세,2017,3481,1785,1696,105.2,3425,1757,1668,105.3
26010, 중구,040,35~39세,2017,18488,9599,8889,108,18187,9472,8715,108.7
26010, 중구,040001, 35세,2017,3758,1902,1856,102.5,3698,1878,1820,103.2
26010, 중구,040002, 36세,2017,3715,1940,1775,109.3,3651,1910,1741,109.7
26010, 중구,040003, 37세,2017,3976,2060,1916,107.5,3920,2039,1881,108.4
26010, 중구,040004, 38세,2017,3699,1931,1768,109.2,3638,1898,1740,109.1
26010, 중구,040005, 39세,2017,3340,1766,1574,112.2,3280,1747,1533,114
26010, 중구,045,40~44세,2017,17620,9027,8593,105.1,17390,8916,8474,105.2
26010, 중구,045001, 40세,2017,3394,1800,1594,112.9,3349,1780,1569,113.4
26010, 중구,045002, 41세,2017,3126,1627,1499,108.5,3090,1612,1478,109.1
26010, 중구,045003, 42세,2017,3438,1747,1691,103.3,3396,1727,1669,103.5
26010, 중구,045004, 43세,2017,3716,1868,1848,101.1,3662,1835,1827,100.4
26010, 중구,045005, 44세,2017,3946,1985,1961,101.2,3893,1962,1931,101.6
26010, 중구,050,45~49세,2017,21459,10399,11060,94,21105,10213,10892,93.8
26010, 중구,050001, 45세,2017,4006,1964,2042,96.2,3941,1932,2009,96.2
26010, 중구,050002, 46세,2017,4279,2109,2170,97.2,4197,2067,2130,97
26010, 중구,050003, 47세,2017,4156,1987,2169,91.6,4090,1948,2142,90.9
26010, 중구,050004, 48세,2017,4410,2119,2291,92.5,4345,2087,2258,92.4
26010, 중구,050005, 49세,2017,4608,2220,2388,93,4532,2179,2353,92.6
26010, 중구,055,50~54세,2017,21848,10999,10849,101.4,21475,10821,10654,101.6
26010, 중구,055001, 50세,2017,4351,2131,2220,96,4297,2106,2191,96.1
26010, 중구,055002, 51세,2017,4401,2248,2153,104.4,4319,2209,2110,104.7
26010, 중구,055003, 52세,2017,4591,2293,2298,99.8,4511,2253,2258,99.8
26010, 중구,055004, 53세,2017,4209,2162,2047,105.6,4130,2125,2005,106
26010, 중구,055005, 54세,2017,4296,2165,2131,101.6,4218,2128,2090,101.8
26010, 중구,060,55~59세,2017,22080,11146,10934,101.9,21831,11017,10814,101.9
26010, 중구,060001, 55세,2017,4531,2353,2178,108,4471,2320,2151,107.9
26010, 중구,060002, 56세,2017,4935,2512,2423,103.7,4898,2492,2406,103.6
26010, 중구,060003, 57세,2017,4509,2206,2303,95.8,4469,2185,2284,95.7
26010, 중구,060004, 58세,2017,4186,2106,2080,101.3,4136,2074,2062,100.6
26010, 중구,060005, 59세,2017,3919,1969,1950,101,3857,1946,1911,101.8
26010, 중구,065,60~64세,2017,16236,7910,8326,95,16030,7799,8231,94.8
26010, 중구,065001, 60세,2017,3747,1884,1863,101.1,3703,1860,1843,100.9
26010, 중구,065002, 61세,2017,3523,1703,1820,93.6,3470,1673,1797,93.1
26010, 중구,065003, 62세,2017,3438,1608,1830,87.9,3397,1582,1815,87.2
26010, 중구,065004, 63세,2017,2882,1429,1453,98.3,2840,1408,1432,98.3
26010, 중구,065005, 64세,2017,2646,1286,1360,94.6,2620,1276,1344,94.9
26010, 중구,070,65~69세,2017,10792,5380,5412,99.4,10685,5331,5354,99.6
26010, 중구,070001, 65세,2017,2699,1343,1356,99,2665,1327,1338,99.2
26010, 중구,070002, 66세,2017,2104,1066,1038,102.7,2079,1057,1022,103.4
26010, 중구,070003, 67세,2017,2003,992,1011,98.1,1988,985,1003,98.2
26010, 중구,070004, 68세,2017,2064,1054,1010,104.4,2039,1042,997,104.5
26010, 중구,070005, 69세,2017,1922,925,997,92.8,1914,920,994,92.6
26010, 중구,075,70~74세,2017,6869,3230,3639,88.8,6840,3217,3623,88.8
26010, 중구,075001, 70세,2017,1770,840,930,90.3,1757,834,923,90.4
26010, 중구,075002, 71세,2017,1155,587,568,103.3,1153,585,568,103
26010, 중구,075003, 72세,2017,1263,610,653,93.4,1259,608,651,93.4
26010, 중구,075004, 73세,2017,1325,553,772,71.6,1321,552,769,71.8
26010, 중구,075005, 74세,2017,1356,640,716,89.4,1350,638,712,89.6
26010, 중구,080,75~79세,2017,5206,2224,2982,74.6,5194,2218,2976,74.5
26010, 중구,080001, 75세,2017,1399,635,764,83.1,1397,634,763,83.1
26010, 중구,080002, 76세,2017,1061,464,597,77.7,1055,459,596,77
26010, 중구,080003, 77세,2017,1004,414,590,70.2,1003,414,589,70.3
26010, 중구,080004, 78세,2017,961,407,554,73.5,959,407,552,73.7
26010, 중구,080005, 79세,2017,781,304,477,63.7,780,304,476,63.9
26010, 중구,085,80~84세,2017,2777,978,1799,54.4,2765,976,1789,54.6
26010, 중구,085001, 80세,2017,687,256,431,59.4,687,256,431,59.4
26010, 중구,085002, 81세,2017,674,230,444,51.8,670,228,442,51.6
26010, 중구,085003, 82세,2017,544,191,353,54.1,540,191,349,54.7
26010, 중구,085004, 83세,2017,443,159,284,56,442,159,283,56.2
26010, 중구,085005, 84세,2017,429,142,287,49.5,426,142,284,50
26010, 중구,090,85~89세,2017,1149,289,860,33.6,1143,287,856,33.5
26010, 중구,090001, 85세,2017,344,96,248,38.7,342,95,247,38.5
26010, 중구,090002, 86세,2017,271,67,204,32.8,270,67,203,33
26010, 중구,090003, 87세,2017,191,54,137,39.4,190,54,136,39.7
26010, 중구,090004, 88세,2017,188,47,141,33.3,187,46,141,32.6
26010, 중구,090005, 89세,2017,155,25,130,19.2,154,25,129,19.4
26010, 중구,095,90~94세,2017,340,43,297,14.5,339,43,296,14.5
26010, 중구,095001, 90세,2017,127,17,110,15.5,127,17,110,15.5
26010, 중구,095002, 91세,2017,74,9,65,13.8,74,9,65,13.8
26010, 중구,095003, 92세,2017,62,10,52,19.2,61,10,51,19.6
26010, 중구,095004, 93세,2017,33,X,30,10,33,X,30,10
26010, 중구,095005, 94세,2017,44,X,40,10,44,X,40,10
26010, 중구,100,95~99세,2017,67,6,61,9.8,67,6,61,9.8
26010, 중구,100001, 95세,2017,21,X,21,0,21,X,21,0
26010, 중구,100002, 96세,2017,14,X,12,16.7,14,X,12,16.7
26010, 중구,100003, 97세,2017,18,X,15,20,18,X,15,20
26010, 중구,100004, 98세,2017,11,X,10,10,11,X,10,10
26010, 중구,100005, 99세,2017,X,X,X,0,X,X,X,0
26010, 중구,101,100세이상,2017,7,X,6,16.7,7,X,6,16.7
26010, 중구,102,15세미만,2017,31236,16447,14789,111.2,31132,16387,14745,111.1
26010, 중구,103,15~64세,2017,174900,90379,84521,106.9,172264,89205,83059,107.4
26010, 중구,104,65세이상,2017,27207,12151,15056,80.7,27040,12079,14961,80.7
26010, 중구,086,85세이상,2017,1563,339,1224,27.7,1556,337,1219,27.6
26010, 중구,126,평균연령,2017,41,39.8,42.2,,41,39.8,42.2,
26010, 중구,127,중위연령,2017,42.9,41.2,44.5,,42.9,41.1,44.6,
26020, 남구,000,합계,2017,333117,170349,162768,104.7,326711,166965,159746,104.5
26020, 남구,005,0~4세,2017,13366,6906,6460,106.9,13239,6839,6400,106.9
26020, 남구,005001, 0세,2017,2436,1251,1185,105.6,2403,1231,1172,105
26020, 남구,005002, 1세,2017,2660,1384,1276,108.5,2632,1372,1260,108.9
26020, 남구,005003, 2세,2017,2873,1502,1371,109.6,2852,1492,1360,109.7
26020, 남구,005004, 3세,2017,2674,1382,1292,107,2648,1367,1281,106.7
26020, 남구,005005, 4세,2017,2723,1387,1336,103.8,2704,1377,1327,103.8
26020, 남구,010,5~9세,2017,14203,7365,6838,107.7,14137,7329,6808,107.7
26020, 남구,010001, 5세,2017,2906,1487,1419,104.8,2890,1482,1408,105.3
26020, 남구,010002, 6세,2017,2835,1491,1344,110.9,2821,1482,1339,110.7
26020, 남구,010003, 7세,2017,2737,1448,1289,112.3,2723,1440,1283,112.2
26020, 남구,010004, 8세,2017,2762,1420,1342,105.8,2752,1412,1340,105.4
26020, 남구,010005, 9세,2017,2963,1519,1444,105.2,2951,1513,1438,105.2
26020, 남구,015,10~14세,2017,15066,8008,7058,113.5,15025,7995,7030,113.7
26020, 남구,015001, 10세,2017,2968,1601,1367,117.1,2953,1596,1357,117.6
26020, 남구,015002, 11세,2017,2763,1416,1347,105.1,2758,1415,1343,105.4
26020, 남구,015003, 12세,2017,2803,1509,1294,116.6,2791,1504,1287,116.9
26020, 남구,015004, 13세,2017,3254,1733,1521,113.9,3250,1732,1518,114.1
26020, 남구,015005, 14세,2017,3278,1749,1529,114.4,3273,1748,1525,114.6
26020, 남구,020,15~19세,2017,20576,11094,9482,117,20439,11029,9410,117.2
26020, 남구,020001, 15세,2017,3440,1823,1617,112.7,3432,1818,1614,112.6
26020, 남구,020002, 16세,2017,4036,2169,1867,116.2,4028,2166,1862,116.3
26020, 남구,020003, 17세,2017,4609,2440,2169,112.5,4601,2438,2163,112.7
26020, 남구,020004, 18세,2017,4413,2338,2075,112.7,4379,2325,2054,113.2
26020, 남구,020005, 19세,2017,4078,2324,1754,132.5,3999,2282,1717,132.9
26020, 남구,025,20~24세,2017,24364,13923,10441,133.3,23750,13663,10087,135.5
26020, 남구,025001, 20세,2017,4571,2740,1831,149.6,4469,2689,1780,151.1
26020, 남구,025002, 21세,2017,4874,2784,2090,133.2,4766,2740,2026,135.2
26020, 남구,025003, 22세,2017,4925,2825,2100,134.5,4815,2772,2043,135.7
26020, 남구,025004, 23세,2017,4891,2731,2160,126.4,4756,2685,2071,129.6
26020, 남구,025005, 24세,2017,5103,2843,2260,125.8,4944,2777,2167,128.1
26020, 남구,030,25~29세,2017,23275,12953,10322,125.5,22316,12463,9853,126.5
26020, 남구,030001, 25세,2017,5228,2998,2230,134.4,5061,2913,2148,135.6
26020, 남구,030002, 26세,2017,4783,2633,2150,122.5,4599,2543,2056,123.7
26020, 남구,030003, 27세,2017,4557,2526,2031,124.4,4349,2420,1929,125.5
26020, 남구,030004, 28세,2017,4463,2441,2022,120.7,4259,2324,1935,120.1
26020, 남구,030005, 29세,2017,4244,2355,1889,124.7,4048,2263,1785,126.8
26020, 남구,035,30~34세,2017,21905,11562,10343,111.8,21068,11110,9958,111.6
26020, 남구,035001, 30세,2017,4232,2265,1967,115.1,4036,2159,1877,115
26020, 남구,035002, 31세,2017,4252,2246,2006,112,4062,2149,1913,112.3
26020, 남구,035003, 32세,2017,4344,2288,2056,111.3,4192,2218,1974,112.4
26020, 남구,035004, 33세,2017,4401,2326,2075,112.1,4255,2237,2018,110.9
26020, 남구,035005, 34세,2017,4676,2437,2239,108.8,4523,2347,2176,107.9
26020, 남구,040,35~39세,2017,25456,13094,12362,105.9,24811,12727,12084,105.3
26020, 남구,040001, 35세,2017,5272,2712,2560,105.9,5137,2641,2496,105.8
26020, 남구,040002, 36세,2017,5293,2800,2493,112.3,5168,2730,2438,112
26020, 남구,040003, 37세,2017,5345,2721,2624,103.7,5211,2651,2560,103.6
26020, 남구,040004, 38세,2017,4928,2449,2479,98.8,4796,2365,2431,97.3
26020, 남구,040005, 39세,2017,4618,2412,2206,109.3,4499,2340,2159,108.4
26020, 남구,045,40~44세,2017,25823,12421,13402,92.7,25310,12121,13189,91.9
26020, 남구,045001, 40세,2017,4742,2371,2371,100,4628,2310,2318,99.7
26020, 남구,045002, 41세,2017,4542,2237,2305,97,4442,2177,2265,96.1
26020, 남구,045003, 42세,2017,4928,2363,2565,92.1,4838,2311,2527,91.5
26020, 남구,045004, 43세,2017,5674,2665,3009,88.6,5570,2601,2969,87.6
26020, 남구,045005, 44세,2017,5937,2785,3152,88.4,5832,2722,3110,87.5
26020, 남구,050,45~49세,2017,33770,16332,17438,93.7,33048,15932,17116,93.1
26020, 남구,050001, 45세,2017,6129,2915,3214,90.7,6004,2845,3159,90.1
26020, 남구,050002, 46세,2017,6789,3246,3543,91.6,6641,3165,3476,91.1
26020, 남구,050003, 47세,2017,6879,3349,3530,94.9,6731,3265,3466,94.2
26020, 남구,050004, 48세,2017,6880,3345,3535,94.6,6729,3263,3466,94.1
26020, 남구,050005, 49세,2017,7093,3477,3616,96.2,6943,3394,3549,95.6
26020, 남구,055,50~54세,2017,32260,16384,15876,103.2,31549,15991,15558,102.8
26020, 남구,055001, 50세,2017,6594,3136,3458,90.7,6485,3080,3405,90.5
26020, 남구,055002, 51세,2017,6650,3450,3200,107.8,6498,3358,3140,106.9
26020, 남구,055003, 52세,2017,6676,3480,3196,108.9,6536,3402,3134,108.6
26020, 남구,055004, 53세,2017,5951,3024,2927,103.3,5807,2944,2863,102.8
26020, 남구,055005, 54세,2017,6389,3294,3095,106.4,6223,3207,3016,106.3
26020, 남구,060,55~59세,2017,30317,15407,14910,103.3,29865,15152,14713,103
26020, 남구,060001, 55세,2017,6369,3262,3107,105,6246,3200,3046,105.1
26020, 남구,060002, 56세,2017,6702,3484,3218,108.3,6616,3434,3182,107.9
26020, 남구,060003, 57세,2017,6340,3165,3175,99.7,6245,3112,3133,99.3
26020, 남구,060004, 58세,2017,5694,2849,2845,100.1,5616,2799,2817,99.4
26020, 남구,060005, 59세,2017,5212,2647,2565,103.2,5142,2607,2535,102.8
26020, 남구,065,60~64세,2017,21064,10681,10383,102.9,20720,10493,10227,102.6
26020, 남구,065001, 60세,2017,5005,2535,2470,102.6,4920,2482,2438,101.8
26020, 남구,065002, 61세,2017,4486,2259,2227,101.4,4429,2234,2195,101.8
26020, 남구,065003, 62세,2017,4530,2303,2227,103.4,4461,2264,2197,103
26020, 남구,065004, 63세,2017,3744,1915,1829,104.7,3673,1879,1794,104.7
26020, 남구,065005, 64세,2017,3299,1669,1630,102.4,3237,1634,1603,101.9
26020, 남구,070,65~69세,2017,13000,6598,6402,103.1,12873,6532,6341,103
26020, 남구,070001, 65세,2017,3223,1630,1593,102.3,3186,1612,1574,102.4
26020, 남구,070002, 66세,2017,2545,1288,1257,102.5,2506,1264,1242,101.8
26020, 남구,070003, 67세,2017,2483,1256,1227,102.4,2465,1248,1217,102.5
26020, 남구,070004, 68세,2017,2344,1205,1139,105.8,2321,1195,1126,106.1
26020, 남구,070005, 69세,2017,2405,1219,1186,102.8,2395,1213,1182,102.6
26020, 남구,075,70~74세,2017,7659,3682,3977,92.6,7613,3664,3949,92.8
26020, 남구,075001, 70세,2017,1990,1022,968,105.6,1980,1019,961,106
26020, 남구,075002, 71세,2017,1449,684,765,89.4,1439,678,761,89.1
26020, 남구,075003, 72세,2017,1378,666,712,93.5,1367,662,705,93.9
26020, 남구,075004, 73세,2017,1417,656,761,86.2,1407,654,753,86.9
26020, 남구,075005, 74세,2017,1425,654,771,84.8,1420,651,769,84.7
26020, 남구,080,75~79세,2017,5780,2504,3276,76.4,5742,2491,3251,76.6
26020, 남구,080001, 75세,2017,1577,731,846,86.4,1565,727,838,86.8
26020, 남구,080002, 76세,2017,1194,541,653,82.8,1183,537,646,83.1
26020, 남구,080003, 77세,2017,1112,465,647,71.9,1105,462,643,71.9
26020, 남구,080004, 78세,2017,1041,460,581,79.2,1036,459,577,79.5
26020, 남구,080005, 79세,2017,856,307,549,55.9,853,306,547,55.9
26020, 남구,085,80~84세,2017,3266,1035,2231,46.4,3246,1035,2211,46.8
26020, 남구,085001, 80세,2017,825,293,532,55.1,816,293,523,56
26020, 남구,085002, 81세,2017,696,220,476,46.2,695,220,475,46.3
26020, 남구,085003, 82세,2017,660,195,465,41.9,655,195,460,42.4
26020, 남구,085004, 83세,2017,605,197,408,48.3,602,197,405,48.6
26020, 남구,085005, 84세,2017,480,130,350,37.1,478,130,348,37.4
26020, 남구,090,85~89세,2017,1375,315,1060,29.7,1369,315,1054,29.9
26020, 남구,090001, 85세,2017,377,111,266,41.7,377,111,266,41.7
26020, 남구,090002, 86세,2017,306,68,238,28.6,306,68,238,28.6
26020, 남구,090003, 87세,2017,268,60,208,28.8,264,60,204,29.4
26020, 남구,090004, 88세,2017,232,52,180,28.9,230,52,178,29.2
26020, 남구,090005, 89세,2017,192,24,168,14.3,192,24,168,14.3
26020, 남구,095,90~94세,2017,481,69,412,16.7,480,68,412,16.5
26020, 남구,095001, 90세,2017,141,26,115,22.6,140,25,115,21.7
26020, 남구,095002, 91세,2017,117,16,101,15.8,117,16,101,15.8
26020, 남구,095003, 92세,2017,95,11,84,13.1,95,11,84,13.1
26020, 남구,095004, 93세,2017,64,9,55,16.4,64,9,55,16.4
26020, 남구,095005, 94세,2017,64,7,57,12.3,64,7,57,12.3
26020, 남구,100,95~99세,2017,102,16,86,18.6,102,16,86,18.6
26020, 남구,100001, 95세,2017,43,8,35,22.9,43,8,35,22.9
26020, 남구,100002, 96세,2017,24,X,21,14.3,24,X,21,14.3
26020, 남구,100003, 97세,2017,20,X,17,17.6,20,X,17,17.6
26020, 남구,100004, 98세,2017,7,X,5,40,7,X,5,40
26020, 남구,100005, 99세,2017,8,X,8,0,8,X,8,0
26020, 남구,101,100세이상,2017,9,X,9,0,9,X,9,0
26020, 남구,102,15세미만,2017,42635,22279,20356,109.4,42401,22163,20238,109.5
26020, 남구,103,15~64세,2017,258810,133851,124959,107.1,252876,130681,122195,106.9
26020, 남구,104,65세이상,2017,31672,14219,17453,81.5,31434,14121,17313,81.6
26020, 남구,086,85세이상,2017,1967,400,1567,25.5,1960,399,1561,25.6
26020, 남구,126,평균연령,2017,40,39,41,,40,39,41,
26020, 남구,127,중위연령,2017,41.8,40.1,43.3,,41.9,40.1,43.4,
26030, 동구,000,합계,2017,172306,91965,80341,114.5,167765,88950,78815,112.9
26030, 동구,005,0~4세,2017,9720,4938,4782,103.3,9606,4875,4731,103
26030, 동구,005001, 0세,2017,1760,915,845,108.3,1738,909,829,109.7
26030, 동구,005002, 1세,2017,1977,992,985,100.7,1954,977,977,100
26030, 동구,005003, 2세,2017,1996,1035,961,107.7,1969,1016,953,106.6
26030, 동구,005004, 3세,2017,2086,1021,1065,95.9,2061,1006,1055,95.4
26030, 동구,005005, 4세,2017,1901,975,926,105.3,1884,967,917,105.5
26030, 동구,010,5~9세,2017,9262,4831,4431,109,9184,4792,4392,109.1
26030, 동구,010001, 5세,2017,2070,1061,1009,105.2,2045,1048,997,105.1
26030, 동구,010002, 6세,2017,1948,1024,924,110.8,1931,1012,919,110.1
26030, 동구,010003, 7세,2017,1859,990,869,113.9,1847,985,862,114.3
26030, 동구,010004, 8세,2017,1701,868,833,104.2,1694,865,829,104.3
26030, 동구,010005, 9세,2017,1684,888,796,111.6,1667,882,785,112.4
26030, 동구,015,10~14세,2017,7764,4132,3632,113.8,7730,4115,3615,113.8
26030, 동구,015001, 10세,2017,1727,880,847,103.9,1717,876,841,104.2
26030, 동구,015002, 11세,2017,1542,844,698,120.9,1535,840,695,120.9
26030, 동구,015003, 12세,2017,1436,761,675,112.7,1427,756,671,112.7
26030, 동구,015004, 13세,2017,1503,808,695,116.3,1496,805,691,116.5
26030, 동구,015005, 14세,2017,1556,839,717,117,1555,838,717,116.9
26030, 동구,020,15~19세,2017,9228,4895,4333,113,9189,4876,4313,113.1
26030, 동구,020001, 15세,2017,1573,820,753,108.9,1569,819,750,109.2
26030, 동구,020002, 16세,2017,1914,1026,888,115.5,1911,1025,886,115.7
26030, 동구,020003, 17세,2017,2404,1249,1155,108.1,2394,1243,1151,108
26030, 동구,020004, 18세,2017,1866,991,875,113.3,1857,985,872,113
26030, 동구,020005, 19세,2017,1471,809,662,122.2,1458,804,654,122.9
26030, 동구,025,20~24세,2017,9386,5484,3902,140.5,9104,5325,3779,140.9
26030, 동구,025001, 20세,2017,1726,1022,704,145.2,1691,1008,683,147.6
26030, 동구,025002, 21세,2017,1886,1161,725,160.1,1842,1142,700,163.1
26030, 동구,025003, 22세,2017,1828,1090,738,147.7,1786,1068,718,148.7
26030, 동구,025004, 23세,2017,1897,1077,820,131.3,1837,1040,797,130.5
26030, 동구,025005, 24세,2017,2049,1134,915,123.9,1948,1067,881,121.1
26030, 동구,030,25~29세,2017,12011,7015,4996,140.4,11290,6510,4780,136.2
26030, 동구,030001, 25세,2017,2224,1230,994,123.7,2126,1166,960,121.5
26030, 동구,030002, 26세,2017,2345,1307,1038,125.9,2206,1200,1006,119.3
26030, 동구,030003, 27세,2017,2347,1392,955,145.8,2199,1297,902,143.8
26030, 동구,030004, 28세,2017,2535,1533,1002,153,2379,1420,959,148.1
26030, 동구,030005, 29세,2017,2560,1553,1007,154.2,2380,1427,953,149.7
26030, 동구,035,30~34세,2017,15158,8727,6431,135.7,14232,8061,6171,130.6
26030, 동구,035001, 30세,2017,2685,1572,1113,141.2,2522,1463,1059,138.1
26030, 동구,035002, 31세,2017,2879,1646,1233,133.5,2692,1506,1186,127
26030, 동구,035003, 32세,2017,2917,1698,1219,139.3,2732,1555,1177,132.1
26030, 동구,035004, 33세,2017,3094,1794,1300,138,2891,1651,1240,133.1
26030, 동구,035005, 34세,2017,3583,2017,1566,128.8,3395,1886,1509,125
26030, 동구,040,35~39세,2017,17040,9701,7339,132.2,16389,9224,7165,128.7
26030, 동구,040001, 35세,2017,3662,2081,1581,131.6,3481,1946,1535,126.8
26030, 동구,040002, 36세,2017,3552,2050,1502,136.5,3418,1943,1475,131.7
26030, 동구,040003, 37세,2017,3654,2099,1555,135,3532,2006,1526,131.5
26030, 동구,040004, 38세,2017,3169,1810,1359,133.2,3058,1733,1325,130.8
26030, 동구,040005, 39세,2017,3003,1661,1342,123.8,2900,1596,1304,122.4
26030, 동구,045,40~44세,2017,13453,7490,5963,125.6,12992,7162,5830,122.8
26030, 동구,045001, 40세,2017,2781,1525,1256,121.4,2664,1438,1226,117.3
26030, 동구,045002, 41세,2017,2605,1504,1101,136.6,2514,1433,1081,132.6
26030, 동구,045003, 42세,2017,2672,1491,1181,126.2,2583,1428,1155,123.6
26030, 동구,045004, 43세,2017,2685,1501,1184,126.8,2598,1448,1150,125.9
26030, 동구,045005, 44세,2017,2710,1469,1241,118.4,2633,1415,1218,116.2
26030, 동구,050,45~49세,2017,13514,7161,6353,112.7,13055,6842,6213,110.1
26030, 동구,050001, 45세,2017,2580,1454,1126,129.1,2492,1389,1103,125.9
26030, 동구,050002, 46세,2017,2776,1487,1289,115.4,2675,1412,1263,111.8
26030, 동구,050003, 47세,2017,2675,1388,1287,107.8,2585,1329,1256,105.8
26030, 동구,050004, 48세,2017,2722,1444,1278,113,2637,1382,1255,110.1
26030, 동구,050005, 49세,2017,2761,1388,1373,101.1,2666,1330,1336,99.6
26030, 동구,055,50~54세,2017,13329,6648,6681,99.5,12991,6445,6546,98.5
26030, 동구,055001, 50세,2017,2593,1276,1317,96.9,2537,1244,1293,96.2
26030, 동구,055002, 51세,2017,2660,1385,1275,108.6,2593,1344,1249,107.6
26030, 동구,055003, 52세,2017,2735,1332,1403,94.9,2666,1295,1371,94.5
26030, 동구,055004, 53세,2017,2521,1270,1251,101.5,2458,1227,1231,99.7
26030, 동구,055005, 54세,2017,2820,1385,1435,96.5,2737,1335,1402,95.2
26030, 동구,060,55~59세,2017,16017,8005,8012,99.9,15789,7880,7909,99.6
26030, 동구,060001, 55세,2017,2978,1467,1511,97.1,2930,1448,1482,97.7
26030, 동구,060002, 56세,2017,3394,1587,1807,87.8,3351,1568,1783,87.9
26030, 동구,060003, 57세,2017,3512,1689,1823,92.6,3449,1647,1802,91.4
26030, 동구,060004, 58세,2017,3157,1653,1504,109.9,3118,1631,1487,109.7
26030, 동구,060005, 59세,2017,2976,1609,1367,117.7,2941,1586,1355,117
26030, 동구,065,60~64세,2017,11181,5695,5486,103.8,11080,5641,5439,103.7
26030, 동구,065001, 60세,2017,2779,1380,1399,98.6,2748,1364,1384,98.6
26030, 동구,065002, 61세,2017,2451,1275,1176,108.4,2436,1265,1171,108
26030, 동구,065003, 62세,2017,2364,1208,1156,104.5,2340,1194,1146,104.2
26030, 동구,065004, 63세,2017,1870,953,917,103.9,1854,945,909,104
26030, 동구,065005, 64세,2017,1717,879,838,104.9,1702,873,829,105.3
26030, 동구,070,65~69세,2017,6819,3680,3139,117.2,6760,3655,3105,117.7
26030, 동구,070001, 65세,2017,1791,975,816,119.5,1778,969,809,119.8
26030, 동구,070002, 66세,2017,1327,709,618,114.7,1318,706,612,115.4
26030, 동구,070003, 67세,2017,1297,688,609,113,1277,680,597,113.9
26030, 동구,070004, 68세,2017,1230,667,563,118.5,1221,663,558,118.8
26030, 동구,070005, 69세,2017,1174,641,533,120.3,1166,637,529,120.4
26030, 동구,075,70~74세,2017,3727,1950,1777,109.7,3700,1939,1761,110.1
26030, 동구,075001, 70세,2017,1018,549,469,117.1,1007,546,461,118.4
26030, 동구,075002, 71세,2017,752,412,340,121.2,746,411,335,122.7
26030, 동구,075003, 72세,2017,659,333,326,102.1,653,330,323,102.2
26030, 동구,075004, 73세,2017,599,316,283,111.7,597,314,283,111
26030, 동구,075005, 74세,2017,699,340,359,94.7,697,338,359,94.2
26030, 동구,080,75~79세,2017,2473,1076,1397,77,2459,1072,1387,77.3
26030, 동구,080001, 75세,2017,687,323,364,88.7,685,323,362,89.2
26030, 동구,080002, 76세,2017,501,228,273,83.5,497,226,271,83.4
26030, 동구,080003, 77세,2017,475,203,272,74.6,470,201,269,74.7
26030, 동구,080004, 78세,2017,428,190,238,79.8,426,190,236,80.5
26030, 동구,080005, 79세,2017,382,132,250,52.8,381,132,249,53
26030, 동구,085,80~84세,2017,1314,394,920,42.8,1307,394,913,43.2
26030, 동구,085001, 80세,2017,312,105,207,50.7,310,105,205,51.2
26030, 동구,085002, 81세,2017,297,82,215,38.1,295,82,213,38.5
26030, 동구,085003, 82세,2017,266,74,192,38.5,265,74,191,38.7
26030, 동구,085004, 83세,2017,232,66,166,39.8,232,66,166,39.8
26030, 동구,085005, 84세,2017,207,67,140,47.9,205,67,138,48.6
26030, 동구,090,85~89세,2017,614,109,505,21.6,612,108,504,21.4
26030, 동구,090001, 85세,2017,174,32,142,22.5,174,32,142,22.5
26030, 동구,090002, 86세,2017,132,24,108,22.2,130,23,107,21.5
26030, 동구,090003, 87세,2017,120,24,96,25,120,24,96,25
26030, 동구,090004, 88세,2017,107,21,86,24.4,107,21,86,24.4
26030, 동구,090005, 89세,2017,81,8,73,11,81,8,73,11
26030, 동구,095,90~94세,2017,239,27,212,12.7,239,27,212,12.7
26030, 동구,095001, 90세,2017,75,9,66,13.6,75,9,66,13.6
26030, 동구,095002, 91세,2017,43,6,37,16.2,43,6,37,16.2
26030, 동구,095003, 92세,2017,58,7,51,13.7,58,7,51,13.7
26030, 동구,095004, 93세,2017,37,X,36,2.8,37,X,36,2.8
26030, 동구,095005, 94세,2017,26,X,22,18.2,26,X,22,18.2
26030, 동구,100,95~99세,2017,50,7,43,16.3,50,7,43,16.3
26030, 동구,100001, 95세,2017,19,X,17,11.8,19,X,17,11.8
26030, 동구,100002, 96세,2017,13,X,11,18.2,13,X,11,18.2
26030, 동구,100003, 97세,2017,9,X,7,28.6,9,X,7,28.6
26030, 동구,100004, 98세,2017,6,X,5,20,6,X,5,20
26030, 동구,100005, 99세,2017,X,X,X,0,X,X,X,0
26030, 동구,101,100세이상,2017,7,X,7,0,7,X,7,0
26030, 동구,102,15세미만,2017,26746,13901,12845,108.2,26520,13782,12738,108.2
26030, 동구,103,15~64세,2017,130317,70821,59496,119,126111,67966,58145,116.9
26030, 동구,104,65세이상,2017,15243,7243,8000,90.5,15134,7202,7932,90.8
26030, 동구,086,85세이상,2017,910,143,767,18.6,908,142,766,18.5
26030, 동구,126,평균연령,2017,38.7,37.9,39.5,,38.7,38,39.6,
26030, 동구,127,중위연령,2017,38.9,37.9,40.3,,39,38,40.4,
26040, 북구,000,합계,2017,196147,102170,93977,108.7,193068,100231,92837,108
26040, 북구,005,0~4세,2017,11879,6121,5758,106.3,11848,6104,5744,106.3
26040, 북구,005001, 0세,2017,1945,998,947,105.4,1935,993,942,105.4
26040, 북구,005002, 1세,2017,2415,1259,1156,108.9,2410,1256,1154,108.8
26040, 북구,005003, 2세,2017,2563,1314,1249,105.2,2559,1312,1247,105.2
26040, 북구,005004, 3세,2017,2438,1247,1191,104.7,2432,1243,1189,104.5
26040, 북구,005005, 4세,2017,2518,1303,1215,107.2,2512,1300,1212,107.3
26040, 북구,010,5~9세,2017,12528,6451,6077,106.2,12513,6444,6069,106.2
26040, 북구,010001, 5세,2017,2632,1349,1283,105.1,2627,1347,1280,105.2
26040, 북구,010002, 6세,2017,2545,1292,1253,103.1,2541,1290,1251,103.1
26040, 북구,010003, 7세,2017,2466,1266,1200,105.5,2462,1264,1198,105.5
26040, 북구,010004, 8세,2017,2378,1269,1109,114.4,2378,1269,1109,114.4
26040, 북구,010005, 9세,2017,2507,1275,1232,103.5,2505,1274,1231,103.5
26040, 북구,015,10~14세,2017,10692,5515,5177,106.5,10685,5513,5172,106.6
26040, 북구,015001, 10세,2017,2437,1257,1180,106.5,2435,1256,1179,106.5
26040, 북구,015002, 11세,2017,2128,1046,1082,96.7,2127,1046,1081,96.8
26040, 북구,015003, 12세,2017,2043,1053,990,106.4,2042,1052,990,106.3
26040, 북구,015004, 13세,2017,2022,1055,967,109.1,2020,1055,965,109.3
26040, 북구,015005, 14세,2017,2062,1104,958,115.2,2061,1104,957,115.4
26040, 북구,020,15~19세,2017,12153,6651,5502,120.9,12131,6635,5496,120.7
26040, 북구,020001, 15세,2017,2204,1175,1029,114.2,2202,1173,1029,114
26040, 북구,020002, 16세,2017,2641,1423,1218,116.8,2636,1420,1216,116.8
26040, 북구,020003, 17세,2017,2967,1593,1374,115.9,2965,1592,1373,116
26040, 북구,020004, 18세,2017,2497,1358,1139,119.2,2491,1352,1139,118.7
26040, 북구,020005, 19세,2017,1844,1102,742,148.5,1837,1098,739,148.6
26040, 북구,025,20~24세,2017,12100,7152,4948,144.5,11828,6985,4843,144.2
26040, 북구,025001, 20세,2017,2338,1457,881,165.4,2322,1449,873,166
26040, 북구,025002, 21세,2017,2435,1550,885,175.1,2401,1534,867,176.9
26040, 북구,025003, 22세,2017,2369,1363,1006,135.5,2322,1336,986,135.5
26040, 북구,025004, 23세,2017,2460,1384,1076,128.6,2376,1328,1048,126.7
26040, 북구,025005, 24세,2017,2498,1398,1100,127.1,2407,1338,1069,125.2
26040, 북구,030,25~29세,2017,12565,7093,5472,129.6,11912,6651,5261,126.4
26040, 북구,030001, 25세,2017,2559,1453,1106,131.4,2453,1376,1077,127.8
26040, 북구,030002, 26세,2017,2559,1400,1159,120.8,2406,1304,1102,118.3
26040, 북구,030003, 27세,2017,2551,1460,1091,133.8,2421,1377,1044,131.9
26040, 북구,030004, 28세,2017,2458,1424,1034,137.7,2329,1328,1001,132.7
26040, 북구,030005, 29세,2017,2438,1356,1082,125.3,2303,1266,1037,122.1
26040, 북구,035,30~34세,2017,14059,7293,6766,107.8,13444,6863,6581,104.3
26040, 북구,035001, 30세,2017,2432,1306,1126,116,2301,1221,1080,113.1
26040, 북구,035002, 31세,2017,2518,1340,1178,113.8,2402,1261,1141,110.5
26040, 북구,035003, 32세,2017,2629,1375,1254,109.6,2502,1287,1215,105.9
26040, 북구,035004, 33세,2017,3020,1557,1463,106.4,2902,1478,1424,103.8
26040, 북구,035005, 34세,2017,3460,1715,1745,98.3,3337,1616,1721,93.9
26040, 북구,040,35~39세,2017,19144,9854,9290,106.1,18736,9574,9162,104.5
26040, 북구,040001, 35세,2017,3736,1858,1878,98.9,3649,1801,1848,97.5
26040, 북구,040002, 36세,2017,3987,2018,1969,102.5,3891,1944,1947,99.8
26040, 북구,040003, 37세,2017,4141,2124,2017,105.3,4069,2077,1992,104.3
26040, 북구,040004, 38세,2017,3835,2026,1809,112,3757,1975,1782,110.8
26040, 북구,040005, 39세,2017,3445,1828,1617,113,3370,1777,1593,111.6
26040, 북구,045,40~44세,2017,17217,8900,8317,107,16950,8724,8226,106.1
26040, 북구,045001, 40세,2017,3589,1897,1692,112.1,3529,1856,1673,110.9
26040, 북구,045002, 41세,2017,3227,1716,1511,113.6,3172,1680,1492,112.6
26040, 북구,045003, 42세,2017,3457,1795,1662,108,3398,1754,1644,106.7
26040, 북구,045004, 43세,2017,3519,1764,1755,100.5,3475,1736,1739,99.8
26040, 북구,045005, 44세,2017,3425,1728,1697,101.8,3376,1698,1678,101.2
26040, 북구,050,45~49세,2017,18675,9104,9571,95.1,18398,8942,9456,94.6
26040, 북구,050001, 45세,2017,3488,1710,1778,96.2,3430,1678,1752,95.8
26040, 북구,050002, 46세,2017,3636,1814,1822,99.6,3588,1786,1802,99.1
26040, 북구,050003, 47세,2017,3679,1775,1904,93.2,3621,1738,1883,92.3
26040, 북구,050004, 48세,2017,3931,1903,2028,93.8,3876,1871,2005,93.3
26040, 북구,050005, 49세,2017,3941,1902,2039,93.3,3883,1869,2014,92.8
26040, 북구,055,50~54세,2017,18153,9683,8470,114.3,17946,9573,8373,114.3
26040, 북구,055001, 50세,2017,3833,1902,1931,98.5,3786,1873,1913,97.9
26040, 북구,055002, 51세,2017,3889,2085,1804,115.6,3850,2062,1788,115.3
26040, 북구,055003, 52세,2017,3692,1972,1720,114.7,3659,1960,1699,115.4
26040, 북구,055004, 53세,2017,3363,1812,1551,116.8,3323,1791,1532,116.9
26040, 북구,055005, 54세,2017,3376,1912,1464,130.6,3328,1887,1441,131
26040, 북구,060,55~59세,2017,14830,8077,6753,119.6,14701,8021,6680,120.1
26040, 북구,060001, 55세,2017,3393,1888,1505,125.4,3360,1876,1484,126.4
26040, 북구,060002, 56세,2017,3485,1878,1607,116.9,3463,1867,1596,117
26040, 북구,060003, 57세,2017,3056,1669,1387,120.3,3019,1654,1365,121.2
26040, 북구,060004, 58세,2017,2562,1400,1162,120.5,2545,1393,1152,120.9
26040, 북구,060005, 59세,2017,2334,1242,1092,113.7,2314,1231,1083,113.7
26040, 북구,065,60~64세,2017,8561,4456,4105,108.6,8465,4413,4052,108.9
26040, 북구,065001, 60세,2017,2121,1111,1010,110,2095,1096,999,109.7
26040, 북구,065002, 61세,2017,1880,965,915,105.5,1868,958,910,105.3
26040, 북구,065003, 62세,2017,1817,943,874,107.9,1792,935,857,109.1
26040, 북구,065004, 63세,2017,1503,775,728,106.5,1486,768,718,107
26040, 북구,065005, 64세,2017,1240,662,578,114.5,1224,656,568,115.5
26040, 북구,070,65~69세,2017,5038,2535,2503,101.3,4998,2517,2481,101.5
26040, 북구,070001, 65세,2017,1273,654,619,105.7,1263,650,613,106
26040, 북구,070002, 66세,2017,966,507,459,110.5,952,499,453,110.2
26040, 북구,070003, 67세,2017,970,481,489,98.4,964,480,484,99.2
26040, 북구,070004, 68세,2017,938,470,468,100.4,934,469,465,100.9
26040, 북구,070005, 69세,2017,891,423,468,90.4,885,419,466,89.9
26040, 북구,075,70~74세,2017,3331,1553,1778,87.3,3313,1545,1768,87.4
26040, 북구,075001, 70세,2017,886,403,483,83.4,883,402,481,83.6
26040, 북구,075002, 71세,2017,578,287,291,98.6,573,285,288,99
26040, 북구,075003, 72세,2017,604,283,321,88.2,599,280,319,87.8
26040, 북구,075004, 73세,2017,607,311,296,105.1,606,311,295,105.4
26040, 북구,075005, 74세,2017,656,269,387,69.5,652,267,385,69.4
26040, 북구,080,75~79세,2017,2596,1045,1551,67.4,2585,1041,1544,67.4
26040, 북구,080001, 75세,2017,728,325,403,80.6,725,325,400,81.3
26040, 북구,080002, 76세,2017,492,204,288,70.8,489,203,286,71
26040, 북구,080003, 77세,2017,496,193,303,63.7,493,192,301,63.8
26040, 북구,080004, 78세,2017,444,173,271,63.8,443,172,271,63.5
26040, 북구,080005, 79세,2017,436,150,286,52.4,435,149,286,52.1
26040, 북구,085,80~84세,2017,1610,484,1126,43,1603,483,1120,43.1
26040, 북구,085001, 80세,2017,404,119,285,41.8,402,119,283,42
26040, 북구,085002, 81세,2017,342,99,243,40.7,339,98,241,40.7
26040, 북구,085003, 82세,2017,311,95,216,44,311,95,216,44
26040, 북구,085004, 83세,2017,299,91,208,43.8,297,91,206,44.2
26040, 북구,085005, 84세,2017,254,80,174,46,254,80,174,46
26040, 북구,090,85~89세,2017,705,154,551,27.9,702,154,548,28.1
26040, 북구,090001, 85세,2017,216,50,166,30.1,216,50,166,30.1
26040, 북구,090002, 86세,2017,140,29,111,26.1,139,29,110,26.4
26040, 북구,090003, 87세,2017,150,32,118,27.1,149,32,117,27.4
26040, 북구,090004, 88세,2017,114,23,91,25.3,114,23,91,25.3
26040, 북구,090005, 89세,2017,85,20,65,30.8,84,20,64,31.3
26040, 북구,095,90~94세,2017,240,39,201,19.4,239,39,200,19.5
26040, 북구,095001, 90세,2017,79,12,67,17.9,79,12,67,17.9
26040, 북구,095002, 91세,2017,56,7,49,14.3,55,7,48,14.6
26040, 북구,095003, 92세,2017,41,9,32,28.1,41,9,32,28.1
26040, 북구,095004, 93세,2017,32,7,25,28,32,7,25,28
26040, 북구,095005, 94세,2017,32,X,28,14.3,32,X,28,14.3
26040, 북구,100,95~99세,2017,63,10,53,18.9,63,10,53,18.9
26040, 북구,100001, 95세,2017,25,X,21,19,25,X,21,19
26040, 북구,100002, 96세,2017,19,X,16,18.8,19,X,16,18.8
26040, 북구,100003, 97세,2017,10,X,9,11.1,10,X,9,11.1
26040, 북구,100004, 98세,2017,X,X,X,33.3,X,X,X,33.3
26040, 북구,100005, 99세,2017,5,X,X,25,5,X,X,25
26040, 북구,101,100세이상,2017,8,X,8,0,8,X,8,0
26040, 북구,102,15세미만,2017,35099,18087,17012,106.3,35046,18061,16985,106.3
26040, 북구,103,15~64세,2017,147457,78263,69194,113.1,144511,76381,68130,112.1
26040, 북구,104,65세이상,2017,13591,5820,7771,74.9,13511,5789,7722,75
26040, 북구,086,85세이상,2017,1016,203,813,25,1012,203,809,25.1
26040, 북구,126,평균연령,2017,36.8,36.1,37.6,,36.8,36.1,37.5,
26040, 북구,127,중위연령,2017,38.1,37.4,38.8,,38.1,37.6,38.8,
26310, 울주군,000,합계,2017,222164,116632,105532,110.5,212496,109922,102574,107.2
26310, 울주군,005,0~4세,2017,9528,4900,4628,105.9,9358,4816,4542,106
26310, 울주군,005001, 0세,2017,1648,882,766,115.1,1608,860,748,115
26310, 울주군,005002, 1세,2017,1825,938,887,105.7,1800,926,874,105.9
26310, 울주군,005003, 2세,2017,1971,1023,948,107.9,1930,1003,927,108.2
26310, 울주군,005004, 3세,2017,2048,1053,995,105.8,2013,1035,978,105.8
26310, 울주군,005005, 4세,2017,2036,1004,1032,97.3,2007,992,1015,97.7
26310, 울주군,010,5~9세,2017,10861,5536,5325,104,10770,5487,5283,103.9
26310, 울주군,010001, 5세,2017,2246,1119,1127,99.3,2221,1108,1113,99.6
26310, 울주군,010002, 6세,2017,2183,1127,1056,106.7,2167,1119,1048,106.8
26310, 울주군,010003, 7세,2017,2160,1104,1056,104.5,2147,1100,1047,105.1
26310, 울주군,010004, 8세,2017,2022,1023,999,102.4,2003,1011,992,101.9
26310, 울주군,010005, 9세,2017,2250,1163,1087,107,2232,1149,1083,106.1
26310, 울주군,015,10~14세,2017,11012,5769,5243,110,10965,5747,5218,110.1
26310, 울주군,015001, 10세,2017,2281,1205,1076,112,2270,1197,1073,111.6
26310, 울주군,015002, 11세,2017,2092,1101,991,111.1,2083,1099,984,111.7
26310, 울주군,015003, 12세,2017,2122,1109,1013,109.5,2110,1104,1006,109.7
26310, 울주군,015004, 13세,2017,2251,1179,1072,110,2246,1175,1071,109.7
26310, 울주군,015005, 14세,2017,2266,1175,1091,107.7,2256,1172,1084,108.1
26310, 울주군,020,15~19세,2017,12771,6964,5807,119.9,12619,6862,5757,119.2
26310, 울주군,020001, 15세,2017,2309,1176,1133,103.8,2302,1174,1128,104.1
26310, 울주군,020002, 16세,2017,2535,1332,1203,110.7,2522,1324,1198,110.5
26310, 울주군,020003, 17세,2017,2764,1488,1276,116.6,2747,1475,1272,116
26310, 울주군,020004, 18세,2017,2724,1498,1226,122.2,2686,1469,1217,120.7
26310, 울주군,020005, 19세,2017,2439,1470,969,151.7,2362,1420,942,150.7
26310, 울주군,025,20~24세,2017,15144,9152,5992,152.7,14383,8594,5789,148.5
26310, 울주군,025001, 20세,2017,2874,1754,1120,156.6,2790,1697,1093,155.3
26310, 울주군,025002, 21세,2017,2910,1801,1109,162.4,2795,1724,1071,161
26310, 울주군,025003, 22세,2017,3136,1849,1287,143.7,2991,1741,1250,139.3
26310, 울주군,025004, 23세,2017,3124,1853,1271,145.8,2925,1700,1225,138.8
26310, 울주군,025005, 24세,2017,3100,1895,1205,157.3,2882,1732,1150,150.6
26310, 울주군,030,25~29세,2017,13596,8198,5398,151.9,11870,6863,5007,137.1
26310, 울주군,030001, 25세,2017,3124,1887,1237,152.5,2825,1646,1179,139.6
26310, 울주군,030002, 26세,2017,2973,1781,1192,149.4,2635,1522,1113,136.7
26310, 울주군,030003, 27세,2017,2595,1581,1014,155.9,2218,1287,931,138.2
26310, 울주군,030004, 28세,2017,2540,1545,995,155.3,2183,1275,908,140.4
26310, 울주군,030005, 29세,2017,2364,1404,960,146.3,2009,1133,876,129.3
26310, 울주군,035,30~34세,2017,13466,7605,5861,129.8,11697,6236,5461,114.2
26310, 울주군,035001, 30세,2017,2496,1425,1071,133.1,2101,1124,977,115
26310, 울주군,035002, 31세,2017,2557,1475,1082,136.3,2165,1179,986,119.6
26310, 울주군,035003, 32세,2017,2588,1472,1116,131.9,2222,1195,1027,116.4
26310, 울주군,035004, 33세,2017,2816,1555,1261,123.3,2492,1296,1196,108.4
26310, 울주군,035005, 34세,2017,3009,1678,1331,126.1,2717,1442,1275,113.1
26310, 울주군,040,35~39세,2017,17159,9160,7999,114.5,16021,8330,7691,108.3
26310, 울주군,040001, 35세,2017,3389,1840,1549,118.8,3136,1649,1487,110.9
26310, 울주군,040002, 36세,2017,3503,1926,1577,122.1,3259,1738,1521,114.3
26310, 울주군,040003, 37세,2017,3644,1895,1749,108.3,3430,1738,1692,102.7
26310, 울주군,040004, 38세,2017,3417,1808,1609,112.4,3203,1662,1541,107.9
26310, 울주군,040005, 39세,2017,3206,1691,1515,111.6,2993,1543,1450,106.4
26310, 울주군,045,40~44세,2017,18759,9643,9116,105.8,17876,9024,8852,101.9
26310, 울주군,045001, 40세,2017,3468,1777,1691,105.1,3306,1664,1642,101.3
26310, 울주군,045002, 41세,2017,3477,1839,1638,112.3,3293,1707,1586,107.6
26310, 울주군,045003, 42세,2017,3716,1873,1843,101.6,3537,1748,1789,97.7
26310, 울주군,045004, 43세,2017,3973,2047,1926,106.3,3804,1930,1874,103
26310, 울주군,045005, 44세,2017,4125,2107,2018,104.4,3936,1975,1961,100.7
26310, 울주군,050,45~49세,2017,21683,11255,10428,107.9,20701,10667,10034,106.3
26310, 울주군,050001, 45세,2017,4100,2123,1977,107.4,3914,2010,1904,105.6
26310, 울주군,050002, 46세,2017,4518,2339,2179,107.3,4313,2210,2103,105.1
26310, 울주군,050003, 47세,2017,4287,2203,2084,105.7,4073,2084,1989,104.8
26310, 울주군,050004, 48세,2017,4360,2281,2079,109.7,4173,2175,1998,108.9
26310, 울주군,050005, 49세,2017,4418,2309,2109,109.5,4228,2188,2040,107.3
26310, 울주군,055,50~54세,2017,19606,10510,9096,115.5,18677,9941,8736,113.8
26310, 울주군,055001, 50세,2017,4044,2080,1964,105.9,3888,1987,1901,104.5
26310, 울주군,055002, 51세,2017,4011,2173,1838,118.2,3822,2054,1768,116.2
26310, 울주군,055003, 52세,2017,4028,2214,1814,122.1,3829,2090,1739,120.2
26310, 울주군,055004, 53세,2017,3719,1993,1726,115.5,3534,1872,1662,112.6
26310, 울주군,055005, 54세,2017,3804,2050,1754,116.9,3604,1938,1666,116.3
26310, 울주군,060,55~59세,2017,18431,9744,8687,112.2,17933,9437,8496,111.1
26310, 울주군,060001, 55세,2017,3818,2092,1726,121.2,3689,2011,1678,119.8
26310, 울주군,060002, 56세,2017,4061,2124,1937,109.7,3983,2075,1908,108.8
26310, 울주군,060003, 57세,2017,3765,1993,1772,112.5,3662,1931,1731,111.6
26310, 울주군,060004, 58세,2017,3489,1840,1649,111.6,3387,1783,1604,111.2
26310, 울주군,060005, 59세,2017,3298,1695,1603,105.7,3212,1637,1575,103.9
26310, 울주군,065,60~64세,2017,13443,6905,6538,105.6,13142,6727,6415,104.9
26310, 울주군,065001, 60세,2017,3101,1613,1488,108.4,3044,1577,1467,107.5
26310, 울주군,065002, 61세,2017,2918,1521,1397,108.9,2831,1469,1362,107.9
26310, 울주군,065003, 62세,2017,2877,1450,1427,101.6,2822,1418,1404,101
26310, 울주군,065004, 63세,2017,2404,1258,1146,109.8,2343,1222,1121,109
26310, 울주군,065005, 64세,2017,2143,1063,1080,98.4,2102,1041,1061,98.1
26310, 울주군,070,65~69세,2017,8989,4551,4438,102.5,8860,4479,4381,102.2
26310, 울주군,070001, 65세,2017,2172,1084,1088,99.6,2138,1062,1076,98.7
26310, 울주군,070002, 66세,2017,1724,877,847,103.5,1695,862,833,103.5
26310, 울주군,070003, 67세,2017,1763,917,846,108.4,1731,899,832,108.1
26310, 울주군,070004, 68세,2017,1678,824,854,96.5,1661,815,846,96.3
26310, 울주군,070005, 69세,2017,1652,849,803,105.7,1635,841,794,105.9
26310, 울주군,075,70~74세,2017,6168,2881,3287,87.6,6133,2869,3264,87.9
26310, 울주군,075001, 70세,2017,1528,778,750,103.7,1518,775,743,104.3
26310, 울주군,075002, 71세,2017,1063,511,552,92.6,1056,510,546,93.4
26310, 울주군,075003, 72세,2017,1128,533,595,89.6,1120,528,592,89.2
26310, 울주군,075004, 73세,2017,1150,485,665,72.9,1146,483,663,72.9
26310, 울주군,075005, 74세,2017,1299,574,725,79.2,1293,573,720,79.6
26310, 울주군,080,75~79세,2017,5617,2203,3414,64.5,5586,2193,3393,64.6
26310, 울주군,080001, 75세,2017,1418,591,827,71.5,1406,586,820,71.5
26310, 울주군,080002, 76세,2017,1119,442,677,65.3,1115,441,674,65.4
26310, 울주군,080003, 77세,2017,1079,421,658,64,1073,419,654,64.1
26310, 울주군,080004, 78세,2017,1035,390,645,60.5,1031,388,643,60.3
26310, 울주군,080005, 79세,2017,966,359,607,59.1,961,359,602,59.6
26310, 울주군,085,80~84세,2017,3474,1115,2359,47.3,3460,1112,2348,47.4
26310, 울주군,085001, 80세,2017,820,286,534,53.6,815,286,529,54.1
26310, 울주군,085002, 81세,2017,742,251,491,51.1,739,251,488,51.4
26310, 울주군,085003, 82세,2017,715,234,481,48.6,713,233,480,48.5
26310, 울주군,085004, 83세,2017,659,195,464,42,658,195,463,42.1
26310, 울주군,085005, 84세,2017,538,149,389,38.3,535,147,388,37.9
26310, 울주군,090,85~89세,2017,1776,426,1350,31.6,1767,424,1343,31.6
26310, 울주군,090001, 85세,2017,494,130,364,35.7,492,130,362,35.9
26310, 울주군,090002, 86세,2017,406,101,305,33.1,403,100,303,33
26310, 울주군,090003, 87세,2017,332,71,261,27.2,329,71,258,27.5
26310, 울주군,090004, 88세,2017,298,70,228,30.7,298,70,228,30.7
26310, 울주군,090005, 89세,2017,246,54,192,28.1,245,53,192,27.6
26310, 울주군,095,90~94세,2017,564,97,467,20.8,563,97,466,20.8
26310, 울주군,095001, 90세,2017,192,39,153,25.5,191,39,152,25.7
26310, 울주군,095002, 91세,2017,129,20,109,18.3,129,20,109,18.3
26310, 울주군,095003, 92세,2017,104,15,89,16.9,104,15,89,16.9
26310, 울주군,095004, 93세,2017,72,7,65,10.8,72,7,65,10.8
26310, 울주군,095005, 94세,2017,67,16,51,31.4,67,16,51,31.4
26310, 울주군,100,95~99세,2017,103,17,86,19.8,101,16,85,18.8
26310, 울주군,100001, 95세,2017,41,7,34,20.6,40,7,33,21.2
26310, 울주군,100002, 96세,2017,27,X,23,17.4,27,X,23,17.4
26310, 울주군,100003, 97세,2017,14,X,12,16.7,14,X,12,16.7
26310, 울주군,100004, 98세,2017,12,X,10,20,12,X,10,20
26310, 울주군,100005, 99세,2017,9,X,7,28.6,8,X,7,14.3
26310, 울주군,101,100세이상,2017,14,X,13,7.7,14,X,13,7.7
26310, 울주군,102,15세미만,2017,31401,16205,15196,106.6,31093,16050,15043,106.7
26310, 울주군,103,15~64세,2017,164058,89136,74922,119,154919,82681,72238,114.5
26310, 울주군,104,65세이상,2017,26705,11291,15414,73.3,26484,11191,15293,73.2
26310, 울주군,086,85세이상,2017,2457,541,1916,28.2,2445,538,1907,28.2
26310, 울주군,126,평균연령,2017,40.5,39.3,41.9,,40.7,39.4,42,
26310, 울주군,127,중위연령,2017,42.2,40.6,43.7,,42.6,41.2,43.8,
29,세종특별자치시,000,합계,2017,276589,139347,137242,101.5,271299,136217,135082,100.8
29,세종특별자치시,005,0~4세,2017,18887,9720,9167,106,18818,9678,9140,105.9
29,세종특별자치시,005001, 0세,2017,3534,1794,1740,103.1,3524,1786,1738,102.8
29,세종특별자치시,005002, 1세,2017,3778,1972,1806,109.2,3765,1965,1800,109.2
29,세종특별자치시,005003, 2세,2017,3889,2014,1875,107.4,3873,2006,1867,107.4
29,세종특별자치시,005004, 3세,2017,3754,1946,1808,107.6,3737,1933,1804,107.2
29,세종특별자치시,005005, 4세,2017,3932,1994,1938,102.9,3919,1988,1931,103
29,세종특별자치시,010,5~9세,2017,20036,10208,9828,103.9,19998,10185,9813,103.8
29,세종특별자치시,010001, 5세,2017,4083,2090,1993,104.9,4073,2084,1989,104.8
29,세종특별자치시,010002, 6세,2017,4137,2115,2022,104.6,4131,2110,2021,104.4
29,세종특별자치시,010003, 7세,2017,3981,2051,1930,106.3,3970,2044,1926,106.1
29,세종특별자치시,010004, 8세,2017,3882,1988,1894,105,3877,1985,1892,104.9
29,세종특별자치시,010005, 9세,2017,3953,1964,1989,98.7,3947,1962,1985,98.8
29,세종특별자치시,015,10~14세,2017,16808,8392,8416,99.7,16786,8387,8399,99.9
29,세종특별자치시,015001, 10세,2017,3715,1810,1905,95,3706,1809,1897,95.4
29,세종특별자치시,015002, 11세,2017,3504,1788,1716,104.2,3497,1788,1709,104.6
29,세종특별자치시,015003, 12세,2017,3127,1565,1562,100.2,3127,1565,1562,100.2
29,세종특별자치시,015004, 13세,2017,3365,1680,1685,99.7,3361,1677,1684,99.6
29,세종특별자치시,015005, 14세,2017,3097,1549,1548,100.1,3095,1548,1547,100.1
29,세종특별자치시,020,15~19세,2017,15821,8030,7791,103.1,15631,7933,7698,103.1
29,세종특별자치시,020001, 15세,2017,2877,1451,1426,101.8,2872,1449,1423,101.8
29,세종특별자치시,020002, 16세,2017,3030,1493,1537,97.1,3025,1491,1534,97.2
29,세종특별자치시,020003, 17세,2017,3074,1541,1533,100.5,3056,1528,1528,100
29,세종특별자치시,020004, 18세,2017,2962,1493,1469,101.6,2906,1463,1443,101.4
29,세종특별자치시,020005, 19세,2017,3878,2052,1826,112.4,3772,2002,1770,113.1
29,세종특별자치시,025,20~24세,2017,18151,9868,8283,119.1,17536,9518,8018,118.7
29,세종특별자치시,025001, 20세,2017,3652,1870,1782,104.9,3545,1815,1730,104.9
29,세종특별자치시,025002, 21세,2017,3446,1690,1756,96.2,3332,1634,1698,96.2
29,세종특별자치시,025003, 22세,2017,3577,1958,1619,120.9,3465,1896,1569,120.8
29,세종특별자치시,025004, 23세,2017,3760,2125,1635,130,3648,2063,1585,130.2
29,세종특별자치시,025005, 24세,2017,3716,2225,1491,149.2,3546,2110,1436,146.9
29,세종특별자치시,030,25~29세,2017,16675,8784,7891,111.3,15724,8177,7547,108.3
29,세종특별자치시,030001, 25세,2017,3542,1965,1577,124.6,3364,1861,1503,123.8
29,세종특별자치시,030002, 26세,2017,3341,1809,1532,118.1,3131,1676,1455,115.2
29,세종특별자치시,030003, 27세,2017,3200,1663,1537,108.2,3009,1537,1472,104.4
29,세종특별자치시,030004, 28세,2017,3197,1623,1574,103.1,3013,1505,1508,99.8
29,세종특별자치시,030005, 29세,2017,3395,1724,1671,103.2,3207,1598,1609,99.3
29,세종특별자치시,035,30~34세,2017,21563,10463,11100,94.3,20674,9913,10761,92.1
29,세종특별자치시,035001, 30세,2017,3658,1735,1923,90.2,3467,1613,1854,87
29,세종특별자치시,035002, 31세,2017,3843,1904,1939,98.2,3660,1786,1874,95.3
29,세종특별자치시,035003, 32세,2017,4248,2114,2134,99.1,4038,1988,2050,97
29,세종특별자치시,035004, 33세,2017,4597,2240,2357,95,4440,2144,2296,93.4
29,세종특별자치시,035005, 34세,2017,5217,2470,2747,89.9,5069,2382,2687,88.6
29,세종특별자치시,040,35~39세,2017,29326,14358,14968,95.9,28716,13988,14728,95
29,세종특별자치시,040001, 35세,2017,6043,2925,3118,93.8,5902,2843,3059,92.9
29,세종특별자치시,040002, 36세,2017,5931,2885,3046,94.7,5809,2809,3000,93.6
29,세종특별자치시,040003, 37세,2017,6077,2993,3084,97,5954,2919,3035,96.2
29,세종특별자치시,040004, 38세,2017,5921,2905,3016,96.3,5798,2825,2973,95
29,세종특별자치시,040005, 39세,2017,5354,2650,2704,98,5253,2592,2661,97.4
29,세종특별자치시,045,40~44세,2017,26892,13841,13051,106.1,26426,13544,12882,105.1
29,세종특별자치시,045001, 40세,2017,5539,2772,2767,100.2,5440,2710,2730,99.3
29,세종특별자치시,045002, 41세,2017,5202,2640,2562,103,5101,2577,2524,102.1
29,세종특별자치시,045003, 42세,2017,5336,2732,2604,104.9,5235,2674,2561,104.4
29,세종특별자치시,045004, 43세,2017,5618,2949,2669,110.5,5521,2878,2643,108.9
29,세종특별자치시,045005, 44세,2017,5197,2748,2449,112.2,5129,2705,2424,111.6
29,세종특별자치시,050,45~49세,2017,22720,12308,10412,118.2,22292,12071,10221,118.1
29,세종특별자치시,050001, 45세,2017,4914,2722,2192,124.2,4822,2675,2147,124.6
29,세종특별자치시,050002, 46세,2017,5100,2728,2372,115,5012,2679,2333,114.8
29,세종특별자치시,050003, 47세,2017,4324,2415,1909,126.5,4232,2361,1871,126.2
29,세종특별자치시,050004, 48세,2017,4322,2335,1987,117.5,4235,2281,1954,116.7
29,세종특별자치시,050005, 49세,2017,4060,2108,1952,108,3991,2075,1916,108.3
29,세종특별자치시,055,50~54세,2017,16342,8520,7822,108.9,15929,8286,7643,108.4
29,세종특별자치시,055001, 50세,2017,3496,1797,1699,105.8,3420,1756,1664,105.5
29,세종특별자치시,055002, 51세,2017,3208,1682,1526,110.2,3139,1642,1497,109.7
29,세종특별자치시,055003, 52세,2017,3396,1785,1611,110.8,3312,1732,1580,109.6
29,세종특별자치시,055004, 53세,2017,3055,1607,1448,111,2969,1556,1413,110.1
29,세종특별자치시,055005, 54세,2017,3187,1649,1538,107.2,3089,1600,1489,107.5
29,세종특별자치시,060,55~59세,2017,15936,8098,7838,103.3,15675,7961,7714,103.2
29,세종특별자치시,060001, 55세,2017,3246,1703,1543,110.4,3189,1677,1512,110.9
29,세종특별자치시,060002, 56세,2017,3603,1797,1806,99.5,3562,1779,1783,99.8
29,세종특별자치시,060003, 57세,2017,3367,1718,1649,104.2,3298,1672,1626,102.8
29,세종특별자치시,060004, 58세,2017,2936,1467,1469,99.9,2892,1448,1444,100.3
29,세종특별자치시,060005, 59세,2017,2784,1413,1371,103.1,2734,1385,1349,102.7
29,세종특별자치시,065,60~64세,2017,12034,5994,6040,99.2,11818,5875,5943,98.9
29,세종특별자치시,065001, 60세,2017,2750,1388,1362,101.9,2695,1354,1341,101
29,세종특별자치시,065002, 61세,2017,2588,1317,1271,103.6,2546,1293,1253,103.2
29,세종특별자치시,065003, 62세,2017,2675,1332,1343,99.2,2620,1310,1310,100
29,세종특별자치시,065004, 63세,2017,2203,1071,1132,94.6,2171,1054,1117,94.4
29,세종특별자치시,065005, 64세,2017,1818,886,932,95.1,1786,864,922,93.7
29,세종특별자치시,070,65~69세,2017,8195,3967,4228,93.8,8122,3926,4196,93.6
29,세종특별자치시,070001, 65세,2017,1967,958,1009,94.9,1947,943,1004,93.9
29,세종특별자치시,070002, 66세,2017,1453,675,778,86.8,1435,668,767,87.1
29,세종특별자치시,070003, 67세,2017,1711,861,850,101.3,1693,851,842,101.1
29,세종특별자치시,070004, 68세,2017,1620,765,855,89.5,1610,758,852,89
29,세종특별자치시,070005, 69세,2017,1444,708,736,96.2,1437,706,731,96.6
29,세종특별자치시,075,70~74세,2017,5775,2654,3121,85,5750,2640,3110,84.9
29,세종특별자치시,075001, 70세,2017,1399,658,741,88.8,1389,651,738,88.2
29,세종특별자치시,075002, 71세,2017,1086,515,571,90.2,1081,510,571,89.3
29,세종특별자치시,075003, 72세,2017,1078,510,568,89.8,1077,509,568,89.6
29,세종특별자치시,075004, 73세,2017,1124,488,636,76.7,1122,487,635,76.7
29,세종특별자치시,075005, 74세,2017,1088,483,605,79.8,1081,483,598,80.8
29,세종특별자치시,080,75~79세,2017,5421,2237,3184,70.3,5411,2235,3176,70.4
29,세종특별자치시,080001, 75세,2017,1398,613,785,78.1,1398,613,785,78.1
29,세종특별자치시,080002, 76세,2017,1107,455,652,69.8,1105,455,650,70
29,세종특별자치시,080003, 77세,2017,1007,407,600,67.8,1006,407,599,67.9
29,세종특별자치시,080004, 78세,2017,977,394,583,67.6,974,392,582,67.4
29,세종특별자치시,080005, 79세,2017,932,368,564,65.2,928,368,560,65.7
29,세종특별자치시,085,80~84세,2017,3576,1279,2297,55.7,3563,1275,2288,55.7
29,세종특별자치시,085001, 80세,2017,813,309,504,61.3,809,308,501,61.5
29,세종특별자치시,085002, 81세,2017,801,296,505,58.6,798,294,504,58.3
29,세종특별자치시,085003, 82세,2017,733,265,468,56.6,731,265,466,56.9
29,세종특별자치시,085004, 83세,2017,666,245,421,58.2,663,245,418,58.6
29,세종특별자치시,085005, 84세,2017,563,164,399,41.1,562,163,399,40.9
29,세종특별자치시,090,85~89세,2017,1754,479,1275,37.6,1753,478,1275,37.5
29,세종특별자치시,090001, 85세,2017,476,133,343,38.8,476,133,343,38.8
29,세종특별자치시,090002, 86세,2017,389,115,274,42,388,114,274,41.6
29,세종특별자치시,090003, 87세,2017,348,98,250,39.2,348,98,250,39.2
29,세종특별자치시,090004, 88세,2017,299,76,223,34.1,299,76,223,34.1
29,세종특별자치시,090005, 89세,2017,242,57,185,30.8,242,57,185,30.8
29,세종특별자치시,095,90~94세,2017,548,123,425,28.9,548,123,425,28.9
29,세종특별자치시,095001, 90세,2017,203,48,155,31,203,48,155,31
29,세종특별자치시,095002, 91세,2017,115,31,84,36.9,115,31,84,36.9
29,세종특별자치시,095003, 92세,2017,100,19,81,23.5,100,19,81,23.5
29,세종특별자치시,095004, 93세,2017,72,15,57,26.3,72,15,57,26.3
29,세종특별자치시,095005, 94세,2017,58,10,48,20.8,58,10,48,20.8
29,세종특별자치시,100,95~99세,2017,111,24,87,27.6,111,24,87,27.6
29,세종특별자치시,100001, 95세,2017,52,12,40,30,52,12,40,30
29,세종특별자치시,100002, 96세,2017,29,6,23,26.1,29,6,23,26.1
29,세종특별자치시,100003, 97세,2017,11,X,9,22.2,11,X,9,22.2
29,세종특별자치시,100004, 98세,2017,10,X,7,42.9,10,X,7,42.9
29,세종특별자치시,100005, 99세,2017,9,X,8,12.5,9,X,8,12.5
29,세종특별자치시,101,100세이상,2017,18,X,18,0,18,X,18,0
29,세종특별자치시,102,15세미만,2017,55731,28320,27411,103.3,55602,28250,27352,103.3
29,세종특별자치시,103,15~64세,2017,195460,100264,95196,105.3,190421,97266,93155,104.4
29,세종특별자치시,104,65세이상,2017,25398,10763,14635,73.5,25276,10701,14575,73.4
29,세종특별자치시,086,85세이상,2017,2431,626,1805,34.7,2430,625,1805,34.6
29,세종특별자치시,126,평균연령,2017,36.1,35.5,36.8,,36.1,35.4,36.8,
29,세종특별자치시,127,중위연령,2017,36.7,36.4,37,,36.8,36.5,37,
29004, 읍부,000,합계,2017,52007,27176,24831,109.4,50447,26359,24088,109.4
29004, 읍부,005,0~4세,2017,2099,1101,998,110.3,2064,1078,986,109.3
29004, 읍부,005001, 0세,2017,387,192,195,98.5,382,188,194,96.9
29004, 읍부,005002, 1세,2017,388,209,179,116.8,385,207,178,116.3
29004, 읍부,005003, 2세,2017,434,246,188,130.9,427,240,187,128.3
29004, 읍부,005004, 3세,2017,454,236,218,108.3,443,229,214,107
29004, 읍부,005005, 4세,2017,436,218,218,100,427,214,213,100.5
29004, 읍부,010,5~9세,2017,2440,1237,1203,102.8,2427,1232,1195,103.1
29004, 읍부,010001, 5세,2017,473,238,235,101.3,467,236,231,102.2
29004, 읍부,010002, 6세,2017,485,258,227,113.7,485,258,227,113.7
29004, 읍부,010003, 7세,2017,497,248,249,99.6,494,245,249,98.4
29004, 읍부,010004, 8세,2017,454,232,222,104.5,452,232,220,105.5
29004, 읍부,010005, 9세,2017,531,261,270,96.7,529,261,268,97.4
29004, 읍부,015,10~14세,2017,2127,1081,1046,103.3,2123,1081,1042,103.7
29004, 읍부,015001, 10세,2017,458,229,229,100,456,229,227,100.9
29004, 읍부,015002, 11세,2017,421,215,206,104.4,420,215,205,104.9
29004, 읍부,015003, 12세,2017,408,203,205,99,408,203,205,99
29004, 읍부,015004, 13세,2017,425,218,207,105.3,425,218,207,105.3
29004, 읍부,015005, 14세,2017,415,216,199,108.5,414,216,198,109.1
29004, 읍부,020,15~19세,2017,4058,2206,1852,119.1,3951,2145,1806,118.8
29004, 읍부,020001, 15세,2017,443,220,223,98.7,443,220,223,98.7
29004, 읍부,020002, 16세,2017,444,236,208,113.5,444,236,208,113.5
29004, 읍부,020003, 17세,2017,511,277,234,118.4,502,271,231,117.3
29004, 읍부,020004, 18세,2017,866,476,390,122.1,823,451,372,121.2
29004, 읍부,020005, 19세,2017,1794,997,797,125.1,1739,967,772,125.3
29004, 읍부,025,20~24세,2017,6990,3789,3201,118.4,6809,3703,3106,119.2
29004, 읍부,025001, 20세,2017,1490,709,781,90.8,1442,684,758,90.2
29004, 읍부,025002, 21세,2017,1358,571,787,72.6,1320,554,766,72.3
29004, 읍부,025003, 22세,2017,1366,716,650,110.2,1337,704,633,111.2
29004, 읍부,025004, 23세,2017,1402,851,551,154.4,1380,844,536,157.5
29004, 읍부,025005, 24세,2017,1374,942,432,218.1,1330,917,413,222
29004, 읍부,030,25~29세,2017,4056,2503,1553,161.2,3832,2389,1443,165.6
29004, 읍부,030001, 25세,2017,1132,756,376,201.1,1097,740,357,207.3
29004, 읍부,030002, 26세,2017,902,571,331,172.5,850,545,305,178.7
29004, 읍부,030003, 27세,2017,757,449,308,145.8,707,422,285,148.1
29004, 읍부,030004, 28세,2017,638,355,283,125.4,594,338,256,132
29004, 읍부,030005, 29세,2017,627,372,255,145.9,584,344,240,143.3
29004, 읍부,035,30~34세,2017,3143,1670,1473,113.4,2955,1574,1381,114
29004, 읍부,035001, 30세,2017,599,321,278,115.5,558,299,259,115.4
29004, 읍부,035002, 31세,2017,613,328,285,115.1,573,309,264,117
29004, 읍부,035003, 32세,2017,624,332,292,113.7,579,308,271,113.7
29004, 읍부,035004, 33세,2017,624,345,279,123.7,594,331,263,125.9
29004, 읍부,035005, 34세,2017,683,344,339,101.5,651,327,324,100.9
29004, 읍부,040,35~39세,2017,3719,1940,1779,109.1,3615,1893,1722,109.9
29004, 읍부,040001, 35세,2017,773,409,364,112.4,745,397,348,114.1
29004, 읍부,040002, 36세,2017,751,406,345,117.7,733,397,336,118.2
29004, 읍부,040003, 37세,2017,783,399,384,103.9,766,392,374,104.8
29004, 읍부,040004, 38세,2017,721,367,354,103.7,698,355,343,103.5
29004, 읍부,040005, 39세,2017,691,359,332,108.1,673,352,321,109.7
29004, 읍부,045,40~44세,2017,3728,1984,1744,113.8,3596,1909,1687,113.2
29004, 읍부,045001, 40세,2017,722,376,346,108.7,689,356,333,106.9
29004, 읍부,045002, 41세,2017,704,362,342,105.8,671,345,326,105.8
29004, 읍부,045003, 42세,2017,688,363,325,111.7,664,353,311,113.5
29004, 읍부,045004, 43세,2017,806,454,352,129,785,439,346,126.9
29004, 읍부,045005, 44세,2017,808,429,379,113.2,787,416,371,112.1
29004, 읍부,050,45~49세,2017,3940,2153,1787,120.5,3788,2073,1715,120.9
29004, 읍부,050001, 45세,2017,805,441,364,121.2,779,428,351,121.9
29004, 읍부,050002, 46세,2017,837,447,390,114.6,803,427,376,113.6
29004, 읍부,050003, 47세,2017,722,412,310,132.9,700,402,298,134.9
29004, 읍부,050004, 48세,2017,817,448,369,121.4,780,426,354,120.3
29004, 읍부,050005, 49세,2017,759,405,354,114.4,726,390,336,116.1
29004, 읍부,055,50~54세,2017,3368,1742,1626,107.1,3199,1652,1547,106.8
29004, 읍부,055001, 50세,2017,696,348,348,100,664,334,330,101.2
29004, 읍부,055002, 51세,2017,656,341,315,108.3,629,328,301,109
29004, 읍부,055003, 52세,2017,707,355,352,100.9,672,333,339,98.2
29004, 읍부,055004, 53세,2017,641,356,285,124.9,607,334,273,122.3
29004, 읍부,055005, 54세,2017,668,342,326,104.9,627,323,304,106.3
29004, 읍부,060,55~59세,2017,3423,1764,1659,106.3,3308,1701,1607,105.8
29004, 읍부,060001, 55세,2017,698,358,340,105.3,670,344,326,105.5
29004, 읍부,060002, 56세,2017,780,416,364,114.3,765,409,356,114.9
29004, 읍부,060003, 57세,2017,745,389,356,109.3,718,370,348,106.3
29004, 읍부,060004, 58세,2017,606,295,311,94.9,588,286,302,94.7
29004, 읍부,060005, 59세,2017,594,306,288,106.3,567,292,275,106.2
29004, 읍부,065,60~64세,2017,2727,1359,1368,99.3,2636,1308,1328,98.5
29004, 읍부,065001, 60세,2017,624,313,311,100.6,600,297,303,98
29004, 읍부,065002, 61세,2017,561,299,262,114.1,544,289,255,113.3
29004, 읍부,065003, 62세,2017,623,310,313,99,599,300,299,100.3
29004, 읍부,065004, 63세,2017,479,221,258,85.7,468,215,253,85
29004, 읍부,065005, 64세,2017,440,216,224,96.4,425,207,218,95
29004, 읍부,070,65~69세,2017,1927,938,989,94.8,1895,918,977,94
29004, 읍부,070001, 65세,2017,455,246,209,117.7,446,238,208,114.4
29004, 읍부,070002, 66세,2017,330,146,184,79.3,323,142,181,78.5
29004, 읍부,070003, 67세,2017,400,191,209,91.4,392,187,205,91.2
29004, 읍부,070004, 68세,2017,389,177,212,83.5,384,174,210,82.9
29004, 읍부,070005, 69세,2017,353,178,175,101.7,350,177,173,102.3
29004, 읍부,075,70~74세,2017,1475,645,830,77.7,1467,640,827,77.4
29004, 읍부,075001, 70세,2017,331,157,174,90.2,328,155,173,89.6
29004, 읍부,075002, 71세,2017,275,115,160,71.9,273,113,160,70.6
29004, 읍부,075003, 72세,2017,290,132,158,83.5,290,132,158,83.5
29004, 읍부,075004, 73세,2017,282,111,171,64.9,281,110,171,64.3
29004, 읍부,075005, 74세,2017,297,130,167,77.8,295,130,165,78.8
29004, 읍부,080,75~79세,2017,1383,603,780,77.3,1382,603,779,77.4
29004, 읍부,080001, 75세,2017,337,153,184,83.2,337,153,184,83.2
29004, 읍부,080002, 76세,2017,313,134,179,74.9,313,134,179,74.9
29004, 읍부,080003, 77세,2017,249,113,136,83.1,249,113,136,83.1
29004, 읍부,080004, 78세,2017,258,103,155,66.5,258,103,155,66.5
29004, 읍부,080005, 79세,2017,226,100,126,79.4,225,100,125,80
29004, 읍부,085,80~84세,2017,804,300,504,59.5,800,299,501,59.7
29004, 읍부,085001, 80세,2017,179,80,99,80.8,177,79,98,80.6
29004, 읍부,085002, 81세,2017,198,77,121,63.6,198,77,121,63.6
29004, 읍부,085003, 82세,2017,181,63,118,53.4,179,63,116,54.3
29004, 읍부,085004, 83세,2017,134,50,84,59.5,134,50,84,59.5
29004, 읍부,085005, 84세,2017,112,30,82,36.6,112,30,82,36.6
29004, 읍부,090,85~89세,2017,419,113,306,36.9,419,113,306,36.9
29004, 읍부,090001, 85세,2017,106,27,79,34.2,106,27,79,34.2
29004, 읍부,090002, 86세,2017,97,31,66,47,97,31,66,47
29004, 읍부,090003, 87세,2017,85,25,60,41.7,85,25,60,41.7
29004, 읍부,090004, 88세,2017,80,21,59,35.6,80,21,59,35.6
29004, 읍부,090005, 89세,2017,51,9,42,21.4,51,9,42,21.4
29004, 읍부,095,90~94세,2017,148,39,109,35.8,148,39,109,35.8
29004, 읍부,095001, 90세,2017,57,16,41,39,57,16,41,39
29004, 읍부,095002, 91세,2017,28,8,20,40,28,8,20,40
29004, 읍부,095003, 92세,2017,28,X,24,16.7,28,X,24,16.7
29004, 읍부,095004, 93세,2017,25,8,17,47.1,25,8,17,47.1
29004, 읍부,095005, 94세,2017,10,X,7,42.9,10,X,7,42.9
29004, 읍부,100,95~99세,2017,29,9,20,45,29,9,20,45
29004, 읍부,100001, 95세,2017,14,6,8,75,14,6,8,75
29004, 읍부,100002, 96세,2017,6,X,X,50,6,X,X,50
29004, 읍부,100003, 97세,2017,X,X,X,0,X,X,X,0
29004, 읍부,100004, 98세,2017,X,X,X,0,X,X,X,0
29004, 읍부,100005, 99세,2017,X,X,X,33.3,X,X,X,33.3
29004, 읍부,101,100세이상,2017,X,X,X,0,X,X,X,0
29004, 읍부,102,15세미만,2017,6666,3419,3247,105.3,6614,3391,3223,105.2
29004, 읍부,103,15~64세,2017,39152,21110,18042,117,37689,20347,17342,117.3
29004, 읍부,104,65세이상,2017,6189,2647,3542,74.7,6144,2621,3523,74.4
29004, 읍부,086,85세이상,2017,600,161,439,36.7,600,161,439,36.7
29004, 읍부,126,평균연령,2017,38.2,37,39.4,,38.2,37,39.5,
29004, 읍부,127,중위연령,2017,36.4,35,38,,36.4,34.9,38.1,
29005, 면부,000,합계,2017,52757,28445,24312,117,50064,26587,23477,113.2
29005, 면부,005,0~4세,2017,1207,646,561,115.2,1191,637,554,115
29005, 면부,005001, 0세,2017,243,126,117,107.7,241,124,117,106
29005, 면부,005002, 1세,2017,254,140,114,122.8,250,137,113,121.2
29005, 면부,005003, 2세,2017,248,136,112,121.4,244,136,108,125.9
29005, 면부,005004, 3세,2017,213,106,107,99.1,210,103,107,96.3
29005, 면부,005005, 4세,2017,249,138,111,124.3,246,137,109,125.7
29005, 면부,010,5~9세,2017,1241,617,624,98.9,1229,608,621,97.9
29005, 면부,010001, 5세,2017,254,133,121,109.9,253,132,121,109.1
29005, 면부,010002, 6세,2017,224,105,119,88.2,221,102,119,85.7
29005, 면부,010003, 7세,2017,244,125,119,105,240,123,117,105.1
29005, 면부,010004, 8세,2017,233,108,125,86.4,232,107,125,85.6
29005, 면부,010005, 9세,2017,286,146,140,104.3,283,144,139,103.6
29005, 면부,015,10~14세,2017,1242,640,602,106.3,1233,639,594,107.6
29005, 면부,015001, 10세,2017,239,127,112,113.4,234,127,107,118.7
29005, 면부,015002, 11세,2017,245,120,125,96,242,120,122,98.4
29005, 면부,015003, 12세,2017,227,116,111,104.5,227,116,111,104.5
29005, 면부,015004, 13세,2017,267,131,136,96.3,266,130,136,95.6
29005, 면부,015005, 14세,2017,264,146,118,123.7,264,146,118,123.7
29005, 면부,020,15~19세,2017,2645,1355,1290,105,2580,1329,1251,106.2
29005, 면부,020001, 15세,2017,275,154,121,127.3,274,154,120,128.3
29005, 면부,020002, 16세,2017,364,208,156,133.3,363,208,155,134.2
29005, 면부,020003, 17세,2017,346,195,151,129.1,340,191,149,128.2
29005, 면부,020004, 18세,2017,561,269,292,92.1,550,264,286,92.3
29005, 면부,020005, 19세,2017,1099,529,570,92.8,1053,512,541,94.6
29005, 면부,025,20~24세,2017,5155,2876,2279,126.2,4793,2630,2163,121.6
29005, 면부,025001, 20세,2017,1067,473,594,79.6,1013,443,570,77.7
29005, 면부,025002, 21세,2017,908,419,489,85.7,839,381,458,83.2
29005, 면부,025003, 22세,2017,1017,578,439,131.7,946,529,417,126.9
29005, 면부,025004, 23세,2017,1100,691,409,168.9,1031,642,389,165
29005, 면부,025005, 24세,2017,1063,715,348,205.5,964,635,329,193
29005, 면부,030,25~29세,2017,4015,2670,1345,198.5,3461,2256,1205,187.2
29005, 면부,030001, 25세,2017,908,599,309,193.9,807,529,278,190.3
29005, 면부,030002, 26세,2017,931,633,298,212.4,796,537,259,207.3
29005, 면부,030003, 27세,2017,793,535,258,207.4,680,447,233,191.8
29005, 면부,030004, 28세,2017,730,472,258,182.9,625,389,236,164.8
29005, 면부,030005, 29세,2017,653,431,222,194.1,553,354,199,177.9
29005, 면부,035,30~34세,2017,3003,1875,1128,166.2,2535,1524,1011,150.7
29005, 면부,035001, 30세,2017,644,413,231,178.8,540,332,208,159.6
29005, 면부,035002, 31세,2017,600,386,214,180.4,512,317,195,162.6
29005, 면부,035003, 32세,2017,622,397,225,176.4,512,318,194,163.9
29005, 면부,035004, 33세,2017,554,339,215,157.7,468,273,195,140
29005, 면부,035005, 34세,2017,583,340,243,139.9,503,284,219,129.7
29005, 면부,040,35~39세,2017,2947,1851,1096,168.9,2594,1595,999,159.7
29005, 면부,040001, 35세,2017,627,386,241,160.2,554,334,220,151.8
29005, 면부,040002, 36세,2017,603,377,226,166.8,528,319,209,152.6
29005, 면부,040003, 37세,2017,618,383,235,163,536,325,211,154
29005, 면부,040004, 38세,2017,570,358,212,168.9,503,308,195,157.9
29005, 면부,040005, 39세,2017,529,347,182,190.7,473,309,164,188.4
29005, 면부,045,40~44세,2017,3049,1896,1153,164.4,2806,1718,1088,157.9
29005, 면부,045001, 40세,2017,563,351,212,165.6,518,318,200,159
29005, 면부,045002, 41세,2017,563,355,208,170.7,516,320,196,163.3
29005, 면부,045003, 42세,2017,605,381,224,170.1,545,340,205,165.9
29005, 면부,045004, 43세,2017,693,439,254,172.8,637,394,243,162.1
29005, 면부,045005, 44세,2017,625,370,255,145.1,590,346,244,141.8
29005, 면부,050,45~49세,2017,3640,2155,1485,145.1,3430,2028,1402,144.7
29005, 면부,050001, 45세,2017,628,388,240,161.7,577,359,218,164.7
29005, 면부,050002, 46세,2017,757,461,296,155.7,715,437,278,157.2
29005, 면부,050003, 47세,2017,726,436,290,150.3,675,402,273,147.3
29005, 면부,050004, 48세,2017,757,460,297,154.9,720,436,284,153.5
29005, 면부,050005, 49세,2017,772,410,362,113.3,743,394,349,112.9
29005, 면부,055,50~54세,2017,3998,2222,1776,125.1,3815,2099,1716,122.3
29005, 면부,055001, 50세,2017,734,395,339,116.5,702,375,327,114.7
29005, 면부,055002, 51세,2017,726,411,315,130.5,689,386,303,127.4
29005, 면부,055003, 52세,2017,895,531,364,145.9,856,503,353,142.5
29005, 면부,055004, 53세,2017,791,429,362,118.5,756,404,352,114.8
29005, 면부,055005, 54세,2017,852,456,396,115.2,812,431,381,113.1
29005, 면부,060,55~59세,2017,4796,2559,2237,114.4,4701,2509,2192,114.5
29005, 면부,060001, 55세,2017,940,503,437,115.1,917,493,424,116.3
29005, 면부,060002, 56세,2017,1059,536,523,102.5,1038,527,511,103.1
29005, 면부,060003, 57세,2017,997,553,444,124.5,973,537,436,123.2
29005, 면부,060004, 58세,2017,943,497,446,111.4,925,489,436,112.2
29005, 면부,060005, 59세,2017,857,470,387,121.4,848,463,385,120.3
29005, 면부,065,60~64세,2017,4150,2150,2000,107.5,4077,2105,1972,106.7
29005, 면부,065001, 60세,2017,873,441,432,102.1,855,430,425,101.2
29005, 면부,065002, 61세,2017,905,478,427,111.9,890,467,423,110.4
29005, 면부,065003, 62세,2017,928,485,443,109.5,913,478,435,109.9
29005, 면부,065004, 63세,2017,819,427,392,108.9,801,417,384,108.6
29005, 면부,065005, 64세,2017,625,319,306,104.2,618,313,305,102.6
29005, 면부,070,65~69세,2017,3192,1611,1581,101.9,3164,1598,1566,102
29005, 면부,070001, 65세,2017,739,362,377,96,734,358,376,95.2
29005, 면부,070002, 66세,2017,564,298,266,112,556,296,260,113.8
29005, 면부,070003, 67세,2017,666,361,305,118.4,658,357,301,118.6
29005, 면부,070004, 68세,2017,646,317,329,96.4,643,315,328,96
29005, 면부,070005, 69세,2017,577,273,304,89.8,573,272,301,90.4
29005, 면부,075,70~74세,2017,2421,1110,1311,84.7,2411,1103,1308,84.3
29005, 면부,075001, 70세,2017,543,261,282,92.6,537,257,280,91.8
29005, 면부,075002, 71세,2017,450,212,238,89.1,448,210,238,88.2
29005, 면부,075003, 72세,2017,439,208,231,90,438,207,231,89.6
29005, 면부,075004, 73세,2017,508,217,291,74.6,508,217,291,74.6
29005, 면부,075005, 74세,2017,481,212,269,78.8,480,212,268,79.1
29005, 면부,080,75~79세,2017,2766,1128,1638,68.9,2760,1126,1634,68.9
29005, 면부,080001, 75세,2017,701,308,393,78.4,701,308,393,78.4
29005, 면부,080002, 76세,2017,533,206,327,63,532,206,326,63.2
29005, 면부,080003, 77세,2017,527,204,323,63.2,527,204,323,63.2
29005, 면부,080004, 78세,2017,514,216,298,72.5,511,214,297,72.1
29005, 면부,080005, 79세,2017,491,194,297,65.3,489,194,295,65.8
29005, 면부,085,80~84세,2017,2012,749,1263,59.3,2006,748,1258,59.5
29005, 면부,085001, 80세,2017,464,175,289,60.6,462,175,287,61
29005, 면부,085002, 81세,2017,431,160,271,59,430,160,270,59.3
29005, 면부,085003, 82세,2017,401,163,238,68.5,401,163,238,68.5
29005, 면부,085004, 83세,2017,377,145,232,62.5,375,145,230,63
29005, 면부,085005, 84세,2017,339,106,233,45.5,338,105,233,45.1
29005, 면부,090,85~89세,2017,924,266,658,40.4,924,266,658,40.4
29005, 면부,090001, 85세,2017,259,75,184,40.8,259,75,184,40.8
29005, 면부,090002, 86세,2017,204,63,141,44.7,204,63,141,44.7
29005, 면부,090003, 87세,2017,178,53,125,42.4,178,53,125,42.4
29005, 면부,090004, 88세,2017,156,40,116,34.5,156,40,116,34.5
29005, 면부,090005, 89세,2017,127,35,92,38,127,35,92,38
29005, 면부,095,90~94세,2017,280,59,221,26.7,280,59,221,26.7
29005, 면부,095001, 90세,2017,106,26,80,32.5,106,26,80,32.5
29005, 면부,095002, 91세,2017,61,16,45,35.6,61,16,45,35.6
29005, 면부,095003, 92세,2017,51,9,42,21.4,51,9,42,21.4
29005, 면부,095004, 93세,2017,30,X,26,15.4,30,X,26,15.4
29005, 면부,095005, 94세,2017,32,X,28,14.3,32,X,28,14.3
29005, 면부,100,95~99세,2017,62,10,52,19.2,62,10,52,19.2
29005, 면부,100001, 95세,2017,31,X,27,14.8,31,X,27,14.8
29005, 면부,100002, 96세,2017,17,X,14,21.4,17,X,14,21.4
29005, 면부,100003, 97세,2017,X,X,X,50,X,X,X,50
29005, 면부,100004, 98세,2017,7,X,5,40,7,X,5,40
29005, 면부,100005, 99세,2017,X,X,X,0,X,X,X,0
29005, 면부,101,100세이상,2017,12,X,12,0,12,X,12,0
29005, 면부,102,15세미만,2017,3690,1903,1787,106.5,3653,1884,1769,106.5
29005, 면부,103,15~64세,2017,37398,21609,15789,136.9,34792,19793,14999,132
29005, 면부,104,65세이상,2017,11669,4933,6736,73.2,11619,4910,6709,73.2
29005, 면부,086,85세이상,2017,1278,335,943,35.5,1278,335,943,35.5
29005, 면부,126,평균연령,2017,46.3,44.1,48.8,,46.8,44.7,49.2,
29005, 면부,127,중위연령,2017,47.7,44.4,51.8,,48.9,46,52.6,
29003, 동부,000,합계,2017,171825,83726,88099,95,170788,83271,87517,95.1
29003, 동부,005,0~4세,2017,15581,7973,7608,104.8,15563,7963,7600,104.8
29003, 동부,005001, 0세,2017,2904,1476,1428,103.4,2901,1474,1427,103.3
29003, 동부,005002, 1세,2017,3136,1623,1513,107.3,3130,1621,1509,107.4
29003, 동부,005003, 2세,2017,3207,1632,1575,103.6,3202,1630,1572,103.7
29003, 동부,005004, 3세,2017,3087,1604,1483,108.2,3084,1601,1483,108
29003, 동부,005005, 4세,2017,3247,1638,1609,101.8,3246,1637,1609,101.7
29003, 동부,010,5~9세,2017,16355,8354,8001,104.4,16342,8345,7997,104.4
29003, 동부,010001, 5세,2017,3356,1719,1637,105,3353,1716,1637,104.8
29003, 동부,010002, 6세,2017,3428,1752,1676,104.5,3425,1750,1675,104.5
29003, 동부,010003, 7세,2017,3240,1678,1562,107.4,3236,1676,1560,107.4
29003, 동부,010004, 8세,2017,3195,1648,1547,106.5,3193,1646,1547,106.4
29003, 동부,010005, 9세,2017,3136,1557,1579,98.6,3135,1557,1578,98.7
29003, 동부,015,10~14세,2017,13439,6671,6768,98.6,13430,6667,6763,98.6
29003, 동부,015001, 10세,2017,3018,1454,1564,93,3016,1453,1563,93
29003, 동부,015002, 11세,2017,2838,1453,1385,104.9,2835,1453,1382,105.1
29003, 동부,015003, 12세,2017,2492,1246,1246,100,2492,1246,1246,100
29003, 동부,015004, 13세,2017,2673,1331,1342,99.2,2670,1329,1341,99.1
29003, 동부,015005, 14세,2017,2418,1187,1231,96.4,2417,1186,1231,96.3
29003, 동부,020,15~19세,2017,9118,4469,4649,96.1,9100,4459,4641,96.1
29003, 동부,020001, 15세,2017,2159,1077,1082,99.5,2155,1075,1080,99.5
29003, 동부,020002, 16세,2017,2222,1049,1173,89.4,2218,1047,1171,89.4
29003, 동부,020003, 17세,2017,2217,1069,1148,93.1,2214,1066,1148,92.9
29003, 동부,020004, 18세,2017,1535,748,787,95,1533,748,785,95.3
29003, 동부,020005, 19세,2017,985,526,459,114.6,980,523,457,114.4
29003, 동부,025,20~24세,2017,6006,3203,2803,114.3,5934,3185,2749,115.9
29003, 동부,025001, 20세,2017,1095,688,407,169,1090,688,402,171.1
29003, 동부,025002, 21세,2017,1180,700,480,145.8,1173,699,474,147.5
29003, 동부,025003, 22세,2017,1194,664,530,125.3,1182,663,519,127.7
29003, 동부,025004, 23세,2017,1258,583,675,86.4,1237,577,660,87.4
29003, 동부,025005, 24세,2017,1279,568,711,79.9,1252,558,694,80.4
29003, 동부,030,25~29세,2017,8604,3611,4993,72.3,8431,3532,4899,72.1
29003, 동부,030001, 25세,2017,1502,610,892,68.4,1460,592,868,68.2
29003, 동부,030002, 26세,2017,1508,605,903,67,1485,594,891,66.7
29003, 동부,030003, 27세,2017,1650,679,971,69.9,1622,668,954,70
29003, 동부,030004, 28세,2017,1829,796,1033,77.1,1794,778,1016,76.6
29003, 동부,030005, 29세,2017,2115,921,1194,77.1,2070,900,1170,76.9
29003, 동부,035,30~34세,2017,15417,6918,8499,81.4,15184,6815,8369,81.4
29003, 동부,035001, 30세,2017,2415,1001,1414,70.8,2369,982,1387,70.8
29003, 동부,035002, 31세,2017,2630,1190,1440,82.6,2575,1160,1415,82
29003, 동부,035003, 32세,2017,3002,1385,1617,85.7,2947,1362,1585,85.9
29003, 동부,035004, 33세,2017,3419,1556,1863,83.5,3378,1540,1838,83.8
29003, 동부,035005, 34세,2017,3951,1786,2165,82.5,3915,1771,2144,82.6
29003, 동부,040,35~39세,2017,22660,10567,12093,87.4,22507,10500,12007,87.4
29003, 동부,040001, 35세,2017,4643,2130,2513,84.8,4603,2112,2491,84.8
29003, 동부,040002, 36세,2017,4577,2102,2475,84.9,4548,2093,2455,85.3
29003, 동부,040003, 37세,2017,4676,2211,2465,89.7,4652,2202,2450,89.9
29003, 동부,040004, 38세,2017,4630,2180,2450,89,4597,2162,2435,88.8
29003, 동부,040005, 39세,2017,4134,1944,2190,88.8,4107,1931,2176,88.7
29003, 동부,045,40~44세,2017,20115,9961,10154,98.1,20024,9917,10107,98.1
29003, 동부,045001, 40세,2017,4254,2045,2209,92.6,4233,2036,2197,92.7
29003, 동부,045002, 41세,2017,3935,1923,2012,95.6,3914,1912,2002,95.5
29003, 동부,045003, 42세,2017,4043,1988,2055,96.7,4026,1981,2045,96.9
29003, 동부,045004, 43세,2017,4119,2056,2063,99.7,4099,2045,2054,99.6
29003, 동부,045005, 44세,2017,3764,1949,1815,107.4,3752,1943,1809,107.4
29003, 동부,050,45~49세,2017,15140,8000,7140,112,15074,7970,7104,112.2
29003, 동부,050001, 45세,2017,3481,1893,1588,119.2,3466,1888,1578,119.6
29003, 동부,050002, 46세,2017,3506,1820,1686,107.9,3494,1815,1679,108.1
29003, 동부,050003, 47세,2017,2876,1567,1309,119.7,2857,1557,1300,119.8
29003, 동부,050004, 48세,2017,2748,1427,1321,108,2735,1419,1316,107.8
29003, 동부,050005, 49세,2017,2529,1293,1236,104.6,2522,1291,1231,104.9
29003, 동부,055,50~54세,2017,8976,4556,4420,103.1,8915,4535,4380,103.5
29003, 동부,055001, 50세,2017,2066,1054,1012,104.2,2054,1047,1007,104
29003, 동부,055002, 51세,2017,1826,930,896,103.8,1821,928,893,103.9
29003, 동부,055003, 52세,2017,1794,899,895,100.4,1784,896,888,100.9
29003, 동부,055004, 53세,2017,1623,822,801,102.6,1606,818,788,103.8
29003, 동부,055005, 54세,2017,1667,851,816,104.3,1650,846,804,105.2
29003, 동부,060,55~59세,2017,7717,3775,3942,95.8,7666,3751,3915,95.8
29003, 동부,060001, 55세,2017,1608,842,766,109.9,1602,840,762,110.2
29003, 동부,060002, 56세,2017,1764,845,919,91.9,1759,843,916,92
29003, 동부,060003, 57세,2017,1625,776,849,91.4,1607,765,842,90.9
29003, 동부,060004, 58세,2017,1387,675,712,94.8,1379,673,706,95.3
29003, 동부,060005, 59세,2017,1333,637,696,91.5,1319,630,689,91.4
29003, 동부,065,60~64세,2017,5157,2485,2672,93,5105,2462,2643,93.2
29003, 동부,065001, 60세,2017,1253,634,619,102.4,1240,627,613,102.3
29003, 동부,065002, 61세,2017,1122,540,582,92.8,1112,537,575,93.4
29003, 동부,065003, 62세,2017,1124,537,587,91.5,1108,532,576,92.4
29003, 동부,065004, 63세,2017,905,423,482,87.8,902,422,480,87.9
29003, 동부,065005, 64세,2017,753,351,402,87.3,743,344,399,86.2
29003, 동부,070,65~69세,2017,3076,1418,1658,85.5,3063,1410,1653,85.3
29003, 동부,070001, 65세,2017,773,350,423,82.7,767,347,420,82.6
29003, 동부,070002, 66세,2017,559,231,328,70.4,556,230,326,70.6
29003, 동부,070003, 67세,2017,645,309,336,92,643,307,336,91.4
29003, 동부,070004, 68세,2017,585,271,314,86.3,583,269,314,85.7
29003, 동부,070005, 69세,2017,514,257,257,100,514,257,257,100
29003, 동부,075,70~74세,2017,1879,899,980,91.7,1872,897,975,92
29003, 동부,075001, 70세,2017,525,240,285,84.2,524,239,285,83.9
29003, 동부,075002, 71세,2017,361,188,173,108.7,360,187,173,108.1
29003, 동부,075003, 72세,2017,349,170,179,95,349,170,179,95
29003, 동부,075004, 73세,2017,334,160,174,92,333,160,173,92.5
29003, 동부,075005, 74세,2017,310,141,169,83.4,306,141,165,85.5
29003, 동부,080,75~79세,2017,1272,506,766,66.1,1269,506,763,66.3
29003, 동부,080001, 75세,2017,360,152,208,73.1,360,152,208,73.1
29003, 동부,080002, 76세,2017,261,115,146,78.8,260,115,145,79.3
29003, 동부,080003, 77세,2017,231,90,141,63.8,230,90,140,64.3
29003, 동부,080004, 78세,2017,205,75,130,57.7,205,75,130,57.7
29003, 동부,080005, 79세,2017,215,74,141,52.5,214,74,140,52.9
29003, 동부,085,80~84세,2017,760,230,530,43.4,757,228,529,43.1
29003, 동부,085001, 80세,2017,170,54,116,46.6,170,54,116,46.6
29003, 동부,085002, 81세,2017,172,59,113,52.2,170,57,113,50.4
29003, 동부,085003, 82세,2017,151,39,112,34.8,151,39,112,34.8
29003, 동부,085004, 83세,2017,155,50,105,47.6,154,50,104,48.1
29003, 동부,085005, 84세,2017,112,28,84,33.3,112,28,84,33.3
29003, 동부,090,85~89세,2017,411,100,311,32.2,410,99,311,31.8
29003, 동부,090001, 85세,2017,111,31,80,38.8,111,31,80,38.8
29003, 동부,090002, 86세,2017,88,21,67,31.3,87,20,67,29.9
29003, 동부,090003, 87세,2017,85,20,65,30.8,85,20,65,30.8
29003, 동부,090004, 88세,2017,63,15,48,31.3,63,15,48,31.3
29003, 동부,090005, 89세,2017,64,13,51,25.5,64,13,51,25.5
29003, 동부,095,90~94세,2017,120,25,95,26.3,120,25,95,26.3
29003, 동부,095001, 90세,2017,40,6,34,17.6,40,6,34,17.6
29003, 동부,095002, 91세,2017,26,7,19,36.8,26,7,19,36.8
29003, 동부,095003, 92세,2017,21,6,15,40,21,6,15,40
29003, 동부,095004, 93세,2017,17,X,14,21.4,17,X,14,21.4
29003, 동부,095005, 94세,2017,16,X,13,23.1,16,X,13,23.1
29003, 동부,100,95~99세,2017,20,5,15,33.3,20,5,15,33.3
29003, 동부,100001, 95세,2017,7,X,5,40,7,X,5,40
29003, 동부,100002, 96세,2017,6,X,5,20,6,X,5,20
29003, 동부,100003, 97세,2017,X,X,X,33.3,X,X,X,33.3
29003, 동부,100004, 98세,2017,X,X,X,100,X,X,X,100
29003, 동부,100005, 99세,2017,X,X,X,0,X,X,X,0
29003, 동부,101,100세이상,2017,X,X,X,0,X,X,X,0
29003, 동부,102,15세미만,2017,45375,22998,22377,102.8,45335,22975,22360,102.8
29003, 동부,103,15~64세,2017,118910,57545,61365,93.8,117940,57126,60814,93.9
29003, 동부,104,65세이상,2017,7540,3183,4357,73.1,7513,3170,4343,73
29003, 동부,086,85세이상,2017,553,130,423,30.7,552,129,423,30.5
29003, 동부,126,평균연령,2017,32.4,32,32.8,,32.4,32,32.8,
29003, 동부,127,중위연령,2017,35.3,35.3,35.3,,35.3,35.3,35.3,
29010, 세종시,000,합계,2017,276589,139347,137242,101.5,271299,136217,135082,100.8
29010, 세종시,005,0~4세,2017,18887,9720,9167,106,18818,9678,9140,105.9
29010, 세종시,005001, 0세,2017,3534,1794,1740,103.1,3524,1786,1738,102.8
29010, 세종시,005002, 1세,2017,3778,1972,1806,109.2,3765,1965,1800,109.2
29010, 세종시,005003, 2세,2017,3889,2014,1875,107.4,3873,2006,1867,107.4
29010, 세종시,005004, 3세,2017,3754,1946,1808,107.6,3737,1933,1804,107.2
29010, 세종시,005005, 4세,2017,3932,1994,1938,102.9,3919,1988,1931,103
29010, 세종시,010,5~9세,2017,20036,10208,9828,103.9,19998,10185,9813,103.8
29010, 세종시,010001, 5세,2017,4083,2090,1993,104.9,4073,2084,1989,104.8
29010, 세종시,010002, 6세,2017,4137,2115,2022,104.6,4131,2110,2021,104.4
29010, 세종시,010003, 7세,2017,3981,2051,1930,106.3,3970,2044,1926,106.1
29010, 세종시,010004, 8세,2017,3882,1988,1894,105,3877,1985,1892,104.9
29010, 세종시,010005, 9세,2017,3953,1964,1989,98.7,3947,1962,1985,98.8
29010, 세종시,015,10~14세,2017,16808,8392,8416,99.7,16786,8387,8399,99.9
29010, 세종시,015001, 10세,2017,3715,1810,1905,95,3706,1809,1897,95.4
29010, 세종시,015002, 11세,2017,3504,1788,1716,104.2,3497,1788,1709,104.6
29010, 세종시,015003, 12세,2017,3127,1565,1562,100.2,3127,1565,1562,100.2
29010, 세종시,015004, 13세,2017,3365,1680,1685,99.7,3361,1677,1684,99.6
29010, 세종시,015005, 14세,2017,3097,1549,1548,100.1,3095,1548,1547,100.1
29010, 세종시,020,15~19세,2017,15821,8030,7791,103.1,15631,7933,7698,103.1
29010, 세종시,020001, 15세,2017,2877,1451,1426,101.8,2872,1449,1423,101.8
29010, 세종시,020002, 16세,2017,3030,1493,1537,97.1,3025,1491,1534,97.2
29010, 세종시,020003, 17세,2017,3074,1541,1533,100.5,3056,1528,1528,100
29010, 세종시,020004, 18세,2017,2962,1493,1469,101.6,2906,1463,1443,101.4
29010, 세종시,020005, 19세,2017,3878,2052,1826,112.4,3772,2002,1770,113.1
29010, 세종시,025,20~24세,2017,18151,9868,8283,119.1,17536,9518,8018,118.7
29010, 세종시,025001, 20세,2017,3652,1870,1782,104.9,3545,1815,1730,104.9
29010, 세종시,025002, 21세,2017,3446,1690,1756,96.2,3332,1634,1698,96.2
29010, 세종시,025003, 22세,2017,3577,1958,1619,120.9,3465,1896,1569,120.8
29010, 세종시,025004, 23세,2017,3760,2125,1635,130,3648,2063,1585,130.2
29010, 세종시,025005, 24세,2017,3716,2225,1491,149.2,3546,2110,1436,146.9
29010, 세종시,030,25~29세,2017,16675,8784,7891,111.3,15724,8177,7547,108.3
29010, 세종시,030001, 25세,2017,3542,1965,1577,124.6,3364,1861,1503,123.8
29010, 세종시,030002, 26세,2017,3341,1809,1532,118.1,3131,1676,1455,115.2
29010, 세종시,030003, 27세,2017,3200,1663,1537,108.2,3009,1537,1472,104.4
29010, 세종시,030004, 28세,2017,3197,1623,1574,103.1,3013,1505,1508,99.8
29010, 세종시,030005, 29세,2017,3395,1724,1671,103.2,3207,1598,1609,99.3
29010, 세종시,035,30~34세,2017,21563,10463,11100,94.3,20674,9913,10761,92.1
29010, 세종시,035001, 30세,2017,3658,1735,1923,90.2,3467,1613,1854,87
29010, 세종시,035002, 31세,2017,3843,1904,1939,98.2,3660,1786,1874,95.3
29010, 세종시,035003, 32세,2017,4248,2114,2134,99.1,4038,1988,2050,97
29010, 세종시,035004, 33세,2017,4597,2240,2357,95,4440,2144,2296,93.4
29010, 세종시,035005, 34세,2017,5217,2470,2747,89.9,5069,2382,2687,88.6
29010, 세종시,040,35~39세,2017,29326,14358,14968,95.9,28716,13988,14728,95
29010, 세종시,040001, 35세,2017,6043,2925,3118,93.8,5902,2843,3059,92.9
29010, 세종시,040002, 36세,2017,5931,2885,3046,94.7,5809,2809,3000,93.6
29010, 세종시,040003, 37세,2017,6077,2993,3084,97,5954,2919,3035,96.2
29010, 세종시,040004, 38세,2017,5921,2905,3016,96.3,5798,2825,2973,95
29010, 세종시,040005, 39세,2017,5354,2650,2704,98,5253,2592,2661,97.4
29010, 세종시,045,40~44세,2017,26892,13841,13051,106.1,26426,13544,12882,105.1
29010, 세종시,045001, 40세,2017,5539,2772,2767,100.2,5440,2710,2730,99.3
29010, 세종시,045002, 41세,2017,5202,2640,2562,103,5101,2577,2524,102.1
29010, 세종시,045003, 42세,2017,5336,2732,2604,104.9,5235,2674,2561,104.4
29010, 세종시,045004, 43세,2017,5618,2949,2669,110.5,5521,2878,2643,108.9
29010, 세종시,045005, 44세,2017,5197,2748,2449,112.2,5129,2705,2424,111.6
29010, 세종시,050,45~49세,2017,22720,12308,10412,118.2,22292,12071,10221,118.1
29010, 세종시,050001, 45세,2017,4914,2722,2192,124.2,4822,2675,2147,124.6
29010, 세종시,050002, 46세,2017,5100,2728,2372,115,5012,2679,2333,114.8
29010, 세종시,050003, 47세,2017,4324,2415,1909,126.5,4232,2361,1871,126.2
29010, 세종시,050004, 48세,2017,4322,2335,1987,117.5,4235,2281,1954,116.7
29010, 세종시,050005, 49세,2017,4060,2108,1952,108,3991,2075,1916,108.3
29010, 세종시,055,50~54세,2017,16342,8520,7822,108.9,15929,8286,7643,108.4
29010, 세종시,055001, 50세,2017,3496,1797,1699,105.8,3420,1756,1664,105.5
29010, 세종시,055002, 51세,2017,3208,1682,1526,110.2,3139,1642,1497,109.7
29010, 세종시,055003, 52세,2017,3396,1785,1611,110.8,3312,1732,1580,109.6
29010, 세종시,055004, 53세,2017,3055,1607,1448,111,2969,1556,1413,110.1
29010, 세종시,055005, 54세,2017,3187,1649,1538,107.2,3089,1600,1489,107.5
29010, 세종시,060,55~59세,2017,15936,8098,7838,103.3,15675,7961,7714,103.2
29010, 세종시,060001, 55세,2017,3246,1703,1543,110.4,3189,1677,1512,110.9
29010, 세종시,060002, 56세,2017,3603,1797,1806,99.5,3562,1779,1783,99.8
29010, 세종시,060003, 57세,2017,3367,1718,1649,104.2,3298,1672,1626,102.8
29010, 세종시,060004, 58세,2017,2936,1467,1469,99.9,2892,1448,1444,100.3
29010, 세종시,060005, 59세,2017,2784,1413,1371,103.1,2734,1385,1349,102.7
29010, 세종시,065,60~64세,2017,12034,5994,6040,99.2,11818,5875,5943,98.9
29010, 세종시,065001, 60세,2017,2750,1388,1362,101.9,2695,1354,1341,101
29010, 세종시,065002, 61세,2017,2588,1317,1271,103.6,2546,1293,1253,103.2
29010, 세종시,065003, 62세,2017,2675,1332,1343,99.2,2620,1310,1310,100
29010, 세종시,065004, 63세,2017,2203,1071,1132,94.6,2171,1054,1117,94.4
29010, 세종시,065005, 64세,2017,1818,886,932,95.1,1786,864,922,93.7
29010, 세종시,070,65~69세,2017,8195,3967,4228,93.8,8122,3926,4196,93.6
29010, 세종시,070001, 65세,2017,1967,958,1009,94.9,1947,943,1004,93.9
29010, 세종시,070002, 66세,2017,1453,675,778,86.8,1435,668,767,87.1
29010, 세종시,070003, 67세,2017,1711,861,850,101.3,1693,851,842,101.1
29010, 세종시,070004, 68세,2017,1620,765,855,89.5,1610,758,852,89
29010, 세종시,070005, 69세,2017,1444,708,736,96.2,1437,706,731,96.6
29010, 세종시,075,70~74세,2017,5775,2654,3121,85,5750,2640,3110,84.9
29010, 세종시,075001, 70세,2017,1399,658,741,88.8,1389,651,738,88.2
29010, 세종시,075002, 71세,2017,1086,515,571,90.2,1081,510,571,89.3
29010, 세종시,075003, 72세,2017,1078,510,568,89.8,1077,509,568,89.6
29010, 세종시,075004, 73세,2017,1124,488,636,76.7,1122,487,635,76.7
29010, 세종시,075005, 74세,2017,1088,483,605,79.8,1081,483,598,80.8
29010, 세종시,080,75~79세,2017,5421,2237,3184,70.3,5411,2235,3176,70.4
29010, 세종시,080001, 75세,2017,1398,613,785,78.1,1398,613,785,78.1
29010, 세종시,080002, 76세,2017,1107,455,652,69.8,1105,455,650,70
29010, 세종시,080003, 77세,2017,1007,407,600,67.8,1006,407,599,67.9
29010, 세종시,080004, 78세,2017,977,394,583,67.6,974,392,582,67.4
29010, 세종시,080005, 79세,2017,932,368,564,65.2,928,368,560,65.7
29010, 세종시,085,80~84세,2017,3576,1279,2297,55.7,3563,1275,2288,55.7
29010, 세종시,085001, 80세,2017,813,309,504,61.3,809,308,501,61.5
29010, 세종시,085002, 81세,2017,801,296,505,58.6,798,294,504,58.3
29010, 세종시,085003, 82세,2017,733,265,468,56.6,731,265,466,56.9
29010, 세종시,085004, 83세,2017,666,245,421,58.2,663,245,418,58.6
29010, 세종시,085005, 84세,2017,563,164,399,41.1,562,163,399,40.9
29010, 세종시,090,85~89세,2017,1754,479,1275,37.6,1753,478,1275,37.5
29010, 세종시,090001, 85세,2017,476,133,343,38.8,476,133,343,38.8
29010, 세종시,090002, 86세,2017,389,115,274,42,388,114,274,41.6
29010, 세종시,090003, 87세,2017,348,98,250,39.2,348,98,250,39.2
29010, 세종시,090004, 88세,2017,299,76,223,34.1,299,76,223,34.1
29010, 세종시,090005, 89세,2017,242,57,185,30.8,242,57,185,30.8
29010, 세종시,095,90~94세,2017,548,123,425,28.9,548,123,425,28.9
29010, 세종시,095001, 90세,2017,203,48,155,31,203,48,155,31
29010, 세종시,095002, 91세,2017,115,31,84,36.9,115,31,84,36.9
29010, 세종시,095003, 92세,2017,100,19,81,23.5,100,19,81,23.5
29010, 세종시,095004, 93세,2017,72,15,57,26.3,72,15,57,26.3
29010, 세종시,095005, 94세,2017,58,10,48,20.8,58,10,48,20.8
29010, 세종시,100,95~99세,2017,111,24,87,27.6,111,24,87,27.6
29010, 세종시,100001, 95세,2017,52,12,40,30,52,12,40,30
29010, 세종시,100002, 96세,2017,29,6,23,26.1,29,6,23,26.1
29010, 세종시,100003, 97세,2017,11,X,9,22.2,11,X,9,22.2
29010, 세종시,100004, 98세,2017,10,X,7,42.9,10,X,7,42.9
29010, 세종시,100005, 99세,2017,9,X,8,12.5,9,X,8,12.5
29010, 세종시,101,100세이상,2017,18,X,18,0,18,X,18,0
29010, 세종시,102,15세미만,2017,55731,28320,27411,103.3,55602,28250,27352,103.3
29010, 세종시,103,15~64세,2017,195460,100264,95196,105.3,190421,97266,93155,104.4
29010, 세종시,104,65세이상,2017,25398,10763,14635,73.5,25276,10701,14575,73.4
29010, 세종시,086,85세이상,2017,2431,626,1805,34.7,2430,625,1805,34.6
29010, 세종시,126,평균연령,2017,36.1,35.5,36.8,,36.1,35.4,36.8,
29010, 세종시,127,중위연령,2017,36.7,36.4,37,,36.8,36.5,37,
31,경기도,000,합계,2017,12851601,6502723,6348878,102.4,12354512,6206756,6147756,101
31,경기도,005,0~4세,2017,578415,296246,282169,105,567564,290760,276804,105
31,경기도,005001, 0세,2017,98523,50731,47792,106.1,96145,49503,46642,106.1
31,경기도,005002, 1세,2017,114420,58511,55909,104.7,111824,57170,54654,104.6
31,경기도,005003, 2세,2017,121694,62361,59333,105.1,119615,61277,58338,105
31,경기도,005004, 3세,2017,121123,61923,59200,104.6,119085,60929,58156,104.8
31,경기도,005005, 4세,2017,122655,62720,59935,104.6,120895,61881,59014,104.9
31,경기도,010,5~9세,2017,642575,330241,312334,105.7,637092,327400,309692,105.7
31,경기도,010001, 5세,2017,133504,68530,64974,105.5,131938,67740,64198,105.5
31,경기도,010002, 6세,2017,131041,67236,63805,105.4,129912,66638,63274,105.3
31,경기도,010003, 7세,2017,126291,65043,61248,106.2,125278,64503,60775,106.1
31,경기도,010004, 8세,2017,122496,63042,59454,106,121560,62567,58993,106.1
31,경기도,010005, 9세,2017,129243,66390,62853,105.6,128404,65952,62452,105.6
31,경기도,015,10~14세,2017,620144,319076,301068,106,617392,317717,299675,106
31,경기도,015001, 10세,2017,130942,67221,63721,105.5,130189,66854,63335,105.6
31,경기도,015002, 11세,2017,119524,61549,57975,106.2,118934,61248,57686,106.2
31,경기도,015003, 12세,2017,116354,59628,56726,105.1,115869,59390,56479,105.2
31,경기도,015004, 13세,2017,126195,64966,61229,106.1,125697,64727,60970,106.2
31,경기도,015005, 14세,2017,127129,65712,61417,107,126703,65498,61205,107
31,경기도,020,15~19세,2017,741283,383053,358230,106.9,735505,380128,355377,107
31,경기도,020001, 15세,2017,129582,67118,62464,107.5,129091,66874,62217,107.5
31,경기도,020002, 16세,2017,146082,75300,70782,106.4,145552,75021,70531,106.4
31,경기도,020003, 17세,2017,159264,82061,77203,106.3,158543,81700,76843,106.3
31,경기도,020004, 18세,2017,152954,79133,73821,107.2,151613,78447,73166,107.2
31,경기도,020005, 19세,2017,153401,79441,73960,107.4,150706,78086,72620,107.5
31,경기도,025,20~24세,2017,849008,452960,396048,114.4,810977,428430,382547,112
31,경기도,025001, 20세,2017,159085,84042,75043,112,155278,81979,73299,111.8
31,경기도,025002, 21세,2017,165369,89781,75588,118.8,159810,86390,73420,117.7
31,경기도,025003, 22세,2017,169468,91450,78018,117.2,162010,86605,75405,114.9
31,경기도,025004, 23세,2017,175132,92624,82508,112.3,165811,86432,79379,108.9
31,경기도,025005, 24세,2017,179954,95063,84891,112,168068,87024,81044,107.4
31,경기도,030,25~29세,2017,876704,470526,406178,115.8,796839,417477,379362,110
31,경기도,030001, 25세,2017,187050,99844,87206,114.5,173284,90508,82776,109.3
31,경기도,030002, 26세,2017,179506,96210,83296,115.5,164779,86237,78542,109.8
31,경기도,030003, 27세,2017,172763,93100,79663,116.9,155879,81935,73944,110.8
31,경기도,030004, 28세,2017,169894,91744,78150,117.4,152894,80497,72397,111.2
31,경기도,030005, 29세,2017,167491,89628,77863,115.1,150003,78300,71703,109.2
31,경기도,035,30~34세,2017,906282,477664,428618,111.4,824632,424265,400367,106
31,경기도,035001, 30세,2017,168890,89958,78932,114,150831,78119,72712,107.4
31,경기도,035002, 31세,2017,172266,91301,80965,112.8,154900,80114,74786,107.1
31,경기도,035003, 32세,2017,176588,93111,83477,111.5,160361,82527,77834,106
31,경기도,035004, 33세,2017,184539,96840,87699,110.4,169037,86564,82473,105
31,경기도,035005, 34세,2017,203999,106454,97545,109.1,189503,96941,92562,104.7
31,경기도,040,35~39세,2017,1101844,568303,533541,106.5,1041924,529103,512821,103.2
31,경기도,040001, 35세,2017,223158,115938,107220,108.1,208763,106524,102239,104.2
31,경기도,040002, 36세,2017,225898,117335,108563,108.1,213644,109246,104398,104.6
31,경기도,040003, 37세,2017,230496,118288,112208,105.4,218887,110681,108206,102.3
31,경기도,040004, 38세,2017,220197,112942,107255,105.3,208676,105437,103239,102.1
31,경기도,040005, 39세,2017,202095,103800,98295,105.6,191954,97215,94739,102.6
31,경기도,045,40~44세,2017,1097795,560690,537105,104.4,1055120,534388,520732,102.6
31,경기도,045001, 40세,2017,209373,107048,102325,104.6,200335,101264,99071,102.2
31,경기도,045002, 41세,2017,206114,106307,99807,106.5,197246,100651,96595,104.2
31,경기도,045003, 42세,2017,215208,109702,105506,104,207076,104675,102401,102.2
31,경기도,045004, 43세,2017,232656,118972,113684,104.7,224577,114116,110461,103.3
31,경기도,045005, 44세,2017,234444,118661,115783,102.5,225886,113682,112204,101.3
31,경기도,050,45~49세,2017,1204113,610206,593907,102.7,1158126,584619,573507,101.9
31,경기도,050001, 45세,2017,237182,121961,115221,105.8,228180,116685,111495,104.7
31,경기도,050002, 46세,2017,249446,127189,122257,104,240059,121926,118133,103.2
31,경기도,050003, 47세,2017,239468,121665,117803,103.3,229829,116331,113498,102.5
31,경기도,050004, 48세,2017,241557,121574,119983,101.3,232578,116723,115855,100.7
31,경기도,050005, 49세,2017,236460,117817,118643,99.3,227480,112954,114526,98.6
31,경기도,055,50~54세,2017,1055583,537785,517798,103.9,1012005,515176,496829,103.7
31,경기도,055001, 50세,2017,214859,107154,107705,99.5,207460,103231,104229,99
31,경기도,055002, 51세,2017,210622,108321,102301,105.9,202374,103969,98405,105.7
31,경기도,055003, 52세,2017,217102,110152,106950,103,208096,105507,102589,102.8
31,경기도,055004, 53세,2017,202274,103555,98719,104.9,193685,99097,94588,104.8
31,경기도,055005, 54세,2017,210726,108603,102123,106.3,200390,103372,97018,106.5
31,경기도,060,55~59세,2017,1015993,516234,499759,103.3,983610,500165,483445,103.5
31,경기도,060001, 55세,2017,210252,107930,102322,105.5,202323,104001,98322,105.8
31,경기도,060002, 56세,2017,220814,111443,109371,101.9,215767,108947,106820,102
31,경기도,060003, 57세,2017,215528,108875,106653,102.1,208095,105177,102918,102.2
31,경기도,060004, 58세,2017,190470,96701,93769,103.1,184583,93776,90807,103.3
31,경기도,060005, 59세,2017,178929,91285,87644,104.2,172842,88264,84578,104.4
31,경기도,065,60~64세,2017,716151,357073,359078,99.4,688022,343033,344989,99.4
31,경기도,065001, 60세,2017,169610,85580,84030,101.8,162617,82109,80508,102
31,경기도,065002, 61세,2017,153608,77171,76437,101,147503,74123,73380,101
31,경기도,065003, 62세,2017,154066,76203,77863,97.9,148243,73260,74983,97.7
31,경기도,065004, 63세,2017,128234,63718,64516,98.8,123199,61207,61992,98.7
31,경기도,065005, 64세,2017,110633,54401,56232,96.7,106460,52334,54126,96.7
31,경기도,070,65~69세,2017,470087,227286,242801,93.6,457905,221459,236446,93.7
31,경기도,070001, 65세,2017,119271,58736,60535,97,115653,56979,58674,97.1
31,경기도,070002, 66세,2017,81042,39345,41697,94.4,78189,37967,40222,94.4
31,경기도,070003, 67세,2017,90173,43170,47003,91.8,87810,42032,45778,91.8
31,경기도,070004, 68세,2017,90658,43548,47110,92.4,88646,42621,46025,92.6
31,경기도,070005, 69세,2017,88943,42487,46456,91.5,87607,41860,45747,91.5
31,경기도,075,70~74세,2017,361783,165414,196369,84.2,357975,163886,194089,84.4
31,경기도,075001, 70세,2017,89998,42171,47827,88.2,88828,41644,47184,88.3
31,경기도,075002, 71세,2017,70108,32757,37351,87.7,69231,32410,36821,88
31,경기도,075003, 72세,2017,67710,31181,36529,85.4,67046,30923,36123,85.6
31,경기도,075004, 73세,2017,66710,29724,36986,80.4,66124,29488,36636,80.5
31,경기도,075005, 74세,2017,67257,29581,37676,78.5,66746,29421,37325,78.8
31,경기도,080,75~79세,2017,304187,128798,175389,73.4,301957,128080,173877,73.7
31,경기도,080001, 75세,2017,77123,33955,43168,78.7,76598,33763,42835,78.8
31,경기도,080002, 76세,2017,63367,27445,35922,76.4,62898,27291,35607,76.6
31,경기도,080003, 77세,2017,56984,24024,32960,72.9,56540,23886,32654,73.1
31,경기도,080004, 78세,2017,55967,23002,32965,69.8,55576,22888,32688,70
31,경기도,080005, 79세,2017,50746,20372,30374,67.1,50345,20252,30093,67.3
31,경기도,085,80~84세,2017,185880,67803,118077,57.4,184672,67456,117216,57.5
31,경기도,085001, 80세,2017,45852,17999,27853,64.6,45536,17906,27630,64.8
31,경기도,085002, 81세,2017,41590,15698,25892,60.6,41302,15620,25682,60.8
31,경기도,085003, 82세,2017,38785,13853,24932,55.6,38547,13782,24765,55.7
31,경기도,085004, 83세,2017,32379,11237,21142,53.2,32172,11180,20992,53.3
31,경기도,085005, 84세,2017,27274,9016,18258,49.4,27115,8968,18147,49.4
31,경기도,090,85~89세,2017,86400,24803,61597,40.3,85947,24684,61263,40.3
31,경기도,090001, 85세,2017,23907,7573,16334,46.4,23785,7540,16245,46.4
31,경기도,090002, 86세,2017,18460,5506,12954,42.5,18353,5477,12876,42.5
31,경기도,090003, 87세,2017,17360,4724,12636,37.4,17271,4698,12573,37.4
31,경기도,090004, 88세,2017,14716,4062,10654,38.1,14636,4049,10587,38.2
31,경기도,090005, 89세,2017,11957,2938,9019,32.6,11902,2920,8982,32.5
31,경기도,095,90~94세,2017,29427,6804,22623,30.1,29325,6780,22545,30.1
31,경기도,095001, 90세,2017,9317,2198,7119,30.9,9286,2191,7095,30.9
31,경기도,095002, 91세,2017,6702,1521,5181,29.4,6674,1514,5160,29.3
31,경기도,095003, 92세,2017,5577,1153,4424,26.1,5559,1149,4410,26.1
31,경기도,095004, 93세,2017,4027,984,3043,32.3,4017,983,3034,32.4
31,경기도,095005, 94세,2017,3804,948,2856,33.2,3789,943,2846,33.1
31,경기도,100,95~99세,2017,7048,1621,5427,29.9,7031,1617,5414,29.9
31,경기도,100001, 95세,2017,2738,644,2094,30.8,2729,642,2087,30.8
31,경기도,100002, 96세,2017,1759,402,1357,29.6,1758,402,1356,29.6
31,경기도,100003, 97세,2017,1254,285,969,29.4,1252,284,968,29.3
31,경기도,100004, 98세,2017,808,201,607,33.1,805,200,605,33.1
31,경기도,100005, 99세,2017,489,89,400,22.3,487,89,398,22.4
31,경기도,101,100세이상,2017,899,137,762,18,892,133,759,17.5
31,경기도,102,15세미만,2017,1841134,945563,895571,105.6,1822048,935877,886171,105.6
31,경기도,103,15~64세,2017,9564756,4934494,4630262,106.6,9106760,4656784,4449976,104.6
31,경기도,104,65세이상,2017,1445711,622666,823045,75.7,1425704,614095,811609,75.7
31,경기도,086,85세이상,2017,123774,33365,90409,36.9,123195,33214,89981,36.9
31,경기도,126,평균연령,2017,39.8,38.9,40.7,,39.8,38.9,40.7,
31,경기도,127,중위연령,2017,40.5,39.6,41.5,,40.7,39.9,41.6,
31004, 읍부,000,합계,2017,1357641,704740,652901,107.9,1290052,659599,630453,104.6
31004, 읍부,005,0~4세,2017,66509,34124,32385,105.4,65530,33649,31881,105.5
31004, 읍부,005001, 0세,2017,11113,5655,5458,103.6,10896,5560,5336,104.2
31004, 읍부,005002, 1세,2017,13216,6811,6405,106.3,12971,6691,6280,106.5
31004, 읍부,005003, 2세,2017,14020,7231,6789,106.5,13837,7131,6706,106.3
31004, 읍부,005004, 3세,2017,13970,7137,6833,104.4,13793,7053,6740,104.6
31004, 읍부,005005, 4세,2017,14190,7290,6900,105.7,14033,7214,6819,105.8
31004, 읍부,010,5~9세,2017,74738,38187,36551,104.5,74246,37929,36317,104.4
31004, 읍부,010001, 5세,2017,15585,7983,7602,105,15450,7907,7543,104.8
31004, 읍부,010002, 6세,2017,15338,7815,7523,103.9,15244,7764,7480,103.8
31004, 읍부,010003, 7세,2017,14775,7540,7235,104.2,14683,7493,7190,104.2
31004, 읍부,010004, 8세,2017,14083,7142,6941,102.9,13989,7099,6890,103
31004, 읍부,010005, 9세,2017,14957,7707,7250,106.3,14880,7666,7214,106.3
31004, 읍부,015,10~14세,2017,69213,35789,33424,107.1,68893,35636,33257,107.2
31004, 읍부,015001, 10세,2017,15019,7683,7336,104.7,14930,7650,7280,105.1
31004, 읍부,015002, 11세,2017,13673,7027,6646,105.7,13613,6991,6622,105.6
31004, 읍부,015003, 12세,2017,13259,6915,6344,109,13189,6882,6307,109.1
31004, 읍부,015004, 13세,2017,13814,7183,6631,108.3,13763,7159,6604,108.4
31004, 읍부,015005, 14세,2017,13448,6981,6467,107.9,13398,6954,6444,107.9
31004, 읍부,020,15~19세,2017,75688,39383,36305,108.5,75085,39052,36033,108.4
31004, 읍부,020001, 15세,2017,13968,7215,6753,106.8,13922,7194,6728,106.9
31004, 읍부,020002, 16세,2017,15234,7846,7388,106.2,15180,7816,7364,106.1
31004, 읍부,020003, 17세,2017,16235,8442,7793,108.3,16166,8402,7764,108.2
31004, 읍부,020004, 18세,2017,15418,7995,7423,107.7,15307,7926,7381,107.4
31004, 읍부,020005, 19세,2017,14833,7885,6948,113.5,14510,7714,6796,113.5
31004, 읍부,025,20~24세,2017,80535,44633,35902,124.3,73902,39825,34077,116.9
31004, 읍부,025001, 20세,2017,15392,8355,7037,118.7,14809,8020,6789,118.1
31004, 읍부,025002, 21세,2017,15748,8825,6923,127.5,14855,8217,6638,123.8
31004, 읍부,025003, 22세,2017,15968,8856,7112,124.5,14652,7891,6761,116.7
31004, 읍부,025004, 23세,2017,16430,9108,7322,124.4,14740,7846,6894,113.8
31004, 읍부,025005, 24세,2017,16997,9489,7508,126.4,14846,7851,6995,112.2
31004, 읍부,030,25~29세,2017,86416,49275,37141,132.7,72920,39278,33642,116.8
31004, 읍부,030001, 25세,2017,17868,10166,7702,132,15401,8282,7119,116.3
31004, 읍부,030002, 26세,2017,17138,9776,7362,132.8,14573,7846,6727,116.6
31004, 읍부,030003, 27세,2017,17137,9836,7301,134.7,14203,7697,6506,118.3
31004, 읍부,030004, 28세,2017,17220,9867,7353,134.2,14457,7836,6621,118.4
31004, 읍부,030005, 29세,2017,17053,9630,7423,129.7,14286,7617,6669,114.2
31004, 읍부,035,30~34세,2017,97424,53602,43822,122.3,84381,44208,40173,110
31004, 읍부,035001, 30세,2017,17742,9953,7789,127.8,14810,7874,6936,113.5
31004, 읍부,035002, 31세,2017,18331,10110,8221,123,15640,8205,7435,110.4
31004, 읍부,035003, 32세,2017,18986,10451,8535,122.4,16389,8557,7832,109.3
31004, 읍부,035004, 33세,2017,20094,11041,9053,122,17606,9205,8401,109.6
31004, 읍부,035005, 34세,2017,22271,12047,10224,117.8,19936,10367,9569,108.3
31004, 읍부,040,35~39세,2017,122993,65510,57483,114,113529,58703,54826,107.1
31004, 읍부,040001, 35세,2017,24598,13224,11374,116.3,22330,11574,10756,107.6
31004, 읍부,040002, 36세,2017,25097,13701,11396,120.2,23100,12247,10853,112.8
31004, 읍부,040003, 37세,2017,25905,13703,12202,112.3,24044,12403,11641,106.5
31004, 읍부,040004, 38세,2017,24546,12895,11651,110.7,22810,11644,11166,104.3
31004, 읍부,040005, 39세,2017,22847,11987,10860,110.4,21245,10835,10410,104.1
31004, 읍부,045,40~44세,2017,119941,63753,56188,113.5,114111,59896,54215,110.5
31004, 읍부,045001, 40세,2017,23331,12332,10999,112.1,22031,11421,10610,107.6
31004, 읍부,045002, 41세,2017,22849,12152,10697,113.6,21517,11256,10261,109.7
31004, 읍부,045003, 42세,2017,23598,12523,11075,113.1,22507,11785,10722,109.9
31004, 읍부,045004, 43세,2017,25038,13338,11700,114,23970,12660,11310,111.9
31004, 읍부,045005, 44세,2017,25125,13408,11717,114.4,24086,12774,11312,112.9
31004, 읍부,050,45~49세,2017,122462,65379,57083,114.5,117056,62242,54814,113.6
31004, 읍부,050001, 45세,2017,24948,13521,11427,118.3,23865,12867,10998,117
31004, 읍부,050002, 46세,2017,25765,13875,11890,116.7,24644,13205,11439,115.4
31004, 읍부,050003, 47세,2017,24210,12947,11263,115,23052,12283,10769,114.1
31004, 읍부,050004, 48세,2017,24038,12707,11331,112.1,23002,12117,10885,111.3
31004, 읍부,050005, 49세,2017,23501,12329,11172,110.4,22493,11770,10723,109.8
31004, 읍부,055,50~54세,2017,104027,55478,48549,114.3,99606,53046,46560,113.9
31004, 읍부,055001, 50세,2017,21238,11150,10088,110.5,20446,10714,9732,110.1
31004, 읍부,055002, 51세,2017,21179,11511,9668,119.1,20300,11006,9294,118.4
31004, 읍부,055003, 52세,2017,21108,11209,9899,113.2,20184,10727,9457,113.4
31004, 읍부,055004, 53세,2017,19963,10663,9300,114.7,19091,10174,8917,114.1
31004, 읍부,055005, 54세,2017,20539,10945,9594,114.1,19585,10425,9160,113.8
31004, 읍부,060,55~59세,2017,101103,52042,49061,106.1,98079,50479,47600,106
31004, 읍부,060001, 55세,2017,20776,11016,9760,112.9,20016,10624,9392,113.1
31004, 읍부,060002, 56세,2017,21848,11257,10591,106.3,21320,10995,10325,106.5
31004, 읍부,060003, 57세,2017,21020,10769,10251,105.1,20330,10395,9935,104.6
31004, 읍부,060004, 58세,2017,19074,9644,9430,102.3,18550,9372,9178,102.1
31004, 읍부,060005, 59세,2017,18385,9356,9029,103.6,17863,9093,8770,103.7
31004, 읍부,065,60~64세,2017,74585,37256,37329,99.8,72368,36090,36278,99.5
31004, 읍부,065001, 60세,2017,17067,8637,8430,102.5,16499,8346,8153,102.4
31004, 읍부,065002, 61세,2017,16116,8104,8012,101.1,15624,7843,7781,100.8
31004, 읍부,065003, 62세,2017,15985,7884,8101,97.3,15561,7653,7908,96.8
31004, 읍부,065004, 63세,2017,13670,6784,6886,98.5,13285,6598,6687,98.7
31004, 읍부,065005, 64세,2017,11747,5847,5900,99.1,11399,5650,5749,98.3
31004, 읍부,070,65~69세,2017,51204,24682,26522,93.1,50270,24224,26046,93
31004, 읍부,070001, 65세,2017,12936,6384,6552,97.4,12677,6254,6423,97.4
31004, 읍부,070002, 66세,2017,8758,4261,4497,94.8,8550,4151,4399,94.4
31004, 읍부,070003, 67세,2017,9627,4596,5031,91.4,9452,4513,4939,91.4
31004, 읍부,070004, 68세,2017,10061,4708,5353,88,9900,4633,5267,88
31004, 읍부,070005, 69세,2017,9822,4733,5089,93,9691,4673,5018,93.1
31004, 읍부,075,70~74세,2017,40673,18940,21733,87.1,40307,18776,21531,87.2
31004, 읍부,075001, 70세,2017,9984,4814,5170,93.1,9867,4757,5110,93.1
31004, 읍부,075002, 71세,2017,7911,3769,4142,91,7843,3739,4104,91.1
31004, 읍부,075003, 72세,2017,7733,3634,4099,88.7,7670,3607,4063,88.8
31004, 읍부,075004, 73세,2017,7434,3340,4094,81.6,7371,3309,4062,81.5
31004, 읍부,075005, 74세,2017,7611,3383,4228,80,7556,3364,4192,80.2
31004, 읍부,080,75~79세,2017,35138,14953,20185,74.1,34927,14870,20057,74.1
31004, 읍부,080001, 75세,2017,8875,3938,4937,79.8,8811,3911,4900,79.8
31004, 읍부,080002, 76세,2017,7332,3175,4157,76.4,7289,3153,4136,76.2
31004, 읍부,080003, 77세,2017,6576,2822,3754,75.2,6537,2810,3727,75.4
31004, 읍부,080004, 78세,2017,6508,2685,3823,70.2,6470,2670,3800,70.3
31004, 읍부,080005, 79세,2017,5847,2333,3514,66.4,5820,2326,3494,66.6
31004, 읍부,085,80~84세,2017,21468,8075,13393,60.3,21369,8040,13329,60.3
31004, 읍부,085001, 80세,2017,5230,2128,3102,68.6,5199,2118,3081,68.7
31004, 읍부,085002, 81세,2017,4897,1866,3031,61.6,4885,1864,3021,61.7
31004, 읍부,085003, 82세,2017,4507,1650,2857,57.8,4483,1641,2842,57.7
31004, 읍부,085004, 83세,2017,3763,1380,2383,57.9,3749,1373,2376,57.8
31004, 읍부,085005, 84세,2017,3071,1051,2020,52,3053,1044,2009,52
31004, 읍부,090,85~89세,2017,9506,2735,6771,40.4,9466,2716,6750,40.2
31004, 읍부,090001, 85세,2017,2670,820,1850,44.3,2661,816,1845,44.2
31004, 읍부,090002, 86세,2017,2028,617,1411,43.7,2013,611,1402,43.6
31004, 읍부,090003, 87세,2017,1908,550,1358,40.5,1901,545,1356,40.2
31004, 읍부,090004, 88세,2017,1639,443,1196,37,1632,441,1191,37
31004, 읍부,090005, 89세,2017,1261,305,956,31.9,1259,303,956,31.7
31004, 읍부,095,90~94세,2017,3147,719,2428,29.6,3137,716,2421,29.6
31004, 읍부,095001, 90세,2017,966,211,755,27.9,961,210,751,28
31004, 읍부,095002, 91세,2017,740,172,568,30.3,736,170,566,30
31004, 읍부,095003, 92세,2017,594,118,476,24.8,594,118,476,24.8
31004, 읍부,095004, 93세,2017,439,109,330,33,439,109,330,33
31004, 읍부,095005, 94세,2017,408,109,299,36.5,407,109,298,36.6
31004, 읍부,100,95~99세,2017,779,208,571,36.4,778,207,571,36.3
31004, 읍부,100001, 95세,2017,290,76,214,35.5,290,76,214,35.5
31004, 읍부,100002, 96세,2017,211,60,151,39.7,211,60,151,39.7
31004, 읍부,100003, 97세,2017,127,29,98,29.6,126,28,98,28.6
31004, 읍부,100004, 98세,2017,95,31,64,48.4,95,31,64,48.4
31004, 읍부,100005, 99세,2017,56,12,44,27.3,56,12,44,27.3
31004, 읍부,101,100세이상,2017,92,17,75,22.7,92,17,75,22.7
31004, 읍부,102,15세미만,2017,210460,108100,102360,105.6,208669,107214,101455,105.7
31004, 읍부,103,15~64세,2017,985174,526311,458863,114.7,921037,482819,438218,110.2
31004, 읍부,104,65세이상,2017,162007,70329,91678,76.7,160346,69566,90780,76.6
31004, 읍부,086,85세이상,2017,13524,3679,9845,37.4,13473,3656,9817,37.2
31004, 읍부,126,평균연령,2017,39.6,38.7,40.6,,39.8,38.9,40.7,
31004, 읍부,127,중위연령,2017,40.2,39.3,41.2,,40.8,40.1,41.4,
31005, 면부,000,합계,2017,881231,480667,400564,120,795456,415579,379877,109.4
31005, 면부,005,0~4세,2017,25525,13273,12252,108.3,25151,13082,12069,108.4
31005, 면부,005001, 0세,2017,4522,2316,2206,105,4436,2271,2165,104.9
31005, 면부,005002, 1세,2017,5004,2630,2374,110.8,4921,2583,2338,110.5
31005, 면부,005003, 2세,2017,5258,2719,2539,107.1,5185,2684,2501,107.3
31005, 면부,005004, 3세,2017,5344,2797,2547,109.8,5274,2758,2516,109.6
31005, 면부,005005, 4세,2017,5397,2811,2586,108.7,5335,2786,2549,109.3
31005, 면부,010,5~9세,2017,28451,14740,13711,107.5,28162,14598,13564,107.6
31005, 면부,010001, 5세,2017,5886,2970,2916,101.9,5807,2934,2873,102.1
31005, 면부,010002, 6세,2017,5782,3029,2753,110,5723,2997,2726,109.9
31005, 면부,010003, 7세,2017,5541,2881,2660,108.3,5497,2862,2635,108.6
31005, 면부,010004, 8세,2017,5562,2907,2655,109.5,5510,2881,2629,109.6
31005, 면부,010005, 9세,2017,5680,2953,2727,108.3,5625,2924,2701,108.3
31005, 면부,015,10~14세,2017,26813,14083,12730,110.6,26663,14019,12644,110.9
31005, 면부,015001, 10세,2017,5585,2848,2737,104.1,5549,2828,2721,103.9
31005, 면부,015002, 11세,2017,5273,2782,2491,111.7,5243,2774,2469,112.4
31005, 면부,015003, 12세,2017,4996,2670,2326,114.8,4965,2657,2308,115.1
31005, 면부,015004, 13세,2017,5479,2931,2548,115,5450,2918,2532,115.2
31005, 면부,015005, 14세,2017,5480,2852,2628,108.5,5456,2842,2614,108.7
31005, 면부,020,15~19세,2017,44780,23152,21628,107,44143,22783,21360,106.7
31005, 면부,020001, 15세,2017,6055,3276,2779,117.9,6011,3247,2764,117.5
31005, 면부,020002, 16세,2017,7736,3910,3826,102.2,7694,3886,3808,102
31005, 면부,020003, 17세,2017,9266,4527,4739,95.5,9190,4484,4706,95.3
31005, 면부,020004, 18세,2017,9570,4946,4624,107,9421,4869,4552,107
31005, 면부,020005, 19세,2017,12153,6493,5660,114.7,11827,6297,5530,113.9
31005, 면부,025,20~24세,2017,59502,34903,24599,141.9,49373,26996,22377,120.6
31005, 면부,025001, 20세,2017,10613,5541,5072,109.2,9963,5104,4859,105
31005, 면부,025002, 21세,2017,10900,6100,4800,127.1,9518,5048,4470,112.9
31005, 면부,025003, 22세,2017,11663,6900,4763,144.9,9659,5330,4329,123.1
31005, 면부,025004, 23세,2017,12612,7641,4971,153.7,10042,5588,4454,125.5
31005, 면부,025005, 24세,2017,13714,8721,4993,174.7,10191,5926,4265,138.9
31005, 면부,030,25~29세,2017,68822,45316,23506,192.8,47508,28197,19311,146
31005, 면부,030001, 25세,2017,14652,9302,5350,173.9,10625,6099,4526,134.8
31005, 면부,030002, 26세,2017,13922,9012,4910,183.5,9740,5636,4104,137.3
31005, 면부,030003, 27세,2017,13791,9184,4607,199.3,9327,5615,3712,151.3
31005, 면부,030004, 28세,2017,13180,8894,4286,207.5,8917,5450,3467,157.2
31005, 면부,030005, 29세,2017,13277,8924,4353,205,8899,5397,3502,154.1
31005, 면부,035,30~34세,2017,61989,40582,21407,189.6,43466,25573,17893,142.9
31005, 면부,035001, 30세,2017,12767,8529,4238,201.3,8655,5189,3466,149.7
31005, 면부,035002, 31세,2017,12595,8463,4132,204.8,8650,5256,3394,154.9
31005, 면부,035003, 32세,2017,12234,8072,4162,193.9,8505,5055,3450,146.5
31005, 면부,035004, 33세,2017,12003,7745,4258,181.9,8512,4914,3598,136.6
31005, 면부,035005, 34세,2017,12390,7773,4617,168.4,9144,5159,3985,129.5
31005, 면부,040,35~39세,2017,61234,37435,23799,157.3,48681,27476,21205,129.6
31005, 면부,040001, 35세,2017,13223,8210,5013,163.8,10117,5733,4384,130.8
31005, 면부,040002, 36세,2017,12648,7737,4911,157.5,9954,5600,4354,128.6
31005, 면부,040003, 37세,2017,12576,7668,4908,156.2,10087,5672,4415,128.5
31005, 면부,040004, 38세,2017,11852,7229,4623,156.4,9561,5418,4143,130.8
31005, 면부,040005, 39세,2017,10935,6591,4344,151.7,8962,5053,3909,129.3
31005, 면부,045,40~44세,2017,56476,33034,23442,140.9,49365,27824,21541,129.2
31005, 면부,045001, 40세,2017,10939,6463,4476,144.4,9215,5142,4073,126.2
31005, 면부,045002, 41세,2017,10728,6330,4398,143.9,9123,5116,4007,127.7
31005, 면부,045003, 42세,2017,10998,6458,4540,142.2,9656,5480,4176,131.2
31005, 면부,045004, 43세,2017,11832,6922,4910,141,10534,6009,4525,132.8
31005, 면부,045005, 44세,2017,11979,6861,5118,134.1,10837,6077,4760,127.7
31005, 면부,050,45~49세,2017,64369,36346,28023,129.7,58959,32756,26203,125
31005, 면부,050001, 45세,2017,12022,7025,4997,140.6,10853,6239,4614,135.2
31005, 면부,050002, 46세,2017,12724,7276,5448,133.6,11632,6554,5078,129.1
31005, 면부,050003, 47세,2017,12854,7295,5559,131.2,11693,6526,5167,126.3
31005, 면부,050004, 48세,2017,13251,7375,5876,125.5,12251,6718,5533,121.4
31005, 면부,050005, 49세,2017,13518,7375,6143,120.1,12530,6719,5811,115.6
31005, 면부,055,50~54세,2017,69474,37730,31744,118.9,65550,35295,30255,116.7
31005, 면부,055001, 50세,2017,13041,7009,6032,116.2,12252,6505,5747,113.2
31005, 면부,055002, 51세,2017,13306,7385,5921,124.7,12529,6894,5635,122.3
31005, 면부,055003, 52세,2017,14591,7933,6658,119.1,13784,7413,6371,116.4
31005, 면부,055004, 53세,2017,13718,7426,6292,118,12969,6986,5983,116.8
31005, 면부,055005, 54세,2017,14818,7977,6841,116.6,14016,7497,6519,115
31005, 면부,060,55~59세,2017,81468,42757,38711,110.5,78879,41208,37671,109.4
31005, 면부,060001, 55세,2017,15349,8209,7140,115,14694,7830,6864,114.1
31005, 면부,060002, 56세,2017,17290,9024,8266,109.2,16829,8751,8078,108.3
31005, 면부,060003, 57세,2017,17284,8903,8381,106.2,16690,8546,8144,104.9
31005, 면부,060004, 58세,2017,15988,8379,7609,110.1,15548,8114,7434,109.1
31005, 면부,060005, 59세,2017,15557,8242,7315,112.7,15118,7967,7151,111.4
31005, 면부,065,60~64세,2017,67060,34527,32533,106.1,65419,33559,31860,105.3
31005, 면부,065001, 60세,2017,14899,7753,7146,108.5,14457,7481,6976,107.2
31005, 면부,065002, 61세,2017,14303,7489,6814,109.9,13977,7293,6684,109.1
31005, 면부,065003, 62세,2017,14412,7393,7019,105.3,14077,7198,6879,104.6
31005, 면부,065004, 63세,2017,12397,6372,6025,105.8,12100,6206,5894,105.3
31005, 면부,065005, 64세,2017,11049,5520,5529,99.8,10808,5381,5427,99.2
31005, 면부,070,65~69세,2017,47232,23955,23277,102.9,46568,23579,22989,102.6
31005, 면부,070001, 65세,2017,12251,6308,5943,106.1,12063,6208,5855,106
31005, 면부,070002, 66세,2017,7857,3944,3913,100.8,7695,3848,3847,100
31005, 면부,070003, 67세,2017,8958,4439,4519,98.2,8835,4366,4469,97.7
31005, 면부,070004, 68세,2017,8993,4513,4480,100.7,8874,4445,4429,100.4
31005, 면부,070005, 69세,2017,9173,4751,4422,107.4,9101,4712,4389,107.4
31005, 면부,075,70~74세,2017,39616,18904,20712,91.3,39379,18791,20588,91.3
31005, 면부,075001, 70세,2017,9503,4673,4830,96.7,9428,4633,4795,96.6
31005, 면부,075002, 71세,2017,7649,3771,3878,97.2,7588,3747,3841,97.6
31005, 면부,075003, 72세,2017,7541,3661,3880,94.4,7505,3643,3862,94.3
31005, 면부,075004, 73세,2017,7335,3395,3940,86.2,7302,3378,3924,86.1
31005, 면부,075005, 74세,2017,7588,3404,4184,81.4,7556,3390,4166,81.4
31005, 면부,080,75~79세,2017,36477,15898,20579,77.3,36340,15846,20494,77.3
31005, 면부,080001, 75세,2017,8765,3933,4832,81.4,8734,3920,4814,81.4
31005, 면부,080002, 76세,2017,7577,3429,4148,82.7,7547,3414,4133,82.6
31005, 면부,080003, 77세,2017,6732,2980,3752,79.4,6704,2970,3734,79.5
31005, 면부,080004, 78세,2017,7019,2949,4070,72.5,6999,2940,4059,72.4
31005, 면부,080005, 79세,2017,6384,2607,3777,69,6356,2602,3754,69.3
31005, 면부,085,80~84세,2017,24646,9472,15174,62.4,24599,9448,15151,62.4
31005, 면부,085001, 80세,2017,6057,2504,3553,70.5,6041,2497,3544,70.5
31005, 면부,085002, 81세,2017,5490,2246,3244,69.2,5476,2240,3236,69.2
31005, 면부,085003, 82세,2017,5061,1895,3166,59.9,5053,1891,3162,59.8
31005, 면부,085004, 83세,2017,4382,1601,2781,57.6,4376,1596,2780,57.4
31005, 면부,085005, 84세,2017,3656,1226,2430,50.5,3653,1224,2429,50.4
31005, 면부,090,85~89세,2017,11837,3331,8506,39.2,11801,3322,8479,39.2
31005, 면부,090001, 85세,2017,3202,1013,2189,46.3,3193,1011,2182,46.3
31005, 면부,090002, 86세,2017,2543,775,1768,43.8,2534,773,1761,43.9
31005, 면부,090003, 87세,2017,2397,641,1756,36.5,2390,639,1751,36.5
31005, 면부,090004, 88세,2017,2061,531,1530,34.7,2053,529,1524,34.7
31005, 면부,090005, 89세,2017,1634,371,1263,29.4,1631,370,1261,29.3
31005, 면부,095,90~94세,2017,4271,986,3285,30,4264,985,3279,30
31005, 면부,095001, 90세,2017,1272,275,997,27.6,1269,275,994,27.7
31005, 면부,095002, 91세,2017,992,213,779,27.3,991,213,778,27.4
31005, 면부,095003, 92세,2017,838,192,646,29.7,838,192,646,29.7
31005, 면부,095004, 93세,2017,600,160,440,36.4,599,160,439,36.4
31005, 면부,095005, 94세,2017,569,146,423,34.5,567,145,422,34.4
31005, 면부,100,95~99세,2017,1062,227,835,27.2,1060,227,833,27.3
31005, 면부,100001, 95세,2017,395,82,313,26.2,394,82,312,26.3
31005, 면부,100002, 96세,2017,275,64,211,30.3,275,64,211,30.3
31005, 면부,100003, 97세,2017,196,44,152,28.9,196,44,152,28.9
31005, 면부,100004, 98세,2017,130,27,103,26.2,129,27,102,26.5
31005, 면부,100005, 99세,2017,66,10,56,17.9,66,10,56,17.9
31005, 면부,101,100세이상,2017,127,16,111,14.4,126,15,111,13.5
31005, 면부,102,15세미만,2017,80789,42096,38693,108.8,79976,41699,38277,108.9
31005, 면부,103,15~64세,2017,635174,365782,269392,135.8,551343,301667,249676,120.8
31005, 면부,104,65세이상,2017,165268,72789,92479,78.7,164137,72213,91924,78.6
31005, 면부,086,85세이상,2017,17297,4560,12737,35.8,17251,4549,12702,35.8
31005, 면부,126,평균연령,2017,44.7,42.9,46.8,,45.7,44.2,47.4,
31005, 면부,127,중위연령,2017,45.6,42.6,49.2,,48.1,46.2,50.3,
31003, 동부,000,합계,2017,10612729,5317316,5295413,100.4,10269004,5131578,5137426,99.9
31003, 동부,005,0~4세,2017,486381,248849,237532,104.8,476883,244029,232854,104.8
31003, 동부,005001, 0세,2017,82888,42760,40128,106.6,80813,41672,39141,106.5
31003, 동부,005002, 1세,2017,96200,49070,47130,104.1,93932,47896,46036,104
31003, 동부,005003, 2세,2017,102416,52411,50005,104.8,100593,51462,49131,104.7
31003, 동부,005004, 3세,2017,101809,51989,49820,104.4,100018,51118,48900,104.5
31003, 동부,005005, 4세,2017,103068,52619,50449,104.3,101527,51881,49646,104.5
31003, 동부,010,5~9세,2017,539386,277314,262072,105.8,534684,274873,259811,105.8
31003, 동부,010001, 5세,2017,112033,57577,54456,105.7,110681,56899,53782,105.8
31003, 동부,010002, 6세,2017,109921,56392,53529,105.3,108945,55877,53068,105.3
31003, 동부,010003, 7세,2017,105975,54622,51353,106.4,105098,54148,50950,106.3
31003, 동부,010004, 8세,2017,102851,52993,49858,106.3,102061,52587,49474,106.3
31003, 동부,010005, 9세,2017,108606,55730,52876,105.4,107899,55362,52537,105.4
31003, 동부,015,10~14세,2017,524118,269204,254914,105.6,521836,268062,253774,105.6
31003, 동부,015001, 10세,2017,110338,56690,53648,105.7,109710,56376,53334,105.7
31003, 동부,015002, 11세,2017,100578,51740,48838,105.9,100078,51483,48595,105.9
31003, 동부,015003, 12세,2017,98099,50043,48056,104.1,97715,49851,47864,104.2
31003, 동부,015004, 13세,2017,106902,54852,52050,105.4,106484,54650,51834,105.4
31003, 동부,015005, 14세,2017,108201,55879,52322,106.8,107849,55702,52147,106.8
31003, 동부,020,15~19세,2017,620815,320518,300297,106.7,616277,318293,297984,106.8
31003, 동부,020001, 15세,2017,109559,56627,52932,107,109158,56433,52725,107
31003, 동부,020002, 16세,2017,123112,63544,59568,106.7,122678,63319,59359,106.7
31003, 동부,020003, 17세,2017,133763,69092,64671,106.8,133187,68814,64373,106.9
31003, 동부,020004, 18세,2017,127966,66192,61774,107.2,126885,65652,61233,107.2
31003, 동부,020005, 19세,2017,126415,65063,61352,106,124369,64075,60294,106.3
31003, 동부,025,20~24세,2017,708971,373424,335547,111.3,687702,361609,326093,110.9
31003, 동부,025001, 20세,2017,133080,70146,62934,111.5,130506,68855,61651,111.7
31003, 동부,025002, 21세,2017,138721,74856,63865,117.2,135437,73125,62312,117.4
31003, 동부,025003, 22세,2017,141837,75694,66143,114.4,137699,73384,64315,114.1
31003, 동부,025004, 23세,2017,146090,75875,70215,108.1,141029,72998,68031,107.3
31003, 동부,025005, 24세,2017,149243,76853,72390,106.2,143031,73247,69784,105
31003, 동부,030,25~29세,2017,721466,375935,345531,108.8,676411,350002,326409,107.2
31003, 동부,030001, 25세,2017,154530,80376,74154,108.4,147258,76127,71131,107
31003, 동부,030002, 26세,2017,148446,77422,71024,109,140466,72755,67711,107.4
31003, 동부,030003, 27세,2017,141835,74080,67755,109.3,132349,68623,63726,107.7
31003, 동부,030004, 28세,2017,139494,72983,66511,109.7,129520,67211,62309,107.9
31003, 동부,030005, 29세,2017,137161,71074,66087,107.5,126818,65286,61532,106.1
31003, 동부,035,30~34세,2017,746869,383480,363389,105.5,696785,354484,342301,103.6
31003, 동부,035001, 30세,2017,138381,71476,66905,106.8,127366,65056,62310,104.4
31003, 동부,035002, 31세,2017,141340,72728,68612,106,130610,66653,63957,104.2
31003, 동부,035003, 32세,2017,145368,74588,70780,105.4,135467,68915,66552,103.6
31003, 동부,035004, 33세,2017,152442,78054,74388,104.9,142919,72445,70474,102.8
31003, 동부,035005, 34세,2017,169338,86634,82704,104.8,160423,81415,79008,103
31003, 동부,040,35~39세,2017,917617,465358,452259,102.9,879714,442924,436790,101.4
31003, 동부,040001, 35세,2017,185337,94504,90833,104,176316,89217,87099,102.4
31003, 동부,040002, 36세,2017,188153,95897,92256,103.9,180590,91399,89191,102.5
31003, 동부,040003, 37세,2017,192015,96917,95098,101.9,184756,92606,92150,100.5
31003, 동부,040004, 38세,2017,183799,92818,90981,102,176305,88375,87930,100.5
31003, 동부,040005, 39세,2017,168313,85222,83091,102.6,161747,81327,80420,101.1
31003, 동부,045,40~44세,2017,921378,463903,457475,101.4,891644,446668,444976,100.4
31003, 동부,045001, 40세,2017,175103,88253,86850,101.6,169089,84701,84388,100.4
31003, 동부,045002, 41세,2017,172537,87825,84712,103.7,166606,84279,82327,102.4
31003, 동부,045003, 42세,2017,180612,90721,89891,100.9,174913,87410,87503,99.9
31003, 동부,045004, 43세,2017,195786,98712,97074,101.7,190073,95447,94626,100.9
31003, 동부,045005, 44세,2017,197340,98392,98948,99.4,190963,94831,96132,98.6
31003, 동부,050,45~49세,2017,1017282,508481,508801,99.9,982111,489621,492490,99.4
31003, 동부,050001, 45세,2017,200212,101415,98797,102.6,193462,97579,95883,101.8
31003, 동부,050002, 46세,2017,210957,106038,104919,101.1,203783,102167,101616,100.5
31003, 동부,050003, 47세,2017,202404,101423,100981,100.4,195084,97522,97562,100
31003, 동부,050004, 48세,2017,204268,101492,102776,98.8,197325,97888,99437,98.4
31003, 동부,050005, 49세,2017,199441,98113,101328,96.8,192457,94465,97992,96.4
31003, 동부,055,50~54세,2017,882082,444577,437505,101.6,846849,426835,420014,101.6
31003, 동부,055001, 50세,2017,180580,88995,91585,97.2,174762,86012,88750,96.9
31003, 동부,055002, 51세,2017,176137,89425,86712,103.1,169545,86069,83476,103.1
31003, 동부,055003, 52세,2017,181403,91010,90393,100.7,174128,87367,86761,100.7
31003, 동부,055004, 53세,2017,168593,85466,83127,102.8,161625,81937,79688,102.8
31003, 동부,055005, 54세,2017,175369,89681,85688,104.7,166789,85450,81339,105.1
31003, 동부,060,55~59세,2017,833422,421435,411987,102.3,806652,408478,398174,102.6
31003, 동부,060001, 55세,2017,174127,88705,85422,103.8,167613,85547,82066,104.2
31003, 동부,060002, 56세,2017,181676,91162,90514,100.7,177618,89201,88417,100.9
31003, 동부,060003, 57세,2017,177224,89203,88021,101.3,171075,86236,84839,101.6
31003, 동부,060004, 58세,2017,155408,78678,76730,102.5,150485,76290,74195,102.8
31003, 동부,060005, 59세,2017,144987,73687,71300,103.3,139861,71204,68657,103.7
31003, 동부,065,60~64세,2017,574506,285290,289216,98.6,550235,273384,276851,98.7
31003, 동부,065001, 60세,2017,137644,69190,68454,101.1,131661,66282,65379,101.4
31003, 동부,065002, 61세,2017,123189,61578,61611,99.9,117902,58987,58915,100.1
31003, 동부,065003, 62세,2017,123669,60926,62743,97.1,118605,58409,60196,97
31003, 동부,065004, 63세,2017,102167,50562,51605,98,97814,48403,49411,98
31003, 동부,065005, 64세,2017,87837,43034,44803,96.1,84253,41303,42950,96.2
31003, 동부,070,65~69세,2017,371651,178649,193002,92.6,361067,173656,187411,92.7
31003, 동부,070001, 65세,2017,94084,46044,48040,95.8,90913,44517,46396,96
31003, 동부,070002, 66세,2017,64427,31140,33287,93.6,61944,29968,31976,93.7
31003, 동부,070003, 67세,2017,71588,34135,37453,91.1,69523,33153,36370,91.2
31003, 동부,070004, 68세,2017,71604,34327,37277,92.1,69872,33543,36329,92.3
31003, 동부,070005, 69세,2017,69948,33003,36945,89.3,68815,32475,36340,89.4
31003, 동부,075,70~74세,2017,281494,127570,153924,82.9,278289,126319,151970,83.1
31003, 동부,075001, 70세,2017,70511,32684,37827,86.4,69533,32254,37279,86.5
31003, 동부,075002, 71세,2017,54548,25217,29331,86,53800,24924,28876,86.3
31003, 동부,075003, 72세,2017,52436,23886,28550,83.7,51871,23673,28198,84
31003, 동부,075004, 73세,2017,51941,22989,28952,79.4,51451,22801,28650,79.6
31003, 동부,075005, 74세,2017,52058,22794,29264,77.9,51634,22667,28967,78.3
31003, 동부,080,75~79세,2017,232572,97947,134625,72.8,230690,97364,133326,73
31003, 동부,080001, 75세,2017,59483,26084,33399,78.1,59053,25932,33121,78.3
31003, 동부,080002, 76세,2017,48458,20841,27617,75.5,48062,20724,27338,75.8
31003, 동부,080003, 77세,2017,43676,18222,25454,71.6,43299,18106,25193,71.9
31003, 동부,080004, 78세,2017,42440,17368,25072,69.3,42107,17278,24829,69.6
31003, 동부,080005, 79세,2017,38515,15432,23083,66.9,38169,15324,22845,67.1
31003, 동부,085,80~84세,2017,139766,50256,89510,56.1,138704,49968,88736,56.3
31003, 동부,085001, 80세,2017,34565,13367,21198,63.1,34296,13291,21005,63.3
31003, 동부,085002, 81세,2017,31203,11586,19617,59.1,30941,11516,19425,59.3
31003, 동부,085003, 82세,2017,29217,10308,18909,54.5,29011,10250,18761,54.6
31003, 동부,085004, 83세,2017,24234,8256,15978,51.7,24047,8211,15836,51.9
31003, 동부,085005, 84세,2017,20547,6739,13808,48.8,20409,6700,13709,48.9
31003, 동부,090,85~89세,2017,65057,18737,46320,40.5,64680,18646,46034,40.5
31003, 동부,090001, 85세,2017,18035,5740,12295,46.7,17931,5713,12218,46.8
31003, 동부,090002, 86세,2017,13889,4114,9775,42.1,13806,4093,9713,42.1
31003, 동부,090003, 87세,2017,13055,3533,9522,37.1,12980,3514,9466,37.1
31003, 동부,090004, 88세,2017,11016,3088,7928,39,10951,3079,7872,39.1
31003, 동부,090005, 89세,2017,9062,2262,6800,33.3,9012,2247,6765,33.2
31003, 동부,095,90~94세,2017,22009,5099,16910,30.2,21924,5079,16845,30.2
31003, 동부,095001, 90세,2017,7079,1712,5367,31.9,7056,1706,5350,31.9
31003, 동부,095002, 91세,2017,4970,1136,3834,29.6,4947,1131,3816,29.6
31003, 동부,095003, 92세,2017,4145,843,3302,25.5,4127,839,3288,25.5
31003, 동부,095004, 93세,2017,2988,715,2273,31.5,2979,714,2265,31.5
31003, 동부,095005, 94세,2017,2827,693,2134,32.5,2815,689,2126,32.4
31003, 동부,100,95~99세,2017,5207,1186,4021,29.5,5193,1183,4010,29.5
31003, 동부,100001, 95세,2017,2053,486,1567,31,2045,484,1561,31
31003, 동부,100002, 96세,2017,1273,278,995,27.9,1272,278,994,28
31003, 동부,100003, 97세,2017,931,212,719,29.5,930,212,718,29.5
31003, 동부,100004, 98세,2017,583,143,440,32.5,581,142,439,32.3
31003, 동부,100005, 99세,2017,367,67,300,22.3,365,67,298,22.5
31003, 동부,101,100세이상,2017,680,104,576,18.1,674,101,573,17.6
31003, 동부,102,15세미만,2017,1549885,795367,754518,105.4,1533403,786964,746439,105.4
31003, 동부,103,15~64세,2017,7944408,4042401,3902007,103.6,7634380,3872298,3762082,102.9
31003, 동부,104,65세이상,2017,1118436,479548,638888,75.1,1101221,472316,628905,75.1
31003, 동부,086,85세이상,2017,92953,25126,67827,37,92471,25009,67462,37.1
31003, 동부,126,평균연령,2017,39.4,38.5,40.2,,39.3,38.5,40.2,
31003, 동부,127,중위연령,2017,40.2,39.3,41.1,,40.3,39.4,41.1,
31010, 수원시,000,합계,2017,1216996,615690,601306,102.4,1168404,589882,578522,102
31010, 수원시,005,0~4세,2017,56590,29149,27441,106.2,54958,28323,26635,106.3
31010, 수원시,005001, 0세,2017,9965,5149,4816,106.9,9617,4969,4648,106.9
31010, 수원시,005002, 1세,2017,11449,5912,5537,106.8,11058,5705,5353,106.6
31010, 수원시,005003, 2세,2017,12026,6158,5868,104.9,11713,5993,5720,104.8
31010, 수원시,005004, 3세,2017,11571,5927,5644,105,11259,5783,5476,105.6
31010, 수원시,005005, 4세,2017,11579,6003,5576,107.7,11311,5873,5438,108
31010, 수원시,010,5~9세,2017,58825,30284,28541,106.1,58075,29889,28186,106
31010, 수원시,010001, 5세,2017,12406,6337,6069,104.4,12194,6230,5964,104.5
31010, 수원시,010002, 6세,2017,12052,6248,5804,107.6,11888,6166,5722,107.8
31010, 수원시,010003, 7세,2017,11332,5856,5476,106.9,11206,5782,5424,106.6
31010, 수원시,010004, 8세,2017,11137,5714,5423,105.4,10995,5640,5355,105.3
31010, 수원시,010005, 9세,2017,11898,6129,5769,106.2,11792,6071,5721,106.1
31010, 수원시,015,10~14세,2017,57465,29611,27854,106.3,57150,29469,27681,106.5
31010, 수원시,015001, 10세,2017,12038,6207,5831,106.4,11958,6169,5789,106.6
31010, 수원시,015002, 11세,2017,10838,5588,5250,106.4,10761,5559,5202,106.9
31010, 수원시,015003, 12세,2017,10644,5381,5263,102.2,10590,5359,5231,102.4
31010, 수원시,015004, 13세,2017,11832,6155,5677,108.4,11775,6124,5651,108.4
31010, 수원시,015005, 14세,2017,12113,6280,5833,107.7,12066,6258,5808,107.7
31010, 수원시,020,15~19세,2017,72845,38287,34558,110.8,72032,37913,34119,111.1
31010, 수원시,020001, 15세,2017,12196,6298,5898,106.8,12137,6275,5862,107
31010, 수원시,020002, 16세,2017,14183,7585,6598,115,14123,7552,6571,114.9
31010, 수원시,020003, 17세,2017,15552,8090,7462,108.4,15474,8058,7416,108.7
31010, 수원시,020004, 18세,2017,14931,7874,7057,111.6,14745,7787,6958,111.9
31010, 수원시,020005, 19세,2017,15983,8440,7543,111.9,15553,8241,7312,112.7
31010, 수원시,025,20~24세,2017,91040,48226,42814,112.6,87937,46592,41345,112.7
31010, 수원시,025001, 20세,2017,16651,8852,7799,113.5,16158,8593,7565,113.6
31010, 수원시,025002, 21세,2017,17341,9221,8120,113.6,16854,8966,7888,113.7
31010, 수원시,025003, 22세,2017,18128,9693,8435,114.9,17528,9402,8126,115.7
31010, 수원시,025004, 23세,2017,18986,9943,9043,110,18312,9566,8746,109.4
31010, 수원시,025005, 24세,2017,19934,10517,9417,111.7,19085,10065,9020,111.6
31010, 수원시,030,25~29세,2017,96070,51251,44819,114.4,90269,48160,42109,114.4
31010, 수원시,030001, 25세,2017,20541,10925,9616,113.6,19634,10413,9221,112.9
31010, 수원시,030002, 26세,2017,19820,10601,9219,115,18823,10082,8741,115.3
31010, 수원시,030003, 27세,2017,18887,10153,8734,116.2,17608,9477,8131,116.6
31010, 수원시,030004, 28세,2017,18680,9966,8714,114.4,17397,9291,8106,114.6
31010, 수원시,030005, 29세,2017,18142,9606,8536,112.5,16807,8897,7910,112.5
31010, 수원시,035,30~34세,2017,94656,49600,45056,110.1,88251,46028,42223,109
31010, 수원시,035001, 30세,2017,18355,9761,8594,113.6,16940,8936,8004,111.6
31010, 수원시,035002, 31세,2017,18263,9560,8703,109.8,16836,8797,8039,109.4
31010, 수원시,035003, 32세,2017,18581,9642,8939,107.9,17301,8951,8350,107.2
31010, 수원시,035004, 33세,2017,18826,9834,8992,109.4,17632,9146,8486,107.8
31010, 수원시,035005, 34세,2017,20631,10803,9828,109.9,19542,10198,9344,109.1
31010, 수원시,040,35~39세,2017,107790,55326,52464,105.5,103195,52596,50599,103.9
31010, 수원시,040001, 35세,2017,22308,11426,10882,105,21226,10781,10445,103.2
31010, 수원시,040002, 36세,2017,22447,11440,11007,103.9,21610,10942,10668,102.6
31010, 수원시,040003, 37세,2017,22303,11491,10812,106.3,21413,10965,10448,104.9
31010, 수원시,040004, 38세,2017,21342,10906,10436,104.5,20401,10336,10065,102.7
31010, 수원시,040005, 39세,2017,19390,10063,9327,107.9,18545,9572,8973,106.7
31010, 수원시,045,40~44세,2017,103196,52174,51022,102.3,99404,49973,49431,101.1
31010, 수원시,045001, 40세,2017,20031,10213,9818,104,19246,9762,9484,102.9
31010, 수원시,045002, 41세,2017,19557,10059,9498,105.9,18838,9626,9212,104.5
31010, 수원시,045003, 42세,2017,20099,10193,9906,102.9,19385,9765,9620,101.5
31010, 수원시,045004, 43세,2017,21554,10823,10731,100.9,20806,10373,10433,99.4
31010, 수원시,045005, 44세,2017,21955,10886,11069,98.3,21129,10447,10682,97.8
31010, 수원시,050,45~49세,2017,113649,56496,57153,98.9,108617,53773,54844,98
31010, 수원시,050001, 45세,2017,21799,11130,10669,104.3,20828,10565,10263,102.9
31010, 수원시,050002, 46세,2017,23317,11784,11533,102.2,22287,11216,11071,101.3
31010, 수원시,050003, 47세,2017,22397,11261,11136,101.1,21359,10707,10652,100.5
31010, 수원시,050004, 48세,2017,23292,11319,11973,94.5,22291,10801,11490,94
31010, 수원시,050005, 49세,2017,22844,11002,11842,92.9,21852,10484,11368,92.2
31010, 수원시,055,50~54세,2017,101079,50809,50270,101.1,95489,47942,47547,100.8
31010, 수원시,055001, 50세,2017,20738,10166,10572,96.2,19907,9711,10196,95.2
31010, 수원시,055002, 51세,2017,20158,10113,10045,100.7,19119,9591,9528,100.7
31010, 수원시,055003, 52세,2017,20670,10393,10277,101.1,19514,9803,9711,100.9
31010, 수원시,055004, 53세,2017,19230,9739,9491,102.6,18094,9148,8946,102.3
31010, 수원시,055005, 54세,2017,20283,10398,9885,105.2,18855,9689,9166,105.7
31010, 수원시,060,55~59세,2017,92443,47148,45295,104.1,88214,44997,43217,104.1
31010, 수원시,060001, 55세,2017,19597,9997,9600,104.1,18527,9488,9039,105
31010, 수원시,060002, 56세,2017,20658,10378,10280,101,20029,10060,9969,100.9
31010, 수원시,060003, 57세,2017,19633,10050,9583,104.9,18669,9544,9125,104.6
31010, 수원시,060004, 58세,2017,16966,8712,8254,105.5,16223,8326,7897,105.4
31010, 수원시,060005, 59세,2017,15589,8011,7578,105.7,14766,7579,7187,105.5
31010, 수원시,065,60~64세,2017,59916,29630,30286,97.8,56058,27681,28377,97.5
31010, 수원시,065001, 60세,2017,14322,7240,7082,102.2,13339,6744,6595,102.3
31010, 수원시,065002, 61세,2017,12973,6534,6439,101.5,12128,6100,6028,101.2
31010, 수원시,065003, 62세,2017,12877,6294,6583,95.6,12071,5885,6186,95.1
31010, 수원시,065004, 63세,2017,10586,5172,5414,95.5,9909,4833,5076,95.2
31010, 수원시,065005, 64세,2017,9158,4390,4768,92.1,8611,4119,4492,91.7
31010, 수원시,070,65~69세,2017,38336,18604,19732,94.3,36671,17782,18889,94.1
31010, 수원시,070001, 65세,2017,9916,4911,5005,98.1,9444,4677,4767,98.1
31010, 수원시,070002, 66세,2017,6650,3216,3434,93.7,6234,3019,3215,93.9
31010, 수원시,070003, 67세,2017,7437,3581,3856,92.9,7105,3408,3697,92.2
31010, 수원시,070004, 68세,2017,7224,3507,3717,94.4,6958,3379,3579,94.4
31010, 수원시,070005, 69세,2017,7109,3389,3720,91.1,6930,3299,3631,90.9
31010, 수원시,075,70~74세,2017,28058,12730,15328,83.1,27553,12530,15023,83.4
31010, 수원시,075001, 70세,2017,7048,3251,3797,85.6,6879,3178,3701,85.9
31010, 수원시,075002, 71세,2017,5415,2550,2865,89,5312,2508,2804,89.4
31010, 수원시,075003, 72세,2017,5274,2417,2857,84.6,5184,2380,2804,84.9
31010, 수원시,075004, 73세,2017,5213,2313,2900,79.8,5130,2284,2846,80.3
31010, 수원시,075005, 74세,2017,5108,2199,2909,75.6,5048,2180,2868,76
31010, 수원시,080,75~79세,2017,22335,9252,13083,70.7,22071,9184,12887,71.3
31010, 수원시,080001, 75세,2017,5709,2493,3216,77.5,5647,2474,3173,78
31010, 수원시,080002, 76세,2017,4719,1976,2743,72,4657,1963,2694,72.9
31010, 수원시,080003, 77세,2017,4129,1666,2463,67.6,4079,1652,2427,68.1
31010, 수원시,080004, 78세,2017,4081,1636,2445,66.9,4033,1625,2408,67.5
31010, 수원시,080005, 79세,2017,3697,1481,2216,66.8,3655,1470,2185,67.3
31010, 수원시,085,80~84세,2017,13592,4714,8878,53.1,13410,4666,8744,53.4
31010, 수원시,085001, 80세,2017,3375,1254,2121,59.1,3320,1235,2085,59.2
31010, 수원시,085002, 81세,2017,3057,1053,2004,52.5,3018,1044,1974,52.9
31010, 수원시,085003, 82세,2017,2792,951,1841,51.7,2758,943,1815,52
31010, 수원시,085004, 83세,2017,2359,826,1533,53.9,2329,820,1509,54.3
31010, 수원시,085005, 84세,2017,2009,630,1379,45.7,1985,624,1361,45.8
31010, 수원시,090,85~89세,2017,6423,1778,4645,38.3,6375,1766,4609,38.3
31010, 수원시,090001, 85세,2017,1801,562,1239,45.4,1789,559,1230,45.4
31010, 수원시,090002, 86세,2017,1327,374,953,39.2,1313,369,944,39.1
31010, 수원시,090003, 87세,2017,1292,323,969,33.3,1283,322,961,33.5
31010, 수원시,090004, 88세,2017,1116,303,813,37.3,1108,303,805,37.6
31010, 수원시,090005, 89세,2017,887,216,671,32.2,882,213,669,31.8
31010, 수원시,095,90~94세,2017,2129,520,1609,32.3,2118,517,1601,32.3
31010, 수원시,095001, 90세,2017,692,179,513,34.9,688,178,510,34.9
31010, 수원시,095002, 91세,2017,485,110,375,29.3,481,109,372,29.3
31010, 수원시,095003, 92세,2017,394,77,317,24.3,394,77,317,24.3
31010, 수원시,095004, 93세,2017,286,79,207,38.2,285,79,206,38.3
31010, 수원시,095005, 94세,2017,272,75,197,38.1,270,74,196,37.8
31010, 수원시,100,95~99세,2017,509,94,415,22.7,508,94,414,22.7
31010, 수원시,100001, 95세,2017,213,44,169,26,213,44,169,26
31010, 수원시,100002, 96세,2017,139,24,115,20.9,139,24,115,20.9
31010, 수원시,100003, 97세,2017,80,10,70,14.3,80,10,70,14.3
31010, 수원시,100004, 98세,2017,52,13,39,33.3,52,13,39,33.3
31010, 수원시,100005, 99세,2017,25,X,22,13.6,24,X,21,14.3
31010, 수원시,101,100세이상,2017,50,7,43,16.3,49,7,42,16.7
31010, 수원시,102,15세미만,2017,172880,89044,83836,106.2,170183,87681,82502,106.3
31010, 수원시,103,15~64세,2017,932684,478947,453737,105.6,889466,455655,433811,105
31010, 수원시,104,65세이상,2017,111432,47699,63733,74.8,108755,46546,62209,74.8
31010, 수원시,086,85세이상,2017,9111,2399,6712,35.7,9050,2384,6666,35.8
31010, 수원시,126,평균연령,2017,38.5,37.6,39.3,,38.3,37.4,39.3,
31010, 수원시,127,중위연령,2017,38.7,37.7,39.7,,38.6,37.6,39.6,
31011, 장안구,000,합계,2017,295436,149660,145776,102.7,287001,145193,141808,102.4
31011, 장안구,005,0~4세,2017,11315,5905,5410,109.1,11055,5765,5290,109
31011, 장안구,005001, 0세,2017,1877,986,891,110.7,1811,953,858,111.1
31011, 장안구,005002, 1세,2017,2155,1101,1054,104.5,2106,1072,1034,103.7
31011, 장안구,005003, 2세,2017,2436,1278,1158,110.4,2390,1253,1137,110.2
31011, 장안구,005004, 3세,2017,2379,1246,1133,110,2322,1216,1106,109.9
31011, 장안구,005005, 4세,2017,2468,1294,1174,110.2,2426,1271,1155,110
31011, 장안구,010,5~9세,2017,13540,6948,6592,105.4,13437,6895,6542,105.4
31011, 장안구,010001, 5세,2017,2644,1331,1313,101.4,2615,1321,1294,102.1
31011, 장안구,010002, 6세,2017,2731,1434,1297,110.6,2714,1425,1289,110.6
31011, 장안구,010003, 7세,2017,2591,1332,1259,105.8,2569,1318,1251,105.4
31011, 장안구,010004, 8세,2017,2663,1353,1310,103.3,2641,1338,1303,102.7
31011, 장안구,010005, 9세,2017,2911,1498,1413,106,2898,1493,1405,106.3
31011, 장안구,015,10~14세,2017,14385,7395,6990,105.8,14353,7384,6969,106
31011, 장안구,015001, 10세,2017,2942,1518,1424,106.6,2935,1515,1420,106.7
31011, 장안구,015002, 11세,2017,2708,1386,1322,104.8,2701,1385,1316,105.2
31011, 장안구,015003, 12세,2017,2680,1339,1341,99.9,2674,1337,1337,100
31011, 장안구,015004, 13세,2017,2927,1549,1378,112.4,2920,1546,1374,112.5
31011, 장안구,015005, 14세,2017,3128,1603,1525,105.1,3123,1601,1522,105.2
31011, 장안구,020,15~19세,2017,19890,10750,9140,117.6,19611,10598,9013,117.6
31011, 장안구,020001, 15세,2017,3164,1660,1504,110.4,3152,1655,1497,110.6
31011, 장안구,020002, 16세,2017,3851,2121,1730,122.6,3844,2117,1727,122.6
31011, 장안구,020003, 17세,2017,4183,2205,1978,111.5,4165,2197,1968,111.6
31011, 장안구,020004, 18세,2017,4018,2199,1819,120.9,3939,2159,1780,121.3
31011, 장안구,020005, 19세,2017,4674,2565,2109,121.6,4511,2470,2041,121
31011, 장안구,025,20~24세,2017,25088,14076,11012,127.8,24120,13541,10579,128
31011, 장안구,025001, 20세,2017,4866,2727,2139,127.5,4671,2622,2049,128
31011, 장안구,025002, 21세,2017,4783,2627,2156,121.8,4631,2534,2097,120.8
31011, 장안구,025003, 22세,2017,4959,2828,2131,132.7,4778,2728,2050,133.1
31011, 장안구,025004, 23세,2017,5182,2932,2250,130.3,4964,2816,2148,131.1
31011, 장안구,025005, 24세,2017,5298,2962,2336,126.8,5076,2841,2235,127.1
31011, 장안구,030,25~29세,2017,21606,11892,9714,122.4,20424,11236,9188,122.3
31011, 장안구,030001, 25세,2017,5106,2837,2269,125,4890,2701,2189,123.4
31011, 장안구,030002, 26세,2017,4672,2579,2093,123.2,4449,2457,1992,123.3
31011, 장안구,030003, 27세,2017,4307,2390,1917,124.7,4036,2239,1797,124.6
31011, 장안구,030004, 28세,2017,3927,2152,1775,121.2,3685,2026,1659,122.1
31011, 장안구,030005, 29세,2017,3594,1934,1660,116.5,3364,1813,1551,116.9
31011, 장안구,035,30~34세,2017,18355,9595,8760,109.5,17309,9020,8289,108.8
31011, 장안구,035001, 30세,2017,3554,1928,1626,118.6,3323,1792,1531,117
31011, 장안구,035002, 31세,2017,3542,1849,1693,109.2,3293,1716,1577,108.8
31011, 장안구,035003, 32세,2017,3591,1904,1687,112.9,3391,1793,1598,112.2
31011, 장안구,035004, 33세,2017,3615,1825,1790,102,3427,1729,1698,101.8
31011, 장안구,035005, 34세,2017,4053,2089,1964,106.4,3875,1990,1885,105.6
31011, 장안구,040,35~39세,2017,22293,11188,11105,100.7,21598,10786,10812,99.8
31011, 장안구,040001, 35세,2017,4328,2179,2149,101.4,4164,2076,2088,99.4
31011, 장안구,040002, 36세,2017,4534,2262,2272,99.6,4398,2187,2211,98.9
31011, 장안구,040003, 37세,2017,4587,2323,2264,102.6,4470,2254,2216,101.7
31011, 장안구,040004, 38세,2017,4621,2266,2355,96.2,4472,2178,2294,94.9
31011, 장안구,040005, 39세,2017,4223,2158,2065,104.5,4094,2091,2003,104.4
31011, 장안구,045,40~44세,2017,24149,11986,12163,98.5,23593,11673,11920,97.9
31011, 장안구,045001, 40세,2017,4471,2213,2258,98,4353,2151,2202,97.7
31011, 장안구,045002, 41세,2017,4484,2279,2205,103.4,4378,2217,2161,102.6
31011, 장안구,045003, 42세,2017,4675,2333,2342,99.6,4589,2279,2310,98.7
31011, 장안구,045004, 43세,2017,5220,2607,2613,99.8,5103,2534,2569,98.6
31011, 장안구,045005, 44세,2017,5299,2554,2745,93,5170,2492,2678,93.1
31011, 장안구,050,45~49세,2017,28573,14041,14532,96.6,27820,13645,14175,96.3
31011, 장안구,050001, 45세,2017,5348,2697,2651,101.7,5218,2618,2600,100.7
31011, 장안구,050002, 46세,2017,5694,2808,2886,97.3,5551,2742,2809,97.6
31011, 장안구,050003, 47세,2017,5703,2869,2834,101.2,5547,2777,2770,100.3
31011, 장안구,050004, 48세,2017,5970,2853,3117,91.5,5817,2782,3035,91.7
31011, 장안구,050005, 49세,2017,5858,2814,3044,92.4,5687,2726,2961,92.1
31011, 장안구,055,50~54세,2017,25776,12960,12816,101.1,24908,12530,12378,101.2
31011, 장안구,055001, 50세,2017,5405,2608,2797,93.2,5270,2540,2730,93
31011, 장안구,055002, 51세,2017,5229,2635,2594,101.6,5074,2562,2512,102
31011, 장안구,055003, 52세,2017,5224,2641,2583,102.2,5053,2547,2506,101.6
31011, 장안구,055004, 53세,2017,4775,2400,2375,101.1,4593,2310,2283,101.2
31011, 장안구,055005, 54세,2017,5143,2676,2467,108.5,4918,2571,2347,109.5
31011, 장안구,060,55~59세,2017,23452,11876,11576,102.6,22795,11557,11238,102.8
31011, 장안구,060001, 55세,2017,4988,2547,2441,104.3,4820,2471,2349,105.2
31011, 장안구,060002, 56세,2017,5238,2603,2635,98.8,5150,2559,2591,98.8
31011, 장안구,060003, 57세,2017,4961,2517,2444,103,4797,2443,2354,103.8
31011, 장안구,060004, 58세,2017,4293,2185,2108,103.7,4176,2127,2049,103.8
31011, 장안구,060005, 59세,2017,3972,2024,1948,103.9,3852,1957,1895,103.3
31011, 장안구,065,60~64세,2017,15208,7548,7660,98.5,14615,7258,7357,98.7
31011, 장안구,065001, 60세,2017,3562,1837,1725,106.5,3440,1773,1667,106.4
31011, 장안구,065002, 61세,2017,3268,1659,1609,103.1,3141,1600,1541,103.8
31011, 장안구,065003, 62세,2017,3266,1572,1694,92.8,3129,1502,1627,92.3
31011, 장안구,065004, 63세,2017,2717,1333,1384,96.3,2605,1286,1319,97.5
31011, 장안구,065005, 64세,2017,2395,1147,1248,91.9,2300,1097,1203,91.2
31011, 장안구,070,65~69세,2017,10136,4891,5245,93.3,9879,4753,5126,92.7
31011, 장안구,070001, 65세,2017,2562,1264,1298,97.4,2488,1224,1264,96.8
31011, 장안구,070002, 66세,2017,1752,836,916,91.3,1687,802,885,90.6
31011, 장안구,070003, 67세,2017,1982,931,1051,88.6,1933,905,1028,88
31011, 장안구,070004, 68세,2017,1935,937,998,93.9,1894,916,978,93.7
31011, 장안구,070005, 69세,2017,1905,923,982,94,1877,906,971,93.3
31011, 장안구,075,70~74세,2017,7951,3556,4395,80.9,7864,3524,4340,81.2
31011, 장안구,075001, 70세,2017,1935,886,1049,84.5,1912,874,1038,84.2
31011, 장안구,075002, 71세,2017,1511,712,799,89.1,1491,703,788,89.2
31011, 장안구,075003, 72세,2017,1511,653,858,76.1,1493,645,848,76.1
31011, 장안구,075004, 73세,2017,1502,666,836,79.7,1483,663,820,80.9
31011, 장안구,075005, 74세,2017,1492,639,853,74.9,1485,639,846,75.5
31011, 장안구,080,75~79세,2017,6565,2762,3803,72.6,6517,2750,3767,73
31011, 장안구,080001, 75세,2017,1659,700,959,73,1646,697,949,73.4
31011, 장안구,080002, 76세,2017,1363,595,768,77.5,1353,593,760,78
31011, 장안구,080003, 77세,2017,1238,502,736,68.2,1227,499,728,68.5
31011, 장안구,080004, 78세,2017,1194,499,695,71.8,1188,497,691,71.9
31011, 장안구,080005, 79세,2017,1111,466,645,72.2,1103,464,639,72.6
31011, 장안구,085,80~84세,2017,4182,1463,2719,53.8,4144,1453,2691,54
31011, 장안구,085001, 80세,2017,1047,404,643,62.8,1036,400,636,62.9
31011, 장안구,085002, 81세,2017,954,315,639,49.3,946,313,633,49.4
31011, 장안구,085003, 82세,2017,862,292,570,51.2,854,291,563,51.7
31011, 장안구,085004, 83세,2017,695,254,441,57.6,689,253,436,58
31011, 장안구,085005, 84세,2017,624,198,426,46.5,619,196,423,46.3
31011, 장안구,090,85~89세,2017,2063,608,1455,41.8,2054,605,1449,41.8
31011, 장안구,090001, 85세,2017,577,181,396,45.7,575,181,394,45.9
31011, 장안구,090002, 86세,2017,419,131,288,45.5,416,130,286,45.5
31011, 장안구,090003, 87세,2017,418,107,311,34.4,418,107,311,34.4
31011, 장안구,090004, 88세,2017,359,107,252,42.5,358,107,251,42.6
31011, 장안구,090005, 89세,2017,290,82,208,39.4,287,80,207,38.6
31011, 장안구,095,90~94세,2017,711,186,525,35.4,708,186,522,35.6
31011, 장안구,095001, 90세,2017,234,54,180,30,232,54,178,30.3
31011, 장안구,095002, 91세,2017,156,39,117,33.3,156,39,117,33.3
31011, 장안구,095003, 92세,2017,143,36,107,33.6,143,36,107,33.6
31011, 장안구,095004, 93세,2017,94,30,64,46.9,94,30,64,46.9
31011, 장안구,095005, 94세,2017,84,27,57,47.4,83,27,56,48.2
31011, 장안구,100,95~99세,2017,180,31,149,20.8,179,31,148,20.9
31011, 장안구,100001, 95세,2017,77,13,64,20.3,77,13,64,20.3
31011, 장안구,100002, 96세,2017,44,9,35,25.7,44,9,35,25.7
31011, 장안구,100003, 97세,2017,29,X,27,7.4,29,X,27,7.4
31011, 장안구,100004, 98세,2017,20,6,14,42.9,20,6,14,42.9
31011, 장안구,100005, 99세,2017,10,X,9,11.1,9,X,8,12.5
31011, 장안구,101,100세이상,2017,18,X,15,20,18,X,15,20
31011, 장안구,102,15세미만,2017,39240,20248,18992,106.6,38845,20044,18801,106.6
31011, 장안구,103,15~64세,2017,224390,115912,108478,106.9,216793,111844,104949,106.6
31011, 장안구,104,65세이상,2017,31806,13500,18306,73.7,31363,13305,18058,73.7
31011, 장안구,086,85세이상,2017,2972,828,2144,38.6,2959,825,2134,38.7
31011, 장안구,126,평균연령,2017,39.5,38.3,40.7,,39.5,38.3,40.7,
31011, 장안구,127,중위연령,2017,40.3,38.7,41.9,,40.4,38.8,41.9,
31012, 권선구,000,합계,2017,364650,183913,180737,101.8,351909,177344,174565,101.6
31012, 권선구,005,0~4세,2017,18672,9516,9156,103.9,18232,9297,8935,104.1
31012, 권선구,005001, 0세,2017,3320,1682,1638,102.7,3220,1626,1594,102
31012, 권선구,005002, 1세,2017,3845,2007,1838,109.2,3733,1947,1786,109
31012, 권선구,005003, 2세,2017,3906,1987,1919,103.5,3822,1941,1881,103.2
31012, 권선구,005004, 3세,2017,3822,1916,1906,100.5,3744,1886,1858,101.5
31012, 권선구,005005, 4세,2017,3779,1924,1855,103.7,3713,1897,1816,104.5
31012, 권선구,010,5~9세,2017,17706,9107,8599,105.9,17547,9025,8522,105.9
31012, 권선구,010001, 5세,2017,3961,2042,1919,106.4,3918,2018,1900,106.2
31012, 권선구,010002, 6세,2017,3758,1930,1828,105.6,3720,1911,1809,105.6
31012, 권선구,010003, 7세,2017,3397,1721,1676,102.7,3368,1704,1664,102.4
31012, 권선구,010004, 8세,2017,3239,1658,1581,104.9,3212,1647,1565,105.2
31012, 권선구,010005, 9세,2017,3351,1756,1595,110.1,3329,1745,1584,110.2
31012, 권선구,015,10~14세,2017,15912,8336,7576,110,15833,8306,7527,110.3
31012, 권선구,015001, 10세,2017,3430,1772,1658,106.9,3403,1760,1643,107.1
31012, 권선구,015002, 11세,2017,3027,1587,1440,110.2,3014,1580,1434,110.2
31012, 권선구,015003, 12세,2017,2886,1487,1399,106.3,2873,1484,1389,106.8
31012, 권선구,015004, 13세,2017,3259,1733,1526,113.6,3248,1729,1519,113.8
31012, 권선구,015005, 14세,2017,3310,1757,1553,113.1,3295,1753,1542,113.7
31012, 권선구,020,15~19세,2017,19213,10052,9161,109.7,19113,10010,9103,110
31012, 권선구,020001, 15세,2017,3367,1758,1609,109.3,3352,1755,1597,109.9
31012, 권선구,020002, 16세,2017,3775,2016,1759,114.6,3755,2006,1749,114.7
31012, 권선구,020003, 17세,2017,4096,2125,1971,107.8,4084,2119,1965,107.8
31012, 권선구,020004, 18세,2017,3984,2038,1946,104.7,3964,2031,1933,105.1
31012, 권선구,020005, 19세,2017,3991,2115,1876,112.7,3958,2099,1859,112.9
31012, 권선구,025,20~24세,2017,24979,12942,12037,107.5,24483,12667,11816,107.2
31012, 권선구,025001, 20세,2017,4507,2311,2196,105.2,4471,2295,2176,105.5
31012, 권선구,025002, 21세,2017,4861,2603,2258,115.3,4807,2579,2228,115.8
31012, 권선구,025003, 22세,2017,4966,2548,2418,105.4,4875,2499,2376,105.2
31012, 권선구,025004, 23세,2017,5150,2633,2517,104.6,5028,2553,2475,103.2
31012, 권선구,025005, 24세,2017,5495,2847,2648,107.5,5302,2741,2561,107
31012, 권선구,030,25~29세,2017,27816,14321,13495,106.1,26405,13637,12768,106.8
31012, 권선구,030001, 25세,2017,5788,2962,2826,104.8,5593,2860,2733,104.6
31012, 권선구,030002, 26세,2017,5736,2932,2804,104.6,5486,2817,2669,105.5
31012, 권선구,030003, 27세,2017,5321,2751,2570,107,5060,2638,2422,108.9
31012, 권선구,030004, 28세,2017,5516,2826,2690,105.1,5184,2665,2519,105.8
31012, 권선구,030005, 29세,2017,5455,2850,2605,109.4,5082,2657,2425,109.6
31012, 권선구,035,30~34세,2017,30051,15505,14546,106.6,28203,14503,13700,105.9
31012, 권선구,035001, 30세,2017,5740,2978,2762,107.8,5304,2726,2578,105.7
31012, 권선구,035002, 31세,2017,5626,2830,2796,101.2,5247,2638,2609,101.1
31012, 권선구,035003, 32세,2017,5887,3018,2869,105.2,5502,2815,2687,104.8
31012, 권선구,035004, 33세,2017,6156,3230,2926,110.4,5811,3035,2776,109.3
31012, 권선구,035005, 34세,2017,6642,3449,3193,108,6339,3289,3050,107.8
31012, 권선구,040,35~39세,2017,34545,18038,16507,109.3,33313,17336,15977,108.5
31012, 권선구,040001, 35세,2017,7263,3758,3505,107.2,6980,3592,3388,106
31012, 권선구,040002, 36세,2017,7355,3791,3564,106.4,7137,3670,3467,105.9
31012, 권선구,040003, 37세,2017,7216,3817,3399,112.3,6967,3671,3296,111.4
31012, 권선구,040004, 38세,2017,6673,3501,3172,110.4,6421,3361,3060,109.8
31012, 권선구,040005, 39세,2017,6038,3171,2867,110.6,5808,3042,2766,110
31012, 권선구,045,40~44세,2017,30201,15727,14474,108.7,29134,15130,14004,108
31012, 권선구,045001, 40세,2017,6058,3200,2858,112,5854,3085,2769,111.4
31012, 권선구,045002, 41세,2017,5764,3062,2702,113.3,5555,2934,2621,111.9
31012, 권선구,045003, 42세,2017,5889,3051,2838,107.5,5662,2921,2741,106.6
31012, 권선구,045004, 43세,2017,6182,3202,2980,107.4,5973,3081,2892,106.5
31012, 권선구,045005, 44세,2017,6308,3212,3096,103.7,6090,3109,2981,104.3
31012, 권선구,050,45~49세,2017,32730,16114,16616,97,31336,15398,15938,96.6
31012, 권선구,050001, 45세,2017,6207,3198,3009,106.3,5953,3053,2900,105.3
31012, 권선구,050002, 46세,2017,6654,3387,3267,103.7,6372,3228,3144,102.7
31012, 권선구,050003, 47세,2017,6227,3061,3166,96.7,5951,2924,3027,96.6
31012, 권선구,050004, 48세,2017,6841,3242,3599,90.1,6555,3110,3445,90.3
31012, 권선구,050005, 49세,2017,6801,3226,3575,90.2,6505,3083,3422,90.1
31012, 권선구,055,50~54세,2017,30950,15393,15557,98.9,29457,14647,14810,98.9
31012, 권선구,055001, 50세,2017,6277,3046,3231,94.3,6046,2921,3125,93.5
31012, 권선구,055002, 51세,2017,6155,3053,3102,98.4,5904,2927,2977,98.3
31012, 권선구,055003, 52세,2017,6426,3165,3261,97.1,6121,3014,3107,97
31012, 권선구,055004, 53세,2017,5938,2996,2942,101.8,5634,2839,2795,101.6
31012, 권선구,055005, 54세,2017,6154,3133,3021,103.7,5752,2946,2806,105
31012, 권선구,060,55~59세,2017,29462,14888,14574,102.2,28261,14281,13980,102.2
31012, 권선구,060001, 55세,2017,6104,3108,2996,103.7,5809,2967,2842,104.4
31012, 권선구,060002, 56세,2017,6633,3292,3341,98.5,6440,3193,3247,98.3
31012, 권선구,060003, 57세,2017,6289,3219,3070,104.9,6009,3072,2937,104.6
31012, 권선구,060004, 58세,2017,5520,2773,2747,100.9,5321,2672,2649,100.9
31012, 권선구,060005, 59세,2017,4916,2496,2420,103.1,4682,2377,2305,103.1
31012, 권선구,065,60~64세,2017,19160,9526,9634,98.9,18072,8954,9118,98.2
31012, 권선구,065001, 60세,2017,4580,2298,2282,100.7,4290,2141,2149,99.6
31012, 권선구,065002, 61세,2017,4150,2070,2080,99.5,3912,1950,1962,99.4
31012, 권선구,065003, 62세,2017,4136,2070,2066,100.2,3918,1962,1956,100.3
31012, 권선구,065004, 63세,2017,3342,1644,1698,96.8,3160,1544,1616,95.5
31012, 권선구,065005, 64세,2017,2952,1444,1508,95.8,2792,1357,1435,94.6
31012, 권선구,070,65~69세,2017,11868,5825,6043,96.4,11405,5613,5792,96.9
31012, 권선구,070001, 65세,2017,3151,1590,1561,101.9,3013,1533,1480,103.6
31012, 권선구,070002, 66세,2017,2091,1011,1080,93.6,1982,963,1019,94.5
31012, 권선구,070003, 67세,2017,2265,1097,1168,93.9,2170,1050,1120,93.8
31012, 권선구,070004, 68세,2017,2202,1086,1116,97.3,2132,1049,1083,96.9
31012, 권선구,070005, 69세,2017,2159,1041,1118,93.1,2108,1018,1090,93.4
31012, 권선구,075,70~74세,2017,8420,3948,4472,88.3,8286,3896,4390,88.7
31012, 권선구,075001, 70세,2017,2192,1056,1136,93,2148,1040,1108,93.9
31012, 권선구,075002, 71세,2017,1617,759,858,88.5,1591,748,843,88.7
31012, 권선구,075003, 72세,2017,1578,759,819,92.7,1555,750,805,93.2
31012, 권선구,075004, 73세,2017,1573,730,843,86.6,1550,721,829,87
31012, 권선구,075005, 74세,2017,1460,644,816,78.9,1442,637,805,79.1
31012, 권선구,080,75~79세,2017,6503,2666,3837,69.5,6427,2649,3778,70.1
31012, 권선구,080001, 75세,2017,1625,746,879,84.9,1605,737,868,84.9
31012, 권선구,080002, 76세,2017,1384,563,821,68.6,1363,560,803,69.7
31012, 권선구,080003, 77세,2017,1168,446,722,61.8,1154,444,710,62.5
31012, 권선구,080004, 78세,2017,1239,490,749,65.4,1230,489,741,66
31012, 권선구,080005, 79세,2017,1087,421,666,63.2,1075,419,656,63.9
31012, 권선구,085,80~84세,2017,3913,1359,2554,53.2,3863,1348,2515,53.6
31012, 권선구,085001, 80세,2017,971,354,617,57.4,954,349,605,57.7
31012, 권선구,085002, 81세,2017,853,309,544,56.8,846,307,539,57
31012, 권선구,085003, 82세,2017,798,265,533,49.7,792,264,528,50
31012, 권선구,085004, 83세,2017,707,251,456,55,696,250,446,56.1
31012, 권선구,085005, 84세,2017,584,180,404,44.6,575,178,397,44.8
31012, 권선구,090,85~89세,2017,1815,493,1322,37.3,1808,491,1317,37.3
31012, 권선구,090001, 85세,2017,492,150,342,43.9,491,149,342,43.6
31012, 권선구,090002, 86세,2017,380,110,270,40.7,378,110,268,41
31012, 권선구,090003, 87세,2017,368,86,282,30.5,367,85,282,30.1
31012, 권선구,090004, 88세,2017,320,86,234,36.8,318,86,232,37.1
31012, 권선구,090005, 89세,2017,255,61,194,31.4,254,61,193,31.6
31012, 권선구,095,90~94세,2017,588,133,455,29.2,585,132,453,29.1
31012, 권선구,095001, 90세,2017,196,52,144,36.1,196,52,144,36.1
31012, 권선구,095002, 91세,2017,132,32,100,32,130,31,99,31.3
31012, 권선구,095003, 92세,2017,107,15,92,16.3,107,15,92,16.3
31012, 권선구,095004, 93세,2017,70,19,51,37.3,69,19,50,38
31012, 권선구,095005, 94세,2017,83,15,68,22.1,83,15,68,22.1
31012, 권선구,100,95~99세,2017,134,23,111,20.7,134,23,111,20.7
31012, 권선구,100001, 95세,2017,48,11,37,29.7,48,11,37,29.7
31012, 권선구,100002, 96세,2017,45,X,42,7.1,45,X,42,7.1
31012, 권선구,100003, 97세,2017,22,5,17,29.4,22,5,17,29.4
31012, 권선구,100004, 98세,2017,13,X,10,30,13,X,10,30
31012, 권선구,100005, 99세,2017,6,X,5,20,6,X,5,20
31012, 권선구,101,100세이상,2017,12,X,11,9.1,12,X,11,9.1
31012, 권선구,102,15세미만,2017,52290,26959,25331,106.4,51612,26628,24984,106.6
31012, 권선구,103,15~64세,2017,279107,142506,136601,104.3,267777,136563,131214,104.1
31012, 권선구,104,65세이상,2017,33253,14448,18805,76.8,32520,14153,18367,77.1
31012, 권선구,086,85세이상,2017,2549,650,1899,34.2,2539,647,1892,34.2
31012, 권선구,126,평균연령,2017,38.7,38,39.5,,38.6,37.8,39.4,
31012, 권선구,127,중위연령,2017,38.9,38.2,39.8,,38.8,38.1,39.6,
31013, 팔달구,000,합계,2017,206092,104339,101753,102.5,187184,94215,92969,101.3
31013, 팔달구,005,0~4세,2017,7154,3679,3475,105.9,6577,3393,3184,106.6
31013, 팔달구,005001, 0세,2017,1334,675,659,102.4,1223,619,604,102.5
31013, 팔달구,005002, 1세,2017,1492,759,733,103.5,1342,688,654,105.2
31013, 팔달구,005003, 2세,2017,1492,765,727,105.2,1375,702,673,104.3
31013, 팔달구,005004, 3세,2017,1455,761,694,109.7,1344,713,631,113
31013, 팔달구,005005, 4세,2017,1381,719,662,108.6,1293,671,622,107.9
31013, 팔달구,010,5~9세,2017,7125,3729,3396,109.8,6857,3592,3265,110
31013, 팔달구,010001, 5세,2017,1499,766,733,104.5,1420,723,697,103.7
31013, 팔달구,010002, 6세,2017,1412,742,670,110.7,1357,718,639,112.4
31013, 팔달구,010003, 7세,2017,1381,722,659,109.6,1340,700,640,109.4
31013, 팔달구,010004, 8세,2017,1328,715,613,116.6,1276,690,586,117.7
31013, 팔달구,010005, 9세,2017,1505,784,721,108.7,1464,761,703,108.3
31013, 팔달구,015,10~14세,2017,7319,3730,3589,103.9,7198,3678,3520,104.5
31013, 팔달구,015001, 10세,2017,1465,744,721,103.2,1438,733,705,104
31013, 팔달구,015002, 11세,2017,1361,683,678,100.7,1326,674,652,103.4
31013, 팔달구,015003, 12세,2017,1356,670,686,97.7,1337,663,674,98.4
31013, 팔달구,015004, 13세,2017,1566,795,771,103.1,1542,779,763,102.1
31013, 팔달구,015005, 14세,2017,1571,838,733,114.3,1555,829,726,114.2
31013, 팔달구,020,15~19세,2017,9905,5168,4737,109.1,9772,5096,4676,109
31013, 팔달구,020001, 15세,2017,1661,861,800,107.6,1643,852,791,107.7
31013, 팔달구,020002, 16세,2017,1956,1028,928,110.8,1935,1015,920,110.3
31013, 팔달구,020003, 17세,2017,2130,1119,1011,110.7,2100,1104,996,110.8
31013, 팔달구,020004, 18세,2017,2081,1104,977,113,2051,1086,965,112.5
31013, 팔달구,020005, 19세,2017,2077,1056,1021,103.4,2043,1039,1004,103.5
31013, 팔달구,025,20~24세,2017,13514,7020,6494,108.1,12978,6764,6214,108.9
31013, 팔달구,025001, 20세,2017,2301,1232,1069,115.2,2237,1197,1040,115.1
31013, 팔달구,025002, 21세,2017,2505,1334,1171,113.9,2430,1295,1135,114.1
31013, 팔달구,025003, 22세,2017,2666,1371,1295,105.9,2566,1332,1234,107.9
31013, 팔달구,025004, 23세,2017,2899,1437,1462,98.3,2795,1390,1405,98.9
31013, 팔달구,025005, 24세,2017,3143,1646,1497,110,2950,1550,1400,110.7
31013, 팔달구,030,25~29세,2017,16914,8896,8018,111,15039,7888,7151,110.3
31013, 팔달구,030001, 25세,2017,3382,1761,1621,108.6,3156,1641,1515,108.3
31013, 팔달구,030002, 26세,2017,3353,1752,1601,109.4,3084,1611,1473,109.4
31013, 팔달구,030003, 27세,2017,3373,1765,1608,109.8,2919,1518,1401,108.4
31013, 팔달구,030004, 28세,2017,3455,1844,1611,114.5,2984,1586,1398,113.4
31013, 팔달구,030005, 29세,2017,3351,1774,1577,112.5,2896,1532,1364,112.3
31013, 팔달구,035,30~34세,2017,16219,8807,7412,118.8,14020,7558,6462,117
31013, 팔달구,035001, 30세,2017,3269,1783,1486,120,2823,1520,1303,116.7
31013, 팔달구,035002, 31세,2017,3291,1802,1489,121,2764,1515,1249,121.3
31013, 팔달구,035003, 32세,2017,3136,1650,1486,111,2706,1419,1287,110.3
31013, 팔달구,035004, 33세,2017,3184,1765,1419,124.4,2783,1522,1261,120.7
31013, 팔달구,035005, 34세,2017,3339,1807,1532,118,2944,1582,1362,116.2
31013, 팔달구,040,35~39세,2017,16678,8888,7790,114.1,14949,7850,7099,110.6
31013, 팔달구,040001, 35세,2017,3555,1872,1683,111.2,3152,1641,1511,108.6
31013, 팔달구,040002, 36세,2017,3457,1821,1636,111.3,3150,1634,1516,107.8
31013, 팔달구,040003, 37세,2017,3413,1848,1565,118.1,3085,1650,1435,115
31013, 팔달구,040004, 38세,2017,3281,1763,1518,116.1,2924,1542,1382,111.6
31013, 팔달구,040005, 39세,2017,2972,1584,1388,114.1,2638,1383,1255,110.2
31013, 팔달구,045,40~44세,2017,16213,8445,7768,108.7,14699,7582,7117,106.5
31013, 팔달구,045001, 40세,2017,3055,1574,1481,106.3,2746,1402,1344,104.3
31013, 팔달구,045002, 41세,2017,3013,1582,1431,110.6,2735,1421,1314,108.1
31013, 팔달구,045003, 42세,2017,3206,1674,1532,109.3,2922,1501,1421,105.6
31013, 팔달구,045004, 43세,2017,3446,1805,1641,110,3154,1642,1512,108.6
31013, 팔달구,045005, 44세,2017,3493,1810,1683,107.5,3142,1616,1526,105.9
31013, 팔달구,050,45~49세,2017,18799,9596,9203,104.3,16565,8361,8204,101.9
31013, 팔달구,050001, 45세,2017,3459,1832,1627,112.6,3017,1580,1437,110
31013, 팔달구,050002, 46세,2017,3878,1997,1881,106.2,3406,1730,1676,103.2
31013, 팔달구,050003, 47세,2017,3778,1966,1812,108.5,3317,1727,1590,108.6
31013, 팔달구,050004, 48세,2017,3796,1917,1879,102,3350,1668,1682,99.2
31013, 팔달구,050005, 49세,2017,3888,1884,2004,94,3475,1656,1819,91
31013, 팔달구,055,50~54세,2017,18400,9328,9072,102.8,15744,7935,7809,101.6
31013, 팔달구,055001, 50세,2017,3478,1757,1721,102.1,3104,1549,1555,99.6
31013, 팔달구,055002, 51세,2017,3582,1817,1765,102.9,3061,1553,1508,103
31013, 팔달구,055003, 52세,2017,3699,1899,1800,105.5,3148,1622,1526,106.3
31013, 팔달구,055004, 53세,2017,3702,1901,1801,105.6,3156,1608,1548,103.9
31013, 팔달구,055005, 54세,2017,3939,1954,1985,98.4,3275,1603,1672,95.9
31013, 팔달구,060,55~59세,2017,18446,9338,9108,102.5,16455,8300,8155,101.8
31013, 팔달구,060001, 55세,2017,3750,1898,1852,102.5,3245,1645,1600,102.8
31013, 팔달구,060002, 56세,2017,3994,2001,1993,100.4,3716,1863,1853,100.5
31013, 팔달구,060003, 57세,2017,3922,1959,1963,99.8,3480,1722,1758,98
31013, 팔달구,060004, 58세,2017,3484,1783,1701,104.8,3128,1590,1538,103.4
31013, 팔달구,060005, 59세,2017,3296,1697,1599,106.1,2886,1480,1406,105.3
31013, 팔달구,065,60~64세,2017,13690,6625,7065,93.8,11850,5692,6158,92.4
31013, 팔달구,065001, 60세,2017,3193,1578,1615,97.7,2713,1349,1364,98.9
31013, 팔달구,065002, 61세,2017,2919,1446,1473,98.2,2521,1231,1290,95.4
31013, 팔달구,065003, 62세,2017,2946,1399,1547,90.4,2559,1195,1364,87.6
31013, 팔달구,065004, 63세,2017,2557,1229,1328,92.5,2225,1059,1166,90.8
31013, 팔달구,065005, 64세,2017,2075,973,1102,88.3,1832,858,974,88.1
31013, 팔달구,070,65~69세,2017,9092,4399,4693,93.7,8312,3992,4320,92.4
31013, 팔달구,070001, 65세,2017,2321,1127,1194,94.4,2103,1009,1094,92.2
31013, 팔달구,070002, 66세,2017,1580,772,808,95.5,1386,675,711,94.9
31013, 팔달구,070003, 67세,2017,1764,871,893,97.5,1609,783,826,94.8
31013, 팔달구,070004, 68세,2017,1704,823,881,93.4,1575,763,812,94
31013, 팔달구,070005, 69세,2017,1723,806,917,87.9,1639,762,877,86.9
31013, 팔달구,075,70~74세,2017,6579,2943,3636,80.9,6350,2849,3501,81.4
31013, 팔달구,075001, 70세,2017,1655,715,940,76.1,1571,678,893,75.9
31013, 팔달구,075002, 71세,2017,1276,608,668,91,1233,590,643,91.8
31013, 팔달구,075003, 72세,2017,1212,565,647,87.3,1173,548,625,87.7
31013, 팔달구,075004, 73세,2017,1222,532,690,77.1,1188,520,668,77.8
31013, 팔달구,075005, 74세,2017,1214,523,691,75.7,1185,513,672,76.3
31013, 팔달구,080,75~79세,2017,5200,2214,2986,74.1,5077,2180,2897,75.3
31013, 팔달구,080001, 75세,2017,1378,618,760,81.3,1353,613,740,82.8
31013, 팔달구,080002, 76세,2017,1112,472,640,73.8,1087,464,623,74.5
31013, 팔달구,080003, 77세,2017,959,398,561,70.9,936,390,546,71.4
31013, 팔달구,080004, 78세,2017,939,382,557,68.6,909,374,535,69.9
31013, 팔달구,080005, 79세,2017,812,344,468,73.5,792,339,453,74.8
31013, 팔달구,085,80~84세,2017,2954,1056,1898,55.6,2881,1034,1847,56
31013, 팔달구,085001, 80세,2017,731,278,453,61.4,711,270,441,61.2
31013, 팔달구,085002, 81세,2017,693,242,451,53.7,671,237,434,54.6
31013, 팔달구,085003, 82세,2017,602,222,380,58.4,586,218,368,59.2
31013, 팔달구,085004, 83세,2017,510,178,332,53.6,501,174,327,53.2
31013, 팔달구,085005, 84세,2017,418,136,282,48.2,412,135,277,48.7
31013, 팔달구,090,85~89세,2017,1326,345,981,35.2,1300,339,961,35.3
31013, 팔달구,090001, 85세,2017,384,114,270,42.2,378,113,265,42.6
31013, 팔달구,090002, 86세,2017,281,69,212,32.5,273,65,208,31.3
31013, 팔달구,090003, 87세,2017,241,68,173,39.3,235,68,167,40.7
31013, 팔달구,090004, 88세,2017,240,56,184,30.4,235,56,179,31.3
31013, 팔달구,090005, 89세,2017,180,38,142,26.8,179,37,142,26.1
31013, 팔달구,095,90~94세,2017,452,110,342,32.2,449,109,340,32.1
31013, 팔달구,095001, 90세,2017,142,37,105,35.2,140,36,104,34.6
31013, 팔달구,095002, 91세,2017,104,22,82,26.8,103,22,81,27.2
31013, 팔달구,095003, 92세,2017,78,10,68,14.7,78,10,68,14.7
31013, 팔달구,095004, 93세,2017,62,18,44,40.9,62,18,44,40.9
31013, 팔달구,095005, 94세,2017,66,23,43,53.5,66,23,43,53.5
31013, 팔달구,100,95~99세,2017,104,23,81,28.4,104,23,81,28.4
31013, 팔달구,100001, 95세,2017,52,12,40,30,52,12,40,30
31013, 팔달구,100002, 96세,2017,28,8,20,40,28,8,20,40
31013, 팔달구,100003, 97세,2017,15,X,14,7.1,15,X,14,7.1
31013, 팔달구,100004, 98세,2017,5,X,X,66.7,5,X,X,66.7
31013, 팔달구,100005, 99세,2017,X,X,X,0,X,X,X,0
31013, 팔달구,101,100세이상,2017,9,X,9,0,8,X,8,0
31013, 팔달구,102,15세미만,2017,21598,11138,10460,106.5,20632,10663,9969,107
31013, 팔달구,103,15~64세,2017,158778,82111,76667,107.1,142071,73026,69045,105.8
31013, 팔달구,104,65세이상,2017,25716,11090,14626,75.8,24481,10526,13955,75.4
31013, 팔달구,086,85세이상,2017,1891,478,1413,33.8,1861,471,1390,33.9
31013, 팔달구,126,평균연령,2017,41.8,40.8,42.9,,41.6,40.5,42.7,
31013, 팔달구,127,중위연령,2017,42.7,41.4,43.9,,42.2,40.9,43.6,
31014, 영통구,000,합계,2017,350818,177778,173040,102.7,342310,173130,169180,102.3
31014, 영통구,005,0~4세,2017,19449,10049,9400,106.9,19094,9868,9226,107
31014, 영통구,005001, 0세,2017,3434,1806,1628,110.9,3363,1771,1592,111.2
31014, 영통구,005002, 1세,2017,3957,2045,1912,107,3877,1998,1879,106.3
31014, 영통구,005003, 2세,2017,4192,2128,2064,103.1,4126,2097,2029,103.4
31014, 영통구,005004, 3세,2017,3915,2004,1911,104.9,3849,1968,1881,104.6
31014, 영통구,005005, 4세,2017,3951,2066,1885,109.6,3879,2034,1845,110.2
31014, 영통구,010,5~9세,2017,20454,10500,9954,105.5,20234,10377,9857,105.3
31014, 영통구,010001, 5세,2017,4302,2198,2104,104.5,4241,2168,2073,104.6
31014, 영통구,010002, 6세,2017,4151,2142,2009,106.6,4097,2112,1985,106.4
31014, 영통구,010003, 7세,2017,3963,2081,1882,110.6,3929,2060,1869,110.2
31014, 영통구,010004, 8세,2017,3907,1988,1919,103.6,3866,1965,1901,103.4
31014, 영통구,010005, 9세,2017,4131,2091,2040,102.5,4101,2072,2029,102.1
31014, 영통구,015,10~14세,2017,19849,10150,9699,104.6,19766,10101,9665,104.5
31014, 영통구,015001, 10세,2017,4201,2173,2028,107.1,4182,2161,2021,106.9
31014, 영통구,015002, 11세,2017,3742,1932,1810,106.7,3720,1920,1800,106.7
31014, 영통구,015003, 12세,2017,3722,1885,1837,102.6,3706,1875,1831,102.4
31014, 영통구,015004, 13세,2017,4080,2078,2002,103.8,4065,2070,1995,103.8
31014, 영통구,015005, 14세,2017,4104,2082,2022,103,4093,2075,2018,102.8
31014, 영통구,020,15~19세,2017,23837,12317,11520,106.9,23536,12209,11327,107.8
31014, 영통구,020001, 15세,2017,4004,2019,1985,101.7,3990,2013,1977,101.8
31014, 영통구,020002, 16세,2017,4601,2420,2181,111,4589,2414,2175,111
31014, 영통구,020003, 17세,2017,5143,2641,2502,105.6,5125,2638,2487,106.1
31014, 영통구,020004, 18세,2017,4848,2533,2315,109.4,4791,2511,2280,110.1
31014, 영통구,020005, 19세,2017,5241,2704,2537,106.6,5041,2633,2408,109.3
31014, 영통구,025,20~24세,2017,27459,14188,13271,106.9,26356,13620,12736,106.9
31014, 영통구,025001, 20세,2017,4977,2582,2395,107.8,4779,2479,2300,107.8
31014, 영통구,025002, 21세,2017,5192,2657,2535,104.8,4986,2558,2428,105.4
31014, 영통구,025003, 22세,2017,5537,2946,2591,113.7,5309,2843,2466,115.3
31014, 영통구,025004, 23세,2017,5755,2941,2814,104.5,5525,2807,2718,103.3
31014, 영통구,025005, 24세,2017,5998,3062,2936,104.3,5757,2933,2824,103.9
31014, 영통구,030,25~29세,2017,29734,16142,13592,118.8,28401,15399,13002,118.4
31014, 영통구,030001, 25세,2017,6265,3365,2900,116,5995,3211,2784,115.3
31014, 영통구,030002, 26세,2017,6059,3338,2721,122.7,5804,3197,2607,122.6
31014, 영통구,030003, 27세,2017,5886,3247,2639,123,5593,3082,2511,122.7
31014, 영통구,030004, 28세,2017,5782,3144,2638,119.2,5544,3014,2530,119.1
31014, 영통구,030005, 29세,2017,5742,3048,2694,113.1,5465,2895,2570,112.6
31014, 영통구,035,30~34세,2017,30031,15693,14338,109.5,28719,14947,13772,108.5
31014, 영통구,035001, 30세,2017,5792,3072,2720,112.9,5490,2898,2592,111.8
31014, 영통구,035002, 31세,2017,5804,3079,2725,113,5532,2928,2604,112.4
31014, 영통구,035003, 32세,2017,5967,3070,2897,106,5702,2924,2778,105.3
31014, 영통구,035004, 33세,2017,5871,3014,2857,105.5,5611,2860,2751,104
31014, 영통구,035005, 34세,2017,6597,3458,3139,110.2,6384,3337,3047,109.5
31014, 영통구,040,35~39세,2017,34274,17212,17062,100.9,33335,16624,16711,99.5
31014, 영통구,040001, 35세,2017,7162,3617,3545,102,6930,3472,3458,100.4
31014, 영통구,040002, 36세,2017,7101,3566,3535,100.9,6925,3451,3474,99.3
31014, 영통구,040003, 37세,2017,7087,3503,3584,97.7,6891,3390,3501,96.8
31014, 영통구,040004, 38세,2017,6767,3376,3391,99.6,6584,3255,3329,97.8
31014, 영통구,040005, 39세,2017,6157,3150,3007,104.8,6005,3056,2949,103.6
31014, 영통구,045,40~44세,2017,32633,16016,16617,96.4,31978,15588,16390,95.1
31014, 영통구,045001, 40세,2017,6447,3226,3221,100.2,6293,3124,3169,98.6
31014, 영통구,045002, 41세,2017,6296,3136,3160,99.2,6170,3054,3116,98
31014, 영통구,045003, 42세,2017,6329,3135,3194,98.2,6212,3064,3148,97.3
31014, 영통구,045004, 43세,2017,6706,3209,3497,91.8,6576,3116,3460,90.1
31014, 영통구,045005, 44세,2017,6855,3310,3545,93.4,6727,3230,3497,92.4
31014, 영통구,050,45~49세,2017,33547,16745,16802,99.7,32896,16369,16527,99
31014, 영통구,050001, 45세,2017,6785,3403,3382,100.6,6640,3314,3326,99.6
31014, 영통구,050002, 46세,2017,7091,3592,3499,102.7,6958,3516,3442,102.1
31014, 영통구,050003, 47세,2017,6689,3365,3324,101.2,6544,3279,3265,100.4
31014, 영통구,050004, 48세,2017,6685,3307,3378,97.9,6569,3241,3328,97.4
31014, 영통구,050005, 49세,2017,6297,3078,3219,95.6,6185,3019,3166,95.4
31014, 영통구,055,50~54세,2017,25953,13128,12825,102.4,25380,12830,12550,102.2
31014, 영통구,055001, 50세,2017,5578,2755,2823,97.6,5487,2701,2786,96.9
31014, 영통구,055002, 51세,2017,5192,2608,2584,100.9,5080,2549,2531,100.7
31014, 영통구,055003, 52세,2017,5321,2688,2633,102.1,5192,2620,2572,101.9
31014, 영통구,055004, 53세,2017,4815,2442,2373,102.9,4711,2391,2320,103.1
31014, 영통구,055005, 54세,2017,5047,2635,2412,109.2,4910,2569,2341,109.7
31014, 영통구,060,55~59세,2017,21083,11046,10037,110.1,20703,10859,9844,110.3
31014, 영통구,060001, 55세,2017,4755,2444,2311,105.8,4653,2405,2248,107
31014, 영통구,060002, 56세,2017,4793,2482,2311,107.4,4723,2445,2278,107.3
31014, 영통구,060003, 57세,2017,4461,2355,2106,111.8,4383,2307,2076,111.1
31014, 영통구,060004, 58세,2017,3669,1971,1698,116.1,3598,1937,1661,116.6
31014, 영통구,060005, 59세,2017,3405,1794,1611,111.4,3346,1765,1581,111.6
31014, 영통구,065,60~64세,2017,11858,5931,5927,100.1,11521,5777,5744,100.6
31014, 영통구,065001, 60세,2017,2987,1527,1460,104.6,2896,1481,1415,104.7
31014, 영통구,065002, 61세,2017,2636,1359,1277,106.4,2554,1319,1235,106.8
31014, 영통구,065003, 62세,2017,2529,1253,1276,98.2,2465,1226,1239,99
31014, 영통구,065004, 63세,2017,1970,966,1004,96.2,1919,944,975,96.8
31014, 영통구,065005, 64세,2017,1736,826,910,90.8,1687,807,880,91.7
31014, 영통구,070,65~69세,2017,7240,3489,3751,93,7075,3424,3651,93.8
31014, 영통구,070001, 65세,2017,1882,930,952,97.7,1840,911,929,98.1
31014, 영통구,070002, 66세,2017,1227,597,630,94.8,1179,579,600,96.5
31014, 영통구,070003, 67세,2017,1426,682,744,91.7,1393,670,723,92.7
31014, 영통구,070004, 68세,2017,1383,661,722,91.6,1357,651,706,92.2
31014, 영통구,070005, 69세,2017,1322,619,703,88.1,1306,613,693,88.5
31014, 영통구,075,70~74세,2017,5108,2283,2825,80.8,5053,2261,2792,81
31014, 영통구,075001, 70세,2017,1266,594,672,88.4,1248,586,662,88.5
31014, 영통구,075002, 71세,2017,1011,471,540,87.2,997,467,530,88.1
31014, 영통구,075003, 72세,2017,973,440,533,82.6,963,437,526,83.1
31014, 영통구,075004, 73세,2017,916,385,531,72.5,909,380,529,71.8
31014, 영통구,075005, 74세,2017,942,393,549,71.6,936,391,545,71.7
31014, 영통구,080,75~79세,2017,4067,1610,2457,65.5,4050,1605,2445,65.6
31014, 영통구,080001, 75세,2017,1047,429,618,69.4,1043,427,616,69.3
31014, 영통구,080002, 76세,2017,860,346,514,67.3,854,346,508,68.1
31014, 영통구,080003, 77세,2017,764,320,444,72.1,762,319,443,72
31014, 영통구,080004, 78세,2017,709,265,444,59.7,706,265,441,60.1
31014, 영통구,080005, 79세,2017,687,250,437,57.2,685,248,437,56.8
31014, 영통구,085,80~84세,2017,2543,836,1707,49,2522,831,1691,49.1
31014, 영통구,085001, 80세,2017,626,218,408,53.4,619,216,403,53.6
31014, 영통구,085002, 81세,2017,557,187,370,50.5,555,187,368,50.8
31014, 영통구,085003, 82세,2017,530,172,358,48,526,170,356,47.8
31014, 영통구,085004, 83세,2017,447,143,304,47,443,143,300,47.7
31014, 영통구,085005, 84세,2017,383,116,267,43.4,379,115,264,43.6
31014, 영통구,090,85~89세,2017,1219,332,887,37.4,1213,331,882,37.5
31014, 영통구,090001, 85세,2017,348,117,231,50.6,345,116,229,50.7
31014, 영통구,090002, 86세,2017,247,64,183,35,246,64,182,35.2
31014, 영통구,090003, 87세,2017,265,62,203,30.5,263,62,201,30.8
31014, 영통구,090004, 88세,2017,197,54,143,37.8,197,54,143,37.8
31014, 영통구,090005, 89세,2017,162,35,127,27.6,162,35,127,27.6
31014, 영통구,095,90~94세,2017,378,91,287,31.7,376,90,286,31.5
31014, 영통구,095001, 90세,2017,120,36,84,42.9,120,36,84,42.9
31014, 영통구,095002, 91세,2017,93,17,76,22.4,92,17,75,22.7
31014, 영통구,095003, 92세,2017,66,16,50,32,66,16,50,32
31014, 영통구,095004, 93세,2017,60,12,48,25,60,12,48,25
31014, 영통구,095005, 94세,2017,39,10,29,34.5,38,9,29,31
31014, 영통구,100,95~99세,2017,91,17,74,23,91,17,74,23
31014, 영통구,100001, 95세,2017,36,8,28,28.6,36,8,28,28.6
31014, 영통구,100002, 96세,2017,22,X,18,22.2,22,X,18,22.2
31014, 영통구,100003, 97세,2017,14,X,12,16.7,14,X,12,16.7
31014, 영통구,100004, 98세,2017,14,X,12,16.7,14,X,12,16.7
31014, 영통구,100005, 99세,2017,5,X,X,25,5,X,X,25
31014, 영통구,101,100세이상,2017,11,X,8,37.5,11,X,8,37.5
31014, 영통구,102,15세미만,2017,59752,30699,29053,105.7,59094,30346,28748,105.6
31014, 영통구,103,15~64세,2017,270409,138418,131991,104.9,262825,134222,128603,104.4
31014, 영통구,104,65세이상,2017,20657,8661,11996,72.2,20391,8562,11829,72.4
31014, 영통구,086,85세이상,2017,1699,443,1256,35.3,1691,441,1250,35.3
31014, 영통구,126,평균연령,2017,35.3,34.7,36,,35.3,34.7,36,
31014, 영통구,127,중위연령,2017,35.6,35,36.3,,35.7,35,36.4,
31020, 성남시,000,합계,2017,944297,467176,477121,97.9,921073,455877,465196,98
31020, 성남시,005,0~4세,2017,38223,19562,18661,104.8,37717,19315,18402,105
31020, 성남시,005001, 0세,2017,7090,3686,3404,108.3,6992,3640,3352,108.6
31020, 성남시,005002, 1세,2017,7583,3863,3720,103.8,7459,3794,3665,103.5
31020, 성남시,005003, 2세,2017,7858,4048,3810,106.2,7764,4006,3758,106.6
31020, 성남시,005004, 3세,2017,7824,3969,3855,103,7719,3916,3803,103
31020, 성남시,005005, 4세,2017,7868,3996,3872,103.2,7783,3959,3824,103.5
31020, 성남시,010,5~9세,2017,40567,20888,19679,106.1,40288,20746,19542,106.2
31020, 성남시,010001, 5세,2017,8235,4296,3939,109.1,8156,4262,3894,109.5
31020, 성남시,010002, 6세,2017,8243,4263,3980,107.1,8196,4240,3956,107.2
31020, 성남시,010003, 7세,2017,8095,4133,3962,104.3,8040,4105,3935,104.3
31020, 성남시,010004, 8세,2017,7831,3996,3835,104.2,7780,3964,3816,103.9
31020, 성남시,010005, 9세,2017,8163,4200,3963,106,8116,4175,3941,105.9
31020, 성남시,015,10~14세,2017,41905,21637,20268,106.8,41693,21526,20167,106.7
31020, 성남시,015001, 10세,2017,8605,4473,4132,108.3,8548,4448,4100,108.5
31020, 성남시,015002, 11세,2017,7817,3998,3819,104.7,7771,3967,3804,104.3
31020, 성남시,015003, 12세,2017,7764,3961,3803,104.2,7724,3941,3783,104.2
31020, 성남시,015004, 13세,2017,8818,4588,4230,108.5,8774,4566,4208,108.5
31020, 성남시,015005, 14세,2017,8901,4617,4284,107.8,8876,4604,4272,107.8
31020, 성남시,020,15~19세,2017,52196,26529,25667,103.4,51853,26361,25492,103.4
31020, 성남시,020001, 15세,2017,8926,4632,4294,107.9,8888,4613,4275,107.9
31020, 성남시,020002, 16세,2017,10272,5250,5022,104.5,10237,5234,5003,104.6
31020, 성남시,020003, 17세,2017,11229,5631,5598,100.6,11179,5606,5573,100.6
31020, 성남시,020004, 18세,2017,10861,5501,5360,102.6,10780,5454,5326,102.4
31020, 성남시,020005, 19세,2017,10908,5515,5393,102.3,10769,5454,5315,102.6
31020, 성남시,025,20~24세,2017,60450,31036,29414,105.5,58975,30347,28628,106
31020, 성남시,025001, 20세,2017,11126,5686,5440,104.5,10948,5614,5334,105.2
31020, 성남시,025002, 21세,2017,11770,6164,5606,110,11509,6049,5460,110.8
31020, 성남시,025003, 22세,2017,11869,6200,5669,109.4,11541,6042,5499,109.9
31020, 성남시,025004, 23세,2017,12607,6340,6267,101.2,12278,6197,6081,101.9
31020, 성남시,025005, 24세,2017,13078,6646,6432,103.3,12699,6445,6254,103.1
31020, 성남시,030,25~29세,2017,67618,34026,33592,101.3,65088,32852,32236,101.9
31020, 성남시,030001, 25세,2017,14084,7061,7023,100.5,13636,6862,6774,101.3
31020, 성남시,030002, 26세,2017,13732,6863,6869,99.9,13285,6648,6637,100.2
31020, 성남시,030003, 27세,2017,13295,6713,6582,102,12779,6485,6294,103
31020, 성남시,030004, 28세,2017,13357,6797,6560,103.6,12790,6519,6271,104
31020, 성남시,030005, 29세,2017,13150,6592,6558,100.5,12598,6338,6260,101.2
31020, 성남시,035,30~34세,2017,70023,35495,34528,102.8,67402,34151,33251,102.7
31020, 성남시,035001, 30세,2017,13400,6771,6629,102.1,12793,6450,6343,101.7
31020, 성남시,035002, 31세,2017,13327,6731,6596,102,12768,6449,6319,102.1
31020, 성남시,035003, 32세,2017,13824,6998,6826,102.5,13333,6754,6579,102.7
31020, 성남시,035004, 33세,2017,14133,7183,6950,103.4,13614,6920,6694,103.4
31020, 성남시,035005, 34세,2017,15339,7812,7527,103.8,14894,7578,7316,103.6
31020, 성남시,040,35~39세,2017,78537,39446,39091,100.9,76440,38309,38131,100.5
31020, 성남시,040001, 35세,2017,16325,8274,8051,102.8,15814,8015,7799,102.8
31020, 성남시,040002, 36세,2017,16284,8252,8032,102.7,15874,8018,7856,102.1
31020, 성남시,040003, 37세,2017,16350,8171,8179,99.9,15966,7959,8007,99.4
31020, 성남시,040004, 38세,2017,15585,7829,7756,100.9,15161,7602,7559,100.6
31020, 성남시,040005, 39세,2017,13993,6920,7073,97.8,13625,6715,6910,97.2
31020, 성남시,045,40~44세,2017,77568,38497,39071,98.5,75706,37505,38201,98.2
31020, 성남시,045001, 40세,2017,14613,7339,7274,100.9,14256,7156,7100,100.8
31020, 성남시,045002, 41세,2017,14441,7279,7162,101.6,14088,7081,7007,101.1
31020, 성남시,045003, 42세,2017,15188,7541,7647,98.6,14824,7347,7477,98.3
31020, 성남시,045004, 43세,2017,16344,8062,8282,97.3,15981,7871,8110,97.1
31020, 성남시,045005, 44세,2017,16982,8276,8706,95.1,16557,8050,8507,94.6
31020, 성남시,050,45~49세,2017,89868,44770,45098,99.3,87232,43424,43808,99.1
31020, 성남시,050001, 45세,2017,17534,8728,8806,99.1,17051,8468,8583,98.7
31020, 성남시,050002, 46세,2017,18891,9517,9374,101.5,18356,9223,9133,101
31020, 성남시,050003, 47세,2017,18099,9107,8992,101.3,17573,8843,8730,101.3
31020, 성남시,050004, 48세,2017,18005,8906,9099,97.9,17477,8648,8829,97.9
31020, 성남시,050005, 49세,2017,17339,8512,8827,96.4,16775,8242,8533,96.6
31020, 성남시,055,50~54세,2017,78477,39165,39312,99.6,75579,37808,37771,100.1
31020, 성남시,055001, 50세,2017,16013,7939,8074,98.3,15536,7705,7831,98.4
31020, 성남시,055002, 51세,2017,15416,7781,7635,101.9,14872,7537,7335,102.8
31020, 성남시,055003, 52세,2017,15891,7940,7951,99.9,15314,7660,7654,100.1
31020, 성남시,055004, 53세,2017,15265,7565,7700,98.2,14701,7301,7400,98.7
31020, 성남시,055005, 54세,2017,15892,7940,7952,99.8,15156,7605,7551,100.7
31020, 성남시,060,55~59세,2017,77959,38463,39496,97.4,75722,37468,38254,97.9
31020, 성남시,060001, 55세,2017,15609,7727,7882,98,15072,7493,7579,98.9
31020, 성남시,060002, 56세,2017,16802,8092,8710,92.9,16472,7941,8531,93.1
31020, 성남시,060003, 57세,2017,16631,8125,8506,95.5,16105,7895,8210,96.2
31020, 성남시,060004, 58세,2017,14871,7329,7542,97.2,14473,7153,7320,97.7
31020, 성남시,060005, 59세,2017,14046,7190,6856,104.9,13600,6986,6614,105.6
31020, 성남시,065,60~64세,2017,57873,28465,29408,96.8,55823,27473,28350,96.9
31020, 성남시,065001, 60세,2017,13702,6877,6825,100.8,13186,6628,6558,101.1
31020, 성남시,065002, 61세,2017,12342,6079,6263,97.1,11852,5840,6012,97.1
31020, 성남시,065003, 62세,2017,12510,6114,6396,95.6,12114,5911,6203,95.3
31020, 성남시,065004, 63세,2017,10326,5020,5306,94.6,9980,4858,5122,94.8
31020, 성남시,065005, 64세,2017,8993,4375,4618,94.7,8691,4236,4455,95.1
31020, 성남시,070,65~69세,2017,38422,18419,20003,92.1,37506,17998,19508,92.3
31020, 성남시,070001, 65세,2017,9505,4648,4857,95.7,9221,4519,4702,96.1
31020, 성남시,070002, 66세,2017,6678,3205,3473,92.3,6476,3116,3360,92.7
31020, 성남시,070003, 67세,2017,7306,3519,3787,92.9,7143,3437,3706,92.7
31020, 성남시,070004, 68세,2017,7675,3621,4054,89.3,7517,3552,3965,89.6
31020, 성남시,070005, 69세,2017,7258,3426,3832,89.4,7149,3374,3775,89.4
31020, 성남시,075,70~74세,2017,28938,13196,15742,83.8,28671,13094,15577,84.1
31020, 성남시,075001, 70세,2017,7428,3485,3943,88.4,7366,3450,3916,88.1
31020, 성남시,075002, 71세,2017,5570,2513,3057,82.2,5502,2490,3012,82.7
31020, 성남시,075003, 72세,2017,5411,2462,2949,83.5,5353,2442,2911,83.9
31020, 성남시,075004, 73세,2017,5290,2382,2908,81.9,5247,2367,2880,82.2
31020, 성남시,075005, 74세,2017,5239,2354,2885,81.6,5203,2345,2858,82.1
31020, 성남시,080,75~79세,2017,22873,10027,12846,78.1,22715,9976,12739,78.3
31020, 성남시,080001, 75세,2017,6046,2792,3254,85.8,6011,2775,3236,85.8
31020, 성남시,080002, 76세,2017,4730,2141,2589,82.7,4700,2133,2567,83.1
31020, 성남시,080003, 77세,2017,4276,1817,2459,73.9,4243,1803,2440,73.9
31020, 성남시,080004, 78세,2017,4151,1750,2401,72.9,4122,1745,2377,73.4
31020, 성남시,080005, 79세,2017,3670,1527,2143,71.3,3639,1520,2119,71.7
31020, 성남시,085,80~84세,2017,13359,4934,8425,58.6,13272,4912,8360,58.8
31020, 성남시,085001, 80세,2017,3328,1332,1996,66.7,3305,1326,1979,67
31020, 성남시,085002, 81세,2017,3009,1191,1818,65.5,2987,1183,1804,65.6
31020, 성남시,085003, 82세,2017,2770,1010,1760,57.4,2754,1009,1745,57.8
31020, 성남시,085004, 83세,2017,2330,773,1557,49.6,2317,771,1546,49.9
31020, 성남시,085005, 84세,2017,1922,628,1294,48.5,1909,623,1286,48.4
31020, 성남시,090,85~89세,2017,6564,1940,4624,42,6535,1936,4599,42.1
31020, 성남시,090001, 85세,2017,1768,559,1209,46.2,1758,557,1201,46.4
31020, 성남시,090002, 86세,2017,1358,398,960,41.5,1352,398,954,41.7
31020, 성남시,090003, 87세,2017,1339,386,953,40.5,1337,385,952,40.4
31020, 성남시,090004, 88세,2017,1167,351,816,43,1161,350,811,43.2
31020, 성남시,090005, 89세,2017,932,246,686,35.9,927,246,681,36.1
31020, 성남시,095,90~94세,2017,2270,539,1731,31.1,2256,536,1720,31.2
31020, 성남시,095001, 90세,2017,761,177,584,30.3,759,177,582,30.4
31020, 성남시,095002, 91세,2017,480,121,359,33.7,475,120,355,33.8
31020, 성남시,095003, 92세,2017,433,78,355,22,429,77,352,21.9
31020, 성남시,095004, 93세,2017,308,80,228,35.1,307,80,227,35.2
31020, 성남시,095005, 94세,2017,288,83,205,40.5,286,82,204,40.2
31020, 성남시,100,95~99세,2017,541,128,413,31,538,128,410,31.2
31020, 성남시,100001, 95세,2017,219,53,166,31.9,217,53,164,32.3
31020, 성남시,100002, 96세,2017,132,24,108,22.2,132,24,108,22.2
31020, 성남시,100003, 97세,2017,93,27,66,40.9,92,27,65,41.5
31020, 성남시,100004, 98세,2017,63,17,46,37,63,17,46,37
31020, 성남시,100005, 99세,2017,34,7,27,25.9,34,7,27,25.9
31020, 성남시,101,100세이상,2017,66,14,52,26.9,62,12,50,24
31020, 성남시,102,15세미만,2017,120695,62087,58608,105.9,119698,61587,58111,106
31020, 성남시,103,15~64세,2017,710569,355892,354677,100.3,689820,345698,344122,100.5
31020, 성남시,104,65세이상,2017,113033,49197,63836,77.1,111555,48592,62963,77.2
31020, 성남시,086,85세이상,2017,9441,2621,6820,38.4,9391,2612,6779,38.5
31020, 성남시,126,평균연령,2017,40.7,39.9,41.6,,40.7,39.8,41.5,
31020, 성남시,127,중위연령,2017,41.6,40.7,42.4,,41.5,40.6,42.4,
31021, 수정구,000,합계,2017,241862,122336,119526,102.4,228035,115455,112580,102.6
31021, 수정구,005,0~4세,2017,9054,4576,4478,102.2,8736,4427,4309,102.7
31021, 수정구,005001, 0세,2017,1744,901,843,106.9,1681,873,808,108
31021, 수정구,005002, 1세,2017,1855,953,902,105.7,1783,913,870,104.9
31021, 수정구,005003, 2세,2017,1820,876,944,92.8,1763,853,910,93.7
31021, 수정구,005004, 3세,2017,1873,963,910,105.8,1799,926,873,106.1
31021, 수정구,005005, 4세,2017,1762,883,879,100.5,1710,862,848,101.7
31021, 수정구,010,5~9세,2017,8490,4346,4144,104.9,8338,4268,4070,104.9
31021, 수정구,010001, 5세,2017,1738,892,846,105.4,1690,869,821,105.8
31021, 수정구,010002, 6세,2017,1779,915,864,105.9,1749,900,849,106
31021, 수정구,010003, 7세,2017,1766,873,893,97.8,1740,860,880,97.7
31021, 수정구,010004, 8세,2017,1554,810,744,108.9,1528,794,734,108.2
31021, 수정구,010005, 9세,2017,1653,856,797,107.4,1631,845,786,107.5
31021, 수정구,015,10~14세,2017,8190,4247,3943,107.7,8087,4200,3887,108.1
31021, 수정구,015001, 10세,2017,1743,899,844,106.5,1716,890,826,107.7
31021, 수정구,015002, 11세,2017,1517,787,730,107.8,1493,774,719,107.6
31021, 수정구,015003, 12세,2017,1511,781,730,107,1490,773,717,107.8
31021, 수정구,015004, 13세,2017,1699,908,791,114.8,1673,893,780,114.5
31021, 수정구,015005, 14세,2017,1720,872,848,102.8,1715,870,845,103
31021, 수정구,020,15~19세,2017,11496,5914,5582,105.9,11272,5805,5467,106.2
31021, 수정구,020001, 15세,2017,1721,905,816,110.9,1705,896,809,110.8
31021, 수정구,020002, 16세,2017,1961,1034,927,111.5,1946,1029,917,112.2
31021, 수정구,020003, 17세,2017,2107,1102,1005,109.7,2079,1090,989,110.2
31021, 수정구,020004, 18세,2017,2535,1336,1199,111.4,2481,1301,1180,110.3
31021, 수정구,020005, 19세,2017,3172,1537,1635,94,3061,1489,1572,94.7
31021, 수정구,025,20~24세,2017,17262,8804,8458,104.1,16285,8332,7953,104.8
31021, 수정구,025001, 20세,2017,3263,1511,1752,86.2,3118,1455,1663,87.5
31021, 수정구,025002, 21세,2017,3306,1648,1658,99.4,3095,1556,1539,101.1
31021, 수정구,025003, 22세,2017,3419,1809,1610,112.4,3195,1692,1503,112.6
31021, 수정구,025004, 23세,2017,3614,1890,1724,109.6,3418,1796,1622,110.7
31021, 수정구,025005, 24세,2017,3660,1946,1714,113.5,3459,1833,1626,112.7
31021, 수정구,030,25~29세,2017,18099,9633,8466,113.8,16817,9008,7809,115.4
31021, 수정구,030001, 25세,2017,3917,2076,1841,112.8,3685,1969,1716,114.7
31021, 수정구,030002, 26세,2017,3694,1970,1724,114.3,3452,1848,1604,115.2
31021, 수정구,030003, 27세,2017,3539,1888,1651,114.4,3276,1770,1506,117.5
31021, 수정구,030004, 28세,2017,3505,1880,1625,115.7,3227,1736,1491,116.4
31021, 수정구,030005, 29세,2017,3444,1819,1625,111.9,3177,1685,1492,112.9
31021, 수정구,035,30~34세,2017,18093,9770,8323,117.4,16797,9081,7716,117.7
31021, 수정구,035001, 30세,2017,3539,1926,1613,119.4,3217,1752,1465,119.6
31021, 수정구,035002, 31세,2017,3443,1869,1574,118.7,3174,1730,1444,119.8
31021, 수정구,035003, 32세,2017,3561,1894,1667,113.6,3323,1776,1547,114.8
31021, 수정구,035004, 33세,2017,3604,1932,1672,115.6,3350,1801,1549,116.3
31021, 수정구,035005, 34세,2017,3946,2149,1797,119.6,3733,2022,1711,118.2
31021, 수정구,040,35~39세,2017,20258,10807,9451,114.3,19224,10219,9005,113.5
31021, 수정구,040001, 35세,2017,4353,2340,2013,116.2,4097,2207,1890,116.8
31021, 수정구,040002, 36세,2017,4223,2309,1914,120.6,4028,2188,1840,118.9
31021, 수정구,040003, 37세,2017,4193,2185,2008,108.8,4001,2076,1925,107.8
31021, 수정구,040004, 38세,2017,3963,2121,1842,115.1,3751,1998,1753,114
31021, 수정구,040005, 39세,2017,3526,1852,1674,110.6,3347,1750,1597,109.6
31021, 수정구,045,40~44세,2017,18568,10001,8567,116.7,17565,9440,8125,116.2
31021, 수정구,045001, 40세,2017,3636,1959,1677,116.8,3446,1854,1592,116.5
31021, 수정구,045002, 41세,2017,3461,1924,1537,125.2,3269,1810,1459,124.1
31021, 수정구,045003, 42세,2017,3728,2016,1712,117.8,3536,1905,1631,116.8
31021, 수정구,045004, 43세,2017,3765,2067,1698,121.7,3573,1957,1616,121.1
31021, 수정구,045005, 44세,2017,3978,2035,1943,104.7,3741,1914,1827,104.8
31021, 수정구,050,45~49세,2017,21138,11106,10032,110.7,19505,10274,9231,111.3
31021, 수정구,050001, 45세,2017,4157,2267,1890,119.9,3856,2111,1745,121
31021, 수정구,050002, 46세,2017,4352,2347,2005,117.1,4003,2150,1853,116
31021, 수정구,050003, 47세,2017,4207,2184,2023,108,3893,2023,1870,108.2
31021, 수정구,050004, 48세,2017,4201,2165,2036,106.3,3880,2013,1867,107.8
31021, 수정구,050005, 49세,2017,4221,2143,2078,103.1,3873,1977,1896,104.3
31021, 수정구,055,50~54세,2017,20702,10415,10287,101.2,18726,9465,9261,102.2
31021, 수정구,055001, 50세,2017,3983,2016,1967,102.5,3686,1866,1820,102.5
31021, 수정구,055002, 51세,2017,4072,2034,2038,99.8,3696,1864,1832,101.7
31021, 수정구,055003, 52세,2017,4142,2079,2063,100.8,3732,1875,1857,101
31021, 수정구,055004, 53세,2017,4104,2070,2034,101.8,3716,1884,1832,102.8
31021, 수정구,055005, 54세,2017,4401,2216,2185,101.4,3896,1976,1920,102.9
31021, 수정구,060,55~59세,2017,21772,10678,11094,96.3,20309,10010,10299,97.2
31021, 수정구,060001, 55세,2017,4322,2186,2136,102.3,3964,2022,1942,104.1
31021, 수정구,060002, 56세,2017,4574,2218,2356,94.1,4379,2121,2258,93.9
31021, 수정구,060003, 57세,2017,4715,2245,2470,90.9,4350,2080,2270,91.6
31021, 수정구,060004, 58세,2017,4158,2041,2117,96.4,3902,1935,1967,98.4
31021, 수정구,060005, 59세,2017,4003,1988,2015,98.7,3714,1852,1862,99.5
31021, 수정구,065,60~64세,2017,17087,8300,8787,94.5,15670,7585,8085,93.8
31021, 수정구,065001, 60세,2017,3922,1913,2009,95.2,3560,1728,1832,94.3
31021, 수정구,065002, 61세,2017,3681,1816,1865,97.4,3340,1645,1695,97.1
31021, 수정구,065003, 62세,2017,3628,1765,1863,94.7,3360,1619,1741,93
31021, 수정구,065004, 63세,2017,3139,1496,1643,91.1,2899,1386,1513,91.6
31021, 수정구,065005, 64세,2017,2717,1310,1407,93.1,2511,1207,1304,92.6
31021, 수정구,070,65~69세,2017,11660,5530,6130,90.2,11061,5244,5817,90.1
31021, 수정구,070001, 65세,2017,2882,1376,1506,91.4,2700,1290,1410,91.5
31021, 수정구,070002, 66세,2017,2112,1007,1105,91.1,1963,937,1026,91.3
31021, 수정구,070003, 67세,2017,2183,1039,1144,90.8,2083,989,1094,90.4
31021, 수정구,070004, 68세,2017,2316,1090,1226,88.9,2217,1047,1170,89.5
31021, 수정구,070005, 69세,2017,2167,1018,1149,88.6,2098,981,1117,87.8
31021, 수정구,075,70~74세,2017,8356,3790,4566,83,8194,3721,4473,83.2
31021, 수정구,075001, 70세,2017,2121,1009,1112,90.7,2081,982,1099,89.4
31021, 수정구,075002, 71세,2017,1612,727,885,82.1,1574,713,861,82.8
31021, 수정구,075003, 72세,2017,1547,690,857,80.5,1511,678,833,81.4
31021, 수정구,075004, 73세,2017,1519,682,837,81.5,1489,670,819,81.8
31021, 수정구,075005, 74세,2017,1557,682,875,77.9,1539,678,861,78.7
31021, 수정구,080,75~79세,2017,6401,2787,3614,77.1,6296,2762,3534,78.2
31021, 수정구,080001, 75세,2017,1765,821,944,87,1743,812,931,87.2
31021, 수정구,080002, 76세,2017,1284,565,719,78.6,1264,561,703,79.8
31021, 수정구,080003, 77세,2017,1178,503,675,74.5,1158,498,660,75.5
31021, 수정구,080004, 78세,2017,1174,490,684,71.6,1155,489,666,73.4
31021, 수정구,080005, 79세,2017,1000,408,592,68.9,976,402,574,70
31021, 수정구,085,80~84세,2017,3253,1160,2093,55.4,3194,1144,2050,55.8
31021, 수정구,085001, 80세,2017,784,315,469,67.2,772,312,460,67.8
31021, 수정구,085002, 81세,2017,754,286,468,61.1,735,278,457,60.8
31021, 수정구,085003, 82세,2017,706,228,478,47.7,694,228,466,48.9
31021, 수정구,085004, 83세,2017,541,181,360,50.3,532,179,353,50.7
31021, 수정구,085005, 84세,2017,468,150,318,47.2,461,147,314,46.8
31021, 수정구,090,85~89세,2017,1400,349,1051,33.2,1382,348,1034,33.7
31021, 수정구,090001, 85세,2017,383,102,281,36.3,376,102,274,37.2
31021, 수정구,090002, 86세,2017,276,69,207,33.3,272,69,203,34
31021, 수정구,090003, 87세,2017,284,76,208,36.5,283,75,208,36.1
31021, 수정구,090004, 88세,2017,266,65,201,32.3,263,65,198,32.8
31021, 수정구,090005, 89세,2017,191,37,154,24,188,37,151,24.5
31021, 수정구,095,90~94세,2017,454,99,355,27.9,451,99,352,28.1
31021, 수정구,095001, 90세,2017,158,35,123,28.5,157,35,122,28.7
31021, 수정구,095002, 91세,2017,97,25,72,34.7,95,25,70,35.7
31021, 수정구,095003, 92세,2017,84,17,67,25.4,84,17,67,25.4
31021, 수정구,095004, 93세,2017,53,12,41,29.3,53,12,41,29.3
31021, 수정구,095005, 94세,2017,62,10,52,19.2,62,10,52,19.2
31021, 수정구,100,95~99세,2017,109,22,87,25.3,107,22,85,25.9
31021, 수정구,100001, 95세,2017,44,7,37,18.9,43,7,36,19.4
31021, 수정구,100002, 96세,2017,28,5,23,21.7,28,5,23,21.7
31021, 수정구,100003, 97세,2017,22,6,16,37.5,21,6,15,40
31021, 수정구,100004, 98세,2017,8,X,7,14.3,8,X,7,14.3
31021, 수정구,100005, 99세,2017,7,X,X,75,7,X,X,75
31021, 수정구,101,100세이상,2017,20,X,18,11.1,19,X,18,5.6
31021, 수정구,102,15세미만,2017,25734,13169,12565,104.8,25161,12895,12266,105.1
31021, 수정구,103,15~64세,2017,184475,95428,89047,107.2,172170,89219,82951,107.6
31021, 수정구,104,65세이상,2017,31653,13739,17914,76.7,30704,13341,17363,76.8
31021, 수정구,086,85세이상,2017,1983,472,1511,31.2,1959,470,1489,31.6
31021, 수정구,126,평균연령,2017,42,41,43,,41.9,40.9,42.9,
31021, 수정구,127,중위연령,2017,42.8,41.6,44.2,,42.5,41.3,43.9,
31022, 중원구,000,합계,2017,226657,114220,112437,101.6,222291,112137,110154,101.8
31022, 중원구,005,0~4세,2017,8443,4400,4043,108.8,8370,4359,4011,108.7
31022, 중원구,005001, 0세,2017,1600,867,733,118.3,1587,860,727,118.3
31022, 중원구,005002, 1세,2017,1685,863,822,105,1666,852,814,104.7
31022, 중원구,005003, 2세,2017,1785,944,841,112.2,1770,935,835,112
31022, 중원구,005004, 3세,2017,1718,874,844,103.6,1702,865,837,103.3
31022, 중원구,005005, 4세,2017,1655,852,803,106.1,1645,847,798,106.1
31022, 중원구,010,5~9세,2017,8558,4442,4116,107.9,8523,4424,4099,107.9
31022, 중원구,010001, 5세,2017,1834,966,868,111.3,1821,959,862,111.3
31022, 중원구,010002, 6세,2017,1778,949,829,114.5,1774,948,826,114.8
31022, 중원구,010003, 7세,2017,1641,858,783,109.6,1634,854,780,109.5
31022, 중원구,010004, 8세,2017,1639,786,853,92.1,1635,783,852,91.9
31022, 중원구,010005, 9세,2017,1666,883,783,112.8,1659,880,779,113
31022, 중원구,015,10~14세,2017,8508,4350,4158,104.6,8478,4334,4144,104.6
31022, 중원구,015001, 10세,2017,1816,897,919,97.6,1807,893,914,97.7
31022, 중원구,015002, 11세,2017,1558,789,769,102.6,1553,785,768,102.2
31022, 중원구,015003, 12세,2017,1582,770,812,94.8,1576,766,810,94.6
31022, 중원구,015004, 13세,2017,1744,918,826,111.1,1737,915,822,111.3
31022, 중원구,015005, 14세,2017,1808,976,832,117.3,1805,975,830,117.5
31022, 중원구,020,15~19세,2017,11410,5808,5602,103.7,11375,5795,5580,103.9
31022, 중원구,020001, 15세,2017,1922,984,938,104.9,1921,984,937,105
31022, 중원구,020002, 16세,2017,2169,1144,1025,111.6,2166,1142,1024,111.5
31022, 중원구,020003, 17세,2017,2427,1207,1220,98.9,2420,1204,1216,99
31022, 중원구,020004, 18세,2017,2438,1221,1217,100.3,2430,1219,1211,100.7
31022, 중원구,020005, 19세,2017,2454,1252,1202,104.2,2438,1246,1192,104.5
31022, 중원구,025,20~24세,2017,15142,7838,7304,107.3,14925,7738,7187,107.7
31022, 중원구,025001, 20세,2017,2627,1343,1284,104.6,2608,1335,1273,104.9
31022, 중원구,025002, 21세,2017,2961,1523,1438,105.9,2930,1511,1419,106.5
31022, 중원구,025003, 22세,2017,2993,1570,1423,110.3,2948,1554,1394,111.5
31022, 중원구,025004, 23세,2017,3186,1637,1549,105.7,3133,1614,1519,106.3
31022, 중원구,025005, 24세,2017,3375,1765,1610,109.6,3306,1724,1582,109
31022, 중원구,030,25~29세,2017,16676,8682,7994,108.6,16138,8445,7693,109.8
31022, 중원구,030001, 25세,2017,3585,1863,1722,108.2,3490,1819,1671,108.9
31022, 중원구,030002, 26세,2017,3448,1745,1703,102.5,3359,1700,1659,102.5
31022, 중원구,030003, 27세,2017,3310,1718,1592,107.9,3189,1664,1525,109.1
31022, 중원구,030004, 28세,2017,3163,1671,1492,112,3055,1626,1429,113.8
31022, 중원구,030005, 29세,2017,3170,1685,1485,113.5,3045,1636,1409,116.1
31022, 중원구,035,30~34세,2017,16812,8845,7967,111,16285,8593,7692,111.7
31022, 중원구,035001, 30세,2017,3134,1664,1470,113.2,3023,1604,1419,113
31022, 중원구,035002, 31세,2017,3129,1666,1463,113.9,3023,1614,1409,114.5
31022, 중원구,035003, 32세,2017,3301,1717,1584,108.4,3200,1669,1531,109
31022, 중원구,035004, 33세,2017,3447,1796,1651,108.8,3340,1749,1591,109.9
31022, 중원구,035005, 34세,2017,3801,2002,1799,111.3,3699,1957,1742,112.3
31022, 중원구,040,35~39세,2017,18418,9707,8711,111.4,17993,9493,8500,111.7
31022, 중원구,040001, 35세,2017,3908,2046,1862,109.9,3804,1999,1805,110.7
31022, 중원구,040002, 36세,2017,3864,2018,1846,109.3,3775,1970,1805,109.1
31022, 중원구,040003, 37세,2017,3813,2006,1807,111,3743,1976,1767,111.8
31022, 중원구,040004, 38세,2017,3632,1908,1724,110.7,3545,1865,1680,111
31022, 중원구,040005, 39세,2017,3201,1729,1472,117.5,3126,1683,1443,116.6
31022, 중원구,045,40~44세,2017,17340,9168,8172,112.2,16972,8973,7999,112.2
31022, 중원구,045001, 40세,2017,3257,1772,1485,119.3,3189,1739,1450,119.9
31022, 중원구,045002, 41세,2017,3202,1720,1482,116.1,3133,1682,1451,115.9
31022, 중원구,045003, 42세,2017,3399,1784,1615,110.5,3322,1745,1577,110.7
31022, 중원구,045004, 43세,2017,3684,1922,1762,109.1,3610,1879,1731,108.5
31022, 중원구,045005, 44세,2017,3798,1970,1828,107.8,3718,1928,1790,107.7
31022, 중원구,050,45~49세,2017,20175,10396,9779,106.3,19658,10149,9509,106.7
31022, 중원구,050001, 45세,2017,3867,2072,1795,115.4,3787,2028,1759,115.3
31022, 중원구,050002, 46세,2017,4118,2171,1947,111.5,4023,2123,1900,111.7
31022, 중원구,050003, 47세,2017,3965,2052,1913,107.3,3854,2001,1853,108
31022, 중원구,050004, 48세,2017,4098,2024,2074,97.6,3988,1974,2014,98
31022, 중원구,050005, 49세,2017,4127,2077,2050,101.3,4006,2023,1983,102
31022, 중원구,055,50~54세,2017,19567,9782,9785,100,19044,9539,9505,100.4
31022, 중원구,055001, 50세,2017,3939,1963,1976,99.3,3846,1910,1936,98.7
31022, 중원구,055002, 51세,2017,3863,1928,1935,99.6,3761,1884,1877,100.4
31022, 중원구,055003, 52세,2017,4022,2009,2013,99.8,3928,1965,1963,100.1
31022, 중원구,055004, 53세,2017,3749,1834,1915,95.8,3644,1785,1859,96
31022, 중원구,055005, 54세,2017,3994,2048,1946,105.2,3865,1995,1870,106.7
31022, 중원구,060,55~59세,2017,21064,10440,10624,98.3,20631,10238,10393,98.5
31022, 중원구,060001, 55세,2017,4177,2054,2123,96.7,4084,2013,2071,97.2
31022, 중원구,060002, 56세,2017,4521,2140,2381,89.9,4457,2110,2347,89.9
31022, 중원구,060003, 57세,2017,4583,2282,2301,99.2,4482,2234,2248,99.4
31022, 중원구,060004, 58세,2017,3955,1970,1985,99.2,3870,1928,1942,99.3
31022, 중원구,060005, 59세,2017,3828,1994,1834,108.7,3738,1953,1785,109.4
31022, 중원구,065,60~64세,2017,15424,7630,7794,97.9,15066,7450,7616,97.8
31022, 중원구,065001, 60세,2017,3642,1874,1768,106,3555,1827,1728,105.7
31022, 중원구,065002, 61세,2017,3261,1607,1654,97.2,3174,1560,1614,96.7
31022, 중원구,065003, 62세,2017,3378,1610,1768,91.1,3306,1579,1727,91.4
31022, 중원구,065004, 63세,2017,2797,1382,1415,97.7,2736,1350,1386,97.4
31022, 중원구,065005, 64세,2017,2346,1157,1189,97.3,2295,1134,1161,97.7
31022, 중원구,070,65~69세,2017,10541,5187,5354,96.9,10356,5094,5262,96.8
31022, 중원구,070001, 65세,2017,2633,1298,1335,97.2,2570,1267,1303,97.2
31022, 중원구,070002, 66세,2017,1861,893,968,92.3,1827,881,946,93.1
31022, 중원구,070003, 67세,2017,1988,999,989,101,1953,977,976,100.1
31022, 중원구,070004, 68세,2017,2096,1033,1063,97.2,2063,1016,1047,97
31022, 중원구,070005, 69세,2017,1963,964,999,96.5,1943,953,990,96.3
31022, 중원구,075,70~74세,2017,7613,3517,4096,85.9,7564,3502,4062,86.2
31022, 중원구,075001, 70세,2017,2002,956,1046,91.4,1989,951,1038,91.6
31022, 중원구,075002, 71세,2017,1447,676,771,87.7,1431,670,761,88
31022, 중원구,075003, 72세,2017,1434,665,769,86.5,1428,663,765,86.7
31022, 중원구,075004, 73세,2017,1370,588,782,75.2,1364,587,777,75.5
31022, 중원구,075005, 74세,2017,1360,632,728,86.8,1352,631,721,87.5
31022, 중원구,080,75~79세,2017,5770,2458,3312,74.2,5743,2448,3295,74.3
31022, 중원구,080001, 75세,2017,1621,728,893,81.5,1616,725,891,81.4
31022, 중원구,080002, 76세,2017,1208,540,668,80.8,1201,538,663,81.1
31022, 중원구,080003, 77세,2017,1069,444,625,71,1063,440,623,70.6
31022, 중원구,080004, 78세,2017,994,406,588,69,988,405,583,69.5
31022, 중원구,080005, 79세,2017,878,340,538,63.2,875,340,535,63.6
31022, 중원구,085,80~84세,2017,3119,1092,2027,53.9,3101,1088,2013,54
31022, 중원구,085001, 80세,2017,821,315,506,62.3,812,313,499,62.7
31022, 중원구,085002, 81세,2017,703,277,426,65,702,277,425,65.2
31022, 중원구,085003, 82세,2017,618,215,403,53.3,615,215,400,53.8
31022, 중원구,085004, 83세,2017,576,181,395,45.8,575,181,394,45.9
31022, 중원구,085005, 84세,2017,401,104,297,35,397,102,295,34.6
31022, 중원구,090,85~89세,2017,1411,356,1055,33.7,1407,355,1052,33.7
31022, 중원구,090001, 85세,2017,388,114,274,41.6,387,113,274,41.2
31022, 중원구,090002, 86세,2017,291,63,228,27.6,290,63,227,27.8
31022, 중원구,090003, 87세,2017,296,71,225,31.6,296,71,225,31.6
31022, 중원구,090004, 88세,2017,249,67,182,36.8,247,67,180,37.2
31022, 중원구,090005, 89세,2017,187,41,146,28.1,187,41,146,28.1
31022, 중원구,095,90~94세,2017,517,100,417,24,514,99,415,23.9
31022, 중원구,095001, 90세,2017,171,33,138,23.9,170,33,137,24.1
31022, 중원구,095002, 91세,2017,113,23,90,25.6,112,22,90,24.4
31022, 중원구,095003, 92세,2017,104,13,91,14.3,104,13,91,14.3
31022, 중원구,095004, 93세,2017,65,16,49,32.7,64,16,48,33.3
31022, 중원구,095005, 94세,2017,64,15,49,30.6,64,15,49,30.6
31022, 중원구,100,95~99세,2017,135,18,117,15.4,135,18,117,15.4
31022, 중원구,100001, 95세,2017,51,8,43,18.6,51,8,43,18.6
31022, 중원구,100002, 96세,2017,30,X,27,11.1,30,X,27,11.1
31022, 중원구,100003, 97세,2017,31,5,26,19.2,31,5,26,19.2
31022, 중원구,100004, 98세,2017,12,X,11,9.1,12,X,11,9.1
31022, 중원구,100005, 99세,2017,11,X,10,10,11,X,10,10
31022, 중원구,101,100세이상,2017,14,X,10,40,13,X,10,30
31022, 중원구,102,15세미만,2017,25509,13192,12317,107.1,25371,13117,12254,107
31022, 중원구,103,15~64세,2017,172028,88296,83732,105.5,168087,86413,81674,105.8
31022, 중원구,104,65세이상,2017,29120,12732,16388,77.7,28833,12607,16226,77.7
31022, 중원구,086,85세이상,2017,2077,478,1599,29.9,2069,475,1594,29.8
31022, 중원구,126,평균연령,2017,41.8,40.9,42.7,,41.8,40.8,42.7,
31022, 중원구,127,중위연령,2017,42.9,41.7,44,,42.8,41.7,44,
31023, 분당구,000,합계,2017,475778,230620,245158,94.1,470747,228285,242462,94.2
31023, 분당구,005,0~4세,2017,20726,10586,10140,104.4,20611,10529,10082,104.4
31023, 분당구,005001, 0세,2017,3746,1918,1828,104.9,3724,1907,1817,105
31023, 분당구,005002, 1세,2017,4043,2047,1996,102.6,4010,2029,1981,102.4
31023, 분당구,005003, 2세,2017,4253,2228,2025,110,4231,2218,2013,110.2
31023, 분당구,005004, 3세,2017,4233,2132,2101,101.5,4218,2125,2093,101.5
31023, 분당구,005005, 4세,2017,4451,2261,2190,103.2,4428,2250,2178,103.3
31023, 분당구,010,5~9세,2017,23519,12100,11419,106,23427,12054,11373,106
31023, 분당구,010001, 5세,2017,4663,2438,2225,109.6,4645,2434,2211,110.1
31023, 분당구,010002, 6세,2017,4686,2399,2287,104.9,4673,2392,2281,104.9
31023, 분당구,010003, 7세,2017,4688,2402,2286,105.1,4666,2391,2275,105.1
31023, 분당구,010004, 8세,2017,4638,2400,2238,107.2,4617,2387,2230,107
31023, 분당구,010005, 9세,2017,4844,2461,2383,103.3,4826,2450,2376,103.1
31023, 분당구,015,10~14세,2017,25207,13040,12167,107.2,25128,12992,12136,107.1
31023, 분당구,015001, 10세,2017,5046,2677,2369,113,5025,2665,2360,112.9
31023, 분당구,015002, 11세,2017,4742,2422,2320,104.4,4725,2408,2317,103.9
31023, 분당구,015003, 12세,2017,4671,2410,2261,106.6,4658,2402,2256,106.5
31023, 분당구,015004, 13세,2017,5375,2762,2613,105.7,5364,2758,2606,105.8
31023, 분당구,015005, 14세,2017,5373,2769,2604,106.3,5356,2759,2597,106.2
31023, 분당구,020,15~19세,2017,29290,14807,14483,102.2,29206,14761,14445,102.2
31023, 분당구,020001, 15세,2017,5283,2743,2540,108,5262,2733,2529,108.1
31023, 분당구,020002, 16세,2017,6142,3072,3070,100.1,6125,3063,3062,100
31023, 분당구,020003, 17세,2017,6695,3322,3373,98.5,6680,3312,3368,98.3
31023, 분당구,020004, 18세,2017,5888,2944,2944,100,5869,2934,2935,100
31023, 분당구,020005, 19세,2017,5282,2726,2556,106.7,5270,2719,2551,106.6
31023, 분당구,025,20~24세,2017,28046,14394,13652,105.4,27765,14277,13488,105.8
31023, 분당구,025001, 20세,2017,5236,2832,2404,117.8,5222,2824,2398,117.8
31023, 분당구,025002, 21세,2017,5503,2993,2510,119.2,5484,2982,2502,119.2
31023, 분당구,025003, 22세,2017,5457,2821,2636,107,5398,2796,2602,107.5
31023, 분당구,025004, 23세,2017,5807,2813,2994,94,5727,2787,2940,94.8
31023, 분당구,025005, 24세,2017,6043,2935,3108,94.4,5934,2888,3046,94.8
31023, 분당구,030,25~29세,2017,32843,15711,17132,91.7,32133,15399,16734,92
31023, 분당구,030001, 25세,2017,6582,3122,3460,90.2,6461,3074,3387,90.8
31023, 분당구,030002, 26세,2017,6590,3148,3442,91.5,6474,3100,3374,91.9
31023, 분당구,030003, 27세,2017,6446,3107,3339,93.1,6314,3051,3263,93.5
31023, 분당구,030004, 28세,2017,6689,3246,3443,94.3,6508,3157,3351,94.2
31023, 분당구,030005, 29세,2017,6536,3088,3448,89.6,6376,3017,3359,89.8
31023, 분당구,035,30~34세,2017,35118,16880,18238,92.6,34320,16477,17843,92.3
31023, 분당구,035001, 30세,2017,6727,3181,3546,89.7,6553,3094,3459,89.4
31023, 분당구,035002, 31세,2017,6755,3196,3559,89.8,6571,3105,3466,89.6
31023, 분당구,035003, 32세,2017,6962,3387,3575,94.7,6810,3309,3501,94.5
31023, 분당구,035004, 33세,2017,7082,3455,3627,95.3,6924,3370,3554,94.8
31023, 분당구,035005, 34세,2017,7592,3661,3931,93.1,7462,3599,3863,93.2
31023, 분당구,040,35~39세,2017,39861,18932,20929,90.5,39223,18597,20626,90.2
31023, 분당구,040001, 35세,2017,8064,3888,4176,93.1,7913,3809,4104,92.8
31023, 분당구,040002, 36세,2017,8197,3925,4272,91.9,8071,3860,4211,91.7
31023, 분당구,040003, 37세,2017,8344,3980,4364,91.2,8222,3907,4315,90.5
31023, 분당구,040004, 38세,2017,7990,3800,4190,90.7,7865,3739,4126,90.6
31023, 분당구,040005, 39세,2017,7266,3339,3927,85,7152,3282,3870,84.8
31023, 분당구,045,40~44세,2017,41660,19328,22332,86.5,41169,19092,22077,86.5
31023, 분당구,045001, 40세,2017,7720,3608,4112,87.7,7621,3563,4058,87.8
31023, 분당구,045002, 41세,2017,7778,3635,4143,87.7,7686,3589,4097,87.6
31023, 분당구,045003, 42세,2017,8061,3741,4320,86.6,7966,3697,4269,86.6
31023, 분당구,045004, 43세,2017,8895,4073,4822,84.5,8798,4035,4763,84.7
31023, 분당구,045005, 44세,2017,9206,4271,4935,86.5,9098,4208,4890,86.1
31023, 분당구,050,45~49세,2017,48555,23268,25287,92,48069,23001,25068,91.8
31023, 분당구,050001, 45세,2017,9510,4389,5121,85.7,9408,4329,5079,85.2
31023, 분당구,050002, 46세,2017,10421,4999,5422,92.2,10330,4950,5380,92
31023, 분당구,050003, 47세,2017,9927,4871,5056,96.3,9826,4819,5007,96.2
31023, 분당구,050004, 48세,2017,9706,4717,4989,94.5,9609,4661,4948,94.2
31023, 분당구,050005, 49세,2017,8991,4292,4699,91.3,8896,4242,4654,91.1
31023, 분당구,055,50~54세,2017,38208,18968,19240,98.6,37809,18804,19005,98.9
31023, 분당구,055001, 50세,2017,8091,3960,4131,95.9,8004,3929,4075,96.4
31023, 분당구,055002, 51세,2017,7481,3819,3662,104.3,7415,3789,3626,104.5
31023, 분당구,055003, 52세,2017,7727,3852,3875,99.4,7654,3820,3834,99.6
31023, 분당구,055004, 53세,2017,7412,3661,3751,97.6,7341,3632,3709,97.9
31023, 분당구,055005, 54세,2017,7497,3676,3821,96.2,7395,3634,3761,96.6
31023, 분당구,060,55~59세,2017,35123,17345,17778,97.6,34782,17220,17562,98.1
31023, 분당구,060001, 55세,2017,7110,3487,3623,96.2,7024,3458,3566,97
31023, 분당구,060002, 56세,2017,7707,3734,3973,94,7636,3710,3926,94.5
31023, 분당구,060003, 57세,2017,7333,3598,3735,96.3,7273,3581,3692,97
31023, 분당구,060004, 58세,2017,6758,3318,3440,96.5,6701,3290,3411,96.5
31023, 분당구,060005, 59세,2017,6215,3208,3007,106.7,6148,3181,2967,107.2
31023, 분당구,065,60~64세,2017,25362,12535,12827,97.7,25087,12438,12649,98.3
31023, 분당구,065001, 60세,2017,6138,3090,3048,101.4,6071,3073,2998,102.5
31023, 분당구,065002, 61세,2017,5400,2656,2744,96.8,5338,2635,2703,97.5
31023, 분당구,065003, 62세,2017,5504,2739,2765,99.1,5448,2713,2735,99.2
31023, 분당구,065004, 63세,2017,4390,2142,2248,95.3,4345,2122,2223,95.5
31023, 분당구,065005, 64세,2017,3930,1908,2022,94.4,3885,1895,1990,95.2
31023, 분당구,070,65~69세,2017,16221,7702,8519,90.4,16089,7660,8429,90.9
31023, 분당구,070001, 65세,2017,3990,1974,2016,97.9,3951,1962,1989,98.6
31023, 분당구,070002, 66세,2017,2705,1305,1400,93.2,2686,1298,1388,93.5
31023, 분당구,070003, 67세,2017,3135,1481,1654,89.5,3107,1471,1636,89.9
31023, 분당구,070004, 68세,2017,3263,1498,1765,84.9,3237,1489,1748,85.2
31023, 분당구,070005, 69세,2017,3128,1444,1684,85.7,3108,1440,1668,86.3
31023, 분당구,075,70~74세,2017,12969,5889,7080,83.2,12913,5871,7042,83.4
31023, 분당구,075001, 70세,2017,3305,1520,1785,85.2,3296,1517,1779,85.3
31023, 분당구,075002, 71세,2017,2511,1110,1401,79.2,2497,1107,1390,79.6
31023, 분당구,075003, 72세,2017,2430,1107,1323,83.7,2414,1101,1313,83.9
31023, 분당구,075004, 73세,2017,2401,1112,1289,86.3,2394,1110,1284,86.4
31023, 분당구,075005, 74세,2017,2322,1040,1282,81.1,2312,1036,1276,81.2
31023, 분당구,080,75~79세,2017,10702,4782,5920,80.8,10676,4766,5910,80.6
31023, 분당구,080001, 75세,2017,2660,1243,1417,87.7,2652,1238,1414,87.6
31023, 분당구,080002, 76세,2017,2238,1036,1202,86.2,2235,1034,1201,86.1
31023, 분당구,080003, 77세,2017,2029,870,1159,75.1,2022,865,1157,74.8
31023, 분당구,080004, 78세,2017,1983,854,1129,75.6,1979,851,1128,75.4
31023, 분당구,080005, 79세,2017,1792,779,1013,76.9,1788,778,1010,77
31023, 분당구,085,80~84세,2017,6987,2682,4305,62.3,6977,2680,4297,62.4
31023, 분당구,085001, 80세,2017,1723,702,1021,68.8,1721,701,1020,68.7
31023, 분당구,085002, 81세,2017,1552,628,924,68,1550,628,922,68.1
31023, 분당구,085003, 82세,2017,1446,567,879,64.5,1445,566,879,64.4
31023, 분당구,085004, 83세,2017,1213,411,802,51.2,1210,411,799,51.4
31023, 분당구,085005, 84세,2017,1053,374,679,55.1,1051,374,677,55.2
31023, 분당구,090,85~89세,2017,3753,1235,2518,49,3746,1233,2513,49.1
31023, 분당구,090001, 85세,2017,997,343,654,52.4,995,342,653,52.4
31023, 분당구,090002, 86세,2017,791,266,525,50.7,790,266,524,50.8
31023, 분당구,090003, 87세,2017,759,239,520,46,758,239,519,46.1
31023, 분당구,090004, 88세,2017,652,219,433,50.6,651,218,433,50.3
31023, 분당구,090005, 89세,2017,554,168,386,43.5,552,168,384,43.8
31023, 분당구,095,90~94세,2017,1299,340,959,35.5,1291,338,953,35.5
31023, 분당구,095001, 90세,2017,432,109,323,33.7,432,109,323,33.7
31023, 분당구,095002, 91세,2017,270,73,197,37.1,268,73,195,37.4
31023, 분당구,095003, 92세,2017,245,48,197,24.4,241,47,194,24.2
31023, 분당구,095004, 93세,2017,190,52,138,37.7,190,52,138,37.7
31023, 분당구,095005, 94세,2017,162,58,104,55.8,160,57,103,55.3
31023, 분당구,100,95~99세,2017,297,88,209,42.1,296,88,208,42.3
31023, 분당구,100001, 95세,2017,124,38,86,44.2,123,38,85,44.7
31023, 분당구,100002, 96세,2017,74,16,58,27.6,74,16,58,27.6
31023, 분당구,100003, 97세,2017,40,16,24,66.7,40,16,24,66.7
31023, 분당구,100004, 98세,2017,43,15,28,53.6,43,15,28,53.6
31023, 분당구,100005, 99세,2017,16,X,13,23.1,16,X,13,23.1
31023, 분당구,101,100세이상,2017,32,8,24,33.3,30,8,22,36.4
31023, 분당구,102,15세미만,2017,69452,35726,33726,105.9,69166,35575,33591,105.9
31023, 분당구,103,15~64세,2017,354066,172168,181898,94.7,349563,170066,179497,94.7
31023, 분당구,104,65세이상,2017,52260,22726,29534,76.9,52018,22644,29374,77.1
31023, 분당구,086,85세이상,2017,5381,1671,3710,45,5363,1667,3696,45.1
31023, 분당구,126,평균연령,2017,39.6,38.8,40.3,,39.6,38.8,40.3,
31023, 분당구,127,중위연령,2017,40.4,39.7,41.1,,40.5,39.7,41.1,
31030, 의정부시,000,합계,2017,426530,210519,216011,97.5,421263,208022,213241,97.6
31030, 의정부시,005,0~4세,2017,16701,8553,8148,105,16628,8528,8100,105.3
31030, 의정부시,005001, 0세,2017,2773,1435,1338,107.2,2760,1431,1329,107.7
31030, 의정부시,005002, 1세,2017,3208,1615,1593,101.4,3192,1609,1583,101.6
31030, 의정부시,005003, 2세,2017,3612,1860,1752,106.2,3586,1851,1735,106.7
31030, 의정부시,005004, 3세,2017,3507,1794,1713,104.7,3498,1792,1706,105
31030, 의정부시,005005, 4세,2017,3601,1849,1752,105.5,3592,1845,1747,105.6
31030, 의정부시,010,5~9세,2017,19199,9862,9337,105.6,19150,9837,9313,105.6
31030, 의정부시,010001, 5세,2017,4005,2034,1971,103.2,3992,2029,1963,103.4
31030, 의정부시,010002, 6세,2017,3823,1982,1841,107.7,3816,1979,1837,107.7
31030, 의정부시,010003, 7세,2017,3872,1999,1873,106.7,3860,1993,1867,106.7
31030, 의정부시,010004, 8세,2017,3635,1824,1811,100.7,3627,1819,1808,100.6
31030, 의정부시,010005, 9세,2017,3864,2023,1841,109.9,3855,2017,1838,109.7
31030, 의정부시,015,10~14세,2017,19729,10129,9600,105.5,19691,10103,9588,105.4
31030, 의정부시,015001, 10세,2017,4148,2189,1959,111.7,4140,2184,1956,111.7
31030, 의정부시,015002, 11세,2017,3691,1864,1827,102,3682,1858,1824,101.9
31030, 의정부시,015003, 12세,2017,3698,1884,1814,103.9,3693,1880,1813,103.7
31030, 의정부시,015004, 13세,2017,4028,2057,1971,104.4,4022,2054,1968,104.4
31030, 의정부시,015005, 14세,2017,4164,2135,2029,105.2,4154,2127,2027,104.9
31030, 의정부시,020,15~19세,2017,24889,12919,11970,107.9,24737,12818,11919,107.5
31030, 의정부시,020001, 15세,2017,4464,2323,2141,108.5,4461,2321,2140,108.5
31030, 의정부시,020002, 16세,2017,4790,2467,2323,106.2,4784,2463,2321,106.1
31030, 의정부시,020003, 17세,2017,5498,2926,2572,113.8,5477,2913,2564,113.6
31030, 의정부시,020004, 18세,2017,5166,2688,2478,108.5,5127,2662,2465,108
31030, 의정부시,020005, 19세,2017,4971,2515,2456,102.4,4888,2459,2429,101.2
31030, 의정부시,025,20~24세,2017,29248,15017,14231,105.5,28682,14729,13953,105.6
31030, 의정부시,025001, 20세,2017,5514,2837,2677,106,5413,2780,2633,105.6
31030, 의정부시,025002, 21세,2017,5748,3086,2662,115.9,5641,3025,2616,115.6
31030, 의정부시,025003, 22세,2017,5821,2985,2836,105.3,5702,2926,2776,105.4
31030, 의정부시,025004, 23세,2017,5989,3037,2952,102.9,5882,2985,2897,103
31030, 의정부시,025005, 24세,2017,6176,3072,3104,99,6044,3013,3031,99.4
31030, 의정부시,030,25~29세,2017,27175,13736,13439,102.2,26417,13389,13028,102.8
31030, 의정부시,030001, 25세,2017,6168,3138,3030,103.6,6011,3061,2950,103.8
31030, 의정부시,030002, 26세,2017,5916,2999,2917,102.8,5759,2925,2834,103.2
31030, 의정부시,030003, 27세,2017,5278,2646,2632,100.5,5130,2581,2549,101.3
31030, 의정부시,030004, 28세,2017,4966,2521,2445,103.1,4821,2454,2367,103.7
31030, 의정부시,030005, 29세,2017,4847,2432,2415,100.7,4696,2368,2328,101.7
31030, 의정부시,035,30~34세,2017,26016,13185,12831,102.8,25324,12872,12452,103.4
31030, 의정부시,035001, 30세,2017,4762,2401,2361,101.7,4613,2333,2280,102.3
31030, 의정부시,035002, 31세,2017,4929,2519,2410,104.5,4785,2445,2340,104.5
31030, 의정부시,035003, 32세,2017,4938,2504,2434,102.9,4806,2446,2360,103.6
31030, 의정부시,035004, 33세,2017,5301,2683,2618,102.5,5159,2621,2538,103.3
31030, 의정부시,035005, 34세,2017,6086,3078,3008,102.3,5961,3027,2934,103.2
31030, 의정부시,040,35~39세,2017,32443,16515,15928,103.7,31912,16264,15648,103.9
31030, 의정부시,040001, 35세,2017,6472,3303,3169,104.2,6334,3240,3094,104.7
31030, 의정부시,040002, 36세,2017,6708,3412,3296,103.5,6603,3364,3239,103.9
31030, 의정부시,040003, 37세,2017,6813,3508,3305,106.1,6717,3456,3261,106
31030, 의정부시,040004, 38세,2017,6508,3320,3188,104.1,6410,3285,3125,105.1
31030, 의정부시,040005, 39세,2017,5942,2972,2970,100.1,5848,2919,2929,99.7
31030, 의정부시,045,40~44세,2017,34335,17059,17276,98.7,33909,16843,17066,98.7
31030, 의정부시,045001, 40세,2017,6312,3148,3164,99.5,6213,3098,3115,99.5
31030, 의정부시,045002, 41세,2017,6146,3087,3059,100.9,6053,3033,3020,100.4
31030, 의정부시,045003, 42세,2017,6746,3331,3415,97.5,6664,3293,3371,97.7
31030, 의정부시,045004, 43세,2017,7568,3798,3770,100.7,7493,3763,3730,100.9
31030, 의정부시,045005, 44세,2017,7563,3695,3868,95.5,7486,3656,3830,95.5
31030, 의정부시,050,45~49세,2017,40634,19993,20641,96.9,40120,19745,20375,96.9
31030, 의정부시,050001, 45세,2017,8007,3977,4030,98.7,7904,3930,3974,98.9
31030, 의정부시,050002, 46세,2017,8361,4180,4181,100,8267,4140,4127,100.3
31030, 의정부시,050003, 47세,2017,8114,4007,4107,97.6,8000,3951,4049,97.6
31030, 의정부시,050004, 48세,2017,8100,3964,4136,95.8,8006,3917,4089,95.8
31030, 의정부시,050005, 49세,2017,8052,3865,4187,92.3,7943,3807,4136,92
31030, 의정부시,055,50~54세,2017,36855,18318,18537,98.8,36369,18095,18274,99
31030, 의정부시,055001, 50세,2017,7284,3502,3782,92.6,7196,3462,3734,92.7
31030, 의정부시,055002, 51세,2017,7490,3694,3796,97.3,7389,3645,3744,97.4
31030, 의정부시,055003, 52세,2017,7538,3747,3791,98.8,7433,3706,3727,99.4
31030, 의정부시,055004, 53세,2017,7067,3578,3489,102.6,6973,3539,3434,103.1
31030, 의정부시,055005, 54세,2017,7476,3797,3679,103.2,7378,3743,3635,103
31030, 의정부시,060,55~59세,2017,36159,18146,18013,100.7,35798,17991,17807,101
31030, 의정부시,060001, 55세,2017,7486,3745,3741,100.1,7401,3710,3691,100.5
31030, 의정부시,060002, 56세,2017,7651,3768,3883,97,7580,3737,3843,97.2
31030, 의정부시,060003, 57세,2017,7746,3911,3835,102,7669,3878,3791,102.3
31030, 의정부시,060004, 58세,2017,6735,3384,3351,101,6667,3353,3314,101.2
31030, 의정부시,060005, 59세,2017,6541,3338,3203,104.2,6481,3313,3168,104.6
31030, 의정부시,065,60~64세,2017,26331,12910,13421,96.2,26009,12755,13254,96.2
31030, 의정부시,065001, 60세,2017,6329,3154,3175,99.3,6249,3113,3136,99.3
31030, 의정부시,065002, 61세,2017,5478,2730,2748,99.3,5412,2695,2717,99.2
31030, 의정부시,065003, 62세,2017,5639,2675,2964,90.2,5571,2642,2929,90.2
31030, 의정부시,065004, 63세,2017,4792,2347,2445,96,4735,2324,2411,96.4
31030, 의정부시,065005, 64세,2017,4093,2004,2089,95.9,4042,1981,2061,96.1
31030, 의정부시,070,65~69세,2017,17959,8290,9669,85.7,17780,8215,9565,85.9
31030, 의정부시,070001, 65세,2017,4388,2039,2349,86.8,4333,2018,2315,87.2
31030, 의정부시,070002, 66세,2017,2993,1388,1605,86.5,2955,1371,1584,86.6
31030, 의정부시,070003, 67세,2017,3476,1601,1875,85.4,3446,1588,1858,85.5
31030, 의정부시,070004, 68세,2017,3590,1666,1924,86.6,3558,1652,1906,86.7
31030, 의정부시,070005, 69세,2017,3512,1596,1916,83.3,3488,1586,1902,83.4
31030, 의정부시,075,70~74세,2017,14797,6606,8191,80.6,14731,6577,8154,80.7
31030, 의정부시,075001, 70세,2017,3672,1691,1981,85.4,3651,1679,1972,85.1
31030, 의정부시,075002, 71세,2017,2832,1258,1574,79.9,2823,1254,1569,79.9
31030, 의정부시,075003, 72세,2017,2797,1250,1547,80.8,2786,1246,1540,80.9
31030, 의정부시,075004, 73세,2017,2717,1187,1530,77.6,2707,1182,1525,77.5
31030, 의정부시,075005, 74세,2017,2779,1220,1559,78.3,2764,1216,1548,78.6
31030, 의정부시,080,75~79세,2017,12695,5395,7300,73.9,12666,5384,7282,73.9
31030, 의정부시,080001, 75세,2017,3252,1407,1845,76.3,3244,1404,1840,76.3
31030, 의정부시,080002, 76세,2017,2607,1136,1471,77.2,2600,1134,1466,77.4
31030, 의정부시,080003, 77세,2017,2422,1027,1395,73.6,2417,1026,1391,73.8
31030, 의정부시,080004, 78세,2017,2319,987,1332,74.1,2315,985,1330,74.1
31030, 의정부시,080005, 79세,2017,2095,838,1257,66.7,2090,835,1255,66.5
31030, 의정부시,085,80~84세,2017,7140,2671,4469,59.8,7129,2670,4459,59.9
31030, 의정부시,085001, 80세,2017,1781,701,1080,64.9,1778,701,1077,65.1
31030, 의정부시,085002, 81세,2017,1646,607,1039,58.4,1643,607,1036,58.6
31030, 의정부시,085003, 82세,2017,1446,548,898,61,1442,547,895,61.1
31030, 의정부시,085004, 83세,2017,1252,428,824,51.9,1252,428,824,51.9
31030, 의정부시,085005, 84세,2017,1015,387,628,61.6,1014,387,627,61.7
31030, 의정부시,090,85~89세,2017,3012,917,2095,43.8,3002,912,2090,43.6
31030, 의정부시,090001, 85세,2017,843,296,547,54.1,841,294,547,53.7
31030, 의정부시,090002, 86세,2017,611,201,410,49,609,200,409,48.9
31030, 의정부시,090003, 87세,2017,626,159,467,34,623,158,465,34
31030, 의정부시,090004, 88세,2017,516,142,374,38,514,141,373,37.8
31030, 의정부시,090005, 89세,2017,416,119,297,40.1,415,119,296,40.2
31030, 의정부시,095,90~94세,2017,960,232,728,31.9,957,230,727,31.6
31030, 의정부시,095001, 90세,2017,320,77,243,31.7,318,76,242,31.4
31030, 의정부시,095002, 91세,2017,221,52,169,30.8,221,52,169,30.8
31030, 의정부시,095003, 92세,2017,170,38,132,28.8,169,37,132,28
31030, 의정부시,095004, 93세,2017,124,27,97,27.8,124,27,97,27.8
31030, 의정부시,095005, 94세,2017,125,38,87,43.7,125,38,87,43.7
31030, 의정부시,100,95~99세,2017,222,61,161,37.9,221,60,161,37.3
31030, 의정부시,100001, 95세,2017,82,23,59,39,82,23,59,39
31030, 의정부시,100002, 96세,2017,53,17,36,47.2,53,17,36,47.2
31030, 의정부시,100003, 97세,2017,42,8,34,23.5,42,8,34,23.5
31030, 의정부시,100004, 98세,2017,29,9,20,45,28,8,20,40
31030, 의정부시,100005, 99세,2017,16,X,12,33.3,16,X,12,33.3
31030, 의정부시,101,100세이상,2017,31,5,26,19.2,31,5,26,19.2
31030, 의정부시,102,15세미만,2017,55629,28544,27085,105.4,55469,28468,27001,105.4
31030, 의정부시,103,15~64세,2017,314085,157798,156287,101,309277,155501,153776,101.1
31030, 의정부시,104,65세이상,2017,56816,24177,32639,74.1,56517,24053,32464,74.1
31030, 의정부시,086,85세이상,2017,4225,1215,3010,40.4,4211,1207,3004,40.2
31030, 의정부시,126,평균연령,2017,41.3,40.3,42.3,,41.3,40.3,42.3,
31030, 의정부시,127,중위연령,2017,42.8,41.7,43.8,,42.9,41.8,43.8,
31040, 안양시,000,합계,2017,576697,285721,290976,98.2,566976,281009,285967,98.3
31040, 안양시,005,0~4세,2017,22950,11637,11313,102.9,22711,11517,11194,102.9
31040, 안양시,005001, 0세,2017,4065,2109,1956,107.8,4025,2089,1936,107.9
31040, 안양시,005002, 1세,2017,4785,2449,2336,104.8,4718,2411,2307,104.5
31040, 안양시,005003, 2세,2017,4856,2399,2457,97.6,4814,2374,2440,97.3
31040, 안양시,005004, 3세,2017,4670,2389,2281,104.7,4620,2369,2251,105.2
31040, 안양시,005005, 4세,2017,4574,2291,2283,100.4,4534,2274,2260,100.6
31040, 안양시,010,5~9세,2017,24530,12704,11826,107.4,24407,12651,11756,107.6
31040, 안양시,010001, 5세,2017,5030,2634,2396,109.9,4988,2617,2371,110.4
31040, 안양시,010002, 6세,2017,5033,2559,2474,103.4,5012,2552,2460,103.7
31040, 안양시,010003, 7세,2017,4784,2496,2288,109.1,4758,2485,2273,109.3
31040, 안양시,010004, 8세,2017,4602,2396,2206,108.6,4584,2386,2198,108.6
31040, 안양시,010005, 9세,2017,5081,2619,2462,106.4,5065,2611,2454,106.4
31040, 안양시,015,10~14세,2017,26110,13546,12564,107.8,26056,13519,12537,107.8
31040, 안양시,015001, 10세,2017,5143,2676,2467,108.5,5128,2670,2458,108.6
31040, 안양시,015002, 11세,2017,4986,2579,2407,107.1,4978,2575,2403,107.2
31040, 안양시,015003, 12세,2017,4927,2547,2380,107,4919,2543,2376,107
31040, 안양시,015004, 13세,2017,5316,2783,2533,109.9,5300,2773,2527,109.7
31040, 안양시,015005, 14세,2017,5738,2961,2777,106.6,5731,2958,2773,106.7
31040, 안양시,020,15~19세,2017,33843,17486,16357,106.9,33659,17403,16256,107.1
31040, 안양시,020001, 15세,2017,5726,2997,2729,109.8,5716,2993,2723,109.9
31040, 안양시,020002, 16세,2017,6620,3417,3203,106.7,6605,3407,3198,106.5
31040, 안양시,020003, 17세,2017,7217,3764,3453,109,7189,3750,3439,109
31040, 안양시,020004, 18세,2017,7140,3742,3398,110.1,7107,3721,3386,109.9
31040, 안양시,020005, 19세,2017,7140,3566,3574,99.8,7042,3532,3510,100.6
31040, 안양시,025,20~24세,2017,40615,21082,19533,107.9,40122,20848,19274,108.2
31040, 안양시,025001, 20세,2017,7690,4004,3686,108.6,7610,3975,3635,109.4
31040, 안양시,025002, 21세,2017,8021,4258,3763,113.2,7943,4221,3722,113.4
31040, 안양시,025003, 22세,2017,8222,4297,3925,109.5,8136,4253,3883,109.5
31040, 안양시,025004, 23세,2017,8357,4277,4080,104.8,8237,4211,4026,104.6
31040, 안양시,025005, 24세,2017,8325,4246,4079,104.1,8196,4188,4008,104.5
31040, 안양시,030,25~29세,2017,41322,21183,20139,105.2,40208,20688,19520,106
31040, 안양시,030001, 25세,2017,8724,4414,4310,102.4,8537,4329,4208,102.9
31040, 안양시,030002, 26세,2017,8552,4403,4149,106.1,8350,4317,4033,107
31040, 안양시,030003, 27세,2017,8061,4183,3878,107.9,7832,4078,3754,108.6
31040, 안양시,030004, 28세,2017,8020,4040,3980,101.5,7808,3949,3859,102.3
31040, 안양시,030005, 29세,2017,7965,4143,3822,108.4,7681,4015,3666,109.5
31040, 안양시,035,30~34세,2017,40683,20992,19691,106.6,39506,20393,19113,106.7
31040, 안양시,035001, 30세,2017,7818,3974,3844,103.4,7557,3853,3704,104
31040, 안양시,035002, 31세,2017,7960,4118,3842,107.2,7715,4000,3715,107.7
31040, 안양시,035003, 32세,2017,7804,4025,3779,106.5,7582,3913,3669,106.7
31040, 안양시,035004, 33세,2017,8318,4309,4009,107.5,8079,4179,3900,107.2
31040, 안양시,035005, 34세,2017,8783,4566,4217,108.3,8573,4448,4125,107.8
31040, 안양시,040,35~39세,2017,44581,22620,21961,103,43658,22134,21524,102.8
31040, 안양시,040001, 35세,2017,9367,4843,4524,107.1,9125,4720,4405,107.2
31040, 안양시,040002, 36세,2017,9304,4813,4491,107.2,9134,4728,4406,107.3
31040, 안양시,040003, 37세,2017,9228,4606,4622,99.7,9063,4505,4558,98.8
31040, 안양시,040004, 38세,2017,8719,4409,4310,102.3,8535,4321,4214,102.5
31040, 안양시,040005, 39세,2017,7963,3949,4014,98.4,7801,3860,3941,97.9
31040, 안양시,045,40~44세,2017,45190,22214,22976,96.7,44414,21782,22632,96.2
31040, 안양시,045001, 40세,2017,8325,4080,4245,96.1,8185,4002,4183,95.7
31040, 안양시,045002, 41세,2017,8261,4124,4137,99.7,8115,4033,4082,98.8
31040, 안양시,045003, 42세,2017,8883,4360,4523,96.4,8733,4274,4459,95.9
31040, 안양시,045004, 43세,2017,9775,4858,4917,98.8,9615,4774,4841,98.6
31040, 안양시,045005, 44세,2017,9946,4792,5154,93,9766,4699,5067,92.7
31040, 안양시,050,45~49세,2017,54195,26232,27963,93.8,53232,25769,27463,93.8
31040, 안양시,050001, 45세,2017,10198,5071,5127,98.9,10022,4975,5047,98.6
31040, 안양시,050002, 46세,2017,10988,5307,5681,93.4,10805,5220,5585,93.5
31040, 안양시,050003, 47세,2017,10866,5215,5651,92.3,10659,5125,5534,92.6
31040, 안양시,050004, 48세,2017,11073,5328,5745,92.7,10875,5239,5636,93
31040, 안양시,050005, 49세,2017,11070,5311,5759,92.2,10871,5210,5661,92
31040, 안양시,055,50~54세,2017,50573,24765,25808,96,49445,24209,25236,95.9
31040, 안양시,055001, 50세,2017,10122,4768,5354,89.1,9949,4687,5262,89.1
31040, 안양시,055002, 51세,2017,10018,5004,5014,99.8,9826,4903,4923,99.6
31040, 안양시,055003, 52세,2017,10402,5055,5347,94.5,10175,4945,5230,94.6
31040, 안양시,055004, 53세,2017,9821,4914,4907,100.1,9585,4794,4791,100.1
31040, 안양시,055005, 54세,2017,10210,5024,5186,96.9,9910,4880,5030,97
31040, 안양시,060,55~59세,2017,51996,25371,26625,95.3,51047,24938,26109,95.5
31040, 안양시,060001, 55세,2017,10566,5089,5477,92.9,10363,4990,5373,92.9
31040, 안양시,060002, 56세,2017,11178,5366,5812,92.3,11030,5310,5720,92.8
31040, 안양시,060003, 57세,2017,11272,5445,5827,93.4,11052,5343,5709,93.6
31040, 안양시,060004, 58세,2017,9782,4816,4966,97,9612,4741,4871,97.3
31040, 안양시,060005, 59세,2017,9198,4655,4543,102.5,8990,4554,4436,102.7
31040, 안양시,065,60~64세,2017,36274,18258,18016,101.3,35322,17777,17545,101.3
31040, 안양시,065001, 60세,2017,8776,4343,4433,98,8530,4225,4305,98.1
31040, 안양시,065002, 61세,2017,7709,3825,3884,98.5,7506,3725,3781,98.5
31040, 안양시,065003, 62세,2017,7930,3991,3939,101.3,7742,3895,3847,101.2
31040, 안양시,065004, 63세,2017,6363,3294,3069,107.3,6199,3204,2995,107
31040, 안양시,065005, 64세,2017,5496,2805,2691,104.2,5345,2728,2617,104.2
31040, 안양시,070,65~69세,2017,22230,11078,11152,99.3,21831,10902,10929,99.8
31040, 안양시,070001, 65세,2017,5755,2903,2852,101.8,5631,2841,2790,101.8
31040, 안양시,070002, 66세,2017,3917,1919,1998,96,3824,1877,1947,96.4
31040, 안양시,070003, 67세,2017,4401,2247,2154,104.3,4329,2221,2108,105.4
31040, 안양시,070004, 68세,2017,4133,2073,2060,100.6,4062,2043,2019,101.2
31040, 안양시,070005, 69세,2017,4024,1936,2088,92.7,3985,1920,2065,93
31040, 안양시,075,70~74세,2017,15649,7164,8485,84.4,15544,7132,8412,84.8
31040, 안양시,075001, 70세,2017,3909,1823,2086,87.4,3880,1810,2070,87.4
31040, 안양시,075002, 71세,2017,3037,1434,1603,89.5,3016,1429,1587,90
31040, 안양시,075003, 72세,2017,2943,1334,1609,82.9,2925,1331,1594,83.5
31040, 안양시,075004, 73세,2017,2920,1297,1623,79.9,2899,1292,1607,80.4
31040, 안양시,075005, 74세,2017,2840,1276,1564,81.6,2824,1270,1554,81.7
31040, 안양시,080,75~79세,2017,12801,5366,7435,72.2,12725,5342,7383,72.4
31040, 안양시,080001, 75세,2017,3376,1492,1884,79.2,3358,1488,1870,79.6
31040, 안양시,080002, 76세,2017,2611,1120,1491,75.1,2592,1112,1480,75.1
31040, 안양시,080003, 77세,2017,2274,921,1353,68.1,2263,919,1344,68.4
31040, 안양시,080004, 78세,2017,2353,983,1370,71.8,2337,976,1361,71.7
31040, 안양시,080005, 79세,2017,2187,850,1337,63.6,2175,847,1328,63.8
31040, 안양시,085,80~84세,2017,7830,2646,5184,51,7785,2632,5153,51.1
31040, 안양시,085001, 80세,2017,1907,699,1208,57.9,1894,694,1200,57.8
31040, 안양시,085002, 81세,2017,1692,588,1104,53.3,1677,585,1092,53.6
31040, 안양시,085003, 82세,2017,1627,537,1090,49.3,1618,534,1084,49.3
31040, 안양시,085004, 83세,2017,1387,444,943,47.1,1382,442,940,47
31040, 안양시,085005, 84세,2017,1217,378,839,45.1,1214,377,837,45
31040, 안양시,090,85~89세,2017,3792,1027,2765,37.1,3772,1023,2749,37.2
31040, 안양시,090001, 85세,2017,1064,313,751,41.7,1058,313,745,42
31040, 안양시,090002, 86세,2017,851,236,615,38.4,848,236,612,38.6
31040, 안양시,090003, 87세,2017,783,202,581,34.8,778,199,579,34.4
31040, 안양시,090004, 88세,2017,583,149,434,34.3,580,148,432,34.3
31040, 안양시,090005, 89세,2017,511,127,384,33.1,508,127,381,33.3
31040, 안양시,095,90~94세,2017,1252,294,958,30.7,1251,294,957,30.7
31040, 안양시,095001, 90세,2017,389,91,298,30.5,388,91,297,30.6
31040, 안양시,095002, 91세,2017,289,59,230,25.7,289,59,230,25.7
31040, 안양시,095003, 92세,2017,252,63,189,33.3,252,63,189,33.3
31040, 안양시,095004, 93세,2017,168,48,120,40,168,48,120,40
31040, 안양시,095005, 94세,2017,154,33,121,27.3,154,33,121,27.3
31040, 안양시,100,95~99세,2017,244,53,191,27.7,244,53,191,27.7
31040, 안양시,100001, 95세,2017,94,19,75,25.3,94,19,75,25.3
31040, 안양시,100002, 96세,2017,56,9,47,19.1,56,9,47,19.1
31040, 안양시,100003, 97세,2017,48,13,35,37.1,48,13,35,37.1
31040, 안양시,100004, 98세,2017,28,8,20,40,28,8,20,40
31040, 안양시,100005, 99세,2017,18,X,14,28.6,18,X,14,28.6
31040, 안양시,101,100세이상,2017,37,X,34,8.8,37,X,34,8.8
31040, 안양시,102,15세미만,2017,73590,37887,35703,106.1,73174,37687,35487,106.2
31040, 안양시,103,15~64세,2017,439272,220203,219069,100.5,430613,215941,214672,100.6
31040, 안양시,104,65세이상,2017,63835,27631,36204,76.3,63189,27381,35808,76.5
31040, 안양시,086,85세이상,2017,5325,1377,3948,34.9,5304,1373,3931,34.9
31040, 안양시,126,평균연령,2017,40.5,39.5,41.4,,40.4,39.5,41.4,
31040, 안양시,127,중위연령,2017,41.7,40.4,42.8,,41.6,40.3,42.8,
31041, 만안구,000,합계,2017,254107,127061,127046,100,246822,123485,123337,100.1
31041, 만안구,005,0~4세,2017,9813,4943,4870,101.5,9630,4850,4780,101.5
31041, 만안구,005001, 0세,2017,1761,930,831,111.9,1726,911,815,111.8
31041, 만안구,005002, 1세,2017,2143,1058,1085,97.5,2086,1025,1061,96.6
31041, 만안구,005003, 2세,2017,2075,1038,1037,100.1,2044,1022,1022,100
31041, 만안구,005004, 3세,2017,1967,986,981,100.5,1932,971,961,101
31041, 만안구,005005, 4세,2017,1867,931,936,99.5,1842,921,921,100
31041, 만안구,010,5~9세,2017,9241,4815,4426,108.8,9147,4777,4370,109.3
31041, 만안구,010001, 5세,2017,2018,1076,942,114.2,1985,1065,920,115.8
31041, 만안구,010002, 6세,2017,1867,944,923,102.3,1853,938,915,102.5
31041, 만안구,010003, 7세,2017,1796,939,857,109.6,1776,931,845,110.2
31041, 만안구,010004, 8세,2017,1674,877,797,110,1658,869,789,110.1
31041, 만안구,010005, 9세,2017,1886,979,907,107.9,1875,974,901,108.1
31041, 만안구,015,10~14세,2017,9307,4909,4398,111.6,9273,4896,4377,111.9
31041, 만안구,015001, 10세,2017,1837,976,861,113.4,1826,972,854,113.8
31041, 만안구,015002, 11세,2017,1784,919,865,106.2,1779,916,863,106.1
31041, 만안구,015003, 12세,2017,1707,905,802,112.8,1702,903,799,113
31041, 만안구,015004, 13세,2017,1865,989,876,112.9,1856,986,870,113.3
31041, 만안구,015005, 14세,2017,2114,1120,994,112.7,2110,1119,991,112.9
31041, 만안구,020,15~19세,2017,13408,6960,6448,107.9,13245,6884,6361,108.2
31041, 만안구,020001, 15세,2017,2057,1067,990,107.8,2048,1063,985,107.9
31041, 만안구,020002, 16세,2017,2520,1366,1154,118.4,2510,1358,1152,117.9
31041, 만안구,020003, 17세,2017,2943,1552,1391,111.6,2921,1540,1381,111.5
31041, 만안구,020004, 18세,2017,2788,1440,1348,106.8,2758,1421,1337,106.3
31041, 만안구,020005, 19세,2017,3100,1535,1565,98.1,3008,1502,1506,99.7
31041, 만안구,025,20~24세,2017,18744,9514,9230,103.1,18388,9343,9045,103.3
31041, 만안구,025001, 20세,2017,3464,1733,1731,100.1,3393,1706,1687,101.1
31041, 만안구,025002, 21세,2017,3632,1853,1779,104.2,3578,1830,1748,104.7
31041, 만안구,025003, 22세,2017,3886,1984,1902,104.3,3818,1948,1870,104.2
31041, 만안구,025004, 23세,2017,3881,1958,1923,101.8,3804,1915,1889,101.4
31041, 만안구,025005, 24세,2017,3881,1986,1895,104.8,3795,1944,1851,105
31041, 만안구,030,25~29세,2017,19062,9866,9196,107.3,18282,9518,8764,108.6
31041, 만안구,030001, 25세,2017,4062,2050,2012,101.9,3934,1991,1943,102.5
31041, 만안구,030002, 26세,2017,3901,2059,1842,111.8,3753,1998,1755,113.8
31041, 만안구,030003, 27세,2017,3740,1958,1782,109.9,3574,1884,1690,111.5
31041, 만안구,030004, 28세,2017,3676,1849,1827,101.2,3531,1783,1748,102
31041, 만안구,030005, 29세,2017,3683,1950,1733,112.5,3490,1862,1628,114.4
31041, 만안구,035,30~34세,2017,18255,9653,8602,112.2,17452,9234,8218,112.4
31041, 만안구,035001, 30세,2017,3475,1797,1678,107.1,3305,1714,1591,107.7
31041, 만안구,035002, 31세,2017,3566,1864,1702,109.5,3394,1783,1611,110.7
31041, 만안구,035003, 32세,2017,3491,1863,1628,114.4,3335,1781,1554,114.6
31041, 만안구,035004, 33세,2017,3728,2019,1709,118.1,3569,1927,1642,117.4
31041, 만안구,035005, 34세,2017,3995,2110,1885,111.9,3849,2029,1820,111.5
31041, 만안구,040,35~39세,2017,19558,10337,9221,112.1,18934,9992,8942,111.7
31041, 만안구,040001, 35세,2017,4218,2248,1970,114.1,4055,2162,1893,114.2
31041, 만안구,040002, 36세,2017,4147,2222,1925,115.4,4039,2163,1876,115.3
31041, 만안구,040003, 37세,2017,4073,2109,1964,107.4,3967,2041,1926,106
31041, 만안구,040004, 38세,2017,3742,1968,1774,110.9,3610,1904,1706,111.6
31041, 만안구,040005, 39세,2017,3378,1790,1588,112.7,3263,1722,1541,111.7
31041, 만안구,045,40~44세,2017,18195,9543,8652,110.3,17640,9220,8420,109.5
31041, 만안구,045001, 40세,2017,3497,1832,1665,110,3400,1775,1625,109.2
31041, 만안구,045002, 41세,2017,3406,1824,1582,115.3,3300,1755,1545,113.6
31041, 만안구,045003, 42세,2017,3496,1843,1653,111.5,3390,1781,1609,110.7
31041, 만안구,045004, 43세,2017,3841,2040,1801,113.3,3731,1982,1749,113.3
31041, 만안구,045005, 44세,2017,3955,2004,1951,102.7,3819,1927,1892,101.8
31041, 만안구,050,45~49세,2017,21709,10620,11089,95.8,20992,10284,10708,96
31041, 만안구,050001, 45세,2017,4056,2073,1983,104.5,3932,2007,1925,104.3
31041, 만안구,050002, 46세,2017,4310,2132,2178,97.9,4178,2071,2107,98.3
31041, 만안구,050003, 47세,2017,4330,2091,2239,93.4,4167,2026,2141,94.6
31041, 만안구,050004, 48세,2017,4415,2112,2303,91.7,4270,2050,2220,92.3
31041, 만안구,050005, 49세,2017,4598,2212,2386,92.7,4445,2130,2315,92
31041, 만안구,055,50~54세,2017,22475,11015,11460,96.1,21560,10559,11001,96
31041, 만안구,055001, 50세,2017,4319,2017,2302,87.6,4190,1954,2236,87.4
31041, 만안구,055002, 51세,2017,4397,2192,2205,99.4,4245,2111,2134,98.9
31041, 만안구,055003, 52세,2017,4634,2228,2406,92.6,4447,2138,2309,92.6
31041, 만안구,055004, 53세,2017,4418,2262,2156,104.9,4219,2163,2056,105.2
31041, 만안구,055005, 54세,2017,4707,2316,2391,96.9,4459,2193,2266,96.8
31041, 만안구,060,55~59세,2017,24227,11883,12344,96.3,23443,11522,11921,96.7
31041, 만안구,060001, 55세,2017,4866,2390,2476,96.5,4698,2308,2390,96.6
31041, 만안구,060002, 56세,2017,5163,2490,2673,93.2,5039,2443,2596,94.1
31041, 만안구,060003, 57세,2017,5243,2552,2691,94.8,5063,2466,2597,95
31041, 만안구,060004, 58세,2017,4589,2243,2346,95.6,4453,2181,2272,96
31041, 만안구,060005, 59세,2017,4366,2208,2158,102.3,4190,2124,2066,102.8
31041, 만안구,065,60~64세,2017,17707,8800,8907,98.8,16912,8392,8520,98.5
31041, 만안구,065001, 60세,2017,4263,2078,2185,95.1,4059,1976,2083,94.9
31041, 만안구,065002, 61세,2017,3731,1845,1886,97.8,3557,1755,1802,97.4
31041, 만안구,065003, 62세,2017,3767,1842,1925,95.7,3613,1764,1849,95.4
31041, 만안구,065004, 63세,2017,3220,1657,1563,106,3081,1582,1499,105.5
31041, 만안구,065005, 64세,2017,2726,1378,1348,102.2,2602,1315,1287,102.2
31041, 만안구,070,65~69세,2017,11380,5686,5694,99.9,11073,5549,5524,100.5
31041, 만안구,070001, 65세,2017,2916,1441,1475,97.7,2816,1390,1426,97.5
31041, 만안구,070002, 66세,2017,2011,978,1033,94.7,1938,943,995,94.8
31041, 만안구,070003, 67세,2017,2223,1156,1067,108.3,2170,1138,1032,110.3
31041, 만안구,070004, 68세,2017,2151,1082,1069,101.2,2100,1060,1040,101.9
31041, 만안구,070005, 69세,2017,2079,1029,1050,98,2049,1018,1031,98.7
31041, 만안구,075,70~74세,2017,8114,3738,4376,85.4,8039,3715,4324,85.9
31041, 만안구,075001, 70세,2017,2007,931,1076,86.5,1989,923,1066,86.6
31041, 만안구,075002, 71세,2017,1551,733,818,89.6,1536,728,808,90.1
31041, 만안구,075003, 72세,2017,1544,690,854,80.8,1531,688,843,81.6
31041, 만안구,075004, 73세,2017,1501,693,808,85.8,1486,690,796,86.7
31041, 만안구,075005, 74세,2017,1511,691,820,84.3,1497,686,811,84.6
31041, 만안구,080,75~79세,2017,6561,2823,3738,75.5,6511,2808,3703,75.8
31041, 만안구,080001, 75세,2017,1792,806,986,81.7,1780,802,978,82
31041, 만안구,080002, 76세,2017,1335,595,740,80.4,1323,591,732,80.7
31041, 만안구,080003, 77세,2017,1144,469,675,69.5,1135,468,667,70.2
31041, 만안구,080004, 78세,2017,1186,519,667,77.8,1177,516,661,78.1
31041, 만안구,080005, 79세,2017,1104,434,670,64.8,1096,431,665,64.8
31041, 만안구,085,80~84세,2017,3844,1351,2493,54.2,3809,1340,2469,54.3
31041, 만안구,085001, 80세,2017,955,359,596,60.2,945,354,591,59.9
31041, 만안구,085002, 81세,2017,812,293,519,56.5,800,291,509,57.2
31041, 만안구,085003, 82세,2017,799,273,526,51.9,791,270,521,51.8
31041, 만안구,085004, 83세,2017,678,232,446,52,675,231,444,52
31041, 만안구,085005, 84세,2017,600,194,406,47.8,598,194,404,48
31041, 만안구,090,85~89세,2017,1760,443,1317,33.6,1746,440,1306,33.7
31041, 만안구,090001, 85세,2017,499,128,371,34.5,494,128,366,35
31041, 만안구,090002, 86세,2017,392,108,284,38,389,108,281,38.4
31041, 만안구,090003, 87세,2017,355,78,277,28.2,352,76,276,27.5
31041, 만안구,090004, 88세,2017,277,69,208,33.2,274,68,206,33
31041, 만안구,090005, 89세,2017,237,60,177,33.9,237,60,177,33.9
31041, 만안구,095,90~94세,2017,609,137,472,29,608,137,471,29.1
31041, 만안구,095001, 90세,2017,188,42,146,28.8,187,42,145,29
31041, 만안구,095002, 91세,2017,136,23,113,20.4,136,23,113,20.4
31041, 만안구,095003, 92세,2017,128,34,94,36.2,128,34,94,36.2
31041, 만안구,095004, 93세,2017,73,24,49,49,73,24,49,49
31041, 만안구,095005, 94세,2017,84,14,70,20,84,14,70,20
31041, 만안구,100,95~99세,2017,118,24,94,25.5,118,24,94,25.5
31041, 만안구,100001, 95세,2017,43,8,35,22.9,43,8,35,22.9
31041, 만안구,100002, 96세,2017,28,5,23,21.7,28,5,23,21.7
31041, 만안구,100003, 97세,2017,21,6,15,40,21,6,15,40
31041, 만안구,100004, 98세,2017,16,X,13,23.1,16,X,13,23.1
31041, 만안구,100005, 99세,2017,10,X,8,25,10,X,8,25
31041, 만안구,101,100세이상,2017,20,X,19,5.3,20,X,19,5.3
31041, 만안구,102,15세미만,2017,28361,14667,13694,107.1,28050,14523,13527,107.4
31041, 만안구,103,15~64세,2017,193340,98191,95149,103.2,186848,94948,91900,103.3
31041, 만안구,104,65세이상,2017,32406,14203,18203,78,31924,14014,17910,78.2
31041, 만안구,086,85세이상,2017,2507,605,1902,31.8,2492,602,1890,31.9
31041, 만안구,126,평균연령,2017,41.7,40.7,42.7,,41.7,40.7,42.7,
31041, 만안구,127,중위연령,2017,42.8,41.4,44.2,,42.7,41.3,44.1,
31042, 동안구,000,합계,2017,322590,158660,163930,96.8,320154,157524,162630,96.9
31042, 동안구,005,0~4세,2017,13137,6694,6443,103.9,13081,6667,6414,103.9
31042, 동안구,005001, 0세,2017,2304,1179,1125,104.8,2299,1178,1121,105.1
31042, 동안구,005002, 1세,2017,2642,1391,1251,111.2,2632,1386,1246,111.2
31042, 동안구,005003, 2세,2017,2781,1361,1420,95.8,2770,1352,1418,95.3
31042, 동안구,005004, 3세,2017,2703,1403,1300,107.9,2688,1398,1290,108.4
31042, 동안구,005005, 4세,2017,2707,1360,1347,101,2692,1353,1339,101
31042, 동안구,010,5~9세,2017,15289,7889,7400,106.6,15260,7874,7386,106.6
31042, 동안구,010001, 5세,2017,3012,1558,1454,107.2,3003,1552,1451,107
31042, 동안구,010002, 6세,2017,3166,1615,1551,104.1,3159,1614,1545,104.5
31042, 동안구,010003, 7세,2017,2988,1557,1431,108.8,2982,1554,1428,108.8
31042, 동안구,010004, 8세,2017,2928,1519,1409,107.8,2926,1517,1409,107.7
31042, 동안구,010005, 9세,2017,3195,1640,1555,105.5,3190,1637,1553,105.4
31042, 동안구,015,10~14세,2017,16803,8637,8166,105.8,16783,8623,8160,105.7
31042, 동안구,015001, 10세,2017,3306,1700,1606,105.9,3302,1698,1604,105.9
31042, 동안구,015002, 11세,2017,3202,1660,1542,107.7,3199,1659,1540,107.7
31042, 동안구,015003, 12세,2017,3220,1642,1578,104.1,3217,1640,1577,104
31042, 동안구,015004, 13세,2017,3451,1794,1657,108.3,3444,1787,1657,107.8
31042, 동안구,015005, 14세,2017,3624,1841,1783,103.3,3621,1839,1782,103.2
31042, 동안구,020,15~19세,2017,20435,10526,9909,106.2,20414,10519,9895,106.3
31042, 동안구,020001, 15세,2017,3669,1930,1739,111,3668,1930,1738,111
31042, 동안구,020002, 16세,2017,4100,2051,2049,100.1,4095,2049,2046,100.1
31042, 동안구,020003, 17세,2017,4274,2212,2062,107.3,4268,2210,2058,107.4
31042, 동안구,020004, 18세,2017,4352,2302,2050,112.3,4349,2300,2049,112.2
31042, 동안구,020005, 19세,2017,4040,2031,2009,101.1,4034,2030,2004,101.3
31042, 동안구,025,20~24세,2017,21871,11568,10303,112.3,21734,11505,10229,112.5
31042, 동안구,025001, 20세,2017,4226,2271,1955,116.2,4217,2269,1948,116.5
31042, 동안구,025002, 21세,2017,4389,2405,1984,121.2,4365,2391,1974,121.1
31042, 동안구,025003, 22세,2017,4336,2313,2023,114.3,4318,2305,2013,114.5
31042, 동안구,025004, 23세,2017,4476,2319,2157,107.5,4433,2296,2137,107.4
31042, 동안구,025005, 24세,2017,4444,2260,2184,103.5,4401,2244,2157,104
31042, 동안구,030,25~29세,2017,22260,11317,10943,103.4,21926,11170,10756,103.8
31042, 동안구,030001, 25세,2017,4662,2364,2298,102.9,4603,2338,2265,103.2
31042, 동안구,030002, 26세,2017,4651,2344,2307,101.6,4597,2319,2278,101.8
31042, 동안구,030003, 27세,2017,4321,2225,2096,106.2,4258,2194,2064,106.3
31042, 동안구,030004, 28세,2017,4344,2191,2153,101.8,4277,2166,2111,102.6
31042, 동안구,030005, 29세,2017,4282,2193,2089,105,4191,2153,2038,105.6
31042, 동안구,035,30~34세,2017,22428,11339,11089,102.3,22054,11159,10895,102.4
31042, 동안구,035001, 30세,2017,4343,2177,2166,100.5,4252,2139,2113,101.2
31042, 동안구,035002, 31세,2017,4394,2254,2140,105.3,4321,2217,2104,105.4
31042, 동안구,035003, 32세,2017,4313,2162,2151,100.5,4247,2132,2115,100.8
31042, 동안구,035004, 33세,2017,4590,2290,2300,99.6,4510,2252,2258,99.7
31042, 동안구,035005, 34세,2017,4788,2456,2332,105.3,4724,2419,2305,104.9
31042, 동안구,040,35~39세,2017,25023,12283,12740,96.4,24724,12142,12582,96.5
31042, 동안구,040001, 35세,2017,5149,2595,2554,101.6,5070,2558,2512,101.8
31042, 동안구,040002, 36세,2017,5157,2591,2566,101,5095,2565,2530,101.4
31042, 동안구,040003, 37세,2017,5155,2497,2658,93.9,5096,2464,2632,93.6
31042, 동안구,040004, 38세,2017,4977,2441,2536,96.3,4925,2417,2508,96.4
31042, 동안구,040005, 39세,2017,4585,2159,2426,89,4538,2138,2400,89.1
31042, 동안구,045,40~44세,2017,26995,12671,14324,88.5,26774,12562,14212,88.4
31042, 동안구,045001, 40세,2017,4828,2248,2580,87.1,4785,2227,2558,87.1
31042, 동안구,045002, 41세,2017,4855,2300,2555,90,4815,2278,2537,89.8
31042, 동안구,045003, 42세,2017,5387,2517,2870,87.7,5343,2493,2850,87.5
31042, 동안구,045004, 43세,2017,5934,2818,3116,90.4,5884,2792,3092,90.3
31042, 동안구,045005, 44세,2017,5991,2788,3203,87,5947,2772,3175,87.3
31042, 동안구,050,45~49세,2017,32486,15612,16874,92.5,32240,15485,16755,92.4
31042, 동안구,050001, 45세,2017,6142,2998,3144,95.4,6090,2968,3122,95.1
31042, 동안구,050002, 46세,2017,6678,3175,3503,90.6,6627,3149,3478,90.5
31042, 동안구,050003, 47세,2017,6536,3124,3412,91.6,6492,3099,3393,91.3
31042, 동안구,050004, 48세,2017,6658,3216,3442,93.4,6605,3189,3416,93.4
31042, 동안구,050005, 49세,2017,6472,3099,3373,91.9,6426,3080,3346,92.1
31042, 동안구,055,50~54세,2017,28098,13750,14348,95.8,27885,13650,14235,95.9
31042, 동안구,055001, 50세,2017,5803,2751,3052,90.1,5759,2733,3026,90.3
31042, 동안구,055002, 51세,2017,5621,2812,2809,100.1,5581,2792,2789,100.1
31042, 동안구,055003, 52세,2017,5768,2827,2941,96.1,5728,2807,2921,96.1
31042, 동안구,055004, 53세,2017,5403,2652,2751,96.4,5366,2631,2735,96.2
31042, 동안구,055005, 54세,2017,5503,2708,2795,96.9,5451,2687,2764,97.2
31042, 동안구,060,55~59세,2017,27769,13488,14281,94.4,27604,13416,14188,94.6
31042, 동안구,060001, 55세,2017,5700,2699,3001,89.9,5665,2682,2983,89.9
31042, 동안구,060002, 56세,2017,6015,2876,3139,91.6,5991,2867,3124,91.8
31042, 동안구,060003, 57세,2017,6029,2893,3136,92.3,5989,2877,3112,92.4
31042, 동안구,060004, 58세,2017,5193,2573,2620,98.2,5159,2560,2599,98.5
31042, 동안구,060005, 59세,2017,4832,2447,2385,102.6,4800,2430,2370,102.5
31042, 동안구,065,60~64세,2017,18567,9458,9109,103.8,18410,9385,9025,104
31042, 동안구,065001, 60세,2017,4513,2265,2248,100.8,4471,2249,2222,101.2
31042, 동안구,065002, 61세,2017,3978,1980,1998,99.1,3949,1970,1979,99.5
31042, 동안구,065003, 62세,2017,4163,2149,2014,106.7,4129,2131,1998,106.7
31042, 동안구,065004, 63세,2017,3143,1637,1506,108.7,3118,1622,1496,108.4
31042, 동안구,065005, 64세,2017,2770,1427,1343,106.3,2743,1413,1330,106.2
31042, 동안구,070,65~69세,2017,10850,5392,5458,98.8,10758,5353,5405,99
31042, 동안구,070001, 65세,2017,2839,1462,1377,106.2,2815,1451,1364,106.4
31042, 동안구,070002, 66세,2017,1906,941,965,97.5,1886,934,952,98.1
31042, 동안구,070003, 67세,2017,2178,1091,1087,100.4,2159,1083,1076,100.7
31042, 동안구,070004, 68세,2017,1982,991,991,100,1962,983,979,100.4
31042, 동안구,070005, 69세,2017,1945,907,1038,87.4,1936,902,1034,87.2
31042, 동안구,075,70~74세,2017,7535,3426,4109,83.4,7505,3417,4088,83.6
31042, 동안구,075001, 70세,2017,1902,892,1010,88.3,1891,887,1004,88.3
31042, 동안구,075002, 71세,2017,1486,701,785,89.3,1480,701,779,90
31042, 동안구,075003, 72세,2017,1399,644,755,85.3,1394,643,751,85.6
31042, 동안구,075004, 73세,2017,1419,604,815,74.1,1413,602,811,74.2
31042, 동안구,075005, 74세,2017,1329,585,744,78.6,1327,584,743,78.6
31042, 동안구,080,75~79세,2017,6240,2543,3697,68.8,6214,2534,3680,68.9
31042, 동안구,080001, 75세,2017,1584,686,898,76.4,1578,686,892,76.9
31042, 동안구,080002, 76세,2017,1276,525,751,69.9,1269,521,748,69.7
31042, 동안구,080003, 77세,2017,1130,452,678,66.7,1128,451,677,66.6
31042, 동안구,080004, 78세,2017,1167,464,703,66,1160,460,700,65.7
31042, 동안구,080005, 79세,2017,1083,416,667,62.4,1079,416,663,62.7
31042, 동안구,085,80~84세,2017,3986,1295,2691,48.1,3976,1292,2684,48.1
31042, 동안구,085001, 80세,2017,952,340,612,55.6,949,340,609,55.8
31042, 동안구,085002, 81세,2017,880,295,585,50.4,877,294,583,50.4
31042, 동안구,085003, 82세,2017,828,264,564,46.8,827,264,563,46.9
31042, 동안구,085004, 83세,2017,709,212,497,42.7,707,211,496,42.5
31042, 동안구,085005, 84세,2017,617,184,433,42.5,616,183,433,42.3
31042, 동안구,090,85~89세,2017,2032,584,1448,40.3,2026,583,1443,40.4
31042, 동안구,090001, 85세,2017,565,185,380,48.7,564,185,379,48.8
31042, 동안구,090002, 86세,2017,459,128,331,38.7,459,128,331,38.7
31042, 동안구,090003, 87세,2017,428,124,304,40.8,426,123,303,40.6
31042, 동안구,090004, 88세,2017,306,80,226,35.4,306,80,226,35.4
31042, 동안구,090005, 89세,2017,274,67,207,32.4,271,67,204,32.8
31042, 동안구,095,90~94세,2017,643,157,486,32.3,643,157,486,32.3
31042, 동안구,095001, 90세,2017,201,49,152,32.2,201,49,152,32.2
31042, 동안구,095002, 91세,2017,153,36,117,30.8,153,36,117,30.8
31042, 동안구,095003, 92세,2017,124,29,95,30.5,124,29,95,30.5
31042, 동안구,095004, 93세,2017,95,24,71,33.8,95,24,71,33.8
31042, 동안구,095005, 94세,2017,70,19,51,37.3,70,19,51,37.3
31042, 동안구,100,95~99세,2017,126,29,97,29.9,126,29,97,29.9
31042, 동안구,100001, 95세,2017,51,11,40,27.5,51,11,40,27.5
31042, 동안구,100002, 96세,2017,28,X,24,16.7,28,X,24,16.7
31042, 동안구,100003, 97세,2017,27,7,20,35,27,7,20,35
31042, 동안구,100004, 98세,2017,12,5,7,71.4,12,5,7,71.4
31042, 동안구,100005, 99세,2017,8,X,6,33.3,8,X,6,33.3
31042, 동안구,101,100세이상,2017,17,X,15,13.3,17,X,15,13.3
31042, 동안구,102,15세미만,2017,45229,23220,22009,105.5,45124,23164,21960,105.5
31042, 동안구,103,15~64세,2017,245932,122012,123920,98.5,243765,120993,122772,98.6
31042, 동안구,104,65세이상,2017,31429,13428,18001,74.6,31265,13367,17898,74.7
31042, 동안구,086,85세이상,2017,2818,772,2046,37.7,2812,771,2041,37.8
31042, 동안구,126,평균연령,2017,39.5,38.6,40.4,,39.5,38.5,40.4,
31042, 동안구,127,중위연령,2017,40.8,39.6,41.9,,40.9,39.6,42,
31050, 부천시,000,합계,2017,845514,420656,424858,99,817493,406520,410973,98.9
31050, 부천시,005,0~4세,2017,33682,17297,16385,105.6,32823,16843,15980,105.4
31050, 부천시,005001, 0세,2017,6142,3186,2956,107.8,5954,3072,2882,106.6
31050, 부천시,005002, 1세,2017,6765,3454,3311,104.3,6549,3349,3200,104.7
31050, 부천시,005003, 2세,2017,6921,3598,3323,108.3,6750,3505,3245,108
31050, 부천시,005004, 3세,2017,7022,3528,3494,101,6871,3461,3410,101.5
31050, 부천시,005005, 4세,2017,6832,3531,3301,107,6699,3456,3243,106.6
31050, 부천시,010,5~9세,2017,35166,18044,17122,105.4,34777,17838,16939,105.3
31050, 부천시,010001, 5세,2017,7415,3804,3611,105.3,7284,3737,3547,105.4
31050, 부천시,010002, 6세,2017,7130,3599,3531,101.9,7049,3556,3493,101.8
31050, 부천시,010003, 7세,2017,6903,3546,3357,105.6,6838,3509,3329,105.4
31050, 부천시,010004, 8세,2017,6730,3482,3248,107.2,6676,3452,3224,107.1
31050, 부천시,010005, 9세,2017,6988,3613,3375,107.1,6930,3584,3346,107.1
31050, 부천시,015,10~14세,2017,34913,17937,16976,105.7,34723,17828,16895,105.5
31050, 부천시,015001, 10세,2017,7346,3764,3582,105.1,7294,3741,3553,105.3
31050, 부천시,015002, 11세,2017,6679,3458,3221,107.4,6624,3421,3203,106.8
31050, 부천시,015003, 12세,2017,6443,3294,3149,104.6,6412,3272,3140,104.2
31050, 부천시,015004, 13세,2017,7038,3537,3501,101,7005,3521,3484,101.1
31050, 부천시,015005, 14세,2017,7407,3884,3523,110.2,7388,3873,3515,110.2
31050, 부천시,020,15~19세,2017,45130,23266,21864,106.4,44816,23107,21709,106.4
31050, 부천시,020001, 15세,2017,7600,3920,3680,106.5,7574,3905,3669,106.4
31050, 부천시,020002, 16세,2017,8640,4450,4190,106.2,8606,4433,4173,106.2
31050, 부천시,020003, 17세,2017,9601,5004,4597,108.9,9561,4984,4577,108.9
31050, 부천시,020004, 18세,2017,9545,4917,4628,106.2,9469,4876,4593,106.2
31050, 부천시,020005, 19세,2017,9744,4975,4769,104.3,9606,4909,4697,104.5
31050, 부천시,025,20~24세,2017,58650,30752,27898,110.2,57342,30131,27211,110.7
31050, 부천시,025001, 20세,2017,10655,5609,5046,111.2,10481,5514,4967,111
31050, 부천시,025002, 21세,2017,11279,6145,5134,119.7,11069,6046,5023,120.4
31050, 부천시,025003, 22세,2017,11639,6174,5465,113,11397,6057,5340,113.4
31050, 부천시,025004, 23세,2017,12347,6347,6000,105.8,12032,6206,5826,106.5
31050, 부천시,025005, 24세,2017,12730,6477,6253,103.6,12363,6308,6055,104.2
31050, 부천시,030,25~29세,2017,63337,32312,31025,104.1,59990,30647,29343,104.4
31050, 부천시,030001, 25세,2017,13508,6921,6587,105.1,13018,6701,6317,106.1
31050, 부천시,030002, 26세,2017,12966,6555,6411,102.2,12431,6292,6139,102.5
31050, 부천시,030003, 27세,2017,12401,6253,6148,101.7,11675,5886,5789,101.7
31050, 부천시,030004, 28세,2017,12289,6336,5953,106.4,11516,5918,5598,105.7
31050, 부천시,030005, 29세,2017,12173,6247,5926,105.4,11350,5850,5500,106.4
31050, 부천시,035,30~34세,2017,62597,32152,30445,105.6,58578,29972,28606,104.8
31050, 부천시,035001, 30세,2017,11942,6062,5880,103.1,11066,5581,5485,101.8
31050, 부천시,035002, 31세,2017,12082,6225,5857,106.3,11256,5782,5474,105.6
31050, 부천시,035003, 32세,2017,12243,6335,5908,107.2,11433,5914,5519,107.2
31050, 부천시,035004, 33세,2017,12592,6443,6149,104.8,11844,6026,5818,103.6
31050, 부천시,035005, 34세,2017,13738,7087,6651,106.6,12979,6669,6310,105.7
31050, 부천시,040,35~39세,2017,69173,35677,33496,106.5,66432,34109,32323,105.5
31050, 부천시,040001, 35세,2017,14520,7574,6946,109,13837,7189,6648,108.1
31050, 부천시,040002, 36세,2017,14483,7528,6955,108.2,13917,7200,6717,107.2
31050, 부천시,040003, 37세,2017,14382,7282,7100,102.6,13876,6991,6885,101.5
31050, 부천시,040004, 38세,2017,13652,7053,6599,106.9,13134,6752,6382,105.8
31050, 부천시,040005, 39세,2017,12136,6240,5896,105.8,11668,5977,5691,105
31050, 부천시,045,40~44세,2017,65207,33132,32075,103.3,63090,31980,31110,102.8
31050, 부천시,045001, 40세,2017,12470,6353,6117,103.9,12029,6088,5941,102.5
31050, 부천시,045002, 41세,2017,11994,6181,5813,106.3,11582,5957,5625,105.9
31050, 부천시,045003, 42세,2017,12751,6464,6287,102.8,12336,6234,6102,102.2
31050, 부천시,045004, 43세,2017,13946,7075,6871,103,13545,6869,6676,102.9
31050, 부천시,045005, 44세,2017,14046,7059,6987,101,13598,6832,6766,101
31050, 부천시,050,45~49세,2017,75680,37149,38531,96.4,73094,35855,37239,96.3
31050, 부천시,050001, 45세,2017,14314,7235,7079,102.2,13821,6983,6838,102.1
31050, 부천시,050002, 46세,2017,15484,7709,7775,99.2,15006,7472,7534,99.2
31050, 부천시,050003, 47세,2017,14903,7263,7640,95.1,14379,7007,7372,95
31050, 부천시,050004, 48세,2017,15376,7486,7890,94.9,14839,7196,7643,94.2
31050, 부천시,050005, 49세,2017,15603,7456,8147,91.5,15049,7197,7852,91.7
31050, 부천시,055,50~54세,2017,74544,36114,38430,94,71545,34682,36863,94.1
31050, 부천시,055001, 50세,2017,14265,6822,7443,91.7,13843,6628,7215,91.9
31050, 부천시,055002, 51세,2017,14462,7047,7415,95,13953,6796,7157,95
31050, 부천시,055003, 52세,2017,15602,7445,8157,91.3,14981,7163,7818,91.6
31050, 부천시,055004, 53세,2017,14792,7169,7623,94,14160,6863,7297,94.1
31050, 부천시,055005, 54세,2017,15423,7631,7792,97.9,14608,7232,7376,98
31050, 부천시,060,55~59세,2017,79487,39337,40150,98,76823,38047,38776,98.1
31050, 부천시,060001, 55세,2017,16018,7999,8019,99.8,15392,7691,7701,99.9
31050, 부천시,060002, 56세,2017,17063,8342,8721,95.7,16663,8133,8530,95.3
31050, 부천시,060003, 57세,2017,17324,8517,8807,96.7,16688,8209,8479,96.8
31050, 부천시,060004, 58세,2017,15101,7518,7583,99.1,14615,7291,7324,99.5
31050, 부천시,060005, 59세,2017,13981,6961,7020,99.2,13465,6723,6742,99.7
31050, 부천시,065,60~64세,2017,55277,27612,27665,99.8,52627,26357,26270,100.3
31050, 부천시,065001, 60세,2017,13438,6717,6721,99.9,12811,6411,6400,100.2
31050, 부천시,065002, 61세,2017,12044,6003,6041,99.4,11454,5736,5718,100.3
31050, 부천시,065003, 62세,2017,11944,5972,5972,100,11389,5709,5680,100.5
31050, 부천시,065004, 63세,2017,9680,4805,4875,98.6,9189,4566,4623,98.8
31050, 부천시,065005, 64세,2017,8171,4115,4056,101.5,7784,3935,3849,102.2
31050, 부천시,070,65~69세,2017,33394,16703,16691,100.1,32219,16159,16060,100.6
31050, 부천시,070001, 65세,2017,8706,4322,4384,98.6,8333,4137,4196,98.6
31050, 부천시,070002, 66세,2017,5994,3095,2899,106.8,5728,2974,2754,108
31050, 부천시,070003, 67세,2017,6549,3226,3323,97.1,6306,3120,3186,97.9
31050, 부천시,070004, 68세,2017,6191,3102,3089,100.4,6010,3024,2986,101.3
31050, 부천시,070005, 69세,2017,5954,2958,2996,98.7,5842,2904,2938,98.8
31050, 부천시,075,70~74세,2017,22138,10406,11732,88.7,21840,10293,11547,89.1
31050, 부천시,075001, 70세,2017,5754,2743,3011,91.1,5673,2705,2968,91.1
31050, 부천시,075002, 71세,2017,4278,2135,2143,99.6,4202,2109,2093,100.8
31050, 부천시,075003, 72세,2017,4039,1943,2096,92.7,3981,1921,2060,93.3
31050, 부천시,075004, 73세,2017,4074,1831,2243,81.6,4027,1813,2214,81.9
31050, 부천시,075005, 74세,2017,3993,1754,2239,78.3,3957,1745,2212,78.9
31050, 부천시,080,75~79세,2017,17979,7240,10739,67.4,17776,7187,10589,67.9
31050, 부천시,080001, 75세,2017,4736,2072,2664,77.8,4696,2063,2633,78.4
31050, 부천시,080002, 76세,2017,3562,1428,2134,66.9,3522,1419,2103,67.5
31050, 부천시,080003, 77세,2017,3356,1370,1986,69,3318,1359,1959,69.4
31050, 부천시,080004, 78세,2017,3367,1300,2067,62.9,3327,1288,2039,63.2
31050, 부천시,080005, 79세,2017,2958,1070,1888,56.7,2913,1058,1855,57
31050, 부천시,085,80~84세,2017,11227,3615,7612,47.5,11113,3583,7530,47.6
31050, 부천시,085001, 80세,2017,2609,914,1695,53.9,2589,908,1681,54
31050, 부천시,085002, 81세,2017,2545,842,1703,49.4,2513,830,1683,49.3
31050, 부천시,085003, 82세,2017,2447,740,1707,43.4,2418,735,1683,43.7
31050, 부천시,085004, 83세,2017,1883,607,1276,47.6,1867,604,1263,47.8
31050, 부천시,085005, 84세,2017,1743,512,1231,41.6,1726,506,1220,41.5
31050, 부천시,090,85~89세,2017,5584,1432,4152,34.5,5540,1424,4116,34.6
31050, 부천시,090001, 85세,2017,1515,399,1116,35.8,1504,396,1108,35.7
31050, 부천시,090002, 86세,2017,1188,340,848,40.1,1179,338,841,40.2
31050, 부천시,090003, 87세,2017,1086,262,824,31.8,1078,261,817,31.9
31050, 부천시,090004, 88세,2017,960,246,714,34.5,953,246,707,34.8
31050, 부천시,090005, 89세,2017,835,185,650,28.5,826,183,643,28.5
31050, 부천시,095,90~94세,2017,1856,379,1477,25.7,1852,378,1474,25.6
31050, 부천시,095001, 90세,2017,606,140,466,30,603,139,464,30
31050, 부천시,095002, 91세,2017,409,83,326,25.5,408,83,325,25.5
31050, 부천시,095003, 92세,2017,346,53,293,18.1,346,53,293,18.1
31050, 부천시,095004, 93세,2017,249,52,197,26.4,249,52,197,26.4
31050, 부천시,095005, 94세,2017,246,51,195,26.2,246,51,195,26.2
31050, 부천시,100,95~99세,2017,436,95,341,27.9,436,95,341,27.9
31050, 부천시,100001, 95세,2017,160,40,120,33.3,160,40,120,33.3
31050, 부천시,100002, 96세,2017,129,25,104,24,129,25,104,24
31050, 부천시,100003, 97세,2017,73,14,59,23.7,73,14,59,23.7
31050, 부천시,100004, 98세,2017,44,9,35,25.7,44,9,35,25.7
31050, 부천시,100005, 99세,2017,30,7,23,30.4,30,7,23,30.4
31050, 부천시,101,100세이상,2017,57,5,52,9.6,57,5,52,9.6
31050, 부천시,102,15세미만,2017,103761,53278,50483,105.5,102323,52509,49814,105.4
31050, 부천시,103,15~64세,2017,649082,327503,321579,101.8,624337,314887,309450,101.8
31050, 부천시,104,65세이상,2017,92671,39875,52796,75.5,90833,39124,51709,75.7
31050, 부천시,086,85세이상,2017,7933,1911,6022,31.7,7885,1902,5983,31.8
31050, 부천시,126,평균연령,2017,40.7,39.8,41.7,,40.7,39.7,41.6,
31050, 부천시,127,중위연령,2017,41.6,40.5,42.8,,41.6,40.5,42.8,
31060, 광명시,000,합계,2017,328253,162480,165773,98,319912,158421,161491,98.1
31060, 광명시,005,0~4세,2017,14256,7344,6912,106.3,14002,7212,6790,106.2
31060, 광명시,005001, 0세,2017,2461,1255,1206,104.1,2404,1227,1177,104.2
31060, 광명시,005002, 1세,2017,2847,1478,1369,108,2784,1444,1340,107.8
31060, 광명시,005003, 2세,2017,2917,1510,1407,107.3,2874,1487,1387,107.2
31060, 광명시,005004, 3세,2017,3005,1563,1442,108.4,2965,1546,1419,108.9
31060, 광명시,005005, 4세,2017,3026,1538,1488,103.4,2975,1508,1467,102.8
31060, 광명시,010,5~9세,2017,16393,8428,7965,105.8,16282,8369,7913,105.8
31060, 광명시,010001, 5세,2017,3324,1722,1602,107.5,3293,1704,1589,107.2
31060, 광명시,010002, 6세,2017,3335,1722,1613,106.8,3310,1705,1605,106.2
31060, 광명시,010003, 7세,2017,3200,1655,1545,107.1,3176,1646,1530,107.6
31060, 광명시,010004, 8세,2017,3142,1614,1528,105.6,3125,1606,1519,105.7
31060, 광명시,010005, 9세,2017,3392,1715,1677,102.3,3378,1708,1670,102.3
31060, 광명시,015,10~14세,2017,16326,8429,7897,106.7,16294,8417,7877,106.9
31060, 광명시,015001, 10세,2017,3429,1693,1736,97.5,3418,1691,1727,97.9
31060, 광명시,015002, 11세,2017,3147,1635,1512,108.1,3141,1632,1509,108.2
31060, 광명시,015003, 12세,2017,3055,1599,1456,109.8,3049,1596,1453,109.8
31060, 광명시,015004, 13세,2017,3379,1745,1634,106.8,3375,1744,1631,106.9
31060, 광명시,015005, 14세,2017,3316,1757,1559,112.7,3311,1754,1557,112.7
31060, 광명시,020,15~19세,2017,18593,9592,9001,106.6,18537,9563,8974,106.6
31060, 광명시,020001, 15세,2017,3331,1736,1595,108.8,3327,1734,1593,108.9
31060, 광명시,020002, 16세,2017,3801,1934,1867,103.6,3793,1931,1862,103.7
31060, 광명시,020003, 17세,2017,4070,2124,1946,109.1,4062,2119,1943,109.1
31060, 광명시,020004, 18세,2017,3800,1925,1875,102.7,3779,1914,1865,102.6
31060, 광명시,020005, 19세,2017,3591,1873,1718,109,3576,1865,1711,109
31060, 광명시,025,20~24세,2017,19700,10616,9084,116.9,19392,10470,8922,117.4
31060, 광명시,025001, 20세,2017,3752,2024,1728,117.1,3731,2017,1714,117.7
31060, 광명시,025002, 21세,2017,3880,2185,1695,128.9,3839,2167,1672,129.6
31060, 광명시,025003, 22세,2017,3948,2145,1803,119,3897,2118,1779,119.1
31060, 광명시,025004, 23세,2017,4045,2133,1912,111.6,3986,2105,1881,111.9
31060, 광명시,025005, 24세,2017,4075,2129,1946,109.4,3939,2063,1876,110
31060, 광명시,030,25~29세,2017,20748,10658,10090,105.6,19919,10264,9655,106.3
31060, 광명시,030001, 25세,2017,4354,2251,2103,107,4253,2204,2049,107.6
31060, 광명시,030002, 26세,2017,4310,2220,2090,106.2,4152,2151,2001,107.5
31060, 광명시,030003, 27세,2017,4034,2108,1926,109.4,3884,2029,1855,109.4
31060, 광명시,030004, 28세,2017,3981,2024,1957,103.4,3778,1935,1843,105
31060, 광명시,030005, 29세,2017,4069,2055,2014,102,3852,1945,1907,102
31060, 광명시,035,30~34세,2017,22782,11466,11316,101.3,21762,10931,10831,100.9
31060, 광명시,035001, 30세,2017,4114,2039,2075,98.3,3891,1919,1972,97.3
31060, 광명시,035002, 31세,2017,4337,2184,2153,101.4,4110,2068,2042,101.3
31060, 광명시,035003, 32세,2017,4373,2160,2213,97.6,4192,2069,2123,97.5
31060, 광명시,035004, 33세,2017,4845,2480,2365,104.9,4630,2363,2267,104.2
31060, 광명시,035005, 34세,2017,5113,2603,2510,103.7,4939,2512,2427,103.5
31060, 광명시,040,35~39세,2017,28403,14136,14267,99.1,27655,13744,13911,98.8
31060, 광명시,040001, 35세,2017,5820,2912,2908,100.1,5634,2816,2818,99.9
31060, 광명시,040002, 36세,2017,5806,2874,2932,98,5667,2808,2859,98.2
31060, 광명시,040003, 37세,2017,5934,2979,2955,100.8,5793,2907,2886,100.7
31060, 광명시,040004, 38세,2017,5697,2826,2871,98.4,5539,2741,2798,98
31060, 광명시,040005, 39세,2017,5146,2545,2601,97.8,5022,2472,2550,96.9
31060, 광명시,045,40~44세,2017,28702,14357,14345,100.1,28115,14050,14065,99.9
31060, 광명시,045001, 40세,2017,5396,2629,2767,95,5277,2570,2707,94.9
31060, 광명시,045002, 41세,2017,5334,2666,2668,99.9,5221,2607,2614,99.7
31060, 광명시,045003, 42세,2017,5715,2865,2850,100.5,5603,2804,2799,100.2
31060, 광명시,045004, 43세,2017,6062,3113,2949,105.6,5970,3066,2904,105.6
31060, 광명시,045005, 44세,2017,6195,3084,3111,99.1,6044,3003,3041,98.8
31060, 광명시,050,45~49세,2017,30657,15254,15403,99,29753,14824,14929,99.3
31060, 광명시,050001, 45세,2017,6162,3047,3115,97.8,5999,2963,3036,97.6
31060, 광명시,050002, 46세,2017,6440,3241,3199,101.3,6274,3164,3110,101.7
31060, 광명시,050003, 47세,2017,5978,2978,3000,99.3,5786,2884,2902,99.4
31060, 광명시,050004, 48세,2017,6063,3040,3023,100.6,5885,2962,2923,101.3
31060, 광명시,050005, 49세,2017,6014,2948,3066,96.2,5809,2851,2958,96.4
31060, 광명시,055,50~54세,2017,26391,13167,13224,99.6,25320,12656,12664,99.9
31060, 광명시,055001, 50세,2017,5432,2633,2799,94.1,5283,2563,2720,94.2
31060, 광명시,055002, 51세,2017,5166,2654,2512,105.7,4989,2564,2425,105.7
31060, 광명시,055003, 52세,2017,5483,2694,2789,96.6,5282,2604,2678,97.2
31060, 광명시,055004, 53세,2017,5015,2528,2487,101.6,4781,2414,2367,102
31060, 광명시,055005, 54세,2017,5295,2658,2637,100.8,4985,2511,2474,101.5
31060, 광명시,060,55~59세,2017,27069,13110,13959,93.9,26194,12704,13490,94.2
31060, 광명시,060001, 55세,2017,5320,2658,2662,99.8,5116,2554,2562,99.7
31060, 광명시,060002, 56세,2017,5832,2840,2992,94.9,5721,2787,2934,95
31060, 광명시,060003, 57세,2017,5692,2692,3000,89.7,5472,2603,2869,90.7
31060, 광명시,060004, 58세,2017,5276,2478,2798,88.6,5108,2406,2702,89
31060, 광명시,060005, 59세,2017,4949,2442,2507,97.4,4777,2354,2423,97.2
31060, 광명시,065,60~64세,2017,20761,9981,10780,92.6,19868,9552,10316,92.6
31060, 광명시,065001, 60세,2017,4858,2289,2569,89.1,4635,2178,2457,88.6
31060, 광명시,065002, 61세,2017,4431,2110,2321,90.9,4244,2019,2225,90.7
31060, 광명시,065003, 62세,2017,4475,2186,2289,95.5,4266,2086,2180,95.7
31060, 광명시,065004, 63세,2017,3803,1860,1943,95.7,3665,1797,1868,96.2
31060, 광명시,065005, 64세,2017,3194,1536,1658,92.6,3058,1472,1586,92.8
31060, 광명시,070,65~69세,2017,13335,6460,6875,94,12912,6255,6657,94
31060, 광명시,070001, 65세,2017,3398,1643,1755,93.6,3244,1572,1672,94
31060, 광명시,070002, 66세,2017,2378,1177,1201,98,2282,1130,1152,98.1
31060, 광명시,070003, 67세,2017,2606,1242,1364,91.1,2529,1205,1324,91
31060, 광명시,070004, 68세,2017,2535,1223,1312,93.2,2477,1193,1284,92.9
31060, 광명시,070005, 69세,2017,2418,1175,1243,94.5,2380,1155,1225,94.3
31060, 광명시,075,70~74세,2017,9401,4228,5173,81.7,9287,4183,5104,82
31060, 광명시,075001, 70세,2017,2463,1143,1320,86.6,2425,1127,1298,86.8
31060, 광명시,075002, 71세,2017,1743,783,960,81.6,1721,777,944,82.3
31060, 광명시,075003, 72세,2017,1748,799,949,84.2,1729,792,937,84.5
31060, 광명시,075004, 73세,2017,1681,750,931,80.6,1662,741,921,80.5
31060, 광명시,075005, 74세,2017,1766,753,1013,74.3,1750,746,1004,74.3
31060, 광명시,080,75~79세,2017,7553,3073,4480,68.6,7490,3057,4433,69
31060, 광명시,080001, 75세,2017,2023,840,1183,71,2011,836,1175,71.1
31060, 광명시,080002, 76세,2017,1562,632,930,68,1547,627,920,68.2
31060, 광명시,080003, 77세,2017,1380,569,811,70.2,1366,565,801,70.5
31060, 광명시,080004, 78세,2017,1366,560,806,69.5,1357,560,797,70.3
31060, 광명시,080005, 79세,2017,1222,472,750,62.9,1209,469,740,63.4
31060, 광명시,085,80~84세,2017,4412,1445,2967,48.7,4372,1437,2935,49
31060, 광명시,085001, 80세,2017,1067,405,662,61.2,1057,403,654,61.6
31060, 광명시,085002, 81세,2017,971,318,653,48.7,962,316,646,48.9
31060, 광명시,085003, 82세,2017,965,288,677,42.5,959,286,673,42.5
31060, 광명시,085004, 83세,2017,773,244,529,46.1,763,243,520,46.7
31060, 광명시,085005, 84세,2017,636,190,446,42.6,631,189,442,42.8
31060, 광명시,090,85~89세,2017,2042,571,1471,38.8,2033,568,1465,38.8
31060, 광명시,090001, 85세,2017,599,188,411,45.7,595,185,410,45.1
31060, 광명시,090002, 86세,2017,448,121,327,37,446,121,325,37.2
31060, 광명시,090003, 87세,2017,417,106,311,34.1,415,106,309,34.3
31060, 광명시,090004, 88세,2017,311,88,223,39.5,310,88,222,39.6
31060, 광명시,090005, 89세,2017,267,68,199,34.2,267,68,199,34.2
31060, 광명시,095,90~94세,2017,582,138,444,31.1,580,138,442,31.2
31060, 광명시,095001, 90세,2017,185,49,136,36,185,49,136,36
31060, 광명시,095002, 91세,2017,136,31,105,29.5,135,31,104,29.8
31060, 광명시,095003, 92세,2017,113,23,90,25.6,113,23,90,25.6
31060, 광명시,095004, 93세,2017,77,18,59,30.5,77,18,59,30.5
31060, 광명시,095005, 94세,2017,71,17,54,31.5,70,17,53,32.1
31060, 광명시,100,95~99세,2017,129,25,104,24,127,25,102,24.5
31060, 광명시,100001, 95세,2017,46,8,38,21.1,45,8,37,21.6
31060, 광명시,100002, 96세,2017,26,7,19,36.8,26,7,19,36.8
31060, 광명시,100003, 97세,2017,28,6,22,27.3,28,6,22,27.3
31060, 광명시,100004, 98세,2017,16,X,15,6.7,15,X,14,7.1
31060, 광명시,100005, 99세,2017,13,X,10,30,13,X,10,30
31060, 광명시,101,100세이상,2017,18,X,16,12.5,18,X,16,12.5
31060, 광명시,102,15세미만,2017,46975,24201,22774,106.3,46578,23998,22580,106.3
31060, 광명시,103,15~64세,2017,243806,122337,121469,100.7,236515,118758,117757,100.9
31060, 광명시,104,65세이상,2017,37472,15942,21530,74,36819,15665,21154,74.1
31060, 광명시,086,85세이상,2017,2771,736,2035,36.2,2758,733,2025,36.2
31060, 광명시,126,평균연령,2017,40.2,39.1,41.2,,40.1,39,41.1,
31060, 광명시,127,중위연령,2017,41.3,40.2,42.3,,41.2,40.1,42.2,
31070, 평택시,000,합계,2017,486077,252448,233629,108.1,459185,236350,222835,106.1
31070, 평택시,005,0~4세,2017,22962,11655,11307,103.1,22265,11332,10933,103.6
31070, 평택시,005001, 0세,2017,4025,1998,2027,98.6,3867,1929,1938,99.5
31070, 평택시,005002, 1세,2017,4650,2392,2258,105.9,4450,2289,2161,105.9
31070, 평택시,005003, 2세,2017,4832,2537,2295,110.5,4699,2469,2230,110.7
31070, 평택시,005004, 3세,2017,4731,2382,2349,101.4,4616,2334,2282,102.3
31070, 평택시,005005, 4세,2017,4724,2346,2378,98.7,4633,2311,2322,99.5
31070, 평택시,010,5~9세,2017,24919,12813,12106,105.8,24601,12646,11955,105.8
31070, 평택시,010001, 5세,2017,5115,2672,2443,109.4,5028,2624,2404,109.2
31070, 평택시,010002, 6세,2017,5081,2570,2511,102.3,5018,2538,2480,102.3
31070, 평택시,010003, 7세,2017,4934,2584,2350,110,4873,2549,2324,109.7
31070, 평택시,010004, 8세,2017,4802,2451,2351,104.3,4746,2425,2321,104.5
31070, 평택시,010005, 9세,2017,4987,2536,2451,103.5,4936,2510,2426,103.5
31070, 평택시,015,10~14세,2017,23719,12130,11589,104.7,23550,12045,11505,104.7
31070, 평택시,015001, 10세,2017,5015,2587,2428,106.5,4968,2569,2399,107.1
31070, 평택시,015002, 11세,2017,4664,2366,2298,103,4632,2344,2288,102.4
31070, 평택시,015003, 12세,2017,4476,2284,2192,104.2,4440,2267,2173,104.3
31070, 평택시,015004, 13세,2017,4682,2400,2282,105.2,4657,2390,2267,105.4
31070, 평택시,015005, 14세,2017,4882,2493,2389,104.4,4853,2475,2378,104.1
31070, 평택시,020,15~19세,2017,27949,14673,13276,110.5,27543,14469,13074,110.7
31070, 평택시,020001, 15세,2017,5093,2681,2412,111.2,5067,2671,2396,111.5
31070, 평택시,020002, 16세,2017,5603,2887,2716,106.3,5574,2870,2704,106.1
31070, 평택시,020003, 17세,2017,6131,3208,2923,109.8,6078,3181,2897,109.8
31070, 평택시,020004, 18세,2017,5623,2960,2663,111.2,5498,2892,2606,111
31070, 평택시,020005, 19세,2017,5499,2937,2562,114.6,5326,2855,2471,115.5
31070, 평택시,025,20~24세,2017,31780,17236,14544,118.5,29935,16071,13864,115.9
31070, 평택시,025001, 20세,2017,6011,3301,2710,121.8,5824,3201,2623,122
31070, 평택시,025002, 21세,2017,6203,3390,2813,120.5,5911,3203,2708,118.3
31070, 평택시,025003, 22세,2017,6403,3494,2909,120.1,6038,3253,2785,116.8
31070, 평택시,025004, 23세,2017,6523,3462,3061,113.1,6073,3175,2898,109.6
31070, 평택시,025005, 24세,2017,6640,3589,3051,117.6,6089,3239,2850,113.6
31070, 평택시,030,25~29세,2017,34064,19339,14725,131.3,29882,16599,13283,125
31070, 평택시,030001, 25세,2017,6970,3859,3111,124,6284,3401,2883,118
31070, 평택시,030002, 26세,2017,6828,3840,2988,128.5,6088,3335,2753,121.1
31070, 평택시,030003, 27세,2017,6948,3995,2953,135.3,6011,3380,2631,128.5
31070, 평택시,030004, 28세,2017,6691,3878,2813,137.9,5800,3309,2491,132.8
31070, 평택시,030005, 29세,2017,6627,3767,2860,131.7,5699,3174,2525,125.7
31070, 평택시,035,30~34세,2017,36605,20247,16358,123.8,31897,17227,14670,117.4
31070, 평택시,035001, 30세,2017,6987,3958,3029,130.7,5964,3307,2657,124.5
31070, 평택시,035002, 31세,2017,7021,3925,3096,126.8,6048,3314,2734,121.2
31070, 평택시,035003, 32세,2017,7093,3894,3199,121.7,6168,3311,2857,115.9
31070, 평택시,035004, 33세,2017,7412,4098,3314,123.7,6529,3516,3013,116.7
31070, 평택시,035005, 34세,2017,8092,4372,3720,117.5,7188,3779,3409,110.9
31070, 평택시,040,35~39세,2017,43338,23635,19703,120,39687,21179,18508,114.4
31070, 평택시,040001, 35세,2017,8911,4879,4032,121,8031,4308,3723,115.7
31070, 평택시,040002, 36세,2017,8861,4925,3936,125.1,8121,4416,3705,119.2
31070, 평택시,040003, 37세,2017,8885,4830,4055,119.1,8197,4365,3832,113.9
31070, 평택시,040004, 38세,2017,8680,4677,4003,116.8,7940,4182,3758,111.3
31070, 평택시,040005, 39세,2017,8001,4324,3677,117.6,7398,3908,3490,112
31070, 평택시,045,40~44세,2017,42288,22494,19794,113.6,39904,20955,18949,110.6
31070, 평택시,045001, 40세,2017,8064,4362,3702,117.8,7544,4022,3522,114.2
31070, 평택시,045002, 41세,2017,8046,4327,3719,116.3,7514,3968,3546,111.9
31070, 평택시,045003, 42세,2017,8352,4423,3929,112.6,7922,4147,3775,109.9
31070, 평택시,045004, 43세,2017,8901,4758,4143,114.8,8446,4455,3991,111.6
31070, 평택시,045005, 44세,2017,8925,4624,4301,107.5,8478,4363,4115,106
31070, 평택시,050,45~49세,2017,45340,23823,21517,110.7,42897,22487,20410,110.2
31070, 평택시,050001, 45세,2017,8941,4795,4146,115.7,8446,4520,3926,115.1
31070, 평택시,050002, 46세,2017,9323,4944,4379,112.9,8848,4685,4163,112.5
31070, 평택시,050003, 47세,2017,9118,4883,4235,115.3,8599,4592,4007,114.6
31070, 평택시,050004, 48세,2017,9176,4709,4467,105.4,8703,4451,4252,104.7
31070, 평택시,050005, 49세,2017,8782,4492,4290,104.7,8301,4239,4062,104.4
31070, 평택시,055,50~54세,2017,39061,20618,18443,111.8,36898,19475,17423,111.8
31070, 평택시,055001, 50세,2017,7963,4103,3860,106.3,7620,3894,3726,104.5
31070, 평택시,055002, 51세,2017,7863,4214,3649,115.5,7434,3983,3451,115.4
31070, 평택시,055003, 52세,2017,8207,4284,3923,109.2,7743,4040,3703,109.1
31070, 평택시,055004, 53세,2017,7374,3923,3451,113.7,6962,3705,3257,113.8
31070, 평택시,055005, 54세,2017,7654,4094,3560,115,7139,3853,3286,117.3
31070, 평택시,060,55~59세,2017,36154,18879,17275,109.3,34577,18107,16470,109.9
31070, 평택시,060001, 55세,2017,7595,4060,3535,114.9,7225,3871,3354,115.4
31070, 평택시,060002, 56세,2017,8000,4209,3791,111,7767,4107,3660,112.2
31070, 평택시,060003, 57세,2017,7611,3861,3750,103,7251,3681,3570,103.1
31070, 평택시,060004, 58세,2017,6658,3474,3184,109.1,6347,3327,3020,110.2
31070, 평택시,060005, 59세,2017,6290,3275,3015,108.6,5987,3121,2866,108.9
31070, 평택시,065,60~64세,2017,24412,12267,12145,101,23037,11583,11454,101.1
31070, 평택시,065001, 60세,2017,5598,2913,2685,108.5,5250,2758,2492,110.7
31070, 평택시,065002, 61세,2017,5441,2792,2649,105.4,5127,2621,2506,104.6
31070, 평택시,065003, 62세,2017,5232,2575,2657,96.9,4934,2430,2504,97
31070, 평택시,065004, 63세,2017,4386,2138,2248,95.1,4161,2028,2133,95.1
31070, 평택시,065005, 64세,2017,3755,1849,1906,97,3565,1746,1819,96
31070, 평택시,070,65~69세,2017,16577,7859,8718,90.1,16040,7578,8462,89.6
31070, 평택시,070001, 65세,2017,4100,2019,2081,97,3942,1937,2005,96.6
31070, 평택시,070002, 66세,2017,2902,1389,1513,91.8,2767,1311,1456,90
31070, 평택시,070003, 67세,2017,3231,1524,1707,89.3,3135,1476,1659,89
31070, 평택시,070004, 68세,2017,3147,1450,1697,85.4,3072,1414,1658,85.3
31070, 평택시,070005, 69세,2017,3197,1477,1720,85.9,3124,1440,1684,85.5
31070, 평택시,075,70~74세,2017,13107,5900,7207,81.9,12895,5805,7090,81.9
31070, 평택시,075001, 70세,2017,3184,1522,1662,91.6,3120,1496,1624,92.1
31070, 평택시,075002, 71세,2017,2460,1159,1301,89.1,2409,1134,1275,88.9
31070, 평택시,075003, 72세,2017,2445,1086,1359,79.9,2413,1072,1341,79.9
31070, 평택시,075004, 73세,2017,2470,1036,1434,72.2,2442,1021,1421,71.9
31070, 평택시,075005, 74세,2017,2548,1097,1451,75.6,2511,1082,1429,75.7
31070, 평택시,080,75~79세,2017,11943,4929,7014,70.3,11822,4878,6944,70.2
31070, 평택시,080001, 75세,2017,2945,1256,1689,74.4,2917,1240,1677,73.9
31070, 평택시,080002, 76세,2017,2508,1076,1432,75.1,2478,1064,1414,75.2
31070, 평택시,080003, 77세,2017,2202,939,1263,74.3,2183,935,1248,74.9
31070, 평택시,080004, 78세,2017,2210,875,1335,65.5,2188,868,1320,65.8
31070, 평택시,080005, 79세,2017,2078,783,1295,60.5,2056,771,1285,60
31070, 평택시,085,80~84세,2017,7464,2753,4711,58.4,7392,2729,4663,58.5
31070, 평택시,085001, 80세,2017,1909,741,1168,63.4,1889,738,1151,64.1
31070, 평택시,085002, 81세,2017,1711,645,1066,60.5,1693,639,1054,60.6
31070, 평택시,085003, 82세,2017,1525,553,972,56.9,1510,547,963,56.8
31070, 평택시,085004, 83세,2017,1275,449,826,54.4,1266,446,820,54.4
31070, 평택시,085005, 84세,2017,1044,365,679,53.8,1034,359,675,53.2
31070, 평택시,090,85~89세,2017,3136,877,2259,38.8,3113,866,2247,38.5
31070, 평택시,090001, 85세,2017,894,261,633,41.2,888,256,632,40.5
31070, 평택시,090002, 86세,2017,666,190,476,39.9,663,188,475,39.6
31070, 평택시,090003, 87세,2017,616,169,447,37.8,612,168,444,37.8
31070, 평택시,090004, 88세,2017,539,143,396,36.1,532,142,390,36.4
31070, 평택시,090005, 89세,2017,421,114,307,37.1,418,112,306,36.6
31070, 평택시,095,90~94세,2017,1002,253,749,33.8,994,251,743,33.8
31070, 평택시,095001, 90세,2017,353,96,257,37.4,352,96,256,37.5
31070, 평택시,095002, 91세,2017,215,46,169,27.2,212,45,167,26.9
31070, 평택시,095003, 92세,2017,170,37,133,27.8,170,37,133,27.8
31070, 평택시,095004, 93세,2017,128,33,95,34.7,128,33,95,34.7
31070, 평택시,095005, 94세,2017,136,41,95,43.2,132,40,92,43.5
31070, 평택시,100,95~99세,2017,224,59,165,35.8,223,59,164,36
31070, 평택시,100001, 95세,2017,90,21,69,30.4,89,21,68,30.9
31070, 평택시,100002, 96세,2017,52,17,35,48.6,52,17,35,48.6
31070, 평택시,100003, 97세,2017,37,7,30,23.3,37,7,30,23.3
31070, 평택시,100004, 98세,2017,28,8,20,40,28,8,20,40
31070, 평택시,100005, 99세,2017,17,6,11,54.5,17,6,11,54.5
31070, 평택시,101,100세이상,2017,33,9,24,37.5,33,9,24,37.5
31070, 평택시,102,15세미만,2017,71600,36598,35002,104.6,70416,36023,34393,104.7
31070, 평택시,103,15~64세,2017,360991,193211,167780,115.2,336257,178152,158105,112.7
31070, 평택시,104,65세이상,2017,53486,22639,30847,73.4,52512,22175,30337,73.1
31070, 평택시,086,85세이상,2017,4395,1198,3197,37.5,4363,1185,3178,37.3
31070, 평택시,126,평균연령,2017,39.3,38.4,40.3,,39.3,38.4,40.3,
31070, 평택시,127,중위연령,2017,39.7,38.7,40.9,,40,39.1,41,
31080, 동두천시,000,합계,2017,97373,48666,48707,99.9,93504,46465,47039,98.8
31080, 동두천시,005,0~4세,2017,3714,1933,1781,108.5,3604,1857,1747,106.3
31080, 동두천시,005001, 0세,2017,619,320,299,107,594,301,293,102.7
31080, 동두천시,005002, 1세,2017,710,367,343,107,684,349,335,104.2
31080, 동두천시,005003, 2세,2017,774,409,365,112.1,746,388,358,108.4
31080, 동두천시,005004, 3세,2017,802,422,380,111.1,785,413,372,111
31080, 동두천시,005005, 4세,2017,809,415,394,105.3,795,406,389,104.4
31080, 동두천시,010,5~9세,2017,4431,2227,2204,101,4385,2202,2183,100.9
31080, 동두천시,010001, 5세,2017,857,438,419,104.5,849,432,417,103.6
31080, 동두천시,010002, 6세,2017,895,463,432,107.2,888,461,427,108
31080, 동두천시,010003, 7세,2017,912,486,426,114.1,901,480,421,114
31080, 동두천시,010004, 8세,2017,882,420,462,90.9,872,412,460,89.6
31080, 동두천시,010005, 9세,2017,885,420,465,90.3,875,417,458,91
31080, 동두천시,015,10~14세,2017,4434,2250,2184,103,4400,2232,2168,103
31080, 동두천시,015001, 10세,2017,977,501,476,105.3,967,496,471,105.3
31080, 동두천시,015002, 11세,2017,844,419,425,98.6,837,416,421,98.8
31080, 동두천시,015003, 12세,2017,804,396,408,97.1,800,393,407,96.6
31080, 동두천시,015004, 13세,2017,875,453,422,107.3,865,448,417,107.4
31080, 동두천시,015005, 14세,2017,934,481,453,106.2,931,479,452,106
31080, 동두천시,020,15~19세,2017,5720,2890,2830,102.1,5682,2869,2813,102
31080, 동두천시,020001, 15세,2017,913,472,441,107,908,468,440,106.4
31080, 동두천시,020002, 16세,2017,1274,619,655,94.5,1261,611,650,94
31080, 동두천시,020003, 17세,2017,1366,656,710,92.4,1363,656,707,92.8
31080, 동두천시,020004, 18세,2017,1104,588,516,114,1097,585,512,114.3
31080, 동두천시,020005, 19세,2017,1063,555,508,109.3,1053,549,504,108.9
31080, 동두천시,025,20~24세,2017,5780,3107,2673,116.2,5481,2932,2549,115
31080, 동두천시,025001, 20세,2017,1082,533,549,97.1,1067,524,543,96.5
31080, 동두천시,025002, 21세,2017,1099,602,497,121.1,1070,591,479,123.4
31080, 동두천시,025003, 22세,2017,1208,672,536,125.4,1135,629,506,124.3
31080, 동두천시,025004, 23세,2017,1193,661,532,124.2,1107,607,500,121.4
31080, 동두천시,025005, 24세,2017,1198,639,559,114.3,1102,581,521,111.5
31080, 동두천시,030,25~29세,2017,5486,2884,2602,110.8,4846,2553,2293,111.3
31080, 동두천시,030001, 25세,2017,1171,626,545,114.9,1057,565,492,114.8
31080, 동두천시,030002, 26세,2017,1172,599,573,104.5,1053,534,519,102.9
31080, 동두천시,030003, 27세,2017,1101,575,526,109.3,964,507,457,110.9
31080, 동두천시,030004, 28세,2017,1037,549,488,112.5,905,476,429,111
31080, 동두천시,030005, 29세,2017,1005,535,470,113.8,867,471,396,118.9
31080, 동두천시,035,30~34세,2017,5784,2997,2787,107.5,5102,2645,2457,107.7
31080, 동두천시,035001, 30세,2017,1058,563,495,113.7,934,494,440,112.3
31080, 동두천시,035002, 31세,2017,1125,602,523,115.1,980,530,450,117.8
31080, 동두천시,035003, 32세,2017,1142,591,551,107.3,1007,526,481,109.4
31080, 동두천시,035004, 33세,2017,1171,564,607,92.9,1036,489,547,89.4
31080, 동두천시,035005, 34세,2017,1288,677,611,110.8,1145,606,539,112.4
31080, 동두천시,040,35~39세,2017,6922,3543,3379,104.9,6422,3261,3161,103.2
31080, 동두천시,040001, 35세,2017,1416,722,694,104,1309,665,644,103.3
31080, 동두천시,040002, 36세,2017,1446,737,709,103.9,1346,685,661,103.6
31080, 동두천시,040003, 37세,2017,1421,732,689,106.2,1315,663,652,101.7
31080, 동두천시,040004, 38세,2017,1378,713,665,107.2,1282,660,622,106.1
31080, 동두천시,040005, 39세,2017,1261,639,622,102.7,1170,588,582,101
31080, 동두천시,045,40~44세,2017,7562,3996,3566,112.1,7135,3721,3414,109
31080, 동두천시,045001, 40세,2017,1401,733,668,109.7,1309,674,635,106.1
31080, 동두천시,045002, 41세,2017,1437,782,655,119.4,1366,732,634,115.5
31080, 동두천시,045003, 42세,2017,1503,799,704,113.5,1405,735,670,109.7
31080, 동두천시,045004, 43세,2017,1576,838,738,113.6,1496,792,704,112.5
31080, 동두천시,045005, 44세,2017,1645,844,801,105.4,1559,788,771,102.2
31080, 동두천시,050,45~49세,2017,8633,4604,4029,114.3,8263,4361,3902,111.8
31080, 동두천시,050001, 45세,2017,1726,909,817,111.3,1664,874,790,110.6
31080, 동두천시,050002, 46세,2017,1735,909,826,110,1648,850,798,106.5
31080, 동두천시,050003, 47세,2017,1694,898,796,112.8,1599,832,767,108.5
31080, 동두천시,050004, 48세,2017,1741,940,801,117.4,1684,905,779,116.2
31080, 동두천시,050005, 49세,2017,1737,948,789,120.2,1668,900,768,117.2
31080, 동두천시,055,50~54세,2017,7775,4175,3600,116,7488,3995,3493,114.4
31080, 동두천시,055001, 50세,2017,1513,820,693,118.3,1449,773,676,114.3
31080, 동두천시,055002, 51세,2017,1621,902,719,125.5,1573,876,697,125.7
31080, 동두천시,055003, 52세,2017,1600,826,774,106.7,1520,777,743,104.6
31080, 동두천시,055004, 53세,2017,1464,781,683,114.3,1422,754,668,112.9
31080, 동두천시,055005, 54세,2017,1577,846,731,115.7,1524,815,709,115
31080, 동두천시,060,55~59세,2017,8074,4106,3968,103.5,7898,4014,3884,103.3
31080, 동두천시,060001, 55세,2017,1596,835,761,109.7,1552,808,744,108.6
31080, 동두천시,060002, 56세,2017,1693,858,835,102.8,1668,842,826,101.9
31080, 동두천시,060003, 57세,2017,1673,840,833,100.8,1637,820,817,100.4
31080, 동두천시,060004, 58세,2017,1541,788,753,104.6,1507,771,736,104.8
31080, 동두천시,060005, 59세,2017,1571,785,786,99.9,1534,773,761,101.6
31080, 동두천시,065,60~64세,2017,6187,3085,3102,99.5,6044,3008,3036,99.1
31080, 동두천시,065001, 60세,2017,1409,730,679,107.5,1365,708,657,107.8
31080, 동두천시,065002, 61세,2017,1281,641,640,100.2,1252,626,626,100
31080, 동두천시,065003, 62세,2017,1357,689,668,103.1,1333,673,660,102
31080, 동두천시,065004, 63세,2017,1165,574,591,97.1,1144,559,585,95.6
31080, 동두천시,065005, 64세,2017,975,451,524,86.1,950,442,508,87
31080, 동두천시,070,65~69세,2017,4549,2090,2459,85,4487,2058,2429,84.7
31080, 동두천시,070001, 65세,2017,1044,504,540,93.3,1029,498,531,93.8
31080, 동두천시,070002, 66세,2017,792,369,423,87.2,778,361,417,86.6
31080, 동두천시,070003, 67세,2017,846,403,443,91,836,397,439,90.4
31080, 동두천시,070004, 68세,2017,918,411,507,81.1,902,404,498,81.1
31080, 동두천시,070005, 69세,2017,949,403,546,73.8,942,398,544,73.2
31080, 동두천시,075,70~74세,2017,4183,1790,2393,74.8,4158,1781,2377,74.9
31080, 동두천시,075001, 70세,2017,1028,451,577,78.2,1020,445,575,77.4
31080, 동두천시,075002, 71세,2017,806,355,451,78.7,802,355,447,79.4
31080, 동두천시,075003, 72세,2017,753,332,421,78.9,749,332,417,79.6
31080, 동두천시,075004, 73세,2017,766,285,481,59.3,765,284,481,59
31080, 동두천시,075005, 74세,2017,830,367,463,79.3,822,365,457,79.9
31080, 동두천시,080,75~79세,2017,4118,1638,2480,66,4099,1628,2471,65.9
31080, 동두천시,080001, 75세,2017,961,386,575,67.1,957,385,572,67.3
31080, 동두천시,080002, 76세,2017,921,379,542,69.9,917,377,540,69.8
31080, 동두천시,080003, 77세,2017,795,316,479,66,790,313,477,65.6
31080, 동두천시,080004, 78세,2017,730,280,450,62.2,727,278,449,61.9
31080, 동두천시,080005, 79세,2017,711,277,434,63.8,708,275,433,63.5
31080, 동두천시,085,80~84세,2017,2405,888,1517,58.5,2398,887,1511,58.7
31080, 동두천시,085001, 80세,2017,615,225,390,57.7,614,225,389,57.8
31080, 동두천시,085002, 81세,2017,560,228,332,68.7,557,227,330,68.8
31080, 동두천시,085003, 82세,2017,486,189,297,63.6,484,189,295,64.1
31080, 동두천시,085004, 83세,2017,381,133,248,53.6,381,133,248,53.6
31080, 동두천시,085005, 84세,2017,363,113,250,45.2,362,113,249,45.4
31080, 동두천시,090,85~89세,2017,1098,338,760,44.5,1095,336,759,44.3
31080, 동두천시,090001, 85세,2017,310,110,200,55,309,110,199,55.3
31080, 동두천시,090002, 86세,2017,211,59,152,38.8,210,58,152,38.2
31080, 동두천시,090003, 87세,2017,219,68,151,45,218,67,151,44.4
31080, 동두천시,090004, 88세,2017,194,55,139,39.6,194,55,139,39.6
31080, 동두천시,090005, 89세,2017,164,46,118,39,164,46,118,39
31080, 동두천시,095,90~94세,2017,392,91,301,30.2,391,91,300,30.3
31080, 동두천시,095001, 90세,2017,115,31,84,36.9,115,31,84,36.9
31080, 동두천시,095002, 91세,2017,102,21,81,25.9,102,21,81,25.9
31080, 동두천시,095003, 92세,2017,77,17,60,28.3,77,17,60,28.3
31080, 동두천시,095004, 93세,2017,51,10,41,24.4,50,10,40,25
31080, 동두천시,095005, 94세,2017,47,12,35,34.3,47,12,35,34.3
31080, 동두천시,100,95~99세,2017,106,30,76,39.5,106,30,76,39.5
31080, 동두천시,100001, 95세,2017,45,17,28,60.7,45,17,28,60.7
31080, 동두천시,100002, 96세,2017,21,6,15,40,21,6,15,40
31080, 동두천시,100003, 97세,2017,22,5,17,29.4,22,5,17,29.4
31080, 동두천시,100004, 98세,2017,12,X,10,20,12,X,10,20
31080, 동두천시,100005, 99세,2017,6,X,6,0,6,X,6,0
31080, 동두천시,101,100세이상,2017,20,X,16,25,20,X,16,25
31080, 동두천시,102,15세미만,2017,12579,6410,6169,103.9,12389,6291,6098,103.2
31080, 동두천시,103,15~64세,2017,67923,35387,32536,108.8,64361,33359,31002,107.6
31080, 동두천시,104,65세이상,2017,16871,6869,10002,68.7,16754,6815,9939,68.6
31080, 동두천시,086,85세이상,2017,1616,463,1153,40.2,1612,461,1151,40.1
31080, 동두천시,126,평균연령,2017,43,41.7,44.3,,43.2,41.9,44.6,
31080, 동두천시,127,중위연령,2017,44.3,43.2,45.4,,44.8,43.7,45.9,
31090, 안산시,000,합계,2017,733661,379670,353991,107.3,663898,339550,324348,104.7
31090, 안산시,005,0~4세,2017,27502,13944,13558,102.8,25429,12938,12491,103.6
31090, 안산시,005001, 0세,2017,4822,2486,2336,106.4,4394,2268,2126,106.7
31090, 안산시,005002, 1세,2017,5442,2794,2648,105.5,4970,2560,2410,106.2
31090, 안산시,005003, 2세,2017,5881,2932,2949,99.4,5478,2737,2741,99.9
31090, 안산시,005004, 3세,2017,5661,2869,2792,102.8,5242,2664,2578,103.3
31090, 안산시,005005, 4세,2017,5696,2863,2833,101.1,5345,2709,2636,102.8
31090, 안산시,010,5~9세,2017,30261,15463,14798,104.5,29064,14835,14229,104.3
31090, 안산시,010001, 5세,2017,6135,3078,3057,100.7,5809,2917,2892,100.9
31090, 안산시,010002, 6세,2017,6139,3109,3030,102.6,5892,2974,2918,101.9
31090, 안산시,010003, 7세,2017,5881,3020,2861,105.6,5671,2895,2776,104.3
31090, 안산시,010004, 8세,2017,5867,3033,2834,107,5657,2932,2725,107.6
31090, 안산시,010005, 9세,2017,6239,3223,3016,106.9,6035,3117,2918,106.8
31090, 안산시,015,10~14세,2017,32620,16744,15876,105.5,31961,16429,15532,105.8
31090, 안산시,015001, 10세,2017,6719,3415,3304,103.4,6532,3329,3203,103.9
31090, 안산시,015002, 11세,2017,5898,3063,2835,108,5763,2995,2768,108.2
31090, 안산시,015003, 12세,2017,6178,3133,3045,102.9,6075,3086,2989,103.2
31090, 안산시,015004, 13세,2017,6822,3525,3297,106.9,6702,3467,3235,107.2
31090, 안산시,015005, 14세,2017,7003,3608,3395,106.3,6889,3552,3337,106.4
31090, 안산시,020,15~19세,2017,46219,24054,22165,108.5,45503,23692,21811,108.6
31090, 안산시,020001, 15세,2017,7597,3904,3693,105.7,7481,3856,3625,106.4
31090, 안산시,020002, 16세,2017,8986,4657,4329,107.6,8894,4609,4285,107.6
31090, 안산시,020003, 17세,2017,9934,5259,4675,112.5,9804,5186,4618,112.3
31090, 안산시,020004, 18세,2017,10030,5262,4768,110.4,9874,5179,4695,110.3
31090, 안산시,020005, 19세,2017,9672,4972,4700,105.8,9450,4862,4588,106
31090, 안산시,025,20~24세,2017,57979,30745,27234,112.9,54840,28819,26021,110.8
31090, 안산시,025001, 20세,2017,10643,5633,5010,112.4,10343,5482,4861,112.8
31090, 안산시,025002, 21세,2017,11340,6042,5298,114,10877,5769,5108,112.9
31090, 안산시,025003, 22세,2017,11707,6206,5501,112.8,11095,5843,5252,111.3
31090, 안산시,025004, 23세,2017,12070,6390,5680,112.5,11315,5894,5421,108.7
31090, 안산시,025005, 24세,2017,12219,6474,5745,112.7,11210,5831,5379,108.4
31090, 안산시,030,25~29세,2017,58295,32382,25913,125,49408,26679,22729,117.4
31090, 안산시,030001, 25세,2017,12838,6964,5874,118.6,11490,6070,5420,112
31090, 안산시,030002, 26세,2017,12038,6641,5397,123,10509,5630,4879,115.4
31090, 안산시,030003, 27세,2017,11585,6473,5112,126.6,9718,5282,4436,119.1
31090, 안산시,030004, 28세,2017,11175,6292,4883,128.9,9126,5012,4114,121.8
31090, 안산시,030005, 29세,2017,10659,6012,4647,129.4,8565,4685,3880,120.7
31090, 안산시,035,30~34세,2017,52917,29624,23293,127.2,42663,23251,19412,119.8
31090, 안산시,035001, 30세,2017,10464,5928,4536,130.7,8245,4571,3674,124.4
31090, 안산시,035002, 31세,2017,10469,5871,4598,127.7,8280,4527,3753,120.6
31090, 안산시,035003, 32세,2017,10282,5714,4568,125.1,8211,4447,3764,118.1
31090, 안산시,035004, 33세,2017,10600,5967,4633,128.8,8590,4686,3904,120
31090, 안산시,035005, 34세,2017,11102,6144,4958,123.9,9337,5020,4317,116.3
31090, 안산시,040,35~39세,2017,58621,31694,26927,117.7,50262,26512,23750,111.6
31090, 안산시,040001, 35세,2017,12090,6738,5352,125.9,10169,5517,4652,118.6
31090, 안산시,040002, 36세,2017,11701,6410,5291,121.1,10060,5399,4661,115.8
31090, 안산시,040003, 37세,2017,12290,6583,5707,115.3,10667,5561,5106,108.9
31090, 안산시,040004, 38세,2017,11620,6165,5455,113,9929,5121,4808,106.5
31090, 안산시,040005, 39세,2017,10920,5798,5122,113.2,9437,4914,4523,108.6
31090, 안산시,045,40~44세,2017,61901,32376,29525,109.7,55025,28196,26829,105.1
31090, 안산시,045001, 40세,2017,11222,5998,5224,114.8,9868,5147,4721,109
31090, 안산시,045002, 41세,2017,11246,5965,5281,113,9864,5115,4749,107.7
31090, 안산시,045003, 42세,2017,12221,6371,5850,108.9,10910,5564,5346,104.1
31090, 안산시,045004, 43세,2017,13460,7037,6423,109.6,12094,6226,5868,106.1
31090, 안산시,045005, 44세,2017,13752,7005,6747,103.8,12289,6144,6145,100
31090, 안산시,050,45~49세,2017,76042,38042,38000,100.1,68136,33552,34584,97
31090, 안산시,050001, 45세,2017,14158,7191,6967,103.2,12645,6273,6372,98.4
31090, 안산시,050002, 46세,2017,15345,7692,7653,100.5,13651,6746,6905,97.7
31090, 안산시,050003, 47세,2017,15059,7553,7506,100.6,13432,6620,6812,97.2
31090, 안산시,050004, 48세,2017,15791,7812,7979,97.9,14227,6940,7287,95.2
31090, 안산시,050005, 49세,2017,15689,7794,7895,98.7,14181,6973,7208,96.7
31090, 안산시,055,50~54세,2017,70267,36466,33801,107.9,63055,32583,30472,106.9
31090, 안산시,055001, 50세,2017,14275,7209,7066,102,13028,6499,6529,99.5
31090, 안산시,055002, 51세,2017,14286,7357,6929,106.2,12878,6601,6277,105.2
31090, 안산시,055003, 52세,2017,14763,7588,7175,105.8,13239,6797,6442,105.5
31090, 안산시,055004, 53세,2017,13197,6943,6254,111,11816,6186,5630,109.9
31090, 안산시,055005, 54세,2017,13746,7369,6377,115.6,12094,6500,5594,116.2
31090, 안산시,060,55~59세,2017,61491,32876,28615,114.9,56300,30205,26095,115.8
31090, 안산시,060001, 55세,2017,13586,7225,6361,113.6,12284,6547,5737,114.1
31090, 안산시,060002, 56세,2017,13605,7220,6385,113.1,12792,6808,5984,113.8
31090, 안산시,060003, 57세,2017,13107,6977,6130,113.8,11918,6375,5543,115
31090, 안산시,060004, 58세,2017,11170,6045,5125,118,10206,5537,4669,118.6
31090, 안산시,060005, 59세,2017,10023,5409,4614,117.2,9100,4938,4162,118.6
31090, 안산시,065,60~64세,2017,36600,19074,17526,108.8,32241,16883,15358,109.9
31090, 안산시,065001, 60세,2017,9286,4901,4385,111.8,8248,4382,3866,113.3
31090, 안산시,065002, 61세,2017,8128,4284,3844,111.4,7171,3815,3356,113.7
31090, 안산시,065003, 62세,2017,7709,3991,3718,107.3,6790,3518,3272,107.5
31090, 안산시,065004, 63세,2017,6262,3183,3079,103.4,5462,2773,2689,103.1
31090, 안산시,065005, 64세,2017,5215,2715,2500,108.6,4570,2395,2175,110.1
31090, 안산시,070,65~69세,2017,21205,10524,10681,98.5,19377,9670,9707,99.6
31090, 안산시,070001, 65세,2017,5511,2781,2730,101.9,5004,2538,2466,102.9
31090, 안산시,070002, 66세,2017,3870,1971,1899,103.8,3431,1754,1677,104.6
31090, 안산시,070003, 67세,2017,4162,2053,2109,97.3,3783,1864,1919,97.1
31090, 안산시,070004, 68세,2017,3963,1947,2016,96.6,3633,1813,1820,99.6
31090, 안산시,070005, 69세,2017,3699,1772,1927,92,3526,1701,1825,93.2
31090, 안산시,075,70~74세,2017,14870,6627,8243,80.4,14308,6423,7885,81.5
31090, 안산시,075001, 70세,2017,3721,1745,1976,88.3,3538,1674,1864,89.8
31090, 안산시,075002, 71세,2017,2833,1311,1522,86.1,2703,1261,1442,87.4
31090, 안산시,075003, 72세,2017,2720,1198,1522,78.7,2633,1168,1465,79.7
31090, 안산시,075004, 73세,2017,2713,1177,1536,76.6,2624,1144,1480,77.3
31090, 안산시,075005, 74세,2017,2883,1196,1687,70.9,2810,1176,1634,72
31090, 안산시,080,75~79세,2017,12785,4965,7820,63.5,12437,4861,7576,64.2
31090, 안산시,080001, 75세,2017,3187,1351,1836,73.6,3112,1324,1788,74
31090, 안산시,080002, 76세,2017,2602,1001,1601,62.5,2532,979,1553,63
31090, 안산시,080003, 77세,2017,2420,963,1457,66.1,2339,940,1399,67.2
31090, 안산시,080004, 78세,2017,2406,908,1498,60.6,2346,890,1456,61.1
31090, 안산시,080005, 79세,2017,2170,742,1428,52,2108,728,1380,52.8
31090, 안산시,085,80~84세,2017,8485,2730,5755,47.4,8342,2692,5650,47.6
31090, 안산시,085001, 80세,2017,2031,703,1328,52.9,1990,689,1301,53
31090, 안산시,085002, 81세,2017,1869,606,1263,48,1832,600,1232,48.7
31090, 안산시,085003, 82세,2017,1845,592,1253,47.2,1817,583,1234,47.2
31090, 안산시,085004, 83세,2017,1462,448,1014,44.2,1439,442,997,44.3
31090, 안산시,085005, 84세,2017,1278,381,897,42.5,1264,378,886,42.7
31090, 안산시,090,85~89세,2017,3863,1021,2842,35.9,3816,1013,2803,36.1
31090, 안산시,090001, 85세,2017,1122,312,810,38.5,1109,310,799,38.8
31090, 안산시,090002, 86세,2017,813,232,581,39.9,802,230,572,40.2
31090, 안산시,090003, 87세,2017,754,193,561,34.4,742,192,550,34.9
31090, 안산시,090004, 88세,2017,622,166,456,36.4,616,165,451,36.6
31090, 안산시,090005, 89세,2017,552,118,434,27.2,547,116,431,26.9
31090, 안산시,095,90~94세,2017,1397,266,1131,23.5,1391,264,1127,23.4
31090, 안산시,095001, 90세,2017,436,75,361,20.8,434,74,360,20.6
31090, 안산시,095002, 91세,2017,322,67,255,26.3,321,67,254,26.4
31090, 안산시,095003, 92세,2017,262,46,216,21.3,261,45,216,20.8
31090, 안산시,095004, 93세,2017,191,37,154,24,189,37,152,24.3
31090, 안산시,095005, 94세,2017,186,41,145,28.3,186,41,145,28.3
31090, 안산시,100,95~99세,2017,289,49,240,20.4,288,49,239,20.5
31090, 안산시,100001, 95세,2017,120,22,98,22.4,120,22,98,22.4
31090, 안산시,100002, 96세,2017,62,11,51,21.6,62,11,51,21.6
31090, 안산시,100003, 97세,2017,56,10,46,21.7,56,10,46,21.7
31090, 안산시,100004, 98세,2017,26,X,25,4,26,X,25,4
31090, 안산시,100005, 99세,2017,25,5,20,25,24,5,19,26.3
31090, 안산시,101,100세이상,2017,52,X,48,8.3,52,X,48,8.3
31090, 안산시,102,15세미만,2017,90383,46151,44232,104.3,86454,44202,42252,104.6
31090, 안산시,103,15~64세,2017,580332,307333,272999,112.6,517433,270372,247061,109.4
31090, 안산시,104,65세이상,2017,62946,26186,36760,71.2,60011,24976,35035,71.3
31090, 안산시,086,85세이상,2017,5601,1340,4261,31.4,5547,1330,4217,31.5
31090, 안산시,126,평균연령,2017,39.2,38.5,40,,39.1,38.3,39.9,
31090, 안산시,127,중위연령,2017,40.2,39.2,41.4,,40.3,39.3,41.3,
31091, 상록구,000,합계,2017,379209,193021,186188,103.7,364203,185258,178945,103.5
31091, 상록구,005,0~4세,2017,14778,7552,7226,104.5,14193,7260,6933,104.7
31091, 상록구,005001, 0세,2017,2575,1328,1247,106.5,2456,1268,1188,106.7
31091, 상록구,005002, 1세,2017,2956,1538,1418,108.5,2820,1465,1355,108.1
31091, 상록구,005003, 2세,2017,3261,1650,1611,102.4,3138,1595,1543,103.4
31091, 상록구,005004, 3세,2017,2979,1531,1448,105.7,2861,1469,1392,105.5
31091, 상록구,005005, 4세,2017,3007,1505,1502,100.2,2918,1463,1455,100.5
31091, 상록구,010,5~9세,2017,15722,8009,7713,103.8,15446,7862,7584,103.7
31091, 상록구,010001, 5세,2017,3223,1642,1581,103.9,3145,1603,1542,104
31091, 상록구,010002, 6세,2017,3199,1591,1608,98.9,3138,1564,1574,99.4
31091, 상록구,010003, 7세,2017,3106,1591,1515,105,3059,1560,1499,104.1
31091, 상록구,010004, 8세,2017,3018,1555,1463,106.3,2972,1529,1443,106
31091, 상록구,010005, 9세,2017,3176,1630,1546,105.4,3132,1606,1526,105.2
31091, 상록구,015,10~14세,2017,17143,8772,8371,104.8,17012,8711,8301,104.9
31091, 상록구,015001, 10세,2017,3521,1776,1745,101.8,3481,1759,1722,102.1
31091, 상록구,015002, 11세,2017,3087,1584,1503,105.4,3064,1572,1492,105.4
31091, 상록구,015003, 12세,2017,3282,1643,1639,100.2,3262,1637,1625,100.7
31091, 상록구,015004, 13세,2017,3570,1878,1692,111,3549,1868,1681,111.1
31091, 상록구,015005, 14세,2017,3683,1891,1792,105.5,3656,1875,1781,105.3
31091, 상록구,020,15~19세,2017,25037,12981,12056,107.7,24850,12887,11963,107.7
31091, 상록구,020001, 15세,2017,4024,2093,1931,108.4,4004,2085,1919,108.7
31091, 상록구,020002, 16세,2017,4695,2395,2300,104.1,4674,2386,2288,104.3
31091, 상록구,020003, 17세,2017,5226,2756,2470,111.6,5198,2741,2457,111.6
31091, 상록구,020004, 18세,2017,5486,2838,2648,107.2,5439,2809,2630,106.8
31091, 상록구,020005, 19세,2017,5606,2899,2707,107.1,5535,2866,2669,107.4
31091, 상록구,025,20~24세,2017,32421,16933,15488,109.3,31499,16461,15038,109.5
31091, 상록구,025001, 20세,2017,6156,3200,2956,108.3,6023,3135,2888,108.6
31091, 상록구,025002, 21세,2017,6424,3346,3078,108.7,6249,3254,2995,108.6
31091, 상록구,025003, 22세,2017,6542,3410,3132,108.9,6350,3319,3031,109.5
31091, 상록구,025004, 23세,2017,6656,3504,3152,111.2,6462,3401,3061,111.1
31091, 상록구,025005, 24세,2017,6643,3473,3170,109.6,6415,3352,3063,109.4
31091, 상록구,030,25~29세,2017,29381,15817,13564,116.6,27479,14782,12697,116.4
31091, 상록구,030001, 25세,2017,6789,3654,3135,116.6,6494,3484,3010,115.7
31091, 상록구,030002, 26세,2017,6180,3286,2894,113.5,5840,3103,2737,113.4
31091, 상록구,030003, 27세,2017,5810,3121,2689,116.1,5406,2897,2509,115.5
31091, 상록구,030004, 28세,2017,5407,2942,2465,119.4,4956,2705,2251,120.2
31091, 상록구,030005, 29세,2017,5195,2814,2381,118.2,4783,2593,2190,118.4
31091, 상록구,035,30~34세,2017,25902,14035,11867,118.3,23588,12780,10808,118.2
31091, 상록구,035001, 30세,2017,5019,2721,2298,118.4,4547,2486,2061,120.6
31091, 상록구,035002, 31세,2017,5141,2779,2362,117.7,4621,2498,2123,117.7
31091, 상록구,035003, 32세,2017,4997,2746,2251,122,4538,2490,2048,121.6
31091, 상록구,035004, 33세,2017,5188,2825,2363,119.6,4709,2553,2156,118.4
31091, 상록구,035005, 34세,2017,5557,2964,2593,114.3,5173,2753,2420,113.8
31091, 상록구,040,35~39세,2017,28857,15201,13656,111.3,27111,14237,12874,110.6
31091, 상록구,040001, 35세,2017,5943,3224,2719,118.6,5562,3007,2555,117.7
31091, 상록구,040002, 36세,2017,5714,3029,2685,112.8,5348,2835,2513,112.8
31091, 상록구,040003, 37세,2017,6104,3163,2941,107.5,5759,2979,2780,107.2
31091, 상록구,040004, 38세,2017,5750,2958,2792,105.9,5389,2760,2629,105
31091, 상록구,040005, 39세,2017,5346,2827,2519,112.2,5053,2656,2397,110.8
31091, 상록구,045,40~44세,2017,31045,15905,15140,105.1,29641,15126,14515,104.2
31091, 상록구,045001, 40세,2017,5595,2952,2643,111.7,5331,2807,2524,111.2
31091, 상록구,045002, 41세,2017,5571,2922,2649,110.3,5302,2760,2542,108.6
31091, 상록구,045003, 42세,2017,6173,3106,3067,101.3,5872,2935,2937,99.9
31091, 상록구,045004, 43세,2017,6788,3466,3322,104.3,6504,3309,3195,103.6
31091, 상록구,045005, 44세,2017,6918,3459,3459,100,6632,3315,3317,99.9
31091, 상록구,050,45~49세,2017,38569,18920,19649,96.3,37230,18220,19010,95.8
31091, 상록구,050001, 45세,2017,7197,3624,3573,101.4,6913,3462,3451,100.3
31091, 상록구,050002, 46세,2017,7743,3788,3955,95.8,7449,3631,3818,95.1
31091, 상록구,050003, 47세,2017,7640,3760,3880,96.9,7387,3633,3754,96.8
31091, 상록구,050004, 48세,2017,8064,3905,4159,93.9,7822,3785,4037,93.8
31091, 상록구,050005, 49세,2017,7925,3843,4082,94.1,7659,3709,3950,93.9
31091, 상록구,055,50~54세,2017,35638,18263,17375,105.1,34269,17584,16685,105.4
31091, 상록구,055001, 50세,2017,7420,3709,3711,99.9,7174,3585,3589,99.9
31091, 상록구,055002, 51세,2017,7324,3712,3612,102.8,7062,3587,3475,103.2
31091, 상록구,055003, 52세,2017,7470,3803,3667,103.7,7204,3661,3543,103.3
31091, 상록구,055004, 53세,2017,6525,3371,3154,106.9,6246,3227,3019,106.9
31091, 상록구,055005, 54세,2017,6899,3668,3231,113.5,6583,3524,3059,115.2
31091, 상록구,060,55~59세,2017,31316,16732,14584,114.7,30184,16190,13994,115.7
31091, 상록구,060001, 55세,2017,6852,3686,3166,116.4,6570,3549,3021,117.5
31091, 상록구,060002, 56세,2017,7098,3768,3330,113.2,6923,3684,3239,113.7
31091, 상록구,060003, 57세,2017,6671,3545,3126,113.4,6420,3431,2989,114.8
31091, 상록구,060004, 58세,2017,5670,3052,2618,116.6,5460,2946,2514,117.2
31091, 상록구,060005, 59세,2017,5025,2681,2344,114.4,4811,2580,2231,115.6
31091, 상록구,065,60~64세,2017,18384,9442,8942,105.6,17429,9000,8429,106.8
31091, 상록구,065001, 60세,2017,4692,2433,2259,107.7,4460,2325,2135,108.9
31091, 상록구,065002, 61세,2017,4078,2147,1931,111.2,3877,2059,1818,113.3
31091, 상록구,065003, 62세,2017,3887,1974,1913,103.2,3686,1883,1803,104.4
31091, 상록구,065004, 63세,2017,3128,1551,1577,98.4,2948,1461,1487,98.3
31091, 상록구,065005, 64세,2017,2599,1337,1262,105.9,2458,1272,1186,107.3
31091, 상록구,070,65~69세,2017,11089,5440,5649,96.3,10659,5242,5417,96.8
31091, 상록구,070001, 65세,2017,2859,1449,1410,102.8,2735,1386,1349,102.7
31091, 상록구,070002, 66세,2017,1964,951,1013,93.9,1860,895,965,92.7
31091, 상록구,070003, 67세,2017,2124,1060,1064,99.6,2035,1023,1012,101.1
31091, 상록구,070004, 68세,2017,2064,1004,1060,94.7,1996,979,1017,96.3
31091, 상록구,070005, 69세,2017,2078,976,1102,88.6,2033,959,1074,89.3
31091, 상록구,075,70~74세,2017,8495,3720,4775,77.9,8338,3662,4676,78.3
31091, 상록구,075001, 70세,2017,2094,976,1118,87.3,2041,955,1086,87.9
31091, 상록구,075002, 71세,2017,1614,733,881,83.2,1581,717,864,83
31091, 상록구,075003, 72세,2017,1587,690,897,76.9,1565,685,880,77.8
31091, 상록구,075004, 73세,2017,1520,644,876,73.5,1491,633,858,73.8
31091, 상록구,075005, 74세,2017,1680,677,1003,67.5,1660,672,988,68
31091, 상록구,080,75~79세,2017,7426,2892,4534,63.8,7326,2859,4467,64
31091, 상록구,080001, 75세,2017,1902,811,1091,74.3,1877,800,1077,74.3
31091, 상록구,080002, 76세,2017,1483,575,908,63.3,1463,572,891,64.2
31091, 상록구,080003, 77세,2017,1407,559,848,65.9,1385,550,835,65.9
31091, 상록구,080004, 78세,2017,1368,509,859,59.3,1354,503,851,59.1
31091, 상록구,080005, 79세,2017,1266,438,828,52.9,1247,434,813,53.4
31091, 상록구,085,80~84세,2017,4849,1605,3244,49.5,4811,1598,3213,49.7
31091, 상록구,085001, 80세,2017,1213,432,781,55.3,1202,429,773,55.5
31091, 상록구,085002, 81세,2017,1071,356,715,49.8,1060,355,705,50.4
31091, 상록구,085003, 82세,2017,1007,327,680,48.1,1003,327,676,48.4
31091, 상록구,085004, 83세,2017,845,270,575,47,836,267,569,46.9
31091, 상록구,085005, 84세,2017,713,220,493,44.6,710,220,490,44.9
31091, 상록구,090,85~89세,2017,2152,622,1530,40.7,2135,618,1517,40.7
31091, 상록구,090001, 85세,2017,654,202,452,44.7,648,201,447,45
31091, 상록구,090002, 86세,2017,441,133,308,43.2,436,131,305,43
31091, 상록구,090003, 87세,2017,402,122,280,43.6,400,122,278,43.9
31091, 상록구,090004, 88세,2017,347,100,247,40.5,346,100,246,40.7
31091, 상록구,090005, 89세,2017,308,65,243,26.7,305,64,241,26.6
31091, 상록구,095,90~94세,2017,796,144,652,22.1,794,143,651,22
31091, 상록구,095001, 90세,2017,250,38,212,17.9,250,38,212,17.9
31091, 상록구,095002, 91세,2017,185,40,145,27.6,185,40,145,27.6
31091, 상록구,095003, 92세,2017,136,26,110,23.6,135,25,110,22.7
31091, 상록구,095004, 93세,2017,117,22,95,23.2,116,22,94,23.4
31091, 상록구,095005, 94세,2017,108,18,90,20,108,18,90,20
31091, 상록구,100,95~99세,2017,179,34,145,23.4,179,34,145,23.4
31091, 상록구,100001, 95세,2017,73,16,57,28.1,73,16,57,28.1
31091, 상록구,100002, 96세,2017,37,6,31,19.4,37,6,31,19.4
31091, 상록구,100003, 97세,2017,39,7,32,21.9,39,7,32,21.9
31091, 상록구,100004, 98세,2017,15,X,14,7.1,15,X,14,7.1
31091, 상록구,100005, 99세,2017,15,X,11,36.4,15,X,11,36.4
31091, 상록구,101,100세이상,2017,30,X,28,7.1,30,X,28,7.1
31091, 상록구,102,15세미만,2017,47643,24333,23310,104.4,46651,23833,22818,104.4
31091, 상록구,103,15~64세,2017,296550,154229,142321,108.4,283280,147267,136013,108.3
31091, 상록구,104,65세이상,2017,35016,14459,20557,70.3,34272,14158,20114,70.4
31091, 상록구,086,85세이상,2017,3157,802,2355,34.1,3138,797,2341,34
31091, 상록구,126,평균연령,2017,39.2,38.3,40,,39.1,38.3,40,
31091, 상록구,127,중위연령,2017,40.1,39,41.2,,40.2,39.1,41.3,
31092, 단원구,000,합계,2017,354452,186649,167803,111.2,299695,154292,145403,106.1
31092, 단원구,005,0~4세,2017,12724,6392,6332,100.9,11236,5678,5558,102.2
31092, 단원구,005001, 0세,2017,2247,1158,1089,106.3,1938,1000,938,106.6
31092, 단원구,005002, 1세,2017,2486,1256,1230,102.1,2150,1095,1055,103.8
31092, 단원구,005003, 2세,2017,2620,1282,1338,95.8,2340,1142,1198,95.3
31092, 단원구,005004, 3세,2017,2682,1338,1344,99.6,2381,1195,1186,100.8
31092, 단원구,005005, 4세,2017,2689,1358,1331,102,2427,1246,1181,105.5
31092, 단원구,010,5~9세,2017,14539,7454,7085,105.2,13618,6973,6645,104.9
31092, 단원구,010001, 5세,2017,2912,1436,1476,97.3,2664,1314,1350,97.3
31092, 단원구,010002, 6세,2017,2940,1518,1422,106.8,2754,1410,1344,104.9
31092, 단원구,010003, 7세,2017,2775,1429,1346,106.2,2612,1335,1277,104.5
31092, 단원구,010004, 8세,2017,2849,1478,1371,107.8,2685,1403,1282,109.4
31092, 단원구,010005, 9세,2017,3063,1593,1470,108.4,2903,1511,1392,108.5
31092, 단원구,015,10~14세,2017,15477,7972,7505,106.2,14949,7718,7231,106.7
31092, 단원구,015001, 10세,2017,3198,1639,1559,105.1,3051,1570,1481,106
31092, 단원구,015002, 11세,2017,2811,1479,1332,111,2699,1423,1276,111.5
31092, 단원구,015003, 12세,2017,2896,1490,1406,106,2813,1449,1364,106.2
31092, 단원구,015004, 13세,2017,3252,1647,1605,102.6,3153,1599,1554,102.9
31092, 단원구,015005, 14세,2017,3320,1717,1603,107.1,3233,1677,1556,107.8
31092, 단원구,020,15~19세,2017,21182,11073,10109,109.5,20653,10805,9848,109.7
31092, 단원구,020001, 15세,2017,3573,1811,1762,102.8,3477,1771,1706,103.8
31092, 단원구,020002, 16세,2017,4291,2262,2029,111.5,4220,2223,1997,111.3
31092, 단원구,020003, 17세,2017,4708,2503,2205,113.5,4606,2445,2161,113.1
31092, 단원구,020004, 18세,2017,4544,2424,2120,114.3,4435,2370,2065,114.8
31092, 단원구,020005, 19세,2017,4066,2073,1993,104,3915,1996,1919,104
31092, 단원구,025,20~24세,2017,25558,13812,11746,117.6,23341,12358,10983,112.5
31092, 단원구,025001, 20세,2017,4487,2433,2054,118.5,4320,2347,1973,119
31092, 단원구,025002, 21세,2017,4916,2696,2220,121.4,4628,2515,2113,119
31092, 단원구,025003, 22세,2017,5165,2796,2369,118,4745,2524,2221,113.6
31092, 단원구,025004, 23세,2017,5414,2886,2528,114.2,4853,2493,2360,105.6
31092, 단원구,025005, 24세,2017,5576,3001,2575,116.5,4795,2479,2316,107
31092, 단원구,030,25~29세,2017,28914,16565,12349,134.1,21929,11897,10032,118.6
31092, 단원구,030001, 25세,2017,6049,3310,2739,120.8,4996,2586,2410,107.3
31092, 단원구,030002, 26세,2017,5858,3355,2503,134,4669,2527,2142,118
31092, 단원구,030003, 27세,2017,5775,3352,2423,138.3,4312,2385,1927,123.8
31092, 단원구,030004, 28세,2017,5768,3350,2418,138.5,4170,2307,1863,123.8
31092, 단원구,030005, 29세,2017,5464,3198,2266,141.1,3782,2092,1690,123.8
31092, 단원구,035,30~34세,2017,27015,15589,11426,136.4,19075,10471,8604,121.7
31092, 단원구,035001, 30세,2017,5445,3207,2238,143.3,3698,2085,1613,129.3
31092, 단원구,035002, 31세,2017,5328,3092,2236,138.3,3659,2029,1630,124.5
31092, 단원구,035003, 32세,2017,5285,2968,2317,128.1,3673,1957,1716,114
31092, 단원구,035004, 33세,2017,5412,3142,2270,138.4,3881,2133,1748,122
31092, 단원구,035005, 34세,2017,5545,3180,2365,134.5,4164,2267,1897,119.5
31092, 단원구,040,35~39세,2017,29764,16493,13271,124.3,23151,12275,10876,112.9
31092, 단원구,040001, 35세,2017,6147,3514,2633,133.5,4607,2510,2097,119.7
31092, 단원구,040002, 36세,2017,5987,3381,2606,129.7,4712,2564,2148,119.4
31092, 단원구,040003, 37세,2017,6186,3420,2766,123.6,4908,2582,2326,111
31092, 단원구,040004, 38세,2017,5870,3207,2663,120.4,4540,2361,2179,108.4
31092, 단원구,040005, 39세,2017,5574,2971,2603,114.1,4384,2258,2126,106.2
31092, 단원구,045,40~44세,2017,30856,16471,14385,114.5,25384,13070,12314,106.1
31092, 단원구,045001, 40세,2017,5627,3046,2581,118,4537,2340,2197,106.5
31092, 단원구,045002, 41세,2017,5675,3043,2632,115.6,4562,2355,2207,106.7
31092, 단원구,045003, 42세,2017,6048,3265,2783,117.3,5038,2629,2409,109.1
31092, 단원구,045004, 43세,2017,6672,3571,3101,115.2,5590,2917,2673,109.1
31092, 단원구,045005, 44세,2017,6834,3546,3288,107.8,5657,2829,2828,100
31092, 단원구,050,45~49세,2017,37473,19122,18351,104.2,30906,15332,15574,98.4
31092, 단원구,050001, 45세,2017,6961,3567,3394,105.1,5732,2811,2921,96.2
31092, 단원구,050002, 46세,2017,7602,3904,3698,105.6,6202,3115,3087,100.9
31092, 단원구,050003, 47세,2017,7419,3793,3626,104.6,6045,2987,3058,97.7
31092, 단원구,050004, 48세,2017,7727,3907,3820,102.3,6405,3155,3250,97.1
31092, 단원구,050005, 49세,2017,7764,3951,3813,103.6,6522,3264,3258,100.2
31092, 단원구,055,50~54세,2017,34629,18203,16426,110.8,28786,14999,13787,108.8
31092, 단원구,055001, 50세,2017,6855,3500,3355,104.3,5854,2914,2940,99.1
31092, 단원구,055002, 51세,2017,6962,3645,3317,109.9,5816,3014,2802,107.6
31092, 단원구,055003, 52세,2017,7293,3785,3508,107.9,6035,3136,2899,108.2
31092, 단원구,055004, 53세,2017,6672,3572,3100,115.2,5570,2959,2611,113.3
31092, 단원구,055005, 54세,2017,6847,3701,3146,117.6,5511,2976,2535,117.4
31092, 단원구,060,55~59세,2017,30175,16144,14031,115.1,26116,14015,12101,115.8
31092, 단원구,060001, 55세,2017,6734,3539,3195,110.8,5714,2998,2716,110.4
31092, 단원구,060002, 56세,2017,6507,3452,3055,113,5869,3124,2745,113.8
31092, 단원구,060003, 57세,2017,6436,3432,3004,114.2,5498,2944,2554,115.3
31092, 단원구,060004, 58세,2017,5500,2993,2507,119.4,4746,2591,2155,120.2
31092, 단원구,060005, 59세,2017,4998,2728,2270,120.2,4289,2358,1931,122.1
31092, 단원구,065,60~64세,2017,18216,9632,8584,112.2,14812,7883,6929,113.8
31092, 단원구,065001, 60세,2017,4594,2468,2126,116.1,3788,2057,1731,118.8
31092, 단원구,065002, 61세,2017,4050,2137,1913,111.7,3294,1756,1538,114.2
31092, 단원구,065003, 62세,2017,3822,2017,1805,111.7,3104,1635,1469,111.3
31092, 단원구,065004, 63세,2017,3134,1632,1502,108.7,2514,1312,1202,109.2
31092, 단원구,065005, 64세,2017,2616,1378,1238,111.3,2112,1123,989,113.5
31092, 단원구,070,65~69세,2017,10116,5084,5032,101,8718,4428,4290,103.2
31092, 단원구,070001, 65세,2017,2652,1332,1320,100.9,2269,1152,1117,103.1
31092, 단원구,070002, 66세,2017,1906,1020,886,115.1,1571,859,712,120.6
31092, 단원구,070003, 67세,2017,2038,993,1045,95,1748,841,907,92.7
31092, 단원구,070004, 68세,2017,1899,943,956,98.6,1637,834,803,103.9
31092, 단원구,070005, 69세,2017,1621,796,825,96.5,1493,742,751,98.8
31092, 단원구,075,70~74세,2017,6375,2907,3468,83.8,5970,2761,3209,86
31092, 단원구,075001, 70세,2017,1627,769,858,89.6,1497,719,778,92.4
31092, 단원구,075002, 71세,2017,1219,578,641,90.2,1122,544,578,94.1
31092, 단원구,075003, 72세,2017,1133,508,625,81.3,1068,483,585,82.6
31092, 단원구,075004, 73세,2017,1193,533,660,80.8,1133,511,622,82.2
31092, 단원구,075005, 74세,2017,1203,519,684,75.9,1150,504,646,78
31092, 단원구,080,75~79세,2017,5359,2073,3286,63.1,5111,2002,3109,64.4
31092, 단원구,080001, 75세,2017,1285,540,745,72.5,1235,524,711,73.7
31092, 단원구,080002, 76세,2017,1119,426,693,61.5,1069,407,662,61.5
31092, 단원구,080003, 77세,2017,1013,404,609,66.3,954,390,564,69.1
31092, 단원구,080004, 78세,2017,1038,399,639,62.4,992,387,605,64
31092, 단원구,080005, 79세,2017,904,304,600,50.7,861,294,567,51.9
31092, 단원구,085,80~84세,2017,3636,1125,2511,44.8,3531,1094,2437,44.9
31092, 단원구,085001, 80세,2017,818,271,547,49.5,788,260,528,49.2
31092, 단원구,085002, 81세,2017,798,250,548,45.6,772,245,527,46.5
31092, 단원구,085003, 82세,2017,838,265,573,46.2,814,256,558,45.9
31092, 단원구,085004, 83세,2017,617,178,439,40.5,603,175,428,40.9
31092, 단원구,085005, 84세,2017,565,161,404,39.9,554,158,396,39.9
31092, 단원구,090,85~89세,2017,1711,399,1312,30.4,1681,395,1286,30.7
31092, 단원구,090001, 85세,2017,468,110,358,30.7,461,109,352,31
31092, 단원구,090002, 86세,2017,372,99,273,36.3,366,99,267,37.1
31092, 단원구,090003, 87세,2017,352,71,281,25.3,342,70,272,25.7
31092, 단원구,090004, 88세,2017,275,66,209,31.6,270,65,205,31.7
31092, 단원구,090005, 89세,2017,244,53,191,27.7,242,52,190,27.4
31092, 단원구,095,90~94세,2017,601,122,479,25.5,597,121,476,25.4
31092, 단원구,095001, 90세,2017,186,37,149,24.8,184,36,148,24.3
31092, 단원구,095002, 91세,2017,137,27,110,24.5,136,27,109,24.8
31092, 단원구,095003, 92세,2017,126,20,106,18.9,126,20,106,18.9
31092, 단원구,095004, 93세,2017,74,15,59,25.4,73,15,58,25.9
31092, 단원구,095005, 94세,2017,78,23,55,41.8,78,23,55,41.8
31092, 단원구,100,95~99세,2017,110,15,95,15.8,109,15,94,16
31092, 단원구,100001, 95세,2017,47,6,41,14.6,47,6,41,14.6
31092, 단원구,100002, 96세,2017,25,5,20,25,25,5,20,25
31092, 단원구,100003, 97세,2017,17,X,14,21.4,17,X,14,21.4
31092, 단원구,100004, 98세,2017,11,X,11,0,11,X,11,0
31092, 단원구,100005, 99세,2017,10,X,9,11.1,9,X,8,12.5
31092, 단원구,101,100세이상,2017,22,X,20,10,22,X,20,10
31092, 단원구,102,15세미만,2017,42740,21818,20922,104.3,39803,20369,19434,104.8
31092, 단원구,103,15~64세,2017,283782,153104,130678,117.2,234153,123105,111048,110.9
31092, 단원구,104,65세이상,2017,27930,11727,16203,72.4,25739,10818,14921,72.5
31092, 단원구,086,85세이상,2017,2444,538,1906,28.2,2409,533,1876,28.4
31092, 단원구,126,평균연령,2017,39.3,38.6,40.1,,39,38.3,39.8,
31092, 단원구,127,중위연령,2017,40.4,39.3,41.6,,40.4,39.5,41.3,
31100, 고양시,000,합계,2017,1005102,492804,512298,96.2,988580,484232,504348,96
31100, 고양시,005,0~4세,2017,40446,20718,19728,105,40161,20567,19594,105
31100, 고양시,005001, 0세,2017,6792,3523,3269,107.8,6728,3490,3238,107.8
31100, 고양시,005002, 1세,2017,7908,4036,3872,104.2,7844,4007,3837,104.4
31100, 고양시,005003, 2세,2017,8618,4372,4246,103,8568,4341,4227,102.7
31100, 고양시,005004, 3세,2017,8482,4356,4126,105.6,8421,4324,4097,105.5
31100, 고양시,005005, 4세,2017,8646,4431,4215,105.1,8600,4405,4195,105
31100, 고양시,010,5~9세,2017,47103,24218,22885,105.8,46940,24153,22787,106
31100, 고양시,010001, 5세,2017,9585,4934,4651,106.1,9533,4912,4621,106.3
31100, 고양시,010002, 6세,2017,9513,4861,4652,104.5,9481,4849,4632,104.7
31100, 고양시,010003, 7세,2017,9252,4776,4476,106.7,9224,4765,4459,106.9
31100, 고양시,010004, 8세,2017,8942,4670,4272,109.3,8910,4658,4252,109.5
31100, 고양시,010005, 9세,2017,9811,4977,4834,103,9792,4969,4823,103
31100, 고양시,015,10~14세,2017,49066,25264,23802,106.1,48993,25231,23762,106.2
31100, 고양시,015001, 10세,2017,9677,5041,4636,108.7,9656,5029,4627,108.7
31100, 고양시,015002, 11세,2017,9217,4697,4520,103.9,9208,4693,4515,103.9
31100, 고양시,015003, 12세,2017,9204,4651,4553,102.2,9191,4647,4544,102.3
31100, 고양시,015004, 13세,2017,10435,5318,5117,103.9,10420,5313,5107,104
31100, 고양시,015005, 14세,2017,10533,5557,4976,111.7,10518,5549,4969,111.7
31100, 고양시,020,15~19세,2017,60371,30901,29470,104.9,60208,30821,29387,104.9
31100, 고양시,020001, 15세,2017,10730,5515,5215,105.8,10711,5502,5209,105.6
31100, 고양시,020002, 16세,2017,12053,6217,5836,106.5,12040,6214,5826,106.7
31100, 고양시,020003, 17세,2017,13394,6812,6582,103.5,13368,6797,6571,103.4
31100, 고양시,020004, 18세,2017,12612,6502,6110,106.4,12576,6484,6092,106.4
31100, 고양시,020005, 19세,2017,11582,5855,5727,102.2,11513,5824,5689,102.4
31100, 고양시,025,20~24세,2017,66547,35032,31515,111.2,65255,34278,30977,110.7
31100, 고양시,025001, 20세,2017,11984,6392,5592,114.3,11902,6339,5563,113.9
31100, 고양시,025002, 21세,2017,13070,7304,5766,126.7,12911,7218,5693,126.8
31100, 고양시,025003, 22세,2017,13452,7183,6269,114.6,13216,7035,6181,113.8
31100, 고양시,025004, 23세,2017,13890,7195,6695,107.5,13508,6985,6523,107.1
31100, 고양시,025005, 24세,2017,14151,6958,7193,96.7,13718,6701,7017,95.5
31100, 고양시,030,25~29세,2017,66394,33029,33365,99,64027,31689,32338,98
31100, 고양시,030001, 25세,2017,14766,7326,7440,98.5,14338,7070,7268,97.3
31100, 고양시,030002, 26세,2017,14175,7046,7129,98.8,13748,6802,6946,97.9
31100, 고양시,030003, 27세,2017,13220,6559,6661,98.5,12728,6275,6453,97.2
31100, 고양시,030004, 28세,2017,12367,6181,6186,99.9,11871,5899,5972,98.8
31100, 고양시,030005, 29세,2017,11866,5917,5949,99.5,11342,5643,5699,99
31100, 고양시,035,30~34세,2017,62041,30669,31372,97.8,59598,29287,30311,96.6
31100, 고양시,035001, 30세,2017,11621,5731,5890,97.3,11119,5442,5677,95.9
31100, 고양시,035002, 31세,2017,11775,5793,5982,96.8,11240,5498,5742,95.8
31100, 고양시,035003, 32세,2017,12152,6014,6138,98,11680,5754,5926,97.1
31100, 고양시,035004, 33세,2017,12529,6220,6309,98.6,12058,5941,6117,97.1
31100, 고양시,035005, 34세,2017,13964,6911,7053,98,13501,6652,6849,97.1
31100, 고양시,040,35~39세,2017,76077,36831,39246,93.8,74162,35762,38400,93.1
31100, 고양시,040001, 35세,2017,14794,7270,7524,96.6,14327,7012,7315,95.9
31100, 고양시,040002, 36세,2017,15450,7416,8034,92.3,15056,7194,7862,91.5
31100, 고양시,040003, 37세,2017,15672,7516,8156,92.2,15285,7319,7966,91.9
31100, 고양시,040004, 38세,2017,15706,7552,8154,92.6,15343,7339,8004,91.7
31100, 고양시,040005, 39세,2017,14455,7077,7378,95.9,14151,6898,7253,95.1
31100, 고양시,045,40~44세,2017,85051,40984,44067,93,83566,40189,43377,92.7
31100, 고양시,045001, 40세,2017,15366,7351,8015,91.7,15055,7171,7884,91
31100, 고양시,045002, 41세,2017,15435,7549,7886,95.7,15127,7370,7757,95
31100, 고양시,045003, 42세,2017,16553,7982,8571,93.1,16255,7835,8420,93.1
31100, 고양시,045004, 43세,2017,18567,8949,9618,93,18292,8807,9485,92.9
31100, 고양시,045005, 44세,2017,19130,9153,9977,91.7,18837,9006,9831,91.6
31100, 고양시,050,45~49세,2017,103541,50343,53198,94.6,102011,49583,52428,94.6
31100, 고양시,050001, 45세,2017,20273,9758,10515,92.8,19989,9609,10380,92.6
31100, 고양시,050002, 46세,2017,21328,10431,10897,95.7,21017,10280,10737,95.7
31100, 고양시,050003, 47세,2017,20845,10149,10696,94.9,20522,9997,10525,95
31100, 고양시,050004, 48세,2017,20960,10272,10688,96.1,20640,10121,10519,96.2
31100, 고양시,050005, 49세,2017,20135,9733,10402,93.6,19843,9576,10267,93.3
31100, 고양시,055,50~54세,2017,91354,45058,46296,97.3,89825,44361,45464,97.6
31100, 고양시,055001, 50세,2017,18592,8946,9646,92.7,18326,8829,9497,93
31100, 고양시,055002, 51세,2017,18033,8992,9041,99.5,17752,8845,8907,99.3
31100, 고양시,055003, 52세,2017,18635,9092,9543,95.3,18339,8962,9377,95.6
31100, 고양시,055004, 53세,2017,17660,8734,8926,97.8,17348,8595,8753,98.2
31100, 고양시,055005, 54세,2017,18434,9294,9140,101.7,18060,9130,8930,102.2
31100, 고양시,060,55~59세,2017,83620,42605,41015,103.9,82328,42047,40281,104.4
31100, 고양시,060001, 55세,2017,17864,8978,8886,101,17586,8854,8732,101.4
31100, 고양시,060002, 56세,2017,18337,9379,8958,104.7,18114,9284,8830,105.1
31100, 고양시,060003, 57세,2017,17740,9008,8732,103.2,17430,8877,8553,103.8
31100, 고양시,060004, 58세,2017,15481,7896,7585,104.1,15236,7795,7441,104.8
31100, 고양시,060005, 59세,2017,14198,7344,6854,107.1,13962,7237,6725,107.6
31100, 고양시,065,60~64세,2017,54817,28091,26726,105.1,53730,27575,26155,105.4
31100, 고양시,065001, 60세,2017,13529,7059,6470,109.1,13277,6949,6328,109.8
31100, 고양시,065002, 61세,2017,11945,6209,5736,108.2,11732,6098,5634,108.2
31100, 고양시,065003, 62세,2017,11791,5909,5882,100.5,11553,5794,5759,100.6
31100, 고양시,065004, 63세,2017,9437,4860,4577,106.2,9232,4762,4470,106.5
31100, 고양시,065005, 64세,2017,8115,4054,4061,99.8,7936,3972,3964,100.2
31100, 고양시,070,65~69세,2017,33984,15849,18135,87.4,33496,15629,17867,87.5
31100, 고양시,070001, 65세,2017,8334,4131,4203,98.3,8187,4069,4118,98.8
31100, 고양시,070002, 66세,2017,5586,2664,2922,91.2,5481,2621,2860,91.6
31100, 고양시,070003, 67세,2017,6518,2941,3577,82.2,6421,2893,3528,82
31100, 고양시,070004, 68세,2017,6758,3090,3668,84.2,6677,3052,3625,84.2
31100, 고양시,070005, 69세,2017,6788,3023,3765,80.3,6730,2994,3736,80.1
31100, 고양시,075,70~74세,2017,29148,12475,16673,74.8,28946,12379,16567,74.7
31100, 고양시,075001, 70세,2017,6964,3070,3894,78.8,6908,3045,3863,78.8
31100, 고양시,075002, 71세,2017,5596,2456,3140,78.2,5543,2432,3111,78.2
31100, 고양시,075003, 72세,2017,5386,2304,3082,74.8,5345,2280,3065,74.4
31100, 고양시,075004, 73세,2017,5519,2279,3240,70.3,5489,2264,3225,70.2
31100, 고양시,075005, 74세,2017,5683,2366,3317,71.3,5661,2358,3303,71.4
31100, 고양시,080,75~79세,2017,26901,10989,15912,69.1,26788,10955,15833,69.2
31100, 고양시,080001, 75세,2017,6511,2723,3788,71.9,6483,2713,3770,72
31100, 고양시,080002, 76세,2017,5515,2319,3196,72.6,5491,2313,3178,72.8
31100, 고양시,080003, 77세,2017,5179,2086,3093,67.4,5161,2083,3078,67.7
31100, 고양시,080004, 78세,2017,5083,2012,3071,65.5,5067,2006,3061,65.5
31100, 고양시,080005, 79세,2017,4613,1849,2764,66.9,4586,1840,2746,67
31100, 고양시,085,80~84세,2017,17401,6388,11013,58,17339,6372,10967,58.1
31100, 고양시,085001, 80세,2017,4248,1626,2622,62,4231,1622,2609,62.2
31100, 고양시,085002, 81세,2017,3926,1540,2386,64.5,3911,1535,2376,64.6
31100, 고양시,085003, 82세,2017,3689,1342,2347,57.2,3677,1340,2337,57.3
31100, 고양시,085004, 83세,2017,3008,1007,2001,50.3,2996,1003,1993,50.3
31100, 고양시,085005, 84세,2017,2530,873,1657,52.7,2524,872,1652,52.8
31100, 고양시,090,85~89세,2017,7958,2521,5437,46.4,7934,2517,5417,46.5
31100, 고양시,090001, 85세,2017,2213,786,1427,55.1,2205,785,1420,55.3
31100, 고양시,090002, 86세,2017,1778,592,1186,49.9,1774,592,1182,50.1
31100, 고양시,090003, 87세,2017,1565,452,1113,40.6,1562,451,1111,40.6
31100, 고양시,090004, 88세,2017,1326,401,925,43.4,1321,401,920,43.6
31100, 고양시,090005, 89세,2017,1076,290,786,36.9,1072,288,784,36.7
31100, 고양시,095,90~94세,2017,2580,647,1933,33.5,2572,645,1927,33.5
31100, 고양시,095001, 90세,2017,819,214,605,35.4,817,213,604,35.3
31100, 고양시,095002, 91세,2017,598,140,458,30.6,597,139,458,30.3
31100, 고양시,095003, 92세,2017,501,116,385,30.1,498,116,382,30.4
31100, 고양시,095004, 93세,2017,346,92,254,36.2,346,92,254,36.2
31100, 고양시,095005, 94세,2017,316,85,231,36.8,314,85,229,37.1
31100, 고양시,100,95~99세,2017,620,171,449,38.1,619,171,448,38.2
31100, 고양시,100001, 95세,2017,249,70,179,39.1,248,70,178,39.3
31100, 고양시,100002, 96세,2017,146,38,108,35.2,146,38,108,35.2
31100, 고양시,100003, 97세,2017,113,35,78,44.9,113,35,78,44.9
31100, 고양시,100004, 98세,2017,71,22,49,44.9,71,22,49,44.9
31100, 고양시,100005, 99세,2017,41,6,35,17.1,41,6,35,17.1
31100, 고양시,101,100세이상,2017,82,21,61,34.4,82,21,61,34.4
31100, 고양시,102,15세미만,2017,136615,70200,66415,105.7,136094,69951,66143,105.8
31100, 고양시,103,15~64세,2017,749813,373543,376270,99.3,734710,365592,369118,99
31100, 고양시,104,65세이상,2017,118674,49061,69613,70.5,117776,48689,69087,70.5
31100, 고양시,086,85세이상,2017,11240,3360,7880,42.6,11207,3354,7853,42.7
31100, 고양시,126,평균연령,2017,40.6,39.6,41.5,,40.6,39.6,41.5,
31100, 고양시,127,중위연령,2017,42.2,41.3,43,,42.3,41.4,43.1,
31101, 덕양구,000,합계,2017,433606,214769,218837,98.1,427188,211634,215554,98.2
31101, 덕양구,005,0~4세,2017,18801,9629,9172,105,18708,9579,9129,104.9
31101, 덕양구,005001, 0세,2017,3165,1682,1483,113.4,3139,1670,1469,113.7
31101, 덕양구,005002, 1세,2017,3727,1884,1843,102.2,3706,1874,1832,102.3
31101, 덕양구,005003, 2세,2017,4019,2007,2012,99.8,4007,1999,2008,99.6
31101, 덕양구,005004, 3세,2017,3960,2035,1925,105.7,3937,2024,1913,105.8
31101, 덕양구,005005, 4세,2017,3930,2021,1909,105.9,3919,2012,1907,105.5
31101, 덕양구,010,5~9세,2017,20552,10588,9964,106.3,20487,10564,9923,106.5
31101, 덕양구,010001, 5세,2017,4358,2236,2122,105.4,4336,2227,2109,105.6
31101, 덕양구,010002, 6세,2017,4308,2216,2092,105.9,4297,2212,2085,106.1
31101, 덕양구,010003, 7세,2017,3975,2065,1910,108.1,3963,2061,1902,108.4
31101, 덕양구,010004, 8세,2017,3846,2015,1831,110,3834,2011,1823,110.3
31101, 덕양구,010005, 9세,2017,4065,2056,2009,102.3,4057,2053,2004,102.4
31101, 덕양구,015,10~14세,2017,19160,9805,9355,104.8,19133,9797,9336,104.9
31101, 덕양구,015001, 10세,2017,3917,2025,1892,107,3908,2019,1889,106.9
31101, 덕양구,015002, 11세,2017,3639,1837,1802,101.9,3636,1837,1799,102.1
31101, 덕양구,015003, 12세,2017,3539,1748,1791,97.6,3533,1747,1786,97.8
31101, 덕양구,015004, 13세,2017,3982,2066,1916,107.8,3978,2065,1913,107.9
31101, 덕양구,015005, 14세,2017,4083,2129,1954,109,4078,2129,1949,109.2
31101, 덕양구,020,15~19세,2017,23321,12050,11271,106.9,23244,12012,11232,106.9
31101, 덕양구,020001, 15세,2017,4058,2086,1972,105.8,4053,2083,1970,105.7
31101, 덕양구,020002, 16세,2017,4615,2373,2242,105.8,4610,2371,2239,105.9
31101, 덕양구,020003, 17세,2017,5090,2598,2492,104.3,5074,2589,2485,104.2
31101, 덕양구,020004, 18세,2017,4860,2579,2281,113.1,4844,2572,2272,113.2
31101, 덕양구,020005, 19세,2017,4698,2414,2284,105.7,4663,2397,2266,105.8
31101, 덕양구,025,20~24세,2017,28264,15096,13168,114.6,27676,14798,12878,114.9
31101, 덕양구,025001, 20세,2017,4994,2710,2284,118.7,4953,2686,2267,118.5
31101, 덕양구,025002, 21세,2017,5549,3031,2518,120.4,5472,2998,2474,121.2
31101, 덕양구,025003, 22세,2017,5770,3078,2692,114.3,5661,3021,2640,114.4
31101, 덕양구,025004, 23세,2017,5912,3167,2745,115.4,5733,3082,2651,116.3
31101, 덕양구,025005, 24세,2017,6039,3110,2929,106.2,5857,3011,2846,105.8
31101, 덕양구,030,25~29세,2017,28333,14393,13940,103.2,27406,13889,13517,102.8
31101, 덕양구,030001, 25세,2017,6291,3264,3027,107.8,6117,3162,2955,107
31101, 덕양구,030002, 26세,2017,6006,3033,2973,102,5842,2945,2897,101.7
31101, 덕양구,030003, 27세,2017,5673,2852,2821,101.1,5488,2754,2734,100.7
31101, 덕양구,030004, 28세,2017,5285,2687,2598,103.4,5092,2575,2517,102.3
31101, 덕양구,030005, 29세,2017,5078,2557,2521,101.4,4867,2453,2414,101.6
31101, 덕양구,035,30~34세,2017,28059,14091,13968,100.9,27163,13627,13536,100.7
31101, 덕양구,035001, 30세,2017,5079,2529,2550,99.2,4885,2431,2454,99.1
31101, 덕양구,035002, 31세,2017,5270,2664,2606,102.2,5074,2555,2519,101.4
31101, 덕양구,035003, 32세,2017,5572,2803,2769,101.2,5402,2721,2681,101.5
31101, 덕양구,035004, 33세,2017,5712,2872,2840,101.1,5541,2781,2760,100.8
31101, 덕양구,035005, 34세,2017,6426,3223,3203,100.6,6261,3139,3122,100.5
31101, 덕양구,040,35~39세,2017,34591,17241,17350,99.4,33885,16887,16998,99.3
31101, 덕양구,040001, 35세,2017,6775,3409,3366,101.3,6612,3329,3283,101.4
31101, 덕양구,040002, 36세,2017,7104,3527,3577,98.6,6970,3456,3514,98.3
31101, 덕양구,040003, 37세,2017,7169,3563,3606,98.8,7009,3489,3520,99.1
31101, 덕양구,040004, 38세,2017,7055,3458,3597,96.1,6921,3393,3528,96.2
31101, 덕양구,040005, 39세,2017,6488,3284,3204,102.5,6373,3220,3153,102.1
31101, 덕양구,045,40~44세,2017,35952,18096,17856,101.3,35378,17806,17572,101.3
31101, 덕양구,045001, 40세,2017,6761,3350,3411,98.2,6656,3289,3367,97.7
31101, 덕양구,045002, 41세,2017,6654,3420,3234,105.8,6524,3352,3172,105.7
31101, 덕양구,045003, 42세,2017,7032,3510,3522,99.7,6918,3461,3457,100.1
31101, 덕양구,045004, 43세,2017,7770,3906,3864,101.1,7650,3844,3806,101
31101, 덕양구,045005, 44세,2017,7735,3910,3825,102.2,7630,3860,3770,102.4
31101, 덕양구,050,45~49세,2017,41071,20422,20649,98.9,40482,20155,20327,99.2
31101, 덕양구,050001, 45세,2017,8149,4083,4066,100.4,8042,4025,4017,100.2
31101, 덕양구,050002, 46세,2017,8436,4241,4195,101.1,8309,4197,4112,102.1
31101, 덕양구,050003, 47세,2017,8160,4084,4076,100.2,8034,4025,4009,100.4
31101, 덕양구,050004, 48세,2017,8285,4104,4181,98.2,8160,4053,4107,98.7
31101, 덕양구,050005, 49세,2017,8041,3910,4131,94.7,7937,3855,4082,94.4
31101, 덕양구,055,50~54세,2017,37872,18797,19075,98.5,37268,18528,18740,98.9
31101, 덕양구,055001, 50세,2017,7533,3640,3893,93.5,7410,3584,3826,93.7
31101, 덕양구,055002, 51세,2017,7508,3768,3740,100.7,7416,3712,3704,100.2
31101, 덕양구,055003, 52세,2017,7757,3808,3949,96.4,7643,3767,3876,97.2
31101, 덕양구,055004, 53세,2017,7273,3640,3633,100.2,7156,3594,3562,100.9
31101, 덕양구,055005, 54세,2017,7801,3941,3860,102.1,7643,3871,3772,102.6
31101, 덕양구,060,55~59세,2017,36506,18567,17939,103.5,35991,18339,17652,103.9
31101, 덕양구,060001, 55세,2017,7584,3813,3771,101.1,7464,3761,3703,101.6
31101, 덕양구,060002, 56세,2017,7920,4027,3893,103.4,7839,3991,3848,103.7
31101, 덕양구,060003, 57세,2017,7834,3983,3851,103.4,7705,3921,3784,103.6
31101, 덕양구,060004, 58세,2017,6817,3473,3344,103.9,6720,3433,3287,104.4
31101, 덕양구,060005, 59세,2017,6351,3271,3080,106.2,6263,3233,3030,106.7
31101, 덕양구,065,60~64세,2017,25255,12692,12563,101,24843,12489,12354,101.1
31101, 덕양구,065001, 60세,2017,6090,3140,2950,106.4,5983,3094,2889,107.1
31101, 덕양구,065002, 61세,2017,5375,2726,2649,102.9,5312,2693,2619,102.8
31101, 덕양구,065003, 62세,2017,5499,2697,2802,96.3,5406,2649,2757,96.1
31101, 덕양구,065004, 63세,2017,4439,2237,2202,101.6,4367,2204,2163,101.9
31101, 덕양구,065005, 64세,2017,3852,1892,1960,96.5,3775,1849,1926,96
31101, 덕양구,070,65~69세,2017,16675,7760,8915,87,16477,7674,8803,87.2
31101, 덕양구,070001, 65세,2017,4100,2027,2073,97.8,4046,2006,2040,98.3
31101, 덕양구,070002, 66세,2017,2751,1302,1449,89.9,2710,1285,1425,90.2
31101, 덕양구,070003, 67세,2017,3162,1393,1769,78.7,3125,1379,1746,79
31101, 덕양구,070004, 68세,2017,3311,1523,1788,85.2,3266,1500,1766,84.9
31101, 덕양구,070005, 69세,2017,3351,1515,1836,82.5,3330,1504,1826,82.4
31101, 덕양구,075,70~74세,2017,14176,6102,8074,75.6,14104,6070,8034,75.6
31101, 덕양구,075001, 70세,2017,3373,1503,1870,80.4,3350,1495,1855,80.6
31101, 덕양구,075002, 71세,2017,2778,1247,1531,81.5,2757,1237,1520,81.4
31101, 덕양구,075003, 72세,2017,2666,1144,1522,75.2,2654,1135,1519,74.7
31101, 덕양구,075004, 73세,2017,2648,1070,1578,67.8,2641,1065,1576,67.6
31101, 덕양구,075005, 74세,2017,2711,1138,1573,72.3,2702,1138,1564,72.8
31101, 덕양구,080,75~79세,2017,12704,5306,7398,71.7,12661,5296,7365,71.9
31101, 덕양구,080001, 75세,2017,3139,1301,1838,70.8,3127,1297,1830,70.9
31101, 덕양구,080002, 76세,2017,2592,1149,1443,79.6,2585,1148,1437,79.9
31101, 덕양구,080003, 77세,2017,2471,1039,1432,72.6,2463,1037,1426,72.7
31101, 덕양구,080004, 78세,2017,2387,964,1423,67.7,2382,963,1419,67.9
31101, 덕양구,080005, 79세,2017,2115,853,1262,67.6,2104,851,1253,67.9
31101, 덕양구,085,80~84세,2017,7569,2765,4804,57.6,7547,2760,4787,57.7
31101, 덕양구,085001, 80세,2017,1887,722,1165,62,1884,722,1162,62.1
31101, 덕양구,085002, 81세,2017,1740,674,1066,63.2,1735,673,1062,63.4
31101, 덕양구,085003, 82세,2017,1580,581,999,58.2,1577,581,996,58.3
31101, 덕양구,085004, 83세,2017,1276,427,849,50.3,1268,423,845,50.1
31101, 덕양구,085005, 84세,2017,1086,361,725,49.8,1083,361,722,50
31101, 덕양구,090,85~89세,2017,3346,1041,2305,45.2,3339,1038,2301,45.1
31101, 덕양구,090001, 85세,2017,964,322,642,50.2,962,321,641,50.1
31101, 덕양구,090002, 86세,2017,743,252,491,51.3,742,252,490,51.4
31101, 덕양구,090003, 87세,2017,642,180,462,39,641,179,462,38.7
31101, 덕양구,090004, 88세,2017,548,162,386,42,546,162,384,42.2
31101, 덕양구,090005, 89세,2017,449,125,324,38.6,448,124,324,38.3
31101, 덕양구,095,90~94세,2017,1105,252,853,29.5,1102,250,852,29.3
31101, 덕양구,095001, 90세,2017,367,87,280,31.1,366,86,280,30.7
31101, 덕양구,095002, 91세,2017,267,59,208,28.4,266,58,208,27.9
31101, 덕양구,095003, 92세,2017,208,47,161,29.2,207,47,160,29.4
31101, 덕양구,095004, 93세,2017,145,36,109,33,145,36,109,33
31101, 덕양구,095005, 94세,2017,118,23,95,24.2,118,23,95,24.2
31101, 덕양구,100,95~99세,2017,261,71,190,37.4,261,71,190,37.4
31101, 덕양구,100001, 95세,2017,101,28,73,38.4,101,28,73,38.4
31101, 덕양구,100002, 96세,2017,60,12,48,25,60,12,48,25
31101, 덕양구,100003, 97세,2017,49,19,30,63.3,49,19,30,63.3
31101, 덕양구,100004, 98세,2017,35,11,24,45.8,35,11,24,45.8
31101, 덕양구,100005, 99세,2017,16,X,15,6.7,16,X,15,6.7
31101, 덕양구,101,100세이상,2017,33,5,28,17.9,33,5,28,17.9
31101, 덕양구,102,15세미만,2017,58513,30022,28491,105.4,58328,29940,28388,105.5
31101, 덕양구,103,15~64세,2017,319224,161445,157779,102.3,313336,158530,154806,102.4
31101, 덕양구,104,65세이상,2017,55869,23302,32567,71.6,55524,23164,32360,71.6
31101, 덕양구,086,85세이상,2017,4745,1369,3376,40.6,4735,1364,3371,40.5
31101, 덕양구,126,평균연령,2017,41,40,42.1,,41,40,42.1,
31101, 덕양구,127,중위연령,2017,42.3,41.3,43.3,,42.4,41.4,43.3,
31103, 일산동구,000,합계,2017,284692,138851,145841,95.2,279088,135677,143411,94.6
31103, 일산동구,005,0~4세,2017,10252,5272,4980,105.9,10154,5219,4935,105.8
31103, 일산동구,005001, 0세,2017,1815,918,897,102.3,1794,906,888,102
31103, 일산동구,005002, 1세,2017,1920,1003,917,109.4,1900,994,906,109.7
31103, 일산동구,005003, 2세,2017,2199,1137,1062,107.1,2180,1126,1054,106.8
31103, 일산동구,005004, 3세,2017,2148,1092,1056,103.4,2130,1080,1050,102.9
31103, 일산동구,005005, 4세,2017,2170,1122,1048,107.1,2150,1113,1037,107.3
31103, 일산동구,010,5~9세,2017,12317,6361,5956,106.8,12266,6339,5927,107
31103, 일산동구,010001, 5세,2017,2410,1260,1150,109.6,2394,1251,1143,109.4
31103, 일산동구,010002, 6세,2017,2397,1180,1217,97,2387,1177,1210,97.3
31103, 일산동구,010003, 7세,2017,2494,1283,1211,105.9,2489,1280,1209,105.9
31103, 일산동구,010004, 8세,2017,2399,1273,1126,113.1,2387,1269,1118,113.5
31103, 일산동구,010005, 9세,2017,2617,1365,1252,109,2609,1362,1247,109.2
31103, 일산동구,015,10~14세,2017,13725,7073,6652,106.3,13704,7062,6642,106.3
31103, 일산동구,015001, 10세,2017,2622,1363,1259,108.3,2616,1361,1255,108.4
31103, 일산동구,015002, 11세,2017,2582,1322,1260,104.9,2582,1322,1260,104.9
31103, 일산동구,015003, 12세,2017,2584,1326,1258,105.4,2579,1323,1256,105.3
31103, 일산동구,015004, 13세,2017,2961,1476,1485,99.4,2956,1474,1482,99.5
31103, 일산동구,015005, 14세,2017,2976,1586,1390,114.1,2971,1582,1389,113.9
31103, 일산동구,020,15~19세,2017,17516,8954,8562,104.6,17472,8930,8542,104.5
31103, 일산동구,020001, 15세,2017,3022,1569,1453,108,3015,1564,1451,107.8
31103, 일산동구,020002, 16세,2017,3493,1857,1636,113.5,3489,1857,1632,113.8
31103, 일산동구,020003, 17세,2017,3920,1987,1933,102.8,3917,1984,1933,102.6
31103, 일산동구,020004, 18세,2017,3731,1891,1840,102.8,3716,1882,1834,102.6
31103, 일산동구,020005, 19세,2017,3350,1650,1700,97.1,3335,1643,1692,97.1
31103, 일산동구,025,20~24세,2017,19417,10006,9411,106.3,18943,9691,9252,104.7
31103, 일산동구,025001, 20세,2017,3443,1766,1677,105.3,3416,1746,1670,104.6
31103, 일산동구,025002, 21세,2017,3719,2059,1660,124,3665,2022,1643,123.1
31103, 일산동구,025003, 22세,2017,3874,2109,1765,119.5,3789,2044,1745,117.1
31103, 일산동구,025004, 23세,2017,4108,2076,2032,102.2,3980,1998,1982,100.8
31103, 일산동구,025005, 24세,2017,4273,1996,2277,87.7,4093,1881,2212,85
31103, 일산동구,030,25~29세,2017,20251,10019,10232,97.9,19323,9446,9877,95.6
31103, 일산동구,030001, 25세,2017,4503,2208,2295,96.2,4334,2102,2232,94.2
31103, 일산동구,030002, 26세,2017,4244,2062,2182,94.5,4076,1956,2120,92.3
31103, 일산동구,030003, 27세,2017,4059,2017,2042,98.8,3852,1883,1969,95.6
31103, 일산동구,030004, 28세,2017,3764,1871,1893,98.8,3580,1760,1820,96.7
31103, 일산동구,030005, 29세,2017,3681,1861,1820,102.3,3481,1745,1736,100.5
31103, 일산동구,035,30~34세,2017,18122,8983,9139,98.3,17177,8390,8787,95.5
31103, 일산동구,035001, 30세,2017,3610,1770,1840,96.2,3414,1643,1771,92.8
31103, 일산동구,035002, 31세,2017,3527,1737,1790,97,3323,1623,1700,95.5
31103, 일산동구,035003, 32세,2017,3493,1720,1773,97,3310,1597,1713,93.2
31103, 일산동구,035004, 33세,2017,3582,1817,1765,102.9,3400,1696,1704,99.5
31103, 일산동구,035005, 34세,2017,3910,1939,1971,98.4,3730,1831,1899,96.4
31103, 일산동구,040,35~39세,2017,21186,10051,11135,90.3,20470,9606,10864,88.4
31103, 일산동구,040001, 35세,2017,4142,2015,2127,94.7,3960,1900,2060,92.2
31103, 일산동구,040002, 36세,2017,4289,1990,2299,86.6,4123,1888,2235,84.5
31103, 일산동구,040003, 37세,2017,4309,1996,2313,86.3,4192,1929,2263,85.2
31103, 일산동구,040004, 38세,2017,4396,2105,2291,91.9,4258,2013,2245,89.7
31103, 일산동구,040005, 39세,2017,4050,1945,2105,92.4,3937,1876,2061,91
31103, 일산동구,045,40~44세,2017,24202,11330,12872,88,23701,11047,12654,87.3
31103, 일산동구,045001, 40세,2017,4236,1964,2272,86.4,4131,1901,2230,85.2
31103, 일산동구,045002, 41세,2017,4430,2130,2300,92.6,4326,2061,2265,91
31103, 일산동구,045003, 42세,2017,4597,2191,2406,91.1,4489,2133,2356,90.5
31103, 일산동구,045004, 43세,2017,5329,2486,2843,87.4,5243,2440,2803,87
31103, 일산동구,045005, 44세,2017,5610,2559,3051,83.9,5512,2512,3000,83.7
31103, 일산동구,050,45~49세,2017,30592,14763,15829,93.3,30104,14515,15589,93.1
31103, 일산동구,050001, 45세,2017,5985,2865,3120,91.8,5881,2818,3063,92
31103, 일산동구,050002, 46세,2017,6311,3032,3279,92.5,6209,2971,3238,91.8
31103, 일산동구,050003, 47세,2017,6252,3012,3240,93,6146,2964,3182,93.1
31103, 일산동구,050004, 48세,2017,6198,3022,3176,95.2,6101,2971,3130,94.9
31103, 일산동구,050005, 49세,2017,5846,2832,3014,94,5767,2791,2976,93.8
31103, 일산동구,055,50~54세,2017,26621,13041,13580,96,26185,12832,13353,96.1
31103, 일산동구,055001, 50세,2017,5411,2599,2812,92.4,5340,2566,2774,92.5
31103, 일산동구,055002, 51세,2017,5251,2601,2650,98.2,5154,2547,2607,97.7
31103, 일산동구,055003, 52세,2017,5381,2605,2776,93.8,5291,2562,2729,93.9
31103, 일산동구,055004, 53세,2017,5229,2546,2683,94.9,5134,2505,2629,95.3
31103, 일산동구,055005, 54세,2017,5349,2690,2659,101.2,5266,2652,2614,101.5
31103, 일산동구,060,55~59세,2017,23968,12142,11826,102.7,23610,11988,11622,103.1
31103, 일산동구,060001, 55세,2017,5235,2629,2606,100.9,5170,2598,2572,101
31103, 일산동구,060002, 56세,2017,5241,2718,2523,107.7,5174,2690,2484,108.3
31103, 일산동구,060003, 57세,2017,5041,2501,2540,98.5,4959,2470,2489,99.2
31103, 일산동구,060004, 58세,2017,4368,2187,2181,100.3,4293,2157,2136,101
31103, 일산동구,060005, 59세,2017,4083,2107,1976,106.6,4014,2073,1941,106.8
31103, 일산동구,065,60~64세,2017,15262,7955,7307,108.9,14980,7829,7151,109.5
31103, 일산동구,065001, 60세,2017,3820,1995,1825,109.3,3757,1970,1787,110.2
31103, 일산동구,065002, 61세,2017,3409,1795,1614,111.2,3345,1759,1586,110.9
31103, 일산동구,065003, 62세,2017,3191,1606,1585,101.3,3136,1583,1553,101.9
31103, 일산동구,065004, 63세,2017,2600,1383,1217,113.6,2542,1354,1188,114
31103, 일산동구,065005, 64세,2017,2242,1176,1066,110.3,2200,1163,1037,112.2
31103, 일산동구,070,65~69세,2017,8758,4137,4621,89.5,8629,4073,4556,89.4
31103, 일산동구,070001, 65세,2017,2117,1061,1056,100.5,2076,1044,1032,101.2
31103, 일산동구,070002, 66세,2017,1436,696,740,94.1,1405,682,723,94.3
31103, 일산동구,070003, 67세,2017,1737,834,903,92.4,1708,815,893,91.3
31103, 일산동구,070004, 68세,2017,1739,783,956,81.9,1721,774,947,81.7
31103, 일산동구,070005, 69세,2017,1729,763,966,79,1719,758,961,78.9
31103, 일산동구,075,70~74세,2017,7444,3249,4195,77.4,7375,3214,4161,77.2
31103, 일산동구,075001, 70세,2017,1765,792,973,81.4,1750,783,967,81
31103, 일산동구,075002, 71세,2017,1399,601,798,75.3,1379,592,787,75.2
31103, 일산동구,075003, 72세,2017,1316,573,743,77.1,1304,568,736,77.2
31103, 일산동구,075004, 73세,2017,1490,634,856,74.1,1477,628,849,74
31103, 일산동구,075005, 74세,2017,1474,649,825,78.7,1465,643,822,78.2
31103, 일산동구,080,75~79세,2017,6831,2771,4060,68.3,6799,2758,4041,68.3
31103, 일산동구,080001, 75세,2017,1614,689,925,74.5,1606,686,920,74.6
31103, 일산동구,080002, 76세,2017,1390,565,825,68.5,1380,561,819,68.5
31103, 일산동구,080003, 77세,2017,1347,544,803,67.7,1343,544,799,68.1
31103, 일산동구,080004, 78세,2017,1296,484,812,59.6,1294,482,812,59.4
31103, 일산동구,080005, 79세,2017,1184,489,695,70.4,1176,485,691,70.2
31103, 일산동구,085,80~84세,2017,4862,1756,3106,56.5,4842,1751,3091,56.6
31103, 일산동구,085001, 80세,2017,1149,446,703,63.4,1143,444,699,63.5
31103, 일산동구,085002, 81세,2017,1071,400,671,59.6,1065,398,667,59.7
31103, 일산동구,085003, 82세,2017,1025,366,659,55.5,1020,365,655,55.7
31103, 일산동구,085004, 83세,2017,877,278,599,46.4,874,278,596,46.6
31103, 일산동구,085005, 84세,2017,740,266,474,56.1,740,266,474,56.1
31103, 일산동구,090,85~89세,2017,2329,722,1607,44.9,2319,721,1598,45.1
31103, 일산동구,090001, 85세,2017,654,232,422,55,651,232,419,55.4
31103, 일산동구,090002, 86세,2017,488,158,330,47.9,486,158,328,48.2
31103, 일산동구,090003, 87세,2017,446,125,321,38.9,444,125,319,39.2
31103, 일산동구,090004, 88세,2017,405,125,280,44.6,405,125,280,44.6
31103, 일산동구,090005, 89세,2017,336,82,254,32.3,333,81,252,32.1
31103, 일산동구,095,90~94세,2017,824,211,613,34.4,823,211,612,34.5
31103, 일산동구,095001, 90세,2017,236,65,171,38,236,65,171,38
31103, 일산동구,095002, 91세,2017,172,37,135,27.4,172,37,135,27.4
31103, 일산동구,095003, 92세,2017,174,40,134,29.9,174,40,134,29.9
31103, 일산동구,095004, 93세,2017,109,30,79,38,109,30,79,38
31103, 일산동구,095005, 94세,2017,133,39,94,41.5,132,39,93,41.9
31103, 일산동구,100,95~99세,2017,185,45,140,32.1,184,45,139,32.4
31103, 일산동구,100001, 95세,2017,75,17,58,29.3,74,17,57,29.8
31103, 일산동구,100002, 96세,2017,48,15,33,45.5,48,15,33,45.5
31103, 일산동구,100003, 97세,2017,33,6,27,22.2,33,6,27,22.2
31103, 일산동구,100004, 98세,2017,18,5,13,38.5,18,5,13,38.5
31103, 일산동구,100005, 99세,2017,11,X,9,22.2,11,X,9,22.2
31103, 일산동구,101,100세이상,2017,28,10,18,55.6,28,10,18,55.6
31103, 일산동구,102,15세미만,2017,36294,18706,17588,106.4,36124,18620,17504,106.4
31103, 일산동구,103,15~64세,2017,217137,107244,109893,97.6,211965,104274,107691,96.8
31103, 일산동구,104,65세이상,2017,31261,12901,18360,70.3,30999,12783,18216,70.2
31103, 일산동구,086,85세이상,2017,3366,988,2378,41.5,3354,987,2367,41.7
31103, 일산동구,126,평균연령,2017,40.5,39.6,41.4,,40.6,39.6,41.4,
31103, 일산동구,127,중위연령,2017,42.2,41.3,42.9,,42.4,41.6,43,
31104, 일산서구,000,합계,2017,286804,139184,147620,94.3,282304,136921,145383,94.2
31104, 일산서구,005,0~4세,2017,11393,5817,5576,104.3,11299,5769,5530,104.3
31104, 일산서구,005001, 0세,2017,1812,923,889,103.8,1795,914,881,103.7
31104, 일산서구,005002, 1세,2017,2261,1149,1112,103.3,2238,1139,1099,103.6
31104, 일산서구,005003, 2세,2017,2400,1228,1172,104.8,2381,1216,1165,104.4
31104, 일산서구,005004, 3세,2017,2374,1229,1145,107.3,2354,1220,1134,107.6
31104, 일산서구,005005, 4세,2017,2546,1288,1258,102.4,2531,1280,1251,102.3
31104, 일산서구,010,5~9세,2017,14234,7269,6965,104.4,14187,7250,6937,104.5
31104, 일산서구,010001, 5세,2017,2817,1438,1379,104.3,2803,1434,1369,104.7
31104, 일산서구,010002, 6세,2017,2808,1465,1343,109.1,2797,1460,1337,109.2
31104, 일산서구,010003, 7세,2017,2783,1428,1355,105.4,2772,1424,1348,105.6
31104, 일산서구,010004, 8세,2017,2697,1382,1315,105.1,2689,1378,1311,105.1
31104, 일산서구,010005, 9세,2017,3129,1556,1573,98.9,3126,1554,1572,98.9
31104, 일산서구,015,10~14세,2017,16181,8386,7795,107.6,16156,8372,7784,107.6
31104, 일산서구,015001, 10세,2017,3138,1653,1485,111.3,3132,1649,1483,111.2
31104, 일산서구,015002, 11세,2017,2996,1538,1458,105.5,2990,1534,1456,105.4
31104, 일산서구,015003, 12세,2017,3081,1577,1504,104.9,3079,1577,1502,105
31104, 일산서구,015004, 13세,2017,3492,1776,1716,103.5,3486,1774,1712,103.6
31104, 일산서구,015005, 14세,2017,3474,1842,1632,112.9,3469,1838,1631,112.7
31104, 일산서구,020,15~19세,2017,19534,9897,9637,102.7,19492,9879,9613,102.8
31104, 일산서구,020001, 15세,2017,3650,1860,1790,103.9,3643,1855,1788,103.7
31104, 일산서구,020002, 16세,2017,3945,1987,1958,101.5,3941,1986,1955,101.6
31104, 일산서구,020003, 17세,2017,4384,2227,2157,103.2,4377,2224,2153,103.3
31104, 일산서구,020004, 18세,2017,4021,2032,1989,102.2,4016,2030,1986,102.2
31104, 일산서구,020005, 19세,2017,3534,1791,1743,102.8,3515,1784,1731,103.1
31104, 일산서구,025,20~24세,2017,18866,9930,8936,111.1,18636,9789,8847,110.6
31104, 일산서구,025001, 20세,2017,3547,1916,1631,117.5,3533,1907,1626,117.3
31104, 일산서구,025002, 21세,2017,3802,2214,1588,139.4,3774,2198,1576,139.5
31104, 일산서구,025003, 22세,2017,3808,1996,1812,110.2,3766,1970,1796,109.7
31104, 일산서구,025004, 23세,2017,3870,1952,1918,101.8,3795,1905,1890,100.8
31104, 일산서구,025005, 24세,2017,3839,1852,1987,93.2,3768,1809,1959,92.3
31104, 일산서구,030,25~29세,2017,17810,8617,9193,93.7,17298,8354,8944,93.4
31104, 일산서구,030001, 25세,2017,3972,1854,2118,87.5,3887,1806,2081,86.8
31104, 일산서구,030002, 26세,2017,3925,1951,1974,98.8,3830,1901,1929,98.5
31104, 일산서구,030003, 27세,2017,3488,1690,1798,94,3388,1638,1750,93.6
31104, 일산서구,030004, 28세,2017,3318,1623,1695,95.8,3199,1564,1635,95.7
31104, 일산서구,030005, 29세,2017,3107,1499,1608,93.2,2994,1445,1549,93.3
31104, 일산서구,035,30~34세,2017,15860,7595,8265,91.9,15258,7270,7988,91
31104, 일산서구,035001, 30세,2017,2932,1432,1500,95.5,2820,1368,1452,94.2
31104, 일산서구,035002, 31세,2017,2978,1392,1586,87.8,2843,1320,1523,86.7
31104, 일산서구,035003, 32세,2017,3087,1491,1596,93.4,2968,1436,1532,93.7
31104, 일산서구,035004, 33세,2017,3235,1531,1704,89.8,3117,1464,1653,88.6
31104, 일산서구,035005, 34세,2017,3628,1749,1879,93.1,3510,1682,1828,92
31104, 일산서구,040,35~39세,2017,20300,9539,10761,88.6,19807,9269,10538,88
31104, 일산서구,040001, 35세,2017,3877,1846,2031,90.9,3755,1783,1972,90.4
31104, 일산서구,040002, 36세,2017,4057,1899,2158,88,3963,1850,2113,87.6
31104, 일산서구,040003, 37세,2017,4194,1957,2237,87.5,4084,1901,2183,87.1
31104, 일산서구,040004, 38세,2017,4255,1989,2266,87.8,4164,1933,2231,86.6
31104, 일산서구,040005, 39세,2017,3917,1848,2069,89.3,3841,1802,2039,88.4
31104, 일산서구,045,40~44세,2017,24897,11558,13339,86.6,24487,11336,13151,86.2
31104, 일산서구,045001, 40세,2017,4369,2037,2332,87.3,4268,1981,2287,86.6
31104, 일산서구,045002, 41세,2017,4351,1999,2352,85,4277,1957,2320,84.4
31104, 일산서구,045003, 42세,2017,4924,2281,2643,86.3,4848,2241,2607,86
31104, 일산서구,045004, 43세,2017,5468,2557,2911,87.8,5399,2523,2876,87.7
31104, 일산서구,045005, 44세,2017,5785,2684,3101,86.6,5695,2634,3061,86.1
31104, 일산서구,050,45~49세,2017,31878,15158,16720,90.7,31425,14913,16512,90.3
31104, 일산서구,050001, 45세,2017,6139,2810,3329,84.4,6066,2766,3300,83.8
31104, 일산서구,050002, 46세,2017,6581,3158,3423,92.3,6499,3112,3387,91.9
31104, 일산서구,050003, 47세,2017,6433,3053,3380,90.3,6342,3008,3334,90.2
31104, 일산서구,050004, 48세,2017,6477,3146,3331,94.4,6379,3097,3282,94.4
31104, 일산서구,050005, 49세,2017,6248,2991,3257,91.8,6139,2930,3209,91.3
31104, 일산서구,055,50~54세,2017,26861,13220,13641,96.9,26372,13001,13371,97.2
31104, 일산서구,055001, 50세,2017,5648,2707,2941,92,5576,2679,2897,92.5
31104, 일산서구,055002, 51세,2017,5274,2623,2651,98.9,5182,2586,2596,99.6
31104, 일산서구,055003, 52세,2017,5497,2679,2818,95.1,5405,2633,2772,95
31104, 일산서구,055004, 53세,2017,5158,2548,2610,97.6,5058,2496,2562,97.4
31104, 일산서구,055005, 54세,2017,5284,2663,2621,101.6,5151,2607,2544,102.5
31104, 일산서구,060,55~59세,2017,23146,11896,11250,105.7,22727,11720,11007,106.5
31104, 일산서구,060001, 55세,2017,5045,2536,2509,101.1,4952,2495,2457,101.5
31104, 일산서구,060002, 56세,2017,5176,2634,2542,103.6,5101,2603,2498,104.2
31104, 일산서구,060003, 57세,2017,4865,2524,2341,107.8,4766,2486,2280,109
31104, 일산서구,060004, 58세,2017,4296,2236,2060,108.5,4223,2205,2018,109.3
31104, 일산서구,060005, 59세,2017,3764,1966,1798,109.3,3685,1931,1754,110.1
31104, 일산서구,065,60~64세,2017,14300,7444,6856,108.6,13907,7257,6650,109.1
31104, 일산서구,065001, 60세,2017,3619,1924,1695,113.5,3537,1885,1652,114.1
31104, 일산서구,065002, 61세,2017,3161,1688,1473,114.6,3075,1646,1429,115.2
31104, 일산서구,065003, 62세,2017,3101,1606,1495,107.4,3011,1562,1449,107.8
31104, 일산서구,065004, 63세,2017,2398,1240,1158,107.1,2323,1204,1119,107.6
31104, 일산서구,065005, 64세,2017,2021,986,1035,95.3,1961,960,1001,95.9
31104, 일산서구,070,65~69세,2017,8551,3952,4599,85.9,8390,3882,4508,86.1
31104, 일산서구,070001, 65세,2017,2117,1043,1074,97.1,2065,1019,1046,97.4
31104, 일산서구,070002, 66세,2017,1399,666,733,90.9,1366,654,712,91.9
31104, 일산서구,070003, 67세,2017,1619,714,905,78.9,1588,699,889,78.6
31104, 일산서구,070004, 68세,2017,1708,784,924,84.8,1690,778,912,85.3
31104, 일산서구,070005, 69세,2017,1708,745,963,77.4,1681,732,949,77.1
31104, 일산서구,075,70~74세,2017,7528,3124,4404,70.9,7467,3095,4372,70.8
31104, 일산서구,075001, 70세,2017,1826,775,1051,73.7,1808,767,1041,73.7
31104, 일산서구,075002, 71세,2017,1419,608,811,75,1407,603,804,75
31104, 일산서구,075003, 72세,2017,1404,587,817,71.8,1387,577,810,71.2
31104, 일산서구,075004, 73세,2017,1381,575,806,71.3,1371,571,800,71.4
31104, 일산서구,075005, 74세,2017,1498,579,919,63,1494,577,917,62.9
31104, 일산서구,080,75~79세,2017,7366,2912,4454,65.4,7328,2901,4427,65.5
31104, 일산서구,080001, 75세,2017,1758,733,1025,71.5,1750,730,1020,71.6
31104, 일산서구,080002, 76세,2017,1533,605,928,65.2,1526,604,922,65.5
31104, 일산서구,080003, 77세,2017,1361,503,858,58.6,1355,502,853,58.9
31104, 일산서구,080004, 78세,2017,1400,564,836,67.5,1391,561,830,67.6
31104, 일산서구,080005, 79세,2017,1314,507,807,62.8,1306,504,802,62.8
31104, 일산서구,085,80~84세,2017,4970,1867,3103,60.2,4950,1861,3089,60.2
31104, 일산서구,085001, 80세,2017,1212,458,754,60.7,1204,456,748,61
31104, 일산서구,085002, 81세,2017,1115,466,649,71.8,1111,464,647,71.7
31104, 일산서구,085003, 82세,2017,1084,395,689,57.3,1080,394,686,57.4
31104, 일산서구,085004, 83세,2017,855,302,553,54.6,854,302,552,54.7
31104, 일산서구,085005, 84세,2017,704,246,458,53.7,701,245,456,53.7
31104, 일산서구,090,85~89세,2017,2283,758,1525,49.7,2276,758,1518,49.9
31104, 일산서구,090001, 85세,2017,595,232,363,63.9,592,232,360,64.4
31104, 일산서구,090002, 86세,2017,547,182,365,49.9,546,182,364,50
31104, 일산서구,090003, 87세,2017,477,147,330,44.5,477,147,330,44.5
31104, 일산서구,090004, 88세,2017,373,114,259,44,370,114,256,44.5
31104, 일산서구,090005, 89세,2017,291,83,208,39.9,291,83,208,39.9
31104, 일산서구,095,90~94세,2017,651,184,467,39.4,647,184,463,39.7
31104, 일산서구,095001, 90세,2017,216,62,154,40.3,215,62,153,40.5
31104, 일산서구,095002, 91세,2017,159,44,115,38.3,159,44,115,38.3
31104, 일산서구,095003, 92세,2017,119,29,90,32.2,117,29,88,33
31104, 일산서구,095004, 93세,2017,92,26,66,39.4,92,26,66,39.4
31104, 일산서구,095005, 94세,2017,65,23,42,54.8,64,23,41,56.1
31104, 일산서구,100,95~99세,2017,174,55,119,46.2,174,55,119,46.2
31104, 일산서구,100001, 95세,2017,73,25,48,52.1,73,25,48,52.1
31104, 일산서구,100002, 96세,2017,38,11,27,40.7,38,11,27,40.7
31104, 일산서구,100003, 97세,2017,31,10,21,47.6,31,10,21,47.6
31104, 일산서구,100004, 98세,2017,18,6,12,50,18,6,12,50
31104, 일산서구,100005, 99세,2017,14,X,11,27.3,14,X,11,27.3
31104, 일산서구,101,100세이상,2017,21,6,15,40,21,6,15,40
31104, 일산서구,102,15세미만,2017,41808,21472,20336,105.6,41642,21391,20251,105.6
31104, 일산서구,103,15~64세,2017,213452,104854,108598,96.6,209409,102788,106621,96.4
31104, 일산서구,104,65세이상,2017,31544,12858,18686,68.8,31253,12742,18511,68.8
31104, 일산서구,086,85세이상,2017,3129,1003,2126,47.2,3118,1003,2115,47.4
31104, 일산서구,126,평균연령,2017,39.9,39,40.8,,39.9,38.9,40.8,
31104, 일산서구,127,중위연령,2017,42.1,41.3,42.8,,42.1,41.3,42.7,
31110, 과천시,000,합계,2017,53583,26267,27316,96.2,53197,26081,27116,96.2
31110, 과천시,005,0~4세,2017,1824,943,881,107,1818,940,878,107.1
31110, 과천시,005001, 0세,2017,298,159,139,114.4,296,158,138,114.5
31110, 과천시,005002, 1세,2017,363,185,178,103.9,362,184,178,103.4
31110, 과천시,005003, 2세,2017,357,180,177,101.7,355,179,176,101.7
31110, 과천시,005004, 3세,2017,392,215,177,121.5,392,215,177,121.5
31110, 과천시,005005, 4세,2017,414,204,210,97.1,413,204,209,97.6
31110, 과천시,010,5~9세,2017,2434,1249,1185,105.4,2430,1248,1182,105.6
31110, 과천시,010001, 5세,2017,468,243,225,108,468,243,225,108
31110, 과천시,010002, 6세,2017,459,227,232,97.8,457,226,231,97.8
31110, 과천시,010003, 7세,2017,476,251,225,111.6,475,251,224,112.1
31110, 과천시,010004, 8세,2017,495,242,253,95.7,494,242,252,96
31110, 과천시,010005, 9세,2017,536,286,250,114.4,536,286,250,114.4
31110, 과천시,015,10~14세,2017,2899,1530,1369,111.8,2897,1528,1369,111.6
31110, 과천시,015001, 10세,2017,548,292,256,114.1,547,291,256,113.7
31110, 과천시,015002, 11세,2017,551,295,256,115.2,550,294,256,114.8
31110, 과천시,015003, 12세,2017,545,288,257,112.1,545,288,257,112.1
31110, 과천시,015004, 13세,2017,632,343,289,118.7,632,343,289,118.7
31110, 과천시,015005, 14세,2017,623,312,311,100.3,623,312,311,100.3
31110, 과천시,020,15~19세,2017,3551,1860,1691,110,3545,1859,1686,110.3
31110, 과천시,020001, 15세,2017,662,342,320,106.9,661,342,319,107.2
31110, 과천시,020002, 16세,2017,708,377,331,113.9,708,377,331,113.9
31110, 과천시,020003, 17세,2017,755,407,348,117,755,407,348,117
31110, 과천시,020004, 18세,2017,745,400,345,115.9,745,400,345,115.9
31110, 과천시,020005, 19세,2017,681,334,347,96.3,676,333,343,97.1
31110, 과천시,025,20~24세,2017,3583,1884,1699,110.9,3545,1867,1678,111.3
31110, 과천시,025001, 20세,2017,714,411,303,135.6,710,407,303,134.3
31110, 과천시,025002, 21세,2017,712,385,327,117.7,707,384,323,118.9
31110, 과천시,025003, 22세,2017,712,382,330,115.8,701,378,323,117
31110, 과천시,025004, 23세,2017,687,350,337,103.9,682,349,333,104.8
31110, 과천시,025005, 24세,2017,758,356,402,88.6,745,349,396,88.1
31110, 과천시,030,25~29세,2017,3376,1803,1573,114.6,3328,1783,1545,115.4
31110, 과천시,030001, 25세,2017,668,339,329,103,658,335,323,103.7
31110, 과천시,030002, 26세,2017,717,385,332,116,707,381,326,116.9
31110, 과천시,030003, 27세,2017,688,382,306,124.8,678,378,300,126
31110, 과천시,030004, 28세,2017,662,351,311,112.9,655,347,308,112.7
31110, 과천시,030005, 29세,2017,641,346,295,117.3,630,342,288,118.8
31110, 과천시,035,30~34세,2017,3065,1552,1513,102.6,3019,1529,1490,102.6
31110, 과천시,035001, 30세,2017,638,305,333,91.6,624,300,324,92.6
31110, 과천시,035002, 31세,2017,586,296,290,102.1,576,294,282,104.3
31110, 과천시,035003, 32세,2017,600,308,292,105.5,595,305,290,105.2
31110, 과천시,035004, 33세,2017,607,335,272,123.2,599,329,270,121.9
31110, 과천시,035005, 34세,2017,634,308,326,94.5,625,301,324,92.9
31110, 과천시,040,35~39세,2017,3314,1618,1696,95.4,3274,1591,1683,94.5
31110, 과천시,040001, 35세,2017,667,326,341,95.6,661,322,339,95
31110, 과천시,040002, 36세,2017,667,345,322,107.1,658,340,318,106.9
31110, 과천시,040003, 37세,2017,655,312,343,91,649,308,341,90.3
31110, 과천시,040004, 38세,2017,681,324,357,90.8,671,317,354,89.5
31110, 과천시,040005, 39세,2017,644,311,333,93.4,635,304,331,91.8
31110, 과천시,045,40~44세,2017,4019,1877,2142,87.6,3985,1856,2129,87.2
31110, 과천시,045001, 40세,2017,641,284,357,79.6,635,279,356,78.4
31110, 과천시,045002, 41세,2017,743,347,396,87.6,739,344,395,87.1
31110, 과천시,045003, 42세,2017,746,333,413,80.6,738,330,408,80.9
31110, 과천시,045004, 43세,2017,885,430,455,94.5,883,429,454,94.5
31110, 과천시,045005, 44세,2017,1004,483,521,92.7,990,474,516,91.9
31110, 과천시,050,45~49세,2017,5499,2611,2888,90.4,5460,2591,2869,90.3
31110, 과천시,050001, 45세,2017,1002,476,526,90.5,997,474,523,90.6
31110, 과천시,050002, 46세,2017,1172,557,615,90.6,1164,552,612,90.2
31110, 과천시,050003, 47세,2017,1092,510,582,87.6,1085,506,579,87.4
31110, 과천시,050004, 48세,2017,1098,533,565,94.3,1089,528,561,94.1
31110, 과천시,050005, 49세,2017,1135,535,600,89.2,1125,531,594,89.4
31110, 과천시,055,50~54세,2017,4989,2478,2511,98.7,4952,2465,2487,99.1
31110, 과천시,055001, 50세,2017,1011,483,528,91.5,998,478,520,91.9
31110, 과천시,055002, 51세,2017,1011,516,495,104.2,1003,513,490,104.7
31110, 과천시,055003, 52세,2017,1009,491,518,94.8,1003,489,514,95.1
31110, 과천시,055004, 53세,2017,931,456,475,96,927,456,471,96.8
31110, 과천시,055005, 54세,2017,1027,532,495,107.5,1021,529,492,107.5
31110, 과천시,060,55~59세,2017,4632,2249,2383,94.4,4598,2236,2362,94.7
31110, 과천시,060001, 55세,2017,934,473,461,102.6,929,472,457,103.3
31110, 과천시,060002, 56세,2017,1039,499,540,92.4,1033,497,536,92.7
31110, 과천시,060003, 57세,2017,992,447,545,82,984,444,540,82.2
31110, 과천시,060004, 58세,2017,837,411,426,96.5,830,409,421,97.1
31110, 과천시,060005, 59세,2017,830,419,411,101.9,822,414,408,101.5
31110, 과천시,065,60~64세,2017,3356,1680,1676,100.2,3328,1669,1659,100.6
31110, 과천시,065001, 60세,2017,801,401,400,100.3,793,399,394,101.3
31110, 과천시,065002, 61세,2017,720,364,356,102.2,713,360,353,102
31110, 과천시,065003, 62세,2017,707,354,353,100.3,701,354,347,102
31110, 과천시,065004, 63세,2017,582,294,288,102.1,578,290,288,100.7
31110, 과천시,065005, 64세,2017,546,267,279,95.7,543,266,277,96
31110, 과천시,070,65~69세,2017,2120,1008,1112,90.6,2109,1003,1106,90.7
31110, 과천시,070001, 65세,2017,496,245,251,97.6,493,244,249,98
31110, 과천시,070002, 66세,2017,377,176,201,87.6,377,176,201,87.6
31110, 과천시,070003, 67세,2017,450,219,231,94.8,448,218,230,94.8
31110, 과천시,070004, 68세,2017,400,182,218,83.5,397,181,216,83.8
31110, 과천시,070005, 69세,2017,397,186,211,88.2,394,184,210,87.6
31110, 과천시,075,70~74세,2017,1709,746,963,77.5,1703,742,961,77.2
31110, 과천시,075001, 70세,2017,405,172,233,73.8,404,172,232,74.1
31110, 과천시,075002, 71세,2017,345,156,189,82.5,343,155,188,82.4
31110, 과천시,075003, 72세,2017,295,139,156,89.1,294,138,156,88.5
31110, 과천시,075004, 73세,2017,329,123,206,59.7,327,121,206,58.7
31110, 과천시,075005, 74세,2017,335,156,179,87.2,335,156,179,87.2
31110, 과천시,080,75~79세,2017,1458,598,860,69.5,1455,597,858,69.6
31110, 과천시,080001, 75세,2017,366,151,215,70.2,366,151,215,70.2
31110, 과천시,080002, 76세,2017,298,121,177,68.4,296,121,175,69.1
31110, 과천시,080003, 77세,2017,276,120,156,76.9,276,120,156,76.9
31110, 과천시,080004, 78세,2017,268,103,165,62.4,268,103,165,62.4
31110, 과천시,080005, 79세,2017,250,103,147,70.1,249,102,147,69.4
31110, 과천시,085,80~84세,2017,1024,368,656,56.1,1024,368,656,56.1
31110, 과천시,085001, 80세,2017,244,90,154,58.4,244,90,154,58.4
31110, 과천시,085002, 81세,2017,218,82,136,60.3,218,82,136,60.3
31110, 과천시,085003, 82세,2017,236,94,142,66.2,236,94,142,66.2
31110, 과천시,085004, 83세,2017,169,56,113,49.6,169,56,113,49.6
31110, 과천시,085005, 84세,2017,157,46,111,41.4,157,46,111,41.4
31110, 과천시,090,85~89세,2017,516,158,358,44.1,514,156,358,43.6
31110, 과천시,090001, 85세,2017,120,43,77,55.8,119,42,77,54.5
31110, 과천시,090002, 86세,2017,105,30,75,40,105,30,75,40
31110, 과천시,090003, 87세,2017,111,33,78,42.3,110,32,78,41
31110, 과천시,090004, 88세,2017,89,33,56,58.9,89,33,56,58.9
31110, 과천시,090005, 89세,2017,91,19,72,26.4,91,19,72,26.4
31110, 과천시,095,90~94세,2017,170,40,130,30.8,169,39,130,30
31110, 과천시,095001, 90세,2017,48,10,38,26.3,48,10,38,26.3
31110, 과천시,095002, 91세,2017,40,10,30,33.3,40,10,30,33.3
31110, 과천시,095003, 92세,2017,38,9,29,31,38,9,29,31
31110, 과천시,095004, 93세,2017,21,6,15,40,20,5,15,33.3
31110, 과천시,095005, 94세,2017,23,5,18,27.8,23,5,18,27.8
31110, 과천시,100,95~99세,2017,40,14,26,53.8,39,13,26,50
31110, 과천시,100001, 95세,2017,16,7,9,77.8,15,6,9,66.7
31110, 과천시,100002, 96세,2017,6,X,5,20,6,X,5,20
31110, 과천시,100003, 97세,2017,5,X,X,25,5,X,X,25
31110, 과천시,100004, 98세,2017,6,X,X,100,6,X,X,100
31110, 과천시,100005, 99세,2017,7,X,5,40,7,X,5,40
31110, 과천시,101,100세이상,2017,5,X,X,25,5,X,X,25
31110, 과천시,102,15세미만,2017,7157,3722,3435,108.4,7145,3716,3429,108.4
31110, 과천시,103,15~64세,2017,39384,19612,19772,99.2,39034,19446,19588,99.3
31110, 과천시,104,65세이상,2017,7042,2933,4109,71.4,7018,2919,4099,71.2
31110, 과천시,086,85세이상,2017,731,213,518,41.1,727,209,518,40.3
31110, 과천시,126,평균연령,2017,41.4,40.1,42.7,,41.4,40,42.7,
31110, 과천시,127,중위연령,2017,43.7,42.2,44.8,,43.7,42.2,44.8,
31120, 구리시,000,합계,2017,189741,93903,95838,98,188000,93112,94888,98.1
31120, 구리시,005,0~4세,2017,8019,4106,3913,104.9,8000,4095,3905,104.9
31120, 구리시,005001, 0세,2017,1327,673,654,102.9,1324,671,653,102.8
31120, 구리시,005002, 1세,2017,1565,778,787,98.9,1559,773,786,98.3
31120, 구리시,005003, 2세,2017,1664,848,816,103.9,1660,846,814,103.9
31120, 구리시,005004, 3세,2017,1745,911,834,109.2,1741,909,832,109.3
31120, 구리시,005005, 4세,2017,1718,896,822,109,1716,896,820,109.3
31120, 구리시,010,5~9세,2017,8665,4455,4210,105.8,8646,4446,4200,105.9
31120, 구리시,010001, 5세,2017,1829,939,890,105.5,1821,936,885,105.8
31120, 구리시,010002, 6세,2017,1758,889,869,102.3,1756,889,867,102.5
31120, 구리시,010003, 7세,2017,1664,865,799,108.3,1661,864,797,108.4
31120, 구리시,010004, 8세,2017,1661,869,792,109.7,1657,866,791,109.5
31120, 구리시,010005, 9세,2017,1753,893,860,103.8,1751,891,860,103.6
31120, 구리시,015,10~14세,2017,8894,4650,4244,109.6,8881,4642,4239,109.5
31120, 구리시,015001, 10세,2017,1757,923,834,110.7,1754,922,832,110.8
31120, 구리시,015002, 11세,2017,1774,970,804,120.6,1772,969,803,120.7
31120, 구리시,015003, 12세,2017,1633,887,746,118.9,1631,887,744,119.2
31120, 구리시,015004, 13세,2017,1858,937,921,101.7,1855,934,921,101.4
31120, 구리시,015005, 14세,2017,1872,933,939,99.4,1869,930,939,99
31120, 구리시,020,15~19세,2017,11051,5658,5393,104.9,11038,5649,5389,104.8
31120, 구리시,020001, 15세,2017,1959,1009,950,106.2,1957,1008,949,106.2
31120, 구리시,020002, 16세,2017,2202,1125,1077,104.5,2198,1122,1076,104.3
31120, 구리시,020003, 17세,2017,2438,1274,1164,109.5,2438,1274,1164,109.5
31120, 구리시,020004, 18세,2017,2270,1134,1136,99.8,2267,1132,1135,99.7
31120, 구리시,020005, 19세,2017,2182,1116,1066,104.7,2178,1113,1065,104.5
31120, 구리시,025,20~24세,2017,12983,6838,6145,111.3,12837,6763,6074,111.3
31120, 구리시,025001, 20세,2017,2382,1296,1086,119.3,2375,1295,1080,119.9
31120, 구리시,025002, 21세,2017,2548,1398,1150,121.6,2527,1388,1139,121.9
31120, 구리시,025003, 22세,2017,2611,1389,1222,113.7,2573,1369,1204,113.7
31120, 구리시,025004, 23세,2017,2707,1384,1323,104.6,2683,1371,1312,104.5
31120, 구리시,025005, 24세,2017,2735,1371,1364,100.5,2679,1340,1339,100.1
31120, 구리시,030,25~29세,2017,12387,6233,6154,101.3,12118,6103,6015,101.5
31120, 구리시,030001, 25세,2017,2810,1418,1392,101.9,2754,1397,1357,102.9
31120, 구리시,030002, 26세,2017,2556,1254,1302,96.3,2504,1223,1281,95.5
31120, 구리시,030003, 27세,2017,2480,1236,1244,99.4,2435,1212,1223,99.1
31120, 구리시,030004, 28세,2017,2312,1166,1146,101.7,2261,1143,1118,102.2
31120, 구리시,030005, 29세,2017,2229,1159,1070,108.3,2164,1128,1036,108.9
31120, 구리시,035,30~34세,2017,12150,6042,6108,98.9,11935,5931,6004,98.8
31120, 구리시,035001, 30세,2017,2263,1131,1132,99.9,2218,1103,1115,98.9
31120, 구리시,035002, 31세,2017,2222,1093,1129,96.8,2187,1081,1106,97.7
31120, 구리시,035003, 32세,2017,2396,1178,1218,96.7,2357,1160,1197,96.9
31120, 구리시,035004, 33세,2017,2436,1206,1230,98,2392,1182,1210,97.7
31120, 구리시,035005, 34세,2017,2833,1434,1399,102.5,2781,1405,1376,102.1
31120, 구리시,040,35~39세,2017,15396,7724,7672,100.7,15217,7636,7581,100.7
31120, 구리시,040001, 35세,2017,3134,1550,1584,97.9,3091,1527,1564,97.6
31120, 구리시,040002, 36세,2017,3186,1614,1572,102.7,3143,1596,1547,103.2
31120, 구리시,040003, 37세,2017,3235,1619,1616,100.2,3199,1598,1601,99.8
31120, 구리시,040004, 38세,2017,3061,1546,1515,102,3030,1532,1498,102.3
31120, 구리시,040005, 39세,2017,2780,1395,1385,100.7,2754,1383,1371,100.9
31120, 구리시,045,40~44세,2017,15650,7723,7927,97.4,15491,7660,7831,97.8
31120, 구리시,045001, 40세,2017,2925,1503,1422,105.7,2891,1490,1401,106.4
31120, 구리시,045002, 41세,2017,2909,1445,1464,98.7,2875,1431,1444,99.1
31120, 구리시,045003, 42세,2017,3093,1474,1619,91,3058,1465,1593,92
31120, 구리시,045004, 43세,2017,3322,1637,1685,97.2,3298,1625,1673,97.1
31120, 구리시,045005, 44세,2017,3401,1664,1737,95.8,3369,1649,1720,95.9
31120, 구리시,050,45~49세,2017,18447,8862,9585,92.5,18260,8779,9481,92.6
31120, 구리시,050001, 45세,2017,3532,1774,1758,100.9,3495,1754,1741,100.7
31120, 구리시,050002, 46세,2017,3747,1746,2001,87.3,3708,1733,1975,87.7
31120, 구리시,050003, 47세,2017,3632,1800,1832,98.3,3592,1780,1812,98.2
31120, 구리시,050004, 48세,2017,3745,1779,1966,90.5,3715,1768,1947,90.8
31120, 구리시,050005, 49세,2017,3791,1763,2028,86.9,3750,1744,2006,86.9
31120, 구리시,055,50~54세,2017,16885,8373,8512,98.4,16714,8310,8404,98.9
31120, 구리시,055001, 50세,2017,3334,1586,1748,90.7,3304,1577,1727,91.3
31120, 구리시,055002, 51세,2017,3451,1677,1774,94.5,3419,1666,1753,95
31120, 구리시,055003, 52세,2017,3461,1752,1709,102.5,3426,1733,1693,102.4
31120, 구리시,055004, 53세,2017,3248,1594,1654,96.4,3214,1580,1634,96.7
31120, 구리시,055005, 54세,2017,3391,1764,1627,108.4,3351,1754,1597,109.8
31120, 구리시,060,55~59세,2017,16539,8331,8208,101.5,16393,8274,8119,101.9
31120, 구리시,060001, 55세,2017,3564,1849,1715,107.8,3527,1838,1689,108.8
31120, 구리시,060002, 56세,2017,3610,1768,1842,96,3588,1754,1834,95.6
31120, 구리시,060003, 57세,2017,3465,1678,1787,93.9,3438,1671,1767,94.6
31120, 구리시,060004, 58세,2017,3043,1592,1451,109.7,3014,1582,1432,110.5
31120, 구리시,060005, 59세,2017,2857,1444,1413,102.2,2826,1429,1397,102.3
31120, 구리시,065,60~64세,2017,11223,5596,5627,99.4,11113,5551,5562,99.8
31120, 구리시,065001, 60세,2017,2701,1350,1351,99.9,2664,1331,1333,99.8
31120, 구리시,065002, 61세,2017,2395,1211,1184,102.3,2377,1206,1171,103
31120, 구리시,065003, 62세,2017,2433,1205,1228,98.1,2415,1197,1218,98.3
31120, 구리시,065004, 63세,2017,1993,1014,979,103.6,1974,1012,962,105.2
31120, 구리시,065005, 64세,2017,1701,816,885,92.2,1683,805,878,91.7
31120, 구리시,070,65~69세,2017,7218,3505,3713,94.4,7159,3476,3683,94.4
31120, 구리시,070001, 65세,2017,1913,927,986,94,1888,917,971,94.4
31120, 구리시,070002, 66세,2017,1258,644,614,104.9,1247,638,609,104.8
31120, 구리시,070003, 67세,2017,1347,640,707,90.5,1335,633,702,90.2
31120, 구리시,070004, 68세,2017,1297,637,660,96.5,1289,632,657,96.2
31120, 구리시,070005, 69세,2017,1403,657,746,88.1,1400,656,744,88.2
31120, 구리시,075,70~74세,2017,5648,2540,3108,81.7,5631,2532,3099,81.7
31120, 구리시,075001, 70세,2017,1401,645,756,85.3,1394,642,752,85.4
31120, 구리시,075002, 71세,2017,1125,518,607,85.3,1123,517,606,85.3
31120, 구리시,075003, 72세,2017,1028,471,557,84.6,1024,469,555,84.5
31120, 구리시,075004, 73세,2017,1054,455,599,76,1051,454,597,76
31120, 구리시,075005, 74세,2017,1040,451,589,76.6,1039,450,589,76.4
31120, 구리시,080,75~79세,2017,4549,1960,2589,75.7,4539,1959,2580,75.9
31120, 구리시,080001, 75세,2017,1192,542,650,83.4,1190,541,649,83.4
31120, 구리시,080002, 76세,2017,966,429,537,79.9,962,429,533,80.5
31120, 구리시,080003, 77세,2017,843,340,503,67.6,842,340,502,67.7
31120, 구리시,080004, 78세,2017,838,351,487,72.1,836,351,485,72.4
31120, 구리시,080005, 79세,2017,710,298,412,72.3,709,298,411,72.5
31120, 구리시,085,80~84세,2017,2464,896,1568,57.1,2460,895,1565,57.2
31120, 구리시,085001, 80세,2017,619,248,371,66.8,619,248,371,66.8
31120, 구리시,085002, 81세,2017,526,194,332,58.4,526,194,332,58.4
31120, 구리시,085003, 82세,2017,511,170,341,49.9,511,170,341,49.9
31120, 구리시,085004, 83세,2017,443,154,289,53.3,440,153,287,53.3
31120, 구리시,085005, 84세,2017,365,130,235,55.3,364,130,234,55.6
31120, 구리시,090,85~89세,2017,1106,319,787,40.5,1102,319,783,40.7
31120, 구리시,090001, 85세,2017,300,92,208,44.2,299,92,207,44.4
31120, 구리시,090002, 86세,2017,238,77,161,47.8,238,77,161,47.8
31120, 구리시,090003, 87세,2017,253,74,179,41.3,251,74,177,41.8
31120, 구리시,090004, 88세,2017,170,48,122,39.3,170,48,122,39.3
31120, 구리시,090005, 89세,2017,145,28,117,23.9,144,28,116,24.1
31120, 구리시,095,90~94세,2017,369,72,297,24.2,368,72,296,24.3
31120, 구리시,095001, 90세,2017,114,20,94,21.3,114,20,94,21.3
31120, 구리시,095002, 91세,2017,88,16,72,22.2,88,16,72,22.2
31120, 구리시,095003, 92세,2017,73,19,54,35.2,73,19,54,35.2
31120, 구리시,095004, 93세,2017,60,14,46,30.4,60,14,46,30.4
31120, 구리시,095005, 94세,2017,34,X,31,9.7,33,X,30,10
31120, 구리시,100,95~99세,2017,85,18,67,26.9,85,18,67,26.9
31120, 구리시,100001, 95세,2017,28,6,22,27.3,28,6,22,27.3
31120, 구리시,100002, 96세,2017,18,X,14,28.6,18,X,14,28.6
31120, 구리시,100003, 97세,2017,20,5,15,33.3,20,5,15,33.3
31120, 구리시,100004, 98세,2017,14,X,11,27.3,14,X,11,27.3
31120, 구리시,100005, 99세,2017,5,X,5,0,5,X,5,0
31120, 구리시,101,100세이상,2017,13,X,11,18.2,13,X,11,18.2
31120, 구리시,102,15세미만,2017,25578,13211,12367,106.8,25527,13183,12344,106.8
31120, 구리시,103,15~64세,2017,142711,71380,71331,100.1,141116,70656,70460,100.3
31120, 구리시,104,65세이상,2017,21452,9312,12140,76.7,21357,9273,12084,76.7
31120, 구리시,086,85세이상,2017,1573,411,1162,35.4,1568,411,1157,35.5
31120, 구리시,126,평균연령,2017,40.4,39.5,41.2,,40.4,39.5,41.2,
31120, 구리시,127,중위연령,2017,41.8,40.8,42.7,,41.8,40.9,42.7,
31130, 남양주시,000,합계,2017,644936,322289,322647,99.9,636400,317098,319302,99.3
31130, 남양주시,005,0~4세,2017,29803,15285,14518,105.3,29741,15252,14489,105.3
31130, 남양주시,005001, 0세,2017,4656,2356,2300,102.4,4640,2348,2292,102.4
31130, 남양주시,005002, 1세,2017,5670,2940,2730,107.7,5655,2930,2725,107.5
31130, 남양주시,005003, 2세,2017,6294,3168,3126,101.3,6281,3159,3122,101.2
31130, 남양주시,005004, 3세,2017,6366,3312,3054,108.4,6355,3308,3047,108.6
31130, 남양주시,005005, 4세,2017,6817,3509,3308,106.1,6810,3507,3303,106.2
31130, 남양주시,010,5~9세,2017,37337,19213,18124,106,37291,19190,18101,106
31130, 남양주시,010001, 5세,2017,7585,3879,3706,104.7,7572,3872,3700,104.6
31130, 남양주시,010002, 6세,2017,7679,3941,3738,105.4,7670,3936,3734,105.4
31130, 남양주시,010003, 7세,2017,7296,3797,3499,108.5,7289,3794,3495,108.6
31130, 남양주시,010004, 8세,2017,7234,3694,3540,104.4,7224,3688,3536,104.3
31130, 남양주시,010005, 9세,2017,7543,3902,3641,107.2,7536,3900,3636,107.3
31130, 남양주시,015,10~14세,2017,35143,18077,17066,105.9,35107,18059,17048,105.9
31130, 남양주시,015001, 10세,2017,7649,3952,3697,106.9,7644,3950,3694,106.9
31130, 남양주시,015002, 11세,2017,6834,3501,3333,105,6823,3494,3329,105
31130, 남양주시,015003, 12세,2017,6599,3397,3202,106.1,6592,3395,3197,106.2
31130, 남양주시,015004, 13세,2017,7147,3676,3471,105.9,7137,3670,3467,105.9
31130, 남양주시,015005, 14세,2017,6914,3551,3363,105.6,6911,3550,3361,105.6
31130, 남양주시,020,15~19세,2017,37539,19395,18144,106.9,37430,19331,18099,106.8
31130, 남양주시,020001, 15세,2017,6965,3619,3346,108.2,6959,3616,3343,108.2
31130, 남양주시,020002, 16세,2017,7708,3944,3764,104.8,7700,3938,3762,104.7
31130, 남양주시,020003, 17세,2017,8025,4193,3832,109.4,8015,4186,3829,109.3
31130, 남양주시,020004, 18세,2017,7695,3897,3798,102.6,7671,3882,3789,102.5
31130, 남양주시,020005, 19세,2017,7146,3742,3404,109.9,7085,3709,3376,109.9
31130, 남양주시,025,20~24세,2017,38484,20516,17968,114.2,37631,19963,17668,113
31130, 남양주시,025001, 20세,2017,7621,4107,3514,116.9,7536,4060,3476,116.8
31130, 남양주시,025002, 21세,2017,7729,4260,3469,122.8,7629,4201,3428,122.5
31130, 남양주시,025003, 22세,2017,7800,4217,3583,117.7,7636,4108,3528,116.4
31130, 남양주시,025004, 23세,2017,7628,3980,3648,109.1,7397,3832,3565,107.5
31130, 남양주시,025005, 24세,2017,7706,3952,3754,105.3,7433,3762,3671,102.5
31130, 남양주시,030,25~29세,2017,34806,18284,16522,110.7,32960,16967,15993,106.1
31130, 남양주시,030001, 25세,2017,7743,4078,3665,111.3,7402,3828,3574,107.1
31130, 남양주시,030002, 26세,2017,7300,3784,3516,107.6,6918,3513,3405,103.2
31130, 남양주시,030003, 27세,2017,6802,3619,3183,113.7,6441,3376,3065,110.1
31130, 남양주시,030004, 28세,2017,6562,3428,3134,109.4,6184,3160,3024,104.5
31130, 남양주시,030005, 29세,2017,6399,3375,3024,111.6,6015,3090,2925,105.6
31130, 남양주시,035,30~34세,2017,36964,18427,18537,99.4,35418,17414,18004,96.7
31130, 남양주시,035001, 30세,2017,6269,3202,3067,104.4,5931,2964,2967,99.9
31130, 남양주시,035002, 31세,2017,6761,3384,3377,100.2,6450,3200,3250,98.5
31130, 남양주시,035003, 32세,2017,7193,3584,3609,99.3,6874,3365,3509,95.9
31130, 남양주시,035004, 33세,2017,7825,3818,4007,95.3,7515,3611,3904,92.5
31130, 남양주시,035005, 34세,2017,8916,4439,4477,99.2,8648,4274,4374,97.7
31130, 남양주시,040,35~39세,2017,54990,26841,28149,95.4,53913,26149,27764,94.2
31130, 남양주시,040001, 35세,2017,10267,4940,5327,92.7,10006,4768,5238,91
31130, 남양주시,040002, 36세,2017,10904,5332,5572,95.7,10686,5190,5496,94.4
31130, 남양주시,040003, 37세,2017,11711,5703,6008,94.9,11492,5564,5928,93.9
31130, 남양주시,040004, 38세,2017,11475,5634,5841,96.5,11261,5492,5769,95.2
31130, 남양주시,040005, 39세,2017,10633,5232,5401,96.9,10468,5135,5333,96.3
31130, 남양주시,045,40~44세,2017,58897,29656,29241,101.4,58190,29248,28942,101.1
31130, 남양주시,045001, 40세,2017,10982,5455,5527,98.7,10846,5373,5473,98.2
31130, 남양주시,045002, 41세,2017,10962,5462,5500,99.3,10800,5368,5432,98.8
31130, 남양주시,045003, 42세,2017,11804,5946,5858,101.5,11670,5865,5805,101
31130, 남양주시,045004, 43세,2017,12555,6362,6193,102.7,12415,6288,6127,102.6
31130, 남양주시,045005, 44세,2017,12594,6431,6163,104.3,12459,6354,6105,104.1
31130, 남양주시,050,45~49세,2017,61672,31497,30175,104.4,61027,31138,29889,104.2
31130, 남양주시,050001, 45세,2017,12695,6576,6119,107.5,12573,6507,6066,107.3
31130, 남양주시,050002, 46세,2017,13044,6653,6391,104.1,12903,6579,6324,104
31130, 남양주시,050003, 47세,2017,12257,6362,5895,107.9,12110,6279,5831,107.7
31130, 남양주시,050004, 48세,2017,12044,6099,5945,102.6,11919,6026,5893,102.3
31130, 남양주시,050005, 49세,2017,11632,5807,5825,99.7,11522,5747,5775,99.5
31130, 남양주시,055,50~54세,2017,51864,26676,25188,105.9,51320,26418,24902,106.1
31130, 남양주시,055001, 50세,2017,10729,5408,5321,101.6,10615,5347,5268,101.5
31130, 남양주시,055002, 51세,2017,10489,5511,4978,110.7,10389,5457,4932,110.6
31130, 남양주시,055003, 52세,2017,10410,5296,5114,103.6,10294,5250,5044,104.1
31130, 남양주시,055004, 53세,2017,10072,5218,4854,107.5,9969,5174,4795,107.9
31130, 남양주시,055005, 54세,2017,10164,5243,4921,106.5,10053,5190,4863,106.7
31130, 남양주시,060,55~59세,2017,49433,24992,24441,102.3,49019,24825,24194,102.6
31130, 남양주시,060001, 55세,2017,10074,5243,4831,108.5,9970,5199,4771,109
31130, 남양주시,060002, 56세,2017,10487,5267,5220,100.9,10401,5238,5163,101.5
31130, 남양주시,060003, 57세,2017,10518,5325,5193,102.5,10443,5290,5153,102.7
31130, 남양주시,060004, 58세,2017,9340,4657,4683,99.4,9269,4632,4637,99.9
31130, 남양주시,060005, 59세,2017,9014,4500,4514,99.7,8936,4466,4470,99.9
31130, 남양주시,065,60~64세,2017,37460,18266,19194,95.2,37123,18108,19015,95.2
31130, 남양주시,065001, 60세,2017,8658,4247,4411,96.3,8570,4207,4363,96.4
31130, 남양주시,065002, 61세,2017,7954,3945,4009,98.4,7875,3901,3974,98.2
31130, 남양주시,065003, 62세,2017,8071,3860,4211,91.7,8013,3833,4180,91.7
31130, 남양주시,065004, 63세,2017,6965,3389,3576,94.8,6903,3364,3539,95.1
31130, 남양주시,065005, 64세,2017,5812,2825,2987,94.6,5762,2803,2959,94.7
31130, 남양주시,070,65~69세,2017,26445,12536,13909,90.1,26263,12458,13805,90.2
31130, 남양주시,070001, 65세,2017,6659,3180,3479,91.4,6612,3161,3451,91.6
31130, 남양주시,070002, 66세,2017,4465,2113,2352,89.8,4433,2098,2335,89.9
31130, 남양주시,070003, 67세,2017,5059,2350,2709,86.7,5009,2332,2677,87.1
31130, 남양주시,070004, 68세,2017,5119,2442,2677,91.2,5090,2428,2662,91.2
31130, 남양주시,070005, 69세,2017,5143,2451,2692,91,5119,2439,2680,91
31130, 남양주시,075,70~74세,2017,20900,9702,11198,86.6,20840,9677,11163,86.7
31130, 남양주시,075001, 70세,2017,5119,2454,2665,92.1,5109,2450,2659,92.1
31130, 남양주시,075002, 71세,2017,4072,1878,2194,85.6,4059,1872,2187,85.6
31130, 남양주시,075003, 72세,2017,3963,1875,2088,89.8,3952,1870,2082,89.8
31130, 남양주시,075004, 73세,2017,3862,1765,2097,84.2,3846,1757,2089,84.1
31130, 남양주시,075005, 74세,2017,3884,1730,2154,80.3,3874,1728,2146,80.5
31130, 남양주시,080,75~79세,2017,17067,7494,9573,78.3,17029,7477,9552,78.3
31130, 남양주시,080001, 75세,2017,4468,2028,2440,83.1,4459,2022,2437,83
31130, 남양주시,080002, 76세,2017,3543,1589,1954,81.3,3533,1583,1950,81.2
31130, 남양주시,080003, 77세,2017,3240,1430,1810,79,3229,1427,1802,79.2
31130, 남양주시,080004, 78세,2017,3211,1352,1859,72.7,3208,1350,1858,72.7
31130, 남양주시,080005, 79세,2017,2605,1095,1510,72.5,2600,1095,1505,72.8
31130, 남양주시,085,80~84세,2017,9762,3700,6062,61,9739,3693,6046,61.1
31130, 남양주시,085001, 80세,2017,2436,1003,1433,70,2428,1001,1427,70.1
31130, 남양주시,085002, 81세,2017,2226,850,1376,61.8,2223,848,1375,61.7
31130, 남양주시,085003, 82세,2017,2047,786,1261,62.3,2044,785,1259,62.4
31130, 남양주시,085004, 83세,2017,1666,603,1063,56.7,1661,601,1060,56.7
31130, 남양주시,085005, 84세,2017,1387,458,929,49.3,1383,458,925,49.5
31130, 남양주시,090,85~89세,2017,4448,1300,3148,41.3,4441,1299,3142,41.3
31130, 남양주시,090001, 85세,2017,1235,414,821,50.4,1234,414,820,50.5
31130, 남양주시,090002, 86세,2017,943,287,656,43.8,939,287,652,44
31130, 남양주시,090003, 87세,2017,904,230,674,34.1,903,230,673,34.2
31130, 남양주시,090004, 88세,2017,775,225,550,40.9,775,225,550,40.9
31130, 남양주시,090005, 89세,2017,591,144,447,32.2,590,143,447,32
31130, 남양주시,095,90~94세,2017,1457,311,1146,27.1,1453,311,1142,27.2
31130, 남양주시,095001, 90세,2017,438,85,353,24.1,437,85,352,24.1
31130, 남양주시,095002, 91세,2017,367,72,295,24.4,367,72,295,24.4
31130, 남양주시,095003, 92세,2017,289,58,231,25.1,286,58,228,25.4
31130, 남양주시,095004, 93세,2017,174,47,127,37,174,47,127,37
31130, 남양주시,095005, 94세,2017,189,49,140,35,189,49,140,35
31130, 남양주시,100,95~99세,2017,409,114,295,38.6,409,114,295,38.6
31130, 남양주시,100001, 95세,2017,164,45,119,37.8,164,45,119,37.8
31130, 남양주시,100002, 96세,2017,105,31,74,41.9,105,31,74,41.9
31130, 남양주시,100003, 97세,2017,58,15,43,34.9,58,15,43,34.9
31130, 남양주시,100004, 98세,2017,50,15,35,42.9,50,15,35,42.9
31130, 남양주시,100005, 99세,2017,32,8,24,33.3,32,8,24,33.3
31130, 남양주시,101,100세이상,2017,56,7,49,14.3,56,7,49,14.3
31130, 남양주시,102,15세미만,2017,102283,52575,49708,105.8,102139,52501,49638,105.8
31130, 남양주시,103,15~64세,2017,462109,234550,227559,103.1,454031,229561,224470,102.3
31130, 남양주시,104,65세이상,2017,80544,35164,45380,77.5,80230,35036,45194,77.5
31130, 남양주시,086,85세이상,2017,6370,1732,4638,37.3,6359,1731,4628,37.4
31130, 남양주시,126,평균연령,2017,40.1,39.2,41,,40.1,39.3,41,
31130, 남양주시,127,중위연령,2017,41.6,40.9,42.2,,41.7,41.2,42.3,
31140, 오산시,000,합계,2017,219877,112936,106941,105.6,208005,106748,101257,105.4
31140, 오산시,005,0~4세,2017,12690,6511,6179,105.4,12267,6280,5987,104.9
31140, 오산시,005001, 0세,2017,2106,1119,987,113.4,1995,1052,943,111.6
31140, 오산시,005002, 1세,2017,2464,1229,1235,99.5,2367,1177,1190,98.9
31140, 오산시,005003, 2세,2017,2601,1325,1276,103.8,2517,1281,1236,103.6
31140, 오산시,005004, 3세,2017,2743,1388,1355,102.4,2658,1346,1312,102.6
31140, 오산시,005005, 4세,2017,2776,1450,1326,109.4,2730,1424,1306,109
31140, 오산시,010,5~9세,2017,14316,7418,6898,107.5,14148,7330,6818,107.5
31140, 오산시,010001, 5세,2017,3098,1590,1508,105.4,3047,1561,1486,105
31140, 오산시,010002, 6세,2017,2943,1525,1418,107.5,2912,1508,1404,107.4
31140, 오산시,010003, 7세,2017,2829,1438,1391,103.4,2796,1425,1371,103.9
31140, 오산시,010004, 8세,2017,2667,1386,1281,108.2,2641,1374,1267,108.4
31140, 오산시,010005, 9세,2017,2779,1479,1300,113.8,2752,1462,1290,113.3
31140, 오산시,015,10~14세,2017,11911,6123,5788,105.8,11862,6092,5770,105.6
31140, 오산시,015001, 10세,2017,2735,1416,1319,107.4,2724,1407,1317,106.8
31140, 오산시,015002, 11세,2017,2346,1186,1160,102.2,2331,1178,1153,102.2
31140, 오산시,015003, 12세,2017,2242,1164,1078,108,2233,1156,1077,107.3
31140, 오산시,015004, 13세,2017,2300,1176,1124,104.6,2292,1173,1119,104.8
31140, 오산시,015005, 14세,2017,2288,1181,1107,106.7,2282,1178,1104,106.7
31140, 오산시,020,15~19세,2017,12221,6221,6000,103.7,12101,6160,5941,103.7
31140, 오산시,020001, 15세,2017,2216,1102,1114,98.9,2206,1097,1109,98.9
31140, 오산시,020002, 16세,2017,2499,1273,1226,103.8,2480,1261,1219,103.4
31140, 오산시,020003, 17세,2017,2631,1353,1278,105.9,2617,1348,1269,106.2
31140, 오산시,020004, 18세,2017,2489,1281,1208,106,2462,1266,1196,105.9
31140, 오산시,020005, 19세,2017,2386,1212,1174,103.2,2336,1188,1148,103.5
31140, 오산시,025,20~24세,2017,13122,6923,6199,111.7,12675,6689,5986,111.7
31140, 오산시,025001, 20세,2017,2565,1330,1235,107.7,2500,1304,1196,109
31140, 오산시,025002, 21세,2017,2528,1352,1176,115,2459,1314,1145,114.8
31140, 오산시,025003, 22세,2017,2672,1387,1285,107.9,2587,1335,1252,106.6
31140, 오산시,025004, 23세,2017,2612,1414,1198,118,2507,1365,1142,119.5
31140, 오산시,025005, 24세,2017,2745,1440,1305,110.3,2622,1371,1251,109.6
31140, 오산시,030,25~29세,2017,15005,8065,6940,116.2,13599,7324,6275,116.7
31140, 오산시,030001, 25세,2017,3043,1610,1433,112.4,2871,1530,1341,114.1
31140, 오산시,030002, 26세,2017,2951,1580,1371,115.2,2706,1447,1259,114.9
31140, 오산시,030003, 27세,2017,2921,1571,1350,116.4,2637,1424,1213,117.4
31140, 오산시,030004, 28세,2017,2951,1627,1324,122.9,2626,1457,1169,124.6
31140, 오산시,030005, 29세,2017,3139,1677,1462,114.7,2759,1466,1293,113.4
31140, 오산시,035,30~34세,2017,18648,9714,8934,108.7,16775,8744,8031,108.9
31140, 오산시,035001, 30세,2017,3275,1685,1590,106,2864,1480,1384,106.9
31140, 오산시,035002, 31세,2017,3412,1784,1628,109.6,3036,1607,1429,112.5
31140, 오산시,035003, 32세,2017,3684,1923,1761,109.2,3301,1714,1587,108
31140, 오산시,035004, 33세,2017,3875,2028,1847,109.8,3498,1818,1680,108.2
31140, 오산시,035005, 34세,2017,4402,2294,2108,108.8,4076,2125,1951,108.9
31140, 오산시,040,35~39세,2017,24110,12694,11416,111.2,22653,11870,10783,110.1
31140, 오산시,040001, 35세,2017,5049,2703,2346,115.2,4682,2476,2206,112.2
31140, 오산시,040002, 36세,2017,4928,2610,2318,112.6,4648,2458,2190,112.2
31140, 오산시,040003, 37세,2017,5099,2611,2488,104.9,4808,2454,2354,104.2
31140, 오산시,040004, 38세,2017,4730,2485,2245,110.7,4435,2321,2114,109.8
31140, 오산시,040005, 39세,2017,4304,2285,2019,113.2,4080,2161,1919,112.6
31140, 오산시,045,40~44세,2017,21375,11366,10009,113.6,20307,10779,9528,113.1
31140, 오산시,045001, 40세,2017,4338,2319,2019,114.9,4113,2187,1926,113.6
31140, 오산시,045002, 41세,2017,4133,2218,1915,115.8,3940,2110,1830,115.3
31140, 오산시,045003, 42세,2017,4245,2282,1963,116.3,4051,2171,1880,115.5
31140, 오산시,045004, 43세,2017,4418,2344,2074,113,4209,2233,1976,113
31140, 오산시,045005, 44세,2017,4241,2203,2038,108.1,3994,2078,1916,108.5
31140, 오산시,050,45~49세,2017,19804,10386,9418,110.3,18516,9704,8812,110.1
31140, 오산시,050001, 45세,2017,4075,2162,1913,113,3824,2015,1809,111.4
31140, 오산시,050002, 46세,2017,4092,2113,1979,106.8,3841,1999,1842,108.5
31140, 오산시,050003, 47세,2017,3849,2052,1797,114.2,3595,1916,1679,114.1
31140, 오산시,050004, 48세,2017,3915,2075,1840,112.8,3632,1918,1714,111.9
31140, 오산시,050005, 49세,2017,3873,1984,1889,105,3624,1856,1768,105
31140, 오산시,055,50~54세,2017,15570,8128,7442,109.2,14350,7489,6861,109.2
31140, 오산시,055001, 50세,2017,3311,1667,1644,101.4,3093,1553,1540,100.8
31140, 오산시,055002, 51세,2017,3161,1660,1501,110.6,2917,1541,1376,112
31140, 오산시,055003, 52세,2017,3252,1719,1533,112.1,3016,1592,1424,111.8
31140, 오산시,055004, 53세,2017,2940,1557,1383,112.6,2698,1423,1275,111.6
31140, 오산시,055005, 54세,2017,2906,1525,1381,110.4,2626,1380,1246,110.8
31140, 오산시,060,55~59세,2017,14007,7122,6885,103.4,13048,6664,6384,104.4
31140, 오산시,060001, 55세,2017,2960,1524,1436,106.1,2722,1409,1313,107.3
31140, 오산시,060002, 56세,2017,3124,1590,1534,103.7,2989,1530,1459,104.9
31140, 오산시,060003, 57세,2017,2990,1530,1460,104.8,2766,1418,1348,105.2
31140, 오산시,060004, 58세,2017,2534,1281,1253,102.2,2364,1208,1156,104.5
31140, 오산시,060005, 59세,2017,2399,1197,1202,99.6,2207,1099,1108,99.2
31140, 오산시,065,60~64세,2017,9404,4664,4740,98.4,8549,4252,4297,99
31140, 오산시,065001, 60세,2017,2209,1103,1106,99.7,1985,995,990,100.5
31140, 오산시,065002, 61세,2017,2073,1017,1056,96.3,1885,925,960,96.4
31140, 오산시,065003, 62세,2017,2051,1022,1029,99.3,1884,942,942,100
31140, 오산시,065004, 63세,2017,1685,837,848,98.7,1532,769,763,100.8
31140, 오산시,065005, 64세,2017,1386,685,701,97.7,1263,621,642,96.7
31140, 오산시,070,65~69세,2017,6097,2961,3136,94.4,5744,2791,2953,94.5
31140, 오산시,070001, 65세,2017,1628,819,809,101.2,1514,761,753,101.1
31140, 오산시,070002, 66세,2017,1098,527,571,92.3,1012,482,530,90.9
31140, 오산시,070003, 67세,2017,1124,546,578,94.5,1055,514,541,95
31140, 오산시,070004, 68세,2017,1124,535,589,90.8,1074,511,563,90.8
31140, 오산시,070005, 69세,2017,1123,534,589,90.7,1089,523,566,92.4
31140, 오산시,075,70~74세,2017,4496,1985,2511,79.1,4397,1949,2448,79.6
31140, 오산시,075001, 70세,2017,1099,523,576,90.8,1069,510,559,91.2
31140, 오산시,075002, 71세,2017,874,404,470,86,853,397,456,87.1
31140, 오산시,075003, 72세,2017,837,363,474,76.6,821,359,462,77.7
31140, 오산시,075004, 73세,2017,856,359,497,72.2,834,348,486,71.6
31140, 오산시,075005, 74세,2017,830,336,494,68,820,335,485,69.1
31140, 오산시,080,75~79세,2017,3756,1551,2205,70.3,3709,1535,2174,70.6
31140, 오산시,080001, 75세,2017,978,421,557,75.6,959,415,544,76.3
31140, 오산시,080002, 76세,2017,764,318,446,71.3,759,317,442,71.7
31140, 오산시,080003, 77세,2017,692,279,413,67.6,679,273,406,67.2
31140, 오산시,080004, 78세,2017,678,275,403,68.2,670,273,397,68.8
31140, 오산시,080005, 79세,2017,644,258,386,66.8,642,257,385,66.8
31140, 오산시,085,80~84세,2017,2138,815,1323,61.6,2107,808,1299,62.2
31140, 오산시,085001, 80세,2017,502,186,316,58.9,494,184,310,59.4
31140, 오산시,085002, 81세,2017,534,208,326,63.8,525,208,317,65.6
31140, 오산시,085003, 82세,2017,458,169,289,58.5,452,167,285,58.6
31140, 오산시,085004, 83세,2017,371,154,217,71,366,152,214,71
31140, 오산시,085005, 84세,2017,273,98,175,56,270,97,173,56.1
31140, 오산시,090,85~89세,2017,826,216,610,35.4,818,215,603,35.7
31140, 오산시,090001, 85세,2017,232,69,163,42.3,229,68,161,42.2
31140, 오산시,090002, 86세,2017,180,50,130,38.5,178,50,128,39.1
31140, 오산시,090003, 87세,2017,186,37,149,24.8,184,37,147,25.2
31140, 오산시,090004, 88세,2017,115,32,83,38.6,115,32,83,38.6
31140, 오산시,090005, 89세,2017,113,28,85,32.9,112,28,84,33.3
31140, 오산시,095,90~94세,2017,302,53,249,21.3,302,53,249,21.3
31140, 오산시,095001, 90세,2017,101,15,86,17.4,101,15,86,17.4
31140, 오산시,095002, 91세,2017,62,11,51,21.6,62,11,51,21.6
31140, 오산시,095003, 92세,2017,62,15,47,31.9,62,15,47,31.9
31140, 오산시,095004, 93세,2017,40,6,34,17.6,40,6,34,17.6
31140, 오산시,095005, 94세,2017,37,6,31,19.4,37,6,31,19.4
31140, 오산시,100,95~99세,2017,69,19,50,38,68,19,49,38.8
31140, 오산시,100001, 95세,2017,28,8,20,40,27,8,19,42.1
31140, 오산시,100002, 96세,2017,15,X,11,36.4,15,X,11,36.4
31140, 오산시,100003, 97세,2017,13,X,11,18.2,13,X,11,18.2
31140, 오산시,100004, 98세,2017,7,X,X,133.3,7,X,X,133.3
31140, 오산시,100005, 99세,2017,6,X,5,20,6,X,5,20
31140, 오산시,101,100세이상,2017,10,X,9,11.1,10,X,9,11.1
31140, 오산시,102,15세미만,2017,38917,20052,18865,106.3,38277,19702,18575,106.1
31140, 오산시,103,15~64세,2017,163266,85283,77983,109.4,152573,79675,72898,109.3
31140, 오산시,104,65세이상,2017,17694,7601,10093,75.3,17155,7371,9784,75.3
31140, 오산시,086,85세이상,2017,1207,289,918,31.5,1198,288,910,31.6
31140, 오산시,126,평균연령,2017,36.8,36.2,37.4,,36.5,35.9,37.2,
31140, 오산시,127,중위연령,2017,37.4,37.1,37.8,,37.3,36.9,37.6,
31150, 시흥시,000,합계,2017,446369,237042,209327,113.2,404163,211863,192300,110.2
31150, 시흥시,005,0~4세,2017,19611,10042,9569,104.9,18234,9331,8903,104.8
31150, 시흥시,005001, 0세,2017,3372,1704,1668,102.2,3025,1524,1501,101.5
31150, 시흥시,005002, 1세,2017,3866,1945,1921,101.2,3557,1780,1777,100.2
31150, 시흥시,005003, 2세,2017,4233,2224,2009,110.7,3975,2089,1886,110.8
31150, 시흥시,005004, 3세,2017,3961,2022,1939,104.3,3716,1888,1828,103.3
31150, 시흥시,005005, 4세,2017,4179,2147,2032,105.7,3961,2050,1911,107.3
31150, 시흥시,010,5~9세,2017,21788,11290,10498,107.5,21203,10975,10228,107.3
31150, 시흥시,010001, 5세,2017,4468,2322,2146,108.2,4285,2222,2063,107.7
31150, 시흥시,010002, 6세,2017,4356,2273,2083,109.1,4226,2200,2026,108.6
31150, 시흥시,010003, 7세,2017,4270,2160,2110,102.4,4160,2106,2054,102.5
31150, 시흥시,010004, 8세,2017,4249,2221,2028,109.5,4167,2177,1990,109.4
31150, 시흥시,010005, 9세,2017,4445,2314,2131,108.6,4365,2270,2095,108.4
31150, 시흥시,015,10~14세,2017,21563,10948,10615,103.1,21337,10829,10508,103.1
31150, 시흥시,015001, 10세,2017,4461,2222,2239,99.2,4385,2175,2210,98.4
31150, 시흥시,015002, 11세,2017,4182,2094,2088,100.3,4133,2072,2061,100.5
31150, 시흥시,015003, 12세,2017,4091,2064,2027,101.8,4059,2045,2014,101.5
31150, 시흥시,015004, 13세,2017,4329,2255,2074,108.7,4295,2236,2059,108.6
31150, 시흥시,015005, 14세,2017,4500,2313,2187,105.8,4465,2301,2164,106.3
31150, 시흥시,020,15~19세,2017,26472,14001,12471,112.3,26145,13825,12320,112.2
31150, 시흥시,020001, 15세,2017,4567,2408,2159,111.5,4538,2392,2146,111.5
31150, 시흥시,020002, 16세,2017,5202,2727,2475,110.2,5154,2702,2452,110.2
31150, 시흥시,020003, 17세,2017,5701,3020,2681,112.6,5656,3003,2653,113.2
31150, 시흥시,020004, 18세,2017,5424,2859,2565,111.5,5355,2823,2532,111.5
31150, 시흥시,020005, 19세,2017,5578,2987,2591,115.3,5442,2905,2537,114.5
31150, 시흥시,025,20~24세,2017,31785,17832,13953,127.8,29543,16337,13206,123.7
31150, 시흥시,025001, 20세,2017,5766,3085,2681,115.1,5607,3013,2594,116.2
31150, 시흥시,025002, 21세,2017,6139,3428,2711,126.4,5857,3251,2606,124.8
31150, 시흥시,025003, 22세,2017,6421,3703,2718,136.2,6008,3416,2592,131.8
31150, 시흥시,025004, 23세,2017,6719,3776,2943,128.3,6102,3353,2749,122
31150, 시흥시,025005, 24세,2017,6740,3840,2900,132.4,5969,3304,2665,124
31150, 시흥시,030,25~29세,2017,32430,18511,13919,133,26099,14363,11736,122.4
31150, 시흥시,030001, 25세,2017,6902,3911,2991,130.8,5960,3271,2689,121.6
31150, 시흥시,030002, 26세,2017,6576,3753,2823,132.9,5482,3031,2451,123.7
31150, 시흥시,030003, 27세,2017,6486,3727,2759,135.1,5136,2844,2292,124.1
31150, 시흥시,030004, 28세,2017,6321,3670,2651,138.4,4871,2697,2174,124.1
31150, 시흥시,030005, 29세,2017,6145,3450,2695,128,4650,2520,2130,118.3
31150, 시흥시,035,30~34세,2017,33359,18784,14575,128.9,25654,13825,11829,116.9
31150, 시흥시,035001, 30세,2017,6291,3583,2708,132.3,4598,2513,2085,120.5
31150, 시흥시,035002, 31세,2017,6532,3627,2905,124.9,4819,2565,2254,113.8
31150, 시흥시,035003, 32세,2017,6496,3715,2781,133.6,4982,2709,2273,119.2
31150, 시흥시,035004, 33세,2017,6702,3766,2936,128.3,5265,2844,2421,117.5
31150, 시흥시,035005, 34세,2017,7338,4093,3245,126.1,5990,3194,2796,114.2
31150, 시흥시,040,35~39세,2017,40433,22407,18026,124.3,34951,18823,16128,116.7
31150, 시흥시,040001, 35세,2017,8131,4493,3638,123.5,6797,3670,3127,117.4
31150, 시흥시,040002, 36세,2017,8243,4596,3647,126,7086,3843,3243,118.5
31150, 시흥시,040003, 37세,2017,8430,4666,3764,124,7402,3996,3406,117.3
31150, 시흥시,040004, 38세,2017,8019,4455,3564,125,6982,3754,3228,116.3
31150, 시흥시,040005, 39세,2017,7610,4197,3413,123,6684,3560,3124,114
31150, 시흥시,045,40~44세,2017,40828,22346,18482,120.9,37056,19937,17119,116.5
31150, 시흥시,045001, 40세,2017,7665,4272,3393,125.9,6891,3763,3128,120.3
31150, 시흥시,045002, 41세,2017,7720,4301,3419,125.8,6899,3765,3134,120.1
31150, 시흥시,045003, 42세,2017,8028,4377,3651,119.9,7320,3921,3399,115.4
31150, 시흥시,045004, 43세,2017,8681,4726,3955,119.5,7992,4304,3688,116.7
31150, 시흥시,045005, 44세,2017,8734,4670,4064,114.9,7954,4184,3770,111
31150, 시흥시,050,45~49세,2017,46435,24280,22155,109.6,42283,21887,20396,107.3
31150, 시흥시,050001, 45세,2017,8845,4680,4165,112.4,7984,4171,3813,109.4
31150, 시흥시,050002, 46세,2017,9448,4932,4516,109.2,8556,4397,4159,105.7
31150, 시흥시,050003, 47세,2017,9199,4776,4423,108,8340,4286,4054,105.7
31150, 시흥시,050004, 48세,2017,9529,5001,4528,110.4,8770,4584,4186,109.5
31150, 시흥시,050005, 49세,2017,9414,4891,4523,108.1,8633,4449,4184,106.3
31150, 시흥시,055,50~54세,2017,41334,22073,19261,114.6,37736,20178,17558,114.9
31150, 시흥시,055001, 50세,2017,8711,4472,4239,105.5,8076,4149,3927,105.7
31150, 시흥시,055002, 51세,2017,8276,4499,3777,119.1,7607,4130,3477,118.8
31150, 시흥시,055003, 52세,2017,8563,4501,4062,110.8,7808,4102,3706,110.7
31150, 시흥시,055004, 53세,2017,7734,4173,3561,117.2,7040,3803,3237,117.5
31150, 시흥시,055005, 54세,2017,8050,4428,3622,122.3,7205,3994,3211,124.4
31150, 시흥시,060,55~59세,2017,34299,18834,15465,121.8,31896,17672,14224,124.2
31150, 시흥시,060001, 55세,2017,7816,4292,3524,121.8,7213,4007,3206,125
31150, 시흥시,060002, 56세,2017,7513,4110,3403,120.8,7164,3936,3228,121.9
31150, 시흥시,060003, 57세,2017,7254,4006,3248,123.3,6701,3737,2964,126.1
31150, 시흥시,060004, 58세,2017,6130,3425,2705,126.6,5705,3210,2495,128.7
31150, 시흥시,060005, 59세,2017,5586,3001,2585,116.1,5113,2782,2331,119.3
31150, 시흥시,065,60~64세,2017,20499,10804,9695,111.4,18032,9621,8411,114.4
31150, 시흥시,065001, 60세,2017,5236,2804,2432,115.3,4632,2521,2111,119.4
31150, 시흥시,065002, 61세,2017,4437,2305,2132,108.1,3903,2055,1848,111.2
31150, 시흥시,065003, 62세,2017,4329,2288,2041,112.1,3826,2039,1787,114.1
31150, 시흥시,065004, 63세,2017,3564,1874,1690,110.9,3101,1650,1451,113.7
31150, 시흥시,065005, 64세,2017,2933,1533,1400,109.5,2570,1356,1214,111.7
31150, 시흥시,070,65~69세,2017,11864,5964,5900,101.1,10901,5501,5400,101.9
31150, 시흥시,070001, 65세,2017,3099,1613,1486,108.5,2795,1449,1346,107.7
31150, 시흥시,070002, 66세,2017,2157,1043,1114,93.6,1909,935,974,96
31150, 시흥시,070003, 67세,2017,2278,1167,1111,105,2101,1080,1021,105.8
31150, 시흥시,070004, 68세,2017,2237,1121,1116,100.4,2093,1055,1038,101.6
31150, 시흥시,070005, 69세,2017,2093,1020,1073,95.1,2003,982,1021,96.2
31150, 시흥시,075,70~74세,2017,8407,3745,4662,80.3,8122,3648,4474,81.5
31150, 시흥시,075001, 70세,2017,2095,963,1132,85.1,2010,935,1075,87
31150, 시흥시,075002, 71세,2017,1596,699,897,77.9,1520,665,855,77.8
31150, 시흥시,075003, 72세,2017,1559,685,874,78.4,1504,671,833,80.6
31150, 시흥시,075004, 73세,2017,1543,697,846,82.4,1510,687,823,83.5
31150, 시흥시,075005, 74세,2017,1614,701,913,76.8,1578,690,888,77.7
31150, 시흥시,080,75~79세,2017,7590,2932,4658,62.9,7428,2892,4536,63.8
31150, 시흥시,080001, 75세,2017,1850,773,1077,71.8,1817,759,1058,71.7
31150, 시흥시,080002, 76세,2017,1567,617,950,64.9,1526,609,917,66.4
31150, 시흥시,080003, 77세,2017,1412,521,891,58.5,1380,514,866,59.4
31150, 시흥시,080004, 78세,2017,1420,516,904,57.1,1390,511,879,58.1
31150, 시흥시,080005, 79세,2017,1341,505,836,60.4,1315,499,816,61.2
31150, 시흥시,085,80~84세,2017,4550,1531,3019,50.7,4453,1507,2946,51.2
31150, 시흥시,085001, 80세,2017,1097,419,678,61.8,1080,414,666,62.2
31150, 시흥시,085002, 81세,2017,1038,350,688,50.9,1017,345,672,51.3
31150, 시흥시,085003, 82세,2017,918,302,616,49,898,296,602,49.2
31150, 시흥시,085004, 83세,2017,836,255,581,43.9,818,254,564,45
31150, 시흥시,085005, 84세,2017,661,205,456,45,640,198,442,44.8
31150, 시흥시,090,85~89세,2017,2140,517,1623,31.9,2115,513,1602,32
31150, 시흥시,090001, 85세,2017,607,155,452,34.3,602,154,448,34.4
31150, 시흥시,090002, 86세,2017,435,115,320,35.9,426,113,313,36.1
31150, 시흥시,090003, 87세,2017,421,92,329,28,416,91,325,28
31150, 시흥시,090004, 88세,2017,354,77,277,27.8,349,77,272,28.3
31150, 시흥시,090005, 89세,2017,323,78,245,31.8,322,78,244,32
31150, 시흥시,095,90~94세,2017,776,159,617,25.8,769,157,612,25.7
31150, 시흥시,095001, 90세,2017,261,49,212,23.1,258,48,210,22.9
31150, 시흥시,095002, 91세,2017,180,31,149,20.8,178,30,148,20.3
31150, 시흥시,095003, 92세,2017,142,36,106,34,141,36,105,34.3
31150, 시흥시,095004, 93세,2017,89,23,66,34.8,88,23,65,35.4
31150, 시흥시,095005, 94세,2017,104,20,84,23.8,104,20,84,23.8
31150, 시흥시,100,95~99세,2017,182,38,144,26.4,182,38,144,26.4
31150, 시흥시,100001, 95세,2017,78,20,58,34.5,78,20,58,34.5
31150, 시흥시,100002, 96세,2017,40,7,33,21.2,40,7,33,21.2
31150, 시흥시,100003, 97세,2017,33,5,28,17.9,33,5,28,17.9
31150, 시흥시,100004, 98세,2017,17,X,14,21.4,17,X,14,21.4
31150, 시흥시,100005, 99세,2017,14,X,11,27.3,14,X,11,27.3
31150, 시흥시,101,100세이상,2017,24,X,20,20,24,X,20,20
31150, 시흥시,102,15세미만,2017,62962,32280,30682,105.2,60774,31135,29639,105
31150, 시흥시,103,15~64세,2017,347874,189872,158002,120.2,309395,166468,142927,116.5
31150, 시흥시,104,65세이상,2017,35533,14890,20643,72.1,33994,14260,19734,72.3
31150, 시흥시,086,85세이상,2017,3122,718,2404,29.9,3090,712,2378,29.9
31150, 시흥시,126,평균연령,2017,38.4,37.8,39.2,,38.4,37.8,39,
31150, 시흥시,127,중위연령,2017,39.4,38.8,40.3,,39.8,39.3,40.4,
31160, 군포시,000,합계,2017,280913,139468,141445,98.6,271647,134613,137034,98.2
31160, 군포시,005,0~4세,2017,12863,6549,6314,103.7,12572,6395,6177,103.5
31160, 군포시,005001, 0세,2017,2295,1164,1131,102.9,2222,1127,1095,102.9
31160, 군포시,005002, 1세,2017,2675,1345,1330,101.1,2601,1307,1294,101
31160, 군포시,005003, 2세,2017,2630,1358,1272,106.8,2582,1334,1248,106.9
31160, 군포시,005004, 3세,2017,2632,1353,1279,105.8,2573,1322,1251,105.7
31160, 군포시,005005, 4세,2017,2631,1329,1302,102.1,2594,1305,1289,101.2
31160, 군포시,010,5~9세,2017,13546,6983,6563,106.4,13417,6921,6496,106.5
31160, 군포시,010001, 5세,2017,2772,1400,1372,102,2735,1385,1350,102.6
31160, 군포시,010002, 6세,2017,2805,1455,1350,107.8,2774,1440,1334,107.9
31160, 군포시,010003, 7세,2017,2633,1389,1244,111.7,2606,1372,1234,111.2
31160, 군포시,010004, 8세,2017,2547,1291,1256,102.8,2527,1284,1243,103.3
31160, 군포시,010005, 9세,2017,2789,1448,1341,108,2775,1440,1335,107.9
31160, 군포시,015,10~14세,2017,13254,6835,6419,106.5,13210,6816,6394,106.6
31160, 군포시,015001, 10세,2017,2696,1404,1292,108.7,2685,1399,1286,108.8
31160, 군포시,015002, 11세,2017,2531,1308,1223,107,2520,1305,1215,107.4
31160, 군포시,015003, 12세,2017,2462,1274,1188,107.2,2454,1270,1184,107.3
31160, 군포시,015004, 13세,2017,2738,1396,1342,104,2732,1393,1339,104
31160, 군포시,015005, 14세,2017,2827,1453,1374,105.7,2819,1449,1370,105.8
31160, 군포시,020,15~19세,2017,15936,8221,7715,106.6,15850,8186,7664,106.8
31160, 군포시,020001, 15세,2017,2909,1490,1419,105,2901,1486,1415,105
31160, 군포시,020002, 16세,2017,3086,1527,1559,97.9,3075,1521,1554,97.9
31160, 군포시,020003, 17세,2017,3491,1835,1656,110.8,3482,1832,1650,111
31160, 군포시,020004, 18세,2017,3259,1718,1541,111.5,3240,1711,1529,111.9
31160, 군포시,020005, 19세,2017,3191,1651,1540,107.2,3152,1636,1516,107.9
31160, 군포시,025,20~24세,2017,17894,9383,8511,110.2,17451,9147,8304,110.2
31160, 군포시,025001, 20세,2017,3312,1734,1578,109.9,3269,1711,1558,109.8
31160, 군포시,025002, 21세,2017,3562,1953,1609,121.4,3488,1912,1576,121.3
31160, 군포시,025003, 22세,2017,3541,1875,1666,112.5,3468,1837,1631,112.6
31160, 군포시,025004, 23세,2017,3702,1895,1807,104.9,3591,1838,1753,104.8
31160, 군포시,025005, 24세,2017,3777,1926,1851,104.1,3635,1849,1786,103.5
31160, 군포시,030,25~29세,2017,19409,9937,9472,104.9,18335,9359,8976,104.3
31160, 군포시,030001, 25세,2017,4004,2069,1935,106.9,3834,1976,1858,106.4
31160, 군포시,030002, 26세,2017,3927,2015,1912,105.4,3736,1903,1833,103.8
31160, 군포시,030003, 27세,2017,3769,1938,1831,105.8,3543,1811,1732,104.6
31160, 군포시,030004, 28세,2017,3920,2003,1917,104.5,3662,1869,1793,104.2
31160, 군포시,030005, 29세,2017,3789,1912,1877,101.9,3560,1800,1760,102.3
31160, 군포시,035,30~34세,2017,20871,10844,10027,108.1,19517,10074,9443,106.7
31160, 군포시,035001, 30세,2017,3900,2019,1881,107.3,3585,1841,1744,105.6
31160, 군포시,035002, 31세,2017,4089,2089,2000,104.5,3790,1937,1853,104.5
31160, 군포시,035003, 32세,2017,4059,2125,1934,109.9,3800,1982,1818,109
31160, 군포시,035004, 33세,2017,4279,2214,2065,107.2,4032,2061,1971,104.6
31160, 군포시,035005, 34세,2017,4544,2397,2147,111.6,4310,2253,2057,109.5
31160, 군포시,040,35~39세,2017,23247,11818,11429,103.4,22323,11285,11038,102.2
31160, 군포시,040001, 35세,2017,4880,2461,2419,101.7,4649,2320,2329,99.6
31160, 군포시,040002, 36세,2017,4798,2502,2296,109,4631,2403,2228,107.9
31160, 군포시,040003, 37세,2017,4861,2486,2375,104.7,4684,2387,2297,103.9
31160, 군포시,040004, 38세,2017,4557,2258,2299,98.2,4357,2150,2207,97.4
31160, 군포시,040005, 39세,2017,4151,2111,2040,103.5,4002,2025,1977,102.4
31160, 군포시,045,40~44세,2017,23152,11474,11678,98.3,22420,11060,11360,97.4
31160, 군포시,045001, 40세,2017,4323,2146,2177,98.6,4201,2068,2133,97
31160, 군포시,045002, 41세,2017,4259,2138,2121,100.8,4127,2066,2061,100.2
31160, 군포시,045003, 42세,2017,4481,2201,2280,96.5,4338,2128,2210,96.3
31160, 군포시,045004, 43세,2017,4907,2411,2496,96.6,4766,2327,2439,95.4
31160, 군포시,045005, 44세,2017,5182,2578,2604,99,4988,2471,2517,98.2
31160, 군포시,050,45~49세,2017,26201,12703,13498,94.1,25249,12228,13021,93.9
31160, 군포시,050001, 45세,2017,5076,2506,2570,97.5,4912,2423,2489,97.3
31160, 군포시,050002, 46세,2017,5368,2568,2800,91.7,5167,2468,2699,91.4
31160, 군포시,050003, 47세,2017,5291,2572,2719,94.6,5075,2474,2601,95.1
31160, 군포시,050004, 48세,2017,5275,2586,2689,96.2,5071,2489,2582,96.4
31160, 군포시,050005, 49세,2017,5191,2471,2720,90.8,5024,2374,2650,89.6
31160, 군포시,055,50~54세,2017,23779,11673,12106,96.4,22654,11110,11544,96.2
31160, 군포시,055001, 50세,2017,4668,2212,2456,90.1,4474,2123,2351,90.3
31160, 군포시,055002, 51세,2017,4768,2425,2343,103.5,4573,2322,2251,103.2
31160, 군포시,055003, 52세,2017,4888,2392,2496,95.8,4655,2275,2380,95.6
31160, 군포시,055004, 53세,2017,4579,2234,2345,95.3,4354,2132,2222,95.9
31160, 군포시,055005, 54세,2017,4876,2410,2466,97.7,4598,2258,2340,96.5
31160, 군포시,060,55~59세,2017,24295,11989,12306,97.4,23443,11558,11885,97.2
31160, 군포시,060001, 55세,2017,5002,2487,2515,98.9,4794,2376,2418,98.3
31160, 군포시,060002, 56세,2017,5224,2548,2676,95.2,5105,2485,2620,94.8
31160, 군포시,060003, 57세,2017,5204,2578,2626,98.2,5007,2481,2526,98.2
31160, 군포시,060004, 58세,2017,4525,2227,2298,96.9,4367,2155,2212,97.4
31160, 군포시,060005, 59세,2017,4340,2149,2191,98.1,4170,2061,2109,97.7
31160, 군포시,065,60~64세,2017,16063,8065,7998,100.8,15317,7694,7623,100.9
31160, 군포시,065001, 60세,2017,3960,2000,1960,102,3784,1915,1869,102.5
31160, 군포시,065002, 61세,2017,3475,1768,1707,103.6,3326,1689,1637,103.2
31160, 군포시,065003, 62세,2017,3409,1639,1770,92.6,3227,1551,1676,92.5
31160, 군포시,065004, 63세,2017,2842,1466,1376,106.5,2701,1390,1311,106
31160, 군포시,065005, 64세,2017,2377,1192,1185,100.6,2279,1149,1130,101.7
31160, 군포시,070,65~69세,2017,9673,4826,4847,99.6,9356,4680,4676,100.1
31160, 군포시,070001, 65세,2017,2495,1243,1252,99.3,2403,1204,1199,100.4
31160, 군포시,070002, 66세,2017,1748,888,860,103.3,1665,842,823,102.3
31160, 군포시,070003, 67세,2017,1820,900,920,97.8,1775,882,893,98.8
31160, 군포시,070004, 68세,2017,1833,921,912,101,1779,897,882,101.7
31160, 군포시,070005, 69세,2017,1777,874,903,96.8,1734,855,879,97.3
31160, 군포시,075,70~74세,2017,7267,3239,4028,80.4,7187,3209,3978,80.7
31160, 군포시,075001, 70세,2017,1883,881,1002,87.9,1860,872,988,88.3
31160, 군포시,075002, 71세,2017,1426,641,785,81.7,1403,632,771,82
31160, 군포시,075003, 72세,2017,1293,580,713,81.3,1278,574,704,81.5
31160, 군포시,075004, 73세,2017,1336,580,756,76.7,1327,577,750,76.9
31160, 군포시,075005, 74세,2017,1329,557,772,72.2,1319,554,765,72.4
31160, 군포시,080,75~79세,2017,6231,2519,3712,67.9,6172,2502,3670,68.2
31160, 군포시,080001, 75세,2017,1576,681,895,76.1,1562,678,884,76.7
31160, 군포시,080002, 76세,2017,1273,551,722,76.3,1266,548,718,76.3
31160, 군포시,080003, 77세,2017,1147,442,705,62.7,1134,437,697,62.7
31160, 군포시,080004, 78세,2017,1107,429,678,63.3,1099,429,670,64
31160, 군포시,080005, 79세,2017,1128,416,712,58.4,1111,410,701,58.5
31160, 군포시,085,80~84세,2017,4256,1552,2704,57.4,4216,1539,2677,57.5
31160, 군포시,085001, 80세,2017,1038,400,638,62.7,1029,398,631,63.1
31160, 군포시,085002, 81세,2017,885,324,561,57.8,877,321,556,57.7
31160, 군포시,085003, 82세,2017,886,321,565,56.8,879,319,560,57
31160, 군포시,085004, 83세,2017,799,267,532,50.2,785,261,524,49.8
31160, 군포시,085005, 84세,2017,648,240,408,58.8,646,240,406,59.1
31160, 군포시,090,85~89세,2017,2091,632,1459,43.3,2076,625,1451,43.1
31160, 군포시,090001, 85세,2017,591,191,400,47.8,587,189,398,47.5
31160, 군포시,090002, 86세,2017,425,124,301,41.2,422,123,299,41.1
31160, 군포시,090003, 87세,2017,422,126,296,42.6,419,125,294,42.5
31160, 군포시,090004, 88세,2017,352,119,233,51.1,349,117,232,50.4
31160, 군포시,090005, 89세,2017,301,72,229,31.4,299,71,228,31.1
31160, 군포시,095,90~94세,2017,687,184,503,36.6,684,183,501,36.5
31160, 군포시,095001, 90세,2017,220,68,152,44.7,219,68,151,45
31160, 군포시,095002, 91세,2017,148,44,104,42.3,147,44,103,42.7
31160, 군포시,095003, 92세,2017,135,27,108,25,134,26,108,24.1
31160, 군포시,095004, 93세,2017,100,29,71,40.8,100,29,71,40.8
31160, 군포시,095005, 94세,2017,84,16,68,23.5,84,16,68,23.5
31160, 군포시,100,95~99세,2017,179,41,138,29.7,179,41,138,29.7
31160, 군포시,100001, 95세,2017,64,13,51,25.5,64,13,51,25.5
31160, 군포시,100002, 96세,2017,52,10,42,23.8,52,10,42,23.8
31160, 군포시,100003, 97세,2017,26,9,17,52.9,26,9,17,52.9
31160, 군포시,100004, 98세,2017,18,8,10,80,18,8,10,80
31160, 군포시,100005, 99세,2017,19,X,18,5.6,19,X,18,5.6
31160, 군포시,101,100세이상,2017,19,X,18,5.6,19,X,18,5.6
31160, 군포시,102,15세미만,2017,39663,20367,19296,105.6,39199,20132,19067,105.6
31160, 군포시,103,15~64세,2017,210847,106107,104740,101.3,202559,101701,100858,100.8
31160, 군포시,104,65세이상,2017,30403,12994,17409,74.6,29889,12780,17109,74.7
31160, 군포시,086,85세이상,2017,2976,858,2118,40.5,2958,850,2108,40.3
31160, 군포시,126,평균연령,2017,39.9,38.9,40.9,,39.9,38.9,40.8,
31160, 군포시,127,중위연령,2017,40.8,39.6,42,,40.7,39.6,41.9,
31170, 의왕시,000,합계,2017,151852,75667,76185,99.3,150230,74811,75419,99.2
31170, 의왕시,005,0~4세,2017,6184,3147,3037,103.6,6160,3137,3023,103.8
31170, 의왕시,005001, 0세,2017,975,524,451,116.2,968,520,448,116.1
31170, 의왕시,005002, 1세,2017,1208,614,594,103.4,1203,612,591,103.6
31170, 의왕시,005003, 2세,2017,1285,664,621,106.9,1282,663,619,107.1
31170, 의왕시,005004, 3세,2017,1339,678,661,102.6,1335,678,657,103.2
31170, 의왕시,005005, 4세,2017,1377,667,710,93.9,1372,664,708,93.8
31170, 의왕시,010,5~9세,2017,7104,3719,3385,109.9,7093,3712,3381,109.8
31170, 의왕시,010001, 5세,2017,1507,804,703,114.4,1504,803,701,114.6
31170, 의왕시,010002, 6세,2017,1403,739,664,111.3,1401,737,664,111
31170, 의왕시,010003, 7세,2017,1366,709,657,107.9,1363,707,656,107.8
31170, 의왕시,010004, 8세,2017,1402,720,682,105.6,1401,719,682,105.4
31170, 의왕시,010005, 9세,2017,1426,747,679,110,1424,746,678,110
31170, 의왕시,015,10~14세,2017,6563,3410,3153,108.2,6555,3407,3148,108.2
31170, 의왕시,015001, 10세,2017,1377,704,673,104.6,1374,702,672,104.5
31170, 의왕시,015002, 11세,2017,1274,674,600,112.3,1271,673,598,112.5
31170, 의왕시,015003, 12세,2017,1236,638,598,106.7,1236,638,598,106.7
31170, 의왕시,015004, 13세,2017,1308,644,664,97,1307,644,663,97.1
31170, 의왕시,015005, 14세,2017,1368,750,618,121.4,1367,750,617,121.6
31170, 의왕시,020,15~19세,2017,9319,4557,4762,95.7,9311,4551,4760,95.6
31170, 의왕시,020001, 15세,2017,1426,706,720,98.1,1426,706,720,98.1
31170, 의왕시,020002, 16세,2017,1762,882,880,100.2,1760,880,880,100
31170, 의왕시,020003, 17세,2017,2195,1009,1186,85.1,2193,1008,1185,85.1
31170, 의왕시,020004, 18세,2017,2028,993,1035,95.9,2028,993,1035,95.9
31170, 의왕시,020005, 19세,2017,1908,967,941,102.8,1904,964,940,102.6
31170, 의왕시,025,20~24세,2017,10688,5689,4999,113.8,10533,5607,4926,113.8
31170, 의왕시,025001, 20세,2017,2016,1026,990,103.6,2001,1020,981,104
31170, 의왕시,025002, 21세,2017,2158,1163,995,116.9,2133,1153,980,117.7
31170, 의왕시,025003, 22세,2017,2199,1195,1004,119,2175,1182,993,119
31170, 의왕시,025004, 23세,2017,2098,1098,1000,109.8,2061,1080,981,110.1
31170, 의왕시,025005, 24세,2017,2217,1207,1010,119.5,2163,1172,991,118.3
31170, 의왕시,030,25~29세,2017,10235,5347,4888,109.4,9967,5207,4760,109.4
31170, 의왕시,030001, 25세,2017,2247,1202,1045,115,2194,1167,1027,113.6
31170, 의왕시,030002, 26세,2017,2146,1100,1046,105.2,2098,1078,1020,105.7
31170, 의왕시,030003, 27세,2017,1999,1037,962,107.8,1948,1013,935,108.3
31170, 의왕시,030004, 28세,2017,1976,1036,940,110.2,1920,1012,908,111.5
31170, 의왕시,030005, 29세,2017,1867,972,895,108.6,1807,937,870,107.7
31170, 의왕시,035,30~34세,2017,9705,5140,4565,112.6,9452,5004,4448,112.5
31170, 의왕시,035001, 30세,2017,1906,1050,856,122.7,1848,1022,826,123.7
31170, 의왕시,035002, 31세,2017,1799,936,863,108.5,1762,917,845,108.5
31170, 의왕시,035003, 32세,2017,1897,1021,876,116.6,1844,995,849,117.2
31170, 의왕시,035004, 33세,2017,1934,1002,932,107.5,1879,971,908,106.9
31170, 의왕시,035005, 34세,2017,2169,1131,1038,109,2119,1099,1020,107.7
31170, 의왕시,040,35~39세,2017,11321,5767,5554,103.8,11117,5656,5461,103.6
31170, 의왕시,040001, 35세,2017,2301,1209,1092,110.7,2252,1181,1071,110.3
31170, 의왕시,040002, 36세,2017,2356,1182,1174,100.7,2308,1155,1153,100.2
31170, 의왕시,040003, 37세,2017,2356,1172,1184,99,2316,1149,1167,98.5
31170, 의왕시,040004, 38세,2017,2276,1180,1096,107.7,2240,1159,1081,107.2
31170, 의왕시,040005, 39세,2017,2032,1024,1008,101.6,2001,1012,989,102.3
31170, 의왕시,045,40~44세,2017,11777,5927,5850,101.3,11629,5849,5780,101.2
31170, 의왕시,045001, 40세,2017,2260,1135,1125,100.9,2228,1118,1110,100.7
31170, 의왕시,045002, 41세,2017,2238,1149,1089,105.5,2214,1137,1077,105.6
31170, 의왕시,045003, 42세,2017,2216,1116,1100,101.5,2185,1099,1086,101.2
31170, 의왕시,045004, 43세,2017,2442,1238,1204,102.8,2414,1220,1194,102.2
31170, 의왕시,045005, 44세,2017,2621,1289,1332,96.8,2588,1275,1313,97.1
31170, 의왕시,050,45~49세,2017,13868,6678,7190,92.9,13702,6577,7125,92.3
31170, 의왕시,050001, 45세,2017,2604,1296,1308,99.1,2572,1275,1297,98.3
31170, 의왕시,050002, 46세,2017,2771,1329,1442,92.2,2740,1306,1434,91.1
31170, 의왕시,050003, 47세,2017,2722,1268,1454,87.2,2688,1250,1438,86.9
31170, 의왕시,050004, 48세,2017,2849,1365,1484,92,2814,1342,1472,91.2
31170, 의왕시,050005, 49세,2017,2922,1420,1502,94.5,2888,1404,1484,94.6
31170, 의왕시,055,50~54세,2017,13391,6603,6788,97.3,13273,6538,6735,97.1
31170, 의왕시,055001, 50세,2017,2696,1284,1412,90.9,2677,1273,1404,90.7
31170, 의왕시,055002, 51세,2017,2502,1279,1223,104.6,2473,1265,1208,104.7
31170, 의왕시,055003, 52세,2017,2755,1355,1400,96.8,2726,1337,1389,96.3
31170, 의왕시,055004, 53세,2017,2638,1285,1353,95,2620,1274,1346,94.7
31170, 의왕시,055005, 54세,2017,2800,1400,1400,100,2777,1389,1388,100.1
31170, 의왕시,060,55~59세,2017,14103,6929,7174,96.6,13990,6878,7112,96.7
31170, 의왕시,060001, 55세,2017,2792,1329,1463,90.8,2769,1319,1450,91
31170, 의왕시,060002, 56세,2017,3089,1471,1618,90.9,3070,1465,1605,91.3
31170, 의왕시,060003, 57세,2017,3007,1507,1500,100.5,2975,1492,1483,100.6
31170, 의왕시,060004, 58세,2017,2719,1362,1357,100.4,2705,1355,1350,100.4
31170, 의왕시,060005, 59세,2017,2496,1260,1236,101.9,2471,1247,1224,101.9
31170, 의왕시,065,60~64세,2017,9818,4998,4820,103.7,9743,4964,4779,103.9
31170, 의왕시,065001, 60세,2017,2342,1196,1146,104.4,2322,1187,1135,104.6
31170, 의왕시,065002, 61세,2017,2128,1076,1052,102.3,2110,1068,1042,102.5
31170, 의왕시,065003, 62세,2017,2144,1090,1054,103.4,2130,1085,1045,103.8
31170, 의왕시,065004, 63세,2017,1750,901,849,106.1,1739,897,842,106.5
31170, 의왕시,065005, 64세,2017,1454,735,719,102.2,1442,727,715,101.7
31170, 의왕시,070,65~69세,2017,5923,2977,2946,101.1,5885,2957,2928,101
31170, 의왕시,070001, 65세,2017,1534,812,722,112.5,1521,806,715,112.7
31170, 의왕시,070002, 66세,2017,1039,550,489,112.5,1030,546,484,112.8
31170, 의왕시,070003, 67세,2017,1082,534,548,97.4,1073,529,544,97.2
31170, 의왕시,070004, 68세,2017,1195,583,612,95.3,1191,579,612,94.6
31170, 의왕시,070005, 69세,2017,1073,498,575,86.6,1070,497,573,86.7
31170, 의왕시,075,70~74세,2017,4245,2007,2238,89.7,4223,1999,2224,89.9
31170, 의왕시,075001, 70세,2017,1053,522,531,98.3,1044,519,525,98.9
31170, 의왕시,075002, 71세,2017,810,383,427,89.7,803,381,422,90.3
31170, 의왕시,075003, 72세,2017,784,370,414,89.4,783,370,413,89.6
31170, 의왕시,075004, 73세,2017,795,375,420,89.3,792,374,418,89.5
31170, 의왕시,075005, 74세,2017,803,357,446,80,801,355,446,79.6
31170, 의왕시,080,75~79세,2017,3612,1552,2060,75.3,3606,1550,2056,75.4
31170, 의왕시,080001, 75세,2017,930,411,519,79.2,929,410,519,79
31170, 의왕시,080002, 76세,2017,720,317,403,78.7,717,317,400,79.3
31170, 의왕시,080003, 77세,2017,665,270,395,68.4,665,270,395,68.4
31170, 의왕시,080004, 78세,2017,662,287,375,76.5,660,286,374,76.5
31170, 의왕시,080005, 79세,2017,635,267,368,72.6,635,267,368,72.6
31170, 의왕시,085,80~84세,2017,2316,755,1561,48.4,2312,753,1559,48.3
31170, 의왕시,085001, 80세,2017,573,216,357,60.5,571,215,356,60.4
31170, 의왕시,085002, 81세,2017,469,154,315,48.9,467,153,314,48.7
31170, 의왕시,085003, 82세,2017,468,153,315,48.6,468,153,315,48.6
31170, 의왕시,085004, 83세,2017,445,123,322,38.2,445,123,322,38.2
31170, 의왕시,085005, 84세,2017,361,109,252,43.3,361,109,252,43.3
31170, 의왕시,090,85~89세,2017,1164,340,824,41.3,1164,340,824,41.3
31170, 의왕시,090001, 85세,2017,297,108,189,57.1,297,108,189,57.1
31170, 의왕시,090002, 86세,2017,269,78,191,40.8,269,78,191,40.8
31170, 의왕시,090003, 87세,2017,228,60,168,35.7,228,60,168,35.7
31170, 의왕시,090004, 88세,2017,210,58,152,38.2,210,58,152,38.2
31170, 의왕시,090005, 89세,2017,160,36,124,29,160,36,124,29
31170, 의왕시,095,90~94세,2017,411,98,313,31.3,410,98,312,31.4
31170, 의왕시,095001, 90세,2017,124,34,90,37.8,124,34,90,37.8
31170, 의왕시,095002, 91세,2017,85,23,62,37.1,84,23,61,37.7
31170, 의왕시,095003, 92세,2017,76,12,64,18.8,76,12,64,18.8
31170, 의왕시,095004, 93세,2017,63,14,49,28.6,63,14,49,28.6
31170, 의왕시,095005, 94세,2017,63,15,48,31.3,63,15,48,31.3
31170, 의왕시,100,95~99세,2017,95,25,70,35.7,95,25,70,35.7
31170, 의왕시,100001, 95세,2017,34,11,23,47.8,34,11,23,47.8
31170, 의왕시,100002, 96세,2017,25,5,20,25,25,5,20,25
31170, 의왕시,100003, 97세,2017,15,5,10,50,15,5,10,50
31170, 의왕시,100004, 98세,2017,12,X,10,20,12,X,10,20
31170, 의왕시,100005, 99세,2017,9,X,7,28.6,9,X,7,28.6
31170, 의왕시,101,100세이상,2017,10,X,8,25,10,X,8,25
31170, 의왕시,102,15세미만,2017,19851,10276,9575,107.3,19808,10256,9552,107.4
31170, 의왕시,103,15~64세,2017,114225,57635,56590,101.8,112717,56831,55886,101.7
31170, 의왕시,104,65세이상,2017,17776,7756,10020,77.4,17705,7724,9981,77.4
31170, 의왕시,086,85세이상,2017,1680,465,1215,38.3,1679,465,1214,38.3
31170, 의왕시,126,평균연령,2017,40.8,39.8,41.7,,40.8,39.8,41.7,
31170, 의왕시,127,중위연령,2017,42.1,40.9,43.4,,42.2,41,43.4,
31180, 하남시,000,합계,2017,218994,110017,108977,101,216268,108400,107868,100.5
31180, 하남시,005,0~4세,2017,12419,6371,6048,105.3,12409,6366,6043,105.3
31180, 하남시,005001, 0세,2017,1989,1049,940,111.6,1987,1047,940,111.4
31180, 하남시,005002, 1세,2017,2519,1255,1264,99.3,2516,1253,1263,99.2
31180, 하남시,005003, 2세,2017,2600,1331,1269,104.9,2597,1330,1267,105
31180, 하남시,005004, 3세,2017,2586,1328,1258,105.6,2585,1328,1257,105.6
31180, 하남시,005005, 4세,2017,2725,1408,1317,106.9,2724,1408,1316,107
31180, 하남시,010,5~9세,2017,12506,6358,6148,103.4,12493,6355,6138,103.5
31180, 하남시,010001, 5세,2017,2806,1478,1328,111.3,2803,1477,1326,111.4
31180, 하남시,010002, 6세,2017,2638,1306,1332,98,2634,1305,1329,98.2
31180, 하남시,010003, 7세,2017,2533,1297,1236,104.9,2532,1297,1235,105
31180, 하남시,010004, 8세,2017,2268,1162,1106,105.1,2266,1162,1104,105.3
31180, 하남시,010005, 9세,2017,2261,1115,1146,97.3,2258,1114,1144,97.4
31180, 하남시,015,10~14세,2017,9645,5004,4641,107.8,9637,5000,4637,107.8
31180, 하남시,015001, 10세,2017,2281,1206,1075,112.2,2279,1205,1074,112.2
31180, 하남시,015002, 11세,2017,1868,966,902,107.1,1866,965,901,107.1
31180, 하남시,015003, 12세,2017,1770,913,857,106.5,1767,912,855,106.7
31180, 하남시,015004, 13세,2017,1924,984,940,104.7,1923,983,940,104.6
31180, 하남시,015005, 14세,2017,1802,935,867,107.8,1802,935,867,107.8
31180, 하남시,020,15~19세,2017,9879,5025,4854,103.5,9856,5015,4841,103.6
31180, 하남시,020001, 15세,2017,1791,902,889,101.5,1789,901,888,101.5
31180, 하남시,020002, 16세,2017,2084,1079,1005,107.4,2081,1077,1004,107.3
31180, 하남시,020003, 17세,2017,2107,1084,1023,106,2104,1083,1021,106.1
31180, 하남시,020004, 18세,2017,2028,1008,1020,98.8,2023,1006,1017,98.9
31180, 하남시,020005, 19세,2017,1869,952,917,103.8,1859,948,911,104.1
31180, 하남시,025,20~24세,2017,11576,6326,5250,120.5,11323,6151,5172,118.9
31180, 하남시,025001, 20세,2017,2189,1233,956,129,2169,1221,948,128.8
31180, 하남시,025002, 21세,2017,2237,1272,965,131.8,2206,1250,956,130.8
31180, 하남시,025003, 22세,2017,2274,1234,1040,118.7,2225,1201,1024,117.3
31180, 하남시,025004, 23세,2017,2393,1270,1123,113.1,2329,1226,1103,111.2
31180, 하남시,025005, 24세,2017,2483,1317,1166,113,2394,1253,1141,109.8
31180, 하남시,030,25~29세,2017,13014,6661,6353,104.8,12499,6284,6215,101.1
31180, 하남시,030001, 25세,2017,2668,1349,1319,102.3,2566,1269,1297,97.8
31180, 하남시,030002, 26세,2017,2611,1350,1261,107.1,2518,1284,1234,104.1
31180, 하남시,030003, 27세,2017,2636,1356,1280,105.9,2525,1274,1251,101.8
31180, 하남시,030004, 28세,2017,2579,1337,1242,107.6,2460,1254,1206,104
31180, 하남시,030005, 29세,2017,2520,1269,1251,101.4,2430,1203,1227,98
31180, 하남시,035,30~34세,2017,15885,7991,7894,101.2,15403,7656,7747,98.8
31180, 하남시,035001, 30세,2017,2762,1411,1351,104.4,2640,1324,1316,100.6
31180, 하남시,035002, 31세,2017,2876,1455,1421,102.4,2772,1387,1385,100.1
31180, 하남시,035003, 32세,2017,3026,1519,1507,100.8,2943,1458,1485,98.2
31180, 하남시,035004, 33세,2017,3323,1678,1645,102,3230,1615,1615,100
31180, 하남시,035005, 34세,2017,3898,1928,1970,97.9,3818,1872,1946,96.2
31180, 하남시,040,35~39세,2017,22082,11127,10955,101.6,21738,10913,10825,100.8
31180, 하남시,040001, 35세,2017,4318,2173,2145,101.3,4240,2132,2108,101.1
31180, 하남시,040002, 36세,2017,4708,2315,2393,96.7,4634,2269,2365,95.9
31180, 하남시,040003, 37세,2017,4723,2357,2366,99.6,4650,2308,2342,98.5
31180, 하남시,040004, 38세,2017,4444,2269,2175,104.3,4383,2230,2153,103.6
31180, 하남시,040005, 39세,2017,3889,2013,1876,107.3,3831,1974,1857,106.3
31180, 하남시,045,40~44세,2017,18939,9978,8961,111.3,18711,9856,8855,111.3
31180, 하남시,045001, 40세,2017,3998,2088,1910,109.3,3941,2059,1882,109.4
31180, 하남시,045002, 41세,2017,3761,1987,1774,112,3713,1959,1754,111.7
31180, 하남시,045003, 42세,2017,3642,1918,1724,111.3,3600,1897,1703,111.4
31180, 하남시,045004, 43세,2017,3952,2094,1858,112.7,3906,2070,1836,112.7
31180, 하남시,045005, 44세,2017,3586,1891,1695,111.6,3551,1871,1680,111.4
31180, 하남시,050,45~49세,2017,18210,9356,8854,105.7,18016,9257,8759,105.7
31180, 하남시,050001, 45세,2017,3814,2038,1776,114.8,3770,2013,1757,114.6
31180, 하남시,050002, 46세,2017,3849,2042,1807,113,3813,2025,1788,113.3
31180, 하남시,050003, 47세,2017,3464,1778,1686,105.5,3424,1759,1665,105.6
31180, 하남시,050004, 48세,2017,3523,1780,1743,102.1,3485,1761,1724,102.1
31180, 하남시,050005, 49세,2017,3560,1718,1842,93.3,3524,1699,1825,93.1
31180, 하남시,055,50~54세,2017,16382,8106,8276,97.9,16153,8011,8142,98.4
31180, 하남시,055001, 50세,2017,3261,1616,1645,98.2,3220,1599,1621,98.6
31180, 하남시,055002, 51세,2017,3264,1613,1651,97.7,3214,1600,1614,99.1
31180, 하남시,055003, 52세,2017,3287,1653,1634,101.2,3243,1632,1611,101.3
31180, 하남시,055004, 53세,2017,3190,1600,1590,100.6,3145,1577,1568,100.6
31180, 하남시,055005, 54세,2017,3380,1624,1756,92.5,3331,1603,1728,92.8
31180, 하남시,060,55~59세,2017,18332,8851,9481,93.4,18161,8787,9374,93.7
31180, 하남시,060001, 55세,2017,3553,1743,1810,96.3,3516,1726,1790,96.4
31180, 하남시,060002, 56세,2017,3933,1854,2079,89.2,3902,1844,2058,89.6
31180, 하남시,060003, 57세,2017,3915,1866,2049,91.1,3876,1852,2024,91.5
31180, 하남시,060004, 58세,2017,3533,1705,1828,93.3,3502,1693,1809,93.6
31180, 하남시,060005, 59세,2017,3398,1683,1715,98.1,3365,1672,1693,98.8
31180, 하남시,065,60~64세,2017,14649,7171,7478,95.9,14497,7099,7398,96
31180, 하남시,065001, 60세,2017,3355,1644,1711,96.1,3326,1626,1700,95.6
31180, 하남시,065002, 61세,2017,3053,1469,1584,92.7,3020,1457,1563,93.2
31180, 하남시,065003, 62세,2017,3141,1524,1617,94.2,3107,1511,1596,94.7
31180, 하남시,065004, 63세,2017,2714,1350,1364,99,2679,1333,1346,99
31180, 하남시,065005, 64세,2017,2386,1184,1202,98.5,2365,1172,1193,98.2
31180, 하남시,070,65~69세,2017,9827,4976,4851,102.6,9761,4949,4812,102.8
31180, 하남시,070001, 65세,2017,2505,1245,1260,98.8,2484,1238,1246,99.4
31180, 하남시,070002, 66세,2017,1692,844,848,99.5,1674,838,836,100.2
31180, 하남시,070003, 67세,2017,1886,946,940,100.6,1874,940,934,100.6
31180, 하남시,070004, 68세,2017,1924,990,934,106,1917,987,930,106.1
31180, 하남시,070005, 69세,2017,1820,951,869,109.4,1812,946,866,109.2
31180, 하남시,075,70~74세,2017,6537,3351,3186,105.2,6514,3343,3171,105.4
31180, 하남시,075001, 70세,2017,1752,911,841,108.3,1743,908,835,108.7
31180, 하남시,075002, 71세,2017,1275,640,635,100.8,1269,638,631,101.1
31180, 하남시,075003, 72세,2017,1215,641,574,111.7,1212,640,572,111.9
31180, 하남시,075004, 73세,2017,1221,625,596,104.9,1220,624,596,104.7
31180, 하남시,075005, 74세,2017,1074,534,540,98.9,1070,533,537,99.3
31180, 하남시,080,75~79세,2017,4498,1986,2512,79.1,4491,1983,2508,79.1
31180, 하남시,080001, 75세,2017,1173,515,658,78.3,1169,514,655,78.5
31180, 하남시,080002, 76세,2017,958,436,522,83.5,958,436,522,83.5
31180, 하남시,080003, 77세,2017,828,374,454,82.4,828,374,454,82.4
31180, 하남시,080004, 78세,2017,817,343,474,72.4,816,342,474,72.2
31180, 하남시,080005, 79세,2017,722,318,404,78.7,720,317,403,78.7
31180, 하남시,085,80~84세,2017,2612,921,1691,54.5,2607,918,1689,54.4
31180, 하남시,085001, 80세,2017,601,248,353,70.3,599,248,351,70.7
31180, 하남시,085002, 81세,2017,617,244,373,65.4,617,244,373,65.4
31180, 하남시,085003, 82세,2017,533,179,354,50.6,533,179,354,50.6
31180, 하남시,085004, 83세,2017,459,132,327,40.4,456,129,327,39.4
31180, 하남시,085005, 84세,2017,402,118,284,41.5,402,118,284,41.5
31180, 하남시,090,85~89세,2017,1310,314,996,31.5,1307,313,994,31.5
31180, 하남시,090001, 85세,2017,325,87,238,36.6,324,87,237,36.7
31180, 하남시,090002, 86세,2017,298,74,224,33,297,73,224,32.6
31180, 하남시,090003, 87세,2017,271,64,207,30.9,270,64,206,31.1
31180, 하남시,090004, 88세,2017,220,50,170,29.4,220,50,170,29.4
31180, 하남시,090005, 89세,2017,196,39,157,24.8,196,39,157,24.8
31180, 하남시,095,90~94세,2017,536,118,418,28.2,536,118,418,28.2
31180, 하남시,095001, 90세,2017,162,36,126,28.6,162,36,126,28.6
31180, 하남시,095002, 91세,2017,108,23,85,27.1,108,23,85,27.1
31180, 하남시,095003, 92세,2017,109,24,85,28.2,109,24,85,28.2
31180, 하남시,095004, 93세,2017,74,18,56,32.1,74,18,56,32.1
31180, 하남시,095005, 94세,2017,83,17,66,25.8,83,17,66,25.8
31180, 하남시,100,95~99세,2017,144,23,121,19,144,23,121,19
31180, 하남시,100001, 95세,2017,61,5,56,8.9,61,5,56,8.9
31180, 하남시,100002, 96세,2017,29,6,23,26.1,29,6,23,26.1
31180, 하남시,100003, 97세,2017,29,6,23,26.1,29,6,23,26.1
31180, 하남시,100004, 98세,2017,15,X,11,36.4,15,X,11,36.4
31180, 하남시,100005, 99세,2017,10,X,8,25,10,X,8,25
31180, 하남시,101,100세이상,2017,12,X,9,33.3,12,X,9,33.3
31180, 하남시,102,15세미만,2017,34570,17733,16837,105.3,34539,17721,16818,105.4
31180, 하남시,103,15~64세,2017,158948,80592,78356,102.9,156357,79029,77328,102.2
31180, 하남시,104,65세이상,2017,25476,11692,13784,84.8,25372,11650,13722,84.9
31180, 하남시,086,85세이상,2017,2002,458,1544,29.7,1999,457,1542,29.6
31180, 하남시,126,평균연령,2017,40,39.2,40.7,,40,39.2,40.7,
31180, 하남시,127,중위연령,2017,40.6,40.1,41.2,,40.7,40.2,41.2,
31190, 용인시,000,합계,2017,996260,497236,499024,99.6,973840,484508,489332,99
31190, 용인시,005,0~4세,2017,47769,24486,23283,105.2,47407,24292,23115,105.1
31190, 용인시,005001, 0세,2017,7501,3911,3590,108.9,7427,3862,3565,108.3
31190, 용인시,005002, 1세,2017,9093,4631,4462,103.8,9000,4581,4419,103.7
31190, 용인시,005003, 2세,2017,10093,5153,4940,104.3,10022,5114,4908,104.2
31190, 용인시,005004, 3세,2017,10400,5328,5072,105,10330,5293,5037,105.1
31190, 용인시,005005, 4세,2017,10682,5463,5219,104.7,10628,5442,5186,104.9
31190, 용인시,010,5~9세,2017,58194,29921,28273,105.8,57996,29817,28179,105.8
31190, 용인시,010001, 5세,2017,11839,6089,5750,105.9,11784,6065,5719,106.1
31190, 용인시,010002, 6세,2017,11632,5968,5664,105.4,11598,5947,5651,105.2
31190, 용인시,010003, 7세,2017,11470,5878,5592,105.1,11426,5853,5573,105
31190, 용인시,010004, 8세,2017,11201,5810,5391,107.8,11161,5786,5375,107.6
31190, 용인시,010005, 9세,2017,12052,6176,5876,105.1,12027,6166,5861,105.2
31190, 용인시,015,10~14세,2017,56433,29084,27349,106.3,56340,29037,27303,106.4
31190, 용인시,015001, 10세,2017,12182,6243,5939,105.1,12160,6227,5933,105
31190, 용인시,015002, 11세,2017,11039,5772,5267,109.6,11026,5764,5262,109.5
31190, 용인시,015003, 12세,2017,10717,5545,5172,107.2,10699,5539,5160,107.3
31190, 용인시,015004, 13세,2017,11379,5817,5562,104.6,11358,5809,5549,104.7
31190, 용인시,015005, 14세,2017,11116,5707,5409,105.5,11097,5698,5399,105.5
31190, 용인시,020,15~19세,2017,64133,33230,30903,107.5,63617,33024,30593,107.9
31190, 용인시,020001, 15세,2017,11094,5771,5323,108.4,11065,5754,5311,108.3
31190, 용인시,020002, 16세,2017,11701,6023,5678,106.1,11676,6012,5664,106.1
31190, 용인시,020003, 17세,2017,12775,6569,6206,105.8,12723,6549,6174,106.1
31190, 용인시,020004, 18세,2017,13011,6701,6310,106.2,12865,6654,6211,107.1
31190, 용인시,020005, 19세,2017,15552,8166,7386,110.6,15288,8055,7233,111.4
31190, 용인시,025,20~24세,2017,70010,36321,33689,107.8,67149,34763,32386,107.3
31190, 용인시,025001, 20세,2017,14278,7255,7023,103.3,13848,7054,6794,103.8
31190, 용인시,025002, 21세,2017,14028,7201,6827,105.5,13511,6945,6566,105.8
31190, 용인시,025003, 22세,2017,13841,7363,6478,113.7,13289,7071,6218,113.7
31190, 용인시,025004, 23세,2017,14146,7424,6722,110.4,13477,7040,6437,109.4
31190, 용인시,025005, 24세,2017,13717,7078,6639,106.6,13024,6653,6371,104.4
31190, 용인시,030,25~29세,2017,58703,31321,27382,114.4,54910,28887,26023,111
31190, 용인시,030001, 25세,2017,13416,7201,6215,115.9,12687,6751,5936,113.7
31190, 용인시,030002, 26세,2017,12244,6666,5578,119.5,11485,6172,5313,116.2
31190, 용인시,030003, 27세,2017,11327,5911,5416,109.1,10568,5430,5138,105.7
31190, 용인시,030004, 28세,2017,10921,5785,5136,112.6,10157,5283,4874,108.4
31190, 용인시,030005, 29세,2017,10795,5758,5037,114.3,10013,5251,4762,110.3
31190, 용인시,035,30~34세,2017,60688,30385,30303,100.3,57376,28303,29073,97.4
31190, 용인시,035001, 30세,2017,10569,5374,5195,103.4,9803,4908,4895,100.3
31190, 용인시,035002, 31세,2017,11020,5695,5325,106.9,10337,5249,5088,103.2
31190, 용인시,035003, 32세,2017,11755,5915,5840,101.3,11079,5492,5587,98.3
31190, 용인시,035004, 33세,2017,12654,6213,6441,96.5,12057,5827,6230,93.5
31190, 용인시,035005, 34세,2017,14690,7188,7502,95.8,14100,6827,7273,93.9
31190, 용인시,040,35~39세,2017,86941,42402,44539,95.2,84501,40859,43642,93.6
31190, 용인시,040001, 35세,2017,16634,8188,8446,96.9,16044,7810,8234,94.9
31190, 용인시,040002, 36세,2017,17413,8662,8751,99,16921,8341,8580,97.2
31190, 용인시,040003, 37세,2017,18338,8907,9431,94.4,17835,8593,9242,93
31190, 용인시,040004, 38세,2017,18080,8678,9402,92.3,17636,8401,9235,91
31190, 용인시,040005, 39세,2017,16476,7967,8509,93.6,16065,7714,8351,92.4
31190, 용인시,045,40~44세,2017,94427,46748,47679,98,92586,45669,46917,97.3
31190, 용인시,045001, 40세,2017,18100,8755,9345,93.7,17697,8512,9185,92.7
31190, 용인시,045002, 41세,2017,17753,8818,8935,98.7,17382,8597,8785,97.9
31190, 용인시,045003, 42세,2017,18532,9191,9341,98.4,18206,8996,9210,97.7
31190, 용인시,045004, 43세,2017,20222,10155,10067,100.9,19874,9955,9919,100.4
31190, 용인시,045005, 44세,2017,19820,9829,9991,98.4,19427,9609,9818,97.9
31190, 용인시,050,45~49세,2017,97180,49092,48088,102.1,95299,48068,47231,101.8
31190, 용인시,050001, 45세,2017,19918,10098,9820,102.8,19530,9874,9656,102.3
31190, 용인시,050002, 46세,2017,20744,10544,10200,103.4,20378,10349,10029,103.2
31190, 용인시,050003, 47세,2017,19591,9822,9769,100.5,19194,9609,9585,100.3
31190, 용인시,050004, 48세,2017,18901,9547,9354,102.1,18548,9366,9182,102
31190, 용인시,050005, 49세,2017,18026,9081,8945,101.5,17649,8870,8779,101
31190, 용인시,055,50~54세,2017,73657,38044,35613,106.8,71965,37223,34742,107.1
31190, 용인시,055001, 50세,2017,16081,8147,7934,102.7,15797,8020,7777,103.1
31190, 용인시,055002, 51세,2017,14727,7573,7154,105.9,14404,7405,6999,105.8
31190, 용인시,055003, 52세,2017,15077,7827,7250,108,14726,7646,7080,108
31190, 용인시,055004, 53세,2017,13785,7204,6581,109.5,13439,7040,6399,110
31190, 용인시,055005, 54세,2017,13987,7293,6694,108.9,13599,7112,6487,109.6
31190, 용인시,060,55~59세,2017,63465,32228,31237,103.2,62134,31574,30560,103.3
31190, 용인시,060001, 55세,2017,13252,6874,6378,107.8,12923,6714,6209,108.1
31190, 용인시,060002, 56세,2017,14006,7139,6867,104,13788,7031,6757,104.1
31190, 용인시,060003, 57세,2017,13182,6672,6510,102.5,12891,6538,6353,102.9
31190, 용인시,060004, 58세,2017,11936,6020,5916,101.8,11693,5899,5794,101.8
31190, 용인시,060005, 59세,2017,11089,5523,5566,99.2,10839,5392,5447,99
31190, 용인시,065,60~64세,2017,48239,22670,25569,88.7,47100,22107,24993,88.5
31190, 용인시,065001, 60세,2017,10689,5097,5592,91.1,10418,4973,5445,91.3
31190, 용인시,065002, 61세,2017,9939,4735,5204,91,9687,4606,5081,90.7
31190, 용인시,065003, 62세,2017,10411,4948,5463,90.6,10185,4835,5350,90.4
31190, 용인시,065004, 63세,2017,8963,4152,4811,86.3,8747,4038,4709,85.8
31190, 용인시,065005, 64세,2017,8237,3738,4499,83.1,8063,3655,4408,82.9
31190, 용인시,070,65~69세,2017,36874,16849,20025,84.1,36321,16588,19733,84.1
31190, 용인시,070001, 65세,2017,8936,4135,4801,86.1,8771,4057,4714,86.1
31190, 용인시,070002, 66세,2017,6247,2791,3456,80.8,6126,2732,3394,80.5
31190, 용인시,070003, 67세,2017,7113,3238,3875,83.6,7000,3189,3811,83.7
31190, 용인시,070004, 68세,2017,7236,3333,3903,85.4,7148,3289,3859,85.2
31190, 용인시,070005, 69세,2017,7342,3352,3990,84,7276,3321,3955,84
31190, 용인시,075,70~74세,2017,31068,14201,16867,84.2,30885,14129,16756,84.3
31190, 용인시,075001, 70세,2017,7688,3384,4304,78.6,7628,3353,4275,78.4
31190, 용인시,075002, 71세,2017,6273,2872,3401,84.4,6233,2859,3374,84.7
31190, 용인시,075003, 72세,2017,5889,2748,3141,87.5,5865,2737,3128,87.5
31190, 용인시,075004, 73세,2017,5593,2589,3004,86.2,5563,2578,2985,86.4
31190, 용인시,075005, 74세,2017,5625,2608,3017,86.4,5596,2602,2994,86.9
31190, 용인시,080,75~79세,2017,24609,11569,13040,88.7,24494,11516,12978,88.7
31190, 용인시,080001, 75세,2017,6297,2957,3340,88.5,6262,2947,3315,88.9
31190, 용인시,080002, 76세,2017,5363,2570,2793,92,5340,2558,2782,91.9
31190, 용인시,080003, 77세,2017,4586,2177,2409,90.4,4566,2168,2398,90.4
31190, 용인시,080004, 78세,2017,4424,2053,2371,86.6,4405,2041,2364,86.3
31190, 용인시,080005, 79세,2017,3939,1812,2127,85.2,3921,1802,2119,85
31190, 용인시,085,80~84세,2017,14081,5805,8276,70.1,14020,5784,8236,70.2
31190, 용인시,085001, 80세,2017,3586,1583,2003,79,3571,1577,1994,79.1
31190, 용인시,085002, 81세,2017,3054,1287,1767,72.8,3041,1282,1759,72.9
31190, 용인시,085003, 82세,2017,2931,1214,1717,70.7,2920,1210,1710,70.8
31190, 용인시,085004, 83세,2017,2472,994,1478,67.3,2462,992,1470,67.5
31190, 용인시,085005, 84세,2017,2038,727,1311,55.5,2026,723,1303,55.5
31190, 용인시,090,85~89세,2017,6655,2118,4537,46.7,6618,2109,4509,46.8
31190, 용인시,090001, 85세,2017,1773,659,1114,59.2,1764,658,1106,59.5
31190, 용인시,090002, 86세,2017,1407,441,966,45.7,1403,440,963,45.7
31190, 용인시,090003, 87세,2017,1328,419,909,46.1,1318,415,903,46
31190, 용인시,090004, 88세,2017,1218,354,864,41,1210,352,858,41
31190, 용인시,090005, 89세,2017,929,245,684,35.8,923,244,679,35.9
31190, 용인시,095,90~94세,2017,2449,627,1822,34.4,2439,625,1814,34.5
31190, 용인시,095001, 90세,2017,759,201,558,36,756,201,555,36.2
31190, 용인시,095002, 91세,2017,574,150,424,35.4,571,149,422,35.3
31190, 용인시,095003, 92세,2017,467,100,367,27.2,465,100,365,27.4
31190, 용인시,095004, 93세,2017,342,87,255,34.1,341,87,254,34.3
31190, 용인시,095005, 94세,2017,307,89,218,40.8,306,88,218,40.4
31190, 용인시,100,95~99세,2017,603,129,474,27.2,602,129,473,27.3
31190, 용인시,100001, 95세,2017,237,51,186,27.4,237,51,186,27.4
31190, 용인시,100002, 96세,2017,160,42,118,35.6,159,42,117,35.9
31190, 용인시,100003, 97세,2017,98,16,82,19.5,98,16,82,19.5
31190, 용인시,100004, 98세,2017,66,13,53,24.5,66,13,53,24.5
31190, 용인시,100005, 99세,2017,42,7,35,20,42,7,35,20
31190, 용인시,101,100세이상,2017,82,6,76,7.9,81,5,76,6.6
31190, 용인시,102,15세미만,2017,162396,83491,78905,105.8,161743,83146,78597,105.8
31190, 용인시,103,15~64세,2017,717443,362441,355002,102.1,696637,350477,346160,101.2
31190, 용인시,104,65세이상,2017,116421,51304,65117,78.8,115460,50885,64575,78.8
31190, 용인시,086,85세이상,2017,9789,2880,6909,41.7,9740,2868,6872,41.7
31190, 용인시,126,평균연령,2017,38.8,37.9,39.6,,38.8,38,39.6,
31190, 용인시,127,중위연령,2017,39.7,38.9,40.4,,39.9,39.1,40.5,
31191, 처인구,000,합계,2017,240521,125322,115199,108.8,228783,117828,110955,106.2
31191, 처인구,005,0~4세,2017,9396,4829,4567,105.7,9238,4744,4494,105.6
31191, 처인구,005001, 0세,2017,1590,815,775,105.2,1550,787,763,103.1
31191, 처인구,005002, 1세,2017,1866,943,923,102.2,1824,921,903,102
31191, 처인구,005003, 2세,2017,1964,1008,956,105.4,1933,992,941,105.4
31191, 처인구,005004, 3세,2017,2002,1055,947,111.4,1974,1041,933,111.6
31191, 처인구,005005, 4세,2017,1974,1008,966,104.3,1957,1003,954,105.1
31191, 처인구,010,5~9세,2017,10938,5569,5369,103.7,10869,5532,5337,103.7
31191, 처인구,010001, 5세,2017,2230,1124,1106,101.6,2209,1112,1097,101.4
31191, 처인구,010002, 6세,2017,2200,1132,1068,106,2191,1126,1065,105.7
31191, 처인구,010003, 7세,2017,2137,1070,1067,100.3,2120,1059,1061,99.8
31191, 처인구,010004, 8세,2017,2132,1107,1025,108,2123,1102,1021,107.9
31191, 처인구,010005, 9세,2017,2239,1136,1103,103,2226,1133,1093,103.7
31191, 처인구,015,10~14세,2017,10803,5704,5099,111.9,10770,5689,5081,112
31191, 처인구,015001, 10세,2017,2293,1169,1124,104,2286,1166,1120,104.1
31191, 처인구,015002, 11세,2017,2083,1140,943,120.9,2078,1137,941,120.8
31191, 처인구,015003, 12세,2017,2065,1078,987,109.2,2059,1077,982,109.7
31191, 처인구,015004, 13세,2017,2178,1176,1002,117.4,2170,1171,999,117.2
31191, 처인구,015005, 14세,2017,2184,1141,1043,109.4,2177,1138,1039,109.5
31191, 처인구,020,15~19세,2017,17145,9143,8002,114.3,16971,9070,7901,114.8
31191, 처인구,020001, 15세,2017,2350,1254,1096,114.4,2343,1250,1093,114.4
31191, 처인구,020002, 16세,2017,2505,1301,1204,108.1,2500,1299,1201,108.2
31191, 처인구,020003, 17세,2017,3219,1670,1549,107.8,3196,1659,1537,107.9
31191, 처인구,020004, 18세,2017,3614,1912,1702,112.3,3553,1887,1666,113.3
31191, 처인구,020005, 19세,2017,5457,3006,2451,122.6,5379,2975,2404,123.8
31191, 처인구,025,20~24세,2017,20728,11296,9432,119.8,19450,10475,8975,116.7
31191, 처인구,025001, 20세,2017,4439,2292,2147,106.8,4291,2215,2076,106.7
31191, 처인구,025002, 21세,2017,4140,2107,2033,103.6,3941,1997,1944,102.7
31191, 처인구,025003, 22세,2017,4108,2292,1816,126.2,3887,2153,1734,124.2
31191, 처인구,025004, 23세,2017,4142,2370,1772,133.7,3809,2142,1667,128.5
31191, 처인구,025005, 24세,2017,3899,2235,1664,134.3,3522,1968,1554,126.6
31191, 처인구,030,25~29세,2017,16644,9887,6757,146.3,14261,8198,6063,135.2
31191, 처인구,030001, 25세,2017,3914,2320,1594,145.5,3473,2009,1464,137.2
31191, 처인구,030002, 26세,2017,3492,2109,1383,152.5,3009,1758,1251,140.5
31191, 처인구,030003, 27세,2017,3161,1853,1308,141.7,2667,1517,1150,131.9
31191, 처인구,030004, 28세,2017,3061,1851,1210,153,2587,1506,1081,139.3
31191, 처인구,030005, 29세,2017,3016,1754,1262,139,2525,1408,1117,126.1
31191, 처인구,035,30~34세,2017,15706,8868,6838,129.7,13633,7418,6215,119.4
31191, 처인구,035001, 30세,2017,2912,1683,1229,136.9,2452,1376,1076,127.9
31191, 처인구,035002, 31세,2017,3018,1756,1262,139.1,2579,1453,1126,129
31191, 처인구,035003, 32세,2017,3065,1774,1291,137.4,2634,1472,1162,126.7
31191, 처인구,035004, 33세,2017,3208,1747,1461,119.6,2828,1472,1356,108.6
31191, 처인구,035005, 34세,2017,3503,1908,1595,119.6,3140,1645,1495,110
31191, 처인구,040,35~39세,2017,18904,10160,8744,116.2,17492,9160,8332,109.9
31191, 처인구,040001, 35세,2017,3837,2034,1803,112.8,3492,1793,1699,105.5
31191, 처인구,040002, 36세,2017,3819,2126,1693,125.6,3535,1915,1620,118.2
31191, 처인구,040003, 37세,2017,3948,2106,1842,114.3,3652,1894,1758,107.7
31191, 처인구,040004, 38세,2017,3891,2078,1813,114.6,3634,1898,1736,109.3
31191, 처인구,040005, 39세,2017,3409,1816,1593,114,3179,1660,1519,109.3
31191, 처인구,045,40~44세,2017,19463,10287,9176,112.1,18508,9671,8837,109.4
31191, 처인구,045001, 40세,2017,3714,1915,1799,106.4,3496,1766,1730,102.1
31191, 처인구,045002, 41세,2017,3699,1971,1728,114.1,3484,1835,1649,111.3
31191, 처인구,045003, 42세,2017,3776,2023,1753,115.4,3616,1915,1701,112.6
31191, 처인구,045004, 43세,2017,4162,2253,1909,118,3985,2140,1845,116
31191, 처인구,045005, 44세,2017,4112,2125,1987,106.9,3927,2015,1912,105.4
31191, 처인구,050,45~49세,2017,21062,10902,10160,107.3,20140,10365,9775,106
31191, 처인구,050001, 45세,2017,4128,2209,1919,115.1,3930,2089,1841,113.5
31191, 처인구,050002, 46세,2017,4276,2213,2063,107.3,4103,2115,1988,106.4
31191, 처인구,050003, 47세,2017,4174,2148,2026,106,3978,2037,1941,104.9
31191, 처인구,050004, 48세,2017,4304,2182,2122,102.8,4131,2085,2046,101.9
31191, 처인구,050005, 49세,2017,4180,2150,2030,105.9,3998,2039,1959,104.1
31191, 처인구,055,50~54세,2017,18862,9841,9021,109.1,18070,9433,8637,109.2
31191, 처인구,055001, 50세,2017,3760,1910,1850,103.2,3638,1862,1776,104.8
31191, 처인구,055002, 51세,2017,3803,1995,1808,110.3,3659,1912,1747,109.4
31191, 처인구,055003, 52세,2017,3991,2060,1931,106.7,3808,1958,1850,105.8
31191, 처인구,055004, 53세,2017,3548,1900,1648,115.3,3389,1818,1571,115.7
31191, 처인구,055005, 54세,2017,3760,1976,1784,110.8,3576,1883,1693,111.2
31191, 처인구,060,55~59세,2017,18379,9590,8789,109.1,17803,9288,8515,109.1
31191, 처인구,060001, 55세,2017,3767,1962,1805,108.7,3621,1890,1731,109.2
31191, 처인구,060002, 56세,2017,4167,2174,1993,109.1,4068,2121,1947,108.9
31191, 처인구,060003, 57세,2017,3844,2000,1844,108.5,3714,1932,1782,108.4
31191, 처인구,060004, 58세,2017,3441,1825,1616,112.9,3355,1781,1574,113.2
31191, 처인구,060005, 59세,2017,3160,1629,1531,106.4,3045,1564,1481,105.6
31191, 처인구,065,60~64세,2017,13368,6597,6771,97.4,12886,6335,6551,96.7
31191, 처인구,065001, 60세,2017,2982,1445,1537,94,2879,1393,1486,93.7
31191, 처인구,065002, 61세,2017,2884,1478,1406,105.1,2776,1414,1362,103.8
31191, 처인구,065003, 62세,2017,2879,1440,1439,100.1,2779,1381,1398,98.8
31191, 처인구,065004, 63세,2017,2415,1164,1251,93,2322,1116,1206,92.5
31191, 처인구,065005, 64세,2017,2208,1070,1138,94,2130,1031,1099,93.8
31191, 처인구,070,65~69세,2017,9237,4526,4711,96.1,8966,4384,4582,95.7
31191, 처인구,070001, 65세,2017,2416,1212,1204,100.7,2333,1169,1164,100.4
31191, 처인구,070002, 66세,2017,1657,768,889,86.4,1592,734,858,85.5
31191, 처인구,070003, 67세,2017,1749,840,909,92.4,1693,811,882,92
31191, 처인구,070004, 68세,2017,1690,853,837,101.9,1654,830,824,100.7
31191, 처인구,070005, 69세,2017,1725,853,872,97.8,1694,840,854,98.4
31191, 처인구,075,70~74세,2017,7178,3321,3857,86.1,7103,3292,3811,86.4
31191, 처인구,075001, 70세,2017,1724,799,925,86.4,1702,788,914,86.2
31191, 처인구,075002, 71세,2017,1414,677,737,91.9,1394,672,722,93.1
31191, 처인구,075003, 72세,2017,1367,644,723,89.1,1356,638,718,88.9
31191, 처인구,075004, 73세,2017,1321,610,711,85.8,1311,606,705,86
31191, 처인구,075005, 74세,2017,1352,591,761,77.7,1340,588,752,78.2
31191, 처인구,080,75~79세,2017,6068,2566,3502,73.3,6023,2549,3474,73.4
31191, 처인구,080001, 75세,2017,1454,633,821,77.1,1443,631,812,77.7
31191, 처인구,080002, 76세,2017,1302,550,752,73.1,1291,544,747,72.8
31191, 처인구,080003, 77세,2017,1115,487,628,77.5,1109,485,624,77.7
31191, 처인구,080004, 78세,2017,1164,487,677,71.9,1155,482,673,71.6
31191, 처인구,080005, 79세,2017,1033,409,624,65.5,1025,407,618,65.9
31191, 처인구,085,80~84세,2017,3956,1537,2419,63.5,3933,1530,2403,63.7
31191, 처인구,085001, 80세,2017,972,403,569,70.8,964,400,564,70.9
31191, 처인구,085002, 81세,2017,822,328,494,66.4,816,326,490,66.5
31191, 처인구,085003, 82세,2017,869,334,535,62.4,863,333,530,62.8
31191, 처인구,085004, 83세,2017,717,280,437,64.1,715,279,436,64
31191, 처인구,085005, 84세,2017,576,192,384,50,575,192,383,50.1
31191, 처인구,090,85~89세,2017,1854,509,1345,37.8,1839,505,1334,37.9
31191, 처인구,090001, 85세,2017,494,154,340,45.3,490,154,336,45.8
31191, 처인구,090002, 86세,2017,391,114,277,41.2,391,114,277,41.2
31191, 처인구,090003, 87세,2017,384,97,287,33.8,376,94,282,33.3
31191, 처인구,090004, 88세,2017,334,97,237,40.9,332,96,236,40.7
31191, 처인구,090005, 89세,2017,251,47,204,23,250,47,203,23.2
31191, 처인구,095,90~94세,2017,674,160,514,31.1,673,160,513,31.2
31191, 처인구,095001, 90세,2017,211,53,158,33.5,210,53,157,33.8
31191, 처인구,095002, 91세,2017,163,34,129,26.4,163,34,129,26.4
31191, 처인구,095003, 92세,2017,130,31,99,31.3,130,31,99,31.3
31191, 처인구,095004, 93세,2017,88,20,68,29.4,88,20,68,29.4
31191, 처인구,095005, 94세,2017,82,22,60,36.7,82,22,60,36.7
31191, 처인구,100,95~99세,2017,141,30,111,27,140,30,110,27.3
31191, 처인구,100001, 95세,2017,48,8,40,20,48,8,40,20
31191, 처인구,100002, 96세,2017,50,12,38,31.6,49,12,37,32.4
31191, 처인구,100003, 97세,2017,22,7,15,46.7,22,7,15,46.7
31191, 처인구,100004, 98세,2017,9,X,8,12.5,9,X,8,12.5
31191, 처인구,100005, 99세,2017,12,X,10,20,12,X,10,20
31191, 처인구,101,100세이상,2017,15,X,15,0,15,X,15,0
31191, 처인구,102,15세미만,2017,31137,16102,15035,107.1,30877,15965,14912,107.1
31191, 처인구,103,15~64세,2017,180261,96571,83690,115.4,169214,89413,79801,112
31191, 처인구,104,65세이상,2017,29123,12649,16474,76.8,28692,12450,16242,76.7
31191, 처인구,086,85세이상,2017,2684,699,1985,35.2,2667,695,1972,35.2
31191, 처인구,126,평균연령,2017,39.8,38.7,41,,39.9,38.8,41.1,
31191, 처인구,127,중위연령,2017,40,38.5,41.6,,40.5,39.2,41.8,
31192, 기흥구,000,합계,2017,416746,206270,210476,98,410112,202872,207240,97.9
31192, 기흥구,005,0~4세,2017,21920,11206,10714,104.6,21799,11146,10653,104.6
31192, 기흥구,005001, 0세,2017,3319,1759,1560,112.8,3300,1750,1550,112.9
31192, 기흥구,005002, 1세,2017,4163,2112,2051,103,4131,2093,2038,102.7
31192, 기흥구,005003, 2세,2017,4701,2390,2311,103.4,4676,2375,2301,103.2
31192, 기흥구,005004, 3세,2017,4818,2445,2373,103,4793,2435,2358,103.3
31192, 기흥구,005005, 4세,2017,4919,2500,2419,103.3,4899,2493,2406,103.6
31192, 기흥구,010,5~9세,2017,26741,13783,12958,106.4,26669,13743,12926,106.3
31192, 기흥구,010001, 5세,2017,5560,2868,2692,106.5,5539,2860,2679,106.8
31192, 기흥구,010002, 6세,2017,5353,2738,2615,104.7,5338,2727,2611,104.4
31192, 기흥구,010003, 7세,2017,5272,2727,2545,107.2,5258,2720,2538,107.2
31192, 기흥구,010004, 8세,2017,5007,2602,2405,108.2,4989,2590,2399,108
31192, 기흥구,010005, 9세,2017,5549,2848,2701,105.4,5545,2846,2699,105.4
31192, 기흥구,015,10~14세,2017,24871,12767,12104,105.5,24838,12750,12088,105.5
31192, 기흥구,015001, 10세,2017,5613,2898,2715,106.7,5605,2891,2714,106.5
31192, 기흥구,015002, 11세,2017,4881,2569,2312,111.1,4876,2566,2310,111.1
31192, 기흥구,015003, 12세,2017,4744,2433,2311,105.3,4739,2431,2308,105.3
31192, 기흥구,015004, 13세,2017,4917,2472,2445,101.1,4909,2471,2438,101.4
31192, 기흥구,015005, 14세,2017,4716,2395,2321,103.2,4709,2391,2318,103.1
31192, 기흥구,020,15~19세,2017,25278,13043,12235,106.6,25116,12971,12145,106.8
31192, 기흥구,020001, 15세,2017,4570,2350,2220,105.9,4558,2343,2215,105.8
31192, 기흥구,020002, 16세,2017,4840,2538,2302,110.3,4830,2533,2297,110.3
31192, 기흥구,020003, 17세,2017,4984,2577,2407,107.1,4971,2571,2400,107.1
31192, 기흥구,020004, 18세,2017,5100,2602,2498,104.2,5059,2587,2472,104.7
31192, 기흥구,020005, 19세,2017,5784,2976,2808,106,5698,2937,2761,106.4
31192, 기흥구,025,20~24세,2017,28299,14363,13936,103.1,27360,13905,13455,103.3
31192, 기흥구,025001, 20세,2017,5556,2797,2759,101.4,5423,2738,2685,102
31192, 기흥구,025002, 21세,2017,5707,2909,2798,104,5527,2821,2706,104.2
31192, 기흥구,025003, 22세,2017,5601,2932,2669,109.9,5396,2833,2563,110.5
31192, 기흥구,025004, 23세,2017,5718,2885,2833,101.8,5506,2781,2725,102.1
31192, 기흥구,025005, 24세,2017,5717,2840,2877,98.7,5508,2732,2776,98.4
31192, 기흥구,030,25~29세,2017,23596,12257,11339,108.1,22658,11746,10912,107.6
31192, 기흥구,030001, 25세,2017,5360,2813,2547,110.4,5178,2717,2461,110.4
31192, 기흥구,030002, 26세,2017,4902,2601,2301,113,4720,2505,2215,113.1
31192, 기흥구,030003, 27세,2017,4638,2321,2317,100.2,4455,2218,2237,99.2
31192, 기흥구,030004, 28세,2017,4333,2229,2104,105.9,4137,2124,2013,105.5
31192, 기흥구,030005, 29세,2017,4363,2293,2070,110.8,4168,2182,1986,109.9
31192, 기흥구,035,30~34세,2017,25226,12259,12967,94.5,24421,11842,12579,94.1
31192, 기흥구,035001, 30세,2017,4229,2045,2184,93.6,4029,1937,2092,92.6
31192, 기흥구,035002, 31세,2017,4469,2240,2229,100.5,4305,2139,2166,98.8
31192, 기흥구,035003, 32세,2017,4875,2398,2477,96.8,4707,2316,2391,96.9
31192, 기흥구,035004, 33세,2017,5308,2545,2763,92.1,5172,2479,2693,92.1
31192, 기흥구,035005, 34세,2017,6345,3031,3314,91.5,6208,2971,3237,91.8
31192, 기흥구,040,35~39세,2017,38723,18553,20170,92,38097,18210,19887,91.6
31192, 기흥구,040001, 35세,2017,7315,3516,3799,92.6,7168,3425,3743,91.5
31192, 기흥구,040002, 36세,2017,7702,3702,4000,92.6,7583,3639,3944,92.3
31192, 기흥구,040003, 37세,2017,8295,4003,4292,93.3,8168,3938,4230,93.1
31192, 기흥구,040004, 38세,2017,8039,3834,4205,91.2,7921,3773,4148,91
31192, 기흥구,040005, 39세,2017,7372,3498,3874,90.3,7257,3435,3822,89.9
31192, 기흥구,045,40~44세,2017,41458,20522,20936,98,40927,20230,20697,97.7
31192, 기흥구,045001, 40세,2017,8044,3914,4130,94.8,7926,3849,4077,94.4
31192, 기흥구,045002, 41세,2017,7685,3829,3856,99.3,7595,3780,3815,99.1
31192, 기흥구,045003, 42세,2017,8148,3981,4167,95.5,8051,3934,4117,95.6
31192, 기흥구,045004, 43세,2017,8775,4397,4378,100.4,8676,4340,4336,100.1
31192, 기흥구,045005, 44세,2017,8806,4401,4405,99.9,8679,4327,4352,99.4
31192, 기흥구,050,45~49세,2017,40911,20752,20159,102.9,40304,20420,19884,102.7
31192, 기흥구,050001, 45세,2017,8537,4347,4190,103.7,8411,4274,4137,103.3
31192, 기흥구,050002, 46세,2017,8835,4530,4305,105.2,8709,4467,4242,105.3
31192, 기흥구,050003, 47세,2017,8394,4238,4156,102,8266,4167,4099,101.7
31192, 기흥구,050004, 48세,2017,7696,3899,3797,102.7,7592,3846,3746,102.7
31192, 기흥구,050005, 49세,2017,7449,3738,3711,100.7,7326,3666,3660,100.2
31192, 기흥구,055,50~54세,2017,29617,15232,14385,105.9,29037,14953,14084,106.2
31192, 기흥구,055001, 50세,2017,6728,3426,3302,103.8,6627,3376,3251,103.8
31192, 기흥구,055002, 51세,2017,5934,3032,2902,104.5,5821,2974,2847,104.5
31192, 기흥구,055003, 52세,2017,6049,3140,2909,107.9,5935,3080,2855,107.9
31192, 기흥구,055004, 53세,2017,5386,2786,2600,107.2,5267,2735,2532,108
31192, 기흥구,055005, 54세,2017,5520,2848,2672,106.6,5387,2788,2599,107.3
31192, 기흥구,060,55~59세,2017,24697,12306,12391,99.3,24224,12073,12151,99.4
31192, 기흥구,060001, 55세,2017,5190,2650,2540,104.3,5074,2592,2482,104.4
31192, 기흥구,060002, 56세,2017,5361,2718,2643,102.8,5292,2682,2610,102.8
31192, 기흥구,060003, 57세,2017,5048,2506,2542,98.6,4945,2459,2486,98.9
31192, 기흥구,060004, 58세,2017,4731,2336,2395,97.5,4633,2290,2343,97.7
31192, 기흥구,060005, 59세,2017,4367,2096,2271,92.3,4280,2050,2230,91.9
31192, 기흥구,065,60~64세,2017,18982,8826,10156,86.9,18559,8619,9940,86.7
31192, 기흥구,065001, 60세,2017,4198,1968,2230,88.3,4088,1919,2169,88.5
31192, 기흥구,065002, 61세,2017,3911,1840,2071,88.8,3820,1796,2024,88.7
31192, 기흥구,065003, 62세,2017,4041,1904,2137,89.1,3956,1865,2091,89.2
31192, 기흥구,065004, 63세,2017,3593,1650,1943,84.9,3513,1607,1906,84.3
31192, 기흥구,065005, 64세,2017,3239,1464,1775,82.5,3182,1432,1750,81.8
31192, 기흥구,070,65~69세,2017,14688,6569,8119,80.9,14511,6491,8020,80.9
31192, 기흥구,070001, 65세,2017,3541,1593,1948,81.8,3499,1572,1927,81.6
31192, 기흥구,070002, 66세,2017,2511,1122,1389,80.8,2471,1105,1366,80.9
31192, 기흥구,070003, 67세,2017,2801,1252,1549,80.8,2760,1236,1524,81.1
31192, 기흥구,070004, 68세,2017,2906,1276,1630,78.3,2874,1262,1612,78.3
31192, 기흥구,070005, 69세,2017,2929,1326,1603,82.7,2907,1316,1591,82.7
31192, 기흥구,075,70~74세,2017,12530,5727,6803,84.2,12461,5697,6764,84.2
31192, 기흥구,075001, 70세,2017,3164,1404,1760,79.8,3141,1390,1751,79.4
31192, 기흥구,075002, 71세,2017,2568,1181,1387,85.1,2552,1175,1377,85.3
31192, 기흥구,075003, 72세,2017,2312,1080,1232,87.7,2304,1076,1228,87.6
31192, 기흥구,075004, 73세,2017,2234,1016,1218,83.4,2224,1013,1211,83.6
31192, 기흥구,075005, 74세,2017,2252,1046,1206,86.7,2240,1043,1197,87.1
31192, 기흥구,080,75~79세,2017,9782,4623,5159,89.6,9740,4603,5137,89.6
31192, 기흥구,080001, 75세,2017,2530,1201,1329,90.4,2515,1196,1319,90.7
31192, 기흥구,080002, 76세,2017,2167,1053,1114,94.5,2159,1049,1110,94.5
31192, 기흥구,080003, 77세,2017,1812,857,955,89.7,1801,852,949,89.8
31192, 기흥구,080004, 78세,2017,1736,794,942,84.3,1730,789,941,83.8
31192, 기흥구,080005, 79세,2017,1537,718,819,87.7,1535,717,818,87.7
31192, 기흥구,085,80~84세,2017,5448,2263,3185,71.1,5428,2257,3171,71.2
31192, 기흥구,085001, 80세,2017,1350,604,746,81,1345,602,743,81
31192, 기흥구,085002, 81세,2017,1220,527,693,76,1216,526,690,76.2
31192, 기흥구,085003, 82세,2017,1104,455,649,70.1,1102,454,648,70.1
31192, 기흥구,085004, 83세,2017,973,389,584,66.6,969,389,580,67.1
31192, 기흥구,085005, 84세,2017,801,288,513,56.1,796,286,510,56.1
31192, 기흥구,090,85~89세,2017,2641,887,1754,50.6,2628,885,1743,50.8
31192, 기흥구,090001, 85세,2017,674,268,406,66,671,268,403,66.5
31192, 기흥구,090002, 86세,2017,569,184,385,47.8,566,184,382,48.2
31192, 기흥구,090003, 87세,2017,555,188,367,51.2,553,187,366,51.1
31192, 기흥구,090004, 88세,2017,489,144,345,41.7,487,143,344,41.6
31192, 기흥구,090005, 89세,2017,354,103,251,41,351,103,248,41.5
31192, 기흥구,095,90~94세,2017,1029,275,754,36.5,1027,275,752,36.6
31192, 기흥구,095001, 90세,2017,337,88,249,35.3,337,88,249,35.3
31192, 기흥구,095002, 91세,2017,226,63,163,38.7,226,63,163,38.7
31192, 기흥구,095003, 92세,2017,188,39,149,26.2,186,39,147,26.5
31192, 기흥구,095004, 93세,2017,148,39,109,35.8,148,39,109,35.8
31192, 기흥구,095005, 94세,2017,130,46,84,54.8,130,46,84,54.8
31192, 기흥구,100,95~99세,2017,266,53,213,24.9,266,53,213,24.9
31192, 기흥구,100001, 95세,2017,106,17,89,19.1,106,17,89,19.1
31192, 기흥구,100002, 96세,2017,60,19,41,46.3,60,19,41,46.3
31192, 기흥구,100003, 97세,2017,42,5,37,13.5,42,5,37,13.5
31192, 기흥구,100004, 98세,2017,37,9,28,32.1,37,9,28,32.1
31192, 기흥구,100005, 99세,2017,21,X,18,16.7,21,X,18,16.7
31192, 기흥구,101,100세이상,2017,43,X,39,10.3,42,X,39,7.7
31192, 기흥구,102,15세미만,2017,73532,37756,35776,105.5,73306,37639,35667,105.5
31192, 기흥구,103,15~64세,2017,296787,148113,148674,99.6,290703,144969,145734,99.5
31192, 기흥구,104,65세이상,2017,46427,20401,26026,78.4,46103,20264,25839,78.4
31192, 기흥구,086,85세이상,2017,3979,1219,2760,44.2,3963,1216,2747,44.3
31192, 기흥구,126,평균연령,2017,38.1,37.3,38.9,,38.1,37.3,38.9,
31192, 기흥구,127,중위연령,2017,39.1,38.6,39.7,,39.2,38.6,39.7,
31193, 수지구,000,합계,2017,338993,165644,173349,95.6,334945,163808,171137,95.7
31193, 수지구,005,0~4세,2017,16453,8451,8002,105.6,16370,8402,7968,105.4
31193, 수지구,005001, 0세,2017,2592,1337,1255,106.5,2577,1325,1252,105.8
31193, 수지구,005002, 1세,2017,3064,1576,1488,105.9,3045,1567,1478,106
31193, 수지구,005003, 2세,2017,3428,1755,1673,104.9,3413,1747,1666,104.9
31193, 수지구,005004, 3세,2017,3580,1828,1752,104.3,3563,1817,1746,104.1
31193, 수지구,005005, 4세,2017,3789,1955,1834,106.6,3772,1946,1826,106.6
31193, 수지구,010,5~9세,2017,20515,10569,9946,106.3,20458,10542,9916,106.3
31193, 수지구,010001, 5세,2017,4049,2097,1952,107.4,4036,2093,1943,107.7
31193, 수지구,010002, 6세,2017,4079,2098,1981,105.9,4069,2094,1975,106
31193, 수지구,010003, 7세,2017,4061,2081,1980,105.1,4048,2074,1974,105.1
31193, 수지구,010004, 8세,2017,4062,2101,1961,107.1,4049,2094,1955,107.1
31193, 수지구,010005, 9세,2017,4264,2192,2072,105.8,4256,2187,2069,105.7
31193, 수지구,015,10~14세,2017,20759,10613,10146,104.6,20732,10598,10134,104.6
31193, 수지구,015001, 10세,2017,4276,2176,2100,103.6,4269,2170,2099,103.4
31193, 수지구,015002, 11세,2017,4075,2063,2012,102.5,4072,2061,2011,102.5
31193, 수지구,015003, 12세,2017,3908,2034,1874,108.5,3901,2031,1870,108.6
31193, 수지구,015004, 13세,2017,4284,2169,2115,102.6,4279,2167,2112,102.6
31193, 수지구,015005, 14세,2017,4216,2171,2045,106.2,4211,2169,2042,106.2
31193, 수지구,020,15~19세,2017,21710,11044,10666,103.5,21530,10983,10547,104.1
31193, 수지구,020001, 15세,2017,4174,2167,2007,108,4164,2161,2003,107.9
31193, 수지구,020002, 16세,2017,4356,2184,2172,100.6,4346,2180,2166,100.6
31193, 수지구,020003, 17세,2017,4572,2322,2250,103.2,4556,2319,2237,103.7
31193, 수지구,020004, 18세,2017,4297,2187,2110,103.6,4253,2180,2073,105.2
31193, 수지구,020005, 19세,2017,4311,2184,2127,102.7,4211,2143,2068,103.6
31193, 수지구,025,20~24세,2017,20983,10662,10321,103.3,20339,10383,9956,104.3
31193, 수지구,025001, 20세,2017,4283,2166,2117,102.3,4134,2101,2033,103.3
31193, 수지구,025002, 21세,2017,4181,2185,1996,109.5,4043,2127,1916,111
31193, 수지구,025003, 22세,2017,4132,2139,1993,107.3,4006,2085,1921,108.5
31193, 수지구,025004, 23세,2017,4286,2169,2117,102.5,4162,2117,2045,103.5
31193, 수지구,025005, 24세,2017,4101,2003,2098,95.5,3994,1953,2041,95.7
31193, 수지구,030,25~29세,2017,18463,9177,9286,98.8,17991,8943,9048,98.8
31193, 수지구,030001, 25세,2017,4142,2068,2074,99.7,4036,2025,2011,100.7
31193, 수지구,030002, 26세,2017,3850,1956,1894,103.3,3756,1909,1847,103.4
31193, 수지구,030003, 27세,2017,3528,1737,1791,97,3446,1695,1751,96.8
31193, 수지구,030004, 28세,2017,3527,1705,1822,93.6,3433,1653,1780,92.9
31193, 수지구,030005, 29세,2017,3416,1711,1705,100.4,3320,1661,1659,100.1
31193, 수지구,035,30~34세,2017,19756,9258,10498,88.2,19322,9043,10279,88
31193, 수지구,035001, 30세,2017,3428,1646,1782,92.4,3322,1595,1727,92.4
31193, 수지구,035002, 31세,2017,3533,1699,1834,92.6,3453,1657,1796,92.3
31193, 수지구,035003, 32세,2017,3815,1743,2072,84.1,3738,1704,2034,83.8
31193, 수지구,035004, 33세,2017,4138,1921,2217,86.6,4057,1876,2181,86
31193, 수지구,035005, 34세,2017,4842,2249,2593,86.7,4752,2211,2541,87
31193, 수지구,040,35~39세,2017,29314,13689,15625,87.6,28912,13489,15423,87.5
31193, 수지구,040001, 35세,2017,5482,2638,2844,92.8,5384,2592,2792,92.8
31193, 수지구,040002, 36세,2017,5892,2834,3058,92.7,5803,2787,3016,92.4
31193, 수지구,040003, 37세,2017,6095,2798,3297,84.9,6015,2761,3254,84.8
31193, 수지구,040004, 38세,2017,6150,2766,3384,81.7,6081,2730,3351,81.5
31193, 수지구,040005, 39세,2017,5695,2653,3042,87.2,5629,2619,3010,87
31193, 수지구,045,40~44세,2017,33506,15939,17567,90.7,33151,15768,17383,90.7
31193, 수지구,045001, 40세,2017,6342,2926,3416,85.7,6275,2897,3378,85.8
31193, 수지구,045002, 41세,2017,6369,3018,3351,90.1,6303,2982,3321,89.8
31193, 수지구,045003, 42세,2017,6608,3187,3421,93.2,6539,3147,3392,92.8
31193, 수지구,045004, 43세,2017,7285,3505,3780,92.7,7213,3475,3738,93
31193, 수지구,045005, 44세,2017,6902,3303,3599,91.8,6821,3267,3554,91.9
31193, 수지구,050,45~49세,2017,35207,17438,17769,98.1,34855,17283,17572,98.4
31193, 수지구,050001, 45세,2017,7253,3542,3711,95.4,7189,3511,3678,95.5
31193, 수지구,050002, 46세,2017,7633,3801,3832,99.2,7566,3767,3799,99.2
31193, 수지구,050003, 47세,2017,7023,3436,3587,95.8,6950,3405,3545,96.1
31193, 수지구,050004, 48세,2017,6901,3466,3435,100.9,6825,3435,3390,101.3
31193, 수지구,050005, 49세,2017,6397,3193,3204,99.7,6325,3165,3160,100.2
31193, 수지구,055,50~54세,2017,25178,12971,12207,106.3,24858,12837,12021,106.8
31193, 수지구,055001, 50세,2017,5593,2811,2782,101,5532,2782,2750,101.2
31193, 수지구,055002, 51세,2017,4990,2546,2444,104.2,4924,2519,2405,104.7
31193, 수지구,055003, 52세,2017,5037,2627,2410,109,4983,2608,2375,109.8
31193, 수지구,055004, 53세,2017,4851,2518,2333,107.9,4783,2487,2296,108.3
31193, 수지구,055005, 54세,2017,4707,2469,2238,110.3,4636,2441,2195,111.2
31193, 수지구,060,55~59세,2017,20389,10332,10057,102.7,20107,10213,9894,103.2
31193, 수지구,060001, 55세,2017,4295,2262,2033,111.3,4228,2232,1996,111.8
31193, 수지구,060002, 56세,2017,4478,2247,2231,100.7,4428,2228,2200,101.3
31193, 수지구,060003, 57세,2017,4290,2166,2124,102,4232,2147,2085,103
31193, 수지구,060004, 58세,2017,3764,1859,1905,97.6,3705,1828,1877,97.4
31193, 수지구,060005, 59세,2017,3562,1798,1764,101.9,3514,1778,1736,102.4
31193, 수지구,065,60~64세,2017,15889,7247,8642,83.9,15655,7153,8502,84.1
31193, 수지구,065001, 60세,2017,3509,1684,1825,92.3,3451,1661,1790,92.8
31193, 수지구,065002, 61세,2017,3144,1417,1727,82,3091,1396,1695,82.4
31193, 수지구,065003, 62세,2017,3491,1604,1887,85,3450,1589,1861,85.4
31193, 수지구,065004, 63세,2017,2955,1338,1617,82.7,2912,1315,1597,82.3
31193, 수지구,065005, 64세,2017,2790,1204,1586,75.9,2751,1192,1559,76.5
31193, 수지구,070,65~69세,2017,12949,5754,7195,80,12844,5713,7131,80.1
31193, 수지구,070001, 65세,2017,2979,1330,1649,80.7,2939,1316,1623,81.1
31193, 수지구,070002, 66세,2017,2079,901,1178,76.5,2063,893,1170,76.3
31193, 수지구,070003, 67세,2017,2563,1146,1417,80.9,2547,1142,1405,81.3
31193, 수지구,070004, 68세,2017,2640,1204,1436,83.8,2620,1197,1423,84.1
31193, 수지구,070005, 69세,2017,2688,1173,1515,77.4,2675,1165,1510,77.2
31193, 수지구,075,70~74세,2017,11360,5153,6207,83,11321,5140,6181,83.2
31193, 수지구,075001, 70세,2017,2800,1181,1619,72.9,2785,1175,1610,73
31193, 수지구,075002, 71세,2017,2291,1014,1277,79.4,2287,1012,1275,79.4
31193, 수지구,075003, 72세,2017,2210,1024,1186,86.3,2205,1023,1182,86.5
31193, 수지구,075004, 73세,2017,2038,963,1075,89.6,2028,959,1069,89.7
31193, 수지구,075005, 74세,2017,2021,971,1050,92.5,2016,971,1045,92.9
31193, 수지구,080,75~79세,2017,8759,4380,4379,100,8731,4364,4367,99.9
31193, 수지구,080001, 75세,2017,2313,1123,1190,94.4,2304,1120,1184,94.6
31193, 수지구,080002, 76세,2017,1894,967,927,104.3,1890,965,925,104.3
31193, 수지구,080003, 77세,2017,1659,833,826,100.8,1656,831,825,100.7
31193, 수지구,080004, 78세,2017,1524,772,752,102.7,1520,770,750,102.7
31193, 수지구,080005, 79세,2017,1369,685,684,100.1,1361,678,683,99.3
31193, 수지구,085,80~84세,2017,4677,2005,2672,75,4659,1997,2662,75
31193, 수지구,085001, 80세,2017,1264,576,688,83.7,1262,575,687,83.7
31193, 수지구,085002, 81세,2017,1012,432,580,74.5,1009,430,579,74.3
31193, 수지구,085003, 82세,2017,958,425,533,79.7,955,423,532,79.5
31193, 수지구,085004, 83세,2017,782,325,457,71.1,778,324,454,71.4
31193, 수지구,085005, 84세,2017,661,247,414,59.7,655,245,410,59.8
31193, 수지구,090,85~89세,2017,2160,722,1438,50.2,2151,719,1432,50.2
31193, 수지구,090001, 85세,2017,605,237,368,64.4,603,236,367,64.3
31193, 수지구,090002, 86세,2017,447,143,304,47,446,142,304,46.7
31193, 수지구,090003, 87세,2017,389,134,255,52.5,389,134,255,52.5
31193, 수지구,090004, 88세,2017,395,113,282,40.1,391,113,278,40.6
31193, 수지구,090005, 89세,2017,324,95,229,41.5,322,94,228,41.2
31193, 수지구,095,90~94세,2017,746,192,554,34.7,739,190,549,34.6
31193, 수지구,095001, 90세,2017,211,60,151,39.7,209,60,149,40.3
31193, 수지구,095002, 91세,2017,185,53,132,40.2,182,52,130,40
31193, 수지구,095003, 92세,2017,149,30,119,25.2,149,30,119,25.2
31193, 수지구,095004, 93세,2017,106,28,78,35.9,105,28,77,36.4
31193, 수지구,095005, 94세,2017,95,21,74,28.4,94,20,74,27
31193, 수지구,100,95~99세,2017,196,46,150,30.7,196,46,150,30.7
31193, 수지구,100001, 95세,2017,83,26,57,45.6,83,26,57,45.6
31193, 수지구,100002, 96세,2017,50,11,39,28.2,50,11,39,28.2
31193, 수지구,100003, 97세,2017,34,X,30,13.3,34,X,30,13.3
31193, 수지구,100004, 98세,2017,20,X,17,17.6,20,X,17,17.6
31193, 수지구,100005, 99세,2017,9,X,7,28.6,9,X,7,28.6
31193, 수지구,101,100세이상,2017,24,X,22,9.1,24,X,22,9.1
31193, 수지구,102,15세미만,2017,57727,29633,28094,105.5,57560,29542,28018,105.4
31193, 수지구,103,15~64세,2017,240395,117757,122638,96,236720,116095,120625,96.2
31193, 수지구,104,65세이상,2017,40871,18254,22617,80.7,40665,18171,22494,80.8
31193, 수지구,086,85세이상,2017,3126,962,2164,44.5,3110,957,2153,44.4
31193, 수지구,126,평균연령,2017,38.9,38.1,39.6,,38.9,38.1,39.6,
31193, 수지구,127,중위연령,2017,40.2,39.8,40.6,,40.3,39.8,40.7,
31200, 파주시,000,합계,2017,430650,220786,209864,105.2,416933,211315,205618,102.8
31200, 파주시,005,0~4세,2017,21584,10978,10606,103.5,21471,10916,10555,103.4
31200, 파주시,005001, 0세,2017,3568,1780,1788,99.6,3539,1765,1774,99.5
31200, 파주시,005002, 1세,2017,4201,2189,2012,108.8,4171,2174,1997,108.9
31200, 파주시,005003, 2세,2017,4474,2265,2209,102.5,4452,2251,2201,102.3
31200, 파주시,005004, 3세,2017,4684,2400,2284,105.1,4668,2391,2277,105
31200, 파주시,005005, 4세,2017,4657,2344,2313,101.3,4641,2335,2306,101.3
31200, 파주시,010,5~9세,2017,24472,12542,11930,105.1,24413,12509,11904,105.1
31200, 파주시,010001, 5세,2017,5114,2622,2492,105.2,5103,2617,2486,105.3
31200, 파주시,010002, 6세,2017,4962,2538,2424,104.7,4956,2534,2422,104.6
31200, 파주시,010003, 7세,2017,4924,2457,2467,99.6,4913,2452,2461,99.6
31200, 파주시,010004, 8세,2017,4582,2407,2175,110.7,4565,2396,2169,110.5
31200, 파주시,010005, 9세,2017,4890,2518,2372,106.2,4876,2510,2366,106.1
31200, 파주시,015,10~14세,2017,22489,11595,10894,106.4,22444,11570,10874,106.4
31200, 파주시,015001, 10세,2017,4916,2496,2420,103.1,4908,2493,2415,103.2
31200, 파주시,015002, 11세,2017,4361,2209,2152,102.6,4351,2203,2148,102.6
31200, 파주시,015003, 12세,2017,4233,2194,2039,107.6,4222,2187,2035,107.5
31200, 파주시,015004, 13세,2017,4479,2344,2135,109.8,4471,2341,2130,109.9
31200, 파주시,015005, 14세,2017,4500,2352,2148,109.5,4492,2346,2146,109.3
31200, 파주시,020,15~19세,2017,24412,12513,11899,105.2,24329,12456,11873,104.9
31200, 파주시,020001, 15세,2017,4491,2341,2150,108.9,4485,2336,2149,108.7
31200, 파주시,020002, 16세,2017,5139,2629,2510,104.7,5130,2625,2505,104.8
31200, 파주시,020003, 17세,2017,5620,2827,2793,101.2,5608,2819,2789,101.1
31200, 파주시,020004, 18세,2017,5004,2543,2461,103.3,4986,2530,2456,103
31200, 파주시,020005, 19세,2017,4158,2173,1985,109.5,4120,2146,1974,108.7
31200, 파주시,025,20~24세,2017,25233,13635,11598,117.6,23686,12398,11288,109.8
31200, 파주시,025001, 20세,2017,4400,2382,2018,118,4331,2333,1998,116.8
31200, 파주시,025002, 21세,2017,4626,2646,1980,133.6,4441,2500,1941,128.8
31200, 파주시,025003, 22세,2017,4938,2735,2203,124.1,4610,2469,2141,115.3
31200, 파주시,025004, 23세,2017,5498,2907,2591,112.2,5063,2552,2511,101.6
31200, 파주시,025005, 24세,2017,5771,2965,2806,105.7,5241,2544,2697,94.3
31200, 파주시,030,25~29세,2017,29045,15988,13057,122.4,26336,13985,12351,113.2
31200, 파주시,030001, 25세,2017,6059,3178,2881,110.3,5545,2772,2773,100
31200, 파주시,030002, 26세,2017,5798,3059,2739,111.7,5259,2654,2605,101.9
31200, 파주시,030003, 27세,2017,5536,3070,2466,124.5,4964,2653,2311,114.8
31200, 파주시,030004, 28세,2017,5719,3299,2420,136.3,5178,2914,2264,128.7
31200, 파주시,030005, 29세,2017,5933,3382,2551,132.6,5390,2992,2398,124.8
31200, 파주시,035,30~34세,2017,32262,18271,13991,130.6,29676,16394,13282,123.4
31200, 파주시,035001, 30세,2017,6128,3530,2598,135.9,5571,3132,2439,128.4
31200, 파주시,035002, 31세,2017,6202,3610,2592,139.3,5699,3258,2441,133.5
31200, 파주시,035003, 32세,2017,6463,3738,2725,137.2,5935,3355,2580,130
31200, 파주시,035004, 33세,2017,6342,3488,2854,122.2,5828,3105,2723,114
31200, 파주시,035005, 34세,2017,7127,3905,3222,121.2,6643,3544,3099,114.4
31200, 파주시,040,35~39세,2017,37449,19881,17568,113.2,35454,18395,17059,107.8
31200, 파주시,040001, 35세,2017,7632,4176,3456,120.8,7169,3821,3348,114.1
31200, 파주시,040002, 36세,2017,7727,4151,3576,116.1,7280,3801,3479,109.3
31200, 파주시,040003, 37세,2017,7950,4202,3748,112.1,7568,3937,3631,108.4
31200, 파주시,040004, 38세,2017,7303,3801,3502,108.5,6942,3541,3401,104.1
31200, 파주시,040005, 39세,2017,6837,3551,3286,108.1,6495,3295,3200,103
31200, 파주시,045,40~44세,2017,37047,18945,18102,104.7,35742,18059,17683,102.1
31200, 파주시,045001, 40세,2017,7148,3665,3483,105.2,6841,3451,3390,101.8
31200, 파주시,045002, 41세,2017,7006,3615,3391,106.6,6693,3398,3295,103.1
31200, 파주시,045003, 42세,2017,7121,3593,3528,101.8,6877,3431,3446,99.6
31200, 파주시,045004, 43세,2017,7773,3969,3804,104.3,7537,3816,3721,102.6
31200, 파주시,045005, 44세,2017,7999,4103,3896,105.3,7794,3963,3831,103.4
31200, 파주시,050,45~49세,2017,39279,20676,18603,111.1,38151,20001,18150,110.2
31200, 파주시,050001, 45세,2017,8131,4284,3847,111.4,7920,4146,3774,109.9
31200, 파주시,050002, 46세,2017,8406,4417,3989,110.7,8166,4274,3892,109.8
31200, 파주시,050003, 47세,2017,7854,4156,3698,112.4,7599,3996,3603,110.9
31200, 파주시,050004, 48세,2017,7411,3891,3520,110.5,7197,3782,3415,110.7
31200, 파주시,050005, 49세,2017,7477,3928,3549,110.7,7269,3803,3466,109.7
31200, 파주시,055,50~54세,2017,31959,16810,15149,111,31094,16323,14771,110.5
31200, 파주시,055001, 50세,2017,6615,3456,3159,109.4,6436,3355,3081,108.9
31200, 파주시,055002, 51세,2017,6481,3471,3010,115.3,6304,3373,2931,115.1
31200, 파주시,055003, 52세,2017,6481,3385,3096,109.3,6293,3273,3020,108.4
31200, 파주시,055004, 53세,2017,6038,3162,2876,109.9,5874,3069,2805,109.4
31200, 파주시,055005, 54세,2017,6344,3336,3008,110.9,6187,3253,2934,110.9
31200, 파주시,060,55~59세,2017,30411,15609,14802,105.5,29852,15324,14528,105.5
31200, 파주시,060001, 55세,2017,6437,3408,3029,112.5,6294,3337,2957,112.9
31200, 파주시,060002, 56세,2017,6632,3380,3252,103.9,6543,3334,3209,103.9
31200, 파주시,060003, 57세,2017,6152,3152,3000,105.1,6040,3100,2940,105.4
31200, 파주시,060004, 58세,2017,5712,2899,2813,103.1,5599,2833,2766,102.4
31200, 파주시,060005, 59세,2017,5478,2770,2708,102.3,5376,2720,2656,102.4
31200, 파주시,065,60~64세,2017,22051,10950,11101,98.6,21679,10756,10923,98.5
31200, 파주시,065001, 60세,2017,5280,2686,2594,103.5,5188,2633,2555,103.1
31200, 파주시,065002, 61세,2017,4623,2289,2334,98.1,4551,2251,2300,97.9
31200, 파주시,065003, 62세,2017,4737,2321,2416,96.1,4655,2278,2377,95.8
31200, 파주시,065004, 63세,2017,3910,1949,1961,99.4,3844,1913,1931,99.1
31200, 파주시,065005, 64세,2017,3501,1705,1796,94.9,3441,1681,1760,95.5
31200, 파주시,070,65~69세,2017,15349,7091,8258,85.9,15151,6989,8162,85.6
31200, 파주시,070001, 65세,2017,3695,1767,1928,91.6,3632,1730,1902,91
31200, 파주시,070002, 66세,2017,2471,1131,1340,84.4,2441,1113,1328,83.8
31200, 파주시,070003, 67세,2017,2930,1339,1591,84.2,2890,1320,1570,84.1
31200, 파주시,070004, 68세,2017,3129,1427,1702,83.8,3092,1413,1679,84.2
31200, 파주시,070005, 69세,2017,3124,1427,1697,84.1,3096,1413,1683,84
31200, 파주시,075,70~74세,2017,13397,5975,7422,80.5,13329,5944,7385,80.5
31200, 파주시,075001, 70세,2017,3142,1475,1667,88.5,3114,1459,1655,88.2
31200, 파주시,075002, 71세,2017,2554,1163,1391,83.6,2541,1159,1382,83.9
31200, 파주시,075003, 72세,2017,2513,1125,1388,81.1,2505,1122,1383,81.1
31200, 파주시,075004, 73세,2017,2538,1092,1446,75.5,2532,1088,1444,75.3
31200, 파주시,075005, 74세,2017,2650,1120,1530,73.2,2637,1116,1521,73.4
31200, 파주시,080,75~79세,2017,12143,5127,7016,73.1,12093,5110,6983,73.2
31200, 파주시,080001, 75세,2017,2996,1353,1643,82.3,2984,1350,1634,82.6
31200, 파주시,080002, 76세,2017,2567,1093,1474,74.2,2555,1086,1469,73.9
31200, 파주시,080003, 77세,2017,2300,975,1325,73.6,2293,973,1320,73.7
31200, 파주시,080004, 78세,2017,2186,909,1277,71.2,2178,907,1271,71.4
31200, 파주시,080005, 79세,2017,2094,797,1297,61.4,2083,794,1289,61.6
31200, 파주시,085,80~84세,2017,7227,2786,4441,62.7,7203,2774,4429,62.6
31200, 파주시,085001, 80세,2017,1814,752,1062,70.8,1808,750,1058,70.9
31200, 파주시,085002, 81세,2017,1651,647,1004,64.4,1645,646,999,64.7
31200, 파주시,085003, 82세,2017,1493,582,911,63.9,1488,578,910,63.5
31200, 파주시,085004, 83세,2017,1217,446,771,57.8,1210,441,769,57.3
31200, 파주시,085005, 84세,2017,1052,359,693,51.8,1052,359,693,51.8
31200, 파주시,090,85~89세,2017,3408,1071,2337,45.8,3399,1069,2330,45.9
31200, 파주시,090001, 85세,2017,949,322,627,51.4,947,321,626,51.3
31200, 파주시,090002, 86세,2017,742,236,506,46.6,740,235,505,46.5
31200, 파주시,090003, 87세,2017,655,213,442,48.2,655,213,442,48.2
31200, 파주시,090004, 88세,2017,604,181,423,42.8,600,181,419,43.2
31200, 파주시,090005, 89세,2017,458,119,339,35.1,457,119,338,35.2
31200, 파주시,095,90~94세,2017,1121,255,866,29.4,1119,255,864,29.5
31200, 파주시,095001, 90세,2017,367,82,285,28.8,367,82,285,28.8
31200, 파주시,095002, 91세,2017,253,65,188,34.6,253,65,188,34.6
31200, 파주시,095003, 92세,2017,189,28,161,17.4,188,28,160,17.5
31200, 파주시,095004, 93세,2017,168,39,129,30.2,168,39,129,30.2
31200, 파주시,095005, 94세,2017,144,41,103,39.8,143,41,102,40.2
31200, 파주시,100,95~99세,2017,270,78,192,40.6,270,78,192,40.6
31200, 파주시,100001, 95세,2017,107,27,80,33.8,107,27,80,33.8
31200, 파주시,100002, 96세,2017,62,17,45,37.8,62,17,45,37.8
31200, 파주시,100003, 97세,2017,53,21,32,65.6,53,21,32,65.6
31200, 파주시,100004, 98세,2017,35,11,24,45.8,35,11,24,45.8
31200, 파주시,100005, 99세,2017,13,X,11,18.2,13,X,11,18.2
31200, 파주시,101,100세이상,2017,42,10,32,31.3,42,10,32,31.3
31200, 파주시,102,15세미만,2017,68545,35115,33430,105,68328,34995,33333,105
31200, 파주시,103,15~64세,2017,309148,163278,145870,111.9,295999,154091,141908,108.6
31200, 파주시,104,65세이상,2017,52957,22393,30564,73.3,52606,22229,30377,73.2
31200, 파주시,086,85세이상,2017,4841,1414,3427,41.3,4830,1412,3418,41.3
31200, 파주시,126,평균연령,2017,39.4,38.4,40.5,,39.5,38.5,40.5,
31200, 파주시,127,중위연령,2017,39.8,38.6,41,,40.1,39.1,41.1,
31210, 이천시,000,합계,2017,218798,112606,106192,106,209949,107286,102663,104.5
31210, 이천시,005,0~4세,2017,10457,5415,5042,107.4,10384,5377,5007,107.4
31210, 이천시,005001, 0세,2017,1843,983,860,114.3,1828,973,855,113.8
31210, 이천시,005002, 1세,2017,2037,1054,983,107.2,2029,1051,978,107.5
31210, 이천시,005003, 2세,2017,2241,1147,1094,104.8,2227,1140,1087,104.9
31210, 이천시,005004, 3세,2017,2154,1141,1013,112.6,2143,1134,1009,112.4
31210, 이천시,005005, 4세,2017,2182,1090,1092,99.8,2157,1079,1078,100.1
31210, 이천시,010,5~9세,2017,11160,5806,5354,108.4,11124,5782,5342,108.2
31210, 이천시,010001, 5세,2017,2330,1185,1145,103.5,2318,1175,1143,102.8
31210, 이천시,010002, 6세,2017,2319,1215,1104,110.1,2316,1213,1103,110
31210, 이천시,010003, 7세,2017,2206,1168,1038,112.5,2196,1161,1035,112.2
31210, 이천시,010004, 8세,2017,2077,1078,999,107.9,2068,1074,994,108
31210, 이천시,010005, 9세,2017,2228,1160,1068,108.6,2226,1159,1067,108.6
31210, 이천시,015,10~14세,2017,10748,5527,5221,105.9,10727,5519,5208,106
31210, 이천시,015001, 10세,2017,2262,1141,1121,101.8,2257,1140,1117,102.1
31210, 이천시,015002, 11세,2017,2118,1108,1010,109.7,2114,1105,1009,109.5
31210, 이천시,015003, 12세,2017,2055,1066,989,107.8,2051,1065,986,108
31210, 이천시,015004, 13세,2017,2183,1123,1060,105.9,2180,1123,1057,106.2
31210, 이천시,015005, 14세,2017,2130,1089,1041,104.6,2125,1086,1039,104.5
31210, 이천시,020,15~19세,2017,13801,7271,6530,111.3,13744,7235,6509,111.2
31210, 이천시,020001, 15세,2017,2323,1225,1098,111.6,2317,1220,1097,111.2
31210, 이천시,020002, 16세,2017,2521,1272,1249,101.8,2511,1265,1246,101.5
31210, 이천시,020003, 17세,2017,2738,1397,1341,104.2,2736,1397,1339,104.3
31210, 이천시,020004, 18세,2017,2943,1583,1360,116.4,2928,1571,1357,115.8
31210, 이천시,020005, 19세,2017,3276,1794,1482,121.1,3252,1782,1470,121.2
31210, 이천시,025,20~24세,2017,14565,7787,6778,114.9,13520,7169,6351,112.9
31210, 이천시,025001, 20세,2017,2718,1440,1278,112.7,2659,1404,1255,111.9
31210, 이천시,025002, 21세,2017,2828,1553,1275,121.8,2675,1464,1211,120.9
31210, 이천시,025003, 22세,2017,2778,1495,1283,116.5,2581,1377,1204,114.4
31210, 이천시,025004, 23세,2017,2965,1538,1427,107.8,2702,1394,1308,106.6
31210, 이천시,025005, 24세,2017,3276,1761,1515,116.2,2903,1530,1373,111.4
31210, 이천시,030,25~29세,2017,16866,9347,7519,124.3,14612,7935,6677,118.8
31210, 이천시,030001, 25세,2017,3612,2014,1598,126,3147,1730,1417,122.1
31210, 이천시,030002, 26세,2017,3241,1833,1408,130.2,2812,1563,1249,125.1
31210, 이천시,030003, 27세,2017,3394,1905,1489,127.9,2901,1610,1291,124.7
31210, 이천시,030004, 28세,2017,3430,1915,1515,126.4,2980,1615,1365,118.3
31210, 이천시,030005, 29세,2017,3189,1680,1509,111.3,2772,1417,1355,104.6
31210, 이천시,035,30~34세,2017,16052,8529,7523,113.4,14519,7533,6986,107.8
31210, 이천시,035001, 30세,2017,3178,1688,1490,113.3,2813,1448,1365,106.1
31210, 이천시,035002, 31세,2017,3077,1646,1431,115,2739,1417,1322,107.2
31210, 이천시,035003, 32세,2017,3195,1641,1554,105.6,2894,1454,1440,101
31210, 이천시,035004, 33세,2017,3210,1737,1473,117.9,2932,1548,1384,111.8
31210, 이천시,035005, 34세,2017,3392,1817,1575,115.4,3141,1666,1475,112.9
31210, 이천시,040,35~39세,2017,18099,9691,8408,115.3,17047,9043,8004,113
31210, 이천시,040001, 35세,2017,3829,2132,1697,125.6,3566,1980,1586,124.8
31210, 이천시,040002, 36세,2017,3624,2008,1616,124.3,3417,1881,1536,122.5
31210, 이천시,040003, 37세,2017,3614,1939,1675,115.8,3420,1815,1605,113.1
31210, 이천시,040004, 38세,2017,3513,1817,1696,107.1,3309,1690,1619,104.4
31210, 이천시,040005, 39세,2017,3519,1795,1724,104.1,3335,1677,1658,101.1
31210, 이천시,045,40~44세,2017,17355,8836,8519,103.7,16667,8414,8253,102
31210, 이천시,045001, 40세,2017,3406,1687,1719,98.1,3252,1583,1669,94.8
31210, 이천시,045002, 41세,2017,3396,1691,1705,99.2,3239,1590,1649,96.4
31210, 이천시,045003, 42세,2017,3320,1706,1614,105.7,3208,1638,1570,104.3
31210, 이천시,045004, 43세,2017,3663,1910,1753,109,3520,1826,1694,107.8
31210, 이천시,045005, 44세,2017,3570,1842,1728,106.6,3448,1777,1671,106.3
31210, 이천시,050,45~49세,2017,18229,9593,8636,111.1,17570,9221,8349,110.4
31210, 이천시,050001, 45세,2017,3526,1889,1637,115.4,3395,1814,1581,114.7
31210, 이천시,050002, 46세,2017,3660,1958,1702,115,3521,1875,1646,113.9
31210, 이천시,050003, 47세,2017,3701,2002,1699,117.8,3567,1920,1647,116.6
31210, 이천시,050004, 48세,2017,3716,1897,1819,104.3,3585,1833,1752,104.6
31210, 이천시,050005, 49세,2017,3626,1847,1779,103.8,3502,1779,1723,103.3
31210, 이천시,055,50~54세,2017,16376,8508,7868,108.1,15817,8207,7610,107.8
31210, 이천시,055001, 50세,2017,3328,1699,1629,104.3,3232,1648,1584,104
31210, 이천시,055002, 51세,2017,3314,1757,1557,112.8,3218,1705,1513,112.7
31210, 이천시,055003, 52세,2017,3408,1755,1653,106.2,3303,1692,1611,105
31210, 이천시,055004, 53세,2017,3169,1639,1530,107.1,3039,1575,1464,107.6
31210, 이천시,055005, 54세,2017,3157,1658,1499,110.6,3025,1587,1438,110.4
31210, 이천시,060,55~59세,2017,16925,8853,8072,109.7,16550,8658,7892,109.7
31210, 이천시,060001, 55세,2017,3396,1811,1585,114.3,3306,1768,1538,115
31210, 이천시,060002, 56세,2017,3830,2022,1808,111.8,3771,1986,1785,111.3
31210, 이천시,060003, 57세,2017,3520,1784,1736,102.8,3423,1733,1690,102.5
31210, 이천시,060004, 58세,2017,3153,1635,1518,107.7,3088,1603,1485,107.9
31210, 이천시,060005, 59세,2017,3026,1601,1425,112.4,2962,1568,1394,112.5
31210, 이천시,065,60~64세,2017,11749,6017,5732,105,11460,5865,5595,104.8
31210, 이천시,065001, 60세,2017,2768,1398,1370,102,2682,1355,1327,102.1
31210, 이천시,065002, 61세,2017,2535,1364,1171,116.5,2482,1333,1149,116
31210, 이천시,065003, 62세,2017,2564,1285,1279,100.5,2499,1250,1249,100.1
31210, 이천시,065004, 63세,2017,2098,1088,1010,107.7,2047,1057,990,106.8
31210, 이천시,065005, 64세,2017,1784,882,902,97.8,1750,870,880,98.9
31210, 이천시,070,65~69세,2017,8118,4001,4117,97.2,7984,3930,4054,96.9
31210, 이천시,070001, 65세,2017,2271,1159,1112,104.2,2238,1142,1096,104.2
31210, 이천시,070002, 66세,2017,1354,633,721,87.8,1317,614,703,87.3
31210, 이천시,070003, 67세,2017,1497,714,783,91.2,1467,696,771,90.3
31210, 이천시,070004, 68세,2017,1519,758,761,99.6,1498,747,751,99.5
31210, 이천시,070005, 69세,2017,1477,737,740,99.6,1464,731,733,99.7
31210, 이천시,075,70~74세,2017,6245,2940,3305,89,6206,2927,3279,89.3
31210, 이천시,075001, 70세,2017,1504,720,784,91.8,1493,718,775,92.6
31210, 이천시,075002, 71세,2017,1248,637,611,104.3,1237,633,604,104.8
31210, 이천시,075003, 72세,2017,1168,541,627,86.3,1158,537,621,86.5
31210, 이천시,075004, 73세,2017,1099,501,598,83.8,1094,498,596,83.6
31210, 이천시,075005, 74세,2017,1226,541,685,79,1224,541,683,79.2
31210, 이천시,080,75~79세,2017,5809,2463,3346,73.6,5787,2454,3333,73.6
31210, 이천시,080001, 75세,2017,1435,615,820,75,1428,611,817,74.8
31210, 이천시,080002, 76세,2017,1184,506,678,74.6,1179,505,674,74.9
31210, 이천시,080003, 77세,2017,1147,499,648,77,1143,497,646,76.9
31210, 이천시,080004, 78세,2017,1053,433,620,69.8,1050,432,618,69.9
31210, 이천시,080005, 79세,2017,990,410,580,70.7,987,409,578,70.8
31210, 이천시,085,80~84세,2017,3790,1366,2424,56.4,3785,1362,2423,56.2
31210, 이천시,085001, 80세,2017,930,352,578,60.9,930,352,578,60.9
31210, 이천시,085002, 81세,2017,800,308,492,62.6,799,307,492,62.4
31210, 이천시,085003, 82세,2017,791,271,520,52.1,790,270,520,51.9
31210, 이천시,085004, 83세,2017,693,246,447,55,692,246,446,55.2
31210, 이천시,085005, 84세,2017,576,189,387,48.8,574,187,387,48.3
31210, 이천시,090,85~89세,2017,1721,487,1234,39.5,1714,486,1228,39.6
31210, 이천시,090001, 85세,2017,476,148,328,45.1,474,148,326,45.4
31210, 이천시,090002, 86세,2017,355,105,250,42,354,104,250,41.6
31210, 이천시,090003, 87세,2017,347,102,245,41.6,343,102,241,42.3
31210, 이천시,090004, 88세,2017,313,80,233,34.3,313,80,233,34.3
31210, 이천시,090005, 89세,2017,230,52,178,29.2,230,52,178,29.2
31210, 이천시,095,90~94세,2017,581,138,443,31.2,580,138,442,31.2
31210, 이천시,095001, 90세,2017,174,40,134,29.9,173,40,133,30.1
31210, 이천시,095002, 91세,2017,127,30,97,30.9,127,30,97,30.9
31210, 이천시,095003, 92세,2017,122,28,94,29.8,122,28,94,29.8
31210, 이천시,095004, 93세,2017,77,21,56,37.5,77,21,56,37.5
31210, 이천시,095005, 94세,2017,81,19,62,30.6,81,19,62,30.6
31210, 이천시,100,95~99세,2017,134,31,103,30.1,134,31,103,30.1
31210, 이천시,100001, 95세,2017,50,9,41,22,50,9,41,22
31210, 이천시,100002, 96세,2017,38,9,29,31,38,9,29,31
31210, 이천시,100003, 97세,2017,23,X,19,21.1,23,X,19,21.1
31210, 이천시,100004, 98세,2017,14,7,7,100,14,7,7,100
31210, 이천시,100005, 99세,2017,9,X,7,28.6,9,X,7,28.6
31210, 이천시,101,100세이상,2017,18,X,18,0,18,X,18,0
31210, 이천시,102,15세미만,2017,32365,16748,15617,107.2,32235,16678,15557,107.2
31210, 이천시,103,15~64세,2017,160017,84432,75585,111.7,151506,79280,72226,109.8
31210, 이천시,104,65세이상,2017,26416,11426,14990,76.2,26208,11328,14880,76.1
31210, 이천시,086,85세이상,2017,2454,656,1798,36.5,2446,655,1791,36.6
31210, 이천시,126,평균연령,2017,39.4,38.5,40.4,,39.6,38.6,40.6,
31210, 이천시,127,중위연령,2017,39.3,38.3,40.4,,39.8,38.8,40.7,
31220, 안성시,000,합계,2017,198832,103648,95184,108.9,184453,94322,90131,104.6
31220, 안성시,005,0~4세,2017,7754,3994,3760,106.2,7527,3884,3643,106.6
31220, 안성시,005001, 0세,2017,1279,631,648,97.4,1232,613,619,99
31220, 안성시,005002, 1세,2017,1505,768,737,104.2,1466,746,720,103.6
31220, 안성시,005003, 2세,2017,1635,865,770,112.3,1584,832,752,110.6
31220, 안성시,005004, 3세,2017,1606,813,793,102.5,1562,796,766,103.9
31220, 안성시,005005, 4세,2017,1729,917,812,112.9,1683,897,786,114.1
31220, 안성시,010,5~9세,2017,9245,4720,4525,104.3,9118,4660,4458,104.5
31220, 안성시,010001, 5세,2017,1859,918,941,97.6,1818,902,916,98.5
31220, 안성시,010002, 6세,2017,1902,982,920,106.7,1877,967,910,106.3
31220, 안성시,010003, 7세,2017,1810,940,870,108,1789,928,861,107.8
31220, 안성시,010004, 8세,2017,1818,929,889,104.5,1794,919,875,105
31220, 안성시,010005, 9세,2017,1856,951,905,105.1,1840,944,896,105.4
31220, 안성시,015,10~14세,2017,8599,4466,4133,108.1,8526,4434,4092,108.4
31220, 안성시,015001, 10세,2017,1854,950,904,105.1,1836,940,896,104.9
31220, 안성시,015002, 11세,2017,1680,869,811,107.2,1666,865,801,108
31220, 안성시,015003, 12세,2017,1653,869,784,110.8,1632,862,770,111.9
31220, 안성시,015004, 13세,2017,1690,867,823,105.3,1681,861,820,105
31220, 안성시,015005, 14세,2017,1722,911,811,112.3,1711,906,805,112.5
31220, 안성시,020,15~19세,2017,12506,6479,6027,107.5,12316,6389,5927,107.8
31220, 안성시,020001, 15세,2017,1893,1011,882,114.6,1882,1006,876,114.8
31220, 안성시,020002, 16세,2017,2218,1188,1030,115.3,2201,1181,1020,115.8
31220, 안성시,020003, 17세,2017,2276,1157,1119,103.4,2260,1150,1110,103.6
31220, 안성시,020004, 18세,2017,2502,1301,1201,108.3,2456,1280,1176,108.8
31220, 안성시,020005, 19세,2017,3617,1822,1795,101.5,3517,1772,1745,101.5
31220, 안성시,025,20~24세,2017,15303,8251,7052,117,13794,7212,6582,109.6
31220, 안성시,025001, 20세,2017,3210,1493,1717,87,3055,1403,1652,84.9
31220, 안성시,025002, 21세,2017,3010,1537,1473,104.3,2804,1402,1402,100
31220, 안성시,025003, 22세,2017,3075,1625,1450,112.1,2751,1406,1345,104.5
31220, 안성시,025004, 23세,2017,2964,1738,1226,141.8,2604,1473,1131,130.2
31220, 안성시,025005, 24세,2017,3044,1858,1186,156.7,2580,1528,1052,145.2
31220, 안성시,030,25~29세,2017,12916,7712,5204,148.2,10344,5889,4455,132.2
31220, 안성시,030001, 25세,2017,2788,1707,1081,157.9,2298,1351,947,142.7
31220, 안성시,030002, 26세,2017,2583,1523,1060,143.7,2111,1187,924,128.5
31220, 안성시,030003, 27세,2017,2541,1538,1003,153.3,2006,1167,839,139.1
31220, 안성시,030004, 28세,2017,2510,1486,1024,145.1,1983,1109,874,126.9
31220, 안성시,030005, 29세,2017,2494,1458,1036,140.7,1946,1075,871,123.4
31220, 안성시,035,30~34세,2017,13672,7846,5826,134.7,11040,6010,5030,119.5
31220, 안성시,035001, 30세,2017,2502,1448,1054,137.4,1949,1068,881,121.2
31220, 안성시,035002, 31세,2017,2571,1483,1088,136.3,2033,1098,935,117.4
31220, 안성시,035003, 32세,2017,2697,1585,1112,142.5,2149,1193,956,124.8
31220, 안성시,035004, 33세,2017,2806,1625,1181,137.6,2306,1284,1022,125.6
31220, 안성시,035005, 34세,2017,3096,1705,1391,122.6,2603,1367,1236,110.6
31220, 안성시,040,35~39세,2017,16556,9163,7393,123.9,14515,7710,6805,113.3
31220, 안성시,040001, 35세,2017,3294,1854,1440,128.8,2820,1514,1306,115.9
31220, 안성시,040002, 36세,2017,3420,1890,1530,123.5,2983,1571,1412,111.3
31220, 안성시,040003, 37세,2017,3457,1907,1550,123,3064,1626,1438,113.1
31220, 안성시,040004, 38세,2017,3333,1827,1506,121.3,2950,1558,1392,111.9
31220, 안성시,040005, 39세,2017,3052,1685,1367,123.3,2698,1441,1257,114.6
31220, 안성시,045,40~44세,2017,15620,8484,7136,118.9,14270,7591,6679,113.7
31220, 안성시,045001, 40세,2017,3031,1670,1361,122.7,2739,1465,1274,115
31220, 안성시,045002, 41세,2017,2984,1661,1323,125.5,2668,1449,1219,118.9
31220, 안성시,045003, 42세,2017,3043,1643,1400,117.4,2776,1468,1308,112.2
31220, 안성시,045004, 43세,2017,3262,1782,1480,120.4,3018,1622,1396,116.2
31220, 안성시,045005, 44세,2017,3300,1728,1572,109.9,3069,1587,1482,107.1
31220, 안성시,050,45~49세,2017,16620,8936,7684,116.3,15421,8256,7165,115.2
31220, 안성시,050001, 45세,2017,3202,1759,1443,121.9,2960,1612,1348,119.6
31220, 안성시,050002, 46세,2017,3455,1864,1591,117.2,3213,1724,1489,115.8
31220, 안성시,050003, 47세,2017,3293,1747,1546,113,3033,1605,1428,112.4
31220, 안성시,050004, 48세,2017,3419,1842,1577,116.8,3180,1708,1472,116
31220, 안성시,050005, 49세,2017,3251,1724,1527,112.9,3035,1607,1428,112.5
31220, 안성시,055,50~54세,2017,14790,7837,6953,112.7,13867,7342,6525,112.5
31220, 안성시,055001, 50세,2017,2949,1536,1413,108.7,2795,1449,1346,107.7
31220, 안성시,055002, 51세,2017,2989,1629,1360,119.8,2810,1535,1275,120.4
31220, 안성시,055003, 52세,2017,3010,1595,1415,112.7,2820,1490,1330,112
31220, 안성시,055004, 53세,2017,2829,1492,1337,111.6,2638,1394,1244,112.1
31220, 안성시,055005, 54세,2017,3013,1585,1428,111,2804,1474,1330,110.8
31220, 안성시,060,55~59세,2017,15428,7995,7433,107.6,14723,7608,7115,106.9
31220, 안성시,060001, 55세,2017,2937,1572,1365,115.2,2756,1481,1275,116.2
31220, 안성시,060002, 56세,2017,3393,1776,1617,109.8,3279,1712,1567,109.3
31220, 안성시,060003, 57세,2017,3283,1691,1592,106.2,3133,1603,1530,104.8
31220, 안성시,060004, 58세,2017,2994,1518,1476,102.8,2861,1440,1421,101.3
31220, 안성시,060005, 59세,2017,2821,1438,1383,104,2694,1372,1322,103.8
31220, 안성시,065,60~64세,2017,11634,5885,5749,102.4,11114,5605,5509,101.7
31220, 안성시,065001, 60세,2017,2598,1338,1260,106.2,2467,1260,1207,104.4
31220, 안성시,065002, 61세,2017,2466,1237,1229,100.7,2361,1183,1178,100.4
31220, 안성시,065003, 62세,2017,2496,1250,1246,100.3,2383,1182,1201,98.4
31220, 안성시,065004, 63세,2017,2167,1119,1048,106.8,2086,1084,1002,108.2
31220, 안성시,065005, 64세,2017,1907,941,966,97.4,1817,896,921,97.3
31220, 안성시,070,65~69세,2017,8185,4050,4135,97.9,7988,3947,4041,97.7
31220, 안성시,070001, 65세,2017,2164,1101,1063,103.6,2123,1077,1046,103
31220, 안성시,070002, 66세,2017,1458,697,761,91.6,1412,671,741,90.6
31220, 안성시,070003, 67세,2017,1566,778,788,98.7,1517,755,762,99.1
31220, 안성시,070004, 68세,2017,1479,725,754,96.2,1434,703,731,96.2
31220, 안성시,070005, 69세,2017,1518,749,769,97.4,1502,741,761,97.4
31220, 안성시,075,70~74세,2017,6563,3032,3531,85.9,6513,3008,3505,85.8
31220, 안성시,075001, 70세,2017,1646,770,876,87.9,1627,758,869,87.2
31220, 안성시,075002, 71세,2017,1226,607,619,98.1,1215,603,612,98.5
31220, 안성시,075003, 72세,2017,1243,571,672,85,1236,569,667,85.3
31220, 안성시,075004, 73세,2017,1232,559,673,83.1,1224,556,668,83.2
31220, 안성시,075005, 74세,2017,1216,525,691,76,1211,522,689,75.8
31220, 안성시,080,75~79세,2017,6145,2521,3624,69.6,6107,2507,3600,69.6
31220, 안성시,080001, 75세,2017,1436,581,855,68,1434,580,854,67.9
31220, 안성시,080002, 76세,2017,1231,542,689,78.7,1225,539,686,78.6
31220, 안성시,080003, 77세,2017,1202,498,704,70.7,1190,495,695,71.2
31220, 안성시,080004, 78세,2017,1193,479,714,67.1,1184,475,709,67
31220, 안성시,080005, 79세,2017,1083,421,662,63.6,1074,418,656,63.7
31220, 안성시,085,80~84세,2017,4362,1572,2790,56.3,4344,1566,2778,56.4
31220, 안성시,085001, 80세,2017,1084,422,662,63.7,1076,418,658,63.5
31220, 안성시,085002, 81세,2017,997,383,614,62.4,995,383,612,62.6
31220, 안성시,085003, 82세,2017,828,284,544,52.2,826,283,543,52.1
31220, 안성시,085004, 83세,2017,805,280,525,53.3,802,279,523,53.3
31220, 안성시,085005, 84세,2017,648,203,445,45.6,645,203,442,45.9
31220, 안성시,090,85~89세,2017,2042,519,1523,34.1,2035,518,1517,34.1
31220, 안성시,090001, 85세,2017,592,169,423,40,590,169,421,40.1
31220, 안성시,090002, 86세,2017,481,139,342,40.6,478,139,339,41
31220, 안성시,090003, 87세,2017,392,101,291,34.7,391,100,291,34.4
31220, 안성시,090004, 88세,2017,313,63,250,25.2,312,63,249,25.3
31220, 안성시,090005, 89세,2017,264,47,217,21.7,264,47,217,21.7
31220, 안성시,095,90~94세,2017,693,151,542,27.9,692,151,541,27.9
31220, 안성시,095001, 90세,2017,198,38,160,23.8,198,38,160,23.8
31220, 안성시,095002, 91세,2017,174,33,141,23.4,173,33,140,23.6
31220, 안성시,095003, 92세,2017,128,26,102,25.5,128,26,102,25.5
31220, 안성시,095004, 93세,2017,114,34,80,42.5,114,34,80,42.5
31220, 안성시,095005, 94세,2017,79,20,59,33.9,79,20,59,33.9
31220, 안성시,100,95~99세,2017,176,34,142,23.9,176,34,142,23.9
31220, 안성시,100001, 95세,2017,69,15,54,27.8,69,15,54,27.8
31220, 안성시,100002, 96세,2017,44,9,35,25.7,44,9,35,25.7
31220, 안성시,100003, 97세,2017,30,X,26,15.4,30,X,26,15.4
31220, 안성시,100004, 98세,2017,30,5,25,20,30,5,25,20
31220, 안성시,100005, 99세,2017,X,X,X,50,X,X,X,50
31220, 안성시,101,100세이상,2017,23,X,22,4.5,23,X,22,4.5
31220, 안성시,102,15세미만,2017,25598,13180,12418,106.1,25171,12978,12193,106.4
31220, 안성시,103,15~64세,2017,145045,78588,66457,118.3,131404,69612,61792,112.7
31220, 안성시,104,65세이상,2017,28189,11880,16309,72.8,27878,11732,16146,72.7
31220, 안성시,086,85세이상,2017,2934,705,2229,31.6,2926,704,2222,31.7
31220, 안성시,126,평균연령,2017,41,39.7,42.4,,41.3,40.1,42.6,
31220, 안성시,127,중위연령,2017,40.9,39.5,42.7,,41.9,40.7,43.2,
31230, 김포시,000,합계,2017,392438,202239,190199,106.3,369674,184914,184760,100.1
31230, 김포시,005,0~4세,2017,22778,11660,11118,104.9,22534,11543,10991,105
31230, 김포시,005001, 0세,2017,3574,1845,1729,106.7,3520,1823,1697,107.4
31230, 김포시,005002, 1세,2017,4456,2275,2181,104.3,4385,2238,2147,104.2
31230, 김포시,005003, 2세,2017,4954,2534,2420,104.7,4917,2518,2399,105
31230, 김포시,005004, 3세,2017,4905,2503,2402,104.2,4867,2481,2386,104
31230, 김포시,005005, 4세,2017,4889,2503,2386,104.9,4845,2483,2362,105.1
31230, 김포시,010,5~9세,2017,24691,12630,12061,104.7,24583,12570,12013,104.6
31230, 김포시,010001, 5세,2017,5491,2726,2765,98.6,5464,2713,2751,98.6
31230, 김포시,010002, 6세,2017,5156,2660,2496,106.6,5124,2641,2483,106.4
31230, 김포시,010003, 7세,2017,4916,2600,2316,112.3,4901,2591,2310,112.2
31230, 김포시,010004, 8세,2017,4516,2289,2227,102.8,4500,2281,2219,102.8
31230, 김포시,010005, 9세,2017,4612,2355,2257,104.3,4594,2344,2250,104.2
31230, 김포시,015,10~14세,2017,19947,10150,9797,103.6,19893,10117,9776,103.5
31230, 김포시,015001, 10세,2017,4407,2191,2216,98.9,4391,2181,2210,98.7
31230, 김포시,015002, 11세,2017,4055,2133,1922,111,4043,2126,1917,110.9
31230, 김포시,015003, 12세,2017,3776,1886,1890,99.8,3764,1878,1886,99.6
31230, 김포시,015004, 13세,2017,3886,1979,1907,103.8,3877,1974,1903,103.7
31230, 김포시,015005, 14세,2017,3823,1961,1862,105.3,3818,1958,1860,105.3
31230, 김포시,020,15~19세,2017,19323,9906,9417,105.2,19162,9821,9341,105.1
31230, 김포시,020001, 15세,2017,3810,1933,1877,103,3795,1927,1868,103.2
31230, 김포시,020002, 16세,2017,4124,2087,2037,102.5,4111,2079,2032,102.3
31230, 김포시,020003, 17세,2017,4379,2250,2129,105.7,4350,2237,2113,105.9
31230, 김포시,020004, 18세,2017,3789,1935,1854,104.4,3751,1916,1835,104.4
31230, 김포시,020005, 19세,2017,3221,1701,1520,111.9,3155,1662,1493,111.3
31230, 김포시,025,20~24세,2017,20125,11485,8640,132.9,17999,9718,8281,117.4
31230, 김포시,025001, 20세,2017,3464,2000,1464,136.6,3362,1928,1434,134.4
31230, 김포시,025002, 21세,2017,3866,2276,1590,143.1,3600,2065,1535,134.5
31230, 김포시,025003, 22세,2017,3955,2251,1704,132.1,3574,1945,1629,119.4
31230, 김포시,025004, 23세,2017,4297,2383,1914,124.5,3722,1893,1829,103.5
31230, 김포시,025005, 24세,2017,4543,2575,1968,130.8,3741,1887,1854,101.8
31230, 김포시,030,25~29세,2017,23790,13786,10004,137.8,18560,9331,9229,101.1
31230, 김포시,030001, 25세,2017,4874,2853,2021,141.2,3879,1994,1885,105.8
31230, 김포시,030002, 26세,2017,4759,2746,2013,136.4,3767,1896,1871,101.3
31230, 김포시,030003, 27세,2017,4808,2839,1969,144.2,3633,1849,1784,103.6
31230, 김포시,030004, 28세,2017,4792,2815,1977,142.4,3694,1877,1817,103.3
31230, 김포시,030005, 29세,2017,4557,2533,2024,125.1,3587,1715,1872,91.6
31230, 김포시,035,30~34세,2017,29379,15552,13827,112.5,24659,11627,13032,89.2
31230, 김포시,035001, 30세,2017,5034,2742,2292,119.6,3969,1851,2118,87.4
31230, 김포시,035002, 31세,2017,5300,2894,2406,120.3,4274,2037,2237,91.1
31230, 김포시,035003, 32세,2017,5539,2950,2589,113.9,4591,2155,2436,88.5
31230, 김포시,035004, 33세,2017,6263,3247,3016,107.7,5395,2536,2859,88.7
31230, 김포시,035005, 34세,2017,7243,3719,3524,105.5,6430,3048,3382,90.1
31230, 김포시,040,35~39세,2017,41204,21523,19681,109.4,37989,18945,19044,99.5
31230, 김포시,040001, 35세,2017,8242,4295,3947,108.8,7418,3624,3794,95.5
31230, 김포시,040002, 36세,2017,8425,4412,4013,109.9,7729,3851,3878,99.3
31230, 김포시,040003, 37세,2017,8782,4576,4206,108.8,8137,4060,4077,99.6
31230, 김포시,040004, 38세,2017,8214,4244,3970,106.9,7646,3791,3855,98.3
31230, 김포시,040005, 39세,2017,7541,3996,3545,112.7,7059,3619,3440,105.2
31230, 김포시,045,40~44세,2017,36832,19569,17263,113.4,35072,18274,16798,108.8
31230, 김포시,045001, 40세,2017,7598,4002,3596,111.3,7151,3653,3498,104.4
31230, 김포시,045002, 41세,2017,7235,3863,3372,114.6,6849,3565,3284,108.6
31230, 김포시,045003, 42세,2017,7256,3854,3402,113.3,6931,3612,3319,108.8
31230, 김포시,045004, 43세,2017,7587,3991,3596,111,7283,3788,3495,108.4
31230, 김포시,045005, 44세,2017,7156,3859,3297,117,6858,3656,3202,114.2
31230, 김포시,050,45~49세,2017,34060,17845,16215,110.1,32458,16832,15626,107.7
31230, 김포시,050001, 45세,2017,7271,3884,3387,114.7,6960,3676,3284,111.9
31230, 김포시,050002, 46세,2017,7129,3754,3375,111.2,6828,3567,3261,109.4
31230, 김포시,050003, 47세,2017,6684,3489,3195,109.2,6328,3257,3071,106.1
31230, 김포시,050004, 48세,2017,6618,3419,3199,106.9,6309,3246,3063,106
31230, 김포시,050005, 49세,2017,6358,3299,3059,107.8,6033,3086,2947,104.7
31230, 김포시,055,50~54세,2017,28288,14559,13729,106,26916,13740,13176,104.3
31230, 김포시,055001, 50세,2017,5791,2949,2842,103.8,5554,2802,2752,101.8
31230, 김포시,055002, 51세,2017,5696,2956,2740,107.9,5441,2790,2651,105.2
31230, 김포시,055003, 52세,2017,5736,2873,2863,100.3,5457,2708,2749,98.5
31230, 김포시,055004, 53세,2017,5401,2818,2583,109.1,5113,2658,2455,108.3
31230, 김포시,055005, 54세,2017,5664,2963,2701,109.7,5351,2782,2569,108.3
31230, 김포시,060,55~59세,2017,27801,14203,13598,104.4,26851,13661,13190,103.6
31230, 김포시,060001, 55세,2017,5865,3066,2799,109.5,5614,2918,2696,108.2
31230, 김포시,060002, 56세,2017,5813,2974,2839,104.8,5664,2885,2779,103.8
31230, 김포시,060003, 57세,2017,5838,3011,2827,106.5,5633,2890,2743,105.4
31230, 김포시,060004, 58세,2017,5297,2682,2615,102.6,5107,2580,2527,102.1
31230, 김포시,060005, 59세,2017,4988,2470,2518,98.1,4833,2388,2445,97.7
31230, 김포시,065,60~64세,2017,20994,10198,10796,94.5,20268,9782,10486,93.3
31230, 김포시,065001, 60세,2017,4919,2463,2456,100.3,4720,2351,2369,99.2
31230, 김포시,065002, 61세,2017,4331,2080,2251,92.4,4169,1994,2175,91.7
31230, 김포시,065003, 62세,2017,4537,2173,2364,91.9,4402,2096,2306,90.9
31230, 김포시,065004, 63세,2017,3805,1871,1934,96.7,3679,1793,1886,95.1
31230, 김포시,065005, 64세,2017,3402,1611,1791,89.9,3298,1548,1750,88.5
31230, 김포시,070,65~69세,2017,14743,7159,7584,94.4,14437,7017,7420,94.6
31230, 김포시,070001, 65세,2017,3584,1742,1842,94.6,3509,1707,1802,94.7
31230, 김포시,070002, 66세,2017,2484,1210,1274,95,2418,1177,1241,94.8
31230, 김포시,070003, 67세,2017,2852,1343,1509,89,2791,1316,1475,89.2
31230, 김포시,070004, 68세,2017,2970,1447,1523,95,2907,1418,1489,95.2
31230, 김포시,070005, 69세,2017,2853,1417,1436,98.7,2812,1399,1413,99
31230, 김포시,075,70~74세,2017,11141,5257,5884,89.3,11047,5214,5833,89.4
31230, 김포시,075001, 70세,2017,2741,1335,1406,95,2710,1319,1391,94.8
31230, 김포시,075002, 71세,2017,2259,1095,1164,94.1,2237,1084,1153,94
31230, 김포시,075003, 72세,2017,2137,1014,1123,90.3,2120,1007,1113,90.5
31230, 김포시,075004, 73세,2017,1955,876,1079,81.2,1943,871,1072,81.3
31230, 김포시,075005, 74세,2017,2049,937,1112,84.3,2037,933,1104,84.5
31230, 김포시,080,75~79세,2017,8782,3837,4945,77.6,8726,3818,4908,77.8
31230, 김포시,080001, 75세,2017,2293,1002,1291,77.6,2281,998,1283,77.8
31230, 김포시,080002, 76세,2017,1855,839,1016,82.6,1846,838,1008,83.1
31230, 김포시,080003, 77세,2017,1616,729,887,82.2,1600,721,879,82
31230, 김포시,080004, 78세,2017,1567,656,911,72,1554,654,900,72.7
31230, 김포시,080005, 79세,2017,1451,611,840,72.7,1445,607,838,72.4
31230, 김포시,085,80~84세,2017,5168,1986,3182,62.4,5140,1977,3163,62.5
31230, 김포시,085001, 80세,2017,1321,532,789,67.4,1311,530,781,67.9
31230, 김포시,085002, 81세,2017,1128,468,660,70.9,1123,467,656,71.2
31230, 김포시,085003, 82세,2017,1092,418,674,62,1083,413,670,61.6
31230, 김포시,085004, 83세,2017,903,321,582,55.2,901,320,581,55.1
31230, 김포시,085005, 84세,2017,724,247,477,51.8,722,247,475,52
31230, 김포시,090,85~89세,2017,2361,687,1674,41,2351,681,1670,40.8
31230, 김포시,090001, 85세,2017,655,209,446,46.9,652,207,445,46.5
31230, 김포시,090002, 86세,2017,562,176,386,45.6,559,174,385,45.2
31230, 김포시,090003, 87세,2017,456,122,334,36.5,456,122,334,36.5
31230, 김포시,090004, 88세,2017,388,101,287,35.2,386,101,285,35.4
31230, 김포시,090005, 89세,2017,300,79,221,35.7,298,77,221,34.8
31230, 김포시,095,90~94세,2017,837,201,636,31.6,835,200,635,31.5
31230, 김포시,095001, 90세,2017,280,69,211,32.7,280,69,211,32.7
31230, 김포시,095002, 91세,2017,187,42,145,29,185,41,144,28.5
31230, 김포시,095003, 92세,2017,155,40,115,34.8,155,40,115,34.8
31230, 김포시,095004, 93세,2017,110,22,88,25,110,22,88,25
31230, 김포시,095005, 94세,2017,105,28,77,36.4,105,28,77,36.4
31230, 김포시,100,95~99세,2017,177,41,136,30.1,177,41,136,30.1
31230, 김포시,100001, 95세,2017,71,17,54,31.5,71,17,54,31.5
31230, 김포시,100002, 96세,2017,45,10,35,28.6,45,10,35,28.6
31230, 김포시,100003, 97세,2017,32,7,25,28,32,7,25,28
31230, 김포시,100004, 98세,2017,18,6,12,50,18,6,12,50
31230, 김포시,100005, 99세,2017,11,X,10,10,11,X,10,10
31230, 김포시,101,100세이상,2017,17,5,12,41.7,17,5,12,41.7
31230, 김포시,102,15세미만,2017,67416,34440,32976,104.4,67010,34230,32780,104.4
31230, 김포시,103,15~64세,2017,281796,148626,133170,111.6,259934,131731,128203,102.8
31230, 김포시,104,65세이상,2017,43226,19173,24053,79.7,42730,18953,23777,79.7
31230, 김포시,086,85세이상,2017,3392,934,2458,38,3380,927,2453,37.8
31230, 김포시,126,평균연령,2017,38.8,37.9,39.7,,38.9,38.2,39.6,
31230, 김포시,127,중위연령,2017,39.3,38.6,40.2,,39.9,39.7,40.2,
31240, 화성시,000,합계,2017,708569,374529,334040,112.1,662439,341686,320753,106.5
31240, 화성시,005,0~4세,2017,44835,22931,21904,104.7,44267,22645,21622,104.7
31240, 화성시,005001, 0세,2017,7570,3859,3711,104,7447,3803,3644,104.4
31240, 화성시,005002, 1세,2017,8826,4480,4346,103.1,8696,4418,4278,103.3
31240, 화성시,005003, 2세,2017,9374,4818,4556,105.8,9275,4766,4509,105.7
31240, 화성시,005004, 3세,2017,9426,4772,4654,102.5,9321,4717,4604,102.5
31240, 화성시,005005, 4세,2017,9639,5002,4637,107.9,9528,4941,4587,107.7
31240, 화성시,010,5~9세,2017,49200,25122,24078,104.3,48906,24968,23938,104.3
31240, 화성시,010001, 5세,2017,10336,5264,5072,103.8,10261,5219,5042,103.5
31240, 화성시,010002, 6세,2017,10218,5223,4995,104.6,10155,5189,4966,104.5
31240, 화성시,010003, 7세,2017,9688,4967,4721,105.2,9630,4942,4688,105.4
31240, 화성시,010004, 8세,2017,9416,4819,4597,104.8,9364,4794,4570,104.9
31240, 화성시,010005, 9세,2017,9542,4849,4693,103.3,9496,4824,4672,103.3
31240, 화성시,015,10~14세,2017,40804,20849,19955,104.5,40642,20787,19855,104.7
31240, 화성시,015001, 10세,2017,9252,4707,4545,103.6,9205,4688,4517,103.8
31240, 화성시,015002, 11세,2017,8305,4227,4078,103.7,8269,4214,4055,103.9
31240, 화성시,015003, 12세,2017,7615,3855,3760,102.5,7586,3843,3743,102.7
31240, 화성시,015004, 13세,2017,8027,4108,3919,104.8,7999,4100,3899,105.2
31240, 화성시,015005, 14세,2017,7605,3952,3653,108.2,7583,3942,3641,108.3
31240, 화성시,020,15~19세,2017,37974,19410,18564,104.6,37689,19253,18436,104.4
31240, 화성시,020001, 15세,2017,7255,3699,3556,104,7232,3687,3545,104
31240, 화성시,020002, 16세,2017,8076,4119,3957,104.1,8055,4108,3947,104.1
31240, 화성시,020003, 17세,2017,8394,4332,4062,106.6,8356,4311,4045,106.6
31240, 화성시,020004, 18세,2017,7448,3793,3655,103.8,7390,3761,3629,103.6
31240, 화성시,020005, 19세,2017,6801,3467,3334,104,6656,3386,3270,103.5
31240, 화성시,025,20~24세,2017,39274,21943,17331,126.6,34993,18656,16337,114.2
31240, 화성시,025001, 20세,2017,7429,3951,3478,113.6,7102,3754,3348,112.1
31240, 화성시,025002, 21세,2017,7442,4080,3362,121.4,6881,3669,3212,114.2
31240, 화성시,025003, 22세,2017,7783,4448,3335,133.4,6915,3769,3146,119.8
31240, 화성시,025004, 23세,2017,7956,4467,3489,128,6890,3620,3270,110.7
31240, 화성시,025005, 24세,2017,8664,4997,3667,136.3,7205,3844,3361,114.4
31240, 화성시,030,25~29세,2017,49044,28850,20194,142.9,39174,21112,18062,116.9
31240, 화성시,030001, 25세,2017,9144,5428,3716,146.1,7393,4038,3355,120.4
31240, 화성시,030002, 26세,2017,9196,5507,3689,149.3,7336,4036,3300,122.3
31240, 화성시,030003, 27세,2017,9617,5766,3851,149.7,7536,4115,3421,120.3
31240, 화성시,030004, 28세,2017,10307,6012,4295,140,8281,4437,3844,115.4
31240, 화성시,030005, 29세,2017,10780,6137,4643,132.2,8628,4486,4142,108.3
31240, 화성시,035,30~34세,2017,62437,34579,27858,124.1,52643,27066,25577,105.8
31240, 화성시,035001, 30세,2017,11161,6407,4754,134.8,8994,4761,4233,112.5
31240, 화성시,035002, 31세,2017,11675,6486,5189,125,9605,4902,4703,104.2
31240, 화성시,035003, 32세,2017,12092,6761,5331,126.8,10185,5283,4902,107.8
31240, 화성시,035004, 33세,2017,12925,7130,5795,123,11031,5671,5360,105.8
31240, 화성시,035005, 34세,2017,14584,7795,6789,114.8,12828,6449,6379,101.1
31240, 화성시,040,35~39세,2017,80378,43390,36988,117.3,73526,38250,35276,108.4
31240, 화성시,040001, 35세,2017,16434,8737,7697,113.5,14770,7483,7287,102.7
31240, 화성시,040002, 36세,2017,16529,9017,7512,120,15068,7893,7175,110
31240, 화성시,040003, 37세,2017,16917,9107,7810,116.6,15534,8080,7454,108.4
31240, 화성시,040004, 38세,2017,15866,8579,7287,117.7,14657,7676,6981,110
31240, 화성시,040005, 39세,2017,14632,7950,6682,119,13497,7118,6379,111.6
31240, 화성시,045,40~44세,2017,70801,38066,32735,116.3,66802,35269,31533,111.8
31240, 화성시,045001, 40세,2017,14755,7907,6848,115.5,13886,7274,6612,110
31240, 화성시,045002, 41세,2017,13957,7576,6381,118.7,13054,6939,6115,113.5
31240, 화성시,045003, 42세,2017,13964,7457,6507,114.6,13170,6904,6266,110.2
31240, 화성시,045004, 43세,2017,14314,7619,6695,113.8,13585,7122,6463,110.2
31240, 화성시,045005, 44세,2017,13811,7507,6304,119.1,13107,7030,6077,115.7
31240, 화성시,050,45~49세,2017,62032,34042,27990,121.6,58656,31992,26664,120
31240, 화성시,050001, 45세,2017,12963,7170,5793,123.8,12300,6758,5542,121.9
31240, 화성시,050002, 46세,2017,13313,7385,5928,124.6,12591,6938,5653,122.7
31240, 화성시,050003, 47세,2017,12497,6933,5564,124.6,11756,6485,5271,123
31240, 화성시,050004, 48세,2017,12029,6533,5496,118.9,11409,6156,5253,117.2
31240, 화성시,050005, 49세,2017,11230,6021,5209,115.6,10600,5655,4945,114.4
31240, 화성시,055,50~54세,2017,46176,25180,20996,119.9,43348,23572,19776,119.2
31240, 화성시,055001, 50세,2017,9810,5289,4521,117,9297,5010,4287,116.9
31240, 화성시,055002, 51세,2017,9333,5159,4174,123.6,8738,4815,3923,122.7
31240, 화성시,055003, 52세,2017,9660,5308,4352,122,9083,4977,4106,121.2
31240, 화성시,055004, 53세,2017,8564,4646,3918,118.6,8030,4346,3684,118
31240, 화성시,055005, 54세,2017,8809,4778,4031,118.5,8200,4424,3776,117.2
31240, 화성시,060,55~59세,2017,41073,21647,19426,111.4,39294,20635,18659,110.6
31240, 화성시,060001, 55세,2017,8686,4684,4002,117,8205,4411,3794,116.3
31240, 화성시,060002, 56세,2017,9238,4906,4332,113.3,8942,4744,4198,113
31240, 화성시,060003, 57세,2017,8585,4533,4052,111.9,8170,4298,3872,111
31240, 화성시,060004, 58세,2017,7612,3965,3647,108.7,7314,3781,3533,107
31240, 화성시,060005, 59세,2017,6952,3559,3393,104.9,6663,3401,3262,104.3
31240, 화성시,065,60~64세,2017,28186,14066,14120,99.6,26967,13404,13563,98.8
31240, 화성시,065001, 60세,2017,6350,3157,3193,98.9,6043,2984,3059,97.5
31240, 화성시,065002, 61세,2017,6198,3164,3034,104.3,5934,3018,2916,103.5
31240, 화성시,065003, 62세,2017,5977,2972,3005,98.9,5739,2836,2903,97.7
31240, 화성시,065004, 63세,2017,5114,2506,2608,96.1,4891,2402,2489,96.5
31240, 화성시,065005, 64세,2017,4547,2267,2280,99.4,4360,2164,2196,98.5
31240, 화성시,070,65~69세,2017,18935,9233,9702,95.2,18451,8993,9458,95.1
31240, 화성시,070001, 65세,2017,4985,2424,2561,94.7,4856,2366,2490,95
31240, 화성시,070002, 66세,2017,3232,1597,1635,97.7,3109,1532,1577,97.1
31240, 화성시,070003, 67세,2017,3642,1759,1883,93.4,3560,1720,1840,93.5
31240, 화성시,070004, 68세,2017,3591,1730,1861,93,3504,1686,1818,92.7
31240, 화성시,070005, 69세,2017,3485,1723,1762,97.8,3422,1689,1733,97.5
31240, 화성시,075,70~74세,2017,13897,6508,7389,88.1,13731,6430,7301,88.1
31240, 화성시,075001, 70세,2017,3509,1705,1804,94.5,3456,1676,1780,94.2
31240, 화성시,075002, 71세,2017,2754,1360,1394,97.6,2727,1348,1379,97.8
31240, 화성시,075003, 72세,2017,2606,1251,1355,92.3,2572,1234,1338,92.2
31240, 화성시,075004, 73세,2017,2537,1124,1413,79.5,2511,1114,1397,79.7
31240, 화성시,075005, 74세,2017,2491,1068,1423,75.1,2465,1058,1407,75.2
31240, 화성시,080,75~79세,2017,11435,4833,6602,73.2,11348,4800,6548,73.3
31240, 화성시,080001, 75세,2017,2812,1228,1584,77.5,2790,1219,1571,77.6
31240, 화성시,080002, 76세,2017,2424,1065,1359,78.4,2406,1054,1352,78
31240, 화성시,080003, 77세,2017,2107,876,1231,71.2,2090,871,1219,71.5
31240, 화성시,080004, 78세,2017,2130,864,1266,68.2,2116,860,1256,68.5
31240, 화성시,080005, 79세,2017,1962,800,1162,68.8,1946,796,1150,69.2
31240, 화성시,085,80~84세,2017,7329,2682,4647,57.7,7277,2666,4611,57.8
31240, 화성시,085001, 80세,2017,1818,723,1095,66,1804,718,1086,66.1
31240, 화성시,085002, 81세,2017,1669,652,1017,64.1,1655,649,1006,64.5
31240, 화성시,085003, 82세,2017,1460,488,972,50.2,1451,485,966,50.2
31240, 화성시,085004, 83세,2017,1287,456,831,54.9,1278,453,825,54.9
31240, 화성시,085005, 84세,2017,1095,363,732,49.6,1089,361,728,49.6
31240, 화성시,090,85~89세,2017,3342,890,2452,36.3,3316,883,2433,36.3
31240, 화성시,090001, 85세,2017,983,287,696,41.2,977,286,691,41.4
31240, 화성시,090002, 86세,2017,696,190,506,37.5,687,187,500,37.4
31240, 화성시,090003, 87세,2017,674,172,502,34.3,670,170,500,34
31240, 화성시,090004, 88세,2017,540,145,395,36.7,535,144,391,36.8
31240, 화성시,090005, 89세,2017,449,96,353,27.2,447,96,351,27.4
31240, 화성시,095,90~94세,2017,1122,255,867,29.4,1117,253,864,29.3
31240, 화성시,095001, 90세,2017,349,75,274,27.4,347,74,273,27.1
31240, 화성시,095002, 91세,2017,256,72,184,39.1,255,72,183,39.3
31240, 화성시,095003, 92세,2017,219,42,177,23.7,219,42,177,23.7
31240, 화성시,095004, 93세,2017,149,30,119,25.2,148,30,118,25.4
31240, 화성시,095005, 94세,2017,149,36,113,31.9,148,35,113,31
31240, 화성시,100,95~99세,2017,266,49,217,22.6,263,48,215,22.3
31240, 화성시,100001, 95세,2017,93,20,73,27.4,92,20,72,27.8
31240, 화성시,100002, 96세,2017,71,13,58,22.4,71,13,58,22.4
31240, 화성시,100003, 97세,2017,49,6,43,14,48,5,43,11.6
31240, 화성시,100004, 98세,2017,37,7,30,23.3,36,7,29,24.1
31240, 화성시,100005, 99세,2017,16,X,13,23.1,16,X,13,23.1
31240, 화성시,101,100세이상,2017,29,X,25,16,29,X,25,16
31240, 화성시,102,15세미만,2017,134839,68902,65937,104.5,133815,68400,65415,104.6
31240, 화성시,103,15~64세,2017,517375,281173,236202,119,473092,249209,223883,111.3
31240, 화성시,104,65세이상,2017,56355,24454,31901,76.7,55532,24077,31455,76.5
31240, 화성시,086,85세이상,2017,4759,1198,3561,33.6,4725,1188,3537,33.6
31240, 화성시,126,평균연령,2017,36.2,35.6,36.7,,36.1,35.7,36.6,
31240, 화성시,127,중위연령,2017,36.9,36.5,37.2,,37.2,37.1,37.3,
31250, 광주시,000,합계,2017,341046,176877,164169,107.7,325392,166316,159076,104.6
31250, 광주시,005,0~4세,2017,17648,9046,8602,105.2,17491,8972,8519,105.3
31250, 광주시,005001, 0세,2017,3075,1541,1534,100.5,3046,1526,1520,100.4
31250, 광주시,005002, 1세,2017,3659,1879,1780,105.6,3625,1865,1760,106
31250, 광주시,005003, 2세,2017,3746,1955,1791,109.2,3716,1942,1774,109.5
31250, 광주시,005004, 3세,2017,3682,1914,1768,108.3,3649,1897,1752,108.3
31250, 광주시,005005, 4세,2017,3486,1757,1729,101.6,3455,1742,1713,101.7
31250, 광주시,010,5~9세,2017,16777,8601,8176,105.2,16672,8550,8122,105.3
31250, 광주시,010001, 5세,2017,3783,1983,1800,110.2,3748,1964,1784,110.1
31250, 광주시,010002, 6세,2017,3564,1832,1732,105.8,3542,1822,1720,105.9
31250, 광주시,010003, 7세,2017,3212,1641,1571,104.5,3193,1632,1561,104.5
31250, 광주시,010004, 8세,2017,3005,1535,1470,104.4,2994,1531,1463,104.6
31250, 광주시,010005, 9세,2017,3213,1610,1603,100.4,3195,1601,1594,100.4
31250, 광주시,015,10~14세,2017,14838,7528,7310,103,14777,7493,7284,102.9
31250, 광주시,015001, 10세,2017,3208,1608,1600,100.5,3191,1597,1594,100.2
31250, 광주시,015002, 11세,2017,2981,1520,1461,104,2971,1517,1454,104.3
31250, 광주시,015003, 12세,2017,2788,1405,1383,101.6,2774,1395,1379,101.2
31250, 광주시,015004, 13세,2017,2967,1542,1425,108.2,2953,1534,1419,108.1
31250, 광주시,015005, 14세,2017,2894,1453,1441,100.8,2888,1450,1438,100.8
31250, 광주시,020,15~19세,2017,17263,8977,8286,108.3,17081,8878,8203,108.2
31250, 광주시,020001, 15세,2017,3054,1593,1461,109,3045,1588,1457,109
31250, 광주시,020002, 16세,2017,3210,1652,1558,106,3199,1646,1553,106
31250, 광주시,020003, 17세,2017,3526,1756,1770,99.2,3516,1750,1766,99.1
31250, 광주시,020004, 18세,2017,3520,1850,1670,110.8,3493,1837,1656,110.9
31250, 광주시,020005, 19세,2017,3953,2126,1827,116.4,3828,2057,1771,116.1
31250, 광주시,025,20~24세,2017,20033,11186,8847,126.4,18240,9870,8370,117.9
31250, 광주시,025001, 20세,2017,3791,2075,1716,120.9,3580,1953,1627,120
31250, 광주시,025002, 21세,2017,3893,2221,1672,132.8,3625,2036,1589,128.1
31250, 광주시,025003, 22세,2017,4036,2279,1757,129.7,3672,2006,1666,120.4
31250, 광주시,025004, 23세,2017,4139,2289,1850,123.7,3727,1980,1747,113.3
31250, 광주시,025005, 24세,2017,4174,2322,1852,125.4,3636,1895,1741,108.8
31250, 광주시,030,25~29세,2017,22071,12125,9946,121.9,18945,9806,9139,107.3
31250, 광주시,030001, 25세,2017,4583,2483,2100,118.2,3992,2024,1968,102.8
31250, 광주시,030002, 26세,2017,4356,2407,1949,123.5,3778,1971,1807,109.1
31250, 광주시,030003, 27세,2017,4332,2399,1933,124.1,3644,1897,1747,108.6
31250, 광주시,030004, 28세,2017,4353,2406,1947,123.6,3748,1965,1783,110.2
31250, 광주시,030005, 29세,2017,4447,2430,2017,120.5,3783,1949,1834,106.3
31250, 광주시,035,30~34세,2017,27098,14790,12308,120.2,24138,12581,11557,108.9
31250, 광주시,035001, 30세,2017,4728,2593,2135,121.5,4078,2106,1972,106.8
31250, 광주시,035002, 31세,2017,4939,2692,2247,119.8,4353,2259,2094,107.9
31250, 광주시,035003, 32세,2017,5381,2945,2436,120.9,4758,2482,2276,109.1
31250, 광주시,035004, 33세,2017,5641,3053,2588,118,5096,2638,2458,107.3
31250, 광주시,035005, 34세,2017,6409,3507,2902,120.8,5853,3096,2757,112.3
31250, 광주시,040,35~39세,2017,33126,17835,15291,116.6,30976,16277,14699,110.7
31250, 광주시,040001, 35세,2017,6981,3772,3209,117.5,6484,3394,3090,109.8
31250, 광주시,040002, 36세,2017,6922,3792,3130,121.2,6443,3445,2998,114.9
31250, 광주시,040003, 37세,2017,7170,3814,3356,113.6,6758,3531,3227,109.4
31250, 광주시,040004, 38세,2017,6343,3440,2903,118.5,5944,3149,2795,112.7
31250, 광주시,040005, 39세,2017,5710,3017,2693,112,5347,2758,2589,106.5
31250, 광주시,045,40~44세,2017,28874,15492,13382,115.8,27577,14624,12953,112.9
31250, 광주시,045001, 40세,2017,5693,3108,2585,120.2,5411,2908,2503,116.2
31250, 광주시,045002, 41세,2017,5645,3048,2597,117.4,5372,2857,2515,113.6
31250, 광주시,045003, 42세,2017,5687,3036,2651,114.5,5438,2869,2569,111.7
31250, 광주시,045004, 43세,2017,5901,3148,2753,114.3,5655,2987,2668,112
31250, 광주시,045005, 44세,2017,5948,3152,2796,112.7,5701,3003,2698,111.3
31250, 광주시,050,45~49세,2017,30220,15968,14252,112,29085,15285,13800,110.8
31250, 광주시,050001, 45세,2017,6065,3293,2772,118.8,5824,3141,2683,117.1
31250, 광주시,050002, 46세,2017,6258,3288,2970,110.7,6037,3147,2890,108.9
31250, 광주시,050003, 47세,2017,5935,3165,2770,114.3,5704,3028,2676,113.2
31250, 광주시,050004, 48세,2017,6009,3167,2842,111.4,5777,3031,2746,110.4
31250, 광주시,050005, 49세,2017,5953,3055,2898,105.4,5743,2938,2805,104.7
31250, 광주시,055,50~54세,2017,26512,13585,12927,105.1,25482,13052,12430,105
31250, 광주시,055001, 50세,2017,5343,2663,2680,99.4,5158,2563,2595,98.8
31250, 광주시,055002, 51세,2017,5305,2760,2545,108.4,5110,2666,2444,109.1
31250, 광주시,055003, 52세,2017,5500,2844,2656,107.1,5277,2735,2542,107.6
31250, 광주시,055004, 53세,2017,5075,2609,2466,105.8,4880,2499,2381,105
31250, 광주시,055005, 54세,2017,5289,2709,2580,105,5057,2589,2468,104.9
31250, 광주시,060,55~59세,2017,27658,13791,13867,99.5,26924,13437,13487,99.6
31250, 광주시,060001, 55세,2017,5613,2874,2739,104.9,5432,2787,2645,105.4
31250, 광주시,060002, 56세,2017,5796,2851,2945,96.8,5674,2798,2876,97.3
31250, 광주시,060003, 57세,2017,5824,2885,2939,98.2,5673,2803,2870,97.7
31250, 광주시,060004, 58세,2017,5298,2599,2699,96.3,5170,2533,2637,96.1
31250, 광주시,060005, 59세,2017,5127,2582,2545,101.5,4975,2516,2459,102.3
31250, 광주시,065,60~64세,2017,21073,10632,10441,101.8,20557,10355,10202,101.5
31250, 광주시,065001, 60세,2017,4910,2496,2414,103.4,4771,2422,2349,103.1
31250, 광주시,065002, 61세,2017,4468,2253,2215,101.7,4378,2212,2166,102.1
31250, 광주시,065003, 62세,2017,4590,2292,2298,99.7,4483,2230,2253,99
31250, 광주시,065004, 63세,2017,3811,1943,1868,104,3710,1886,1824,103.4
31250, 광주시,065005, 64세,2017,3294,1648,1646,100.1,3215,1605,1610,99.7
31250, 광주시,070,65~69세,2017,13731,6864,6867,100,13493,6749,6744,100.1
31250, 광주시,070001, 65세,2017,3553,1817,1736,104.7,3474,1782,1692,105.3
31250, 광주시,070002, 66세,2017,2462,1214,1248,97.3,2412,1191,1221,97.5
31250, 광주시,070003, 67세,2017,2598,1288,1310,98.3,2547,1258,1289,97.6
31250, 광주시,070004, 68세,2017,2612,1278,1334,95.8,2581,1262,1319,95.7
31250, 광주시,070005, 69세,2017,2506,1267,1239,102.3,2479,1256,1223,102.7
31250, 광주시,075,70~74세,2017,9738,4821,4917,98,9640,4778,4862,98.3
31250, 광주시,075001, 70세,2017,2544,1291,1253,103,2510,1274,1236,103.1
31250, 광주시,075002, 71세,2017,1938,939,999,94,1911,929,982,94.6
31250, 광주시,075003, 72세,2017,1789,897,892,100.6,1777,891,886,100.6
31250, 광주시,075004, 73세,2017,1754,855,899,95.1,1740,850,890,95.5
31250, 광주시,075005, 74세,2017,1713,839,874,96,1702,834,868,96.1
31250, 광주시,080,75~79세,2017,7433,3331,4102,81.2,7392,3315,4077,81.3
31250, 광주시,080001, 75세,2017,1945,914,1031,88.7,1935,908,1027,88.4
31250, 광주시,080002, 76세,2017,1610,735,875,84,1606,733,873,84
31250, 광주시,080003, 77세,2017,1417,621,796,78,1409,617,792,77.9
31250, 광주시,080004, 78세,2017,1278,561,717,78.2,1268,558,710,78.6
31250, 광주시,080005, 79세,2017,1183,500,683,73.2,1174,499,675,73.9
31250, 광주시,085,80~84세,2017,4145,1605,2540,63.2,4129,1601,2528,63.3
31250, 광주시,085001, 80세,2017,1020,431,589,73.2,1015,430,585,73.5
31250, 광주시,085002, 81세,2017,925,390,535,72.9,923,390,533,73.2
31250, 광주시,085003, 82세,2017,889,311,578,53.8,888,311,577,53.9
31250, 광주시,085004, 83세,2017,699,263,436,60.3,695,261,434,60.1
31250, 광주시,085005, 84세,2017,612,210,402,52.2,608,209,399,52.4
31250, 광주시,090,85~89세,2017,1907,531,1376,38.6,1895,524,1371,38.2
31250, 광주시,090001, 85세,2017,508,162,346,46.8,504,160,344,46.5
31250, 광주시,090002, 86세,2017,385,106,279,38,383,105,278,37.8
31250, 광주시,090003, 87세,2017,411,114,297,38.4,407,111,296,37.5
31250, 광주시,090004, 88세,2017,346,100,246,40.7,344,99,245,40.4
31250, 광주시,090005, 89세,2017,257,49,208,23.6,257,49,208,23.6
31250, 광주시,095,90~94세,2017,713,135,578,23.4,710,135,575,23.5
31250, 광주시,095001, 90세,2017,221,40,181,22.1,219,40,179,22.3
31250, 광주시,095002, 91세,2017,163,37,126,29.4,162,37,125,29.6
31250, 광주시,095003, 92세,2017,124,19,105,18.1,124,19,105,18.1
31250, 광주시,095004, 93세,2017,102,19,83,22.9,102,19,83,22.9
31250, 광주시,095005, 94세,2017,103,20,83,24.1,103,20,83,24.1
31250, 광주시,100,95~99세,2017,170,32,138,23.2,170,32,138,23.2
31250, 광주시,100001, 95세,2017,67,8,59,13.6,67,8,59,13.6
31250, 광주시,100002, 96세,2017,37,11,26,42.3,37,11,26,42.3
31250, 광주시,100003, 97세,2017,35,8,27,29.6,35,8,27,29.6
31250, 광주시,100004, 98세,2017,18,X,15,20,18,X,15,20
31250, 광주시,100005, 99세,2017,13,X,11,18.2,13,X,11,18.2
31250, 광주시,101,100세이상,2017,18,X,16,12.5,18,X,16,12.5
31250, 광주시,102,15세미만,2017,49263,25175,24088,104.5,48940,25015,23925,104.6
31250, 광주시,103,15~64세,2017,253928,134381,119547,112.4,239005,124165,114840,108.1
31250, 광주시,104,65세이상,2017,37855,17321,20534,84.4,37447,17136,20311,84.4
31250, 광주시,086,85세이상,2017,2808,700,2108,33.2,2793,693,2100,33
31250, 광주시,126,평균연령,2017,39.9,39.1,40.6,,40,39.4,40.7,
31250, 광주시,127,중위연령,2017,40.3,39.5,41.3,,40.8,40.3,41.5,
31260, 양주시,000,합계,2017,212631,109115,103516,105.4,203236,102258,100978,101.3
31260, 양주시,005,0~4세,2017,9055,4678,4377,106.9,8997,4642,4355,106.6
31260, 양주시,005001, 0세,2017,1526,805,721,111.7,1513,800,713,112.2
31260, 양주시,005002, 1세,2017,1707,882,825,106.9,1694,876,818,107.1
31260, 양주시,005003, 2세,2017,1900,1016,884,114.9,1886,1004,882,113.8
31260, 양주시,005004, 3세,2017,1928,974,954,102.1,1916,966,950,101.7
31260, 양주시,005005, 4세,2017,1994,1001,993,100.8,1988,996,992,100.4
31260, 양주시,010,5~9세,2017,11115,5642,5473,103.1,11059,5610,5449,103
31260, 양주시,010001, 5세,2017,2318,1182,1136,104,2305,1174,1131,103.8
31260, 양주시,010002, 6세,2017,2238,1125,1113,101.1,2226,1119,1107,101.1
31260, 양주시,010003, 7세,2017,2155,1075,1080,99.5,2141,1066,1075,99.2
31260, 양주시,010004, 8세,2017,2153,1108,1045,106,2147,1106,1041,106.2
31260, 양주시,010005, 9세,2017,2251,1152,1099,104.8,2240,1145,1095,104.6
31260, 양주시,015,10~14세,2017,11093,5715,5378,106.3,11064,5698,5366,106.2
31260, 양주시,015001, 10세,2017,2351,1209,1142,105.9,2342,1204,1138,105.8
31260, 양주시,015002, 11세,2017,2146,1104,1042,106,2139,1100,1039,105.9
31260, 양주시,015003, 12세,2017,2099,1128,971,116.2,2095,1126,969,116.2
31260, 양주시,015004, 13세,2017,2262,1181,1081,109.3,2260,1180,1080,109.3
31260, 양주시,015005, 14세,2017,2235,1093,1142,95.7,2228,1088,1140,95.4
31260, 양주시,020,15~19세,2017,12251,6270,5981,104.8,12179,6225,5954,104.6
31260, 양주시,020001, 15세,2017,2298,1213,1085,111.8,2293,1209,1084,111.5
31260, 양주시,020002, 16세,2017,2448,1241,1207,102.8,2440,1239,1201,103.2
31260, 양주시,020003, 17세,2017,2542,1289,1253,102.9,2531,1282,1249,102.6
31260, 양주시,020004, 18세,2017,2634,1357,1277,106.3,2615,1345,1270,105.9
31260, 양주시,020005, 19세,2017,2329,1170,1159,100.9,2300,1150,1150,100
31260, 양주시,025,20~24세,2017,12714,6948,5766,120.5,11795,6228,5567,111.9
31260, 양주시,025001, 20세,2017,2518,1306,1212,107.8,2439,1251,1188,105.3
31260, 양주시,025002, 21세,2017,2492,1394,1098,127,2370,1301,1069,121.7
31260, 양주시,025003, 22세,2017,2513,1363,1150,118.5,2345,1230,1115,110.3
31260, 양주시,025004, 23세,2017,2572,1411,1161,121.5,2328,1218,1110,109.7
31260, 양주시,025005, 24세,2017,2619,1474,1145,128.7,2313,1228,1085,113.2
31260, 양주시,030,25~29세,2017,12775,7414,5361,138.3,10660,5722,4938,115.9
31260, 양주시,030001, 25세,2017,2725,1529,1196,127.8,2335,1217,1118,108.9
31260, 양주시,030002, 26세,2017,2689,1563,1126,138.8,2282,1236,1046,118.2
31260, 양주시,030003, 27세,2017,2573,1520,1053,144.3,2143,1171,972,120.5
31260, 양주시,030004, 28세,2017,2358,1376,982,140.1,1935,1041,894,116.4
31260, 양주시,030005, 29세,2017,2430,1426,1004,142,1965,1057,908,116.4
31260, 양주시,035,30~34세,2017,12829,7175,5654,126.9,10970,5713,5257,108.7
31260, 양주시,035001, 30세,2017,2362,1385,977,141.8,1937,1036,901,115
31260, 양주시,035002, 31세,2017,2483,1398,1085,128.8,2102,1098,1004,109.4
31260, 양주시,035003, 32세,2017,2403,1307,1096,119.3,2029,1028,1001,102.7
31260, 양주시,035004, 33세,2017,2661,1464,1197,122.3,2307,1179,1128,104.5
31260, 양주시,035005, 34세,2017,2920,1621,1299,124.8,2595,1372,1223,112.2
31260, 양주시,040,35~39세,2017,16805,8688,8117,107,15464,7687,7777,98.8
31260, 양주시,040001, 35세,2017,3212,1670,1542,108.3,2925,1451,1474,98.4
31260, 양주시,040002, 36세,2017,3317,1729,1588,108.9,3041,1525,1516,100.6
31260, 양주시,040003, 37세,2017,3646,1889,1757,107.5,3354,1669,1685,99.1
31260, 양주시,040004, 38세,2017,3375,1723,1652,104.3,3116,1532,1584,96.7
31260, 양주시,040005, 39세,2017,3255,1677,1578,106.3,3028,1510,1518,99.5
31260, 양주시,045,40~44세,2017,18574,9540,9034,105.6,17733,8982,8751,102.6
31260, 양주시,045001, 40세,2017,3318,1669,1649,101.2,3125,1539,1586,97
31260, 양주시,045002, 41세,2017,3447,1764,1683,104.8,3273,1643,1630,100.8
31260, 양주시,045003, 42세,2017,3658,1892,1766,107.1,3494,1781,1713,104
31260, 양주시,045004, 43세,2017,3964,2041,1923,106.1,3803,1935,1868,103.6
31260, 양주시,045005, 44세,2017,4187,2174,2013,108,4038,2084,1954,106.7
31260, 양주시,050,45~49세,2017,19821,10391,9430,110.2,19031,9866,9165,107.6
31260, 양주시,050001, 45세,2017,4044,2171,1873,115.9,3865,2051,1814,113.1
31260, 양주시,050002, 46세,2017,4070,2153,1917,112.3,3918,2045,1873,109.2
31260, 양주시,050003, 47세,2017,3906,2031,1875,108.3,3757,1934,1823,106.1
31260, 양주시,050004, 48세,2017,3986,2035,1951,104.3,3831,1935,1896,102.1
31260, 양주시,050005, 49세,2017,3815,2001,1814,110.3,3660,1901,1759,108.1
31260, 양주시,055,50~54세,2017,16850,8953,7897,113.4,16332,8611,7721,111.5
31260, 양주시,055001, 50세,2017,3438,1829,1609,113.7,3315,1745,1570,111.1
31260, 양주시,055002, 51세,2017,3387,1771,1616,109.6,3288,1704,1584,107.6
31260, 양주시,055003, 52세,2017,3477,1865,1612,115.7,3376,1793,1583,113.3
31260, 양주시,055004, 53세,2017,3170,1729,1441,120,3082,1675,1407,119
31260, 양주시,055005, 54세,2017,3378,1759,1619,108.6,3271,1694,1577,107.4
31260, 양주시,060,55~59세,2017,16839,8653,8186,105.7,16496,8445,8051,104.9
31260, 양주시,060001, 55세,2017,3396,1807,1589,113.7,3331,1768,1563,113.1
31260, 양주시,060002, 56세,2017,3544,1801,1743,103.3,3483,1763,1720,102.5
31260, 양주시,060003, 57세,2017,3619,1819,1800,101.1,3532,1766,1766,100
31260, 양주시,060004, 58세,2017,3234,1673,1561,107.2,3172,1638,1534,106.8
31260, 양주시,060005, 59세,2017,3046,1553,1493,104,2978,1510,1468,102.9
31260, 양주시,065,60~64세,2017,13112,6490,6622,98,12871,6376,6495,98.2
31260, 양주시,065001, 60세,2017,3058,1529,1529,100,3008,1504,1504,100
31260, 양주시,065002, 61세,2017,2820,1425,1395,102.2,2762,1401,1361,102.9
31260, 양주시,065003, 62세,2017,2802,1358,1444,94,2750,1335,1415,94.3
31260, 양주시,065004, 63세,2017,2409,1201,1208,99.4,2365,1182,1183,99.9
31260, 양주시,065005, 64세,2017,2023,977,1046,93.4,1986,954,1032,92.4
31260, 양주시,070,65~69세,2017,8847,4244,4603,92.2,8726,4184,4542,92.1
31260, 양주시,070001, 65세,2017,2128,1025,1103,92.9,2093,1005,1088,92.4
31260, 양주시,070002, 66세,2017,1468,713,755,94.4,1441,698,743,93.9
31260, 양주시,070003, 67세,2017,1682,801,881,90.9,1661,792,869,91.1
31260, 양주시,070004, 68세,2017,1785,833,952,87.5,1761,821,940,87.3
31260, 양주시,070005, 69세,2017,1784,872,912,95.6,1770,868,902,96.2
31260, 양주시,075,70~74세,2017,7579,3613,3966,91.1,7525,3583,3942,90.9
31260, 양주시,075001, 70세,2017,1891,923,968,95.4,1870,911,959,95
31260, 양주시,075002, 71세,2017,1435,695,740,93.9,1421,688,733,93.9
31260, 양주시,075003, 72세,2017,1460,706,754,93.6,1450,701,749,93.6
31260, 양주시,075004, 73세,2017,1382,635,747,85,1378,632,746,84.7
31260, 양주시,075005, 74세,2017,1411,654,757,86.4,1406,651,755,86.2
31260, 양주시,080,75~79세,2017,6158,2636,3522,74.8,6136,2626,3510,74.8
31260, 양주시,080001, 75세,2017,1608,715,893,80.1,1601,712,889,80.1
31260, 양주시,080002, 76세,2017,1300,556,744,74.7,1296,553,743,74.4
31260, 양주시,080003, 77세,2017,1117,496,621,79.9,1113,495,618,80.1
31260, 양주시,080004, 78세,2017,1070,443,627,70.7,1068,442,626,70.6
31260, 양주시,080005, 79세,2017,1063,426,637,66.9,1058,424,634,66.9
31260, 양주시,085,80~84세,2017,3735,1435,2300,62.4,3723,1432,2291,62.5
31260, 양주시,085001, 80세,2017,945,406,539,75.3,941,406,535,75.9
31260, 양주시,085002, 81세,2017,806,322,484,66.5,804,321,483,66.5
31260, 양주시,085003, 82세,2017,779,300,479,62.6,777,299,478,62.6
31260, 양주시,085004, 83세,2017,642,230,412,55.8,641,230,411,56
31260, 양주시,085005, 84세,2017,563,177,386,45.9,560,176,384,45.8
31260, 양주시,090,85~89세,2017,1702,479,1223,39.2,1698,477,1221,39.1
31260, 양주시,090001, 85세,2017,474,153,321,47.7,474,153,321,47.7
31260, 양주시,090002, 86세,2017,358,98,260,37.7,357,97,260,37.3
31260, 양주시,090003, 87세,2017,325,82,243,33.7,324,81,243,33.3
31260, 양주시,090004, 88세,2017,291,78,213,36.6,290,78,212,36.8
31260, 양주시,090005, 89세,2017,254,68,186,36.6,253,68,185,36.8
31260, 양주시,095,90~94세,2017,609,124,485,25.6,609,124,485,25.6
31260, 양주시,095001, 90세,2017,173,47,126,37.3,173,47,126,37.3
31260, 양주시,095002, 91세,2017,133,17,116,14.7,133,17,116,14.7
31260, 양주시,095003, 92세,2017,114,24,90,26.7,114,24,90,26.7
31260, 양주시,095004, 93세,2017,98,17,81,21,98,17,81,21
31260, 양주시,095005, 94세,2017,91,19,72,26.4,91,19,72,26.4
31260, 양주시,100,95~99세,2017,153,25,128,19.5,153,25,128,19.5
31260, 양주시,100001, 95세,2017,55,10,45,22.2,55,10,45,22.2
31260, 양주시,100002, 96세,2017,40,7,33,21.2,40,7,33,21.2
31260, 양주시,100003, 97세,2017,29,5,24,20.8,29,5,24,20.8
31260, 양주시,100004, 98세,2017,19,X,16,18.8,19,X,16,18.8
31260, 양주시,100005, 99세,2017,10,X,10,0,10,X,10,0
31260, 양주시,101,100세이상,2017,15,X,13,15.4,15,X,13,15.4
31260, 양주시,102,15세미만,2017,31263,16035,15228,105.3,31120,15950,15170,105.1
31260, 양주시,103,15~64세,2017,152570,80522,72048,111.8,143531,73855,69676,106
31260, 양주시,104,65세이상,2017,28798,12558,16240,77.3,28585,12453,16132,77.2
31260, 양주시,086,85세이상,2017,2479,630,1849,34.1,2475,628,1847,34
31260, 양주시,126,평균연령,2017,40.9,39.9,42,,41.1,40.2,42,
31260, 양주시,127,중위연령,2017,42.2,41.2,43.3,,42.9,42.2,43.5,
31270, 포천시,000,합계,2017,161239,87185,74054,117.7,145093,75147,69946,107.4
31270, 포천시,005,0~4세,2017,5094,2611,2483,105.2,5023,2579,2444,105.5
31270, 포천시,005001, 0세,2017,892,466,426,109.4,882,463,419,110.5
31270, 포천시,005002, 1세,2017,1021,538,483,111.4,1003,529,474,111.6
31270, 포천시,005003, 2세,2017,1080,544,536,101.5,1064,539,525,102.7
31270, 포천시,005004, 3세,2017,1039,526,513,102.5,1028,518,510,101.6
31270, 포천시,005005, 4세,2017,1062,537,525,102.3,1046,530,516,102.7
31270, 포천시,010,5~9세,2017,5871,3039,2832,107.3,5812,3010,2802,107.4
31270, 포천시,010001, 5세,2017,1189,598,591,101.2,1178,592,586,101
31270, 포천시,010002, 6세,2017,1153,641,512,125.2,1137,631,506,124.7
31270, 포천시,010003, 7세,2017,1157,581,576,100.9,1147,578,569,101.6
31270, 포천시,010004, 8세,2017,1151,573,578,99.1,1139,568,571,99.5
31270, 포천시,010005, 9세,2017,1221,646,575,112.3,1211,641,570,112.5
31270, 포천시,015,10~14세,2017,6249,3264,2985,109.3,6222,3254,2968,109.6
31270, 포천시,015001, 10세,2017,1258,686,572,119.9,1251,683,568,120.2
31270, 포천시,015002, 11세,2017,1209,627,582,107.7,1205,625,580,107.8
31270, 포천시,015003, 12세,2017,1172,629,543,115.8,1167,627,540,116.1
31270, 포천시,015004, 13세,2017,1187,617,570,108.2,1182,615,567,108.5
31270, 포천시,015005, 14세,2017,1423,705,718,98.2,1417,704,713,98.7
31270, 포천시,020,15~19세,2017,8569,4505,4064,110.9,8440,4426,4014,110.3
31270, 포천시,020001, 15세,2017,1414,755,659,114.6,1406,748,658,113.7
31270, 포천시,020002, 16세,2017,1562,840,722,116.3,1555,836,719,116.3
31270, 포천시,020003, 17세,2017,1712,881,831,106,1696,869,827,105.1
31270, 포천시,020004, 18세,2017,1798,942,856,110,1773,930,843,110.3
31270, 포천시,020005, 19세,2017,2083,1087,996,109.1,2010,1043,967,107.9
31270, 포천시,025,20~24세,2017,12302,7041,5261,133.8,10144,5404,4740,114
31270, 포천시,025001, 20세,2017,2248,1136,1112,102.2,2049,1010,1039,97.2
31270, 포천시,025002, 21세,2017,2466,1341,1125,119.2,2123,1090,1033,105.5
31270, 포천시,025003, 22세,2017,2449,1403,1046,134.1,2020,1076,944,114
31270, 포천시,025004, 23세,2017,2504,1504,1000,150.4,1992,1108,884,125.3
31270, 포천시,025005, 24세,2017,2635,1657,978,169.4,1960,1120,840,133.3
31270, 포천시,030,25~29세,2017,12444,7975,4469,178.5,8408,4738,3670,129.1
31270, 포천시,030001, 25세,2017,2626,1649,977,168.8,1891,1080,811,133.2
31270, 포천시,030002, 26세,2017,2626,1739,887,196.1,1782,1042,740,140.8
31270, 포천시,030003, 27세,2017,2516,1564,952,164.3,1693,909,784,115.9
31270, 포천시,030004, 28세,2017,2350,1523,827,184.2,1535,854,681,125.4
31270, 포천시,030005, 29세,2017,2326,1500,826,181.6,1507,853,654,130.4
31270, 포천시,035,30~34세,2017,10585,6651,3934,169.1,7311,4038,3273,123.4
31270, 포천시,035001, 30세,2017,2227,1439,788,182.6,1451,808,643,125.7
31270, 포천시,035002, 31세,2017,2166,1402,764,183.5,1415,799,616,129.7
31270, 포천시,035003, 32세,2017,2047,1298,749,173.3,1417,778,639,121.8
31270, 포천시,035004, 33세,2017,1988,1225,763,160.6,1426,793,633,125.3
31270, 포천시,035005, 34세,2017,2157,1287,870,147.9,1602,860,742,115.9
31270, 포천시,040,35~39세,2017,10676,6167,4509,136.8,8559,4552,4007,113.6
31270, 포천시,040001, 35세,2017,2174,1290,884,145.9,1656,894,762,117.3
31270, 포천시,040002, 36세,2017,2173,1273,900,141.4,1726,942,784,120.2
31270, 포천시,040003, 37세,2017,2138,1242,896,138.6,1750,933,817,114.2
31270, 포천시,040004, 38세,2017,2120,1224,896,136.6,1700,901,799,112.8
31270, 포천시,040005, 39세,2017,2071,1138,933,122,1727,882,845,104.4
31270, 포천시,045,40~44세,2017,11303,6212,5091,122,9930,5234,4696,111.5
31270, 포천시,045001, 40세,2017,2126,1174,952,123.3,1785,931,854,109
31270, 포천시,045002, 41세,2017,2116,1168,948,123.2,1816,951,865,109.9
31270, 포천시,045003, 42세,2017,2216,1182,1034,114.3,1954,992,962,103.1
31270, 포천시,045004, 43세,2017,2395,1359,1036,131.2,2150,1184,966,122.6
31270, 포천시,045005, 44세,2017,2450,1329,1121,118.6,2225,1176,1049,112.1
31270, 포천시,050,45~49세,2017,13511,7362,6149,119.7,12449,6660,5789,115
31270, 포천시,050001, 45세,2017,2570,1423,1147,124.1,2310,1242,1068,116.3
31270, 포천시,050002, 46세,2017,2742,1524,1218,125.1,2532,1376,1156,119
31270, 포천시,050003, 47세,2017,2581,1394,1187,117.4,2356,1254,1102,113.8
31270, 포천시,050004, 48세,2017,2689,1454,1235,117.7,2527,1347,1180,114.2
31270, 포천시,050005, 49세,2017,2929,1567,1362,115.1,2724,1441,1283,112.3
31270, 포천시,055,50~54세,2017,14119,7822,6297,124.2,13306,7325,5981,122.5
31270, 포천시,055001, 50세,2017,2691,1438,1253,114.8,2509,1335,1174,113.7
31270, 포천시,055002, 51세,2017,2818,1593,1225,130,2657,1481,1176,125.9
31270, 포천시,055003, 52세,2017,2933,1634,1299,125.8,2768,1538,1230,125
31270, 포천시,055004, 53세,2017,2757,1522,1235,123.2,2608,1426,1182,120.6
31270, 포천시,055005, 54세,2017,2920,1635,1285,127.2,2764,1545,1219,126.7
31270, 포천시,060,55~59세,2017,15014,8042,6972,115.3,14521,7741,6780,114.2
31270, 포천시,060001, 55세,2017,2891,1558,1333,116.9,2771,1490,1281,116.3
31270, 포천시,060002, 56세,2017,3141,1677,1464,114.5,3045,1615,1430,112.9
31270, 포천시,060003, 57세,2017,3203,1736,1467,118.3,3076,1654,1422,116.3
31270, 포천시,060004, 58세,2017,2884,1510,1374,109.9,2798,1457,1341,108.7
31270, 포천시,060005, 59세,2017,2895,1561,1334,117,2831,1525,1306,116.8
31270, 포천시,065,60~64세,2017,11005,5913,5092,116.1,10690,5730,4960,115.5
31270, 포천시,065001, 60세,2017,2660,1452,1208,120.2,2570,1399,1171,119.5
31270, 포천시,065002, 61세,2017,2419,1322,1097,120.5,2349,1282,1067,120.1
31270, 포천시,065003, 62세,2017,2293,1266,1027,123.3,2245,1238,1007,122.9
31270, 포천시,065004, 63세,2017,1974,1011,963,105,1917,981,936,104.8
31270, 포천시,065005, 64세,2017,1659,862,797,108.2,1609,830,779,106.5
31270, 포천시,070,65~69세,2017,6920,3561,3359,106,6798,3479,3319,104.8
31270, 포천시,070001, 65세,2017,1715,904,811,111.5,1677,878,799,109.9
31270, 포천시,070002, 66세,2017,1100,583,517,112.8,1073,565,508,111.2
31270, 포천시,070003, 67세,2017,1281,623,658,94.7,1263,610,653,93.4
31270, 포천시,070004, 68세,2017,1441,746,695,107.3,1421,732,689,106.2
31270, 포천시,070005, 69세,2017,1383,705,678,104,1364,694,670,103.6
31270, 포천시,075,70~74세,2017,5946,2691,3255,82.7,5896,2666,3230,82.5
31270, 포천시,075001, 70세,2017,1433,646,787,82.1,1422,640,782,81.8
31270, 포천시,075002, 71세,2017,1150,544,606,89.8,1138,535,603,88.7
31270, 포천시,075003, 72세,2017,1168,538,630,85.4,1161,535,626,85.5
31270, 포천시,075004, 73세,2017,1073,486,587,82.8,1062,481,581,82.8
31270, 포천시,075005, 74세,2017,1122,477,645,74,1113,475,638,74.5
31270, 포천시,080,75~79세,2017,5638,2306,3332,69.2,5610,2295,3315,69.2
31270, 포천시,080001, 75세,2017,1300,544,756,72,1289,541,748,72.3
31270, 포천시,080002, 76세,2017,1136,478,658,72.6,1130,475,655,72.5
31270, 포천시,080003, 77세,2017,1148,478,670,71.3,1145,476,669,71.2
31270, 포천시,080004, 78세,2017,1106,442,664,66.6,1102,440,662,66.5
31270, 포천시,080005, 79세,2017,948,364,584,62.3,944,363,581,62.5
31270, 포천시,085,80~84세,2017,3586,1352,2234,60.5,3576,1348,2228,60.5
31270, 포천시,085001, 80세,2017,880,355,525,67.6,877,354,523,67.7
31270, 포천시,085002, 81세,2017,797,304,493,61.7,794,303,491,61.7
31270, 포천시,085003, 82세,2017,790,290,500,58,787,288,499,57.7
31270, 포천시,085004, 83세,2017,612,226,386,58.5,611,226,385,58.7
31270, 포천시,085005, 84세,2017,507,177,330,53.6,507,177,330,53.6
31270, 포천시,090,85~89세,2017,1616,467,1149,40.6,1610,465,1145,40.6
31270, 포천시,090001, 85세,2017,415,134,281,47.7,414,134,280,47.9
31270, 포천시,090002, 86세,2017,340,120,220,54.5,336,119,217,54.8
31270, 포천시,090003, 87세,2017,348,87,261,33.3,348,87,261,33.3
31270, 포천시,090004, 88세,2017,306,78,228,34.2,305,77,228,33.8
31270, 포천시,090005, 89세,2017,207,48,159,30.2,207,48,159,30.2
31270, 포천시,095,90~94세,2017,610,152,458,33.2,608,152,456,33.3
31270, 포천시,095001, 90세,2017,176,43,133,32.3,175,43,132,32.6
31270, 포천시,095002, 91세,2017,130,35,95,36.8,130,35,95,36.8
31270, 포천시,095003, 92세,2017,124,30,94,31.9,123,30,93,32.3
31270, 포천시,095004, 93세,2017,84,24,60,40,84,24,60,40
31270, 포천시,095005, 94세,2017,96,20,76,26.3,96,20,76,26.3
31270, 포천시,100,95~99세,2017,163,46,117,39.3,163,46,117,39.3
31270, 포천시,100001, 95세,2017,54,17,37,45.9,54,17,37,45.9
31270, 포천시,100002, 96세,2017,49,11,38,28.9,49,11,38,28.9
31270, 포천시,100003, 97세,2017,29,12,17,70.6,29,12,17,70.6
31270, 포천시,100004, 98세,2017,18,X,14,28.6,18,X,14,28.6
31270, 포천시,100005, 99세,2017,13,X,11,18.2,13,X,11,18.2
31270, 포천시,101,100세이상,2017,18,6,12,50,17,5,12,41.7
31270, 포천시,102,15세미만,2017,17214,8914,8300,107.4,17057,8843,8214,107.7
31270, 포천시,103,15~64세,2017,119528,67690,51838,130.6,103758,55848,47910,116.6
31270, 포천시,104,65세이상,2017,24497,10581,13916,76,24278,10456,13822,75.6
31270, 포천시,086,85세이상,2017,2407,671,1736,38.7,2398,668,1730,38.6
31270, 포천시,126,평균연령,2017,42.8,41.5,44.5,,43.7,42.6,44.9,
31270, 포천시,127,중위연령,2017,44,42,46.2,,46.2,45.3,47.1,
31280, 여주시,000,합계,2017,111476,56779,54697,103.8,107019,53995,53024,101.8
31280, 여주시,005,0~4세,2017,3902,2042,1860,109.8,3889,2034,1855,109.6
31280, 여주시,005001, 0세,2017,623,314,309,101.6,620,312,308,101.3
31280, 여주시,005002, 1세,2017,767,389,378,102.9,764,388,376,103.2
31280, 여주시,005003, 2세,2017,818,434,384,113,816,432,384,112.5
31280, 여주시,005004, 3세,2017,818,418,400,104.5,814,415,399,104
31280, 여주시,005005, 4세,2017,876,487,389,125.2,875,487,388,125.5
31280, 여주시,010,5~9세,2017,4622,2418,2204,109.7,4608,2410,2198,109.6
31280, 여주시,010001, 5세,2017,922,490,432,113.4,920,488,432,113
31280, 여주시,010002, 6세,2017,972,494,478,103.3,966,489,477,102.5
31280, 여주시,010003, 7세,2017,910,450,460,97.8,907,450,457,98.5
31280, 여주시,010004, 8세,2017,909,502,407,123.3,908,502,406,123.6
31280, 여주시,010005, 9세,2017,909,482,427,112.9,907,481,426,112.9
31280, 여주시,015,10~14세,2017,4705,2382,2323,102.5,4700,2380,2320,102.6
31280, 여주시,015001, 10세,2017,979,492,487,101,977,491,486,101
31280, 여주시,015002, 11세,2017,891,448,443,101.1,891,448,443,101.1
31280, 여주시,015003, 12세,2017,921,476,445,107,920,476,444,107.2
31280, 여주시,015004, 13세,2017,979,521,458,113.8,978,520,458,113.5
31280, 여주시,015005, 14세,2017,935,445,490,90.8,934,445,489,91
31280, 여주시,020,15~19세,2017,6430,3330,3100,107.4,6269,3237,3032,106.8
31280, 여주시,020001, 15세,2017,1036,531,505,105.1,1032,529,503,105.2
31280, 여주시,020002, 16세,2017,1233,635,598,106.2,1230,634,596,106.4
31280, 여주시,020003, 17세,2017,1373,685,688,99.6,1365,679,686,99
31280, 여주시,020004, 18세,2017,1391,735,656,112,1362,719,643,111.8
31280, 여주시,020005, 19세,2017,1397,744,653,113.9,1280,676,604,111.9
31280, 여주시,025,20~24세,2017,6813,3792,3021,125.5,6039,3289,2750,119.6
31280, 여주시,025001, 20세,2017,1432,786,646,121.7,1320,714,606,117.8
31280, 여주시,025002, 21세,2017,1323,698,625,111.7,1214,638,576,110.8
31280, 여주시,025003, 22세,2017,1352,790,562,140.6,1208,693,515,134.6
31280, 여주시,025004, 23세,2017,1319,731,588,124.3,1155,615,540,113.9
31280, 여주시,025005, 24세,2017,1387,787,600,131.2,1142,629,513,122.6
31280, 여주시,030,25~29세,2017,6555,3715,2840,130.8,5503,3008,2495,120.6
31280, 여주시,030001, 25세,2017,1423,798,625,127.7,1207,654,553,118.3
31280, 여주시,030002, 26세,2017,1382,802,580,138.3,1157,644,513,125.5
31280, 여주시,030003, 27세,2017,1299,732,567,129.1,1082,590,492,119.9
31280, 여주시,030004, 28세,2017,1242,727,515,141.2,1040,588,452,130.1
31280, 여주시,030005, 29세,2017,1209,656,553,118.6,1017,532,485,109.7
31280, 여주시,035,30~34세,2017,6212,3376,2836,119,5412,2834,2578,109.9
31280, 여주시,035001, 30세,2017,1138,652,486,134.2,959,533,426,125.1
31280, 여주시,035002, 31세,2017,1230,686,544,126.1,1058,571,487,117.2
31280, 여주시,035003, 32세,2017,1225,663,562,118,1044,542,502,108
31280, 여주시,035004, 33세,2017,1290,714,576,124,1144,607,537,113
31280, 여주시,035005, 34세,2017,1329,661,668,99,1207,581,626,92.8
31280, 여주시,040,35~39세,2017,7586,3926,3660,107.3,7117,3623,3494,103.7
31280, 여주시,040001, 35세,2017,1519,766,753,101.7,1405,697,708,98.4
31280, 여주시,040002, 36세,2017,1567,819,748,109.5,1456,752,704,106.8
31280, 여주시,040003, 37세,2017,1601,844,757,111.5,1516,786,730,107.7
31280, 여주시,040004, 38세,2017,1498,764,734,104.1,1411,707,704,100.4
31280, 여주시,040005, 39세,2017,1401,733,668,109.7,1329,681,648,105.1
31280, 여주시,045,40~44세,2017,7805,4005,3800,105.4,7510,3839,3671,104.6
31280, 여주시,045001, 40세,2017,1453,760,693,109.7,1381,716,665,107.7
31280, 여주시,045002, 41세,2017,1463,730,733,99.6,1407,694,713,97.3
31280, 여주시,045003, 42세,2017,1491,755,736,102.6,1439,727,712,102.1
31280, 여주시,045004, 43세,2017,1688,874,814,107.4,1632,848,784,108.2
31280, 여주시,045005, 44세,2017,1710,886,824,107.5,1651,854,797,107.2
31280, 여주시,050,45~49세,2017,8995,4783,4212,113.6,8735,4646,4089,113.6
31280, 여주시,050001, 45세,2017,1654,913,741,123.2,1604,887,717,123.7
31280, 여주시,050002, 46세,2017,1828,964,864,111.6,1764,930,834,111.5
31280, 여주시,050003, 47세,2017,1764,942,822,114.6,1719,917,802,114.3
31280, 여주시,050004, 48세,2017,1916,989,927,106.7,1863,958,905,105.9
31280, 여주시,050005, 49세,2017,1833,975,858,113.6,1785,954,831,114.8
31280, 여주시,055,50~54세,2017,9062,4749,4313,110.1,8844,4638,4206,110.3
31280, 여주시,055001, 50세,2017,1757,901,856,105.3,1703,872,831,104.9
31280, 여주시,055002, 51세,2017,1797,965,832,116,1763,950,813,116.9
31280, 여주시,055003, 52세,2017,1849,972,877,110.8,1794,945,849,111.3
31280, 여주시,055004, 53세,2017,1794,929,865,107.4,1760,911,849,107.3
31280, 여주시,055005, 54세,2017,1865,982,883,111.2,1824,960,864,111.1
31280, 여주시,060,55~59세,2017,10177,5224,4953,105.5,9986,5131,4855,105.7
31280, 여주시,060001, 55세,2017,1988,1036,952,108.8,1938,1009,929,108.6
31280, 여주시,060002, 56세,2017,2199,1141,1058,107.8,2161,1122,1039,108
31280, 여주시,060003, 57세,2017,2121,1070,1051,101.8,2086,1051,1035,101.5
31280, 여주시,060004, 58세,2017,1916,995,921,108,1880,981,899,109.1
31280, 여주시,060005, 59세,2017,1953,982,971,101.1,1921,968,953,101.6
31280, 여주시,065,60~64세,2017,8323,4155,4168,99.7,8218,4086,4132,98.9
31280, 여주시,065001, 60세,2017,1808,908,900,100.9,1783,890,893,99.7
31280, 여주시,065002, 61세,2017,1812,931,881,105.7,1791,917,874,104.9
31280, 여주시,065003, 62세,2017,1803,909,894,101.7,1784,898,886,101.4
31280, 여주시,065004, 63세,2017,1543,743,800,92.9,1517,725,792,91.5
31280, 여주시,065005, 64세,2017,1357,664,693,95.8,1343,656,687,95.5
31280, 여주시,070,65~69세,2017,5836,2963,2873,103.1,5787,2945,2842,103.6
31280, 여주시,070001, 65세,2017,1680,867,813,106.6,1667,864,803,107.6
31280, 여주시,070002, 66세,2017,1005,522,483,108.1,994,520,474,109.7
31280, 여주시,070003, 67세,2017,997,490,507,96.6,990,487,503,96.8
31280, 여주시,070004, 68세,2017,1072,530,542,97.8,1063,524,539,97.2
31280, 여주시,070005, 69세,2017,1082,554,528,104.9,1073,550,523,105.2
31280, 여주시,075,70~74세,2017,4813,2257,2556,88.3,4786,2245,2541,88.4
31280, 여주시,075001, 70세,2017,1146,578,568,101.8,1134,571,563,101.4
31280, 여주시,075002, 71세,2017,900,438,462,94.8,895,437,458,95.4
31280, 여주시,075003, 72세,2017,918,419,499,84,915,418,497,84.1
31280, 여주시,075004, 73세,2017,925,391,534,73.2,921,389,532,73.1
31280, 여주시,075005, 74세,2017,924,431,493,87.4,921,430,491,87.6
31280, 여주시,080,75~79세,2017,4596,1996,2600,76.8,4584,1989,2595,76.6
31280, 여주시,080001, 75세,2017,1103,501,602,83.2,1099,499,600,83.2
31280, 여주시,080002, 76세,2017,1043,467,576,81.1,1039,463,576,80.4
31280, 여주시,080003, 77세,2017,827,345,482,71.6,825,345,480,71.9
31280, 여주시,080004, 78세,2017,849,360,489,73.6,847,359,488,73.6
31280, 여주시,080005, 79세,2017,774,323,451,71.6,774,323,451,71.6
31280, 여주시,085,80~84세,2017,3037,1152,1885,61.1,3031,1149,1882,61.1
31280, 여주시,085001, 80세,2017,756,314,442,71,754,313,441,71
31280, 여주시,085002, 81세,2017,681,248,433,57.3,680,248,432,57.4
31280, 여주시,085003, 82세,2017,622,235,387,60.7,621,234,387,60.5
31280, 여주시,085004, 83세,2017,531,215,316,68,530,215,315,68.3
31280, 여주시,085005, 84세,2017,447,140,307,45.6,446,139,307,45.3
31280, 여주시,090,85~89세,2017,1401,398,1003,39.7,1396,397,999,39.7
31280, 여주시,090001, 85세,2017,365,107,258,41.5,364,107,257,41.6
31280, 여주시,090002, 86세,2017,322,102,220,46.4,319,101,218,46.3
31280, 여주시,090003, 87세,2017,288,84,204,41.2,288,84,204,41.2
31280, 여주시,090004, 88세,2017,231,54,177,30.5,230,54,176,30.7
31280, 여주시,090005, 89세,2017,195,51,144,35.4,195,51,144,35.4
31280, 여주시,095,90~94세,2017,482,92,390,23.6,482,92,390,23.6
31280, 여주시,095001, 90세,2017,136,29,107,27.1,136,29,107,27.1
31280, 여주시,095002, 91세,2017,119,19,100,19,119,19,100,19
31280, 여주시,095003, 92세,2017,84,15,69,21.7,84,15,69,21.7
31280, 여주시,095004, 93세,2017,80,15,65,23.1,80,15,65,23.1
31280, 여주시,095005, 94세,2017,63,14,49,28.6,63,14,49,28.6
31280, 여주시,100,95~99세,2017,112,21,91,23.1,111,20,91,22
31280, 여주시,100001, 95세,2017,45,12,33,36.4,44,11,33,33.3
31280, 여주시,100002, 96세,2017,35,X,31,12.9,35,X,31,12.9
31280, 여주시,100003, 97세,2017,17,X,13,30.8,17,X,13,30.8
31280, 여주시,100004, 98세,2017,9,X,8,12.5,9,X,8,12.5
31280, 여주시,100005, 99세,2017,6,X,6,0,6,X,6,0
31280, 여주시,101,100세이상,2017,12,X,9,33.3,12,X,9,33.3
31280, 여주시,102,15세미만,2017,13229,6842,6387,107.1,13197,6824,6373,107.1
31280, 여주시,103,15~64세,2017,77958,41055,36903,111.3,73633,38331,35302,108.6
31280, 여주시,104,65세이상,2017,20289,8882,11407,77.9,20189,8840,11349,77.9
31280, 여주시,086,85세이상,2017,2007,514,1493,34.4,2001,512,1489,34.4
31280, 여주시,126,평균연령,2017,44,42.6,45.4,,44.4,43.1,45.7,
31280, 여주시,127,중위연령,2017,45.7,44.3,47.1,,46.5,45.4,47.7,
31350, 연천군,000,합계,2017,43990,23259,20731,112.2,42742,22366,20376,109.8
31350, 연천군,005,0~4세,2017,1786,908,878,103.4,1786,908,878,103.4
31350, 연천군,005001, 0세,2017,329,193,136,141.9,329,193,136,141.9
31350, 연천군,005002, 1세,2017,394,201,193,104.1,394,201,193,104.1
31350, 연천군,005003, 2세,2017,342,159,183,86.9,342,159,183,86.9
31350, 연천군,005004, 3세,2017,351,158,193,81.9,351,158,193,81.9
31350, 연천군,005005, 4세,2017,370,197,173,113.9,370,197,173,113.9
31350, 연천군,010,5~9세,2017,1575,836,739,113.1,1572,834,738,113
31350, 연천군,010001, 5세,2017,327,176,151,116.6,327,176,151,116.6
31350, 연천군,010002, 6세,2017,320,166,154,107.8,317,164,153,107.2
31350, 연천군,010003, 7세,2017,324,171,153,111.8,324,171,153,111.8
31350, 연천군,010004, 8세,2017,291,156,135,115.6,291,156,135,115.6
31350, 연천군,010005, 9세,2017,313,167,146,114.4,313,167,146,114.4
31350, 연천군,015,10~14세,2017,1495,792,703,112.7,1494,792,702,112.8
31350, 연천군,015001, 10세,2017,294,156,138,113,293,156,137,113.9
31350, 연천군,015002, 11세,2017,284,161,123,130.9,284,161,123,130.9
31350, 연천군,015003, 12세,2017,315,155,160,96.9,315,155,160,96.9
31350, 연천군,015004, 13세,2017,302,156,146,106.8,302,156,146,106.8
31350, 연천군,015005, 14세,2017,300,164,136,120.6,300,164,136,120.6
31350, 연천군,020,15~19세,2017,1989,1062,927,114.6,1973,1048,925,113.3
31350, 연천군,020001, 15세,2017,369,198,171,115.8,368,197,171,115.2
31350, 연천군,020002, 16세,2017,454,256,198,129.3,454,256,198,129.3
31350, 연천군,020003, 17세,2017,462,234,228,102.6,460,232,228,101.8
31350, 연천군,020004, 18세,2017,390,206,184,112,389,205,184,111.4
31350, 연천군,020005, 19세,2017,314,168,146,115.1,302,158,144,109.7
31350, 연천군,025,20~24세,2017,2524,1672,852,196.2,2338,1524,814,187.2
31350, 연천군,025001, 20세,2017,354,203,151,134.4,343,194,149,130.2
31350, 연천군,025002, 21세,2017,419,275,144,191,386,250,136,183.8
31350, 연천군,025003, 22세,2017,490,337,153,220.3,440,291,149,195.3
31350, 연천군,025004, 23세,2017,573,376,197,190.9,533,346,187,185
31350, 연천군,025005, 24세,2017,688,481,207,232.4,636,443,193,229.5
31350, 연천군,030,25~29세,2017,3121,2071,1050,197.2,2866,1876,990,189.5
31350, 연천군,030001, 25세,2017,752,518,234,221.4,709,487,222,219.4
31350, 연천군,030002, 26세,2017,663,449,214,209.8,607,406,201,202
31350, 연천군,030003, 27세,2017,596,398,198,201,545,359,186,193
31350, 연천군,030004, 28세,2017,564,358,206,173.8,514,319,195,163.6
31350, 연천군,030005, 29세,2017,546,348,198,175.8,491,305,186,164
31350, 연천군,035,30~34세,2017,2452,1437,1015,141.6,2241,1283,958,133.9
31350, 연천군,035001, 30세,2017,520,296,224,132.1,467,256,211,121.3
31350, 연천군,035002, 31세,2017,515,326,189,172.5,468,286,182,157.1
31350, 연천군,035003, 32세,2017,467,270,197,137.1,417,237,180,131.7
31350, 연천군,035004, 33세,2017,479,280,199,140.7,451,260,191,136.1
31350, 연천군,035005, 34세,2017,471,265,206,128.6,438,244,194,125.8
31350, 연천군,040,35~39세,2017,2472,1345,1127,119.3,2301,1215,1086,111.9
31350, 연천군,040001, 35세,2017,521,283,238,118.9,473,247,226,109.3
31350, 연천군,040002, 36세,2017,542,305,237,128.7,514,285,229,124.5
31350, 연천군,040003, 37세,2017,492,256,236,108.5,470,238,232,102.6
31350, 연천군,040004, 38세,2017,479,249,230,108.3,442,223,219,101.8
31350, 연천군,040005, 39세,2017,438,252,186,135.5,402,222,180,123.3
31350, 연천군,045,40~44세,2017,2526,1416,1110,127.6,2431,1346,1085,124.1
31350, 연천군,045001, 40세,2017,477,257,220,116.8,456,238,218,109.2
31350, 연천군,045002, 41세,2017,441,256,185,138.4,416,237,179,132.4
31350, 연천군,045003, 42세,2017,489,281,208,135.1,471,267,204,130.9
31350, 연천군,045004, 43세,2017,586,305,281,108.5,566,296,270,109.6
31350, 연천군,045005, 44세,2017,533,317,216,146.8,522,308,214,143.9
31350, 연천군,050,45~49세,2017,2964,1633,1331,122.7,2866,1571,1295,121.3
31350, 연천군,050001, 45세,2017,584,341,243,140.3,573,333,240,138.8
31350, 연천군,050002, 46세,2017,601,356,245,145.3,582,345,237,145.6
31350, 연천군,050003, 47세,2017,527,261,266,98.1,504,246,258,95.3
31350, 연천군,050004, 48세,2017,650,360,290,124.1,626,344,282,122
31350, 연천군,050005, 49세,2017,602,315,287,109.8,581,303,278,109
31350, 연천군,055,50~54세,2017,3414,1830,1584,115.5,3341,1792,1549,115.7
31350, 연천군,055001, 50세,2017,602,321,281,114.2,588,314,274,114.6
31350, 연천군,055002, 51세,2017,657,359,298,120.5,640,349,291,119.9
31350, 연천군,055003, 52세,2017,712,391,321,121.8,699,385,314,122.6
31350, 연천군,055004, 53세,2017,692,375,317,118.3,681,368,313,117.6
31350, 연천군,055005, 54세,2017,751,384,367,104.6,733,376,357,105.3
31350, 연천군,060,55~59세,2017,4027,2094,1933,108.3,3977,2071,1906,108.7
31350, 연천군,060001, 55세,2017,741,410,331,123.9,731,407,324,125.6
31350, 연천군,060002, 56세,2017,789,405,384,105.5,781,401,380,105.5
31350, 연천군,060003, 57세,2017,852,426,426,100,838,418,420,99.5
31350, 연천군,060004, 58세,2017,830,426,404,105.4,821,423,398,106.3
31350, 연천군,060005, 59세,2017,815,427,388,110.1,806,422,384,109.9
31350, 연천군,065,60~64세,2017,3605,1863,1742,106.9,3559,1833,1726,106.2
31350, 연천군,065001, 60세,2017,853,449,404,111.1,842,440,402,109.5
31350, 연천군,065002, 61세,2017,747,370,377,98.1,741,368,373,98.7
31350, 연천군,065003, 62세,2017,810,425,385,110.4,794,418,376,111.2
31350, 연천군,065004, 63세,2017,681,366,315,116.2,677,362,315,114.9
31350, 연천군,065005, 64세,2017,514,253,261,96.9,505,245,260,94.2
31350, 연천군,070,65~69세,2017,2618,1269,1349,94.1,2593,1250,1343,93.1
31350, 연천군,070001, 65세,2017,605,295,310,95.2,596,289,307,94.1
31350, 연천군,070002, 66세,2017,412,194,218,89,408,191,217,88
31350, 연천군,070003, 67세,2017,471,230,241,95.4,468,228,240,95
31350, 연천군,070004, 68세,2017,554,274,280,97.9,549,270,279,96.8
31350, 연천군,070005, 69세,2017,576,276,300,92,572,272,300,90.7
31350, 연천군,075,70~74세,2017,2489,1137,1352,84.1,2482,1134,1348,84.1
31350, 연천군,075001, 70세,2017,592,267,325,82.2,590,267,323,82.7
31350, 연천군,075002, 71세,2017,490,233,257,90.7,488,232,256,90.6
31350, 연천군,075003, 72세,2017,479,229,250,91.6,478,228,250,91.2
31350, 연천군,075004, 73세,2017,463,220,243,90.5,463,220,243,90.5
31350, 연천군,075005, 74세,2017,465,188,277,67.9,463,187,276,67.8
31350, 연천군,080,75~79세,2017,2452,1033,1419,72.8,2441,1028,1413,72.8
31350, 연천군,080001, 75세,2017,582,251,331,75.8,575,248,327,75.8
31350, 연천군,080002, 76세,2017,515,238,277,85.9,512,236,276,85.5
31350, 연천군,080003, 77세,2017,463,183,280,65.4,463,183,280,65.4
31350, 연천군,080004, 78세,2017,447,172,275,62.5,446,172,274,62.8
31350, 연천군,080005, 79세,2017,445,189,256,73.8,445,189,256,73.8
31350, 연천군,085,80~84세,2017,1516,578,938,61.6,1516,578,938,61.6
31350, 연천군,085001, 80세,2017,401,141,260,54.2,401,141,260,54.2
31350, 연천군,085002, 81세,2017,318,133,185,71.9,318,133,185,71.9
31350, 연천군,085003, 82세,2017,343,128,215,59.5,343,128,215,59.5
31350, 연천군,085004, 83세,2017,243,94,149,63.1,243,94,149,63.1
31350, 연천군,085005, 84세,2017,211,82,129,63.6,211,82,129,63.6
31350, 연천군,090,85~89세,2017,659,208,451,46.1,659,208,451,46.1
31350, 연천군,090001, 85세,2017,206,70,136,51.5,206,70,136,51.5
31350, 연천군,090002, 86세,2017,123,45,78,57.7,123,45,78,57.7
31350, 연천군,090003, 87세,2017,133,47,86,54.7,133,47,86,54.7
31350, 연천군,090004, 88세,2017,119,30,89,33.7,119,30,89,33.7
31350, 연천군,090005, 89세,2017,78,16,62,25.8,78,16,62,25.8
31350, 연천군,095,90~94세,2017,244,58,186,31.2,244,58,186,31.2
31350, 연천군,095001, 90세,2017,84,22,62,35.5,84,22,62,35.5
31350, 연천군,095002, 91세,2017,47,10,37,27,47,10,37,27
31350, 연천군,095003, 92세,2017,45,10,35,28.6,45,10,35,28.6
31350, 연천군,095004, 93세,2017,34,7,27,25.9,34,7,27,25.9
31350, 연천군,095005, 94세,2017,34,9,25,36,34,9,25,36
31350, 연천군,100,95~99세,2017,58,17,41,41.5,58,17,41,41.5
31350, 연천군,100001, 95세,2017,13,5,8,62.5,13,5,8,62.5
31350, 연천군,100002, 96세,2017,11,X,7,57.1,11,X,7,57.1
31350, 연천군,100003, 97세,2017,18,6,12,50,18,6,12,50
31350, 연천군,100004, 98세,2017,9,X,7,28.6,9,X,7,28.6
31350, 연천군,100005, 99세,2017,7,X,7,0,7,X,7,0
31350, 연천군,101,100세이상,2017,X,X,X,0,X,X,X,0
31350, 연천군,102,15세미만,2017,4856,2536,2320,109.3,4852,2534,2318,109.3
31350, 연천군,103,15~64세,2017,29094,16423,12671,129.6,27893,15559,12334,126.1
31350, 연천군,104,65세이상,2017,10040,4300,5740,74.9,9997,4273,5724,74.7
31350, 연천군,086,85세이상,2017,965,283,682,41.5,965,283,682,41.5
31350, 연천군,126,평균연령,2017,46.1,43.8,48.5,,46.3,44.2,48.7,
31350, 연천군,127,중위연령,2017,48.5,45.3,52.2,,49.1,46.1,52.5,
31370, 가평군,000,합계,2017,59548,30169,29379,102.7,58297,29642,28655,103.4
31370, 가평군,005,0~4세,2017,1790,938,852,110.1,1774,931,843,110.4
31370, 가평군,005001, 0세,2017,350,179,171,104.7,350,179,171,104.7
31370, 가평군,005002, 1세,2017,369,210,159,132.1,364,207,157,131.8
31370, 가평군,005003, 2세,2017,372,190,182,104.4,368,189,179,105.6
31370, 가평군,005004, 3세,2017,342,171,171,100,339,169,170,99.4
31370, 가평군,005005, 4세,2017,357,188,169,111.2,353,187,166,112.7
31370, 가평군,010,5~9세,2017,2152,1072,1080,99.3,2131,1062,1069,99.3
31370, 가평군,010001, 5세,2017,449,218,231,94.4,445,217,228,95.2
31370, 가평군,010002, 6세,2017,440,201,239,84.1,438,201,237,84.8
31370, 가평군,010003, 7세,2017,432,225,207,108.7,427,221,206,107.3
31370, 가평군,010004, 8세,2017,408,203,205,99,405,201,204,98.5
31370, 가평군,010005, 9세,2017,423,225,198,113.6,416,222,194,114.4
31370, 가평군,015,10~14세,2017,2172,1155,1017,113.6,2157,1150,1007,114.2
31370, 가평군,015001, 10세,2017,440,226,214,105.6,439,226,213,106.1
31370, 가평군,015002, 11세,2017,413,228,185,123.2,411,228,183,124.6
31370, 가평군,015003, 12세,2017,429,221,208,106.3,424,218,206,105.8
31370, 가평군,015004, 13세,2017,454,238,216,110.2,450,237,213,111.3
31370, 가평군,015005, 14세,2017,436,242,194,124.7,433,241,192,125.5
31370, 가평군,020,15~19세,2017,3062,1477,1585,93.2,3038,1466,1572,93.3
31370, 가평군,020001, 15세,2017,534,278,256,108.6,527,274,253,108.3
31370, 가평군,020002, 16세,2017,708,327,381,85.8,703,324,379,85.5
31370, 가평군,020003, 17세,2017,672,317,355,89.3,670,317,353,89.8
31370, 가평군,020004, 18세,2017,584,302,282,107.1,577,300,277,108.3
31370, 가평군,020005, 19세,2017,564,253,311,81.4,561,251,310,81
31370, 가평군,025,20~24세,2017,2976,1750,1226,142.7,2865,1693,1172,144.5
31370, 가평군,025001, 20세,2017,552,323,229,141,544,321,223,143.9
31370, 가평군,025002, 21세,2017,606,375,231,162.3,588,365,223,163.7
31370, 가평군,025003, 22세,2017,580,342,238,143.7,561,332,229,145
31370, 가평군,025004, 23세,2017,585,348,237,146.8,559,331,228,145.2
31370, 가평군,025005, 24세,2017,653,362,291,124.4,613,344,269,127.9
31370, 가평군,030,25~29세,2017,2976,1691,1285,131.6,2822,1622,1200,135.2
31370, 가평군,030001, 25세,2017,651,357,294,121.4,622,343,279,122.9
31370, 가평군,030002, 26세,2017,614,343,271,126.6,581,326,255,127.8
31370, 가평군,030003, 27세,2017,577,340,237,143.5,545,329,216,152.3
31370, 가평군,030004, 28세,2017,558,314,244,128.7,529,304,225,135.1
31370, 가평군,030005, 29세,2017,576,337,239,141,545,320,225,142.2
31370, 가평군,035,30~34세,2017,2833,1509,1324,114,2681,1451,1230,118
31370, 가평군,035001, 30세,2017,571,316,255,123.9,541,301,240,125.4
31370, 가평군,035002, 31세,2017,566,294,272,108.1,528,281,247,113.8
31370, 가평군,035003, 32세,2017,544,281,263,106.8,512,271,241,112.4
31370, 가평군,035004, 33세,2017,562,304,258,117.8,530,293,237,123.6
31370, 가평군,035005, 34세,2017,590,314,276,113.8,570,305,265,115.1
31370, 가평군,040,35~39세,2017,3373,1732,1641,105.5,3262,1692,1570,107.8
31370, 가평군,040001, 35세,2017,683,343,340,100.9,660,335,325,103.1
31370, 가평군,040002, 36세,2017,685,355,330,107.6,662,348,314,110.8
31370, 가평군,040003, 37세,2017,670,338,332,101.8,649,329,320,102.8
31370, 가평군,040004, 38세,2017,677,360,317,113.6,655,349,306,114.1
31370, 가평군,040005, 39세,2017,658,336,322,104.3,636,331,305,108.5
31370, 가평군,045,40~44세,2017,3661,1961,1700,115.4,3564,1927,1637,117.7
31370, 가평군,045001, 40세,2017,661,356,305,116.7,643,349,294,118.7
31370, 가평군,045002, 41세,2017,689,336,353,95.2,669,328,341,96.2
31370, 가평군,045003, 42세,2017,728,382,346,110.4,707,377,330,114.2
31370, 가평군,045004, 43세,2017,810,444,366,121.3,790,436,354,123.2
31370, 가평군,045005, 44세,2017,773,443,330,134.2,755,437,318,137.4
31370, 가평군,050,45~49세,2017,4572,2426,2146,113,4432,2364,2068,114.3
31370, 가평군,050001, 45세,2017,872,489,383,127.7,843,472,371,127.2
31370, 가평군,050002, 46세,2017,869,464,405,114.6,841,453,388,116.8
31370, 가평군,050003, 47세,2017,919,454,465,97.6,892,444,448,99.1
31370, 가평군,050004, 48세,2017,975,534,441,121.1,949,522,427,122.2
31370, 가평군,050005, 49세,2017,937,485,452,107.3,907,473,434,109
31370, 가평군,055,50~54세,2017,5055,2651,2404,110.3,4907,2592,2315,112
31370, 가평군,055001, 50세,2017,913,464,449,103.3,889,457,432,105.8
31370, 가평군,055002, 51세,2017,992,531,461,115.2,962,518,444,116.7
31370, 가평군,055003, 52세,2017,1039,537,502,107,1006,524,482,108.7
31370, 가평군,055004, 53세,2017,1038,547,491,111.4,1009,534,475,112.4
31370, 가평군,055005, 54세,2017,1073,572,501,114.2,1041,559,482,116
31370, 가평군,060,55~59세,2017,6098,3088,3010,102.6,5996,3045,2951,103.2
31370, 가평군,060001, 55세,2017,1122,576,546,105.5,1103,569,534,106.6
31370, 가평군,060002, 56세,2017,1245,635,610,104.1,1223,629,594,105.9
31370, 가평군,060003, 57세,2017,1318,641,677,94.7,1290,631,659,95.8
31370, 가평군,060004, 58세,2017,1211,621,590,105.3,1198,614,584,105.1
31370, 가평군,060005, 59세,2017,1202,615,587,104.8,1182,602,580,103.8
31370, 가평군,065,60~64세,2017,5566,2871,2695,106.5,5480,2831,2649,106.9
31370, 가평군,065001, 60세,2017,1167,623,544,114.5,1146,615,531,115.8
31370, 가평군,065002, 61세,2017,1208,634,574,110.5,1192,624,568,109.9
31370, 가평군,065003, 62세,2017,1196,596,600,99.3,1177,590,587,100.5
31370, 가평군,065004, 63세,2017,1062,523,539,97,1049,516,533,96.8
31370, 가평군,065005, 64세,2017,933,495,438,113,916,486,430,113
31370, 가평군,070,65~69세,2017,3590,1791,1799,99.6,3557,1776,1781,99.7
31370, 가평군,070001, 65세,2017,985,512,473,108.2,976,506,470,107.7
31370, 가평군,070002, 66세,2017,583,304,279,109,576,301,275,109.5
31370, 가평군,070003, 67세,2017,658,297,361,82.3,652,296,356,83.1
31370, 가평군,070004, 68세,2017,655,316,339,93.2,647,313,334,93.7
31370, 가평군,070005, 69세,2017,709,362,347,104.3,706,360,346,104
31370, 가평군,075,70~74세,2017,3318,1550,1768,87.7,3299,1540,1759,87.5
31370, 가평군,075001, 70세,2017,728,355,373,95.2,725,354,371,95.4
31370, 가평군,075002, 71세,2017,623,292,331,88.2,619,290,329,88.1
31370, 가평군,075003, 72세,2017,686,320,366,87.4,681,317,364,87.1
31370, 가평군,075004, 73세,2017,627,302,325,92.9,622,299,323,92.6
31370, 가평군,075005, 74세,2017,654,281,373,75.3,652,280,372,75.3
31370, 가평군,080,75~79세,2017,3041,1317,1724,76.4,3030,1314,1716,76.6
31370, 가평군,080001, 75세,2017,723,328,395,83,722,327,395,82.8
31370, 가평군,080002, 76세,2017,609,263,346,76,609,263,346,76
31370, 가평군,080003, 77세,2017,605,270,335,80.6,601,269,332,81
31370, 가평군,080004, 78세,2017,612,261,351,74.4,609,260,349,74.5
31370, 가평군,080005, 79세,2017,492,195,297,65.7,489,195,294,66.3
31370, 가평군,085,80~84세,2017,2007,806,1201,67.1,2001,803,1198,67
31370, 가평군,085001, 80세,2017,488,224,264,84.8,488,224,264,84.8
31370, 가평군,085002, 81세,2017,458,194,264,73.5,456,193,263,73.4
31370, 가평군,085003, 82세,2017,416,155,261,59.4,414,154,260,59.2
31370, 가평군,085004, 83세,2017,354,124,230,53.9,353,123,230,53.5
31370, 가평군,085005, 84세,2017,291,109,182,59.9,290,109,181,60.2
31370, 가평군,090,85~89세,2017,925,290,635,45.7,920,289,631,45.8
31370, 가평군,090001, 85세,2017,276,89,187,47.6,273,89,184,48.4
31370, 가평군,090002, 86세,2017,191,69,122,56.6,190,69,121,57
31370, 가평군,090003, 87세,2017,174,52,122,42.6,174,52,122,42.6
31370, 가평군,090004, 88세,2017,155,40,115,34.8,155,40,115,34.8
31370, 가평군,090005, 89세,2017,129,40,89,44.9,128,39,89,43.8
31370, 가평군,095,90~94세,2017,285,69,216,31.9,285,69,216,31.9
31370, 가평군,095001, 90세,2017,86,22,64,34.4,86,22,64,34.4
31370, 가평군,095002, 91세,2017,70,17,53,32.1,70,17,53,32.1
31370, 가평군,095003, 92세,2017,59,12,47,25.5,59,12,47,25.5
31370, 가평군,095004, 93세,2017,42,11,31,35.5,42,11,31,35.5
31370, 가평군,095005, 94세,2017,28,7,21,33.3,28,7,21,33.3
31370, 가평군,100,95~99세,2017,87,24,63,38.1,87,24,63,38.1
31370, 가평군,100001, 95세,2017,37,10,27,37,37,10,27,37
31370, 가평군,100002, 96세,2017,19,9,10,90,19,9,10,90
31370, 가평군,100003, 97세,2017,17,X,15,13.3,17,X,15,13.3
31370, 가평군,100004, 98세,2017,7,X,5,40,7,X,5,40
31370, 가평군,100005, 99세,2017,7,X,6,16.7,7,X,6,16.7
31370, 가평군,101,100세이상,2017,9,X,8,12.5,9,X,8,12.5
31370, 가평군,102,15세미만,2017,6114,3165,2949,107.3,6062,3143,2919,107.7
31370, 가평군,103,15~64세,2017,40172,21156,19016,111.3,39047,20683,18364,112.6
31370, 가평군,104,65세이상,2017,13262,5848,7414,78.9,13188,5816,7372,78.9
31370, 가평군,086,85세이상,2017,1306,384,922,41.6,1301,383,918,41.7
31370, 가평군,126,평균연령,2017,47.1,45.8,48.5,,47.2,45.8,48.6,
31370, 가평군,127,중위연령,2017,50.2,48.7,51.8,,50.5,48.9,52.2,
31380, 양평군,000,합계,2017,109359,54876,54483,100.7,107247,53947,53300,101.2
31380, 양평군,005,0~4세,2017,3524,1813,1711,106,3515,1809,1706,106
31380, 양평군,005001, 0세,2017,621,329,292,112.7,620,328,292,112.3
31380, 양평군,005002, 1세,2017,708,364,344,105.8,705,363,342,106.1
31380, 양평군,005003, 2세,2017,706,360,346,104,705,359,346,103.8
31380, 양평군,005004, 3세,2017,749,399,350,114,746,398,348,114.4
31380, 양평군,005005, 4세,2017,740,361,379,95.3,739,361,378,95.5
31380, 양평군,010,5~9세,2017,4411,2276,2135,106.6,4408,2275,2133,106.7
31380, 양평군,010001, 5세,2017,907,475,432,110,906,475,431,110.2
31380, 양평군,010002, 6세,2017,880,460,420,109.5,880,460,420,109.5
31380, 양평군,010003, 7세,2017,855,433,422,102.6,855,433,422,102.6
31380, 양평군,010004, 8세,2017,876,448,428,104.7,875,447,428,104.4
31380, 양평군,010005, 9세,2017,893,460,433,106.2,892,460,432,106.5
31380, 양평군,015,10~14세,2017,4413,2315,2098,110.3,4409,2314,2095,110.5
31380, 양평군,015001, 10세,2017,938,451,487,92.6,938,451,487,92.6
31380, 양평군,015002, 11세,2017,901,482,419,115,901,482,419,115
31380, 양평군,015003, 12세,2017,810,444,366,121.3,810,444,366,121.3
31380, 양평군,015004, 13세,2017,939,501,438,114.4,938,501,437,114.6
31380, 양평군,015005, 14세,2017,825,437,388,112.6,822,436,386,113
31380, 양평군,020,15~19세,2017,5847,3088,2759,111.9,5822,3078,2744,112.2
31380, 양평군,020001, 15세,2017,940,514,426,120.7,937,513,424,121
31380, 양평군,020002, 16세,2017,1215,614,601,102.2,1214,614,600,102.3
31380, 양평군,020003, 17세,2017,1460,718,742,96.8,1457,717,740,96.9
31380, 양평군,020004, 18세,2017,1190,636,554,114.8,1185,632,553,114.3
31380, 양평군,020005, 19세,2017,1042,606,436,139,1029,602,427,141
31380, 양평군,025,20~24세,2017,5232,2909,2323,125.2,4916,2765,2151,128.5
31380, 양평군,025001, 20세,2017,1018,599,419,143,1002,590,412,143.2
31380, 양평군,025002, 21세,2017,1006,576,430,134,962,557,405,137.5
31380, 양평군,025003, 22세,2017,1051,588,463,127,986,556,430,129.3
31380, 양평군,025004, 23세,2017,1061,556,505,110.1,977,517,460,112.4
31380, 양평군,025005, 24세,2017,1096,590,506,116.6,989,545,444,122.7
31380, 양평군,030,25~29세,2017,5227,2890,2337,123.7,4740,2656,2084,127.4
31380, 양평군,030001, 25세,2017,1188,668,520,128.5,1082,618,464,133.2
31380, 양평군,030002, 26세,2017,1062,585,477,122.6,955,528,427,123.7
31380, 양평군,030003, 27세,2017,1056,594,462,128.6,947,544,403,135
31380, 양평군,030004, 28세,2017,944,526,418,125.8,869,490,379,129.3
31380, 양평군,030005, 29세,2017,977,517,460,112.4,887,476,411,115.8
31380, 양평군,035,30~34세,2017,5032,2643,2389,110.6,4710,2498,2212,112.9
31380, 양평군,035001, 30세,2017,947,514,433,118.7,869,478,391,122.3
31380, 양평군,035002, 31세,2017,957,497,460,108,879,461,418,110.3
31380, 양평군,035003, 32세,2017,997,507,490,103.5,942,484,458,105.7
31380, 양평군,035004, 33세,2017,1010,532,478,111.3,953,505,448,112.7
31380, 양평군,035005, 34세,2017,1121,593,528,112.3,1067,570,497,114.7
31380, 양평군,040,35~39세,2017,6401,3141,3260,96.3,6202,3062,3140,97.5
31380, 양평군,040001, 35세,2017,1233,636,597,106.5,1189,615,574,107.1
31380, 양평군,040002, 36세,2017,1274,619,655,94.5,1222,603,619,97.4
31380, 양평군,040003, 37세,2017,1373,643,730,88.1,1340,629,711,88.5
31380, 양평군,040004, 38세,2017,1266,635,631,100.6,1235,625,610,102.5
31380, 양평군,040005, 39세,2017,1255,608,647,94,1216,590,626,94.2
31380, 양평군,045,40~44세,2017,7333,3786,3547,106.7,7179,3721,3458,107.6
31380, 양평군,045001, 40세,2017,1275,630,645,97.7,1240,618,622,99.4
31380, 양평군,045002, 41세,2017,1360,715,645,110.9,1333,701,632,110.9
31380, 양평군,045003, 42세,2017,1437,754,683,110.4,1408,739,669,110.5
31380, 양평군,045004, 43세,2017,1576,822,754,109,1543,809,734,110.2
31380, 양평군,045005, 44세,2017,1685,865,820,105.5,1655,854,801,106.6
31380, 양평군,050,45~49세,2017,8255,4380,3875,113,8105,4323,3782,114.3
31380, 양평군,050001, 45세,2017,1627,898,729,123.2,1600,887,713,124.4
31380, 양평군,050002, 46세,2017,1668,864,804,107.5,1637,848,789,107.5
31380, 양평군,050003, 47세,2017,1637,837,800,104.6,1603,828,775,106.8
31380, 양평군,050004, 48세,2017,1683,912,771,118.3,1655,899,756,118.9
31380, 양평군,050005, 49세,2017,1640,869,771,112.7,1610,861,749,115
31380, 양평군,055,50~54세,2017,8755,4492,4263,105.4,8621,4434,4187,105.9
31380, 양평군,055001, 50세,2017,1623,826,797,103.6,1593,811,782,103.7
31380, 양평군,055002, 51세,2017,1691,859,832,103.2,1659,843,816,103.3
31380, 양평군,055003, 52세,2017,1804,943,861,109.5,1783,934,849,110
31380, 양평군,055004, 53세,2017,1745,892,853,104.6,1723,884,839,105.4
31380, 양평군,055005, 54세,2017,1892,972,920,105.7,1863,962,901,106.8
31380, 양평군,060,55~59세,2017,10985,5469,5516,99.1,10857,5423,5434,99.8
31380, 양평군,060001, 55세,2017,1996,1001,995,100.6,1961,990,971,102
31380, 양평군,060002, 56세,2017,2350,1177,1173,100.3,2325,1169,1156,101.1
31380, 양평군,060003, 57세,2017,2257,1092,1165,93.7,2229,1082,1147,94.3
31380, 양평군,060004, 58세,2017,2151,1058,1093,96.8,2132,1050,1082,97
31380, 양평군,060005, 59세,2017,2231,1141,1090,104.7,2210,1132,1078,105
31380, 양평군,065,60~64세,2017,9694,4746,4948,95.9,9598,4701,4897,96
31380, 양평군,065001, 60세,2017,2041,1016,1025,99.1,2013,1006,1007,99.9
31380, 양평군,065002, 61세,2017,2035,1005,1030,97.6,2019,998,1021,97.7
31380, 양평군,065003, 62세,2017,2101,1030,1071,96.2,2081,1019,1062,96
31380, 양평군,065004, 63세,2017,1802,868,934,92.9,1787,859,928,92.6
31380, 양평군,065005, 64세,2017,1715,827,888,93.1,1698,819,879,93.2
31380, 양평군,070,65~69세,2017,7183,3582,3601,99.5,7122,3551,3571,99.4
31380, 양평군,070001, 65세,2017,1984,1003,981,102.2,1963,990,973,101.7
31380, 양평군,070002, 66세,2017,1172,578,594,97.3,1159,573,586,97.8
31380, 양평군,070003, 67세,2017,1308,631,677,93.2,1301,628,673,93.3
31380, 양평군,070004, 68세,2017,1352,650,702,92.6,1345,647,698,92.7
31380, 양평군,070005, 69세,2017,1367,720,647,111.3,1354,713,641,111.2
31380, 양평군,075,70~74세,2017,6091,2995,3096,96.7,6086,2992,3094,96.7
31380, 양평군,075001, 70세,2017,1456,727,729,99.7,1456,727,729,99.7
31380, 양평군,075002, 71세,2017,1165,609,556,109.5,1163,607,556,109.2
31380, 양평군,075003, 72세,2017,1164,573,591,97,1162,572,590,96.9
31380, 양평군,075004, 73세,2017,1173,578,595,97.1,1172,578,594,97.3
31380, 양평군,075005, 74세,2017,1133,508,625,81.3,1133,508,625,81.3
31380, 양평군,080,75~79세,2017,5202,2363,2839,83.2,5191,2361,2830,83.4
31380, 양평군,080001, 75세,2017,1314,632,682,92.7,1311,631,680,92.8
31380, 양평군,080002, 76세,2017,1104,507,597,84.9,1102,507,595,85.2
31380, 양평군,080003, 77세,2017,913,427,486,87.9,910,426,484,88
31380, 양평군,080004, 78세,2017,985,422,563,75,983,422,561,75.2
31380, 양평군,080005, 79세,2017,886,375,511,73.4,885,375,510,73.5
31380, 양평군,085,80~84세,2017,3460,1356,2104,64.4,3457,1355,2102,64.5
31380, 양평군,085001, 80세,2017,829,354,475,74.5,829,354,475,74.5
31380, 양평군,085002, 81세,2017,807,338,469,72.1,806,337,469,71.9
31380, 양평군,085003, 82세,2017,702,253,449,56.3,701,253,448,56.5
31380, 양평군,085004, 83세,2017,623,239,384,62.2,622,239,383,62.4
31380, 양평군,085005, 84세,2017,499,172,327,52.6,499,172,327,52.6
31380, 양평군,090,85~89세,2017,1588,440,1148,38.3,1584,437,1147,38.1
31380, 양평군,090001, 85세,2017,399,119,280,42.5,399,119,280,42.5
31380, 양평군,090002, 86세,2017,354,101,253,39.9,354,101,253,39.9
31380, 양평군,090003, 87세,2017,336,93,243,38.3,335,92,243,37.9
31380, 양평군,090004, 88세,2017,273,72,201,35.8,271,71,200,35.5
31380, 양평군,090005, 89세,2017,226,55,171,32.2,225,54,171,31.6
31380, 양평군,095,90~94세,2017,553,153,400,38.3,552,153,399,38.3
31380, 양평군,095001, 90세,2017,170,44,126,34.9,170,44,126,34.9
31380, 양평군,095002, 91세,2017,134,34,100,34,134,34,100,34
31380, 양평군,095003, 92세,2017,105,31,74,41.9,105,31,74,41.9
31380, 양평군,095004, 93세,2017,78,25,53,47.2,77,25,52,48.1
31380, 양평군,095005, 94세,2017,66,19,47,40.4,66,19,47,40.4
31380, 양평군,100,95~99세,2017,156,37,119,31.1,156,37,119,31.1
31380, 양평군,100001, 95세,2017,49,11,38,28.9,49,11,38,28.9
31380, 양평군,100002, 96세,2017,42,10,32,31.3,42,10,32,31.3
31380, 양평군,100003, 97세,2017,33,7,26,26.9,33,7,26,26.9
31380, 양평군,100004, 98세,2017,20,5,15,33.3,20,5,15,33.3
31380, 양평군,100005, 99세,2017,12,X,8,50,12,X,8,50
31380, 양평군,101,100세이상,2017,17,X,15,13.3,17,X,15,13.3
31380, 양평군,102,15세미만,2017,12348,6404,5944,107.7,12332,6398,5934,107.8
31380, 양평군,103,15~64세,2017,72761,37544,35217,106.6,70750,36661,34089,107.5
31380, 양평군,104,65세이상,2017,24250,10928,13322,82,24165,10888,13277,82
31380, 양평군,086,85세이상,2017,2314,632,1682,37.6,2309,629,1680,37.4
31380, 양평군,126,평균연령,2017,46.5,45.2,47.8,,46.7,45.3,48.1,
31380, 양평군,127,중위연령,2017,49.4,48,51,,49.8,48.3,51.4,
32,강원도,000,합계,2017,1521386,769043,752343,102.2,1500390,757764,742626,102
32,강원도,005,0~4세,2017,52755,26958,25797,104.5,52636,26893,25743,104.5
32,강원도,005001, 0세,2017,9183,4730,4453,106.2,9164,4720,4444,106.2
32,강원도,005002, 1세,2017,10321,5312,5009,106,10288,5292,4996,105.9
32,강원도,005003, 2세,2017,10992,5555,5437,102.2,10971,5546,5425,102.2
32,강원도,005004, 3세,2017,10979,5588,5391,103.7,10961,5580,5381,103.7
32,강원도,005005, 4세,2017,11280,5773,5507,104.8,11252,5755,5497,104.7
32,강원도,010,5~9세,2017,62989,32368,30621,105.7,62903,32332,30571,105.8
32,강원도,010001, 5세,2017,12817,6545,6272,104.4,12794,6532,6262,104.3
32,강원도,010002, 6세,2017,12741,6573,6168,106.6,12718,6562,6156,106.6
32,강원도,010003, 7세,2017,12463,6389,6074,105.2,12451,6384,6067,105.2
32,강원도,010004, 8세,2017,12248,6301,5947,106,12232,6297,5935,106.1
32,강원도,010005, 9세,2017,12720,6560,6160,106.5,12708,6557,6151,106.6
32,강원도,015,10~14세,2017,65912,34317,31595,108.6,65841,34285,31556,108.6
32,강원도,015001, 10세,2017,13334,6946,6388,108.7,13319,6940,6379,108.8
32,강원도,015002, 11세,2017,12398,6440,5958,108.1,12381,6435,5946,108.2
32,강원도,015003, 12세,2017,12637,6602,6035,109.4,12624,6595,6029,109.4
32,강원도,015004, 13세,2017,13663,7124,6539,108.9,13648,7115,6533,108.9
32,강원도,015005, 14세,2017,13880,7205,6675,107.9,13869,7200,6669,108
32,강원도,020,15~19세,2017,89850,47915,41935,114.3,89224,47592,41632,114.3
32,강원도,020001, 15세,2017,14823,7730,7093,109,14810,7721,7089,108.9
32,강원도,020002, 16세,2017,17057,9039,8018,112.7,17038,9027,8011,112.7
32,강원도,020003, 17세,2017,18474,9815,8659,113.4,18429,9788,8641,113.3
32,강원도,020004, 18세,2017,18745,9912,8833,112.2,18639,9855,8784,112.2
32,강원도,020005, 19세,2017,20751,11419,9332,122.4,20308,11201,9107,123
32,강원도,025,20~24세,2017,107260,61508,45752,134.4,103149,59138,44011,134.4
32,강원도,025001, 20세,2017,21246,11488,9758,117.7,20584,11157,9427,118.4
32,강원도,025002, 21세,2017,21537,11680,9857,118.5,20656,11176,9480,117.9
32,강원도,025003, 22세,2017,21401,12073,9328,129.4,20589,11568,9021,128.2
32,강원도,025004, 23세,2017,21733,13128,8605,152.6,20876,12613,8263,152.6
32,강원도,025005, 24세,2017,21343,13139,8204,160.2,20444,12624,7820,161.4
32,강원도,030,25~29세,2017,84879,48381,36498,132.6,81027,46216,34811,132.8
32,강원도,030001, 25세,2017,20150,11988,8162,146.9,19298,11502,7796,147.5
32,강원도,030002, 26세,2017,17716,10155,7561,134.3,16949,9728,7221,134.7
32,강원도,030003, 27세,2017,16274,9212,7062,130.4,15493,8777,6716,130.7
32,강원도,030004, 28세,2017,15540,8735,6805,128.4,14796,8294,6502,127.6
32,강원도,030005, 29세,2017,15199,8291,6908,120,14491,7915,6576,120.4
32,강원도,035,30~34세,2017,79689,42731,36958,115.6,76594,40984,35610,115.1
32,강원도,035001, 30세,2017,14923,8100,6823,118.7,14252,7708,6544,117.8
32,강원도,035002, 31세,2017,15317,8308,7009,118.5,14677,7972,6705,118.9
32,강원도,035003, 32세,2017,15484,8367,7117,117.6,14825,7995,6830,117.1
32,강원도,035004, 33세,2017,16023,8546,7477,114.3,15452,8217,7235,113.6
32,강원도,035005, 34세,2017,17942,9410,8532,110.3,17388,9092,8296,109.6
32,강원도,040,35~39세,2017,98679,50391,48288,104.4,96458,49092,47366,103.6
32,강원도,040001, 35세,2017,19625,10016,9609,104.2,19108,9724,9384,103.6
32,강원도,040002, 36세,2017,19901,10390,9511,109.2,19428,10104,9324,108.4
32,강원도,040003, 37세,2017,20380,10272,10108,101.6,19895,9985,9910,100.8
32,강원도,040004, 38세,2017,19627,9981,9646,103.5,19235,9767,9468,103.2
32,강원도,040005, 39세,2017,19146,9732,9414,103.4,18792,9512,9280,102.5
32,강원도,045,40~44세,2017,108105,55547,52558,105.7,106571,54692,51879,105.4
32,강원도,045001, 40세,2017,19679,10051,9628,104.4,19355,9867,9488,104
32,강원도,045002, 41세,2017,19659,10071,9588,105,19357,9892,9465,104.5
32,강원도,045003, 42세,2017,21062,10809,10253,105.4,20713,10620,10093,105.2
32,강원도,045004, 43세,2017,23606,12081,11525,104.8,23345,11935,11410,104.6
32,강원도,045005, 44세,2017,24099,12535,11564,108.4,23801,12378,11423,108.4
32,강원도,050,45~49세,2017,125915,65585,60330,108.7,124393,64849,59544,108.9
32,강원도,050001, 45세,2017,23369,12363,11006,112.3,23083,12222,10861,112.5
32,강원도,050002, 46세,2017,25401,13123,12278,106.9,25103,12970,12133,106.9
32,강원도,050003, 47세,2017,24935,13029,11906,109.4,24594,12867,11727,109.7
32,강원도,050004, 48세,2017,25922,13412,12510,107.2,25616,13277,12339,107.6
32,강원도,050005, 49세,2017,26288,13658,12630,108.1,25997,13513,12484,108.2
32,강원도,055,50~54세,2017,121263,62397,58866,106,119940,61849,58091,106.5
32,강원도,055001, 50세,2017,23993,12310,11683,105.4,23753,12208,11545,105.7
32,강원도,055002, 51세,2017,24554,12881,11673,110.3,24271,12757,11514,110.8
32,강원도,055003, 52세,2017,23509,11809,11700,100.9,23224,11686,11538,101.3
32,강원도,055004, 53세,2017,23724,12314,11410,107.9,23482,12220,11262,108.5
32,강원도,055005, 54세,2017,25483,13083,12400,105.5,25210,12978,12232,106.1
32,강원도,060,55~59세,2017,140558,70338,70220,100.2,139603,69933,69670,100.4
32,강원도,060001, 55세,2017,27113,13861,13252,104.6,26899,13772,13127,104.9
32,강원도,060002, 56세,2017,30050,15003,15047,99.7,29866,14922,14944,99.9
32,강원도,060003, 57세,2017,29659,14574,15085,96.6,29458,14478,14980,96.6
32,강원도,060004, 58세,2017,27080,13523,13557,99.7,26882,13448,13434,100.1
32,강원도,060005, 59세,2017,26656,13377,13279,100.7,26498,13313,13185,101
32,강원도,065,60~64세,2017,112039,56432,55607,101.5,111303,56075,55228,101.5
32,강원도,065001, 60세,2017,26270,13404,12866,104.2,26097,13325,12772,104.3
32,강원도,065002, 61세,2017,23735,11997,11738,102.2,23577,11924,11653,102.3
32,강원도,065003, 62세,2017,23756,11931,11825,100.9,23597,11848,11749,100.8
32,강원도,065004, 63세,2017,20918,10501,10417,100.8,20788,10432,10356,100.7
32,강원도,065005, 64세,2017,17360,8599,8761,98.2,17244,8546,8698,98.3
32,강원도,070,65~69세,2017,75253,35940,39313,91.4,74860,35752,39108,91.4
32,강원도,070001, 65세,2017,20846,10226,10620,96.3,20733,10177,10556,96.4
32,강원도,070002, 66세,2017,12313,5833,6480,90,12225,5795,6430,90.1
32,강원도,070003, 67세,2017,13210,6128,7082,86.5,13142,6093,7049,86.4
32,강원도,070004, 68세,2017,14041,6761,7280,92.9,13966,6723,7243,92.8
32,강원도,070005, 69세,2017,14843,6992,7851,89.1,14794,6964,7830,88.9
32,강원도,075,70~74세,2017,67980,31015,36965,83.9,67806,30930,36876,83.9
32,강원도,075001, 70세,2017,14943,7098,7845,90.5,14899,7082,7817,90.6
32,강원도,075002, 71세,2017,12558,5863,6695,87.6,12515,5839,6676,87.5
32,강원도,075003, 72세,2017,13626,6249,7377,84.7,13593,6230,7363,84.6
32,강원도,075004, 73세,2017,13387,5912,7475,79.1,13364,5901,7463,79.1
32,강원도,075005, 74세,2017,13466,5893,7573,77.8,13435,5878,7557,77.8
32,강원도,080,75~79세,2017,64184,26881,37303,72.1,64089,26843,37246,72.1
32,강원도,080001, 75세,2017,14926,6493,8433,77,14900,6480,8420,77
32,강원도,080002, 76세,2017,13421,5712,7709,74.1,13400,5706,7694,74.2
32,강원도,080003, 77세,2017,12616,5230,7386,70.8,12600,5221,7379,70.8
32,강원도,080004, 78세,2017,12017,4903,7114,68.9,12004,4898,7106,68.9
32,강원도,080005, 79세,2017,11204,4543,6661,68.2,11185,4538,6647,68.3
32,강원도,085,80~84세,2017,38061,13632,24429,55.8,38005,13609,24396,55.8
32,강원도,085001, 80세,2017,9640,3841,5799,66.2,9621,3832,5789,66.2
32,강원도,085002, 81세,2017,8698,3343,5355,62.4,8692,3340,5352,62.4
32,강원도,085003, 82세,2017,7784,2660,5124,51.9,7776,2658,5118,51.9
32,강원도,085004, 83세,2017,6491,2082,4409,47.2,6476,2076,4400,47.2
32,강원도,085005, 84세,2017,5448,1706,3742,45.6,5440,1703,3737,45.6
32,강원도,090,85~89세,2017,17753,4699,13054,36,17741,4696,13045,36
32,강원도,090001, 85세,2017,4605,1322,3283,40.3,4601,1322,3279,40.3
32,강원도,090002, 86세,2017,3840,1075,2765,38.9,3839,1074,2765,38.8
32,강원도,090003, 87세,2017,3701,958,2743,34.9,3696,957,2739,34.9
32,강원도,090004, 88세,2017,3141,770,2371,32.5,3140,770,2370,32.5
32,강원도,090005, 89세,2017,2466,574,1892,30.3,2465,573,1892,30.3
32,강원도,095,90~94세,2017,6596,1628,4968,32.8,6590,1626,4964,32.8
32,강원도,095001, 90세,2017,2023,473,1550,30.5,2020,471,1549,30.4
32,강원도,095002, 91세,2017,1505,330,1175,28.1,1503,330,1173,28.1
32,강원도,095003, 92세,2017,1284,325,959,33.9,1284,325,959,33.9
32,강원도,095004, 93세,2017,958,263,695,37.8,958,263,695,37.8
32,강원도,095005, 94세,2017,826,237,589,40.2,825,237,588,40.3
32,강원도,100,95~99세,2017,1477,348,1129,30.8,1468,346,1122,30.8
32,강원도,100001, 95세,2017,566,151,415,36.4,562,150,412,36.4
32,강원도,100002, 96세,2017,375,72,303,23.8,375,72,303,23.8
32,강원도,100003, 97세,2017,232,58,174,33.3,229,58,171,33.9
32,강원도,100004, 98세,2017,187,46,141,32.6,185,45,140,32.1
32,강원도,100005, 99세,2017,117,21,96,21.9,117,21,96,21.9
32,강원도,101,100세이상,2017,189,32,157,20.4,189,32,157,20.4
32,강원도,102,15세미만,2017,181656,93643,88013,106.4,181380,93510,87870,106.4
32,강원도,103,15~64세,2017,1068237,561225,507012,110.7,1048262,550420,497842,110.6
32,강원도,104,65세이상,2017,271493,114175,157318,72.6,270748,113834,156914,72.5
32,강원도,086,85세이상,2017,26015,6707,19308,34.7,25988,6700,19288,34.7
32,강원도,126,평균연령,2017,43.7,42.1,45.4,,43.8,42.2,45.5,
32,강원도,127,중위연령,2017,45.5,43.7,47.2,,45.7,44,47.4,
32004, 읍부,000,합계,2017,260460,133729,126731,105.5,256410,131466,124944,105.2
32004, 읍부,005,0~4세,2017,9144,4649,4495,103.4,9129,4642,4487,103.5
32004, 읍부,005001, 0세,2017,1699,859,840,102.3,1698,859,839,102.4
32004, 읍부,005002, 1세,2017,1787,930,857,108.5,1784,928,856,108.4
32004, 읍부,005003, 2세,2017,1939,989,950,104.1,1935,987,948,104.1
32004, 읍부,005004, 3세,2017,1833,940,893,105.3,1829,939,890,105.5
32004, 읍부,005005, 4세,2017,1886,931,955,97.5,1883,929,954,97.4
32004, 읍부,010,5~9세,2017,10733,5561,5172,107.5,10727,5560,5167,107.6
32004, 읍부,010001, 5세,2017,2168,1107,1061,104.3,2166,1106,1060,104.3
32004, 읍부,010002, 6세,2017,2164,1116,1048,106.5,2164,1116,1048,106.5
32004, 읍부,010003, 7세,2017,2135,1110,1025,108.3,2135,1110,1025,108.3
32004, 읍부,010004, 8세,2017,2060,1079,981,110,2057,1079,978,110.3
32004, 읍부,010005, 9세,2017,2206,1149,1057,108.7,2205,1149,1056,108.8
32004, 읍부,015,10~14세,2017,10881,5640,5241,107.6,10871,5634,5237,107.6
32004, 읍부,015001, 10세,2017,2190,1132,1058,107,2187,1131,1056,107.1
32004, 읍부,015002, 11세,2017,2131,1113,1018,109.3,2129,1111,1018,109.1
32004, 읍부,015003, 12세,2017,2150,1134,1016,111.6,2148,1133,1015,111.6
32004, 읍부,015004, 13세,2017,2155,1097,1058,103.7,2155,1097,1058,103.7
32004, 읍부,015005, 14세,2017,2255,1164,1091,106.7,2252,1162,1090,106.6
32004, 읍부,020,15~19세,2017,14992,7900,7092,111.4,14965,7889,7076,111.5
32004, 읍부,020001, 15세,2017,2582,1346,1236,108.9,2580,1345,1235,108.9
32004, 읍부,020002, 16세,2017,3093,1632,1461,111.7,3089,1630,1459,111.7
32004, 읍부,020003, 17세,2017,3323,1750,1573,111.3,3319,1749,1570,111.4
32004, 읍부,020004, 18세,2017,3077,1637,1440,113.7,3074,1637,1437,113.9
32004, 읍부,020005, 19세,2017,2917,1535,1382,111.1,2903,1528,1375,111.1
32004, 읍부,025,20~24세,2017,16628,9913,6715,147.6,15983,9493,6490,146.3
32004, 읍부,025001, 20세,2017,3182,1749,1433,122.1,3130,1722,1408,122.3
32004, 읍부,025002, 21세,2017,3194,1808,1386,130.4,3112,1755,1357,129.3
32004, 읍부,025003, 22세,2017,3443,1954,1489,131.2,3314,1858,1456,127.6
32004, 읍부,025004, 23세,2017,3428,2204,1224,180.1,3255,2088,1167,178.9
32004, 읍부,025005, 24세,2017,3381,2198,1183,185.8,3172,2070,1102,187.8
32004, 읍부,030,25~29세,2017,14689,8866,5823,152.3,13883,8364,5519,151.5
32004, 읍부,030001, 25세,2017,3383,2171,1212,179.1,3207,2058,1149,179.1
32004, 읍부,030002, 26세,2017,3166,1874,1292,145,2998,1782,1216,146.5
32004, 읍부,030003, 27세,2017,2838,1703,1135,150,2683,1605,1078,148.9
32004, 읍부,030004, 28세,2017,2681,1619,1062,152.4,2511,1504,1007,149.4
32004, 읍부,030005, 29세,2017,2621,1499,1122,133.6,2484,1415,1069,132.4
32004, 읍부,035,30~34세,2017,13530,7499,6031,124.3,12834,7061,5773,122.3
32004, 읍부,035001, 30세,2017,2641,1553,1088,142.7,2500,1462,1038,140.8
32004, 읍부,035002, 31세,2017,2631,1499,1132,132.4,2486,1412,1074,131.5
32004, 읍부,035003, 32세,2017,2592,1471,1121,131.2,2448,1381,1067,129.4
32004, 읍부,035004, 33세,2017,2707,1441,1266,113.8,2572,1357,1215,111.7
32004, 읍부,035005, 34세,2017,2959,1535,1424,107.8,2828,1449,1379,105.1
32004, 읍부,040,35~39세,2017,16433,8654,7779,111.2,15931,8365,7566,110.6
32004, 읍부,040001, 35세,2017,3223,1695,1528,110.9,3121,1634,1487,109.9
32004, 읍부,040002, 36세,2017,3429,1802,1627,110.8,3314,1736,1578,110
32004, 읍부,040003, 37세,2017,3369,1749,1620,108,3251,1685,1566,107.6
32004, 읍부,040004, 38세,2017,3181,1704,1477,115.4,3088,1648,1440,114.4
32004, 읍부,040005, 39세,2017,3231,1704,1527,111.6,3157,1662,1495,111.2
32004, 읍부,045,40~44세,2017,17819,9566,8253,115.9,17520,9398,8122,115.7
32004, 읍부,045001, 40세,2017,3310,1731,1579,109.6,3242,1686,1556,108.4
32004, 읍부,045002, 41세,2017,3279,1764,1515,116.4,3214,1721,1493,115.3
32004, 읍부,045003, 42세,2017,3492,1858,1634,113.7,3431,1831,1600,114.4
32004, 읍부,045004, 43세,2017,3868,2127,1741,122.2,3821,2102,1719,122.3
32004, 읍부,045005, 44세,2017,3870,2086,1784,116.9,3812,2058,1754,117.3
32004, 읍부,050,45~49세,2017,20364,11008,9356,117.7,20037,10870,9167,118.6
32004, 읍부,050001, 45세,2017,3790,2018,1772,113.9,3741,2000,1741,114.9
32004, 읍부,050002, 46세,2017,4090,2214,1876,118,4023,2178,1845,118
32004, 읍부,050003, 47세,2017,3981,2157,1824,118.3,3908,2125,1783,119.2
32004, 읍부,050004, 48세,2017,4178,2244,1934,116,4101,2217,1884,117.7
32004, 읍부,050005, 49세,2017,4325,2375,1950,121.8,4264,2350,1914,122.8
32004, 읍부,055,50~54세,2017,20318,10796,9522,113.4,20050,10699,9351,114.4
32004, 읍부,055001, 50세,2017,3859,2045,1814,112.7,3812,2030,1782,113.9
32004, 읍부,055002, 51세,2017,4093,2201,1892,116.3,4031,2176,1855,117.3
32004, 읍부,055003, 52세,2017,3920,1998,1922,104,3858,1972,1886,104.6
32004, 읍부,055004, 53세,2017,4061,2202,1859,118.5,4009,2187,1822,120
32004, 읍부,055005, 54세,2017,4385,2350,2035,115.5,4340,2334,2006,116.4
32004, 읍부,060,55~59세,2017,24167,12584,11583,108.6,23970,12510,11460,109.2
32004, 읍부,060001, 55세,2017,4679,2475,2204,112.3,4632,2455,2177,112.8
32004, 읍부,060002, 56세,2017,5148,2692,2456,109.6,5107,2676,2431,110.1
32004, 읍부,060003, 57세,2017,5107,2606,2501,104.2,5064,2588,2476,104.5
32004, 읍부,060004, 58세,2017,4563,2389,2174,109.9,4526,2377,2149,110.6
32004, 읍부,060005, 59세,2017,4670,2422,2248,107.7,4641,2414,2227,108.4
32004, 읍부,065,60~64세,2017,19595,9829,9766,100.6,19465,9767,9698,100.7
32004, 읍부,065001, 60세,2017,4455,2341,2114,110.7,4416,2323,2093,111
32004, 읍부,065002, 61세,2017,4246,2108,2138,98.6,4215,2095,2120,98.8
32004, 읍부,065003, 62세,2017,4150,2095,2055,101.9,4131,2084,2047,101.8
32004, 읍부,065004, 63세,2017,3735,1830,1905,96.1,3715,1818,1897,95.8
32004, 읍부,065005, 64세,2017,3009,1455,1554,93.6,2988,1447,1541,93.9
32004, 읍부,070,65~69세,2017,13692,6412,7280,88.1,13626,6384,7242,88.2
32004, 읍부,070001, 65세,2017,3582,1737,1845,94.1,3560,1729,1831,94.4
32004, 읍부,070002, 66세,2017,2303,1084,1219,88.9,2288,1077,1211,88.9
32004, 읍부,070003, 67세,2017,2449,1126,1323,85.1,2437,1119,1318,84.9
32004, 읍부,070004, 68세,2017,2666,1237,1429,86.6,2657,1233,1424,86.6
32004, 읍부,070005, 69세,2017,2692,1228,1464,83.9,2684,1226,1458,84.1
32004, 읍부,075,70~74세,2017,13069,5904,7165,82.4,13036,5888,7148,82.4
32004, 읍부,075001, 70세,2017,2872,1321,1551,85.2,2864,1318,1546,85.3
32004, 읍부,075002, 71세,2017,2388,1117,1271,87.9,2376,1112,1264,88
32004, 읍부,075003, 72세,2017,2633,1214,1419,85.6,2627,1209,1418,85.3
32004, 읍부,075004, 73세,2017,2557,1126,1431,78.7,2555,1126,1429,78.8
32004, 읍부,075005, 74세,2017,2619,1126,1493,75.4,2614,1123,1491,75.3
32004, 읍부,080,75~79세,2017,12475,5153,7322,70.4,12463,5150,7313,70.4
32004, 읍부,080001, 75세,2017,2941,1272,1669,76.2,2937,1270,1667,76.2
32004, 읍부,080002, 76세,2017,2644,1111,1533,72.5,2641,1111,1530,72.6
32004, 읍부,080003, 77세,2017,2476,1007,1469,68.6,2475,1006,1469,68.5
32004, 읍부,080004, 78세,2017,2366,958,1408,68,2365,958,1407,68.1
32004, 읍부,080005, 79세,2017,2048,805,1243,64.8,2045,805,1240,64.9
32004, 읍부,085,80~84세,2017,7040,2495,4545,54.9,7031,2492,4539,54.9
32004, 읍부,085001, 80세,2017,1843,698,1145,61,1840,697,1143,61
32004, 읍부,085002, 81세,2017,1587,619,968,63.9,1585,617,968,63.7
32004, 읍부,085003, 82세,2017,1419,488,931,52.4,1416,488,928,52.6
32004, 읍부,085004, 83세,2017,1173,350,823,42.5,1172,350,822,42.6
32004, 읍부,085005, 84세,2017,1018,340,678,50.1,1018,340,678,50.1
32004, 읍부,090,85~89세,2017,3350,905,2445,37,3349,905,2444,37
32004, 읍부,090001, 85세,2017,881,271,610,44.4,881,271,610,44.4
32004, 읍부,090002, 86세,2017,695,189,506,37.4,695,189,506,37.4
32004, 읍부,090003, 87세,2017,710,179,531,33.7,709,179,530,33.8
32004, 읍부,090004, 88세,2017,596,159,437,36.4,596,159,437,36.4
32004, 읍부,090005, 89세,2017,468,107,361,29.6,468,107,361,29.6
32004, 읍부,095,90~94세,2017,1230,315,915,34.4,1230,315,915,34.4
32004, 읍부,095001, 90세,2017,379,93,286,32.5,379,93,286,32.5
32004, 읍부,095002, 91세,2017,283,60,223,26.9,283,60,223,26.9
32004, 읍부,095003, 92세,2017,242,69,173,39.9,242,69,173,39.9
32004, 읍부,095004, 93세,2017,178,54,124,43.5,178,54,124,43.5
32004, 읍부,095005, 94세,2017,148,39,109,35.8,148,39,109,35.8
32004, 읍부,100,95~99세,2017,277,74,203,36.5,276,74,202,36.6
32004, 읍부,100001, 95세,2017,93,30,63,47.6,93,30,63,47.6
32004, 읍부,100002, 96세,2017,77,18,59,30.5,77,18,59,30.5
32004, 읍부,100003, 97세,2017,46,15,31,48.4,45,15,30,50
32004, 읍부,100004, 98세,2017,35,5,30,16.7,35,5,30,16.7
32004, 읍부,100005, 99세,2017,26,6,20,30,26,6,20,30
32004, 읍부,101,100세이상,2017,34,6,28,21.4,34,6,28,21.4
32004, 읍부,102,15세미만,2017,30758,15850,14908,106.3,30727,15836,14891,106.3
32004, 읍부,103,15~64세,2017,178535,96615,81920,117.9,174638,94416,80222,117.7
32004, 읍부,104,65세이상,2017,51167,21264,29903,71.1,51045,21214,29831,71.1
32004, 읍부,086,85세이상,2017,4891,1300,3591,36.2,4889,1300,3589,36.2
32004, 읍부,126,평균연령,2017,44.5,42.7,46.4,,44.6,42.8,46.5,
32004, 읍부,127,중위연령,2017,46.4,44.3,48.7,,46.7,44.7,48.9,
32005, 면부,000,합계,2017,337821,175670,162151,108.3,331231,171822,159409,107.8
32005, 면부,005,0~4세,2017,8653,4508,4145,108.8,8636,4496,4140,108.6
32005, 면부,005001, 0세,2017,1522,803,719,111.7,1519,802,717,111.9
32005, 면부,005002, 1세,2017,1698,877,821,106.8,1694,873,821,106.3
32005, 면부,005003, 2세,2017,1759,909,850,106.9,1756,907,849,106.8
32005, 면부,005004, 3세,2017,1847,936,911,102.7,1847,936,911,102.7
32005, 면부,005005, 4세,2017,1827,983,844,116.5,1820,978,842,116.2
32005, 면부,010,5~9세,2017,10255,5295,4960,106.8,10241,5291,4950,106.9
32005, 면부,010001, 5세,2017,2064,1055,1009,104.6,2061,1054,1007,104.7
32005, 면부,010002, 6세,2017,2049,1114,935,119.1,2045,1112,933,119.2
32005, 면부,010003, 7세,2017,2031,1030,1001,102.9,2028,1029,999,103
32005, 면부,010004, 8세,2017,2026,1021,1005,101.6,2025,1021,1004,101.7
32005, 면부,010005, 9세,2017,2085,1075,1010,106.4,2082,1075,1007,106.8
32005, 면부,015,10~14세,2017,9987,5227,4760,109.8,9975,5223,4752,109.9
32005, 면부,015001, 10세,2017,2077,1056,1021,103.4,2074,1055,1019,103.5
32005, 면부,015002, 11세,2017,1972,1032,940,109.8,1969,1032,937,110.1
32005, 면부,015003, 12세,2017,1860,984,876,112.3,1859,984,875,112.5
32005, 면부,015004, 13세,2017,2055,1090,965,113,2052,1088,964,112.9
32005, 면부,015005, 14세,2017,2023,1065,958,111.2,2021,1064,957,111.2
32005, 면부,020,15~19세,2017,14931,8137,6794,119.8,14761,8044,6717,119.8
32005, 면부,020001, 15세,2017,2165,1143,1022,111.8,2163,1141,1022,111.6
32005, 면부,020002, 16세,2017,2673,1386,1287,107.7,2667,1383,1284,107.7
32005, 면부,020003, 17세,2017,2860,1503,1357,110.8,2851,1496,1355,110.4
32005, 면부,020004, 18세,2017,3239,1749,1490,117.4,3210,1731,1479,117
32005, 면부,020005, 19세,2017,3994,2356,1638,143.8,3870,2293,1577,145.4
32005, 면부,025,20~24세,2017,22624,14069,8555,164.5,21257,13124,8133,161.4
32005, 면부,025001, 20세,2017,4062,2260,1802,125.4,3854,2128,1726,123.3
32005, 면부,025002, 21세,2017,4387,2465,1922,128.3,4045,2221,1824,121.8
32005, 면부,025003, 22세,2017,4397,2663,1734,153.6,4113,2454,1659,147.9
32005, 면부,025004, 23세,2017,4881,3279,1602,204.7,4626,3105,1521,204.1
32005, 면부,025005, 24세,2017,4897,3402,1495,227.6,4619,3216,1403,229.2
32005, 면부,030,25~29세,2017,18142,11471,6671,172,16871,10697,6174,173.3
32005, 면부,030001, 25세,2017,4538,3021,1517,199.1,4227,2825,1402,201.5
32005, 면부,030002, 26세,2017,3927,2514,1413,177.9,3678,2361,1317,179.3
32005, 면부,030003, 27세,2017,3448,2167,1281,169.2,3187,2005,1182,169.6
32005, 면부,030004, 28세,2017,3186,1955,1231,158.8,2945,1808,1137,159
32005, 면부,030005, 29세,2017,3043,1814,1229,147.6,2834,1698,1136,149.5
32005, 면부,035,30~34세,2017,15067,8691,6376,136.3,14045,8075,5970,135.3
32005, 면부,035001, 30세,2017,2932,1724,1208,142.7,2725,1598,1127,141.8
32005, 면부,035002, 31세,2017,2994,1745,1249,139.7,2781,1618,1163,139.1
32005, 면부,035003, 32세,2017,2944,1704,1240,137.4,2725,1570,1155,135.9
32005, 면부,035004, 33세,2017,2962,1680,1282,131,2775,1570,1205,130.3
32005, 면부,035005, 34세,2017,3235,1838,1397,131.6,3039,1719,1320,130.2
32005, 면부,040,35~39세,2017,16761,9224,7537,122.4,16026,8782,7244,121.2
32005, 면부,040001, 35세,2017,3389,1852,1537,120.5,3222,1757,1465,119.9
32005, 면부,040002, 36세,2017,3354,1912,1442,132.6,3207,1817,1390,130.7
32005, 면부,040003, 37세,2017,3439,1832,1607,114,3282,1741,1541,113
32005, 면부,040004, 38세,2017,3359,1840,1519,121.1,3218,1756,1462,120.1
32005, 면부,040005, 39세,2017,3220,1788,1432,124.9,3097,1711,1386,123.4
32005, 면부,045,40~44세,2017,18119,10268,7851,130.8,17662,9996,7666,130.4
32005, 면부,045001, 40세,2017,3317,1857,1460,127.2,3207,1788,1419,126
32005, 면부,045002, 41세,2017,3320,1903,1417,134.3,3226,1841,1385,132.9
32005, 면부,045003, 42세,2017,3507,2000,1507,132.7,3416,1951,1465,133.2
32005, 면부,045004, 43세,2017,3905,2174,1731,125.6,3824,2126,1698,125.2
32005, 면부,045005, 44세,2017,4070,2334,1736,134.4,3989,2290,1699,134.8
32005, 면부,050,45~49세,2017,22745,12684,10061,126.1,22297,12471,9826,126.9
32005, 면부,050001, 45세,2017,3974,2327,1647,141.3,3880,2276,1604,141.9
32005, 면부,050002, 46세,2017,4382,2488,1894,131.4,4299,2448,1851,132.3
32005, 면부,050003, 47세,2017,4343,2388,1955,122.1,4242,2343,1899,123.4
32005, 면부,050004, 48세,2017,4885,2678,2207,121.3,4802,2640,2162,122.1
32005, 면부,050005, 49세,2017,5161,2803,2358,118.9,5074,2764,2310,119.7
32005, 면부,055,50~54세,2017,26471,14015,12456,112.5,26112,13875,12237,113.4
32005, 면부,055001, 50세,2017,4794,2581,2213,116.6,4733,2558,2175,117.6
32005, 면부,055002, 51세,2017,5138,2783,2355,118.2,5059,2751,2308,119.2
32005, 면부,055003, 52세,2017,5190,2730,2460,111,5115,2698,2417,111.6
32005, 면부,055004, 53세,2017,5372,2832,2540,111.5,5298,2802,2496,112.3
32005, 면부,055005, 54세,2017,5977,3089,2888,107,5907,3066,2841,107.9
32005, 면부,060,55~59세,2017,36762,18747,18015,104.1,36482,18628,17854,104.3
32005, 면부,060001, 55세,2017,6628,3471,3157,109.9,6558,3446,3112,110.7
32005, 면부,060002, 56세,2017,7775,3890,3885,100.1,7727,3869,3858,100.3
32005, 면부,060003, 57세,2017,7723,3906,3817,102.3,7667,3877,3790,102.3
32005, 면부,060004, 58세,2017,7210,3687,3523,104.7,7156,3666,3490,105
32005, 면부,060005, 59세,2017,7426,3793,3633,104.4,7374,3770,3604,104.6
32005, 면부,065,60~64세,2017,31998,16713,15285,109.3,31771,16596,15175,109.4
32005, 면부,065001, 60세,2017,7406,3859,3547,108.8,7353,3834,3519,109
32005, 면부,065002, 61세,2017,6630,3465,3165,109.5,6582,3439,3143,109.4
32005, 면부,065003, 62세,2017,6777,3507,3270,107.2,6727,3483,3244,107.4
32005, 면부,065004, 63세,2017,6074,3208,2866,111.9,6033,3183,2850,111.7
32005, 면부,065005, 64세,2017,5111,2674,2437,109.7,5076,2657,2419,109.8
32005, 면부,070,65~69세,2017,21981,10980,11001,99.8,21867,10922,10945,99.8
32005, 면부,070001, 65세,2017,6239,3251,2988,108.8,6209,3236,2973,108.8
32005, 면부,070002, 66세,2017,3558,1733,1825,95,3533,1720,1813,94.9
32005, 면부,070003, 67세,2017,3771,1797,1974,91,3752,1788,1964,91
32005, 면부,070004, 68세,2017,4081,2046,2035,100.5,4058,2037,2021,100.8
32005, 면부,070005, 69세,2017,4332,2153,2179,98.8,4315,2141,2174,98.5
32005, 면부,075,70~74세,2017,20504,9703,10801,89.8,20449,9676,10773,89.8
32005, 면부,075001, 70세,2017,4390,2229,2161,103.1,4372,2224,2148,103.5
32005, 면부,075002, 71세,2017,3841,1890,1951,96.9,3830,1883,1947,96.7
32005, 면부,075003, 72세,2017,4081,1934,2147,90.1,4068,1927,2141,90
32005, 면부,075004, 73세,2017,4027,1793,2234,80.3,4023,1790,2233,80.2
32005, 면부,075005, 74세,2017,4165,1857,2308,80.5,4156,1852,2304,80.4
32005, 면부,080,75~79세,2017,20956,9057,11899,76.1,20934,9050,11884,76.2
32005, 면부,080001, 75세,2017,4749,2155,2594,83.1,4743,2153,2590,83.1
32005, 면부,080002, 76세,2017,4352,1903,2449,77.7,4348,1903,2445,77.8
32005, 면부,080003, 77세,2017,4106,1806,2300,78.5,4099,1803,2296,78.5
32005, 면부,080004, 78세,2017,3957,1633,2324,70.3,3955,1632,2323,70.3
32005, 면부,080005, 79세,2017,3792,1560,2232,69.9,3789,1559,2230,69.9
32005, 면부,085,80~84세,2017,12883,4604,8279,55.6,12875,4603,8272,55.6
32005, 면부,085001, 80세,2017,3298,1332,1966,67.8,3294,1331,1963,67.8
32005, 면부,085002, 81세,2017,2942,1159,1783,65,2940,1159,1781,65.1
32005, 면부,085003, 82세,2017,2648,897,1751,51.2,2648,897,1751,51.2
32005, 면부,085004, 83세,2017,2211,685,1526,44.9,2210,685,1525,44.9
32005, 면부,085005, 84세,2017,1784,531,1253,42.4,1783,531,1252,42.4
32005, 면부,090,85~89세,2017,5934,1550,4384,35.4,5928,1547,4381,35.3
32005, 면부,090001, 85세,2017,1549,426,1123,37.9,1548,426,1122,38
32005, 면부,090002, 86세,2017,1336,378,958,39.5,1335,377,958,39.4
32005, 면부,090003, 87세,2017,1215,306,909,33.7,1212,305,907,33.6
32005, 면부,090004, 88세,2017,1017,245,772,31.7,1017,245,772,31.7
32005, 면부,090005, 89세,2017,817,195,622,31.4,816,194,622,31.2
32005, 면부,095,90~94세,2017,2428,592,1836,32.2,2425,592,1833,32.3
32005, 면부,095001, 90세,2017,698,136,562,24.2,697,136,561,24.2
32005, 면부,095002, 91세,2017,541,119,422,28.2,540,119,421,28.3
32005, 면부,095003, 92세,2017,488,132,356,37.1,488,132,356,37.1
32005, 면부,095004, 93세,2017,388,117,271,43.2,388,117,271,43.2
32005, 면부,095005, 94세,2017,313,88,225,39.1,312,88,224,39.3
32005, 면부,100,95~99세,2017,547,122,425,28.7,544,121,423,28.6
32005, 면부,100001, 95세,2017,215,55,160,34.4,214,55,159,34.6
32005, 면부,100002, 96세,2017,128,14,114,12.3,128,14,114,12.3
32005, 면부,100003, 97세,2017,85,18,67,26.9,85,18,67,26.9
32005, 면부,100004, 98세,2017,75,26,49,53.1,73,25,48,52.1
32005, 면부,100005, 99세,2017,44,9,35,25.7,44,9,35,25.7
32005, 면부,101,100세이상,2017,73,13,60,21.7,73,13,60,21.7
32005, 면부,102,15세미만,2017,28895,15030,13865,108.4,28852,15010,13842,108.4
32005, 면부,103,15~64세,2017,223620,124019,99601,124.5,217284,120288,96996,124
32005, 면부,104,65세이상,2017,85306,36621,48685,75.2,85095,36524,48571,75.2
32005, 면부,086,85세이상,2017,8982,2277,6705,34,8970,2273,6697,33.9
32005, 면부,126,평균연령,2017,48.6,46.4,51,,48.9,46.6,51.3,
32005, 면부,127,중위연령,2017,52.3,49.4,55.3,,52.8,49.9,55.6,
32003, 동부,000,합계,2017,923105,459644,463461,99.2,912749,454476,458273,99.2
32003, 동부,005,0~4세,2017,34958,17801,17157,103.8,34871,17755,17116,103.7
32003, 동부,005001, 0세,2017,5962,3068,2894,106,5947,3059,2888,105.9
32003, 동부,005002, 1세,2017,6836,3505,3331,105.2,6810,3491,3319,105.2
32003, 동부,005003, 2세,2017,7294,3657,3637,100.5,7280,3652,3628,100.7
32003, 동부,005004, 3세,2017,7299,3712,3587,103.5,7285,3705,3580,103.5
32003, 동부,005005, 4세,2017,7567,3859,3708,104.1,7549,3848,3701,104
32003, 동부,010,5~9세,2017,42001,21512,20489,105,41935,21481,20454,105
32003, 동부,010001, 5세,2017,8585,4383,4202,104.3,8567,4372,4195,104.2
32003, 동부,010002, 6세,2017,8528,4343,4185,103.8,8509,4334,4175,103.8
32003, 동부,010003, 7세,2017,8297,4249,4048,105,8288,4245,4043,105
32003, 동부,010004, 8세,2017,8162,4201,3961,106.1,8150,4197,3953,106.2
32003, 동부,010005, 9세,2017,8429,4336,4093,105.9,8421,4333,4088,106
32003, 동부,015,10~14세,2017,45044,23450,21594,108.6,44995,23428,21567,108.6
32003, 동부,015001, 10세,2017,9067,4758,4309,110.4,9058,4754,4304,110.5
32003, 동부,015002, 11세,2017,8295,4295,4000,107.4,8283,4292,3991,107.5
32003, 동부,015003, 12세,2017,8627,4484,4143,108.2,8617,4478,4139,108.2
32003, 동부,015004, 13세,2017,9453,4937,4516,109.3,9441,4930,4511,109.3
32003, 동부,015005, 14세,2017,9602,4976,4626,107.6,9596,4974,4622,107.6
32003, 동부,020,15~19세,2017,59927,31878,28049,113.7,59498,31659,27839,113.7
32003, 동부,020001, 15세,2017,10076,5241,4835,108.4,10067,5235,4832,108.3
32003, 동부,020002, 16세,2017,11291,6021,5270,114.3,11282,6014,5268,114.2
32003, 동부,020003, 17세,2017,12291,6562,5729,114.5,12259,6543,5716,114.5
32003, 동부,020004, 18세,2017,12429,6526,5903,110.6,12355,6487,5868,110.5
32003, 동부,020005, 19세,2017,13840,7528,6312,119.3,13535,7380,6155,119.9
32003, 동부,025,20~24세,2017,68008,37526,30482,123.1,65909,36521,29388,124.3
32003, 동부,025001, 20세,2017,14002,7479,6523,114.7,13600,7307,6293,116.1
32003, 동부,025002, 21세,2017,13956,7407,6549,113.1,13499,7200,6299,114.3
32003, 동부,025003, 22세,2017,13561,7456,6105,122.1,13162,7256,5906,122.9
32003, 동부,025004, 23세,2017,13424,7645,5779,132.3,12995,7420,5575,133.1
32003, 동부,025005, 24세,2017,13065,7539,5526,136.4,12653,7338,5315,138.1
32003, 동부,030,25~29세,2017,52048,28044,24004,116.8,50273,27155,23118,117.5
32003, 동부,030001, 25세,2017,12229,6796,5433,125.1,11864,6619,5245,126.2
32003, 동부,030002, 26세,2017,10623,5767,4856,118.8,10273,5585,4688,119.1
32003, 동부,030003, 27세,2017,9988,5342,4646,115,9623,5167,4456,116
32003, 동부,030004, 28세,2017,9673,5161,4512,114.4,9340,4982,4358,114.3
32003, 동부,030005, 29세,2017,9535,4978,4557,109.2,9173,4802,4371,109.9
32003, 동부,035,30~34세,2017,51092,26541,24551,108.1,49715,25848,23867,108.3
32003, 동부,035001, 30세,2017,9350,4823,4527,106.5,9027,4648,4379,106.1
32003, 동부,035002, 31세,2017,9692,5064,4628,109.4,9410,4942,4468,110.6
32003, 동부,035003, 32세,2017,9948,5192,4756,109.2,9652,5044,4608,109.5
32003, 동부,035004, 33세,2017,10354,5425,4929,110.1,10105,5290,4815,109.9
32003, 동부,035005, 34세,2017,11748,6037,5711,105.7,11521,5924,5597,105.8
32003, 동부,040,35~39세,2017,65485,32513,32972,98.6,64501,31945,32556,98.1
32003, 동부,040001, 35세,2017,13013,6469,6544,98.9,12765,6333,6432,98.5
32003, 동부,040002, 36세,2017,13118,6676,6442,103.6,12907,6551,6356,103.1
32003, 동부,040003, 37세,2017,13572,6691,6881,97.2,13362,6559,6803,96.4
32003, 동부,040004, 38세,2017,13087,6437,6650,96.8,12929,6363,6566,96.9
32003, 동부,040005, 39세,2017,12695,6240,6455,96.7,12538,6139,6399,95.9
32003, 동부,045,40~44세,2017,72167,35713,36454,98,71389,35298,36091,97.8
32003, 동부,045001, 40세,2017,13052,6463,6589,98.1,12906,6393,6513,98.2
32003, 동부,045002, 41세,2017,13060,6404,6656,96.2,12917,6330,6587,96.1
32003, 동부,045003, 42세,2017,14063,6951,7112,97.7,13866,6838,7028,97.3
32003, 동부,045004, 43세,2017,15833,7780,8053,96.6,15700,7707,7993,96.4
32003, 동부,045005, 44세,2017,16159,8115,8044,100.9,16000,8030,7970,100.8
32003, 동부,050,45~49세,2017,82806,41893,40913,102.4,82059,41508,40551,102.4
32003, 동부,050001, 45세,2017,15605,8018,7587,105.7,15462,7946,7516,105.7
32003, 동부,050002, 46세,2017,16929,8421,8508,99,16781,8344,8437,98.9
32003, 동부,050003, 47세,2017,16611,8484,8127,104.4,16444,8399,8045,104.4
32003, 동부,050004, 48세,2017,16859,8490,8369,101.4,16713,8420,8293,101.5
32003, 동부,050005, 49세,2017,16802,8480,8322,101.9,16659,8399,8260,101.7
32003, 동부,055,50~54세,2017,74474,37586,36888,101.9,73778,37275,36503,102.1
32003, 동부,055001, 50세,2017,15340,7684,7656,100.4,15208,7620,7588,100.4
32003, 동부,055002, 51세,2017,15323,7897,7426,106.3,15181,7830,7351,106.5
32003, 동부,055003, 52세,2017,14399,7081,7318,96.8,14251,7016,7235,97
32003, 동부,055004, 53세,2017,14291,7280,7011,103.8,14175,7231,6944,104.1
32003, 동부,055005, 54세,2017,15121,7644,7477,102.2,14963,7578,7385,102.6
32003, 동부,060,55~59세,2017,79629,39007,40622,96,79151,38795,40356,96.1
32003, 동부,060001, 55세,2017,15806,7915,7891,100.3,15709,7871,7838,100.4
32003, 동부,060002, 56세,2017,17127,8421,8706,96.7,17032,8377,8655,96.8
32003, 동부,060003, 57세,2017,16829,8062,8767,92,16727,8013,8714,92
32003, 동부,060004, 58세,2017,15307,7447,7860,94.7,15200,7405,7795,95
32003, 동부,060005, 59세,2017,14560,7162,7398,96.8,14483,7129,7354,96.9
32003, 동부,065,60~64세,2017,60446,29890,30556,97.8,60067,29712,30355,97.9
32003, 동부,065001, 60세,2017,14409,7204,7205,100,14328,7168,7160,100.1
32003, 동부,065002, 61세,2017,12859,6424,6435,99.8,12780,6390,6390,100
32003, 동부,065003, 62세,2017,12829,6329,6500,97.4,12739,6281,6458,97.3
32003, 동부,065004, 63세,2017,11109,5463,5646,96.8,11040,5431,5609,96.8
32003, 동부,065005, 64세,2017,9240,4470,4770,93.7,9180,4442,4738,93.8
32003, 동부,070,65~69세,2017,39580,18548,21032,88.2,39367,18446,20921,88.2
32003, 동부,070001, 65세,2017,11025,5238,5787,90.5,10964,5212,5752,90.6
32003, 동부,070002, 66세,2017,6452,3016,3436,87.8,6404,2998,3406,88
32003, 동부,070003, 67세,2017,6990,3205,3785,84.7,6953,3186,3767,84.6
32003, 동부,070004, 68세,2017,7294,3478,3816,91.1,7251,3453,3798,90.9
32003, 동부,070005, 69세,2017,7819,3611,4208,85.8,7795,3597,4198,85.7
32003, 동부,075,70~74세,2017,34407,15408,18999,81.1,34321,15366,18955,81.1
32003, 동부,075001, 70세,2017,7681,3548,4133,85.8,7663,3540,4123,85.9
32003, 동부,075002, 71세,2017,6329,2856,3473,82.2,6309,2844,3465,82.1
32003, 동부,075003, 72세,2017,6912,3101,3811,81.4,6898,3094,3804,81.3
32003, 동부,075004, 73세,2017,6803,2993,3810,78.6,6786,2985,3801,78.5
32003, 동부,075005, 74세,2017,6682,2910,3772,77.1,6665,2903,3762,77.2
32003, 동부,080,75~79세,2017,30753,12671,18082,70.1,30692,12643,18049,70
32003, 동부,080001, 75세,2017,7236,3066,4170,73.5,7220,3057,4163,73.4
32003, 동부,080002, 76세,2017,6425,2698,3727,72.4,6411,2692,3719,72.4
32003, 동부,080003, 77세,2017,6034,2417,3617,66.8,6026,2412,3614,66.7
32003, 동부,080004, 78세,2017,5694,2312,3382,68.4,5684,2308,3376,68.4
32003, 동부,080005, 79세,2017,5364,2178,3186,68.4,5351,2174,3177,68.4
32003, 동부,085,80~84세,2017,18138,6533,11605,56.3,18099,6514,11585,56.2
32003, 동부,085001, 80세,2017,4499,1811,2688,67.4,4487,1804,2683,67.2
32003, 동부,085002, 81세,2017,4169,1565,2604,60.1,4167,1564,2603,60.1
32003, 동부,085003, 82세,2017,3717,1275,2442,52.2,3712,1273,2439,52.2
32003, 동부,085004, 83세,2017,3107,1047,2060,50.8,3094,1041,2053,50.7
32003, 동부,085005, 84세,2017,2646,835,1811,46.1,2639,832,1807,46
32003, 동부,090,85~89세,2017,8469,2244,6225,36,8464,2244,6220,36.1
32003, 동부,090001, 85세,2017,2175,625,1550,40.3,2172,625,1547,40.4
32003, 동부,090002, 86세,2017,1809,508,1301,39,1809,508,1301,39
32003, 동부,090003, 87세,2017,1776,473,1303,36.3,1775,473,1302,36.3
32003, 동부,090004, 88세,2017,1528,366,1162,31.5,1527,366,1161,31.5
32003, 동부,090005, 89세,2017,1181,272,909,29.9,1181,272,909,29.9
32003, 동부,095,90~94세,2017,2938,721,2217,32.5,2935,719,2216,32.4
32003, 동부,095001, 90세,2017,946,244,702,34.8,944,242,702,34.5
32003, 동부,095002, 91세,2017,681,151,530,28.5,680,151,529,28.5
32003, 동부,095003, 92세,2017,554,124,430,28.8,554,124,430,28.8
32003, 동부,095004, 93세,2017,392,92,300,30.7,392,92,300,30.7
32003, 동부,095005, 94세,2017,365,110,255,43.1,365,110,255,43.1
32003, 동부,100,95~99세,2017,653,152,501,30.3,648,151,497,30.4
32003, 동부,100001, 95세,2017,258,66,192,34.4,255,65,190,34.2
32003, 동부,100002, 96세,2017,170,40,130,30.8,170,40,130,30.8
32003, 동부,100003, 97세,2017,101,25,76,32.9,99,25,74,33.8
32003, 동부,100004, 98세,2017,77,15,62,24.2,77,15,62,24.2
32003, 동부,100005, 99세,2017,47,6,41,14.6,47,6,41,14.6
32003, 동부,101,100세이상,2017,82,13,69,18.8,82,13,69,18.8
32003, 동부,102,15세미만,2017,122003,62763,59240,105.9,121801,62664,59137,106
32003, 동부,103,15~64세,2017,666082,340591,325491,104.6,656340,335716,320624,104.7
32003, 동부,104,65세이상,2017,135020,56290,78730,71.5,134608,56096,78512,71.4
32003, 동부,086,85세이상,2017,12142,3130,9012,34.7,12129,3127,9002,34.7
32003, 동부,126,평균연령,2017,41.7,40.3,43.1,,41.7,40.3,43.2,
32003, 동부,127,중위연령,2017,43.2,41.6,44.5,,43.3,41.8,44.6,
32010, 춘천시,000,합계,2017,283742,139217,144525,96.3,279284,137017,142267,96.3
32010, 춘천시,005,0~4세,2017,10626,5426,5200,104.3,10576,5398,5178,104.2
32010, 춘천시,005001, 0세,2017,1759,902,857,105.3,1748,895,853,104.9
32010, 춘천시,005002, 1세,2017,2092,1077,1015,106.1,2078,1069,1009,105.9
32010, 춘천시,005003, 2세,2017,2160,1088,1072,101.5,2152,1087,1065,102.1
32010, 춘천시,005004, 3세,2017,2251,1150,1101,104.5,2248,1148,1100,104.4
32010, 춘천시,005005, 4세,2017,2364,1209,1155,104.7,2350,1199,1151,104.2
32010, 춘천시,010,5~9세,2017,12454,6440,6014,107.1,12422,6425,5997,107.1
32010, 춘천시,010001, 5세,2017,2537,1328,1209,109.8,2528,1322,1206,109.6
32010, 춘천시,010002, 6세,2017,2642,1372,1270,108,2631,1365,1266,107.8
32010, 춘천시,010003, 7세,2017,2438,1242,1196,103.8,2433,1241,1192,104.1
32010, 춘천시,010004, 8세,2017,2322,1223,1099,111.3,2318,1222,1096,111.5
32010, 춘천시,010005, 9세,2017,2515,1275,1240,102.8,2512,1275,1237,103.1
32010, 춘천시,015,10~14세,2017,12748,6621,6127,108.1,12727,6613,6114,108.2
32010, 춘천시,015001, 10세,2017,2542,1309,1233,106.2,2538,1308,1230,106.3
32010, 춘천시,015002, 11세,2017,2385,1221,1164,104.9,2380,1220,1160,105.2
32010, 춘천시,015003, 12세,2017,2446,1298,1148,113.1,2442,1296,1146,113.1
32010, 춘천시,015004, 13세,2017,2620,1374,1246,110.3,2614,1371,1243,110.3
32010, 춘천시,015005, 14세,2017,2755,1419,1336,106.2,2753,1418,1335,106.2
32010, 춘천시,020,15~19세,2017,19420,10042,9378,107.1,19134,9880,9254,106.8
32010, 춘천시,020001, 15세,2017,2870,1534,1336,114.8,2865,1529,1336,114.4
32010, 춘천시,020002, 16세,2017,3458,1813,1645,110.2,3454,1809,1645,110
32010, 춘천시,020003, 17세,2017,3642,1973,1669,118.2,3624,1963,1661,118.2
32010, 춘천시,020004, 18세,2017,4095,2079,2016,103.1,4046,2051,1995,102.8
32010, 춘천시,020005, 19세,2017,5355,2643,2712,97.5,5145,2528,2617,96.6
32010, 춘천시,025,20~24세,2017,23594,11844,11750,100.8,22406,11263,11143,101.1
32010, 춘천시,025001, 20세,2017,4991,2269,2722,83.4,4725,2150,2575,83.5
32010, 춘천시,025002, 21세,2017,4988,2261,2727,82.9,4701,2126,2575,82.6
32010, 춘천시,025003, 22세,2017,4872,2488,2384,104.4,4659,2385,2274,104.9
32010, 춘천시,025004, 23세,2017,4468,2451,2017,121.5,4253,2333,1920,121.5
32010, 춘천시,025005, 24세,2017,4275,2375,1900,125,4068,2269,1799,126.1
32010, 춘천시,030,25~29세,2017,17622,9348,8274,113,16788,8950,7838,114.2
32010, 춘천시,030001, 25세,2017,4164,2299,1865,123.3,3970,2209,1761,125.4
32010, 춘천시,030002, 26세,2017,3627,1932,1695,114,3465,1857,1608,115.5
32010, 춘천시,030003, 27세,2017,3444,1824,1620,112.6,3274,1747,1527,114.4
32010, 춘천시,030004, 28세,2017,3184,1652,1532,107.8,3038,1575,1463,107.7
32010, 춘천시,030005, 29세,2017,3203,1641,1562,105.1,3041,1562,1479,105.6
32010, 춘천시,035,30~34세,2017,16316,8393,7923,105.9,15785,8132,7653,106.3
32010, 춘천시,035001, 30세,2017,3042,1536,1506,102,2928,1477,1451,101.8
32010, 춘천시,035002, 31세,2017,3178,1639,1539,106.5,3055,1584,1471,107.7
32010, 춘천시,035003, 32세,2017,3197,1656,1541,107.5,3080,1597,1483,107.7
32010, 춘천시,035004, 33세,2017,3253,1696,1557,108.9,3157,1646,1511,108.9
32010, 춘천시,035005, 34세,2017,3646,1866,1780,104.8,3565,1828,1737,105.2
32010, 춘천시,040,35~39세,2017,19491,9657,9834,98.2,19149,9482,9667,98.1
32010, 춘천시,040001, 35세,2017,3978,1954,2024,96.5,3886,1911,1975,96.8
32010, 춘천시,040002, 36세,2017,3910,1935,1975,98,3849,1903,1946,97.8
32010, 춘천시,040003, 37세,2017,4066,2012,2054,98,3989,1972,2017,97.8
32010, 춘천시,040004, 38세,2017,3854,1905,1949,97.7,3799,1878,1921,97.8
32010, 춘천시,040005, 39세,2017,3683,1851,1832,101,3626,1818,1808,100.6
32010, 춘천시,045,40~44세,2017,20155,9809,10346,94.8,19902,9672,10230,94.5
32010, 춘천시,045001, 40세,2017,3648,1796,1852,97,3593,1766,1827,96.7
32010, 춘천시,045002, 41세,2017,3661,1770,1891,93.6,3616,1746,1870,93.4
32010, 춘천시,045003, 42세,2017,3962,1883,2079,90.6,3902,1853,2049,90.4
32010, 춘천시,045004, 43세,2017,4379,2149,2230,96.4,4338,2123,2215,95.8
32010, 춘천시,045005, 44세,2017,4505,2211,2294,96.4,4453,2184,2269,96.3
32010, 춘천시,050,45~49세,2017,23908,12024,11884,101.2,23640,11883,11757,101.1
32010, 춘천시,050001, 45세,2017,4552,2306,2246,102.7,4504,2279,2225,102.4
32010, 춘천시,050002, 46세,2017,4915,2463,2452,100.4,4866,2440,2426,100.6
32010, 춘천시,050003, 47세,2017,4641,2371,2270,104.4,4580,2339,2241,104.4
32010, 춘천시,050004, 48세,2017,4876,2427,2449,99.1,4821,2398,2423,99
32010, 춘천시,050005, 49세,2017,4924,2457,2467,99.6,4869,2427,2442,99.4
32010, 춘천시,055,50~54세,2017,21963,11092,10871,102,21722,10983,10739,102.3
32010, 춘천시,055001, 50세,2017,4525,2308,2217,104.1,4480,2287,2193,104.3
32010, 춘천시,055002, 51세,2017,4445,2257,2188,103.2,4391,2229,2162,103.1
32010, 춘천시,055003, 52세,2017,4079,2045,2034,100.5,4027,2028,1999,101.5
32010, 춘천시,055004, 53세,2017,4405,2237,2168,103.2,4369,2222,2147,103.5
32010, 춘천시,055005, 54세,2017,4509,2245,2264,99.2,4455,2217,2238,99.1
32010, 춘천시,060,55~59세,2017,23612,11430,12182,93.8,23456,11365,12091,94
32010, 춘천시,060001, 55세,2017,4666,2279,2387,95.5,4632,2270,2362,96.1
32010, 춘천시,060002, 56세,2017,5350,2632,2718,96.8,5321,2616,2705,96.7
32010, 춘천시,060003, 57세,2017,4678,2190,2488,88,4641,2172,2469,88
32010, 춘천시,060004, 58세,2017,4430,2137,2293,93.2,4400,2126,2274,93.5
32010, 춘천시,060005, 59세,2017,4488,2192,2296,95.5,4462,2181,2281,95.6
32010, 춘천시,065,60~64세,2017,18599,9134,9465,96.5,18463,9069,9394,96.5
32010, 춘천시,065001, 60세,2017,4366,2122,2244,94.6,4334,2110,2224,94.9
32010, 춘천시,065002, 61세,2017,3999,1962,2037,96.3,3971,1944,2027,95.9
32010, 춘천시,065003, 62세,2017,3994,1962,2032,96.6,3962,1948,2014,96.7
32010, 춘천시,065004, 63세,2017,3385,1718,1667,103.1,3355,1703,1652,103.1
32010, 춘천시,065005, 64세,2017,2855,1370,1485,92.3,2841,1364,1477,92.3
32010, 춘천시,070,65~69세,2017,11337,5238,6099,85.9,11279,5212,6067,85.9
32010, 춘천시,070001, 65세,2017,3370,1620,1750,92.6,3353,1614,1739,92.8
32010, 춘천시,070002, 66세,2017,1805,841,964,87.2,1790,836,954,87.6
32010, 춘천시,070003, 67세,2017,1866,828,1038,79.8,1855,822,1033,79.6
32010, 춘천시,070004, 68세,2017,2030,938,1092,85.9,2020,933,1087,85.8
32010, 춘천시,070005, 69세,2017,2266,1011,1255,80.6,2261,1007,1254,80.3
32010, 춘천시,075,70~74세,2017,10854,4896,5958,82.2,10820,4879,5941,82.1
32010, 춘천시,075001, 70세,2017,2439,1150,1289,89.2,2430,1146,1284,89.3
32010, 춘천시,075002, 71세,2017,2113,951,1162,81.8,2108,948,1160,81.7
32010, 춘천시,075003, 72세,2017,2150,990,1160,85.3,2144,987,1157,85.3
32010, 춘천시,075004, 73세,2017,2041,893,1148,77.8,2037,892,1145,77.9
32010, 춘천시,075005, 74세,2017,2111,912,1199,76.1,2101,906,1195,75.8
32010, 춘천시,080,75~79세,2017,10366,4304,6062,71,10349,4298,6051,71
32010, 춘천시,080001, 75세,2017,2439,1071,1368,78.3,2434,1068,1366,78.2
32010, 춘천시,080002, 76세,2017,2192,902,1290,69.9,2189,901,1288,70
32010, 춘천시,080003, 77세,2017,2011,826,1185,69.7,2010,826,1184,69.8
32010, 춘천시,080004, 78세,2017,1898,770,1128,68.3,1894,768,1126,68.2
32010, 춘천시,080005, 79세,2017,1826,735,1091,67.4,1822,735,1087,67.6
32010, 춘천시,085,80~84세,2017,6276,2288,3988,57.4,6270,2285,3985,57.3
32010, 춘천시,085001, 80세,2017,1573,641,932,68.8,1572,641,931,68.9
32010, 춘천시,085002, 81세,2017,1477,558,919,60.7,1476,557,919,60.6
32010, 춘천시,085003, 82세,2017,1295,456,839,54.4,1294,456,838,54.4
32010, 춘천시,085004, 83세,2017,1029,352,677,52,1028,351,677,51.8
32010, 춘천시,085005, 84세,2017,902,281,621,45.2,900,280,620,45.2
32010, 춘천시,090,85~89세,2017,2978,858,2120,40.5,2976,857,2119,40.4
32010, 춘천시,090001, 85세,2017,771,234,537,43.6,770,234,536,43.7
32010, 춘천시,090002, 86세,2017,630,196,434,45.2,630,196,434,45.2
32010, 춘천시,090003, 87세,2017,626,188,438,42.9,625,187,438,42.7
32010, 춘천시,090004, 88세,2017,546,153,393,38.9,546,153,393,38.9
32010, 춘천시,090005, 89세,2017,405,87,318,27.4,405,87,318,27.4
32010, 춘천시,095,90~94세,2017,1118,292,826,35.4,1117,291,826,35.2
32010, 춘천시,095001, 90세,2017,372,89,283,31.4,371,88,283,31.1
32010, 춘천시,095002, 91세,2017,251,55,196,28.1,251,55,196,28.1
32010, 춘천시,095003, 92세,2017,219,56,163,34.4,219,56,163,34.4
32010, 춘천시,095004, 93세,2017,137,42,95,44.2,137,42,95,44.2
32010, 춘천시,095005, 94세,2017,139,50,89,56.2,139,50,89,56.2
32010, 춘천시,100,95~99세,2017,271,76,195,39,269,75,194,38.7
32010, 춘천시,100001, 95세,2017,107,38,69,55.1,106,38,68,55.9
32010, 춘천시,100002, 96세,2017,75,19,56,33.9,75,19,56,33.9
32010, 춘천시,100003, 97세,2017,43,9,34,26.5,43,9,34,26.5
32010, 춘천시,100004, 98세,2017,31,7,24,29.2,30,6,24,25
32010, 춘천시,100005, 99세,2017,15,X,12,25,15,X,12,25
32010, 춘천시,101,100세이상,2017,34,5,29,17.2,34,5,29,17.2
32010, 춘천시,102,15세미만,2017,35828,18487,17341,106.6,35725,18436,17289,106.6
32010, 춘천시,103,15~64세,2017,204680,102773,101907,100.8,200445,100679,99766,100.9
32010, 춘천시,104,65세이상,2017,43234,17957,25277,71,43114,17902,25212,71
32010, 춘천시,086,85세이상,2017,4401,1231,3170,38.8,4396,1228,3168,38.8
32010, 춘천시,126,평균연령,2017,41.7,40.3,42.9,,41.8,40.5,43.1,
32010, 춘천시,127,중위연령,2017,42.6,41,43.9,,42.9,41.3,44.1,
32020, 원주시,000,합계,2017,341338,170450,170888,99.7,337244,168226,169018,99.5
32020, 원주시,005,0~4세,2017,13390,6814,6576,103.6,13365,6802,6563,103.6
32020, 원주시,005001, 0세,2017,2371,1231,1140,108,2365,1229,1136,108.2
32020, 원주시,005002, 1세,2017,2560,1326,1234,107.5,2554,1322,1232,107.3
32020, 원주시,005003, 2세,2017,2813,1419,1394,101.8,2806,1415,1391,101.7
32020, 원주시,005004, 3세,2017,2802,1413,1389,101.7,2799,1413,1386,101.9
32020, 원주시,005005, 4세,2017,2844,1425,1419,100.4,2841,1423,1418,100.4
32020, 원주시,010,5~9세,2017,16284,8334,7950,104.8,16263,8329,7934,105
32020, 원주시,010001, 5세,2017,3315,1683,1632,103.1,3310,1681,1629,103.2
32020, 원주시,010002, 6세,2017,3237,1641,1596,102.8,3231,1639,1592,103
32020, 원주시,010003, 7세,2017,3270,1637,1633,100.2,3267,1636,1631,100.3
32020, 원주시,010004, 8세,2017,3215,1685,1530,110.1,3210,1685,1525,110.5
32020, 원주시,010005, 9세,2017,3247,1688,1559,108.3,3245,1688,1557,108.4
32020, 원주시,015,10~14세,2017,17004,8828,8176,108,16990,8822,8168,108
32020, 원주시,015001, 10세,2017,3564,1832,1732,105.8,3562,1832,1730,105.9
32020, 원주시,015002, 11세,2017,3165,1646,1519,108.4,3162,1646,1516,108.6
32020, 원주시,015003, 12세,2017,3259,1686,1573,107.2,3255,1684,1571,107.2
32020, 원주시,015004, 13세,2017,3526,1842,1684,109.4,3523,1839,1684,109.2
32020, 원주시,015005, 14세,2017,3490,1822,1668,109.2,3488,1821,1667,109.2
32020, 원주시,020,15~19세,2017,22468,11862,10606,111.8,22368,11819,10549,112
32020, 원주시,020001, 15세,2017,3688,1877,1811,103.6,3684,1876,1808,103.8
32020, 원주시,020002, 16세,2017,4147,2266,1881,120.5,4144,2264,1880,120.4
32020, 원주시,020003, 17세,2017,4381,2347,2034,115.4,4369,2337,2032,115
32020, 원주시,020004, 18세,2017,4715,2469,2246,109.9,4696,2461,2235,110.1
32020, 원주시,020005, 19세,2017,5537,2903,2634,110.2,5475,2881,2594,111.1
32020, 원주시,025,20~24세,2017,26111,13991,12120,115.4,25555,13681,11874,115.2
32020, 원주시,025001, 20세,2017,5479,2816,2663,105.7,5389,2772,2617,105.9
32020, 원주시,025002, 21세,2017,5352,2778,2574,107.9,5242,2722,2520,108
32020, 원주시,025003, 22세,2017,5190,2752,2438,112.9,5084,2694,2390,112.7
32020, 원주시,025004, 23세,2017,5125,2836,2289,123.9,5009,2757,2252,122.4
32020, 원주시,025005, 24세,2017,4965,2809,2156,130.3,4831,2736,2095,130.6
32020, 원주시,030,25~29세,2017,20474,10930,9544,114.5,19756,10516,9240,113.8
32020, 원주시,030001, 25세,2017,4748,2600,2148,121,4603,2517,2086,120.7
32020, 원주시,030002, 26세,2017,4311,2301,2010,114.5,4180,2228,1952,114.1
32020, 원주시,030003, 27세,2017,3918,2061,1857,111,3779,1980,1799,110.1
32020, 원주시,030004, 28세,2017,3774,2043,1731,118,3618,1948,1670,116.6
32020, 원주시,030005, 29세,2017,3723,1925,1798,107.1,3576,1843,1733,106.3
32020, 원주시,035,30~34세,2017,20401,10617,9784,108.5,19776,10248,9528,107.6
32020, 원주시,035001, 30세,2017,3640,1890,1750,108,3517,1815,1702,106.6
32020, 원주시,035002, 31세,2017,3980,2083,1897,109.8,3843,2009,1834,109.5
32020, 원주시,035003, 32세,2017,3973,2101,1872,112.2,3838,2017,1821,110.8
32020, 원주시,035004, 33세,2017,4101,2119,1982,106.9,3982,2051,1931,106.2
32020, 원주시,035005, 34세,2017,4707,2424,2283,106.2,4596,2356,2240,105.2
32020, 원주시,040,35~39세,2017,25109,12514,12595,99.4,24614,12203,12411,98.3
32020, 원주시,040001, 35세,2017,5037,2518,2519,100,4938,2455,2483,98.9
32020, 원주시,040002, 36세,2017,5116,2608,2508,104,5005,2536,2469,102.7
32020, 원주시,040003, 37세,2017,5121,2511,2610,96.2,5032,2454,2578,95.2
32020, 원주시,040004, 38세,2017,4999,2502,2497,100.2,4896,2443,2453,99.6
32020, 원주시,040005, 39세,2017,4836,2375,2461,96.5,4743,2315,2428,95.3
32020, 원주시,045,40~44세,2017,27247,13376,13871,96.4,26878,13174,13704,96.1
32020, 원주시,045001, 40세,2017,5049,2494,2555,97.6,4956,2442,2514,97.1
32020, 원주시,045002, 41세,2017,4983,2425,2558,94.8,4914,2381,2533,94
32020, 원주시,045003, 42세,2017,5285,2637,2648,99.6,5198,2596,2602,99.8
32020, 원주시,045004, 43세,2017,5925,2844,3081,92.3,5872,2815,3057,92.1
32020, 원주시,045005, 44세,2017,6005,2976,3029,98.3,5938,2940,2998,98.1
32020, 원주시,050,45~49세,2017,30640,15465,15175,101.9,30301,15307,14994,102.1
32020, 원주시,050001, 45세,2017,5792,2954,2838,104.1,5731,2930,2801,104.6
32020, 원주시,050002, 46세,2017,6219,3123,3096,100.9,6151,3084,3067,100.6
32020, 원주시,050003, 47세,2017,6094,3044,3050,99.8,6013,3005,3008,99.9
32020, 원주시,050004, 48세,2017,6300,3175,3125,101.6,6237,3147,3090,101.8
32020, 원주시,050005, 49세,2017,6235,3169,3066,103.4,6169,3141,3028,103.7
32020, 원주시,055,50~54세,2017,27862,14063,13799,101.9,27588,13938,13650,102.1
32020, 원주시,055001, 50세,2017,5631,2771,2860,96.9,5586,2753,2833,97.2
32020, 원주시,055002, 51세,2017,5763,2959,2804,105.5,5710,2935,2775,105.8
32020, 원주시,055003, 52세,2017,5698,2818,2880,97.8,5640,2784,2856,97.5
32020, 원주시,055004, 53세,2017,5191,2645,2546,103.9,5127,2618,2509,104.3
32020, 원주시,055005, 54세,2017,5579,2870,2709,105.9,5525,2848,2677,106.4
32020, 원주시,060,55~59세,2017,29252,14658,14594,100.4,29026,14547,14479,100.5
32020, 원주시,060001, 55세,2017,5917,2985,2932,101.8,5868,2962,2906,101.9
32020, 원주시,060002, 56세,2017,6297,3192,3105,102.8,6246,3170,3076,103.1
32020, 원주시,060003, 57세,2017,6279,3113,3166,98.3,6240,3090,3150,98.1
32020, 원주시,060004, 58세,2017,5583,2770,2813,98.5,5532,2742,2790,98.3
32020, 원주시,060005, 59세,2017,5176,2598,2578,100.8,5140,2583,2557,101
32020, 원주시,065,60~64세,2017,20445,10419,10026,103.9,20276,10335,9941,104
32020, 원주시,065001, 60세,2017,5051,2595,2456,105.7,5009,2577,2432,106
32020, 원주시,065002, 61세,2017,4554,2330,2224,104.8,4520,2312,2208,104.7
32020, 원주시,065003, 62세,2017,4236,2144,2092,102.5,4200,2119,2081,101.8
32020, 원주시,065004, 63세,2017,3702,1902,1800,105.7,3674,1889,1785,105.8
32020, 원주시,065005, 64세,2017,2902,1448,1454,99.6,2873,1438,1435,100.2
32020, 원주시,070,65~69세,2017,12766,6105,6661,91.7,12670,6056,6614,91.6
32020, 원주시,070001, 65세,2017,4046,1979,2067,95.7,4019,1964,2055,95.6
32020, 원주시,070002, 66세,2017,2098,987,1111,88.8,2072,974,1098,88.7
32020, 원주시,070003, 67세,2017,2124,998,1126,88.6,2108,992,1116,88.9
32020, 원주시,070004, 68세,2017,2151,1016,1135,89.5,2135,1007,1128,89.3
32020, 원주시,070005, 69세,2017,2347,1125,1222,92.1,2336,1119,1217,91.9
32020, 원주시,075,70~74세,2017,10694,4811,5883,81.8,10671,4799,5872,81.7
32020, 원주시,075001, 70세,2017,2436,1143,1293,88.4,2433,1142,1291,88.5
32020, 원주시,075002, 71세,2017,1996,901,1095,82.3,1988,896,1092,82.1
32020, 원주시,075003, 72세,2017,2053,950,1103,86.1,2049,947,1102,85.9
32020, 원주시,075004, 73세,2017,2076,920,1156,79.6,2072,919,1153,79.7
32020, 원주시,075005, 74세,2017,2133,897,1236,72.6,2129,895,1234,72.5
32020, 원주시,080,75~79세,2017,10464,4234,6230,68,10442,4228,6214,68
32020, 원주시,080001, 75세,2017,2402,987,1415,69.8,2397,985,1412,69.8
32020, 원주시,080002, 76세,2017,2196,930,1266,73.5,2191,929,1262,73.6
32020, 원주시,080003, 77세,2017,1989,765,1224,62.5,1987,764,1223,62.5
32020, 원주시,080004, 78세,2017,2026,809,1217,66.5,2023,809,1214,66.6
32020, 원주시,080005, 79세,2017,1851,743,1108,67.1,1844,741,1103,67.2
32020, 원주시,085,80~84세,2017,6385,2286,4099,55.8,6372,2280,4092,55.7
32020, 원주시,085001, 80세,2017,1598,653,945,69.1,1593,650,943,68.9
32020, 원주시,085002, 81세,2017,1435,557,878,63.4,1435,557,878,63.4
32020, 원주시,085003, 82세,2017,1297,422,875,48.2,1293,421,872,48.3
32020, 원주시,085004, 83세,2017,1086,333,753,44.2,1082,331,751,44.1
32020, 원주시,085005, 84세,2017,969,321,648,49.5,969,321,648,49.5
32020, 원주시,090,85~89세,2017,3073,809,2264,35.7,3068,809,2259,35.8
32020, 원주시,090001, 85세,2017,825,233,592,39.4,822,233,589,39.6
32020, 원주시,090002, 86세,2017,667,186,481,38.7,667,186,481,38.7
32020, 원주시,090003, 87세,2017,630,166,464,35.8,629,166,463,35.9
32020, 원주시,090004, 88세,2017,517,120,397,30.2,516,120,396,30.3
32020, 원주시,090005, 89세,2017,434,104,330,31.5,434,104,330,31.5
32020, 원주시,095,90~94세,2017,1020,289,731,39.5,1018,288,730,39.5
32020, 원주시,095001, 90세,2017,315,82,233,35.2,313,81,232,34.9
32020, 원주시,095002, 91세,2017,244,58,186,31.2,244,58,186,31.2
32020, 원주시,095003, 92세,2017,193,69,124,55.6,193,69,124,55.6
32020, 원주시,095004, 93세,2017,154,46,108,42.6,154,46,108,42.6
32020, 원주시,095005, 94세,2017,114,34,80,42.5,114,34,80,42.5
32020, 원주시,100,95~99세,2017,215,37,178,20.8,213,37,176,21
32020, 원주시,100001, 95세,2017,88,19,69,27.5,86,19,67,28.4
32020, 원주시,100002, 96세,2017,40,X,37,8.1,40,X,37,8.1
32020, 원주시,100003, 97세,2017,41,12,29,41.4,41,12,29,41.4
32020, 원주시,100004, 98세,2017,30,X,27,11.1,30,X,27,11.1
32020, 원주시,100005, 99세,2017,16,X,16,0,16,X,16,0
32020, 원주시,101,100세이상,2017,34,8,26,30.8,34,8,26,30.8
32020, 원주시,102,15세미만,2017,46678,23976,22702,105.6,46618,23953,22665,105.7
32020, 원주시,103,15~64세,2017,250009,127895,122114,104.7,246138,125768,120370,104.5
32020, 원주시,104,65세이상,2017,44651,18579,26072,71.3,44488,18505,25983,71.2
32020, 원주시,086,85세이상,2017,4342,1143,3199,35.7,4333,1142,3191,35.8
32020, 원주시,126,평균연령,2017,40.7,39.5,41.9,,40.8,39.6,42,
32020, 원주시,127,중위연령,2017,41.9,40.5,43.1,,42,40.7,43.2,
32030, 강릉시,000,합계,2017,215914,108572,107342,101.1,213552,107358,106194,101.1
32030, 강릉시,005,0~4세,2017,6565,3384,3181,106.4,6551,3377,3174,106.4
32030, 강릉시,005001, 0세,2017,1103,565,538,105,1103,565,538,105
32030, 강릉시,005002, 1세,2017,1292,674,618,109.1,1290,674,616,109.4
32030, 강릉시,005003, 2세,2017,1398,694,704,98.6,1393,690,703,98.2
32030, 강릉시,005004, 3세,2017,1363,694,669,103.7,1359,693,666,104.1
32030, 강릉시,005005, 4세,2017,1409,757,652,116.1,1406,755,651,116
32030, 강릉시,010,5~9세,2017,8287,4260,4027,105.8,8274,4252,4022,105.7
32030, 강릉시,010001, 5세,2017,1652,849,803,105.7,1650,847,803,105.5
32030, 강릉시,010002, 6세,2017,1672,871,801,108.7,1668,870,798,109
32030, 강릉시,010003, 7세,2017,1637,869,768,113.2,1635,867,768,112.9
32030, 강릉시,010004, 8세,2017,1663,819,844,97,1661,817,844,96.8
32030, 강릉시,010005, 9세,2017,1663,852,811,105.1,1660,851,809,105.2
32030, 강릉시,015,10~14세,2017,9183,4873,4310,113.1,9172,4866,4306,113
32030, 강릉시,015001, 10세,2017,1798,990,808,122.5,1795,988,807,122.4
32030, 강릉시,015002, 11세,2017,1686,938,748,125.4,1683,937,746,125.6
32030, 강릉시,015003, 12세,2017,1737,896,841,106.5,1735,894,841,106.3
32030, 강릉시,015004, 13세,2017,1962,1012,950,106.5,1960,1011,949,106.5
32030, 강릉시,015005, 14세,2017,2000,1037,963,107.7,1999,1036,963,107.6
32030, 강릉시,020,15~19세,2017,14296,7658,6638,115.4,14224,7626,6598,115.6
32030, 강릉시,020001, 15세,2017,2114,1140,974,117,2114,1140,974,117
32030, 강릉시,020002, 16세,2017,2393,1255,1138,110.3,2391,1253,1138,110.1
32030, 강릉시,020003, 17세,2017,2688,1371,1317,104.1,2683,1369,1314,104.2
32030, 강릉시,020004, 18세,2017,2950,1553,1397,111.2,2943,1550,1393,111.3
32030, 강릉시,020005, 19세,2017,4151,2339,1812,129.1,4093,2314,1779,130.1
32030, 강릉시,025,20~24세,2017,18164,10514,7650,137.4,17687,10303,7384,139.5
32030, 강릉시,025001, 20세,2017,3876,2056,1820,113,3792,2026,1766,114.7
32030, 강릉시,025002, 21세,2017,3531,1853,1678,110.4,3443,1817,1626,111.7
32030, 강릉시,025003, 22세,2017,3610,2024,1586,127.6,3506,1969,1537,128.1
32030, 강릉시,025004, 23세,2017,3699,2341,1358,172.4,3586,2288,1298,176.3
32030, 강릉시,025005, 24세,2017,3448,2240,1208,185.4,3360,2203,1157,190.4
32030, 강릉시,030,25~29세,2017,11465,6698,4767,140.5,11085,6483,4602,140.9
32030, 강릉시,030001, 25세,2017,3002,1884,1118,168.5,2911,1836,1075,170.8
32030, 강릉시,030002, 26세,2017,2405,1404,1001,140.3,2323,1358,965,140.7
32030, 강릉시,030003, 27세,2017,2080,1192,888,134.2,2010,1152,858,134.3
32030, 강릉시,030004, 28세,2017,2055,1146,909,126.1,1988,1107,881,125.7
32030, 강릉시,030005, 29세,2017,1923,1072,851,126,1853,1030,823,125.2
32030, 강릉시,035,30~34세,2017,10041,5331,4710,113.2,9724,5153,4571,112.7
32030, 강릉시,035001, 30세,2017,1891,1038,853,121.7,1810,994,816,121.8
32030, 강릉시,035002, 31세,2017,1907,1034,873,118.4,1846,1000,846,118.2
32030, 강릉시,035003, 32세,2017,1915,1009,906,111.4,1860,980,880,111.4
32030, 강릉시,035004, 33세,2017,2055,1103,952,115.9,1988,1059,929,114
32030, 강릉시,035005, 34세,2017,2273,1147,1126,101.9,2220,1120,1100,101.8
32030, 강릉시,040,35~39세,2017,13360,6721,6639,101.2,13117,6586,6531,100.8
32030, 강릉시,040001, 35세,2017,2519,1248,1271,98.2,2474,1220,1254,97.3
32030, 강릉시,040002, 36세,2017,2654,1385,1269,109.1,2605,1359,1246,109.1
32030, 강릉시,040003, 37세,2017,2796,1384,1412,98,2738,1354,1384,97.8
32030, 강릉시,040004, 38세,2017,2774,1399,1375,101.7,2725,1375,1350,101.9
32030, 강릉시,040005, 39세,2017,2617,1305,1312,99.5,2575,1278,1297,98.5
32030, 강릉시,045,40~44세,2017,15730,8012,7718,103.8,15549,7911,7638,103.6
32030, 강릉시,045001, 40세,2017,2767,1428,1339,106.6,2744,1417,1327,106.8
32030, 강릉시,045002, 41세,2017,2814,1403,1411,99.4,2783,1388,1395,99.5
32030, 강릉시,045003, 42세,2017,3080,1557,1523,102.2,3035,1528,1507,101.4
32030, 강릉시,045004, 43세,2017,3448,1768,1680,105.2,3407,1743,1664,104.7
32030, 강릉시,045005, 44세,2017,3621,1856,1765,105.2,3580,1835,1745,105.2
32030, 강릉시,050,45~49세,2017,17788,9162,8626,106.2,17609,9068,8541,106.2
32030, 강릉시,050001, 45세,2017,3271,1755,1516,115.8,3240,1740,1500,116
32030, 강릉시,050002, 46세,2017,3605,1852,1753,105.6,3573,1834,1739,105.5
32030, 강릉시,050003, 47세,2017,3669,1903,1766,107.8,3625,1878,1747,107.5
32030, 강릉시,050004, 48세,2017,3574,1827,1747,104.6,3536,1810,1726,104.9
32030, 강릉시,050005, 49세,2017,3669,1825,1844,99,3635,1806,1829,98.7
32030, 강릉시,055,50~54세,2017,16720,8427,8293,101.6,16562,8360,8202,101.9
32030, 강릉시,055001, 50세,2017,3378,1712,1666,102.8,3343,1694,1649,102.7
32030, 강릉시,055002, 51세,2017,3414,1782,1632,109.2,3378,1767,1611,109.7
32030, 강릉시,055003, 52세,2017,3101,1494,1607,93,3071,1482,1589,93.3
32030, 강릉시,055004, 53세,2017,3224,1659,1565,106,3201,1649,1552,106.3
32030, 강릉시,055005, 54세,2017,3603,1780,1823,97.6,3569,1768,1801,98.2
32030, 강릉시,060,55~59세,2017,19561,9522,10039,94.9,19436,9455,9981,94.7
32030, 강릉시,060001, 55세,2017,3734,1886,1848,102.1,3709,1871,1838,101.8
32030, 강릉시,060002, 56세,2017,4052,1899,2153,88.2,4027,1886,2141,88.1
32030, 강릉시,060003, 57세,2017,4119,2002,2117,94.6,4093,1989,2104,94.5
32030, 강릉시,060004, 58세,2017,3954,1907,2047,93.2,3926,1894,2032,93.2
32030, 강릉시,060005, 59세,2017,3702,1828,1874,97.5,3681,1815,1866,97.3
32030, 강릉시,065,60~64세,2017,15779,7594,8185,92.8,15694,7552,8142,92.8
32030, 강릉시,065001, 60세,2017,3674,1824,1850,98.6,3664,1819,1845,98.6
32030, 강릉시,065002, 61세,2017,3284,1588,1696,93.6,3261,1580,1681,94
32030, 강릉시,065003, 62세,2017,3286,1568,1718,91.3,3269,1560,1709,91.3
32030, 강릉시,065004, 63세,2017,2958,1399,1559,89.7,2943,1389,1554,89.4
32030, 강릉시,065005, 64세,2017,2577,1215,1362,89.2,2557,1204,1353,89
32030, 강릉시,070,65~69세,2017,11317,5368,5949,90.2,11261,5343,5918,90.3
32030, 강릉시,070001, 65세,2017,2951,1422,1529,93,2931,1413,1518,93.1
32030, 강릉시,070002, 66세,2017,1908,893,1015,88,1895,889,1006,88.4
32030, 강릉시,070003, 67세,2017,1974,913,1061,86.1,1964,908,1056,86
32030, 강릉시,070004, 68세,2017,2223,1045,1178,88.7,2214,1040,1174,88.6
32030, 강릉시,070005, 69세,2017,2261,1095,1166,93.9,2257,1093,1164,93.9
32030, 강릉시,075,70~74세,2017,9901,4540,5361,84.7,9884,4533,5351,84.7
32030, 강릉시,075001, 70세,2017,2194,1020,1174,86.9,2192,1020,1172,87
32030, 강릉시,075002, 71세,2017,1780,859,921,93.3,1777,857,920,93.2
32030, 강릉시,075003, 72세,2017,2060,935,1125,83.1,2058,935,1123,83.3
32030, 강릉시,075004, 73세,2017,1995,896,1099,81.5,1988,892,1096,81.4
32030, 강릉시,075005, 74세,2017,1872,830,1042,79.7,1869,829,1040,79.7
32030, 강릉시,080,75~79세,2017,8714,3698,5016,73.7,8693,3686,5007,73.6
32030, 강릉시,080001, 75세,2017,2043,910,1133,80.3,2036,907,1129,80.3
32030, 강릉시,080002, 76세,2017,1749,723,1026,70.5,1746,721,1025,70.3
32030, 강릉시,080003, 77세,2017,1777,754,1023,73.7,1773,750,1023,73.3
32030, 강릉시,080004, 78세,2017,1600,669,931,71.9,1596,667,929,71.8
32030, 강릉시,080005, 79세,2017,1545,642,903,71.1,1542,641,901,71.1
32030, 강릉시,085,80~84세,2017,5259,1891,3368,56.1,5247,1885,3362,56.1
32030, 강릉시,085001, 80세,2017,1296,503,793,63.4,1290,500,790,63.3
32030, 강릉시,085002, 81세,2017,1196,463,733,63.2,1196,463,733,63.2
32030, 강릉시,085003, 82세,2017,1097,380,717,53,1095,379,716,52.9
32030, 강릉시,085004, 83세,2017,918,303,615,49.3,915,302,613,49.3
32030, 강릉시,085005, 84세,2017,752,242,510,47.5,751,241,510,47.3
32030, 강릉시,090,85~89세,2017,2526,668,1858,36,2526,668,1858,36
32030, 강릉시,090001, 85세,2017,630,194,436,44.5,630,194,436,44.5
32030, 강릉시,090002, 86세,2017,541,145,396,36.6,541,145,396,36.6
32030, 강릉시,090003, 87세,2017,519,133,386,34.5,519,133,386,34.5
32030, 강릉시,090004, 88세,2017,481,114,367,31.1,481,114,367,31.1
32030, 강릉시,090005, 89세,2017,355,82,273,30,355,82,273,30
32030, 강릉시,095,90~94세,2017,993,202,791,25.5,993,202,791,25.5
32030, 강릉시,095001, 90세,2017,310,71,239,29.7,310,71,239,29.7
32030, 강릉시,095002, 91세,2017,227,44,183,24,227,44,183,24
32030, 강릉시,095003, 92세,2017,194,36,158,22.8,194,36,158,22.8
32030, 강릉시,095004, 93세,2017,138,24,114,21.1,138,24,114,21.1
32030, 강릉시,095005, 94세,2017,124,27,97,27.8,124,27,97,27.8
32030, 강릉시,100,95~99세,2017,236,46,190,24.2,235,46,189,24.3
32030, 강릉시,100001, 95세,2017,86,16,70,22.9,86,16,70,22.9
32030, 강릉시,100002, 96세,2017,69,17,52,32.7,69,17,52,32.7
32030, 강릉시,100003, 97세,2017,32,5,27,18.5,31,5,26,19.2
32030, 강릉시,100004, 98세,2017,30,5,25,20,30,5,25,20
32030, 강릉시,100005, 99세,2017,19,X,16,18.8,19,X,16,18.8
32030, 강릉시,101,100세이상,2017,29,X,26,11.5,29,X,26,11.5
32030, 강릉시,102,15세미만,2017,24035,12517,11518,108.7,23997,12495,11502,108.6
32030, 강릉시,103,15~64세,2017,152904,79639,73265,108.7,150687,78497,72190,108.7
32030, 강릉시,104,65세이상,2017,38975,16416,22559,72.8,38868,16366,22502,72.7
32030, 강릉시,086,85세이상,2017,3784,919,2865,32.1,3783,919,2864,32.1
32030, 강릉시,126,평균연령,2017,43.7,41.8,45.5,,43.7,41.8,45.6,
32030, 강릉시,127,중위연령,2017,45.3,43.3,47.4,,45.4,43.4,47.6,
32040, 동해시,000,합계,2017,89151,45347,43804,103.5,88263,44827,43436,103.2
32040, 동해시,005,0~4세,2017,3484,1788,1696,105.4,3479,1784,1695,105.3
32040, 동해시,005001, 0세,2017,590,292,298,98,590,292,298,98
32040, 동해시,005002, 1세,2017,708,341,367,92.9,706,339,367,92.4
32040, 동해시,005003, 2세,2017,693,364,329,110.6,693,364,329,110.6
32040, 동해시,005004, 3세,2017,712,394,318,123.9,710,392,318,123.3
32040, 동해시,005005, 4세,2017,781,397,384,103.4,780,397,383,103.7
32040, 동해시,010,5~9세,2017,4142,2157,1985,108.7,4139,2156,1983,108.7
32040, 동해시,010001, 5세,2017,852,447,405,110.4,851,446,405,110.1
32040, 동해시,010002, 6세,2017,861,431,430,100.2,861,431,430,100.2
32040, 동해시,010003, 7세,2017,761,415,346,119.9,761,415,346,119.9
32040, 동해시,010004, 8세,2017,826,422,404,104.5,824,422,402,105
32040, 동해시,010005, 9세,2017,842,442,400,110.5,842,442,400,110.5
32040, 동해시,015,10~14세,2017,4377,2279,2098,108.6,4374,2278,2096,108.7
32040, 동해시,015001, 10세,2017,888,465,423,109.9,887,465,422,110.2
32040, 동해시,015002, 11세,2017,803,398,405,98.3,802,397,405,98
32040, 동해시,015003, 12세,2017,851,440,411,107.1,851,440,411,107.1
32040, 동해시,015004, 13세,2017,925,490,435,112.6,925,490,435,112.6
32040, 동해시,015005, 14세,2017,910,486,424,114.6,909,486,423,114.9
32040, 동해시,020,15~19세,2017,4779,2551,2228,114.5,4771,2549,2222,114.7
32040, 동해시,020001, 15세,2017,963,489,474,103.2,962,488,474,103
32040, 동해시,020002, 16세,2017,1045,531,514,103.3,1044,531,513,103.5
32040, 동해시,020003, 17세,2017,1102,578,524,110.3,1102,578,524,110.3
32040, 동해시,020004, 18세,2017,1013,558,455,122.6,1012,558,454,122.9
32040, 동해시,020005, 19세,2017,656,395,261,151.3,651,394,257,153.3
32040, 동해시,025,20~24세,2017,4765,2985,1780,167.7,4666,2921,1745,167.4
32040, 동해시,025001, 20세,2017,944,675,269,250.9,934,670,264,253.8
32040, 동해시,025002, 21세,2017,991,657,334,196.7,979,650,329,197.6
32040, 동해시,025003, 22세,2017,900,537,363,147.9,884,524,360,145.6
32040, 동해시,025004, 23세,2017,928,544,384,141.7,902,530,372,142.5
32040, 동해시,025005, 24세,2017,1002,572,430,133,967,547,420,130.2
32040, 동해시,030,25~29세,2017,3939,2225,1714,129.8,3757,2110,1647,128.1
32040, 동해시,030001, 25세,2017,840,475,365,130.1,812,455,357,127.5
32040, 동해시,030002, 26세,2017,776,447,329,135.9,737,419,318,131.8
32040, 동해시,030003, 27세,2017,779,443,336,131.8,747,426,321,132.7
32040, 동해시,030004, 28세,2017,790,447,343,130.3,747,420,327,128.4
32040, 동해시,030005, 29세,2017,754,413,341,121.1,714,390,324,120.4
32040, 동해시,035,30~34세,2017,4510,2456,2054,119.6,4354,2357,1997,118
32040, 동해시,035001, 30세,2017,794,435,359,121.2,759,410,349,117.5
32040, 동해시,035002, 31세,2017,801,437,364,120.1,774,423,351,120.5
32040, 동해시,035003, 32세,2017,921,499,422,118.2,879,473,406,116.5
32040, 동해시,035004, 33세,2017,925,511,414,123.4,901,498,403,123.6
32040, 동해시,035005, 34세,2017,1069,574,495,116,1041,553,488,113.3
32040, 동해시,040,35~39세,2017,6331,3216,3115,103.2,6202,3119,3083,101.2
32040, 동해시,040001, 35세,2017,1215,643,572,112.4,1183,621,562,110.5
32040, 동해시,040002, 36세,2017,1281,686,595,115.3,1255,665,590,112.7
32040, 동해시,040003, 37세,2017,1285,632,653,96.8,1251,606,645,94
32040, 동해시,040004, 38세,2017,1258,623,635,98.1,1239,609,630,96.7
32040, 동해시,040005, 39세,2017,1292,632,660,95.8,1274,618,656,94.2
32040, 동해시,045,40~44세,2017,7268,3839,3429,112,7183,3791,3392,111.8
32040, 동해시,045001, 40세,2017,1326,682,644,105.9,1308,674,634,106.3
32040, 동해시,045002, 41세,2017,1300,685,615,111.4,1285,674,611,110.3
32040, 동해시,045003, 42세,2017,1414,753,661,113.9,1391,736,655,112.4
32040, 동해시,045004, 43세,2017,1600,818,782,104.6,1581,813,768,105.9
32040, 동해시,045005, 44세,2017,1628,901,727,123.9,1618,894,724,123.5
32040, 동해시,050,45~49세,2017,7998,4189,3809,110,7926,4157,3769,110.3
32040, 동해시,050001, 45세,2017,1508,830,678,122.4,1497,825,672,122.8
32040, 동해시,050002, 46세,2017,1671,836,835,100.1,1652,827,825,100.2
32040, 동해시,050003, 47세,2017,1619,850,769,110.5,1606,845,761,111
32040, 동해시,050004, 48세,2017,1617,813,804,101.1,1600,807,793,101.8
32040, 동해시,050005, 49세,2017,1583,860,723,118.9,1571,853,718,118.8
32040, 동해시,055,50~54세,2017,7236,3743,3493,107.2,7176,3719,3457,107.6
32040, 동해시,055001, 50세,2017,1498,783,715,109.5,1487,776,711,109.1
32040, 동해시,055002, 51세,2017,1445,726,719,101,1430,720,710,101.4
32040, 동해시,055003, 52세,2017,1417,743,674,110.2,1405,738,667,110.6
32040, 동해시,055004, 53세,2017,1398,738,660,111.8,1387,733,654,112.1
32040, 동해시,055005, 54세,2017,1478,753,725,103.9,1467,752,715,105.2
32040, 동해시,060,55~59세,2017,8156,3999,4157,96.2,8124,3986,4138,96.3
32040, 동해시,060001, 55세,2017,1605,834,771,108.2,1596,828,768,107.8
32040, 동해시,060002, 56세,2017,1616,805,811,99.3,1613,804,809,99.4
32040, 동해시,060003, 57세,2017,1821,897,924,97.1,1812,894,918,97.4
32040, 동해시,060004, 58세,2017,1567,741,826,89.7,1563,741,822,90.1
32040, 동해시,060005, 59세,2017,1547,722,825,87.5,1540,719,821,87.6
32040, 동해시,065,60~64세,2017,6728,3345,3383,98.9,6699,3335,3364,99.1
32040, 동해시,065001, 60세,2017,1539,777,762,102,1534,774,760,101.8
32040, 동해시,065002, 61세,2017,1320,670,650,103.1,1316,669,647,103.4
32040, 동해시,065003, 62세,2017,1450,708,742,95.4,1441,705,736,95.8
32040, 동해시,065004, 63세,2017,1270,607,663,91.6,1267,607,660,92
32040, 동해시,065005, 64세,2017,1149,583,566,103,1141,580,561,103.4
32040, 동해시,070,65~69세,2017,4681,2259,2422,93.3,4668,2254,2414,93.4
32040, 동해시,070001, 65세,2017,1168,554,614,90.2,1165,554,611,90.7
32040, 동해시,070002, 66세,2017,740,357,383,93.2,739,356,383,93
32040, 동해시,070003, 67세,2017,881,421,460,91.5,880,420,460,91.3
32040, 동해시,070004, 68세,2017,881,440,441,99.8,877,438,439,99.8
32040, 동해시,070005, 69세,2017,1011,487,524,92.9,1007,486,521,93.3
32040, 동해시,075,70~74세,2017,3964,1802,2162,83.3,3959,1800,2159,83.4
32040, 동해시,075001, 70세,2017,848,398,450,88.4,845,396,449,88.2
32040, 동해시,075002, 71세,2017,660,296,364,81.3,659,296,363,81.5
32040, 동해시,075003, 72세,2017,809,372,437,85.1,809,372,437,85.1
32040, 동해시,075004, 73세,2017,843,387,456,84.9,842,387,455,85.1
32040, 동해시,075005, 74세,2017,804,349,455,76.7,804,349,455,76.7
32040, 동해시,080,75~79세,2017,3484,1487,1997,74.5,3481,1485,1996,74.4
32040, 동해시,080001, 75세,2017,851,374,477,78.4,849,372,477,78
32040, 동해시,080002, 76세,2017,723,331,392,84.4,723,331,392,84.4
32040, 동해시,080003, 77세,2017,659,243,416,58.4,658,243,415,58.6
32040, 동해시,080004, 78세,2017,631,279,352,79.3,631,279,352,79.3
32040, 동해시,080005, 79세,2017,620,260,360,72.2,620,260,360,72.2
32040, 동해시,085,80~84세,2017,2004,729,1275,57.2,2002,729,1273,57.3
32040, 동해시,085001, 80세,2017,474,192,282,68.1,474,192,282,68.1
32040, 동해시,085002, 81세,2017,448,173,275,62.9,447,173,274,63.1
32040, 동해시,085003, 82세,2017,419,149,270,55.2,419,149,270,55.2
32040, 동해시,085004, 83세,2017,373,134,239,56.1,372,134,238,56.3
32040, 동해시,085005, 84세,2017,290,81,209,38.8,290,81,209,38.8
32040, 동해시,090,85~89세,2017,936,225,711,31.6,936,225,711,31.6
32040, 동해시,090001, 85세,2017,251,60,191,31.4,251,60,191,31.4
32040, 동해시,090002, 86세,2017,225,57,168,33.9,225,57,168,33.9
32040, 동해시,090003, 87세,2017,186,45,141,31.9,186,45,141,31.9
32040, 동해시,090004, 88세,2017,151,33,118,28,151,33,118,28
32040, 동해시,090005, 89세,2017,123,30,93,32.3,123,30,93,32.3
32040, 동해시,095,90~94세,2017,300,58,242,24,299,58,241,24.1
32040, 동해시,095001, 90세,2017,92,26,66,39.4,92,26,66,39.4
32040, 동해시,095002, 91세,2017,54,7,47,14.9,53,7,46,15.2
32040, 동해시,095003, 92세,2017,65,12,53,22.6,65,12,53,22.6
32040, 동해시,095004, 93세,2017,44,5,39,12.8,44,5,39,12.8
32040, 동해시,095005, 94세,2017,45,8,37,21.6,45,8,37,21.6
32040, 동해시,100,95~99세,2017,62,15,47,31.9,61,14,47,29.8
32040, 동해시,100001, 95세,2017,28,8,20,40,27,7,20,35
32040, 동해시,100002, 96세,2017,21,X,17,23.5,21,X,17,23.5
32040, 동해시,100003, 97세,2017,6,X,5,20,6,X,5,20
32040, 동해시,100004, 98세,2017,X,X,X,200,X,X,X,200
32040, 동해시,100005, 99세,2017,X,X,X,0,X,X,X,0
32040, 동해시,101,100세이상,2017,7,X,7,0,7,X,7,0
32040, 동해시,102,15세미만,2017,12003,6224,5779,107.7,11992,6218,5774,107.7
32040, 동해시,103,15~64세,2017,61710,32548,29162,111.6,60858,32044,28814,111.2
32040, 동해시,104,65세이상,2017,15438,6575,8863,74.2,15413,6565,8848,74.2
32040, 동해시,086,85세이상,2017,1305,298,1007,29.6,1303,297,1006,29.5
32040, 동해시,126,평균연령,2017,43.6,42,45.3,,43.7,42.1,45.4,
32040, 동해시,127,중위연령,2017,45.6,44.1,47.4,,45.8,44.3,47.5,
32050, 태백시,000,합계,2017,44733,22638,22095,102.5,44421,22522,21899,102.8
32050, 태백시,005,0~4세,2017,1411,732,679,107.8,1410,731,679,107.7
32050, 태백시,005001, 0세,2017,228,117,111,105.4,228,117,111,105.4
32050, 태백시,005002, 1세,2017,260,140,120,116.7,259,139,120,115.8
32050, 태백시,005003, 2세,2017,301,154,147,104.8,301,154,147,104.8
32050, 태백시,005004, 3세,2017,307,162,145,111.7,307,162,145,111.7
32050, 태백시,005005, 4세,2017,315,159,156,101.9,315,159,156,101.9
32050, 태백시,010,5~9세,2017,1960,971,989,98.2,1959,970,989,98.1
32050, 태백시,010001, 5세,2017,402,200,202,99,402,200,202,99
32050, 태백시,010002, 6세,2017,391,191,200,95.5,391,191,200,95.5
32050, 태백시,010003, 7세,2017,392,195,197,99,392,195,197,99
32050, 태백시,010004, 8세,2017,389,189,200,94.5,388,188,200,94
32050, 태백시,010005, 9세,2017,386,196,190,103.2,386,196,190,103.2
32050, 태백시,015,10~14세,2017,1889,966,923,104.7,1886,966,920,105
32050, 태백시,015001, 10세,2017,429,223,206,108.3,428,223,205,108.8
32050, 태백시,015002, 11세,2017,348,172,176,97.7,347,172,175,98.3
32050, 태백시,015003, 12세,2017,371,195,176,110.8,371,195,176,110.8
32050, 태백시,015004, 13세,2017,359,180,179,100.6,358,180,178,101.1
32050, 태백시,015005, 14세,2017,382,196,186,105.4,382,196,186,105.4
32050, 태백시,020,15~19세,2017,2310,1359,951,142.9,2308,1358,950,142.9
32050, 태백시,020001, 15세,2017,423,213,210,101.4,423,213,210,101.4
32050, 태백시,020002, 16세,2017,516,329,187,175.9,516,329,187,175.9
32050, 태백시,020003, 17세,2017,575,353,222,159,575,353,222,159
32050, 태백시,020004, 18세,2017,435,257,178,144.4,435,257,178,144.4
32050, 태백시,020005, 19세,2017,361,207,154,134.4,359,206,153,134.6
32050, 태백시,025,20~24세,2017,2001,1159,842,137.6,1977,1156,821,140.8
32050, 태백시,025001, 20세,2017,430,251,179,140.2,429,251,178,141
32050, 태백시,025002, 21세,2017,457,282,175,161.1,453,282,171,164.9
32050, 태백시,025003, 22세,2017,392,222,170,130.6,391,222,169,131.4
32050, 태백시,025004, 23세,2017,359,210,149,140.9,350,209,141,148.2
32050, 태백시,025005, 24세,2017,363,194,169,114.8,354,192,162,118.5
32050, 태백시,030,25~29세,2017,1675,863,812,106.3,1618,847,771,109.9
32050, 태백시,030001, 25세,2017,344,173,171,101.2,338,171,167,102.4
32050, 태백시,030002, 26세,2017,315,165,150,110,303,160,143,111.9
32050, 태백시,030003, 27세,2017,329,156,173,90.2,309,151,158,95.6
32050, 태백시,030004, 28세,2017,366,195,171,114,359,193,166,116.3
32050, 태백시,030005, 29세,2017,321,174,147,118.4,309,172,137,125.5
32050, 태백시,035,30~34세,2017,1926,1001,925,108.2,1870,986,884,111.5
32050, 태백시,035001, 30세,2017,344,165,179,92.2,327,162,165,98.2
32050, 태백시,035002, 31세,2017,322,189,133,142.1,313,184,129,142.6
32050, 태백시,035003, 32세,2017,339,183,156,117.3,328,179,149,120.1
32050, 태백시,035004, 33세,2017,404,200,204,98,397,198,199,99.5
32050, 태백시,035005, 34세,2017,517,264,253,104.3,505,263,242,108.7
32050, 태백시,040,35~39세,2017,3160,1609,1551,103.7,3120,1591,1529,104.1
32050, 태백시,040001, 35세,2017,609,309,300,103,596,305,291,104.8
32050, 태백시,040002, 36세,2017,561,286,275,104,554,283,271,104.4
32050, 태백시,040003, 37세,2017,658,350,308,113.6,649,346,303,114.2
32050, 태백시,040004, 38세,2017,652,327,325,100.6,646,324,322,100.6
32050, 태백시,040005, 39세,2017,680,337,343,98.3,675,333,342,97.4
32050, 태백시,045,40~44세,2017,3370,1851,1519,121.9,3346,1840,1506,122.2
32050, 태백시,045001, 40세,2017,654,342,312,109.6,649,339,310,109.4
32050, 태백시,045002, 41세,2017,623,341,282,120.9,615,337,278,121.2
32050, 태백시,045003, 42세,2017,676,387,289,133.9,675,387,288,134.4
32050, 태백시,045004, 43세,2017,709,395,314,125.8,704,393,311,126.4
32050, 태백시,045005, 44세,2017,708,386,322,119.9,703,384,319,120.4
32050, 태백시,050,45~49세,2017,3816,2109,1707,123.6,3784,2091,1693,123.5
32050, 태백시,050001, 45세,2017,729,399,330,120.9,721,396,325,121.8
32050, 태백시,050002, 46세,2017,724,379,345,109.9,716,375,341,110
32050, 태백시,050003, 47세,2017,788,433,355,122,781,429,352,121.9
32050, 태백시,050004, 48세,2017,755,431,324,133,752,429,323,132.8
32050, 태백시,050005, 49세,2017,820,467,353,132.3,814,462,352,131.3
32050, 태백시,055,50~54세,2017,3644,1932,1712,112.9,3616,1921,1695,113.3
32050, 태백시,055001, 50세,2017,735,393,342,114.9,730,391,339,115.3
32050, 태백시,055002, 51세,2017,764,403,361,111.6,758,400,358,111.7
32050, 태백시,055003, 52세,2017,735,369,366,100.8,730,368,362,101.7
32050, 태백시,055004, 53세,2017,662,352,310,113.5,662,352,310,113.5
32050, 태백시,055005, 54세,2017,748,415,333,124.6,736,410,326,125.8
32050, 태백시,060,55~59세,2017,4382,2224,2158,103.1,4361,2216,2145,103.3
32050, 태백시,060001, 55세,2017,765,393,372,105.6,762,392,370,105.9
32050, 태백시,060002, 56세,2017,922,471,451,104.4,920,469,451,104
32050, 태백시,060003, 57세,2017,991,496,495,100.2,982,492,490,100.4
32050, 태백시,060004, 58세,2017,900,458,442,103.6,894,457,437,104.6
32050, 태백시,060005, 59세,2017,804,406,398,102,803,406,397,102.3
32050, 태백시,065,60~64세,2017,3898,1941,1957,99.2,3888,1937,1951,99.3
32050, 태백시,065001, 60세,2017,869,458,411,111.4,868,458,410,111.7
32050, 태백시,065002, 61세,2017,805,417,388,107.5,801,415,386,107.5
32050, 태백시,065003, 62세,2017,843,393,450,87.3,839,392,447,87.7
32050, 태백시,065004, 63세,2017,720,351,369,95.1,719,350,369,94.9
32050, 태백시,065005, 64세,2017,661,322,339,95,661,322,339,95
32050, 태백시,070,65~69세,2017,3024,1404,1620,86.7,3018,1400,1618,86.5
32050, 태백시,070001, 65세,2017,724,338,386,87.6,723,337,386,87.3
32050, 태백시,070002, 66세,2017,528,259,269,96.3,527,258,269,95.9
32050, 태백시,070003, 67세,2017,596,258,338,76.3,594,257,337,76.3
32050, 태백시,070004, 68세,2017,596,287,309,92.9,594,286,308,92.9
32050, 태백시,070005, 69세,2017,580,262,318,82.4,580,262,318,82.4
32050, 태백시,075,70~74세,2017,2472,1094,1378,79.4,2469,1091,1378,79.2
32050, 태백시,075001, 70세,2017,556,241,315,76.5,556,241,315,76.5
32050, 태백시,075002, 71세,2017,438,189,249,75.9,437,188,249,75.5
32050, 태백시,075003, 72세,2017,500,222,278,79.9,498,220,278,79.1
32050, 태백시,075004, 73세,2017,481,203,278,73,481,203,278,73
32050, 태백시,075005, 74세,2017,497,239,258,92.6,497,239,258,92.6
32050, 태백시,080,75~79세,2017,2135,894,1241,72,2132,892,1240,71.9
32050, 태백시,080001, 75세,2017,542,245,297,82.5,542,245,297,82.5
32050, 태백시,080002, 76세,2017,447,204,243,84,445,203,242,83.9
32050, 태백시,080003, 77세,2017,408,153,255,60,407,152,255,59.6
32050, 태백시,080004, 78세,2017,411,167,244,68.4,411,167,244,68.4
32050, 태백시,080005, 79세,2017,327,125,202,61.9,327,125,202,61.9
32050, 태백시,085,80~84세,2017,1147,420,727,57.8,1146,420,726,57.9
32050, 태백시,085001, 80세,2017,292,121,171,70.8,292,121,171,70.8
32050, 태백시,085002, 81세,2017,264,99,165,60,264,99,165,60
32050, 태백시,085003, 82세,2017,242,81,161,50.3,242,81,161,50.3
32050, 태백시,085004, 83세,2017,188,59,129,45.7,188,59,129,45.7
32050, 태백시,085005, 84세,2017,161,60,101,59.4,160,60,100,60
32050, 태백시,090,85~89세,2017,362,80,282,28.4,362,80,282,28.4
32050, 태백시,090001, 85세,2017,89,24,65,36.9,89,24,65,36.9
32050, 태백시,090002, 86세,2017,79,12,67,17.9,79,12,67,17.9
32050, 태백시,090003, 87세,2017,94,27,67,40.3,94,27,67,40.3
32050, 태백시,090004, 88세,2017,53,6,47,12.8,53,6,47,12.8
32050, 태백시,090005, 89세,2017,47,11,36,30.6,47,11,36,30.6
32050, 태백시,095,90~94세,2017,122,23,99,23.2,122,23,99,23.2
32050, 태백시,095001, 90세,2017,38,8,30,26.7,38,8,30,26.7
32050, 태백시,095002, 91세,2017,31,6,25,24,31,6,25,24
32050, 태백시,095003, 92세,2017,20,X,17,17.6,20,X,17,17.6
32050, 태백시,095004, 93세,2017,21,X,21,0,21,X,21,0
32050, 태백시,095005, 94세,2017,12,6,6,100,12,6,6,100
32050, 태백시,100,95~99세,2017,28,6,22,27.3,28,6,22,27.3
32050, 태백시,100001, 95세,2017,14,5,9,55.6,14,5,9,55.6
32050, 태백시,100002, 96세,2017,X,X,X,0,X,X,X,0
32050, 태백시,100003, 97세,2017,X,X,X,0,X,X,X,0
32050, 태백시,100004, 98세,2017,X,X,X,0,X,X,X,0
32050, 태백시,100005, 99세,2017,5,X,X,25,5,X,X,25
32050, 태백시,101,100세이상,2017,X,X,X,0,X,X,X,0
32050, 태백시,102,15세미만,2017,5260,2669,2591,103,5255,2667,2588,103.1
32050, 태백시,103,15~64세,2017,30182,16048,14134,113.5,29888,15943,13945,114.3
32050, 태백시,104,65세이상,2017,9291,3921,5370,73,9278,3912,5366,72.9
32050, 태백시,086,85세이상,2017,513,109,404,27,513,109,404,27
32050, 태백시,126,평균연령,2017,45.9,44.4,47.5,,46,44.4,47.6,
32050, 태백시,127,중위연령,2017,48.6,47.1,50.4,,48.7,47.1,50.6,
32060, 속초시,000,합계,2017,78618,38962,39656,98.2,77447,38259,39188,97.6
32060, 속초시,005,0~4세,2017,2878,1449,1429,101.4,2873,1445,1428,101.2
32060, 속초시,005001, 0세,2017,418,234,184,127.2,418,234,184,127.2
32060, 속초시,005002, 1세,2017,566,288,278,103.6,564,287,277,103.6
32060, 속초시,005003, 2세,2017,662,314,348,90.2,662,314,348,90.2
32060, 속초시,005004, 3세,2017,608,295,313,94.2,606,293,313,93.6
32060, 속초시,005005, 4세,2017,624,318,306,103.9,623,317,306,103.6
32060, 속초시,010,5~9세,2017,3307,1653,1654,99.9,3304,1652,1652,100
32060, 속초시,010001, 5세,2017,673,324,349,92.8,671,324,347,93.4
32060, 속초시,010002, 6세,2017,680,340,340,100,680,340,340,100
32060, 속초시,010003, 7세,2017,666,342,324,105.6,666,342,324,105.6
32060, 속초시,010004, 8세,2017,628,311,317,98.1,628,311,317,98.1
32060, 속초시,010005, 9세,2017,660,336,324,103.7,659,335,324,103.4
32060, 속초시,015,10~14세,2017,3676,1898,1778,106.7,3674,1897,1777,106.8
32060, 속초시,015001, 10세,2017,690,368,322,114.3,689,367,322,114
32060, 속초시,015002, 11세,2017,656,318,338,94.1,656,318,338,94.1
32060, 속초시,015003, 12세,2017,673,344,329,104.6,673,344,329,104.6
32060, 속초시,015004, 13세,2017,836,437,399,109.5,836,437,399,109.5
32060, 속초시,015005, 14세,2017,821,431,390,110.5,820,431,389,110.8
32060, 속초시,020,15~19세,2017,4214,2216,1998,110.9,4198,2213,1985,111.5
32060, 속초시,020001, 15세,2017,864,449,415,108.2,863,449,414,108.5
32060, 속초시,020002, 16세,2017,911,436,475,91.8,911,436,475,91.8
32060, 속초시,020003, 17세,2017,1095,581,514,113,1094,580,514,112.8
32060, 속초시,020004, 18세,2017,850,444,406,109.4,847,444,403,110.2
32060, 속초시,020005, 19세,2017,494,306,188,162.8,483,304,179,169.8
32060, 속초시,025,20~24세,2017,3790,2242,1548,144.8,3594,2128,1466,145.2
32060, 속초시,025001, 20세,2017,695,473,222,213.1,678,466,212,219.8
32060, 속초시,025002, 21세,2017,822,515,307,167.8,774,493,281,175.4
32060, 속초시,025003, 22세,2017,756,452,304,148.7,710,424,286,148.3
32060, 속초시,025004, 23세,2017,788,410,378,108.5,738,376,362,103.9
32060, 속초시,025005, 24세,2017,729,392,337,116.3,694,369,325,113.5
32060, 속초시,030,25~29세,2017,3873,2118,1755,120.7,3664,1987,1677,118.5
32060, 속초시,030001, 25세,2017,846,439,407,107.9,807,417,390,106.9
32060, 속초시,030002, 26세,2017,753,415,338,122.8,712,387,325,119.1
32060, 속초시,030003, 27세,2017,750,423,327,129.4,699,391,308,126.9
32060, 속초시,030004, 28세,2017,738,410,328,125,698,380,318,119.5
32060, 속초시,030005, 29세,2017,786,431,355,121.4,748,412,336,122.6
32060, 속초시,035,30~34세,2017,4040,2178,1862,117,3856,2062,1794,114.9
32060, 속초시,035001, 30세,2017,771,419,352,119,731,389,342,113.7
32060, 속초시,035002, 31세,2017,726,381,345,110.4,690,355,335,106
32060, 속초시,035003, 32세,2017,770,415,355,116.9,727,394,333,118.3
32060, 속초시,035004, 33세,2017,870,473,397,119.1,840,454,386,117.6
32060, 속초시,035005, 34세,2017,903,490,413,118.6,868,470,398,118.1
32060, 속초시,040,35~39세,2017,5462,2751,2711,101.5,5327,2653,2674,99.2
32060, 속초시,040001, 35세,2017,1104,572,532,107.5,1062,543,519,104.6
32060, 속초시,040002, 36세,2017,1123,586,537,109.1,1089,563,526,107
32060, 속초시,040003, 37세,2017,1123,560,563,99.5,1099,541,558,97
32060, 속초시,040004, 38세,2017,1078,524,554,94.6,1063,515,548,94
32060, 속초시,040005, 39세,2017,1034,509,525,97,1014,491,523,93.9
32060, 속초시,045,40~44세,2017,5951,3003,2948,101.9,5833,2918,2915,100.1
32060, 속초시,045001, 40세,2017,1074,547,527,103.8,1053,530,523,101.3
32060, 속초시,045002, 41세,2017,1077,542,535,101.3,1054,527,527,100
32060, 속초시,045003, 42세,2017,1137,552,585,94.4,1106,528,578,91.3
32060, 속초시,045004, 43세,2017,1325,676,649,104.2,1310,665,645,103.1
32060, 속초시,045005, 44세,2017,1338,686,652,105.2,1310,668,642,104
32060, 속초시,050,45~49세,2017,7444,3697,3747,98.7,7363,3646,3717,98.1
32060, 속초시,050001, 45세,2017,1367,683,684,99.9,1346,668,678,98.5
32060, 속초시,050002, 46세,2017,1483,722,761,94.9,1464,712,752,94.7
32060, 속초시,050003, 47세,2017,1513,771,742,103.9,1495,758,737,102.8
32060, 속초시,050004, 48세,2017,1539,780,759,102.8,1527,774,753,102.8
32060, 속초시,050005, 49세,2017,1542,741,801,92.5,1531,734,797,92.1
32060, 속초시,055,50~54세,2017,7033,3559,3474,102.4,6962,3530,3432,102.9
32060, 속초시,055001, 50세,2017,1371,673,698,96.4,1364,670,694,96.5
32060, 속초시,055002, 51세,2017,1363,738,625,118.1,1354,736,618,119.1
32060, 속초시,055003, 52세,2017,1348,669,679,98.5,1326,656,670,97.9
32060, 속초시,055004, 53세,2017,1421,707,714,99,1410,704,706,99.7
32060, 속초시,055005, 54세,2017,1530,772,758,101.8,1508,764,744,102.7
32060, 속초시,060,55~59세,2017,7741,3784,3957,95.6,7694,3770,3924,96.1
32060, 속초시,060001, 55세,2017,1482,763,719,106.1,1475,760,715,106.3
32060, 속초시,060002, 56세,2017,1641,782,859,91,1634,781,853,91.6
32060, 속초시,060003, 57세,2017,1650,772,878,87.9,1636,766,870,88
32060, 속초시,060004, 58세,2017,1473,721,752,95.9,1461,717,744,96.4
32060, 속초시,060005, 59세,2017,1495,746,749,99.6,1488,746,742,100.5
32060, 속초시,065,60~64세,2017,6040,3063,2977,102.9,5996,3035,2961,102.5
32060, 속초시,065001, 60세,2017,1372,704,668,105.4,1358,696,662,105.1
32060, 속초시,065002, 61세,2017,1266,668,598,111.7,1260,665,595,111.8
32060, 속초시,065003, 62세,2017,1312,668,644,103.7,1305,664,641,103.6
32060, 속초시,065004, 63세,2017,1189,574,615,93.3,1180,567,613,92.5
32060, 속초시,065005, 64세,2017,901,449,452,99.3,893,443,450,98.4
32060, 속초시,070,65~69세,2017,3800,1760,2040,86.3,3770,1745,2025,86.2
32060, 속초시,070001, 65세,2017,960,458,502,91.2,951,456,495,92.1
32060, 속초시,070002, 66세,2017,639,264,375,70.4,633,262,371,70.6
32060, 속초시,070003, 67세,2017,708,327,381,85.8,704,325,379,85.8
32060, 속초시,070004, 68세,2017,749,373,376,99.2,743,369,374,98.7
32060, 속초시,070005, 69세,2017,744,338,406,83.3,739,333,406,82
32060, 속초시,075,70~74세,2017,3446,1519,1927,78.8,3432,1513,1919,78.8
32060, 속초시,075001, 70세,2017,774,356,418,85.2,771,355,416,85.3
32060, 속초시,075002, 71세,2017,661,293,368,79.6,657,291,366,79.5
32060, 속초시,075003, 72세,2017,715,307,408,75.2,713,306,407,75.2
32060, 속초시,075004, 73세,2017,654,264,390,67.7,652,263,389,67.6
32060, 속초시,075005, 74세,2017,642,299,343,87.2,639,298,341,87.4
32060, 속초시,080,75~79세,2017,2889,1176,1713,68.7,2883,1174,1709,68.7
32060, 속초시,080001, 75세,2017,689,282,407,69.3,688,281,407,69
32060, 속초시,080002, 76세,2017,610,254,356,71.3,608,254,354,71.8
32060, 속초시,080003, 77세,2017,577,248,329,75.4,577,248,329,75.4
32060, 속초시,080004, 78세,2017,513,193,320,60.3,512,193,319,60.5
32060, 속초시,080005, 79세,2017,500,199,301,66.1,498,198,300,66
32060, 속초시,085,80~84세,2017,1740,604,1136,53.2,1731,599,1132,52.9
32060, 속초시,085001, 80세,2017,431,160,271,59,429,158,271,58.3
32060, 속초시,085002, 81세,2017,415,155,260,59.6,415,155,260,59.6
32060, 속초시,085003, 82세,2017,343,112,231,48.5,343,112,231,48.5
32060, 속초시,085004, 83세,2017,305,97,208,46.6,301,95,206,46.1
32060, 속초시,085005, 84세,2017,246,80,166,48.2,243,79,164,48.2
32060, 속초시,090,85~89세,2017,869,192,677,28.4,869,192,677,28.4
32060, 속초시,090001, 85세,2017,200,50,150,33.3,200,50,150,33.3
32060, 속초시,090002, 86세,2017,169,33,136,24.3,169,33,136,24.3
32060, 속초시,090003, 87세,2017,172,35,137,25.5,172,35,137,25.5
32060, 속초시,090004, 88세,2017,185,41,144,28.5,185,41,144,28.5
32060, 속초시,090005, 89세,2017,143,33,110,30,143,33,110,30
32060, 속초시,095,90~94세,2017,354,80,274,29.2,354,80,274,29.2
32060, 속초시,095001, 90세,2017,116,20,96,20.8,116,20,96,20.8
32060, 속초시,095002, 91세,2017,86,21,65,32.3,86,21,65,32.3
32060, 속초시,095003, 92세,2017,74,14,60,23.3,74,14,60,23.3
32060, 속초시,095004, 93세,2017,39,8,31,25.8,39,8,31,25.8
32060, 속초시,095005, 94세,2017,39,17,22,77.3,39,17,22,77.3
32060, 속초시,100,95~99세,2017,65,20,45,44.4,64,20,44,45.5
32060, 속초시,100001, 95세,2017,26,9,17,52.9,26,9,17,52.9
32060, 속초시,100002, 96세,2017,21,6,15,40,21,6,15,40
32060, 속초시,100003, 97세,2017,10,X,7,42.9,9,X,6,50
32060, 속초시,100004, 98세,2017,6,X,X,50,6,X,X,50
32060, 속초시,100005, 99세,2017,X,X,X,0,X,X,X,0
32060, 속초시,101,100세이상,2017,6,X,6,0,6,X,6,0
32060, 속초시,102,15세미만,2017,9861,5000,4861,102.9,9851,4994,4857,102.8
32060, 속초시,103,15~64세,2017,55588,28611,26977,106.1,54487,27942,26545,105.3
32060, 속초시,104,65세이상,2017,13169,5351,7818,68.4,13109,5323,7786,68.4
32060, 속초시,086,85세이상,2017,1294,292,1002,29.1,1293,292,1001,29.2
32060, 속초시,126,평균연령,2017,44.1,42.5,45.7,,44.2,42.6,45.7,
32060, 속초시,127,중위연령,2017,46.5,45,47.9,,46.7,45.3,48.1,
32070, 삼척시,000,합계,2017,67860,35066,32794,106.9,66928,34542,32386,106.7
32070, 삼척시,005,0~4세,2017,1951,1003,948,105.8,1945,1000,945,105.8
32070, 삼척시,005001, 0세,2017,340,189,151,125.2,340,189,151,125.2
32070, 삼척시,005002, 1세,2017,375,180,195,92.3,372,178,194,91.8
32070, 삼척시,005003, 2세,2017,390,203,187,108.6,390,203,187,108.6
32070, 삼척시,005004, 3세,2017,421,217,204,106.4,420,217,203,106.9
32070, 삼척시,005005, 4세,2017,425,214,211,101.4,423,213,210,101.4
32070, 삼척시,010,5~9세,2017,2383,1243,1140,109,2382,1242,1140,108.9
32070, 삼척시,010001, 5세,2017,501,264,237,111.4,501,264,237,111.4
32070, 삼척시,010002, 6세,2017,468,251,217,115.7,468,251,217,115.7
32070, 삼척시,010003, 7세,2017,444,216,228,94.7,444,216,228,94.7
32070, 삼척시,010004, 8세,2017,485,260,225,115.6,485,260,225,115.6
32070, 삼척시,010005, 9세,2017,485,252,233,108.2,484,251,233,107.7
32070, 삼척시,015,10~14세,2017,2394,1228,1166,105.3,2392,1228,1164,105.5
32070, 삼척시,015001, 10세,2017,477,245,232,105.6,477,245,232,105.6
32070, 삼척시,015002, 11세,2017,458,248,210,118.1,457,248,209,118.7
32070, 삼척시,015003, 12세,2017,475,255,220,115.9,475,255,220,115.9
32070, 삼척시,015004, 13세,2017,464,220,244,90.2,464,220,244,90.2
32070, 삼척시,015005, 14세,2017,520,260,260,100,519,260,259,100.4
32070, 삼척시,020,15~19세,2017,4175,2397,1778,134.8,4152,2390,1762,135.6
32070, 삼척시,020001, 15세,2017,560,295,265,111.3,560,295,265,111.3
32070, 삼척시,020002, 16세,2017,611,345,266,129.7,610,344,266,129.3
32070, 삼척시,020003, 17세,2017,698,388,310,125.2,696,388,308,126
32070, 삼척시,020004, 18세,2017,903,506,397,127.5,898,502,396,126.8
32070, 삼척시,020005, 19세,2017,1403,863,540,159.8,1388,861,527,163.4
32070, 삼척시,025,20~24세,2017,6343,3834,2509,152.8,6147,3728,2419,154.1
32070, 삼척시,025001, 20세,2017,1289,684,605,113.1,1253,670,583,114.9
32070, 삼척시,025002, 21세,2017,1306,667,639,104.4,1278,656,622,105.5
32070, 삼척시,025003, 22세,2017,1305,744,561,132.6,1270,719,551,130.5
32070, 삼척시,025004, 23세,2017,1293,901,392,229.8,1250,880,370,237.8
32070, 삼척시,025005, 24세,2017,1150,838,312,268.6,1096,803,293,274.1
32070, 삼척시,030,25~29세,2017,3168,1930,1238,155.9,2988,1828,1160,157.6
32070, 삼척시,030001, 25세,2017,897,593,304,195.1,856,570,286,199.3
32070, 삼척시,030002, 26세,2017,627,370,257,144,587,349,238,146.6
32070, 삼척시,030003, 27세,2017,586,364,222,164,550,344,206,167
32070, 삼척시,030004, 28세,2017,535,323,212,152.4,502,301,201,149.8
32070, 삼척시,030005, 29세,2017,523,280,243,115.2,493,264,229,115.3
32070, 삼척시,035,30~34세,2017,2917,1633,1284,127.2,2760,1538,1222,125.9
32070, 삼척시,035001, 30세,2017,517,287,230,124.8,488,265,223,118.8
32070, 삼척시,035002, 31세,2017,555,316,239,132.2,525,298,227,131.3
32070, 삼척시,035003, 32세,2017,599,337,262,128.6,555,312,243,128.4
32070, 삼척시,035004, 33세,2017,580,328,252,130.2,560,314,246,127.6
32070, 삼척시,035005, 34세,2017,666,365,301,121.3,632,349,283,123.3
32070, 삼척시,040,35~39세,2017,3790,2034,1756,115.8,3669,1948,1721,113.2
32070, 삼척시,040001, 35세,2017,716,383,333,115,691,367,324,113.3
32070, 삼척시,040002, 36세,2017,758,423,335,126.3,727,400,327,122.3
32070, 삼척시,040003, 37세,2017,787,401,386,103.9,757,379,378,100.3
32070, 삼척시,040004, 38세,2017,754,410,344,119.2,735,397,338,117.5
32070, 삼척시,040005, 39세,2017,775,417,358,116.5,759,405,354,114.4
32070, 삼척시,045,40~44세,2017,4438,2476,1962,126.2,4368,2428,1940,125.2
32070, 삼척시,045001, 40세,2017,790,436,354,123.2,779,428,351,121.9
32070, 삼척시,045002, 41세,2017,797,425,372,114.2,788,419,369,113.6
32070, 삼척시,045003, 42세,2017,885,485,400,121.3,863,471,392,120.2
32070, 삼척시,045004, 43세,2017,993,559,434,128.8,980,549,431,127.4
32070, 삼척시,045005, 44세,2017,973,571,402,142,958,561,397,141.3
32070, 삼척시,050,45~49세,2017,5024,2816,2208,127.5,4967,2789,2178,128.1
32070, 삼척시,050001, 45세,2017,889,515,374,137.7,871,507,364,139.3
32070, 삼척시,050002, 46세,2017,1044,588,456,128.9,1033,584,449,130.1
32070, 삼척시,050003, 47세,2017,967,543,424,128.1,957,538,419,128.4
32070, 삼척시,050004, 48세,2017,1050,575,475,121.1,1040,571,469,121.7
32070, 삼척시,050005, 49세,2017,1074,595,479,124.2,1066,589,477,123.5
32070, 삼척시,055,50~54세,2017,5052,2677,2375,112.7,5001,2658,2343,113.4
32070, 삼척시,055001, 50세,2017,987,519,468,110.9,973,512,461,111.1
32070, 삼척시,055002, 51세,2017,1049,574,475,120.8,1040,571,469,121.7
32070, 삼척시,055003, 52세,2017,961,488,473,103.2,953,486,467,104.1
32070, 삼척시,055004, 53세,2017,1029,558,471,118.5,1021,555,466,119.1
32070, 삼척시,055005, 54세,2017,1026,538,488,110.2,1014,534,480,111.3
32070, 삼척시,060,55~59세,2017,6423,3251,3172,102.5,6389,3237,3152,102.7
32070, 삼척시,060001, 55세,2017,1182,602,580,103.8,1175,599,576,104
32070, 삼척시,060002, 56세,2017,1420,715,705,101.4,1411,711,700,101.6
32070, 삼척시,060003, 57세,2017,1394,711,683,104.1,1388,708,680,104.1
32070, 삼척시,060004, 58세,2017,1274,636,638,99.7,1267,635,632,100.5
32070, 삼척시,060005, 59세,2017,1153,587,566,103.7,1148,584,564,103.5
32070, 삼척시,065,60~64세,2017,5273,2621,2652,98.8,5250,2611,2639,98.9
32070, 삼척시,065001, 60세,2017,1194,598,596,100.3,1189,595,594,100.2
32070, 삼척시,065002, 61세,2017,1079,518,561,92.3,1072,517,555,93.2
32070, 삼척시,065003, 62세,2017,1117,558,559,99.8,1113,554,559,99.1
32070, 삼척시,065004, 63세,2017,968,492,476,103.4,964,491,473,103.8
32070, 삼척시,065005, 64세,2017,915,455,460,98.9,912,454,458,99.1
32070, 삼척시,070,65~69세,2017,4053,1956,2097,93.3,4047,1952,2095,93.2
32070, 삼척시,070001, 65세,2017,961,487,474,102.7,960,486,474,102.5
32070, 삼척시,070002, 66세,2017,628,289,339,85.3,627,289,338,85.5
32070, 삼척시,070003, 67세,2017,790,384,406,94.6,788,383,405,94.6
32070, 삼척시,070004, 68세,2017,822,412,410,100.5,820,410,410,100
32070, 삼척시,070005, 69세,2017,852,384,468,82.1,852,384,468,82.1
32070, 삼척시,075,70~74세,2017,3514,1582,1932,81.9,3511,1581,1930,81.9
32070, 삼척시,075001, 70세,2017,716,356,360,98.9,716,356,360,98.9
32070, 삼척시,075002, 71세,2017,613,289,324,89.2,613,289,324,89.2
32070, 삼척시,075003, 72세,2017,699,317,382,83,698,317,381,83.2
32070, 삼척시,075004, 73세,2017,719,297,422,70.4,718,296,422,70.1
32070, 삼척시,075005, 74세,2017,767,323,444,72.7,766,323,443,72.9
32070, 삼척시,080,75~79세,2017,3337,1299,2038,63.7,3335,1298,2037,63.7
32070, 삼척시,080001, 75세,2017,748,294,454,64.8,748,294,454,64.8
32070, 삼척시,080002, 76세,2017,681,255,426,59.9,680,254,426,59.6
32070, 삼척시,080003, 77세,2017,693,286,407,70.3,692,286,406,70.4
32070, 삼척시,080004, 78세,2017,628,248,380,65.3,628,248,380,65.3
32070, 삼척시,080005, 79세,2017,587,216,371,58.2,587,216,371,58.2
32070, 삼척시,085,80~84세,2017,2186,741,1445,51.3,2186,741,1445,51.3
32070, 삼척시,085001, 80세,2017,517,184,333,55.3,517,184,333,55.3
32070, 삼척시,085002, 81세,2017,486,169,317,53.3,486,169,317,53.3
32070, 삼척시,085003, 82세,2017,469,167,302,55.3,469,167,302,55.3
32070, 삼척시,085004, 83세,2017,413,131,282,46.5,413,131,282,46.5
32070, 삼척시,085005, 84세,2017,301,90,211,42.7,301,90,211,42.7
32070, 삼척시,090,85~89세,2017,1050,272,778,35,1050,272,778,35
32070, 삼척시,090001, 85세,2017,302,86,216,39.8,302,86,216,39.8
32070, 삼척시,090002, 86세,2017,240,70,170,41.2,240,70,170,41.2
32070, 삼척시,090003, 87세,2017,207,50,157,31.8,207,50,157,31.8
32070, 삼척시,090004, 88세,2017,168,37,131,28.2,168,37,131,28.2
32070, 삼척시,090005, 89세,2017,133,29,104,27.9,133,29,104,27.9
32070, 삼척시,095,90~94세,2017,329,63,266,23.7,329,63,266,23.7
32070, 삼척시,095001, 90세,2017,98,21,77,27.3,98,21,77,27.3
32070, 삼척시,095002, 91세,2017,89,16,73,21.9,89,16,73,21.9
32070, 삼척시,095003, 92세,2017,67,12,55,21.8,67,12,55,21.8
32070, 삼척시,095004, 93세,2017,41,9,32,28.1,41,9,32,28.1
32070, 삼척시,095005, 94세,2017,34,5,29,17.2,34,5,29,17.2
32070, 삼척시,100,95~99세,2017,59,9,50,18,59,9,50,18
32070, 삼척시,100001, 95세,2017,23,X,20,15,23,X,20,15
32070, 삼척시,100002, 96세,2017,16,X,15,6.7,16,X,15,6.7
32070, 삼척시,100003, 97세,2017,6,X,X,50,6,X,X,50
32070, 삼척시,100004, 98세,2017,7,X,5,40,7,X,5,40
32070, 삼척시,100005, 99세,2017,7,X,6,16.7,7,X,6,16.7
32070, 삼척시,101,100세이상,2017,X,X,X,,X,X,X,
32070, 삼척시,102,15세미만,2017,6728,3474,3254,106.8,6719,3470,3249,106.8
32070, 삼척시,103,15~64세,2017,46603,25669,20934,122.6,45691,25155,20536,122.5
32070, 삼척시,104,65세이상,2017,14529,5923,8606,68.8,14518,5917,8601,68.8
32070, 삼척시,086,85세이상,2017,1439,345,1094,31.5,1439,345,1094,31.5
32070, 삼척시,126,평균연령,2017,45.4,43,47.9,,45.5,43.1,48.1,
32070, 삼척시,127,중위연령,2017,47.5,44.6,50.9,,47.8,44.9,51.2,
32310, 홍천군,000,합계,2017,67168,34331,32837,104.5,65895,33561,32334,103.8
32310, 홍천군,005,0~4세,2017,2025,1046,979,106.8,2023,1044,979,106.6
32310, 홍천군,005001, 0세,2017,379,186,193,96.4,379,186,193,96.4
32310, 홍천군,005002, 1세,2017,397,229,168,136.3,397,229,168,136.3
32310, 홍천군,005003, 2세,2017,429,221,208,106.3,429,221,208,106.3
32310, 홍천군,005004, 3세,2017,409,198,211,93.8,409,198,211,93.8
32310, 홍천군,005005, 4세,2017,411,212,199,106.5,409,210,199,105.5
32310, 홍천군,010,5~9세,2017,2418,1199,1219,98.4,2417,1199,1218,98.4
32310, 홍천군,010001, 5세,2017,486,236,250,94.4,486,236,250,94.4
32310, 홍천군,010002, 6세,2017,455,220,235,93.6,455,220,235,93.6
32310, 홍천군,010003, 7세,2017,509,256,253,101.2,509,256,253,101.2
32310, 홍천군,010004, 8세,2017,483,256,227,112.8,482,256,226,113.3
32310, 홍천군,010005, 9세,2017,485,231,254,90.9,485,231,254,90.9
32310, 홍천군,015,10~14세,2017,2579,1330,1249,106.5,2574,1327,1247,106.4
32310, 홍천군,015001, 10세,2017,527,257,270,95.2,526,257,269,95.5
32310, 홍천군,015002, 11세,2017,462,248,214,115.9,460,247,213,116
32310, 홍천군,015003, 12세,2017,503,256,247,103.6,503,256,247,103.6
32310, 홍천군,015004, 13세,2017,514,266,248,107.3,513,265,248,106.9
32310, 홍천군,015005, 14세,2017,573,303,270,112.2,572,302,270,111.9
32310, 홍천군,020,15~19세,2017,3272,1655,1617,102.4,3266,1652,1614,102.4
32310, 홍천군,020001, 15세,2017,629,325,304,106.9,629,325,304,106.9
32310, 홍천군,020002, 16세,2017,763,376,387,97.2,760,376,384,97.9
32310, 홍천군,020003, 17세,2017,808,380,428,88.8,808,380,428,88.8
32310, 홍천군,020004, 18세,2017,676,347,329,105.5,676,347,329,105.5
32310, 홍천군,020005, 19세,2017,396,227,169,134.3,393,224,169,132.5
32310, 홍천군,025,20~24세,2017,3181,1923,1258,152.9,2953,1746,1207,144.7
32310, 홍천군,025001, 20세,2017,547,373,174,214.4,531,362,169,214.2
32310, 홍천군,025002, 21세,2017,615,383,232,165.1,579,353,226,156.2
32310, 홍천군,025003, 22세,2017,634,374,260,143.8,595,340,255,133.3
32310, 홍천군,025004, 23세,2017,635,357,278,128.4,577,313,264,118.6
32310, 홍천군,025005, 24세,2017,750,436,314,138.9,671,378,293,129
32310, 홍천군,030,25~29세,2017,3479,2047,1432,142.9,3183,1839,1344,136.8
32310, 홍천군,030001, 25세,2017,731,420,311,135,655,369,286,129
32310, 홍천군,030002, 26세,2017,732,436,296,147.3,670,394,276,142.8
32310, 홍천군,030003, 27세,2017,683,413,270,153,624,371,253,146.6
32310, 홍천군,030004, 28세,2017,676,402,274,146.7,620,360,260,138.5
32310, 홍천군,030005, 29세,2017,657,376,281,133.8,614,345,269,128.3
32310, 홍천군,035,30~34세,2017,3220,1858,1362,136.4,2995,1707,1288,132.5
32310, 홍천군,035001, 30세,2017,655,396,259,152.9,603,357,246,145.1
32310, 홍천군,035002, 31세,2017,633,369,264,139.8,588,340,248,137.1
32310, 홍천군,035003, 32세,2017,656,372,284,131,609,344,265,129.8
32310, 홍천군,035004, 33세,2017,624,359,265,135.5,583,332,251,132.3
32310, 홍천군,035005, 34세,2017,652,362,290,124.8,612,334,278,120.1
32310, 홍천군,040,35~39세,2017,3632,1929,1703,113.3,3521,1868,1653,113
32310, 홍천군,040001, 35세,2017,752,397,355,111.8,725,382,343,111.4
32310, 홍천군,040002, 36세,2017,756,408,348,117.2,731,392,339,115.6
32310, 홍천군,040003, 37세,2017,748,391,357,109.5,725,379,346,109.5
32310, 홍천군,040004, 38세,2017,672,351,321,109.3,651,343,308,111.4
32310, 홍천군,040005, 39세,2017,704,382,322,118.6,689,372,317,117.4
32310, 홍천군,045,40~44세,2017,4122,2209,1913,115.5,4054,2180,1874,116.3
32310, 홍천군,045001, 40세,2017,765,394,371,106.2,745,384,361,106.4
32310, 홍천군,045002, 41세,2017,748,399,349,114.3,730,389,341,114.1
32310, 홍천군,045003, 42세,2017,766,410,356,115.2,754,405,349,116
32310, 홍천군,045004, 43세,2017,914,502,412,121.8,904,499,405,123.2
32310, 홍천군,045005, 44세,2017,929,504,425,118.6,921,503,418,120.3
32310, 홍천군,050,45~49세,2017,4919,2588,2331,111,4841,2559,2282,112.1
32310, 홍천군,050001, 45세,2017,890,477,413,115.5,880,471,409,115.2
32310, 홍천군,050002, 46세,2017,949,517,432,119.7,937,510,427,119.4
32310, 홍천군,050003, 47세,2017,937,493,444,111,918,488,430,113.5
32310, 홍천군,050004, 48세,2017,1063,543,520,104.4,1043,536,507,105.7
32310, 홍천군,050005, 49세,2017,1080,558,522,106.9,1063,554,509,108.8
32310, 홍천군,055,50~54세,2017,5564,2934,2630,111.6,5477,2903,2574,112.8
32310, 홍천군,055001, 50세,2017,1016,519,497,104.4,1005,515,490,105.1
32310, 홍천군,055002, 51세,2017,1097,581,516,112.6,1074,572,502,113.9
32310, 홍천군,055003, 52세,2017,1026,533,493,108.1,1001,523,478,109.4
32310, 홍천군,055004, 53세,2017,1193,664,529,125.5,1175,660,515,128.2
32310, 홍천군,055005, 54세,2017,1232,637,595,107.1,1222,633,589,107.5
32310, 홍천군,060,55~59세,2017,7254,3682,3572,103.1,7193,3653,3540,103.2
32310, 홍천군,060001, 55세,2017,1366,704,662,106.3,1355,698,657,106.2
32310, 홍천군,060002, 56세,2017,1624,820,804,102,1616,817,799,102.3
32310, 홍천군,060003, 57세,2017,1389,678,711,95.4,1374,668,706,94.6
32310, 홍천군,060004, 58세,2017,1360,713,647,110.2,1348,709,639,111
32310, 홍천군,060005, 59세,2017,1515,767,748,102.5,1500,761,739,103
32310, 홍천군,065,60~64세,2017,6249,3259,2990,109,6201,3236,2965,109.1
32310, 홍천군,065001, 60세,2017,1495,785,710,110.6,1483,779,704,110.7
32310, 홍천군,065002, 61세,2017,1363,708,655,108.1,1357,705,652,108.1
32310, 홍천군,065003, 62세,2017,1325,708,617,114.7,1312,703,609,115.4
32310, 홍천군,065004, 63세,2017,1129,584,545,107.2,1120,579,541,107
32310, 홍천군,065005, 64세,2017,937,474,463,102.4,929,470,459,102.4
32310, 홍천군,070,65~69세,2017,4041,2084,1957,106.5,4010,2070,1940,106.7
32310, 홍천군,070001, 65세,2017,1237,668,569,117.4,1228,665,563,118.1
32310, 홍천군,070002, 66세,2017,639,326,313,104.2,633,323,310,104.2
32310, 홍천군,070003, 67세,2017,706,354,352,100.6,702,352,350,100.6
32310, 홍천군,070004, 68세,2017,690,361,329,109.7,682,358,324,110.5
32310, 홍천군,070005, 69세,2017,769,375,394,95.2,765,372,393,94.7
32310, 홍천군,075,70~74세,2017,3624,1723,1901,90.6,3605,1715,1890,90.7
32310, 홍천군,075001, 70세,2017,832,422,410,102.9,826,420,406,103.4
32310, 홍천군,075002, 71세,2017,719,344,375,91.7,718,344,374,92
32310, 홍천군,075003, 72세,2017,689,333,356,93.5,686,332,354,93.8
32310, 홍천군,075004, 73세,2017,664,303,361,83.9,661,301,360,83.6
32310, 홍천군,075005, 74세,2017,720,321,399,80.5,714,318,396,80.3
32310, 홍천군,080,75~79세,2017,3686,1601,2085,76.8,3683,1601,2082,76.9
32310, 홍천군,080001, 75세,2017,809,336,473,71,808,336,472,71.2
32310, 홍천군,080002, 76세,2017,780,359,421,85.3,779,359,420,85.5
32310, 홍천군,080003, 77세,2017,706,311,395,78.7,705,311,394,78.9
32310, 홍천군,080004, 78세,2017,719,297,422,70.4,719,297,422,70.4
32310, 홍천군,080005, 79세,2017,672,298,374,79.7,672,298,374,79.7
32310, 홍천군,085,80~84세,2017,2368,856,1512,56.6,2365,854,1511,56.5
32310, 홍천군,085001, 80세,2017,626,257,369,69.6,625,256,369,69.4
32310, 홍천군,085002, 81세,2017,524,217,307,70.7,522,216,306,70.6
32310, 홍천군,085003, 82세,2017,487,162,325,49.8,487,162,325,49.8
32310, 홍천군,085004, 83세,2017,424,125,299,41.8,424,125,299,41.8
32310, 홍천군,085005, 84세,2017,307,95,212,44.8,307,95,212,44.8
32310, 홍천군,090,85~89세,2017,1045,276,769,35.9,1044,276,768,35.9
32310, 홍천군,090001, 85세,2017,264,72,192,37.5,264,72,192,37.5
32310, 홍천군,090002, 86세,2017,229,54,175,30.9,229,54,175,30.9
32310, 홍천군,090003, 87세,2017,251,66,185,35.7,250,66,184,35.9
32310, 홍천군,090004, 88세,2017,163,48,115,41.7,163,48,115,41.7
32310, 홍천군,090005, 89세,2017,138,36,102,35.3,138,36,102,35.3
32310, 홍천군,095,90~94세,2017,385,111,274,40.5,385,111,274,40.5
32310, 홍천군,095001, 90세,2017,108,27,81,33.3,108,27,81,33.3
32310, 홍천군,095002, 91세,2017,90,23,67,34.3,90,23,67,34.3
32310, 홍천군,095003, 92세,2017,84,24,60,40,84,24,60,40
32310, 홍천군,095004, 93세,2017,57,21,36,58.3,57,21,36,58.3
32310, 홍천군,095005, 94세,2017,46,16,30,53.3,46,16,30,53.3
32310, 홍천군,100,95~99세,2017,88,17,71,23.9,88,17,71,23.9
32310, 홍천군,100001, 95세,2017,29,5,24,20.8,29,5,24,20.8
32310, 홍천군,100002, 96세,2017,19,X,15,26.7,19,X,15,26.7
32310, 홍천군,100003, 97세,2017,20,X,17,17.6,20,X,17,17.6
32310, 홍천군,100004, 98세,2017,10,X,7,42.9,10,X,7,42.9
32310, 홍천군,100005, 99세,2017,10,X,8,25,10,X,8,25
32310, 홍천군,101,100세이상,2017,17,X,13,30.8,17,X,13,30.8
32310, 홍천군,102,15세미만,2017,7022,3575,3447,103.7,7014,3570,3444,103.7
32310, 홍천군,103,15~64세,2017,44892,24084,20808,115.7,43684,23343,20341,114.8
32310, 홍천군,104,65세이상,2017,15254,6672,8582,77.7,15197,6648,8549,77.8
32310, 홍천군,086,85세이상,2017,1535,408,1127,36.2,1534,408,1126,36.2
32310, 홍천군,126,평균연령,2017,47.4,45.8,49,,47.6,46,49.1,
32310, 홍천군,127,중위연령,2017,50.7,48.9,52.7,,51.1,49.4,53,
32320, 횡성군,000,합계,2017,43211,21839,21372,102.2,42418,21382,21036,101.6
32320, 횡성군,005,0~4세,2017,1049,512,537,95.3,1046,511,535,95.5
32320, 횡성군,005001, 0세,2017,197,99,98,101,196,99,97,102.1
32320, 횡성군,005002, 1세,2017,191,105,86,122.1,189,104,85,122.4
32320, 횡성군,005003, 2세,2017,236,108,128,84.4,236,108,128,84.4
32320, 횡성군,005004, 3세,2017,207,95,112,84.8,207,95,112,84.8
32320, 횡성군,005005, 4세,2017,218,105,113,92.9,218,105,113,92.9
32320, 횡성군,010,5~9세,2017,1353,705,648,108.8,1351,705,646,109.1
32320, 횡성군,010001, 5세,2017,264,126,138,91.3,264,126,138,91.3
32320, 횡성군,010002, 6세,2017,267,144,123,117.1,267,144,123,117.1
32320, 횡성군,010003, 7세,2017,255,129,126,102.4,254,129,125,103.2
32320, 횡성군,010004, 8세,2017,278,138,140,98.6,278,138,140,98.6
32320, 횡성군,010005, 9세,2017,289,168,121,138.8,288,168,120,140
32320, 횡성군,015,10~14세,2017,1438,752,686,109.6,1435,749,686,109.2
32320, 횡성군,015001, 10세,2017,299,155,144,107.6,298,154,144,106.9
32320, 횡성군,015002, 11세,2017,286,145,141,102.8,285,144,141,102.1
32320, 횡성군,015003, 12세,2017,292,138,154,89.6,292,138,154,89.6
32320, 횡성군,015004, 13세,2017,269,154,115,133.9,269,154,115,133.9
32320, 횡성군,015005, 14세,2017,292,160,132,121.2,291,159,132,120.5
32320, 횡성군,020,15~19세,2017,2241,1203,1038,115.9,2225,1194,1031,115.8
32320, 횡성군,020001, 15세,2017,354,184,170,108.2,354,184,170,108.2
32320, 횡성군,020002, 16세,2017,482,254,228,111.4,480,254,226,112.4
32320, 횡성군,020003, 17세,2017,512,265,247,107.3,511,265,246,107.7
32320, 횡성군,020004, 18세,2017,510,272,238,114.3,508,271,237,114.3
32320, 횡성군,020005, 19세,2017,383,228,155,147.1,372,220,152,144.7
32320, 횡성군,025,20~24세,2017,2171,1236,935,132.2,2050,1154,896,128.8
32320, 횡성군,025001, 20세,2017,451,239,212,112.7,430,225,205,109.8
32320, 횡성군,025002, 21세,2017,493,280,213,131.5,478,268,210,127.6
32320, 횡성군,025003, 22세,2017,416,248,168,147.6,392,232,160,145
32320, 횡성군,025004, 23세,2017,439,254,185,137.3,405,232,173,134.1
32320, 횡성군,025005, 24세,2017,372,215,157,136.9,345,197,148,133.1
32320, 횡성군,030,25~29세,2017,1753,980,773,126.8,1626,897,729,123
32320, 횡성군,030001, 25세,2017,390,215,175,122.9,371,202,169,119.5
32320, 횡성군,030002, 26세,2017,381,216,165,130.9,351,196,155,126.5
32320, 횡성군,030003, 27세,2017,355,201,154,130.5,332,186,146,127.4
32320, 횡성군,030004, 28세,2017,329,191,138,138.4,301,175,126,138.9
32320, 횡성군,030005, 29세,2017,298,157,141,111.3,271,138,133,103.8
32320, 횡성군,035,30~34세,2017,1750,954,796,119.8,1608,864,744,116.1
32320, 횡성군,035001, 30세,2017,343,183,160,114.4,306,160,146,109.6
32320, 횡성군,035002, 31세,2017,308,161,147,109.5,280,146,134,109
32320, 횡성군,035003, 32세,2017,375,217,158,137.3,351,199,152,130.9
32320, 횡성군,035004, 33세,2017,329,185,144,128.5,297,167,130,128.5
32320, 횡성군,035005, 34세,2017,395,208,187,111.2,374,192,182,105.5
32320, 횡성군,040,35~39세,2017,2029,1048,981,106.8,1937,1001,936,106.9
32320, 횡성군,040001, 35세,2017,393,187,206,90.8,374,178,196,90.8
32320, 횡성군,040002, 36세,2017,408,220,188,117,390,211,179,117.9
32320, 횡성군,040003, 37세,2017,410,217,193,112.4,392,205,187,109.6
32320, 횡성군,040004, 38세,2017,415,217,198,109.6,395,205,190,107.9
32320, 횡성군,040005, 39세,2017,403,207,196,105.6,386,202,184,109.8
32320, 횡성군,045,40~44세,2017,2227,1255,972,129.1,2184,1233,951,129.7
32320, 횡성군,045001, 40세,2017,388,230,158,145.6,378,225,153,147.1
32320, 횡성군,045002, 41세,2017,405,238,167,142.5,392,230,162,142
32320, 횡성군,045003, 42세,2017,435,249,186,133.9,426,244,182,134.1
32320, 횡성군,045004, 43세,2017,487,257,230,111.7,485,256,229,111.8
32320, 횡성군,045005, 44세,2017,512,281,231,121.6,503,278,225,123.6
32320, 횡성군,050,45~49세,2017,3081,1647,1434,114.9,3006,1610,1396,115.3
32320, 횡성군,050001, 45세,2017,510,280,230,121.7,497,274,223,122.9
32320, 횡성군,050002, 46세,2017,603,317,286,110.8,588,312,276,113
32320, 횡성군,050003, 47세,2017,611,319,292,109.2,598,311,287,108.4
32320, 횡성군,050004, 48세,2017,695,370,325,113.8,680,364,316,115.2
32320, 횡성군,050005, 49세,2017,662,361,301,119.9,643,349,294,118.7
32320, 횡성군,055,50~54세,2017,3508,1807,1701,106.2,3443,1777,1666,106.7
32320, 횡성군,055001, 50세,2017,656,317,339,93.5,638,310,328,94.5
32320, 횡성군,055002, 51세,2017,674,366,308,118.8,661,359,302,118.9
32320, 횡성군,055003, 52세,2017,717,356,361,98.6,706,348,358,97.2
32320, 횡성군,055004, 53세,2017,687,373,314,118.8,673,367,306,119.9
32320, 횡성군,055005, 54세,2017,774,395,379,104.2,765,393,372,105.6
32320, 횡성군,060,55~59세,2017,4974,2507,2467,101.6,4927,2483,2444,101.6
32320, 횡성군,060001, 55세,2017,890,466,424,109.9,874,458,416,110.1
32320, 횡성군,060002, 56세,2017,998,499,499,100,987,491,496,99
32320, 횡성군,060003, 57세,2017,1091,536,555,96.6,1084,534,550,97.1
32320, 횡성군,060004, 58세,2017,959,489,470,104,951,486,465,104.5
32320, 횡성군,060005, 59세,2017,1036,517,519,99.6,1031,514,517,99.4
32320, 횡성군,065,60~64세,2017,4251,2189,2062,106.2,4223,2176,2047,106.3
32320, 횡성군,065001, 60세,2017,980,513,467,109.9,968,507,461,110
32320, 횡성군,065002, 61세,2017,961,472,489,96.5,956,470,486,96.7
32320, 횡성군,065003, 62세,2017,857,460,397,115.9,852,456,396,115.2
32320, 횡성군,065004, 63세,2017,812,409,403,101.5,808,409,399,102.5
32320, 횡성군,065005, 64세,2017,641,335,306,109.5,639,334,305,109.5
32320, 횡성군,070,65~69세,2017,2996,1537,1459,105.3,2982,1529,1453,105.2
32320, 횡성군,070001, 65세,2017,913,479,434,110.4,910,476,434,109.7
32320, 횡성군,070002, 66세,2017,460,246,214,115,459,245,214,114.5
32320, 횡성군,070003, 67세,2017,524,265,259,102.3,519,262,257,101.9
32320, 횡성군,070004, 68세,2017,524,272,252,107.9,521,272,249,109.2
32320, 횡성군,070005, 69세,2017,575,275,300,91.7,573,274,299,91.6
32320, 횡성군,075,70~74세,2017,2697,1299,1398,92.9,2689,1294,1395,92.8
32320, 횡성군,075001, 70세,2017,625,330,295,111.9,622,329,293,112.3
32320, 횡성군,075002, 71세,2017,500,239,261,91.6,498,238,260,91.5
32320, 횡성군,075003, 72세,2017,517,264,253,104.3,514,261,253,103.2
32320, 횡성군,075004, 73세,2017,525,232,293,79.2,525,232,293,79.2
32320, 횡성군,075005, 74세,2017,530,234,296,79.1,530,234,296,79.1
32320, 횡성군,080,75~79세,2017,2734,1258,1476,85.2,2730,1256,1474,85.2
32320, 횡성군,080001, 75세,2017,603,302,301,100.3,601,302,299,101
32320, 횡성군,080002, 76세,2017,612,282,330,85.5,612,282,330,85.5
32320, 횡성군,080003, 77세,2017,502,238,264,90.2,501,237,264,89.8
32320, 횡성군,080004, 78세,2017,508,202,306,66,507,201,306,65.7
32320, 횡성군,080005, 79세,2017,509,234,275,85.1,509,234,275,85.1
32320, 횡성군,085,80~84세,2017,1726,635,1091,58.2,1724,635,1089,58.3
32320, 횡성군,085001, 80세,2017,458,201,257,78.2,457,201,256,78.5
32320, 횡성군,085002, 81세,2017,401,163,238,68.5,401,163,238,68.5
32320, 횡성군,085003, 82세,2017,336,104,232,44.8,335,104,231,45
32320, 횡성군,085004, 83세,2017,286,92,194,47.4,286,92,194,47.4
32320, 횡성군,085005, 84세,2017,245,75,170,44.1,245,75,170,44.1
32320, 횡성군,090,85~89세,2017,847,226,621,36.4,846,225,621,36.2
32320, 횡성군,090001, 85세,2017,199,49,150,32.7,199,49,150,32.7
32320, 횡성군,090002, 86세,2017,195,60,135,44.4,194,59,135,43.7
32320, 횡성군,090003, 87세,2017,198,48,150,32,198,48,150,32
32320, 횡성군,090004, 88세,2017,140,36,104,34.6,140,36,104,34.6
32320, 횡성군,090005, 89세,2017,115,33,82,40.2,115,33,82,40.2
32320, 횡성군,095,90~94세,2017,305,79,226,35,305,79,226,35
32320, 횡성군,095001, 90세,2017,92,18,74,24.3,92,18,74,24.3
32320, 횡성군,095002, 91세,2017,72,17,55,30.9,72,17,55,30.9
32320, 횡성군,095003, 92세,2017,64,16,48,33.3,64,16,48,33.3
32320, 횡성군,095004, 93세,2017,41,17,24,70.8,41,17,24,70.8
32320, 횡성군,095005, 94세,2017,36,11,25,44,36,11,25,44
32320, 횡성군,100,95~99세,2017,71,10,61,16.4,71,10,61,16.4
32320, 횡성군,100001, 95세,2017,30,6,24,25,30,6,24,25
32320, 횡성군,100002, 96세,2017,20,X,20,0,20,X,20,0
32320, 횡성군,100003, 97세,2017,8,X,8,0,8,X,8,0
32320, 횡성군,100004, 98세,2017,11,X,8,37.5,11,X,8,37.5
32320, 횡성군,100005, 99세,2017,X,X,X,100,X,X,X,100
32320, 횡성군,101,100세이상,2017,10,X,10,0,10,X,10,0
32320, 횡성군,102,15세미만,2017,3840,1969,1871,105.2,3832,1965,1867,105.2
32320, 횡성군,103,15~64세,2017,27985,14826,13159,112.7,27229,14389,12840,112.1
32320, 횡성군,104,65세이상,2017,11386,5044,6342,79.5,11357,5028,6329,79.4
32320, 횡성군,086,85세이상,2017,1233,315,918,34.3,1232,314,918,34.2
32320, 횡성군,126,평균연령,2017,49.5,47.8,51.1,,49.7,48.1,51.3,
32320, 횡성군,127,중위연령,2017,53.7,51.8,55.4,,54.1,52.3,55.7,
32330, 영월군,000,합계,2017,36934,19006,17928,106,36469,18822,17647,106.7
32330, 영월군,005,0~4세,2017,824,435,389,111.8,823,435,388,112.1
32330, 영월군,005001, 0세,2017,146,80,66,121.2,146,80,66,121.2
32330, 영월군,005002, 1세,2017,151,78,73,106.8,151,78,73,106.8
32330, 영월군,005003, 2세,2017,158,83,75,110.7,157,83,74,112.2
32330, 영월군,005004, 3세,2017,195,104,91,114.3,195,104,91,114.3
32330, 영월군,005005, 4세,2017,174,90,84,107.1,174,90,84,107.1
32330, 영월군,010,5~9세,2017,1108,586,522,112.3,1108,586,522,112.3
32330, 영월군,010001, 5세,2017,200,113,87,129.9,200,113,87,129.9
32330, 영월군,010002, 6세,2017,246,124,122,101.6,246,124,122,101.6
32330, 영월군,010003, 7세,2017,221,117,104,112.5,221,117,104,112.5
32330, 영월군,010004, 8세,2017,221,119,102,116.7,221,119,102,116.7
32330, 영월군,010005, 9세,2017,220,113,107,105.6,220,113,107,105.6
32330, 영월군,015,10~14세,2017,1279,681,598,113.9,1277,681,596,114.3
32330, 영월군,015001, 10세,2017,227,115,112,102.7,227,115,112,102.7
32330, 영월군,015002, 11세,2017,268,142,126,112.7,268,142,126,112.7
32330, 영월군,015003, 12세,2017,236,137,99,138.4,235,137,98,139.8
32330, 영월군,015004, 13세,2017,283,147,136,108.1,283,147,136,108.1
32330, 영월군,015005, 14세,2017,265,140,125,112,264,140,124,112.9
32330, 영월군,020,15~19세,2017,1802,1022,780,131,1800,1020,780,130.8
32330, 영월군,020001, 15세,2017,307,162,145,111.7,306,161,145,111
32330, 영월군,020002, 16세,2017,402,216,186,116.1,402,216,186,116.1
32330, 영월군,020003, 17세,2017,387,242,145,166.9,386,241,145,166.2
32330, 영월군,020004, 18세,2017,370,203,167,121.6,370,203,167,121.6
32330, 영월군,020005, 19세,2017,336,199,137,145.3,336,199,137,145.3
32330, 영월군,025,20~24세,2017,1705,1054,651,161.9,1666,1044,622,167.8
32330, 영월군,025001, 20세,2017,414,276,138,200,412,276,136,202.9
32330, 영월군,025002, 21세,2017,385,256,129,198.4,376,253,123,205.7
32330, 영월군,025003, 22세,2017,317,193,124,155.6,309,191,118,161.9
32330, 영월군,025004, 23세,2017,303,173,130,133.1,292,170,122,139.3
32330, 영월군,025005, 24세,2017,286,156,130,120,277,154,123,125.2
32330, 영월군,030,25~29세,2017,1419,798,621,128.5,1333,774,559,138.5
32330, 영월군,030001, 25세,2017,311,165,146,113,293,161,132,122
32330, 영월군,030002, 26세,2017,315,178,137,129.9,294,171,123,139
32330, 영월군,030003, 27세,2017,238,134,104,128.8,214,128,86,148.8
32330, 영월군,030004, 28세,2017,268,151,117,129.1,257,147,110,133.6
32330, 영월군,030005, 29세,2017,287,170,117,145.3,275,167,108,154.6
32330, 영월군,035,30~34세,2017,1365,754,611,123.4,1291,730,561,130.1
32330, 영월군,035001, 30세,2017,250,131,119,110.1,232,125,107,116.8
32330, 영월군,035002, 31세,2017,268,163,105,155.2,254,159,95,167.4
32330, 영월군,035003, 32세,2017,243,131,112,117,228,125,103,121.4
32330, 영월군,035004, 33세,2017,294,159,135,117.8,281,154,127,121.3
32330, 영월군,035005, 34세,2017,310,170,140,121.4,296,167,129,129.5
32330, 영월군,040,35~39세,2017,1719,930,789,117.9,1660,900,760,118.4
32330, 영월군,040001, 35세,2017,366,203,163,124.5,346,192,154,124.7
32330, 영월군,040002, 36세,2017,339,194,145,133.8,332,191,141,135.5
32330, 영월군,040003, 37세,2017,334,168,166,101.2,322,161,161,100
32330, 영월군,040004, 38세,2017,317,160,157,101.9,309,157,152,103.3
32330, 영월군,040005, 39세,2017,363,205,158,129.7,351,199,152,130.9
32330, 영월군,045,40~44세,2017,2198,1189,1009,117.8,2152,1165,987,118
32330, 영월군,045001, 40세,2017,360,192,168,114.3,352,187,165,113.3
32330, 영월군,045002, 41세,2017,407,220,187,117.6,395,212,183,115.8
32330, 영월군,045003, 42세,2017,424,237,187,126.7,417,235,182,129.1
32330, 영월군,045004, 43세,2017,491,247,244,101.2,483,243,240,101.3
32330, 영월군,045005, 44세,2017,516,293,223,131.4,505,288,217,132.7
32330, 영월군,050,45~49세,2017,2880,1603,1277,125.5,2823,1576,1247,126.4
32330, 영월군,050001, 45세,2017,469,257,212,121.2,453,246,207,118.8
32330, 영월군,050002, 46세,2017,614,345,269,128.3,607,341,266,128.2
32330, 영월군,050003, 47세,2017,557,313,244,128.3,542,309,233,132.6
32330, 영월군,050004, 48세,2017,576,315,261,120.7,569,312,257,121.4
32330, 영월군,050005, 49세,2017,664,373,291,128.2,652,368,284,129.6
32330, 영월군,055,50~54세,2017,3118,1705,1413,120.7,3075,1691,1384,122.2
32330, 영월군,055001, 50세,2017,552,315,237,132.9,547,313,234,133.8
32330, 영월군,055002, 51세,2017,666,368,298,123.5,655,365,290,125.9
32330, 영월군,055003, 52세,2017,619,305,314,97.1,609,302,307,98.4
32330, 영월군,055004, 53세,2017,590,328,262,125.2,580,323,257,125.7
32330, 영월군,055005, 54세,2017,691,389,302,128.8,684,388,296,131.1
32330, 영월군,060,55~59세,2017,4106,2139,1967,108.7,4091,2133,1958,108.9
32330, 영월군,060001, 55세,2017,808,436,372,117.2,804,433,371,116.7
32330, 영월군,060002, 56세,2017,793,439,354,124,790,439,351,125.1
32330, 영월군,060003, 57세,2017,866,411,455,90.3,864,410,454,90.3
32330, 영월군,060004, 58세,2017,822,428,394,108.6,819,426,393,108.4
32330, 영월군,060005, 59세,2017,817,425,392,108.4,814,425,389,109.3
32330, 영월군,065,60~64세,2017,3592,1874,1718,109.1,3568,1861,1707,109
32330, 영월군,065001, 60세,2017,797,422,375,112.5,794,422,372,113.4
32330, 영월군,065002, 61세,2017,766,408,358,114,757,402,355,113.2
32330, 영월군,065003, 62세,2017,766,400,366,109.3,762,398,364,109.3
32330, 영월군,065004, 63세,2017,677,356,321,110.9,674,354,320,110.6
32330, 영월군,065005, 64세,2017,586,288,298,96.6,581,285,296,96.3
32330, 영월군,070,65~69세,2017,2754,1350,1404,96.2,2746,1344,1402,95.9
32330, 영월군,070001, 65세,2017,777,411,366,112.3,775,409,366,111.7
32330, 영월군,070002, 66세,2017,457,212,245,86.5,456,211,245,86.1
32330, 영월군,070003, 67세,2017,497,229,268,85.4,495,227,268,84.7
32330, 영월군,070004, 68세,2017,497,244,253,96.4,495,243,252,96.4
32330, 영월군,070005, 69세,2017,526,254,272,93.4,525,254,271,93.7
32330, 영월군,075,70~74세,2017,2344,1090,1254,86.9,2336,1087,1249,87
32330, 영월군,075001, 70세,2017,506,250,256,97.7,503,249,254,98
32330, 영월군,075002, 71세,2017,434,208,226,92,432,207,225,92
32330, 영월군,075003, 72세,2017,458,228,230,99.1,457,228,229,99.6
32330, 영월군,075004, 73세,2017,492,209,283,73.9,492,209,283,73.9
32330, 영월군,075005, 74세,2017,454,195,259,75.3,452,194,258,75.2
32330, 영월군,080,75~79세,2017,2493,1067,1426,74.8,2492,1066,1426,74.8
32330, 영월군,080001, 75세,2017,587,260,327,79.5,587,260,327,79.5
32330, 영월군,080002, 76세,2017,504,215,289,74.4,504,215,289,74.4
32330, 영월군,080003, 77세,2017,513,227,286,79.4,512,226,286,79
32330, 영월군,080004, 78세,2017,458,188,270,69.6,458,188,270,69.6
32330, 영월군,080005, 79세,2017,431,177,254,69.7,431,177,254,69.7
32330, 영월군,085,80~84세,2017,1405,502,903,55.6,1405,502,903,55.6
32330, 영월군,085001, 80세,2017,351,129,222,58.1,351,129,222,58.1
32330, 영월군,085002, 81세,2017,328,139,189,73.5,328,139,189,73.5
32330, 영월군,085003, 82세,2017,277,107,170,62.9,277,107,170,62.9
32330, 영월군,085004, 83세,2017,258,74,184,40.2,258,74,184,40.2
32330, 영월군,085005, 84세,2017,191,53,138,38.4,191,53,138,38.4
32330, 영월군,090,85~89세,2017,569,157,412,38.1,569,157,412,38.1
32330, 영월군,090001, 85세,2017,158,41,117,35,158,41,117,35
32330, 영월군,090002, 86세,2017,127,43,84,51.2,127,43,84,51.2
32330, 영월군,090003, 87세,2017,115,24,91,26.4,115,24,91,26.4
32330, 영월군,090004, 88세,2017,112,35,77,45.5,112,35,77,45.5
32330, 영월군,090005, 89세,2017,57,14,43,32.6,57,14,43,32.6
32330, 영월군,095,90~94세,2017,200,57,143,39.9,200,57,143,39.9
32330, 영월군,095001, 90세,2017,65,18,47,38.3,65,18,47,38.3
32330, 영월군,095002, 91세,2017,39,12,27,44.4,39,12,27,44.4
32330, 영월군,095003, 92세,2017,42,16,26,61.5,42,16,26,61.5
32330, 영월군,095004, 93세,2017,27,8,19,42.1,27,8,19,42.1
32330, 영월군,095005, 94세,2017,27,X,24,12.5,27,X,24,12.5
32330, 영월군,100,95~99세,2017,49,13,36,36.1,49,13,36,36.1
32330, 영월군,100001, 95세,2017,18,6,12,50,18,6,12,50
32330, 영월군,100002, 96세,2017,16,X,13,23.1,16,X,13,23.1
32330, 영월군,100003, 97세,2017,6,X,X,50,6,X,X,50
32330, 영월군,100004, 98세,2017,5,X,X,25,5,X,X,25
32330, 영월군,100005, 99세,2017,X,X,X,33.3,X,X,X,33.3
32330, 영월군,101,100세이상,2017,5,X,5,0,5,X,5,0
32330, 영월군,102,15세미만,2017,3211,1702,1509,112.8,3208,1702,1506,113
32330, 영월군,103,15~64세,2017,23904,13068,10836,120.6,23459,12894,10565,122
32330, 영월군,104,65세이상,2017,9819,4236,5583,75.9,9802,4226,5576,75.8
32330, 영월군,086,85세이상,2017,823,227,596,38.1,823,227,596,38.1
32330, 영월군,126,평균연령,2017,49.7,47.7,51.8,,49.8,47.8,52,
32330, 영월군,127,중위연령,2017,53.6,51.4,55.8,,53.8,51.5,56.1,
32340, 평창군,000,합계,2017,40264,20670,19594,105.5,39715,20404,19311,105.7
32340, 평창군,005,0~4세,2017,1000,497,503,98.8,999,497,502,99
32340, 평창군,005001, 0세,2017,184,93,91,102.2,184,93,91,102.2
32340, 평창군,005002, 1세,2017,185,87,98,88.8,185,87,98,88.8
32340, 평창군,005003, 2세,2017,193,89,104,85.6,193,89,104,85.6
32340, 평창군,005004, 3세,2017,212,103,109,94.5,211,103,108,95.4
32340, 평창군,005005, 4세,2017,226,125,101,123.8,226,125,101,123.8
32340, 평창군,010,5~9세,2017,1342,693,649,106.8,1336,690,646,106.8
32340, 평창군,010001, 5세,2017,255,126,129,97.7,253,125,128,97.7
32340, 평창군,010002, 6세,2017,252,138,114,121.1,251,137,114,120.2
32340, 평창군,010003, 7세,2017,257,135,122,110.7,256,134,122,109.8
32340, 평창군,010004, 8세,2017,270,132,138,95.7,269,132,137,96.4
32340, 평창군,010005, 9세,2017,308,162,146,111,307,162,145,111.7
32340, 평창군,015,10~14세,2017,1478,795,683,116.4,1476,794,682,116.4
32340, 평창군,015001, 10세,2017,297,163,134,121.6,296,162,134,120.9
32340, 평창군,015002, 11세,2017,283,154,129,119.4,283,154,129,119.4
32340, 평창군,015003, 12세,2017,264,146,118,123.7,264,146,118,123.7
32340, 평창군,015004, 13세,2017,305,162,143,113.3,304,162,142,114.1
32340, 평창군,015005, 14세,2017,329,170,159,106.9,329,170,159,106.9
32340, 평창군,020,15~19세,2017,1577,864,713,121.2,1573,863,710,121.5
32340, 평창군,020001, 15세,2017,329,177,152,116.4,328,176,152,115.8
32340, 평창군,020002, 16세,2017,348,188,160,117.5,348,188,160,117.5
32340, 평창군,020003, 17세,2017,400,205,195,105.1,400,205,195,105.1
32340, 평창군,020004, 18세,2017,299,158,141,112.1,299,158,141,112.1
32340, 평창군,020005, 19세,2017,201,136,65,209.2,198,136,62,219.4
32340, 평창군,025,20~24세,2017,1580,956,624,153.2,1511,924,587,157.4
32340, 평창군,025001, 20세,2017,270,177,93,190.3,265,175,90,194.4
32340, 평창군,025002, 21세,2017,332,222,110,201.8,319,215,104,206.7
32340, 평창군,025003, 22세,2017,284,171,113,151.3,274,167,107,156.1
32340, 평창군,025004, 23세,2017,329,193,136,141.9,315,185,130,142.3
32340, 평창군,025005, 24세,2017,365,193,172,112.2,338,182,156,116.7
32340, 평창군,030,25~29세,2017,1758,978,780,125.4,1663,930,733,126.9
32340, 평창군,030001, 25세,2017,391,214,177,120.9,365,203,162,125.3
32340, 평창군,030002, 26세,2017,355,189,166,113.9,337,180,157,114.6
32340, 평창군,030003, 27세,2017,345,198,147,134.7,324,182,142,128.2
32340, 평창군,030004, 28세,2017,346,203,143,142,329,196,133,147.4
32340, 평창군,030005, 29세,2017,321,174,147,118.4,308,169,139,121.6
32340, 평창군,035,30~34세,2017,1679,932,747,124.8,1611,895,716,125
32340, 평창군,035001, 30세,2017,318,183,135,135.6,306,178,128,139.1
32340, 평창군,035002, 31세,2017,348,189,159,118.9,329,179,150,119.3
32340, 평창군,035003, 32세,2017,319,169,150,112.7,301,156,145,107.6
32340, 평창군,035004, 33세,2017,325,173,152,113.8,318,171,147,116.3
32340, 평창군,035005, 34세,2017,369,218,151,144.4,357,211,146,144.5
32340, 평창군,040,35~39세,2017,2181,1183,998,118.5,2117,1149,968,118.7
32340, 평창군,040001, 35세,2017,407,222,185,120,391,214,177,120.9
32340, 평창군,040002, 36세,2017,441,255,186,137.1,428,248,180,137.8
32340, 평창군,040003, 37세,2017,454,244,210,116.2,445,240,205,117.1
32340, 평창군,040004, 38세,2017,451,234,217,107.8,433,224,209,107.2
32340, 평창군,040005, 39세,2017,428,228,200,114,420,223,197,113.2
32340, 평창군,045,40~44세,2017,2588,1419,1169,121.4,2547,1393,1154,120.7
32340, 평창군,045001, 40세,2017,450,223,227,98.2,439,215,224,96
32340, 평창군,045002, 41세,2017,454,272,182,149.5,448,267,181,147.5
32340, 평창군,045003, 42세,2017,514,279,235,118.7,506,276,230,120
32340, 평창군,045004, 43세,2017,553,292,261,111.9,546,287,259,110.8
32340, 평창군,045005, 44세,2017,617,353,264,133.7,608,348,260,133.8
32340, 평창군,050,45~49세,2017,3302,1828,1474,124,3252,1806,1446,124.9
32340, 평창군,050001, 45세,2017,592,338,254,133.1,584,336,248,135.5
32340, 평창군,050002, 46세,2017,615,338,277,122,609,335,274,122.3
32340, 평창군,050003, 47세,2017,648,359,289,124.2,641,356,285,124.9
32340, 평창군,050004, 48세,2017,706,383,323,118.6,692,376,316,119
32340, 평창군,050005, 49세,2017,741,410,331,123.9,726,403,323,124.8
32340, 평창군,055,50~54세,2017,3415,1837,1578,116.4,3362,1815,1547,117.3
32340, 평창군,055001, 50세,2017,646,350,296,118.2,636,348,288,120.8
32340, 평창군,055002, 51세,2017,680,373,307,121.5,666,367,299,122.7
32340, 평창군,055003, 52세,2017,714,394,320,123.1,706,390,316,123.4
32340, 평창군,055004, 53세,2017,655,326,329,99.1,642,320,322,99.4
32340, 평창군,055005, 54세,2017,720,394,326,120.9,712,390,322,121.1
32340, 평창군,060,55~59세,2017,4630,2414,2216,108.9,4597,2401,2196,109.3
32340, 평창군,060001, 55세,2017,896,478,418,114.4,889,476,413,115.3
32340, 평창군,060002, 56세,2017,926,474,452,104.9,920,471,449,104.9
32340, 평창군,060003, 57세,2017,1027,508,519,97.9,1019,504,515,97.9
32340, 평창군,060004, 58세,2017,867,470,397,118.4,863,470,393,119.6
32340, 평창군,060005, 59세,2017,914,484,430,112.6,906,480,426,112.7
32340, 평창군,065,60~64세,2017,3929,2048,1881,108.9,3889,2032,1857,109.4
32340, 평창군,065001, 60세,2017,944,491,453,108.4,937,487,450,108.2
32340, 평창군,065002, 61세,2017,809,424,385,110.1,798,422,376,112.2
32340, 평창군,065003, 62세,2017,870,451,419,107.6,862,448,414,108.2
32340, 평창군,065004, 63세,2017,705,374,331,113,699,370,329,112.5
32340, 평창군,065005, 64세,2017,601,308,293,105.1,593,305,288,105.9
32340, 평창군,070,65~69세,2017,2731,1328,1403,94.7,2719,1323,1396,94.8
32340, 평창군,070001, 65세,2017,799,409,390,104.9,795,408,387,105.4
32340, 평창군,070002, 66세,2017,440,206,234,88,438,204,234,87.2
32340, 평창군,070003, 67세,2017,434,204,230,88.7,434,204,230,88.7
32340, 평창군,070004, 68세,2017,517,245,272,90.1,514,244,270,90.4
32340, 평창군,070005, 69세,2017,541,264,277,95.3,538,263,275,95.6
32340, 평창군,075,70~74세,2017,2427,1133,1294,87.6,2421,1127,1294,87.1
32340, 평창군,075001, 70세,2017,543,267,276,96.7,543,267,276,96.7
32340, 평창군,075002, 71세,2017,444,215,229,93.9,441,212,229,92.6
32340, 평창군,075003, 72세,2017,528,232,296,78.4,525,229,296,77.4
32340, 평창군,075004, 73세,2017,480,211,269,78.4,480,211,269,78.4
32340, 평창군,075005, 74세,2017,432,208,224,92.9,432,208,224,92.9
32340, 평창군,080,75~79세,2017,2413,1048,1365,76.8,2411,1048,1363,76.9
32340, 평창군,080001, 75세,2017,508,226,282,80.1,507,226,281,80.4
32340, 평창군,080002, 76세,2017,517,238,279,85.3,517,238,279,85.3
32340, 평창군,080003, 77세,2017,496,217,279,77.8,496,217,279,77.8
32340, 평창군,080004, 78세,2017,491,207,284,72.9,491,207,284,72.9
32340, 평창군,080005, 79세,2017,401,160,241,66.4,400,160,240,66.7
32340, 평창군,085,80~84세,2017,1345,484,861,56.2,1342,484,858,56.4
32340, 평창군,085001, 80세,2017,371,151,220,68.6,370,151,219,68.9
32340, 평창군,085002, 81세,2017,329,130,199,65.3,328,130,198,65.7
32340, 평창군,085003, 82세,2017,272,90,182,49.5,272,90,182,49.5
32340, 평창군,085004, 83세,2017,192,58,134,43.3,191,58,133,43.6
32340, 평창군,085005, 84세,2017,181,55,126,43.7,181,55,126,43.7
32340, 평창군,090,85~89세,2017,574,143,431,33.2,574,143,431,33.2
32340, 평창군,090001, 85세,2017,153,41,112,36.6,153,41,112,36.6
32340, 평창군,090002, 86세,2017,139,31,108,28.7,139,31,108,28.7
32340, 평창군,090003, 87세,2017,112,28,84,33.3,112,28,84,33.3
32340, 평창군,090004, 88세,2017,104,28,76,36.8,104,28,76,36.8
32340, 평창군,090005, 89세,2017,66,15,51,29.4,66,15,51,29.4
32340, 평창군,095,90~94세,2017,246,67,179,37.4,246,67,179,37.4
32340, 평창군,095001, 90세,2017,59,14,45,31.1,59,14,45,31.1
32340, 평창군,095002, 91세,2017,53,13,40,32.5,53,13,40,32.5
32340, 평창군,095003, 92세,2017,42,8,34,23.5,42,8,34,23.5
32340, 평창군,095004, 93세,2017,58,22,36,61.1,58,22,36,61.1
32340, 평창군,095005, 94세,2017,34,10,24,41.7,34,10,24,41.7
32340, 평창군,100,95~99세,2017,58,18,40,45,58,18,40,45
32340, 평창군,100001, 95세,2017,13,X,9,44.4,13,X,9,44.4
32340, 평창군,100002, 96세,2017,12,X,12,0,12,X,12,0
32340, 평창군,100003, 97세,2017,16,7,9,77.8,16,7,9,77.8
32340, 평창군,100004, 98세,2017,10,5,5,100,10,5,5,100
32340, 평창군,100005, 99세,2017,7,X,5,40,7,X,5,40
32340, 평창군,101,100세이상,2017,11,5,6,83.3,11,5,6,83.3
32340, 평창군,102,15세미만,2017,3820,1985,1835,108.2,3811,1981,1830,108.3
32340, 평창군,103,15~64세,2017,26639,14459,12180,118.7,26122,14208,11914,119.3
32340, 평창군,104,65세이상,2017,9805,4226,5579,75.7,9782,4215,5567,75.7
32340, 평창군,086,85세이상,2017,889,233,656,35.5,889,233,656,35.5
32340, 평창군,126,평균연령,2017,49,47.3,50.8,,49.1,47.4,50.9,
32340, 평창군,127,중위연령,2017,52.4,50.5,54.6,,52.7,50.7,54.9,
32350, 정선군,000,합계,2017,36002,18776,17226,109,35652,18667,16985,109.9
32350, 정선군,005,0~4세,2017,919,488,431,113.2,917,487,430,113.3
32350, 정선군,005001, 0세,2017,162,88,74,118.9,161,87,74,117.6
32350, 정선군,005002, 1세,2017,156,94,62,151.6,156,94,62,151.6
32350, 정선군,005003, 2세,2017,195,105,90,116.7,195,105,90,116.7
32350, 정선군,005004, 3세,2017,197,95,102,93.1,197,95,102,93.1
32350, 정선군,005005, 4세,2017,209,106,103,102.9,208,106,102,103.9
32350, 정선군,010,5~9세,2017,1263,639,624,102.4,1263,639,624,102.4
32350, 정선군,010001, 5세,2017,252,127,125,101.6,252,127,125,101.6
32350, 정선군,010002, 6세,2017,225,114,111,102.7,225,114,111,102.7
32350, 정선군,010003, 7세,2017,267,132,135,97.8,267,132,135,97.8
32350, 정선군,010004, 8세,2017,247,133,114,116.7,247,133,114,116.7
32350, 정선군,010005, 9세,2017,272,133,139,95.7,272,133,139,95.7
32350, 정선군,015,10~14세,2017,1228,628,600,104.7,1227,627,600,104.5
32350, 정선군,015001, 10세,2017,256,127,129,98.4,256,127,129,98.4
32350, 정선군,015002, 11세,2017,235,114,121,94.2,235,114,121,94.2
32350, 정선군,015003, 12세,2017,245,129,116,111.2,244,128,116,110.3
32350, 정선군,015004, 13세,2017,249,133,116,114.7,249,133,116,114.7
32350, 정선군,015005, 14세,2017,243,125,118,105.9,243,125,118,105.9
32350, 정선군,020,15~19세,2017,1409,754,655,115.1,1402,753,649,116
32350, 정선군,020001, 15세,2017,289,151,138,109.4,289,151,138,109.4
32350, 정선군,020002, 16세,2017,314,163,151,107.9,313,162,151,107.3
32350, 정선군,020003, 17세,2017,353,178,175,101.7,353,178,175,101.7
32350, 정선군,020004, 18세,2017,284,157,127,123.6,282,157,125,125.6
32350, 정선군,020005, 19세,2017,169,105,64,164.1,165,105,60,175
32350, 정선군,025,20~24세,2017,1275,791,484,163.4,1236,779,457,170.5
32350, 정선군,025001, 20세,2017,237,161,76,211.8,233,161,72,223.6
32350, 정선군,025002, 21세,2017,256,181,75,241.3,251,179,72,248.6
32350, 정선군,025003, 22세,2017,252,154,98,157.1,245,151,94,160.6
32350, 정선군,025004, 23세,2017,266,140,126,111.1,257,137,120,114.2
32350, 정선군,025005, 24세,2017,264,155,109,142.2,250,151,99,152.5
32350, 정선군,030,25~29세,2017,1566,840,726,115.7,1510,828,682,121.4
32350, 정선군,030001, 25세,2017,269,145,124,116.9,263,145,118,122.9
32350, 정선군,030002, 26세,2017,294,144,150,96,286,143,143,100
32350, 정선군,030003, 27세,2017,324,177,147,120.4,314,174,140,124.3
32350, 정선군,030004, 28세,2017,317,173,144,120.1,307,171,136,125.7
32350, 정선군,030005, 29세,2017,362,201,161,124.8,340,195,145,134.5
32350, 정선군,035,30~34세,2017,1799,1019,780,130.6,1748,1000,748,133.7
32350, 정선군,035001, 30세,2017,339,202,137,147.4,332,199,133,149.6
32350, 정선군,035002, 31세,2017,340,185,155,119.4,332,184,148,124.3
32350, 정선군,035003, 32세,2017,333,212,121,175.2,318,204,114,178.9
32350, 정선군,035004, 33세,2017,371,182,189,96.3,359,179,180,99.4
32350, 정선군,035005, 34세,2017,416,238,178,133.7,407,234,173,135.3
32350, 정선군,040,35~39세,2017,2243,1290,953,135.4,2211,1276,935,136.5
32350, 정선군,040001, 35세,2017,440,247,193,128,431,242,189,128
32350, 정선군,040002, 36세,2017,425,233,192,121.4,419,233,186,125.3
32350, 정선군,040003, 37세,2017,469,278,191,145.5,464,275,189,145.5
32350, 정선군,040004, 38세,2017,480,277,203,136.5,476,275,201,136.8
32350, 정선군,040005, 39세,2017,429,255,174,146.6,421,251,170,147.6
32350, 정선군,045,40~44세,2017,2414,1425,989,144.1,2392,1420,972,146.1
32350, 정선군,045001, 40세,2017,441,270,171,157.9,437,269,168,160.1
32350, 정선군,045002, 41세,2017,460,261,199,131.2,455,260,195,133.3
32350, 정선군,045003, 42세,2017,469,281,188,149.5,464,280,184,152.2
32350, 정선군,045004, 43세,2017,548,318,230,138.3,542,316,226,139.8
32350, 정선군,045005, 44세,2017,496,295,201,146.8,494,295,199,148.2
32350, 정선군,050,45~49세,2017,2829,1661,1168,142.2,2781,1650,1131,145.9
32350, 정선군,050001, 45세,2017,489,287,202,142.1,484,286,198,144.4
32350, 정선군,050002, 46세,2017,582,341,241,141.5,572,338,234,144.4
32350, 정선군,050003, 47세,2017,508,300,208,144.2,496,298,198,150.5
32350, 정선군,050004, 48세,2017,595,345,250,138,586,344,242,142.1
32350, 정선군,050005, 49세,2017,655,388,267,145.3,643,384,259,148.3
32350, 정선군,055,50~54세,2017,2987,1670,1317,126.8,2961,1659,1302,127.4
32350, 정선군,055001, 50세,2017,589,330,259,127.4,585,327,258,126.7
32350, 정선군,055002, 51세,2017,590,329,261,126.1,585,327,258,126.7
32350, 정선군,055003, 52세,2017,555,294,261,112.6,551,294,257,114.4
32350, 정선군,055004, 53세,2017,578,322,256,125.8,570,320,250,128
32350, 정선군,055005, 54세,2017,675,395,280,141.1,670,391,279,140.1
32350, 정선군,060,55~59세,2017,4054,2106,1948,108.1,4020,2099,1921,109.3
32350, 정선군,060001, 55세,2017,743,403,340,118.5,730,400,330,121.2
32350, 정선군,060002, 56세,2017,834,422,412,102.4,829,421,408,103.2
32350, 정선군,060003, 57세,2017,894,452,442,102.3,887,450,437,103
32350, 정선군,060004, 58세,2017,781,404,377,107.2,774,403,371,108.6
32350, 정선군,060005, 59세,2017,802,425,377,112.7,800,425,375,113.3
32350, 정선군,065,60~64세,2017,3362,1794,1568,114.4,3346,1785,1561,114.3
32350, 정선군,065001, 60세,2017,794,414,380,108.9,789,412,377,109.3
32350, 정선군,065002, 61세,2017,743,410,333,123.1,740,408,332,122.9
32350, 정선군,065003, 62세,2017,702,383,319,120.1,698,380,318,119.5
32350, 정선군,065004, 63세,2017,601,318,283,112.4,598,317,281,112.8
32350, 정선군,065005, 64세,2017,522,269,253,106.3,521,268,253,105.9
32350, 정선군,070,65~69세,2017,2507,1209,1298,93.1,2497,1204,1293,93.1
32350, 정선군,070001, 65세,2017,652,313,339,92.3,651,313,338,92.6
32350, 정선군,070002, 66세,2017,441,216,225,96,438,215,223,96.4
32350, 정선군,070003, 67세,2017,450,188,262,71.8,449,187,262,71.4
32350, 정선군,070004, 68세,2017,473,244,229,106.6,470,242,228,106.1
32350, 정선군,070005, 69세,2017,491,248,243,102.1,489,247,242,102.1
32350, 정선군,075,70~74세,2017,2212,1026,1186,86.5,2208,1025,1183,86.6
32350, 정선군,075001, 70세,2017,451,209,242,86.4,450,209,241,86.7
32350, 정선군,075002, 71세,2017,390,201,189,106.3,389,201,188,106.9
32350, 정선군,075003, 72세,2017,453,209,244,85.7,451,208,243,85.6
32350, 정선군,075004, 73세,2017,443,203,240,84.6,443,203,240,84.6
32350, 정선군,075005, 74세,2017,475,204,271,75.3,475,204,271,75.3
32350, 정선군,080,75~79세,2017,2059,876,1183,74,2058,876,1182,74.1
32350, 정선군,080001, 75세,2017,502,229,273,83.9,502,229,273,83.9
32350, 정선군,080002, 76세,2017,419,179,240,74.6,418,179,239,74.9
32350, 정선군,080003, 77세,2017,448,188,260,72.3,448,188,260,72.3
32350, 정선군,080004, 78세,2017,382,163,219,74.4,382,163,219,74.4
32350, 정선군,080005, 79세,2017,308,117,191,61.3,308,117,191,61.3
32350, 정선군,085,80~84세,2017,1130,388,742,52.3,1130,388,742,52.3
32350, 정선군,085001, 80세,2017,279,104,175,59.4,279,104,175,59.4
32350, 정선군,085002, 81세,2017,244,87,157,55.4,244,87,157,55.4
32350, 정선군,085003, 82세,2017,232,82,150,54.7,232,82,150,54.7
32350, 정선군,085004, 83세,2017,211,72,139,51.8,211,72,139,51.8
32350, 정선군,085005, 84세,2017,164,43,121,35.5,164,43,121,35.5
32350, 정선군,090,85~89세,2017,490,119,371,32.1,490,119,371,32.1
32350, 정선군,090001, 85세,2017,153,41,112,36.6,153,41,112,36.6
32350, 정선군,090002, 86세,2017,91,23,68,33.8,91,23,68,33.8
32350, 정선군,090003, 87세,2017,105,26,79,32.9,105,26,79,32.9
32350, 정선군,090004, 88세,2017,82,16,66,24.2,82,16,66,24.2
32350, 정선군,090005, 89세,2017,59,13,46,28.3,59,13,46,28.3
32350, 정선군,095,90~94세,2017,217,44,173,25.4,216,44,172,25.6
32350, 정선군,095001, 90세,2017,54,6,48,12.5,54,6,48,12.5
32350, 정선군,095002, 91세,2017,46,11,35,31.4,46,11,35,31.4
32350, 정선군,095003, 92세,2017,38,10,28,35.7,38,10,28,35.7
32350, 정선군,095004, 93세,2017,42,9,33,27.3,42,9,33,27.3
32350, 정선군,095005, 94세,2017,37,8,29,27.6,36,8,28,28.6
32350, 정선군,100,95~99세,2017,33,8,25,32,33,8,25,32
32350, 정선군,100001, 95세,2017,11,X,10,10,11,X,10,10
32350, 정선군,100002, 96세,2017,7,X,5,40,7,X,5,40
32350, 정선군,100003, 97세,2017,7,X,5,40,7,X,5,40
32350, 정선군,100004, 98세,2017,5,X,X,150,5,X,X,150
32350, 정선군,100005, 99세,2017,X,X,X,0,X,X,X,0
32350, 정선군,101,100세이상,2017,6,X,5,20,6,X,5,20
32350, 정선군,102,15세미만,2017,3410,1755,1655,106,3407,1753,1654,106
32350, 정선군,103,15~64세,2017,23938,13350,10588,126.1,23607,13249,10358,127.9
32350, 정선군,104,65세이상,2017,8654,3671,4983,73.7,8638,3665,4973,73.7
32350, 정선군,086,85세이상,2017,746,172,574,30,745,172,573,30
32350, 정선군,126,평균연령,2017,48.7,46.9,50.6,,48.7,46.9,50.7,
32350, 정선군,127,중위연령,2017,51.8,49.6,54.6,,51.9,49.7,54.9,
32360, 철원군,000,합계,2017,44770,23792,20978,113.4,43831,23202,20629,112.5
32360, 철원군,005,0~4세,2017,1769,892,877,101.7,1769,892,877,101.7
32360, 철원군,005001, 0세,2017,361,186,175,106.3,361,186,175,106.3
32360, 철원군,005002, 1세,2017,360,180,180,100,360,180,180,100
32360, 철원군,005003, 2세,2017,358,182,176,103.4,358,182,176,103.4
32360, 철원군,005004, 3세,2017,354,172,182,94.5,354,172,182,94.5
32360, 철원군,005005, 4세,2017,336,172,164,104.9,336,172,164,104.9
32360, 철원군,010,5~9세,2017,1855,967,888,108.9,1855,967,888,108.9
32360, 철원군,010001, 5세,2017,376,182,194,93.8,376,182,194,93.8
32360, 철원군,010002, 6세,2017,373,203,170,119.4,373,203,170,119.4
32360, 철원군,010003, 7세,2017,361,197,164,120.1,361,197,164,120.1
32360, 철원군,010004, 8세,2017,342,171,171,100,342,171,171,100
32360, 철원군,010005, 9세,2017,403,214,189,113.2,403,214,189,113.2
32360, 철원군,015,10~14세,2017,1927,997,930,107.2,1927,997,930,107.2
32360, 철원군,015001, 10세,2017,375,196,179,109.5,375,196,179,109.5
32360, 철원군,015002, 11세,2017,412,213,199,107,412,213,199,107
32360, 철원군,015003, 12세,2017,368,194,174,111.5,368,194,174,111.5
32360, 철원군,015004, 13세,2017,389,210,179,117.3,389,210,179,117.3
32360, 철원군,015005, 14세,2017,383,184,199,92.5,383,184,199,92.5
32360, 철원군,020,15~19세,2017,2130,1147,983,116.7,2127,1144,983,116.4
32360, 철원군,020001, 15세,2017,425,208,217,95.9,425,208,217,95.9
32360, 철원군,020002, 16세,2017,476,252,224,112.5,474,250,224,111.6
32360, 철원군,020003, 17세,2017,496,281,215,130.7,496,281,215,130.7
32360, 철원군,020004, 18세,2017,436,233,203,114.8,436,233,203,114.8
32360, 철원군,020005, 19세,2017,297,173,124,139.5,296,172,124,138.7
32360, 철원군,025,20~24세,2017,3069,2229,840,265.4,2795,2007,788,254.7
32360, 철원군,025001, 20세,2017,382,247,135,183,361,229,132,173.5
32360, 철원군,025002, 21세,2017,475,346,129,268.2,416,293,123,238.2
32360, 철원군,025003, 22세,2017,633,456,177,257.6,553,386,167,231.1
32360, 철원군,025004, 23세,2017,764,566,198,285.9,714,527,187,281.8
32360, 철원군,025005, 24세,2017,815,614,201,305.5,751,572,179,319.6
32360, 철원군,030,25~29세,2017,3376,2320,1056,219.7,3184,2177,1007,216.2
32360, 철원군,030001, 25세,2017,877,670,207,323.7,829,628,201,312.4
32360, 철원군,030002, 26세,2017,769,533,236,225.8,728,503,225,223.6
32360, 철원군,030003, 27세,2017,626,424,202,209.9,590,401,189,212.2
32360, 철원군,030004, 28세,2017,576,365,211,173,538,340,198,171.7
32360, 철원군,030005, 29세,2017,528,328,200,164,499,305,194,157.2
32360, 철원군,035,30~34세,2017,2478,1418,1060,133.8,2321,1334,987,135.2
32360, 철원군,035001, 30세,2017,508,316,192,164.6,466,294,172,170.9
32360, 철원군,035002, 31세,2017,485,279,206,135.4,450,266,184,144.6
32360, 철원군,035003, 32세,2017,476,274,202,135.6,456,261,195,133.8
32360, 철원군,035004, 33세,2017,477,252,225,112,441,230,211,109
32360, 철원군,035005, 34세,2017,532,297,235,126.4,508,283,225,125.8
32360, 철원군,040,35~39세,2017,2714,1405,1309,107.3,2601,1348,1253,107.6
32360, 철원군,040001, 35세,2017,539,298,241,123.7,516,284,232,122.4
32360, 철원군,040002, 36세,2017,577,305,272,112.1,554,292,262,111.5
32360, 철원군,040003, 37세,2017,550,272,278,97.8,518,257,261,98.5
32360, 철원군,040004, 38세,2017,503,258,245,105.3,482,250,232,107.8
32360, 철원군,040005, 39세,2017,545,272,273,99.6,531,265,266,99.6
32360, 철원군,045,40~44세,2017,2887,1558,1329,117.2,2836,1530,1306,117.2
32360, 철원군,045001, 40세,2017,570,301,269,111.9,554,290,264,109.8
32360, 철원군,045002, 41세,2017,516,291,225,129.3,501,282,219,128.8
32360, 철원군,045003, 42세,2017,526,286,240,119.2,521,283,238,118.9
32360, 철원군,045004, 43세,2017,643,349,294,118.7,634,346,288,120.1
32360, 철원군,045005, 44세,2017,632,331,301,110,626,329,297,110.8
32360, 철원군,050,45~49세,2017,3241,1752,1489,117.7,3198,1731,1467,118
32360, 철원군,050001, 45세,2017,664,374,290,129,661,373,288,129.5
32360, 철원군,050002, 46세,2017,630,334,296,112.8,622,329,293,112.3
32360, 철원군,050003, 47세,2017,620,342,278,123,610,336,274,122.6
32360, 철원군,050004, 48세,2017,644,343,301,114,628,337,291,115.8
32360, 철원군,050005, 49세,2017,683,359,324,110.8,677,356,321,110.9
32360, 철원군,055,50~54세,2017,3381,1783,1598,111.6,3350,1775,1575,112.7
32360, 철원군,055001, 50세,2017,633,339,294,115.3,627,339,288,117.7
32360, 철원군,055002, 51세,2017,693,377,316,119.3,687,372,315,118.1
32360, 철원군,055003, 52세,2017,659,334,325,102.8,651,332,319,104.1
32360, 철원군,055004, 53세,2017,640,341,299,114,634,340,294,115.6
32360, 철원군,055005, 54세,2017,756,392,364,107.7,751,392,359,109.2
32360, 철원군,060,55~59세,2017,3855,2021,1834,110.2,3827,2013,1814,111
32360, 철원군,060001, 55세,2017,728,393,335,117.3,720,391,329,118.8
32360, 철원군,060002, 56세,2017,831,449,382,117.5,826,449,377,119.1
32360, 철원군,060003, 57세,2017,824,428,396,108.1,820,426,394,108.1
32360, 철원군,060004, 58세,2017,715,369,346,106.6,709,367,342,107.3
32360, 철원군,060005, 59세,2017,757,382,375,101.9,752,380,372,102.2
32360, 철원군,065,60~64세,2017,3243,1602,1641,97.6,3225,1594,1631,97.7
32360, 철원군,065001, 60세,2017,730,388,342,113.5,725,386,339,113.9
32360, 철원군,065002, 61세,2017,662,319,343,93,658,317,341,93
32360, 철원군,065003, 62세,2017,690,346,344,100.6,687,345,342,100.9
32360, 철원군,065004, 63세,2017,664,331,333,99.4,661,328,333,98.5
32360, 철원군,065005, 64세,2017,497,218,279,78.1,494,218,276,79
32360, 철원군,070,65~69세,2017,2209,996,1213,82.1,2192,993,1199,82.8
32360, 철원군,070001, 65세,2017,458,190,268,70.9,453,189,264,71.6
32360, 철원군,070002, 66세,2017,350,164,186,88.2,347,164,183,89.6
32360, 철원군,070003, 67세,2017,423,196,227,86.3,419,195,224,87.1
32360, 철원군,070004, 68세,2017,505,236,269,87.7,504,236,268,88.1
32360, 철원군,070005, 69세,2017,473,210,263,79.8,469,209,260,80.4
32360, 철원군,075,70~74세,2017,2446,1110,1336,83.1,2439,1106,1333,83
32360, 철원군,075001, 70세,2017,502,238,264,90.2,502,238,264,90.2
32360, 철원군,075002, 71세,2017,425,202,223,90.6,421,200,221,90.5
32360, 철원군,075003, 72세,2017,542,258,284,90.8,540,257,283,90.8
32360, 철원군,075004, 73세,2017,478,197,281,70.1,478,197,281,70.1
32360, 철원군,075005, 74세,2017,499,215,284,75.7,498,214,284,75.4
32360, 철원군,080,75~79세,2017,2255,957,1298,73.7,2253,956,1297,73.7
32360, 철원군,080001, 75세,2017,526,231,295,78.3,525,230,295,78
32360, 철원군,080002, 76세,2017,491,212,279,76,490,212,278,76.3
32360, 철원군,080003, 77세,2017,442,187,255,73.3,442,187,255,73.3
32360, 철원군,080004, 78세,2017,434,174,260,66.9,434,174,260,66.9
32360, 철원군,080005, 79세,2017,362,153,209,73.2,362,153,209,73.2
32360, 철원군,085,80~84세,2017,1128,399,729,54.7,1127,399,728,54.8
32360, 철원군,085001, 80세,2017,337,133,204,65.2,336,133,203,65.5
32360, 철원군,085002, 81세,2017,238,87,151,57.6,238,87,151,57.6
32360, 철원군,085003, 82세,2017,217,73,144,50.7,217,73,144,50.7
32360, 철원군,085004, 83세,2017,168,52,116,44.8,168,52,116,44.8
32360, 철원군,085005, 84세,2017,168,54,114,47.4,168,54,114,47.4
32360, 철원군,090,85~89세,2017,548,159,389,40.9,547,159,388,41
32360, 철원군,090001, 85세,2017,130,55,75,73.3,130,55,75,73.3
32360, 철원군,090002, 86세,2017,101,31,70,44.3,101,31,70,44.3
32360, 철원군,090003, 87세,2017,113,34,79,43,112,34,78,43.6
32360, 철원군,090004, 88세,2017,110,20,90,22.2,110,20,90,22.2
32360, 철원군,090005, 89세,2017,94,19,75,25.3,94,19,75,25.3
32360, 철원군,095,90~94세,2017,201,58,143,40.6,201,58,143,40.6
32360, 철원군,095001, 90세,2017,71,19,52,36.5,71,19,52,36.5
32360, 철원군,095002, 91세,2017,43,10,33,30.3,43,10,33,30.3
32360, 철원군,095003, 92세,2017,37,10,27,37,37,10,27,37
32360, 철원군,095004, 93세,2017,25,7,18,38.9,25,7,18,38.9
32360, 철원군,095005, 94세,2017,25,12,13,92.3,25,12,13,92.3
32360, 철원군,100,95~99세,2017,51,20,31,64.5,50,20,30,66.7
32360, 철원군,100001, 95세,2017,21,10,11,90.9,21,10,11,90.9
32360, 철원군,100002, 96세,2017,12,X,9,33.3,12,X,9,33.3
32360, 철원군,100003, 97세,2017,5,X,X,66.7,5,X,X,66.7
32360, 철원군,100004, 98세,2017,8,X,X,100,7,X,X,133.3
32360, 철원군,100005, 99세,2017,5,X,X,25,5,X,X,25
32360, 철원군,101,100세이상,2017,7,X,5,40,7,X,5,40
32360, 철원군,102,15세미만,2017,5551,2856,2695,106,5551,2856,2695,106
32360, 철원군,103,15~64세,2017,30374,17235,13139,131.2,29464,16653,12811,130
32360, 철원군,104,65세이상,2017,8845,3701,5144,71.9,8816,3693,5123,72.1
32360, 철원군,086,85세이상,2017,807,239,568,42.1,805,239,566,42.2
32360, 철원군,126,평균연령,2017,44,41.6,46.6,,44.2,41.9,46.8,
32360, 철원군,127,중위연령,2017,45.3,41.8,49.2,,45.8,42.6,49.5,
32370, 화천군,000,합계,2017,24625,13589,11036,123.1,24322,13441,10881,123.5
32370, 화천군,005,0~4세,2017,1120,597,523,114.1,1119,597,522,114.4
32370, 화천군,005001, 0세,2017,212,116,96,120.8,212,116,96,120.8
32370, 화천군,005002, 1세,2017,225,114,111,102.7,225,114,111,102.7
32370, 화천군,005003, 2세,2017,242,129,113,114.2,242,129,113,114.2
32370, 화천군,005004, 3세,2017,232,130,102,127.5,232,130,102,127.5
32370, 화천군,005005, 4세,2017,209,108,101,106.9,208,108,100,108
32370, 화천군,010,5~9세,2017,990,485,505,96,990,485,505,96
32370, 화천군,010001, 5세,2017,215,101,114,88.6,215,101,114,88.6
32370, 화천군,010002, 6세,2017,201,107,94,113.8,201,107,94,113.8
32370, 화천군,010003, 7세,2017,196,99,97,102.1,196,99,97,102.1
32370, 화천군,010004, 8세,2017,194,85,109,78,194,85,109,78
32370, 화천군,010005, 9세,2017,184,93,91,102.2,184,93,91,102.2
32370, 화천군,015,10~14세,2017,901,458,443,103.4,901,458,443,103.4
32370, 화천군,015001, 10세,2017,198,98,100,98,198,98,100,98
32370, 화천군,015002, 11세,2017,191,98,93,105.4,191,98,93,105.4
32370, 화천군,015003, 12세,2017,159,85,74,114.9,159,85,74,114.9
32370, 화천군,015004, 13세,2017,192,89,103,86.4,192,89,103,86.4
32370, 화천군,015005, 14세,2017,161,88,73,120.5,161,88,73,120.5
32370, 화천군,020,15~19세,2017,976,528,448,117.9,973,526,447,117.7
32370, 화천군,020001, 15세,2017,205,93,112,83,205,93,112,83
32370, 화천군,020002, 16세,2017,210,111,99,112.1,210,111,99,112.1
32370, 화천군,020003, 17세,2017,230,122,108,113,229,122,107,114
32370, 화천군,020004, 18세,2017,194,112,82,136.6,194,112,82,136.6
32370, 화천군,020005, 19세,2017,137,90,47,191.5,135,88,47,187.2
32370, 화천군,025,20~24세,2017,2061,1579,482,327.6,2015,1547,468,330.6
32370, 화천군,025001, 20세,2017,206,138,68,202.9,203,135,68,198.5
32370, 화천군,025002, 21세,2017,247,171,76,225,242,168,74,227
32370, 화천군,025003, 22세,2017,347,262,85,308.2,339,256,83,308.4
32370, 화천군,025004, 23세,2017,586,450,136,330.9,573,441,132,334.1
32370, 화천군,025005, 24세,2017,675,558,117,476.9,658,547,111,492.8
32370, 화천군,030,25~29세,2017,2260,1621,639,253.7,2197,1591,606,262.5
32370, 화천군,030001, 25세,2017,604,469,135,347.4,586,457,129,354.3
32370, 화천군,030002, 26세,2017,506,381,125,304.8,489,376,113,332.7
32370, 화천군,030003, 27세,2017,428,293,135,217,419,288,131,219.8
32370, 화천군,030004, 28세,2017,364,253,111,227.9,356,248,108,229.6
32370, 화천군,030005, 29세,2017,358,225,133,169.2,347,222,125,177.6
32370, 화천군,035,30~34세,2017,1602,932,670,139.1,1558,912,646,141.2
32370, 화천군,035001, 30세,2017,343,210,133,157.9,330,205,125,164
32370, 화천군,035002, 31세,2017,361,222,139,159.7,354,218,136,160.3
32370, 화천군,035003, 32세,2017,312,177,135,131.1,304,173,131,132.1
32370, 화천군,035004, 33세,2017,294,165,129,127.9,288,164,124,132.3
32370, 화천군,035005, 34세,2017,292,158,134,117.9,282,152,130,116.9
32370, 화천군,040,35~39세,2017,1418,789,629,125.4,1373,766,607,126.2
32370, 화천군,040001, 35세,2017,305,168,137,122.6,299,166,133,124.8
32370, 화천군,040002, 36세,2017,308,163,145,112.4,294,157,137,114.6
32370, 화천군,040003, 37세,2017,278,140,138,101.4,268,135,133,101.5
32370, 화천군,040004, 38세,2017,285,169,116,145.7,276,162,114,142.1
32370, 화천군,040005, 39세,2017,242,149,93,160.2,236,146,90,162.2
32370, 화천군,045,40~44세,2017,1372,738,634,116.4,1351,726,625,116.2
32370, 화천군,045001, 40세,2017,271,140,131,106.9,269,138,131,105.3
32370, 화천군,045002, 41세,2017,277,149,128,116.4,271,147,124,118.5
32370, 화천군,045003, 42세,2017,268,156,112,139.3,262,152,110,138.2
32370, 화천군,045004, 43세,2017,267,143,124,115.3,262,140,122,114.8
32370, 화천군,045005, 44세,2017,289,150,139,107.9,287,149,138,108
32370, 화천군,050,45~49세,2017,1608,886,722,122.7,1590,877,713,123
32370, 화천군,050001, 45세,2017,301,167,134,124.6,296,164,132,124.2
32370, 화천군,050002, 46세,2017,302,167,135,123.7,297,165,132,125
32370, 화천군,050003, 47세,2017,303,171,132,129.5,303,171,132,129.5
32370, 화천군,050004, 48세,2017,365,202,163,123.9,359,199,160,124.4
32370, 화천군,050005, 49세,2017,337,179,158,113.3,335,178,157,113.4
32370, 화천군,055,50~54세,2017,1727,934,793,117.8,1705,926,779,118.9
32370, 화천군,055001, 50세,2017,314,173,141,122.7,311,172,139,123.7
32370, 화천군,055002, 51세,2017,342,190,152,125,334,186,148,125.7
32370, 화천군,055003, 52세,2017,345,192,153,125.5,340,190,150,126.7
32370, 화천군,055004, 53세,2017,385,200,185,108.1,382,199,183,108.7
32370, 화천군,055005, 54세,2017,341,179,162,110.5,338,179,159,112.6
32370, 화천군,060,55~59세,2017,2101,1145,956,119.8,2078,1139,939,121.3
32370, 화천군,060001, 55세,2017,386,226,160,141.3,382,226,156,144.9
32370, 화천군,060002, 56세,2017,485,264,221,119.5,481,262,219,119.6
32370, 화천군,060003, 57세,2017,442,229,213,107.5,438,228,210,108.6
32370, 화천군,060004, 58세,2017,403,218,185,117.8,398,217,181,119.9
32370, 화천군,060005, 59세,2017,385,208,177,117.5,379,206,173,119.1
32370, 화천군,065,60~64세,2017,1756,931,825,112.8,1748,927,821,112.9
32370, 화천군,065001, 60세,2017,407,213,194,109.8,404,212,192,110.4
32370, 화천군,065002, 61세,2017,359,192,167,115,358,191,167,114.4
32370, 화천군,065003, 62세,2017,373,198,175,113.1,371,197,174,113.2
32370, 화천군,065004, 63세,2017,342,182,160,113.8,341,181,160,113.1
32370, 화천군,065005, 64세,2017,275,146,129,113.2,274,146,128,114.1
32370, 화천군,070,65~69세,2017,1089,503,586,85.8,1086,502,584,86
32370, 화천군,070001, 65세,2017,276,141,135,104.4,275,141,134,105.2
32370, 화천군,070002, 66세,2017,155,72,83,86.7,155,72,83,86.7
32370, 화천군,070003, 67세,2017,204,90,114,78.9,204,90,114,78.9
32370, 화천군,070004, 68세,2017,218,88,130,67.7,216,87,129,67.4
32370, 화천군,070005, 69세,2017,236,112,124,90.3,236,112,124,90.3
32370, 화천군,075,70~74세,2017,1208,567,641,88.5,1206,566,640,88.4
32370, 화천군,075001, 70세,2017,249,119,130,91.5,248,118,130,90.8
32370, 화천군,075002, 71세,2017,230,115,115,100,229,115,114,100.9
32370, 화천군,075003, 72세,2017,222,84,138,60.9,222,84,138,60.9
32370, 화천군,075004, 73세,2017,230,119,111,107.2,230,119,111,107.2
32370, 화천군,075005, 74세,2017,277,130,147,88.4,277,130,147,88.4
32370, 화천군,080,75~79세,2017,1306,516,790,65.3,1305,516,789,65.4
32370, 화천군,080001, 75세,2017,292,123,169,72.8,292,123,169,72.8
32370, 화천군,080002, 76세,2017,300,118,182,64.8,299,118,181,65.2
32370, 화천군,080003, 77세,2017,252,95,157,60.5,252,95,157,60.5
32370, 화천군,080004, 78세,2017,249,107,142,75.4,249,107,142,75.4
32370, 화천군,080005, 79세,2017,213,73,140,52.1,213,73,140,52.1
32370, 화천군,085,80~84세,2017,675,246,429,57.3,674,246,428,57.5
32370, 화천군,085001, 80세,2017,198,80,118,67.8,197,80,117,68.4
32370, 화천군,085002, 81세,2017,149,48,101,47.5,149,48,101,47.5
32370, 화천군,085003, 82세,2017,123,36,87,41.4,123,36,87,41.4
32370, 화천군,085004, 83세,2017,114,44,70,62.9,114,44,70,62.9
32370, 화천군,085005, 84세,2017,91,38,53,71.7,91,38,53,71.7
32370, 화천군,090,85~89세,2017,310,88,222,39.6,309,88,221,39.8
32370, 화천군,090001, 85세,2017,79,25,54,46.3,79,25,54,46.3
32370, 화천군,090002, 86세,2017,60,21,39,53.8,60,21,39,53.8
32370, 화천군,090003, 87세,2017,78,24,54,44.4,77,24,53,45.3
32370, 화천군,090004, 88세,2017,48,12,36,33.3,48,12,36,33.3
32370, 화천군,090005, 89세,2017,45,6,39,15.4,45,6,39,15.4
32370, 화천군,095,90~94세,2017,113,37,76,48.7,113,37,76,48.7
32370, 화천군,095001, 90세,2017,29,9,20,45,29,9,20,45
32370, 화천군,095002, 91세,2017,19,6,13,46.2,19,6,13,46.2
32370, 화천군,095003, 92세,2017,25,8,17,47.1,25,8,17,47.1
32370, 화천군,095004, 93세,2017,17,5,12,41.7,17,5,12,41.7
32370, 화천군,095005, 94세,2017,23,9,14,64.3,23,9,14,64.3
32370, 화천군,100,95~99세,2017,29,9,20,45,28,9,19,47.4
32370, 화천군,100001, 95세,2017,14,6,8,75,14,6,8,75
32370, 화천군,100002, 96세,2017,8,X,7,14.3,8,X,7,14.3
32370, 화천군,100003, 97세,2017,X,X,X,0,X,X,X,0
32370, 화천군,100004, 98세,2017,X,X,X,0,X,X,X,0
32370, 화천군,100005, 99세,2017,X,X,X,,X,X,X,
32370, 화천군,101,100세이상,2017,X,X,X,0,X,X,X,0
32370, 화천군,102,15세미만,2017,3011,1540,1471,104.7,3010,1540,1470,104.8
32370, 화천군,103,15~64세,2017,16881,10083,6798,148.3,16588,9937,6651,149.4
32370, 화천군,104,65세이상,2017,4733,1966,2767,71.1,4724,1964,2760,71.2
32370, 화천군,086,85세이상,2017,455,134,321,41.7,453,134,319,42
32370, 화천군,126,평균연령,2017,43.3,40.7,46.4,,43.4,40.8,46.5,
32370, 화천군,127,중위연령,2017,43.6,38.7,48.9,,43.9,38.9,49.1,
32380, 양구군,000,합계,2017,22355,11971,10384,115.3,22002,11836,10166,116.4
32380, 양구군,005,0~4세,2017,984,477,507,94.1,983,476,507,93.9
32380, 양구군,005001, 0세,2017,202,92,110,83.6,202,92,110,83.6
32380, 양구군,005002, 1세,2017,209,101,108,93.5,209,101,108,93.5
32380, 양구군,005003, 2세,2017,220,114,106,107.5,220,114,106,107.5
32380, 양구군,005004, 3세,2017,172,86,86,100,171,85,86,98.8
32380, 양구군,005005, 4세,2017,181,84,97,86.6,181,84,97,86.6
32380, 양구군,010,5~9세,2017,967,506,461,109.8,966,506,460,110
32380, 양구군,010001, 5세,2017,222,116,106,109.4,221,116,105,110.5
32380, 양구군,010002, 6세,2017,195,111,84,132.1,195,111,84,132.1
32380, 양구군,010003, 7세,2017,207,95,112,84.8,207,95,112,84.8
32380, 양구군,010004, 8세,2017,159,89,70,127.1,159,89,70,127.1
32380, 양구군,010005, 9세,2017,184,95,89,106.7,184,95,89,106.7
32380, 양구군,015,10~14세,2017,909,464,445,104.3,909,464,445,104.3
32380, 양구군,015001, 10세,2017,182,96,86,111.6,182,96,86,111.6
32380, 양구군,015002, 11세,2017,185,84,101,83.2,185,84,101,83.2
32380, 양구군,015003, 12세,2017,181,111,70,158.6,181,111,70,158.6
32380, 양구군,015004, 13세,2017,200,89,111,80.2,200,89,111,80.2
32380, 양구군,015005, 14세,2017,161,84,77,109.1,161,84,77,109.1
32380, 양구군,020,15~19세,2017,1253,611,642,95.2,1251,611,640,95.5
32380, 양구군,020001, 15세,2017,217,117,100,117,217,117,100,117
32380, 양구군,020002, 16세,2017,307,145,162,89.5,307,145,162,89.5
32380, 양구군,020003, 17세,2017,350,157,193,81.3,350,157,193,81.3
32380, 양구군,020004, 18세,2017,265,120,145,82.8,265,120,145,82.8
32380, 양구군,020005, 19세,2017,114,72,42,171.4,112,72,40,180
32380, 양구군,025,20~24세,2017,1585,1206,379,318.2,1545,1188,357,332.8
32380, 양구군,025001, 20세,2017,151,110,41,268.3,149,109,40,272.5
32380, 양구군,025002, 21세,2017,187,135,52,259.6,183,132,51,258.8
32380, 양구군,025003, 22세,2017,315,243,72,337.5,310,241,69,349.3
32380, 양구군,025004, 23세,2017,461,356,105,339,446,350,96,364.6
32380, 양구군,025005, 24세,2017,471,362,109,332.1,457,356,101,352.5
32380, 양구군,030,25~29세,2017,1824,1228,596,206,1752,1198,554,216.2
32380, 양구군,030001, 25세,2017,462,338,124,272.6,452,333,119,279.8
32380, 양구군,030002, 26세,2017,418,283,135,209.6,407,278,129,215.5
32380, 양구군,030003, 27세,2017,343,231,112,206.3,324,222,102,217.6
32380, 양구군,030004, 28세,2017,299,187,112,167,278,179,99,180.8
32380, 양구군,030005, 29세,2017,302,189,113,167.3,291,186,105,177.1
32380, 양구군,035,30~34세,2017,1362,761,601,126.6,1303,735,568,129.4
32380, 양구군,035001, 30세,2017,298,186,112,166.1,289,182,107,170.1
32380, 양구군,035002, 31세,2017,249,139,110,126.4,236,133,103,129.1
32380, 양구군,035003, 32세,2017,253,142,111,127.9,236,136,100,136
32380, 양구군,035004, 33세,2017,275,148,127,116.5,264,144,120,120
32380, 양구군,035005, 34세,2017,287,146,141,103.5,278,140,138,101.4
32380, 양구군,040,35~39세,2017,1358,733,625,117.3,1320,719,601,119.6
32380, 양구군,040001, 35세,2017,297,150,147,102,286,145,141,102.8
32380, 양구군,040002, 36세,2017,272,141,131,107.6,265,140,125,112
32380, 양구군,040003, 37세,2017,299,171,128,133.6,290,167,123,135.8
32380, 양구군,040004, 38세,2017,244,132,112,117.9,239,130,109,119.3
32380, 양구군,040005, 39세,2017,246,139,107,129.9,240,137,103,133
32380, 양구군,045,40~44세,2017,1311,696,615,113.2,1287,689,598,115.2
32380, 양구군,045001, 40세,2017,234,115,119,96.6,232,115,117,98.3
32380, 양구군,045002, 41세,2017,250,135,115,117.4,247,134,113,118.6
32380, 양구군,045003, 42세,2017,249,128,121,105.8,241,126,115,109.6
32380, 양구군,045004, 43세,2017,287,154,133,115.8,281,152,129,117.8
32380, 양구군,045005, 44세,2017,291,164,127,129.1,286,162,124,130.6
32380, 양구군,050,45~49세,2017,1478,809,669,120.9,1440,796,644,123.6
32380, 양구군,050001, 45세,2017,262,152,110,138.2,256,150,106,141.5
32380, 양구군,050002, 46세,2017,266,140,126,111.1,259,137,122,112.3
32380, 양구군,050003, 47세,2017,297,155,142,109.2,286,151,135,111.9
32380, 양구군,050004, 48세,2017,321,179,142,126.1,316,178,138,129
32380, 양구군,050005, 49세,2017,332,183,149,122.8,323,180,143,125.9
32380, 양구군,055,50~54세,2017,1618,866,752,115.2,1595,859,736,116.7
32380, 양구군,055001, 50세,2017,309,170,139,122.3,304,168,136,123.5
32380, 양구군,055002, 51세,2017,287,148,139,106.5,285,148,137,108
32380, 양구군,055003, 52세,2017,295,158,137,115.3,288,156,132,118.2
32380, 양구군,055004, 53세,2017,359,189,170,111.2,355,188,167,112.6
32380, 양구군,055005, 54세,2017,368,201,167,120.4,363,199,164,121.3
32380, 양구군,060,55~59세,2017,2018,1063,955,111.3,1994,1056,938,112.6
32380, 양구군,060001, 55세,2017,386,198,188,105.3,378,196,182,107.7
32380, 양구군,060002, 56세,2017,424,219,205,106.8,418,217,201,108
32380, 양구군,060003, 57세,2017,430,234,196,119.4,430,234,196,119.4
32380, 양구군,060004, 58세,2017,378,207,171,121.1,373,205,168,122
32380, 양구군,060005, 59세,2017,400,205,195,105.1,395,204,191,106.8
32380, 양구군,065,60~64세,2017,1607,877,730,120.1,1588,870,718,121.2
32380, 양구군,065001, 60세,2017,377,209,168,124.4,374,208,166,125.3
32380, 양구군,065002, 61세,2017,346,187,159,117.6,341,186,155,120
32380, 양구군,065003, 62세,2017,332,182,150,121.3,329,182,147,123.8
32380, 양구군,065004, 63세,2017,331,180,151,119.2,325,177,148,119.6
32380, 양구군,065005, 64세,2017,221,119,102,116.7,219,117,102,114.7
32380, 양구군,070,65~69세,2017,950,448,502,89.2,946,446,500,89.2
32380, 양구군,070001, 65세,2017,240,133,107,124.3,239,132,107,123.4
32380, 양구군,070002, 66세,2017,164,73,91,80.2,163,73,90,81.1
32380, 양구군,070003, 67세,2017,172,78,94,83,171,77,94,81.9
32380, 양구군,070004, 68세,2017,193,79,114,69.3,192,79,113,69.9
32380, 양구군,070005, 69세,2017,181,85,96,88.5,181,85,96,88.5
32380, 양구군,075,70~74세,2017,1042,479,563,85.1,1037,477,560,85.2
32380, 양구군,075001, 70세,2017,209,87,122,71.3,207,87,120,72.5
32380, 양구군,075002, 71세,2017,182,90,92,97.8,182,90,92,97.8
32380, 양구군,075003, 72세,2017,200,99,101,98,198,98,100,98
32380, 양구군,075004, 73세,2017,232,109,123,88.6,231,108,123,87.8
32380, 양구군,075005, 74세,2017,219,94,125,75.2,219,94,125,75.2
32380, 양구군,080,75~79세,2017,1058,422,636,66.4,1055,421,634,66.4
32380, 양구군,080001, 75세,2017,261,109,152,71.7,260,108,152,71.1
32380, 양구군,080002, 76세,2017,223,92,131,70.2,222,92,130,70.8
32380, 양구군,080003, 77세,2017,197,77,120,64.2,196,77,119,64.7
32380, 양구군,080004, 78세,2017,203,80,123,65,203,80,123,65
32380, 양구군,080005, 79세,2017,174,64,110,58.2,174,64,110,58.2
32380, 양구군,085,80~84세,2017,606,205,401,51.1,606,205,401,51.1
32380, 양구군,085001, 80세,2017,148,56,92,60.9,148,56,92,60.9
32380, 양구군,085002, 81세,2017,141,61,80,76.3,141,61,80,76.3
32380, 양구군,085003, 82세,2017,116,36,80,45,116,36,80,45
32380, 양구군,085004, 83세,2017,106,28,78,35.9,106,28,78,35.9
32380, 양구군,085005, 84세,2017,95,24,71,33.8,95,24,71,33.8
32380, 양구군,090,85~89세,2017,283,83,200,41.5,283,83,200,41.5
32380, 양구군,090001, 85세,2017,70,24,46,52.2,70,24,46,52.2
32380, 양구군,090002, 86세,2017,77,27,50,54,77,27,50,54
32380, 양구군,090003, 87세,2017,50,8,42,19,50,8,42,19
32380, 양구군,090004, 88세,2017,53,14,39,35.9,53,14,39,35.9
32380, 양구군,090005, 89세,2017,33,10,23,43.5,33,10,23,43.5
32380, 양구군,095,90~94세,2017,115,28,87,32.2,115,28,87,32.2
32380, 양구군,095001, 90세,2017,36,9,27,33.3,36,9,27,33.3
32380, 양구군,095002, 91세,2017,22,X,19,15.8,22,X,19,15.8
32380, 양구군,095003, 92세,2017,23,7,16,43.8,23,7,16,43.8
32380, 양구군,095004, 93세,2017,17,5,12,41.7,17,5,12,41.7
32380, 양구군,095005, 94세,2017,17,X,13,30.8,17,X,13,30.8
32380, 양구군,100,95~99세,2017,24,8,16,50,24,8,16,50
32380, 양구군,100001, 95세,2017,7,X,6,16.7,7,X,6,16.7
32380, 양구군,100002, 96세,2017,7,X,5,40,7,X,5,40
32380, 양구군,100003, 97세,2017,X,X,X,,X,X,X,
32380, 양구군,100004, 98세,2017,X,X,X,50,X,X,X,50
32380, 양구군,100005, 99세,2017,X,X,X,0,X,X,X,0
32380, 양구군,101,100세이상,2017,X,X,X,50,X,X,X,50
32380, 양구군,102,15세미만,2017,2860,1447,1413,102.4,2858,1446,1412,102.4
32380, 양구군,103,15~64세,2017,15414,8850,6564,134.8,15075,8721,6354,137.3
32380, 양구군,104,65세이상,2017,4081,1674,2407,69.5,4069,1669,2400,69.5
32380, 양구군,086,85세이상,2017,425,120,305,39.3,425,120,305,39.3
32380, 양구군,126,평균연령,2017,43,40.9,45.4,,43,40.9,45.5,
32380, 양구군,127,중위연령,2017,43.7,40,47.6,,43.9,40.2,47.9,
32390, 인제군,000,합계,2017,30524,16456,14068,117,30086,16244,13842,117.4
32390, 인제군,005,0~4세,2017,1483,769,714,107.7,1482,768,714,107.6
32390, 인제군,005001, 0세,2017,309,164,145,113.1,309,164,145,113.1
32390, 인제군,005002, 1세,2017,337,171,166,103,336,170,166,102.4
32390, 인제군,005003, 2세,2017,290,148,142,104.2,290,148,142,104.2
32390, 인제군,005004, 3세,2017,270,142,128,110.9,270,142,128,110.9
32390, 인제군,005005, 4세,2017,277,144,133,108.3,277,144,133,108.3
32390, 인제군,010,5~9세,2017,1368,727,641,113.4,1368,727,641,113.4
32390, 인제군,010001, 5세,2017,313,164,149,110.1,313,164,149,110.1
32390, 인제군,010002, 6세,2017,259,146,113,129.2,259,146,113,129.2
32390, 인제군,010003, 7세,2017,294,158,136,116.2,294,158,136,116.2
32390, 인제군,010004, 8세,2017,240,130,110,118.2,240,130,110,118.2
32390, 인제군,010005, 9세,2017,262,129,133,97,262,129,133,97
32390, 인제군,015,10~14세,2017,1224,639,585,109.2,1224,639,585,109.2
32390, 인제군,015001, 10세,2017,247,132,115,114.8,247,132,115,114.8
32390, 인제군,015002, 11세,2017,256,127,129,98.4,256,127,129,98.4
32390, 인제군,015003, 12세,2017,248,125,123,101.6,248,125,123,101.6
32390, 인제군,015004, 13세,2017,238,132,106,124.5,238,132,106,124.5
32390, 인제군,015005, 14세,2017,235,123,112,109.8,235,123,112,109.8
32390, 인제군,020,15~19세,2017,1041,567,474,119.6,1039,567,472,120.1
32390, 인제군,020001, 15세,2017,209,117,92,127.2,209,117,92,127.2
32390, 인제군,020002, 16세,2017,232,117,115,101.7,232,117,115,101.7
32390, 인제군,020003, 17세,2017,247,123,124,99.2,246,123,123,100
32390, 인제군,020004, 18세,2017,223,129,94,137.2,223,129,94,137.2
32390, 인제군,020005, 19세,2017,130,81,49,165.3,129,81,48,168.8
32390, 인제군,025,20~24세,2017,1646,1163,483,240.8,1563,1110,453,245
32390, 인제군,025001, 20세,2017,208,149,59,252.5,200,144,56,257.1
32390, 인제군,025002, 21세,2017,250,176,74,237.8,240,171,69,247.8
32390, 인제군,025003, 22세,2017,309,217,92,235.9,290,202,88,229.5
32390, 인제군,025004, 23세,2017,401,270,131,206.1,383,261,122,213.9
32390, 인제군,025005, 24세,2017,478,351,127,276.4,450,332,118,281.4
32390, 인제군,030,25~29세,2017,2217,1463,754,194,2124,1419,705,201.3
32390, 인제군,030001, 25세,2017,480,346,134,258.2,455,330,125,264
32390, 인제군,030002, 26세,2017,495,332,163,203.7,484,328,156,210.3
32390, 인제군,030003, 27세,2017,442,287,155,185.2,423,277,146,189.7
32390, 인제군,030004, 28세,2017,406,264,142,185.9,386,256,130,196.9
32390, 인제군,030005, 29세,2017,394,234,160,146.3,376,228,148,154.1
32390, 인제군,035,30~34세,2017,2044,1154,890,129.7,1973,1122,851,131.8
32390, 인제군,035001, 30세,2017,419,244,175,139.4,405,237,168,141.1
32390, 인제군,035002, 31세,2017,436,252,184,137,421,247,174,142
32390, 인제군,035003, 32세,2017,379,222,157,141.4,368,217,151,143.7
32390, 인제군,035004, 33세,2017,383,217,166,130.7,367,207,160,129.4
32390, 인제군,035005, 34세,2017,427,219,208,105.3,412,214,198,108.1
32390, 인제군,040,35~39세,2017,2132,1139,993,114.7,2088,1126,962,117
32390, 인제군,040001, 35세,2017,450,235,215,109.3,435,233,202,115.3
32390, 인제군,040002, 36세,2017,452,248,204,121.6,445,245,200,122.5
32390, 인제군,040003, 37세,2017,450,244,206,118.4,439,241,198,121.7
32390, 인제군,040004, 38세,2017,405,214,191,112,400,212,188,112.8
32390, 인제군,040005, 39세,2017,375,198,177,111.9,369,195,174,112.1
32390, 인제군,045,40~44세,2017,1889,1065,824,129.2,1867,1053,814,129.4
32390, 인제군,045001, 40세,2017,370,186,184,101.1,366,184,182,101.1
32390, 인제군,045002, 41세,2017,337,191,146,130.8,336,190,146,130.1
32390, 인제군,045003, 42세,2017,399,230,169,136.1,395,229,166,138
32390, 인제군,045004, 43세,2017,409,248,161,154,403,245,158,155.1
32390, 인제군,045005, 44세,2017,374,210,164,128,367,205,162,126.5
32390, 인제군,050,45~49세,2017,2157,1207,950,127.1,2128,1195,933,128.1
32390, 인제군,050001, 45세,2017,399,219,180,121.7,394,218,176,123.9
32390, 인제군,050002, 46세,2017,436,252,184,137,428,246,182,135.2
32390, 인제군,050003, 47세,2017,416,228,188,121.3,409,227,182,124.7
32390, 인제군,050004, 48세,2017,452,258,194,133,446,256,190,134.7
32390, 인제군,050005, 49세,2017,454,250,204,122.5,451,248,203,122.2
32390, 인제군,055,50~54세,2017,2318,1230,1088,113.1,2280,1210,1070,113.1
32390, 인제군,055001, 50세,2017,388,215,173,124.3,380,212,168,126.2
32390, 인제군,055002, 51세,2017,463,269,194,138.7,457,265,192,138
32390, 인제군,055003, 52세,2017,437,220,217,101.4,429,216,213,101.4
32390, 인제군,055004, 53세,2017,495,266,229,116.2,489,262,227,115.4
32390, 인제군,055005, 54세,2017,535,260,275,94.5,525,255,270,94.4
32390, 인제군,060,55~59세,2017,2990,1610,1380,116.7,2971,1605,1366,117.5
32390, 인제군,060001, 55세,2017,577,316,261,121.1,572,314,258,121.7
32390, 인제군,060002, 56세,2017,685,347,338,102.7,683,347,336,103.3
32390, 인제군,060003, 57세,2017,621,330,291,113.4,615,328,287,114.3
32390, 인제군,060004, 58세,2017,528,291,237,122.8,525,290,235,123.4
32390, 인제군,060005, 59세,2017,579,326,253,128.9,576,326,250,130.4
32390, 인제군,065,60~64세,2017,2381,1275,1106,115.3,2365,1266,1099,115.2
32390, 인제군,065001, 60세,2017,608,347,261,133,606,345,261,132.2
32390, 인제군,065002, 61세,2017,492,264,228,115.8,488,262,226,115.9
32390, 인제군,065003, 62세,2017,501,254,247,102.8,498,253,245,103.3
32390, 인제군,065004, 63세,2017,430,217,213,101.9,425,214,211,101.4
32390, 인제군,065005, 64세,2017,350,193,157,122.9,348,192,156,123.1
32390, 인제군,070,65~69세,2017,1461,717,744,96.4,1451,710,741,95.8
32390, 인제군,070001, 65세,2017,433,216,217,99.5,430,214,216,99.1
32390, 인제군,070002, 66세,2017,249,126,123,102.4,248,125,123,101.6
32390, 인제군,070003, 67세,2017,238,109,129,84.5,236,108,128,84.4
32390, 인제군,070004, 68세,2017,269,131,138,94.9,267,130,137,94.9
32390, 인제군,070005, 69세,2017,272,135,137,98.5,270,133,137,97.1
32390, 인제군,075,70~74세,2017,1441,696,745,93.4,1434,692,742,93.3
32390, 인제군,075001, 70세,2017,306,152,154,98.7,301,150,151,99.3
32390, 인제군,075002, 71세,2017,260,131,129,101.6,258,129,129,100
32390, 인제군,075003, 72세,2017,291,137,154,89,291,137,154,89
32390, 인제군,075004, 73세,2017,286,151,135,111.9,286,151,135,111.9
32390, 인제군,075005, 74세,2017,298,125,173,72.3,298,125,173,72.3
32390, 인제군,080,75~79세,2017,1394,595,799,74.5,1393,595,798,74.6
32390, 인제군,080001, 75세,2017,307,149,158,94.3,307,149,158,94.3
32390, 인제군,080002, 76세,2017,291,136,155,87.7,291,136,155,87.7
32390, 인제군,080003, 77세,2017,272,118,154,76.6,271,118,153,77.1
32390, 인제군,080004, 78세,2017,255,92,163,56.4,255,92,163,56.4
32390, 인제군,080005, 79세,2017,269,100,169,59.2,269,100,169,59.2
32390, 인제군,085,80~84세,2017,779,282,497,56.7,778,282,496,56.9
32390, 인제군,085001, 80세,2017,215,101,114,88.6,215,101,114,88.6
32390, 인제군,085002, 81세,2017,170,66,104,63.5,170,66,104,63.5
32390, 인제군,085003, 82세,2017,159,44,115,38.3,159,44,115,38.3
32390, 인제군,085004, 83세,2017,118,38,80,47.5,118,38,80,47.5
32390, 인제군,085005, 84세,2017,117,33,84,39.3,116,33,83,39.8
32390, 인제군,090,85~89세,2017,373,94,279,33.7,373,94,279,33.7
32390, 인제군,090001, 85세,2017,98,28,70,40,98,28,70,40
32390, 인제군,090002, 86세,2017,74,21,53,39.6,74,21,53,39.6
32390, 인제군,090003, 87세,2017,74,13,61,21.3,74,13,61,21.3
32390, 인제군,090004, 88세,2017,60,15,45,33.3,60,15,45,33.3
32390, 인제군,090005, 89세,2017,67,17,50,34,67,17,50,34
32390, 인제군,095,90~94세,2017,143,49,94,52.1,142,49,93,52.7
32390, 인제군,095001, 90세,2017,36,10,26,38.5,36,10,26,38.5
32390, 인제군,095002, 91세,2017,37,7,30,23.3,36,7,29,24.1
32390, 인제군,095003, 92세,2017,18,8,10,80,18,8,10,80
32390, 인제군,095004, 93세,2017,27,16,11,145.5,27,16,11,145.5
32390, 인제군,095005, 94세,2017,25,8,17,47.1,25,8,17,47.1
32390, 인제군,100,95~99세,2017,38,15,23,65.2,38,15,23,65.2
32390, 인제군,100001, 95세,2017,15,X,11,36.4,15,X,11,36.4
32390, 인제군,100002, 96세,2017,8,X,5,60,8,X,5,60
32390, 인제군,100003, 97세,2017,7,X,X,75,7,X,X,75
32390, 인제군,100004, 98세,2017,6,X,X,100,6,X,X,100
32390, 인제군,100005, 99세,2017,X,X,X,,X,X,X,
32390, 인제군,101,100세이상,2017,5,X,5,0,5,X,5,0
32390, 인제군,102,15세미만,2017,4075,2135,1940,110.1,4074,2134,1940,110
32390, 인제군,103,15~64세,2017,20815,11873,8942,132.8,20398,11673,8725,133.8
32390, 인제군,104,65세이상,2017,5634,2448,3186,76.8,5614,2437,3177,76.7
32390, 인제군,086,85세이상,2017,559,158,401,39.4,558,158,400,39.5
32390, 인제군,126,평균연령,2017,43.9,42.1,46.1,,44,42.2,46.2,
32390, 인제군,127,중위연령,2017,45.5,43,48.6,,45.8,43.2,49,
32400, 고성군,000,합계,2017,28621,15422,13199,116.8,27640,14702,12938,113.6
32400, 고성군,005,0~4세,2017,654,319,335,95.2,654,319,335,95.2
32400, 고성군,005001, 0세,2017,127,48,79,60.8,127,48,79,60.8
32400, 고성군,005002, 1세,2017,136,66,70,94.3,136,66,70,94.3
32400, 고성군,005003, 2세,2017,124,71,53,134,124,71,53,134
32400, 고성군,005004, 3세,2017,141,72,69,104.3,141,72,69,104.3
32400, 고성군,005005, 4세,2017,126,62,64,96.9,126,62,64,96.9
32400, 고성군,010,5~9세,2017,734,399,335,119.1,733,399,334,119.5
32400, 고성군,010001, 5세,2017,152,86,66,130.3,152,86,66,130.3
32400, 고성군,010002, 6세,2017,160,86,74,116.2,159,86,73,117.8
32400, 고성군,010003, 7세,2017,129,71,58,122.4,129,71,58,122.4
32400, 고성군,010004, 8세,2017,138,64,74,86.5,138,64,74,86.5
32400, 고성군,010005, 9세,2017,155,92,63,146,155,92,63,146
32400, 고성군,015,10~14세,2017,811,429,382,112.3,811,429,382,112.3
32400, 고성군,015001, 10세,2017,159,83,76,109.2,159,83,76,109.2
32400, 고성군,015002, 11세,2017,164,94,70,134.3,164,94,70,134.3
32400, 고성군,015003, 12세,2017,159,84,75,112,159,84,75,112
32400, 고성군,015004, 13세,2017,155,81,74,109.5,155,81,74,109.5
32400, 고성군,015005, 14세,2017,174,87,87,100,174,87,87,100
32400, 고성군,020,15~19세,2017,1531,954,577,165.3,1458,903,555,162.7
32400, 고성군,020001, 15세,2017,192,106,86,123.3,192,106,86,123.3
32400, 고성군,020002, 16세,2017,225,129,96,134.4,225,129,96,134.4
32400, 고성군,020003, 17세,2017,268,143,125,114.4,265,140,125,112
32400, 고성군,020004, 18세,2017,330,206,124,166.1,312,193,119,162.2
32400, 고성군,020005, 19세,2017,516,370,146,253.4,464,335,129,259.7
32400, 고성군,025,20~24세,2017,3242,2186,1056,207,2833,1861,972,191.5
32400, 고성군,025001, 20세,2017,512,291,221,131.7,437,233,204,114.2
32400, 고성군,025002, 21세,2017,663,385,278,138.5,517,267,250,106.8
32400, 고성군,025003, 22세,2017,669,414,255,162.4,584,346,238,145.4
32400, 고성군,025004, 23세,2017,705,559,146,382.9,649,513,136,377.2
32400, 고성군,025005, 24세,2017,693,537,156,344.2,646,502,144,348.6
32400, 고성군,030,25~29세,2017,1898,1336,562,237.7,1769,1233,536,230
32400, 고성군,030001, 25세,2017,584,426,158,269.6,541,392,149,263.1
32400, 고성군,030002, 26세,2017,389,280,109,256.9,365,261,104,251
32400, 고성군,030003, 27세,2017,375,258,117,220.5,348,235,113,208
32400, 고성군,030004, 28세,2017,304,205,99,207.1,278,185,93,198.9
32400, 고성군,030005, 29세,2017,246,167,79,211.4,237,160,77,207.8
32400, 고성군,035,30~34세,2017,1209,756,453,166.9,1080,654,426,153.5
32400, 고성군,035001, 30세,2017,257,175,82,213.4,234,159,75,212
32400, 고성군,035002, 31세,2017,237,156,81,192.6,218,141,77,183.1
32400, 고성군,035003, 32세,2017,226,141,85,165.9,199,122,77,158.4
32400, 고성군,035004, 33세,2017,259,151,108,139.8,235,130,105,123.8
32400, 고성군,035005, 34세,2017,230,133,97,137.1,194,102,92,110.9
32400, 고성군,040,35~39세,2017,1186,700,486,144,1110,643,467,137.7
32400, 고성군,040001, 35세,2017,234,147,87,169,224,138,86,160.5
32400, 고성군,040002, 36세,2017,254,154,100,154,233,136,97,140.2
32400, 고성군,040003, 37세,2017,268,148,120,123.3,242,132,110,120
32400, 고성군,040004, 38세,2017,207,124,83,149.4,197,116,81,143.2
32400, 고성군,040005, 39세,2017,223,127,96,132.3,214,121,93,130.1
32400, 고성군,045,40~44세,2017,1387,767,620,123.7,1330,730,600,121.7
32400, 고성군,045001, 40세,2017,232,127,105,121,219,117,102,114.7
32400, 고성군,045002, 41세,2017,275,152,123,123.6,264,143,121,118.2
32400, 고성군,045003, 42세,2017,265,147,118,124.6,255,142,113,125.7
32400, 고성군,045004, 43세,2017,315,188,127,148,307,183,124,147.6
32400, 고성군,045005, 44세,2017,300,153,147,104.1,285,145,140,103.6
32400, 고성군,050,45~49세,2017,1885,1075,810,132.7,1848,1054,794,132.7
32400, 고성군,050001, 45세,2017,348,199,149,133.6,338,193,145,133.1
32400, 고성군,050002, 46세,2017,375,213,162,131.5,368,209,159,131.4
32400, 고성군,050003, 47세,2017,374,216,158,136.7,365,212,153,138.6
32400, 고성군,050004, 48세,2017,383,216,167,129.3,375,211,164,128.7
32400, 고성군,050005, 49세,2017,405,231,174,132.8,402,229,173,132.4
32400, 고성군,055,50~54세,2017,2058,1076,982,109.6,2026,1067,959,111.3
32400, 고성군,055001, 50세,2017,379,200,179,111.7,377,200,177,113
32400, 고성군,055002, 51세,2017,400,207,193,107.3,392,204,188,108.5
32400, 고성군,055003, 52세,2017,407,211,196,107.7,398,208,190,109.5
32400, 고성군,055004, 53세,2017,393,211,182,115.9,389,210,179,117.3
32400, 고성군,055005, 54세,2017,479,247,232,106.5,470,245,225,108.9
32400, 고성군,060,55~59세,2017,2702,1379,1323,104.2,2689,1375,1314,104.6
32400, 고성군,060001, 55세,2017,491,252,239,105.4,490,252,238,105.9
32400, 고성군,060002, 56세,2017,579,281,298,94.3,575,279,296,94.3
32400, 고성군,060003, 57세,2017,563,287,276,104,558,286,272,105.1
32400, 고성군,060004, 58세,2017,539,282,257,109.7,537,282,255,110.6
32400, 고성군,060005, 59세,2017,530,277,253,109.5,529,276,253,109.1
32400, 고성군,065,60~64세,2017,2418,1236,1182,104.6,2411,1232,1179,104.5
32400, 고성군,065001, 60세,2017,514,280,234,119.7,511,278,233,119.3
32400, 고성군,065002, 61세,2017,466,237,229,103.5,465,237,228,103.9
32400, 고성군,065003, 62세,2017,546,266,280,95,543,264,279,94.6
32400, 고성군,065004, 63세,2017,503,243,260,93.5,503,243,260,93.5
32400, 고성군,065005, 64세,2017,389,210,179,117.3,389,210,179,117.3
32400, 고성군,070,65~69세,2017,1704,812,892,91,1696,810,886,91.4
32400, 고성군,070001, 65세,2017,409,197,212,92.9,407,197,210,93.8
32400, 고성군,070002, 66세,2017,300,145,155,93.5,298,145,153,94.8
32400, 고성군,070003, 67세,2017,297,134,163,82.2,295,133,162,82.1
32400, 고성군,070004, 68세,2017,346,167,179,93.3,345,166,179,92.7
32400, 고성군,070005, 69세,2017,352,169,183,92.3,351,169,182,92.9
32400, 고성군,075,70~74세,2017,1781,770,1011,76.2,1775,768,1007,76.3
32400, 고성군,075001, 70세,2017,347,156,191,81.7,344,155,189,82
32400, 고성군,075002, 71세,2017,367,164,203,80.8,364,163,201,81.1
32400, 고성군,075003, 72세,2017,370,165,205,80.5,370,165,205,80.5
32400, 고성군,075004, 73세,2017,350,136,214,63.6,350,136,214,63.6
32400, 고성군,075005, 74세,2017,347,149,198,75.3,347,149,198,75.3
32400, 고성군,080,75~79세,2017,1717,719,998,72,1715,718,997,72
32400, 고성군,080001, 75세,2017,429,185,244,75.8,429,185,244,75.8
32400, 고성군,080002, 76세,2017,341,137,204,67.2,341,137,204,67.2
32400, 고성군,080003, 77세,2017,333,144,189,76.2,333,144,189,76.2
32400, 고성군,080004, 78세,2017,314,133,181,73.5,314,133,181,73.5
32400, 고성군,080005, 79세,2017,300,120,180,66.7,298,119,179,66.5
32400, 고성군,085,80~84세,2017,941,317,624,50.8,940,316,624,50.6
32400, 고성군,085001, 80세,2017,252,82,170,48.2,252,82,170,48.2
32400, 고성군,085002, 81세,2017,209,82,127,64.6,208,81,127,63.8
32400, 고성군,085003, 82세,2017,196,69,127,54.3,196,69,127,54.3
32400, 고성군,085004, 83세,2017,152,45,107,42.1,152,45,107,42.1
32400, 고성군,085005, 84세,2017,132,39,93,41.9,132,39,93,41.9
32400, 고성군,090,85~89세,2017,490,123,367,33.5,489,122,367,33.2
32400, 고성군,090001, 85세,2017,117,31,86,36,117,31,86,36
32400, 고성군,090002, 86세,2017,97,29,68,42.6,97,29,68,42.6
32400, 고성군,090003, 87세,2017,99,26,73,35.6,99,26,73,35.6
32400, 고성군,090004, 88세,2017,96,23,73,31.5,96,23,73,31.5
32400, 고성군,090005, 89세,2017,81,14,67,20.9,80,13,67,19.4
32400, 고성군,095,90~94세,2017,217,54,163,33.1,217,54,163,33.1
32400, 고성군,095001, 90세,2017,67,12,55,21.8,67,12,55,21.8
32400, 고성군,095002, 91세,2017,55,14,41,34.1,55,14,41,34.1
32400, 고성군,095003, 92세,2017,38,12,26,46.2,38,12,26,46.2
32400, 고성군,095004, 93세,2017,33,12,21,57.1,33,12,21,57.1
32400, 고성군,095005, 94세,2017,24,X,20,20,24,X,20,20
32400, 고성군,100,95~99세,2017,52,14,38,36.8,52,14,38,36.8
32400, 고성군,100001, 95세,2017,19,8,11,72.7,19,8,11,72.7
32400, 고성군,100002, 96세,2017,9,X,7,28.6,9,X,7,28.6
32400, 고성군,100003, 97세,2017,6,X,6,0,6,X,6,0
32400, 고성군,100004, 98세,2017,11,X,9,22.2,11,X,9,22.2
32400, 고성군,100005, 99세,2017,7,X,5,40,7,X,5,40
32400, 고성군,101,100세이상,2017,X,X,X,33.3,X,X,X,33.3
32400, 고성군,102,15세미만,2017,2199,1147,1052,109,2198,1147,1051,109.1
32400, 고성군,103,15~64세,2017,19516,11465,8051,142.4,18554,10752,7802,137.8
32400, 고성군,104,65세이상,2017,6906,2810,4096,68.6,6888,2803,4085,68.6
32400, 고성군,086,85세이상,2017,763,192,571,33.6,762,191,571,33.5
32400, 고성군,126,평균연령,2017,46.8,43.4,50.7,,47.4,44.1,51.1,
32400, 고성군,127,중위연령,2017,49.4,44.1,55,,50.5,45.9,55.5,
32410, 양양군,000,합계,2017,25556,12939,12617,102.6,25221,12752,12469,102.3
32410, 양양군,005,0~4세,2017,623,330,293,112.6,622,330,292,113
32410, 양양군,005001, 0세,2017,95,48,47,102.1,95,48,47,102.1
32410, 양양군,005002, 1세,2017,121,61,60,101.7,121,61,60,101.7
32410, 양양군,005003, 2세,2017,130,69,61,113.1,130,69,61,113.1
32410, 양양군,005004, 3세,2017,126,66,60,110,125,66,59,111.9
32410, 양양군,005005, 4세,2017,151,86,65,132.3,151,86,65,132.3
32410, 양양군,010,5~9세,2017,774,404,370,109.2,773,403,370,108.9
32410, 양양군,010001, 5세,2017,150,73,77,94.8,149,72,77,93.5
32410, 양양군,010002, 6세,2017,157,83,74,112.2,157,83,74,112.2
32410, 양양군,010003, 7세,2017,159,84,75,112,159,84,75,112
32410, 양양군,010004, 8세,2017,148,75,73,102.7,148,75,73,102.7
32410, 양양군,010005, 9세,2017,160,89,71,125.4,160,89,71,125.4
32410, 양양군,015,10~14세,2017,867,451,416,108.4,865,450,415,108.4
32410, 양양군,015001, 10세,2017,179,92,87,105.7,179,92,87,105.7
32410, 양양군,015002, 11세,2017,155,80,75,106.7,155,80,75,106.7
32410, 양양군,015003, 12세,2017,170,83,87,95.4,169,83,86,96.5
32410, 양양군,015004, 13세,2017,177,106,71,149.3,176,105,71,147.9
32410, 양양군,015005, 14세,2017,186,90,96,93.8,186,90,96,93.8
32410, 양양군,020,15~19세,2017,956,525,431,121.8,955,524,431,121.6
32410, 양양군,020001, 15세,2017,185,93,92,101.1,185,93,92,101.1
32410, 양양군,020002, 16세,2017,217,113,104,108.7,217,113,104,108.7
32410, 양양군,020003, 17세,2017,242,128,114,112.3,242,128,114,112.3
32410, 양양군,020004, 18세,2017,197,109,88,123.9,197,109,88,123.9
32410, 양양군,020005, 19세,2017,115,82,33,248.5,114,81,33,245.5
32410, 양양군,025,20~24세,2017,977,616,361,170.6,950,598,352,169.9
32410, 양양군,025001, 20세,2017,164,103,61,168.9,163,103,60,171.7
32410, 양양군,025002, 21세,2017,187,132,55,240,185,131,54,242.6
32410, 양양군,025003, 22세,2017,200,122,78,156.4,194,119,75,158.7
32410, 양양군,025004, 23세,2017,184,117,67,174.6,177,111,66,168.2
32410, 양양군,025005, 24세,2017,242,142,100,142,231,134,97,138.1
32410, 양양군,030,25~29세,2017,1113,658,455,144.6,1030,609,421,144.7
32410, 양양군,030001, 25세,2017,210,117,93,125.8,191,107,84,127.4
32410, 양양군,030002, 26세,2017,248,149,99,150.5,231,140,91,153.8
32410, 양양군,030003, 27세,2017,229,133,96,138.5,213,122,91,134.1
32410, 양양군,030004, 28세,2017,213,125,88,142,196,113,83,136.1
32410, 양양군,030005, 29세,2017,213,134,79,169.6,199,127,72,176.4
32410, 양양군,035,30~34세,2017,1030,584,446,130.9,981,555,426,130.3
32410, 양양군,035001, 30세,2017,194,104,90,115.6,189,100,89,112.4
32410, 양양군,035002, 31세,2017,183,114,69,165.2,169,106,63,168.3
32410, 양양군,035003, 32세,2017,198,110,88,125,188,106,82,129.3
32410, 양양군,035004, 33세,2017,204,125,79,158.2,194,119,75,158.7
32410, 양양군,035005, 34세,2017,251,131,120,109.2,241,124,117,106
32410, 양양군,040,35~39세,2017,1364,743,621,119.6,1322,714,608,117.4
32410, 양양군,040001, 35세,2017,264,135,129,104.7,251,128,123,104.1
32410, 양양군,040002, 36세,2017,266,160,106,150.9,253,150,103,145.6
32410, 양양군,040003, 37세,2017,284,149,135,110.4,275,141,134,105.2
32410, 양양군,040004, 38세,2017,279,155,124,125,274,152,122,124.6
32410, 양양군,040005, 39세,2017,271,144,127,113.4,269,143,126,113.5
32410, 양양군,045,40~44세,2017,1551,860,691,124.5,1512,839,673,124.7
32410, 양양군,045001, 40세,2017,290,148,142,104.2,282,147,135,108.9
32410, 양양군,045002, 41세,2017,275,172,103,167,263,166,97,171.1
32410, 양양군,045003, 42세,2017,308,152,156,97.4,302,149,153,97.4
32410, 양양군,045004, 43세,2017,313,174,139,125.2,306,167,139,120.1
32410, 양양군,045005, 44세,2017,365,214,151,141.7,359,210,149,140.9
32410, 양양군,050,45~49세,2017,1917,1067,850,125.5,1896,1054,842,125.2
32410, 양양군,050001, 45세,2017,337,171,166,103,330,166,164,101.2
32410, 양양군,050002, 46세,2017,368,196,172,114,361,192,169,113.6
32410, 양양군,050003, 47세,2017,373,218,155,140.6,369,216,153,141.2
32410, 양양군,050004, 48세,2017,411,230,181,127.1,409,228,181,126
32410, 양양군,050005, 49세,2017,428,252,176,143.2,427,252,175,144
32410, 양양군,055,50~54세,2017,2059,1062,997,106.5,2039,1058,981,107.8
32410, 양양군,055001, 50세,2017,386,223,163,136.8,380,221,159,139
32410, 양양군,055002, 51세,2017,419,234,185,126.5,414,234,180,130
32410, 양양군,055003, 52세,2017,396,186,210,88.6,393,185,208,88.9
32410, 양양군,055004, 53세,2017,419,198,221,89.6,416,198,218,90.8
32410, 양양군,055005, 54세,2017,439,221,218,101.4,436,220,216,101.9
32410, 양양군,060,55~59세,2017,2747,1404,1343,104.5,2730,1400,1330,105.3
32410, 양양군,060001, 55세,2017,491,247,244,101.2,488,246,242,101.7
32410, 양양군,060002, 56세,2017,573,293,280,104.6,569,292,277,105.4
32410, 양양군,060003, 57세,2017,580,300,280,107.1,577,299,278,107.6
32410, 양양군,060004, 58세,2017,547,282,265,106.4,542,281,261,107.7
32410, 양양군,060005, 59세,2017,556,282,274,102.9,554,282,272,103.7
32410, 양양군,065,60~64세,2017,2489,1230,1259,97.7,2473,1222,1251,97.7
32410, 양양군,065001, 60세,2017,559,264,295,89.5,550,260,290,89.7
32410, 양양군,065002, 61세,2017,461,223,238,93.7,458,222,236,94.1
32410, 양양군,065003, 62세,2017,556,282,274,102.9,554,280,274,102.2
32410, 양양군,065004, 63세,2017,532,264,268,98.5,532,264,268,98.5
32410, 양양군,065005, 64세,2017,381,197,184,107.1,379,196,183,107.1
32410, 양양군,070,65~69세,2017,1833,866,967,89.6,1822,859,963,89.2
32410, 양양군,070001, 65세,2017,472,211,261,80.8,468,209,259,80.7
32410, 양양군,070002, 66세,2017,312,157,155,101.3,307,154,153,100.7
32410, 양양군,070003, 67세,2017,326,152,174,87.4,325,151,174,86.8
32410, 양양군,070004, 68세,2017,357,183,174,105.2,357,183,174,105.2
32410, 양양군,070005, 69세,2017,366,163,203,80.3,365,162,203,79.8
32410, 양양군,075,70~74세,2017,1913,878,1035,84.8,1910,877,1033,84.9
32410, 양양군,075001, 70세,2017,410,204,206,99,410,204,206,99
32410, 양양군,075002, 71세,2017,346,176,170,103.5,344,175,169,103.6
32410, 양양군,075003, 72세,2017,370,147,223,65.9,370,147,223,65.9
32410, 양양군,075004, 73세,2017,398,182,216,84.3,398,182,216,84.3
32410, 양양군,075005, 74세,2017,389,169,220,76.8,388,169,219,77.2
32410, 양양군,080,75~79세,2017,1680,730,950,76.8,1679,729,950,76.7
32410, 양양군,080001, 75세,2017,388,180,208,86.5,388,180,208,86.5
32410, 양양군,080002, 76세,2017,345,145,200,72.5,345,145,200,72.5
32410, 양양군,080003, 77세,2017,341,153,188,81.4,340,152,188,80.9
32410, 양양군,080004, 78세,2017,297,125,172,72.7,297,125,172,72.7
32410, 양양군,080005, 79세,2017,309,127,182,69.8,309,127,182,69.8
32410, 양양군,085,80~84세,2017,961,359,602,59.6,960,359,601,59.7
32410, 양양군,085001, 80세,2017,224,93,131,71,224,93,131,71
32410, 양양군,085002, 81세,2017,244,89,155,57.4,244,89,155,57.4
32410, 양양군,085003, 82세,2017,207,90,117,76.9,207,90,117,76.9
32410, 양양군,085004, 83세,2017,150,45,105,42.9,149,45,104,43.3
32410, 양양군,085005, 84세,2017,136,42,94,44.7,136,42,94,44.7
32410, 양양군,090,85~89세,2017,430,127,303,41.9,430,127,303,41.9
32410, 양양군,090001, 85세,2017,116,34,82,41.5,116,34,82,41.5
32410, 양양군,090002, 86세,2017,99,36,63,57.1,99,36,63,57.1
32410, 양양군,090003, 87세,2017,72,17,55,30.9,72,17,55,30.9
32410, 양양군,090004, 88세,2017,72,19,53,35.8,72,19,53,35.8
32410, 양양군,090005, 89세,2017,71,21,50,42,71,21,50,42
32410, 양양군,095,90~94세,2017,218,37,181,20.4,218,37,181,20.4
32410, 양양군,095001, 90세,2017,65,14,51,27.5,65,14,51,27.5
32410, 양양군,095002, 91세,2017,47,7,40,17.5,47,7,40,17.5
32410, 양양군,095003, 92세,2017,41,X,37,10.8,41,X,37,10.8
32410, 양양군,095004, 93세,2017,40,7,33,21.2,40,7,33,21.2
32410, 양양군,095005, 94세,2017,25,5,20,25,25,5,20,25
32410, 양양군,100,95~99세,2017,48,7,41,17.1,48,7,41,17.1
32410, 양양군,100001, 95세,2017,17,X,15,13.3,17,X,15,13.3
32410, 양양군,100002, 96세,2017,12,X,10,20,12,X,10,20
32410, 양양군,100003, 97세,2017,8,X,5,60,8,X,5,60
32410, 양양군,100004, 98세,2017,7,X,7,0,7,X,7,0
32410, 양양군,100005, 99세,2017,X,X,X,0,X,X,X,0
32410, 양양군,101,100세이상,2017,6,X,5,20,6,X,5,20
32410, 양양군,102,15세미만,2017,2264,1185,1079,109.8,2260,1183,1077,109.8
32410, 양양군,103,15~64세,2017,16203,8749,7454,117.4,15888,8573,7315,117.2
32410, 양양군,104,65세이상,2017,7089,3005,4084,73.6,7073,2996,4077,73.5
32410, 양양군,086,85세이상,2017,702,172,530,32.5,702,172,530,32.5
32410, 양양군,126,평균연령,2017,50.3,48,52.6,,50.5,48.2,52.7,
32410, 양양군,127,중위연령,2017,54,51,56.5,,54.2,51.3,56.7,
33,충청북도,000,합계,2017,1611009,818500,792509,103.3,1562772,788322,774450,101.8
33,충청북도,005,0~4세,2017,64931,33083,31848,103.9,64328,32785,31543,103.9
33,충청북도,005001, 0세,2017,11534,5951,5583,106.6,11409,5889,5520,106.7
33,충청북도,005002, 1세,2017,12982,6663,6319,105.4,12851,6593,6258,105.4
33,충청북도,005003, 2세,2017,13353,6822,6531,104.5,13234,6761,6473,104.4
33,충청북도,005004, 3세,2017,13422,6726,6696,100.4,13309,6670,6639,100.5
33,충청북도,005005, 4세,2017,13640,6921,6719,103,13525,6872,6653,103.3
33,충청북도,010,5~9세,2017,72095,37142,34953,106.3,71716,36962,34754,106.4
33,충청북도,010001, 5세,2017,14881,7583,7298,103.9,14794,7546,7248,104.1
33,충청북도,010002, 6세,2017,14857,7588,7269,104.4,14764,7544,7220,104.5
33,충청북도,010003, 7세,2017,14288,7363,6925,106.3,14214,7326,6888,106.4
33,충청북도,010004, 8세,2017,13676,7151,6525,109.6,13613,7121,6492,109.7
33,충청북도,010005, 9세,2017,14393,7457,6936,107.5,14331,7425,6906,107.5
33,충청북도,015,10~14세,2017,71447,37130,34317,108.2,71209,37003,34206,108.2
33,충청북도,015001, 10세,2017,14852,7651,7201,106.2,14791,7623,7168,106.3
33,충청북도,015002, 11세,2017,13481,6947,6534,106.3,13432,6914,6518,106.1
33,충청북도,015003, 12세,2017,13452,6973,6479,107.6,13405,6947,6458,107.6
33,충청북도,015004, 13세,2017,14719,7738,6981,110.8,14674,7716,6958,110.9
33,충청북도,015005, 14세,2017,14943,7821,7122,109.8,14907,7803,7104,109.8
33,충청북도,020,15~19세,2017,96815,50954,45861,111.1,95873,50435,45438,111
33,충청북도,020001, 15세,2017,15679,8211,7468,109.9,15631,8192,7439,110.1
33,충청북도,020002, 16세,2017,18017,9390,8627,108.8,17952,9356,8596,108.8
33,충청북도,020003, 17세,2017,19563,10216,9347,109.3,19465,10155,9310,109.1
33,충청북도,020004, 18세,2017,20256,10794,9462,114.1,20057,10690,9367,114.1
33,충청북도,020005, 19세,2017,23300,12343,10957,112.6,22768,12042,10726,112.3
33,충청북도,025,20~24세,2017,118717,65217,53500,121.9,112596,61397,51199,119.9
33,충청북도,025001, 20세,2017,23849,12140,11709,103.7,23074,11743,11331,103.6
33,충청북도,025002, 21세,2017,23906,12588,11318,111.2,22863,11946,10917,109.4
33,충청북도,025003, 22세,2017,24176,13198,10978,120.2,22828,12343,10485,117.7
33,충청북도,025004, 23세,2017,23573,13746,9827,139.9,22155,12819,9336,137.3
33,충청북도,025005, 24세,2017,23213,13545,9668,140.1,21676,12546,9130,137.4
33,충청북도,030,25~29세,2017,99523,56215,43308,129.8,90676,50340,40336,124.8
33,충청북도,030001, 25세,2017,22137,12911,9226,139.9,20520,11824,8696,136
33,충청북도,030002, 26세,2017,20344,11527,8817,130.7,18646,10414,8232,126.5
33,충청북도,030003, 27세,2017,19660,11077,8583,129.1,17726,9828,7898,124.4
33,충청북도,030004, 28세,2017,18753,10525,8228,127.9,16958,9300,7658,121.4
33,충청북도,030005, 29세,2017,18629,10175,8454,120.4,16826,8974,7852,114.3
33,충청북도,035,30~34세,2017,100098,54074,46024,117.5,92156,48691,43465,112
33,충청북도,035001, 30세,2017,18976,10306,8670,118.9,17123,9069,8054,112.6
33,충청북도,035002, 31세,2017,19369,10734,8635,124.3,17703,9591,8112,118.2
33,충청북도,035003, 32세,2017,19238,10374,8864,117,17632,9292,8340,111.4
33,충청북도,035004, 33세,2017,20559,11143,9416,118.3,19146,10176,8970,113.4
33,충청북도,035005, 34세,2017,21956,11517,10439,110.3,20552,10563,9989,105.7
33,충청북도,040,35~39세,2017,116122,61092,55030,111,110424,57179,53245,107.4
33,충청북도,040001, 35세,2017,24454,12812,11642,110,23096,11890,11206,106.1
33,충청북도,040002, 36세,2017,23264,12419,10845,114.5,22032,11554,10478,110.3
33,충청북도,040003, 37세,2017,24010,12509,11501,108.8,22953,11779,11174,105.4
33,충청북도,040004, 38세,2017,23004,12106,10898,111.1,21914,11363,10551,107.7
33,충청북도,040005, 39세,2017,21390,11246,10144,110.9,20429,10593,9836,107.7
33,충청북도,045,40~44세,2017,119249,61810,57439,107.6,115204,59261,55943,105.9
33,충청북도,045001, 40세,2017,22267,11653,10614,109.8,21324,11004,10320,106.6
33,충청북도,045002, 41세,2017,22171,11627,10544,110.3,21339,11089,10250,108.2
33,충청북도,045003, 42세,2017,23316,11933,11383,104.8,22547,11450,11097,103.2
33,충청북도,045004, 43세,2017,25639,13322,12317,108.2,24923,12904,12019,107.4
33,충청북도,045005, 44세,2017,25856,13275,12581,105.5,25071,12814,12257,104.5
33,충청북도,050,45~49세,2017,135000,69526,65474,106.2,130882,67102,63780,105.2
33,충청북도,050001, 45세,2017,24470,12791,11679,109.5,23660,12318,11342,108.6
33,충청북도,050002, 46세,2017,27107,14102,13005,108.4,26280,13608,12672,107.4
33,충청북도,050003, 47세,2017,26266,13689,12577,108.8,25423,13190,12233,107.8
33,충청북도,050004, 48세,2017,28836,14692,14144,103.9,28048,14222,13826,102.9
33,충청북도,050005, 49세,2017,28321,14252,14069,101.3,27471,13764,13707,100.4
33,충청북도,055,50~54세,2017,126496,65359,61137,106.9,122843,63303,59540,106.3
33,충청북도,055001, 50세,2017,26037,13331,12706,104.9,25383,12973,12410,104.5
33,충청북도,055002, 51세,2017,25872,13456,12416,108.4,25165,13067,12098,108
33,충청북도,055003, 52세,2017,26501,13580,12921,105.1,25763,13138,12625,104.1
33,충청북도,055004, 53세,2017,23323,12063,11260,107.1,22596,11663,10933,106.7
33,충청북도,055005, 54세,2017,24763,12929,11834,109.3,23936,12462,11474,108.6
33,충청북도,060,55~59세,2017,137450,70034,67416,103.9,134865,68632,66233,103.6
33,충청북도,060001, 55세,2017,27669,14375,13294,108.1,27051,14040,13011,107.9
33,충청북도,060002, 56세,2017,30993,15831,15162,104.4,30564,15605,14959,104.3
33,충청북도,060003, 57세,2017,27596,13786,13810,99.8,27030,13488,13542,99.6
33,충청북도,060004, 58세,2017,25773,12946,12827,100.9,25288,12687,12601,100.7
33,충청북도,060005, 59세,2017,25419,13096,12323,106.3,24932,12812,12120,105.7
33,충청북도,065,60~64세,2017,106038,53233,52805,100.8,104240,52178,52062,100.2
33,충청북도,065001, 60세,2017,24893,12652,12241,103.4,24401,12367,12034,102.8
33,충청북도,065002, 61세,2017,22830,11614,11216,103.5,22441,11372,11069,102.7
33,충청북도,065003, 62세,2017,21912,10802,11110,97.2,21574,10609,10965,96.8
33,충청북도,065004, 63세,2017,19580,9754,9826,99.3,19262,9566,9696,98.7
33,충청북도,065005, 64세,2017,16823,8411,8412,100,16562,8264,8298,99.6
33,충청북도,070,65~69세,2017,72124,35321,36803,96,71375,34940,36435,95.9
33,충청북도,070001, 65세,2017,19086,9465,9621,98.4,18884,9355,9529,98.2
33,충청북도,070002, 66세,2017,12538,6032,6506,92.7,12368,5942,6426,92.5
33,충청북도,070003, 67세,2017,13164,6394,6770,94.4,13039,6338,6701,94.6
33,충청북도,070004, 68세,2017,13763,6803,6960,97.7,13603,6714,6889,97.5
33,충청북도,070005, 69세,2017,13573,6627,6946,95.4,13481,6591,6890,95.7
33,충청북도,075,70~74세,2017,57665,26132,31533,82.9,57403,26012,31391,82.9
33,충청북도,075001, 70세,2017,13328,6290,7038,89.4,13250,6252,6998,89.3
33,충청북도,075002, 71세,2017,10214,4840,5374,90.1,10156,4813,5343,90.1
33,충청북도,075003, 72세,2017,11047,5078,5969,85.1,10996,5054,5942,85.1
33,충청북도,075004, 73세,2017,11266,4842,6424,75.4,11222,4827,6395,75.5
33,충청북도,075005, 74세,2017,11810,5082,6728,75.5,11779,5066,6713,75.5
33,충청북도,080,75~79세,2017,56653,23258,33395,69.6,56519,23221,33298,69.7
33,충청북도,080001, 75세,2017,14175,6079,8096,75.1,14142,6068,8074,75.2
33,충청북도,080002, 76세,2017,11512,4786,6726,71.2,11481,4778,6703,71.3
33,충청북도,080003, 77세,2017,10458,4286,6172,69.4,10433,4279,6154,69.5
33,충청북도,080004, 78세,2017,10876,4375,6501,67.3,10850,4368,6482,67.4
33,충청북도,080005, 79세,2017,9632,3732,5900,63.3,9613,3728,5885,63.3
33,충청북도,085,80~84세,2017,37632,13093,24539,53.4,37549,13066,24483,53.4
33,충청북도,085001, 80세,2017,9002,3412,5590,61,8980,3401,5579,61
33,충청북도,085002, 81세,2017,8474,3056,5418,56.4,8456,3053,5403,56.5
33,충청북도,085003, 82세,2017,8029,2747,5282,52,8013,2742,5271,52
33,충청북도,085004, 83세,2017,6507,2152,4355,49.4,6493,2146,4347,49.4
33,충청북도,085005, 84세,2017,5620,1726,3894,44.3,5607,1724,3883,44.4
33,충청북도,090,85~89세,2017,16273,4327,11946,36.2,16242,4318,11924,36.2
33,충청북도,090001, 85세,2017,4641,1358,3283,41.4,4633,1354,3279,41.3
33,충청북도,090002, 86세,2017,3367,900,2467,36.5,3360,898,2462,36.5
33,충청북도,090003, 87세,2017,3338,842,2496,33.7,3332,840,2492,33.7
33,충청북도,090004, 88세,2017,2780,703,2077,33.8,2774,702,2072,33.9
33,충청북도,090005, 89세,2017,2147,524,1623,32.3,2143,524,1619,32.4
33,충청북도,095,90~94세,2017,5306,1240,4066,30.5,5298,1237,4061,30.5
33,충청북도,095001, 90세,2017,1771,432,1339,32.3,1768,432,1336,32.3
33,충청북도,095002, 91세,2017,1143,266,877,30.3,1142,266,876,30.4
33,충청북도,095003, 92세,2017,1079,238,841,28.3,1078,238,840,28.3
33,충청북도,095004, 93세,2017,669,173,496,34.9,667,171,496,34.5
33,충청북도,095005, 94세,2017,644,131,513,25.5,643,130,513,25.3
33,충청북도,100,95~99세,2017,1241,242,999,24.2,1240,242,998,24.2
33,충청북도,100001, 95세,2017,494,114,380,30,494,114,380,30
33,충청북도,100002, 96세,2017,325,62,263,23.6,325,62,263,23.6
33,충청북도,100003, 97세,2017,191,29,162,17.9,190,29,161,18
33,충청북도,100004, 98세,2017,144,27,117,23.1,144,27,117,23.1
33,충청북도,100005, 99세,2017,87,10,77,13,87,10,77,13
33,충청북도,101,100세이상,2017,134,18,116,15.5,134,18,116,15.5
33,충청북도,102,15세미만,2017,208473,107355,101118,106.2,207253,106750,100503,106.2
33,충청북도,103,15~64세,2017,1155508,607514,547994,110.9,1109759,578518,531241,108.9
33,충청북도,104,65세이상,2017,247028,103631,143397,72.3,245760,103054,142706,72.2
33,충청북도,086,85세이상,2017,22954,5827,17127,34,22914,5815,17099,34
33,충청북도,126,평균연령,2017,41.9,40.5,43.4,,42.1,40.7,43.5,
33,충청북도,127,중위연령,2017,42.9,41.2,44.5,,43.3,41.8,44.8,
33004, 읍부,000,합계,2017,320852,165384,155468,106.4,310014,158623,151391,104.8
33004, 읍부,005,0~4세,2017,16336,8314,8022,103.6,16171,8222,7949,103.4
33004, 읍부,005001, 0세,2017,2979,1501,1478,101.6,2946,1479,1467,100.8
33004, 읍부,005002, 1세,2017,3304,1688,1616,104.5,3263,1664,1599,104.1
33004, 읍부,005003, 2세,2017,3407,1750,1657,105.6,3373,1728,1645,105
33004, 읍부,005004, 3세,2017,3327,1690,1637,103.2,3300,1677,1623,103.3
33004, 읍부,005005, 4세,2017,3319,1685,1634,103.1,3289,1674,1615,103.7
33004, 읍부,010,5~9세,2017,16825,8715,8110,107.5,16741,8672,8069,107.5
33004, 읍부,010001, 5세,2017,3604,1818,1786,101.8,3586,1811,1775,102
33004, 읍부,010002, 6세,2017,3519,1819,1700,107,3500,1809,1691,107
33004, 읍부,010003, 7세,2017,3311,1750,1561,112.1,3294,1741,1553,112.1
33004, 읍부,010004, 8세,2017,3119,1645,1474,111.6,3101,1637,1464,111.8
33004, 읍부,010005, 9세,2017,3272,1683,1589,105.9,3260,1674,1586,105.5
33004, 읍부,015,10~14세,2017,14971,7824,7147,109.5,14924,7793,7131,109.3
33004, 읍부,015001, 10세,2017,3286,1692,1594,106.1,3276,1688,1588,106.3
33004, 읍부,015002, 11세,2017,2875,1524,1351,112.8,2860,1513,1347,112.3
33004, 읍부,015003, 12세,2017,2865,1532,1333,114.9,2858,1528,1330,114.9
33004, 읍부,015004, 13세,2017,2998,1574,1424,110.5,2989,1567,1422,110.2
33004, 읍부,015005, 14세,2017,2947,1502,1445,103.9,2941,1497,1444,103.7
33004, 읍부,020,15~19세,2017,18856,9853,9003,109.4,18751,9798,8953,109.4
33004, 읍부,020001, 15세,2017,3113,1575,1538,102.4,3099,1571,1528,102.8
33004, 읍부,020002, 16세,2017,3696,1908,1788,106.7,3677,1897,1780,106.6
33004, 읍부,020003, 17세,2017,3952,1962,1990,98.6,3936,1952,1984,98.4
33004, 읍부,020004, 18세,2017,3874,2070,1804,114.7,3853,2057,1796,114.5
33004, 읍부,020005, 19세,2017,4221,2338,1883,124.2,4186,2321,1865,124.5
33004, 읍부,025,20~24세,2017,20792,11709,9083,128.9,19793,11080,8713,127.2
33004, 읍부,025001, 20세,2017,4450,2300,2150,107,4359,2258,2101,107.5
33004, 읍부,025002, 21세,2017,4206,2241,1965,114,4068,2146,1922,111.7
33004, 읍부,025003, 22세,2017,4149,2327,1822,127.7,3935,2199,1736,126.7
33004, 읍부,025004, 23세,2017,3999,2440,1559,156.5,3728,2266,1462,155
33004, 읍부,025005, 24세,2017,3988,2401,1587,151.3,3703,2211,1492,148.2
33004, 읍부,030,25~29세,2017,19124,10987,8137,135,17235,9736,7499,129.8
33004, 읍부,030001, 25세,2017,3997,2401,1596,150.4,3633,2154,1479,145.6
33004, 읍부,030002, 26세,2017,3710,2178,1532,142.2,3340,1929,1411,136.7
33004, 읍부,030003, 27세,2017,3774,2195,1579,139,3391,1942,1449,134
33004, 읍부,030004, 28세,2017,3805,2172,1633,133,3397,1903,1494,127.4
33004, 읍부,030005, 29세,2017,3838,2041,1797,113.6,3474,1808,1666,108.5
33004, 읍부,035,30~34세,2017,22736,12373,10363,119.4,20963,11189,9774,114.5
33004, 읍부,035001, 30세,2017,4122,2255,1867,120.8,3711,1979,1732,114.3
33004, 읍부,035002, 31세,2017,4284,2381,1903,125.1,3925,2137,1788,119.5
33004, 읍부,035003, 32세,2017,4441,2405,2036,118.1,4065,2156,1909,112.9
33004, 읍부,035004, 33세,2017,4797,2619,2178,120.2,4471,2406,2065,116.5
33004, 읍부,035005, 34세,2017,5092,2713,2379,114,4791,2511,2280,110.1
33004, 읍부,040,35~39세,2017,26589,14211,12378,114.8,25263,13301,11962,111.2
33004, 읍부,040001, 35세,2017,5625,2941,2684,109.6,5323,2734,2589,105.6
33004, 읍부,040002, 36세,2017,5306,2880,2426,118.7,5018,2674,2344,114.1
33004, 읍부,040003, 37세,2017,5535,2925,2610,112.1,5292,2759,2533,108.9
33004, 읍부,040004, 38세,2017,5262,2850,2412,118.2,4995,2676,2319,115.4
33004, 읍부,040005, 39세,2017,4861,2615,2246,116.4,4635,2458,2177,112.9
33004, 읍부,045,40~44세,2017,25068,13424,11644,115.3,24105,12848,11257,114.1
33004, 읍부,045001, 40세,2017,4796,2560,2236,114.5,4576,2418,2158,112
33004, 읍부,045002, 41세,2017,4771,2554,2217,115.2,4582,2441,2141,114
33004, 읍부,045003, 42세,2017,4918,2636,2282,115.5,4729,2518,2211,113.9
33004, 읍부,045004, 43세,2017,5237,2815,2422,116.2,5065,2719,2346,115.9
33004, 읍부,045005, 44세,2017,5346,2859,2487,115,5153,2752,2401,114.6
33004, 읍부,050,45~49세,2017,25808,14031,11777,119.1,24794,13418,11376,118
33004, 읍부,050001, 45세,2017,4839,2615,2224,117.6,4643,2489,2154,115.6
33004, 읍부,050002, 46세,2017,5295,2853,2442,116.8,5095,2725,2370,115
33004, 읍부,050003, 47세,2017,5006,2811,2195,128.1,4789,2697,2092,128.9
33004, 읍부,050004, 48세,2017,5476,2971,2505,118.6,5280,2842,2438,116.6
33004, 읍부,050005, 49세,2017,5192,2781,2411,115.3,4987,2665,2322,114.8
33004, 읍부,055,50~54세,2017,22690,12060,10630,113.5,21734,11510,10224,112.6
33004, 읍부,055001, 50세,2017,4669,2492,2177,114.5,4505,2411,2094,115.1
33004, 읍부,055002, 51세,2017,4625,2455,2170,113.1,4447,2359,2088,113
33004, 읍부,055003, 52세,2017,4803,2538,2265,112.1,4595,2414,2181,110.7
33004, 읍부,055004, 53세,2017,4165,2240,1925,116.4,3963,2120,1843,115
33004, 읍부,055005, 54세,2017,4428,2335,2093,111.6,4224,2206,2018,109.3
33004, 읍부,060,55~59세,2017,24648,12640,12008,105.3,23991,12304,11687,105.3
33004, 읍부,060001, 55세,2017,5048,2721,2327,116.9,4882,2633,2249,117.1
33004, 읍부,060002, 56세,2017,5524,2824,2700,104.6,5426,2776,2650,104.8
33004, 읍부,060003, 57세,2017,4910,2429,2481,97.9,4757,2355,2402,98
33004, 읍부,060004, 58세,2017,4658,2356,2302,102.3,4548,2309,2239,103.1
33004, 읍부,060005, 59세,2017,4508,2310,2198,105.1,4378,2231,2147,103.9
33004, 읍부,065,60~64세,2017,19470,9702,9768,99.3,18961,9390,9571,98.1
33004, 읍부,065001, 60세,2017,4537,2310,2227,103.7,4403,2224,2179,102.1
33004, 읍부,065002, 61세,2017,4128,2075,2053,101.1,4029,2019,2010,100.4
33004, 읍부,065003, 62세,2017,4081,2001,2080,96.2,3971,1936,2035,95.1
33004, 읍부,065004, 63세,2017,3624,1768,1856,95.3,3524,1701,1823,93.3
33004, 읍부,065005, 64세,2017,3100,1548,1552,99.7,3034,1510,1524,99.1
33004, 읍부,070,65~69세,2017,13586,6570,7016,93.6,13375,6444,6931,93
33004, 읍부,070001, 65세,2017,3446,1708,1738,98.3,3384,1670,1714,97.4
33004, 읍부,070002, 66세,2017,2357,1121,1236,90.7,2310,1088,1222,89
33004, 읍부,070003, 67세,2017,2576,1224,1352,90.5,2547,1209,1338,90.4
33004, 읍부,070004, 68세,2017,2677,1328,1349,98.4,2629,1296,1333,97.2
33004, 읍부,070005, 69세,2017,2530,1189,1341,88.7,2505,1181,1324,89.2
33004, 읍부,075,70~74세,2017,10966,4913,6053,81.2,10891,4882,6009,81.2
33004, 읍부,075001, 70세,2017,2533,1190,1343,88.6,2506,1181,1325,89.1
33004, 읍부,075002, 71세,2017,1985,923,1062,86.9,1967,911,1056,86.3
33004, 읍부,075003, 72세,2017,2036,954,1082,88.2,2023,949,1074,88.4
33004, 읍부,075004, 73세,2017,2095,872,1223,71.3,2083,869,1214,71.6
33004, 읍부,075005, 74세,2017,2317,974,1343,72.5,2312,972,1340,72.5
33004, 읍부,080,75~79세,2017,10826,4494,6332,71,10791,4482,6309,71
33004, 읍부,080001, 75세,2017,2694,1147,1547,74.1,2689,1143,1546,73.9
33004, 읍부,080002, 76세,2017,2179,922,1257,73.3,2165,917,1248,73.5
33004, 읍부,080003, 77세,2017,2022,870,1152,75.5,2015,869,1146,75.8
33004, 읍부,080004, 78세,2017,2053,834,1219,68.4,2047,833,1214,68.6
33004, 읍부,080005, 79세,2017,1878,721,1157,62.3,1875,720,1155,62.3
33004, 읍부,085,80~84세,2017,7104,2429,4675,52,7086,2422,4664,51.9
33004, 읍부,085001, 80세,2017,1671,638,1033,61.8,1663,633,1030,61.5
33004, 읍부,085002, 81세,2017,1598,547,1051,52,1596,547,1049,52.1
33004, 읍부,085003, 82세,2017,1518,503,1015,49.6,1517,502,1015,49.5
33004, 읍부,085004, 83세,2017,1253,430,823,52.2,1250,429,821,52.3
33004, 읍부,085005, 84세,2017,1064,311,753,41.3,1060,311,749,41.5
33004, 읍부,090,85~89세,2017,3196,853,2343,36.4,3188,851,2337,36.4
33004, 읍부,090001, 85세,2017,927,262,665,39.4,925,261,664,39.3
33004, 읍부,090002, 86세,2017,689,193,496,38.9,687,193,494,39.1
33004, 읍부,090003, 87세,2017,623,152,471,32.3,621,152,469,32.4
33004, 읍부,090004, 88세,2017,542,145,397,36.5,540,144,396,36.4
33004, 읍부,090005, 89세,2017,415,101,314,32.2,415,101,314,32.2
33004, 읍부,095,90~94세,2017,1023,237,786,30.2,1019,236,783,30.1
33004, 읍부,095001, 90세,2017,309,81,228,35.5,308,81,227,35.7
33004, 읍부,095002, 91세,2017,215,45,170,26.5,214,45,169,26.6
33004, 읍부,095003, 92세,2017,195,46,149,30.9,194,46,148,31.1
33004, 읍부,095004, 93세,2017,151,41,110,37.3,151,41,110,37.3
33004, 읍부,095005, 94세,2017,153,24,129,18.6,152,23,129,17.8
33004, 읍부,100,95~99세,2017,221,44,177,24.9,221,44,177,24.9
33004, 읍부,100001, 95세,2017,89,17,72,23.6,89,17,72,23.6
33004, 읍부,100002, 96세,2017,58,12,46,26.1,58,12,46,26.1
33004, 읍부,100003, 97세,2017,25,6,19,31.6,25,6,19,31.6
33004, 읍부,100004, 98세,2017,31,7,24,29.2,31,7,24,29.2
33004, 읍부,100005, 99세,2017,18,X,16,12.5,18,X,16,12.5
33004, 읍부,101,100세이상,2017,17,X,16,6.3,17,X,16,6.3
33004, 읍부,102,15세미만,2017,48132,24853,23279,106.8,47836,24687,23149,106.6
33004, 읍부,103,15~64세,2017,225781,120990,104791,115.5,215590,114574,101016,113.4
33004, 읍부,104,65세이상,2017,46939,19541,27398,71.3,46588,19362,27226,71.1
33004, 읍부,086,85세이상,2017,4457,1135,3322,34.2,4445,1132,3313,34.2
33004, 읍부,126,평균연령,2017,40.7,39.3,42.1,,40.8,39.4,42.2,
33004, 읍부,127,중위연령,2017,40.9,39.5,42.5,,41.1,39.8,42.6,
33005, 면부,000,합계,2017,344064,179939,164125,109.6,323499,165361,158138,104.6
33005, 면부,005,0~4세,2017,9145,4633,4512,102.7,9010,4568,4442,102.8
33005, 면부,005001, 0세,2017,1698,863,835,103.4,1667,848,819,103.5
33005, 면부,005002, 1세,2017,1898,996,902,110.4,1862,978,884,110.6
33005, 면부,005003, 2세,2017,1850,948,902,105.1,1828,938,890,105.4
33005, 면부,005004, 3세,2017,1847,902,945,95.4,1823,890,933,95.4
33005, 면부,005005, 4세,2017,1852,924,928,99.6,1830,914,916,99.8
33005, 면부,010,5~9세,2017,9703,5063,4640,109.1,9620,5029,4591,109.5
33005, 면부,010001, 5세,2017,2015,1038,977,106.2,1994,1029,965,106.6
33005, 면부,010002, 6세,2017,1988,1027,961,106.9,1972,1023,949,107.8
33005, 면부,010003, 7세,2017,1885,979,906,108.1,1875,974,901,108.1
33005, 면부,010004, 8세,2017,1856,985,871,113.1,1841,980,861,113.8
33005, 면부,010005, 9세,2017,1959,1034,925,111.8,1938,1023,915,111.8
33005, 면부,015,10~14세,2017,9584,5090,4494,113.3,9544,5072,4472,113.4
33005, 면부,015001, 10세,2017,1989,1043,946,110.3,1979,1039,940,110.5
33005, 면부,015002, 11세,2017,1781,903,878,102.8,1773,897,876,102.4
33005, 면부,015003, 12세,2017,1769,940,829,113.4,1760,934,826,113.1
33005, 면부,015004, 13세,2017,1998,1083,915,118.4,1991,1082,909,119
33005, 면부,015005, 14세,2017,2047,1121,926,121.1,2041,1120,921,121.6
33005, 면부,020,15~19세,2017,14091,7577,6514,116.3,13930,7475,6455,115.8
33005, 면부,020001, 15세,2017,2225,1151,1074,107.2,2217,1148,1069,107.4
33005, 면부,020002, 16세,2017,2469,1320,1149,114.9,2458,1315,1143,115
33005, 면부,020003, 17세,2017,2728,1496,1232,121.4,2702,1473,1229,119.9
33005, 면부,020004, 18세,2017,2949,1617,1332,121.4,2912,1596,1316,121.3
33005, 면부,020005, 19세,2017,3720,1993,1727,115.4,3641,1943,1698,114.4
33005, 면부,025,20~24세,2017,20087,11775,8312,141.7,17817,10066,7751,129.9
33005, 면부,025001, 20세,2017,3807,1987,1820,109.2,3637,1879,1758,106.9
33005, 면부,025002, 21세,2017,3906,2142,1764,121.4,3588,1910,1678,113.8
33005, 면부,025003, 22세,2017,4164,2404,1760,136.6,3670,2025,1645,123.1
33005, 면부,025004, 23세,2017,4026,2537,1489,170.4,3449,2084,1365,152.7
33005, 면부,025005, 24세,2017,4184,2705,1479,182.9,3473,2168,1305,166.1
33005, 면부,030,25~29세,2017,18582,11564,7018,164.8,14190,8292,5898,140.6
33005, 면부,030001, 25세,2017,3912,2454,1458,168.3,3137,1869,1268,147.4
33005, 면부,030002, 26세,2017,3708,2300,1408,163.4,2879,1681,1198,140.3
33005, 면부,030003, 27세,2017,3754,2319,1435,161.6,2789,1623,1166,139.2
33005, 면부,030004, 28세,2017,3628,2269,1359,167,2714,1568,1146,136.8
33005, 면부,030005, 29세,2017,3580,2222,1358,163.6,2671,1551,1120,138.5
33005, 면부,035,30~34세,2017,17823,10925,6898,158.4,13911,7946,5965,133.2
33005, 면부,035001, 30세,2017,3563,2155,1408,153.1,2669,1497,1172,127.7
33005, 면부,035002, 31세,2017,3530,2186,1344,162.6,2679,1535,1144,134.2
33005, 면부,035003, 32세,2017,3437,2178,1259,173,2656,1573,1083,145.2
33005, 면부,035004, 33세,2017,3486,2155,1331,161.9,2769,1600,1169,136.9
33005, 면부,035005, 34세,2017,3807,2251,1556,144.7,3138,1741,1397,124.6
33005, 면부,040,35~39세,2017,18836,11157,7679,145.3,16091,9079,7012,129.5
33005, 면부,040001, 35세,2017,4004,2377,1627,146.1,3317,1863,1454,128.1
33005, 면부,040002, 36세,2017,3939,2366,1573,150.4,3351,1913,1438,133
33005, 면부,040003, 37세,2017,3855,2245,1610,139.4,3321,1851,1470,125.9
33005, 면부,040004, 38세,2017,3661,2154,1507,142.9,3153,1767,1386,127.5
33005, 면부,040005, 39세,2017,3377,2015,1362,147.9,2949,1685,1264,133.3
33005, 면부,045,40~44세,2017,18808,11199,7609,147.2,17011,9947,7064,140.8
33005, 면부,045001, 40세,2017,3576,2149,1427,150.6,3157,1832,1325,138.3
33005, 면부,045002, 41세,2017,3581,2181,1400,155.8,3180,1896,1284,147.7
33005, 면부,045003, 42세,2017,3644,2157,1487,145.1,3304,1918,1386,138.4
33005, 면부,045004, 43세,2017,3971,2342,1629,143.8,3653,2141,1512,141.6
33005, 면부,045005, 44세,2017,4036,2370,1666,142.3,3717,2160,1557,138.7
33005, 면부,050,45~49세,2017,23123,13076,10047,130.1,21477,12047,9430,127.8
33005, 면부,050001, 45세,2017,3832,2249,1583,142.1,3491,2034,1457,139.6
33005, 면부,050002, 46세,2017,4496,2610,1886,138.4,4165,2404,1761,136.5
33005, 면부,050003, 47세,2017,4445,2559,1886,135.7,4119,2356,1763,133.6
33005, 면부,050004, 48세,2017,5049,2780,2269,122.5,4737,2583,2154,119.9
33005, 면부,050005, 49세,2017,5301,2878,2423,118.8,4965,2670,2295,116.3
33005, 면부,055,50~54세,2017,27538,14922,12616,118.3,26069,14017,12052,116.3
33005, 면부,055001, 50세,2017,5173,2767,2406,115,4893,2604,2289,113.8
33005, 면부,055002, 51세,2017,5468,3052,2416,126.3,5183,2879,2304,125
33005, 면부,055003, 52세,2017,5798,3118,2680,116.3,5507,2922,2585,113
33005, 면부,055004, 53세,2017,5347,2819,2528,111.5,5067,2648,2419,109.5
33005, 면부,055005, 54세,2017,5752,3166,2586,122.4,5419,2964,2455,120.7
33005, 면부,060,55~59세,2017,35604,18780,16824,111.6,34671,18203,16468,110.5
33005, 면부,060001, 55세,2017,6651,3524,3127,112.7,6420,3379,3041,111.1
33005, 면부,060002, 56세,2017,7834,4158,3676,113.1,7664,4065,3599,112.9
33005, 면부,060003, 57세,2017,7170,3684,3486,105.7,6969,3564,3405,104.7
33005, 면부,060004, 58세,2017,6934,3698,3236,114.3,6762,3582,3180,112.6
33005, 면부,060005, 59세,2017,7015,3716,3299,112.6,6856,3613,3243,111.4
33005, 면부,065,60~64세,2017,31447,16292,15155,107.5,30830,15903,14927,106.5
33005, 면부,065001, 60세,2017,7042,3718,3324,111.9,6868,3610,3258,110.8
33005, 면부,065002, 61세,2017,6722,3530,3192,110.6,6580,3432,3148,109
33005, 면부,065003, 62세,2017,6466,3258,3208,101.6,6363,3197,3166,101
33005, 면부,065004, 63세,2017,6116,3120,2996,104.1,6010,3053,2957,103.2
33005, 면부,065005, 64세,2017,5101,2666,2435,109.5,5009,2611,2398,108.9
33005, 면부,070,65~69세,2017,23059,11760,11299,104.1,22843,11651,11192,104.1
33005, 면부,070001, 65세,2017,5966,3091,2875,107.5,5899,3056,2843,107.5
33005, 면부,070002, 66세,2017,4000,1984,2016,98.4,3962,1965,1997,98.4
33005, 면부,070003, 67세,2017,4183,2136,2047,104.3,4135,2109,2026,104.1
33005, 면부,070004, 68세,2017,4549,2315,2234,103.6,4514,2298,2216,103.7
33005, 면부,070005, 69세,2017,4361,2234,2127,105,4333,2223,2110,105.4
33005, 면부,075,70~74세,2017,19462,9047,10415,86.9,19386,9007,10379,86.8
33005, 면부,075001, 70세,2017,4262,2150,2112,101.8,4240,2135,2105,101.4
33005, 면부,075002, 71세,2017,3428,1705,1723,99,3411,1698,1713,99.1
33005, 면부,075003, 72세,2017,3737,1736,2001,86.8,3723,1730,1993,86.8
33005, 면부,075004, 73세,2017,3861,1636,2225,73.5,3847,1631,2216,73.6
33005, 면부,075005, 74세,2017,4174,1820,2354,77.3,4165,1813,2352,77.1
33005, 면부,080,75~79세,2017,21895,9059,12836,70.6,21853,9048,12805,70.7
33005, 면부,080001, 75세,2017,5268,2288,2980,76.8,5255,2284,2971,76.9
33005, 면부,080002, 76세,2017,4381,1865,2516,74.1,4374,1863,2511,74.2
33005, 면부,080003, 77세,2017,4046,1642,2404,68.3,4037,1639,2398,68.3
33005, 면부,080004, 78세,2017,4339,1734,2605,66.6,4334,1733,2601,66.6
33005, 면부,080005, 79세,2017,3861,1530,2331,65.6,3853,1529,2324,65.8
33005, 면부,085,80~84세,2017,15716,5461,10255,53.3,15693,5453,10240,53.3
33005, 면부,085001, 80세,2017,3650,1381,2269,60.9,3644,1379,2265,60.9
33005, 면부,085002, 81세,2017,3459,1261,2198,57.4,3454,1259,2195,57.4
33005, 면부,085003, 82세,2017,3441,1162,2279,51,3436,1160,2276,51
33005, 면부,085004, 83세,2017,2757,906,1851,48.9,2754,905,1849,48.9
33005, 면부,085005, 84세,2017,2409,751,1658,45.3,2405,750,1655,45.3
33005, 면부,090,85~89세,2017,6790,1895,4895,38.7,6785,1894,4891,38.7
33005, 면부,090001, 85세,2017,1926,612,1314,46.6,1925,612,1313,46.6
33005, 면부,090002, 86세,2017,1382,350,1032,33.9,1381,350,1031,33.9
33005, 면부,090003, 87세,2017,1373,366,1007,36.3,1372,365,1007,36.2
33005, 면부,090004, 88세,2017,1162,320,842,38,1161,320,841,38
33005, 면부,090005, 89세,2017,947,247,700,35.3,946,247,699,35.3
33005, 면부,095,90~94세,2017,2198,554,1644,33.7,2196,554,1642,33.7
33005, 면부,095001, 90세,2017,756,189,567,33.3,754,189,565,33.5
33005, 면부,095002, 91세,2017,479,129,350,36.9,479,129,350,36.9
33005, 면부,095003, 92세,2017,441,97,344,28.2,441,97,344,28.2
33005, 면부,095004, 93세,2017,272,85,187,45.5,272,85,187,45.5
33005, 면부,095005, 94세,2017,250,54,196,27.6,250,54,196,27.6
33005, 면부,100,95~99세,2017,513,100,413,24.2,512,100,412,24.3
33005, 면부,100001, 95세,2017,200,48,152,31.6,200,48,152,31.6
33005, 면부,100002, 96세,2017,127,25,102,24.5,127,25,102,24.5
33005, 면부,100003, 97세,2017,90,14,76,18.4,89,14,75,18.7
33005, 면부,100004, 98세,2017,62,9,53,17,62,9,53,17
33005, 면부,100005, 99세,2017,34,X,30,13.3,34,X,30,13.3
33005, 면부,101,100세이상,2017,60,10,50,20,60,10,50,20
33005, 면부,102,15세미만,2017,28432,14786,13646,108.4,28174,14669,13505,108.6
33005, 면부,103,15~64세,2017,225939,127267,98672,129,205997,112975,93022,121.4
33005, 면부,104,65세이상,2017,89693,37886,51807,73.1,89328,37717,51611,73.1
33005, 면부,086,85세이상,2017,9561,2559,7002,36.5,9553,2558,6995,36.6
33005, 면부,126,평균연령,2017,49,46.7,51.6,,49.8,47.7,52.1,
33005, 면부,127,중위연령,2017,52.3,49.3,55.6,,53.7,51.2,56.2,
33003, 동부,000,합계,2017,946093,473177,472916,100.1,929259,464338,464921,99.9
33003, 동부,005,0~4세,2017,39450,20136,19314,104.3,39147,19995,19152,104.4
33003, 동부,005001, 0세,2017,6857,3587,3270,109.7,6796,3562,3234,110.1
33003, 동부,005002, 1세,2017,7780,3979,3801,104.7,7726,3951,3775,104.7
33003, 동부,005003, 2세,2017,8096,4124,3972,103.8,8033,4095,3938,104
33003, 동부,005004, 3세,2017,8248,4134,4114,100.5,8186,4103,4083,100.5
33003, 동부,005005, 4세,2017,8469,4312,4157,103.7,8406,4284,4122,103.9
33003, 동부,010,5~9세,2017,45567,23364,22203,105.2,45355,23261,22094,105.3
33003, 동부,010001, 5세,2017,9262,4727,4535,104.2,9214,4706,4508,104.4
33003, 동부,010002, 6세,2017,9350,4742,4608,102.9,9292,4712,4580,102.9
33003, 동부,010003, 7세,2017,9092,4634,4458,103.9,9045,4611,4434,104
33003, 동부,010004, 8세,2017,8701,4521,4180,108.2,8671,4504,4167,108.1
33003, 동부,010005, 9세,2017,9162,4740,4422,107.2,9133,4728,4405,107.3
33003, 동부,015,10~14세,2017,46892,24216,22676,106.8,46741,24138,22603,106.8
33003, 동부,015001, 10세,2017,9577,4916,4661,105.5,9536,4896,4640,105.5
33003, 동부,015002, 11세,2017,8825,4520,4305,105,8799,4504,4295,104.9
33003, 동부,015003, 12세,2017,8818,4501,4317,104.3,8787,4485,4302,104.3
33003, 동부,015004, 13세,2017,9723,5081,4642,109.5,9694,5067,4627,109.5
33003, 동부,015005, 14세,2017,9949,5198,4751,109.4,9925,5186,4739,109.4
33003, 동부,020,15~19세,2017,63868,33524,30344,110.5,63192,33162,30030,110.4
33003, 동부,020001, 15세,2017,10341,5485,4856,113,10315,5473,4842,113
33003, 동부,020002, 16세,2017,11852,6162,5690,108.3,11817,6144,5673,108.3
33003, 동부,020003, 17세,2017,12883,6758,6125,110.3,12827,6730,6097,110.4
33003, 동부,020004, 18세,2017,13433,7107,6326,112.3,13292,7037,6255,112.5
33003, 동부,020005, 19세,2017,15359,8012,7347,109.1,14941,7778,7163,108.6
33003, 동부,025,20~24세,2017,77838,41733,36105,115.6,74986,40251,34735,115.9
33003, 동부,025001, 20세,2017,15592,7853,7739,101.5,15078,7606,7472,101.8
33003, 동부,025002, 21세,2017,15794,8205,7589,108.1,15207,7890,7317,107.8
33003, 동부,025003, 22세,2017,15863,8467,7396,114.5,15223,8119,7104,114.3
33003, 동부,025004, 23세,2017,15548,8769,6779,129.4,14978,8469,6509,130.1
33003, 동부,025005, 24세,2017,15041,8439,6602,127.8,14500,8167,6333,129
33003, 동부,030,25~29세,2017,61817,33664,28153,119.6,59251,32312,26939,119.9
33003, 동부,030001, 25세,2017,14228,8056,6172,130.5,13750,7801,5949,131.1
33003, 동부,030002, 26세,2017,12926,7049,5877,119.9,12427,6804,5623,121
33003, 동부,030003, 27세,2017,12132,6563,5569,117.8,11546,6263,5283,118.6
33003, 동부,030004, 28세,2017,11320,6084,5236,116.2,10847,5829,5018,116.2
33003, 동부,030005, 29세,2017,11211,5912,5299,111.6,10681,5615,5066,110.8
33003, 동부,035,30~34세,2017,59539,30776,28763,107,57282,29556,27726,106.6
33003, 동부,035001, 30세,2017,11291,5896,5395,109.3,10743,5593,5150,108.6
33003, 동부,035002, 31세,2017,11555,6167,5388,114.5,11099,5919,5180,114.3
33003, 동부,035003, 32세,2017,11360,5791,5569,104,10911,5563,5348,104
33003, 동부,035004, 33세,2017,12276,6369,5907,107.8,11906,6170,5736,107.6
33003, 동부,035005, 34세,2017,13057,6553,6504,100.8,12623,6311,6312,100
33003, 동부,040,35~39세,2017,70697,35724,34973,102.1,69070,34799,34271,101.5
33003, 동부,040001, 35세,2017,14825,7494,7331,102.2,14456,7293,7163,101.8
33003, 동부,040002, 36세,2017,14019,7173,6846,104.8,13663,6967,6696,104
33003, 동부,040003, 37세,2017,14620,7339,7281,100.8,14340,7169,7171,100
33003, 동부,040004, 38세,2017,14081,7102,6979,101.8,13766,6920,6846,101.1
33003, 동부,040005, 39세,2017,13152,6616,6536,101.2,12845,6450,6395,100.9
33003, 동부,045,40~44세,2017,75373,37187,38186,97.4,74088,36466,37622,96.9
33003, 동부,045001, 40세,2017,13895,6944,6951,99.9,13591,6754,6837,98.8
33003, 동부,045002, 41세,2017,13819,6892,6927,99.5,13577,6752,6825,98.9
33003, 동부,045003, 42세,2017,14754,7140,7614,93.8,14514,7014,7500,93.5
33003, 동부,045004, 43세,2017,16431,8165,8266,98.8,16205,8044,8161,98.6
33003, 동부,045005, 44세,2017,16474,8046,8428,95.5,16201,7902,8299,95.2
33003, 동부,050,45~49세,2017,86069,42419,43650,97.2,84611,41637,42974,96.9
33003, 동부,050001, 45세,2017,15799,7927,7872,100.7,15526,7795,7731,100.8
33003, 동부,050002, 46세,2017,17316,8639,8677,99.6,17020,8479,8541,99.3
33003, 동부,050003, 47세,2017,16815,8319,8496,97.9,16515,8137,8378,97.1
33003, 동부,050004, 48세,2017,18311,8941,9370,95.4,18031,8797,9234,95.3
33003, 동부,050005, 49세,2017,17828,8593,9235,93,17519,8429,9090,92.7
33003, 동부,055,50~54세,2017,76268,38377,37891,101.3,75040,37776,37264,101.4
33003, 동부,055001, 50세,2017,16195,8072,8123,99.4,15985,7958,8027,99.1
33003, 동부,055002, 51세,2017,15779,7949,7830,101.5,15535,7829,7706,101.6
33003, 동부,055003, 52세,2017,15900,7924,7976,99.3,15661,7802,7859,99.3
33003, 동부,055004, 53세,2017,13811,7004,6807,102.9,13566,6895,6671,103.4
33003, 동부,055005, 54세,2017,14583,7428,7155,103.8,14293,7292,7001,104.2
33003, 동부,060,55~59세,2017,77198,38614,38584,100.1,76203,38125,38078,100.1
33003, 동부,060001, 55세,2017,15970,8130,7840,103.7,15749,8028,7721,104
33003, 동부,060002, 56세,2017,17635,8849,8786,100.7,17474,8764,8710,100.6
33003, 동부,060003, 57세,2017,15516,7673,7843,97.8,15304,7569,7735,97.9
33003, 동부,060004, 58세,2017,14181,6892,7289,94.6,13978,6796,7182,94.6
33003, 동부,060005, 59세,2017,13896,7070,6826,103.6,13698,6968,6730,103.5
33003, 동부,065,60~64세,2017,55121,27239,27882,97.7,54449,26885,27564,97.5
33003, 동부,065001, 60세,2017,13314,6624,6690,99,13130,6533,6597,99
33003, 동부,065002, 61세,2017,11980,6009,5971,100.6,11832,5921,5911,100.2
33003, 동부,065003, 62세,2017,11365,5543,5822,95.2,11240,5476,5764,95
33003, 동부,065004, 63세,2017,9840,4866,4974,97.8,9728,4812,4916,97.9
33003, 동부,065005, 64세,2017,8622,4197,4425,94.8,8519,4143,4376,94.7
33003, 동부,070,65~69세,2017,35479,16991,18488,91.9,35157,16845,18312,92
33003, 동부,070001, 65세,2017,9674,4666,5008,93.2,9601,4629,4972,93.1
33003, 동부,070002, 66세,2017,6181,2927,3254,90,6096,2889,3207,90.1
33003, 동부,070003, 67세,2017,6405,3034,3371,90,6357,3020,3337,90.5
33003, 동부,070004, 68세,2017,6537,3160,3377,93.6,6460,3120,3340,93.4
33003, 동부,070005, 69세,2017,6682,3204,3478,92.1,6643,3187,3456,92.2
33003, 동부,075,70~74세,2017,27237,12172,15065,80.8,27126,12123,15003,80.8
33003, 동부,075001, 70세,2017,6533,2950,3583,82.3,6504,2936,3568,82.3
33003, 동부,075002, 71세,2017,4801,2212,2589,85.4,4778,2204,2574,85.6
33003, 동부,075003, 72세,2017,5274,2388,2886,82.7,5250,2375,2875,82.6
33003, 동부,075004, 73세,2017,5310,2334,2976,78.4,5292,2327,2965,78.5
33003, 동부,075005, 74세,2017,5319,2288,3031,75.5,5302,2281,3021,75.5
33003, 동부,080,75~79세,2017,23932,9705,14227,68.2,23875,9691,14184,68.3
33003, 동부,080001, 75세,2017,6213,2644,3569,74.1,6198,2641,3557,74.2
33003, 동부,080002, 76세,2017,4952,1999,2953,67.7,4942,1998,2944,67.9
33003, 동부,080003, 77세,2017,4390,1774,2616,67.8,4381,1771,2610,67.9
33003, 동부,080004, 78세,2017,4484,1807,2677,67.5,4469,1802,2667,67.6
33003, 동부,080005, 79세,2017,3893,1481,2412,61.4,3885,1479,2406,61.5
33003, 동부,085,80~84세,2017,14812,5203,9609,54.1,14770,5191,9579,54.2
33003, 동부,085001, 80세,2017,3681,1393,2288,60.9,3673,1389,2284,60.8
33003, 동부,085002, 81세,2017,3417,1248,2169,57.5,3406,1247,2159,57.8
33003, 동부,085003, 82세,2017,3070,1082,1988,54.4,3060,1080,1980,54.5
33003, 동부,085004, 83세,2017,2497,816,1681,48.5,2489,812,1677,48.4
33003, 동부,085005, 84세,2017,2147,664,1483,44.8,2142,663,1479,44.8
33003, 동부,090,85~89세,2017,6287,1579,4708,33.5,6269,1573,4696,33.5
33003, 동부,090001, 85세,2017,1788,484,1304,37.1,1783,481,1302,36.9
33003, 동부,090002, 86세,2017,1296,357,939,38,1292,355,937,37.9
33003, 동부,090003, 87세,2017,1342,324,1018,31.8,1339,323,1016,31.8
33003, 동부,090004, 88세,2017,1076,238,838,28.4,1073,238,835,28.5
33003, 동부,090005, 89세,2017,785,176,609,28.9,782,176,606,29
33003, 동부,095,90~94세,2017,2085,449,1636,27.4,2083,447,1636,27.3
33003, 동부,095001, 90세,2017,706,162,544,29.8,706,162,544,29.8
33003, 동부,095002, 91세,2017,449,92,357,25.8,449,92,357,25.8
33003, 동부,095003, 92세,2017,443,95,348,27.3,443,95,348,27.3
33003, 동부,095004, 93세,2017,246,47,199,23.6,244,45,199,22.6
33003, 동부,095005, 94세,2017,241,53,188,28.2,241,53,188,28.2
33003, 동부,100,95~99세,2017,507,98,409,24,507,98,409,24
33003, 동부,100001, 95세,2017,205,49,156,31.4,205,49,156,31.4
33003, 동부,100002, 96세,2017,140,25,115,21.7,140,25,115,21.7
33003, 동부,100003, 97세,2017,76,9,67,13.4,76,9,67,13.4
33003, 동부,100004, 98세,2017,51,11,40,27.5,51,11,40,27.5
33003, 동부,100005, 99세,2017,35,X,31,12.9,35,X,31,12.9
33003, 동부,101,100세이상,2017,57,7,50,14,57,7,50,14
33003, 동부,102,15세미만,2017,131909,67716,64193,105.5,131243,67394,63849,105.6
33003, 동부,103,15~64세,2017,703788,359257,344531,104.3,688172,350969,337203,104.1
33003, 동부,104,65세이상,2017,110396,46204,64192,72,109844,45975,63869,72
33003, 동부,086,85세이상,2017,8936,2133,6803,31.4,8916,2125,6791,31.3
33003, 동부,126,평균연령,2017,39.7,38.6,40.9,,39.8,38.6,41,
33003, 동부,127,중위연령,2017,40.5,39,42,,40.7,39.2,42.2,
33020, 충주시,000,합계,2017,212274,108092,104182,103.8,206078,104218,101860,102.3
33020, 충주시,005,0~4세,2017,7182,3638,3544,102.7,7153,3624,3529,102.7
33020, 충주시,005001, 0세,2017,1251,659,592,111.3,1244,656,588,111.6
33020, 충주시,005002, 1세,2017,1465,741,724,102.3,1464,741,723,102.5
33020, 충주시,005003, 2세,2017,1455,729,726,100.4,1446,725,721,100.6
33020, 충주시,005004, 3세,2017,1504,739,765,96.6,1500,736,764,96.3
33020, 충주시,005005, 4세,2017,1507,770,737,104.5,1499,766,733,104.5
33020, 충주시,010,5~9세,2017,8484,4334,4150,104.4,8457,4325,4132,104.7
33020, 충주시,010001, 5세,2017,1645,802,843,95.1,1640,801,839,95.5
33020, 충주시,010002, 6세,2017,1764,936,828,113,1757,933,824,113.2
33020, 충주시,010003, 7세,2017,1703,828,875,94.6,1697,825,872,94.6
33020, 충주시,010004, 8세,2017,1609,824,785,105,1604,823,781,105.4
33020, 충주시,010005, 9세,2017,1763,944,819,115.3,1759,943,816,115.6
33020, 충주시,015,10~14세,2017,8975,4652,4323,107.6,8962,4640,4322,107.4
33020, 충주시,015001, 10세,2017,1868,959,909,105.5,1866,957,909,105.3
33020, 충주시,015002, 11세,2017,1662,857,805,106.5,1660,856,804,106.5
33020, 충주시,015003, 12세,2017,1662,873,789,110.6,1658,869,789,110.1
33020, 충주시,015004, 13세,2017,1879,960,919,104.5,1874,955,919,103.9
33020, 충주시,015005, 14세,2017,1904,1003,901,111.3,1904,1003,901,111.3
33020, 충주시,020,15~19세,2017,13168,6965,6203,112.3,12867,6798,6069,112
33020, 충주시,020001, 15세,2017,2011,1054,957,110.1,2006,1053,953,110.5
33020, 충주시,020002, 16세,2017,2361,1210,1151,105.1,2359,1209,1150,105.1
33020, 충주시,020003, 17세,2017,2600,1361,1239,109.8,2583,1350,1233,109.5
33020, 충주시,020004, 18세,2017,2762,1490,1272,117.1,2696,1455,1241,117.2
33020, 충주시,020005, 19세,2017,3434,1850,1584,116.8,3223,1731,1492,116
33020, 충주시,025,20~24세,2017,16623,9495,7128,133.2,15362,8721,6641,131.3
33020, 충주시,025001, 20세,2017,3380,1845,1535,120.2,3122,1699,1423,119.4
33020, 충주시,025002, 21세,2017,3334,1768,1566,112.9,3094,1620,1474,109.9
33020, 충주시,025003, 22세,2017,3360,1875,1485,126.3,3105,1718,1387,123.9
33020, 충주시,025004, 23세,2017,3332,2013,1319,152.6,3095,1854,1241,149.4
33020, 충주시,025005, 24세,2017,3217,1994,1223,163,2946,1830,1116,164
33020, 충주시,030,25~29세,2017,12381,7284,5097,142.9,11190,6504,4686,138.8
33020, 충주시,030001, 25세,2017,2968,1842,1126,163.6,2730,1692,1038,163
33020, 충주시,030002, 26세,2017,2640,1535,1105,138.9,2401,1377,1024,134.5
33020, 충주시,030003, 27세,2017,2370,1346,1024,131.4,2120,1185,935,126.7
33020, 충주시,030004, 28세,2017,2214,1279,935,136.8,1970,1119,851,131.5
33020, 충주시,030005, 29세,2017,2189,1282,907,141.3,1969,1131,838,135
33020, 충주시,035,30~34세,2017,11564,6305,5259,119.9,10626,5671,4955,114.5
33020, 충주시,035001, 30세,2017,2267,1268,999,126.9,2043,1113,930,119.7
33020, 충주시,035002, 31세,2017,2255,1245,1010,123.3,2060,1118,942,118.7
33020, 충주시,035003, 32세,2017,2097,1144,953,120,1904,1018,886,114.9
33020, 충주시,035004, 33세,2017,2417,1325,1092,121.3,2268,1218,1050,116
33020, 충주시,035005, 34세,2017,2528,1323,1205,109.8,2351,1204,1147,105
33020, 충주시,040,35~39세,2017,13514,7071,6443,109.7,12938,6685,6253,106.9
33020, 충주시,040001, 35세,2017,2789,1477,1312,112.6,2630,1375,1255,109.6
33020, 충주시,040002, 36세,2017,2748,1520,1228,123.8,2621,1428,1193,119.7
33020, 충주시,040003, 37세,2017,2755,1382,1373,100.7,2656,1313,1343,97.8
33020, 충주시,040004, 38세,2017,2724,1405,1319,106.5,2616,1336,1280,104.4
33020, 충주시,040005, 39세,2017,2498,1287,1211,106.3,2415,1233,1182,104.3
33020, 충주시,045,40~44세,2017,15138,7849,7289,107.7,14677,7539,7138,105.6
33020, 충주시,045001, 40세,2017,2776,1432,1344,106.5,2650,1346,1304,103.2
33020, 충주시,045002, 41세,2017,2751,1452,1299,111.8,2656,1385,1271,109
33020, 충주시,045003, 42세,2017,2942,1483,1459,101.6,2871,1432,1439,99.5
33020, 충주시,045004, 43세,2017,3319,1763,1556,113.3,3243,1716,1527,112.4
33020, 충주시,045005, 44세,2017,3350,1719,1631,105.4,3257,1660,1597,103.9
33020, 충주시,050,45~49세,2017,17915,9129,8786,103.9,17465,8875,8590,103.3
33020, 충주시,050001, 45세,2017,3217,1683,1534,109.7,3127,1637,1490,109.9
33020, 충주시,050002, 46세,2017,3579,1804,1775,101.6,3493,1755,1738,101
33020, 충주시,050003, 47세,2017,3442,1749,1693,103.3,3343,1688,1655,102
33020, 충주시,050004, 48세,2017,3833,1927,1906,101.1,3751,1879,1872,100.4
33020, 충주시,050005, 49세,2017,3844,1966,1878,104.7,3751,1916,1835,104.4
33020, 충주시,055,50~54세,2017,17328,9000,8328,108.1,16948,8787,8161,107.7
33020, 충주시,055001, 50세,2017,3559,1835,1724,106.4,3491,1792,1699,105.5
33020, 충주시,055002, 51세,2017,3525,1885,1640,114.9,3449,1842,1607,114.6
33020, 충주시,055003, 52세,2017,3626,1869,1757,106.4,3547,1820,1727,105.4
33020, 충주시,055004, 53세,2017,3157,1638,1519,107.8,3081,1599,1482,107.9
33020, 충주시,055005, 54세,2017,3461,1773,1688,105,3380,1734,1646,105.3
33020, 충주시,060,55~59세,2017,19272,9897,9375,105.6,19013,9749,9264,105.2
33020, 충주시,060001, 55세,2017,3815,1987,1828,108.7,3750,1952,1798,108.6
33020, 충주시,060002, 56세,2017,4357,2209,2148,102.8,4316,2185,2131,102.5
33020, 충주시,060003, 57세,2017,3856,1956,1900,102.9,3809,1931,1878,102.8
33020, 충주시,060004, 58세,2017,3649,1885,1764,106.9,3593,1853,1740,106.5
33020, 충주시,060005, 59세,2017,3595,1860,1735,107.2,3545,1828,1717,106.5
33020, 충주시,065,60~64세,2017,14845,7503,7342,102.2,14670,7385,7285,101.4
33020, 충주시,065001, 60세,2017,3450,1770,1680,105.4,3394,1731,1663,104.1
33020, 충주시,065002, 61세,2017,3309,1696,1613,105.1,3281,1676,1605,104.4
33020, 충주시,065003, 62세,2017,3000,1498,1502,99.7,2974,1479,1495,98.9
33020, 충주시,065004, 63세,2017,2684,1358,1326,102.4,2653,1338,1315,101.7
33020, 충주시,065005, 64세,2017,2402,1181,1221,96.7,2368,1161,1207,96.2
33020, 충주시,070,65~69세,2017,10000,4774,5226,91.4,9925,4738,5187,91.3
33020, 충주시,070001, 65세,2017,2876,1373,1503,91.4,2860,1364,1496,91.2
33020, 충주시,070002, 66세,2017,1705,820,885,92.7,1685,810,875,92.6
33020, 충주시,070003, 67세,2017,1727,809,918,88.1,1716,806,910,88.6
33020, 충주시,070004, 68세,2017,1875,888,987,90,1855,877,978,89.7
33020, 충주시,070005, 69세,2017,1817,884,933,94.7,1809,881,928,94.9
33020, 충주시,075,70~74세,2017,8558,3839,4719,81.4,8526,3828,4698,81.5
33020, 충주시,075001, 70세,2017,2007,932,1075,86.7,1998,927,1071,86.6
33020, 충주시,075002, 71세,2017,1495,704,791,89,1486,700,786,89.1
33020, 충주시,075003, 72세,2017,1596,697,899,77.5,1593,696,897,77.6
33020, 충주시,075004, 73세,2017,1761,769,992,77.5,1754,768,986,77.9
33020, 충주시,075005, 74세,2017,1699,737,962,76.6,1695,737,958,76.9
33020, 충주시,080,75~79세,2017,8663,3576,5087,70.3,8648,3572,5076,70.4
33020, 충주시,080001, 75세,2017,2081,915,1166,78.5,2076,914,1162,78.7
33020, 충주시,080002, 76세,2017,1783,730,1053,69.3,1781,730,1051,69.5
33020, 충주시,080003, 77세,2017,1609,677,932,72.6,1606,676,930,72.7
33020, 충주시,080004, 78세,2017,1748,684,1064,64.3,1743,682,1061,64.3
33020, 충주시,080005, 79세,2017,1442,570,872,65.4,1442,570,872,65.4
33020, 충주시,085,80~84세,2017,5478,1924,3554,54.1,5467,1920,3547,54.1
33020, 충주시,085001, 80세,2017,1328,512,816,62.7,1326,510,816,62.5
33020, 충주시,085002, 81세,2017,1225,464,761,61,1222,464,758,61.2
33020, 충주시,085003, 82세,2017,1123,367,756,48.5,1121,366,755,48.5
33020, 충주시,085004, 83세,2017,980,329,651,50.5,979,329,650,50.6
33020, 충주시,085005, 84세,2017,822,252,570,44.2,819,251,568,44.2
33020, 충주시,090,85~89세,2017,2265,612,1653,37,2263,612,1651,37.1
33020, 충주시,090001, 85세,2017,698,193,505,38.2,698,193,505,38.2
33020, 충주시,090002, 86세,2017,446,130,316,41.1,446,130,316,41.1
33020, 충주시,090003, 87세,2017,466,122,344,35.5,465,122,343,35.6
33020, 충주시,090004, 88세,2017,379,99,280,35.4,379,99,280,35.4
33020, 충주시,090005, 89세,2017,276,68,208,32.7,275,68,207,32.9
33020, 충주시,095,90~94세,2017,728,210,518,40.5,728,210,518,40.5
33020, 충주시,095001, 90세,2017,237,62,175,35.4,237,62,175,35.4
33020, 충주시,095002, 91세,2017,163,43,120,35.8,163,43,120,35.8
33020, 충주시,095003, 92세,2017,145,48,97,49.5,145,48,97,49.5
33020, 충주시,095004, 93세,2017,91,30,61,49.2,91,30,61,49.2
33020, 충주시,095005, 94세,2017,92,27,65,41.5,92,27,65,41.5
33020, 충주시,100,95~99세,2017,176,32,144,22.2,176,32,144,22.2
33020, 충주시,100001, 95세,2017,79,12,67,17.9,79,12,67,17.9
33020, 충주시,100002, 96세,2017,46,11,35,31.4,46,11,35,31.4
33020, 충주시,100003, 97세,2017,26,5,21,23.8,26,5,21,23.8
33020, 충주시,100004, 98세,2017,15,X,12,25,15,X,12,25
33020, 충주시,100005, 99세,2017,10,X,9,11.1,10,X,9,11.1
33020, 충주시,101,100세이상,2017,17,X,14,21.4,17,X,14,21.4
33020, 충주시,102,15세미만,2017,24641,12624,12017,105.1,24572,12589,11983,105.1
33020, 충주시,103,15~64세,2017,151748,80498,71250,113,145756,76714,69042,111.1
33020, 충주시,104,65세이상,2017,35885,14970,20915,71.6,35750,14915,20835,71.6
33020, 충주시,086,85세이상,2017,3186,857,2329,36.8,3184,857,2327,36.8
33020, 충주시,126,평균연령,2017,43.1,41.6,44.8,,43.4,41.8,45,
33020, 충주시,127,중위연령,2017,44.7,43,46.6,,45.3,43.6,47,
33030, 제천시,000,합계,2017,136929,68951,67978,101.4,135087,67999,67088,101.4
33030, 제천시,005,0~4세,2017,4560,2351,2209,106.4,4547,2346,2201,106.6
33030, 제천시,005001, 0세,2017,760,411,349,117.8,757,410,347,118.2
33030, 제천시,005002, 1세,2017,912,502,410,122.4,911,501,410,122.2
33030, 제천시,005003, 2세,2017,919,455,464,98.1,916,453,463,97.8
33030, 제천시,005004, 3세,2017,997,505,492,102.6,994,505,489,103.3
33030, 제천시,005005, 4세,2017,972,478,494,96.8,969,477,492,97
33030, 제천시,010,5~9세,2017,5342,2707,2635,102.7,5334,2705,2629,102.9
33030, 제천시,010001, 5세,2017,1102,566,536,105.6,1101,566,535,105.8
33030, 제천시,010002, 6세,2017,1067,527,540,97.6,1066,527,539,97.8
33030, 제천시,010003, 7세,2017,1072,514,558,92.1,1068,512,556,92.1
33030, 제천시,010004, 8세,2017,1004,512,492,104.1,1004,512,492,104.1
33030, 제천시,010005, 9세,2017,1097,588,509,115.5,1095,588,507,116
33030, 제천시,015,10~14세,2017,5588,2866,2722,105.3,5579,2861,2718,105.3
33030, 제천시,015001, 10세,2017,1097,548,549,99.8,1095,547,548,99.8
33030, 제천시,015002, 11세,2017,1071,554,517,107.2,1070,553,517,107
33030, 제천시,015003, 12세,2017,1056,546,510,107.1,1054,544,510,106.7
33030, 제천시,015004, 13세,2017,1178,605,573,105.6,1176,605,571,106
33030, 제천시,015005, 14세,2017,1186,613,573,107,1184,612,572,107
33030, 제천시,020,15~19세,2017,8848,4692,4156,112.9,8752,4644,4108,113
33030, 제천시,020001, 15세,2017,1279,683,596,114.6,1275,681,594,114.6
33030, 제천시,020002, 16세,2017,1518,817,701,116.5,1511,813,698,116.5
33030, 제천시,020003, 17세,2017,1533,778,755,103,1520,771,749,102.9
33030, 제천시,020004, 18세,2017,1871,998,873,114.3,1848,990,858,115.4
33030, 제천시,020005, 19세,2017,2647,1416,1231,115,2598,1389,1209,114.9
33030, 제천시,025,20~24세,2017,11018,6128,4890,125.3,10730,5967,4763,125.3
33030, 제천시,025001, 20세,2017,2311,1124,1187,94.7,2269,1100,1169,94.1
33030, 제천시,025002, 21세,2017,2239,1077,1162,92.7,2183,1051,1132,92.8
33030, 제천시,025003, 22세,2017,2346,1328,1018,130.5,2281,1284,997,128.8
33030, 제천시,025004, 23세,2017,2144,1369,775,176.6,2075,1331,744,178.9
33030, 제천시,025005, 24세,2017,1978,1230,748,164.4,1922,1201,721,166.6
33030, 제천시,030,25~29세,2017,6783,3796,2987,127.1,6490,3638,2852,127.6
33030, 제천시,030001, 25세,2017,1695,1034,661,156.4,1641,1000,641,156
33030, 제천시,030002, 26세,2017,1406,777,629,123.5,1354,756,598,126.4
33030, 제천시,030003, 27세,2017,1307,723,584,123.8,1230,682,548,124.5
33030, 제천시,030004, 28세,2017,1221,642,579,110.9,1168,611,557,109.7
33030, 제천시,030005, 29세,2017,1154,620,534,116.1,1097,589,508,115.9
33030, 제천시,035,30~34세,2017,6493,3460,3033,114.1,6211,3305,2906,113.7
33030, 제천시,035001, 30세,2017,1204,634,570,111.2,1132,599,533,112.4
33030, 제천시,035002, 31세,2017,1267,702,565,124.2,1208,671,537,125
33030, 제천시,035003, 32세,2017,1245,663,582,113.9,1193,630,563,111.9
33030, 제천시,035004, 33세,2017,1342,710,632,112.3,1301,686,615,111.5
33030, 제천시,035005, 34세,2017,1435,751,684,109.8,1377,719,658,109.3
33030, 제천시,040,35~39세,2017,8012,4116,3896,105.6,7818,4017,3801,105.7
33030, 제천시,040001, 35세,2017,1642,852,790,107.8,1592,831,761,109.2
33030, 제천시,040002, 36세,2017,1588,817,771,106,1554,799,755,105.8
33030, 제천시,040003, 37세,2017,1644,845,799,105.8,1604,821,783,104.9
33030, 제천시,040004, 38세,2017,1611,813,798,101.9,1582,797,785,101.5
33030, 제천시,040005, 39세,2017,1527,789,738,106.9,1486,769,717,107.3
33030, 제천시,045,40~44세,2017,8929,4529,4400,102.9,8799,4462,4337,102.9
33030, 제천시,045001, 40세,2017,1538,810,728,111.3,1514,797,717,111.2
33030, 제천시,045002, 41세,2017,1577,803,774,103.7,1551,790,761,103.8
33030, 제천시,045003, 42세,2017,1807,898,909,98.8,1783,886,897,98.8
33030, 제천시,045004, 43세,2017,2012,1009,1003,100.6,1985,995,990,100.5
33030, 제천시,045005, 44세,2017,1995,1009,986,102.3,1966,994,972,102.3
33030, 제천시,050,45~49세,2017,11314,5871,5443,107.9,11183,5804,5379,107.9
33030, 제천시,050001, 45세,2017,2044,1077,967,111.4,2019,1063,956,111.2
33030, 제천시,050002, 46세,2017,2246,1179,1067,110.5,2217,1163,1054,110.3
33030, 제천시,050003, 47세,2017,2177,1142,1035,110.3,2154,1132,1022,110.8
33030, 제천시,050004, 48세,2017,2391,1235,1156,106.8,2369,1224,1145,106.9
33030, 제천시,050005, 49세,2017,2456,1238,1218,101.6,2424,1222,1202,101.7
33030, 제천시,055,50~54세,2017,10937,5597,5340,104.8,10795,5528,5267,105
33030, 제천시,055001, 50세,2017,2242,1166,1076,108.4,2214,1152,1062,108.5
33030, 제천시,055002, 51세,2017,2268,1161,1107,104.9,2246,1149,1097,104.7
33030, 제천시,055003, 52세,2017,2252,1153,1099,104.9,2226,1139,1087,104.8
33030, 제천시,055004, 53세,2017,2017,1049,968,108.4,1981,1029,952,108.1
33030, 제천시,055005, 54세,2017,2158,1068,1090,98,2128,1059,1069,99.1
33030, 제천시,060,55~59세,2017,13228,6617,6611,100.1,13113,6564,6549,100.2
33030, 제천시,060001, 55세,2017,2528,1246,1282,97.2,2510,1235,1275,96.9
33030, 제천시,060002, 56세,2017,2875,1487,1388,107.1,2854,1478,1376,107.4
33030, 제천시,060003, 57세,2017,2674,1292,1382,93.5,2647,1283,1364,94.1
33030, 제천시,060004, 58세,2017,2513,1233,1280,96.3,2485,1221,1264,96.6
33030, 제천시,060005, 59세,2017,2638,1359,1279,106.3,2617,1347,1270,106.1
33030, 제천시,065,60~64세,2017,10802,5447,5355,101.7,10731,5412,5319,101.7
33030, 제천시,065001, 60세,2017,2541,1286,1255,102.5,2520,1277,1243,102.7
33030, 제천시,065002, 61세,2017,2312,1163,1149,101.2,2291,1152,1139,101.1
33030, 제천시,065003, 62세,2017,2179,1106,1073,103.1,2166,1100,1066,103.2
33030, 제천시,065004, 63세,2017,1993,968,1025,94.4,1984,962,1022,94.1
33030, 제천시,065005, 64세,2017,1777,924,853,108.3,1770,921,849,108.5
33030, 제천시,070,65~69세,2017,7480,3691,3789,97.4,7445,3675,3770,97.5
33030, 제천시,070001, 65세,2017,2223,1144,1079,106,2219,1142,1077,106
33030, 제천시,070002, 66세,2017,1271,590,681,86.6,1260,584,676,86.4
33030, 제천시,070003, 67세,2017,1272,623,649,96,1265,620,645,96.1
33030, 제천시,070004, 68세,2017,1298,637,661,96.4,1289,633,656,96.5
33030, 제천시,070005, 69세,2017,1416,697,719,96.9,1412,696,716,97.2
33030, 제천시,075,70~74세,2017,6115,2816,3299,85.4,6100,2810,3290,85.4
33030, 제천시,075001, 70세,2017,1412,651,761,85.5,1405,649,756,85.8
33030, 제천시,075002, 71세,2017,1028,482,546,88.3,1026,482,544,88.6
33030, 제천시,075003, 72세,2017,1199,547,652,83.9,1198,547,651,84
33030, 제천시,075004, 73세,2017,1231,571,660,86.5,1228,568,660,86.1
33030, 제천시,075005, 74세,2017,1245,565,680,83.1,1243,564,679,83.1
33030, 제천시,080,75~79세,2017,5823,2416,3407,70.9,5816,2415,3401,71
33030, 제천시,080001, 75세,2017,1467,638,829,77,1465,638,827,77.1
33030, 제천시,080002, 76세,2017,1213,511,702,72.8,1212,511,701,72.9
33030, 제천시,080003, 77세,2017,1055,403,652,61.8,1054,403,651,61.9
33030, 제천시,080004, 78세,2017,1072,445,627,71,1069,444,625,71
33030, 제천시,080005, 79세,2017,1016,419,597,70.2,1016,419,597,70.2
33030, 제천시,085,80~84세,2017,3539,1302,2237,58.2,3532,1300,2232,58.2
33030, 제천시,085001, 80세,2017,899,344,555,62,898,344,554,62.1
33030, 제천시,085002, 81세,2017,797,307,490,62.7,794,306,488,62.7
33030, 제천시,085003, 82세,2017,746,275,471,58.4,745,275,470,58.5
33030, 제천시,085004, 83세,2017,602,206,396,52,601,205,396,51.8
33030, 제천시,085005, 84세,2017,495,170,325,52.3,494,170,324,52.5
33030, 제천시,090,85~89세,2017,1504,422,1082,39,1499,420,1079,38.9
33030, 제천시,090001, 85세,2017,415,127,288,44.1,414,126,288,43.8
33030, 제천시,090002, 86세,2017,336,94,242,38.8,334,94,240,39.2
33030, 제천시,090003, 87세,2017,326,90,236,38.1,325,89,236,37.7
33030, 제천시,090004, 88세,2017,245,70,175,40,244,70,174,40.2
33030, 제천시,090005, 89세,2017,182,41,141,29.1,182,41,141,29.1
33030, 제천시,095,90~94세,2017,483,96,387,24.8,482,95,387,24.5
33030, 제천시,095001, 90세,2017,161,30,131,22.9,161,30,131,22.9
33030, 제천시,095002, 91세,2017,112,17,95,17.9,112,17,95,17.9
33030, 제천시,095003, 92세,2017,94,24,70,34.3,94,24,70,34.3
33030, 제천시,095004, 93세,2017,69,15,54,27.8,69,15,54,27.8
33030, 제천시,095005, 94세,2017,47,10,37,27,46,9,37,24.3
33030, 제천시,100,95~99세,2017,115,30,85,35.3,115,30,85,35.3
33030, 제천시,100001, 95세,2017,39,15,24,62.5,39,15,24,62.5
33030, 제천시,100002, 96세,2017,30,6,24,25,30,6,24,25
33030, 제천시,100003, 97세,2017,21,X,18,16.7,21,X,18,16.7
33030, 제천시,100004, 98세,2017,15,X,11,36.4,15,X,11,36.4
33030, 제천시,100005, 99세,2017,10,X,8,25,10,X,8,25
33030, 제천시,101,100세이상,2017,16,X,15,6.7,16,X,15,6.7
33030, 제천시,102,15세미만,2017,15490,7924,7566,104.7,15460,7912,7548,104.8
33030, 제천시,103,15~64세,2017,96364,50253,46111,109,94622,49341,45281,109
33030, 제천시,104,65세이상,2017,25075,10774,14301,75.3,25005,10746,14259,75.4
33030, 제천시,086,85세이상,2017,2118,549,1569,35,2112,546,1566,34.9
33030, 제천시,126,평균연령,2017,44,42.6,45.5,,44.1,42.7,45.6,
33030, 제천시,127,중위연령,2017,46.4,44.8,48,,46.6,45.1,48.2,
33040, 청주시,000,합계,2017,842311,423088,419223,100.9,825950,414090,411860,100.5
33040, 청주시,005,0~4세,2017,39241,20020,19221,104.2,38925,19868,19057,104.3
33040, 청주시,005001, 0세,2017,7006,3605,3401,106,6945,3576,3369,106.1
33040, 청주시,005002, 1세,2017,7791,3962,3829,103.5,7728,3928,3800,103.4
33040, 청주시,005003, 2세,2017,8125,4181,3944,106,8062,4153,3909,106.2
33040, 청주시,005004, 3세,2017,8078,4057,4021,100.9,8010,4022,3988,100.9
33040, 청주시,005005, 4세,2017,8241,4215,4026,104.7,8180,4189,3991,105
33040, 청주시,010,5~9세,2017,42499,21829,20670,105.6,42293,21728,20565,105.7
33040, 청주시,010001, 5세,2017,8928,4558,4370,104.3,8878,4535,4343,104.4
33040, 청주시,010002, 6세,2017,8735,4387,4348,100.9,8679,4357,4322,100.8
33040, 청주시,010003, 7세,2017,8364,4339,4025,107.8,8325,4321,4004,107.9
33040, 청주시,010004, 8세,2017,8084,4240,3844,110.3,8055,4224,3831,110.3
33040, 청주시,010005, 9세,2017,8388,4305,4083,105.4,8356,4291,4065,105.6
33040, 청주시,015,10~14세,2017,41392,21459,19933,107.7,41252,21391,19861,107.7
33040, 청주시,015001, 10세,2017,8650,4465,4185,106.7,8611,4448,4163,106.8
33040, 청주시,015002, 11세,2017,7860,4040,3820,105.8,7834,4024,3810,105.6
33040, 청주시,015003, 12세,2017,7757,3983,3774,105.5,7730,3971,3759,105.6
33040, 청주시,015004, 13세,2017,8459,4451,4008,111.1,8435,4440,3995,111.1
33040, 청주시,015005, 14세,2017,8666,4520,4146,109,8642,4508,4134,109
33040, 청주시,020,15~19세,2017,53950,28196,25754,109.5,53581,27997,25584,109.4
33040, 청주시,020001, 15세,2017,8900,4723,4177,113.1,8876,4713,4163,113.2
33040, 청주시,020002, 16세,2017,10139,5300,4839,109.5,10107,5283,4824,109.5
33040, 청주시,020003, 17세,2017,11148,5874,5274,111.4,11108,5853,5255,111.4
33040, 청주시,020004, 18세,2017,11279,5923,5356,110.6,11200,5880,5320,110.5
33040, 청주시,020005, 19세,2017,12484,6376,6108,104.4,12290,6268,6022,104.1
33040, 청주시,025,20~24세,2017,65852,34811,31041,112.1,63616,33626,29990,112.1
33040, 청주시,025001, 20세,2017,13000,6430,6570,97.9,12694,6300,6394,98.5
33040, 청주시,025002, 21세,2017,13307,6954,6353,109.5,12901,6742,6159,109.5
33040, 청주시,025003, 22세,2017,13262,6941,6321,109.8,12746,6661,6085,109.5
33040, 청주시,025004, 23세,2017,13199,7300,5899,123.7,12694,7012,5682,123.4
33040, 청주시,025005, 24세,2017,13084,7186,5898,121.8,12581,6911,5670,121.9
33040, 청주시,030,25~29세,2017,58130,31698,26432,119.9,55319,30047,25272,118.9
33040, 청주시,030001, 25세,2017,12700,7131,5569,128,12182,6813,5369,126.9
33040, 청주시,030002, 26세,2017,11894,6516,5378,121.2,11339,6199,5140,120.6
33040, 청주시,030003, 27세,2017,11446,6258,5188,120.6,10812,5902,4910,120.2
33040, 청주시,030004, 28세,2017,11019,5979,5040,118.6,10498,5668,4830,117.3
33040, 청주시,030005, 29세,2017,11071,5814,5257,110.6,10488,5465,5023,108.8
33040, 청주시,035,30~34세,2017,59011,30749,28262,108.8,56514,29300,27214,107.7
33040, 청주시,035001, 30세,2017,11179,5843,5336,109.5,10600,5516,5084,108.5
33040, 청주시,035002, 31세,2017,11362,6068,5294,114.6,10845,5750,5095,112.9
33040, 청주시,035003, 32세,2017,11376,5886,5490,107.2,10881,5618,5263,106.7
33040, 청주시,035004, 33세,2017,12114,6364,5750,110.7,11683,6114,5569,109.8
33040, 청주시,035005, 34세,2017,12980,6588,6392,103.1,12505,6302,6203,101.6
33040, 청주시,040,35~39세,2017,67771,34811,32960,105.6,65977,33722,32255,104.5
33040, 청주시,040001, 35세,2017,14472,7335,7137,102.8,14069,7086,6983,101.5
33040, 청주시,040002, 36세,2017,13458,6961,6497,107.1,13066,6732,6334,106.3
33040, 청주시,040003, 37세,2017,14117,7258,6859,105.8,13793,7065,6728,105
33040, 청주시,040004, 38세,2017,13371,6885,6486,106.2,13022,6672,6350,105.1
33040, 청주시,040005, 39세,2017,12353,6372,5981,106.5,12027,6167,5860,105.2
33040, 청주시,045,40~44세,2017,67756,34001,33755,100.7,66426,33250,33176,100.2
33040, 청주시,045001, 40세,2017,12914,6540,6374,102.6,12607,6341,6266,101.2
33040, 청주시,045002, 41세,2017,12695,6464,6231,103.7,12427,6311,6116,103.2
33040, 청주시,045003, 42세,2017,13229,6549,6680,98,12970,6413,6557,97.8
33040, 청주시,045004, 43세,2017,14449,7298,7151,102.1,14209,7169,7040,101.8
33040, 청주시,045005, 44세,2017,14469,7150,7319,97.7,14213,7016,7197,97.5
33040, 청주시,050,45~49세,2017,73843,36794,37049,99.3,72434,36023,36411,98.9
33040, 청주시,050001, 45세,2017,13615,6888,6727,102.4,13334,6740,6594,102.2
33040, 청주시,050002, 46세,2017,14962,7595,7367,103.1,14674,7439,7235,102.8
33040, 청주시,050003, 47세,2017,14409,7246,7163,101.2,14119,7072,7047,100.4
33040, 청주시,050004, 48세,2017,15758,7764,7994,97.1,15481,7612,7869,96.7
33040, 청주시,050005, 49세,2017,15099,7301,7798,93.6,14826,7160,7666,93.4
33040, 청주시,055,50~54세,2017,65114,32842,32272,101.8,63953,32275,31678,101.9
33040, 청주시,055001, 50세,2017,13768,6878,6890,99.8,13574,6779,6795,99.8
33040, 청주시,055002, 51세,2017,13394,6738,6656,101.2,13159,6621,6538,101.3
33040, 청주시,055003, 52세,2017,13667,6799,6868,99,13425,6680,6745,99
33040, 청주시,055004, 53세,2017,11803,5968,5835,102.3,11594,5878,5716,102.8
33040, 청주시,055005, 54세,2017,12482,6459,6023,107.2,12201,6317,5884,107.4
33040, 청주시,060,55~59세,2017,65272,32703,32569,100.4,64342,32256,32086,100.5
33040, 청주시,060001, 55세,2017,13518,6960,6558,106.1,13305,6866,6439,106.6
33040, 청주시,060002, 56세,2017,15008,7538,7470,100.9,14862,7467,7395,101
33040, 청주시,060003, 57세,2017,13034,6451,6583,98,12822,6340,6482,97.8
33040, 청주시,060004, 58세,2017,12082,5889,6193,95.1,11908,5809,6099,95.2
33040, 청주시,060005, 59세,2017,11630,5865,5765,101.7,11445,5774,5671,101.8
33040, 청주시,065,60~64세,2017,47089,23264,23825,97.6,46432,22925,23507,97.5
33040, 청주시,065001, 60세,2017,11345,5622,5723,98.2,11174,5539,5635,98.3
33040, 청주시,065002, 61세,2017,10155,5135,5020,102.3,10005,5046,4959,101.8
33040, 청주시,065003, 62세,2017,9807,4726,5081,93,9679,4659,5020,92.8
33040, 청주시,065004, 63세,2017,8485,4196,4289,97.8,8376,4144,4232,97.9
33040, 청주시,065005, 64세,2017,7297,3585,3712,96.6,7198,3537,3661,96.6
33040, 청주시,070,65~69세,2017,30173,14656,15517,94.5,29871,14509,15362,94.4
33040, 청주시,070001, 65세,2017,7891,3891,4000,97.3,7811,3850,3961,97.2
33040, 청주시,070002, 66세,2017,5328,2563,2765,92.7,5254,2526,2728,92.6
33040, 청주시,070003, 67세,2017,5554,2675,2879,92.9,5513,2661,2852,93.3
33040, 청주시,070004, 68세,2017,5709,2798,2911,96.1,5640,2761,2879,95.9
33040, 청주시,070005, 69세,2017,5691,2729,2962,92.1,5653,2711,2942,92.1
33040, 청주시,075,70~74세,2017,22802,10306,12496,82.5,22701,10255,12446,82.4
33040, 청주시,075001, 70세,2017,5408,2514,2894,86.9,5381,2501,2880,86.8
33040, 청주시,075002, 71세,2017,4129,1947,2182,89.2,4104,1937,2167,89.4
33040, 청주시,075003, 72세,2017,4399,2042,2357,86.6,4375,2027,2348,86.3
33040, 청주시,075004, 73세,2017,4343,1850,2493,74.2,4332,1846,2486,74.3
33040, 청주시,075005, 74세,2017,4523,1953,2570,76,4509,1944,2565,75.8
33040, 청주시,080,75~79세,2017,20432,8288,12144,68.2,20382,8277,12105,68.4
33040, 청주시,080001, 75세,2017,5300,2260,3040,74.3,5289,2257,3032,74.4
33040, 청주시,080002, 76세,2017,4135,1678,2457,68.3,4122,1677,2445,68.6
33040, 청주시,080003, 77세,2017,3776,1541,2235,68.9,3769,1539,2230,69
33040, 청주시,080004, 78세,2017,3833,1539,2294,67.1,3825,1537,2288,67.2
33040, 청주시,080005, 79세,2017,3388,1270,2118,60,3377,1267,2110,60
33040, 청주시,085,80~84세,2017,13567,4670,8897,52.5,13531,4657,8874,52.5
33040, 청주시,085001, 80세,2017,3261,1228,2033,60.4,3252,1223,2029,60.3
33040, 청주시,085002, 81세,2017,3105,1092,2013,54.2,3099,1091,2008,54.3
33040, 청주시,085003, 82세,2017,2906,1006,1900,52.9,2897,1003,1894,53
33040, 청주시,085004, 83세,2017,2287,730,1557,46.9,2279,726,1553,46.7
33040, 청주시,085005, 84세,2017,2008,614,1394,44,2004,614,1390,44.2
33040, 청주시,090,85~89세,2017,5936,1493,4443,33.6,5922,1488,4434,33.6
33040, 청주시,090001, 85세,2017,1677,457,1220,37.5,1673,455,1218,37.4
33040, 청주시,090002, 86세,2017,1187,312,875,35.7,1185,310,875,35.4
33040, 청주시,090003, 87세,2017,1250,305,945,32.3,1248,304,944,32.2
33040, 청주시,090004, 88세,2017,1038,226,812,27.8,1034,226,808,28
33040, 청주시,090005, 89세,2017,784,193,591,32.7,782,193,589,32.8
33040, 청주시,095,90~94세,2017,1949,409,1540,26.6,1947,407,1540,26.4
33040, 청주시,095001, 90세,2017,654,153,501,30.5,654,153,501,30.5
33040, 청주시,095002, 91세,2017,417,86,331,26,417,86,331,26
33040, 청주시,095003, 92세,2017,409,73,336,21.7,409,73,336,21.7
33040, 청주시,095004, 93세,2017,242,49,193,25.4,240,47,193,24.4
33040, 청주시,095005, 94세,2017,227,48,179,26.8,227,48,179,26.8
33040, 청주시,100,95~99세,2017,481,81,400,20.3,481,81,400,20.3
33040, 청주시,100001, 95세,2017,194,40,154,26,194,40,154,26
33040, 청주시,100002, 96세,2017,134,25,109,22.9,134,25,109,22.9
33040, 청주시,100003, 97세,2017,69,6,63,9.5,69,6,63,9.5
33040, 청주시,100004, 98세,2017,50,7,43,16.3,50,7,43,16.3
33040, 청주시,100005, 99세,2017,34,X,31,9.7,34,X,31,9.7
33040, 청주시,101,100세이상,2017,51,8,43,18.6,51,8,43,18.6
33040, 청주시,102,15세미만,2017,123132,63308,59824,105.8,122470,62987,59483,105.9
33040, 청주시,103,15~64세,2017,623788,319869,303919,105.2,608594,311421,297173,104.8
33040, 청주시,104,65세이상,2017,95391,39911,55480,71.9,94886,39682,55204,71.9
33040, 청주시,086,85세이상,2017,8417,1991,6426,31,8401,1984,6417,30.9
33040, 청주시,126,평균연령,2017,39.2,38.1,40.4,,39.3,38.1,40.4,
33040, 청주시,127,중위연령,2017,39.5,38.2,40.8,,39.6,38.3,41,
33041, 상당구,000,합계,2017,166664,83201,83463,99.7,165326,82592,82734,99.8
33041, 상당구,005,0~4세,2017,6242,3214,3028,106.1,6234,3211,3023,106.2
33041, 상당구,005001, 0세,2017,1035,537,498,107.8,1033,537,496,108.3
33041, 상당구,005002, 1세,2017,1176,606,570,106.3,1175,606,569,106.5
33041, 상당구,005003, 2세,2017,1296,659,637,103.5,1294,658,636,103.5
33041, 상당구,005004, 3세,2017,1310,667,643,103.7,1308,665,643,103.4
33041, 상당구,005005, 4세,2017,1425,745,680,109.6,1424,745,679,109.7
33041, 상당구,010,5~9세,2017,7768,4059,3709,109.4,7752,4052,3700,109.5
33041, 상당구,010001, 5세,2017,1603,834,769,108.5,1602,834,768,108.6
33041, 상당구,010002, 6세,2017,1567,799,768,104,1561,796,765,104.1
33041, 상당구,010003, 7세,2017,1598,879,719,122.3,1593,877,716,122.5
33041, 상당구,010004, 8세,2017,1452,766,686,111.7,1450,765,685,111.7
33041, 상당구,010005, 9세,2017,1548,781,767,101.8,1546,780,766,101.8
33041, 상당구,015,10~14세,2017,8367,4294,4073,105.4,8361,4290,4071,105.4
33041, 상당구,015001, 10세,2017,1705,894,811,110.2,1701,892,809,110.3
33041, 상당구,015002, 11세,2017,1516,749,767,97.7,1514,747,767,97.4
33041, 상당구,015003, 12세,2017,1556,799,757,105.5,1556,799,757,105.5
33041, 상당구,015004, 13세,2017,1777,922,855,107.8,1777,922,855,107.8
33041, 상당구,015005, 14세,2017,1813,930,883,105.3,1813,930,883,105.3
33041, 상당구,020,15~19세,2017,10960,5866,5094,115.2,10950,5862,5088,115.2
33041, 상당구,020001, 15세,2017,1977,1073,904,118.7,1975,1072,903,118.7
33041, 상당구,020002, 16세,2017,2232,1180,1052,112.2,2230,1179,1051,112.2
33041, 상당구,020003, 17세,2017,2485,1311,1174,111.7,2484,1310,1174,111.6
33041, 상당구,020004, 18세,2017,2282,1216,1066,114.1,2282,1216,1066,114.1
33041, 상당구,020005, 19세,2017,1984,1086,898,120.9,1979,1085,894,121.4
33041, 상당구,025,20~24세,2017,11438,6387,5051,126.5,11303,6312,4991,126.5
33041, 상당구,025001, 20세,2017,2177,1212,965,125.6,2166,1208,958,126.1
33041, 상당구,025002, 21세,2017,2378,1370,1008,135.9,2356,1357,999,135.8
33041, 상당구,025003, 22세,2017,2294,1247,1047,119.1,2260,1225,1035,118.4
33041, 상당구,025004, 23세,2017,2305,1302,1003,129.8,2274,1282,992,129.2
33041, 상당구,025005, 24세,2017,2284,1256,1028,122.2,2247,1240,1007,123.1
33041, 상당구,030,25~29세,2017,9475,5061,4414,114.7,9229,4939,4290,115.1
33041, 상당구,030001, 25세,2017,2287,1235,1052,117.4,2247,1214,1033,117.5
33041, 상당구,030002, 26세,2017,1981,1067,914,116.7,1938,1049,889,118
33041, 상당구,030003, 27세,2017,1913,1024,889,115.2,1851,992,859,115.5
33041, 상당구,030004, 28세,2017,1639,891,748,119.1,1593,865,728,118.8
33041, 상당구,030005, 29세,2017,1655,844,811,104.1,1600,819,781,104.9
33041, 상당구,035,30~34세,2017,8920,4612,4308,107.1,8752,4535,4217,107.5
33041, 상당구,035001, 30세,2017,1672,875,797,109.8,1634,858,776,110.6
33041, 상당구,035002, 31세,2017,1712,907,805,112.7,1676,892,784,113.8
33041, 상당구,035003, 32세,2017,1742,923,819,112.7,1707,907,800,113.4
33041, 상당구,035004, 33세,2017,1815,955,860,111,1787,940,847,111
33041, 상당구,035005, 34세,2017,1979,952,1027,92.7,1948,938,1010,92.9
33041, 상당구,040,35~39세,2017,11472,5772,5700,101.3,11349,5721,5628,101.7
33041, 상당구,040001, 35세,2017,2291,1153,1138,101.3,2263,1142,1121,101.9
33041, 상당구,040002, 36세,2017,2245,1137,1108,102.6,2213,1124,1089,103.2
33041, 상당구,040003, 37세,2017,2460,1233,1227,100.5,2441,1227,1214,101.1
33041, 상당구,040004, 38세,2017,2328,1193,1135,105.1,2301,1180,1121,105.3
33041, 상당구,040005, 39세,2017,2148,1056,1092,96.7,2131,1048,1083,96.8
33041, 상당구,045,40~44세,2017,13036,6399,6637,96.4,12918,6353,6565,96.8
33041, 상당구,045001, 40세,2017,2354,1156,1198,96.5,2332,1146,1186,96.6
33041, 상당구,045002, 41세,2017,2377,1198,1179,101.6,2353,1187,1166,101.8
33041, 상당구,045003, 42세,2017,2546,1235,1311,94.2,2522,1228,1294,94.9
33041, 상당구,045004, 43세,2017,2827,1401,1426,98.2,2809,1397,1412,98.9
33041, 상당구,045005, 44세,2017,2932,1409,1523,92.5,2902,1395,1507,92.6
33041, 상당구,050,45~49세,2017,15348,7573,7775,97.4,15206,7505,7701,97.5
33041, 상당구,050001, 45세,2017,2797,1436,1361,105.5,2770,1425,1345,105.9
33041, 상당구,050002, 46세,2017,3089,1538,1551,99.2,3056,1522,1534,99.2
33041, 상당구,050003, 47세,2017,3001,1492,1509,98.9,2976,1479,1497,98.8
33041, 상당구,050004, 48세,2017,3248,1562,1686,92.6,3219,1548,1671,92.6
33041, 상당구,050005, 49세,2017,3213,1545,1668,92.6,3185,1531,1654,92.6
33041, 상당구,055,50~54세,2017,14342,7258,7084,102.5,14209,7217,6992,103.2
33041, 상당구,055001, 50세,2017,2973,1457,1516,96.1,2955,1452,1503,96.6
33041, 상당구,055002, 51세,2017,2962,1521,1441,105.6,2933,1514,1419,106.7
33041, 상당구,055003, 52세,2017,2977,1472,1505,97.8,2957,1468,1489,98.6
33041, 상당구,055004, 53세,2017,2631,1333,1298,102.7,2609,1327,1282,103.5
33041, 상당구,055005, 54세,2017,2799,1475,1324,111.4,2755,1456,1299,112.1
33041, 상당구,060,55~59세,2017,14446,7296,7150,102,14354,7248,7106,102
33041, 상당구,060001, 55세,2017,3004,1566,1438,108.9,2976,1553,1423,109.1
33041, 상당구,060002, 56세,2017,3293,1675,1618,103.5,3277,1667,1610,103.5
33041, 상당구,060003, 57세,2017,2877,1435,1442,99.5,2863,1429,1434,99.7
33041, 상당구,060004, 58세,2017,2627,1282,1345,95.3,2612,1274,1338,95.2
33041, 상당구,060005, 59세,2017,2645,1338,1307,102.4,2626,1325,1301,101.8
33041, 상당구,065,60~64세,2017,10921,5443,5478,99.4,10848,5406,5442,99.3
33041, 상당구,065001, 60세,2017,2640,1337,1303,102.6,2622,1327,1295,102.5
33041, 상당구,065002, 61세,2017,2281,1148,1133,101.3,2268,1142,1126,101.4
33041, 상당구,065003, 62세,2017,2219,1062,1157,91.8,2203,1053,1150,91.6
33041, 상당구,065004, 63세,2017,2029,1046,983,106.4,2015,1039,976,106.5
33041, 상당구,065005, 64세,2017,1752,850,902,94.2,1740,845,895,94.4
33041, 상당구,070,65~69세,2017,7227,3519,3708,94.9,7189,3506,3683,95.2
33041, 상당구,070001, 65세,2017,1907,944,963,98,1898,941,957,98.3
33041, 상당구,070002, 66세,2017,1250,620,630,98.4,1245,617,628,98.2
33041, 상당구,070003, 67세,2017,1298,619,679,91.2,1290,618,672,92
33041, 상당구,070004, 68세,2017,1372,683,689,99.1,1362,679,683,99.4
33041, 상당구,070005, 69세,2017,1400,653,747,87.4,1394,651,743,87.6
33041, 상당구,075,70~74세,2017,5681,2550,3131,81.4,5663,2539,3124,81.3
33041, 상당구,075001, 70세,2017,1345,629,716,87.8,1341,627,714,87.8
33041, 상당구,075002, 71세,2017,986,471,515,91.5,981,468,513,91.2
33041, 상당구,075003, 72세,2017,1097,498,599,83.1,1091,495,596,83.1
33041, 상당구,075004, 73세,2017,1106,466,640,72.8,1105,465,640,72.7
33041, 상당구,075005, 74세,2017,1147,486,661,73.5,1145,484,661,73.2
33041, 상당구,080,75~79세,2017,5304,2161,3143,68.8,5295,2161,3134,69
33041, 상당구,080001, 75세,2017,1405,580,825,70.3,1402,580,822,70.6
33041, 상당구,080002, 76세,2017,1083,451,632,71.4,1082,451,631,71.5
33041, 상당구,080003, 77세,2017,972,393,579,67.9,970,393,577,68.1
33041, 상당구,080004, 78세,2017,991,420,571,73.6,991,420,571,73.6
33041, 상당구,080005, 79세,2017,853,317,536,59.1,850,317,533,59.5
33041, 상당구,085,80~84세,2017,3511,1196,2315,51.7,3508,1194,2314,51.6
33041, 상당구,085001, 80세,2017,850,298,552,54,849,297,552,53.8
33041, 상당구,085002, 81세,2017,806,286,520,55,806,286,520,55
33041, 상당구,085003, 82세,2017,766,269,497,54.1,765,269,496,54.2
33041, 상당구,085004, 83세,2017,585,194,391,49.6,584,193,391,49.4
33041, 상당구,085005, 84세,2017,504,149,355,42,504,149,355,42
33041, 상당구,090,85~89세,2017,1572,408,1164,35.1,1572,408,1164,35.1
33041, 상당구,090001, 85세,2017,441,120,321,37.4,441,120,321,37.4
33041, 상당구,090002, 86세,2017,280,73,207,35.3,280,73,207,35.3
33041, 상당구,090003, 87세,2017,340,87,253,34.4,340,87,253,34.4
33041, 상당구,090004, 88세,2017,288,71,217,32.7,288,71,217,32.7
33041, 상당구,090005, 89세,2017,223,57,166,34.3,223,57,166,34.3
33041, 상당구,095,90~94세,2017,488,106,382,27.7,488,106,382,27.7
33041, 상당구,095001, 90세,2017,177,47,130,36.2,177,47,130,36.2
33041, 상당구,095002, 91세,2017,103,22,81,27.2,103,22,81,27.2
33041, 상당구,095003, 92세,2017,91,17,74,23,91,17,74,23
33041, 상당구,095004, 93세,2017,66,8,58,13.8,66,8,58,13.8
33041, 상당구,095005, 94세,2017,51,12,39,30.8,51,12,39,30.8
33041, 상당구,100,95~99세,2017,133,26,107,24.3,133,26,107,24.3
33041, 상당구,100001, 95세,2017,59,14,45,31.1,59,14,45,31.1
33041, 상당구,100002, 96세,2017,39,10,29,34.5,39,10,29,34.5
33041, 상당구,100003, 97세,2017,17,X,15,13.3,17,X,15,13.3
33041, 상당구,100004, 98세,2017,10,X,10,0,10,X,10,0
33041, 상당구,100005, 99세,2017,8,X,8,0,8,X,8,0
33041, 상당구,101,100세이상,2017,13,X,12,8.3,13,X,12,8.3
33041, 상당구,102,15세미만,2017,22377,11567,10810,107,22347,11553,10794,107
33041, 상당구,103,15~64세,2017,120358,61667,58691,105.1,119118,61098,58020,105.3
33041, 상당구,104,65세이상,2017,23929,9967,13962,71.4,23861,9941,13920,71.4
33041, 상당구,086,85세이상,2017,2206,541,1665,32.5,2206,541,1665,32.5
33041, 상당구,126,평균연령,2017,41.7,40.3,43.1,,41.7,40.3,43.1,
33041, 상당구,127,중위연령,2017,43.5,42,44.8,,43.5,42,44.9,
33042, 서원구,000,합계,2017,221147,109810,111337,98.6,217535,107951,109584,98.5
33042, 서원구,005,0~4세,2017,9102,4637,4465,103.9,9028,4597,4431,103.7
33042, 서원구,005001, 0세,2017,1567,822,745,110.3,1554,814,740,110
33042, 서원구,005002, 1세,2017,1789,898,891,100.8,1772,886,886,100
33042, 서원구,005003, 2세,2017,1885,989,896,110.4,1870,981,889,110.3
33042, 서원구,005004, 3세,2017,1890,961,929,103.4,1877,956,921,103.8
33042, 서원구,005005, 4세,2017,1971,967,1004,96.3,1955,960,995,96.5
33042, 서원구,010,5~9세,2017,10561,5375,5186,103.6,10525,5360,5165,103.8
33042, 서원구,010001, 5세,2017,2153,1096,1057,103.7,2142,1092,1050,104
33042, 서원구,010002, 6세,2017,2142,1053,1089,96.7,2137,1051,1086,96.8
33042, 서원구,010003, 7세,2017,2052,1056,996,106,2045,1054,991,106.4
33042, 서원구,010004, 8세,2017,2039,1063,976,108.9,2031,1060,971,109.2
33042, 서원구,010005, 9세,2017,2175,1107,1068,103.7,2170,1103,1067,103.4
33042, 서원구,015,10~14세,2017,10965,5711,5254,108.7,10935,5697,5238,108.8
33042, 서원구,015001, 10세,2017,2192,1143,1049,109,2184,1140,1044,109.2
33042, 서원구,015002, 11세,2017,2077,1052,1025,102.6,2071,1050,1021,102.8
33042, 서원구,015003, 12세,2017,2074,1046,1028,101.8,2069,1044,1025,101.9
33042, 서원구,015004, 13세,2017,2215,1179,1036,113.8,2210,1177,1033,113.9
33042, 서원구,015005, 14세,2017,2407,1291,1116,115.7,2401,1286,1115,115.3
33042, 서원구,020,15~19세,2017,15511,8054,7457,108,15389,7990,7399,108
33042, 서원구,020001, 15세,2017,2386,1275,1111,114.8,2378,1272,1106,115
33042, 서원구,020002, 16세,2017,2731,1401,1330,105.3,2726,1400,1326,105.6
33042, 서원구,020003, 17세,2017,2833,1496,1337,111.9,2819,1488,1331,111.8
33042, 서원구,020004, 18세,2017,3286,1751,1535,114.1,3265,1741,1524,114.2
33042, 서원구,020005, 19세,2017,4275,2131,2144,99.4,4201,2089,2112,98.9
33042, 서원구,025,20~24세,2017,20209,10643,9566,111.3,19526,10316,9210,112
33042, 서원구,025001, 20세,2017,4181,1941,2240,86.7,4067,1886,2181,86.5
33042, 서원구,025002, 21세,2017,4019,2050,1969,104.1,3895,1996,1899,105.1
33042, 서원구,025003, 22세,2017,4185,2186,1999,109.4,4024,2117,1907,111
33042, 서원구,025004, 23세,2017,4037,2312,1725,134,3887,2232,1655,134.9
33042, 서원구,025005, 24세,2017,3787,2154,1633,131.9,3653,2085,1568,133
33042, 서원구,030,25~29세,2017,14703,8128,6575,123.6,14104,7792,6312,123.4
33042, 서원구,030001, 25세,2017,3458,2011,1447,139,3330,1936,1394,138.9
33042, 서원구,030002, 26세,2017,3084,1724,1360,126.8,2987,1667,1320,126.3
33042, 서원구,030003, 27세,2017,2868,1575,1293,121.8,2729,1507,1222,123.3
33042, 서원구,030004, 28세,2017,2657,1439,1218,118.1,2541,1377,1164,118.3
33042, 서원구,030005, 29세,2017,2636,1379,1257,109.7,2517,1305,1212,107.7
33042, 서원구,035,30~34세,2017,13619,6939,6680,103.9,13100,6647,6453,103
33042, 서원구,035001, 30세,2017,2610,1319,1291,102.2,2494,1252,1242,100.8
33042, 서원구,035002, 31세,2017,2571,1382,1189,116.2,2453,1312,1141,115
33042, 서원구,035003, 32세,2017,2607,1283,1324,96.9,2512,1237,1275,97
33042, 서원구,035004, 33세,2017,2826,1468,1358,108.1,2745,1421,1324,107.3
33042, 서원구,035005, 34세,2017,3005,1487,1518,98,2896,1425,1471,96.9
33042, 서원구,040,35~39세,2017,16088,8051,8037,100.2,15767,7886,7881,100.1
33042, 서원구,040001, 35세,2017,3326,1682,1644,102.3,3254,1639,1615,101.5
33042, 서원구,040002, 36세,2017,3237,1636,1601,102.2,3161,1602,1559,102.8
33042, 서원구,040003, 37세,2017,3282,1634,1648,99.2,3214,1596,1618,98.6
33042, 서원구,040004, 38세,2017,3227,1603,1624,98.7,3180,1579,1601,98.6
33042, 서원구,040005, 39세,2017,3016,1496,1520,98.4,2958,1470,1488,98.8
33042, 서원구,045,40~44세,2017,17368,8500,8868,95.9,17094,8356,8738,95.6
33042, 서원구,045001, 40세,2017,3198,1600,1598,100.1,3130,1559,1571,99.2
33042, 서원구,045002, 41세,2017,3226,1623,1603,101.2,3173,1595,1578,101.1
33042, 서원구,045003, 42세,2017,3377,1626,1751,92.9,3324,1598,1726,92.6
33042, 서원구,045004, 43세,2017,3754,1849,1905,97.1,3701,1824,1877,97.2
33042, 서원구,045005, 44세,2017,3813,1802,2011,89.6,3766,1780,1986,89.6
33042, 서원구,050,45~49세,2017,19843,9570,10273,93.2,19574,9436,10138,93.1
33042, 서원구,050001, 45세,2017,3667,1816,1851,98.1,3606,1785,1821,98
33042, 서원구,050002, 46세,2017,3955,1932,2023,95.5,3900,1908,1992,95.8
33042, 서원구,050003, 47세,2017,3848,1866,1982,94.1,3793,1835,1958,93.7
33042, 서원구,050004, 48세,2017,4297,2042,2255,90.6,4252,2021,2231,90.6
33042, 서원구,050005, 49세,2017,4076,1914,2162,88.5,4023,1887,2136,88.3
33042, 서원구,055,50~54세,2017,17451,8726,8725,100,17219,8614,8605,100.1
33042, 서원구,055001, 50세,2017,3808,1867,1941,96.2,3758,1844,1914,96.3
33042, 서원구,055002, 51세,2017,3552,1788,1764,101.4,3512,1765,1747,101
33042, 서원구,055003, 52세,2017,3635,1835,1800,101.9,3586,1813,1773,102.3
33042, 서원구,055004, 53세,2017,3112,1526,1586,96.2,3068,1512,1556,97.2
33042, 서원구,055005, 54세,2017,3344,1710,1634,104.7,3295,1680,1615,104
33042, 서원구,060,55~59세,2017,17611,8666,8945,96.9,17389,8557,8832,96.9
33042, 서원구,060001, 55세,2017,3598,1804,1794,100.6,3550,1785,1765,101.1
33042, 서원구,060002, 56세,2017,4056,2027,2029,99.9,4023,2012,2011,100
33042, 서원구,060003, 57세,2017,3559,1752,1807,97,3503,1719,1784,96.4
33042, 서원구,060004, 58세,2017,3234,1507,1727,87.3,3197,1490,1707,87.3
33042, 서원구,060005, 59세,2017,3164,1576,1588,99.2,3116,1551,1565,99.1
33042, 서원구,065,60~64세,2017,12728,6256,6472,96.7,12605,6190,6415,96.5
33042, 서원구,065001, 60세,2017,3110,1545,1565,98.7,3085,1531,1554,98.5
33042, 서원구,065002, 61세,2017,2746,1364,1382,98.7,2724,1350,1374,98.3
33042, 서원구,065003, 62세,2017,2601,1257,1344,93.5,2572,1242,1330,93.4
33042, 서원구,065004, 63세,2017,2310,1172,1138,103,2284,1161,1123,103.4
33042, 서원구,065005, 64세,2017,1961,918,1043,88,1940,906,1034,87.6
33042, 서원구,070,65~69세,2017,8138,3869,4269,90.6,8079,3845,4234,90.8
33042, 서원구,070001, 65세,2017,2122,1046,1076,97.2,2111,1042,1069,97.5
33042, 서원구,070002, 66세,2017,1410,652,758,86,1395,646,749,86.2
33042, 서원구,070003, 67세,2017,1548,720,828,87,1537,714,823,86.8
33042, 서원구,070004, 68세,2017,1527,718,809,88.8,1512,712,800,89
33042, 서원구,070005, 69세,2017,1531,733,798,91.9,1524,731,793,92.2
33042, 서원구,075,70~74세,2017,6100,2774,3326,83.4,6078,2765,3313,83.5
33042, 서원구,075001, 70세,2017,1473,668,805,83,1466,666,800,83.3
33042, 서원구,075002, 71세,2017,1109,523,586,89.2,1103,520,583,89.2
33042, 서원구,075003, 72세,2017,1169,552,617,89.5,1167,550,617,89.1
33042, 서원구,075004, 73세,2017,1167,523,644,81.2,1163,522,641,81.4
33042, 서원구,075005, 74세,2017,1182,508,674,75.4,1179,507,672,75.4
33042, 서원구,080,75~79세,2017,5358,2180,3178,68.6,5343,2177,3166,68.8
33042, 서원구,080001, 75세,2017,1370,593,777,76.3,1367,593,774,76.6
33042, 서원구,080002, 76세,2017,1095,429,666,64.4,1091,429,662,64.8
33042, 서원구,080003, 77세,2017,1010,414,596,69.5,1007,413,594,69.5
33042, 서원구,080004, 78세,2017,987,397,590,67.3,986,396,590,67.1
33042, 서원구,080005, 79세,2017,896,347,549,63.2,892,346,546,63.4
33042, 서원구,085,80~84세,2017,3541,1258,2283,55.1,3532,1254,2278,55
33042, 서원구,085001, 80세,2017,873,344,529,65,869,342,527,64.9
33042, 서원구,085002, 81세,2017,799,294,505,58.2,799,294,505,58.2
33042, 서원구,085003, 82세,2017,761,276,485,56.9,760,275,485,56.7
33042, 서원구,085004, 83세,2017,571,172,399,43.1,569,171,398,43
33042, 서원구,085005, 84세,2017,537,172,365,47.1,535,172,363,47.4
33042, 서원구,090,85~89세,2017,1539,355,1184,30,1536,354,1182,29.9
33042, 서원구,090001, 85세,2017,425,108,317,34.1,424,107,317,33.8
33042, 서원구,090002, 86세,2017,323,67,256,26.2,323,67,256,26.2
33042, 서원구,090003, 87세,2017,337,80,257,31.1,337,80,257,31.1
33042, 서원구,090004, 88세,2017,256,45,211,21.3,255,45,210,21.4
33042, 서원구,090005, 89세,2017,198,55,143,38.5,197,55,142,38.7
33042, 서원구,095,90~94세,2017,575,97,478,20.3,575,97,478,20.3
33042, 서원구,095001, 90세,2017,185,38,147,25.9,185,38,147,25.9
33042, 서원구,095002, 91세,2017,128,21,107,19.6,128,21,107,19.6
33042, 서원구,095003, 92세,2017,134,16,118,13.6,134,16,118,13.6
33042, 서원구,095004, 93세,2017,65,12,53,22.6,65,12,53,22.6
33042, 서원구,095005, 94세,2017,63,10,53,18.9,63,10,53,18.9
33042, 서원구,100,95~99세,2017,125,19,106,17.9,125,19,106,17.9
33042, 서원구,100001, 95세,2017,51,10,41,24.4,51,10,41,24.4
33042, 서원구,100002, 96세,2017,39,X,35,11.4,39,X,35,11.4
33042, 서원구,100003, 97세,2017,14,X,12,16.7,14,X,12,16.7
33042, 서원구,100004, 98세,2017,13,X,11,18.2,13,X,11,18.2
33042, 서원구,100005, 99세,2017,8,X,7,14.3,8,X,7,14.3
33042, 서원구,101,100세이상,2017,12,X,10,20,12,X,10,20
33042, 서원구,102,15세미만,2017,30628,15723,14905,105.5,30488,15654,14834,105.5
33042, 서원구,103,15~64세,2017,165131,83533,81598,102.4,161767,81784,79983,102.3
33042, 서원구,104,65세이상,2017,25388,10554,14834,71.1,25280,10513,14767,71.2
33042, 서원구,086,85세이상,2017,2251,473,1778,26.6,2248,472,1776,26.6
33042, 서원구,126,평균연령,2017,39.4,38.2,40.6,,39.5,38.2,40.7,
33042, 서원구,127,중위연령,2017,39.9,38.3,41.5,,40.1,38.5,41.7,
33043, 흥덕구,000,합계,2017,258308,130000,128308,101.3,251849,126467,125382,100.9
33043, 흥덕구,005,0~4세,2017,12116,6170,5946,103.8,11951,6094,5857,104
33043, 흥덕구,005001, 0세,2017,2269,1164,1105,105.3,2237,1152,1085,106.2
33043, 흥덕구,005002, 1세,2017,2370,1217,1153,105.6,2338,1202,1136,105.8
33043, 흥덕구,005003, 2세,2017,2476,1264,1212,104.3,2443,1250,1193,104.8
33043, 흥덕구,005004, 3세,2017,2483,1225,1258,97.4,2447,1205,1242,97
33043, 흥덕구,005005, 4세,2017,2518,1300,1218,106.7,2486,1285,1201,107
33043, 흥덕구,010,5~9세,2017,12936,6653,6283,105.9,12819,6590,6229,105.8
33043, 흥덕구,010001, 5세,2017,2598,1317,1281,102.8,2571,1305,1266,103.1
33043, 흥덕구,010002, 6세,2017,2698,1358,1340,101.3,2665,1337,1328,100.7
33043, 흥덕구,010003, 7세,2017,2567,1315,1252,105,2546,1303,1243,104.8
33043, 흥덕구,010004, 8세,2017,2518,1310,1208,108.4,2500,1298,1202,108
33043, 흥덕구,010005, 9세,2017,2555,1353,1202,112.6,2537,1347,1190,113.2
33043, 흥덕구,015,10~14세,2017,12663,6595,6068,108.7,12574,6550,6024,108.7
33043, 흥덕구,015001, 10세,2017,2580,1351,1229,109.9,2557,1339,1218,109.9
33043, 흥덕구,015002, 11세,2017,2422,1267,1155,109.7,2406,1256,1150,109.2
33043, 흥덕구,015003, 12세,2017,2347,1197,1150,104.1,2330,1189,1141,104.2
33043, 흥덕구,015004, 13세,2017,2675,1408,1267,111.1,2658,1399,1259,111.1
33043, 흥덕구,015005, 14세,2017,2639,1372,1267,108.3,2623,1367,1256,108.8
33043, 흥덕구,020,15~19세,2017,15939,8326,7613,109.4,15806,8254,7552,109.3
33043, 흥덕구,020001, 15세,2017,2649,1375,1274,107.9,2639,1370,1269,108
33043, 흥덕구,020002, 16세,2017,3025,1609,1416,113.6,3006,1598,1408,113.5
33043, 흥덕구,020003, 17세,2017,3474,1875,1599,117.3,3460,1865,1595,116.9
33043, 흥덕구,020004, 18세,2017,3319,1741,1578,110.3,3284,1722,1562,110.2
33043, 흥덕구,020005, 19세,2017,3472,1726,1746,98.9,3417,1699,1718,98.9
33043, 흥덕구,025,20~24세,2017,20382,10516,9866,106.6,19665,10143,9522,106.5
33043, 흥덕구,025001, 20세,2017,3786,1891,1895,99.8,3696,1857,1839,101
33043, 흥덕구,025002, 21세,2017,4128,2117,2011,105.3,4004,2043,1961,104.2
33043, 흥덕구,025003, 22세,2017,4112,2088,2024,103.2,3952,2002,1950,102.7
33043, 흥덕구,025004, 23세,2017,4139,2185,1954,111.8,3978,2096,1882,111.4
33043, 흥덕구,025005, 24세,2017,4217,2235,1982,112.8,4035,2145,1890,113.5
33043, 흥덕구,030,25~29세,2017,20210,10687,9523,112.2,19130,10087,9043,111.5
33043, 흥덕구,030001, 25세,2017,4178,2235,1943,115,4000,2141,1859,115.2
33043, 흥덕구,030002, 26세,2017,4153,2197,1956,112.3,3926,2082,1844,112.9
33043, 흥덕구,030003, 27세,2017,4030,2162,1868,115.7,3780,2016,1764,114.3
33043, 흥덕구,030004, 28세,2017,3978,2100,1878,111.8,3784,1988,1796,110.7
33043, 흥덕구,030005, 29세,2017,3871,1993,1878,106.1,3640,1860,1780,104.5
33043, 흥덕구,035,30~34세,2017,19755,10262,9493,108.1,18743,9690,9053,107
33043, 흥덕구,035001, 30세,2017,3857,2042,1815,112.5,3621,1910,1711,111.6
33043, 흥덕구,035002, 31세,2017,3905,2058,1847,111.4,3689,1926,1763,109.2
33043, 흥덕구,035003, 32세,2017,3779,1959,1820,107.6,3573,1848,1725,107.1
33043, 흥덕구,035004, 33세,2017,3976,2029,1947,104.2,3800,1937,1863,104
33043, 흥덕구,035005, 34세,2017,4238,2174,2064,105.3,4060,2069,1991,103.9
33043, 흥덕구,040,35~39세,2017,21548,11052,10496,105.3,20777,10556,10221,103.3
33043, 흥덕구,040001, 35세,2017,4708,2357,2351,100.3,4545,2257,2288,98.6
33043, 흥덕구,040002, 36세,2017,4306,2229,2077,107.3,4139,2124,2015,105.4
33043, 흥덕구,040003, 37세,2017,4381,2240,2141,104.6,4252,2157,2095,103
33043, 흥덕구,040004, 38세,2017,4202,2170,2032,106.8,4044,2067,1977,104.6
33043, 흥덕구,040005, 39세,2017,3951,2056,1895,108.5,3797,1951,1846,105.7
33043, 흥덕구,045,40~44세,2017,21346,10702,10644,100.5,20832,10404,10428,99.8
33043, 흥덕구,045001, 40세,2017,4105,2067,2038,101.4,3989,1986,2003,99.2
33043, 흥덕구,045002, 41세,2017,3955,2005,1950,102.8,3843,1940,1903,101.9
33043, 흥덕구,045003, 42세,2017,4177,2090,2087,100.1,4078,2040,2038,100.1
33043, 흥덕구,045004, 43세,2017,4544,2255,2289,98.5,4449,2203,2246,98.1
33043, 흥덕구,045005, 44세,2017,4565,2285,2280,100.2,4473,2235,2238,99.9
33043, 흥덕구,050,45~49세,2017,23177,11646,11531,101,22599,11334,11265,100.6
33043, 흥덕구,050001, 45세,2017,4189,2115,2074,102,4083,2062,2021,102
33043, 흥덕구,050002, 46세,2017,4672,2421,2251,107.6,4559,2356,2203,106.9
33043, 흥덕구,050003, 47세,2017,4635,2344,2291,102.3,4515,2273,2242,101.4
33043, 흥덕구,050004, 48세,2017,4972,2466,2506,98.4,4853,2402,2451,98
33043, 흥덕구,050005, 49세,2017,4709,2300,2409,95.5,4589,2241,2348,95.4
33043, 흥덕구,055,50~54세,2017,20254,10180,10074,101.1,19798,9944,9854,100.9
33043, 흥덕구,055001, 50세,2017,4218,2134,2084,102.4,4153,2096,2057,101.9
33043, 흥덕구,055002, 51세,2017,4112,2026,2086,97.1,4019,1975,2044,96.6
33043, 흥덕구,055003, 52세,2017,4258,2063,2195,94,4167,2015,2152,93.6
33043, 흥덕구,055004, 53세,2017,3753,1946,1807,107.7,3662,1904,1758,108.3
33043, 흥덕구,055005, 54세,2017,3913,2011,1902,105.7,3797,1954,1843,106
33043, 흥덕구,060,55~59세,2017,19755,10052,9703,103.6,19380,9883,9497,104.1
33043, 흥덕구,060001, 55세,2017,4222,2177,2045,106.5,4132,2137,1995,107.1
33043, 흥덕구,060002, 56세,2017,4621,2361,2260,104.5,4554,2328,2226,104.6
33043, 흥덕구,060003, 57세,2017,3916,1956,1960,99.8,3834,1917,1917,100
33043, 흥덕구,060004, 58세,2017,3595,1811,1784,101.5,3524,1780,1744,102.1
33043, 흥덕구,060005, 59세,2017,3401,1747,1654,105.6,3336,1721,1615,106.6
33043, 흥덕구,065,60~64세,2017,13372,6649,6723,98.9,13104,6515,6589,98.9
33043, 흥덕구,065001, 60세,2017,3204,1540,1664,92.5,3130,1509,1621,93.1
33043, 흥덕구,065002, 61세,2017,2925,1529,1396,109.5,2859,1489,1370,108.7
33043, 흥덕구,065003, 62세,2017,2849,1386,1463,94.7,2801,1362,1439,94.6
33043, 흥덕구,065004, 63세,2017,2392,1163,1229,94.6,2347,1142,1205,94.8
33043, 흥덕구,065005, 64세,2017,2002,1031,971,106.2,1967,1013,954,106.2
33043, 흥덕구,070,65~69세,2017,8356,4107,4249,96.7,8237,4047,4190,96.6
33043, 흥덕구,070001, 65세,2017,2206,1070,1136,94.2,2171,1050,1121,93.7
33043, 흥덕구,070002, 66세,2017,1515,727,788,92.3,1478,710,768,92.4
33043, 흥덕구,070003, 67세,2017,1540,764,776,98.5,1526,761,765,99.5
33043, 흥덕구,070004, 68세,2017,1612,814,798,102,1590,801,789,101.5
33043, 흥덕구,070005, 69세,2017,1483,732,751,97.5,1472,725,747,97.1
33043, 흥덕구,075,70~74세,2017,5953,2683,3270,82,5922,2669,3253,82
33043, 흥덕구,075001, 70세,2017,1403,655,748,87.6,1398,652,746,87.4
33043, 흥덕구,075002, 71세,2017,1079,512,567,90.3,1073,511,562,90.9
33043, 흥덕구,075003, 72세,2017,1157,543,614,88.4,1148,538,610,88.2
33043, 흥덕구,075004, 73세,2017,1118,465,653,71.2,1112,463,649,71.3
33043, 흥덕구,075005, 74세,2017,1196,508,688,73.8,1191,505,686,73.6
33043, 흥덕구,080,75~79세,2017,5041,2035,3006,67.7,5028,2030,2998,67.7
33043, 흥덕구,080001, 75세,2017,1303,567,736,77,1299,565,734,77
33043, 흥덕구,080002, 76세,2017,1032,411,621,66.2,1028,410,618,66.3
33043, 흥덕구,080003, 77세,2017,922,378,544,69.5,921,377,544,69.3
33043, 흥덕구,080004, 78세,2017,967,368,599,61.4,964,368,596,61.7
33043, 흥덕구,080005, 79세,2017,817,311,506,61.5,816,310,506,61.3
33043, 흥덕구,085,80~84세,2017,3445,1187,2258,52.6,3432,1183,2249,52.6
33043, 흥덕구,085001, 80세,2017,807,308,499,61.7,805,308,497,62
33043, 흥덕구,085002, 81세,2017,805,284,521,54.5,802,284,518,54.8
33043, 흥덕구,085003, 82세,2017,752,254,498,51,748,252,496,50.8
33043, 흥덕구,085004, 83세,2017,582,184,398,46.2,579,182,397,45.8
33043, 흥덕구,085005, 84세,2017,499,157,342,45.9,498,157,341,46
33043, 흥덕구,090,85~89세,2017,1459,360,1099,32.8,1453,358,1095,32.7
33043, 흥덕구,090001, 85세,2017,428,103,325,31.7,425,102,323,31.6
33043, 흥덕구,090002, 86세,2017,296,87,209,41.6,295,86,209,41.1
33043, 흥덕구,090003, 87세,2017,309,75,234,32.1,309,75,234,32.1
33043, 흥덕구,090004, 88세,2017,227,50,177,28.2,226,50,176,28.4
33043, 흥덕구,090005, 89세,2017,199,45,154,29.2,198,45,153,29.4
33043, 흥덕구,095,90~94세,2017,463,112,351,31.9,461,110,351,31.3
33043, 흥덕구,095001, 90세,2017,147,39,108,36.1,147,39,108,36.1
33043, 흥덕구,095002, 91세,2017,98,21,77,27.3,98,21,77,27.3
33043, 흥덕구,095003, 92세,2017,102,20,82,24.4,102,20,82,24.4
33043, 흥덕구,095004, 93세,2017,57,14,43,32.6,55,12,43,27.9
33043, 흥덕구,095005, 94세,2017,59,18,41,43.9,59,18,41,43.9
33043, 흥덕구,100,95~99세,2017,125,24,101,23.8,125,24,101,23.8
33043, 흥덕구,100001, 95세,2017,52,11,41,26.8,52,11,41,26.8
33043, 흥덕구,100002, 96세,2017,27,7,20,35,27,7,20,35
33043, 흥덕구,100003, 97세,2017,20,X,19,5.3,20,X,19,5.3
33043, 흥덕구,100004, 98세,2017,15,X,12,25,15,X,12,25
33043, 흥덕구,100005, 99세,2017,11,X,9,22.2,11,X,9,22.2
33043, 흥덕구,101,100세이상,2017,13,X,11,18.2,13,X,11,18.2
33043, 흥덕구,102,15세미만,2017,37715,19418,18297,106.1,37344,19234,18110,106.2
33043, 흥덕구,103,15~64세,2017,195738,100072,95666,104.6,189834,96810,93024,104.1
33043, 흥덕구,104,65세이상,2017,24855,10510,14345,73.3,24671,10423,14248,73.2
33043, 흥덕구,086,85세이상,2017,2060,498,1562,31.9,2052,494,1558,31.7
33043, 흥덕구,126,평균연령,2017,38.4,37.5,39.3,,38.4,37.5,39.4,
33043, 흥덕구,127,중위연령,2017,38.4,37.5,39.4,,38.6,37.7,39.6,
33044, 청원구,000,합계,2017,196192,100077,96115,104.1,191240,97080,94160,103.1
33044, 청원구,005,0~4세,2017,11781,5999,5782,103.8,11712,5966,5746,103.8
33044, 청원구,005001, 0세,2017,2135,1082,1053,102.8,2121,1073,1048,102.4
33044, 청원구,005002, 1세,2017,2456,1241,1215,102.1,2443,1234,1209,102.1
33044, 청원구,005003, 2세,2017,2468,1269,1199,105.8,2455,1264,1191,106.1
33044, 청원구,005004, 3세,2017,2395,1204,1191,101.1,2378,1196,1182,101.2
33044, 청원구,005005, 4세,2017,2327,1203,1124,107,2315,1199,1116,107.4
33044, 청원구,010,5~9세,2017,11234,5742,5492,104.6,11197,5726,5471,104.7
33044, 청원구,010001, 5세,2017,2574,1311,1263,103.8,2563,1304,1259,103.6
33044, 청원구,010002, 6세,2017,2328,1177,1151,102.3,2316,1173,1143,102.6
33044, 청원구,010003, 7세,2017,2147,1089,1058,102.9,2141,1087,1054,103.1
33044, 청원구,010004, 8세,2017,2075,1101,974,113,2074,1101,973,113.2
33044, 청원구,010005, 9세,2017,2110,1064,1046,101.7,2103,1061,1042,101.8
33044, 청원구,015,10~14세,2017,9397,4859,4538,107.1,9382,4854,4528,107.2
33044, 청원구,015001, 10세,2017,2173,1077,1096,98.3,2169,1077,1092,98.6
33044, 청원구,015002, 11세,2017,1845,972,873,111.3,1843,971,872,111.4
33044, 청원구,015003, 12세,2017,1780,941,839,112.2,1775,939,836,112.3
33044, 청원구,015004, 13세,2017,1792,942,850,110.8,1790,942,848,111.1
33044, 청원구,015005, 14세,2017,1807,927,880,105.3,1805,925,880,105.1
33044, 청원구,020,15~19세,2017,11540,5950,5590,106.4,11436,5891,5545,106.2
33044, 청원구,020001, 15세,2017,1888,1000,888,112.6,1884,999,885,112.9
33044, 청원구,020002, 16세,2017,2151,1110,1041,106.6,2145,1106,1039,106.4
33044, 청원구,020003, 17세,2017,2356,1192,1164,102.4,2345,1190,1155,103
33044, 청원구,020004, 18세,2017,2392,1215,1177,103.2,2369,1201,1168,102.8
33044, 청원구,020005, 19세,2017,2753,1433,1320,108.6,2693,1395,1298,107.5
33044, 청원구,025,20~24세,2017,13823,7265,6558,110.8,13122,6855,6267,109.4
33044, 청원구,025001, 20세,2017,2856,1386,1470,94.3,2765,1349,1416,95.3
33044, 청원구,025002, 21세,2017,2782,1417,1365,103.8,2646,1346,1300,103.5
33044, 청원구,025003, 22세,2017,2671,1420,1251,113.5,2510,1317,1193,110.4
33044, 청원구,025004, 23세,2017,2718,1501,1217,123.3,2555,1402,1153,121.6
33044, 청원구,025005, 24세,2017,2796,1541,1255,122.8,2646,1441,1205,119.6
33044, 청원구,030,25~29세,2017,13742,7822,5920,132.1,12856,7229,5627,128.5
33044, 청원구,030001, 25세,2017,2777,1650,1127,146.4,2605,1522,1083,140.5
33044, 청원구,030002, 26세,2017,2676,1528,1148,133.1,2488,1401,1087,128.9
33044, 청원구,030003, 27세,2017,2635,1497,1138,131.5,2452,1387,1065,130.2
33044, 청원구,030004, 28세,2017,2745,1549,1196,129.5,2580,1438,1142,125.9
33044, 청원구,030005, 29세,2017,2909,1598,1311,121.9,2731,1481,1250,118.5
33044, 청원구,035,30~34세,2017,16717,8936,7781,114.8,15919,8428,7491,112.5
33044, 청원구,035001, 30세,2017,3040,1607,1433,112.1,2851,1496,1355,110.4
33044, 청원구,035002, 31세,2017,3174,1721,1453,118.4,3027,1620,1407,115.1
33044, 청원구,035003, 32세,2017,3248,1721,1527,112.7,3089,1626,1463,111.1
33044, 청원구,035004, 33세,2017,3497,1912,1585,120.6,3351,1816,1535,118.3
33044, 청원구,035005, 34세,2017,3758,1975,1783,110.8,3601,1870,1731,108
33044, 청원구,040,35~39세,2017,18663,9936,8727,113.9,18084,9559,8525,112.1
33044, 청원구,040001, 35세,2017,4147,2143,2004,106.9,4007,2048,1959,104.5
33044, 청원구,040002, 36세,2017,3670,1959,1711,114.5,3553,1882,1671,112.6
33044, 청원구,040003, 37세,2017,3994,2151,1843,116.7,3886,2085,1801,115.8
33044, 청원구,040004, 38세,2017,3614,1919,1695,113.2,3497,1846,1651,111.8
33044, 청원구,040005, 39세,2017,3238,1764,1474,119.7,3141,1698,1443,117.7
33044, 청원구,045,40~44세,2017,16006,8400,7606,110.4,15582,8137,7445,109.3
33044, 청원구,045001, 40세,2017,3257,1717,1540,111.5,3156,1650,1506,109.6
33044, 청원구,045002, 41세,2017,3137,1638,1499,109.3,3058,1589,1469,108.2
33044, 청원구,045003, 42세,2017,3129,1598,1531,104.4,3046,1547,1499,103.2
33044, 청원구,045004, 43세,2017,3324,1793,1531,117.1,3250,1745,1505,115.9
33044, 청원구,045005, 44세,2017,3159,1654,1505,109.9,3072,1606,1466,109.5
33044, 청원구,050,45~49세,2017,15475,8005,7470,107.2,15055,7748,7307,106
33044, 청원구,050001, 45세,2017,2962,1521,1441,105.6,2875,1468,1407,104.3
33044, 청원구,050002, 46세,2017,3246,1704,1542,110.5,3159,1653,1506,109.8
33044, 청원구,050003, 47세,2017,2925,1544,1381,111.8,2835,1485,1350,110
33044, 청원구,050004, 48세,2017,3241,1694,1547,109.5,3157,1641,1516,108.2
33044, 청원구,050005, 49세,2017,3101,1542,1559,98.9,3029,1501,1528,98.2
33044, 청원구,055,50~54세,2017,13067,6678,6389,104.5,12727,6500,6227,104.4
33044, 청원구,055001, 50세,2017,2769,1420,1349,105.3,2708,1387,1321,105
33044, 청원구,055002, 51세,2017,2768,1403,1365,102.8,2695,1367,1328,102.9
33044, 청원구,055003, 52세,2017,2797,1429,1368,104.5,2715,1384,1331,104
33044, 청원구,055004, 53세,2017,2307,1163,1144,101.7,2255,1135,1120,101.3
33044, 청원구,055005, 54세,2017,2426,1263,1163,108.6,2354,1227,1127,108.9
33044, 청원구,060,55~59세,2017,13460,6689,6771,98.8,13219,6568,6651,98.8
33044, 청원구,060001, 55세,2017,2694,1413,1281,110.3,2647,1391,1256,110.7
33044, 청원구,060002, 56세,2017,3038,1475,1563,94.4,3008,1460,1548,94.3
33044, 청원구,060003, 57세,2017,2682,1308,1374,95.2,2622,1275,1347,94.7
33044, 청원구,060004, 58세,2017,2626,1289,1337,96.4,2575,1265,1310,96.6
33044, 청원구,060005, 59세,2017,2420,1204,1216,99,2367,1177,1190,98.9
33044, 청원구,065,60~64세,2017,10068,4916,5152,95.4,9875,4814,5061,95.1
33044, 청원구,065001, 60세,2017,2391,1200,1191,100.8,2337,1172,1165,100.6
33044, 청원구,065002, 61세,2017,2203,1094,1109,98.6,2154,1065,1089,97.8
33044, 청원구,065003, 62세,2017,2138,1021,1117,91.4,2103,1002,1101,91
33044, 청원구,065004, 63세,2017,1754,815,939,86.8,1730,802,928,86.4
33044, 청원구,065005, 64세,2017,1582,786,796,98.7,1551,773,778,99.4
33044, 청원구,070,65~69세,2017,6452,3161,3291,96,6366,3111,3255,95.6
33044, 청원구,070001, 65세,2017,1656,831,825,100.7,1631,817,814,100.4
33044, 청원구,070002, 66세,2017,1153,564,589,95.8,1136,553,583,94.9
33044, 청원구,070003, 67세,2017,1168,572,596,96,1160,568,592,95.9
33044, 청원구,070004, 68세,2017,1198,583,615,94.8,1176,569,607,93.7
33044, 청원구,070005, 69세,2017,1277,611,666,91.7,1263,604,659,91.7
33044, 청원구,075,70~74세,2017,5068,2299,2769,83,5038,2282,2756,82.8
33044, 청원구,075001, 70세,2017,1187,562,625,89.9,1176,556,620,89.7
33044, 청원구,075002, 71세,2017,955,441,514,85.8,947,438,509,86.1
33044, 청원구,075003, 72세,2017,976,449,527,85.2,969,444,525,84.6
33044, 청원구,075004, 73세,2017,952,396,556,71.2,952,396,556,71.2
33044, 청원구,075005, 74세,2017,998,451,547,82.4,994,448,546,82.1
33044, 청원구,080,75~79세,2017,4729,1912,2817,67.9,4716,1909,2807,68
33044, 청원구,080001, 75세,2017,1222,520,702,74.1,1221,519,702,73.9
33044, 청원구,080002, 76세,2017,925,387,538,71.9,921,387,534,72.5
33044, 청원구,080003, 77세,2017,872,356,516,69,871,356,515,69.1
33044, 청원구,080004, 78세,2017,888,354,534,66.3,884,353,531,66.5
33044, 청원구,080005, 79세,2017,822,295,527,56,819,294,525,56
33044, 청원구,085,80~84세,2017,3070,1029,2041,50.4,3059,1026,2033,50.5
33044, 청원구,085001, 80세,2017,731,278,453,61.4,729,276,453,60.9
33044, 청원구,085002, 81세,2017,695,228,467,48.8,692,227,465,48.8
33044, 청원구,085003, 82세,2017,627,207,420,49.3,624,207,417,49.6
33044, 청원구,085004, 83세,2017,549,180,369,48.8,547,180,367,49
33044, 청원구,085005, 84세,2017,468,136,332,41,467,136,331,41.1
33044, 청원구,090,85~89세,2017,1366,370,996,37.1,1361,368,993,37.1
33044, 청원구,090001, 85세,2017,383,126,257,49,383,126,257,49
33044, 청원구,090002, 86세,2017,288,85,203,41.9,287,84,203,41.4
33044, 청원구,090003, 87세,2017,264,63,201,31.3,262,62,200,31
33044, 청원구,090004, 88세,2017,267,60,207,29,265,60,205,29.3
33044, 청원구,090005, 89세,2017,164,36,128,28.1,164,36,128,28.1
33044, 청원구,095,90~94세,2017,423,94,329,28.6,423,94,329,28.6
33044, 청원구,095001, 90세,2017,145,29,116,25,145,29,116,25
33044, 청원구,095002, 91세,2017,88,22,66,33.3,88,22,66,33.3
33044, 청원구,095003, 92세,2017,82,20,62,32.3,82,20,62,32.3
33044, 청원구,095004, 93세,2017,54,15,39,38.5,54,15,39,38.5
33044, 청원구,095005, 94세,2017,54,8,46,17.4,54,8,46,17.4
33044, 청원구,100,95~99세,2017,98,12,86,14,98,12,86,14
33044, 청원구,100001, 95세,2017,32,5,27,18.5,32,5,27,18.5
33044, 청원구,100002, 96세,2017,29,X,25,16,29,X,25,16
33044, 청원구,100003, 97세,2017,18,X,17,5.9,18,X,17,5.9
33044, 청원구,100004, 98세,2017,12,X,10,20,12,X,10,20
33044, 청원구,100005, 99세,2017,7,X,7,0,7,X,7,0
33044, 청원구,101,100세이상,2017,13,X,10,30,13,X,10,30
33044, 청원구,102,15세미만,2017,32412,16600,15812,105,32291,16546,15745,105.1
33044, 청원구,103,15~64세,2017,142561,74597,67964,109.8,137875,71729,66146,108.4
33044, 청원구,104,65세이상,2017,21219,8880,12339,72,21074,8805,12269,71.8
33044, 청원구,086,85세이상,2017,1900,479,1421,33.7,1895,477,1418,33.6
33044, 청원구,126,평균연령,2017,38,36.9,39.1,,38,37,39.1,
33044, 청원구,127,중위연령,2017,37.5,36.7,38.5,,37.6,36.8,38.6,
33320, 보은군,000,합계,2017,32253,16018,16235,98.7,31680,15735,15945,98.7
33320, 보은군,005,0~4세,2017,871,447,424,105.4,866,444,422,105.2
33320, 보은군,005001, 0세,2017,167,88,79,111.4,166,87,79,110.1
33320, 보은군,005002, 1세,2017,201,116,85,136.5,198,115,83,138.6
33320, 보은군,005003, 2세,2017,172,86,86,100,171,85,86,98.8
33320, 보은군,005004, 3세,2017,162,83,79,105.1,162,83,79,105.1
33320, 보은군,005005, 4세,2017,169,74,95,77.9,169,74,95,77.9
33320, 보은군,010,5~9세,2017,942,509,433,117.6,941,509,432,117.8
33320, 보은군,010001, 5세,2017,174,97,77,126,174,97,77,126
33320, 보은군,010002, 6세,2017,205,106,99,107.1,205,106,99,107.1
33320, 보은군,010003, 7세,2017,194,115,79,145.6,194,115,79,145.6
33320, 보은군,010004, 8세,2017,185,94,91,103.3,184,94,90,104.4
33320, 보은군,010005, 9세,2017,184,97,87,111.5,184,97,87,111.5
33320, 보은군,015,10~14세,2017,1077,588,489,120.2,1075,586,489,119.8
33320, 보은군,015001, 10세,2017,197,116,81,143.2,197,116,81,143.2
33320, 보은군,015002, 11세,2017,180,104,76,136.8,179,103,76,135.5
33320, 보은군,015003, 12세,2017,229,133,96,138.5,229,133,96,138.5
33320, 보은군,015004, 13세,2017,236,115,121,95,236,115,121,95
33320, 보은군,015005, 14세,2017,235,120,115,104.3,234,119,115,103.5
33320, 보은군,020,15~19세,2017,1305,689,616,111.9,1302,687,615,111.7
33320, 보은군,020001, 15세,2017,266,129,137,94.2,266,129,137,94.2
33320, 보은군,020002, 16세,2017,283,155,128,121.1,282,155,127,122
33320, 보은군,020003, 17세,2017,279,142,137,103.6,279,142,137,103.6
33320, 보은군,020004, 18세,2017,281,150,131,114.5,281,150,131,114.5
33320, 보은군,020005, 19세,2017,196,113,83,136.1,194,111,83,133.7
33320, 보은군,025,20~24세,2017,1282,766,516,148.4,1218,731,487,150.1
33320, 보은군,025001, 20세,2017,245,166,79,210.1,235,159,76,209.2
33320, 보은군,025002, 21세,2017,262,162,100,162,254,157,97,161.9
33320, 보은군,025003, 22세,2017,261,146,115,127,247,140,107,130.8
33320, 보은군,025004, 23세,2017,238,139,99,140.4,221,127,94,135.1
33320, 보은군,025005, 24세,2017,276,153,123,124.4,261,148,113,131
33320, 보은군,030,25~29세,2017,1218,666,552,120.7,1113,619,494,125.3
33320, 보은군,030001, 25세,2017,280,156,124,125.8,263,149,114,130.7
33320, 보은군,030002, 26세,2017,243,142,101,140.6,218,129,89,144.9
33320, 보은군,030003, 27세,2017,240,118,122,96.7,219,111,108,102.8
33320, 보은군,030004, 28세,2017,232,124,108,114.8,210,113,97,116.5
33320, 보은군,030005, 29세,2017,223,126,97,129.9,203,117,86,136
33320, 보은군,035,30~34세,2017,1239,694,545,127.3,1155,647,508,127.4
33320, 보은군,035001, 30세,2017,241,131,110,119.1,223,123,100,123
33320, 보은군,035002, 31세,2017,237,145,92,157.6,220,132,88,150
33320, 보은군,035003, 32세,2017,259,147,112,131.3,244,139,105,132.4
33320, 보은군,035004, 33세,2017,250,127,123,103.3,235,120,115,104.3
33320, 보은군,035005, 34세,2017,252,144,108,133.3,233,133,100,133
33320, 보은군,040,35~39세,2017,1345,754,591,127.6,1275,718,557,128.9
33320, 보은군,040001, 35세,2017,284,149,135,110.4,266,142,124,114.5
33320, 보은군,040002, 36세,2017,303,174,129,134.9,284,162,122,132.8
33320, 보은군,040003, 37세,2017,237,129,108,119.4,227,124,103,120.4
33320, 보은군,040004, 38세,2017,278,160,118,135.6,267,155,112,138.4
33320, 보은군,040005, 39세,2017,243,142,101,140.6,231,135,96,140.6
33320, 보은군,045,40~44세,2017,1536,831,705,117.9,1501,817,684,119.4
33320, 보은군,045001, 40세,2017,244,128,116,110.3,237,126,111,113.5
33320, 보은군,045002, 41세,2017,293,166,127,130.7,289,163,126,129.4
33320, 보은군,045003, 42세,2017,276,133,143,93,264,129,135,95.6
33320, 보은군,045004, 43세,2017,358,203,155,131,353,200,153,130.7
33320, 보은군,045005, 44세,2017,365,201,164,122.6,358,199,159,125.2
33320, 보은군,050,45~49세,2017,2072,1124,948,118.6,2016,1096,920,119.1
33320, 보은군,050001, 45세,2017,364,206,158,130.4,356,203,153,132.7
33320, 보은군,050002, 46세,2017,437,245,192,127.6,426,240,186,129
33320, 보은군,050003, 47세,2017,397,215,182,118.1,381,205,176,116.5
33320, 보은군,050004, 48세,2017,414,222,192,115.6,404,218,186,117.2
33320, 보은군,050005, 49세,2017,460,236,224,105.4,449,230,219,105
33320, 보은군,055,50~54세,2017,2517,1365,1152,118.5,2453,1331,1122,118.6
33320, 보은군,055001, 50세,2017,474,255,219,116.4,465,252,213,118.3
33320, 보은군,055002, 51세,2017,503,287,216,132.9,486,279,207,134.8
33320, 보은군,055003, 52세,2017,548,296,252,117.5,532,288,244,118
33320, 보은군,055004, 53세,2017,468,244,224,108.9,457,237,220,107.7
33320, 보은군,055005, 54세,2017,524,283,241,117.4,513,275,238,115.5
33320, 보은군,060,55~59세,2017,3486,1827,1659,110.1,3445,1810,1635,110.7
33320, 보은군,060001, 55세,2017,667,367,300,122.3,660,365,295,123.7
33320, 보은군,060002, 56세,2017,768,409,359,113.9,759,406,353,115
33320, 보은군,060003, 57세,2017,672,324,348,93.1,659,317,342,92.7
33320, 보은군,060004, 58세,2017,642,334,308,108.4,636,332,304,109.2
33320, 보은군,060005, 59세,2017,737,393,344,114.2,731,390,341,114.4
33320, 보은군,065,60~64세,2017,3199,1598,1601,99.8,3173,1587,1586,100.1
33320, 보은군,065001, 60세,2017,680,346,334,103.6,673,344,329,104.6
33320, 보은군,065002, 61세,2017,710,363,347,104.6,708,362,346,104.6
33320, 보은군,065003, 62세,2017,687,338,349,96.8,677,333,344,96.8
33320, 보은군,065004, 63세,2017,614,300,314,95.5,612,300,312,96.2
33320, 보은군,065005, 64세,2017,508,251,257,97.7,503,248,255,97.3
33320, 보은군,070,65~69세,2017,2429,1238,1191,103.9,2418,1231,1187,103.7
33320, 보은군,070001, 65세,2017,566,288,278,103.6,564,287,277,103.6
33320, 보은군,070002, 66세,2017,427,217,210,103.3,425,216,209,103.3
33320, 보은군,070003, 67세,2017,467,229,238,96.2,465,227,238,95.4
33320, 보은군,070004, 68세,2017,509,268,241,111.2,507,266,241,110.4
33320, 보은군,070005, 69세,2017,460,236,224,105.4,457,235,222,105.9
33320, 보은군,075,70~74세,2017,2116,944,1172,80.5,2113,944,1169,80.8
33320, 보은군,075001, 70세,2017,471,223,248,89.9,471,223,248,89.9
33320, 보은군,075002, 71세,2017,382,183,199,92,382,183,199,92
33320, 보은군,075003, 72세,2017,383,176,207,85,382,176,206,85.4
33320, 보은군,075004, 73세,2017,402,166,236,70.3,401,166,235,70.6
33320, 보은군,075005, 74세,2017,478,196,282,69.5,477,196,281,69.8
33320, 보은군,080,75~79세,2017,2513,1006,1507,66.8,2510,1006,1504,66.9
33320, 보은군,080001, 75세,2017,571,223,348,64.1,570,223,347,64.3
33320, 보은군,080002, 76세,2017,512,198,314,63.1,512,198,314,63.1
33320, 보은군,080003, 77세,2017,477,197,280,70.4,476,197,279,70.6
33320, 보은군,080004, 78세,2017,509,209,300,69.7,509,209,300,69.7
33320, 보은군,080005, 79세,2017,444,179,265,67.5,443,179,264,67.8
33320, 보은군,085,80~84세,2017,1886,645,1241,52,1886,645,1241,52
33320, 보은군,085001, 80세,2017,434,150,284,52.8,434,150,284,52.8
33320, 보은군,085002, 81세,2017,401,139,262,53.1,401,139,262,53.1
33320, 보은군,085003, 82세,2017,425,154,271,56.8,425,154,271,56.8
33320, 보은군,085004, 83세,2017,328,113,215,52.6,328,113,215,52.6
33320, 보은군,085005, 84세,2017,298,89,209,42.6,298,89,209,42.6
33320, 보은군,090,85~89세,2017,856,235,621,37.8,856,235,621,37.8
33320, 보은군,090001, 85세,2017,243,80,163,49.1,243,80,163,49.1
33320, 보은군,090002, 86세,2017,173,47,126,37.3,173,47,126,37.3
33320, 보은군,090003, 87세,2017,171,39,132,29.5,171,39,132,29.5
33320, 보은군,090004, 88세,2017,171,43,128,33.6,171,43,128,33.6
33320, 보은군,090005, 89세,2017,98,26,72,36.1,98,26,72,36.1
33320, 보은군,095,90~94세,2017,310,85,225,37.8,310,85,225,37.8
33320, 보은군,095001, 90세,2017,113,32,81,39.5,113,32,81,39.5
33320, 보은군,095002, 91세,2017,71,22,49,44.9,71,22,49,44.9
33320, 보은군,095003, 92세,2017,64,17,47,36.2,64,17,47,36.2
33320, 보은군,095004, 93세,2017,32,10,22,45.5,32,10,22,45.5
33320, 보은군,095005, 94세,2017,30,X,26,15.4,30,X,26,15.4
33320, 보은군,100,95~99세,2017,45,6,39,15.4,45,6,39,15.4
33320, 보은군,100001, 95세,2017,16,X,13,23.1,16,X,13,23.1
33320, 보은군,100002, 96세,2017,7,X,6,16.7,7,X,6,16.7
33320, 보은군,100003, 97세,2017,8,X,8,0,8,X,8,0
33320, 보은군,100004, 98세,2017,7,X,7,0,7,X,7,0
33320, 보은군,100005, 99세,2017,7,X,5,40,7,X,5,40
33320, 보은군,101,100세이상,2017,9,X,8,12.5,9,X,8,12.5
33320, 보은군,102,15세미만,2017,2890,1544,1346,114.7,2882,1539,1343,114.6
33320, 보은군,103,15~64세,2017,19199,10314,8885,116.1,18651,10043,8608,116.7
33320, 보은군,104,65세이상,2017,10164,4160,6004,69.3,10147,4153,5994,69.3
33320, 보은군,086,85세이상,2017,1220,327,893,36.6,1220,327,893,36.6
33320, 보은군,126,평균연령,2017,51.8,49.2,54.4,,52,49.4,54.6,
33320, 보은군,127,중위연령,2017,56.1,53.4,58.5,,56.3,53.8,58.8,
33330, 옥천군,000,합계,2017,49898,24987,24911,100.3,48998,24457,24541,99.7
33330, 옥천군,005,0~4세,2017,1307,671,636,105.5,1304,669,635,105.4
33330, 옥천군,005001, 0세,2017,203,99,104,95.2,202,98,104,94.2
33330, 옥천군,005002, 1세,2017,254,138,116,119,253,137,116,118.1
33330, 옥천군,005003, 2세,2017,269,139,130,106.9,268,139,129,107.8
33330, 옥천군,005004, 3세,2017,289,141,148,95.3,289,141,148,95.3
33330, 옥천군,005005, 4세,2017,292,154,138,111.6,292,154,138,111.6
33330, 옥천군,010,5~9세,2017,1801,921,880,104.7,1801,921,880,104.7
33330, 옥천군,010001, 5세,2017,340,162,178,91,340,162,178,91
33330, 옥천군,010002, 6세,2017,391,212,179,118.4,391,212,179,118.4
33330, 옥천군,010003, 7세,2017,352,188,164,114.6,352,188,164,114.6
33330, 옥천군,010004, 8세,2017,342,174,168,103.6,342,174,168,103.6
33330, 옥천군,010005, 9세,2017,376,185,191,96.9,376,185,191,96.9
33330, 옥천군,015,10~14세,2017,1831,963,868,110.9,1829,961,868,110.7
33330, 옥천군,015001, 10세,2017,370,187,183,102.2,370,187,183,102.2
33330, 옥천군,015002, 11세,2017,369,199,170,117.1,367,197,170,115.9
33330, 옥천군,015003, 12세,2017,356,187,169,110.7,356,187,169,110.7
33330, 옥천군,015004, 13세,2017,367,192,175,109.7,367,192,175,109.7
33330, 옥천군,015005, 14세,2017,369,198,171,115.8,369,198,171,115.8
33330, 옥천군,020,15~19세,2017,2354,1268,1086,116.8,2350,1267,1083,117
33330, 옥천군,020001, 15세,2017,395,204,191,106.8,394,204,190,107.4
33330, 옥천군,020002, 16세,2017,526,277,249,111.2,524,276,248,111.3
33330, 옥천군,020003, 17세,2017,501,256,245,104.5,501,256,245,104.5
33330, 옥천군,020004, 18세,2017,496,272,224,121.4,495,272,223,122
33330, 옥천군,020005, 19세,2017,436,259,177,146.3,436,259,177,146.3
33330, 옥천군,025,20~24세,2017,2444,1471,973,151.2,2362,1430,932,153.4
33330, 옥천군,025001, 20세,2017,538,325,213,152.6,533,322,211,152.6
33330, 옥천군,025002, 21세,2017,498,310,188,164.9,486,302,184,164.1
33330, 옥천군,025003, 22세,2017,509,311,198,157.1,489,304,185,164.3
33330, 옥천군,025004, 23세,2017,468,275,193,142.5,443,261,182,143.4
33330, 옥천군,025005, 24세,2017,431,250,181,138.1,411,241,170,141.8
33330, 옥천군,030,25~29세,2017,2023,1123,900,124.8,1839,1011,828,122.1
33330, 옥천군,030001, 25세,2017,457,238,219,108.7,414,213,201,106
33330, 옥천군,030002, 26세,2017,412,241,171,140.9,387,228,159,143.4
33330, 옥천군,030003, 27세,2017,430,244,186,131.2,379,214,165,129.7
33330, 옥천군,030004, 28세,2017,350,198,152,130.3,326,182,144,126.4
33330, 옥천군,030005, 29세,2017,374,202,172,117.4,333,174,159,109.4
33330, 옥천군,035,30~34세,2017,1971,1086,885,122.7,1814,974,840,116
33330, 옥천군,035001, 30세,2017,343,192,151,127.2,310,170,140,121.4
33330, 옥천군,035002, 31세,2017,393,227,166,136.7,352,195,157,124.2
33330, 옥천군,035003, 32세,2017,371,202,169,119.5,343,183,160,114.4
33330, 옥천군,035004, 33세,2017,435,227,208,109.1,406,206,200,103
33330, 옥천군,035005, 34세,2017,429,238,191,124.6,403,220,183,120.2
33330, 옥천군,040,35~39세,2017,2731,1467,1264,116.1,2610,1387,1223,113.4
33330, 옥천군,040001, 35세,2017,561,293,268,109.3,524,271,253,107.1
33330, 옥천군,040002, 36세,2017,543,297,246,120.7,518,279,239,116.7
33330, 옥천군,040003, 37세,2017,562,293,269,108.9,537,275,262,105
33330, 옥천군,040004, 38세,2017,525,301,224,134.4,507,289,218,132.6
33330, 옥천군,040005, 39세,2017,540,283,257,110.1,524,273,251,108.8
33330, 옥천군,045,40~44세,2017,3008,1648,1360,121.2,2928,1597,1331,120
33330, 옥천군,045001, 40세,2017,540,305,235,129.8,521,291,230,126.5
33330, 옥천군,045002, 41세,2017,531,288,243,118.5,511,275,236,116.5
33330, 옥천군,045003, 42세,2017,587,322,265,121.5,574,313,261,119.9
33330, 옥천군,045004, 43세,2017,659,350,309,113.3,649,345,304,113.5
33330, 옥천군,045005, 44세,2017,691,383,308,124.4,673,373,300,124.3
33330, 옥천군,050,45~49세,2017,3640,1958,1682,116.4,3570,1930,1640,117.7
33330, 옥천군,050001, 45세,2017,610,338,272,124.3,596,333,263,126.6
33330, 옥천군,050002, 46세,2017,709,378,331,114.2,695,370,325,113.8
33330, 옥천군,050003, 47세,2017,674,387,287,134.8,663,384,279,137.6
33330, 옥천군,050004, 48세,2017,827,429,398,107.8,814,424,390,108.7
33330, 옥천군,050005, 49세,2017,820,426,394,108.1,802,419,383,109.4
33330, 옥천군,055,50~54세,2017,3856,2007,1849,108.5,3784,1970,1814,108.6
33330, 옥천군,055001, 50세,2017,741,379,362,104.7,726,371,355,104.5
33330, 옥천군,055002, 51세,2017,739,388,351,110.5,727,382,345,110.7
33330, 옥천군,055003, 52세,2017,795,412,383,107.6,783,405,378,107.1
33330, 옥천군,055004, 53세,2017,746,388,358,108.4,732,381,351,108.5
33330, 옥천군,055005, 54세,2017,835,440,395,111.4,816,431,385,111.9
33330, 옥천군,060,55~59세,2017,4944,2520,2424,104,4899,2495,2404,103.8
33330, 옥천군,060001, 55세,2017,962,521,441,118.1,953,514,439,117.1
33330, 옥천군,060002, 56세,2017,1105,547,558,98,1096,544,552,98.6
33330, 옥천군,060003, 57세,2017,1047,508,539,94.2,1034,502,532,94.4
33330, 옥천군,060004, 58세,2017,930,483,447,108.1,923,479,444,107.9
33330, 옥천군,060005, 59세,2017,900,461,439,105,893,456,437,104.3
33330, 옥천군,065,60~64세,2017,4600,2300,2300,100,4566,2280,2286,99.7
33330, 옥천군,065001, 60세,2017,1050,541,509,106.3,1044,538,506,106.3
33330, 옥천군,065002, 61세,2017,950,474,476,99.6,941,469,472,99.4
33330, 옥천군,065003, 62세,2017,943,452,491,92.1,933,446,487,91.6
33330, 옥천군,065004, 63세,2017,892,453,439,103.2,884,447,437,102.3
33330, 옥천군,065005, 64세,2017,765,380,385,98.7,764,380,384,99
33330, 옥천군,070,65~69세,2017,3684,1859,1825,101.9,3656,1847,1809,102.1
33330, 옥천군,070001, 65세,2017,892,431,461,93.5,881,427,454,94.1
33330, 옥천군,070002, 66세,2017,658,317,341,93,654,315,339,92.9
33330, 옥천군,070003, 67세,2017,765,416,349,119.2,759,413,346,119.4
33330, 옥천군,070004, 68세,2017,721,373,348,107.2,718,371,347,106.9
33330, 옥천군,070005, 69세,2017,648,322,326,98.8,644,321,323,99.4
33330, 옥천군,075,70~74세,2017,2828,1265,1563,80.9,2817,1260,1557,80.9
33330, 옥천군,075001, 70세,2017,650,300,350,85.7,646,298,348,85.6
33330, 옥천군,075002, 71세,2017,492,230,262,87.8,492,230,262,87.8
33330, 옥천군,075003, 72세,2017,506,242,264,91.7,502,241,261,92.3
33330, 옥천군,075004, 73세,2017,555,231,324,71.3,552,229,323,70.9
33330, 옥천군,075005, 74세,2017,625,262,363,72.2,625,262,363,72.2
33330, 옥천군,080,75~79세,2017,3130,1261,1869,67.5,3127,1260,1867,67.5
33330, 옥천군,080001, 75세,2017,872,364,508,71.7,872,364,508,71.7
33330, 옥천군,080002, 76세,2017,614,255,359,71,612,255,357,71.4
33330, 옥천군,080003, 77세,2017,516,211,305,69.2,515,210,305,68.9
33330, 옥천군,080004, 78세,2017,598,228,370,61.6,598,228,370,61.6
33330, 옥천군,080005, 79세,2017,530,203,327,62.1,530,203,327,62.1
33330, 옥천군,085,80~84세,2017,2309,820,1489,55.1,2306,819,1487,55.1
33330, 옥천군,085001, 80세,2017,494,212,282,75.2,493,211,282,74.8
33330, 옥천군,085002, 81세,2017,504,178,326,54.6,504,178,326,54.6
33330, 옥천군,085003, 82세,2017,519,177,342,51.8,519,177,342,51.8
33330, 옥천군,085004, 83세,2017,406,135,271,49.8,406,135,271,49.8
33330, 옥천군,085005, 84세,2017,386,118,268,44,384,118,266,44.4
33330, 옥천군,090,85~89세,2017,1020,289,731,39.5,1020,289,731,39.5
33330, 옥천군,090001, 85세,2017,281,91,190,47.9,281,91,190,47.9
33330, 옥천군,090002, 86세,2017,210,51,159,32.1,210,51,159,32.1
33330, 옥천군,090003, 87세,2017,216,61,155,39.4,216,61,155,39.4
33330, 옥천군,090004, 88세,2017,169,49,120,40.8,169,49,120,40.8
33330, 옥천군,090005, 89세,2017,144,37,107,34.6,144,37,107,34.6
33330, 옥천군,095,90~94세,2017,335,76,259,29.3,334,76,258,29.5
33330, 옥천군,095001, 90세,2017,120,27,93,29,120,27,93,29
33330, 옥천군,095002, 91세,2017,62,18,44,40.9,61,18,43,41.9
33330, 옥천군,095003, 92세,2017,62,16,46,34.8,62,16,46,34.8
33330, 옥천군,095004, 93세,2017,44,11,33,33.3,44,11,33,33.3
33330, 옥천군,095005, 94세,2017,47,X,43,9.3,47,X,43,9.3
33330, 옥천군,100,95~99세,2017,74,14,60,23.3,74,14,60,23.3
33330, 옥천군,100001, 95세,2017,29,X,25,16,29,X,25,16
33330, 옥천군,100002, 96세,2017,18,5,13,38.5,18,5,13,38.5
33330, 옥천군,100003, 97세,2017,15,5,10,50,15,5,10,50
33330, 옥천군,100004, 98세,2017,6,X,6,0,6,X,6,0
33330, 옥천군,100005, 99세,2017,6,X,6,0,6,X,6,0
33330, 옥천군,101,100세이상,2017,8,X,8,0,8,X,8,0
33330, 옥천군,102,15세미만,2017,4939,2555,2384,107.2,4934,2551,2383,107
33330, 옥천군,103,15~64세,2017,31571,16848,14723,114.4,30722,16341,14381,113.6
33330, 옥천군,104,65세이상,2017,13388,5584,7804,71.6,13342,5565,7777,71.6
33330, 옥천군,086,85세이상,2017,1437,379,1058,35.8,1436,379,1057,35.9
33330, 옥천군,126,평균연령,2017,49,46.8,51.2,,49.2,47,51.4,
33330, 옥천군,127,중위연령,2017,52.5,49.8,55.2,,52.8,50.2,55.4,
33340, 영동군,000,합계,2017,49034,24410,24624,99.1,48335,24069,24266,99.2
33340, 영동군,005,0~4세,2017,1270,645,625,103.2,1268,643,625,102.9
33340, 영동군,005001, 0세,2017,264,123,141,87.2,264,123,141,87.2
33340, 영동군,005002, 1세,2017,237,130,107,121.5,237,130,107,121.5
33340, 영동군,005003, 2세,2017,251,131,120,109.2,249,129,120,107.5
33340, 영동군,005004, 3세,2017,275,135,140,96.4,275,135,140,96.4
33340, 영동군,005005, 4세,2017,243,126,117,107.7,243,126,117,107.7
33340, 영동군,010,5~9세,2017,1454,771,683,112.9,1451,769,682,112.8
33340, 영동군,010001, 5세,2017,291,137,154,89,290,137,153,89.5
33340, 영동군,010002, 6세,2017,307,168,139,120.9,307,168,139,120.9
33340, 영동군,010003, 7세,2017,312,173,139,124.5,311,172,139,123.7
33340, 영동군,010004, 8세,2017,270,144,126,114.3,270,144,126,114.3
33340, 영동군,010005, 9세,2017,274,149,125,119.2,273,148,125,118.4
33340, 영동군,015,10~14세,2017,1598,808,790,102.3,1596,808,788,102.5
33340, 영동군,015001, 10세,2017,330,181,149,121.5,330,181,149,121.5
33340, 영동군,015002, 11세,2017,298,149,149,100,297,149,148,100.7
33340, 영동군,015003, 12세,2017,288,154,134,114.9,288,154,134,114.9
33340, 영동군,015004, 13세,2017,342,156,186,83.9,342,156,186,83.9
33340, 영동군,015005, 14세,2017,340,168,172,97.7,339,168,171,98.2
33340, 영동군,020,15~19세,2017,2563,1361,1202,113.2,2550,1356,1194,113.6
33340, 영동군,020001, 15세,2017,373,191,182,104.9,373,191,182,104.9
33340, 영동군,020002, 16세,2017,438,227,211,107.6,436,225,211,106.6
33340, 영동군,020003, 17세,2017,486,255,231,110.4,486,255,231,110.4
33340, 영동군,020004, 18세,2017,561,285,276,103.3,558,285,273,104.4
33340, 영동군,020005, 19세,2017,705,403,302,133.4,697,400,297,134.7
33340, 영동군,025,20~24세,2017,3477,2015,1462,137.8,3405,1987,1418,140.1
33340, 영동군,025001, 20세,2017,710,366,344,106.4,703,366,337,108.6
33340, 영동군,025002, 21세,2017,692,349,343,101.7,682,344,338,101.8
33340, 영동군,025003, 22세,2017,743,395,348,113.5,730,389,341,114.1
33340, 영동군,025004, 23세,2017,696,475,221,214.9,683,468,215,217.7
33340, 영동군,025005, 24세,2017,636,430,206,208.7,607,420,187,224.6
33340, 영동군,030,25~29세,2017,2087,1248,839,148.7,1952,1172,780,150.3
33340, 영동군,030001, 25세,2017,520,333,187,178.1,492,315,177,178
33340, 영동군,030002, 26세,2017,434,271,163,166.3,401,254,147,172.8
33340, 영동군,030003, 27세,2017,395,231,164,140.9,374,216,158,136.7
33340, 영동군,030004, 28세,2017,381,211,170,124.1,356,201,155,129.7
33340, 영동군,030005, 29세,2017,357,202,155,130.3,329,186,143,130.1
33340, 영동군,035,30~34세,2017,1843,985,858,114.8,1726,921,805,114.4
33340, 영동군,035001, 30세,2017,359,177,182,97.3,321,156,165,94.5
33340, 영동군,035002, 31세,2017,378,224,154,145.5,353,208,145,143.4
33340, 영동군,035003, 32세,2017,354,198,156,126.9,334,188,146,128.8
33340, 영동군,035004, 33세,2017,355,195,160,121.9,331,182,149,122.1
33340, 영동군,035005, 34세,2017,397,191,206,92.7,387,187,200,93.5
33340, 영동군,040,35~39세,2017,2212,1137,1075,105.8,2132,1092,1040,105
33340, 영동군,040001, 35세,2017,430,216,214,100.9,415,208,207,100.5
33340, 영동군,040002, 36세,2017,426,225,201,111.9,407,215,192,112
33340, 영동군,040003, 37세,2017,450,231,219,105.5,438,225,213,105.6
33340, 영동군,040004, 38세,2017,456,224,232,96.6,437,216,221,97.7
33340, 영동군,040005, 39세,2017,450,241,209,115.3,435,228,207,110.1
33340, 영동군,045,40~44세,2017,2654,1473,1181,124.7,2598,1448,1150,125.9
33340, 영동군,045001, 40세,2017,414,230,184,125,406,225,181,124.3
33340, 영동군,045002, 41세,2017,468,262,206,127.2,453,257,196,131.1
33340, 영동군,045003, 42세,2017,524,291,233,124.9,516,289,227,127.3
33340, 영동군,045004, 43세,2017,603,337,266,126.7,592,330,262,126
33340, 영동군,045005, 44세,2017,645,353,292,120.9,631,347,284,122.2
33340, 영동군,050,45~49세,2017,3388,1831,1557,117.6,3334,1809,1525,118.6
33340, 영동군,050001, 45세,2017,566,295,271,108.9,554,291,263,110.6
33340, 영동군,050002, 46세,2017,630,346,284,121.8,622,343,279,122.9
33340, 영동군,050003, 47세,2017,699,382,317,120.5,684,375,309,121.4
33340, 영동군,050004, 48세,2017,728,396,332,119.3,724,393,331,118.7
33340, 영동군,050005, 49세,2017,765,412,353,116.7,750,407,343,118.7
33340, 영동군,055,50~54세,2017,3721,1954,1767,110.6,3671,1935,1736,111.5
33340, 영동군,055001, 50세,2017,725,381,344,110.8,719,381,338,112.7
33340, 영동군,055002, 51세,2017,760,406,354,114.7,750,404,346,116.8
33340, 영동군,055003, 52세,2017,800,434,366,118.6,791,429,362,118.5
33340, 영동군,055004, 53세,2017,700,354,346,102.3,680,346,334,103.6
33340, 영동군,055005, 54세,2017,736,379,357,106.2,731,375,356,105.3
33340, 영동군,060,55~59세,2017,4863,2478,2385,103.9,4818,2460,2358,104.3
33340, 영동군,060001, 55세,2017,926,466,460,101.3,918,463,455,101.8
33340, 영동군,060002, 56세,2017,1070,546,524,104.2,1062,543,519,104.6
33340, 영동군,060003, 57세,2017,990,483,507,95.3,977,477,500,95.4
33340, 영동군,060004, 58세,2017,938,465,473,98.3,933,463,470,98.5
33340, 영동군,060005, 59세,2017,939,518,421,123,928,514,414,124.2
33340, 영동군,065,60~64세,2017,4273,2175,2098,103.7,4238,2159,2079,103.8
33340, 영동군,065001, 60세,2017,986,502,484,103.7,977,498,479,104
33340, 영동군,065002, 61세,2017,867,417,450,92.7,854,411,443,92.8
33340, 영동군,065003, 62세,2017,909,478,431,110.9,907,477,430,110.9
33340, 영동군,065004, 63세,2017,791,408,383,106.5,788,406,382,106.3
33340, 영동군,065005, 64세,2017,720,370,350,105.7,712,367,345,106.4
33340, 영동군,070,65~69세,2017,3530,1643,1887,87.1,3508,1632,1876,87
33340, 영동군,070001, 65세,2017,786,365,421,86.7,778,361,417,86.6
33340, 영동군,070002, 66세,2017,632,292,340,85.9,631,291,340,85.6
33340, 영동군,070003, 67세,2017,671,310,361,85.9,666,309,357,86.6
33340, 영동군,070004, 68세,2017,761,351,410,85.6,756,347,409,84.8
33340, 영동군,070005, 69세,2017,680,325,355,91.5,677,324,353,91.8
33340, 영동군,075,70~74세,2017,2991,1321,1670,79.1,2986,1317,1669,78.9
33340, 영동군,075001, 70세,2017,602,298,304,98,602,298,304,98
33340, 영동군,075002, 71세,2017,535,244,291,83.8,534,243,291,83.5
33340, 영동군,075003, 72세,2017,540,247,293,84.3,537,245,292,83.9
33340, 영동군,075004, 73세,2017,596,232,364,63.7,596,232,364,63.7
33340, 영동군,075005, 74세,2017,718,300,418,71.8,717,299,418,71.5
33340, 영동군,080,75~79세,2017,3361,1368,1993,68.6,3357,1365,1992,68.5
33340, 영동군,080001, 75세,2017,844,353,491,71.9,843,352,491,71.7
33340, 영동군,080002, 76세,2017,659,271,388,69.8,658,270,388,69.6
33340, 영동군,080003, 77세,2017,599,247,352,70.2,598,246,352,69.9
33340, 영동군,080004, 78세,2017,670,267,403,66.3,669,267,402,66.4
33340, 영동군,080005, 79세,2017,589,230,359,64.1,589,230,359,64.1
33340, 영동군,085,80~84세,2017,2315,798,1517,52.6,2313,797,1516,52.6
33340, 영동군,085001, 80세,2017,571,195,376,51.9,570,195,375,52
33340, 영동군,085002, 81세,2017,531,184,347,53,531,184,347,53
33340, 영동군,085003, 82세,2017,487,184,303,60.7,487,184,303,60.7
33340, 영동군,085004, 83세,2017,389,134,255,52.5,389,134,255,52.5
33340, 영동군,085005, 84세,2017,337,101,236,42.8,336,100,236,42.4
33340, 영동군,090,85~89세,2017,989,283,706,40.1,987,283,704,40.2
33340, 영동군,090001, 85세,2017,290,105,185,56.8,290,105,185,56.8
33340, 영동군,090002, 86세,2017,218,56,162,34.6,216,56,160,35
33340, 영동군,090003, 87세,2017,176,42,134,31.3,176,42,134,31.3
33340, 영동군,090004, 88세,2017,168,41,127,32.3,168,41,127,32.3
33340, 영동군,090005, 89세,2017,137,39,98,39.8,137,39,98,39.8
33340, 영동군,095,90~94세,2017,358,101,257,39.3,358,101,257,39.3
33340, 영동군,095001, 90세,2017,142,39,103,37.9,142,39,103,37.9
33340, 영동군,095002, 91세,2017,77,19,58,32.8,77,19,58,32.8
33340, 영동군,095003, 92세,2017,65,19,46,41.3,65,19,46,41.3
33340, 영동군,095004, 93세,2017,37,17,20,85,37,17,20,85
33340, 영동군,095005, 94세,2017,37,7,30,23.3,37,7,30,23.3
33340, 영동군,100,95~99세,2017,85,15,70,21.4,85,15,70,21.4
33340, 영동군,100001, 95세,2017,37,7,30,23.3,37,7,30,23.3
33340, 영동군,100002, 96세,2017,17,X,16,6.3,17,X,16,6.3
33340, 영동군,100003, 97세,2017,19,X,16,18.8,19,X,16,18.8
33340, 영동군,100004, 98세,2017,8,X,5,60,8,X,5,60
33340, 영동군,100005, 99세,2017,X,X,X,33.3,X,X,X,33.3
33340, 영동군,101,100세이상,2017,X,X,X,0,X,X,X,0
33340, 영동군,102,15세미만,2017,4322,2224,2098,106,4315,2220,2095,106
33340, 영동군,103,15~64세,2017,31081,16657,14424,115.5,30424,16339,14085,116
33340, 영동군,104,65세이상,2017,13631,5529,8102,68.2,13596,5510,8086,68.1
33340, 영동군,086,85세이상,2017,1434,399,1035,38.6,1432,399,1033,38.6
33340, 영동군,126,평균연령,2017,49.1,46.7,51.4,,49.2,46.8,51.6,
33340, 영동군,127,중위연령,2017,52.6,49.8,55.6,,52.9,50.1,55.9,
33350, 진천군,000,합계,2017,79186,42564,36622,116.2,71417,37079,34338,108
33350, 진천군,005,0~4세,2017,3413,1744,1669,104.5,3301,1684,1617,104.1
33350, 진천군,005001, 0세,2017,592,301,291,103.4,565,286,279,102.5
33350, 진천군,005002, 1세,2017,696,358,338,105.9,668,341,327,104.3
33350, 진천군,005003, 2세,2017,722,370,352,105.1,705,360,345,104.3
33350, 진천군,005004, 3세,2017,664,341,323,105.6,645,333,312,106.7
33350, 진천군,005005, 4세,2017,739,374,365,102.5,718,364,354,102.8
33350, 진천군,010,5~9세,2017,3770,1935,1835,105.4,3700,1902,1798,105.8
33350, 진천군,010001, 5세,2017,761,391,370,105.7,748,387,361,107.2
33350, 진천군,010002, 6세,2017,809,407,402,101.2,795,403,392,102.8
33350, 진천군,010003, 7세,2017,734,372,362,102.8,721,365,356,102.5
33350, 진천군,010004, 8세,2017,713,368,345,106.7,698,360,338,106.5
33350, 진천군,010005, 9세,2017,753,397,356,111.5,738,387,351,110.3
33350, 진천군,015,10~14세,2017,3378,1815,1563,116.1,3336,1791,1545,115.9
33350, 진천군,015001, 10세,2017,752,385,367,104.9,745,381,364,104.7
33350, 진천군,015002, 11세,2017,634,336,298,112.8,623,328,295,111.2
33350, 진천군,015003, 12세,2017,618,332,286,116.1,608,326,282,115.6
33350, 진천군,015004, 13세,2017,718,404,314,128.7,710,401,309,129.8
33350, 진천군,015005, 14세,2017,656,358,298,120.1,650,355,295,120.3
33350, 진천군,020,15~19세,2017,4292,2276,2016,112.9,4231,2236,1995,112.1
33350, 진천군,020001, 15세,2017,714,331,383,86.4,707,329,378,87
33350, 진천군,020002, 16세,2017,864,423,441,95.9,854,417,437,95.4
33350, 진천군,020003, 17세,2017,990,523,467,112,975,511,464,110.1
33350, 진천군,020004, 18세,2017,834,474,360,131.7,819,464,355,130.7
33350, 진천군,020005, 19세,2017,890,525,365,143.8,876,515,361,142.7
33350, 진천군,025,20~24세,2017,4536,2719,1817,149.6,3929,2260,1669,135.4
33350, 진천군,025001, 20세,2017,914,516,398,129.6,874,494,380,130
33350, 진천군,025002, 21세,2017,914,550,364,151.1,820,477,343,139.1
33350, 진천군,025003, 22세,2017,903,563,340,165.6,775,463,312,148.4
33350, 진천군,025004, 23세,2017,871,529,342,154.7,719,415,304,136.5
33350, 진천군,025005, 24세,2017,934,561,373,150.4,741,411,330,124.5
33350, 진천군,030,25~29세,2017,4935,3103,1832,169.4,3546,2041,1505,135.6
33350, 진천군,030001, 25세,2017,972,608,364,167,745,430,315,136.5
33350, 진천군,030002, 26세,2017,918,572,346,165.3,686,392,294,133.3
33350, 진천군,030003, 27세,2017,1024,660,364,181.3,724,428,296,144.6
33350, 진천군,030004, 28세,2017,989,636,353,180.2,674,392,282,139
33350, 진천군,030005, 29세,2017,1032,627,405,154.8,717,399,318,125.5
33350, 진천군,035,30~34세,2017,5885,3567,2318,153.9,4415,2446,1969,124.2
33350, 진천군,035001, 30세,2017,1050,635,415,153,731,393,338,116.3
33350, 진천군,035002, 31세,2017,1179,738,441,167.3,865,502,363,138.3
33350, 진천군,035003, 32세,2017,1121,681,440,154.8,824,454,370,122.7
33350, 진천군,035004, 33세,2017,1190,727,463,157,900,506,394,128.4
33350, 진천군,035005, 34세,2017,1345,786,559,140.6,1095,591,504,117.3
33350, 진천군,040,35~39세,2017,6788,3897,2891,134.8,5730,3079,2651,116.1
33350, 진천군,040001, 35세,2017,1439,859,580,148.1,1179,664,515,128.9
33350, 진천군,040002, 36세,2017,1355,774,581,133.2,1133,603,530,113.8
33350, 진천군,040003, 37세,2017,1431,782,649,120.5,1237,627,610,102.8
33350, 진천군,040004, 38세,2017,1298,762,536,142.2,1088,597,491,121.6
33350, 진천군,040005, 39세,2017,1265,720,545,132.1,1093,588,505,116.4
33350, 진천군,045,40~44세,2017,6255,3522,2733,128.9,5503,3015,2488,121.2
33350, 진천군,045001, 40세,2017,1219,681,538,126.6,1046,557,489,113.9
33350, 진천군,045002, 41세,2017,1265,738,527,140,1103,619,484,127.9
33350, 진천군,045003, 42세,2017,1238,680,558,121.9,1086,574,512,112.1
33350, 진천군,045004, 43세,2017,1253,699,554,126.2,1129,626,503,124.5
33350, 진천군,045005, 44세,2017,1280,724,556,130.2,1139,639,500,127.8
33350, 진천군,050,45~49세,2017,6515,3599,2916,123.4,5800,3147,2653,118.6
33350, 진천군,050001, 45세,2017,1175,659,516,127.7,1043,571,472,121
33350, 진천군,050002, 46세,2017,1335,739,596,124,1184,646,538,120.1
33350, 진천군,050003, 47세,2017,1262,706,556,127,1117,613,504,121.6
33350, 진천군,050004, 48세,2017,1389,759,630,120.5,1259,679,580,117.1
33350, 진천군,050005, 49세,2017,1354,736,618,119.1,1197,638,559,114.1
33350, 진천군,055,50~54세,2017,6257,3483,2774,125.6,5614,3077,2537,121.3
33350, 진천군,055001, 50세,2017,1258,701,557,125.9,1148,636,512,124.2
33350, 진천군,055002, 51세,2017,1286,726,560,129.6,1156,652,504,129.4
33350, 진천군,055003, 52세,2017,1313,735,578,127.2,1188,650,538,120.8
33350, 진천군,055004, 53세,2017,1183,641,542,118.3,1061,560,501,111.8
33350, 진천군,055005, 54세,2017,1217,680,537,126.6,1061,579,482,120.1
33350, 진천군,060,55~59세,2017,6467,3478,2989,116.4,6039,3208,2831,113.3
33350, 진천군,060001, 55세,2017,1365,751,614,122.3,1268,687,581,118.2
33350, 진천군,060002, 56세,2017,1526,800,726,110.2,1457,758,699,108.4
33350, 진천군,060003, 57세,2017,1266,683,583,117.2,1166,627,539,116.3
33350, 진천군,060004, 58세,2017,1192,640,552,115.9,1110,587,523,112.2
33350, 진천군,060005, 59세,2017,1118,604,514,117.5,1038,549,489,112.3
33350, 진천군,065,60~64세,2017,4922,2500,2422,103.2,4663,2346,2317,101.3
33350, 진천군,065001, 60세,2017,1120,587,533,110.1,1045,539,506,106.5
33350, 진천군,065002, 61세,2017,1034,544,490,111,979,508,471,107.9
33350, 진천군,065003, 62세,2017,1009,503,506,99.4,963,482,481,100.2
33350, 진천군,065004, 63세,2017,935,450,485,92.8,890,429,461,93.1
33350, 진천군,065005, 64세,2017,824,416,408,102,786,388,398,97.5
33350, 진천군,070,65~69세,2017,3279,1635,1644,99.5,3178,1581,1597,99
33350, 진천군,070001, 65세,2017,864,418,446,93.7,831,402,429,93.7
33350, 진천군,070002, 66세,2017,554,276,278,99.3,535,262,273,96
33350, 진천군,070003, 67세,2017,590,282,308,91.6,573,273,300,91
33350, 진천군,070004, 68세,2017,642,346,296,116.9,622,334,288,116
33350, 진천군,070005, 69세,2017,629,313,316,99.1,617,310,307,101
33350, 진천군,075,70~74세,2017,2614,1192,1422,83.8,2583,1175,1408,83.5
33350, 진천군,075001, 70세,2017,577,281,296,94.9,569,275,294,93.5
33350, 진천군,075002, 71세,2017,478,243,235,103.4,472,239,233,102.6
33350, 진천군,075003, 72세,2017,530,234,296,79.1,527,233,294,79.3
33350, 진천군,075004, 73세,2017,499,210,289,72.7,491,208,283,73.5
33350, 진천군,075005, 74세,2017,530,224,306,73.2,524,220,304,72.4
33350, 진천군,080,75~79세,2017,2766,1160,1606,72.2,2747,1154,1593,72.4
33350, 진천군,080001, 75세,2017,656,288,368,78.3,652,285,367,77.7
33350, 진천군,080002, 76세,2017,513,215,298,72.1,509,213,296,72
33350, 진천군,080003, 77세,2017,532,231,301,76.7,529,231,298,77.5
33350, 진천군,080004, 78세,2017,564,209,355,58.9,560,208,352,59.1
33350, 진천군,080005, 79세,2017,501,217,284,76.4,497,217,280,77.5
33350, 진천군,085,80~84세,2017,2012,683,1329,51.4,2004,682,1322,51.6
33350, 진천군,085001, 80세,2017,483,188,295,63.7,481,188,293,64.2
33350, 진천군,085002, 81세,2017,451,162,289,56.1,450,162,288,56.3
33350, 진천군,085003, 82세,2017,426,123,303,40.6,424,122,302,40.4
33350, 진천군,085004, 83세,2017,357,119,238,50,356,119,237,50.2
33350, 진천군,085005, 84세,2017,295,91,204,44.6,293,91,202,45
33350, 진천군,090,85~89세,2017,784,199,585,34,782,198,584,33.9
33350, 진천군,090001, 85세,2017,207,66,141,46.8,205,65,140,46.4
33350, 진천군,090002, 86세,2017,171,38,133,28.6,171,38,133,28.6
33350, 진천군,090003, 87세,2017,149,32,117,27.4,149,32,117,27.4
33350, 진천군,090004, 88세,2017,128,39,89,43.8,128,39,89,43.8
33350, 진천군,090005, 89세,2017,129,24,105,22.9,129,24,105,22.9
33350, 진천군,095,90~94세,2017,256,42,214,19.6,254,42,212,19.8
33350, 진천군,095001, 90세,2017,83,17,66,25.8,81,17,64,26.6
33350, 진천군,095002, 91세,2017,59,11,48,22.9,59,11,48,22.9
33350, 진천군,095003, 92세,2017,43,X,40,7.5,43,X,40,7.5
33350, 진천군,095004, 93세,2017,34,5,29,17.2,34,5,29,17.2
33350, 진천군,095005, 94세,2017,37,6,31,19.4,37,6,31,19.4
33350, 진천군,100,95~99세,2017,60,15,45,33.3,60,15,45,33.3
33350, 진천군,100001, 95세,2017,23,5,18,27.8,23,5,18,27.8
33350, 진천군,100002, 96세,2017,19,5,14,35.7,19,5,14,35.7
33350, 진천군,100003, 97세,2017,6,X,X,50,6,X,X,50
33350, 진천군,100004, 98세,2017,10,X,8,25,10,X,8,25
33350, 진천군,100005, 99세,2017,X,X,X,100,X,X,X,100
33350, 진천군,101,100세이상,2017,X,X,X,0,X,X,X,0
33350, 진천군,102,15세미만,2017,10561,5494,5067,108.4,10337,5377,4960,108.4
33350, 진천군,103,15~64세,2017,56852,32144,24708,130.1,49470,26855,22615,118.7
33350, 진천군,104,65세이상,2017,11773,4926,6847,71.9,11610,4847,6763,71.7
33350, 진천군,086,85세이상,2017,1102,256,846,30.3,1098,255,843,30.2
33350, 진천군,126,평균연령,2017,41.8,40.3,43.5,,42.2,40.8,43.8,
33350, 진천군,127,중위연령,2017,42.1,40.3,44.3,,43.3,41.9,44.9,
33360, 괴산군,000,합계,2017,38579,19826,18753,105.7,37592,19202,18390,104.4
33360, 괴산군,005,0~4세,2017,660,316,344,91.9,660,316,344,91.9
33360, 괴산군,005001, 0세,2017,129,59,70,84.3,129,59,70,84.3
33360, 괴산군,005002, 1세,2017,119,70,49,142.9,119,70,49,142.9
33360, 괴산군,005003, 2세,2017,125,55,70,78.6,125,55,70,78.6
33360, 괴산군,005004, 3세,2017,151,72,79,91.1,151,72,79,91.1
33360, 괴산군,005005, 4세,2017,136,60,76,78.9,136,60,76,78.9
33360, 괴산군,010,5~9세,2017,869,418,451,92.7,866,417,449,92.9
33360, 괴산군,010001, 5세,2017,174,91,83,109.6,174,91,83,109.6
33360, 괴산군,010002, 6세,2017,148,70,78,89.7,147,70,77,90.9
33360, 괴산군,010003, 7세,2017,184,98,86,114,183,97,86,112.8
33360, 괴산군,010004, 8세,2017,166,68,98,69.4,165,68,97,70.1
33360, 괴산군,010005, 9세,2017,197,91,106,85.8,197,91,106,85.8
33360, 괴산군,015,10~14세,2017,992,527,465,113.3,989,526,463,113.6
33360, 괴산군,015001, 10세,2017,204,99,105,94.3,203,99,104,95.2
33360, 괴산군,015002, 11세,2017,162,78,84,92.9,162,78,84,92.9
33360, 괴산군,015003, 12세,2017,171,82,89,92.1,169,81,88,92
33360, 괴산군,015004, 13세,2017,224,131,93,140.9,224,131,93,140.9
33360, 괴산군,015005, 14세,2017,231,137,94,145.7,231,137,94,145.7
33360, 괴산군,020,15~19세,2017,2049,1160,889,130.5,2042,1157,885,130.7
33360, 괴산군,020001, 15세,2017,225,118,107,110.3,225,118,107,110.3
33360, 괴산군,020002, 16세,2017,272,136,136,100,272,136,136,100
33360, 괴산군,020003, 17세,2017,298,150,148,101.4,296,149,147,101.4
33360, 괴산군,020004, 18세,2017,444,260,184,141.3,443,260,183,142.1
33360, 괴산군,020005, 19세,2017,810,496,314,158,806,494,312,158.3
33360, 괴산군,025,20~24세,2017,3167,1835,1332,137.8,3021,1746,1275,136.9
33360, 괴산군,025001, 20세,2017,716,325,391,83.1,702,319,383,83.3
33360, 괴산군,025002, 21세,2017,652,312,340,91.8,622,290,332,87.3
33360, 괴산군,025003, 22세,2017,714,409,305,134.1,676,387,289,133.9
33360, 괴산군,025004, 23세,2017,561,410,151,271.5,533,394,139,283.5
33360, 괴산군,025005, 24세,2017,524,379,145,261.4,488,356,132,269.7
33360, 괴산군,030,25~29세,2017,1552,947,605,156.5,1361,817,544,150.2
33360, 괴산군,030001, 25세,2017,384,251,133,188.7,344,224,120,186.7
33360, 괴산군,030002, 26세,2017,324,209,115,181.7,282,179,103,173.8
33360, 괴산군,030003, 27세,2017,312,180,132,136.4,276,155,121,128.1
33360, 괴산군,030004, 28세,2017,283,166,117,141.9,241,139,102,136.3
33360, 괴산군,030005, 29세,2017,249,141,108,130.6,218,120,98,122.4
33360, 괴산군,035,30~34세,2017,1363,800,563,142.1,1199,686,513,133.7
33360, 괴산군,035001, 30세,2017,256,146,110,132.7,225,126,99,127.3
33360, 괴산군,035002, 31세,2017,270,168,102,164.7,223,134,89,150.6
33360, 괴산군,035003, 32세,2017,255,152,103,147.6,223,132,91,145.1
33360, 괴산군,035004, 33세,2017,289,162,127,127.6,260,139,121,114.9
33360, 괴산군,035005, 34세,2017,293,172,121,142.1,268,155,113,137.2
33360, 괴산군,040,35~39세,2017,1509,852,657,129.7,1402,782,620,126.1
33360, 괴산군,040001, 35세,2017,298,177,121,146.3,275,160,115,139.1
33360, 괴산군,040002, 36세,2017,290,174,116,150,268,156,112,139.3
33360, 괴산군,040003, 37세,2017,315,177,138,128.3,290,163,127,128.3
33360, 괴산군,040004, 38세,2017,293,149,144,103.5,272,138,134,103
33360, 괴산군,040005, 39세,2017,313,175,138,126.8,297,165,132,125
33360, 괴산군,045,40~44세,2017,1725,1023,702,145.7,1643,972,671,144.9
33360, 괴산군,045001, 40세,2017,280,161,119,135.3,261,148,113,131
33360, 괴산군,045002, 41세,2017,309,174,135,128.9,297,167,130,128.5
33360, 괴산군,045003, 42세,2017,372,243,129,188.4,353,230,123,187
33360, 괴산군,045004, 43세,2017,372,214,158,135.4,356,206,150,137.3
33360, 괴산군,045005, 44세,2017,392,231,161,143.5,376,221,155,142.6
33360, 괴산군,050,45~49세,2017,2351,1348,1003,134.4,2290,1307,983,133
33360, 괴산군,050001, 45세,2017,383,239,144,166,371,234,137,170.8
33360, 괴산군,050002, 46세,2017,457,254,203,125.1,446,246,200,123
33360, 괴산군,050003, 47세,2017,439,268,171,156.7,426,259,167,155.1
33360, 괴산군,050004, 48세,2017,519,274,245,111.8,507,266,241,110.4
33360, 괴산군,050005, 49세,2017,553,313,240,130.4,540,302,238,126.9
33360, 괴산군,055,50~54세,2017,3013,1594,1419,112.3,2941,1562,1379,113.3
33360, 괴산군,055001, 50세,2017,552,298,254,117.3,535,291,244,119.3
33360, 괴산군,055002, 51세,2017,610,337,273,123.4,605,335,270,124.1
33360, 괴산군,055003, 52세,2017,611,324,287,112.9,592,314,278,112.9
33360, 괴산군,055004, 53세,2017,601,315,286,110.1,584,307,277,110.8
33360, 괴산군,055005, 54세,2017,639,320,319,100.3,625,315,310,101.6
33360, 괴산군,060,55~59세,2017,4201,2210,1991,111,4132,2168,1964,110.4
33360, 괴산군,060001, 55세,2017,746,380,366,103.8,735,373,362,103
33360, 괴산군,060002, 56세,2017,878,456,422,108.1,865,448,417,107.4
33360, 괴산군,060003, 57세,2017,868,471,397,118.6,850,462,388,119.1
33360, 괴산군,060004, 58세,2017,822,431,391,110.2,805,419,386,108.5
33360, 괴산군,060005, 59세,2017,887,472,415,113.7,877,466,411,113.4
33360, 괴산군,065,60~64세,2017,3848,1986,1862,106.7,3793,1952,1841,106
33360, 괴산군,065001, 60세,2017,778,420,358,117.3,766,411,355,115.8
33360, 괴산군,065002, 61세,2017,854,472,382,123.6,844,465,379,122.7
33360, 괴산군,065003, 62세,2017,804,400,404,99,792,394,398,99
33360, 괴산군,065004, 63세,2017,780,390,390,100,769,383,386,99.2
33360, 괴산군,065005, 64세,2017,632,304,328,92.7,622,299,323,92.6
33360, 괴산군,070,65~69세,2017,2916,1501,1415,106.1,2900,1489,1411,105.5
33360, 괴산군,070001, 65세,2017,698,361,337,107.1,694,358,336,106.5
33360, 괴산군,070002, 66세,2017,520,259,261,99.2,517,257,260,98.8
33360, 괴산군,070003, 67세,2017,556,284,272,104.4,553,281,272,103.3
33360, 괴산군,070004, 68세,2017,579,299,280,106.8,575,296,279,106.1
33360, 괴산군,070005, 69세,2017,563,298,265,112.5,561,297,264,112.5
33360, 괴산군,075,70~74세,2017,2562,1188,1374,86.5,2557,1185,1372,86.4
33360, 괴산군,075001, 70세,2017,588,301,287,104.9,588,301,287,104.9
33360, 괴산군,075002, 71세,2017,431,217,214,101.4,429,216,213,101.4
33360, 괴산군,075003, 72세,2017,543,257,286,89.9,540,255,285,89.5
33360, 괴산군,075004, 73세,2017,472,196,276,71,472,196,276,71
33360, 괴산군,075005, 74세,2017,528,217,311,69.8,528,217,311,69.8
33360, 괴산군,080,75~79세,2017,2815,1179,1636,72.1,2813,1179,1634,72.2
33360, 괴산군,080001, 75세,2017,644,265,379,69.9,643,265,378,70.1
33360, 괴산군,080002, 76세,2017,594,259,335,77.3,594,259,335,77.3
33360, 괴산군,080003, 77세,2017,536,222,314,70.7,535,222,313,70.9
33360, 괴산군,080004, 78세,2017,533,221,312,70.8,533,221,312,70.8
33360, 괴산군,080005, 79세,2017,508,212,296,71.6,508,212,296,71.6
33360, 괴산군,085,80~84세,2017,1867,646,1221,52.9,1864,645,1219,52.9
33360, 괴산군,085001, 80세,2017,448,165,283,58.3,447,164,283,58
33360, 괴산군,085002, 81세,2017,399,147,252,58.3,398,147,251,58.6
33360, 괴산군,085003, 82세,2017,385,138,247,55.9,384,138,246,56.1
33360, 괴산군,085004, 83세,2017,342,113,229,49.3,342,113,229,49.3
33360, 괴산군,085005, 84세,2017,293,83,210,39.5,293,83,210,39.5
33360, 괴산군,090,85~89세,2017,814,226,588,38.4,814,226,588,38.4
33360, 괴산군,090001, 85세,2017,233,78,155,50.3,233,78,155,50.3
33360, 괴산군,090002, 86세,2017,178,49,129,38,178,49,129,38
33360, 괴산군,090003, 87세,2017,158,39,119,32.8,158,39,119,32.8
33360, 괴산군,090004, 88세,2017,124,30,94,31.9,124,30,94,31.9
33360, 괴산군,090005, 89세,2017,121,30,91,33,121,30,91,33
33360, 괴산군,095,90~94세,2017,236,55,181,30.4,236,55,181,30.4
33360, 괴산군,095001, 90세,2017,70,17,53,32.1,70,17,53,32.1
33360, 괴산군,095002, 91세,2017,52,11,41,26.8,52,11,41,26.8
33360, 괴산군,095003, 92세,2017,50,11,39,28.2,50,11,39,28.2
33360, 괴산군,095004, 93세,2017,30,10,20,50,30,10,20,50
33360, 괴산군,095005, 94세,2017,34,6,28,21.4,34,6,28,21.4
33360, 괴산군,100,95~99세,2017,57,13,44,29.5,56,13,43,30.2
33360, 괴산군,100001, 95세,2017,25,9,16,56.3,25,9,16,56.3
33360, 괴산군,100002, 96세,2017,12,X,11,9.1,12,X,11,9.1
33360, 괴산군,100003, 97세,2017,9,X,9,0,8,X,8,0
33360, 괴산군,100004, 98세,2017,8,X,5,60,8,X,5,60
33360, 괴산군,100005, 99세,2017,X,X,X,0,X,X,X,0
33360, 괴산군,101,100세이상,2017,13,X,11,18.2,13,X,11,18.2
33360, 괴산군,102,15세미만,2017,2521,1261,1260,100.1,2515,1259,1256,100.2
33360, 괴산군,103,15~64세,2017,24778,13755,11023,124.8,23824,13149,10675,123.2
33360, 괴산군,104,65세이상,2017,11280,4810,6470,74.3,11253,4794,6459,74.2
33360, 괴산군,086,85세이상,2017,1120,296,824,35.9,1119,296,823,36
33360, 괴산군,126,평균연령,2017,50.6,48.3,53,,50.9,48.6,53.3,
33360, 괴산군,127,중위연령,2017,55.1,52.2,57.4,,55.5,52.8,57.7,
33370, 음성군,000,합계,2017,104509,57136,47373,120.6,92765,48654,44111,110.3
33370, 음성군,005,0~4세,2017,3790,1929,1861,103.7,3679,1872,1807,103.6
33370, 음성군,005001, 0세,2017,675,350,325,107.7,652,339,313,108.3
33370, 음성군,005002, 1세,2017,796,405,391,103.6,766,389,377,103.2
33370, 음성군,005003, 2세,2017,788,404,384,105.2,768,392,376,104.3
33370, 음성군,005004, 3세,2017,747,389,358,108.7,729,379,350,108.3
33370, 음성군,005005, 4세,2017,784,381,403,94.5,764,373,391,95.4
33370, 음성군,010,5~9세,2017,4124,2236,1888,118.4,4068,2205,1863,118.4
33370, 음성군,010001, 5세,2017,902,493,409,120.5,886,484,402,120.4
33370, 음성군,010002, 6세,2017,845,471,374,125.9,834,465,369,126
33370, 음성군,010003, 7세,2017,812,429,383,112,803,424,379,111.9
33370, 음성군,010004, 8세,2017,769,429,340,126.2,757,424,333,127.3
33370, 음성군,010005, 9세,2017,796,414,382,108.4,788,408,380,107.4
33370, 음성군,015,10~14세,2017,3944,2038,1906,106.9,3921,2027,1894,107
33370, 음성군,015001, 10세,2017,849,433,416,104.1,839,429,410,104.6
33370, 음성군,015002, 11세,2017,743,373,370,100.8,738,369,369,100
33370, 음성군,015003, 12세,2017,734,364,370,98.4,732,363,369,98.4
33370, 음성군,015004, 13세,2017,789,436,353,123.5,785,435,350,124.3
33370, 음성군,015005, 14세,2017,829,432,397,108.8,827,431,396,108.8
33370, 음성군,020,15~19세,2017,5147,2766,2381,116.2,5065,2713,2352,115.3
33370, 음성군,020001, 15세,2017,952,490,462,106.1,945,486,459,105.9
33370, 음성군,020002, 16세,2017,1011,534,477,111.9,1003,531,472,112.5
33370, 음성군,020003, 17세,2017,1023,540,483,111.8,1012,531,481,110.4
33370, 음성군,020004, 18세,2017,1103,616,487,126.5,1093,608,485,125.4
33370, 음성군,020005, 19세,2017,1058,586,472,124.2,1012,557,455,122.4
33370, 음성군,025,20~24세,2017,6563,3910,2653,147.4,5303,2922,2381,122.7
33370, 음성군,025001, 20세,2017,1285,663,622,106.6,1199,607,592,102.5
33370, 음성군,025002, 21세,2017,1269,716,553,129.5,1095,579,516,112.2
33370, 음성군,025003, 22세,2017,1349,837,512,163.5,1072,615,457,134.6
33370, 음성군,025004, 23세,2017,1295,789,506,155.9,956,529,427,123.9
33370, 음성군,025005, 24세,2017,1365,905,460,196.7,981,592,389,152.2
33370, 음성군,030,25~29세,2017,7056,4432,2624,168.9,4714,2689,2025,132.8
33370, 음성군,030001, 25세,2017,1440,899,541,166.2,1022,585,437,133.9
33370, 음성군,030002, 26세,2017,1408,880,528,166.7,947,536,411,130.4
33370, 음성군,030003, 27세,2017,1461,915,546,167.6,975,566,409,138.4
33370, 음성군,030004, 28세,2017,1369,886,483,183.4,877,507,370,137
33370, 음성군,030005, 29세,2017,1378,852,526,162,893,495,398,124.4
33370, 음성군,035,30~34세,2017,7061,4380,2681,163.4,5035,2806,2229,125.9
33370, 음성군,035001, 30세,2017,1408,907,501,181,913,523,390,134.1
33370, 음성군,035002, 31세,2017,1351,823,528,155.9,944,511,433,118
33370, 음성군,035003, 32세,2017,1419,889,530,167.7,988,542,446,121.5
33370, 음성군,035004, 33세,2017,1423,891,532,167.5,1063,615,448,137.3
33370, 음성군,035005, 34세,2017,1460,870,590,147.5,1127,615,512,120.1
33370, 음성군,040,35~39세,2017,7998,4693,3305,142,6415,3463,2952,117.3
33370, 음성군,040001, 35세,2017,1673,990,683,144.9,1306,701,605,115.9
33370, 음성군,040002, 36세,2017,1695,1021,674,151.5,1344,733,611,120
33370, 음성군,040003, 37세,2017,1613,931,682,136.5,1305,697,608,114.6
33370, 음성군,040004, 38세,2017,1605,947,658,143.9,1299,713,586,121.7
33370, 음성군,040005, 39세,2017,1412,804,608,132.2,1161,619,542,114.2
33370, 음성군,045,40~44세,2017,7875,4548,3327,136.7,6859,3825,3034,126.1
33370, 음성군,045001, 40세,2017,1521,923,598,154.3,1283,740,543,136.3
33370, 음성군,045002, 41세,2017,1480,843,637,132.3,1265,690,575,120
33370, 음성군,045003, 42세,2017,1543,902,641,140.7,1355,765,590,129.7
33370, 음성군,045004, 43세,2017,1646,919,727,126.4,1459,797,662,120.4
33370, 음성군,045005, 44세,2017,1685,961,724,132.7,1497,833,664,125.5
33370, 음성군,050,45~49세,2017,8801,5139,3662,140.3,7745,4440,3305,134.3
33370, 음성군,050001, 45세,2017,1575,923,652,141.6,1363,778,585,133
33370, 음성군,050002, 46세,2017,1735,1034,701,147.5,1526,890,636,139.9
33370, 음성군,050003, 47세,2017,1777,1043,734,142.1,1569,922,647,142.5
33370, 음성군,050004, 48세,2017,1856,1078,778,138.6,1642,930,712,130.6
33370, 음성군,050005, 49세,2017,1858,1061,797,133.1,1645,920,725,126.9
33370, 음성군,055,50~54세,2017,8578,4801,3777,127.1,7624,4171,3453,120.8
33370, 음성군,055001, 50세,2017,1687,919,768,119.7,1501,806,695,116
33370, 음성군,055002, 51세,2017,1721,973,748,130.1,1545,856,689,124.2
33370, 음성군,055003, 52세,2017,1828,1015,813,124.8,1639,880,759,115.9
33370, 음성군,055004, 53세,2017,1683,941,742,126.8,1485,812,673,120.7
33370, 음성군,055005, 54세,2017,1659,953,706,135,1454,817,637,128.3
33370, 음성군,060,55~59세,2017,9400,5130,4270,120.1,8828,4785,4043,118.4
33370, 음성군,060001, 55세,2017,1914,1046,868,120.5,1752,944,808,116.8
33370, 음성군,060002, 56세,2017,2028,1141,887,128.6,1928,1085,843,128.7
33370, 음성군,060003, 57세,2017,1901,1017,884,115,1791,955,836,114.2
33370, 음성군,060004, 58세,2017,1790,967,823,117.5,1694,909,785,115.8
33370, 음성군,060005, 59세,2017,1767,959,808,118.7,1663,892,771,115.7
33370, 음성군,065,60~64세,2017,7152,3775,3377,111.8,6716,3482,3234,107.7
33370, 음성군,065001, 60세,2017,1644,890,754,118,1523,812,711,114.2
33370, 음성군,065002, 61세,2017,1534,793,741,107,1443,731,712,102.7
33370, 음성군,065003, 62세,2017,1497,771,726,106.2,1413,714,699,102.1
33370, 음성군,065004, 63세,2017,1363,711,652,109,1277,647,630,102.7
33370, 음성군,065005, 64세,2017,1114,610,504,121,1060,578,482,119.9
33370, 음성군,070,65~69세,2017,4834,2445,2389,102.3,4702,2374,2328,102
33370, 음성군,070001, 65세,2017,1301,690,611,112.9,1263,663,600,110.5
33370, 음성군,070002, 66세,2017,818,395,423,93.4,792,383,409,93.6
33370, 음성군,070003, 67세,2017,873,434,439,98.9,845,419,426,98.4
33370, 음성군,070004, 68세,2017,953,479,474,101.1,930,469,461,101.7
33370, 음성군,070005, 69세,2017,889,447,442,101.1,872,440,432,101.9
33370, 음성군,075,70~74세,2017,3900,1869,2031,92,3852,1850,2002,92.4
33370, 음성군,075001, 70세,2017,891,447,444,100.7,874,439,435,100.9
33370, 음성군,075002, 71세,2017,712,355,357,99.4,701,350,351,99.7
33370, 음성군,075003, 72세,2017,753,367,386,95.1,745,365,380,96.1
33370, 음성군,075004, 73세,2017,770,353,417,84.7,760,350,410,85.4
33370, 음성군,075005, 74세,2017,774,347,427,81.3,772,346,426,81.2
33370, 음성군,080,75~79세,2017,3932,1681,2251,74.7,3903,1671,2232,74.9
33370, 음성군,080001, 75세,2017,991,463,528,87.7,984,460,524,87.8
33370, 음성군,080002, 76세,2017,808,358,450,79.6,801,355,446,79.6
33370, 음성군,080003, 77세,2017,762,316,446,70.9,755,314,441,71.2
33370, 음성군,080004, 78세,2017,739,311,428,72.7,734,310,424,73.1
33370, 음성군,080005, 79세,2017,632,233,399,58.4,629,232,397,58.4
33370, 음성군,085,80~84세,2017,2640,901,1739,51.8,2629,897,1732,51.8
33370, 음성군,085001, 80세,2017,619,231,388,59.5,614,229,385,59.5
33370, 음성군,085002, 81세,2017,589,216,373,57.9,587,215,372,57.8
33370, 음성군,085003, 82세,2017,589,189,400,47.3,588,189,399,47.4
33370, 음성군,085004, 83세,2017,467,148,319,46.4,464,147,317,46.4
33370, 음성군,085005, 84세,2017,376,117,259,45.2,376,117,259,45.2
33370, 음성군,090,85~89세,2017,1251,337,914,36.9,1245,336,909,37
33370, 음성군,090001, 85세,2017,350,98,252,38.9,349,98,251,39
33370, 음성군,090002, 86세,2017,267,71,196,36.2,266,71,195,36.4
33370, 음성군,090003, 87세,2017,249,66,183,36.1,247,66,181,36.5
33370, 음성군,090004, 88세,2017,212,59,153,38.6,211,58,153,37.9
33370, 음성군,090005, 89세,2017,173,43,130,33.1,172,43,129,33.3
33370, 음성군,095,90~94세,2017,380,105,275,38.2,379,105,274,38.3
33370, 음성군,095001, 90세,2017,105,34,71,47.9,104,34,70,48.6
33370, 음성군,095002, 91세,2017,78,22,56,39.3,78,22,56,39.3
33370, 음성군,095003, 92세,2017,90,21,69,30.4,90,21,69,30.4
33370, 음성군,095004, 93세,2017,46,13,33,39.4,46,13,33,39.4
33370, 음성군,095005, 94세,2017,61,15,46,32.6,61,15,46,32.6
33370, 음성군,100,95~99세,2017,73,18,55,32.7,73,18,55,32.7
33370, 음성군,100001, 95세,2017,21,10,11,90.9,21,10,11,90.9
33370, 음성군,100002, 96세,2017,22,5,17,29.4,22,5,17,29.4
33370, 음성군,100003, 97세,2017,11,X,8,37.5,11,X,8,37.5
33370, 음성군,100004, 98세,2017,14,X,14,0,14,X,14,0
33370, 음성군,100005, 99세,2017,5,X,5,0,5,X,5,0
33370, 음성군,101,100세이상,2017,10,X,7,42.9,10,X,7,42.9
33370, 음성군,102,15세미만,2017,11858,6203,5655,109.7,11668,6104,5564,109.7
33370, 음성군,103,15~64세,2017,75631,43574,32057,135.9,64304,35296,29008,121.7
33370, 음성군,104,65세이상,2017,17020,7359,9661,76.2,16793,7254,9539,76
33370, 음성군,086,85세이상,2017,1714,463,1251,37,1707,462,1245,37.1
33370, 음성군,126,평균연령,2017,43.3,41.8,45,,44,42.7,45.4,
33370, 음성군,127,중위연령,2017,44.2,42.5,46.6,,46,44.8,47.5,
33380, 단양군,000,합계,2017,28411,14228,14183,100.3,28117,14079,14038,100.3
33380, 단양군,005,0~4세,2017,610,307,303,101.3,610,307,303,101.3
33380, 단양군,005001, 0세,2017,99,46,53,86.8,99,46,53,86.8
33380, 단양군,005002, 1세,2017,112,51,61,83.6,112,51,61,83.6
33380, 단양군,005003, 2세,2017,136,69,67,103,136,69,67,103
33380, 단양군,005004, 3세,2017,142,81,61,132.8,142,81,61,132.8
33380, 단양군,005005, 4세,2017,121,60,61,98.4,121,60,61,98.4
33380, 단양군,010,5~9세,2017,834,444,390,113.8,834,444,390,113.8
33380, 단양군,010001, 5세,2017,165,84,81,103.7,165,84,81,103.7
33380, 단양군,010002, 6세,2017,158,86,72,119.4,158,86,72,119.4
33380, 단양군,010003, 7세,2017,151,87,64,135.9,151,87,64,135.9
33380, 단양군,010004, 8세,2017,167,93,74,125.7,167,93,74,125.7
33380, 단양군,010005, 9세,2017,193,94,99,94.9,193,94,99,94.9
33380, 단양군,015,10~14세,2017,1001,551,450,122.4,1001,551,450,122.4
33380, 단양군,015001, 10세,2017,195,102,93,109.7,195,102,93,109.7
33380, 단양군,015002, 11세,2017,186,94,92,102.2,186,94,92,102.2
33380, 단양군,015003, 12세,2017,205,121,84,144,205,121,84,144
33380, 단양군,015004, 13세,2017,205,123,82,150,205,123,82,150
33380, 단양군,015005, 14세,2017,210,111,99,112.1,210,111,99,112.1
33380, 단양군,020,15~19세,2017,1185,607,578,105,1184,607,577,105.2
33380, 단양군,020001, 15세,2017,225,119,106,112.3,225,119,106,112.3
33380, 단양군,020002, 16세,2017,275,134,141,95,275,134,141,95
33380, 단양군,020003, 17세,2017,306,129,177,72.9,306,129,177,72.9
33380, 단양군,020004, 18세,2017,231,134,97,138.1,231,134,97,138.1
33380, 단양군,020005, 19세,2017,148,91,57,159.6,147,91,56,162.5
33380, 단양군,025,20~24세,2017,1070,666,404,164.9,1038,645,393,164.1
33380, 단양군,025001, 20세,2017,201,144,57,252.6,199,144,55,261.8
33380, 단양군,025002, 21세,2017,234,158,76,207.9,229,153,76,201.3
33380, 단양군,025003, 22세,2017,193,106,87,121.8,186,103,83,124.1
33380, 단양군,025004, 23세,2017,236,142,94,151.1,227,137,90,152.2
33380, 단양군,025005, 24세,2017,206,116,90,128.9,197,108,89,121.3
33380, 단양군,030,25~29세,2017,1106,633,473,133.8,1047,602,445,135.3
33380, 단양군,030001, 25세,2017,260,150,110,136.4,249,145,104,139.4
33380, 단양군,030002, 26세,2017,210,119,91,130.8,198,112,86,130.2
33380, 단양군,030003, 27세,2017,218,132,86,153.5,199,122,77,158.4
33380, 단양군,030004, 28세,2017,239,135,104,129.8,226,128,98,130.6
33380, 단양군,030005, 29세,2017,179,97,82,118.3,175,95,80,118.8
33380, 단양군,035,30~34세,2017,1023,560,463,121,975,536,439,122.1
33380, 단양군,035001, 30세,2017,203,108,95,113.7,192,104,88,118.2
33380, 단양군,035002, 31세,2017,187,115,72,159.7,179,110,69,159.4
33380, 단양군,035003, 32세,2017,198,113,85,132.9,184,105,79,132.9
33380, 단양군,035004, 33세,2017,195,105,90,116.7,187,102,85,120
33380, 단양군,035005, 34세,2017,240,119,121,98.3,233,115,118,97.5
33380, 단양군,040,35~39세,2017,1327,727,600,121.2,1297,708,589,120.2
33380, 단양군,040001, 35세,2017,251,128,123,104.1,247,126,121,104.1
33380, 단양군,040002, 36세,2017,268,139,129,107.8,263,136,127,107.1
33380, 단양군,040003, 37세,2017,286,164,122,134.4,280,160,120,133.3
33380, 단양군,040004, 38세,2017,260,142,118,120.3,253,138,115,120
33380, 단양군,040005, 39세,2017,262,154,108,142.6,254,148,106,139.6
33380, 단양군,045,40~44세,2017,1532,835,697,119.8,1505,823,682,120.7
33380, 단양군,045001, 40세,2017,246,136,110,123.6,239,135,104,129.8
33380, 단양군,045002, 41세,2017,272,158,114,138.6,269,156,113,138.1
33380, 단양군,045003, 42세,2017,287,152,135,112.6,283,149,134,111.2
33380, 단양군,045004, 43세,2017,339,172,167,103,333,169,164,103
33380, 단양군,045005, 44세,2017,388,217,171,126.9,381,214,167,128.1
33380, 단양군,050,45~49세,2017,2202,1176,1026,114.6,2175,1163,1012,114.9
33380, 단양군,050001, 45세,2017,385,208,177,117.5,378,205,173,118.5
33380, 단양군,050002, 46세,2017,434,217,217,100,428,213,215,99.1
33380, 단양군,050003, 47세,2017,439,261,178,146.6,438,260,178,146.1
33380, 단양군,050004, 48세,2017,449,254,195,130.3,443,252,191,131.9
33380, 단양군,050005, 49세,2017,495,236,259,91.1,488,233,255,91.4
33380, 단양군,055,50~54세,2017,2426,1291,1135,113.7,2394,1281,1113,115.1
33380, 단양군,055001, 50세,2017,433,216,217,99.5,428,214,214,100
33380, 단양군,055002, 51세,2017,498,263,235,111.9,490,262,228,114.9
33380, 단양군,055003, 52세,2017,511,271,240,112.9,505,268,237,113.1
33380, 단양군,055004, 53세,2017,465,256,209,122.5,460,255,205,124.4
33380, 단양군,055005, 54세,2017,519,285,234,121.8,511,282,229,123.1
33380, 단양군,060,55~59세,2017,3316,1636,1680,97.4,3297,1627,1670,97.4
33380, 단양군,060001, 55세,2017,608,323,285,113.3,599,319,280,113.9
33380, 단양군,060002, 56세,2017,724,377,347,108.6,721,375,346,108.4
33380, 단양군,060003, 57세,2017,693,306,387,79.1,690,305,385,79.2
33380, 단양군,060004, 58세,2017,632,304,328,92.7,632,304,328,92.7
33380, 단양군,060005, 59세,2017,659,326,333,97.9,655,324,331,97.9
33380, 단양군,065,60~64세,2017,2917,1502,1415,106.1,2906,1495,1411,106
33380, 단양군,065001, 60세,2017,708,378,330,114.5,706,377,329,114.6
33380, 단양군,065002, 61세,2017,606,315,291,108.2,602,313,289,108.3
33380, 단양군,065003, 62세,2017,610,304,306,99.3,610,304,306,99.3
33380, 단양군,065004, 63세,2017,573,295,278,106.1,568,291,277,105.1
33380, 단양군,065005, 64세,2017,420,210,210,100,420,210,210,100
33380, 단양군,070,65~69세,2017,2206,1087,1119,97.1,2200,1084,1116,97.1
33380, 단양군,070001, 65세,2017,552,285,267,106.7,550,284,266,106.8
33380, 단양군,070002, 66세,2017,339,166,173,96,338,165,173,95.4
33380, 단양군,070003, 67세,2017,407,187,220,85,406,187,219,85.4
33380, 단양군,070004, 68세,2017,447,235,212,110.8,445,234,211,110.9
33380, 단양군,070005, 69세,2017,461,214,247,86.6,461,214,247,86.6
33380, 단양군,075,70~74세,2017,1847,794,1053,75.4,1847,794,1053,75.4
33380, 단양군,075001, 70세,2017,427,200,227,88.1,427,200,227,88.1
33380, 단양군,075002, 71세,2017,301,122,179,68.2,301,122,179,68.2
33380, 단양군,075003, 72세,2017,351,153,198,77.3,351,153,198,77.3
33380, 단양군,075004, 73세,2017,383,156,227,68.7,383,156,227,68.7
33380, 단양군,075005, 74세,2017,385,163,222,73.4,385,163,222,73.4
33380, 단양군,080,75~79세,2017,1952,803,1149,69.9,1951,803,1148,69.9
33380, 단양군,080001, 75세,2017,458,189,269,70.3,457,189,268,70.5
33380, 단양군,080002, 76세,2017,412,199,213,93.4,412,199,213,93.4
33380, 단양군,080003, 77세,2017,364,138,226,61.1,364,138,226,61.1
33380, 단양군,080004, 78세,2017,380,161,219,73.5,380,161,219,73.5
33380, 단양군,080005, 79세,2017,338,116,222,52.3,338,116,222,52.3
33380, 단양군,085,80~84세,2017,1163,428,735,58.2,1163,428,735,58.2
33380, 단양군,085001, 80세,2017,280,113,167,67.7,280,113,167,67.7
33380, 단양군,085002, 81세,2017,266,104,162,64.2,266,104,162,64.2
33380, 단양군,085003, 82세,2017,236,79,157,50.3,236,79,157,50.3
33380, 단양군,085004, 83세,2017,206,74,132,56.1,206,74,132,56.1
33380, 단양군,085005, 84세,2017,175,58,117,49.6,175,58,117,49.6
33380, 단양군,090,85~89세,2017,493,132,361,36.6,493,132,361,36.6
33380, 단양군,090001, 85세,2017,139,36,103,35,139,36,103,35
33380, 단양군,090002, 86세,2017,99,32,67,47.8,99,32,67,47.8
33380, 단양군,090003, 87세,2017,111,29,82,35.4,111,29,82,35.4
33380, 단양군,090004, 88세,2017,85,26,59,44.1,85,26,59,44.1
33380, 단양군,090005, 89세,2017,59,9,50,18,59,9,50,18
33380, 단양군,095,90~94세,2017,151,40,111,36,150,40,110,36.4
33380, 단양군,095001, 90세,2017,43,10,33,30.3,43,10,33,30.3
33380, 단양군,095002, 91세,2017,31,11,20,55,31,11,20,55
33380, 단양군,095003, 92세,2017,30,5,25,20,29,5,24,20.8
33380, 단양군,095004, 93세,2017,27,11,16,68.8,27,11,16,68.8
33380, 단양군,095005, 94세,2017,20,X,17,17.6,20,X,17,17.6
33380, 단양군,100,95~99세,2017,48,9,39,23.1,48,9,39,23.1
33380, 단양군,100001, 95세,2017,18,5,13,38.5,18,5,13,38.5
33380, 단양군,100002, 96세,2017,15,X,14,7.1,15,X,14,7.1
33380, 단양군,100003, 97세,2017,X,X,X,33.3,X,X,X,33.3
33380, 단양군,100004, 98세,2017,6,X,X,50,6,X,X,50
33380, 단양군,100005, 99세,2017,5,X,5,0,5,X,5,0
33380, 단양군,101,100세이상,2017,X,X,X,0,X,X,X,0
33380, 단양군,102,15세미만,2017,2445,1302,1143,113.9,2445,1302,1143,113.9
33380, 단양군,103,15~64세,2017,18104,9633,8471,113.7,17818,9487,8331,113.9
33380, 단양군,104,65세이상,2017,7862,3293,4569,72.1,7854,3290,4564,72.1
33380, 단양군,086,85세이상,2017,694,181,513,35.3,693,181,512,35.4
33380, 단양군,126,평균연령,2017,50.7,48.5,52.8,,50.8,48.6,53,
33380, 단양군,127,중위연령,2017,54.8,52.5,56.8,,55,52.7,57,
33390, 증평군,000,합계,2017,37625,19200,18425,104.2,36753,18740,18013,104
33390, 증평군,005,0~4세,2017,2027,1015,1012,100.3,2015,1012,1003,100.9
33390, 증평군,005001, 0세,2017,388,210,178,118,386,209,177,118.1
33390, 증평군,005002, 1세,2017,399,190,209,90.9,395,190,205,92.7
33390, 증평군,005003, 2세,2017,391,203,188,108,388,201,187,107.5
33390, 증평군,005004, 3세,2017,413,183,230,79.6,412,183,229,79.9
33390, 증평군,005005, 4세,2017,436,229,207,110.6,434,229,205,111.7
33390, 증평군,010,5~9세,2017,1976,1038,938,110.7,1971,1037,934,111
33390, 증평군,010001, 5세,2017,399,202,197,102.5,398,202,196,103.1
33390, 증평군,010002, 6세,2017,428,218,210,103.8,425,217,208,104.3
33390, 증평군,010003, 7세,2017,410,220,190,115.8,409,220,189,116.4
33390, 증평군,010004, 8세,2017,367,205,162,126.5,367,205,162,126.5
33390, 증평군,010005, 9세,2017,372,193,179,107.8,372,193,179,107.8
33390, 증평군,015,10~14세,2017,1671,863,808,106.8,1669,861,808,106.6
33390, 증평군,015001, 10세,2017,340,176,164,107.3,340,176,164,107.3
33390, 증평군,015002, 11세,2017,316,163,153,106.5,316,163,153,106.5
33390, 증평군,015003, 12세,2017,376,198,178,111.2,376,198,178,111.2
33390, 증평군,015004, 13세,2017,322,165,157,105.1,320,163,157,103.8
33390, 증평군,015005, 14세,2017,317,161,156,103.2,317,161,156,103.2
33390, 증평군,020,15~19세,2017,1954,974,980,99.4,1949,973,976,99.7
33390, 증평군,020001, 15세,2017,339,169,170,99.4,339,169,170,99.4
33390, 증평군,020002, 16세,2017,330,177,153,115.7,329,177,152,116.4
33390, 증평군,020003, 17세,2017,399,208,191,108.9,399,208,191,108.9
33390, 증평군,020004, 18세,2017,394,192,202,95,393,192,201,95.5
33390, 증평군,020005, 19세,2017,492,228,264,86.4,489,227,262,86.6
33390, 증평군,025,20~24세,2017,2685,1401,1284,109.1,2612,1362,1250,109
33390, 증평군,025001, 20세,2017,549,236,313,75.4,544,233,311,74.9
33390, 증평군,025002, 21세,2017,505,232,273,85,497,231,266,86.8
33390, 증평군,025003, 22세,2017,536,287,249,115.3,521,279,242,115.3
33390, 증평군,025004, 23세,2017,533,305,228,133.8,509,291,218,133.5
33390, 증평군,025005, 24세,2017,562,341,221,154.3,541,328,213,154
33390, 증평군,030,25~29세,2017,2252,1285,967,132.9,2105,1200,905,132.6
33390, 증평군,030001, 25세,2017,461,269,192,140.1,438,258,180,143.3
33390, 증평군,030002, 26세,2017,455,265,190,139.5,433,252,181,139.2
33390, 증평군,030003, 27세,2017,457,270,187,144.4,418,247,171,144.4
33390, 증평군,030004, 28세,2017,456,269,187,143.9,412,240,172,139.5
33390, 증평군,030005, 29세,2017,423,212,211,100.5,404,203,201,101
33390, 증평군,035,30~34세,2017,2645,1488,1157,128.6,2486,1399,1087,128.7
33390, 증평군,035001, 30세,2017,466,265,201,131.8,433,246,187,131.6
33390, 증평군,035002, 31세,2017,490,279,211,132.2,454,260,194,134
33390, 증평군,035003, 32세,2017,543,299,244,122.5,514,283,231,122.5
33390, 증평군,035004, 33세,2017,549,310,239,129.7,512,288,224,128.6
33390, 증평군,035005, 34세,2017,597,335,262,127.9,573,322,251,128.3
33390, 증평군,040,35~39세,2017,2915,1567,1348,116.2,2830,1526,1304,117
33390, 증평군,040001, 35세,2017,615,336,279,120.4,593,326,267,122.1
33390, 증평군,040002, 36세,2017,590,317,273,116.1,574,311,263,118.3
33390, 증평군,040003, 37세,2017,600,317,283,112,586,309,277,111.6
33390, 증평군,040004, 38세,2017,583,318,265,120,571,312,259,120.5
33390, 증평군,040005, 39세,2017,527,279,248,112.5,506,268,238,112.6
33390, 증평군,045,40~44세,2017,2841,1551,1290,120.2,2765,1513,1252,120.8
33390, 증평군,045001, 40세,2017,575,307,268,114.6,560,298,262,113.7
33390, 증평군,045002, 41세,2017,530,279,251,111.2,518,276,242,114
33390, 증평군,045003, 42세,2017,511,280,231,121.2,492,270,222,121.6
33390, 증평군,045004, 43세,2017,629,358,271,132.1,615,351,264,133
33390, 증평군,045005, 44세,2017,596,327,269,121.6,580,318,262,121.4
33390, 증평군,050,45~49세,2017,2959,1557,1402,111.1,2870,1508,1362,110.7
33390, 증평군,050001, 45세,2017,536,275,261,105.4,519,263,256,102.7
33390, 증평군,050002, 46세,2017,583,311,272,114.3,569,303,266,113.9
33390, 증평군,050003, 47세,2017,551,290,261,111.1,529,280,249,112.4
33390, 증평군,050004, 48세,2017,672,354,318,111.3,654,345,309,111.7
33390, 증평군,050005, 49세,2017,617,327,290,112.8,599,317,282,112.4
33390, 증평군,055,50~54세,2017,2749,1425,1324,107.6,2666,1386,1280,108.3
33390, 증평군,055001, 50세,2017,598,303,295,102.7,582,299,283,105.7
33390, 증평군,055002, 51세,2017,568,292,276,105.8,552,285,267,106.7
33390, 증평군,055003, 52세,2017,550,272,278,97.8,535,265,270,98.1
33390, 증평군,055004, 53세,2017,500,269,231,116.5,481,259,222,116.7
33390, 증평군,055005, 54세,2017,533,289,244,118.4,516,278,238,116.8
33390, 증평군,060,55~59세,2017,3001,1538,1463,105.1,2939,1510,1429,105.7
33390, 증평군,060001, 55세,2017,620,328,292,112.3,601,322,279,115.4
33390, 증평군,060002, 56세,2017,654,321,333,96.4,644,316,328,96.3
33390, 증평군,060003, 57세,2017,595,295,300,98.3,585,289,296,97.6
33390, 증평군,060004, 58세,2017,583,315,268,117.5,569,311,258,120.5
33390, 증평군,060005, 59세,2017,549,279,270,103.3,540,272,268,101.5
33390, 증평군,065,60~64세,2017,2391,1183,1208,97.9,2352,1155,1197,96.5
33390, 증평군,065001, 60세,2017,591,310,281,110.3,579,301,278,108.3
33390, 증평군,065002, 61세,2017,499,242,257,94.2,493,239,254,94.1
33390, 증평군,065003, 62세,2017,467,226,241,93.8,460,221,239,92.5
33390, 증평군,065004, 63세,2017,470,225,245,91.8,461,219,242,90.5
33390, 증평군,065005, 64세,2017,364,180,184,97.8,359,175,184,95.1
33390, 증평군,070,65~69세,2017,1593,792,801,98.9,1572,780,792,98.5
33390, 증평군,070001, 65세,2017,437,219,218,100.5,433,217,216,100.5
33390, 증평군,070002, 66세,2017,286,137,149,91.9,277,133,144,92.4
33390, 증평군,070003, 67세,2017,282,145,137,105.8,278,142,136,104.4
33390, 증평군,070004, 68세,2017,269,129,140,92.1,266,126,140,90
33390, 증평군,070005, 69세,2017,319,162,157,103.2,318,162,156,103.8
33390, 증평군,075,70~74세,2017,1332,598,734,81.5,1321,594,727,81.7
33390, 증평군,075001, 70세,2017,295,143,152,94.1,289,141,148,95.3
33390, 증평군,075002, 71세,2017,231,113,118,95.8,229,111,118,94.1
33390, 증평군,075003, 72세,2017,247,116,131,88.5,246,116,130,89.2
33390, 증평군,075004, 73세,2017,254,108,146,74,253,108,145,74.5
33390, 증평군,075005, 74세,2017,305,118,187,63.1,304,118,186,63.4
33390, 증평군,080,75~79세,2017,1266,520,746,69.7,1265,519,746,69.6
33390, 증평군,080001, 75세,2017,291,121,170,71.2,291,121,170,71.2
33390, 증평군,080002, 76세,2017,269,112,157,71.3,268,111,157,70.7
33390, 증평군,080003, 77세,2017,232,103,129,79.8,232,103,129,79.8
33390, 증평군,080004, 78세,2017,230,101,129,78.3,230,101,129,78.3
33390, 증평군,080005, 79세,2017,244,83,161,51.6,244,83,161,51.6
33390, 증평군,085,80~84세,2017,856,276,580,47.6,854,276,578,47.8
33390, 증평군,085001, 80세,2017,185,74,111,66.7,185,74,111,66.7
33390, 증평군,085002, 81세,2017,206,63,143,44.1,204,63,141,44.7
33390, 증평군,085003, 82세,2017,187,55,132,41.7,187,55,132,41.7
33390, 증평군,085004, 83세,2017,143,51,92,55.4,143,51,92,55.4
33390, 증평군,085005, 84세,2017,135,33,102,32.4,135,33,102,32.4
33390, 증평군,090,85~89세,2017,361,99,262,37.8,361,99,262,37.8
33390, 증평군,090001, 85세,2017,108,27,81,33.3,108,27,81,33.3
33390, 증평군,090002, 86세,2017,82,20,62,32.3,82,20,62,32.3
33390, 증평군,090003, 87세,2017,66,17,49,34.7,66,17,49,34.7
33390, 증평군,090004, 88세,2017,61,21,40,52.5,61,21,40,52.5
33390, 증평군,090005, 89세,2017,44,14,30,46.7,44,14,30,46.7
33390, 증평군,095,90~94세,2017,120,21,99,21.2,120,21,99,21.2
33390, 증평군,095001, 90세,2017,43,11,32,34.4,43,11,32,34.4
33390, 증평군,095002, 91세,2017,21,6,15,40,21,6,15,40
33390, 증평군,095003, 92세,2017,27,X,26,3.8,27,X,26,3.8
33390, 증평군,095004, 93세,2017,17,X,15,13.3,17,X,15,13.3
33390, 증평군,095005, 94세,2017,12,X,11,9.1,12,X,11,9.1
33390, 증평군,100,95~99세,2017,27,9,18,50,27,9,18,50
33390, 증평군,100001, 95세,2017,13,X,9,44.4,13,X,9,44.4
33390, 증평군,100002, 96세,2017,5,X,X,25,5,X,X,25
33390, 증평군,100003, 97세,2017,X,X,X,50,X,X,X,50
33390, 증평군,100004, 98세,2017,5,X,X,150,5,X,X,150
33390, 증평군,100005, 99세,2017,X,X,X,0,X,X,X,0
33390, 증평군,101,100세이상,2017,X,X,X,0,X,X,X,0
33390, 증평군,102,15세미만,2017,5674,2916,2758,105.7,5655,2910,2745,106
33390, 증평군,103,15~64세,2017,26392,13969,12423,112.4,25574,13532,12042,112.4
33390, 증평군,104,65세이상,2017,5559,2315,3244,71.4,5524,2298,3226,71.2
33390, 증평군,086,85세이상,2017,512,129,383,33.7,512,129,383,33.7
33390, 증평군,126,평균연령,2017,40.9,39.6,42.2,,40.9,39.6,42.3,
33390, 증평군,127,중위연령,2017,41.2,39.9,42.9,,41.3,40,43,
34,충청남도,000,합계,2017,2162426,1108610,1053816,105.2,2077674,1056508,1021166,103.5
34,충청남도,005,0~4세,2017,92367,47150,45217,104.3,91126,46524,44602,104.3
34,충청남도,005001, 0세,2017,16182,8297,7885,105.2,15892,8149,7743,105.2
34,충청남도,005002, 1세,2017,18170,9206,8964,102.7,17888,9069,8819,102.8
34,충청남도,005003, 2세,2017,19378,9868,9510,103.8,19113,9749,9364,104.1
34,충청남도,005004, 3세,2017,18972,9717,9255,105,18752,9590,9162,104.7
34,충청남도,005005, 4세,2017,19665,10062,9603,104.8,19481,9967,9514,104.8
34,충청남도,010,5~9세,2017,101812,52615,49197,106.9,101160,52257,48903,106.9
34,충청남도,010001, 5세,2017,21164,10883,10281,105.9,20977,10772,10205,105.6
34,충청남도,010002, 6세,2017,20881,10841,10040,108,20744,10772,9972,108
34,충청남도,010003, 7세,2017,20209,10501,9708,108.2,20069,10420,9649,108
34,충청남도,010004, 8세,2017,19309,9969,9340,106.7,19212,9919,9293,106.7
34,충청남도,010005, 9세,2017,20249,10421,9828,106,20158,10374,9784,106
34,충청남도,015,10~14세,2017,97084,50269,46815,107.4,96711,50064,46647,107.3
34,충청남도,015001, 10세,2017,20620,10728,9892,108.5,20524,10670,9854,108.3
34,충청남도,015002, 11세,2017,18867,9747,9120,106.9,18798,9713,9085,106.9
34,충청남도,015003, 12세,2017,18259,9412,8847,106.4,18194,9373,8821,106.3
34,충청남도,015004, 13세,2017,19654,10168,9486,107.2,19564,10124,9440,107.2
34,충청남도,015005, 14세,2017,19684,10214,9470,107.9,19631,10184,9447,107.8
34,충청남도,020,15~19세,2017,128419,67255,61164,110,126640,66462,60178,110.4
34,충청남도,020001, 15세,2017,20369,10699,9670,110.6,20315,10671,9644,110.6
34,충청남도,020002, 16세,2017,23957,12663,11294,112.1,23872,12623,11249,112.2
34,충청남도,020003, 17세,2017,26024,13845,12179,113.7,25856,13770,12086,113.9
34,충청남도,020004, 18세,2017,26580,13820,12760,108.3,26128,13617,12511,108.8
34,충청남도,020005, 19세,2017,31489,16228,15261,106.3,30469,15781,14688,107.4
34,충청남도,025,20~24세,2017,148933,79921,69012,115.8,138349,73928,64421,114.8
34,충청남도,025001, 20세,2017,30333,14758,15575,94.8,28899,14130,14769,95.7
34,충청남도,025002, 21세,2017,30238,15520,14718,105.4,28343,14534,13809,105.3
34,충청남도,025003, 22세,2017,30270,16459,13811,119.2,28057,15214,12843,118.5
34,충청남도,025004, 23세,2017,29339,16825,12514,134.4,26884,15336,11548,132.8
34,충청남도,025005, 24세,2017,28753,16359,12394,132,26166,14714,11452,128.5
34,충청남도,030,25~29세,2017,132844,75318,57526,130.9,117722,65259,52463,124.4
34,충청남도,030001, 25세,2017,28622,16320,12302,132.7,25756,14403,11353,126.9
34,충청남도,030002, 26세,2017,26022,14731,11291,130.5,23174,12912,10262,125.8
34,충청남도,030003, 27세,2017,25927,14708,11219,131.1,22809,12632,10177,124.1
34,충청남도,030004, 28세,2017,25747,14719,11028,133.5,22667,12610,10057,125.4
34,충청남도,030005, 29세,2017,26526,14840,11686,127,23316,12702,10614,119.7
34,충청남도,035,30~34세,2017,142897,79028,63869,123.7,128521,69351,59170,117.2
34,충청남도,035001, 30세,2017,27080,15060,12020,125.3,23931,12957,10974,118.1
34,충청남도,035002, 31세,2017,27286,15180,12106,125.4,24261,13192,11069,119.2
34,충청남도,035003, 32세,2017,27577,15381,12196,126.1,24652,13402,11250,119.1
34,충청남도,035004, 33세,2017,29004,15876,13128,120.9,26299,14036,12263,114.5
34,충청남도,035005, 34세,2017,31950,17531,14419,121.6,29378,15764,13614,115.8
34,충청남도,040,35~39세,2017,167736,91369,76367,119.6,157072,83998,73074,114.9
34,충청남도,040001, 35세,2017,34793,18907,15886,119,32304,17217,15087,114.1
34,충청남도,040002, 36세,2017,34272,18842,15430,122.1,32096,17340,14756,117.5
34,충청남도,040003, 37세,2017,35259,19063,16196,117.7,33095,17554,15541,113
34,충청남도,040004, 38세,2017,32810,17715,15095,117.4,30812,16332,14480,112.8
34,충청남도,040005, 39세,2017,30602,16842,13760,122.4,28765,15555,13210,117.8
34,충청남도,045,40~44세,2017,162681,86985,75696,114.9,155115,82049,73066,112.3
34,충청남도,045001, 40세,2017,31273,16845,14428,116.8,29599,15712,13887,113.1
34,충청남도,045002, 41세,2017,30602,16365,14237,114.9,29043,15334,13709,111.9
34,충청남도,045003, 42세,2017,31695,16723,14972,111.7,30216,15749,14467,108.9
34,충청남도,045004, 43세,2017,34506,18570,15936,116.5,33091,17652,15439,114.3
34,충청남도,045005, 44세,2017,34605,18482,16123,114.6,33166,17602,15564,113.1
34,충청남도,050,45~49세,2017,175351,93668,81683,114.7,168014,89319,78695,113.5
34,충청남도,050001, 45세,2017,33278,17990,15288,117.7,31697,17000,14697,115.7
34,충청남도,050002, 46세,2017,36428,19712,16716,117.9,34885,18765,16120,116.4
34,충청남도,050003, 47세,2017,34335,18412,15923,115.6,32839,17533,15306,114.5
34,충청남도,050004, 48세,2017,35924,19040,16884,112.8,34536,18259,16277,112.2
34,충청남도,050005, 49세,2017,35386,18514,16872,109.7,34057,17762,16295,109
34,충청남도,055,50~54세,2017,158122,83518,74604,111.9,152075,80296,71779,111.9
34,충청남도,055001, 50세,2017,32245,16933,15312,110.6,31101,16302,14799,110.2
34,충청남도,055002, 51세,2017,29772,15886,13886,114.4,28623,15287,13336,114.6
34,충청남도,055003, 52세,2017,34002,17888,16114,111,32687,17198,15489,111
34,충청남도,055004, 53세,2017,30589,16175,14414,112.2,29486,15575,13911,112
34,충청남도,055005, 54세,2017,31514,16636,14878,111.8,30178,15934,14244,111.9
34,충청남도,060,55~59세,2017,169336,86830,82506,105.2,165381,84822,80559,105.3
34,충청남도,060001, 55세,2017,33886,17960,15926,112.8,32875,17438,15437,113
34,충청남도,060002, 56세,2017,37529,19441,18088,107.5,36845,19091,17754,107.5
34,충청남도,060003, 57세,2017,36550,18464,18086,102.1,35686,18037,17649,102.2
34,충청남도,060004, 58세,2017,31543,15841,15702,100.9,30849,15509,15340,101.1
34,충청남도,060005, 59세,2017,29828,15124,14704,102.9,29126,14747,14379,102.6
34,충청남도,065,60~64세,2017,130826,65553,65273,100.4,127846,63982,63864,100.2
34,충청남도,065001, 60세,2017,29235,15021,14214,105.7,28469,14575,13894,104.9
34,충청남도,065002, 61세,2017,27773,14023,13750,102,27126,13690,13436,101.9
34,충청남도,065003, 62세,2017,28871,14420,14451,99.8,28271,14114,14157,99.7
34,충청남도,065004, 63세,2017,24663,12073,12590,95.9,24136,11804,12332,95.7
34,충청남도,065005, 64세,2017,20284,10016,10268,97.5,19844,9799,10045,97.6
34,충청남도,070,65~69세,2017,101470,49478,51992,95.2,100306,48874,51432,95
34,충청남도,070001, 65세,2017,23045,11206,11839,94.7,22693,11027,11666,94.5
34,충청남도,070002, 66세,2017,18039,8921,9118,97.8,17781,8762,9019,97.2
34,충청남도,070003, 67세,2017,20593,9951,10642,93.5,20368,9837,10531,93.4
34,충청남도,070004, 68세,2017,20570,10086,10484,96.2,20367,9991,10376,96.3
34,충청남도,070005, 69세,2017,19223,9314,9909,94,19097,9257,9840,94.1
34,충청남도,075,70~74세,2017,78118,35993,42125,85.4,77663,35802,41861,85.5
34,충청남도,075001, 70세,2017,18863,9090,9773,93,18734,9037,9697,93.2
34,충청남도,075002, 71세,2017,13810,6769,7041,96.1,13693,6723,6970,96.5
34,충청남도,075003, 72세,2017,14093,6444,7649,84.2,14019,6412,7607,84.3
34,충청남도,075004, 73세,2017,15545,6745,8800,76.6,15467,6713,8754,76.7
34,충청남도,075005, 74세,2017,15807,6945,8862,78.4,15750,6917,8833,78.3
34,충청남도,080,75~79세,2017,80124,32499,47625,68.2,79874,32419,47455,68.3
34,충청남도,080001, 75세,2017,20342,8537,11805,72.3,20297,8522,11775,72.4
34,충청남도,080002, 76세,2017,15281,6312,8969,70.4,15220,6288,8932,70.4
34,충청남도,080003, 77세,2017,14218,5793,8425,68.8,14160,5771,8389,68.8
34,충청남도,080004, 78세,2017,15742,6239,9503,65.7,15705,6229,9476,65.7
34,충청남도,080005, 79세,2017,14541,5618,8923,63,14492,5609,8883,63.1
34,충청남도,085,80~84세,2017,57553,21011,36542,57.5,57412,20970,36442,57.5
34,충청남도,085001, 80세,2017,13464,5193,8271,62.8,13419,5182,8237,62.9
34,충청남도,085002, 81세,2017,12884,4847,8037,60.3,12855,4837,8018,60.3
34,충청남도,085003, 82세,2017,12194,4306,7888,54.6,12166,4298,7868,54.6
34,충청남도,085004, 83세,2017,10210,3665,6545,56,10186,3657,6529,56
34,충청남도,085005, 84세,2017,8801,3000,5801,51.7,8786,2996,5790,51.7
34,충청남도,090,85~89세,2017,26401,7797,18604,41.9,26345,7782,18563,41.9
34,충청남도,090001, 85세,2017,7990,2600,5390,48.2,7978,2597,5381,48.3
34,충청남도,090002, 86세,2017,5550,1655,3895,42.5,5534,1650,3884,42.5
34,충청남도,090003, 87세,2017,5011,1430,3581,39.9,4997,1428,3569,40
34,충청남도,090004, 88세,2017,4306,1175,3131,37.5,4297,1171,3126,37.5
34,충청남도,090005, 89세,2017,3544,937,2607,35.9,3539,936,2603,36
34,충청남도,095,90~94세,2017,8213,1961,6252,31.4,8205,1959,6246,31.4
34,충청남도,095001, 90세,2017,2672,691,1981,34.9,2668,690,1978,34.9
34,충청남도,095002, 91세,2017,1863,448,1415,31.7,1863,448,1415,31.7
34,충청남도,095003, 92세,2017,1536,382,1154,33.1,1536,382,1154,33.1
34,충청남도,095004, 93세,2017,1086,226,860,26.3,1085,225,860,26.2
34,충청남도,095005, 94세,2017,1056,214,842,25.4,1053,214,839,25.5
34,충청남도,100,95~99세,2017,1917,366,1551,23.6,1915,365,1550,23.5
34,충청남도,100001, 95세,2017,787,145,642,22.6,786,145,641,22.6
34,충청남도,100002, 96세,2017,464,105,359,29.2,464,105,359,29.2
34,충청남도,100003, 97세,2017,322,55,267,20.6,321,54,267,20.2
34,충청남도,100004, 98세,2017,204,38,166,22.9,204,38,166,22.9
34,충청남도,100005, 99세,2017,140,23,117,19.7,140,23,117,19.7
34,충청남도,101,100세이상,2017,222,26,196,13.3,222,26,196,13.3
34,충청남도,102,15세미만,2017,291263,150034,141229,106.2,288997,148845,140152,106.2
34,충청남도,103,15~64세,2017,1517145,809445,707700,114.4,1436735,759466,677269,112.1
34,충청남도,104,65세이상,2017,354018,149131,204887,72.8,351942,148197,203745,72.7
34,충청남도,086,85세이상,2017,36753,10150,26603,38.2,36687,10132,26555,38.2
34,충청남도,126,평균연령,2017,41.9,40.5,43.3,,42.1,40.7,43.5,
34,충청남도,127,중위연령,2017,42.2,40.7,43.9,,42.8,41.3,44.2,
34004, 읍부,000,합계,2017,507152,260932,246220,106,489753,250081,239672,104.3
34004, 읍부,005,0~4세,2017,21693,11146,10547,105.7,21498,11042,10456,105.6
34004, 읍부,005001, 0세,2017,3748,1918,1830,104.8,3709,1895,1814,104.5
34004, 읍부,005002, 1세,2017,4139,2098,2041,102.8,4107,2079,2028,102.5
34004, 읍부,005003, 2세,2017,4615,2354,2261,104.1,4571,2336,2235,104.5
34004, 읍부,005004, 3세,2017,4529,2340,2189,106.9,4489,2317,2172,106.7
34004, 읍부,005005, 4세,2017,4662,2436,2226,109.4,4622,2415,2207,109.4
34004, 읍부,010,5~9세,2017,24947,12953,11994,108,24833,12884,11949,107.8
34004, 읍부,010001, 5세,2017,5101,2607,2494,104.5,5079,2596,2483,104.6
34004, 읍부,010002, 6세,2017,5050,2601,2449,106.2,5024,2586,2438,106.1
34004, 읍부,010003, 7세,2017,4933,2599,2334,111.4,4901,2577,2324,110.9
34004, 읍부,010004, 8세,2017,4853,2534,2319,109.3,4835,2524,2311,109.2
34004, 읍부,010005, 9세,2017,5010,2612,2398,108.9,4994,2601,2393,108.7
34004, 읍부,015,10~14세,2017,24000,12301,11699,105.1,23931,12265,11666,105.1
34004, 읍부,015001, 10세,2017,5191,2663,2528,105.3,5172,2655,2517,105.5
34004, 읍부,015002, 11세,2017,4667,2405,2262,106.3,4660,2404,2256,106.6
34004, 읍부,015003, 12세,2017,4509,2295,2214,103.7,4492,2285,2207,103.5
34004, 읍부,015004, 13세,2017,4787,2400,2387,100.5,4771,2390,2381,100.4
34004, 읍부,015005, 14세,2017,4846,2538,2308,110,4836,2531,2305,109.8
34004, 읍부,020,15~19세,2017,31003,16177,14826,109.1,30697,16041,14656,109.5
34004, 읍부,020001, 15세,2017,5064,2626,2438,107.7,5058,2623,2435,107.7
34004, 읍부,020002, 16세,2017,5983,3110,2873,108.2,5970,3103,2867,108.2
34004, 읍부,020003, 17세,2017,6527,3463,3064,113,6502,3452,3050,113.2
34004, 읍부,020004, 18세,2017,6398,3338,3060,109.1,6328,3310,3018,109.7
34004, 읍부,020005, 19세,2017,7031,3640,3391,107.3,6839,3553,3286,108.1
34004, 읍부,025,20~24세,2017,31954,17750,14204,125,29779,16492,13287,124.1
34004, 읍부,025001, 20세,2017,6641,3350,3291,101.8,6359,3219,3140,102.5
34004, 읍부,025002, 21세,2017,6718,3626,3092,117.3,6337,3412,2925,116.6
34004, 읍부,025003, 22세,2017,6519,3704,2815,131.6,6043,3438,2605,132
34004, 읍부,025004, 23세,2017,6179,3661,2518,145.4,5702,3358,2344,143.3
34004, 읍부,025005, 24세,2017,5897,3409,2488,137,5338,3065,2273,134.8
34004, 읍부,030,25~29세,2017,28147,16134,12013,134.3,25010,14031,10979,127.8
34004, 읍부,030001, 25세,2017,5950,3429,2521,136,5354,3021,2333,129.5
34004, 읍부,030002, 26세,2017,5502,3184,2318,137.4,4908,2808,2100,133.7
34004, 읍부,030003, 27세,2017,5427,3101,2326,133.3,4785,2668,2117,126
34004, 읍부,030004, 28세,2017,5527,3173,2354,134.8,4879,2741,2138,128.2
34004, 읍부,030005, 29세,2017,5741,3247,2494,130.2,5084,2793,2291,121.9
34004, 읍부,035,30~34세,2017,31273,17326,13947,124.2,28256,15238,13018,117.1
34004, 읍부,035001, 30세,2017,5763,3212,2551,125.9,5092,2743,2349,116.8
34004, 읍부,035002, 31세,2017,5876,3296,2580,127.8,5230,2856,2374,120.3
34004, 읍부,035003, 32세,2017,5975,3329,2646,125.8,5343,2901,2442,118.8
34004, 읍부,035004, 33세,2017,6489,3546,2943,120.5,5963,3185,2778,114.7
34004, 읍부,035005, 34세,2017,7170,3943,3227,122.2,6628,3553,3075,115.5
34004, 읍부,040,35~39세,2017,39354,21334,18020,118.4,37151,19792,17359,114
34004, 읍부,040001, 35세,2017,7919,4231,3688,114.7,7423,3888,3535,110
34004, 읍부,040002, 36세,2017,7975,4448,3527,126.1,7528,4137,3391,122
34004, 읍부,040003, 37세,2017,8322,4530,3792,119.5,7847,4187,3660,114.4
34004, 읍부,040004, 38세,2017,7701,4094,3607,113.5,7310,3829,3481,110
34004, 읍부,040005, 39세,2017,7437,4031,3406,118.3,7043,3751,3292,113.9
34004, 읍부,045,40~44세,2017,39541,21235,18306,116,37908,20167,17741,113.7
34004, 읍부,045001, 40세,2017,7627,4104,3523,116.5,7266,3847,3419,112.5
34004, 읍부,045002, 41세,2017,7410,3977,3433,115.8,7084,3769,3315,113.7
34004, 읍부,045003, 42세,2017,7761,4114,3647,112.8,7412,3877,3535,109.7
34004, 읍부,045004, 43세,2017,8310,4485,3825,117.3,8025,4302,3723,115.6
34004, 읍부,045005, 44세,2017,8433,4555,3878,117.5,8121,4372,3749,116.6
34004, 읍부,050,45~49세,2017,42150,22901,19249,119,40707,22046,18661,118.1
34004, 읍부,050001, 45세,2017,8171,4478,3693,121.3,7857,4287,3570,120.1
34004, 읍부,050002, 46세,2017,8718,4767,3951,120.7,8433,4585,3848,119.2
34004, 읍부,050003, 47세,2017,8404,4544,3860,117.7,8097,4362,3735,116.8
34004, 읍부,050004, 48세,2017,8513,4599,3914,117.5,8253,4453,3800,117.2
34004, 읍부,050005, 49세,2017,8344,4513,3831,117.8,8067,4359,3708,117.6
34004, 읍부,055,50~54세,2017,37506,19929,17577,113.4,36323,19317,17006,113.6
34004, 읍부,055001, 50세,2017,7666,4109,3557,115.5,7448,3984,3464,115
34004, 읍부,055002, 51세,2017,7086,3795,3291,115.3,6867,3693,3174,116.4
34004, 읍부,055003, 52세,2017,8069,4283,3786,113.1,7800,4145,3655,113.4
34004, 읍부,055004, 53세,2017,7285,3847,3438,111.9,7060,3722,3338,111.5
34004, 읍부,055005, 54세,2017,7400,3895,3505,111.1,7148,3773,3375,111.8
34004, 읍부,060,55~59세,2017,40269,20603,19666,104.8,39431,20177,19254,104.8
34004, 읍부,060001, 55세,2017,7964,4263,3701,115.2,7744,4148,3596,115.4
34004, 읍부,060002, 56세,2017,8918,4593,4325,106.2,8775,4523,4252,106.4
34004, 읍부,060003, 57세,2017,8668,4375,4293,101.9,8494,4295,4199,102.3
34004, 읍부,060004, 58세,2017,7550,3755,3795,98.9,7396,3675,3721,98.8
34004, 읍부,060005, 59세,2017,7169,3617,3552,101.8,7022,3536,3486,101.4
34004, 읍부,065,60~64세,2017,31632,15738,15894,99,31010,15404,15606,98.7
34004, 읍부,065001, 60세,2017,7132,3695,3437,107.5,6971,3597,3374,106.6
34004, 읍부,065002, 61세,2017,6627,3324,3303,100.6,6495,3257,3238,100.6
34004, 읍부,065003, 62세,2017,6900,3379,3521,96,6781,3315,3466,95.6
34004, 읍부,065004, 63세,2017,6011,2914,3097,94.1,5896,2855,3041,93.9
34004, 읍부,065005, 64세,2017,4962,2426,2536,95.7,4867,2380,2487,95.7
34004, 읍부,070,65~69세,2017,24719,11918,12801,93.1,24478,11784,12694,92.8
34004, 읍부,070001, 65세,2017,5594,2664,2930,90.9,5522,2626,2896,90.7
34004, 읍부,070002, 66세,2017,4480,2173,2307,94.2,4420,2134,2286,93.4
34004, 읍부,070003, 67세,2017,4940,2366,2574,91.9,4894,2338,2556,91.5
34004, 읍부,070004, 68세,2017,4964,2417,2547,94.9,4920,2397,2523,95
34004, 읍부,070005, 69세,2017,4741,2298,2443,94.1,4722,2289,2433,94.1
34004, 읍부,075,70~74세,2017,19102,8866,10236,86.6,18986,8817,10169,86.7
34004, 읍부,075001, 70세,2017,4676,2271,2405,94.4,4638,2257,2381,94.8
34004, 읍부,075002, 71세,2017,3460,1698,1762,96.4,3428,1685,1743,96.7
34004, 읍부,075003, 72세,2017,3441,1623,1818,89.3,3422,1616,1806,89.5
34004, 읍부,075004, 73세,2017,3690,1596,2094,76.2,3674,1590,2084,76.3
34004, 읍부,075005, 74세,2017,3835,1678,2157,77.8,3824,1669,2155,77.4
34004, 읍부,080,75~79세,2017,18476,7579,10897,69.6,18415,7558,10857,69.6
34004, 읍부,080001, 75세,2017,4705,1994,2711,73.6,4693,1990,2703,73.6
34004, 읍부,080002, 76세,2017,3531,1443,2088,69.1,3521,1439,2082,69.1
34004, 읍부,080003, 77세,2017,3283,1362,1921,70.9,3265,1353,1912,70.8
34004, 읍부,080004, 78세,2017,3641,1458,2183,66.8,3634,1456,2178,66.9
34004, 읍부,080005, 79세,2017,3316,1322,1994,66.3,3302,1320,1982,66.6
34004, 읍부,085,80~84세,2017,12956,4721,8235,57.3,12927,4708,8219,57.3
34004, 읍부,085001, 80세,2017,3035,1161,1874,62,3026,1154,1872,61.6
34004, 읍부,085002, 81세,2017,2919,1114,1805,61.7,2911,1111,1800,61.7
34004, 읍부,085003, 82세,2017,2750,952,1798,52.9,2747,951,1796,53
34004, 읍부,085004, 83세,2017,2289,834,1455,57.3,2283,834,1449,57.6
34004, 읍부,085005, 84세,2017,1963,660,1303,50.7,1960,658,1302,50.5
34004, 읍부,090,85~89세,2017,5985,1772,4213,42.1,5973,1770,4203,42.1
34004, 읍부,090001, 85세,2017,1819,574,1245,46.1,1818,574,1244,46.1
34004, 읍부,090002, 86세,2017,1246,371,875,42.4,1244,371,873,42.5
34004, 읍부,090003, 87세,2017,1143,326,817,39.9,1139,325,814,39.9
34004, 읍부,090004, 88세,2017,968,287,681,42.1,966,287,679,42.3
34004, 읍부,090005, 89세,2017,809,214,595,36,806,213,593,35.9
34004, 읍부,095,90~94세,2017,1940,446,1494,29.9,1936,445,1491,29.8
34004, 읍부,095001, 90세,2017,617,156,461,33.8,615,155,460,33.7
34004, 읍부,095002, 91세,2017,426,109,317,34.4,426,109,317,34.4
34004, 읍부,095003, 92세,2017,372,78,294,26.5,372,78,294,26.5
34004, 읍부,095004, 93세,2017,272,54,218,24.8,272,54,218,24.8
34004, 읍부,095005, 94세,2017,253,49,204,24,251,49,202,24.3
34004, 읍부,100,95~99세,2017,459,99,360,27.5,458,99,359,27.6
34004, 읍부,100001, 95세,2017,195,38,157,24.2,194,38,156,24.4
34004, 읍부,100002, 96세,2017,118,32,86,37.2,118,32,86,37.2
34004, 읍부,100003, 97세,2017,63,14,49,28.6,63,14,49,28.6
34004, 읍부,100004, 98세,2017,45,10,35,28.6,45,10,35,28.6
34004, 읍부,100005, 99세,2017,38,5,33,15.2,38,5,33,15.2
34004, 읍부,101,100세이상,2017,46,X,42,9.5,46,X,42,9.5
34004, 읍부,102,15세미만,2017,70640,36400,34240,106.3,70262,36191,34071,106.2
34004, 읍부,103,15~64세,2017,352829,189127,163702,115.5,336272,178705,157567,113.4
34004, 읍부,104,65세이상,2017,83683,35405,48278,73.3,83219,35185,48034,73.3
34004, 읍부,086,85세이상,2017,8430,2321,6109,38,8413,2318,6095,38
34004, 읍부,126,평균연령,2017,42,40.6,43.5,,42.2,40.8,43.6,
34004, 읍부,127,중위연령,2017,42.8,41.3,44.4,,43.2,41.9,44.7,
34005, 면부,000,합계,2017,676350,353298,323052,109.4,635225,325533,309692,105.1
34005, 면부,005,0~4세,2017,19100,9723,9377,103.7,18717,9527,9190,103.7
34005, 면부,005001, 0세,2017,3234,1627,1607,101.2,3151,1591,1560,102
34005, 면부,005002, 1세,2017,3731,1902,1829,104,3632,1857,1775,104.6
34005, 면부,005003, 2세,2017,4023,2080,1943,107.1,3951,2042,1909,107
34005, 면부,005004, 3세,2017,4002,2009,1993,100.8,3926,1964,1962,100.1
34005, 면부,005005, 4세,2017,4110,2105,2005,105,4057,2073,1984,104.5
34005, 면부,010,5~9세,2017,21541,11158,10383,107.5,21292,11032,10260,107.5
34005, 면부,010001, 5세,2017,4463,2375,2088,113.7,4392,2332,2060,113.2
34005, 면부,010002, 6세,2017,4361,2259,2102,107.5,4310,2238,2072,108
34005, 면부,010003, 7세,2017,4285,2206,2079,106.1,4238,2185,2053,106.4
34005, 면부,010004, 8세,2017,4099,2136,1963,108.8,4060,2117,1943,109
34005, 면부,010005, 9세,2017,4333,2182,2151,101.4,4292,2160,2132,101.3
34005, 면부,015,10~14세,2017,20496,10667,9829,108.5,20350,10583,9767,108.4
34005, 면부,015001, 10세,2017,4390,2340,2050,114.1,4354,2316,2038,113.6
34005, 면부,015002, 11세,2017,4028,2064,1964,105.1,3999,2045,1954,104.7
34005, 면부,015003, 12세,2017,3757,1918,1839,104.3,3738,1906,1832,104
34005, 면부,015004, 13세,2017,4055,2091,1964,106.5,4014,2073,1941,106.8
34005, 면부,015005, 14세,2017,4266,2254,2012,112,4245,2243,2002,112
34005, 면부,020,15~19세,2017,33058,17724,15334,115.6,32285,17357,14928,116.3
34005, 면부,020001, 15세,2017,4301,2298,2003,114.7,4277,2284,1993,114.6
34005, 면부,020002, 16세,2017,5241,2805,2436,115.1,5205,2789,2416,115.4
34005, 면부,020003, 17세,2017,5745,3024,2721,111.1,5673,2985,2688,111
34005, 면부,020004, 18세,2017,7369,3943,3426,115.1,7214,3868,3346,115.6
34005, 면부,020005, 19세,2017,10402,5654,4748,119.1,9916,5431,4485,121.1
34005, 면부,025,20~24세,2017,44530,25434,19096,133.2,38281,21644,16637,130.1
34005, 면부,025001, 20세,2017,9014,4409,4605,95.7,8187,4041,4146,97.5
34005, 면부,025002, 21세,2017,8745,4477,4268,104.9,7629,3870,3759,103
34005, 면부,025003, 22세,2017,9259,5471,3788,144.4,7935,4673,3262,143.3
34005, 면부,025004, 23세,2017,8851,5629,3222,174.7,7378,4666,2712,172.1
34005, 면부,025005, 24세,2017,8661,5448,3213,169.6,7152,4394,2758,159.3
34005, 면부,030,25~29세,2017,37910,23917,13993,170.9,29468,17798,11670,152.5
34005, 면부,030001, 25세,2017,8345,5342,3003,177.9,6662,4139,2523,164.1
34005, 면부,030002, 26세,2017,7460,4661,2799,166.5,5893,3556,2337,152.2
34005, 면부,030003, 27세,2017,7609,4757,2852,166.8,5868,3504,2364,148.2
34005, 면부,030004, 28세,2017,7290,4656,2634,176.8,5591,3371,2220,151.8
34005, 면부,030005, 29세,2017,7206,4501,2705,166.4,5454,3228,2226,145
34005, 면부,035,30~34세,2017,36405,22316,14089,158.4,28869,16746,12123,138.1
34005, 면부,035001, 30세,2017,7257,4531,2726,166.2,5599,3307,2292,144.3
34005, 면부,035002, 31세,2017,7033,4386,2647,165.7,5472,3253,2219,146.6
34005, 면부,035003, 32세,2017,7106,4330,2776,156,5577,3199,2378,134.5
34005, 면부,035004, 33세,2017,7206,4388,2818,155.7,5790,3324,2466,134.8
34005, 면부,035005, 34세,2017,7803,4681,3122,149.9,6431,3663,2768,132.3
34005, 면부,040,35~39세,2017,40062,24109,15953,151.1,34570,20010,14560,137.4
34005, 면부,040001, 35세,2017,8357,5090,3267,155.8,7071,4122,2949,139.8
34005, 면부,040002, 36세,2017,8213,4922,3291,149.6,7060,4051,3009,134.6
34005, 면부,040003, 37세,2017,8319,4934,3385,145.8,7227,4134,3093,133.7
34005, 면부,040004, 38세,2017,7809,4668,3141,148.6,6791,3904,2887,135.2
34005, 면부,040005, 39세,2017,7364,4495,2869,156.7,6421,3799,2622,144.9
34005, 면부,045,40~44세,2017,39310,23377,15933,146.7,35765,20886,14879,140.4
34005, 면부,045001, 40세,2017,7460,4481,2979,150.4,6609,3857,2752,140.2
34005, 면부,045002, 41세,2017,7415,4431,2984,148.5,6669,3903,2766,141.1
34005, 면부,045003, 42세,2017,7590,4470,3120,143.3,6931,4005,2926,136.9
34005, 면부,045004, 43세,2017,8383,5032,3351,150.2,7690,4554,3136,145.2
34005, 면부,045005, 44세,2017,8462,4963,3499,141.8,7866,4567,3299,138.4
34005, 면부,050,45~49세,2017,45430,26233,19197,136.7,42287,24197,18090,133.8
34005, 면부,050001, 45세,2017,8456,5016,3440,145.8,7734,4513,3221,140.1
34005, 면부,050002, 46세,2017,9292,5467,3825,142.9,8609,5013,3596,139.4
34005, 면부,050003, 47세,2017,8638,4997,3641,137.2,8017,4611,3406,135.4
34005, 면부,050004, 48세,2017,9488,5415,4073,132.9,8912,5062,3850,131.5
34005, 면부,050005, 49세,2017,9556,5338,4218,126.6,9015,4998,4017,124.4
34005, 면부,055,50~54세,2017,47456,25940,21516,120.6,45136,24588,20548,119.7
34005, 면부,055001, 50세,2017,8957,4952,4005,123.6,8499,4683,3816,122.7
34005, 면부,055002, 51세,2017,8611,4746,3865,122.8,8174,4490,3684,121.9
34005, 면부,055003, 52세,2017,10252,5642,4610,122.4,9760,5359,4401,121.8
34005, 면부,055004, 53세,2017,9585,5187,4398,117.9,9146,4922,4224,116.5
34005, 면부,055005, 54세,2017,10051,5413,4638,116.7,9557,5134,4423,116.1
34005, 면부,060,55~59세,2017,61096,31483,29613,106.3,59637,30674,28963,105.9
34005, 면부,060001, 55세,2017,11365,6025,5340,112.8,10989,5812,5177,112.3
34005, 면부,060002, 56세,2017,13167,6805,6362,107,12911,6675,6236,107
34005, 면부,060003, 57세,2017,13402,6835,6567,104.1,13062,6639,6423,103.4
34005, 면부,060004, 58세,2017,11741,6018,5723,105.2,11506,5894,5612,105
34005, 면부,060005, 59세,2017,11421,5800,5621,103.2,11169,5654,5515,102.5
34005, 면부,065,60~64세,2017,53637,27050,26587,101.7,52808,26572,26236,101.3
34005, 면부,065001, 60세,2017,11368,5827,5541,105.2,11145,5688,5457,104.2
34005, 면부,065002, 61세,2017,11291,5747,5544,103.7,11103,5643,5460,103.4
34005, 면부,065003, 62세,2017,11896,6037,5859,103,11721,5939,5782,102.7
34005, 면부,065004, 63세,2017,10427,5152,5275,97.7,10284,5075,5209,97.4
34005, 면부,065005, 64세,2017,8655,4287,4368,98.1,8555,4227,4328,97.7
34005, 면부,070,65~69세,2017,45635,22596,23039,98.1,45321,22435,22886,98
34005, 면부,070001, 65세,2017,9876,4891,4985,98.1,9783,4849,4934,98.3
34005, 면부,070002, 66세,2017,8112,4028,4084,98.6,8052,3989,4063,98.2
34005, 면부,070003, 67세,2017,9395,4623,4772,96.9,9332,4590,4742,96.8
34005, 면부,070004, 68세,2017,9474,4741,4733,100.2,9418,4716,4702,100.3
34005, 면부,070005, 69세,2017,8778,4313,4465,96.6,8736,4291,4445,96.5
34005, 면부,075,70~74세,2017,36922,17081,19841,86.1,36811,17031,19780,86.1
34005, 면부,075001, 70세,2017,8646,4219,4427,95.3,8620,4207,4413,95.3
34005, 면부,075002, 71세,2017,6240,3085,3155,97.8,6211,3072,3139,97.9
34005, 면부,075003, 72세,2017,6656,3041,3615,84.1,6635,3033,3602,84.2
34005, 면부,075004, 73세,2017,7534,3285,4249,77.3,7515,3278,4237,77.4
34005, 면부,075005, 74세,2017,7846,3451,4395,78.5,7830,3441,4389,78.4
34005, 면부,080,75~79세,2017,42004,17063,24941,68.4,41928,17039,24889,68.5
34005, 면부,080001, 75세,2017,10447,4440,6007,73.9,10434,4437,5997,74
34005, 면부,080002, 76세,2017,7881,3285,4596,71.5,7864,3277,4587,71.4
34005, 면부,080003, 77세,2017,7422,3023,4399,68.7,7406,3016,4390,68.7
34005, 면부,080004, 78세,2017,8410,3323,5087,65.3,8397,3319,5078,65.4
34005, 면부,080005, 79세,2017,7844,2992,4852,61.7,7827,2990,4837,61.8
34005, 면부,085,80~84세,2017,31732,11750,19982,58.8,31693,11743,19950,58.9
34005, 면부,085001, 80세,2017,7233,2837,4396,64.5,7221,2837,4384,64.7
34005, 면부,085002, 81세,2017,7113,2736,4377,62.5,7104,2734,4370,62.6
34005, 면부,085003, 82세,2017,6744,2426,4318,56.2,6737,2425,4312,56.2
34005, 면부,085004, 83세,2017,5708,2042,3666,55.7,5702,2039,3663,55.7
34005, 면부,085005, 84세,2017,4934,1709,3225,53,4929,1708,3221,53
34005, 면부,090,85~89세,2017,14493,4376,10117,43.3,14478,4372,10106,43.3
34005, 면부,090001, 85세,2017,4400,1479,2921,50.6,4398,1478,2920,50.6
34005, 면부,090002, 86세,2017,3064,943,2121,44.5,3059,941,2118,44.4
34005, 면부,090003, 87세,2017,2755,804,1951,41.2,2749,804,1945,41.3
34005, 면부,090004, 88세,2017,2352,645,1707,37.8,2350,644,1706,37.7
34005, 면부,090005, 89세,2017,1922,505,1417,35.6,1922,505,1417,35.6
34005, 면부,095,90~94세,2017,4407,1115,3292,33.9,4404,1114,3290,33.9
34005, 면부,095001, 90세,2017,1447,409,1038,39.4,1446,409,1037,39.4
34005, 면부,095002, 91세,2017,984,234,750,31.2,984,234,750,31.2
34005, 면부,095003, 92세,2017,811,222,589,37.7,811,222,589,37.7
34005, 면부,095004, 93세,2017,568,126,442,28.5,567,125,442,28.3
34005, 면부,095005, 94세,2017,597,124,473,26.2,596,124,472,26.3
34005, 면부,100,95~99세,2017,1011,171,840,20.4,1010,170,840,20.2
34005, 면부,100001, 95세,2017,428,69,359,19.2,428,69,359,19.2
34005, 면부,100002, 96세,2017,238,53,185,28.6,238,53,185,28.6
34005, 면부,100003, 97세,2017,171,24,147,16.3,170,23,147,15.6
34005, 면부,100004, 98세,2017,105,15,90,16.7,105,15,90,16.7
34005, 면부,100005, 99세,2017,69,10,59,16.9,69,10,59,16.9
34005, 면부,101,100세이상,2017,115,15,100,15,115,15,100,15
34005, 면부,102,15세미만,2017,61137,31548,29589,106.6,60359,31142,29217,106.6
34005, 면부,103,15~64세,2017,438894,247583,191311,129.4,399106,220472,178634,123.4
34005, 면부,104,65세이상,2017,176319,74167,102152,72.6,175760,73919,101841,72.6
34005, 면부,086,85세이상,2017,20026,5677,14349,39.6,20007,5671,14336,39.6
34005, 면부,126,평균연령,2017,47.9,45.5,50.5,,48.7,46.4,51.1,
34005, 면부,127,중위연령,2017,50,46.6,54.3,,51.9,48.6,55.4,
34003, 동부,000,합계,2017,978924,494380,484544,102,952696,480894,471802,101.9
34003, 동부,005,0~4세,2017,51574,26281,25293,103.9,50911,25955,24956,104
34003, 동부,005001, 0세,2017,9200,4752,4448,106.8,9032,4663,4369,106.7
34003, 동부,005002, 1세,2017,10300,5206,5094,102.2,10149,5133,5016,102.3
34003, 동부,005003, 2세,2017,10740,5434,5306,102.4,10591,5371,5220,102.9
34003, 동부,005004, 3세,2017,10441,5368,5073,105.8,10337,5309,5028,105.6
34003, 동부,005005, 4세,2017,10893,5521,5372,102.8,10802,5479,5323,102.9
34003, 동부,010,5~9세,2017,55324,28504,26820,106.3,55035,28341,26694,106.2
34003, 동부,010001, 5세,2017,11600,5901,5699,103.5,11506,5844,5662,103.2
34003, 동부,010002, 6세,2017,11470,5981,5489,109,11410,5948,5462,108.9
34003, 동부,010003, 7세,2017,10991,5696,5295,107.6,10930,5658,5272,107.3
34003, 동부,010004, 8세,2017,10357,5299,5058,104.8,10317,5278,5039,104.7
34003, 동부,010005, 9세,2017,10906,5627,5279,106.6,10872,5613,5259,106.7
34003, 동부,015,10~14세,2017,52588,27301,25287,108,52430,27216,25214,107.9
34003, 동부,015001, 10세,2017,11039,5725,5314,107.7,10998,5699,5299,107.5
34003, 동부,015002, 11세,2017,10172,5278,4894,107.8,10139,5264,4875,108
34003, 동부,015003, 12세,2017,9993,5199,4794,108.4,9964,5182,4782,108.4
34003, 동부,015004, 13세,2017,10812,5677,5135,110.6,10779,5661,5118,110.6
34003, 동부,015005, 14세,2017,10572,5422,5150,105.3,10550,5410,5140,105.3
34003, 동부,020,15~19세,2017,64358,33354,31004,107.6,63658,33064,30594,108.1
34003, 동부,020001, 15세,2017,11004,5775,5229,110.4,10980,5764,5216,110.5
34003, 동부,020002, 16세,2017,12733,6748,5985,112.7,12697,6731,5966,112.8
34003, 동부,020003, 17세,2017,13752,7358,6394,115.1,13681,7333,6348,115.5
34003, 동부,020004, 18세,2017,12813,6539,6274,104.2,12586,6439,6147,104.8
34003, 동부,020005, 19세,2017,14056,6934,7122,97.4,13714,6797,6917,98.3
34003, 동부,025,20~24세,2017,72449,36737,35712,102.9,70289,35792,34497,103.8
34003, 동부,025001, 20세,2017,14678,6999,7679,91.1,14353,6870,7483,91.8
34003, 동부,025002, 21세,2017,14775,7417,7358,100.8,14377,7252,7125,101.8
34003, 동부,025003, 22세,2017,14492,7284,7208,101.1,14079,7103,6976,101.8
34003, 동부,025004, 23세,2017,14309,7535,6774,111.2,13804,7312,6492,112.6
34003, 동부,025005, 24세,2017,14195,7502,6693,112.1,13676,7255,6421,113
34003, 동부,030,25~29세,2017,66787,35267,31520,111.9,63244,33430,29814,112.1
34003, 동부,030001, 25세,2017,14327,7549,6778,111.4,13740,7243,6497,111.5
34003, 동부,030002, 26세,2017,13060,6886,6174,111.5,12373,6548,5825,112.4
34003, 동부,030003, 27세,2017,12891,6850,6041,113.4,12156,6460,5696,113.4
34003, 동부,030004, 28세,2017,12930,6890,6040,114.1,12197,6498,5699,114
34003, 동부,030005, 29세,2017,13579,7092,6487,109.3,12778,6681,6097,109.6
34003, 동부,035,30~34세,2017,75219,39386,35833,109.9,71396,37367,34029,109.8
34003, 동부,035001, 30세,2017,14060,7317,6743,108.5,13240,6907,6333,109.1
34003, 동부,035002, 31세,2017,14377,7498,6879,109,13559,7083,6476,109.4
34003, 동부,035003, 32세,2017,14496,7722,6774,114,13732,7302,6430,113.6
34003, 동부,035004, 33세,2017,15309,7942,7367,107.8,14546,7527,7019,107.2
34003, 동부,035005, 34세,2017,16977,8907,8070,110.4,16319,8548,7771,110
34003, 동부,040,35~39세,2017,88320,45926,42394,108.3,85351,44196,41155,107.4
34003, 동부,040001, 35세,2017,18517,9586,8931,107.3,17810,9207,8603,107
34003, 동부,040002, 36세,2017,18084,9472,8612,110,17508,9152,8356,109.5
34003, 동부,040003, 37세,2017,18618,9599,9019,106.4,18021,9233,8788,105.1
34003, 동부,040004, 38세,2017,17300,8953,8347,107.3,16711,8599,8112,106
34003, 동부,040005, 39세,2017,15801,8316,7485,111.1,15301,8005,7296,109.7
34003, 동부,045,40~44세,2017,83830,42373,41457,102.2,81442,40996,40446,101.4
34003, 동부,045001, 40세,2017,16186,8260,7926,104.2,15724,8008,7716,103.8
34003, 동부,045002, 41세,2017,15777,7957,7820,101.8,15290,7662,7628,100.4
34003, 동부,045003, 42세,2017,16344,8139,8205,99.2,15873,7867,8006,98.3
34003, 동부,045004, 43세,2017,17813,9053,8760,103.3,17376,8796,8580,102.5
34003, 동부,045005, 44세,2017,17710,8964,8746,102.5,17179,8663,8516,101.7
34003, 동부,050,45~49세,2017,87771,44534,43237,103,85020,43076,41944,102.7
34003, 동부,050001, 45세,2017,16651,8496,8155,104.2,16106,8200,7906,103.7
34003, 동부,050002, 46세,2017,18418,9478,8940,106,17843,9167,8676,105.7
34003, 동부,050003, 47세,2017,17293,8871,8422,105.3,16725,8560,8165,104.8
34003, 동부,050004, 48세,2017,17923,9026,8897,101.4,17371,8744,8627,101.4
34003, 동부,050005, 49세,2017,17486,8663,8823,98.2,16975,8405,8570,98.1
34003, 동부,055,50~54세,2017,73160,37649,35511,106,70616,36391,34225,106.3
34003, 동부,055001, 50세,2017,15622,7872,7750,101.6,15154,7635,7519,101.5
34003, 동부,055002, 51세,2017,14075,7345,6730,109.1,13582,7104,6478,109.7
34003, 동부,055003, 52세,2017,15681,7963,7718,103.2,15127,7694,7433,103.5
34003, 동부,055004, 53세,2017,13719,7141,6578,108.6,13280,6931,6349,109.2
34003, 동부,055005, 54세,2017,14063,7328,6735,108.8,13473,7027,6446,109
34003, 동부,060,55~59세,2017,67971,34744,33227,104.6,66313,33971,32342,105
34003, 동부,060001, 55세,2017,14557,7672,6885,111.4,14142,7478,6664,112.2
34003, 동부,060002, 56세,2017,15444,8043,7401,108.7,15159,7893,7266,108.6
34003, 동부,060003, 57세,2017,14480,7254,7226,100.4,14130,7103,7027,101.1
34003, 동부,060004, 58세,2017,12252,6068,6184,98.1,11947,5940,6007,98.9
34003, 동부,060005, 59세,2017,11238,5707,5531,103.2,10935,5557,5378,103.3
34003, 동부,065,60~64세,2017,45557,22765,22792,99.9,44028,22006,22022,99.9
34003, 동부,065001, 60세,2017,10735,5499,5236,105,10353,5290,5063,104.5
34003, 동부,065002, 61세,2017,9855,4952,4903,101,9528,4790,4738,101.1
34003, 동부,065003, 62세,2017,10075,5004,5071,98.7,9769,4860,4909,99
34003, 동부,065004, 63세,2017,8225,4007,4218,95,7956,3874,4082,94.9
34003, 동부,065005, 64세,2017,6667,3303,3364,98.2,6422,3192,3230,98.8
34003, 동부,070,65~69세,2017,31116,14964,16152,92.6,30507,14655,15852,92.4
34003, 동부,070001, 65세,2017,7575,3651,3924,93,7388,3552,3836,92.6
34003, 동부,070002, 66세,2017,5447,2720,2727,99.7,5309,2639,2670,98.8
34003, 동부,070003, 67세,2017,6258,2962,3296,89.9,6142,2909,3233,90
34003, 동부,070004, 68세,2017,6132,2928,3204,91.4,6029,2878,3151,91.3
34003, 동부,070005, 69세,2017,5704,2703,3001,90.1,5639,2677,2962,90.4
34003, 동부,075,70~74세,2017,22094,10046,12048,83.4,21866,9954,11912,83.6
34003, 동부,075001, 70세,2017,5541,2600,2941,88.4,5476,2573,2903,88.6
34003, 동부,075002, 71세,2017,4110,1986,2124,93.5,4054,1966,2088,94.2
34003, 동부,075003, 72세,2017,3996,1780,2216,80.3,3962,1763,2199,80.2
34003, 동부,075004, 73세,2017,4321,1864,2457,75.9,4278,1845,2433,75.8
34003, 동부,075005, 74세,2017,4126,1816,2310,78.6,4096,1807,2289,78.9
34003, 동부,080,75~79세,2017,19644,7857,11787,66.7,19531,7822,11709,66.8
34003, 동부,080001, 75세,2017,5190,2103,3087,68.1,5170,2095,3075,68.1
34003, 동부,080002, 76세,2017,3869,1584,2285,69.3,3835,1572,2263,69.5
34003, 동부,080003, 77세,2017,3513,1408,2105,66.9,3489,1402,2087,67.2
34003, 동부,080004, 78세,2017,3691,1458,2233,65.3,3674,1454,2220,65.5
34003, 동부,080005, 79세,2017,3381,1304,2077,62.8,3363,1299,2064,62.9
34003, 동부,085,80~84세,2017,12865,4540,8325,54.5,12792,4519,8273,54.6
34003, 동부,085001, 80세,2017,3196,1195,2001,59.7,3172,1191,1981,60.1
34003, 동부,085002, 81세,2017,2852,997,1855,53.7,2840,992,1848,53.7
34003, 동부,085003, 82세,2017,2700,928,1772,52.4,2682,922,1760,52.4
34003, 동부,085004, 83세,2017,2213,789,1424,55.4,2201,784,1417,55.3
34003, 동부,085005, 84세,2017,1904,631,1273,49.6,1897,630,1267,49.7
34003, 동부,090,85~89세,2017,5923,1649,4274,38.6,5894,1640,4254,38.6
34003, 동부,090001, 85세,2017,1771,547,1224,44.7,1762,545,1217,44.8
34003, 동부,090002, 86세,2017,1240,341,899,37.9,1231,338,893,37.8
34003, 동부,090003, 87세,2017,1113,300,813,36.9,1109,299,810,36.9
34003, 동부,090004, 88세,2017,986,243,743,32.7,981,240,741,32.4
34003, 동부,090005, 89세,2017,813,218,595,36.6,811,218,593,36.8
34003, 동부,095,90~94세,2017,1866,400,1466,27.3,1865,400,1465,27.3
34003, 동부,095001, 90세,2017,608,126,482,26.1,607,126,481,26.2
34003, 동부,095002, 91세,2017,453,105,348,30.2,453,105,348,30.2
34003, 동부,095003, 92세,2017,353,82,271,30.3,353,82,271,30.3
34003, 동부,095004, 93세,2017,246,46,200,23,246,46,200,23
34003, 동부,095005, 94세,2017,206,41,165,24.8,206,41,165,24.8
34003, 동부,100,95~99세,2017,447,96,351,27.4,447,96,351,27.4
34003, 동부,100001, 95세,2017,164,38,126,30.2,164,38,126,30.2
34003, 동부,100002, 96세,2017,108,20,88,22.7,108,20,88,22.7
34003, 동부,100003, 97세,2017,88,17,71,23.9,88,17,71,23.9
34003, 동부,100004, 98세,2017,54,13,41,31.7,54,13,41,31.7
34003, 동부,100005, 99세,2017,33,8,25,32,33,8,25,32
34003, 동부,101,100세이상,2017,61,7,54,13,61,7,54,13
34003, 동부,102,15세미만,2017,159486,82086,77400,106.1,158376,81512,76864,106
34003, 동부,103,15~64세,2017,725422,372735,352687,105.7,701357,360289,341068,105.6
34003, 동부,104,65세이상,2017,94016,39559,54457,72.6,92963,39093,53870,72.6
34003, 동부,086,85세이상,2017,8297,2152,6145,35,8267,2143,6124,35
34003, 동부,126,평균연령,2017,37.7,36.8,38.5,,37.6,36.8,38.5,
34003, 동부,127,중위연령,2017,37.8,37.1,38.5,,37.8,37.1,38.5,
34010, 천안시,000,합계,2017,656294,336476,319818,105.2,630747,321063,309684,103.7
34010, 천안시,005,0~4세,2017,32079,16371,15708,104.2,31614,16132,15482,104.2
34010, 천안시,005001, 0세,2017,5661,2933,2728,107.5,5547,2869,2678,107.1
34010, 천안시,005002, 1세,2017,6439,3253,3186,102.1,6331,3200,3131,102.2
34010, 천안시,005003, 2세,2017,6761,3451,3310,104.3,6662,3411,3251,104.9
34010, 천안시,005004, 3세,2017,6513,3329,3184,104.6,6438,3284,3154,104.1
34010, 천안시,005005, 4세,2017,6705,3405,3300,103.2,6636,3368,3268,103.1
34010, 천안시,010,5~9세,2017,33997,17537,16460,106.5,33772,17418,16354,106.5
34010, 천안시,010001, 5세,2017,7224,3641,3583,101.6,7163,3609,3554,101.5
34010, 천안시,010002, 6세,2017,6947,3609,3338,108.1,6900,3584,3316,108.1
34010, 천안시,010003, 7세,2017,6713,3474,3239,107.3,6651,3439,3212,107.1
34010, 천안시,010004, 8세,2017,6422,3328,3094,107.6,6392,3314,3078,107.7
34010, 천안시,010005, 9세,2017,6691,3485,3206,108.7,6666,3472,3194,108.7
34010, 천안시,015,10~14세,2017,32246,16753,15493,108.1,32126,16692,15434,108.2
34010, 천안시,015001, 10세,2017,6789,3483,3306,105.4,6755,3465,3290,105.3
34010, 천안시,015002, 11세,2017,6200,3240,2960,109.5,6176,3232,2944,109.8
34010, 천안시,015003, 12세,2017,6157,3178,2979,106.7,6130,3162,2968,106.5
34010, 천안시,015004, 13세,2017,6627,3502,3125,112.1,6605,3489,3116,112
34010, 천안시,015005, 14세,2017,6473,3350,3123,107.3,6460,3344,3116,107.3
34010, 천안시,020,15~19세,2017,43070,22237,20833,106.7,42362,21927,20435,107.3
34010, 천안시,020001, 15세,2017,6726,3517,3209,109.6,6712,3508,3204,109.5
34010, 천안시,020002, 16세,2017,7901,4126,3775,109.3,7877,4111,3766,109.2
34010, 천안시,020003, 17세,2017,8435,4556,3879,117.5,8378,4538,3840,118.2
34010, 천안시,020004, 18세,2017,8821,4480,4341,103.2,8597,4384,4213,104.1
34010, 천안시,020005, 19세,2017,11187,5558,5629,98.7,10798,5386,5412,99.5
34010, 천안시,025,20~24세,2017,54718,27945,26773,104.4,51889,26329,25560,103
34010, 천안시,025001, 20세,2017,10922,5009,5913,84.7,10497,4808,5689,84.5
34010, 천안시,025002, 21세,2017,10870,5314,5556,95.6,10303,5023,5280,95.1
34010, 천안시,025003, 22세,2017,10984,5706,5278,108.1,10443,5388,5055,106.6
34010, 천안시,025004, 23세,2017,10903,5918,4985,118.7,10291,5546,4745,116.9
34010, 천안시,025005, 24세,2017,11039,5998,5041,119,10355,5564,4791,116.1
34010, 천안시,030,25~29세,2017,49596,26860,22736,118.1,45341,24062,21279,113.1
34010, 천안시,030001, 25세,2017,10972,6002,4970,120.8,10200,5479,4721,116.1
34010, 천안시,030002, 26세,2017,9641,5166,4475,115.4,8852,4680,4172,112.2
34010, 천안시,030003, 27세,2017,9548,5201,4347,119.6,8646,4596,4050,113.5
34010, 천안시,030004, 28세,2017,9427,5129,4298,119.3,8546,4523,4023,112.4
34010, 천안시,030005, 29세,2017,10008,5362,4646,115.4,9097,4784,4313,110.9
34010, 천안시,035,30~34세,2017,53164,28753,24411,117.8,49054,26036,23018,113.1
34010, 천안시,035001, 30세,2017,10255,5470,4785,114.3,9309,4863,4446,109.4
34010, 천안시,035002, 31세,2017,10288,5619,4669,120.3,9442,5071,4371,116
34010, 천안시,035003, 32세,2017,10225,5591,4634,120.7,9420,5051,4369,115.6
34010, 천안시,035004, 33세,2017,10652,5770,4882,118.2,9862,5234,4628,113.1
34010, 천안시,035005, 34세,2017,11744,6303,5441,115.8,11021,5817,5204,111.8
34010, 천안시,040,35~39세,2017,58898,31693,27205,116.5,55875,29643,26232,113
34010, 천안시,040001, 35세,2017,12532,6690,5842,114.5,11834,6224,5610,110.9
34010, 천안시,040002, 36세,2017,12174,6608,5566,118.7,11549,6188,5361,115.4
34010, 천안시,040003, 37세,2017,12360,6630,5730,115.7,11723,6202,5521,112.3
34010, 천안시,040004, 38세,2017,11384,6071,5313,114.3,10815,5686,5129,110.9
34010, 천안시,040005, 39세,2017,10448,5694,4754,119.8,9954,5343,4611,115.9
34010, 천안시,045,40~44세,2017,54847,28330,26517,106.8,52545,26859,25686,104.6
34010, 천안시,045001, 40세,2017,10668,5641,5027,112.2,10155,5297,4858,109
34010, 천안시,045002, 41세,2017,10372,5368,5004,107.3,9913,5073,4840,104.8
34010, 천안시,045003, 42세,2017,10782,5457,5325,102.5,10315,5150,5165,99.7
34010, 천안시,045004, 43세,2017,11602,5960,5642,105.6,11194,5702,5492,103.8
34010, 천안시,045005, 44세,2017,11423,5904,5519,107,10968,5637,5331,105.7
34010, 천안시,050,45~49세,2017,58046,29720,28326,104.9,55687,28350,27337,103.7
34010, 천안시,050001, 45세,2017,10990,5601,5389,103.9,10503,5312,5191,102.3
34010, 천안시,050002, 46세,2017,11990,6208,5782,107.4,11513,5926,5587,106.1
34010, 천안시,050003, 47세,2017,11511,5935,5576,106.4,11043,5655,5388,105
34010, 천안시,050004, 48세,2017,11866,6051,5815,104.1,11386,5791,5595,103.5
34010, 천안시,050005, 49세,2017,11689,5925,5764,102.8,11242,5666,5576,101.6
34010, 천안시,055,50~54세,2017,49323,25469,23854,106.8,47295,24365,22930,106.3
34010, 천안시,055001, 50세,2017,10360,5183,5177,100.1,9976,4964,5012,99
34010, 천안시,055002, 51세,2017,9572,4983,4589,108.6,9179,4769,4410,108.1
34010, 천안시,055003, 52세,2017,10572,5492,5080,108.1,10126,5246,4880,107.5
34010, 천안시,055004, 53세,2017,9226,4755,4471,106.4,8886,4585,4301,106.6
34010, 천안시,055005, 54세,2017,9593,5056,4537,111.4,9128,4801,4327,111
34010, 천안시,060,55~59세,2017,45908,23959,21949,109.2,44577,23287,21290,109.4
34010, 천안시,060001, 55세,2017,9833,5294,4539,116.6,9460,5105,4355,117.2
34010, 천안시,060002, 56세,2017,10397,5459,4938,110.6,10185,5345,4840,110.4
34010, 천안시,060003, 57세,2017,9890,5072,4818,105.3,9619,4943,4676,105.7
34010, 천안시,060004, 58세,2017,8290,4216,4074,103.5,8059,4108,3951,104
34010, 천안시,060005, 59세,2017,7498,3918,3580,109.4,7254,3786,3468,109.2
34010, 천안시,065,60~64세,2017,29904,15242,14662,104,28804,14668,14136,103.8
34010, 천안시,065001, 60세,2017,7127,3732,3395,109.9,6850,3572,3278,109
34010, 천안시,065002, 61세,2017,6454,3298,3156,104.5,6221,3183,3038,104.8
34010, 천안시,065003, 62세,2017,6638,3342,3296,101.4,6413,3223,3190,101
34010, 천안시,065004, 63세,2017,5303,2629,2674,98.3,5112,2532,2580,98.1
34010, 천안시,065005, 64세,2017,4382,2241,2141,104.7,4208,2158,2050,105.3
34010, 천안시,070,65~69세,2017,19691,9670,10021,96.5,19281,9451,9830,96.1
34010, 천안시,070001, 65세,2017,4966,2459,2507,98.1,4848,2392,2456,97.4
34010, 천안시,070002, 66세,2017,3465,1751,1714,102.2,3365,1694,1671,101.4
34010, 천안시,070003, 67세,2017,3869,1847,2022,91.3,3798,1809,1989,91
34010, 천안시,070004, 68세,2017,3801,1846,1955,94.4,3729,1811,1918,94.4
34010, 천안시,070005, 69세,2017,3590,1767,1823,96.9,3541,1745,1796,97.2
34010, 천안시,075,70~74세,2017,14042,6372,7670,83.1,13904,6325,7579,83.5
34010, 천안시,075001, 70세,2017,3520,1629,1891,86.1,3480,1618,1862,86.9
34010, 천안시,075002, 71세,2017,2579,1261,1318,95.7,2544,1252,1292,96.9
34010, 천안시,075003, 72세,2017,2539,1162,1377,84.4,2517,1153,1364,84.5
34010, 천안시,075004, 73세,2017,2734,1190,1544,77.1,2709,1178,1531,76.9
34010, 천안시,075005, 74세,2017,2670,1130,1540,73.4,2654,1124,1530,73.5
34010, 천안시,080,75~79세,2017,12709,5110,7599,67.2,12625,5079,7546,67.3
34010, 천안시,080001, 75세,2017,3229,1329,1900,69.9,3211,1323,1888,70.1
34010, 천안시,080002, 76세,2017,2469,1014,1455,69.7,2447,1003,1444,69.5
34010, 천안시,080003, 77세,2017,2355,971,1384,70.2,2336,963,1373,70.1
34010, 천안시,080004, 78세,2017,2453,949,1504,63.1,2444,948,1496,63.4
34010, 천안시,080005, 79세,2017,2203,847,1356,62.5,2187,842,1345,62.6
34010, 천안시,085,80~84세,2017,8425,2947,5478,53.8,8382,2935,5447,53.9
34010, 천안시,085001, 80세,2017,2055,757,1298,58.3,2037,752,1285,58.5
34010, 천안시,085002, 81세,2017,1842,650,1192,54.5,1836,647,1189,54.4
34010, 천안시,085003, 82세,2017,1772,593,1179,50.3,1765,592,1173,50.5
34010, 천안시,085004, 83세,2017,1524,540,984,54.9,1515,538,977,55.1
34010, 천안시,085005, 84세,2017,1232,407,825,49.3,1229,406,823,49.3
34010, 천안시,090,85~89세,2017,3965,1126,2839,39.7,3948,1123,2825,39.8
34010, 천안시,090001, 85세,2017,1171,352,819,43,1167,351,816,43
34010, 천안시,090002, 86세,2017,849,235,614,38.3,841,233,608,38.3
34010, 천안시,090003, 87세,2017,747,229,518,44.2,745,229,516,44.4
34010, 천안시,090004, 88세,2017,648,167,481,34.7,646,167,479,34.9
34010, 천안시,090005, 89세,2017,550,143,407,35.1,549,143,406,35.2
34010, 천안시,095,90~94세,2017,1320,309,1011,30.6,1320,309,1011,30.6
34010, 천안시,095001, 90세,2017,432,97,335,29,432,97,335,29
34010, 천안시,095002, 91세,2017,284,56,228,24.6,284,56,228,24.6
34010, 천안시,095003, 92세,2017,258,68,190,35.8,258,68,190,35.8
34010, 천안시,095004, 93세,2017,177,46,131,35.1,177,46,131,35.1
34010, 천안시,095005, 94세,2017,169,42,127,33.1,169,42,127,33.1
34010, 천안시,100,95~99세,2017,312,70,242,28.9,312,70,242,28.9
34010, 천안시,100001, 95세,2017,127,31,96,32.3,127,31,96,32.3
34010, 천안시,100002, 96세,2017,77,23,54,42.6,77,23,54,42.6
34010, 천안시,100003, 97세,2017,53,9,44,20.5,53,9,44,20.5
34010, 천안시,100004, 98세,2017,34,6,28,21.4,34,6,28,21.4
34010, 천안시,100005, 99세,2017,21,X,20,5,21,X,20,5
34010, 천안시,101,100세이상,2017,34,X,31,9.7,34,X,31,9.7
34010, 천안시,102,15세미만,2017,98322,50661,47661,106.3,97512,50242,47270,106.3
34010, 천안시,103,15~64세,2017,497474,260208,237266,109.7,473429,245526,227903,107.7
34010, 천안시,104,65세이상,2017,60498,25607,34891,73.4,59806,25295,34511,73.3
34010, 천안시,086,85세이상,2017,5631,1508,4123,36.6,5614,1505,4109,36.6
34010, 천안시,126,평균연령,2017,37.7,36.9,38.5,,37.7,36.9,38.5,
34010, 천안시,127,중위연령,2017,37.4,36.8,38.1,,37.5,36.9,38.2,
34011, 동남구,000,합계,2017,273839,139765,134074,104.2,262308,132933,129375,102.8
34011, 동남구,005,0~4세,2017,10754,5546,5208,106.5,10558,5444,5114,106.5
34011, 동남구,005001, 0세,2017,1717,894,823,108.6,1667,868,799,108.6
34011, 동남구,005002, 1세,2017,2075,1068,1007,106.1,2028,1041,987,105.5
34011, 동남구,005003, 2세,2017,2295,1165,1130,103.1,2250,1146,1104,103.8
34011, 동남구,005004, 3세,2017,2237,1173,1064,110.2,2207,1158,1049,110.4
34011, 동남구,005005, 4세,2017,2430,1246,1184,105.2,2406,1231,1175,104.8
34011, 동남구,010,5~9세,2017,12990,6700,6290,106.5,12898,6652,6246,106.5
34011, 동남구,010001, 5세,2017,2596,1327,1269,104.6,2574,1312,1262,104
34011, 동남구,010002, 6세,2017,2642,1374,1268,108.4,2622,1364,1258,108.4
34011, 동남구,010003, 7세,2017,2568,1326,1242,106.8,2541,1314,1227,107.1
34011, 동남구,010004, 8세,2017,2525,1322,1203,109.9,2513,1317,1196,110.1
34011, 동남구,010005, 9세,2017,2659,1351,1308,103.3,2648,1345,1303,103.2
34011, 동남구,015,10~14세,2017,12777,6680,6097,109.6,12726,6654,6072,109.6
34011, 동남구,015001, 10세,2017,2697,1385,1312,105.6,2684,1379,1305,105.7
34011, 동남구,015002, 11세,2017,2463,1315,1148,114.5,2449,1307,1142,114.4
34011, 동남구,015003, 12세,2017,2437,1243,1194,104.1,2426,1237,1189,104
34011, 동남구,015004, 13세,2017,2595,1378,1217,113.2,2586,1374,1212,113.4
34011, 동남구,015005, 14세,2017,2585,1359,1226,110.8,2581,1357,1224,110.9
34011, 동남구,020,15~19세,2017,19670,10232,9438,108.4,19206,10030,9176,109.3
34011, 동남구,020001, 15세,2017,2649,1401,1248,112.3,2642,1397,1245,112.2
34011, 동남구,020002, 16세,2017,3467,1900,1567,121.3,3457,1892,1565,120.9
34011, 동남구,020003, 17세,2017,3670,2140,1530,139.9,3630,2129,1501,141.8
34011, 동남구,020004, 18세,2017,3993,1990,2003,99.4,3826,1916,1910,100.3
34011, 동남구,020005, 19세,2017,5891,2801,3090,90.6,5651,2696,2955,91.2
34011, 동남구,025,20~24세,2017,25347,12872,12475,103.2,23950,12125,11825,102.5
34011, 동남구,025001, 20세,2017,5418,2308,3110,74.2,5183,2203,2980,73.9
34011, 동남구,025002, 21세,2017,5139,2356,2783,84.7,4841,2214,2627,84.3
34011, 동남구,025003, 22세,2017,5078,2647,2431,108.9,4820,2506,2314,108.3
34011, 동남구,025004, 23세,2017,4958,2802,2156,130,4646,2630,2016,130.5
34011, 동남구,025005, 24세,2017,4754,2759,1995,138.3,4460,2572,1888,136.2
34011, 동남구,030,25~29세,2017,18669,10544,8125,129.8,16781,9309,7472,124.6
34011, 동남구,030001, 25세,2017,4479,2657,1822,145.8,4117,2420,1697,142.6
34011, 동남구,030002, 26세,2017,3867,2141,1726,124,3492,1920,1572,122.1
34011, 동남구,030003, 27세,2017,3544,1992,1552,128.4,3134,1712,1422,120.4
34011, 동남구,030004, 28세,2017,3394,1920,1474,130.3,3034,1661,1373,121
34011, 동남구,030005, 29세,2017,3385,1834,1551,118.2,3004,1596,1408,113.4
34011, 동남구,035,30~34세,2017,17492,9387,8105,115.8,15831,8273,7558,109.5
34011, 동남구,035001, 30세,2017,3319,1817,1502,121,2909,1548,1361,113.7
34011, 동남구,035002, 31세,2017,3299,1807,1492,121.1,2958,1583,1375,115.1
34011, 동남구,035003, 32세,2017,3403,1848,1555,118.8,3091,1642,1449,113.3
34011, 동남구,035004, 33세,2017,3599,1898,1701,111.6,3285,1687,1598,105.6
34011, 동남구,035005, 34세,2017,3872,2017,1855,108.7,3588,1813,1775,102.1
34011, 동남구,040,35~39세,2017,21574,11289,10285,109.8,20328,10479,9849,106.4
34011, 동남구,040001, 35세,2017,4341,2262,2079,108.8,4041,2077,1964,105.8
34011, 동남구,040002, 36세,2017,4316,2301,2015,114.2,4053,2123,1930,110
34011, 동남구,040003, 37세,2017,4634,2379,2255,105.5,4372,2210,2162,102.2
34011, 동남구,040004, 38세,2017,4328,2207,2121,104.1,4113,2067,2046,101
34011, 동남구,040005, 39세,2017,3955,2140,1815,117.9,3749,2002,1747,114.6
34011, 동남구,045,40~44세,2017,22119,11580,10539,109.9,21161,10969,10192,107.6
34011, 동남구,045001, 40세,2017,4197,2236,1961,114,3989,2092,1897,110.3
34011, 동남구,045002, 41세,2017,4120,2149,1971,109,3946,2040,1906,107
34011, 동남구,045003, 42세,2017,4403,2255,2148,105,4204,2128,2076,102.5
34011, 동남구,045004, 43세,2017,4719,2468,2251,109.6,4545,2360,2185,108
34011, 동남구,045005, 44세,2017,4680,2472,2208,112,4477,2349,2128,110.4
34011, 동남구,050,45~49세,2017,23406,11999,11407,105.2,22294,11347,10947,103.7
34011, 동남구,050001, 45세,2017,4351,2216,2135,103.8,4132,2097,2035,103
34011, 동남구,050002, 46세,2017,4791,2466,2325,106.1,4582,2339,2243,104.3
34011, 동남구,050003, 47세,2017,4672,2441,2231,109.4,4454,2304,2150,107.2
34011, 동남구,050004, 48세,2017,4864,2480,2384,104,4615,2343,2272,103.1
34011, 동남구,050005, 49세,2017,4728,2396,2332,102.7,4511,2264,2247,100.8
34011, 동남구,055,50~54세,2017,21244,10993,10251,107.2,20239,10440,9799,106.5
34011, 동남구,055001, 50세,2017,4397,2243,2154,104.1,4210,2131,2079,102.5
34011, 동남구,055002, 51세,2017,4086,2155,1931,111.6,3893,2041,1852,110.2
34011, 동남구,055003, 52세,2017,4529,2334,2195,106.3,4315,2225,2090,106.5
34011, 동남구,055004, 53세,2017,4007,2038,1969,103.5,3840,1963,1877,104.6
34011, 동남구,055005, 54세,2017,4225,2223,2002,111,3981,2080,1901,109.4
34011, 동남구,060,55~59세,2017,21291,11005,10286,107,20634,10669,9965,107.1
34011, 동남구,060001, 55세,2017,4400,2320,2080,111.5,4216,2223,1993,111.5
34011, 동남구,060002, 56세,2017,4861,2530,2331,108.5,4758,2474,2284,108.3
34011, 동남구,060003, 57세,2017,4593,2320,2273,102.1,4455,2252,2203,102.2
34011, 동남구,060004, 58세,2017,3868,1989,1879,105.9,3750,1938,1812,107
34011, 동남구,060005, 59세,2017,3569,1846,1723,107.1,3455,1782,1673,106.5
34011, 동남구,065,60~64세,2017,14756,7423,7333,101.2,14263,7167,7096,101
34011, 동남구,065001, 60세,2017,3425,1756,1669,105.2,3292,1676,1616,103.7
34011, 동남구,065002, 61세,2017,3190,1582,1608,98.4,3097,1542,1555,99.2
34011, 동남구,065003, 62세,2017,3271,1631,1640,99.5,3161,1574,1587,99.2
34011, 동남구,065004, 63세,2017,2661,1334,1327,100.5,2581,1291,1290,100.1
34011, 동남구,065005, 64세,2017,2209,1120,1089,102.8,2132,1084,1048,103.4
34011, 동남구,070,65~69세,2017,10127,5025,5102,98.5,9949,4927,5022,98.1
34011, 동남구,070001, 65세,2017,2523,1248,1275,97.9,2467,1215,1252,97
34011, 동남구,070002, 66세,2017,1775,908,867,104.7,1734,883,851,103.8
34011, 동남구,070003, 67세,2017,2032,989,1043,94.8,2001,969,1032,93.9
34011, 동남구,070004, 68세,2017,1970,975,995,98,1941,963,978,98.5
34011, 동남구,070005, 69세,2017,1827,905,922,98.2,1806,897,909,98.7
34011, 동남구,075,70~74세,2017,7269,3337,3932,84.9,7206,3317,3889,85.3
34011, 동남구,075001, 70세,2017,1821,853,968,88.1,1799,848,951,89.2
34011, 동남구,075002, 71세,2017,1302,628,674,93.2,1287,623,664,93.8
34011, 동남구,075003, 72세,2017,1337,637,700,91,1326,630,696,90.5
34011, 동남구,075004, 73세,2017,1442,648,794,81.6,1435,646,789,81.9
34011, 동남구,075005, 74세,2017,1367,571,796,71.7,1359,570,789,72.2
34011, 동남구,080,75~79세,2017,6664,2722,3942,69.1,6622,2706,3916,69.1
34011, 동남구,080001, 75세,2017,1664,688,976,70.5,1653,683,970,70.4
34011, 동남구,080002, 76세,2017,1317,555,762,72.8,1303,548,755,72.6
34011, 동남구,080003, 77세,2017,1251,529,722,73.3,1241,527,714,73.8
34011, 동남구,080004, 78세,2017,1278,508,770,66,1274,508,766,66.3
34011, 동남구,080005, 79세,2017,1154,442,712,62.1,1151,440,711,61.9
34011, 동남구,085,80~84세,2017,4553,1603,2950,54.3,4534,1598,2936,54.4
34011, 동남구,085001, 80세,2017,1115,414,701,59.1,1107,413,694,59.5
34011, 동남구,085002, 81세,2017,986,350,636,55,984,348,636,54.7
34011, 동남구,085003, 82세,2017,983,341,642,53.1,979,340,639,53.2
34011, 동남구,085004, 83세,2017,783,277,506,54.7,778,276,502,55
34011, 동남구,085005, 84세,2017,686,221,465,47.5,686,221,465,47.5
34011, 동남구,090,85~89세,2017,2195,617,1578,39.1,2186,616,1570,39.2
34011, 동남구,090001, 85세,2017,656,192,464,41.4,653,191,462,41.3
34011, 동남구,090002, 86세,2017,467,125,342,36.5,463,125,338,37
34011, 동남구,090003, 87세,2017,405,136,269,50.6,404,136,268,50.7
34011, 동남구,090004, 88세,2017,366,93,273,34.1,366,93,273,34.1
34011, 동남구,090005, 89세,2017,301,71,230,30.9,300,71,229,31
34011, 동남구,095,90~94세,2017,738,168,570,29.5,738,168,570,29.5
34011, 동남구,095001, 90세,2017,239,52,187,27.8,239,52,187,27.8
34011, 동남구,095002, 91세,2017,157,29,128,22.7,157,29,128,22.7
34011, 동남구,095003, 92세,2017,142,34,108,31.5,142,34,108,31.5
34011, 동남구,095004, 93세,2017,96,30,66,45.5,96,30,66,45.5
34011, 동남구,095005, 94세,2017,104,23,81,28.4,104,23,81,28.4
34011, 동남구,100,95~99세,2017,188,43,145,29.7,188,43,145,29.7
34011, 동남구,100001, 95세,2017,79,18,61,29.5,79,18,61,29.5
34011, 동남구,100002, 96세,2017,50,15,35,42.9,50,15,35,42.9
34011, 동남구,100003, 97세,2017,26,8,18,44.4,26,8,18,44.4
34011, 동남구,100004, 98세,2017,20,X,18,11.1,20,X,18,11.1
34011, 동남구,100005, 99세,2017,13,X,13,0,13,X,13,0
34011, 동남구,101,100세이상,2017,16,X,16,0,16,X,16,0
34011, 동남구,102,15세미만,2017,36521,18926,17595,107.6,36182,18750,17432,107.6
34011, 동남구,103,15~64세,2017,205568,107324,98244,109.2,194687,100808,93879,107.4
34011, 동남구,104,65세이상,2017,31750,13515,18235,74.1,31439,13375,18064,74
34011, 동남구,086,85세이상,2017,3137,828,2309,35.9,3128,827,2301,35.9
34011, 동남구,126,평균연령,2017,39.4,38.4,40.4,,39.5,38.5,40.5,
34011, 동남구,127,중위연령,2017,39.4,38.4,40.5,,39.7,38.8,40.7,
34012, 서북구,000,합계,2017,382455,196711,185744,105.9,368439,188130,180309,104.3
34012, 서북구,005,0~4세,2017,21325,10825,10500,103.1,21056,10688,10368,103.1
34012, 서북구,005001, 0세,2017,3944,2039,1905,107,3880,2001,1879,106.5
34012, 서북구,005002, 1세,2017,4364,2185,2179,100.3,4303,2159,2144,100.7
34012, 서북구,005003, 2세,2017,4466,2286,2180,104.9,4412,2265,2147,105.5
34012, 서북구,005004, 3세,2017,4276,2156,2120,101.7,4231,2126,2105,101
34012, 서북구,005005, 4세,2017,4275,2159,2116,102,4230,2137,2093,102.1
34012, 서북구,010,5~9세,2017,21007,10837,10170,106.6,20874,10766,10108,106.5
34012, 서북구,010001, 5세,2017,4628,2314,2314,100,4589,2297,2292,100.2
34012, 서북구,010002, 6세,2017,4305,2235,2070,108,4278,2220,2058,107.9
34012, 서북구,010003, 7세,2017,4145,2148,1997,107.6,4110,2125,1985,107.1
34012, 서북구,010004, 8세,2017,3897,2006,1891,106.1,3879,1997,1882,106.1
34012, 서북구,010005, 9세,2017,4032,2134,1898,112.4,4018,2127,1891,112.5
34012, 서북구,015,10~14세,2017,19469,10073,9396,107.2,19400,10038,9362,107.2
34012, 서북구,015001, 10세,2017,4092,2098,1994,105.2,4071,2086,1985,105.1
34012, 서북구,015002, 11세,2017,3737,1925,1812,106.2,3727,1925,1802,106.8
34012, 서북구,015003, 12세,2017,3720,1935,1785,108.4,3704,1925,1779,108.2
34012, 서북구,015004, 13세,2017,4032,2124,1908,111.3,4019,2115,1904,111.1
34012, 서북구,015005, 14세,2017,3888,1991,1897,105,3879,1987,1892,105
34012, 서북구,020,15~19세,2017,23400,12005,11395,105.4,23156,11897,11259,105.7
34012, 서북구,020001, 15세,2017,4077,2116,1961,107.9,4070,2111,1959,107.8
34012, 서북구,020002, 16세,2017,4434,2226,2208,100.8,4420,2219,2201,100.8
34012, 서북구,020003, 17세,2017,4765,2416,2349,102.9,4748,2409,2339,103
34012, 서북구,020004, 18세,2017,4828,2490,2338,106.5,4771,2468,2303,107.2
34012, 서북구,020005, 19세,2017,5296,2757,2539,108.6,5147,2690,2457,109.5
34012, 서북구,025,20~24세,2017,29371,15073,14298,105.4,27939,14204,13735,103.4
34012, 서북구,025001, 20세,2017,5504,2701,2803,96.4,5314,2605,2709,96.2
34012, 서북구,025002, 21세,2017,5731,2958,2773,106.7,5462,2809,2653,105.9
34012, 서북구,025003, 22세,2017,5906,3059,2847,107.4,5623,2882,2741,105.1
34012, 서북구,025004, 23세,2017,5945,3116,2829,110.1,5645,2916,2729,106.9
34012, 서북구,025005, 24세,2017,6285,3239,3046,106.3,5895,2992,2903,103.1
34012, 서북구,030,25~29세,2017,30927,16316,14611,111.7,28560,14753,13807,106.9
34012, 서북구,030001, 25세,2017,6493,3345,3148,106.3,6083,3059,3024,101.2
34012, 서북구,030002, 26세,2017,5774,3025,2749,110,5360,2760,2600,106.2
34012, 서북구,030003, 27세,2017,6004,3209,2795,114.8,5512,2884,2628,109.7
34012, 서북구,030004, 28세,2017,6033,3209,2824,113.6,5512,2862,2650,108
34012, 서북구,030005, 29세,2017,6623,3528,3095,114,6093,3188,2905,109.7
34012, 서북구,035,30~34세,2017,35672,19366,16306,118.8,33223,17763,15460,114.9
34012, 서북구,035001, 30세,2017,6936,3653,3283,111.3,6400,3315,3085,107.5
34012, 서북구,035002, 31세,2017,6989,3812,3177,120,6484,3488,2996,116.4
34012, 서북구,035003, 32세,2017,6822,3743,3079,121.6,6329,3409,2920,116.7
34012, 서북구,035004, 33세,2017,7053,3872,3181,121.7,6577,3547,3030,117.1
34012, 서북구,035005, 34세,2017,7872,4286,3586,119.5,7433,4004,3429,116.8
34012, 서북구,040,35~39세,2017,37324,20404,16920,120.6,35547,19164,16383,117
34012, 서북구,040001, 35세,2017,8191,4428,3763,117.7,7793,4147,3646,113.7
34012, 서북구,040002, 36세,2017,7858,4307,3551,121.3,7496,4065,3431,118.5
34012, 서북구,040003, 37세,2017,7726,4251,3475,122.3,7351,3992,3359,118.8
34012, 서북구,040004, 38세,2017,7056,3864,3192,121.1,6702,3619,3083,117.4
34012, 서북구,040005, 39세,2017,6493,3554,2939,120.9,6205,3341,2864,116.7
34012, 서북구,045,40~44세,2017,32728,16750,15978,104.8,31384,15890,15494,102.6
34012, 서북구,045001, 40세,2017,6471,3405,3066,111.1,6166,3205,2961,108.2
34012, 서북구,045002, 41세,2017,6252,3219,3033,106.1,5967,3033,2934,103.4
34012, 서북구,045003, 42세,2017,6379,3202,3177,100.8,6111,3022,3089,97.8
34012, 서북구,045004, 43세,2017,6883,3492,3391,103,6649,3342,3307,101.1
34012, 서북구,045005, 44세,2017,6743,3432,3311,103.7,6491,3288,3203,102.7
34012, 서북구,050,45~49세,2017,34640,17721,16919,104.7,33393,17003,16390,103.7
34012, 서북구,050001, 45세,2017,6639,3385,3254,104,6371,3215,3156,101.9
34012, 서북구,050002, 46세,2017,7199,3742,3457,108.2,6931,3587,3344,107.3
34012, 서북구,050003, 47세,2017,6839,3494,3345,104.5,6589,3351,3238,103.5
34012, 서북구,050004, 48세,2017,7002,3571,3431,104.1,6771,3448,3323,103.8
34012, 서북구,050005, 49세,2017,6961,3529,3432,102.8,6731,3402,3329,102.2
34012, 서북구,055,50~54세,2017,28079,14476,13603,106.4,27056,13925,13131,106
34012, 서북구,055001, 50세,2017,5963,2940,3023,97.3,5766,2833,2933,96.6
34012, 서북구,055002, 51세,2017,5486,2828,2658,106.4,5286,2728,2558,106.6
34012, 서북구,055003, 52세,2017,6043,3158,2885,109.5,5811,3021,2790,108.3
34012, 서북구,055004, 53세,2017,5219,2717,2502,108.6,5046,2622,2424,108.2
34012, 서북구,055005, 54세,2017,5368,2833,2535,111.8,5147,2721,2426,112.2
34012, 서북구,060,55~59세,2017,24617,12954,11663,111.1,23943,12618,11325,111.4
34012, 서북구,060001, 55세,2017,5433,2974,2459,120.9,5244,2882,2362,122
34012, 서북구,060002, 56세,2017,5536,2929,2607,112.4,5427,2871,2556,112.3
34012, 서북구,060003, 57세,2017,5297,2752,2545,108.1,5164,2691,2473,108.8
34012, 서북구,060004, 58세,2017,4422,2227,2195,101.5,4309,2170,2139,101.4
34012, 서북구,060005, 59세,2017,3929,2072,1857,111.6,3799,2004,1795,111.6
34012, 서북구,065,60~64세,2017,15148,7819,7329,106.7,14541,7501,7040,106.5
34012, 서북구,065001, 60세,2017,3702,1976,1726,114.5,3558,1896,1662,114.1
34012, 서북구,065002, 61세,2017,3264,1716,1548,110.9,3124,1641,1483,110.7
34012, 서북구,065003, 62세,2017,3367,1711,1656,103.3,3252,1649,1603,102.9
34012, 서북구,065004, 63세,2017,2642,1295,1347,96.1,2531,1241,1290,96.2
34012, 서북구,065005, 64세,2017,2173,1121,1052,106.6,2076,1074,1002,107.2
34012, 서북구,070,65~69세,2017,9564,4645,4919,94.4,9332,4524,4808,94.1
34012, 서북구,070001, 65세,2017,2443,1211,1232,98.3,2381,1177,1204,97.8
34012, 서북구,070002, 66세,2017,1690,843,847,99.5,1631,811,820,98.9
34012, 서북구,070003, 67세,2017,1837,858,979,87.6,1797,840,957,87.8
34012, 서북구,070004, 68세,2017,1831,871,960,90.7,1788,848,940,90.2
34012, 서북구,070005, 69세,2017,1763,862,901,95.7,1735,848,887,95.6
34012, 서북구,075,70~74세,2017,6773,3035,3738,81.2,6698,3008,3690,81.5
34012, 서북구,075001, 70세,2017,1699,776,923,84.1,1681,770,911,84.5
34012, 서북구,075002, 71세,2017,1277,633,644,98.3,1257,629,628,100.2
34012, 서북구,075003, 72세,2017,1202,525,677,77.5,1191,523,668,78.3
34012, 서북구,075004, 73세,2017,1292,542,750,72.3,1274,532,742,71.7
34012, 서북구,075005, 74세,2017,1303,559,744,75.1,1295,554,741,74.8
34012, 서북구,080,75~79세,2017,6045,2388,3657,65.3,6003,2373,3630,65.4
34012, 서북구,080001, 75세,2017,1565,641,924,69.4,1558,640,918,69.7
34012, 서북구,080002, 76세,2017,1152,459,693,66.2,1144,455,689,66
34012, 서북구,080003, 77세,2017,1104,442,662,66.8,1095,436,659,66.2
34012, 서북구,080004, 78세,2017,1175,441,734,60.1,1170,440,730,60.3
34012, 서북구,080005, 79세,2017,1049,405,644,62.9,1036,402,634,63.4
34012, 서북구,085,80~84세,2017,3872,1344,2528,53.2,3848,1337,2511,53.2
34012, 서북구,085001, 80세,2017,940,343,597,57.5,930,339,591,57.4
34012, 서북구,085002, 81세,2017,856,300,556,54,852,299,553,54.1
34012, 서북구,085003, 82세,2017,789,252,537,46.9,786,252,534,47.2
34012, 서북구,085004, 83세,2017,741,263,478,55,737,262,475,55.2
34012, 서북구,085005, 84세,2017,546,186,360,51.7,543,185,358,51.7
34012, 서북구,090,85~89세,2017,1770,509,1261,40.4,1762,507,1255,40.4
34012, 서북구,090001, 85세,2017,515,160,355,45.1,514,160,354,45.2
34012, 서북구,090002, 86세,2017,382,110,272,40.4,378,108,270,40
34012, 서북구,090003, 87세,2017,342,93,249,37.3,341,93,248,37.5
34012, 서북구,090004, 88세,2017,282,74,208,35.6,280,74,206,35.9
34012, 서북구,090005, 89세,2017,249,72,177,40.7,249,72,177,40.7
34012, 서북구,095,90~94세,2017,582,141,441,32,582,141,441,32
34012, 서북구,095001, 90세,2017,193,45,148,30.4,193,45,148,30.4
34012, 서북구,095002, 91세,2017,127,27,100,27,127,27,100,27
34012, 서북구,095003, 92세,2017,116,34,82,41.5,116,34,82,41.5
34012, 서북구,095004, 93세,2017,81,16,65,24.6,81,16,65,24.6
34012, 서북구,095005, 94세,2017,65,19,46,41.3,65,19,46,41.3
34012, 서북구,100,95~99세,2017,124,27,97,27.8,124,27,97,27.8
34012, 서북구,100001, 95세,2017,48,13,35,37.1,48,13,35,37.1
34012, 서북구,100002, 96세,2017,27,8,19,42.1,27,8,19,42.1
34012, 서북구,100003, 97세,2017,27,X,26,3.8,27,X,26,3.8
34012, 서북구,100004, 98세,2017,14,X,10,40,14,X,10,40
34012, 서북구,100005, 99세,2017,8,X,7,14.3,8,X,7,14.3
34012, 서북구,101,100세이상,2017,18,X,15,20,18,X,15,20
34012, 서북구,102,15세미만,2017,61801,31735,30066,105.6,61330,31492,29838,105.5
34012, 서북구,103,15~64세,2017,291906,152884,139022,110,278742,144718,134024,108
34012, 서북구,104,65세이상,2017,28748,12092,16656,72.6,28367,11920,16447,72.5
34012, 서북구,086,85세이상,2017,2494,680,1814,37.5,2486,678,1808,37.5
34012, 서북구,126,평균연령,2017,36.5,35.9,37.1,,36.4,35.8,37,
34012, 서북구,127,중위연령,2017,36.2,35.9,36.7,,36.3,36,36.7,
34020, 공주시,000,합계,2017,111017,55006,56011,98.2,108648,53831,54817,98.2
34020, 공주시,005,0~4세,2017,2981,1554,1427,108.9,2968,1548,1420,109
34020, 공주시,005001, 0세,2017,553,287,266,107.9,550,286,264,108.3
34020, 공주시,005002, 1세,2017,506,254,252,100.8,505,254,251,101.2
34020, 공주시,005003, 2세,2017,618,308,310,99.4,613,305,308,99
34020, 공주시,005004, 3세,2017,614,335,279,120.1,612,334,278,120.1
34020, 공주시,005005, 4세,2017,690,370,320,115.6,688,369,319,115.7
34020, 공주시,010,5~9세,2017,3687,1889,1798,105.1,3678,1883,1795,104.9
34020, 공주시,010001, 5세,2017,732,380,352,108,729,377,352,107.1
34020, 공주시,010002, 6세,2017,753,384,369,104.1,749,382,367,104.1
34020, 공주시,010003, 7세,2017,736,378,358,105.6,736,378,358,105.6
34020, 공주시,010004, 8세,2017,711,369,342,107.9,710,368,342,107.6
34020, 공주시,010005, 9세,2017,755,378,377,100.3,754,378,376,100.5
34020, 공주시,015,10~14세,2017,4001,2059,1942,106,4001,2059,1942,106
34020, 공주시,015001, 10세,2017,816,434,382,113.6,816,434,382,113.6
34020, 공주시,015002, 11세,2017,764,385,379,101.6,764,385,379,101.6
34020, 공주시,015003, 12세,2017,752,380,372,102.2,752,380,372,102.2
34020, 공주시,015004, 13세,2017,794,391,403,97,794,391,403,97
34020, 공주시,015005, 14세,2017,875,469,406,115.5,875,469,406,115.5
34020, 공주시,020,15~19세,2017,7467,3921,3546,110.6,7364,3889,3475,111.9
34020, 공주시,020001, 15세,2017,1008,552,456,121.1,1008,552,456,121.1
34020, 공주시,020002, 16세,2017,1365,782,583,134.1,1362,780,582,134
34020, 공주시,020003, 17세,2017,1507,905,602,150.3,1491,898,593,151.4
34020, 공주시,020004, 18세,2017,1595,863,732,117.9,1561,850,711,119.5
34020, 공주시,020005, 19세,2017,1992,819,1173,69.8,1942,809,1133,71.4
34020, 공주시,025,20~24세,2017,9574,4591,4983,92.1,9135,4389,4746,92.5
34020, 공주시,025001, 20세,2017,2184,844,1340,63,2112,821,1291,63.6
34020, 공주시,025002, 21세,2017,2077,854,1223,69.8,2019,827,1192,69.4
34020, 공주시,025003, 22세,2017,2052,977,1075,90.9,1967,935,1032,90.6
34020, 공주시,025004, 23세,2017,1761,1021,740,138,1650,967,683,141.6
34020, 공주시,025005, 24세,2017,1500,895,605,147.9,1387,839,548,153.1
34020, 공주시,030,25~29세,2017,5880,3368,2512,134.1,5362,3091,2271,136.1
34020, 공주시,030001, 25세,2017,1374,804,570,141.1,1268,744,524,142
34020, 공주시,030002, 26세,2017,1214,715,499,143.3,1105,657,448,146.7
34020, 공주시,030003, 27세,2017,1185,662,523,126.6,1083,610,473,129
34020, 공주시,030004, 28세,2017,1082,626,456,137.3,983,575,408,140.9
34020, 공주시,030005, 29세,2017,1025,561,464,120.9,923,505,418,120.8
34020, 공주시,035,30~34세,2017,5092,2784,2308,120.6,4757,2612,2145,121.8
34020, 공주시,035001, 30세,2017,993,553,440,125.7,911,509,402,126.6
34020, 공주시,035002, 31세,2017,1028,549,479,114.6,957,517,440,117.5
34020, 공주시,035003, 32세,2017,974,536,438,122.4,906,503,403,124.8
34020, 공주시,035004, 33세,2017,986,549,437,125.6,924,513,411,124.8
34020, 공주시,035005, 34세,2017,1111,597,514,116.1,1059,570,489,116.6
34020, 공주시,040,35~39세,2017,5899,3088,2811,109.9,5672,2967,2705,109.7
34020, 공주시,040001, 35세,2017,1097,567,530,107,1034,532,502,106
34020, 공주시,040002, 36세,2017,1206,628,578,108.7,1152,602,550,109.5
34020, 공주시,040003, 37세,2017,1245,650,595,109.2,1213,631,582,108.4
34020, 공주시,040004, 38세,2017,1176,604,572,105.6,1136,583,553,105.4
34020, 공주시,040005, 39세,2017,1175,639,536,119.2,1137,619,518,119.5
34020, 공주시,045,40~44세,2017,6523,3420,3103,110.2,6387,3335,3052,109.3
34020, 공주시,045001, 40세,2017,1159,616,543,113.4,1137,598,539,110.9
34020, 공주시,045002, 41세,2017,1168,622,546,113.9,1141,609,532,114.5
34020, 공주시,045003, 42세,2017,1290,680,610,111.5,1252,656,596,110.1
34020, 공주시,045004, 43세,2017,1431,757,674,112.3,1408,739,669,110.5
34020, 공주시,045005, 44세,2017,1475,745,730,102.1,1449,733,716,102.4
34020, 공주시,050,45~49세,2017,8092,4194,3898,107.6,7922,4109,3813,107.8
34020, 공주시,050001, 45세,2017,1343,686,657,104.4,1313,670,643,104.2
34020, 공주시,050002, 46세,2017,1593,850,743,114.4,1565,835,730,114.4
34020, 공주시,050003, 47세,2017,1626,833,793,105,1581,814,767,106.1
34020, 공주시,050004, 48세,2017,1740,896,844,106.2,1717,883,834,105.9
34020, 공주시,050005, 49세,2017,1790,929,861,107.9,1746,907,839,108.1
34020, 공주시,055,50~54세,2017,8436,4330,4106,105.5,8262,4246,4016,105.7
34020, 공주시,055001, 50세,2017,1659,873,786,111.1,1618,851,767,111
34020, 공주시,055002, 51세,2017,1440,745,695,107.2,1410,731,679,107.7
34020, 공주시,055003, 52세,2017,1821,913,908,100.6,1784,895,889,100.7
34020, 공주시,055004, 53세,2017,1709,889,820,108.4,1678,873,805,108.4
34020, 공주시,055005, 54세,2017,1807,910,897,101.4,1772,896,876,102.3
34020, 공주시,060,55~59세,2017,10358,5219,5139,101.6,10262,5182,5080,102
34020, 공주시,060001, 55세,2017,1972,1015,957,106.1,1953,1008,945,106.7
34020, 공주시,060002, 56세,2017,2304,1189,1115,106.6,2288,1185,1103,107.4
34020, 공주시,060003, 57세,2017,2146,1070,1076,99.4,2123,1060,1063,99.7
34020, 공주시,060004, 58세,2017,1995,974,1021,95.4,1976,964,1012,95.3
34020, 공주시,060005, 59세,2017,1941,971,970,100.1,1922,965,957,100.8
34020, 공주시,065,60~64세,2017,8585,4276,4309,99.2,8504,4233,4271,99.1
34020, 공주시,065001, 60세,2017,1878,940,938,100.2,1863,928,935,99.3
34020, 공주시,065002, 61세,2017,1813,928,885,104.9,1795,918,877,104.7
34020, 공주시,065003, 62세,2017,1998,1003,995,100.8,1973,990,983,100.7
34020, 공주시,065004, 63세,2017,1562,742,820,90.5,1549,738,811,91
34020, 공주시,065005, 64세,2017,1334,663,671,98.8,1324,659,665,99.1
34020, 공주시,070,65~69세,2017,6733,3374,3359,100.4,6695,3358,3337,100.6
34020, 공주시,070001, 65세,2017,1564,777,787,98.7,1557,774,783,98.9
34020, 공주시,070002, 66세,2017,1150,591,559,105.7,1146,589,557,105.7
34020, 공주시,070003, 67세,2017,1411,714,697,102.4,1398,707,691,102.3
34020, 공주시,070004, 68세,2017,1338,679,659,103,1330,677,653,103.7
34020, 공주시,070005, 69세,2017,1270,613,657,93.3,1264,611,653,93.6
34020, 공주시,075,70~74세,2017,5062,2306,2756,83.7,5045,2301,2744,83.9
34020, 공주시,075001, 70세,2017,1183,594,589,100.8,1177,591,586,100.9
34020, 공주시,075002, 71세,2017,877,419,458,91.5,873,419,454,92.3
34020, 공주시,075003, 72세,2017,955,414,541,76.5,953,414,539,76.8
34020, 공주시,075004, 73세,2017,1079,453,626,72.4,1077,453,624,72.6
34020, 공주시,075005, 74세,2017,968,426,542,78.6,965,424,541,78.4
34020, 공주시,080,75~79세,2017,5724,2312,3412,67.8,5719,2312,3407,67.9
34020, 공주시,080001, 75세,2017,1484,610,874,69.8,1484,610,874,69.8
34020, 공주시,080002, 76세,2017,1099,480,619,77.5,1099,480,619,77.5
34020, 공주시,080003, 77세,2017,1023,418,605,69.1,1020,418,602,69.4
34020, 공주시,080004, 78세,2017,1145,435,710,61.3,1144,435,709,61.4
34020, 공주시,080005, 79세,2017,973,369,604,61.1,972,369,603,61.2
34020, 공주시,085,80~84세,2017,4172,1545,2627,58.8,4166,1541,2625,58.7
34020, 공주시,085001, 80세,2017,966,380,586,64.8,964,379,585,64.8
34020, 공주시,085002, 81세,2017,913,332,581,57.1,912,331,581,57
34020, 공주시,085003, 82세,2017,873,339,534,63.5,871,338,533,63.4
34020, 공주시,085004, 83세,2017,761,262,499,52.5,761,262,499,52.5
34020, 공주시,085005, 84세,2017,659,232,427,54.3,658,231,427,54.1
34020, 공주시,090,85~89세,2017,2014,612,1402,43.7,2013,612,1401,43.7
34020, 공주시,090001, 85세,2017,578,184,394,46.7,577,184,393,46.8
34020, 공주시,090002, 86세,2017,446,143,303,47.2,446,143,303,47.2
34020, 공주시,090003, 87세,2017,382,116,266,43.6,382,116,266,43.6
34020, 공주시,090004, 88세,2017,350,92,258,35.7,350,92,258,35.7
34020, 공주시,090005, 89세,2017,258,77,181,42.5,258,77,181,42.5
34020, 공주시,095,90~94세,2017,562,132,430,30.7,561,132,429,30.8
34020, 공주시,095001, 90세,2017,175,34,141,24.1,174,34,140,24.3
34020, 공주시,095002, 91세,2017,139,36,103,35,139,36,103,35
34020, 공주시,095003, 92세,2017,98,25,73,34.2,98,25,73,34.2
34020, 공주시,095004, 93세,2017,68,17,51,33.3,68,17,51,33.3
34020, 공주시,095005, 94세,2017,82,20,62,32.3,82,20,62,32.3
34020, 공주시,100,95~99세,2017,160,30,130,23.1,160,30,130,23.1
34020, 공주시,100001, 95세,2017,65,10,55,18.2,65,10,55,18.2
34020, 공주시,100002, 96세,2017,36,8,28,28.6,36,8,28,28.6
34020, 공주시,100003, 97세,2017,27,X,23,17.4,27,X,23,17.4
34020, 공주시,100004, 98세,2017,20,5,15,33.3,20,5,15,33.3
34020, 공주시,100005, 99세,2017,12,X,9,33.3,12,X,9,33.3
34020, 공주시,101,100세이상,2017,15,X,13,15.4,15,X,13,15.4
34020, 공주시,102,15세미만,2017,10669,5502,5167,106.5,10647,5490,5157,106.5
34020, 공주시,103,15~64세,2017,75906,39191,36715,106.7,73627,38053,35574,107
34020, 공주시,104,65세이상,2017,24442,10313,14129,73,24374,10288,14086,73
34020, 공주시,086,85세이상,2017,2751,776,1975,39.3,2749,776,1973,39.3
34020, 공주시,126,평균연령,2017,45.7,44.1,47.2,,45.9,44.2,47.5,
34020, 공주시,127,중위연령,2017,47.9,46.2,49.6,,48.3,46.6,50.1,
34030, 보령시,000,합계,2017,100922,52077,48845,106.6,97614,49563,48051,103.1
34030, 보령시,005,0~4세,2017,3288,1671,1617,103.3,3275,1664,1611,103.3
34030, 보령시,005001, 0세,2017,558,293,265,110.6,558,293,265,110.6
34030, 보령시,005002, 1세,2017,634,323,311,103.9,630,320,310,103.2
34030, 보령시,005003, 2세,2017,665,340,325,104.6,661,337,324,104
34030, 보령시,005004, 3세,2017,704,341,363,93.9,702,340,362,93.9
34030, 보령시,005005, 4세,2017,727,374,353,105.9,724,374,350,106.9
34030, 보령시,010,5~9세,2017,4007,2032,1975,102.9,3999,2028,1971,102.9
34030, 보령시,010001, 5세,2017,749,389,360,108.1,748,388,360,107.8
34030, 보령시,010002, 6세,2017,841,416,425,97.9,841,416,425,97.9
34030, 보령시,010003, 7세,2017,799,413,386,107,798,412,386,106.7
34030, 보령시,010004, 8세,2017,774,402,372,108.1,773,402,371,108.4
34030, 보령시,010005, 9세,2017,844,412,432,95.4,839,410,429,95.6
34030, 보령시,015,10~14세,2017,4098,2133,1965,108.5,4094,2130,1964,108.5
34030, 보령시,015001, 10세,2017,801,419,382,109.7,801,419,382,109.7
34030, 보령시,015002, 11세,2017,802,412,390,105.6,801,412,389,105.9
34030, 보령시,015003, 12세,2017,796,442,354,124.9,796,442,354,124.9
34030, 보령시,015004, 13세,2017,858,447,411,108.8,856,445,411,108.3
34030, 보령시,015005, 14세,2017,841,413,428,96.5,840,412,428,96.3
34030, 보령시,020,15~19세,2017,4857,2762,2095,131.8,4834,2749,2085,131.8
34030, 보령시,020001, 15세,2017,870,442,428,103.3,868,442,426,103.8
34030, 보령시,020002, 16세,2017,942,493,449,109.8,940,492,448,109.8
34030, 보령시,020003, 17세,2017,1012,507,505,100.4,1010,505,505,100
34030, 보령시,020004, 18세,2017,1032,609,423,144,1026,606,420,144.3
34030, 보령시,020005, 19세,2017,1001,711,290,245.2,990,704,286,246.2
34030, 보령시,025,20~24세,2017,5157,3317,1840,180.3,4800,3026,1774,170.6
34030, 보령시,025001, 20세,2017,874,574,300,191.3,849,553,296,186.8
34030, 보령시,025002, 21세,2017,1075,701,374,187.4,1037,669,368,181.8
34030, 보령시,025003, 22세,2017,1122,702,420,167.1,1042,640,402,159.2
34030, 보령시,025004, 23세,2017,1080,698,382,182.7,981,615,366,168
34030, 보령시,025005, 24세,2017,1006,642,364,176.4,891,549,342,160.5
34030, 보령시,030,25~29세,2017,4877,2976,1901,156.5,4123,2355,1768,133.2
34030, 보령시,030001, 25세,2017,973,612,361,169.5,805,480,325,147.7
34030, 보령시,030002, 26세,2017,1008,605,403,150.1,869,493,376,131.1
34030, 보령시,030003, 27세,2017,965,569,396,143.7,809,430,379,113.5
34030, 보령시,030004, 28세,2017,977,615,362,169.9,823,483,340,142.1
34030, 보령시,030005, 29세,2017,954,575,379,151.7,817,469,348,134.8
34030, 보령시,035,30~34세,2017,5233,3033,2200,137.9,4558,2495,2063,120.9
34030, 보령시,035001, 30세,2017,1009,585,424,138,865,471,394,119.5
34030, 보령시,035002, 31세,2017,975,579,396,146.2,829,467,362,129
34030, 보령시,035003, 32세,2017,982,567,415,136.6,854,465,389,119.5
34030, 보령시,035004, 33세,2017,1081,618,463,133.5,955,517,438,118
34030, 보령시,035005, 34세,2017,1186,684,502,136.3,1055,575,480,119.8
34030, 보령시,040,35~39세,2017,6489,3653,2836,128.8,5971,3227,2744,117.6
34030, 보령시,040001, 35세,2017,1295,725,570,127.2,1190,637,553,115.2
34030, 보령시,040002, 36세,2017,1282,728,554,131.4,1165,632,533,118.6
34030, 보령시,040003, 37세,2017,1377,777,600,129.5,1271,695,576,120.7
34030, 보령시,040004, 38세,2017,1317,736,581,126.7,1227,663,564,117.6
34030, 보령시,040005, 39세,2017,1218,687,531,129.4,1118,600,518,115.8
34030, 보령시,045,40~44세,2017,7135,3974,3161,125.7,6779,3693,3086,119.7
34030, 보령시,045001, 40세,2017,1288,748,540,138.5,1217,694,523,132.7
34030, 보령시,045002, 41세,2017,1316,711,605,117.5,1236,648,588,110.2
34030, 보령시,045003, 42세,2017,1364,757,607,124.7,1302,707,595,118.8
34030, 보령시,045004, 43세,2017,1563,872,691,126.2,1486,812,674,120.5
34030, 보령시,045005, 44세,2017,1604,886,718,123.4,1538,832,706,117.8
34030, 보령시,050,45~49세,2017,7885,4246,3639,116.7,7635,4090,3545,115.4
34030, 보령시,050001, 45세,2017,1489,817,672,121.6,1422,771,651,118.4
34030, 보령시,050002, 46세,2017,1599,872,727,119.9,1546,834,712,117.1
34030, 보령시,050003, 47세,2017,1519,814,705,115.5,1468,783,685,114.3
34030, 보령시,050004, 48세,2017,1568,826,742,111.3,1524,799,725,110.2
34030, 보령시,050005, 49세,2017,1710,917,793,115.6,1675,903,772,117
34030, 보령시,055,50~54세,2017,7677,4061,3616,112.3,7525,3978,3547,112.2
34030, 보령시,055001, 50세,2017,1491,790,701,112.7,1459,770,689,111.8
34030, 보령시,055002, 51세,2017,1390,774,616,125.6,1367,761,606,125.6
34030, 보령시,055003, 52세,2017,1620,834,786,106.1,1593,820,773,106.1
34030, 보령시,055004, 53세,2017,1638,864,774,111.6,1601,844,757,111.5
34030, 보령시,055005, 54세,2017,1538,799,739,108.1,1505,783,722,108.4
34030, 보령시,060,55~59세,2017,9414,4685,4729,99.1,9325,4645,4680,99.3
34030, 보령시,060001, 55세,2017,1789,923,866,106.6,1765,909,856,106.2
34030, 보령시,060002, 56세,2017,2092,1076,1016,105.9,2073,1067,1006,106.1
34030, 보령시,060003, 57세,2017,1994,981,1013,96.8,1974,975,999,97.6
34030, 보령시,060004, 58세,2017,1785,857,928,92.3,1770,850,920,92.4
34030, 보령시,060005, 59세,2017,1754,848,906,93.6,1743,844,899,93.9
34030, 보령시,065,60~64세,2017,8057,3991,4066,98.2,7998,3962,4036,98.2
34030, 보령시,065001, 60세,2017,1704,876,828,105.8,1688,866,822,105.4
34030, 보령시,065002, 61세,2017,1683,853,830,102.8,1673,847,826,102.5
34030, 보령시,065003, 62세,2017,1810,896,914,98,1795,891,904,98.6
34030, 보령시,065004, 63세,2017,1622,790,832,95,1614,788,826,95.4
34030, 보령시,065005, 64세,2017,1238,576,662,87,1228,570,658,86.6
34030, 보령시,070,65~69세,2017,6706,3197,3509,91.1,6677,3184,3493,91.2
34030, 보령시,070001, 65세,2017,1398,632,766,82.5,1392,629,763,82.4
34030, 보령시,070002, 66세,2017,1238,617,621,99.4,1233,613,620,98.9
34030, 보령시,070003, 67세,2017,1371,655,716,91.5,1364,651,713,91.3
34030, 보령시,070004, 68세,2017,1414,680,734,92.6,1407,679,728,93.3
34030, 보령시,070005, 69세,2017,1285,613,672,91.2,1281,612,669,91.5
34030, 보령시,075,70~74세,2017,5202,2375,2827,84,5189,2369,2820,84
34030, 보령시,075001, 70세,2017,1262,570,692,82.4,1257,569,688,82.7
34030, 보령시,075002, 71세,2017,888,436,452,96.5,886,434,452,96
34030, 보령시,075003, 72세,2017,947,409,538,76,945,408,537,76
34030, 보령시,075004, 73세,2017,1050,470,580,81,1048,469,579,81
34030, 보령시,075005, 74세,2017,1055,490,565,86.7,1053,489,564,86.7
34030, 보령시,080,75~79세,2017,5124,2089,3035,68.8,5120,2087,3033,68.8
34030, 보령시,080001, 75세,2017,1255,509,746,68.2,1254,509,745,68.3
34030, 보령시,080002, 76세,2017,995,410,585,70.1,995,410,585,70.1
34030, 보령시,080003, 77세,2017,909,386,523,73.8,909,386,523,73.8
34030, 보령시,080004, 78세,2017,1001,415,586,70.8,999,414,585,70.8
34030, 보령시,080005, 79세,2017,964,369,595,62,963,368,595,61.8
34030, 보령시,085,80~84세,2017,3465,1296,2169,59.8,3462,1295,2167,59.8
34030, 보령시,085001, 80세,2017,820,344,476,72.3,819,344,475,72.4
34030, 보령시,085002, 81세,2017,794,289,505,57.2,794,289,505,57.2
34030, 보령시,085003, 82세,2017,753,260,493,52.7,751,259,492,52.6
34030, 보령시,085004, 83세,2017,595,207,388,53.4,595,207,388,53.4
34030, 보령시,085005, 84세,2017,503,196,307,63.8,503,196,307,63.8
34030, 보령시,090,85~89세,2017,1630,455,1175,38.7,1629,455,1174,38.8
34030, 보령시,090001, 85세,2017,480,137,343,39.9,479,137,342,40.1
34030, 보령시,090002, 86세,2017,351,116,235,49.4,351,116,235,49.4
34030, 보령시,090003, 87세,2017,313,78,235,33.2,313,78,235,33.2
34030, 보령시,090004, 88세,2017,283,72,211,34.1,283,72,211,34.1
34030, 보령시,090005, 89세,2017,203,52,151,34.4,203,52,151,34.4
34030, 보령시,095,90~94세,2017,496,111,385,28.8,496,111,385,28.8
34030, 보령시,095001, 90세,2017,155,46,109,42.2,155,46,109,42.2
34030, 보령시,095002, 91세,2017,125,29,96,30.2,125,29,96,30.2
34030, 보령시,095003, 92세,2017,79,12,67,17.9,79,12,67,17.9
34030, 보령시,095004, 93세,2017,67,12,55,21.8,67,12,55,21.8
34030, 보령시,095005, 94세,2017,70,12,58,20.7,70,12,58,20.7
34030, 보령시,100,95~99세,2017,112,18,94,19.1,112,18,94,19.1
34030, 보령시,100001, 95세,2017,48,9,39,23.1,48,9,39,23.1
34030, 보령시,100002, 96세,2017,27,X,24,12.5,27,X,24,12.5
34030, 보령시,100003, 97세,2017,20,X,18,11.1,20,X,18,11.1
34030, 보령시,100004, 98세,2017,11,X,8,37.5,11,X,8,37.5
34030, 보령시,100005, 99세,2017,6,X,5,20,6,X,5,20
34030, 보령시,101,100세이상,2017,13,X,11,18.2,13,X,11,18.2
34030, 보령시,102,15세미만,2017,11393,5836,5557,105,11368,5822,5546,105
34030, 보령시,103,15~64세,2017,66781,36698,30083,122,63548,34220,29328,116.7
34030, 보령시,104,65세이상,2017,22748,9543,13205,72.3,22698,9521,13177,72.3
34030, 보령시,086,85세이상,2017,2251,586,1665,35.2,2250,586,1664,35.2
34030, 보령시,126,평균연령,2017,46.3,44.1,48.7,,46.7,44.6,48.9,
34030, 보령시,127,중위연령,2017,48.5,45.6,51.8,,49.2,46.8,52.2,
34040, 아산시,000,합계,2017,338473,177501,160972,110.3,315848,163312,152536,107.1
34040, 아산시,005,0~4세,2017,18956,9723,9233,105.3,18476,9491,8985,105.6
34040, 아산시,005001, 0세,2017,3266,1654,1612,102.6,3153,1606,1547,103.8
34040, 아산시,005002, 1세,2017,3826,1931,1895,101.9,3705,1874,1831,102.3
34040, 아산시,005003, 2세,2017,4007,2072,1935,107.1,3911,2030,1881,107.9
34040, 아산시,005004, 3세,2017,3851,1994,1857,107.4,3771,1946,1825,106.6
34040, 아산시,005005, 4세,2017,4006,2072,1934,107.1,3936,2035,1901,107
34040, 아산시,010,5~9세,2017,19855,10206,9649,105.8,19580,10058,9522,105.6
34040, 아산시,010001, 5세,2017,4319,2244,2075,108.1,4235,2192,2043,107.3
34040, 아산시,010002, 6세,2017,4188,2139,2049,104.4,4128,2110,2018,104.6
34040, 아산시,010003, 7세,2017,3877,2042,1835,111.3,3831,2018,1813,111.3
34040, 아산시,010004, 8세,2017,3698,1890,1808,104.5,3656,1870,1786,104.7
34040, 아산시,010005, 9세,2017,3773,1891,1882,100.5,3730,1868,1862,100.3
34040, 아산시,015,10~14세,2017,16533,8546,7987,107,16386,8459,7927,106.7
34040, 아산시,015001, 10세,2017,3657,1924,1733,111,3620,1898,1722,110.2
34040, 아산시,015002, 11세,2017,3316,1697,1619,104.8,3285,1676,1609,104.2
34040, 아산시,015003, 12세,2017,3081,1611,1470,109.6,3065,1603,1462,109.6
34040, 아산시,015004, 13세,2017,3248,1631,1617,100.9,3211,1613,1598,100.9
34040, 아산시,015005, 14세,2017,3231,1683,1548,108.7,3205,1669,1536,108.7
34040, 아산시,020,15~19세,2017,21278,10954,10324,106.1,20830,10780,10050,107.3
34040, 아산시,020001, 15세,2017,3156,1597,1559,102.4,3138,1589,1549,102.6
34040, 아산시,020002, 16세,2017,3502,1802,1700,106,3474,1794,1680,106.8
34040, 아산시,020003, 17세,2017,4025,2001,2024,98.9,3982,1983,1999,99.2
34040, 아산시,020004, 18세,2017,4398,2273,2125,107,4306,2236,2070,108
34040, 아산시,020005, 19세,2017,6197,3281,2916,112.5,5930,3178,2752,115.5
34040, 아산시,025,20~24세,2017,24947,13329,11618,114.7,22279,11803,10476,112.7
34040, 아산시,025001, 20세,2017,5155,2387,2768,86.2,4718,2207,2511,87.9
34040, 아산시,025002, 21세,2017,4959,2451,2508,97.7,4448,2192,2256,97.2
34040, 아산시,025003, 22세,2017,5014,2773,2241,123.7,4453,2471,1982,124.7
34040, 아산시,025004, 23세,2017,4891,2904,1987,146.1,4340,2550,1790,142.5
34040, 아산시,025005, 24세,2017,4928,2814,2114,133.1,4320,2383,1937,123
34040, 아산시,030,25~29세,2017,23870,13476,10394,129.7,20143,10856,9287,116.9
34040, 아산시,030001, 25세,2017,4993,2820,2173,129.8,4374,2373,2001,118.6
34040, 아산시,030002, 26세,2017,4531,2622,1909,137.3,3865,2166,1699,127.5
34040, 아산시,030003, 27세,2017,4600,2563,2037,125.8,3841,2025,1816,111.5
34040, 아산시,030004, 28세,2017,4751,2717,2034,133.6,3950,2149,1801,119.3
34040, 아산시,030005, 29세,2017,4995,2754,2241,122.9,4113,2143,1970,108.8
34040, 아산시,035,30~34세,2017,28202,15619,12583,124.1,24221,12833,11388,112.7
34040, 아산시,035001, 30세,2017,5194,2931,2263,129.5,4358,2352,2006,117.2
34040, 아산시,035002, 31세,2017,5326,2903,2423,119.8,4493,2320,2173,106.8
34040, 아산시,035003, 32세,2017,5495,3116,2379,131,4665,2531,2134,118.6
34040, 아산시,035004, 33세,2017,5765,3131,2634,118.9,5026,2626,2400,109.4
34040, 아산시,035005, 34세,2017,6422,3538,2884,122.7,5679,3004,2675,112.3
34040, 아산시,040,35~39세,2017,33947,18992,14955,127,30962,16898,14064,120.2
34040, 아산시,040001, 35세,2017,7260,4038,3222,125.3,6591,3571,3020,118.2
34040, 아산시,040002, 36세,2017,7012,3964,3048,130.1,6403,3524,2879,122.4
34040, 아산시,040003, 37세,2017,7082,3915,3167,123.6,6500,3504,2996,117
34040, 아산시,040004, 38세,2017,6680,3756,2924,128.5,6071,3330,2741,121.5
34040, 아산시,040005, 39세,2017,5913,3319,2594,127.9,5397,2969,2428,122.3
34040, 아산시,045,40~44세,2017,28547,15685,12862,121.9,26462,14330,12132,118.1
34040, 아산시,045001, 40세,2017,5860,3276,2584,126.8,5406,2967,2439,121.6
34040, 아산시,045002, 41세,2017,5641,3067,2574,119.2,5176,2755,2421,113.8
34040, 아산시,045003, 42세,2017,5465,2945,2520,116.9,5069,2678,2391,112
34040, 아산시,045004, 43세,2017,5860,3269,2591,126.2,5455,3009,2446,123
34040, 아산시,045005, 44세,2017,5721,3128,2593,120.6,5356,2921,2435,120
34040, 아산시,050,45~49세,2017,27657,15288,12369,123.6,25564,14017,11547,121.4
34040, 아산시,050001, 45세,2017,5572,3177,2395,132.7,5078,2868,2210,129.8
34040, 아산시,050002, 46세,2017,5996,3352,2644,126.8,5555,3075,2480,124
34040, 아산시,050003, 47세,2017,5429,3045,2384,127.7,4999,2778,2221,125.1
34040, 아산시,050004, 48세,2017,5528,3025,2503,120.9,5165,2818,2347,120.1
34040, 아산시,050005, 49세,2017,5132,2689,2443,110.1,4767,2478,2289,108.3
34040, 아산시,055,50~54세,2017,22181,12035,10146,118.6,20591,11196,9395,119.2
34040, 아산시,055001, 50세,2017,4637,2513,2124,118.3,4364,2367,1997,118.5
34040, 아산시,055002, 51세,2017,4438,2440,1998,122.1,4120,2278,1842,123.7
34040, 아산시,055003, 52세,2017,4758,2569,2189,117.4,4389,2368,2021,117.2
34040, 아산시,055004, 53세,2017,4107,2213,1894,116.8,3825,2057,1768,116.3
34040, 아산시,055005, 54세,2017,4241,2300,1941,118.5,3893,2126,1767,120.3
34040, 아산시,060,55~59세,2017,21043,11019,10024,109.9,20065,10523,9542,110.3
34040, 아산시,060001, 55세,2017,4416,2381,2035,117,4189,2260,1929,117.2
34040, 아산시,060002, 56세,2017,4751,2555,2196,116.3,4565,2465,2100,117.4
34040, 아산시,060003, 57세,2017,4556,2383,2173,109.7,4327,2265,2062,109.8
34040, 아산시,060004, 58세,2017,3850,1937,1913,101.3,3673,1857,1816,102.3
34040, 아산시,060005, 59세,2017,3470,1763,1707,103.3,3311,1676,1635,102.5
34040, 아산시,065,60~64세,2017,15110,7507,7603,98.7,14434,7150,7284,98.2
34040, 아산시,065001, 60세,2017,3530,1773,1757,100.9,3344,1659,1685,98.5
34040, 아산시,065002, 61세,2017,3211,1611,1600,100.7,3061,1535,1526,100.6
34040, 아산시,065003, 62세,2017,3331,1657,1674,99,3196,1591,1605,99.1
34040, 아산시,065004, 63세,2017,2735,1338,1397,95.8,2613,1277,1336,95.6
34040, 아산시,065005, 64세,2017,2303,1128,1175,96,2220,1088,1132,96.1
34040, 아산시,070,65~69세,2017,10887,5138,5749,89.4,10607,5013,5594,89.6
34040, 아산시,070001, 65세,2017,2602,1214,1388,87.5,2504,1177,1327,88.7
34040, 아산시,070002, 66세,2017,1917,918,999,91.9,1856,882,974,90.6
34040, 아산시,070003, 67세,2017,2175,996,1179,84.5,2124,976,1148,85
34040, 아산시,070004, 68세,2017,2113,1011,1102,91.7,2070,991,1079,91.8
34040, 아산시,070005, 69세,2017,2080,999,1081,92.4,2053,987,1066,92.6
34040, 아산시,075,70~74세,2017,8423,3772,4651,81.1,8320,3723,4597,81
34040, 아산시,075001, 70세,2017,2027,960,1067,90,2000,942,1058,89
34040, 아산시,075002, 71세,2017,1549,703,846,83.1,1524,690,834,82.7
34040, 아산시,075003, 72세,2017,1535,678,857,79.1,1513,669,844,79.3
34040, 아산시,075004, 73세,2017,1634,715,919,77.8,1619,711,908,78.3
34040, 아산시,075005, 74세,2017,1678,716,962,74.4,1664,711,953,74.6
34040, 아산시,080,75~79세,2017,7991,3267,4724,69.2,7936,3253,4683,69.5
34040, 아산시,080001, 75세,2017,2009,853,1156,73.8,2001,851,1150,74
34040, 아산시,080002, 76세,2017,1568,675,893,75.6,1554,670,884,75.8
34040, 아산시,080003, 77세,2017,1428,556,872,63.8,1417,553,864,64
34040, 아산시,080004, 78세,2017,1581,626,955,65.5,1570,623,947,65.8
34040, 아산시,080005, 79세,2017,1405,557,848,65.7,1394,556,838,66.3
34040, 아산시,085,80~84세,2017,5628,2015,3613,55.8,5587,2003,3584,55.9
34040, 아산시,085001, 80세,2017,1407,524,883,59.3,1393,521,872,59.7
34040, 아산시,085002, 81세,2017,1253,487,766,63.6,1245,485,760,63.8
34040, 아산시,085003, 82세,2017,1141,407,734,55.4,1133,405,728,55.6
34040, 아산시,085004, 83세,2017,973,325,648,50.2,965,320,645,49.6
34040, 아산시,085005, 84세,2017,854,272,582,46.7,851,272,579,47
34040, 아산시,090,85~89세,2017,2488,720,1768,40.7,2477,716,1761,40.7
34040, 아산시,090001, 85세,2017,757,269,488,55.1,756,268,488,54.9
34040, 아산시,090002, 86세,2017,522,148,374,39.6,518,147,371,39.6
34040, 아산시,090003, 87세,2017,481,123,358,34.4,479,123,356,34.6
34040, 아산시,090004, 88세,2017,396,104,292,35.6,394,103,291,35.4
34040, 아산시,090005, 89세,2017,332,76,256,29.7,330,75,255,29.4
34040, 아산시,095,90~94세,2017,721,169,552,30.6,720,169,551,30.7
34040, 아산시,095001, 90세,2017,233,54,179,30.2,233,54,179,30.2
34040, 아산시,095002, 91세,2017,165,37,128,28.9,165,37,128,28.9
34040, 아산시,095003, 92세,2017,131,33,98,33.7,131,33,98,33.7
34040, 아산시,095004, 93세,2017,105,22,83,26.5,105,22,83,26.5
34040, 아산시,095005, 94세,2017,87,23,64,35.9,86,23,63,36.5
34040, 아산시,100,95~99세,2017,191,41,150,27.3,190,41,149,27.5
34040, 아산시,100001, 95세,2017,75,18,57,31.6,74,18,56,32.1
34040, 아산시,100002, 96세,2017,44,8,36,22.2,44,8,36,22.2
34040, 아산시,100003, 97세,2017,33,7,26,26.9,33,7,26,26.9
34040, 아산시,100004, 98세,2017,22,X,18,22.2,22,X,18,22.2
34040, 아산시,100005, 99세,2017,17,X,13,30.8,17,X,13,30.8
34040, 아산시,101,100세이상,2017,18,X,18,0,18,X,18,0
34040, 아산시,102,15세미만,2017,55344,28475,26869,106,54442,28008,26434,106
34040, 아산시,103,15~64세,2017,246782,133904,112878,118.6,225551,120386,105165,114.5
34040, 아산시,104,65세이상,2017,36347,15122,21225,71.2,35855,14918,20937,71.3
34040, 아산시,086,85세이상,2017,3418,930,2488,37.4,3405,926,2479,37.4
34040, 아산시,126,평균연령,2017,37.7,36.8,38.6,,37.8,36.9,38.7,
34040, 아산시,127,중위연령,2017,37.2,36.7,37.8,,37.5,37.1,37.9,
34050, 서산시,000,합계,2017,171364,88802,82562,107.6,165964,85747,80217,106.9
34050, 서산시,005,0~4세,2017,8053,4119,3934,104.7,7955,4074,3881,105
34050, 서산시,005001, 0세,2017,1400,720,680,105.9,1373,703,670,104.9
34050, 서산시,005002, 1세,2017,1609,823,786,104.7,1592,817,775,105.4
34050, 서산시,005003, 2세,2017,1666,851,815,104.4,1644,840,804,104.5
34050, 서산시,005004, 3세,2017,1695,895,800,111.9,1676,889,787,113
34050, 서산시,005005, 4세,2017,1683,830,853,97.3,1670,825,845,97.6
34050, 서산시,010,5~9세,2017,8654,4565,4089,111.6,8622,4545,4077,111.5
34050, 서산시,010001, 5세,2017,1806,947,859,110.2,1798,941,857,109.8
34050, 서산시,010002, 6세,2017,1739,922,817,112.9,1732,919,813,113
34050, 서산시,010003, 7세,2017,1736,904,832,108.7,1728,899,829,108.4
34050, 서산시,010004, 8세,2017,1633,871,762,114.3,1628,867,761,113.9
34050, 서산시,010005, 9세,2017,1740,921,819,112.5,1736,919,817,112.5
34050, 서산시,015,10~14세,2017,8331,4372,3959,110.4,8302,4354,3948,110.3
34050, 서산시,015001, 10세,2017,1814,948,866,109.5,1807,943,864,109.1
34050, 서산시,015002, 11세,2017,1617,822,795,103.4,1614,821,793,103.5
34050, 서산시,015003, 12세,2017,1486,780,706,110.5,1478,773,705,109.6
34050, 서산시,015004, 13세,2017,1723,935,788,118.7,1714,932,782,119.2
34050, 서산시,015005, 14세,2017,1691,887,804,110.3,1689,885,804,110.1
34050, 서산시,020,15~19세,2017,9362,4963,4399,112.8,9191,4877,4314,113.1
34050, 서산시,020001, 15세,2017,1756,956,800,119.5,1753,955,798,119.7
34050, 서산시,020002, 16세,2017,1898,974,924,105.4,1892,972,920,105.7
34050, 서산시,020003, 17세,2017,2020,1053,967,108.9,1992,1035,957,108.2
34050, 서산시,020004, 18세,2017,1913,1018,895,113.7,1865,992,873,113.6
34050, 서산시,020005, 19세,2017,1775,962,813,118.3,1689,923,766,120.5
34050, 서산시,025,20~24세,2017,9113,5183,3930,131.9,8356,4827,3529,136.8
34050, 서산시,025001, 20세,2017,1879,1046,833,125.6,1745,1005,740,135.8
34050, 서산시,025002, 21세,2017,1851,1065,786,135.5,1680,994,686,144.9
34050, 서산시,025003, 22세,2017,1734,974,760,128.2,1552,875,677,129.2
34050, 서산시,025004, 23세,2017,1798,1004,794,126.4,1639,921,718,128.3
34050, 서산시,025005, 24세,2017,1851,1094,757,144.5,1740,1032,708,145.8
34050, 서산시,030,25~29세,2017,9876,5849,4027,145.2,9147,5418,3729,145.3
34050, 서산시,030001, 25세,2017,2010,1182,828,142.8,1856,1092,764,142.9
34050, 서산시,030002, 26세,2017,1855,1091,764,142.8,1715,1001,714,140.2
34050, 서산시,030003, 27세,2017,1990,1168,822,142.1,1836,1079,757,142.5
34050, 서산시,030004, 28세,2017,2038,1236,802,154.1,1908,1160,748,155.1
34050, 서산시,030005, 29세,2017,1983,1172,811,144.5,1832,1086,746,145.6
34050, 서산시,035,30~34세,2017,10886,6084,4802,126.7,10093,5620,4473,125.6
34050, 서산시,035001, 30세,2017,2013,1181,832,141.9,1866,1098,768,143
34050, 서산시,035002, 31세,2017,2049,1166,883,132,1889,1078,811,132.9
34050, 서산시,035003, 32세,2017,2092,1183,909,130.1,1922,1080,842,128.3
34050, 서산시,035004, 33세,2017,2280,1238,1042,118.8,2107,1132,975,116.1
34050, 서산시,035005, 34세,2017,2452,1316,1136,115.8,2309,1232,1077,114.4
34050, 서산시,040,35~39세,2017,13577,7300,6277,116.3,12898,6852,6046,113.3
34050, 서산시,040001, 35세,2017,2737,1497,1240,120.7,2582,1394,1188,117.3
34050, 서산시,040002, 36세,2017,2666,1455,1211,120.1,2536,1372,1164,117.9
34050, 서산시,040003, 37세,2017,2871,1534,1337,114.7,2713,1427,1286,111
34050, 서산시,040004, 38세,2017,2670,1398,1272,109.9,2556,1322,1234,107.1
34050, 서산시,040005, 39세,2017,2633,1416,1217,116.4,2511,1337,1174,113.9
34050, 서산시,045,40~44세,2017,13638,7263,6375,113.9,13147,6949,6198,112.1
34050, 서산시,045001, 40세,2017,2613,1372,1241,110.6,2503,1297,1206,107.5
34050, 서산시,045002, 41세,2017,2534,1370,1164,117.7,2423,1294,1129,114.6
34050, 서산시,045003, 42세,2017,2635,1334,1301,102.5,2554,1289,1265,101.9
34050, 서산시,045004, 43세,2017,2862,1580,1282,123.2,2770,1523,1247,122.1
34050, 서산시,045005, 44세,2017,2994,1607,1387,115.9,2897,1546,1351,114.4
34050, 서산시,050,45~49세,2017,14641,7871,6770,116.3,14153,7582,6571,115.4
34050, 서산시,050001, 45세,2017,2766,1494,1272,117.5,2675,1433,1242,115.4
34050, 서산시,050002, 46세,2017,3084,1707,1377,124,2980,1645,1335,123.2
34050, 서산시,050003, 47세,2017,2799,1507,1292,116.6,2689,1444,1245,116
34050, 서산시,050004, 48세,2017,3043,1636,1407,116.3,2946,1578,1368,115.4
34050, 서산시,050005, 49세,2017,2949,1527,1422,107.4,2863,1482,1381,107.3
34050, 서산시,055,50~54세,2017,13085,7065,6020,117.4,12651,6831,5820,117.4
34050, 서산시,055001, 50세,2017,2714,1471,1243,118.3,2616,1426,1190,119.8
34050, 서산시,055002, 51세,2017,2545,1358,1187,114.4,2467,1317,1150,114.5
34050, 서산시,055003, 52세,2017,2831,1540,1291,119.3,2744,1493,1251,119.3
34050, 서산시,055004, 53세,2017,2453,1327,1126,117.9,2370,1279,1091,117.2
34050, 서산시,055005, 54세,2017,2542,1369,1173,116.7,2454,1316,1138,115.6
34050, 서산시,060,55~59세,2017,13698,7072,6626,106.7,13411,6930,6481,106.9
34050, 서산시,060001, 55세,2017,2777,1486,1291,115.1,2705,1452,1253,115.9
34050, 서산시,060002, 56세,2017,3100,1609,1491,107.9,3045,1585,1460,108.6
34050, 서산시,060003, 57세,2017,2985,1502,1483,101.3,2929,1473,1456,101.2
34050, 서산시,060004, 58세,2017,2501,1279,1222,104.7,2452,1250,1202,104
34050, 서산시,060005, 59세,2017,2335,1196,1139,105,2280,1170,1110,105.4
34050, 서산시,065,60~64세,2017,9970,4959,5011,99,9742,4838,4904,98.7
34050, 서산시,065001, 60세,2017,2277,1151,1126,102.2,2223,1123,1100,102.1
34050, 서산시,065002, 61세,2017,2138,1074,1064,100.9,2091,1047,1044,100.3
34050, 서산시,065003, 62세,2017,2123,1036,1087,95.3,2072,1012,1060,95.5
34050, 서산시,065004, 63세,2017,1874,903,971,93,1833,878,955,91.9
34050, 서산시,065005, 64세,2017,1558,795,763,104.2,1523,778,745,104.4
34050, 서산시,070,65~69세,2017,8332,4161,4171,99.8,8232,4108,4124,99.6
34050, 서산시,070001, 65세,2017,1857,917,940,97.6,1826,898,928,96.8
34050, 서산시,070002, 66세,2017,1456,730,726,100.6,1435,718,717,100.1
34050, 서산시,070003, 67세,2017,1689,824,865,95.3,1673,818,855,95.7
34050, 서산시,070004, 68세,2017,1758,903,855,105.6,1739,894,845,105.8
34050, 서산시,070005, 69세,2017,1572,787,785,100.3,1559,780,779,100.1
34050, 서산시,075,70~74세,2017,6218,2955,3263,90.6,6168,2931,3237,90.5
34050, 서산시,075001, 70세,2017,1437,671,766,87.6,1420,664,756,87.8
34050, 서산시,075002, 71세,2017,1202,605,597,101.3,1192,599,593,101
34050, 서산시,075003, 72세,2017,1085,517,568,91,1078,514,564,91.1
34050, 서산시,075004, 73세,2017,1219,544,675,80.6,1211,540,671,80.5
34050, 서산시,075005, 74세,2017,1275,618,657,94.1,1267,614,653,94
34050, 서산시,080,75~79세,2017,6323,2620,3703,70.8,6304,2615,3689,70.9
34050, 서산시,080001, 75세,2017,1748,724,1024,70.7,1743,723,1020,70.9
34050, 서산시,080002, 76세,2017,1144,482,662,72.8,1141,481,660,72.9
34050, 서산시,080003, 77세,2017,1062,448,614,73,1056,445,611,72.8
34050, 서산시,080004, 78세,2017,1168,482,686,70.3,1166,482,684,70.5
34050, 서산시,080005, 79세,2017,1201,484,717,67.5,1198,484,714,67.8
34050, 서산시,085,80~84세,2017,4579,1630,2949,55.3,4569,1627,2942,55.3
34050, 서산시,085001, 80세,2017,1032,394,638,61.8,1031,394,637,61.9
34050, 서산시,085002, 81세,2017,1004,360,644,55.9,1000,358,642,55.8
34050, 서산시,085003, 82세,2017,1002,354,648,54.6,999,353,646,54.6
34050, 서산시,085004, 83세,2017,808,281,527,53.3,807,281,526,53.4
34050, 서산시,085005, 84세,2017,733,241,492,49,732,241,491,49.1
34050, 서산시,090,85~89세,2017,2124,591,1533,38.6,2121,591,1530,38.6
34050, 서산시,090001, 85세,2017,686,219,467,46.9,685,219,466,47
34050, 서산시,090002, 86세,2017,444,122,322,37.9,444,122,322,37.9
34050, 서산시,090003, 87세,2017,367,93,274,33.9,366,93,273,34.1
34050, 서산시,090004, 88세,2017,355,97,258,37.6,355,97,258,37.6
34050, 서산시,090005, 89세,2017,272,60,212,28.3,271,60,211,28.4
34050, 서산시,095,90~94세,2017,713,150,563,26.6,711,148,563,26.3
34050, 서산시,095001, 90세,2017,211,53,158,33.5,210,52,158,32.9
34050, 서산시,095002, 91세,2017,170,29,141,20.6,170,29,141,20.6
34050, 서산시,095003, 92세,2017,142,33,109,30.3,142,33,109,30.3
34050, 서산시,095004, 93세,2017,114,24,90,26.7,113,23,90,25.6
34050, 서산시,095005, 94세,2017,76,11,65,16.9,76,11,65,16.9
34050, 서산시,100,95~99세,2017,162,27,135,20,162,27,135,20
34050, 서산시,100001, 95세,2017,71,11,60,18.3,71,11,60,18.3
34050, 서산시,100002, 96세,2017,32,6,26,23.1,32,6,26,23.1
34050, 서산시,100003, 97세,2017,22,5,17,29.4,22,5,17,29.4
34050, 서산시,100004, 98세,2017,22,X,19,15.8,22,X,19,15.8
34050, 서산시,100005, 99세,2017,15,X,13,15.4,15,X,13,15.4
34050, 서산시,101,100세이상,2017,29,X,26,11.5,29,X,26,11.5
34050, 서산시,102,15세미만,2017,25038,13056,11982,109,24879,12973,11906,109
34050, 서산시,103,15~64세,2017,117846,63609,54237,117.3,112789,60724,52065,116.6
34050, 서산시,104,65세이상,2017,28480,12137,16343,74.3,28296,12050,16246,74.2
34050, 서산시,086,85세이상,2017,3028,771,2257,34.2,3023,769,2254,34.1
34050, 서산시,126,평균연령,2017,42.1,40.6,43.7,,42.2,40.7,43.9,
34050, 서산시,127,중위연령,2017,43,41.4,44.6,,43.3,41.8,44.9,
34060, 논산시,000,합계,2017,123774,62102,61672,100.7,118862,59528,59334,100.3
34060, 논산시,005,0~4세,2017,3833,1941,1892,102.6,3812,1931,1881,102.7
34060, 논산시,005001, 0세,2017,654,336,318,105.7,652,335,317,105.7
34060, 논산시,005002, 1세,2017,757,389,368,105.7,750,387,363,106.6
34060, 논산시,005003, 2세,2017,818,405,413,98.1,812,402,410,98
34060, 논산시,005004, 3세,2017,778,400,378,105.8,773,396,377,105
34060, 논산시,005005, 4세,2017,826,411,415,99,825,411,414,99.3
34060, 논산시,010,5~9세,2017,4576,2347,2229,105.3,4559,2338,2221,105.3
34060, 논산시,010001, 5세,2017,904,467,437,106.9,899,465,434,107.1
34060, 논산시,010002, 6세,2017,883,462,421,109.7,880,460,420,109.5
34060, 논산시,010003, 7세,2017,899,465,434,107.1,897,464,433,107.2
34060, 논산시,010004, 8세,2017,887,451,436,103.4,884,449,435,103.2
34060, 논산시,010005, 9세,2017,1003,502,501,100.2,999,500,499,100.2
34060, 논산시,015,10~14세,2017,4889,2499,2390,104.6,4874,2492,2382,104.6
34060, 논산시,015001, 10세,2017,1009,551,458,120.3,1007,549,458,119.9
34060, 논산시,015002, 11세,2017,971,484,487,99.4,970,483,487,99.2
34060, 논산시,015003, 12세,2017,915,469,446,105.2,910,467,443,105.4
34060, 논산시,015004, 13세,2017,1003,498,505,98.6,997,496,501,99
34060, 논산시,015005, 14세,2017,991,497,494,100.6,990,497,493,100.8
34060, 논산시,020,15~19세,2017,7804,4292,3512,122.2,7712,4246,3466,122.5
34060, 논산시,020001, 15세,2017,1151,644,507,127,1149,643,506,127.1
34060, 논산시,020002, 16세,2017,1604,963,641,150.2,1598,962,636,151.3
34060, 논산시,020003, 17세,2017,1714,1008,706,142.8,1711,1007,704,143
34060, 논산시,020004, 18세,2017,1591,800,791,101.1,1578,793,785,101
34060, 논산시,020005, 19세,2017,1744,877,867,101.2,1676,841,835,100.7
34060, 논산시,025,20~24세,2017,8392,4510,3882,116.2,7331,4026,3305,121.8
34060, 논산시,025001, 20세,2017,1768,879,889,98.9,1644,828,816,101.5
34060, 논산시,025002, 21세,2017,1729,912,817,111.6,1553,829,724,114.5
34060, 논산시,025003, 22세,2017,1734,955,779,122.6,1503,856,647,132.3
34060, 논산시,025004, 23세,2017,1649,913,736,124,1385,787,598,131.6
34060, 논산시,025005, 24세,2017,1512,851,661,128.7,1246,726,520,139.6
34060, 논산시,030,25~29세,2017,6593,3715,2878,129.1,5458,3131,2327,134.6
34060, 논산시,030001, 25세,2017,1468,812,656,123.8,1199,682,517,131.9
34060, 논산시,030002, 26세,2017,1330,734,596,123.2,1097,624,473,131.9
34060, 논산시,030003, 27세,2017,1298,757,541,139.9,1078,654,424,154.2
34060, 논산시,030004, 28세,2017,1249,722,527,137,1041,597,444,134.5
34060, 논산시,030005, 29세,2017,1248,690,558,123.7,1043,574,469,122.4
34060, 논산시,035,30~34세,2017,6146,3310,2836,116.7,5333,2856,2477,115.3
34060, 논산시,035001, 30세,2017,1172,643,529,121.6,989,529,460,115
34060, 논산시,035002, 31세,2017,1245,667,578,115.4,1056,572,484,118.2
34060, 논산시,035003, 32세,2017,1107,575,532,108.1,961,500,461,108.5
34060, 논산시,035004, 33세,2017,1252,674,578,116.6,1093,577,516,111.8
34060, 논산시,035005, 34세,2017,1370,751,619,121.3,1234,678,556,121.9
34060, 논산시,040,35~39세,2017,7004,3705,3299,112.3,6430,3371,3059,110.2
34060, 논산시,040001, 35세,2017,1413,766,647,118.4,1250,673,577,116.6
34060, 논산시,040002, 36세,2017,1451,754,697,108.2,1346,699,647,108
34060, 논산시,040003, 37세,2017,1460,748,712,105.1,1338,675,663,101.8
34060, 논산시,040004, 38세,2017,1389,731,658,111.1,1294,675,619,109
34060, 논산시,040005, 39세,2017,1291,706,585,120.7,1202,649,553,117.4
34060, 논산시,045,40~44세,2017,7789,4192,3597,116.5,7473,4002,3471,115.3
34060, 논산시,045001, 40세,2017,1445,739,706,104.7,1377,699,678,103.1
34060, 논산시,045002, 41세,2017,1390,759,631,120.3,1321,722,599,120.5
34060, 논산시,045003, 42세,2017,1567,849,718,118.2,1499,807,692,116.6
34060, 논산시,045004, 43세,2017,1679,943,736,128.1,1626,902,724,124.6
34060, 논산시,045005, 44세,2017,1708,902,806,111.9,1650,872,778,112.1
34060, 논산시,050,45~49세,2017,9043,4828,4215,114.5,8778,4678,4100,114.1
34060, 논산시,050001, 45세,2017,1693,907,786,115.4,1644,878,766,114.6
34060, 논산시,050002, 46세,2017,1882,980,902,108.6,1819,947,872,108.6
34060, 논산시,050003, 47세,2017,1713,954,759,125.7,1654,921,733,125.6
34060, 논산시,050004, 48세,2017,1869,985,884,111.4,1824,959,865,110.9
34060, 논산시,050005, 49세,2017,1886,1002,884,113.3,1837,973,864,112.6
34060, 논산시,055,50~54세,2017,9116,4774,4342,109.9,8891,4661,4230,110.2
34060, 논산시,055001, 50세,2017,1800,951,849,112,1759,930,829,112.2
34060, 논산시,055002, 51세,2017,1659,884,775,114.1,1619,866,753,115
34060, 논산시,055003, 52세,2017,1926,952,974,97.7,1882,929,953,97.5
34060, 논산시,055004, 53세,2017,1837,978,859,113.9,1795,958,837,114.5
34060, 논산시,055005, 54세,2017,1894,1009,885,114,1836,978,858,114
34060, 논산시,060,55~59세,2017,11055,5584,5471,102.1,10881,5490,5391,101.8
34060, 논산시,060001, 55세,2017,2061,1059,1002,105.7,2025,1037,988,105
34060, 논산시,060002, 56세,2017,2347,1181,1166,101.3,2316,1161,1155,100.5
34060, 논산시,060003, 57세,2017,2366,1176,1190,98.8,2325,1156,1169,98.9
34060, 논산시,060004, 58세,2017,2187,1100,1087,101.2,2152,1083,1069,101.3
34060, 논산시,060005, 59세,2017,2094,1068,1026,104.1,2063,1053,1010,104.3
34060, 논산시,065,60~64세,2017,9544,4845,4699,103.1,9417,4783,4634,103.2
34060, 논산시,065001, 60세,2017,2020,1060,960,110.4,1988,1044,944,110.6
34060, 논산시,065002, 61세,2017,2008,1009,999,101,1976,998,978,102
34060, 논산시,065003, 62세,2017,2072,1085,987,109.9,2050,1075,975,110.3
34060, 논산시,065004, 63세,2017,1912,928,984,94.3,1886,911,975,93.4
34060, 논산시,065005, 64세,2017,1532,763,769,99.2,1517,755,762,99.1
34060, 논산시,070,65~69세,2017,7389,3559,3830,92.9,7350,3537,3813,92.8
34060, 논산시,070001, 65세,2017,1565,756,809,93.4,1553,750,803,93.4
34060, 논산시,070002, 66세,2017,1345,653,692,94.4,1336,647,689,93.9
34060, 논산시,070003, 67세,2017,1549,769,780,98.6,1537,760,777,97.8
34060, 논산시,070004, 68세,2017,1510,708,802,88.3,1505,707,798,88.6
34060, 논산시,070005, 69세,2017,1420,673,747,90.1,1419,673,746,90.2
34060, 논산시,075,70~74세,2017,5936,2700,3236,83.4,5924,2696,3228,83.5
34060, 논산시,075001, 70세,2017,1393,676,717,94.3,1389,674,715,94.3
34060, 논산시,075002, 71세,2017,988,469,519,90.4,985,468,517,90.5
34060, 논산시,075003, 72세,2017,1123,499,624,80,1122,498,624,79.8
34060, 논산시,075004, 73세,2017,1229,524,705,74.3,1227,524,703,74.5
34060, 논산시,075005, 74세,2017,1203,532,671,79.3,1201,532,669,79.5
34060, 논산시,080,75~79세,2017,6551,2597,3954,65.7,6538,2591,3947,65.6
34060, 논산시,080001, 75세,2017,1643,707,936,75.5,1639,704,935,75.3
34060, 논산시,080002, 76세,2017,1288,495,793,62.4,1285,495,790,62.7
34060, 논산시,080003, 77세,2017,1167,478,689,69.4,1165,478,687,69.6
34060, 논산시,080004, 78세,2017,1287,508,779,65.2,1284,505,779,64.8
34060, 논산시,080005, 79세,2017,1166,409,757,54,1165,409,756,54.1
34060, 논산시,085,80~84세,2017,4925,1781,3144,56.6,4919,1778,3141,56.6
34060, 논산시,085001, 80세,2017,1147,444,703,63.2,1147,444,703,63.2
34060, 논산시,085002, 81세,2017,1066,397,669,59.3,1063,395,668,59.1
34060, 논산시,085003, 82세,2017,1067,356,711,50.1,1066,356,710,50.1
34060, 논산시,085004, 83세,2017,903,327,576,56.8,902,326,576,56.6
34060, 논산시,085005, 84세,2017,742,257,485,53,741,257,484,53.1
34060, 논산시,090,85~89세,2017,2275,684,1591,43,2270,682,1588,42.9
34060, 논산시,090001, 85세,2017,671,218,453,48.1,671,218,453,48.1
34060, 논산시,090002, 86세,2017,482,150,332,45.2,482,150,332,45.2
34060, 논산시,090003, 87세,2017,427,117,310,37.7,426,117,309,37.9
34060, 논산시,090004, 88세,2017,357,105,252,41.7,353,103,250,41.2
34060, 논산시,090005, 89세,2017,338,94,244,38.5,338,94,244,38.5
34060, 논산시,095,90~94세,2017,723,194,529,36.7,721,194,527,36.8
34060, 논산시,095001, 90세,2017,266,84,182,46.2,265,84,181,46.4
34060, 논산시,095002, 91세,2017,157,36,121,29.8,157,36,121,29.8
34060, 논산시,095003, 92세,2017,129,32,97,33,129,32,97,33
34060, 논산시,095004, 93세,2017,80,20,60,33.3,80,20,60,33.3
34060, 논산시,095005, 94세,2017,91,22,69,31.9,90,22,68,32.4
34060, 논산시,100,95~99세,2017,172,43,129,33.3,172,43,129,33.3
34060, 논산시,100001, 95세,2017,65,17,48,35.4,65,17,48,35.4
34060, 논산시,100002, 96세,2017,43,10,33,30.3,43,10,33,30.3
34060, 논산시,100003, 97세,2017,34,6,28,21.4,34,6,28,21.4
34060, 논산시,100004, 98세,2017,20,5,15,33.3,20,5,15,33.3
34060, 논산시,100005, 99세,2017,10,5,5,100,10,5,5,100
34060, 논산시,101,100세이상,2017,19,X,17,11.8,19,X,17,11.8
34060, 논산시,102,15세미만,2017,13298,6787,6511,104.2,13245,6761,6484,104.3
34060, 논산시,103,15~64세,2017,82486,43755,38731,113,77704,41244,36460,113.1
34060, 논산시,104,65세이상,2017,27990,11560,16430,70.4,27913,11523,16390,70.3
34060, 논산시,086,85세이상,2017,3189,923,2266,40.7,3182,921,2261,40.7
34060, 논산시,126,평균연령,2017,45.8,43.9,47.8,,46.3,44.3,48.3,
34060, 논산시,127,중위연령,2017,47.8,45.6,50.1,,48.7,46.5,51.2,
34070, 계룡시,000,합계,2017,41858,20761,21097,98.4,41627,20649,20978,98.4
34070, 계룡시,005,0~4세,2017,2016,1003,1013,99,2016,1003,1013,99
34070, 계룡시,005001, 0세,2017,321,171,150,114,321,171,150,114
34070, 계룡시,005002, 1세,2017,399,201,198,101.5,399,201,198,101.5
34070, 계룡시,005003, 2세,2017,421,194,227,85.5,421,194,227,85.5
34070, 계룡시,005004, 3세,2017,408,196,212,92.5,408,196,212,92.5
34070, 계룡시,005005, 4세,2017,467,241,226,106.6,467,241,226,106.6
34070, 계룡시,010,5~9세,2017,2698,1411,1287,109.6,2697,1411,1286,109.7
34070, 계룡시,010001, 5세,2017,509,259,250,103.6,509,259,250,103.6
34070, 계룡시,010002, 6세,2017,545,299,246,121.5,545,299,246,121.5
34070, 계룡시,010003, 7세,2017,552,280,272,102.9,551,280,271,103.3
34070, 계룡시,010004, 8세,2017,522,275,247,111.3,522,275,247,111.3
34070, 계룡시,010005, 9세,2017,570,298,272,109.6,570,298,272,109.6
34070, 계룡시,015,10~14세,2017,3178,1622,1556,104.2,3178,1622,1556,104.2
34070, 계룡시,015001, 10세,2017,658,339,319,106.3,658,339,319,106.3
34070, 계룡시,015002, 11세,2017,621,321,300,107,621,321,300,107
34070, 계룡시,015003, 12세,2017,587,293,294,99.7,587,293,294,99.7
34070, 계룡시,015004, 13세,2017,626,318,308,103.2,626,318,308,103.2
34070, 계룡시,015005, 14세,2017,686,351,335,104.8,686,351,335,104.8
34070, 계룡시,020,15~19세,2017,2997,1518,1479,102.6,2993,1517,1476,102.8
34070, 계룡시,020001, 15세,2017,634,314,320,98.1,634,314,320,98.1
34070, 계룡시,020002, 16세,2017,667,316,351,90,665,315,350,90
34070, 계룡시,020003, 17세,2017,673,337,336,100.3,672,337,335,100.6
34070, 계룡시,020004, 18세,2017,622,332,290,114.5,622,332,290,114.5
34070, 계룡시,020005, 19세,2017,401,219,182,120.3,400,219,181,121
34070, 계룡시,025,20~24세,2017,2199,1292,907,142.4,2177,1283,894,143.5
34070, 계룡시,025001, 20세,2017,477,311,166,187.3,475,310,165,187.9
34070, 계룡시,025002, 21세,2017,483,300,183,163.9,481,299,182,164.3
34070, 계룡시,025003, 22세,2017,459,274,185,148.1,456,272,184,147.8
34070, 계룡시,025004, 23세,2017,399,214,185,115.7,389,210,179,117.3
34070, 계룡시,025005, 24세,2017,381,193,188,102.7,376,192,184,104.3
34070, 계룡시,030,25~29세,2017,1814,996,818,121.8,1767,972,795,122.3
34070, 계룡시,030001, 25세,2017,427,235,192,122.4,417,229,188,121.8
34070, 계룡시,030002, 26세,2017,339,175,164,106.7,325,168,157,107
34070, 계룡시,030003, 27세,2017,376,230,146,157.5,365,223,142,157
34070, 계룡시,030004, 28세,2017,325,170,155,109.7,317,167,150,111.3
34070, 계룡시,030005, 29세,2017,347,186,161,115.5,343,185,158,117.1
34070, 계룡시,035,30~34세,2017,2031,984,1047,94,2011,976,1035,94.3
34070, 계룡시,035001, 30세,2017,335,166,169,98.2,329,163,166,98.2
34070, 계룡시,035002, 31세,2017,352,188,164,114.6,349,186,163,114.1
34070, 계룡시,035003, 32세,2017,389,188,201,93.5,386,188,198,94.9
34070, 계룡시,035004, 33세,2017,449,207,242,85.5,446,205,241,85.1
34070, 계룡시,035005, 34세,2017,506,235,271,86.7,501,234,267,87.6
34070, 계룡시,040,35~39세,2017,3381,1595,1786,89.3,3357,1584,1773,89.3
34070, 계룡시,040001, 35세,2017,604,279,325,85.8,596,277,319,86.8
34070, 계룡시,040002, 36세,2017,631,313,318,98.4,628,311,317,98.1
34070, 계룡시,040003, 37세,2017,751,355,396,89.6,748,353,395,89.4
34070, 계룡시,040004, 38세,2017,722,314,408,77,716,310,406,76.4
34070, 계룡시,040005, 39세,2017,673,334,339,98.5,669,333,336,99.1
34070, 계룡시,045,40~44세,2017,4130,1941,2189,88.7,4107,1926,2181,88.3
34070, 계룡시,045001, 40세,2017,740,340,400,85,735,337,398,84.7
34070, 계룡시,045002, 41세,2017,728,342,386,88.6,723,339,384,88.3
34070, 계룡시,045003, 42세,2017,780,373,407,91.6,773,369,404,91.3
34070, 계룡시,045004, 43세,2017,970,466,504,92.5,968,464,504,92.1
34070, 계룡시,045005, 44세,2017,912,420,492,85.4,908,417,491,84.9
34070, 계룡시,050,45~49세,2017,4890,2450,2440,100.4,4873,2442,2431,100.5
34070, 계룡시,050001, 45세,2017,1024,543,481,112.9,1021,542,479,113.2
34070, 계룡시,050002, 46세,2017,1058,515,543,94.8,1057,515,542,95
34070, 계룡시,050003, 47세,2017,934,457,477,95.8,929,455,474,96
34070, 계룡시,050004, 48세,2017,952,464,488,95.1,947,461,486,94.9
34070, 계룡시,050005, 49세,2017,922,471,451,104.4,919,469,450,104.2
34070, 계룡시,055,50~54세,2017,3343,1731,1612,107.4,3311,1720,1591,108.1
34070, 계룡시,055001, 50세,2017,744,389,355,109.6,738,387,351,110.3
34070, 계룡시,055002, 51세,2017,705,389,316,123.1,698,387,311,124.4
34070, 계룡시,055003, 52세,2017,697,350,347,100.9,692,348,344,101.2
34070, 계룡시,055004, 53세,2017,598,306,292,104.8,590,303,287,105.6
34070, 계룡시,055005, 54세,2017,599,297,302,98.3,593,295,298,99
34070, 계룡시,060,55~59세,2017,2947,1450,1497,96.9,2934,1442,1492,96.6
34070, 계룡시,060001, 55세,2017,606,313,293,106.8,601,311,290,107.2
34070, 계룡시,060002, 56세,2017,664,333,331,100.6,662,331,331,100
34070, 계룡시,060003, 57세,2017,606,291,315,92.4,606,291,315,92.4
34070, 계룡시,060004, 58세,2017,541,260,281,92.5,539,259,280,92.5
34070, 계룡시,060005, 59세,2017,530,253,277,91.3,526,250,276,90.6
34070, 계룡시,065,60~64세,2017,2162,1096,1066,102.8,2151,1090,1061,102.7
34070, 계룡시,065001, 60세,2017,503,256,247,103.6,502,255,247,103.2
34070, 계룡시,065002, 61세,2017,453,226,227,99.6,451,224,227,98.7
34070, 계룡시,065003, 62세,2017,452,229,223,102.7,450,227,223,101.8
34070, 계룡시,065004, 63세,2017,392,197,195,101,389,197,192,102.6
34070, 계룡시,065005, 64세,2017,362,188,174,108,359,187,172,108.7
34070, 계룡시,070,65~69세,2017,1303,636,667,95.4,1290,627,663,94.6
34070, 계룡시,070001, 65세,2017,320,154,166,92.8,319,153,166,92.2
34070, 계룡시,070002, 66세,2017,231,118,113,104.4,229,117,112,104.5
34070, 계룡시,070003, 67세,2017,238,121,117,103.4,233,118,115,102.6
34070, 계룡시,070004, 68세,2017,278,128,150,85.3,273,124,149,83.2
34070, 계룡시,070005, 69세,2017,236,115,121,95,236,115,121,95
34070, 계룡시,075,70~74세,2017,926,460,466,98.7,924,460,464,99.1
34070, 계룡시,075001, 70세,2017,248,143,105,136.2,247,143,104,137.5
34070, 계룡시,075002, 71세,2017,142,71,71,100,141,71,70,101.4
34070, 계룡시,075003, 72세,2017,169,78,91,85.7,169,78,91,85.7
34070, 계룡시,075004, 73세,2017,185,86,99,86.9,185,86,99,86.9
34070, 계룡시,075005, 74세,2017,182,82,100,82,182,82,100,82
34070, 계룡시,080,75~79세,2017,792,288,504,57.1,792,288,504,57.1
34070, 계룡시,080001, 75세,2017,175,59,116,50.9,175,59,116,50.9
34070, 계룡시,080002, 76세,2017,161,54,107,50.5,161,54,107,50.5
34070, 계룡시,080003, 77세,2017,137,69,68,101.5,137,69,68,101.5
34070, 계룡시,080004, 78세,2017,173,54,119,45.4,173,54,119,45.4
34070, 계룡시,080005, 79세,2017,146,52,94,55.3,146,52,94,55.3
34070, 계룡시,085,80~84세,2017,617,184,433,42.5,617,184,433,42.5
34070, 계룡시,085001, 80세,2017,143,44,99,44.4,143,44,99,44.4
34070, 계룡시,085002, 81세,2017,134,39,95,41.1,134,39,95,41.1
34070, 계룡시,085003, 82세,2017,116,36,80,45,116,36,80,45
34070, 계룡시,085004, 83세,2017,119,36,83,43.4,119,36,83,43.4
34070, 계룡시,085005, 84세,2017,105,29,76,38.2,105,29,76,38.2
34070, 계룡시,090,85~89세,2017,296,72,224,32.1,294,70,224,31.3
34070, 계룡시,090001, 85세,2017,82,25,57,43.9,81,24,57,42.1
34070, 계룡시,090002, 86세,2017,58,12,46,26.1,57,11,46,23.9
34070, 계룡시,090003, 87세,2017,58,14,44,31.8,58,14,44,31.8
34070, 계룡시,090004, 88세,2017,55,13,42,31,55,13,42,31
34070, 계룡시,090005, 89세,2017,43,8,35,22.9,43,8,35,22.9
34070, 계룡시,095,90~94세,2017,114,27,87,31,114,27,87,31
34070, 계룡시,095001, 90세,2017,42,14,28,50,42,14,28,50
34070, 계룡시,095002, 91세,2017,20,7,13,53.8,20,7,13,53.8
34070, 계룡시,095003, 92세,2017,24,X,21,14.3,24,X,21,14.3
34070, 계룡시,095004, 93세,2017,12,X,12,0,12,X,12,0
34070, 계룡시,095005, 94세,2017,16,X,13,23.1,16,X,13,23.1
34070, 계룡시,100,95~99세,2017,22,5,17,29.4,22,5,17,29.4
34070, 계룡시,100001, 95세,2017,9,X,7,28.6,9,X,7,28.6
34070, 계룡시,100002, 96세,2017,5,X,X,66.7,5,X,X,66.7
34070, 계룡시,100003, 97세,2017,X,X,X,50,X,X,X,50
34070, 계룡시,100004, 98세,2017,5,X,5,0,5,X,5,0
34070, 계룡시,100005, 99세,2017,X,X,X,,X,X,X,
34070, 계룡시,101,100세이상,2017,X,X,X,0,X,X,X,0
34070, 계룡시,102,15세미만,2017,7892,4036,3856,104.7,7891,4036,3855,104.7
34070, 계룡시,103,15~64세,2017,29894,15053,14841,101.4,29681,14952,14729,101.5
34070, 계룡시,104,65세이상,2017,4072,1672,2400,69.7,4055,1661,2394,69.4
34070, 계룡시,086,85세이상,2017,434,104,330,31.5,432,102,330,30.9
34070, 계룡시,126,평균연령,2017,38.3,37.2,39.4,,38.3,37.2,39.4,
34070, 계룡시,127,중위연령,2017,40.8,39.9,41.7,,40.8,39.9,41.7,
34080, 당진시,000,합계,2017,168508,89656,78852,113.7,161378,84884,76494,111
34080, 당진시,005,0~4세,2017,8873,4496,4377,102.7,8789,4454,4335,102.7
34080, 당진시,005001, 0세,2017,1627,831,796,104.4,1604,820,784,104.6
34080, 당진시,005002, 1세,2017,1698,861,837,102.9,1685,854,831,102.8
34080, 당진시,005003, 2세,2017,1870,936,934,100.2,1854,929,925,100.4
34080, 당진시,005004, 3세,2017,1848,925,923,100.2,1832,917,915,100.2
34080, 당진시,005005, 4세,2017,1830,943,887,106.3,1814,934,880,106.1
34080, 당진시,010,5~9세,2017,8978,4650,4328,107.4,8941,4626,4315,107.2
34080, 당진시,010001, 5세,2017,1874,960,914,105,1863,954,909,105
34080, 당진시,010002, 6세,2017,1911,999,912,109.5,1903,995,908,109.6
34080, 당진시,010003, 7세,2017,1797,949,848,111.9,1791,943,848,111.2
34080, 당진시,010004, 8세,2017,1682,836,846,98.8,1675,831,844,98.5
34080, 당진시,010005, 9세,2017,1714,906,808,112.1,1709,903,806,112
34080, 당진시,015,10~14세,2017,7502,3960,3542,111.8,7478,3947,3531,111.8
34080, 당진시,015001, 10세,2017,1690,910,780,116.7,1682,905,777,116.5
34080, 당진시,015002, 11세,2017,1486,792,694,114.1,1483,792,691,114.6
34080, 당진시,015003, 12세,2017,1414,732,682,107.3,1409,728,681,106.9
34080, 당진시,015004, 13세,2017,1511,775,736,105.3,1507,774,733,105.6
34080, 당진시,015005, 14세,2017,1401,751,650,115.5,1397,748,649,115.3
34080, 당진시,020,15~19세,2017,8559,4557,4002,113.9,8500,4526,3974,113.9
34080, 당진시,020001, 15세,2017,1468,798,670,119.1,1461,794,667,119
34080, 당진시,020002, 16세,2017,1709,878,831,105.7,1700,872,828,105.3
34080, 당진시,020003, 17세,2017,1784,941,843,111.6,1776,936,840,111.4
34080, 당진시,020004, 18세,2017,1748,927,821,112.9,1740,922,818,112.7
34080, 당진시,020005, 19세,2017,1850,1013,837,121,1823,1002,821,122
34080, 당진시,025,20~24세,2017,8759,5013,3746,133.8,8168,4593,3575,128.5
34080, 당진시,025001, 20세,2017,1788,946,842,112.4,1740,923,817,113
34080, 당진시,025002, 21세,2017,1764,1038,726,143,1680,970,710,136.6
34080, 당진시,025003, 22세,2017,1727,997,730,136.6,1596,899,697,129
34080, 당진시,025004, 23세,2017,1739,1034,705,146.7,1578,925,653,141.7
34080, 당진시,025005, 24세,2017,1741,998,743,134.3,1574,876,698,125.5
34080, 당진시,030,25~29세,2017,10030,6152,3878,158.6,8859,5300,3559,148.9
34080, 당진시,030001, 25세,2017,1841,1120,721,155.3,1654,979,675,145
34080, 당진시,030002, 26세,2017,1917,1189,728,163.3,1708,1036,672,154.2
34080, 당진시,030003, 27세,2017,1991,1242,749,165.8,1736,1059,677,156.4
34080, 당진시,030004, 28세,2017,2111,1261,850,148.4,1857,1084,773,140.2
34080, 당진시,030005, 29세,2017,2170,1340,830,161.4,1904,1142,762,149.9
34080, 당진시,035,30~34세,2017,12473,7309,5164,141.5,11146,6351,4795,132.5
34080, 당진시,035001, 30세,2017,2304,1348,956,141,2007,1132,875,129.4
34080, 당진시,035002, 31세,2017,2286,1344,942,142.7,2000,1147,853,134.5
34080, 당진시,035003, 32세,2017,2484,1474,1010,145.9,2192,1262,930,135.7
34080, 당진시,035004, 33세,2017,2554,1481,1073,138,2332,1315,1017,129.3
34080, 당진시,035005, 34세,2017,2845,1662,1183,140.5,2615,1495,1120,133.5
34080, 당진시,040,35~39세,2017,14678,8210,6468,126.9,13734,7518,6216,120.9
34080, 당진시,040001, 35세,2017,3139,1793,1346,133.2,2907,1628,1279,127.3
34080, 당진시,040002, 36세,2017,3083,1713,1370,125,2898,1571,1327,118.4
34080, 당진시,040003, 37세,2017,3089,1687,1402,120.3,2893,1535,1358,113
34080, 당진시,040004, 38세,2017,2798,1580,1218,129.7,2647,1476,1171,126
34080, 당진시,040005, 39세,2017,2569,1437,1132,126.9,2389,1308,1081,121
34080, 당진시,045,40~44세,2017,13298,7449,5849,127.4,12583,6981,5602,124.6
34080, 당진시,045001, 40세,2017,2745,1522,1223,124.4,2573,1413,1160,121.8
34080, 당진시,045002, 41세,2017,2475,1356,1119,121.2,2348,1269,1079,117.6
34080, 당진시,045003, 42세,2017,2547,1450,1097,132.2,2408,1360,1048,129.8
34080, 당진시,045004, 43세,2017,2732,1577,1155,136.5,2600,1496,1104,135.5
34080, 당진시,045005, 44세,2017,2799,1544,1255,123,2654,1443,1211,119.2
34080, 당진시,050,45~49세,2017,13228,7528,5700,132.1,12567,7116,5451,130.5
34080, 당진시,050001, 45세,2017,2523,1466,1057,138.7,2390,1376,1014,135.7
34080, 당진시,050002, 46세,2017,2815,1632,1183,138,2656,1528,1128,135.5
34080, 당진시,050003, 47세,2017,2534,1416,1118,126.7,2384,1323,1061,124.7
34080, 당진시,050004, 48세,2017,2748,1536,1212,126.7,2641,1477,1164,126.9
34080, 당진시,050005, 49세,2017,2608,1478,1130,130.8,2496,1412,1084,130.3
34080, 당진시,055,50~54세,2017,12080,6749,5331,126.6,11475,6391,5084,125.7
34080, 당진시,055001, 50세,2017,2488,1356,1132,119.8,2382,1292,1090,118.5
34080, 당진시,055002, 51세,2017,2223,1254,969,129.4,2122,1200,922,130.2
34080, 당진시,055003, 52세,2017,2648,1477,1171,126.1,2504,1397,1107,126.2
34080, 당진시,055004, 53세,2017,2365,1361,1004,135.6,2232,1272,960,132.5
34080, 당진시,055005, 54세,2017,2356,1301,1055,123.3,2235,1230,1005,122.4
34080, 당진시,060,55~59세,2017,12658,6678,5980,111.7,12263,6458,5805,111.2
34080, 당진시,060001, 55세,2017,2569,1396,1173,119,2466,1338,1128,118.6
34080, 당진시,060002, 56세,2017,2756,1452,1304,111.3,2689,1413,1276,110.7
34080, 당진시,060003, 57세,2017,2729,1419,1310,108.3,2648,1384,1264,109.5
34080, 당진시,060004, 58세,2017,2381,1248,1133,110.2,2306,1206,1100,109.6
34080, 당진시,060005, 59세,2017,2223,1163,1060,109.7,2154,1117,1037,107.7
34080, 당진시,065,60~64세,2017,9858,4986,4872,102.3,9552,4809,4743,101.4
34080, 당진시,065001, 60세,2017,2246,1178,1068,110.3,2168,1130,1038,108.9
34080, 당진시,065002, 61세,2017,2132,1074,1058,101.5,2063,1033,1030,100.3
34080, 당진시,065003, 62세,2017,2190,1118,1072,104.3,2139,1088,1051,103.5
34080, 당진시,065004, 63세,2017,1777,863,914,94.4,1715,832,883,94.2
34080, 당진시,065005, 64세,2017,1513,753,760,99.1,1467,726,741,98
34080, 당진시,070,65~69세,2017,7900,3908,3992,97.9,7792,3847,3945,97.5
34080, 당진시,070001, 65세,2017,1820,912,908,100.4,1782,893,889,100.4
34080, 당진시,070002, 66세,2017,1376,701,675,103.9,1352,683,669,102.1
34080, 당진시,070003, 67세,2017,1630,767,863,88.9,1612,758,854,88.8
34080, 당진시,070004, 68세,2017,1607,803,804,99.9,1590,792,798,99.2
34080, 당진시,070005, 69세,2017,1467,725,742,97.7,1456,721,735,98.1
34080, 당진시,075,70~74세,2017,5918,2883,3035,95,5870,2858,3012,94.9
34080, 당진시,075001, 70세,2017,1488,764,724,105.5,1479,761,718,106
34080, 당진시,075002, 71세,2017,1072,533,539,98.9,1059,526,533,98.7
34080, 당진시,075003, 72세,2017,1033,512,521,98.3,1027,509,518,98.3
34080, 당진시,075004, 73세,2017,1146,519,627,82.8,1136,515,621,82.9
34080, 당진시,075005, 74세,2017,1179,555,624,88.9,1169,547,622,87.9
34080, 당진시,080,75~79세,2017,6336,2655,3681,72.1,6304,2643,3661,72.2
34080, 당진시,080001, 75세,2017,1631,704,927,75.9,1628,703,925,76
34080, 당진시,080002, 76세,2017,1171,495,676,73.2,1163,491,672,73.1
34080, 당진시,080003, 77세,2017,1093,456,637,71.6,1084,453,631,71.8
34080, 당진시,080004, 78세,2017,1241,502,739,67.9,1236,500,736,67.9
34080, 당진시,080005, 79세,2017,1200,498,702,70.9,1193,496,697,71.2
34080, 당진시,085,80~84세,2017,4593,1699,2894,58.7,4577,1695,2882,58.8
34080, 당진시,085001, 80세,2017,1073,400,673,59.4,1071,399,672,59.4
34080, 당진시,085002, 81세,2017,1053,415,638,65,1047,415,632,65.7
34080, 당진시,085003, 82세,2017,996,359,637,56.4,992,357,635,56.2
34080, 당진시,085004, 83세,2017,803,305,498,61.2,801,305,496,61.5
34080, 당진시,085005, 84세,2017,668,220,448,49.1,666,219,447,49
34080, 당진시,090,85~89세,2017,1976,577,1399,41.2,1969,574,1395,41.1
34080, 당진시,090001, 85세,2017,571,176,395,44.6,570,176,394,44.7
34080, 당진시,090002, 86세,2017,390,108,282,38.3,388,107,281,38.1
34080, 당진시,090003, 87세,2017,406,120,286,42,403,119,284,41.9
34080, 당진시,090004, 88세,2017,335,92,243,37.9,334,91,243,37.4
34080, 당진시,090005, 89세,2017,274,81,193,42,274,81,193,42
34080, 당진시,095,90~94세,2017,616,165,451,36.6,616,165,451,36.6
34080, 당진시,095001, 90세,2017,193,58,135,43,193,58,135,43
34080, 당진시,095002, 91세,2017,119,38,81,46.9,119,38,81,46.9
34080, 당진시,095003, 92세,2017,101,34,67,50.7,101,34,67,50.7
34080, 당진시,095004, 93세,2017,111,19,92,20.7,111,19,92,20.7
34080, 당진시,095005, 94세,2017,92,16,76,21.1,92,16,76,21.1
34080, 당진시,100,95~99세,2017,179,30,149,20.1,179,30,149,20.1
34080, 당진시,100001, 95세,2017,73,10,63,15.9,73,10,63,15.9
34080, 당진시,100002, 96세,2017,42,7,35,20,42,7,35,20
34080, 당진시,100003, 97세,2017,35,7,28,25,35,7,28,25
34080, 당진시,100004, 98세,2017,16,5,11,45.5,16,5,11,45.5
34080, 당진시,100005, 99세,2017,13,X,12,8.3,13,X,12,8.3
34080, 당진시,101,100세이상,2017,16,X,14,14.3,16,X,14,14.3
34080, 당진시,102,15세미만,2017,25353,13106,12247,107,25208,13027,12181,106.9
34080, 당진시,103,15~64세,2017,115621,64631,50990,126.8,108847,60043,48804,123
34080, 당진시,104,65세이상,2017,27534,11919,15615,76.3,27323,11814,15509,76.2
34080, 당진시,086,85세이상,2017,2787,774,2013,38.5,2780,771,2009,38.4
34080, 당진시,126,평균연령,2017,41.6,40.3,43.1,,41.7,40.4,43.2,
34080, 당진시,127,중위연령,2017,41.7,40.3,43.4,,42.1,40.8,43.6,
34310, 금산군,000,합계,2017,55672,28047,27625,101.5,53499,26889,26610,101
34310, 금산군,005,0~4세,2017,1362,686,676,101.5,1357,682,675,101
34310, 금산군,005001, 0세,2017,251,126,125,100.8,250,125,125,100
34310, 금산군,005002, 1세,2017,237,111,126,88.1,237,111,126,88.1
34310, 금산군,005003, 2세,2017,284,136,148,91.9,282,134,148,90.5
34310, 금산군,005004, 3세,2017,285,145,140,103.6,283,144,139,103.6
34310, 금산군,005005, 4세,2017,305,168,137,122.6,305,168,137,122.6
34310, 금산군,010,5~9세,2017,1873,987,886,111.4,1866,982,884,111.1
34310, 금산군,010001, 5세,2017,329,181,148,122.3,327,179,148,120.9
34310, 금산군,010002, 6세,2017,384,188,196,95.9,384,188,196,95.9
34310, 금산군,010003, 7세,2017,409,221,188,117.6,407,219,188,116.5
34310, 금산군,010004, 8세,2017,363,181,182,99.5,360,180,180,100
34310, 금산군,010005, 9세,2017,388,216,172,125.6,388,216,172,125.6
34310, 금산군,015,10~14세,2017,1973,1000,973,102.8,1971,999,972,102.8
34310, 금산군,015001, 10세,2017,442,221,221,100,442,221,221,100
34310, 금산군,015002, 11세,2017,347,183,164,111.6,347,183,164,111.6
34310, 금산군,015003, 12세,2017,367,187,180,103.9,367,187,180,103.9
34310, 금산군,015004, 13세,2017,381,198,183,108.2,380,198,182,108.8
34310, 금산군,015005, 14세,2017,436,211,225,93.8,435,210,225,93.3
34310, 금산군,020,15~19세,2017,3297,1752,1545,113.4,3193,1691,1502,112.6
34310, 금산군,020001, 15세,2017,424,224,200,112,424,224,200,112
34310, 금산군,020002, 16세,2017,543,299,244,122.5,541,297,244,121.7
34310, 금산군,020003, 17세,2017,575,324,251,129.1,573,322,251,128.3
34310, 금산군,020004, 18세,2017,692,353,339,104.1,675,344,331,103.9
34310, 금산군,020005, 19세,2017,1063,552,511,108,980,504,476,105.9
34310, 금산군,025,20~24세,2017,4775,2595,2180,119,4135,2267,1868,121.4
34310, 금산군,025001, 20세,2017,875,407,468,87,783,356,427,83.4
34310, 금산군,025002, 21세,2017,937,410,527,77.8,807,346,461,75.1
34310, 금산군,025003, 22세,2017,1042,509,533,95.5,908,449,459,97.8
34310, 금산군,025004, 23세,2017,1019,637,382,166.8,856,556,300,185.3
34310, 금산군,025005, 24세,2017,902,632,270,234.1,781,560,221,253.4
34310, 금산군,030,25~29세,2017,2600,1592,1008,157.9,2192,1366,826,165.4
34310, 금산군,030001, 25세,2017,683,462,221,209,574,400,174,229.9
34310, 금산군,030002, 26세,2017,542,325,217,149.8,458,288,170,169.4
34310, 금산군,030003, 27세,2017,492,284,208,136.5,408,239,169,141.4
34310, 금산군,030004, 28세,2017,430,257,173,148.6,366,221,145,152.4
34310, 금산군,030005, 29세,2017,453,264,189,139.7,386,218,168,129.8
34310, 금산군,035,30~34세,2017,2145,1150,995,115.6,1885,1006,879,114.4
34310, 금산군,035001, 30세,2017,410,223,187,119.3,352,187,165,113.3
34310, 금산군,035002, 31세,2017,430,224,206,108.7,374,199,175,113.7
34310, 금산군,035003, 32세,2017,398,209,189,110.6,350,185,165,112.1
34310, 금산군,035004, 33세,2017,432,232,200,116,385,205,180,113.9
34310, 금산군,035005, 34세,2017,475,262,213,123,424,230,194,118.6
34310, 금산군,040,35~39세,2017,2773,1486,1287,115.5,2571,1370,1201,114.1
34310, 금산군,040001, 35세,2017,554,292,262,111.5,497,262,235,111.5
34310, 금산군,040002, 36세,2017,560,300,260,115.4,517,276,241,114.5
34310, 금산군,040003, 37세,2017,568,303,265,114.3,535,288,247,116.6
34310, 금산군,040004, 38세,2017,558,295,263,112.2,519,267,252,106
34310, 금산군,040005, 39세,2017,533,296,237,124.9,503,277,226,122.6
34310, 금산군,045,40~44세,2017,3057,1699,1358,125.1,2929,1626,1303,124.8
34310, 금산군,045001, 40세,2017,538,290,248,116.9,503,271,232,116.8
34310, 금산군,045002, 41세,2017,569,298,271,110,548,287,261,110
34310, 금산군,045003, 42세,2017,617,354,263,134.6,592,341,251,135.9
34310, 금산군,045004, 43세,2017,644,374,270,138.5,619,360,259,139
34310, 금산군,045005, 44세,2017,689,383,306,125.2,667,367,300,122.3
34310, 금산군,050,45~49세,2017,3794,2104,1690,124.5,3651,2044,1607,127.2
34310, 금산군,050001, 45세,2017,678,388,290,133.8,648,376,272,138.2
34310, 금산군,050002, 46세,2017,790,427,363,117.6,760,413,347,119
34310, 금산군,050003, 47세,2017,792,436,356,122.5,762,427,335,127.5
34310, 금산군,050004, 48세,2017,753,429,324,132.4,726,414,312,132.7
34310, 금산군,050005, 49세,2017,781,424,357,118.8,755,414,341,121.4
34310, 금산군,055,50~54세,2017,4062,2186,1876,116.5,3946,2122,1824,116.3
34310, 금산군,055001, 50세,2017,832,440,392,112.2,809,426,383,111.2
34310, 금산군,055002, 51세,2017,723,395,328,120.4,691,374,317,118
34310, 금산군,055003, 52세,2017,858,470,388,121.1,833,459,374,122.7
34310, 금산군,055004, 53세,2017,793,419,374,112,776,411,365,112.6
34310, 금산군,055005, 54세,2017,856,462,394,117.3,837,452,385,117.4
34310, 금산군,060,55~59세,2017,5027,2537,2490,101.9,4950,2503,2447,102.3
34310, 금산군,060001, 55세,2017,920,497,423,117.5,902,488,414,117.9
34310, 금산군,060002, 56세,2017,1095,578,517,111.8,1073,569,504,112.9
34310, 금산군,060003, 57세,2017,1138,573,565,101.4,1123,565,558,101.3
34310, 금산군,060004, 58세,2017,910,425,485,87.6,899,424,475,89.3
34310, 금산군,060005, 59세,2017,964,464,500,92.8,953,457,496,92.1
34310, 금산군,065,60~64세,2017,4549,2309,2240,103.1,4495,2280,2215,102.9
34310, 금산군,065001, 60세,2017,1013,545,468,116.5,1003,543,460,118
34310, 금산군,065002, 61세,2017,911,476,435,109.4,900,469,431,108.8
34310, 금산군,065003, 62세,2017,955,466,489,95.3,938,456,482,94.6
34310, 금산군,065004, 63세,2017,963,490,473,103.6,955,485,470,103.2
34310, 금산군,065005, 64세,2017,707,332,375,88.5,699,327,372,87.9
34310, 금산군,070,65~69세,2017,3771,1871,1900,98.5,3757,1862,1895,98.3
34310, 금산군,070001, 65세,2017,860,433,427,101.4,858,433,425,101.9
34310, 금산군,070002, 66세,2017,699,342,357,95.8,695,338,357,94.7
34310, 금산군,070003, 67세,2017,767,384,383,100.3,762,380,382,99.5
34310, 금산군,070004, 68세,2017,728,369,359,102.8,726,368,358,102.8
34310, 금산군,070005, 69세,2017,717,343,374,91.7,716,343,373,92
34310, 금산군,075,70~74세,2017,3160,1415,1745,81.1,3152,1414,1738,81.4
34310, 금산군,075001, 70세,2017,745,353,392,90.1,741,353,388,91
34310, 금산군,075002, 71세,2017,576,283,293,96.6,574,283,291,97.3
34310, 금산군,075003, 72세,2017,556,233,323,72.1,556,233,323,72.1
34310, 금산군,075004, 73세,2017,579,247,332,74.4,577,246,331,74.3
34310, 금산군,075005, 74세,2017,704,299,405,73.8,704,299,405,73.8
34310, 금산군,080,75~79세,2017,3553,1397,2156,64.8,3550,1396,2154,64.8
34310, 금산군,080001, 75세,2017,933,400,533,75,932,399,533,74.9
34310, 금산군,080002, 76세,2017,623,243,380,63.9,622,243,379,64.1
34310, 금산군,080003, 77세,2017,647,248,399,62.2,647,248,399,62.2
34310, 금산군,080004, 78세,2017,701,268,433,61.9,701,268,433,61.9
34310, 금산군,080005, 79세,2017,649,238,411,57.9,648,238,410,58
34310, 금산군,085,80~84세,2017,2425,871,1554,56,2424,870,1554,56
34310, 금산군,085001, 80세,2017,534,203,331,61.3,534,203,331,61.3
34310, 금산군,085002, 81세,2017,540,196,344,57,540,196,344,57
34310, 금산군,085003, 82세,2017,542,194,348,55.7,542,194,348,55.7
34310, 금산군,085004, 83세,2017,446,155,291,53.3,446,155,291,53.3
34310, 금산군,085005, 84세,2017,363,123,240,51.3,362,122,240,50.8
34310, 금산군,090,85~89세,2017,1076,314,762,41.2,1075,313,762,41.1
34310, 금산군,090001, 85세,2017,343,108,235,46,343,108,235,46
34310, 금산군,090002, 86세,2017,239,79,160,49.4,239,79,160,49.4
34310, 금산군,090003, 87세,2017,206,49,157,31.2,205,48,157,30.6
34310, 금산군,090004, 88세,2017,146,44,102,43.1,146,44,102,43.1
34310, 금산군,090005, 89세,2017,142,34,108,31.5,142,34,108,31.5
34310, 금산군,095,90~94세,2017,325,86,239,36,325,86,239,36
34310, 금산군,095001, 90세,2017,123,34,89,38.2,123,34,89,38.2
34310, 금산군,095002, 91세,2017,64,21,43,48.8,64,21,43,48.8
34310, 금산군,095003, 92세,2017,63,15,48,31.3,63,15,48,31.3
34310, 금산군,095004, 93세,2017,33,9,24,37.5,33,9,24,37.5
34310, 금산군,095005, 94세,2017,42,7,35,20,42,7,35,20
34310, 금산군,100,95~99세,2017,69,8,61,13.1,69,8,61,13.1
34310, 금산군,100001, 95세,2017,29,X,26,11.5,29,X,26,11.5
34310, 금산군,100002, 96세,2017,18,X,16,12.5,18,X,16,12.5
34310, 금산군,100003, 97세,2017,11,X,9,22.2,11,X,9,22.2
34310, 금산군,100004, 98세,2017,5,X,5,0,5,X,5,0
34310, 금산군,100005, 99세,2017,6,X,5,20,6,X,5,20
34310, 금산군,101,100세이상,2017,6,X,X,50,6,X,X,50
34310, 금산군,102,15세미만,2017,5208,2673,2535,105.4,5194,2663,2531,105.2
34310, 금산군,103,15~64세,2017,36079,19410,16669,116.4,33947,18275,15672,116.6
34310, 금산군,104,65세이상,2017,14385,5964,8421,70.8,14358,5951,8407,70.8
34310, 금산군,086,85세이상,2017,1476,410,1066,38.5,1475,409,1066,38.4
34310, 금산군,126,평균연령,2017,47.4,45.3,49.6,,48,45.8,50.2,
34310, 금산군,127,중위연령,2017,50.2,47.6,53.3,,51.3,48.6,54.4,
34330, 부여군,000,합계,2017,67028,33215,33813,98.2,65347,32322,33025,97.9
34330, 부여군,005,0~4세,2017,1549,810,739,109.6,1546,809,737,109.8
34330, 부여군,005001, 0세,2017,257,129,128,100.8,256,128,128,100
34330, 부여군,005002, 1세,2017,292,151,141,107.1,292,151,141,107.1
34330, 부여군,005003, 2세,2017,333,173,160,108.1,331,173,158,109.5
34330, 부여군,005004, 3세,2017,331,172,159,108.2,331,172,159,108.2
34330, 부여군,005005, 4세,2017,336,185,151,122.5,336,185,151,122.5
34330, 부여군,010,5~9세,2017,1955,1039,916,113.4,1953,1037,916,113.2
34330, 부여군,010001, 5세,2017,406,215,191,112.6,405,214,191,112
34330, 부여군,010002, 6세,2017,361,202,159,127,361,202,159,127
34330, 부여군,010003, 7세,2017,399,215,184,116.8,398,214,184,116.3
34330, 부여군,010004, 8세,2017,380,205,175,117.1,380,205,175,117.1
34330, 부여군,010005, 9세,2017,409,202,207,97.6,409,202,207,97.6
34330, 부여군,015,10~14세,2017,2324,1220,1104,110.5,2322,1220,1102,110.7
34330, 부여군,015001, 10세,2017,433,227,206,110.2,431,227,204,111.3
34330, 부여군,015002, 11세,2017,448,235,213,110.3,448,235,213,110.3
34330, 부여군,015003, 12세,2017,461,224,237,94.5,461,224,237,94.5
34330, 부여군,015004, 13세,2017,463,254,209,121.5,463,254,209,121.5
34330, 부여군,015005, 14세,2017,519,280,239,117.2,519,280,239,117.2
34330, 부여군,020,15~19세,2017,3050,1644,1406,116.9,3042,1641,1401,117.1
34330, 부여군,020001, 15세,2017,517,269,248,108.5,516,269,247,108.9
34330, 부여군,020002, 16세,2017,616,341,275,124,616,341,275,124
34330, 부여군,020003, 17세,2017,764,387,377,102.7,764,387,377,102.7
34330, 부여군,020004, 18세,2017,676,372,304,122.4,674,372,302,123.2
34330, 부여군,020005, 19세,2017,477,275,202,136.1,472,272,200,136
34330, 부여군,025,20~24세,2017,3432,1930,1502,128.5,3239,1830,1409,129.9
34330, 부여군,025001, 20세,2017,654,395,259,152.5,643,387,256,151.2
34330, 부여군,025002, 21세,2017,764,426,338,126,740,414,326,127
34330, 부여군,025003, 22세,2017,701,384,317,121.1,663,368,295,124.7
34330, 부여군,025004, 23세,2017,703,388,315,123.2,647,356,291,122.3
34330, 부여군,025005, 24세,2017,610,337,273,123.4,546,305,241,126.6
34330, 부여군,030,25~29세,2017,2758,1573,1185,132.7,2378,1356,1022,132.7
34330, 부여군,030001, 25세,2017,614,358,256,139.8,542,310,232,133.6
34330, 부여군,030002, 26세,2017,543,288,255,112.9,476,254,222,114.4
34330, 부여군,030003, 27세,2017,572,338,234,144.4,489,294,195,150.8
34330, 부여군,030004, 28세,2017,517,295,222,132.9,437,246,191,128.8
34330, 부여군,030005, 29세,2017,512,294,218,134.9,434,252,182,138.5
34330, 부여군,035,30~34세,2017,2609,1412,1197,118,2290,1250,1040,120.2
34330, 부여군,035001, 30세,2017,535,293,242,121.1,469,262,207,126.6
34330, 부여군,035002, 31세,2017,489,261,228,114.5,421,229,192,119.3
34330, 부여군,035003, 32세,2017,518,287,231,124.2,455,253,202,125.2
34330, 부여군,035004, 33세,2017,504,257,247,104,437,219,218,100.5
34330, 부여군,035005, 34세,2017,563,314,249,126.1,508,287,221,129.9
34330, 부여군,040,35~39세,2017,2941,1638,1303,125.7,2736,1531,1205,127.1
34330, 부여군,040001, 35세,2017,565,316,249,126.9,519,292,227,128.6
34330, 부여군,040002, 36세,2017,572,325,247,131.6,530,305,225,135.6
34330, 부여군,040003, 37세,2017,622,347,275,126.2,578,323,255,126.7
34330, 부여군,040004, 38세,2017,571,309,262,117.9,530,285,245,116.3
34330, 부여군,040005, 39세,2017,611,341,270,126.3,579,326,253,128.9
34330, 부여군,045,40~44세,2017,3589,1960,1629,120.3,3448,1882,1566,120.2
34330, 부여군,045001, 40세,2017,636,335,301,111.3,613,322,291,110.7
34330, 부여군,045002, 41세,2017,664,363,301,120.6,633,346,287,120.6
34330, 부여군,045003, 42세,2017,694,383,311,123.2,667,370,297,124.6
34330, 부여군,045004, 43세,2017,796,430,366,117.5,763,411,352,116.8
34330, 부여군,045005, 44세,2017,799,449,350,128.3,772,433,339,127.7
34330, 부여군,050,45~49세,2017,4505,2430,2075,117.1,4354,2347,2007,116.9
34330, 부여군,050001, 45세,2017,812,448,364,123.1,781,426,355,120
34330, 부여군,050002, 46세,2017,901,499,402,124.1,872,485,387,125.3
34330, 부여군,050003, 47세,2017,853,465,388,119.8,828,454,374,121.4
34330, 부여군,050004, 48세,2017,944,482,462,104.3,909,462,447,103.4
34330, 부여군,050005, 49세,2017,995,536,459,116.8,964,520,444,117.1
34330, 부여군,055,50~54세,2017,4885,2533,2352,107.7,4774,2479,2295,108
34330, 부여군,055001, 50세,2017,915,500,415,120.5,901,493,408,120.8
34330, 부여군,055002, 51세,2017,870,460,410,112.2,850,449,401,112
34330, 부여군,055003, 52세,2017,1037,558,479,116.5,1018,548,470,116.6
34330, 부여군,055004, 53세,2017,1040,517,523,98.9,1010,501,509,98.4
34330, 부여군,055005, 54세,2017,1023,498,525,94.9,995,488,507,96.3
34330, 부여군,060,55~59세,2017,6700,3344,3356,99.6,6622,3303,3319,99.5
34330, 부여군,060001, 55세,2017,1197,620,577,107.5,1178,610,568,107.4
34330, 부여군,060002, 56세,2017,1441,724,717,101,1423,714,709,100.7
34330, 부여군,060003, 57세,2017,1477,706,771,91.6,1456,694,762,91.1
34330, 부여군,060004, 58세,2017,1298,647,651,99.4,1293,644,649,99.2
34330, 부여군,060005, 59세,2017,1287,647,640,101.1,1272,641,631,101.6
34330, 부여군,065,60~64세,2017,6221,3128,3093,101.1,6172,3102,3070,101
34330, 부여군,065001, 60세,2017,1338,712,626,113.7,1322,702,620,113.2
34330, 부여군,065002, 61세,2017,1369,695,674,103.1,1357,688,669,102.8
34330, 부여군,065003, 62세,2017,1320,648,672,96.4,1315,647,668,96.9
34330, 부여군,065004, 63세,2017,1226,606,620,97.7,1218,602,616,97.7
34330, 부여군,065005, 64세,2017,968,467,501,93.2,960,463,497,93.2
34330, 부여군,070,65~69세,2017,5264,2556,2708,94.4,5243,2543,2700,94.2
34330, 부여군,070001, 65세,2017,1109,551,558,98.7,1101,546,555,98.4
34330, 부여군,070002, 66세,2017,934,461,473,97.5,930,457,473,96.6
34330, 부여군,070003, 67세,2017,1091,540,551,98,1088,539,549,98.2
34330, 부여군,070004, 68세,2017,1147,541,606,89.3,1143,539,604,89.2
34330, 부여군,070005, 69세,2017,983,463,520,89,981,462,519,89
34330, 부여군,075,70~74세,2017,4252,1970,2282,86.3,4244,1965,2279,86.2
34330, 부여군,075001, 70세,2017,978,465,513,90.6,976,464,512,90.6
34330, 부여군,075002, 71세,2017,679,345,334,103.3,675,343,332,103.3
34330, 부여군,075003, 72세,2017,832,399,433,92.1,831,398,433,91.9
34330, 부여군,075004, 73세,2017,867,364,503,72.4,866,363,503,72.2
34330, 부여군,075005, 74세,2017,896,397,499,79.6,896,397,499,79.6
34330, 부여군,080,75~79세,2017,4800,1941,2859,67.9,4795,1941,2854,68
34330, 부여군,080001, 75세,2017,1138,485,653,74.3,1137,485,652,74.4
34330, 부여군,080002, 76세,2017,961,404,557,72.5,960,404,556,72.7
34330, 부여군,080003, 77세,2017,859,353,506,69.8,859,353,506,69.8
34330, 부여군,080004, 78세,2017,965,370,595,62.2,964,370,594,62.3
34330, 부여군,080005, 79세,2017,877,329,548,60,875,329,546,60.3
34330, 부여군,085,80~84세,2017,3697,1366,2331,58.6,3694,1366,2328,58.7
34330, 부여군,085001, 80세,2017,856,330,526,62.7,855,330,525,62.9
34330, 부여군,085002, 81세,2017,806,312,494,63.2,806,312,494,63.2
34330, 부여군,085003, 82세,2017,803,277,526,52.7,803,277,526,52.7
34330, 부여군,085004, 83세,2017,668,246,422,58.3,667,246,421,58.4
34330, 부여군,085005, 84세,2017,564,201,363,55.4,563,201,362,55.5
34330, 부여군,090,85~89세,2017,1763,578,1185,48.8,1762,578,1184,48.8
34330, 부여군,090001, 85세,2017,515,181,334,54.2,515,181,334,54.2
34330, 부여군,090002, 86세,2017,374,113,261,43.3,374,113,261,43.3
34330, 부여군,090003, 87세,2017,342,119,223,53.4,341,119,222,53.6
34330, 부여군,090004, 88세,2017,270,81,189,42.9,270,81,189,42.9
34330, 부여군,090005, 89세,2017,262,84,178,47.2,262,84,178,47.2
34330, 부여군,095,90~94세,2017,608,125,483,25.9,608,125,483,25.9
34330, 부여군,095001, 90세,2017,199,41,158,25.9,199,41,158,25.9
34330, 부여군,095002, 91세,2017,155,37,118,31.4,155,37,118,31.4
34330, 부여군,095003, 92세,2017,115,24,91,26.4,115,24,91,26.4
34330, 부여군,095004, 93세,2017,67,14,53,26.4,67,14,53,26.4
34330, 부여군,095005, 94세,2017,72,9,63,14.3,72,9,63,14.3
34330, 부여군,100,95~99세,2017,113,15,98,15.3,112,14,98,14.3
34330, 부여군,100001, 95세,2017,40,X,36,11.1,40,X,36,11.1
34330, 부여군,100002, 96세,2017,34,10,24,41.7,34,10,24,41.7
34330, 부여군,100003, 97세,2017,19,X,18,5.6,18,X,18,0
34330, 부여군,100004, 98세,2017,10,X,10,0,10,X,10,0
34330, 부여군,100005, 99세,2017,10,X,10,0,10,X,10,0
34330, 부여군,101,100세이상,2017,13,X,10,30,13,X,10,30
34330, 부여군,102,15세미만,2017,5828,3069,2759,111.2,5821,3066,2755,111.3
34330, 부여군,103,15~64세,2017,40690,21592,19098,113.1,39055,20721,18334,113
34330, 부여군,104,65세이상,2017,20510,8554,11956,71.5,20471,8535,11936,71.5
34330, 부여군,086,85세이상,2017,2497,721,1776,40.6,2495,720,1775,40.6
34330, 부여군,126,평균연령,2017,50.8,48.4,53.2,,51.2,48.7,53.6,
34330, 부여군,127,중위연령,2017,54.9,52,57.3,,55.5,52.6,57.7,
34340, 서천군,000,합계,2017,53321,26510,26811,98.9,51735,25363,26372,96.2
34340, 서천군,005,0~4세,2017,1233,617,616,100.2,1228,614,614,100
34340, 서천군,005001, 0세,2017,210,100,110,90.9,209,99,110,90
34340, 서천군,005002, 1세,2017,231,119,112,106.3,231,119,112,106.3
34340, 서천군,005003, 2세,2017,249,125,124,100.8,247,125,122,102.5
34340, 서천군,005004, 3세,2017,272,144,128,112.5,270,142,128,110.9
34340, 서천군,005005, 4세,2017,271,129,142,90.8,271,129,142,90.8
34340, 서천군,010,5~9세,2017,1535,777,758,102.5,1529,775,754,102.8
34340, 서천군,010001, 5세,2017,304,146,158,92.4,303,145,158,91.8
34340, 서천군,010002, 6세,2017,312,164,148,110.8,311,164,147,111.6
34340, 서천군,010003, 7세,2017,316,152,164,92.7,314,152,162,93.8
34340, 서천군,010004, 8세,2017,280,149,131,113.7,280,149,131,113.7
34340, 서천군,010005, 9세,2017,323,166,157,105.7,321,165,156,105.8
34340, 서천군,015,10~14세,2017,1692,845,847,99.8,1689,843,846,99.6
34340, 서천군,015001, 10세,2017,321,153,168,91.1,320,153,167,91.6
34340, 서천군,015002, 11세,2017,304,160,144,111.1,304,160,144,111.1
34340, 서천군,015003, 12세,2017,341,169,172,98.3,340,168,172,97.7
34340, 서천군,015004, 13세,2017,330,161,169,95.3,329,160,169,94.7
34340, 서천군,015005, 14세,2017,396,202,194,104.1,396,202,194,104.1
34340, 서천군,020,15~19세,2017,2252,1210,1042,116.1,2243,1203,1040,115.7
34340, 서천군,020001, 15세,2017,401,220,181,121.5,401,220,181,121.5
34340, 서천군,020002, 16세,2017,483,250,233,107.3,481,249,232,107.3
34340, 서천군,020003, 17세,2017,526,264,262,100.8,526,264,262,100.8
34340, 서천군,020004, 18세,2017,531,272,259,105,528,269,259,103.9
34340, 서천군,020005, 19세,2017,311,204,107,190.7,307,201,106,189.6
34340, 서천군,025,20~24세,2017,2153,1332,821,162.2,1988,1207,781,154.5
34340, 서천군,025001, 20세,2017,396,248,148,167.6,391,244,147,166
34340, 서천군,025002, 21세,2017,430,280,150,186.7,414,271,143,189.5
34340, 서천군,025003, 22세,2017,443,274,169,162.1,410,249,161,154.7
34340, 서천군,025004, 23세,2017,419,254,165,153.9,374,219,155,141.3
34340, 서천군,025005, 24세,2017,465,276,189,146,399,224,175,128
34340, 서천군,030,25~29세,2017,2153,1285,868,148,1745,973,772,126
34340, 서천군,030001, 25세,2017,440,259,181,143.1,356,195,161,121.1
34340, 서천군,030002, 26세,2017,484,291,193,150.8,398,228,170,134.1
34340, 서천군,030003, 27세,2017,420,248,172,144.2,347,194,153,126.8
34340, 서천군,030004, 28세,2017,409,250,159,157.2,324,179,145,123.4
34340, 서천군,030005, 29세,2017,400,237,163,145.4,320,177,143,123.8
34340, 서천군,035,30~34세,2017,2023,1208,815,148.2,1724,987,737,133.9
34340, 서천군,035001, 30세,2017,399,256,143,179,330,206,124,166.1
34340, 서천군,035002, 31세,2017,403,248,155,160,336,193,143,135
34340, 서천군,035003, 32세,2017,366,222,144,154.2,310,178,132,134.8
34340, 서천군,035004, 33세,2017,414,231,183,126.2,359,193,166,116.3
34340, 서천군,035005, 34세,2017,441,251,190,132.1,389,217,172,126.2
34340, 서천군,040,35~39세,2017,2503,1427,1076,132.6,2280,1250,1030,121.4
34340, 서천군,040001, 35세,2017,486,285,201,141.8,440,251,189,132.8
34340, 서천군,040002, 36세,2017,516,290,226,128.3,470,252,218,115.6
34340, 서천군,040003, 37세,2017,515,290,225,128.9,475,257,218,117.9
34340, 서천군,040004, 38세,2017,493,271,222,122.1,450,240,210,114.3
34340, 서천군,040005, 39세,2017,493,291,202,144.1,445,250,195,128.2
34340, 서천군,045,40~44세,2017,2920,1636,1284,127.4,2739,1502,1237,121.4
34340, 서천군,045001, 40세,2017,521,283,238,118.9,487,256,231,110.8
34340, 서천군,045002, 41세,2017,562,341,221,154.3,528,315,213,147.9
34340, 서천군,045003, 42세,2017,533,298,235,126.8,500,274,226,121.2
34340, 서천군,045004, 43세,2017,658,348,310,112.3,623,320,303,105.6
34340, 서천군,045005, 44세,2017,646,366,280,130.7,601,337,264,127.7
34340, 서천군,050,45~49세,2017,3672,2026,1646,123.1,3549,1944,1605,121.1
34340, 서천군,050001, 45세,2017,641,352,289,121.8,617,334,283,118
34340, 서천군,050002, 46세,2017,785,449,336,133.6,754,422,332,127.1
34340, 서천군,050003, 47세,2017,735,411,324,126.9,715,400,315,127
34340, 서천군,050004, 48세,2017,776,435,341,127.6,745,417,328,127.1
34340, 서천군,050005, 49세,2017,735,379,356,106.5,718,371,347,106.9
34340, 서천군,055,50~54세,2017,3791,2068,1723,120,3728,2035,1693,120.2
34340, 서천군,055001, 50세,2017,753,411,342,120.2,734,398,336,118.5
34340, 서천군,055002, 51세,2017,627,344,283,121.6,619,340,279,121.9
34340, 서천군,055003, 52세,2017,829,428,401,106.7,820,425,395,107.6
34340, 서천군,055004, 53세,2017,767,430,337,127.6,757,423,334,126.6
34340, 서천군,055005, 54세,2017,815,455,360,126.4,798,449,349,128.7
34340, 서천군,060,55~59세,2017,5102,2517,2585,97.4,5062,2497,2565,97.3
34340, 서천군,060001, 55세,2017,954,506,448,112.9,942,499,443,112.6
34340, 서천군,060002, 56세,2017,1013,485,528,91.9,1004,481,523,92
34340, 서천군,060003, 57세,2017,1098,526,572,92,1087,521,566,92
34340, 서천군,060004, 58세,2017,1039,521,518,100.6,1035,519,516,100.6
34340, 서천군,060005, 59세,2017,998,479,519,92.3,994,477,517,92.3
34340, 서천군,065,60~64세,2017,4836,2383,2453,97.1,4799,2362,2437,96.9
34340, 서천군,065001, 60세,2017,954,491,463,106,941,483,458,105.5
34340, 서천군,065002, 61세,2017,1002,514,488,105.3,997,511,486,105.1
34340, 서천군,065003, 62세,2017,1116,569,547,104,1108,565,543,104.1
34340, 서천군,065004, 63세,2017,1011,466,545,85.5,1008,463,545,85
34340, 서천군,065005, 64세,2017,753,343,410,83.7,745,340,405,84
34340, 서천군,070,65~69세,2017,4430,2124,2306,92.1,4419,2121,2298,92.3
34340, 서천군,070001, 65세,2017,931,448,483,92.8,928,446,482,92.5
34340, 서천군,070002, 66세,2017,810,384,426,90.1,810,384,426,90.1
34340, 서천군,070003, 67세,2017,932,450,482,93.4,928,449,479,93.7
34340, 서천군,070004, 68세,2017,861,411,450,91.3,858,411,447,91.9
34340, 서천군,070005, 69세,2017,896,431,465,92.7,895,431,464,92.9
34340, 서천군,075,70~74세,2017,3776,1705,2071,82.3,3769,1701,2068,82.3
34340, 서천군,075001, 70세,2017,979,491,488,100.6,978,490,488,100.4
34340, 서천군,075002, 71세,2017,596,272,324,84,594,271,323,83.9
34340, 서천군,075003, 72세,2017,675,328,347,94.5,673,327,346,94.5
34340, 서천군,075004, 73세,2017,692,285,407,70,690,284,406,70
34340, 서천군,075005, 74세,2017,834,329,505,65.1,834,329,505,65.1
34340, 서천군,080,75~79세,2017,4074,1602,2472,64.8,4070,1601,2469,64.8
34340, 서천군,080001, 75세,2017,975,415,560,74.1,975,415,560,74.1
34340, 서천군,080002, 76세,2017,761,300,461,65.1,761,300,461,65.1
34340, 서천군,080003, 77세,2017,736,278,458,60.7,735,277,458,60.5
34340, 서천군,080004, 78세,2017,839,328,511,64.2,839,328,511,64.2
34340, 서천군,080005, 79세,2017,763,281,482,58.3,760,281,479,58.7
34340, 서천군,085,80~84세,2017,3027,1162,1865,62.3,3026,1162,1864,62.3
34340, 서천군,085001, 80세,2017,708,295,413,71.4,708,295,413,71.4
34340, 서천군,085002, 81세,2017,691,273,418,65.3,691,273,418,65.3
34340, 서천군,085003, 82세,2017,620,223,397,56.2,620,223,397,56.2
34340, 서천군,085004, 83세,2017,499,194,305,63.6,498,194,304,63.8
34340, 서천군,085005, 84세,2017,509,177,332,53.3,509,177,332,53.3
34340, 서천군,090,85~89세,2017,1570,463,1107,41.8,1569,463,1106,41.9
34340, 서천군,090001, 85세,2017,489,167,322,51.9,489,167,322,51.9
34340, 서천군,090002, 86세,2017,304,97,207,46.9,304,97,207,46.9
34340, 서천군,090003, 87세,2017,321,86,235,36.6,320,86,234,36.8
34340, 서천군,090004, 88세,2017,264,68,196,34.7,264,68,196,34.7
34340, 서천군,090005, 89세,2017,192,45,147,30.6,192,45,147,30.6
34340, 서천군,095,90~94세,2017,471,105,366,28.7,471,105,366,28.7
34340, 서천군,095001, 90세,2017,172,41,131,31.3,172,41,131,31.3
34340, 서천군,095002, 91세,2017,100,25,75,33.3,100,25,75,33.3
34340, 서천군,095003, 92세,2017,75,17,58,29.3,75,17,58,29.3
34340, 서천군,095004, 93세,2017,57,12,45,26.7,57,12,45,26.7
34340, 서천군,095005, 94세,2017,67,10,57,17.5,67,10,57,17.5
34340, 서천군,100,95~99세,2017,93,15,78,19.2,93,15,78,19.2
34340, 서천군,100001, 95세,2017,37,8,29,27.6,37,8,29,27.6
34340, 서천군,100002, 96세,2017,24,X,21,14.3,24,X,21,14.3
34340, 서천군,100003, 97세,2017,14,X,13,7.7,14,X,13,7.7
34340, 서천군,100004, 98세,2017,11,X,9,22.2,11,X,9,22.2
34340, 서천군,100005, 99세,2017,7,X,6,16.7,7,X,6,16.7
34340, 서천군,101,100세이상,2017,15,X,12,25,15,X,12,25
34340, 서천군,102,15세미만,2017,4460,2239,2221,100.8,4446,2232,2214,100.8
34340, 서천군,103,15~64세,2017,31405,17092,14313,119.4,29857,15960,13897,114.8
34340, 서천군,104,65세이상,2017,17456,7179,10277,69.9,17432,7171,10261,69.9
34340, 서천군,086,85세이상,2017,2149,586,1563,37.5,2148,586,1562,37.5
34340, 서천군,126,평균연령,2017,51.8,49.2,54.5,,52.3,49.8,54.8,
34340, 서천군,127,중위연령,2017,55.8,52.3,58.7,,56.5,53.5,59.1,
34350, 청양군,000,합계,2017,31299,15692,15607,100.5,30581,15349,15232,100.8
34350, 청양군,005,0~4세,2017,678,343,335,102.4,676,342,334,102.4
34350, 청양군,005001, 0세,2017,114,57,57,100,114,57,57,100
34350, 청양군,005002, 1세,2017,121,66,55,120,120,65,55,118.2
34350, 청양군,005003, 2세,2017,138,67,71,94.4,138,67,71,94.4
34350, 청양군,005004, 3세,2017,142,64,78,82.1,141,64,77,83.1
34350, 청양군,005005, 4세,2017,163,89,74,120.3,163,89,74,120.3
34350, 청양군,010,5~9세,2017,854,439,415,105.8,854,439,415,105.8
34350, 청양군,010001, 5세,2017,179,92,87,105.7,179,92,87,105.7
34350, 청양군,010002, 6세,2017,173,94,79,119,173,94,79,119
34350, 청양군,010003, 7세,2017,177,82,95,86.3,177,82,95,86.3
34350, 청양군,010004, 8세,2017,151,75,76,98.7,151,75,76,98.7
34350, 청양군,010005, 9세,2017,174,96,78,123.1,174,96,78,123.1
34350, 청양군,015,10~14세,2017,886,444,442,100.5,886,444,442,100.5
34350, 청양군,015001, 10세,2017,173,83,90,92.2,173,83,90,92.2
34350, 청양군,015002, 11세,2017,173,90,83,108.4,173,90,83,108.4
34350, 청양군,015003, 12세,2017,168,81,87,93.1,168,81,87,93.1
34350, 청양군,015004, 13세,2017,188,96,92,104.3,188,96,92,104.3
34350, 청양군,015005, 14세,2017,184,94,90,104.4,184,94,90,104.4
34350, 청양군,020,15~19세,2017,1585,781,804,97.1,1582,780,802,97.3
34350, 청양군,020001, 15세,2017,213,106,107,99.1,213,106,107,99.1
34350, 청양군,020002, 16세,2017,279,165,114,144.7,279,165,114,144.7
34350, 청양군,020003, 17세,2017,289,152,137,110.9,289,152,137,110.9
34350, 청양군,020004, 18세,2017,329,144,185,77.8,328,144,184,78.3
34350, 청양군,020005, 19세,2017,475,214,261,82,473,213,260,81.9
34350, 청양군,025,20~24세,2017,1657,997,660,151.1,1555,954,601,158.7
34350, 청양군,025001, 20세,2017,413,224,189,118.5,407,222,185,120
34350, 청양군,025002, 21세,2017,344,216,128,168.8,325,206,119,173.1
34350, 청양군,025003, 22세,2017,330,212,118,179.7,311,202,109,185.3
34350, 청양군,025004, 23세,2017,296,189,107,176.6,276,181,95,190.5
34350, 청양군,025005, 24세,2017,274,156,118,132.2,236,143,93,153.8
34350, 청양군,030,25~29세,2017,1315,761,554,137.4,1132,665,467,142.4
34350, 청양군,030001, 25세,2017,282,148,134,110.4,245,128,117,109.4
34350, 청양군,030002, 26세,2017,290,167,123,135.8,249,141,108,130.6
34350, 청양군,030003, 27세,2017,244,149,95,156.8,205,135,70,192.9
34350, 청양군,030004, 28세,2017,262,151,111,136,229,133,96,138.5
34350, 청양군,030005, 29세,2017,237,146,91,160.4,204,128,76,168.4
34350, 청양군,035,30~34세,2017,1183,692,491,140.9,1055,618,437,141.4
34350, 청양군,035001, 30세,2017,258,149,109,136.7,222,131,91,144
34350, 청양군,035002, 31세,2017,236,143,93,153.8,218,130,88,147.7
34350, 청양군,035003, 32세,2017,209,120,89,134.8,182,106,76,139.5
34350, 청양군,035004, 33세,2017,240,149,91,163.7,215,132,83,159
34350, 청양군,035005, 34세,2017,240,131,109,120.2,218,119,99,120.2
34350, 청양군,040,35~39세,2017,1269,729,540,135,1208,695,513,135.5
34350, 청양군,040001, 35세,2017,235,132,103,128.2,220,123,97,126.8
34350, 청양군,040002, 36세,2017,272,159,113,140.7,263,156,107,145.8
34350, 청양군,040003, 37세,2017,260,145,115,126.1,249,140,109,128.4
34350, 청양군,040004, 38세,2017,256,143,113,126.5,244,135,109,123.9
34350, 청양군,040005, 39세,2017,246,150,96,156.3,232,141,91,154.9
34350, 청양군,045,40~44세,2017,1547,881,666,132.3,1494,856,638,134.2
34350, 청양군,045001, 40세,2017,263,139,124,112.1,253,134,119,112.6
34350, 청양군,045002, 41세,2017,307,188,119,158,295,181,114,158.8
34350, 청양군,045003, 42세,2017,309,161,148,108.8,301,158,143,110.5
34350, 청양군,045004, 43세,2017,316,184,132,139.4,304,178,126,141.3
34350, 청양군,045005, 44세,2017,352,209,143,146.2,341,205,136,150.7
34350, 청양군,050,45~49세,2017,2027,1130,897,126,1977,1111,866,128.3
34350, 청양군,050001, 45세,2017,374,203,171,118.7,369,201,168,119.6
34350, 청양군,050002, 46세,2017,380,224,156,143.6,373,222,151,147
34350, 청양군,050003, 47세,2017,403,225,178,126.4,393,221,172,128.5
34350, 청양군,050004, 48세,2017,427,245,182,134.6,410,237,173,137
34350, 청양군,050005, 49세,2017,443,233,210,111,432,230,202,113.9
34350, 청양군,055,50~54세,2017,2245,1208,1037,116.5,2195,1191,1004,118.6
34350, 청양군,055001, 50세,2017,415,228,187,121.9,398,219,179,122.3
34350, 청양군,055002, 51세,2017,386,216,170,127.1,381,216,165,130.9
34350, 청양군,055003, 52세,2017,510,280,230,121.7,501,279,222,125.7
34350, 청양군,055004, 53세,2017,475,254,221,114.9,464,248,216,114.8
34350, 청양군,055005, 54세,2017,459,230,229,100.4,451,229,222,103.2
34350, 청양군,060,55~59세,2017,3145,1596,1549,103,3102,1578,1524,103.5
34350, 청양군,060001, 55세,2017,568,289,279,103.6,557,286,271,105.5
34350, 청양군,060002, 56세,2017,679,346,333,103.9,673,345,328,105.2
34350, 청양군,060003, 57세,2017,704,379,325,116.6,692,375,317,118.3
34350, 청양군,060004, 58세,2017,624,313,311,100.6,615,306,309,99
34350, 청양군,060005, 59세,2017,570,269,301,89.4,565,266,299,89
34350, 청양군,065,60~64세,2017,2871,1450,1421,102,2847,1443,1404,102.8
34350, 청양군,065001, 60세,2017,607,305,302,101,601,304,297,102.4
34350, 청양군,065002, 61세,2017,571,274,297,92.3,564,272,292,93.2
34350, 청양군,065003, 62세,2017,659,328,331,99.1,654,327,327,100
34350, 청양군,065004, 63세,2017,563,295,268,110.1,559,293,266,110.2
34350, 청양군,065005, 64세,2017,471,248,223,111.2,469,247,222,111.3
34350, 청양군,070,65~69세,2017,2468,1252,1216,103,2458,1246,1212,102.8
34350, 청양군,070001, 65세,2017,494,243,251,96.8,493,243,250,97.2
34350, 청양군,070002, 66세,2017,433,236,197,119.8,432,235,197,119.3
34350, 청양군,070003, 67세,2017,536,270,266,101.5,533,268,265,101.1
34350, 청양군,070004, 68세,2017,506,250,256,97.7,503,248,255,97.3
34350, 청양군,070005, 69세,2017,499,253,246,102.8,497,252,245,102.9
34350, 청양군,075,70~74세,2017,2005,900,1105,81.4,1999,899,1100,81.7
34350, 청양군,075001, 70세,2017,431,194,237,81.9,429,194,235,82.6
34350, 청양군,075002, 71세,2017,355,182,173,105.2,354,182,172,105.8
34350, 청양군,075003, 72세,2017,381,181,200,90.5,380,181,199,91
34350, 청양군,075004, 73세,2017,424,167,257,65,422,166,256,64.8
34350, 청양군,075005, 74세,2017,414,176,238,73.9,414,176,238,73.9
34350, 청양군,080,75~79세,2017,2424,975,1449,67.3,2422,974,1448,67.3
34350, 청양군,080001, 75세,2017,591,235,356,66,591,235,356,66
34350, 청양군,080002, 76세,2017,466,200,266,75.2,464,199,265,75.1
34350, 청양군,080003, 77세,2017,431,154,277,55.6,431,154,277,55.6
34350, 청양군,080004, 78세,2017,494,209,285,73.3,494,209,285,73.3
34350, 청양군,080005, 79세,2017,442,177,265,66.8,442,177,265,66.8
34350, 청양군,085,80~84세,2017,2002,766,1236,62,2001,766,1235,62
34350, 청양군,085001, 80세,2017,462,163,299,54.5,461,163,298,54.7
34350, 청양군,085002, 81세,2017,456,191,265,72.1,456,191,265,72.1
34350, 청양군,085003, 82세,2017,433,149,284,52.5,433,149,284,52.5
34350, 청양군,085004, 83세,2017,362,141,221,63.8,362,141,221,63.8
34350, 청양군,085005, 84세,2017,289,122,167,73.1,289,122,167,73.1
34350, 청양군,090,85~89세,2017,856,270,586,46.1,856,270,586,46.1
34350, 청양군,090001, 85세,2017,268,93,175,53.1,268,93,175,53.1
34350, 청양군,090002, 86세,2017,170,50,120,41.7,170,50,120,41.7
34350, 청양군,090003, 87세,2017,160,57,103,55.3,160,57,103,55.3
34350, 청양군,090004, 88세,2017,151,45,106,42.5,151,45,106,42.5
34350, 청양군,090005, 89세,2017,107,25,82,30.5,107,25,82,30.5
34350, 청양군,095,90~94세,2017,226,67,159,42.1,226,67,159,42.1
34350, 청양군,095001, 90세,2017,64,17,47,36.2,64,17,47,36.2
34350, 청양군,095002, 91세,2017,65,22,43,51.2,65,22,43,51.2
34350, 청양군,095003, 92세,2017,53,21,32,65.6,53,21,32,65.6
34350, 청양군,095004, 93세,2017,25,X,21,19,25,X,21,19
34350, 청양군,095005, 94세,2017,19,X,16,18.8,19,X,16,18.8
34350, 청양군,100,95~99세,2017,50,11,39,28.2,50,11,39,28.2
34350, 청양군,100001, 95세,2017,29,6,23,26.1,29,6,23,26.1
34350, 청양군,100002, 96세,2017,6,X,X,50,6,X,X,50
34350, 청양군,100003, 97세,2017,7,X,5,40,7,X,5,40
34350, 청양군,100004, 98세,2017,X,X,X,0,X,X,X,0
34350, 청양군,100005, 99세,2017,5,X,X,25,5,X,X,25
34350, 청양군,101,100세이상,2017,6,X,6,0,6,X,6,0
34350, 청양군,102,15세미만,2017,2418,1226,1192,102.9,2416,1225,1191,102.9
34350, 청양군,103,15~64세,2017,18844,10225,8619,118.6,18147,9891,8256,119.8
34350, 청양군,104,65세이상,2017,10037,4241,5796,73.2,10018,4233,5785,73.2
34350, 청양군,086,85세이상,2017,1138,348,790,44.1,1138,348,790,44.1
34350, 청양군,126,평균연령,2017,51.5,49.2,53.8,,51.9,49.5,54.2,
34350, 청양군,127,중위연령,2017,55.7,52.7,58.1,,56.2,53.2,58.6,
34360, 홍성군,000,합계,2017,103048,51438,51610,99.7,100311,49644,50667,98
34360, 홍성군,005,0~4세,2017,4051,2095,1956,107.1,4026,2080,1946,106.9
34360, 홍성군,005001, 0세,2017,751,382,369,103.5,750,382,368,103.8
34360, 홍성군,005002, 1세,2017,780,399,381,104.7,775,395,380,103.9
34360, 홍성군,005003, 2세,2017,853,432,421,102.6,847,429,418,102.6
34360, 홍성군,005004, 3세,2017,817,436,381,114.4,810,432,378,114.3
34360, 홍성군,005005, 4세,2017,850,446,404,110.4,844,442,402,110
34360, 홍성군,010,5~9세,2017,4741,2425,2316,104.7,4719,2413,2306,104.6
34360, 홍성군,010001, 5세,2017,957,506,451,112.2,951,504,447,112.8
34360, 홍성군,010002, 6세,2017,939,483,456,105.9,935,482,453,106.4
34360, 홍성군,010003, 7세,2017,965,485,480,101,959,480,479,100.2
34360, 홍성군,010004, 8세,2017,937,474,463,102.4,933,471,462,101.9
34360, 홍성군,010005, 9세,2017,943,477,466,102.4,941,476,465,102.4
34360, 홍성군,015,10~14세,2017,4631,2363,2268,104.2,4616,2356,2260,104.2
34360, 홍성군,015001, 10세,2017,984,481,503,95.6,980,480,500,96
34360, 홍성군,015002, 11세,2017,880,468,412,113.6,878,467,411,113.6
34360, 홍성군,015003, 12세,2017,840,419,421,99.5,839,419,420,99.8
34360, 홍성군,015004, 13세,2017,970,485,485,100,964,482,482,100
34360, 홍성군,015005, 14세,2017,957,510,447,114.1,955,508,447,113.6
34360, 홍성군,020,15~19세,2017,6485,3313,3172,104.4,6457,3297,3160,104.3
34360, 홍성군,020001, 15세,2017,959,498,461,108,952,493,459,107.4
34360, 홍성군,020002, 16세,2017,1212,658,554,118.8,1212,658,554,118.8
34360, 홍성군,020003, 17세,2017,1336,722,614,117.6,1333,721,612,117.8
34360, 홍성군,020004, 18세,2017,1318,683,635,107.6,1315,680,635,107.1
34360, 홍성군,020005, 19세,2017,1660,752,908,82.8,1645,745,900,82.8
34360, 홍성군,025,20~24세,2017,6843,3539,3304,107.1,6515,3346,3169,105.6
34360, 홍성군,025001, 20세,2017,1525,640,885,72.3,1500,635,865,73.4
34360, 홍성군,025002, 21세,2017,1446,636,810,78.5,1406,617,789,78.2
34360, 홍성군,025003, 22세,2017,1410,765,645,118.6,1331,719,612,117.5
34360, 홍성군,025004, 23세,2017,1309,819,490,167.1,1223,756,467,161.9
34360, 홍성군,025005, 24세,2017,1153,679,474,143.2,1055,619,436,142
34360, 홍성군,030,25~29세,2017,5163,2868,2295,125,4603,2473,2130,116.1
34360, 홍성군,030001, 25세,2017,1127,635,492,129.1,1018,561,457,122.8
34360, 홍성군,030002, 26세,2017,1063,594,469,126.7,951,515,436,118.1
34360, 홍성군,030003, 27세,2017,984,525,459,114.4,883,454,429,105.8
34360, 홍성군,030004, 28세,2017,955,550,405,135.8,835,466,369,126.3
34360, 홍성군,030005, 29세,2017,1034,564,470,120,916,477,439,108.7
34360, 홍성군,035,30~34세,2017,5488,2997,2491,120.3,4991,2617,2374,110.2
34360, 홍성군,035001, 30세,2017,983,542,441,122.9,881,462,419,110.3
34360, 홍성군,035002, 31세,2017,1021,569,452,125.9,908,489,419,116.7
34360, 홍성군,035003, 32세,2017,1126,607,519,117,1003,508,495,102.6
34360, 홍성군,035004, 33세,2017,1128,610,518,117.8,1052,555,497,111.7
34360, 홍성군,035005, 34세,2017,1230,669,561,119.3,1147,603,544,110.8
34360, 홍성군,040,35~39세,2017,6896,3581,3315,108,6539,3315,3224,102.8
34360, 홍성군,040001, 35세,2017,1372,672,700,96,1292,617,675,91.4
34360, 홍성군,040002, 36세,2017,1396,769,627,122.6,1324,716,608,117.8
34360, 홍성군,040003, 37세,2017,1428,759,669,113.5,1350,696,654,106.4
34360, 홍성군,040004, 38세,2017,1367,684,683,100.1,1298,632,666,94.9
34360, 홍성군,040005, 39세,2017,1333,697,636,109.6,1275,654,621,105.3
34360, 홍성군,045,40~44세,2017,7127,3739,3388,110.4,6928,3608,3320,108.7
34360, 홍성군,045001, 40세,2017,1301,688,613,112.2,1255,655,600,109.2
34360, 홍성군,045002, 41세,2017,1307,669,638,104.9,1265,646,619,104.4
34360, 홍성군,045003, 42세,2017,1465,747,718,104,1428,721,707,102
34360, 홍성군,045004, 43세,2017,1533,820,713,115,1494,796,698,114
34360, 홍성군,045005, 44세,2017,1521,815,706,115.4,1486,790,696,113.5
34360, 홍성군,050,45~49세,2017,7796,4227,3569,118.4,7594,4102,3492,117.5
34360, 홍성군,050001, 45세,2017,1551,869,682,127.4,1509,839,670,125.2
34360, 홍성군,050002, 46세,2017,1576,868,708,122.6,1536,841,695,121
34360, 홍성군,050003, 47세,2017,1530,820,710,115.5,1491,798,693,115.2
34360, 홍성군,050004, 48세,2017,1568,834,734,113.6,1528,810,718,112.8
34360, 홍성군,050005, 49세,2017,1571,836,735,113.7,1530,814,716,113.7
34360, 홍성군,055,50~54세,2017,7341,3744,3597,104.1,7162,3655,3507,104.2
34360, 홍성군,055001, 50세,2017,1483,755,728,103.7,1450,739,711,103.9
34360, 홍성군,055002, 51세,2017,1261,636,625,101.8,1227,620,607,102.1
34360, 홍성군,055003, 52세,2017,1573,811,762,106.4,1534,794,740,107.3
34360, 홍성군,055004, 53세,2017,1444,734,710,103.4,1416,721,695,103.7
34360, 홍성군,055005, 54세,2017,1580,808,772,104.7,1535,781,754,103.6
34360, 홍성군,060,55~59세,2017,8366,4242,4124,102.9,8221,4168,4053,102.8
34360, 홍성군,060001, 55세,2017,1671,858,813,105.5,1633,842,791,106.4
34360, 홍성군,060002, 56세,2017,1835,915,920,99.5,1819,906,913,99.2
34360, 홍성군,060003, 57세,2017,1823,909,914,99.5,1788,885,903,98
34360, 홍성군,060004, 58세,2017,1537,800,737,108.5,1510,791,719,110
34360, 홍성군,060005, 59세,2017,1500,760,740,102.7,1471,744,727,102.3
34360, 홍성군,065,60~64세,2017,6934,3418,3516,97.2,6837,3367,3470,97
34360, 홍성군,065001, 60세,2017,1480,765,715,107,1449,745,704,105.8
34360, 홍성군,065002, 61세,2017,1451,694,757,91.7,1430,683,747,91.4
34360, 홍성군,065003, 62세,2017,1552,755,797,94.7,1536,746,790,94.4
34360, 홍성군,065004, 63세,2017,1356,673,683,98.5,1340,667,673,99.1
34360, 홍성군,065005, 64세,2017,1095,531,564,94.1,1082,526,556,94.6
34360, 홍성군,070,65~69세,2017,5892,2817,3075,91.6,5849,2793,3056,91.4
34360, 홍성군,070001, 65세,2017,1237,568,669,84.9,1225,562,663,84.8
34360, 홍성군,070002, 66세,2017,1108,540,568,95.1,1097,535,562,95.2
34360, 홍성군,070003, 67세,2017,1127,516,611,84.5,1116,509,607,83.9
34360, 홍성군,070004, 68세,2017,1301,655,646,101.4,1296,652,644,101.2
34360, 홍성군,070005, 69세,2017,1119,538,581,92.6,1115,535,580,92.2
34360, 홍성군,075,70~74세,2017,4511,2074,2437,85.1,4490,2063,2427,85
34360, 홍성군,075001, 70세,2017,1054,509,545,93.4,1047,504,543,92.8
34360, 홍성군,075002, 71세,2017,813,417,396,105.3,805,414,391,105.9
34360, 홍성군,075003, 72세,2017,752,358,394,90.9,749,357,392,91.1
34360, 홍성군,075004, 73세,2017,936,393,543,72.4,933,391,542,72.1
34360, 홍성군,075005, 74세,2017,956,397,559,71,956,397,559,71
34360, 홍성군,080,75~79세,2017,4870,1957,2913,67.2,4860,1952,2908,67.1
34360, 홍성군,080001, 75세,2017,1226,518,708,73.2,1224,517,707,73.1
34360, 홍성군,080002, 76세,2017,910,367,543,67.6,908,366,542,67.5
34360, 홍성군,080003, 77세,2017,819,316,503,62.8,815,313,502,62.4
34360, 홍성군,080004, 78세,2017,968,394,574,68.6,967,394,573,68.8
34360, 홍성군,080005, 79세,2017,947,362,585,61.9,946,362,584,62
34360, 홍성군,085,80~84세,2017,3644,1357,2287,59.3,3638,1357,2281,59.5
34360, 홍성군,085001, 80세,2017,807,313,494,63.4,805,313,492,63.6
34360, 홍성군,085002, 81세,2017,884,341,543,62.8,883,341,542,62.9
34360, 홍성군,085003, 82세,2017,765,285,480,59.4,764,285,479,59.5
34360, 홍성군,085004, 83세,2017,651,250,401,62.3,650,250,400,62.5
34360, 홍성군,085005, 84세,2017,537,168,369,45.5,536,168,368,45.7
34360, 홍성군,090,85~89세,2017,1650,539,1111,48.5,1648,539,1109,48.6
34360, 홍성군,090001, 85세,2017,510,183,327,56,510,183,327,56
34360, 홍성군,090002, 86세,2017,329,102,227,44.9,328,102,226,45.1
34360, 홍성군,090003, 87세,2017,327,108,219,49.3,327,108,219,49.3
34360, 홍성군,090004, 88세,2017,269,80,189,42.3,269,80,189,42.3
34360, 홍성군,090005, 89세,2017,215,66,149,44.3,214,66,148,44.6
34360, 홍성군,095,90~94세,2017,512,123,389,31.6,511,123,388,31.7
34360, 홍성군,095001, 90세,2017,145,39,106,36.8,145,39,106,36.8
34360, 홍성군,095002, 91세,2017,129,34,95,35.8,129,34,95,35.8
34360, 홍성군,095003, 92세,2017,89,23,66,34.8,89,23,66,34.8
34360, 홍성군,095004, 93세,2017,65,12,53,22.6,65,12,53,22.6
34360, 홍성군,095005, 94세,2017,84,15,69,21.7,83,15,68,22.1
34360, 홍성군,100,95~99세,2017,96,19,77,24.7,96,19,77,24.7
34360, 홍성군,100001, 95세,2017,42,7,35,20,42,7,35,20
34360, 홍성군,100002, 96세,2017,22,5,17,29.4,22,5,17,29.4
34360, 홍성군,100003, 97세,2017,12,X,9,33.3,12,X,9,33.3
34360, 홍성군,100004, 98세,2017,12,X,10,20,12,X,10,20
34360, 홍성군,100005, 99세,2017,8,X,6,33.3,8,X,6,33.3
34360, 홍성군,101,100세이상,2017,11,X,10,10,11,X,10,10
34360, 홍성군,102,15세미만,2017,13423,6883,6540,105.2,13361,6849,6512,105.2
34360, 홍성군,103,15~64세,2017,68439,35668,32771,108.8,65847,33948,31899,106.4
34360, 홍성군,104,65세이상,2017,21186,8887,12299,72.3,21103,8847,12256,72.2
34360, 홍성군,086,85세이상,2017,2269,682,1587,43,2266,682,1584,43.1
34360, 홍성군,126,평균연령,2017,43.9,42.4,45.5,,44.1,42.6,45.6,
34360, 홍성군,127,중위연령,2017,45.1,43.5,46.9,,45.5,44.1,47.1,
34370, 예산군,000,합계,2017,78678,39916,38762,103,75910,38073,37837,100.6
34370, 예산군,005,0~4세,2017,1760,901,859,104.9,1737,883,854,103.4
34370, 예산군,005001, 0세,2017,289,143,146,97.9,285,140,145,96.6
34370, 예산군,005002, 1세,2017,311,160,151,106,307,157,150,104.7
34370, 예산군,005003, 2세,2017,362,210,152,138.2,358,206,152,135.5
34370, 예산군,005004, 3세,2017,382,187,195,95.9,375,181,194,93.3
34370, 예산군,005005, 4세,2017,416,201,215,93.5,412,199,213,93.4
34370, 예산군,010,5~9세,2017,2376,1252,1124,111.4,2366,1246,1120,111.3
34370, 예산군,010001, 5세,2017,469,259,210,123.3,466,257,209,123
34370, 예산군,010002, 6세,2017,490,262,228,114.9,487,259,228,113.6
34370, 예산군,010003, 7세,2017,481,248,233,106.4,478,247,231,106.9
34370, 예산군,010004, 8세,2017,462,243,219,111,461,243,218,111.5
34370, 예산군,010005, 9세,2017,474,240,234,102.6,474,240,234,102.6
34370, 예산군,015,10~14세,2017,2645,1353,1292,104.7,2635,1348,1287,104.7
34370, 예산군,015001, 10세,2017,596,327,269,121.6,595,326,269,121.2
34370, 예산군,015002, 11세,2017,504,234,270,86.7,501,232,269,86.2
34370, 예산군,015003, 12세,2017,485,253,232,109.1,483,252,231,109.1
34370, 예산군,015004, 13세,2017,513,266,247,107.7,511,265,246,107.7
34370, 예산군,015005, 14세,2017,547,273,274,99.6,545,273,272,100.4
34370, 예산군,020,15~19세,2017,3711,1937,1774,109.2,3699,1930,1769,109.1
34370, 예산군,020001, 15세,2017,637,329,308,106.8,637,329,308,106.8
34370, 예산군,020002, 16세,2017,737,389,348,111.8,736,388,348,111.5
34370, 예산군,020003, 17세,2017,801,419,382,109.7,796,416,380,109.5
34370, 예산군,020004, 18세,2017,784,417,367,113.6,784,417,367,113.6
34370, 예산군,020005, 19세,2017,752,383,369,103.8,746,380,366,103.8
34370, 예산군,025,20~24세,2017,4214,2343,1871,125.2,3943,2154,1789,120.4
34370, 예산군,025001, 20세,2017,803,418,385,108.6,787,411,376,109.3
34370, 예산군,025002, 21세,2017,889,486,403,120.6,853,461,392,117.6
34370, 예산군,025003, 22세,2017,895,529,366,144.5,827,484,343,141.1
34370, 예산군,025004, 23세,2017,798,442,356,124.2,728,392,336,116.7
34370, 예산군,025005, 24세,2017,829,468,361,129.6,748,406,342,118.7
34370, 예산군,030,25~29세,2017,3659,2254,1405,160.4,3087,1840,1247,147.6
34370, 예산군,030001, 25세,2017,831,509,322,158.1,714,427,287,148.8
34370, 예산군,030002, 26세,2017,744,459,285,161.1,639,385,254,151.6
34370, 예산군,030003, 27세,2017,739,460,279,164.9,624,374,250,149.6
34370, 예산군,030004, 28세,2017,687,423,264,160.2,574,345,229,150.7
34370, 예산군,030005, 29세,2017,658,403,255,158,536,309,227,136.1
34370, 예산군,035,30~34세,2017,3445,2049,1396,146.8,2920,1670,1250,133.6
34370, 예산군,035001, 30세,2017,694,407,287,141.8,575,322,253,127.3
34370, 예산군,035002, 31세,2017,648,405,243,166.7,544,328,216,151.9
34370, 예산군,035003, 32세,2017,666,389,277,140.4,563,318,245,129.8
34370, 예산군,035004, 33세,2017,719,421,298,141.3,610,346,264,131.1
34370, 예산군,035005, 34세,2017,718,427,291,146.7,628,356,272,130.9
34370, 예산군,040,35~39세,2017,3930,2234,1696,131.7,3553,1959,1594,122.9
34370, 예산군,040001, 35세,2017,776,453,323,140.2,688,386,302,127.8
34370, 예산군,040002, 36세,2017,774,445,329,135.3,692,389,303,128.4
34370, 예산군,040003, 37세,2017,845,468,377,124.1,766,408,358,114
34370, 예산군,040004, 38세,2017,782,443,339,130.7,714,392,322,121.7
34370, 예산군,040005, 39세,2017,753,425,328,129.6,693,384,309,124.3
34370, 예산군,045,40~44세,2017,4790,2684,2106,127.4,4514,2497,2017,123.8
34370, 예산군,045001, 40세,2017,808,463,345,134.2,738,410,328,125
34370, 예산군,045002, 41세,2017,876,502,374,134.2,822,461,361,127.7
34370, 예산군,045003, 42세,2017,920,515,405,127.2,866,480,386,124.4
34370, 예산군,045004, 43세,2017,1052,556,496,112.1,1009,531,478,111.1
34370, 예산군,045005, 44세,2017,1134,648,486,133.3,1079,615,464,132.5
34370, 예산군,050,45~49세,2017,5809,3232,2577,125.4,5584,3093,2491,124.2
34370, 예산군,050001, 45세,2017,1029,570,459,124.2,979,536,443,121
34370, 예산군,050002, 46세,2017,1133,640,493,129.8,1086,613,473,129.6
34370, 예산군,050003, 47세,2017,1122,627,495,126.7,1091,609,482,126.3
34370, 예산군,050004, 48세,2017,1256,715,541,132.2,1203,686,517,132.7
34370, 예산군,050005, 49세,2017,1269,680,589,115.4,1225,649,576,112.7
34370, 예산군,055,50~54세,2017,5918,3123,2795,111.7,5720,3030,2690,112.6
34370, 예산군,055001, 50세,2017,1106,615,491,125.3,1070,593,477,124.3
34370, 예산군,055002, 51세,2017,1064,562,502,112,1022,539,483,111.6
34370, 예산군,055003, 52세,2017,1313,675,638,105.8,1270,663,607,109.2
34370, 예산군,055004, 53세,2017,1206,646,560,115.4,1174,633,541,117
34370, 예산군,055005, 54세,2017,1229,625,604,103.5,1184,602,582,103.4
34370, 예산군,060,55~59세,2017,7939,3936,4003,98.3,7802,3864,3938,98.1
34370, 예산군,060001, 55세,2017,1487,769,718,107.1,1448,746,702,106.3
34370, 예산군,060002, 56세,2017,1777,901,876,102.9,1762,893,869,102.8
34370, 예산군,060003, 57세,2017,1748,823,925,89,1717,805,912,88.3
34370, 예산군,060004, 58세,2017,1451,710,741,95.8,1430,701,729,96.2
34370, 예산군,060005, 59세,2017,1476,733,743,98.7,1445,719,726,99
34370, 예산군,065,60~64세,2017,6821,3437,3384,101.6,6741,3399,3342,101.7
34370, 예산군,065001, 60세,2017,1436,727,709,102.5,1413,717,696,103
34370, 예산군,065002, 61세,2017,1419,752,667,112.7,1397,742,655,113.3
34370, 예산군,065003, 62세,2017,1520,756,764,99,1508,750,758,98.9
34370, 예산군,065004, 63세,2017,1344,660,684,96.5,1333,654,679,96.3
34370, 예산군,065005, 64세,2017,1102,542,560,96.8,1090,536,554,96.8
34370, 예산군,070,65~69세,2017,5854,2800,3054,91.7,5831,2786,3045,91.5
34370, 예산군,070001, 65세,2017,1290,633,657,96.3,1283,629,654,96.2
34370, 예산군,070002, 66세,2017,1032,456,576,79.2,1028,452,576,78.5
34370, 예산군,070003, 67세,2017,1204,571,633,90.2,1201,570,631,90.3
34370, 예산군,070004, 68세,2017,1185,586,599,97.8,1179,583,596,97.8
34370, 예산군,070005, 69세,2017,1143,554,589,94.1,1140,552,588,93.9
34370, 예산군,075,70~74세,2017,4641,2146,2495,86,4627,2140,2487,86
34370, 예산군,075001, 70세,2017,1139,567,572,99.1,1135,566,569,99.5
34370, 예산군,075002, 71세,2017,777,389,388,100.3,773,388,385,100.8
34370, 예산군,075003, 72세,2017,795,330,465,71,791,327,464,70.5
34370, 예산군,075004, 73세,2017,950,410,540,75.9,949,410,539,76.1
34370, 예산군,075005, 74세,2017,980,450,530,84.9,979,449,530,84.7
34370, 예산군,080,75~79세,2017,5161,2129,3032,70.2,5153,2129,3024,70.4
34370, 예산군,080001, 75세,2017,1285,537,748,71.8,1285,537,748,71.8
34370, 예산군,080002, 76세,2017,979,410,569,72.1,975,410,565,72.6
34370, 예산군,080003, 77세,2017,911,397,514,77.2,909,397,512,77.5
34370, 예산군,080004, 78세,2017,1012,409,603,67.8,1012,409,603,67.8
34370, 예산군,080005, 79세,2017,974,376,598,62.9,972,376,596,63.1
34370, 예산군,085,80~84세,2017,3862,1503,2359,63.7,3859,1502,2357,63.7
34370, 예산군,085001, 80세,2017,906,373,533,70,904,372,532,69.9
34370, 예산군,085002, 81세,2017,875,355,520,68.3,875,355,520,68.3
34370, 예산군,085003, 82세,2017,791,296,495,59.8,791,296,495,59.8
34370, 예산군,085004, 83세,2017,681,263,418,62.9,681,263,418,62.9
34370, 예산군,085005, 84세,2017,609,216,393,55,608,216,392,55.1
34370, 예산군,090,85~89세,2017,1587,463,1124,41.2,1584,463,1121,41.3
34370, 예산군,090001, 85세,2017,503,160,343,46.6,501,160,341,46.9
34370, 예산군,090002, 86세,2017,348,104,244,42.6,348,104,244,42.6
34370, 예산군,090003, 87세,2017,282,72,210,34.3,281,72,209,34.4
34370, 예산군,090004, 88세,2017,258,81,177,45.8,258,81,177,45.8
34370, 예산군,090005, 89세,2017,196,46,150,30.7,196,46,150,30.7
34370, 예산군,095,90~94세,2017,437,119,318,37.4,436,119,317,37.5
34370, 예산군,095001, 90세,2017,153,52,101,51.5,152,52,100,52
34370, 예산군,095002, 91세,2017,95,27,68,39.7,95,27,68,39.7
34370, 예산군,095003, 92세,2017,91,25,66,37.9,91,25,66,37.9
34370, 예산군,095004, 93세,2017,49,X,45,8.9,49,X,45,8.9
34370, 예산군,095005, 94세,2017,49,11,38,28.9,49,11,38,28.9
34370, 예산군,100,95~99세,2017,106,19,87,21.8,106,19,87,21.8
34370, 예산군,100001, 95세,2017,40,5,35,14.3,40,5,35,14.3
34370, 예산군,100002, 96세,2017,35,10,25,40,35,10,25,40
34370, 예산군,100003, 97세,2017,19,X,16,18.8,19,X,16,18.8
34370, 예산군,100004, 98세,2017,8,X,8,0,8,X,8,0
34370, 예산군,100005, 99세,2017,X,X,X,33.3,X,X,X,33.3
34370, 예산군,101,100세이상,2017,13,X,11,18.2,13,X,11,18.2
34370, 예산군,102,15세미만,2017,6781,3506,3275,107.1,6738,3477,3261,106.6
34370, 예산군,103,15~64세,2017,50236,27229,23007,118.4,47563,25436,22127,115
34370, 예산군,104,65세이상,2017,21661,9181,12480,73.6,21609,9160,12449,73.6
34370, 예산군,086,85세이상,2017,2143,603,1540,39.2,2139,603,1536,39.3
34370, 예산군,126,평균연령,2017,49.4,47.2,51.6,,49.9,47.8,51.9,
34370, 예산군,127,중위연령,2017,52.6,49.6,55.7,,53.5,50.7,56.1,
34380, 태안군,000,합계,2017,61170,31411,29759,105.6,59603,30291,29312,103.3
34380, 태안군,005,0~4세,2017,1655,820,835,98.2,1651,817,834,98
34380, 태안군,005001, 0세,2017,270,135,135,100,270,135,135,100
34380, 태안군,005002, 1세,2017,330,165,165,100,329,164,165,99.4
34380, 태안군,005003, 2세,2017,333,168,165,101.8,332,167,165,101.2
34380, 태안군,005004, 3세,2017,332,154,178,86.5,330,153,177,86.4
34380, 태안군,005005, 4세,2017,390,198,192,103.1,390,198,192,103.1
34380, 태안군,010,5~9세,2017,2026,1059,967,109.5,2025,1058,967,109.4
34380, 태안군,010001, 5세,2017,403,197,206,95.6,402,196,206,95.1
34380, 태안군,010002, 6세,2017,415,218,197,110.7,415,218,197,110.7
34380, 태안군,010003, 7세,2017,353,193,160,120.6,353,193,160,120.6
34380, 태안군,010004, 8세,2017,407,220,187,117.6,407,220,187,117.6
34380, 태안군,010005, 9세,2017,448,231,217,106.5,448,231,217,106.5
34380, 태안군,015,10~14세,2017,2155,1100,1055,104.3,2153,1099,1054,104.3
34380, 태안군,015001, 10세,2017,437,228,209,109.1,437,228,209,109.1
34380, 태안군,015002, 11세,2017,434,224,210,106.7,433,224,209,107.2
34380, 태안군,015003, 12세,2017,409,194,215,90.2,409,194,215,90.2
34380, 태안군,015004, 13세,2017,419,211,208,101.4,419,211,208,101.4
34380, 태안군,015005, 14세,2017,456,243,213,114.1,455,242,213,113.6
34380, 태안군,020,15~19세,2017,2645,1414,1231,114.9,2638,1409,1229,114.6
34380, 태안군,020001, 15세,2017,449,233,216,107.9,449,233,216,107.9
34380, 태안군,020002, 16세,2017,499,227,272,83.5,499,227,272,83.5
34380, 태안군,020003, 17세,2017,563,269,294,91.5,563,269,294,91.5
34380, 태안군,020004, 18세,2017,530,277,253,109.5,529,276,253,109.1
34380, 태안군,020005, 19세,2017,604,408,196,208.2,598,404,194,208.2
34380, 태안군,025,20~24세,2017,3000,2005,995,201.5,2839,1894,945,200.4
34380, 태안군,025001, 20세,2017,620,430,190,226.3,608,420,188,223.4
34380, 태안군,025002, 21세,2017,620,431,189,228,597,416,181,229.8
34380, 태안군,025003, 22세,2017,623,428,195,219.5,595,407,188,216.5
34380, 태안군,025004, 23세,2017,575,390,185,210.8,527,355,172,206.4
34380, 태안군,025005, 24세,2017,562,326,236,138.1,512,296,216,137
34380, 태안군,030,25~29세,2017,2660,1593,1067,149.3,2385,1401,984,142.4
34380, 태안군,030001, 25세,2017,587,362,225,160.9,534,324,210,154.3
34380, 태안군,030002, 26세,2017,521,310,211,146.9,467,276,191,144.5
34380, 태안군,030003, 27세,2017,523,312,211,147.9,459,266,193,137.8
34380, 태안군,030004, 28세,2017,527,317,210,151,477,282,195,144.6
34380, 태안군,030005, 29세,2017,502,292,210,139,448,253,195,129.7
34380, 태안군,035,30~34세,2017,2777,1644,1133,145.1,2483,1424,1059,134.5
34380, 태안군,035001, 30세,2017,526,313,213,146.9,468,270,198,136.4
34380, 태안군,035002, 31세,2017,510,315,195,161.5,445,266,179,148.6
34380, 태안군,035003, 32세,2017,546,317,229,138.4,483,274,209,131.1
34380, 태안군,035004, 33세,2017,548,308,240,128.3,496,267,229,116.6
34380, 태안군,035005, 34세,2017,647,391,256,152.7,591,347,244,142.2
34380, 태안군,040,35~39세,2017,3551,2038,1513,134.7,3286,1818,1468,123.8
34380, 태안군,040001, 35세,2017,728,402,326,123.3,664,350,314,111.5
34380, 태안군,040002, 36세,2017,677,391,286,136.7,623,347,276,125.7
34380, 태안군,040003, 37세,2017,786,455,331,137.5,743,420,323,130
34380, 태안군,040004, 38세,2017,647,380,267,142.3,595,336,259,129.7
34380, 태안군,040005, 39세,2017,713,410,303,135.3,661,365,296,123.3
34380, 태안군,045,40~44세,2017,3744,2132,1612,132.3,3580,2003,1577,127
34380, 태안군,045001, 40세,2017,688,393,295,133.2,647,362,285,127
34380, 태안군,045002, 41세,2017,693,409,284,144,671,389,282,137.9
34380, 태안군,045003, 42세,2017,727,420,307,136.8,690,389,301,129.2
34380, 태안군,045004, 43세,2017,808,434,374,116,772,409,363,112.7
34380, 태안군,045005, 44세,2017,828,476,352,135.2,800,454,346,131.2
34380, 태안군,050,45~49세,2017,4266,2394,1872,127.9,4126,2294,1832,125.2
34380, 태안군,050001, 45세,2017,793,469,324,144.8,748,438,310,141.3
34380, 태안군,050002, 46세,2017,846,489,357,137,813,464,349,133
34380, 태안군,050003, 47세,2017,835,467,368,126.9,812,451,361,124.9
34380, 태안군,050004, 48세,2017,886,481,405,118.8,865,467,398,117.3
34380, 태안군,050005, 49세,2017,906,488,418,116.7,888,474,414,114.5
34380, 태안군,055,50~54세,2017,4639,2442,2197,111.2,4549,2396,2153,111.3
34380, 태안군,055001, 50세,2017,848,458,390,117.4,827,447,380,117.6
34380, 태안군,055002, 51세,2017,869,446,423,105.4,851,440,411,107.1
34380, 태안군,055003, 52세,2017,1009,539,470,114.7,997,534,463,115.3
34380, 태안군,055004, 53세,2017,931,482,449,107.3,912,467,445,104.9
34380, 태안군,055005, 54세,2017,982,517,465,111.2,962,508,454,111.9
34380, 태안군,060,55~59세,2017,5976,2992,2984,100.3,5904,2952,2952,100
34380, 태안군,060001, 55세,2017,1066,554,512,108.2,1051,547,504,108.5
34380, 태안군,060002, 56세,2017,1278,638,640,99.7,1268,631,637,99.1
34380, 태안군,060003, 57세,2017,1290,654,636,102.8,1272,645,627,102.9
34380, 태안군,060004, 58세,2017,1154,554,600,92.3,1140,547,593,92.2
34380, 태안군,060005, 59세,2017,1188,592,596,99.3,1173,582,591,98.5
34380, 태안군,065,60~64세,2017,5404,2526,2878,87.8,5353,2496,2857,87.4
34380, 태안군,065001, 60세,2017,1122,510,612,83.3,1114,504,610,82.6
34380, 태안군,065002, 61세,2017,1158,545,613,88.9,1150,540,610,88.5
34380, 태안군,065003, 62세,2017,1135,532,603,88.2,1124,526,598,88
34380, 태안군,065004, 63세,2017,1023,493,530,93,1012,487,525,92.8
34380, 태안군,065005, 64세,2017,966,446,520,85.8,953,439,514,85.4
34380, 태안군,070,65~69세,2017,4850,2415,2435,99.2,4825,2398,2427,98.8
34380, 태안군,070001, 65세,2017,1032,509,523,97.3,1024,502,522,96.2
34380, 태안군,070002, 66세,2017,845,423,422,100.2,837,418,419,99.8
34380, 태안군,070003, 67세,2017,1004,527,477,110.5,1001,525,476,110.3
34380, 태안군,070004, 68세,2017,1023,516,507,101.8,1019,515,504,102.2
34380, 태안군,070005, 69세,2017,946,440,506,87,944,438,506,86.6
34380, 태안군,075,70~74세,2017,4046,1960,2086,94,4038,1957,2081,94
34380, 태안군,075001, 70세,2017,979,504,475,106.1,979,504,475,106.1
34380, 태안군,075002, 71세,2017,717,384,333,115.3,714,383,331,115.7
34380, 태안군,075003, 72세,2017,716,346,370,93.5,715,346,369,93.8
34380, 태안군,075004, 73세,2017,821,378,443,85.3,818,377,441,85.5
34380, 태안군,075005, 74세,2017,813,348,465,74.8,812,347,465,74.6
34380, 태안군,080,75~79세,2017,3692,1560,2132,73.2,3686,1558,2128,73.2
34380, 태안군,080001, 75세,2017,1020,452,568,79.6,1018,452,566,79.9
34380, 태안군,080002, 76세,2017,686,283,403,70.2,685,282,403,70
34380, 태안군,080003, 77세,2017,641,265,376,70.5,640,264,376,70.2
34380, 태안군,080004, 78세,2017,714,290,424,68.4,712,290,422,68.7
34380, 태안군,080005, 79세,2017,631,270,361,74.8,631,270,361,74.8
34380, 태안군,085,80~84세,2017,2492,889,1603,55.5,2491,889,1602,55.5
34380, 태안군,085001, 80세,2017,548,229,319,71.8,547,229,318,72
34380, 태안군,085002, 81세,2017,573,210,363,57.9,573,210,363,57.9
34380, 태안군,085003, 82세,2017,520,178,342,52,520,178,342,52
34380, 태안군,085004, 83세,2017,417,133,284,46.8,417,133,284,46.8
34380, 태안군,085005, 84세,2017,434,139,295,47.1,434,139,295,47.1
34380, 태안군,090,85~89세,2017,1131,333,798,41.7,1130,333,797,41.8
34380, 태안군,090001, 85세,2017,366,128,238,53.8,366,128,238,53.8
34380, 태안군,090002, 86세,2017,244,76,168,45.2,244,76,168,45.2
34380, 태안군,090003, 87세,2017,192,49,143,34.3,191,49,142,34.5
34380, 태안군,090004, 88세,2017,169,34,135,25.2,169,34,135,25.2
34380, 태안군,090005, 89세,2017,160,46,114,40.4,160,46,114,40.4
34380, 태안군,095,90~94세,2017,369,79,290,27.2,369,79,290,27.2
34380, 태안군,095001, 90세,2017,109,27,82,32.9,109,27,82,32.9
34380, 태안군,095002, 91세,2017,76,14,62,22.6,76,14,62,22.6
34380, 태안군,095003, 92세,2017,88,17,71,23.9,88,17,71,23.9
34380, 태안군,095004, 93세,2017,56,11,45,24.4,56,11,45,24.4
34380, 태안군,095005, 94세,2017,40,10,30,33.3,40,10,30,33.3
34380, 태안군,100,95~99세,2017,80,15,65,23.1,80,15,65,23.1
34380, 태안군,100001, 95세,2017,37,X,33,12.1,37,X,33,12.1
34380, 태안군,100002, 96세,2017,19,6,13,46.2,19,6,13,46.2
34380, 태안군,100003, 97세,2017,13,X,11,18.2,13,X,11,18.2
34380, 태안군,100004, 98세,2017,5,X,X,150,5,X,X,150
34380, 태안군,100005, 99세,2017,6,X,6,0,6,X,6,0
34380, 태안군,101,100세이상,2017,12,X,11,9.1,12,X,11,9.1
34380, 태안군,102,15세미만,2017,5836,2979,2857,104.3,5829,2974,2855,104.2
34380, 태안군,103,15~64세,2017,38662,21180,17482,121.2,37143,20087,17056,117.8
34380, 태안군,104,65세이상,2017,16672,7252,9420,77,16631,7230,9401,76.9
34380, 태안군,086,85세이상,2017,1592,428,1164,36.8,1591,428,1163,36.8
34380, 태안군,126,평균연령,2017,49,46.7,51.4,,49.3,47,51.6,
34380, 태안군,127,중위연령,2017,52.4,49,55.8,,53,49.8,56.1,
35,전라북도,000,합계,2017,1826174,911592,914582,99.7,1792410,893346,899064,99.4
35,전라북도,005,0~4세,2017,68290,35118,33172,105.9,68023,34967,33056,105.8
35,전라북도,005001, 0세,2017,11492,5847,5645,103.6,11433,5812,5621,103.4
35,전라북도,005002, 1세,2017,13107,6735,6372,105.7,13050,6705,6345,105.7
35,전라북도,005003, 2세,2017,14270,7301,6969,104.8,14211,7266,6945,104.6
35,전라북도,005004, 3세,2017,14383,7398,6985,105.9,14327,7370,6957,105.9
35,전라북도,005005, 4세,2017,15038,7837,7201,108.8,15002,7814,7188,108.7
35,전라북도,010,5~9세,2017,80210,41274,38936,106,80043,41192,38851,106
35,전라북도,010001, 5세,2017,16451,8426,8025,105,16401,8403,7998,105.1
35,전라북도,010002, 6세,2017,16636,8497,8139,104.4,16602,8480,8122,104.4
35,전라북도,010003, 7세,2017,15732,8142,7590,107.3,15699,8125,7574,107.3
35,전라북도,010004, 8세,2017,15223,7822,7401,105.7,15196,7809,7387,105.7
35,전라북도,010005, 9세,2017,16168,8387,7781,107.8,16145,8375,7770,107.8
35,전라북도,015,10~14세,2017,82865,42971,39894,107.7,82765,42923,39842,107.7
35,전라북도,015001, 10세,2017,16759,8631,8128,106.2,16739,8622,8117,106.2
35,전라북도,015002, 11세,2017,15492,8040,7452,107.9,15473,8031,7442,107.9
35,전라북도,015003, 12세,2017,15763,8272,7491,110.4,15749,8264,7485,110.4
35,전라북도,015004, 13세,2017,17071,8842,8229,107.4,17047,8830,8217,107.5
35,전라북도,015005, 14세,2017,17780,9186,8594,106.9,17757,9176,8581,106.9
35,전라북도,020,15~19세,2017,114829,60874,53955,112.8,113587,60244,53343,112.9
35,전라북도,020001, 15세,2017,18890,9934,8956,110.9,18864,9922,8942,111
35,전라북도,020002, 16세,2017,22346,11587,10759,107.7,22314,11574,10740,107.8
35,전라북도,020003, 17세,2017,24758,13072,11686,111.9,24675,13023,11652,111.8
35,전라북도,020004, 18세,2017,23642,12552,11090,113.2,23354,12403,10951,113.3
35,전라북도,020005, 19세,2017,25193,13729,11464,119.8,24380,13322,11058,120.5
35,전라북도,025,20~24세,2017,128067,70721,57346,123.3,122021,67646,54375,124.4
35,전라북도,025001, 20세,2017,25893,14011,11882,117.9,24941,13502,11439,118
35,전라북도,025002, 21세,2017,26577,14487,12090,119.8,25464,13926,11538,120.7
35,전라북도,025003, 22세,2017,26341,14559,11782,123.6,25092,13951,11141,125.2
35,전라북도,025004, 23세,2017,25432,14305,11127,128.6,24101,13616,10485,129.9
35,전라북도,025005, 24세,2017,23824,13359,10465,127.7,22423,12651,9772,129.5
35,전라북도,030,25~29세,2017,99015,53533,45482,117.7,92330,49674,42656,116.5
35,전라북도,030001, 25세,2017,22592,12391,10201,121.5,21232,11652,9580,121.6
35,전라북도,030002, 26세,2017,20623,11139,9484,117.5,19269,10358,8911,116.2
35,전라북도,030003, 27세,2017,19310,10503,8807,119.3,17954,9718,8236,118
35,전라북도,030004, 28세,2017,18390,9948,8442,117.8,17134,9191,7943,115.7
35,전라북도,030005, 29세,2017,18100,9552,8548,111.7,16741,8755,7986,109.6
35,전라북도,035,30~34세,2017,97034,50645,46389,109.2,91748,47482,44266,107.3
35,전라북도,035001, 30세,2017,17997,9479,8518,111.3,16761,8718,8043,108.4
35,전라북도,035002, 31세,2017,18728,9825,8903,110.4,17557,9126,8431,108.2
35,전라북도,035003, 32세,2017,18381,9529,8852,107.6,17363,8928,8435,105.8
35,전라북도,035004, 33세,2017,20198,10550,9648,109.3,19204,9954,9250,107.6
35,전라북도,035005, 34세,2017,21730,11262,10468,107.6,20863,10756,10107,106.4
35,전라북도,040,35~39세,2017,120108,62003,58105,106.7,116625,59943,56682,105.8
35,전라북도,040001, 35세,2017,23850,12347,11503,107.3,23041,11866,11175,106.2
35,전라북도,040002, 36세,2017,23882,12452,11430,108.9,23155,12022,11133,108
35,전라북도,040003, 37세,2017,25162,12893,12269,105.1,24436,12466,11970,104.1
35,전라북도,040004, 38세,2017,24123,12491,11632,107.4,23465,12093,11372,106.3
35,전라북도,040005, 39세,2017,23091,11820,11271,104.9,22528,11496,11032,104.2
35,전라북도,045,40~44세,2017,131711,67634,64077,105.6,129326,66308,63018,105.2
35,전라북도,045001, 40세,2017,24025,12322,11703,105.3,23509,12010,11499,104.4
35,전라북도,045002, 41세,2017,24273,12575,11698,107.5,23779,12282,11497,106.8
35,전라북도,045003, 42세,2017,25258,12925,12333,104.8,24808,12691,12117,104.7
35,전라북도,045004, 43세,2017,29232,15015,14217,105.6,28773,14789,13984,105.8
35,전라북도,045005, 44세,2017,28923,14797,14126,104.8,28457,14536,13921,104.4
35,전라북도,050,45~49세,2017,150192,77962,72230,107.9,147780,76754,71026,108.1
35,전라북도,050001, 45세,2017,28666,14977,13689,109.4,28138,14708,13430,109.5
35,전라북도,050002, 46세,2017,31319,16416,14903,110.2,30845,16179,14666,110.3
35,전라북도,050003, 47세,2017,29611,15406,14205,108.5,29096,15133,13963,108.4
35,전라북도,050004, 48세,2017,30040,15441,14599,105.8,29602,15225,14377,105.9
35,전라북도,050005, 49세,2017,30556,15722,14834,106,30099,15509,14590,106.3
35,전라북도,055,50~54세,2017,140178,72239,67939,106.3,137980,71221,66759,106.7
35,전라북도,055001, 50세,2017,28127,14348,13779,104.1,27701,14163,13538,104.6
35,전라북도,055002, 51세,2017,28522,14888,13634,109.2,28087,14688,13399,109.6
35,전라북도,055003, 52세,2017,28664,14655,14009,104.6,28196,14453,13743,105.2
35,전라북도,055004, 53세,2017,26769,13904,12865,108.1,26329,13684,12645,108.2
35,전라북도,055005, 54세,2017,28096,14444,13652,105.8,27667,14233,13434,105.9
35,전라북도,060,55~59세,2017,150771,75531,75240,100.4,149229,74847,74382,100.6
35,전라북도,060001, 55세,2017,29848,15392,14456,106.5,29450,15216,14234,106.9
35,전라북도,060002, 56세,2017,31982,16022,15960,100.4,31709,15913,15796,100.7
35,전라북도,060003, 57세,2017,33580,16614,16966,97.9,33260,16466,16794,98
35,전라북도,060004, 58세,2017,28791,14208,14583,97.4,28527,14096,14431,97.7
35,전라북도,060005, 59세,2017,26570,13295,13275,100.2,26283,13156,13127,100.2
35,전라북도,065,60~64세,2017,120983,60096,60887,98.7,119906,59575,60331,98.7
35,전라북도,065001, 60세,2017,27255,13780,13475,102.3,26957,13641,13316,102.4
35,전라북도,065002, 61세,2017,25182,12627,12555,100.6,24963,12516,12447,100.6
35,전라북도,065003, 62세,2017,26569,13119,13450,97.5,26343,13009,13334,97.6
35,전라북도,065004, 63세,2017,23213,11408,11805,96.6,23040,11324,11716,96.7
35,전라북도,065005, 64세,2017,18764,9162,9602,95.4,18603,9085,9518,95.5
35,전라북도,070,65~69세,2017,97786,46997,50789,92.5,97319,46757,50562,92.5
35,전라북도,070001, 65세,2017,20908,10265,10643,96.4,20791,10200,10591,96.3
35,전라북도,070002, 66세,2017,18491,9024,9467,95.3,18384,8970,9414,95.3
35,전라북도,070003, 67세,2017,20824,10003,10821,92.4,20722,9953,10769,92.4
35,전라북도,070004, 68세,2017,18932,8851,10081,87.8,18864,8823,10041,87.9
35,전라북도,070005, 69세,2017,18631,8854,9777,90.6,18558,8811,9747,90.4
35,전라북도,075,70~74세,2017,78718,35658,43060,82.8,78503,35554,42949,82.8
35,전라북도,075001, 70세,2017,20207,9643,10564,91.3,20142,9608,10534,91.2
35,전라북도,075002, 71세,2017,15385,7302,8083,90.3,15333,7280,8053,90.4
35,전라북도,075003, 72세,2017,13902,6173,7729,79.9,13860,6143,7717,79.6
35,전라북도,075004, 73세,2017,14047,6134,7913,77.5,14021,6127,7894,77.6
35,전라북도,075005, 74세,2017,15177,6406,8771,73,15147,6396,8751,73.1
35,전라북도,080,75~79세,2017,78204,31139,47065,66.2,78104,31105,46999,66.2
35,전라북도,080001, 75세,2017,21493,8851,12642,70,21470,8841,12629,70
35,전라북도,080002, 76세,2017,14938,6092,8846,68.9,14919,6086,8833,68.9
35,전라북도,080003, 77세,2017,13844,5473,8371,65.4,13816,5463,8353,65.4
35,전라북도,080004, 78세,2017,14552,5728,8824,64.9,14535,5724,8811,65
35,전라북도,080005, 79세,2017,13377,4995,8382,59.6,13364,4991,8373,59.6
35,전라북도,085,80~84세,2017,52557,18276,34281,53.3,52491,18246,34245,53.3
35,전라북도,085001, 80세,2017,12402,4600,7802,59,12383,4593,7790,59
35,전라북도,085002, 81세,2017,11198,4040,7158,56.4,11187,4037,7150,56.5
35,전라북도,085003, 82세,2017,11185,3812,7373,51.7,11171,3804,7367,51.6
35,전라북도,085004, 83세,2017,9613,3225,6388,50.5,9601,3221,6380,50.5
35,전라북도,085005, 84세,2017,8159,2599,5560,46.7,8149,2591,5558,46.6
35,전라북도,090,85~89세,2017,24932,6794,18138,37.5,24911,6784,18127,37.4
35,전라북도,090001, 85세,2017,6894,2033,4861,41.8,6891,2031,4860,41.8
35,전라북도,090002, 86세,2017,5425,1499,3926,38.2,5418,1495,3923,38.1
35,전라북도,090003, 87세,2017,5004,1255,3749,33.5,4997,1251,3746,33.4
35,전라북도,090004, 88세,2017,4088,1140,2948,38.7,4084,1140,2944,38.7
35,전라북도,090005, 89세,2017,3521,867,2654,32.7,3521,867,2654,32.7
35,전라북도,095,90~94세,2017,7685,1775,5910,30,7681,1772,5909,30
35,전라북도,095001, 90세,2017,2789,658,2131,30.9,2788,658,2130,30.9
35,전라북도,095002, 91세,2017,1713,416,1297,32.1,1712,415,1297,32
35,전라북도,095003, 92세,2017,1242,288,954,30.2,1240,286,954,30
35,전라북도,095004, 93세,2017,946,226,720,31.4,946,226,720,31.4
35,전라북도,095005, 94세,2017,995,187,808,23.1,995,187,808,23.1
35,전라북도,100,95~99세,2017,1828,325,1503,21.6,1828,325,1503,21.6
35,전라북도,100001, 95세,2017,729,148,581,25.5,729,148,581,25.5
35,전라북도,100002, 96세,2017,413,75,338,22.2,413,75,338,22.2
35,전라북도,100003, 97세,2017,345,53,292,18.2,345,53,292,18.2
35,전라북도,100004, 98세,2017,206,27,179,15.1,206,27,179,15.1
35,전라북도,100005, 99세,2017,135,22,113,19.5,135,22,113,19.5
35,전라북도,101,100세이상,2017,211,27,184,14.7,210,27,183,14.8
35,전라북도,102,15세미만,2017,231365,119363,112002,106.6,230831,119082,111749,106.6
35,전라북도,103,15~64세,2017,1252888,651238,601650,108.2,1220532,633694,586838,108
35,전라북도,104,65세이상,2017,341921,140991,200930,70.2,341047,140570,200477,70.1
35,전라북도,086,85세이상,2017,34656,8921,25735,34.7,34630,8908,25722,34.6
35,전라북도,126,평균연령,2017,43.3,41.6,45,,43.5,41.8,45.2,
35,전라북도,127,중위연령,2017,44.7,43.1,46.4,,45,43.4,46.7,
35004, 읍부,000,합계,2017,159280,79965,79315,100.8,155241,77819,77422,100.5
35004, 읍부,005,0~4세,2017,6593,3410,3183,107.1,6578,3400,3178,107
35004, 읍부,005001, 0세,2017,1136,579,557,103.9,1131,576,555,103.8
35004, 읍부,005002, 1세,2017,1262,651,611,106.5,1258,648,610,106.2
35004, 읍부,005003, 2세,2017,1357,700,657,106.5,1355,699,656,106.6
35004, 읍부,005004, 3세,2017,1326,693,633,109.5,1322,690,632,109.2
35004, 읍부,005005, 4세,2017,1512,787,725,108.6,1512,787,725,108.6
35004, 읍부,010,5~9세,2017,7855,4101,3754,109.2,7846,4096,3750,109.2
35004, 읍부,010001, 5세,2017,1608,843,765,110.2,1606,841,765,109.9
35004, 읍부,010002, 6세,2017,1665,868,797,108.9,1664,868,796,109
35004, 읍부,010003, 7세,2017,1512,828,684,121.1,1510,827,683,121.1
35004, 읍부,010004, 8세,2017,1475,730,745,98,1472,729,743,98.1
35004, 읍부,010005, 9세,2017,1595,832,763,109,1594,831,763,108.9
35004, 읍부,015,10~14세,2017,7323,3784,3539,106.9,7316,3779,3537,106.8
35004, 읍부,015001, 10세,2017,1572,796,776,102.6,1571,796,775,102.7
35004, 읍부,015002, 11세,2017,1435,748,687,108.9,1433,746,687,108.6
35004, 읍부,015003, 12세,2017,1410,700,710,98.6,1409,699,710,98.5
35004, 읍부,015004, 13세,2017,1439,773,666,116.1,1437,771,666,115.8
35004, 읍부,015005, 14세,2017,1467,767,700,109.6,1466,767,699,109.7
35004, 읍부,020,15~19세,2017,10222,5504,4718,116.7,10116,5437,4679,116.2
35004, 읍부,020001, 15세,2017,1585,837,748,111.9,1581,837,744,112.5
35004, 읍부,020002, 16세,2017,2044,1088,956,113.8,2042,1088,954,114
35004, 읍부,020003, 17세,2017,2223,1188,1035,114.8,2219,1187,1032,115
35004, 읍부,020004, 18세,2017,2006,1092,914,119.5,1987,1079,908,118.8
35004, 읍부,020005, 19세,2017,2364,1299,1065,122,2287,1246,1041,119.7
35004, 읍부,025,20~24세,2017,10387,5943,4444,133.7,9599,5553,4046,137.2
35004, 읍부,025001, 20세,2017,2455,1383,1072,129,2335,1314,1021,128.7
35004, 읍부,025002, 21세,2017,2230,1253,977,128.2,2063,1178,885,133.1
35004, 읍부,025003, 22세,2017,2012,1190,822,144.8,1855,1121,734,152.7
35004, 읍부,025004, 23세,2017,1926,1089,837,130.1,1762,1001,761,131.5
35004, 읍부,025005, 24세,2017,1764,1028,736,139.7,1584,939,645,145.6
35004, 읍부,030,25~29세,2017,7594,4092,3502,116.8,6789,3628,3161,114.8
35004, 읍부,030001, 25세,2017,1683,905,778,116.3,1508,810,698,116
35004, 읍부,030002, 26세,2017,1516,840,676,124.3,1366,752,614,122.5
35004, 읍부,030003, 27세,2017,1469,783,686,114.1,1309,696,613,113.5
35004, 읍부,030004, 28세,2017,1456,790,666,118.6,1306,697,609,114.4
35004, 읍부,030005, 29세,2017,1470,774,696,111.2,1300,673,627,107.3
35004, 읍부,035,30~34세,2017,8142,4132,4010,103,7518,3797,3721,102
35004, 읍부,035001, 30세,2017,1498,767,731,104.9,1336,686,650,105.5
35004, 읍부,035002, 31세,2017,1542,792,750,105.6,1444,737,707,104.2
35004, 읍부,035003, 32세,2017,1545,776,769,100.9,1415,707,708,99.9
35004, 읍부,035004, 33세,2017,1718,861,857,100.5,1590,794,796,99.7
35004, 읍부,035005, 34세,2017,1839,936,903,103.7,1733,873,860,101.5
35004, 읍부,040,35~39세,2017,10774,5529,5245,105.4,10363,5280,5083,103.9
35004, 읍부,040001, 35세,2017,2117,1071,1046,102.4,2020,1017,1003,101.4
35004, 읍부,040002, 36세,2017,2135,1086,1049,103.5,2047,1027,1020,100.7
35004, 읍부,040003, 37세,2017,2305,1196,1109,107.8,2220,1147,1073,106.9
35004, 읍부,040004, 38세,2017,2201,1145,1056,108.4,2123,1099,1024,107.3
35004, 읍부,040005, 39세,2017,2016,1031,985,104.7,1953,990,963,102.8
35004, 읍부,045,40~44세,2017,11116,5988,5128,116.8,10858,5844,5014,116.6
35004, 읍부,045001, 40세,2017,2079,1099,980,112.1,2031,1075,956,112.4
35004, 읍부,045002, 41세,2017,2073,1130,943,119.8,2020,1101,919,119.8
35004, 읍부,045003, 42세,2017,2078,1133,945,119.9,2023,1101,922,119.4
35004, 읍부,045004, 43세,2017,2527,1368,1159,118,2467,1338,1129,118.5
35004, 읍부,045005, 44세,2017,2359,1258,1101,114.3,2317,1229,1088,113
35004, 읍부,050,45~49세,2017,12025,6547,5478,119.5,11739,6415,5324,120.5
35004, 읍부,050001, 45세,2017,2304,1256,1048,119.8,2230,1226,1004,122.1
35004, 읍부,050002, 46세,2017,2563,1405,1158,121.3,2508,1379,1129,122.1
35004, 읍부,050003, 47세,2017,2299,1236,1063,116.3,2243,1204,1039,115.9
35004, 읍부,050004, 48세,2017,2327,1274,1053,121,2282,1254,1028,122
35004, 읍부,050005, 49세,2017,2532,1376,1156,119,2476,1352,1124,120.3
35004, 읍부,055,50~54세,2017,11166,6011,5155,116.6,10879,5876,5003,117.4
35004, 읍부,055001, 50세,2017,2254,1200,1054,113.9,2200,1174,1026,114.4
35004, 읍부,055002, 51세,2017,2246,1224,1022,119.8,2187,1198,989,121.1
35004, 읍부,055003, 52세,2017,2289,1272,1017,125.1,2239,1250,989,126.4
35004, 읍부,055004, 53세,2017,2218,1196,1022,117,2153,1161,992,117
35004, 읍부,055005, 54세,2017,2159,1119,1040,107.6,2100,1093,1007,108.5
35004, 읍부,060,55~59세,2017,12561,6415,6146,104.4,12356,6319,6037,104.7
35004, 읍부,060001, 55세,2017,2461,1296,1165,111.2,2414,1275,1139,111.9
35004, 읍부,060002, 56세,2017,2639,1318,1321,99.8,2601,1300,1301,99.9
35004, 읍부,060003, 57세,2017,2801,1412,1389,101.7,2755,1388,1367,101.5
35004, 읍부,060004, 58세,2017,2407,1229,1178,104.3,2370,1213,1157,104.8
35004, 읍부,060005, 59세,2017,2253,1160,1093,106.1,2216,1143,1073,106.5
35004, 읍부,065,60~64세,2017,10586,5310,5276,100.6,10462,5250,5212,100.7
35004, 읍부,065001, 60세,2017,2326,1182,1144,103.3,2288,1163,1125,103.4
35004, 읍부,065002, 61세,2017,2257,1137,1120,101.5,2233,1127,1106,101.9
35004, 읍부,065003, 62세,2017,2313,1137,1176,96.7,2288,1123,1165,96.4
35004, 읍부,065004, 63세,2017,2051,1008,1043,96.6,2035,1000,1035,96.6
35004, 읍부,065005, 64세,2017,1639,846,793,106.7,1618,837,781,107.2
35004, 읍부,070,65~69세,2017,8782,4165,4617,90.2,8725,4134,4591,90
35004, 읍부,070001, 65세,2017,1845,907,938,96.7,1829,898,931,96.5
35004, 읍부,070002, 66세,2017,1627,756,871,86.8,1617,750,867,86.5
35004, 읍부,070003, 67세,2017,1864,894,970,92.2,1854,892,962,92.7
35004, 읍부,070004, 68세,2017,1731,807,924,87.3,1717,799,918,87
35004, 읍부,070005, 69세,2017,1715,801,914,87.6,1708,795,913,87.1
35004, 읍부,075,70~74세,2017,7260,3253,4007,81.2,7226,3237,3989,81.1
35004, 읍부,075001, 70세,2017,1850,871,979,89,1841,868,973,89.2
35004, 읍부,075002, 71세,2017,1428,676,752,89.9,1421,674,747,90.2
35004, 읍부,075003, 72세,2017,1304,563,741,76,1295,555,740,75
35004, 읍부,075004, 73세,2017,1311,584,727,80.3,1307,582,725,80.3
35004, 읍부,075005, 74세,2017,1367,559,808,69.2,1362,558,804,69.4
35004, 읍부,080,75~79세,2017,7748,3025,4723,64,7733,3021,4712,64.1
35004, 읍부,080001, 75세,2017,2007,798,1209,66,2002,797,1205,66.1
35004, 읍부,080002, 76세,2017,1458,587,871,67.4,1453,586,867,67.6
35004, 읍부,080003, 77세,2017,1409,536,873,61.4,1407,535,872,61.4
35004, 읍부,080004, 78세,2017,1478,554,924,60,1476,554,922,60.1
35004, 읍부,080005, 79세,2017,1396,550,846,65,1395,549,846,64.9
35004, 읍부,085,80~84세,2017,5430,1837,3593,51.1,5425,1835,3590,51.1
35004, 읍부,085001, 80세,2017,1200,423,777,54.4,1199,422,777,54.3
35004, 읍부,085002, 81세,2017,1203,430,773,55.6,1203,430,773,55.6
35004, 읍부,085003, 82세,2017,1198,410,788,52,1197,409,788,51.9
35004, 읍부,085004, 83세,2017,994,305,689,44.3,992,305,687,44.4
35004, 읍부,085005, 84세,2017,835,269,566,47.5,834,269,565,47.6
35004, 읍부,090,85~89세,2017,2631,699,1932,36.2,2628,698,1930,36.2
35004, 읍부,090001, 85세,2017,728,210,518,40.5,728,210,518,40.5
35004, 읍부,090002, 86세,2017,530,141,389,36.2,530,141,389,36.2
35004, 읍부,090003, 87세,2017,544,133,411,32.4,542,132,410,32.2
35004, 읍부,090004, 88세,2017,453,119,334,35.6,452,119,333,35.7
35004, 읍부,090005, 89세,2017,376,96,280,34.3,376,96,280,34.3
35004, 읍부,095,90~94세,2017,862,180,682,26.4,862,180,682,26.4
35004, 읍부,095001, 90세,2017,311,68,243,28,311,68,243,28
35004, 읍부,095002, 91세,2017,197,37,160,23.1,197,37,160,23.1
35004, 읍부,095003, 92세,2017,141,33,108,30.6,141,33,108,30.6
35004, 읍부,095004, 93세,2017,91,18,73,24.7,91,18,73,24.7
35004, 읍부,095005, 94세,2017,122,24,98,24.5,122,24,98,24.5
35004, 읍부,100,95~99세,2017,193,38,155,24.5,193,38,155,24.5
35004, 읍부,100001, 95세,2017,86,15,71,21.1,86,15,71,21.1
35004, 읍부,100002, 96세,2017,33,10,23,43.5,33,10,23,43.5
35004, 읍부,100003, 97세,2017,41,9,32,28.1,41,9,32,28.1
35004, 읍부,100004, 98세,2017,21,X,18,16.7,21,X,18,16.7
35004, 읍부,100005, 99세,2017,12,X,11,9.1,12,X,11,9.1
35004, 읍부,101,100세이상,2017,30,X,28,7.1,30,X,28,7.1
35004, 읍부,102,15세미만,2017,21771,11295,10476,107.8,21740,11275,10465,107.7
35004, 읍부,103,15~64세,2017,104573,55471,49102,113,100679,53399,47280,112.9
35004, 읍부,104,65세이상,2017,32936,13199,19737,66.9,32822,13145,19677,66.8
35004, 읍부,086,85세이상,2017,3716,919,2797,32.9,3713,918,2795,32.8
35004, 읍부,126,평균연령,2017,43.7,41.7,45.8,,43.9,41.9,46,
35004, 읍부,127,중위연령,2017,44.8,43.1,46.9,,45.3,43.5,47.4,
35005, 면부,000,합계,2017,371933,185442,186491,99.4,362647,180080,182567,98.6
35005, 면부,005,0~4세,2017,8357,4271,4086,104.5,8337,4260,4077,104.5
35005, 면부,005001, 0세,2017,1537,801,736,108.8,1536,800,736,108.7
35005, 면부,005002, 1세,2017,1603,808,795,101.6,1595,804,791,101.6
35005, 면부,005003, 2세,2017,1696,869,827,105.1,1693,868,825,105.2
35005, 면부,005004, 3세,2017,1771,896,875,102.4,1767,894,873,102.4
35005, 면부,005005, 4세,2017,1750,897,853,105.2,1746,894,852,104.9
35005, 면부,010,5~9세,2017,9156,4802,4354,110.3,9141,4795,4346,110.3
35005, 면부,010001, 5세,2017,1940,1013,927,109.3,1931,1008,923,109.2
35005, 면부,010002, 6세,2017,1901,1029,872,118,1900,1029,871,118.1
35005, 면부,010003, 7세,2017,1759,915,844,108.4,1755,914,841,108.7
35005, 면부,010004, 8세,2017,1759,921,838,109.9,1759,921,838,109.9
35005, 면부,010005, 9세,2017,1797,924,873,105.8,1796,923,873,105.7
35005, 면부,015,10~14세,2017,9650,5177,4473,115.7,9631,5167,4464,115.7
35005, 면부,015001, 10세,2017,1887,996,891,111.8,1883,993,890,111.6
35005, 면부,015002, 11세,2017,1763,948,815,116.3,1759,947,812,116.6
35005, 면부,015003, 12세,2017,1743,906,837,108.2,1742,905,837,108.1
35005, 면부,015004, 13세,2017,2074,1148,926,124,2071,1147,924,124.1
35005, 면부,015005, 14세,2017,2183,1179,1004,117.4,2176,1175,1001,117.4
35005, 면부,020,15~19세,2017,14104,7920,6184,128.1,13986,7867,6119,128.6
35005, 면부,020001, 15세,2017,2375,1281,1094,117.1,2370,1280,1090,117.4
35005, 면부,020002, 16세,2017,2931,1624,1307,124.3,2924,1619,1305,124.1
35005, 면부,020003, 17세,2017,3214,1863,1351,137.9,3204,1855,1349,137.5
35005, 면부,020004, 18세,2017,2955,1618,1337,121,2936,1612,1324,121.8
35005, 면부,020005, 19세,2017,2629,1534,1095,140.1,2552,1501,1051,142.8
35005, 면부,025,20~24세,2017,16924,10102,6822,148.1,15530,9325,6205,150.3
35005, 면부,025001, 20세,2017,3197,1937,1260,153.7,3055,1856,1199,154.8
35005, 면부,025002, 21세,2017,3473,2028,1445,140.3,3249,1909,1340,142.5
35005, 면부,025003, 22세,2017,3506,2113,1393,151.7,3211,1953,1258,155.2
35005, 면부,025004, 23세,2017,3429,2076,1353,153.4,3088,1885,1203,156.7
35005, 면부,025005, 24세,2017,3319,1948,1371,142.1,2927,1722,1205,142.9
35005, 면부,030,25~29세,2017,15280,8847,6433,137.5,13110,7453,5657,131.7
35005, 면부,030001, 25세,2017,3150,1818,1332,136.5,2752,1572,1180,133.2
35005, 면부,030002, 26세,2017,3166,1794,1372,130.8,2725,1515,1210,125.2
35005, 면부,030003, 27세,2017,3100,1804,1296,139.2,2658,1515,1143,132.5
35005, 면부,030004, 28세,2017,2912,1696,1216,139.5,2489,1413,1076,131.3
35005, 면부,030005, 29세,2017,2952,1735,1217,142.6,2486,1438,1048,137.2
35005, 면부,035,30~34세,2017,14230,8182,6048,135.3,12432,7008,5424,129.2
35005, 면부,035001, 30세,2017,2812,1646,1166,141.2,2396,1345,1051,128
35005, 면부,035002, 31세,2017,2911,1692,1219,138.8,2486,1421,1065,133.4
35005, 면부,035003, 32세,2017,2667,1506,1161,129.7,2319,1289,1030,125.1
35005, 면부,035004, 33세,2017,2904,1674,1230,136.1,2589,1472,1117,131.8
35005, 면부,035005, 34세,2017,2936,1664,1272,130.8,2642,1481,1161,127.6
35005, 면부,040,35~39세,2017,15485,9147,6338,144.3,14409,8497,5912,143.7
35005, 면부,040001, 35세,2017,3139,1803,1336,135,2874,1644,1230,133.7
35005, 면부,040002, 36세,2017,3146,1854,1292,143.5,2920,1720,1200,143.3
35005, 면부,040003, 37세,2017,3166,1812,1354,133.8,2955,1685,1270,132.7
35005, 면부,040004, 38세,2017,3039,1846,1193,154.7,2839,1725,1114,154.8
35005, 면부,040005, 39세,2017,2995,1832,1163,157.5,2821,1723,1098,156.9
35005, 면부,045,40~44세,2017,17754,10653,7101,150,17103,10297,6806,151.3
35005, 면부,045001, 40세,2017,3091,1842,1249,147.5,2937,1739,1198,145.2
35005, 면부,045002, 41세,2017,3273,1967,1306,150.6,3125,1884,1241,151.8
35005, 면부,045003, 42세,2017,3334,2016,1318,153,3225,1966,1259,156.2
35005, 면부,045004, 43세,2017,3986,2397,1589,150.8,3876,2350,1526,154
35005, 면부,045005, 44세,2017,4070,2431,1639,148.3,3940,2358,1582,149.1
35005, 면부,050,45~49세,2017,23224,13470,9754,138.1,22626,13181,9445,139.6
35005, 면부,050001, 45세,2017,4086,2389,1697,140.8,3950,2325,1625,143.1
35005, 면부,050002, 46세,2017,4543,2743,1800,152.4,4424,2678,1746,153.4
35005, 면부,050003, 47세,2017,4394,2567,1827,140.5,4274,2508,1766,142
35005, 면부,050004, 48세,2017,4892,2776,2116,131.2,4784,2726,2058,132.5
35005, 면부,050005, 49세,2017,5309,2995,2314,129.4,5194,2944,2250,130.8
35005, 면부,055,50~54세,2017,27511,14984,12527,119.6,26915,14715,12200,120.6
35005, 면부,055001, 50세,2017,5051,2781,2270,122.5,4936,2735,2201,124.3
35005, 면부,055002, 51세,2017,5392,3005,2387,125.9,5288,2958,2330,127
35005, 면부,055003, 52세,2017,5663,3043,2620,116.1,5530,2989,2541,117.6
35005, 면부,055004, 53세,2017,5543,3018,2525,119.5,5418,2955,2463,120
35005, 면부,055005, 54세,2017,5862,3137,2725,115.1,5743,3078,2665,115.5
35005, 면부,060,55~59세,2017,36472,18655,17817,104.7,36123,18504,17619,105
35005, 면부,060001, 55세,2017,6813,3619,3194,113.3,6718,3582,3136,114.2
35005, 면부,060002, 56세,2017,7529,3893,3636,107.1,7464,3866,3598,107.4
35005, 면부,060003, 57세,2017,8157,4075,4082,99.8,8084,4040,4044,99.9
35005, 면부,060004, 58세,2017,7130,3618,3512,103,7071,3594,3477,103.4
35005, 면부,060005, 59세,2017,6843,3450,3393,101.7,6786,3422,3364,101.7
35005, 면부,065,60~64세,2017,33938,17125,16813,101.9,33668,17008,16660,102.1
35005, 면부,065001, 60세,2017,7286,3766,3520,107,7220,3744,3476,107.7
35005, 면부,065002, 61세,2017,6963,3556,3407,104.4,6902,3527,3375,104.5
35005, 면부,065003, 62세,2017,7447,3754,3693,101.7,7390,3725,3665,101.6
35005, 면부,065004, 63세,2017,6787,3346,3441,97.2,6741,3329,3412,97.6
35005, 면부,065005, 64세,2017,5455,2703,2752,98.2,5415,2683,2732,98.2
35005, 면부,070,65~69세,2017,31081,14986,16095,93.1,30959,14922,16037,93
35005, 면부,070001, 65세,2017,6324,3044,3280,92.8,6291,3024,3267,92.6
35005, 면부,070002, 66세,2017,5827,2816,3011,93.5,5801,2805,2996,93.6
35005, 면부,070003, 67세,2017,6588,3211,3377,95.1,6561,3197,3364,95
35005, 면부,070004, 68세,2017,6101,2871,3230,88.9,6087,2866,3221,89
35005, 면부,070005, 69세,2017,6241,3044,3197,95.2,6219,3030,3189,95
35005, 면부,075,70~74세,2017,28071,12515,15556,80.5,28016,12491,15525,80.5
35005, 면부,075001, 70세,2017,6782,3247,3535,91.9,6764,3238,3526,91.8
35005, 면부,075002, 71세,2017,5257,2479,2778,89.2,5242,2473,2769,89.3
35005, 면부,075003, 72세,2017,4961,2187,2774,78.8,4951,2181,2770,78.7
35005, 면부,075004, 73세,2017,5159,2158,3001,71.9,5155,2158,2997,72
35005, 면부,075005, 74세,2017,5912,2444,3468,70.5,5904,2441,3463,70.5
35005, 면부,080,75~79세,2017,32765,12598,20167,62.5,32744,12590,20154,62.5
35005, 면부,080001, 75세,2017,8770,3489,5281,66.1,8766,3487,5279,66.1
35005, 면부,080002, 76세,2017,6198,2435,3763,64.7,6193,2434,3759,64.8
35005, 면부,080003, 77세,2017,5718,2190,3528,62.1,5711,2187,3524,62.1
35005, 면부,080004, 78세,2017,6308,2390,3918,61,6306,2388,3918,60.9
35005, 면부,080005, 79세,2017,5771,2094,3677,56.9,5768,2094,3674,57
35005, 면부,085,80~84세,2017,23109,7989,15120,52.8,23099,7984,15115,52.8
35005, 면부,085001, 80세,2017,5437,1987,3450,57.6,5434,1986,3448,57.6
35005, 면부,085002, 81세,2017,4892,1747,3145,55.5,4890,1747,3143,55.6
35005, 면부,085003, 82세,2017,4885,1618,3267,49.5,4883,1617,3266,49.5
35005, 면부,085004, 83세,2017,4291,1476,2815,52.4,4289,1474,2815,52.4
35005, 면부,085005, 84세,2017,3604,1161,2443,47.5,3603,1160,2443,47.5
35005, 면부,090,85~89세,2017,10732,3023,7709,39.2,10728,3020,7708,39.2
35005, 면부,090001, 85세,2017,3004,901,2103,42.8,3004,901,2103,42.8
35005, 면부,090002, 86세,2017,2399,690,1709,40.4,2399,690,1709,40.4
35005, 면부,090003, 87세,2017,2119,549,1570,35,2116,546,1570,34.8
35005, 면부,090004, 88세,2017,1681,484,1197,40.4,1680,484,1196,40.5
35005, 면부,090005, 89세,2017,1529,399,1130,35.3,1529,399,1130,35.3
35005, 면부,095,90~94세,2017,3262,846,2416,35,3262,846,2416,35
35005, 면부,095001, 90세,2017,1194,314,880,35.7,1194,314,880,35.7
35005, 면부,095002, 91세,2017,740,209,531,39.4,740,209,531,39.4
35005, 면부,095003, 92세,2017,538,142,396,35.9,538,142,396,35.9
35005, 면부,095004, 93세,2017,388,101,287,35.2,388,101,287,35.2
35005, 면부,095005, 94세,2017,402,80,322,24.8,402,80,322,24.8
35005, 면부,100,95~99세,2017,756,139,617,22.5,756,139,617,22.5
35005, 면부,100001, 95세,2017,298,65,233,27.9,298,65,233,27.9
35005, 면부,100002, 96세,2017,167,29,138,21,167,29,138,21
35005, 면부,100003, 97세,2017,151,22,129,17.1,151,22,129,17.1
35005, 면부,100004, 98세,2017,80,15,65,23.1,80,15,65,23.1
35005, 면부,100005, 99세,2017,60,8,52,15.4,60,8,52,15.4
35005, 면부,101,100세이상,2017,72,11,61,18,72,11,61,18
35005, 면부,102,15세미만,2017,27163,14250,12913,110.4,27109,14222,12887,110.4
35005, 면부,103,15~64세,2017,214922,119085,95837,124.3,205902,113855,92047,123.7
35005, 면부,104,65세이상,2017,129848,52107,77741,67,129636,52003,77633,67
35005, 면부,086,85세이상,2017,14822,4019,10803,37.2,14818,4016,10802,37.2
35005, 면부,126,평균연령,2017,53,49.9,56,,53.4,50.4,56.4,
35005, 면부,127,중위연령,2017,57,53.4,60.4,,57.5,54.2,60.9,
35003, 동부,000,합계,2017,1294961,646185,648776,99.6,1274522,635447,639075,99.4
35003, 동부,005,0~4세,2017,53340,27437,25903,105.9,53108,27307,25801,105.8
35003, 동부,005001, 0세,2017,8819,4467,4352,102.6,8766,4436,4330,102.4
35003, 동부,005002, 1세,2017,10242,5276,4966,106.2,10197,5253,4944,106.3
35003, 동부,005003, 2세,2017,11217,5732,5485,104.5,11163,5699,5464,104.3
35003, 동부,005004, 3세,2017,11286,5809,5477,106.1,11238,5786,5452,106.1
35003, 동부,005005, 4세,2017,11776,6153,5623,109.4,11744,6133,5611,109.3
35003, 동부,010,5~9세,2017,63199,32371,30828,105,63056,32301,30755,105
35003, 동부,010001, 5세,2017,12903,6570,6333,103.7,12864,6554,6310,103.9
35003, 동부,010002, 6세,2017,13070,6600,6470,102,13038,6583,6455,102
35003, 동부,010003, 7세,2017,12461,6399,6062,105.6,12434,6384,6050,105.5
35003, 동부,010004, 8세,2017,11989,6171,5818,106.1,11965,6159,5806,106.1
35003, 동부,010005, 9세,2017,12776,6631,6145,107.9,12755,6621,6134,107.9
35003, 동부,015,10~14세,2017,65892,34010,31882,106.7,65818,33977,31841,106.7
35003, 동부,015001, 10세,2017,13300,6839,6461,105.9,13285,6833,6452,105.9
35003, 동부,015002, 11세,2017,12294,6344,5950,106.6,12281,6338,5943,106.6
35003, 동부,015003, 12세,2017,12610,6666,5944,112.1,12598,6660,5938,112.2
35003, 동부,015004, 13세,2017,13558,6921,6637,104.3,13539,6912,6627,104.3
35003, 동부,015005, 14세,2017,14130,7240,6890,105.1,14115,7234,6881,105.1
35003, 동부,020,15~19세,2017,90503,47450,43053,110.2,89485,46940,42545,110.3
35003, 동부,020001, 15세,2017,14930,7816,7114,109.9,14913,7805,7108,109.8
35003, 동부,020002, 16세,2017,17371,8875,8496,104.5,17348,8867,8481,104.6
35003, 동부,020003, 17세,2017,19321,10021,9300,107.8,19252,9981,9271,107.7
35003, 동부,020004, 18세,2017,18681,9842,8839,111.3,18431,9712,8719,111.4
35003, 동부,020005, 19세,2017,20200,10896,9304,117.1,19541,10575,8966,117.9
35003, 동부,025,20~24세,2017,100756,54676,46080,118.7,96892,52768,44124,119.6
35003, 동부,025001, 20세,2017,20241,10691,9550,111.9,19551,10332,9219,112.1
35003, 동부,025002, 21세,2017,20874,11206,9668,115.9,20152,10839,9313,116.4
35003, 동부,025003, 22세,2017,20823,11256,9567,117.7,20026,10877,9149,118.9
35003, 동부,025004, 23세,2017,20077,11140,8937,124.7,19251,10730,8521,125.9
35003, 동부,025005, 24세,2017,18741,10383,8358,124.2,17912,9990,7922,126.1
35003, 동부,030,25~29세,2017,76141,40594,35547,114.2,72431,38593,33838,114.1
35003, 동부,030001, 25세,2017,17759,9668,8091,119.5,16972,9270,7702,120.4
35003, 동부,030002, 26세,2017,15941,8505,7436,114.4,15178,8091,7087,114.2
35003, 동부,030003, 27세,2017,14741,7916,6825,116,13987,7507,6480,115.8
35003, 동부,030004, 28세,2017,14022,7462,6560,113.8,13339,7081,6258,113.2
35003, 동부,030005, 29세,2017,13678,7043,6635,106.1,12955,6644,6311,105.3
35003, 동부,035,30~34세,2017,74662,38331,36331,105.5,71798,36677,35121,104.4
35003, 동부,035001, 30세,2017,13687,7066,6621,106.7,13029,6687,6342,105.4
35003, 동부,035002, 31세,2017,14275,7341,6934,105.9,13627,6968,6659,104.6
35003, 동부,035003, 32세,2017,14169,7247,6922,104.7,13629,6932,6697,103.5
35003, 동부,035004, 33세,2017,15576,8015,7561,106,15025,7688,7337,104.8
35003, 동부,035005, 34세,2017,16955,8662,8293,104.4,16488,8402,8086,103.9
35003, 동부,040,35~39세,2017,93849,47327,46522,101.7,91853,46166,45687,101
35003, 동부,040001, 35세,2017,18594,9473,9121,103.9,18147,9205,8942,102.9
35003, 동부,040002, 36세,2017,18601,9512,9089,104.7,18188,9275,8913,104.1
35003, 동부,040003, 37세,2017,19691,9885,9806,100.8,19261,9634,9627,100.1
35003, 동부,040004, 38세,2017,18883,9500,9383,101.2,18503,9269,9234,100.4
35003, 동부,040005, 39세,2017,18080,8957,9123,98.2,17754,8783,8971,97.9
35003, 동부,045,40~44세,2017,102841,50993,51848,98.4,101365,50167,51198,98
35003, 동부,045001, 40세,2017,18855,9381,9474,99,18541,9196,9345,98.4
35003, 동부,045002, 41세,2017,18927,9478,9449,100.3,18634,9297,9337,99.6
35003, 동부,045003, 42세,2017,19846,9776,10070,97.1,19560,9624,9936,96.9
35003, 동부,045004, 43세,2017,22719,11250,11469,98.1,22430,11101,11329,98
35003, 동부,045005, 44세,2017,22494,11108,11386,97.6,22200,10949,11251,97.3
35003, 동부,050,45~49세,2017,114943,57945,56998,101.7,113415,57158,56257,101.6
35003, 동부,050001, 45세,2017,22276,11332,10944,103.5,21958,11157,10801,103.3
35003, 동부,050002, 46세,2017,24213,12268,11945,102.7,23913,12122,11791,102.8
35003, 동부,050003, 47세,2017,22918,11603,11315,102.5,22579,11421,11158,102.4
35003, 동부,050004, 48세,2017,22821,11391,11430,99.7,22536,11245,11291,99.6
35003, 동부,050005, 49세,2017,22715,11351,11364,99.9,22429,11213,11216,100
35003, 동부,055,50~54세,2017,101501,51244,50257,102,100186,50630,49556,102.2
35003, 동부,055001, 50세,2017,20822,10367,10455,99.2,20565,10254,10311,99.4
35003, 동부,055002, 51세,2017,20884,10659,10225,104.2,20612,10532,10080,104.5
35003, 동부,055003, 52세,2017,20712,10340,10372,99.7,20427,10214,10213,100
35003, 동부,055004, 53세,2017,19008,9690,9318,104,18758,9568,9190,104.1
35003, 동부,055005, 54세,2017,20075,10188,9887,103,19824,10062,9762,103.1
35003, 동부,060,55~59세,2017,101738,50461,51277,98.4,100750,50024,50726,98.6
35003, 동부,060001, 55세,2017,20574,10477,10097,103.8,20318,10359,9959,104
35003, 동부,060002, 56세,2017,21814,10811,11003,98.3,21644,10747,10897,98.6
35003, 동부,060003, 57세,2017,22622,11127,11495,96.8,22421,11038,11383,97
35003, 동부,060004, 58세,2017,19254,9361,9893,94.6,19086,9289,9797,94.8
35003, 동부,060005, 59세,2017,17474,8685,8789,98.8,17281,8591,8690,98.9
35003, 동부,065,60~64세,2017,76459,37661,38798,97.1,75776,37317,38459,97
35003, 동부,065001, 60세,2017,17643,8832,8811,100.2,17449,8734,8715,100.2
35003, 동부,065002, 61세,2017,15962,7934,8028,98.8,15828,7862,7966,98.7
35003, 동부,065003, 62세,2017,16809,8228,8581,95.9,16665,8161,8504,96
35003, 동부,065004, 63세,2017,14375,7054,7321,96.4,14264,6995,7269,96.2
35003, 동부,065005, 64세,2017,11670,5613,6057,92.7,11570,5565,6005,92.7
35003, 동부,070,65~69세,2017,57923,27846,30077,92.6,57635,27701,29934,92.5
35003, 동부,070001, 65세,2017,12739,6314,6425,98.3,12671,6278,6393,98.2
35003, 동부,070002, 66세,2017,11037,5452,5585,97.6,10966,5415,5551,97.5
35003, 동부,070003, 67세,2017,12372,5898,6474,91.1,12307,5864,6443,91
35003, 동부,070004, 68세,2017,11100,5173,5927,87.3,11060,5158,5902,87.4
35003, 동부,070005, 69세,2017,10675,5009,5666,88.4,10631,4986,5645,88.3
35003, 동부,075,70~74세,2017,43387,19890,23497,84.6,43261,19826,23435,84.6
35003, 동부,075001, 70세,2017,11575,5525,6050,91.3,11537,5502,6035,91.2
35003, 동부,075002, 71세,2017,8700,4147,4553,91.1,8670,4133,4537,91.1
35003, 동부,075003, 72세,2017,7637,3423,4214,81.2,7614,3407,4207,81
35003, 동부,075004, 73세,2017,7577,3392,4185,81.1,7559,3387,4172,81.2
35003, 동부,075005, 74세,2017,7898,3403,4495,75.7,7881,3397,4484,75.8
35003, 동부,080,75~79세,2017,37691,15516,22175,70,37627,15494,22133,70
35003, 동부,080001, 75세,2017,10716,4564,6152,74.2,10702,4557,6145,74.2
35003, 동부,080002, 76세,2017,7282,3070,4212,72.9,7273,3066,4207,72.9
35003, 동부,080003, 77세,2017,6717,2747,3970,69.2,6698,2741,3957,69.3
35003, 동부,080004, 78세,2017,6766,2784,3982,69.9,6753,2782,3971,70.1
35003, 동부,080005, 79세,2017,6210,2351,3859,60.9,6201,2348,3853,60.9
35003, 동부,085,80~84세,2017,24018,8450,15568,54.3,23967,8427,15540,54.2
35003, 동부,085001, 80세,2017,5765,2190,3575,61.3,5750,2185,3565,61.3
35003, 동부,085002, 81세,2017,5103,1863,3240,57.5,5094,1860,3234,57.5
35003, 동부,085003, 82세,2017,5102,1784,3318,53.8,5091,1778,3313,53.7
35003, 동부,085004, 83세,2017,4328,1444,2884,50.1,4320,1442,2878,50.1
35003, 동부,085005, 84세,2017,3720,1169,2551,45.8,3712,1162,2550,45.6
35003, 동부,090,85~89세,2017,11569,3072,8497,36.2,11555,3066,8489,36.1
35003, 동부,090001, 85세,2017,3162,922,2240,41.2,3159,920,2239,41.1
35003, 동부,090002, 86세,2017,2496,668,1828,36.5,2489,664,1825,36.4
35003, 동부,090003, 87세,2017,2341,573,1768,32.4,2339,573,1766,32.4
35003, 동부,090004, 88세,2017,1954,537,1417,37.9,1952,537,1415,38
35003, 동부,090005, 89세,2017,1616,372,1244,29.9,1616,372,1244,29.9
35003, 동부,095,90~94세,2017,3561,749,2812,26.6,3557,746,2811,26.5
35003, 동부,095001, 90세,2017,1284,276,1008,27.4,1283,276,1007,27.4
35003, 동부,095002, 91세,2017,776,170,606,28.1,775,169,606,27.9
35003, 동부,095003, 92세,2017,563,113,450,25.1,561,111,450,24.7
35003, 동부,095004, 93세,2017,467,107,360,29.7,467,107,360,29.7
35003, 동부,095005, 94세,2017,471,83,388,21.4,471,83,388,21.4
35003, 동부,100,95~99세,2017,879,148,731,20.2,879,148,731,20.2
35003, 동부,100001, 95세,2017,345,68,277,24.5,345,68,277,24.5
35003, 동부,100002, 96세,2017,213,36,177,20.3,213,36,177,20.3
35003, 동부,100003, 97세,2017,153,22,131,16.8,153,22,131,16.8
35003, 동부,100004, 98세,2017,105,9,96,9.4,105,9,96,9.4
35003, 동부,100005, 99세,2017,63,13,50,26,63,13,50,26
35003, 동부,101,100세이상,2017,109,14,95,14.7,108,14,94,14.9
35003, 동부,102,15세미만,2017,182431,93818,88613,105.9,181982,93585,88397,105.9
35003, 동부,103,15~64세,2017,933393,476682,456711,104.4,913951,466440,447511,104.2
35003, 동부,104,65세이상,2017,179137,75685,103452,73.2,178589,75422,103167,73.1
35003, 동부,086,85세이상,2017,16118,3983,12135,32.8,16099,3974,12125,32.8
35003, 동부,126,평균연령,2017,40.5,39.2,41.8,,40.6,39.3,41.9,
35003, 동부,127,중위연령,2017,41.5,40.1,42.9,,41.8,40.3,43.1,
35010, 전주시,000,합계,2017,656956,324695,332261,97.7,648671,320780,327891,97.8
35010, 전주시,005,0~4세,2017,26613,13664,12949,105.5,26482,13597,12885,105.5
35010, 전주시,005001, 0세,2017,4404,2239,2165,103.4,4369,2218,2151,103.1
35010, 전주시,005002, 1세,2017,5126,2676,2450,109.2,5098,2662,2436,109.3
35010, 전주시,005003, 2세,2017,5596,2809,2787,100.8,5566,2793,2773,100.7
35010, 전주시,005004, 3세,2017,5668,2901,2767,104.8,5641,2892,2749,105.2
35010, 전주시,005005, 4세,2017,5819,3039,2780,109.3,5808,3032,2776,109.2
35010, 전주시,010,5~9세,2017,31816,16271,15545,104.7,31753,16241,15512,104.7
35010, 전주시,010001, 5세,2017,6428,3225,3203,100.7,6407,3216,3191,100.8
35010, 전주시,010002, 6세,2017,6492,3296,3196,103.1,6479,3288,3191,103
35010, 전주시,010003, 7세,2017,6362,3298,3064,107.6,6346,3289,3057,107.6
35010, 전주시,010004, 8세,2017,6054,3105,2949,105.3,6049,3104,2945,105.4
35010, 전주시,010005, 9세,2017,6480,3347,3133,106.8,6472,3344,3128,106.9
35010, 전주시,015,10~14세,2017,33611,17508,16103,108.7,33582,17493,16089,108.7
35010, 전주시,015001, 10세,2017,6725,3532,3193,110.6,6719,3528,3191,110.6
35010, 전주시,015002, 11세,2017,6217,3246,2971,109.3,6212,3243,2969,109.2
35010, 전주시,015003, 12세,2017,6463,3426,3037,112.8,6459,3423,3036,112.7
35010, 전주시,015004, 13세,2017,6964,3554,3410,104.2,6955,3550,3405,104.3
35010, 전주시,015005, 14세,2017,7242,3750,3492,107.4,7237,3749,3488,107.5
35010, 전주시,020,15~19세,2017,47188,24341,22847,106.5,46676,24099,22577,106.7
35010, 전주시,020001, 15세,2017,7693,3999,3694,108.3,7688,3996,3692,108.2
35010, 전주시,020002, 16세,2017,8796,4472,4324,103.4,8786,4467,4319,103.4
35010, 전주시,020003, 17세,2017,10245,5270,4975,105.9,10203,5247,4956,105.9
35010, 전주시,020004, 18세,2017,9788,5068,4720,107.4,9642,4994,4648,107.4
35010, 전주시,020005, 19세,2017,10666,5532,5134,107.8,10357,5395,4962,108.7
35010, 전주시,025,20~24세,2017,53464,28217,25247,111.8,51369,27259,24110,113.1
35010, 전주시,025001, 20세,2017,10760,5508,5252,104.9,10356,5320,5036,105.6
35010, 전주시,025002, 21세,2017,11155,5869,5286,111,10707,5651,5056,111.8
35010, 전주시,025003, 22세,2017,10940,5737,5203,110.3,10504,5547,4957,111.9
35010, 전주시,025004, 23세,2017,10636,5717,4919,116.2,10212,5522,4690,117.7
35010, 전주시,025005, 24세,2017,9973,5386,4587,117.4,9590,5219,4371,119.4
35010, 전주시,030,25~29세,2017,40867,21432,19435,110.3,39371,20718,18653,111.1
35010, 전주시,030001, 25세,2017,9612,5170,4442,116.4,9255,5012,4243,118.1
35010, 전주시,030002, 26세,2017,8632,4559,4073,111.9,8339,4415,3924,112.5
35010, 전주시,030003, 27세,2017,7911,4172,3739,111.6,7624,4033,3591,112.3
35010, 전주시,030004, 28세,2017,7508,3879,3629,106.9,7221,3739,3482,107.4
35010, 전주시,030005, 29세,2017,7204,3652,3552,102.8,6932,3519,3413,103.1
35010, 전주시,035,30~34세,2017,38973,19665,19308,101.8,37953,19182,18771,102.2
35010, 전주시,035001, 30세,2017,7318,3683,3635,101.3,7064,3555,3509,101.3
35010, 전주시,035002, 31세,2017,7521,3785,3736,101.3,7272,3670,3602,101.9
35010, 전주시,035003, 32세,2017,7403,3757,3646,103,7205,3670,3535,103.8
35010, 전주시,035004, 33세,2017,7992,3990,4002,99.7,7829,3907,3922,99.6
35010, 전주시,035005, 34세,2017,8739,4450,4289,103.8,8583,4380,4203,104.2
35010, 전주시,040,35~39세,2017,47398,23505,23893,98.4,46755,23174,23581,98.3
35010, 전주시,040001, 35세,2017,9442,4703,4739,99.2,9299,4628,4671,99.1
35010, 전주시,040002, 36세,2017,9277,4661,4616,101,9148,4604,4544,101.3
35010, 전주시,040003, 37세,2017,9939,4897,5042,97.1,9789,4816,4973,96.8
35010, 전주시,040004, 38세,2017,9583,4789,4794,99.9,9457,4715,4742,99.4
35010, 전주시,040005, 39세,2017,9157,4455,4702,94.7,9062,4411,4651,94.8
35010, 전주시,045,40~44세,2017,51860,25194,26666,94.5,51365,24952,26413,94.5
35010, 전주시,045001, 40세,2017,9525,4688,4837,96.9,9413,4636,4777,97
35010, 전주시,045002, 41세,2017,9504,4630,4874,95,9409,4575,4834,94.6
35010, 전주시,045003, 42세,2017,10059,4896,5163,94.8,9979,4861,5118,95
35010, 전주시,045004, 43세,2017,11333,5500,5833,94.3,11231,5452,5779,94.3
35010, 전주시,045005, 44세,2017,11439,5480,5959,92,11333,5428,5905,91.9
35010, 전주시,050,45~49세,2017,58510,29051,29459,98.6,57965,28782,29183,98.6
35010, 전주시,050001, 45세,2017,11305,5657,5648,100.2,11191,5596,5595,100
35010, 전주시,050002, 46세,2017,12358,6187,6171,100.3,12245,6135,6110,100.4
35010, 전주시,050003, 47세,2017,11661,5807,5854,99.2,11544,5752,5792,99.3
35010, 전주시,050004, 48세,2017,11610,5681,5929,95.8,11504,5631,5873,95.9
35010, 전주시,050005, 49세,2017,11576,5719,5857,97.6,11481,5668,5813,97.5
35010, 전주시,055,50~54세,2017,51889,25774,26115,98.7,51402,25561,25841,98.9
35010, 전주시,055001, 50세,2017,10625,5247,5378,97.6,10519,5204,5315,97.9
35010, 전주시,055002, 51세,2017,10731,5362,5369,99.9,10632,5316,5316,100
35010, 전주시,055003, 52세,2017,10678,5191,5487,94.6,10571,5146,5425,94.9
35010, 전주시,055004, 53세,2017,9684,4862,4822,100.8,9593,4825,4768,101.2
35010, 전주시,055005, 54세,2017,10171,5112,5059,101,10087,5070,5017,101.1
35010, 전주시,060,55~59세,2017,50843,24981,25862,96.6,50502,24830,25672,96.7
35010, 전주시,060001, 55세,2017,10368,5187,5181,100.1,10279,5144,5135,100.2
35010, 전주시,060002, 56세,2017,10911,5367,5544,96.8,10852,5344,5508,97
35010, 전주시,060003, 57세,2017,11467,5629,5838,96.4,11395,5598,5797,96.6
35010, 전주시,060004, 58세,2017,9676,4609,5067,91,9622,4587,5035,91.1
35010, 전주시,060005, 59세,2017,8421,4189,4232,99,8354,4157,4197,99
35010, 전주시,065,60~64세,2017,37729,18382,19347,95,37485,18267,19218,95.1
35010, 전주시,065001, 60세,2017,8622,4204,4418,95.2,8558,4177,4381,95.3
35010, 전주시,065002, 61세,2017,7835,3890,3945,98.6,7787,3868,3919,98.7
35010, 전주시,065003, 62세,2017,8299,4033,4266,94.5,8239,4004,4235,94.5
35010, 전주시,065004, 63세,2017,7063,3459,3604,96,7029,3444,3585,96.1
35010, 전주시,065005, 64세,2017,5910,2796,3114,89.8,5872,2774,3098,89.5
35010, 전주시,070,65~69세,2017,28332,13501,14831,91,28246,13463,14783,91.1
35010, 전주시,070001, 65세,2017,6238,3039,3199,95,6218,3028,3190,94.9
35010, 전주시,070002, 66세,2017,5270,2599,2671,97.3,5248,2590,2658,97.4
35010, 전주시,070003, 67세,2017,6121,2893,3228,89.6,6103,2884,3219,89.6
35010, 전주시,070004, 68세,2017,5461,2505,2956,84.7,5448,2503,2945,85
35010, 전주시,070005, 69세,2017,5242,2465,2777,88.8,5229,2458,2771,88.7
35010, 전주시,075,70~74세,2017,20802,9627,11175,86.1,20751,9601,11150,86.1
35010, 전주시,075001, 70세,2017,5562,2660,2902,91.7,5544,2649,2895,91.5
35010, 전주시,075002, 71세,2017,4220,2000,2220,90.1,4206,1993,2213,90.1
35010, 전주시,075003, 72세,2017,3637,1661,1976,84.1,3630,1656,1974,83.9
35010, 전주시,075004, 73세,2017,3624,1653,1971,83.9,3616,1651,1965,84
35010, 전주시,075005, 74세,2017,3759,1653,2106,78.5,3755,1652,2103,78.6
35010, 전주시,080,75~79세,2017,18010,7548,10462,72.1,17986,7538,10448,72.1
35010, 전주시,080001, 75세,2017,5150,2221,2929,75.8,5144,2217,2927,75.7
35010, 전주시,080002, 76세,2017,3479,1499,1980,75.7,3473,1496,1977,75.7
35010, 전주시,080003, 77세,2017,3159,1319,1840,71.7,3154,1317,1837,71.7
35010, 전주시,080004, 78세,2017,3296,1385,1911,72.5,3293,1385,1908,72.6
35010, 전주시,080005, 79세,2017,2926,1124,1802,62.4,2922,1123,1799,62.4
35010, 전주시,085,80~84세,2017,11403,4068,7335,55.5,11387,4060,7327,55.4
35010, 전주시,085001, 80세,2017,2792,1089,1703,63.9,2787,1088,1699,64
35010, 전주시,085002, 81세,2017,2469,898,1571,57.2,2469,898,1571,57.2
35010, 전주시,085003, 82세,2017,2378,822,1556,52.8,2376,822,1554,52.9
35010, 전주시,085004, 83세,2017,2061,704,1357,51.9,2058,702,1356,51.8
35010, 전주시,085005, 84세,2017,1703,555,1148,48.3,1697,550,1147,48
35010, 전주시,090,85~89세,2017,5457,1526,3931,38.8,5451,1523,3928,38.8
35010, 전주시,090001, 85세,2017,1530,459,1071,42.9,1528,458,1070,42.8
35010, 전주시,090002, 86세,2017,1168,333,835,39.9,1165,331,834,39.7
35010, 전주시,090003, 87세,2017,1091,277,814,34,1090,277,813,34.1
35010, 전주시,090004, 88세,2017,904,263,641,41,904,263,641,41
35010, 전주시,090005, 89세,2017,764,194,570,34,764,194,570,34
35010, 전주시,095,90~94세,2017,1688,372,1316,28.3,1688,372,1316,28.3
35010, 전주시,095001, 90세,2017,616,158,458,34.5,616,158,458,34.5
35010, 전주시,095002, 91세,2017,371,80,291,27.5,371,80,291,27.5
35010, 전주시,095003, 92세,2017,273,56,217,25.8,273,56,217,25.8
35010, 전주시,095004, 93세,2017,208,38,170,22.4,208,38,170,22.4
35010, 전주시,095005, 94세,2017,220,40,180,22.2,220,40,180,22.2
35010, 전주시,100,95~99세,2017,455,63,392,16.1,455,63,392,16.1
35010, 전주시,100001, 95세,2017,174,31,143,21.7,174,31,143,21.7
35010, 전주시,100002, 96세,2017,115,14,101,13.9,115,14,101,13.9
35010, 전주시,100003, 97세,2017,68,7,61,11.5,68,7,61,11.5
35010, 전주시,100004, 98세,2017,63,5,58,8.6,63,5,58,8.6
35010, 전주시,100005, 99세,2017,35,6,29,20.7,35,6,29,20.7
35010, 전주시,101,100세이상,2017,48,5,43,11.6,47,5,42,11.9
35010, 전주시,102,15세미만,2017,92040,47443,44597,106.4,91817,47331,44486,106.4
35010, 전주시,103,15~64세,2017,478721,240542,238179,101,470843,236824,234019,101.2
35010, 전주시,104,65세이상,2017,86195,36710,49485,74.2,86011,36625,49386,74.2
35010, 전주시,086,85세이상,2017,7648,1966,5682,34.6,7641,1963,5678,34.6
35010, 전주시,126,평균연령,2017,40.1,38.9,41.2,,40.2,39,41.3,
35010, 전주시,127,중위연령,2017,40.9,39.5,42.2,,41.1,39.7,42.4,
35011, 완산구,000,합계,2017,362132,177542,184590,96.2,358682,175910,182772,96.2
35011, 완산구,005,0~4세,2017,13993,7128,6865,103.8,13964,7113,6851,103.8
35011, 완산구,005001, 0세,2017,2301,1154,1147,100.6,2296,1151,1145,100.5
35011, 완산구,005002, 1세,2017,2712,1412,1300,108.6,2705,1409,1296,108.7
35011, 완산구,005003, 2세,2017,2895,1417,1478,95.9,2888,1414,1474,95.9
35011, 완산구,005004, 3세,2017,3055,1581,1474,107.3,3049,1577,1472,107.1
35011, 완산구,005005, 4세,2017,3030,1564,1466,106.7,3026,1562,1464,106.7
35011, 완산구,010,5~9세,2017,16589,8547,8042,106.3,16573,8539,8034,106.3
35011, 완산구,010001, 5세,2017,3335,1685,1650,102.1,3331,1683,1648,102.1
35011, 완산구,010002, 6세,2017,3370,1713,1657,103.4,3367,1712,1655,103.4
35011, 완산구,010003, 7세,2017,3321,1752,1569,111.7,3317,1749,1568,111.5
35011, 완산구,010004, 8세,2017,3169,1645,1524,107.9,3167,1644,1523,107.9
35011, 완산구,010005, 9세,2017,3394,1752,1642,106.7,3391,1751,1640,106.8
35011, 완산구,015,10~14세,2017,18199,9511,8688,109.5,18187,9503,8684,109.4
35011, 완산구,015001, 10세,2017,3534,1824,1710,106.7,3532,1822,1710,106.5
35011, 완산구,015002, 11세,2017,3306,1710,1596,107.1,3302,1707,1595,107
35011, 완산구,015003, 12세,2017,3512,1860,1652,112.6,3511,1860,1651,112.7
35011, 완산구,015004, 13세,2017,3788,1972,1816,108.6,3785,1970,1815,108.5
35011, 완산구,015005, 14세,2017,4059,2145,1914,112.1,4057,2144,1913,112.1
35011, 완산구,020,15~19세,2017,27296,14196,13100,108.4,27038,14078,12960,108.6
35011, 완산구,020001, 15세,2017,4377,2291,2086,109.8,4375,2290,2085,109.8
35011, 완산구,020002, 16세,2017,5168,2695,2473,109,5164,2691,2473,108.8
35011, 완산구,020003, 17세,2017,6061,3161,2900,109,6036,3147,2889,108.9
35011, 완산구,020004, 18세,2017,5707,2964,2743,108.1,5617,2922,2695,108.4
35011, 완산구,020005, 19세,2017,5983,3085,2898,106.5,5846,3028,2818,107.5
35011, 완산구,025,20~24세,2017,28875,15117,13758,109.9,28019,14681,13338,110.1
35011, 완산구,025001, 20세,2017,5886,3036,2850,106.5,5733,2946,2787,105.7
35011, 완산구,025002, 21세,2017,6201,3290,2911,113,5994,3180,2814,113
35011, 완산구,025003, 22세,2017,5994,3140,2854,110,5795,3040,2755,110.3
35011, 완산구,025004, 23세,2017,5605,2943,2662,110.6,5437,2862,2575,111.1
35011, 완산구,025005, 24세,2017,5189,2708,2481,109.1,5060,2653,2407,110.2
35011, 완산구,030,25~29세,2017,21956,11333,10623,106.7,21425,11090,10335,107.3
35011, 완산구,030001, 25세,2017,5106,2699,2407,112.1,4981,2638,2343,112.6
35011, 완산구,030002, 26세,2017,4617,2399,2218,108.2,4502,2344,2158,108.6
35011, 완산구,030003, 27세,2017,4264,2225,2039,109.1,4167,2186,1981,110.3
35011, 완산구,030004, 28세,2017,4006,2051,1955,104.9,3916,2007,1909,105.1
35011, 완산구,030005, 29세,2017,3963,1959,2004,97.8,3859,1915,1944,98.5
35011, 완산구,035,30~34세,2017,21068,10668,10400,102.6,20700,10514,10186,103.2
35011, 완산구,035001, 30세,2017,4014,2013,2001,100.6,3910,1972,1938,101.8
35011, 완산구,035002, 31세,2017,4011,2025,1986,102,3925,1989,1936,102.7
35011, 완산구,035003, 32세,2017,3969,2051,1918,106.9,3895,2023,1872,108.1
35011, 완산구,035004, 33세,2017,4392,2225,2167,102.7,4336,2194,2142,102.4
35011, 완산구,035005, 34세,2017,4682,2354,2328,101.1,4634,2336,2298,101.7
35011, 완산구,040,35~39세,2017,25075,12376,12699,97.5,24810,12254,12556,97.6
35011, 완산구,040001, 35세,2017,4971,2461,2510,98,4920,2441,2479,98.5
35011, 완산구,040002, 36세,2017,4942,2516,2426,103.7,4873,2490,2383,104.5
35011, 완산구,040003, 37세,2017,5340,2583,2757,93.7,5282,2554,2728,93.6
35011, 완산구,040004, 38세,2017,5023,2474,2549,97.1,4968,2442,2526,96.7
35011, 완산구,040005, 39세,2017,4799,2342,2457,95.3,4767,2327,2440,95.4
35011, 완산구,045,40~44세,2017,28170,13349,14821,90.1,27936,13234,14702,90
35011, 완산구,045001, 40세,2017,5070,2423,2647,91.5,5022,2406,2616,92
35011, 완산구,045002, 41세,2017,5075,2447,2628,93.1,5027,2413,2614,92.3
35011, 완산구,045003, 42세,2017,5471,2588,2883,89.8,5430,2572,2858,90
35011, 완산구,045004, 43세,2017,6219,2934,3285,89.3,6169,2910,3259,89.3
35011, 완산구,045005, 44세,2017,6335,2957,3378,87.5,6288,2933,3355,87.4
35011, 완산구,050,45~49세,2017,32877,16102,16775,96,32624,15974,16650,95.9
35011, 완산구,050001, 45세,2017,6242,3050,3192,95.6,6194,3023,3171,95.3
35011, 완산구,050002, 46세,2017,6968,3383,3585,94.4,6913,3355,3558,94.3
35011, 완산구,050003, 47세,2017,6547,3269,3278,99.7,6498,3246,3252,99.8
35011, 완산구,050004, 48세,2017,6518,3137,3381,92.8,6456,3111,3345,93
35011, 완산구,050005, 49세,2017,6602,3263,3339,97.7,6563,3239,3324,97.4
35011, 완산구,055,50~54세,2017,29463,14414,15049,95.8,29201,14295,14906,95.9
35011, 완산구,055001, 50세,2017,6000,2929,3071,95.4,5947,2908,3039,95.7
35011, 완산구,055002, 51세,2017,6008,2961,3047,97.2,5952,2932,3020,97.1
35011, 완산구,055003, 52세,2017,6102,2937,3165,92.8,6044,2913,3131,93
35011, 완산구,055004, 53세,2017,5523,2745,2778,98.8,5478,2726,2752,99.1
35011, 완산구,055005, 54세,2017,5830,2842,2988,95.1,5780,2816,2964,95
35011, 완산구,060,55~59세,2017,28929,14039,14890,94.3,28765,13969,14796,94.4
35011, 완산구,060001, 55세,2017,5850,2911,2939,99,5808,2892,2916,99.2
35011, 완산구,060002, 56세,2017,6266,3030,3236,93.6,6237,3019,3218,93.8
35011, 완산구,060003, 57세,2017,6416,3099,3317,93.4,6374,3082,3292,93.6
35011, 완산구,060004, 58세,2017,5526,2590,2936,88.2,5506,2584,2922,88.4
35011, 완산구,060005, 59세,2017,4871,2409,2462,97.8,4840,2392,2448,97.7
35011, 완산구,065,60~64세,2017,21579,10457,11122,94,21467,10404,11063,94
35011, 완산구,065001, 60세,2017,4967,2408,2559,94.1,4942,2394,2548,94
35011, 완산구,065002, 61세,2017,4463,2184,2279,95.8,4440,2174,2266,95.9
35011, 완산구,065003, 62세,2017,4731,2306,2425,95.1,4703,2294,2409,95.2
35011, 완산구,065004, 63세,2017,4065,1992,2073,96.1,4048,1985,2063,96.2
35011, 완산구,065005, 64세,2017,3353,1567,1786,87.7,3334,1557,1777,87.6
35011, 완산구,070,65~69세,2017,15913,7610,8303,91.7,15872,7593,8279,91.7
35011, 완산구,070001, 65세,2017,3563,1752,1811,96.7,3548,1745,1803,96.8
35011, 완산구,070002, 66세,2017,2961,1432,1529,93.7,2954,1428,1526,93.6
35011, 완산구,070003, 67세,2017,3438,1623,1815,89.4,3430,1620,1810,89.5
35011, 완산구,070004, 68세,2017,3072,1414,1658,85.3,3065,1414,1651,85.6
35011, 완산구,070005, 69세,2017,2879,1389,1490,93.2,2875,1386,1489,93.1
35011, 완산구,075,70~74세,2017,11505,5334,6171,86.4,11477,5316,6161,86.3
35011, 완산구,075001, 70세,2017,3100,1476,1624,90.9,3090,1470,1620,90.7
35011, 완산구,075002, 71세,2017,2348,1149,1199,95.8,2338,1143,1195,95.6
35011, 완산구,075003, 72세,2017,2031,914,1117,81.8,2026,909,1117,81.4
35011, 완산구,075004, 73세,2017,1960,889,1071,83,1957,888,1069,83.1
35011, 완산구,075005, 74세,2017,2066,906,1160,78.1,2066,906,1160,78.1
35011, 완산구,080,75~79세,2017,9808,4035,5773,69.9,9799,4031,5768,69.9
35011, 완산구,080001, 75세,2017,2779,1180,1599,73.8,2776,1178,1598,73.7
35011, 완산구,080002, 76세,2017,1914,819,1095,74.8,1913,818,1095,74.7
35011, 완산구,080003, 77세,2017,1729,710,1019,69.7,1727,710,1017,69.8
35011, 완산구,080004, 78세,2017,1791,752,1039,72.4,1789,752,1037,72.5
35011, 완산구,080005, 79세,2017,1595,574,1021,56.2,1594,573,1021,56.1
35011, 완산구,085,80~84세,2017,6405,2230,4175,53.4,6396,2226,4170,53.4
35011, 완산구,085001, 80세,2017,1534,597,937,63.7,1532,597,935,63.9
35011, 완산구,085002, 81세,2017,1354,477,877,54.4,1354,477,877,54.4
35011, 완산구,085003, 82세,2017,1355,448,907,49.4,1354,448,906,49.4
35011, 완산구,085004, 83세,2017,1184,397,787,50.4,1183,397,786,50.5
35011, 완산구,085005, 84세,2017,978,311,667,46.6,973,307,666,46.1
35011, 완산구,090,85~89세,2017,3133,839,2294,36.6,3131,839,2292,36.6
35011, 완산구,090001, 85세,2017,879,263,616,42.7,879,263,616,42.7
35011, 완산구,090002, 86세,2017,683,179,504,35.5,682,179,503,35.6
35011, 완산구,090003, 87세,2017,631,155,476,32.6,630,155,475,32.6
35011, 완산구,090004, 88세,2017,505,146,359,40.7,505,146,359,40.7
35011, 완산구,090005, 89세,2017,435,96,339,28.3,435,96,339,28.3
35011, 완산구,095,90~94세,2017,996,212,784,27,996,212,784,27
35011, 완산구,095001, 90세,2017,368,88,280,31.4,368,88,280,31.4
35011, 완산구,095002, 91세,2017,222,50,172,29.1,222,50,172,29.1
35011, 완산구,095003, 92세,2017,152,31,121,25.6,152,31,121,25.6
35011, 완산구,095004, 93세,2017,119,18,101,17.8,119,18,101,17.8
35011, 완산구,095005, 94세,2017,135,25,110,22.7,135,25,110,22.7
35011, 완산구,100,95~99세,2017,270,41,229,17.9,270,41,229,17.9
35011, 완산구,100001, 95세,2017,101,21,80,26.3,101,21,80,26.3
35011, 완산구,100002, 96세,2017,66,9,57,15.8,66,9,57,15.8
35011, 완산구,100003, 97세,2017,38,X,35,8.6,38,X,35,8.6
35011, 완산구,100004, 98세,2017,43,X,40,7.5,43,X,40,7.5
35011, 완산구,100005, 99세,2017,22,5,17,29.4,22,5,17,29.4
35011, 완산구,101,100세이상,2017,33,X,29,13.8,32,X,28,14.3
35011, 완산구,102,15세미만,2017,48781,25186,23595,106.7,48724,25155,23569,106.7
35011, 완산구,103,15~64세,2017,265288,132051,133237,99.1,261985,130493,131492,99.2
35011, 완산구,104,65세이상,2017,48063,20305,27758,73.2,47973,20262,27711,73.1
35011, 완산구,086,85세이상,2017,4432,1096,3336,32.9,4429,1096,3333,32.9
35011, 완산구,126,평균연령,2017,40.4,39.2,41.7,,40.5,39.2,41.7,
35011, 완산구,127,중위연령,2017,41.6,40,43,,41.7,40.1,43.1,
35012, 덕진구,000,합계,2017,294824,147153,147671,99.6,289989,144870,145119,99.8
35012, 덕진구,005,0~4세,2017,12620,6536,6084,107.4,12518,6484,6034,107.5
35012, 덕진구,005001, 0세,2017,2103,1085,1018,106.6,2073,1067,1006,106.1
35012, 덕진구,005002, 1세,2017,2414,1264,1150,109.9,2393,1253,1140,109.9
35012, 덕진구,005003, 2세,2017,2701,1392,1309,106.3,2678,1379,1299,106.2
35012, 덕진구,005004, 3세,2017,2613,1320,1293,102.1,2592,1315,1277,103
35012, 덕진구,005005, 4세,2017,2789,1475,1314,112.3,2782,1470,1312,112
35012, 덕진구,010,5~9세,2017,15227,7724,7503,102.9,15180,7702,7478,103
35012, 덕진구,010001, 5세,2017,3093,1540,1553,99.2,3076,1533,1543,99.4
35012, 덕진구,010002, 6세,2017,3122,1583,1539,102.9,3112,1576,1536,102.6
35012, 덕진구,010003, 7세,2017,3041,1546,1495,103.4,3029,1540,1489,103.4
35012, 덕진구,010004, 8세,2017,2885,1460,1425,102.5,2882,1460,1422,102.7
35012, 덕진구,010005, 9세,2017,3086,1595,1491,107,3081,1593,1488,107.1
35012, 덕진구,015,10~14세,2017,15412,7997,7415,107.8,15395,7990,7405,107.9
35012, 덕진구,015001, 10세,2017,3191,1708,1483,115.2,3187,1706,1481,115.2
35012, 덕진구,015002, 11세,2017,2911,1536,1375,111.7,2910,1536,1374,111.8
35012, 덕진구,015003, 12세,2017,2951,1566,1385,113.1,2948,1563,1385,112.9
35012, 덕진구,015004, 13세,2017,3176,1582,1594,99.2,3170,1580,1590,99.4
35012, 덕진구,015005, 14세,2017,3183,1605,1578,101.7,3180,1605,1575,101.9
35012, 덕진구,020,15~19세,2017,19892,10145,9747,104.1,19638,10021,9617,104.2
35012, 덕진구,020001, 15세,2017,3316,1708,1608,106.2,3313,1706,1607,106.2
35012, 덕진구,020002, 16세,2017,3628,1777,1851,96,3622,1776,1846,96.2
35012, 덕진구,020003, 17세,2017,4184,2109,2075,101.6,4167,2100,2067,101.6
35012, 덕진구,020004, 18세,2017,4081,2104,1977,106.4,4025,2072,1953,106.1
35012, 덕진구,020005, 19세,2017,4683,2447,2236,109.4,4511,2367,2144,110.4
35012, 덕진구,025,20~24세,2017,24589,13100,11489,114,23350,12578,10772,116.8
35012, 덕진구,025001, 20세,2017,4874,2472,2402,102.9,4623,2374,2249,105.6
35012, 덕진구,025002, 21세,2017,4954,2579,2375,108.6,4713,2471,2242,110.2
35012, 덕진구,025003, 22세,2017,4946,2597,2349,110.6,4709,2507,2202,113.9
35012, 덕진구,025004, 23세,2017,5031,2774,2257,122.9,4775,2660,2115,125.8
35012, 덕진구,025005, 24세,2017,4784,2678,2106,127.2,4530,2566,1964,130.7
35012, 덕진구,030,25~29세,2017,18911,10099,8812,114.6,17946,9628,8318,115.7
35012, 덕진구,030001, 25세,2017,4506,2471,2035,121.4,4274,2374,1900,124.9
35012, 덕진구,030002, 26세,2017,4015,2160,1855,116.4,3837,2071,1766,117.3
35012, 덕진구,030003, 27세,2017,3647,1947,1700,114.5,3457,1847,1610,114.7
35012, 덕진구,030004, 28세,2017,3502,1828,1674,109.2,3305,1732,1573,110.1
35012, 덕진구,030005, 29세,2017,3241,1693,1548,109.4,3073,1604,1469,109.2
35012, 덕진구,035,30~34세,2017,17905,8997,8908,101,17253,8668,8585,101
35012, 덕진구,035001, 30세,2017,3304,1670,1634,102.2,3154,1583,1571,100.8
35012, 덕진구,035002, 31세,2017,3510,1760,1750,100.6,3347,1681,1666,100.9
35012, 덕진구,035003, 32세,2017,3434,1706,1728,98.7,3310,1647,1663,99
35012, 덕진구,035004, 33세,2017,3600,1765,1835,96.2,3493,1713,1780,96.2
35012, 덕진구,035005, 34세,2017,4057,2096,1961,106.9,3949,2044,1905,107.3
35012, 덕진구,040,35~39세,2017,22323,11129,11194,99.4,21945,10920,11025,99
35012, 덕진구,040001, 35세,2017,4471,2242,2229,100.6,4379,2187,2192,99.8
35012, 덕진구,040002, 36세,2017,4335,2145,2190,97.9,4275,2114,2161,97.8
35012, 덕진구,040003, 37세,2017,4599,2314,2285,101.3,4507,2262,2245,100.8
35012, 덕진구,040004, 38세,2017,4560,2315,2245,103.1,4489,2273,2216,102.6
35012, 덕진구,040005, 39세,2017,4358,2113,2245,94.1,4295,2084,2211,94.3
35012, 덕진구,045,40~44세,2017,23690,11845,11845,100,23429,11718,11711,100.1
35012, 덕진구,045001, 40세,2017,4455,2265,2190,103.4,4391,2230,2161,103.2
35012, 덕진구,045002, 41세,2017,4429,2183,2246,97.2,4382,2162,2220,97.4
35012, 덕진구,045003, 42세,2017,4588,2308,2280,101.2,4549,2289,2260,101.3
35012, 덕진구,045004, 43세,2017,5114,2566,2548,100.7,5062,2542,2520,100.9
35012, 덕진구,045005, 44세,2017,5104,2523,2581,97.8,5045,2495,2550,97.8
35012, 덕진구,050,45~49세,2017,25633,12949,12684,102.1,25341,12808,12533,102.2
35012, 덕진구,050001, 45세,2017,5063,2607,2456,106.1,4997,2573,2424,106.1
35012, 덕진구,050002, 46세,2017,5390,2804,2586,108.4,5332,2780,2552,108.9
35012, 덕진구,050003, 47세,2017,5114,2538,2576,98.5,5046,2506,2540,98.7
35012, 덕진구,050004, 48세,2017,5092,2544,2548,99.8,5048,2520,2528,99.7
35012, 덕진구,050005, 49세,2017,4974,2456,2518,97.5,4918,2429,2489,97.6
35012, 덕진구,055,50~54세,2017,22426,11360,11066,102.7,22201,11266,10935,103
35012, 덕진구,055001, 50세,2017,4625,2318,2307,100.5,4572,2296,2276,100.9
35012, 덕진구,055002, 51세,2017,4723,2401,2322,103.4,4680,2384,2296,103.8
35012, 덕진구,055003, 52세,2017,4576,2254,2322,97.1,4527,2233,2294,97.3
35012, 덕진구,055004, 53세,2017,4161,2117,2044,103.6,4115,2099,2016,104.1
35012, 덕진구,055005, 54세,2017,4341,2270,2071,109.6,4307,2254,2053,109.8
35012, 덕진구,060,55~59세,2017,21914,10942,10972,99.7,21737,10861,10876,99.9
35012, 덕진구,060001, 55세,2017,4518,2276,2242,101.5,4471,2252,2219,101.5
35012, 덕진구,060002, 56세,2017,4645,2337,2308,101.3,4615,2325,2290,101.5
35012, 덕진구,060003, 57세,2017,5051,2530,2521,100.4,5021,2516,2505,100.4
35012, 덕진구,060004, 58세,2017,4150,2019,2131,94.7,4116,2003,2113,94.8
35012, 덕진구,060005, 59세,2017,3550,1780,1770,100.6,3514,1765,1749,100.9
35012, 덕진구,065,60~64세,2017,16150,7925,8225,96.4,16018,7863,8155,96.4
35012, 덕진구,065001, 60세,2017,3655,1796,1859,96.6,3616,1783,1833,97.3
35012, 덕진구,065002, 61세,2017,3372,1706,1666,102.4,3347,1694,1653,102.5
35012, 덕진구,065003, 62세,2017,3568,1727,1841,93.8,3536,1710,1826,93.6
35012, 덕진구,065004, 63세,2017,2998,1467,1531,95.8,2981,1459,1522,95.9
35012, 덕진구,065005, 64세,2017,2557,1229,1328,92.5,2538,1217,1321,92.1
35012, 덕진구,070,65~69세,2017,12419,5891,6528,90.2,12374,5870,6504,90.3
35012, 덕진구,070001, 65세,2017,2675,1287,1388,92.7,2670,1283,1387,92.5
35012, 덕진구,070002, 66세,2017,2309,1167,1142,102.2,2294,1162,1132,102.7
35012, 덕진구,070003, 67세,2017,2683,1270,1413,89.9,2673,1264,1409,89.7
35012, 덕진구,070004, 68세,2017,2389,1091,1298,84.1,2383,1089,1294,84.2
35012, 덕진구,070005, 69세,2017,2363,1076,1287,83.6,2354,1072,1282,83.6
35012, 덕진구,075,70~74세,2017,9297,4293,5004,85.8,9274,4285,4989,85.9
35012, 덕진구,075001, 70세,2017,2462,1184,1278,92.6,2454,1179,1275,92.5
35012, 덕진구,075002, 71세,2017,1872,851,1021,83.3,1868,850,1018,83.5
35012, 덕진구,075003, 72세,2017,1606,747,859,87,1604,747,857,87.2
35012, 덕진구,075004, 73세,2017,1664,764,900,84.9,1659,763,896,85.2
35012, 덕진구,075005, 74세,2017,1693,747,946,79,1689,746,943,79.1
35012, 덕진구,080,75~79세,2017,8202,3513,4689,74.9,8187,3507,4680,74.9
35012, 덕진구,080001, 75세,2017,2371,1041,1330,78.3,2368,1039,1329,78.2
35012, 덕진구,080002, 76세,2017,1565,680,885,76.8,1560,678,882,76.9
35012, 덕진구,080003, 77세,2017,1430,609,821,74.2,1427,607,820,74
35012, 덕진구,080004, 78세,2017,1505,633,872,72.6,1504,633,871,72.7
35012, 덕진구,080005, 79세,2017,1331,550,781,70.4,1328,550,778,70.7
35012, 덕진구,085,80~84세,2017,4998,1838,3160,58.2,4991,1834,3157,58.1
35012, 덕진구,085001, 80세,2017,1258,492,766,64.2,1255,491,764,64.3
35012, 덕진구,085002, 81세,2017,1115,421,694,60.7,1115,421,694,60.7
35012, 덕진구,085003, 82세,2017,1023,374,649,57.6,1022,374,648,57.7
35012, 덕진구,085004, 83세,2017,877,307,570,53.9,875,305,570,53.5
35012, 덕진구,085005, 84세,2017,725,244,481,50.7,724,243,481,50.5
35012, 덕진구,090,85~89세,2017,2324,687,1637,42,2320,684,1636,41.8
35012, 덕진구,090001, 85세,2017,651,196,455,43.1,649,195,454,43
35012, 덕진구,090002, 86세,2017,485,154,331,46.5,483,152,331,45.9
35012, 덕진구,090003, 87세,2017,460,122,338,36.1,460,122,338,36.1
35012, 덕진구,090004, 88세,2017,399,117,282,41.5,399,117,282,41.5
35012, 덕진구,090005, 89세,2017,329,98,231,42.4,329,98,231,42.4
35012, 덕진구,095,90~94세,2017,692,160,532,30.1,692,160,532,30.1
35012, 덕진구,095001, 90세,2017,248,70,178,39.3,248,70,178,39.3
35012, 덕진구,095002, 91세,2017,149,30,119,25.2,149,30,119,25.2
35012, 덕진구,095003, 92세,2017,121,25,96,26,121,25,96,26
35012, 덕진구,095004, 93세,2017,89,20,69,29,89,20,69,29
35012, 덕진구,095005, 94세,2017,85,15,70,21.4,85,15,70,21.4
35012, 덕진구,100,95~99세,2017,185,22,163,13.5,185,22,163,13.5
35012, 덕진구,100001, 95세,2017,73,10,63,15.9,73,10,63,15.9
35012, 덕진구,100002, 96세,2017,49,5,44,11.4,49,5,44,11.4
35012, 덕진구,100003, 97세,2017,30,X,26,15.4,30,X,26,15.4
35012, 덕진구,100004, 98세,2017,20,X,18,11.1,20,X,18,11.1
35012, 덕진구,100005, 99세,2017,13,X,12,8.3,13,X,12,8.3
35012, 덕진구,101,100세이상,2017,15,X,14,7.1,15,X,14,7.1
35012, 덕진구,102,15세미만,2017,43259,22257,21002,106,43093,22176,20917,106
35012, 덕진구,103,15~64세,2017,213433,108491,104942,103.4,208858,106331,102527,103.7
35012, 덕진구,104,65세이상,2017,38132,16405,21727,75.5,38038,16363,21675,75.5
35012, 덕진구,086,85세이상,2017,3216,870,2346,37.1,3212,867,2345,37
35012, 덕진구,126,평균연령,2017,39.6,38.6,40.7,,39.8,38.7,40.8,
35012, 덕진구,127,중위연령,2017,40.1,39,41.2,,40.4,39.3,41.5,
35020, 군산시,000,합계,2017,273649,139957,133692,104.7,267283,135901,131382,103.4
35020, 군산시,005,0~4세,2017,11717,5992,5725,104.7,11665,5960,5705,104.5
35020, 군산시,005001, 0세,2017,1845,940,905,103.9,1834,932,902,103.3
35020, 군산시,005002, 1세,2017,2189,1099,1090,100.8,2185,1099,1086,101.2
35020, 군산시,005003, 2세,2017,2506,1271,1235,102.9,2494,1262,1232,102.4
35020, 군산시,005004, 3세,2017,2511,1311,1200,109.3,2498,1302,1196,108.9
35020, 군산시,005005, 4세,2017,2666,1371,1295,105.9,2654,1365,1289,105.9
35020, 군산시,010,5~9세,2017,13173,6808,6365,107,13131,6786,6345,107
35020, 군산시,010001, 5세,2017,2732,1415,1317,107.4,2719,1409,1310,107.6
35020, 군산시,010002, 6세,2017,2789,1456,1333,109.2,2780,1451,1329,109.2
35020, 군산시,010003, 7세,2017,2617,1313,1304,100.7,2613,1311,1302,100.7
35020, 군산시,010004, 8세,2017,2506,1272,1234,103.1,2497,1266,1231,102.8
35020, 군산시,010005, 9세,2017,2529,1352,1177,114.9,2522,1349,1173,115
35020, 군산시,015,10~14세,2017,12765,6564,6201,105.9,12742,6554,6188,105.9
35020, 군산시,015001, 10세,2017,2677,1353,1324,102.2,2671,1351,1320,102.3
35020, 군산시,015002, 11세,2017,2427,1258,1169,107.6,2422,1257,1165,107.9
35020, 군산시,015003, 12세,2017,2405,1257,1148,109.5,2401,1256,1145,109.7
35020, 군산시,015004, 13세,2017,2600,1338,1262,106,2595,1335,1260,106
35020, 군산시,015005, 14세,2017,2656,1358,1298,104.6,2653,1355,1298,104.4
35020, 군산시,020,15~19세,2017,16967,8979,7988,112.4,16852,8926,7926,112.6
35020, 군산시,020001, 15세,2017,2797,1490,1307,114,2790,1485,1305,113.8
35020, 군산시,020002, 16세,2017,3305,1677,1628,103,3301,1676,1625,103.1
35020, 군산시,020003, 17세,2017,3317,1657,1660,99.8,3299,1646,1653,99.6
35020, 군산시,020004, 18세,2017,3542,1906,1636,116.5,3510,1892,1618,116.9
35020, 군산시,020005, 19세,2017,4006,2249,1757,128,3952,2227,1725,129.1
35020, 군산시,025,20~24세,2017,18448,10396,8052,129.1,17804,10024,7780,128.8
35020, 군산시,025001, 20세,2017,3843,2142,1701,125.9,3765,2099,1666,126
35020, 군산시,025002, 21세,2017,3838,2064,1774,116.3,3726,2003,1723,116.3
35020, 군산시,025003, 22세,2017,3859,2117,1742,121.5,3732,2046,1686,121.4
35020, 군산시,025004, 23세,2017,3502,2109,1393,151.4,3348,2012,1336,150.6
35020, 군산시,025005, 24세,2017,3406,1964,1442,136.2,3233,1864,1369,136.2
35020, 군산시,030,25~29세,2017,14553,8161,6392,127.7,13279,7275,6004,121.2
35020, 군산시,030001, 25세,2017,3267,1884,1383,136.2,3027,1731,1296,133.6
35020, 군산시,030002, 26세,2017,2941,1645,1296,126.9,2686,1477,1209,122.2
35020, 군산시,030003, 27세,2017,2782,1583,1199,132,2521,1403,1118,125.5
35020, 군산시,030004, 28세,2017,2780,1513,1267,119.4,2559,1345,1214,110.8
35020, 군산시,030005, 29세,2017,2783,1536,1247,123.2,2486,1319,1167,113
35020, 군산시,035,30~34세,2017,16173,8796,7377,119.2,14989,7928,7061,112.3
35020, 군산시,035001, 30세,2017,2888,1614,1274,126.7,2606,1398,1208,115.7
35020, 군산시,035002, 31세,2017,3043,1672,1371,122,2775,1482,1293,114.6
35020, 군산시,035003, 32세,2017,3041,1628,1413,115.2,2823,1457,1366,106.7
35020, 군산시,035004, 33세,2017,3427,1891,1536,123.1,3203,1729,1474,117.3
35020, 군산시,035005, 34세,2017,3774,1991,1783,111.7,3582,1862,1720,108.3
35020, 군산시,040,35~39세,2017,21063,11227,9836,114.1,20289,10693,9596,111.4
35020, 군산시,040001, 35세,2017,4329,2309,2020,114.3,4135,2168,1967,110.2
35020, 군산시,040002, 36세,2017,4268,2285,1983,115.2,4119,2177,1942,112.1
35020, 군산시,040003, 37세,2017,4392,2345,2047,114.6,4225,2230,1995,111.8
35020, 군산시,040004, 38세,2017,4178,2239,1939,115.5,4035,2140,1895,112.9
35020, 군산시,040005, 39세,2017,3896,2049,1847,110.9,3775,1978,1797,110.1
35020, 군산시,045,40~44세,2017,21711,11389,10322,110.3,21123,11001,10122,108.7
35020, 군산시,045001, 40세,2017,4044,2130,1914,111.3,3919,2042,1877,108.8
35020, 군산시,045002, 41세,2017,3953,2086,1867,111.7,3821,1995,1826,109.3
35020, 군산시,045003, 42세,2017,4283,2217,2066,107.3,4168,2144,2024,105.9
35020, 군산시,045004, 43세,2017,4806,2484,2322,107,4691,2414,2277,106
35020, 군산시,045005, 44세,2017,4625,2472,2153,114.8,4524,2406,2118,113.6
35020, 군산시,050,45~49세,2017,23640,12587,11053,113.9,23105,12273,10832,113.3
35020, 군산시,050001, 45세,2017,4702,2555,2147,119,4574,2477,2097,118.1
35020, 군산시,050002, 46세,2017,5025,2686,2339,114.8,4923,2622,2301,114
35020, 군산시,050003, 47세,2017,4806,2575,2231,115.4,4677,2490,2187,113.9
35020, 군산시,050004, 48세,2017,4540,2393,2147,111.5,4455,2344,2111,111
35020, 군산시,050005, 49세,2017,4567,2378,2189,108.6,4476,2340,2136,109.6
35020, 군산시,055,50~54세,2017,20457,10639,9818,108.4,20015,10398,9617,108.1
35020, 군산시,055001, 50세,2017,4104,2078,2026,102.6,4024,2035,1989,102.3
35020, 군산시,055002, 51세,2017,4150,2192,1958,112,4056,2141,1915,111.8
35020, 군산시,055003, 52세,2017,4070,2112,1958,107.9,3981,2072,1909,108.5
35020, 군산시,055004, 53세,2017,3974,2123,1851,114.7,3894,2074,1820,114
35020, 군산시,055005, 54세,2017,4159,2134,2025,105.4,4060,2076,1984,104.6
35020, 군산시,060,55~59세,2017,22000,10987,11013,99.8,21693,10845,10848,100
35020, 군산시,060001, 55세,2017,4324,2262,2062,109.7,4240,2223,2017,110.2
35020, 군산시,060002, 56세,2017,4642,2377,2265,104.9,4584,2351,2233,105.3
35020, 군산시,060003, 57세,2017,4725,2292,2433,94.2,4666,2262,2404,94.1
35020, 군산시,060004, 58세,2017,4248,2077,2171,95.7,4190,2056,2134,96.3
35020, 군산시,060005, 59세,2017,4061,1979,2082,95.1,4013,1953,2060,94.8
35020, 군산시,065,60~64세,2017,17762,8968,8794,102,17569,8875,8694,102.1
35020, 군산시,065001, 60세,2017,4069,2092,1977,105.8,4013,2063,1950,105.8
35020, 군산시,065002, 61세,2017,3710,1870,1840,101.6,3672,1849,1823,101.4
35020, 군산시,065003, 62세,2017,3875,1941,1934,100.4,3840,1925,1915,100.5
35020, 군산시,065004, 63세,2017,3448,1751,1697,103.2,3410,1733,1677,103.3
35020, 군산시,065005, 64세,2017,2660,1314,1346,97.6,2634,1305,1329,98.2
35020, 군산시,070,65~69세,2017,13769,6773,6996,96.8,13669,6721,6948,96.7
35020, 군산시,070001, 65세,2017,2996,1537,1459,105.3,2975,1524,1451,105
35020, 군산시,070002, 66세,2017,2802,1394,1408,99,2773,1380,1393,99.1
35020, 군산시,070003, 67세,2017,2894,1425,1469,97,2876,1415,1461,96.9
35020, 군산시,070004, 68세,2017,2576,1234,1342,92,2563,1229,1334,92.1
35020, 군산시,070005, 69세,2017,2501,1183,1318,89.8,2482,1173,1309,89.6
35020, 군산시,075,70~74세,2017,10758,5011,5747,87.2,10702,4979,5723,87
35020, 군산시,075001, 70세,2017,2845,1368,1477,92.6,2825,1357,1468,92.4
35020, 군산시,075002, 71세,2017,2155,1062,1093,97.2,2141,1055,1086,97.1
35020, 군산시,075003, 72세,2017,1927,879,1048,83.9,1915,871,1044,83.4
35020, 군산시,075004, 73세,2017,1903,839,1064,78.9,1899,838,1061,79
35020, 군산시,075005, 74세,2017,1928,863,1065,81,1922,858,1064,80.6
35020, 군산시,080,75~79세,2017,9061,3685,5376,68.5,9044,3678,5366,68.5
35020, 군산시,080001, 75세,2017,2614,1110,1504,73.8,2610,1108,1502,73.8
35020, 군산시,080002, 76세,2017,1691,704,987,71.3,1690,704,986,71.4
35020, 군산시,080003, 77세,2017,1626,639,987,64.7,1621,637,984,64.7
35020, 군산시,080004, 78세,2017,1597,684,913,74.9,1592,683,909,75.1
35020, 군산시,080005, 79세,2017,1533,548,985,55.6,1531,546,985,55.4
35020, 군산시,085,80~84세,2017,5682,2050,3632,56.4,5665,2042,3623,56.4
35020, 군산시,085001, 80세,2017,1357,542,815,66.5,1354,540,814,66.3
35020, 군산시,085002, 81세,2017,1222,459,763,60.2,1218,457,761,60.1
35020, 군산시,085003, 82세,2017,1181,407,774,52.6,1175,403,772,52.2
35020, 군산시,085004, 83세,2017,949,330,619,53.3,945,330,615,53.7
35020, 군산시,085005, 84세,2017,973,312,661,47.2,973,312,661,47.2
35020, 군산시,090,85~89세,2017,2890,714,2176,32.8,2888,712,2176,32.7
35020, 군산시,090001, 85세,2017,816,224,592,37.8,815,223,592,37.7
35020, 군산시,090002, 86세,2017,628,150,478,31.4,627,149,478,31.2
35020, 군산시,090003, 87세,2017,600,140,460,30.4,600,140,460,30.4
35020, 군산시,090004, 88세,2017,449,124,325,38.2,449,124,325,38.2
35020, 군산시,090005, 89세,2017,397,76,321,23.7,397,76,321,23.7
35020, 군산시,095,90~94세,2017,854,181,673,26.9,853,181,672,26.9
35020, 군산시,095001, 90세,2017,296,66,230,28.7,295,66,229,28.8
35020, 군산시,095002, 91세,2017,189,38,151,25.2,189,38,151,25.2
35020, 군산시,095003, 92세,2017,134,23,111,20.7,134,23,111,20.7
35020, 군산시,095004, 93세,2017,109,24,85,28.2,109,24,85,28.2
35020, 군산시,095005, 94세,2017,126,30,96,31.3,126,30,96,31.3
35020, 군산시,100,95~99세,2017,184,45,139,32.4,184,45,139,32.4
35020, 군산시,100001, 95세,2017,70,16,54,29.6,70,16,54,29.6
35020, 군산시,100002, 96세,2017,45,10,35,28.6,45,10,35,28.6
35020, 군산시,100003, 97세,2017,32,10,22,45.5,32,10,22,45.5
35020, 군산시,100004, 98세,2017,18,6,12,50,18,6,12,50
35020, 군산시,100005, 99세,2017,19,X,16,18.8,19,X,16,18.8
35020, 군산시,101,100세이상,2017,22,5,17,29.4,22,5,17,29.4
35020, 군산시,102,15세미만,2017,37655,19364,18291,105.9,37538,19300,18238,105.8
35020, 군산시,103,15~64세,2017,192774,102129,90645,112.7,186718,98238,88480,111
35020, 군산시,104,65세이상,2017,43220,18464,24756,74.6,43027,18363,24664,74.5
35020, 군산시,086,85세이상,2017,3950,945,3005,31.4,3947,943,3004,31.4
35020, 군산시,126,평균연령,2017,41.8,40.4,43.2,,41.9,40.5,43.3,
35020, 군산시,127,중위연령,2017,42.9,41.4,44.3,,43.2,41.9,44.5,
35030, 익산시,000,합계,2017,298928,150084,148844,100.8,292963,146941,146022,100.6
35030, 익산시,005,0~4세,2017,10850,5606,5244,106.9,10813,5579,5234,106.6
35030, 익산시,005001, 0세,2017,1867,924,943,98,1861,921,940,98
35030, 익산시,005002, 1세,2017,2108,1059,1049,101,2099,1053,1046,100.7
35030, 익산시,005003, 2세,2017,2279,1213,1066,113.8,2272,1207,1065,113.3
35030, 익산시,005004, 3세,2017,2225,1161,1064,109.1,2217,1155,1062,108.8
35030, 익산시,005005, 4세,2017,2371,1249,1122,111.3,2364,1243,1121,110.9
35030, 익산시,010,5~9세,2017,12929,6565,6364,103.2,12899,6550,6349,103.2
35030, 익산시,010001, 5세,2017,2765,1431,1334,107.3,2758,1428,1330,107.4
35030, 익산시,010002, 6세,2017,2650,1322,1328,99.5,2643,1320,1323,99.8
35030, 익산시,010003, 7세,2017,2477,1241,1236,100.4,2472,1238,1234,100.3
35030, 익산시,010004, 8세,2017,2425,1248,1177,106,2417,1244,1173,106.1
35030, 익산시,010005, 9세,2017,2612,1323,1289,102.6,2609,1320,1289,102.4
35030, 익산시,015,10~14세,2017,13530,6901,6629,104.1,13516,6894,6622,104.1
35030, 익산시,015001, 10세,2017,2705,1371,1334,102.8,2702,1370,1332,102.9
35030, 익산시,015002, 11세,2017,2525,1288,1237,104.1,2524,1287,1237,104
35030, 익산시,015003, 12세,2017,2573,1365,1208,113,2571,1364,1207,113
35030, 익산시,015004, 13세,2017,2797,1413,1384,102.1,2793,1411,1382,102.1
35030, 익산시,015005, 14세,2017,2930,1464,1466,99.9,2926,1462,1464,99.9
35030, 익산시,020,15~19세,2017,20202,10998,9204,119.5,19846,10808,9038,119.6
35030, 익산시,020001, 15세,2017,3046,1591,1455,109.3,3043,1589,1454,109.3
35030, 익산시,020002, 16세,2017,3800,2026,1774,114.2,3795,2025,1770,114.4
35030, 익산시,020003, 17세,2017,4105,2278,1827,124.7,4095,2272,1823,124.6
35030, 익산시,020004, 18세,2017,4257,2352,1905,123.5,4192,2315,1877,123.3
35030, 익산시,020005, 19세,2017,4994,2751,2243,122.6,4721,2607,2114,123.3
35030, 익산시,025,20~24세,2017,25276,14012,11264,124.4,23969,13343,10626,125.6
35030, 익산시,025001, 20세,2017,4922,2534,2388,106.1,4709,2412,2297,105
35030, 익산시,025002, 21세,2017,5089,2660,2429,109.5,4880,2561,2319,110.4
35030, 익산시,025003, 22세,2017,5310,3014,2296,131.3,5030,2876,2154,133.5
35030, 익산시,025004, 23세,2017,5213,2995,2218,135,4907,2840,2067,137.4
35030, 익산시,025005, 24세,2017,4742,2809,1933,145.3,4443,2654,1789,148.4
35030, 익산시,030,25~29세,2017,17799,9840,7959,123.6,16616,9168,7448,123.1
35030, 익산시,030001, 25세,2017,4242,2348,1894,124,3999,2213,1786,123.9
35030, 익산시,030002, 26세,2017,3800,2043,1757,116.3,3531,1891,1640,115.3
35030, 익산시,030003, 27세,2017,3448,1923,1525,126.1,3202,1784,1418,125.8
35030, 익산시,030004, 28세,2017,3224,1859,1365,136.2,3006,1733,1273,136.1
35030, 익산시,030005, 29세,2017,3085,1667,1418,117.6,2878,1547,1331,116.2
35030, 익산시,035,30~34세,2017,15830,8299,7531,110.2,15020,7827,7193,108.8
35030, 익산시,035001, 30세,2017,2915,1558,1357,114.8,2723,1441,1282,112.4
35030, 익산시,035002, 31세,2017,3087,1634,1453,112.5,2913,1529,1384,110.5
35030, 익산시,035003, 32세,2017,2961,1537,1424,107.9,2802,1449,1353,107.1
35030, 익산시,035004, 33세,2017,3289,1723,1566,110,3142,1638,1504,108.9
35030, 익산시,035005, 34세,2017,3578,1847,1731,106.7,3440,1770,1670,106
35030, 익산시,040,35~39세,2017,19167,9915,9252,107.2,18588,9606,8982,106.9
35030, 익산시,040001, 35세,2017,3743,1993,1750,113.9,3619,1933,1686,114.7
35030, 익산시,040002, 36세,2017,3861,2003,1858,107.8,3736,1943,1793,108.4
35030, 익산시,040003, 37세,2017,4024,2071,1953,106,3910,2010,1900,105.8
35030, 익산시,040004, 38세,2017,3796,1944,1852,105,3678,1876,1802,104.1
35030, 익산시,040005, 39세,2017,3743,1904,1839,103.5,3645,1844,1801,102.4
35030, 익산시,045,40~44세,2017,21444,10946,10498,104.3,21067,10752,10315,104.2
35030, 익산시,045001, 40세,2017,3873,1993,1880,106,3795,1947,1848,105.4
35030, 익산시,045002, 41세,2017,4001,2108,1893,111.4,3924,2065,1859,111.1
35030, 익산시,045003, 42세,2017,4001,2032,1969,103.2,3929,1993,1936,102.9
35030, 익산시,045004, 43세,2017,4851,2457,2394,102.6,4782,2432,2350,103.5
35030, 익산시,045005, 44세,2017,4718,2356,2362,99.7,4637,2315,2322,99.7
35030, 익산시,050,45~49세,2017,24760,12415,12345,100.6,24416,12252,12164,100.7
35030, 익산시,050001, 45세,2017,4588,2299,2289,100.4,4524,2267,2257,100.4
35030, 익산시,050002, 46세,2017,5133,2627,2506,104.8,5065,2594,2471,105
35030, 익산시,050003, 47세,2017,4883,2441,2442,100,4820,2409,2411,99.9
35030, 익산시,050004, 48세,2017,5074,2530,2544,99.4,5003,2498,2505,99.7
35030, 익산시,050005, 49세,2017,5082,2518,2564,98.2,5004,2484,2520,98.6
35030, 익산시,055,50~54세,2017,23790,12113,11677,103.7,23415,11929,11486,103.9
35030, 익산시,055001, 50세,2017,4822,2361,2461,95.9,4749,2330,2419,96.3
35030, 익산시,055002, 51세,2017,4838,2545,2293,111,4755,2501,2254,111
35030, 익산시,055003, 52세,2017,4821,2443,2378,102.7,4750,2407,2343,102.7
35030, 익산시,055004, 53세,2017,4536,2338,2198,106.4,4464,2299,2165,106.2
35030, 익산시,055005, 54세,2017,4773,2426,2347,103.4,4697,2392,2305,103.8
35030, 익산시,060,55~59세,2017,24935,12471,12464,100.1,24665,12357,12308,100.4
35030, 익산시,060001, 55세,2017,5049,2590,2459,105.3,4974,2560,2414,106
35030, 익산시,060002, 56세,2017,5264,2601,2663,97.7,5212,2584,2628,98.3
35030, 익산시,060003, 57세,2017,5593,2753,2840,96.9,5544,2731,2813,97.1
35030, 익산시,060004, 58세,2017,4723,2373,2350,101,4676,2353,2323,101.3
35030, 익산시,060005, 59세,2017,4306,2154,2152,100.1,4259,2129,2130,100
35030, 익산시,065,60~64세,2017,19492,9726,9766,99.6,19337,9657,9680,99.8
35030, 익산시,065001, 60세,2017,4459,2275,2184,104.2,4414,2258,2156,104.7
35030, 익산시,065002, 61세,2017,4186,2140,2046,104.6,4157,2126,2031,104.7
35030, 익산시,065003, 62세,2017,4274,2095,2179,96.1,4241,2081,2160,96.3
35030, 익산시,065004, 63세,2017,3602,1736,1866,93,3580,1725,1855,93
35030, 익산시,065005, 64세,2017,2971,1480,1491,99.3,2945,1467,1478,99.3
35030, 익산시,070,65~69세,2017,14871,7174,7697,93.2,14800,7138,7662,93.2
35030, 익산시,070001, 65세,2017,3274,1594,1680,94.9,3254,1581,1673,94.5
35030, 익산시,070002, 66세,2017,2859,1424,1435,99.2,2841,1415,1426,99.2
35030, 익산시,070003, 67세,2017,3197,1549,1648,94,3180,1542,1638,94.1
35030, 익산시,070004, 68세,2017,2787,1307,1480,88.3,2782,1306,1476,88.5
35030, 익산시,070005, 69세,2017,2754,1300,1454,89.4,2743,1294,1449,89.3
35030, 익산시,075,70~74세,2017,11219,5115,6104,83.8,11199,5106,6093,83.8
35030, 익산시,075001, 70세,2017,2899,1413,1486,95.1,2895,1409,1486,94.8
35030, 익산시,075002, 71세,2017,2151,1010,1141,88.5,2147,1009,1138,88.7
35030, 익산시,075003, 72세,2017,1975,896,1079,83,1972,893,1079,82.8
35030, 익산시,075004, 73세,2017,1976,868,1108,78.3,1972,867,1105,78.5
35030, 익산시,075005, 74세,2017,2218,928,1290,71.9,2213,928,1285,72.2
35030, 익산시,080,75~79세,2017,10739,4262,6477,65.8,10716,4256,6460,65.9
35030, 익산시,080001, 75세,2017,3096,1331,1765,75.4,3091,1329,1762,75.4
35030, 익산시,080002, 76세,2017,1996,803,1193,67.3,1993,802,1191,67.3
35030, 익산시,080003, 77세,2017,1835,709,1126,63,1826,707,1119,63.2
35030, 익산시,080004, 78세,2017,1983,764,1219,62.7,1978,763,1215,62.8
35030, 익산시,080005, 79세,2017,1829,655,1174,55.8,1828,655,1173,55.8
35030, 익산시,085,80~84세,2017,7171,2470,4701,52.5,7161,2465,4696,52.5
35030, 익산시,085001, 80세,2017,1691,599,1092,54.9,1688,598,1090,54.9
35030, 익산시,085002, 81세,2017,1480,541,939,57.6,1477,540,937,57.6
35030, 익산시,085003, 82세,2017,1494,517,977,52.9,1493,516,977,52.8
35030, 익산시,085004, 83세,2017,1294,451,843,53.5,1293,451,842,53.6
35030, 익산시,085005, 84세,2017,1212,362,850,42.6,1210,360,850,42.4
35030, 익산시,090,85~89세,2017,3560,953,2607,36.6,3556,951,2605,36.5
35030, 익산시,090001, 85세,2017,963,296,667,44.4,963,296,667,44.4
35030, 익산시,090002, 86세,2017,806,196,610,32.1,804,195,609,32
35030, 익산시,090003, 87세,2017,696,179,517,34.6,695,178,517,34.4
35030, 익산시,090004, 88세,2017,626,169,457,37,625,169,456,37.1
35030, 익산시,090005, 89세,2017,469,113,356,31.7,469,113,356,31.7
35030, 익산시,095,90~94세,2017,1099,257,842,30.5,1099,257,842,30.5
35030, 익산시,095001, 90세,2017,394,87,307,28.3,394,87,307,28.3
35030, 익산시,095002, 91세,2017,249,72,177,40.7,249,72,177,40.7
35030, 익산시,095003, 92세,2017,182,36,146,24.7,182,36,146,24.7
35030, 익산시,095004, 93세,2017,146,42,104,40.4,146,42,104,40.4
35030, 익산시,095005, 94세,2017,128,20,108,18.5,128,20,108,18.5
35030, 익산시,100,95~99세,2017,229,41,188,21.8,229,41,188,21.8
35030, 익산시,100001, 95세,2017,106,24,82,29.3,106,24,82,29.3
35030, 익산시,100002, 96세,2017,40,5,35,14.3,40,5,35,14.3
35030, 익산시,100003, 97세,2017,43,7,36,19.4,43,7,36,19.4
35030, 익산시,100004, 98세,2017,23,X,20,15,23,X,20,15
35030, 익산시,100005, 99세,2017,17,X,15,13.3,17,X,15,13.3
35030, 익산시,101,100세이상,2017,36,5,31,16.1,36,5,31,16.1
35030, 익산시,102,15세미만,2017,37309,19072,18237,104.6,37228,19023,18205,104.5
35030, 익산시,103,15~64세,2017,212695,110735,101960,108.6,206939,107699,99240,108.5
35030, 익산시,104,65세이상,2017,48924,20277,28647,70.8,48796,20219,28577,70.8
35030, 익산시,086,85세이상,2017,4924,1256,3668,34.2,4920,1254,3666,34.2
35030, 익산시,126,평균연령,2017,42.2,40.5,43.8,,42.3,40.7,44,
35030, 익산시,127,중위연령,2017,43.4,41.4,45.2,,43.7,41.8,45.5,
35040, 정읍시,000,합계,2017,109263,54322,54941,98.9,106529,52692,53837,97.9
35040, 정읍시,005,0~4세,2017,3347,1741,1606,108.4,3336,1736,1600,108.5
35040, 정읍시,005001, 0세,2017,548,294,254,115.7,546,294,252,116.7
35040, 정읍시,005002, 1세,2017,643,330,313,105.4,642,330,312,105.8
35040, 정읍시,005003, 2세,2017,690,371,319,116.3,687,370,317,116.7
35040, 정읍시,005004, 3세,2017,731,363,368,98.6,729,362,367,98.6
35040, 정읍시,005005, 4세,2017,735,383,352,108.8,732,380,352,108
35040, 정읍시,010,5~9세,2017,4196,2204,1992,110.6,4190,2200,1990,110.6
35040, 정읍시,010001, 5세,2017,874,444,430,103.3,873,443,430,103
35040, 정읍시,010002, 6세,2017,883,453,430,105.3,881,452,429,105.4
35040, 정읍시,010003, 7세,2017,792,426,366,116.4,790,425,365,116.4
35040, 정읍시,010004, 8세,2017,766,418,348,120.1,766,418,348,120.1
35040, 정읍시,010005, 9세,2017,881,463,418,110.8,880,462,418,110.5
35040, 정읍시,015,10~14세,2017,4675,2472,2203,112.2,4664,2467,2197,112.3
35040, 정읍시,015001, 10세,2017,928,463,465,99.6,926,462,464,99.6
35040, 정읍시,015002, 11세,2017,851,452,399,113.3,849,452,397,113.9
35040, 정읍시,015003, 12세,2017,880,455,425,107.1,879,454,425,106.8
35040, 정읍시,015004, 13세,2017,987,540,447,120.8,985,540,445,121.3
35040, 정읍시,015005, 14세,2017,1029,562,467,120.3,1025,559,466,120
35040, 정읍시,020,15~19세,2017,6065,3125,2940,106.3,6005,3094,2911,106.3
35040, 정읍시,020001, 15세,2017,1167,629,538,116.9,1165,628,537,116.9
35040, 정읍시,020002, 16세,2017,1283,657,626,105,1279,656,623,105.3
35040, 정읍시,020003, 17세,2017,1432,740,692,106.9,1429,737,692,106.5
35040, 정읍시,020004, 18세,2017,1214,592,622,95.2,1202,585,617,94.8
35040, 정읍시,020005, 19세,2017,969,507,462,109.7,930,488,442,110.4
35040, 정읍시,025,20~24세,2017,5712,3306,2406,137.4,5309,3048,2261,134.8
35040, 정읍시,025001, 20세,2017,1132,669,463,144.5,1075,629,446,141
35040, 정읍시,025002, 21세,2017,1258,791,467,169.4,1194,749,445,168.3
35040, 정읍시,025003, 22세,2017,1174,686,488,140.6,1078,624,454,137.4
35040, 정읍시,025004, 23세,2017,1135,634,501,126.5,1045,574,471,121.9
35040, 정읍시,025005, 24세,2017,1013,526,487,108,917,472,445,106.1
35040, 정읍시,030,25~29세,2017,4958,2743,2215,123.8,4384,2387,1997,119.5
35040, 정읍시,030001, 25세,2017,1052,560,492,113.8,948,496,452,109.7
35040, 정읍시,030002, 26세,2017,1004,569,435,130.8,891,489,402,121.6
35040, 정읍시,030003, 27세,2017,1018,564,454,124.2,894,487,407,119.7
35040, 정읍시,030004, 28세,2017,929,529,400,132.3,818,460,358,128.5
35040, 정읍시,030005, 29세,2017,955,521,434,120,833,455,378,120.4
35040, 정읍시,035,30~34세,2017,4797,2622,2175,120.6,4330,2311,2019,114.5
35040, 정읍시,035001, 30세,2017,907,498,409,121.8,802,427,375,113.9
35040, 정읍시,035002, 31세,2017,928,512,416,123.1,843,448,395,113.4
35040, 정읍시,035003, 32세,2017,876,474,402,117.9,784,411,373,110.2
35040, 정읍시,035004, 33세,2017,1018,560,458,122.3,911,498,413,120.6
35040, 정읍시,035005, 34세,2017,1068,578,490,118,990,527,463,113.8
35040, 정읍시,040,35~39세,2017,6130,3229,2901,111.3,5808,3018,2790,108.2
35040, 정읍시,040001, 35세,2017,1150,612,538,113.8,1073,559,514,108.8
35040, 정읍시,040002, 36세,2017,1205,653,552,118.3,1133,603,530,113.8
35040, 정읍시,040003, 37세,2017,1267,658,609,108,1201,620,581,106.7
35040, 정읍시,040004, 38세,2017,1278,663,615,107.8,1220,627,593,105.7
35040, 정읍시,040005, 39세,2017,1230,643,587,109.5,1181,609,572,106.5
35040, 정읍시,045,40~44세,2017,7326,3847,3479,110.6,7141,3736,3405,109.7
35040, 정읍시,045001, 40세,2017,1289,677,612,110.6,1249,646,603,107.1
35040, 정읍시,045002, 41세,2017,1341,718,623,115.2,1300,693,607,114.2
35040, 정읍시,045003, 42세,2017,1424,717,707,101.4,1394,706,688,102.6
35040, 정읍시,045004, 43세,2017,1636,876,760,115.3,1602,855,747,114.5
35040, 정읍시,045005, 44세,2017,1636,859,777,110.6,1596,836,760,110
35040, 정읍시,050,45~49세,2017,8562,4591,3971,115.6,8369,4495,3874,116
35040, 정읍시,050001, 45세,2017,1605,868,737,117.8,1574,853,721,118.3
35040, 정읍시,050002, 46세,2017,1760,911,849,107.3,1719,894,825,108.4
35040, 정읍시,050003, 47세,2017,1668,906,762,118.9,1630,890,740,120.3
35040, 정읍시,050004, 48세,2017,1761,955,806,118.5,1724,935,789,118.5
35040, 정읍시,050005, 49세,2017,1768,951,817,116.4,1722,923,799,115.5
35040, 정읍시,055,50~54세,2017,8515,4573,3942,116,8346,4489,3857,116.4
35040, 정읍시,055001, 50세,2017,1671,910,761,119.6,1646,895,751,119.2
35040, 정읍시,055002, 51세,2017,1691,925,766,120.8,1664,912,752,121.3
35040, 정읍시,055003, 52세,2017,1776,955,821,116.3,1728,935,793,117.9
35040, 정읍시,055004, 53세,2017,1673,876,797,109.9,1633,854,779,109.6
35040, 정읍시,055005, 54세,2017,1704,907,797,113.8,1675,893,782,114.2
35040, 정읍시,060,55~59세,2017,9438,4866,4572,106.4,9302,4811,4491,107.1
35040, 정읍시,060001, 55세,2017,1789,971,818,118.7,1761,956,805,118.8
35040, 정읍시,060002, 56세,2017,2109,1068,1041,102.6,2092,1064,1028,103.5
35040, 정읍시,060003, 57세,2017,2040,1013,1027,98.6,2004,1000,1004,99.6
35040, 정읍시,060004, 58세,2017,1776,950,826,115,1754,941,813,115.7
35040, 정읍시,060005, 59세,2017,1724,864,860,100.5,1691,850,841,101.1
35040, 정읍시,065,60~64세,2017,7999,3947,4052,97.4,7885,3880,4005,96.9
35040, 정읍시,065001, 60세,2017,1892,1018,874,116.5,1865,1004,861,116.6
35040, 정읍시,065002, 61세,2017,1554,775,779,99.5,1532,760,772,98.4
35040, 정읍시,065003, 62세,2017,1809,875,934,93.7,1782,861,921,93.5
35040, 정읍시,065004, 63세,2017,1548,731,817,89.5,1529,718,811,88.5
35040, 정읍시,065005, 64세,2017,1196,548,648,84.6,1177,537,640,83.9
35040, 정읍시,070,65~69세,2017,6959,3351,3608,92.9,6912,3327,3585,92.8
35040, 정읍시,070001, 65세,2017,1402,675,727,92.8,1393,672,721,93.2
35040, 정읍시,070002, 66세,2017,1250,587,663,88.5,1241,581,660,88
35040, 정읍시,070003, 67세,2017,1442,693,749,92.5,1430,687,743,92.5
35040, 정읍시,070004, 68세,2017,1459,691,768,90,1448,685,763,89.8
35040, 정읍시,070005, 69세,2017,1406,705,701,100.6,1400,702,698,100.6
35040, 정읍시,075,70~74세,2017,6192,2730,3462,78.9,6175,2723,3452,78.9
35040, 정읍시,075001, 70세,2017,1521,717,804,89.2,1517,714,803,88.9
35040, 정읍시,075002, 71세,2017,1166,555,611,90.8,1163,555,608,91.3
35040, 정읍시,075003, 72세,2017,1114,458,656,69.8,1110,456,654,69.7
35040, 정읍시,075004, 73세,2017,1135,483,652,74.1,1132,481,651,73.9
35040, 정읍시,075005, 74세,2017,1256,517,739,70,1253,517,736,70.2
35040, 정읍시,080,75~79세,2017,6662,2603,4059,64.1,6654,2603,4051,64.3
35040, 정읍시,080001, 75세,2017,1773,694,1079,64.3,1771,694,1077,64.4
35040, 정읍시,080002, 76세,2017,1272,506,766,66.1,1270,506,764,66.2
35040, 정읍시,080003, 77세,2017,1226,490,736,66.6,1223,490,733,66.8
35040, 정읍시,080004, 78세,2017,1240,470,770,61,1239,470,769,61.1
35040, 정읍시,080005, 79세,2017,1151,443,708,62.6,1151,443,708,62.6
35040, 정읍시,085,80~84세,2017,4790,1657,3133,52.9,4782,1653,3129,52.8
35040, 정읍시,085001, 80세,2017,1089,414,675,61.3,1084,411,673,61.1
35040, 정읍시,085002, 81세,2017,1015,357,658,54.3,1014,357,657,54.3
35040, 정읍시,085003, 82세,2017,1069,344,725,47.4,1067,343,724,47.4
35040, 정읍시,085004, 83세,2017,876,301,575,52.3,876,301,575,52.3
35040, 정읍시,085005, 84세,2017,741,241,500,48.2,741,241,500,48.2
35040, 정읍시,090,85~89세,2017,2144,550,1594,34.5,2141,549,1592,34.5
35040, 정읍시,090001, 85세,2017,574,154,420,36.7,574,154,420,36.7
35040, 정읍시,090002, 86세,2017,462,124,338,36.7,461,124,337,36.8
35040, 정읍시,090003, 87세,2017,429,97,332,29.2,428,96,332,28.9
35040, 정읍시,090004, 88세,2017,362,100,262,38.2,361,100,261,38.3
35040, 정읍시,090005, 89세,2017,317,75,242,31,317,75,242,31
35040, 정읍시,095,90~94세,2017,607,135,472,28.6,607,135,472,28.6
35040, 정읍시,095001, 90세,2017,241,45,196,23,241,45,196,23
35040, 정읍시,095002, 91세,2017,110,27,83,32.5,110,27,83,32.5
35040, 정읍시,095003, 92세,2017,91,27,64,42.2,91,27,64,42.2
35040, 정읍시,095004, 93세,2017,79,23,56,41.1,79,23,56,41.1
35040, 정읍시,095005, 94세,2017,86,13,73,17.8,86,13,73,17.8
35040, 정읍시,100,95~99세,2017,177,28,149,18.8,177,28,149,18.8
35040, 정읍시,100001, 95세,2017,63,13,50,26,63,13,50,26
35040, 정읍시,100002, 96세,2017,47,11,36,30.6,47,11,36,30.6
35040, 정읍시,100003, 97세,2017,33,X,31,6.5,33,X,31,6.5
35040, 정읍시,100004, 98세,2017,23,X,22,4.5,23,X,22,4.5
35040, 정읍시,100005, 99세,2017,11,X,10,10,11,X,10,10
35040, 정읍시,101,100세이상,2017,12,X,10,20,12,X,10,20
35040, 정읍시,102,15세미만,2017,12218,6417,5801,110.6,12190,6403,5787,110.6
35040, 정읍시,103,15~64세,2017,69502,36849,32653,112.9,66879,35269,31610,111.6
35040, 정읍시,104,65세이상,2017,27543,11056,16487,67.1,27460,11020,16440,67
35040, 정읍시,086,85세이상,2017,2940,715,2225,32.1,2937,714,2223,32.1
35040, 정읍시,126,평균연령,2017,47.1,44.8,49.4,,47.4,45.1,49.7,
35040, 정읍시,127,중위연령,2017,49.4,47.1,52.1,,49.8,47.7,52.5,
35050, 남원시,000,합계,2017,79282,38900,40382,96.3,78128,38400,39728,96.7
35050, 남원시,005,0~4세,2017,2527,1324,1203,110.1,2519,1320,1199,110.1
35050, 남원시,005001, 0세,2017,440,229,211,108.5,439,228,211,108.1
35050, 남원시,005002, 1세,2017,487,249,238,104.6,486,248,238,104.2
35050, 남원시,005003, 2세,2017,491,266,225,118.2,489,265,224,118.3
35050, 남원시,005004, 3세,2017,538,278,260,106.9,535,277,258,107.4
35050, 남원시,005005, 4세,2017,571,302,269,112.3,570,302,268,112.7
35050, 남원시,010,5~9세,2017,3116,1643,1473,111.5,3113,1642,1471,111.6
35050, 남원시,010001, 5세,2017,573,310,263,117.9,573,310,263,117.9
35050, 남원시,010002, 6세,2017,660,326,334,97.6,659,325,334,97.3
35050, 남원시,010003, 7세,2017,593,307,286,107.3,593,307,286,107.3
35050, 남원시,010004, 8세,2017,610,345,265,130.2,609,345,264,130.7
35050, 남원시,010005, 9세,2017,680,355,325,109.2,679,355,324,109.6
35050, 남원시,015,10~14세,2017,3493,1788,1705,104.9,3491,1787,1704,104.9
35050, 남원시,015001, 10세,2017,658,330,328,100.6,658,330,328,100.6
35050, 남원시,015002, 11세,2017,649,330,319,103.4,648,329,319,103.1
35050, 남원시,015003, 12세,2017,683,342,341,100.3,683,342,341,100.3
35050, 남원시,015004, 13세,2017,714,377,337,111.9,714,377,337,111.9
35050, 남원시,015005, 14세,2017,789,409,380,107.6,788,409,379,107.9
35050, 남원시,020,15~19세,2017,4133,2231,1902,117.3,4118,2224,1894,117.4
35050, 남원시,020001, 15세,2017,815,403,412,97.8,815,403,412,97.8
35050, 남원시,020002, 16세,2017,933,475,458,103.7,931,474,457,103.7
35050, 남원시,020003, 17세,2017,936,493,443,111.3,935,493,442,111.5
35050, 남원시,020004, 18세,2017,802,448,354,126.6,799,447,352,127
35050, 남원시,020005, 19세,2017,647,412,235,175.3,638,407,231,176.2
35050, 남원시,025,20~24세,2017,4028,2378,1650,144.1,3882,2316,1566,147.9
35050, 남원시,025001, 20세,2017,797,519,278,186.7,782,511,271,188.6
35050, 남원시,025002, 21세,2017,915,574,341,168.3,898,564,334,168.9
35050, 남원시,025003, 22세,2017,792,462,330,140,758,449,309,145.3
35050, 남원시,025004, 23세,2017,786,424,362,117.1,751,410,341,120.2
35050, 남원시,025005, 24세,2017,738,399,339,117.7,693,382,311,122.8
35050, 남원시,030,25~29세,2017,3216,1725,1491,115.7,3024,1642,1382,118.8
35050, 남원시,030001, 25세,2017,706,391,315,124.1,672,373,299,124.7
35050, 남원시,030002, 26세,2017,648,344,304,113.2,607,334,273,122.3
35050, 남원시,030003, 27세,2017,608,333,275,121.1,571,315,256,123
35050, 남원시,030004, 28세,2017,612,322,290,111,578,302,276,109.4
35050, 남원시,030005, 29세,2017,642,335,307,109.1,596,318,278,114.4
35050, 남원시,035,30~34세,2017,3207,1681,1526,110.2,3046,1607,1439,111.7
35050, 남원시,035001, 30세,2017,585,318,267,119.1,551,299,252,118.7
35050, 남원시,035002, 31세,2017,609,302,307,98.4,574,288,286,100.7
35050, 남원시,035003, 32세,2017,620,323,297,108.8,588,310,278,111.5
35050, 남원시,035004, 33세,2017,677,365,312,117,645,351,294,119.4
35050, 남원시,035005, 34세,2017,716,373,343,108.7,688,359,329,109.1
35050, 남원시,040,35~39세,2017,4104,2041,2063,98.9,3975,1994,1981,100.7
35050, 남원시,040001, 35세,2017,759,388,371,104.6,728,379,349,108.6
35050, 남원시,040002, 36세,2017,800,417,383,108.9,774,407,367,110.9
35050, 남원시,040003, 37세,2017,865,412,453,90.9,840,404,436,92.7
35050, 남원시,040004, 38세,2017,849,416,433,96.1,832,410,422,97.2
35050, 남원시,040005, 39세,2017,831,408,423,96.5,801,394,407,96.8
35050, 남원시,045,40~44세,2017,5259,2710,2549,106.3,5156,2661,2495,106.7
35050, 남원시,045001, 40세,2017,899,429,470,91.3,872,413,459,90
35050, 남원시,045002, 41세,2017,970,492,478,102.9,955,484,471,102.8
35050, 남원시,045003, 42세,2017,987,484,503,96.2,963,478,485,98.6
35050, 남원시,045004, 43세,2017,1197,639,558,114.5,1176,630,546,115.4
35050, 남원시,045005, 44세,2017,1206,666,540,123.3,1190,656,534,122.8
35050, 남원시,050,45~49세,2017,6393,3402,2991,113.7,6279,3352,2927,114.5
35050, 남원시,050001, 45세,2017,1193,633,560,113,1160,620,540,114.8
35050, 남원시,050002, 46세,2017,1312,683,629,108.6,1295,676,619,109.2
35050, 남원시,050003, 47세,2017,1185,669,516,129.7,1160,654,506,129.2
35050, 남원시,050004, 48세,2017,1356,730,626,116.6,1334,723,611,118.3
35050, 남원시,050005, 49세,2017,1347,687,660,104.1,1330,679,651,104.3
35050, 남원시,055,50~54세,2017,6042,3205,2837,113,5945,3170,2775,114.2
35050, 남원시,055001, 50세,2017,1252,646,606,106.6,1234,639,595,107.4
35050, 남원시,055002, 51세,2017,1257,643,614,104.7,1243,640,603,106.1
35050, 남원시,055003, 52세,2017,1255,673,582,115.6,1227,663,564,117.6
35050, 남원시,055004, 53세,2017,1060,586,474,123.6,1038,578,460,125.7
35050, 남원시,055005, 54세,2017,1218,657,561,117.1,1203,650,553,117.5
35050, 남원시,060,55~59세,2017,7172,3636,3536,102.8,7104,3612,3492,103.4
35050, 남원시,060001, 55세,2017,1411,755,656,115.1,1400,753,647,116.4
35050, 남원시,060002, 56세,2017,1513,734,779,94.2,1498,727,771,94.3
35050, 남원시,060003, 57세,2017,1622,831,791,105.1,1611,826,785,105.2
35050, 남원시,060004, 58세,2017,1362,668,694,96.3,1350,664,686,96.8
35050, 남원시,060005, 59세,2017,1264,648,616,105.2,1245,642,603,106.5
35050, 남원시,065,60~64세,2017,5962,2962,3000,98.7,5896,2925,2971,98.5
35050, 남원시,065001, 60세,2017,1285,663,622,106.6,1262,647,615,105.2
35050, 남원시,065002, 61세,2017,1228,571,657,86.9,1214,565,649,87.1
35050, 남원시,065003, 62세,2017,1312,644,668,96.4,1295,635,660,96.2
35050, 남원시,065004, 63세,2017,1171,591,580,101.9,1163,586,577,101.6
35050, 남원시,065005, 64세,2017,966,493,473,104.2,962,492,470,104.7
35050, 남원시,070,65~69세,2017,5264,2466,2798,88.1,5234,2447,2787,87.8
35050, 남원시,070001, 65세,2017,1116,550,566,97.2,1107,543,564,96.3
35050, 남원시,070002, 66세,2017,964,476,488,97.5,957,472,485,97.3
35050, 남원시,070003, 67세,2017,1055,508,547,92.9,1050,506,544,93
35050, 남원시,070004, 68세,2017,1018,444,574,77.4,1013,440,573,76.8
35050, 남원시,070005, 69세,2017,1111,488,623,78.3,1107,486,621,78.3
35050, 남원시,075,70~74세,2017,4416,1947,2469,78.9,4406,1944,2462,79
35050, 남원시,075001, 70세,2017,1187,579,608,95.2,1184,579,605,95.7
35050, 남원시,075002, 71세,2017,863,404,459,88,861,404,457,88.4
35050, 남원시,075003, 72세,2017,761,325,436,74.5,758,323,435,74.3
35050, 남원시,075004, 73세,2017,749,293,456,64.3,747,292,455,64.2
35050, 남원시,075005, 74세,2017,856,346,510,67.8,856,346,510,67.8
35050, 남원시,080,75~79세,2017,4981,1915,3066,62.5,4976,1914,3062,62.5
35050, 남원시,080001, 75세,2017,1375,503,872,57.7,1374,503,871,57.7
35050, 남원시,080002, 76세,2017,988,401,587,68.3,988,401,587,68.3
35050, 남원시,080003, 77세,2017,852,342,510,67.1,851,341,510,66.9
35050, 남원시,080004, 78세,2017,916,345,571,60.4,915,345,570,60.5
35050, 남원시,080005, 79세,2017,850,324,526,61.6,848,324,524,61.8
35050, 남원시,085,80~84세,2017,3582,1195,2387,50.1,3581,1195,2386,50.1
35050, 남원시,085001, 80세,2017,847,295,552,53.4,847,295,552,53.4
35050, 남원시,085002, 81세,2017,721,276,445,62,720,276,444,62.2
35050, 남원시,085003, 82세,2017,789,250,539,46.4,789,250,539,46.4
35050, 남원시,085004, 83세,2017,724,208,516,40.3,724,208,516,40.3
35050, 남원시,085005, 84세,2017,501,166,335,49.6,501,166,335,49.6
35050, 남원시,090,85~89세,2017,1656,477,1179,40.5,1655,477,1178,40.5
35050, 남원시,090001, 85세,2017,471,147,324,45.4,471,147,324,45.4
35050, 남원시,090002, 86세,2017,358,101,257,39.3,358,101,257,39.3
35050, 남원시,090003, 87세,2017,299,84,215,39.1,299,84,215,39.1
35050, 남원시,090004, 88세,2017,246,69,177,39,245,69,176,39.2
35050, 남원시,090005, 89세,2017,282,76,206,36.9,282,76,206,36.9
35050, 남원시,095,90~94세,2017,577,144,433,33.3,574,141,433,32.6
35050, 남원시,095001, 90세,2017,200,55,145,37.9,200,55,145,37.9
35050, 남원시,095002, 91세,2017,141,29,112,25.9,140,28,112,25
35050, 남원시,095003, 92세,2017,81,21,60,35,79,19,60,31.7
35050, 남원시,095004, 93세,2017,73,13,60,21.7,73,13,60,21.7
35050, 남원시,095005, 94세,2017,82,26,56,46.4,82,26,56,46.4
35050, 남원시,100,95~99세,2017,138,29,109,26.6,138,29,109,26.6
35050, 남원시,100001, 95세,2017,55,16,39,41,55,16,39,41
35050, 남원시,100002, 96세,2017,27,5,22,22.7,27,5,22,22.7
35050, 남원시,100003, 97세,2017,31,5,26,19.2,31,5,26,19.2
35050, 남원시,100004, 98세,2017,13,X,12,8.3,13,X,12,8.3
35050, 남원시,100005, 99세,2017,12,X,10,20,12,X,10,20
35050, 남원시,101,100세이상,2017,16,X,15,6.7,16,X,15,6.7
35050, 남원시,102,15세미만,2017,9136,4755,4381,108.5,9123,4749,4374,108.6
35050, 남원시,103,15~64세,2017,49516,25971,23545,110.3,48425,25503,22922,111.3
35050, 남원시,104,65세이상,2017,20630,8174,12456,65.6,20580,8148,12432,65.5
35050, 남원시,086,85세이상,2017,2387,651,1736,37.5,2383,648,1735,37.3
35050, 남원시,126,평균연령,2017,47.7,45.2,50,,47.8,45.3,50.2,
35050, 남원시,127,중위연령,2017,50.1,47.9,52.7,,50.4,48.1,53.1,
35060, 김제시,000,합계,2017,82358,40867,41491,98.5,80111,39367,40744,96.6
35060, 김제시,005,0~4세,2017,2351,1197,1154,103.7,2346,1194,1152,103.6
35060, 김제시,005001, 0세,2017,416,202,214,94.4,416,202,214,94.4
35060, 김제시,005002, 1세,2017,450,231,219,105.5,447,229,218,105
35060, 김제시,005003, 2세,2017,484,237,247,96,484,237,247,96
35060, 김제시,005004, 3세,2017,487,253,234,108.1,486,253,233,108.6
35060, 김제시,005005, 4세,2017,514,274,240,114.2,513,273,240,113.8
35060, 김제시,010,5~9세,2017,2922,1483,1439,103.1,2911,1478,1433,103.1
35060, 김제시,010001, 5세,2017,603,312,291,107.2,600,311,289,107.6
35060, 김제시,010002, 6세,2017,622,291,331,87.9,621,291,330,88.2
35060, 김제시,010003, 7세,2017,561,292,269,108.6,558,290,268,108.2
35060, 김제시,010004, 8세,2017,584,301,283,106.4,582,300,282,106.4
35060, 김제시,010005, 9세,2017,552,287,265,108.3,550,286,264,108.3
35060, 김제시,015,10~14세,2017,2838,1449,1389,104.3,2832,1448,1384,104.6
35060, 김제시,015001, 10세,2017,597,310,287,108,596,310,286,108.4
35060, 김제시,015002, 11세,2017,555,291,264,110.2,555,291,264,110.2
35060, 김제시,015003, 12세,2017,538,289,249,116.1,537,289,248,116.5
35060, 김제시,015004, 13세,2017,544,261,283,92.2,542,260,282,92.2
35060, 김제시,015005, 14세,2017,604,298,306,97.4,602,298,304,98
35060, 김제시,020,15~19세,2017,3624,1944,1680,115.7,3606,1931,1675,115.3
35060, 김제시,020001, 15세,2017,656,345,311,110.9,655,345,310,111.3
35060, 김제시,020002, 16세,2017,785,398,387,102.8,784,397,387,102.6
35060, 김제시,020003, 17세,2017,833,436,397,109.8,831,434,397,109.3
35060, 김제시,020004, 18세,2017,695,363,332,109.3,690,359,331,108.5
35060, 김제시,020005, 19세,2017,655,402,253,158.9,646,396,250,158.4
35060, 김제시,025,20~24세,2017,4093,2458,1635,150.3,3800,2261,1539,146.9
35060, 김제시,025001, 20세,2017,736,461,275,167.6,717,449,268,167.5
35060, 김제시,025002, 21세,2017,790,479,311,154,752,454,298,152.3
35060, 김제시,025003, 22세,2017,867,512,355,144.2,810,476,334,142.5
35060, 김제시,025004, 23세,2017,884,534,350,152.6,807,479,328,146
35060, 김제시,025005, 24세,2017,816,472,344,137.2,714,403,311,129.6
35060, 김제시,030,25~29세,2017,3662,2081,1581,131.6,3144,1729,1415,122.2
35060, 김제시,030001, 25세,2017,745,419,326,128.5,656,361,295,122.4
35060, 김제시,030002, 26세,2017,746,415,331,125.4,656,354,302,117.2
35060, 김제시,030003, 27세,2017,772,450,322,139.8,657,368,289,127.3
35060, 김제시,030004, 28세,2017,669,395,274,144.2,557,318,239,133.1
35060, 김제시,030005, 29세,2017,730,402,328,122.6,618,328,290,113.1
35060, 김제시,035,30~34세,2017,3644,2031,1613,125.9,3185,1681,1504,111.8
35060, 김제시,035001, 30세,2017,706,389,317,122.7,607,316,291,108.6
35060, 김제시,035002, 31세,2017,721,423,298,141.9,620,336,284,118.3
35060, 김제시,035003, 32세,2017,682,371,311,119.3,598,310,288,107.6
35060, 김제시,035004, 33세,2017,775,443,332,133.4,685,375,310,121
35060, 김제시,035005, 34세,2017,760,405,355,114.1,675,344,331,103.9
35060, 김제시,040,35~39세,2017,4418,2498,1920,130.1,4086,2253,1833,122.9
35060, 김제시,040001, 35세,2017,894,517,377,137.1,815,457,358,127.7
35060, 김제시,040002, 36세,2017,930,537,393,136.6,866,487,379,128.5
35060, 김제시,040003, 37세,2017,895,487,408,119.4,828,438,390,112.3
35060, 김제시,040004, 38세,2017,862,471,391,120.5,792,422,370,114.1
35060, 김제시,040005, 39세,2017,837,486,351,138.5,785,449,336,133.6
35060, 김제시,045,40~44세,2017,4883,2734,2149,127.2,4714,2612,2102,124.3
35060, 김제시,045001, 40세,2017,910,488,422,115.6,863,453,410,110.5
35060, 김제시,045002, 41세,2017,926,536,390,137.4,892,510,382,133.5
35060, 김제시,045003, 42세,2017,904,510,394,129.4,870,484,386,125.4
35060, 김제시,045004, 43세,2017,1091,621,470,132.1,1068,607,461,131.7
35060, 김제시,045005, 44세,2017,1052,579,473,122.4,1021,558,463,120.5
35060, 김제시,050,45~49세,2017,5641,3134,2507,125,5489,3054,2435,125.4
35060, 김제시,050001, 45세,2017,1085,616,469,131.3,1046,594,452,131.4
35060, 김제시,050002, 46세,2017,1084,631,453,139.3,1054,614,440,139.5
35060, 김제시,050003, 47세,2017,1118,626,492,127.2,1090,611,479,127.6
35060, 김제시,050004, 48세,2017,1118,606,512,118.4,1097,595,502,118.5
35060, 김제시,050005, 49세,2017,1236,655,581,112.7,1202,640,562,113.9
35060, 김제시,055,50~54세,2017,5985,3173,2812,112.8,5881,3128,2753,113.6
35060, 김제시,055001, 50세,2017,1117,619,498,124.3,1098,611,487,125.5
35060, 김제시,055002, 51세,2017,1127,613,514,119.3,1106,607,499,121.6
35060, 김제시,055003, 52세,2017,1230,651,579,112.4,1209,642,567,113.2
35060, 김제시,055004, 53세,2017,1223,637,586,108.7,1196,623,573,108.7
35060, 김제시,055005, 54세,2017,1288,653,635,102.8,1272,645,627,102.9
35060, 김제시,060,55~59세,2017,7493,3739,3754,99.6,7419,3704,3715,99.7
35060, 김제시,060001, 55세,2017,1374,697,677,103,1357,689,668,103.1
35060, 김제시,060002, 56세,2017,1560,807,753,107.2,1550,803,747,107.5
35060, 김제시,060003, 57세,2017,1702,832,870,95.6,1683,824,859,95.9
35060, 김제시,060004, 58세,2017,1425,695,730,95.2,1414,690,724,95.3
35060, 김제시,060005, 59세,2017,1432,708,724,97.8,1415,698,717,97.4
35060, 김제시,065,60~64세,2017,6727,3358,3369,99.7,6670,3334,3336,99.9
35060, 김제시,065001, 60세,2017,1441,734,707,103.8,1431,729,702,103.8
35060, 김제시,065002, 61세,2017,1432,733,699,104.9,1421,726,695,104.5
35060, 김제시,065003, 62세,2017,1499,742,757,98,1487,738,749,98.5
35060, 김제시,065004, 63세,2017,1309,631,678,93.1,1290,625,665,94
35060, 김제시,065005, 64세,2017,1046,518,528,98.1,1041,516,525,98.3
35060, 김제시,070,65~69세,2017,6032,2843,3189,89.2,5996,2822,3174,88.9
35060, 김제시,070001, 65세,2017,1244,591,653,90.5,1232,585,647,90.4
35060, 김제시,070002, 66세,2017,1187,567,620,91.5,1182,564,618,91.3
35060, 김제시,070003, 67세,2017,1335,601,734,81.9,1322,591,731,80.8
35060, 김제시,070004, 68세,2017,1142,522,620,84.2,1139,521,618,84.3
35060, 김제시,070005, 69세,2017,1124,562,562,100,1121,561,560,100.2
35060, 김제시,075,70~74세,2017,5217,2301,2916,78.9,5210,2296,2914,78.8
35060, 김제시,075001, 70세,2017,1355,614,741,82.9,1354,613,741,82.7
35060, 김제시,075002, 71세,2017,975,463,512,90.4,973,462,511,90.4
35060, 김제시,075003, 72세,2017,914,400,514,77.8,912,398,514,77.4
35060, 김제시,075004, 73세,2017,938,389,549,70.9,938,389,549,70.9
35060, 김제시,075005, 74세,2017,1035,435,600,72.5,1033,434,599,72.5
35060, 김제시,080,75~79세,2017,5763,2268,3495,64.9,5763,2268,3495,64.9
35060, 김제시,080001, 75세,2017,1572,657,915,71.8,1572,657,915,71.8
35060, 김제시,080002, 76세,2017,1064,436,628,69.4,1064,436,628,69.4
35060, 김제시,080003, 77세,2017,1028,404,624,64.7,1028,404,624,64.7
35060, 김제시,080004, 78세,2017,1091,399,692,57.7,1091,399,692,57.7
35060, 김제시,080005, 79세,2017,1008,372,636,58.5,1008,372,636,58.5
35060, 김제시,085,80~84세,2017,4247,1422,2825,50.3,4242,1420,2822,50.3
35060, 김제시,085001, 80세,2017,963,352,611,57.6,962,352,610,57.7
35060, 김제시,085002, 81세,2017,860,287,573,50.1,859,287,572,50.2
35060, 김제시,085003, 82세,2017,888,314,574,54.7,886,313,573,54.6
35060, 김제시,085004, 83세,2017,780,252,528,47.7,780,252,528,47.7
35060, 김제시,085005, 84세,2017,756,217,539,40.3,755,216,539,40.1
35060, 김제시,090,85~89세,2017,2075,582,1493,39,2074,582,1492,39
35060, 김제시,090001, 85세,2017,561,164,397,41.3,561,164,397,41.3
35060, 김제시,090002, 86세,2017,421,135,286,47.2,421,135,286,47.2
35060, 김제시,090003, 87세,2017,437,106,331,32,436,106,330,32.1
35060, 김제시,090004, 88세,2017,353,99,254,39,353,99,254,39
35060, 김제시,090005, 89세,2017,303,78,225,34.7,303,78,225,34.7
35060, 김제시,095,90~94세,2017,605,149,456,32.7,605,149,456,32.7
35060, 김제시,095001, 90세,2017,213,50,163,30.7,213,50,163,30.7
35060, 김제시,095002, 91세,2017,145,42,103,40.8,145,42,103,40.8
35060, 김제시,095003, 92세,2017,100,25,75,33.3,100,25,75,33.3
35060, 김제시,095004, 93세,2017,81,21,60,35,81,21,60,35
35060, 김제시,095005, 94세,2017,66,11,55,20,66,11,55,20
35060, 김제시,100,95~99세,2017,125,22,103,21.4,125,22,103,21.4
35060, 김제시,100001, 95세,2017,50,8,42,19,50,8,42,19
35060, 김제시,100002, 96세,2017,33,5,28,17.9,33,5,28,17.9
35060, 김제시,100003, 97세,2017,27,7,20,35,27,7,20,35
35060, 김제시,100004, 98세,2017,8,X,8,0,8,X,8,0
35060, 김제시,100005, 99세,2017,7,X,5,40,7,X,5,40
35060, 김제시,101,100세이상,2017,13,X,12,8.3,13,X,12,8.3
35060, 김제시,102,15세미만,2017,8111,4129,3982,103.7,8089,4120,3969,103.8
35060, 김제시,103,15~64세,2017,50170,27150,23020,117.9,47994,25687,22307,115.2
35060, 김제시,104,65세이상,2017,24077,9588,14489,66.2,24028,9560,14468,66.1
35060, 김제시,086,85세이상,2017,2818,754,2064,36.5,2817,754,2063,36.5
35060, 김제시,126,평균연령,2017,49.5,46.8,52.1,,49.9,47.2,52.4,
35060, 김제시,127,중위연령,2017,52.7,49.1,56.3,,53.4,50.1,56.6,
35310, 완주군,000,합계,2017,98528,50529,47999,105.3,95623,48907,46716,104.7
35310, 완주군,005,0~4세,2017,4329,2176,2153,101.1,4313,2167,2146,101
35310, 완주군,005001, 0세,2017,731,361,370,97.6,729,360,369,97.6
35310, 완주군,005002, 1세,2017,803,404,399,101.3,796,399,397,100.5
35310, 완주군,005003, 2세,2017,943,485,458,105.9,938,483,455,106.2
35310, 완주군,005004, 3세,2017,874,435,439,99.1,873,434,439,98.9
35310, 완주군,005005, 4세,2017,978,491,487,100.8,977,491,486,101
35310, 완주군,010,5~9세,2017,4676,2455,2221,110.5,4669,2452,2217,110.6
35310, 완주군,010001, 5세,2017,1017,525,492,106.7,1014,523,491,106.5
35310, 완주군,010002, 6세,2017,955,518,437,118.5,954,518,436,118.8
35310, 완주군,010003, 7세,2017,951,518,433,119.6,949,518,431,120.2
35310, 완주군,010004, 8세,2017,839,414,425,97.4,839,414,425,97.4
35310, 완주군,010005, 9세,2017,914,480,434,110.6,913,479,434,110.4
35310, 완주군,015,10~14세,2017,4207,2224,1983,112.2,4200,2220,1980,112.1
35310, 완주군,015001, 10세,2017,914,464,450,103.1,913,464,449,103.3
35310, 완주군,015002, 11세,2017,819,438,381,115,817,436,381,114.4
35310, 완주군,015003, 12세,2017,769,387,382,101.3,768,386,382,101
35310, 완주군,015004, 13세,2017,870,481,389,123.7,869,480,389,123.4
35310, 완주군,015005, 14세,2017,835,454,381,119.2,833,454,379,119.8
35310, 완주군,020,15~19세,2017,6068,3241,2827,114.6,5949,3169,2780,114
35310, 완주군,020001, 15세,2017,827,437,390,112.1,824,437,387,112.9
35310, 완주군,020002, 16세,2017,999,505,494,102.2,997,505,492,102.6
35310, 완주군,020003, 17세,2017,1197,668,529,126.3,1193,667,526,126.8
35310, 완주군,020004, 18세,2017,1251,673,578,116.4,1234,664,570,116.5
35310, 완주군,020005, 19세,2017,1794,958,836,114.6,1701,896,805,111.3
35310, 완주군,025,20~24세,2017,7600,4271,3329,128.3,6896,3908,2988,130.8
35310, 완주군,025001, 20세,2017,1836,940,896,104.9,1702,857,845,101.4
35310, 완주군,025002, 21세,2017,1561,789,772,102.2,1419,722,697,103.6
35310, 완주군,025003, 22세,2017,1448,844,604,139.7,1305,777,528,147.2
35310, 완주군,025004, 23세,2017,1421,883,538,164.1,1286,815,471,173
35310, 완주군,025005, 24세,2017,1334,815,519,157,1184,737,447,164.9
35310, 완주군,030,25~29세,2017,4987,2759,2228,123.8,4373,2389,1984,120.4
35310, 완주군,030001, 25세,2017,1142,676,466,145.1,1006,596,410,145.4
35310, 완주군,030002, 26세,2017,1000,580,420,138.1,875,502,373,134.6
35310, 완주군,030003, 27세,2017,973,519,454,114.3,851,446,405,110.1
35310, 완주군,030004, 28세,2017,904,489,415,117.8,797,423,374,113.1
35310, 완주군,030005, 29세,2017,968,495,473,104.7,844,422,422,100
35310, 완주군,035,30~34세,2017,5567,2887,2680,107.7,5133,2638,2495,105.7
35310, 완주군,035001, 30세,2017,970,494,476,103.8,868,440,428,102.8
35310, 완주군,035002, 31세,2017,1030,532,498,106.8,941,484,457,105.9
35310, 완주군,035003, 32세,2017,1131,595,536,111,1042,541,501,108
35310, 완주군,035004, 33세,2017,1184,637,547,116.5,1100,585,515,113.6
35310, 완주군,035005, 34세,2017,1252,629,623,101,1182,588,594,99
35310, 완주군,040,35~39세,2017,7184,3878,3306,117.3,6921,3717,3204,116
35310, 완주군,040001, 35세,2017,1514,794,720,110.3,1446,754,692,109
35310, 완주군,040002, 36세,2017,1438,759,679,111.8,1376,719,657,109.4
35310, 완주군,040003, 37세,2017,1558,851,707,120.4,1508,818,690,118.6
35310, 완주군,040004, 38세,2017,1408,769,639,120.3,1366,746,620,120.3
35310, 완주군,040005, 39세,2017,1266,705,561,125.7,1225,680,545,124.8
35310, 완주군,045,40~44세,2017,6793,3770,3023,124.7,6625,3677,2948,124.7
35310, 완주군,045001, 40세,2017,1291,689,602,114.5,1262,672,590,113.9
35310, 완주군,045002, 41세,2017,1307,728,579,125.7,1264,702,562,124.9
35310, 완주군,045003, 42세,2017,1324,749,575,130.3,1290,732,558,131.2
35310, 완주군,045004, 43세,2017,1469,832,637,130.6,1432,811,621,130.6
35310, 완주군,045005, 44세,2017,1402,772,630,122.5,1377,760,617,123.2
35310, 완주군,050,45~49세,2017,7169,4029,3140,128.3,6996,3931,3065,128.3
35310, 완주군,050001, 45세,2017,1411,800,611,130.9,1369,777,592,131.3
35310, 완주군,050002, 46세,2017,1540,865,675,128.1,1504,849,655,129.6
35310, 완주군,050003, 47세,2017,1342,758,584,129.8,1304,732,572,128
35310, 완주군,050004, 48세,2017,1326,724,602,120.3,1300,708,592,119.6
35310, 완주군,050005, 49세,2017,1550,882,668,132,1519,865,654,132.3
35310, 완주군,055,50~54세,2017,6740,3654,3086,118.4,6575,3570,3005,118.8
35310, 완주군,055001, 50세,2017,1304,713,591,120.6,1271,696,575,121
35310, 완주군,055002, 51세,2017,1374,769,605,127.1,1345,754,591,127.6
35310, 완주군,055003, 52세,2017,1361,721,640,112.7,1329,708,621,114
35310, 완주군,055004, 53세,2017,1311,725,586,123.7,1274,703,571,123.1
35310, 완주군,055005, 54세,2017,1390,726,664,109.3,1356,709,647,109.6
35310, 완주군,060,55~59세,2017,7729,4021,3708,108.4,7632,3967,3665,108.2
35310, 완주군,060001, 55세,2017,1536,820,716,114.5,1514,809,705,114.8
35310, 완주군,060002, 56세,2017,1673,861,812,106,1651,851,800,106.4
35310, 완주군,060003, 57세,2017,1717,882,835,105.6,1699,870,829,104.9
35310, 완주군,060004, 58세,2017,1450,756,694,108.9,1434,747,687,108.7
35310, 완주군,060005, 59세,2017,1353,702,651,107.8,1334,690,644,107.1
35310, 완주군,065,60~64세,2017,6440,3259,3181,102.5,6366,3225,3141,102.7
35310, 완주군,065001, 60세,2017,1385,684,701,97.6,1365,674,691,97.5
35310, 완주군,065002, 61세,2017,1400,728,672,108.3,1379,721,658,109.6
35310, 완주군,065003, 62세,2017,1398,712,686,103.8,1386,706,680,103.8
35310, 완주군,065004, 63세,2017,1278,620,658,94.2,1271,615,656,93.8
35310, 완주군,065005, 64세,2017,979,515,464,111,965,509,456,111.6
35310, 완주군,070,65~69세,2017,5178,2572,2606,98.7,5150,2558,2592,98.7
35310, 완주군,070001, 65세,2017,1093,553,540,102.4,1083,549,534,102.8
35310, 완주군,070002, 66세,2017,978,492,486,101.2,976,491,485,101.2
35310, 완주군,070003, 67세,2017,1142,568,574,99,1135,566,569,99.5
35310, 완주군,070004, 68세,2017,989,485,504,96.2,983,481,502,95.8
35310, 완주군,070005, 69세,2017,976,474,502,94.4,973,471,502,93.8
35310, 완주군,075,70~74세,2017,4223,1961,2262,86.7,4201,1952,2249,86.8
35310, 완주군,075001, 70세,2017,1069,529,540,98,1061,527,534,98.7
35310, 완주군,075002, 71세,2017,852,434,418,103.8,848,432,416,103.8
35310, 완주군,075003, 72세,2017,740,321,419,76.6,735,317,418,75.8
35310, 완주군,075004, 73세,2017,780,350,430,81.4,778,350,428,81.8
35310, 완주군,075005, 74세,2017,782,327,455,71.9,779,326,453,72
35310, 완주군,080,75~79세,2017,4484,1781,2703,65.9,4476,1778,2698,65.9
35310, 완주군,080001, 75세,2017,1228,498,730,68.2,1225,497,728,68.3
35310, 완주군,080002, 76세,2017,827,345,482,71.6,825,345,480,71.9
35310, 완주군,080003, 77세,2017,779,304,475,64,778,303,475,63.8
35310, 완주군,080004, 78세,2017,827,322,505,63.8,826,321,505,63.6
35310, 완주군,080005, 79세,2017,823,312,511,61.1,822,312,510,61.2
35310, 완주군,085,80~84세,2017,3056,1064,1992,53.4,3051,1062,1989,53.4
35310, 완주군,085001, 80세,2017,694,247,447,55.3,692,247,445,55.5
35310, 완주군,085002, 81세,2017,680,248,432,57.4,680,248,432,57.4
35310, 완주군,085003, 82세,2017,667,227,440,51.6,666,226,440,51.4
35310, 완주군,085004, 83세,2017,551,197,354,55.6,550,196,354,55.4
35310, 완주군,085005, 84세,2017,464,145,319,45.5,463,145,318,45.6
35310, 완주군,090,85~89세,2017,1456,392,1064,36.8,1455,392,1063,36.9
35310, 완주군,090001, 85세,2017,368,114,254,44.9,368,114,254,44.9
35310, 완주군,090002, 86세,2017,343,94,249,37.8,343,94,249,37.8
35310, 완주군,090003, 87세,2017,300,78,222,35.1,299,78,221,35.3
35310, 완주군,090004, 88세,2017,246,53,193,27.5,246,53,193,27.5
35310, 완주군,090005, 89세,2017,199,53,146,36.3,199,53,146,36.3
35310, 완주군,095,90~94세,2017,520,106,414,25.6,520,106,414,25.6
35310, 완주군,095001, 90세,2017,193,47,146,32.2,193,47,146,32.2
35310, 완주군,095002, 91세,2017,119,21,98,21.4,119,21,98,21.4
35310, 완주군,095003, 92세,2017,86,19,67,28.4,86,19,67,28.4
35310, 완주군,095004, 93세,2017,52,10,42,23.8,52,10,42,23.8
35310, 완주군,095005, 94세,2017,70,9,61,14.8,70,9,61,14.8
35310, 완주군,100,95~99세,2017,107,26,81,32.1,107,26,81,32.1
35310, 완주군,100001, 95세,2017,39,7,32,21.9,39,7,32,21.9
35310, 완주군,100002, 96세,2017,20,6,14,42.9,20,6,14,42.9
35310, 완주군,100003, 97세,2017,24,7,17,41.2,24,7,17,41.2
35310, 완주군,100004, 98세,2017,14,X,12,16.7,14,X,12,16.7
35310, 완주군,100005, 99세,2017,10,X,6,66.7,10,X,6,66.7
35310, 완주군,101,100세이상,2017,15,X,12,25,15,X,12,25
35310, 완주군,102,15세미만,2017,13212,6855,6357,107.8,13182,6839,6343,107.8
35310, 완주군,103,15~64세,2017,66277,35769,30508,117.2,63466,34191,29275,116.8
35310, 완주군,104,65세이상,2017,19039,7905,11134,71,18975,7877,11098,71
35310, 완주군,086,85세이상,2017,2098,527,1571,33.5,2097,527,1570,33.6
35310, 완주군,126,평균연령,2017,43,41.3,44.7,,43.2,41.5,45,
35310, 완주군,127,중위연령,2017,43.5,41.9,45.4,,44.1,42.6,46,
35320, 진안군,000,합계,2017,22998,11388,11610,98.1,22582,11225,11357,98.8
35320, 진안군,005,0~4세,2017,744,364,380,95.8,743,364,379,96
35320, 진안군,005001, 0세,2017,144,91,53,171.7,143,91,52,175
35320, 진안군,005002, 1세,2017,165,77,88,87.5,165,77,88,87.5
35320, 진안군,005003, 2세,2017,150,64,86,74.4,150,64,86,74.4
35320, 진안군,005004, 3세,2017,151,68,83,81.9,151,68,83,81.9
35320, 진안군,005005, 4세,2017,134,64,70,91.4,134,64,70,91.4
35320, 진안군,010,5~9세,2017,740,381,359,106.1,738,380,358,106.1
35320, 진안군,010001, 5세,2017,166,82,84,97.6,165,82,83,98.8
35320, 진안군,010002, 6세,2017,161,88,73,120.5,161,88,73,120.5
35320, 진안군,010003, 7세,2017,151,78,73,106.8,151,78,73,106.8
35320, 진안군,010004, 8세,2017,133,67,66,101.5,132,66,66,100
35320, 진안군,010005, 9세,2017,129,66,63,104.8,129,66,63,104.8
35320, 진안군,015,10~14세,2017,719,380,339,112.1,718,379,339,111.8
35320, 진안군,015001, 10세,2017,140,74,66,112.1,139,73,66,110.6
35320, 진안군,015002, 11세,2017,156,76,80,95,156,76,80,95
35320, 진안군,015003, 12세,2017,129,73,56,130.4,129,73,56,130.4
35320, 진안군,015004, 13세,2017,142,75,67,111.9,142,75,67,111.9
35320, 진안군,015005, 14세,2017,152,82,70,117.1,152,82,70,117.1
35320, 진안군,020,15~19세,2017,906,504,402,125.4,893,499,394,126.6
35320, 진안군,020001, 15세,2017,144,78,66,118.2,143,78,65,120
35320, 진안군,020002, 16세,2017,201,109,92,118.5,200,109,91,119.8
35320, 진안군,020003, 17세,2017,216,123,93,132.3,216,123,93,132.3
35320, 진안군,020004, 18세,2017,206,107,99,108.1,202,106,96,110.4
35320, 진안군,020005, 19세,2017,139,87,52,167.3,132,83,49,169.4
35320, 진안군,025,20~24세,2017,893,516,377,136.9,836,490,346,141.6
35320, 진안군,025001, 20세,2017,187,115,72,159.7,182,113,69,163.8
35320, 진안군,025002, 21세,2017,199,120,79,151.9,183,111,72,154.2
35320, 진안군,025003, 22세,2017,183,111,72,154.2,173,106,67,158.2
35320, 진안군,025004, 23세,2017,162,89,73,121.9,152,86,66,130.3
35320, 진안군,025005, 24세,2017,162,81,81,100,146,74,72,102.8
35320, 진안군,030,25~29세,2017,818,422,396,106.6,752,401,351,114.2
35320, 진안군,030001, 25세,2017,165,82,83,98.8,153,80,73,109.6
35320, 진안군,030002, 26세,2017,175,95,80,118.8,162,90,72,125
35320, 진안군,030003, 27세,2017,185,96,89,107.9,168,90,78,115.4
35320, 진안군,030004, 28세,2017,142,78,64,121.9,130,75,55,136.4
35320, 진안군,030005, 29세,2017,151,71,80,88.8,139,66,73,90.4
35320, 진안군,035,30~34세,2017,833,395,438,90.2,758,367,391,93.9
35320, 진안군,035001, 30세,2017,154,74,80,92.5,138,68,70,97.1
35320, 진안군,035002, 31세,2017,161,76,85,89.4,142,69,73,94.5
35320, 진안군,035003, 32세,2017,161,73,88,83,144,68,76,89.5
35320, 진안군,035004, 33세,2017,174,80,94,85.1,163,77,86,89.5
35320, 진안군,035005, 34세,2017,183,92,91,101.1,171,85,86,98.8
35320, 진안군,040,35~39세,2017,1002,525,477,110.1,957,503,454,110.8
35320, 진안군,040001, 35세,2017,194,93,101,92.1,182,87,95,91.6
35320, 진안군,040002, 36세,2017,193,101,92,109.8,184,96,88,109.1
35320, 진안군,040003, 37세,2017,233,122,111,109.9,227,119,108,110.2
35320, 진안군,040004, 38세,2017,197,104,93,111.8,186,100,86,116.3
35320, 진안군,040005, 39세,2017,185,105,80,131.3,178,101,77,131.2
35320, 진안군,045,40~44세,2017,1248,708,540,131.1,1218,698,520,134.2
35320, 진안군,045001, 40세,2017,236,144,92,156.5,228,143,85,168.2
35320, 진안군,045002, 41세,2017,215,116,99,117.2,214,116,98,118.4
35320, 진안군,045003, 42세,2017,227,123,104,118.3,219,119,100,119
35320, 진안군,045004, 43세,2017,296,182,114,159.6,289,180,109,165.1
35320, 진안군,045005, 44세,2017,274,143,131,109.2,268,140,128,109.4
35320, 진안군,050,45~49세,2017,1508,867,641,135.3,1484,858,626,137.1
35320, 진안군,050001, 45세,2017,284,175,109,160.6,280,175,105,166.7
35320, 진안군,050002, 46세,2017,281,169,112,150.9,276,166,110,150.9
35320, 진안군,050003, 47세,2017,310,162,148,109.5,300,158,142,111.3
35320, 진안군,050004, 48세,2017,316,187,129,145,313,186,127,146.5
35320, 진안군,050005, 49세,2017,317,174,143,121.7,315,173,142,121.8
35320, 진안군,055,50~54세,2017,1733,965,768,125.7,1692,953,739,129
35320, 진안군,055001, 50세,2017,336,196,140,140,329,195,134,145.5
35320, 진안군,055002, 51세,2017,337,192,145,132.4,330,190,140,135.7
35320, 진안군,055003, 52세,2017,363,203,160,126.9,351,198,153,129.4
35320, 진안군,055004, 53세,2017,336,176,160,110,329,174,155,112.3
35320, 진안군,055005, 54세,2017,361,198,163,121.5,353,196,157,124.8
35320, 진안군,060,55~59세,2017,2253,1182,1071,110.4,2222,1166,1056,110.4
35320, 진안군,060001, 55세,2017,415,224,191,117.3,400,216,184,117.4
35320, 진안군,060002, 56세,2017,490,271,219,123.7,487,269,218,123.4
35320, 진안군,060003, 57세,2017,512,270,242,111.6,508,267,241,110.8
35320, 진안군,060004, 58세,2017,443,227,216,105.1,439,224,215,104.2
35320, 진안군,060005, 59세,2017,393,190,203,93.6,388,190,198,96
35320, 진안군,065,60~64세,2017,2025,1035,990,104.5,2008,1031,977,105.5
35320, 진안군,065001, 60세,2017,418,226,192,117.7,412,225,187,120.3
35320, 진안군,065002, 61세,2017,414,208,206,101,409,206,203,101.5
35320, 진안군,065003, 62세,2017,442,223,219,101.8,438,222,216,102.8
35320, 진안군,065004, 63세,2017,405,211,194,108.8,404,211,193,109.3
35320, 진안군,065005, 64세,2017,346,167,179,93.3,345,167,178,93.8
35320, 진안군,070,65~69세,2017,1868,914,954,95.8,1859,908,951,95.5
35320, 진안군,070001, 65세,2017,372,198,174,113.8,371,197,174,113.2
35320, 진안군,070002, 66세,2017,298,145,153,94.8,295,144,151,95.4
35320, 진안군,070003, 67세,2017,423,199,224,88.8,422,198,224,88.4
35320, 진안군,070004, 68세,2017,391,187,204,91.7,389,186,203,91.6
35320, 진안군,070005, 69세,2017,384,185,199,93,382,183,199,92
35320, 진안군,075,70~74세,2017,1677,769,908,84.7,1675,768,907,84.7
35320, 진안군,075001, 70세,2017,382,181,201,90,382,181,201,90
35320, 진안군,075002, 71세,2017,312,152,160,95,311,151,160,94.4
35320, 진안군,075003, 72세,2017,349,170,179,95,348,170,178,95.5
35320, 진안군,075004, 73세,2017,289,132,157,84.1,289,132,157,84.1
35320, 진안군,075005, 74세,2017,345,134,211,63.5,345,134,211,63.5
35320, 진안군,080,75~79세,2017,1883,761,1122,67.8,1883,761,1122,67.8
35320, 진안군,080001, 75세,2017,494,229,265,86.4,494,229,265,86.4
35320, 진안군,080002, 76세,2017,356,146,210,69.5,356,146,210,69.5
35320, 진안군,080003, 77세,2017,343,138,205,67.3,343,138,205,67.3
35320, 진안군,080004, 78세,2017,362,131,231,56.7,362,131,231,56.7
35320, 진안군,080005, 79세,2017,328,117,211,55.5,328,117,211,55.5
35320, 진안군,085,80~84세,2017,1362,473,889,53.2,1361,473,888,53.3
35320, 진안군,085001, 80세,2017,317,108,209,51.7,317,108,209,51.7
35320, 진안군,085002, 81세,2017,318,115,203,56.7,318,115,203,56.7
35320, 진안군,085003, 82세,2017,276,96,180,53.3,276,96,180,53.3
35320, 진안군,085004, 83세,2017,246,83,163,50.9,245,83,162,51.2
35320, 진안군,085005, 84세,2017,205,71,134,53,205,71,134,53
35320, 진안군,090,85~89세,2017,571,170,401,42.4,570,169,401,42.1
35320, 진안군,090001, 85세,2017,177,57,120,47.5,177,57,120,47.5
35320, 진안군,090002, 86세,2017,111,30,81,37,111,30,81,37
35320, 진안군,090003, 87세,2017,116,30,86,34.9,115,29,86,33.7
35320, 진안군,090004, 88세,2017,105,38,67,56.7,105,38,67,56.7
35320, 진안군,090005, 89세,2017,62,15,47,31.9,62,15,47,31.9
35320, 진안군,095,90~94세,2017,175,49,126,38.9,175,49,126,38.9
35320, 진안군,095001, 90세,2017,65,20,45,44.4,65,20,45,44.4
35320, 진안군,095002, 91세,2017,35,10,25,40,35,10,25,40
35320, 진안군,095003, 92세,2017,33,10,23,43.5,33,10,23,43.5
35320, 진안군,095004, 93세,2017,24,6,18,33.3,24,6,18,33.3
35320, 진안군,095005, 94세,2017,18,X,15,20,18,X,15,20
35320, 진안군,100,95~99세,2017,35,8,27,29.6,35,8,27,29.6
35320, 진안군,100001, 95세,2017,17,X,13,30.8,17,X,13,30.8
35320, 진안군,100002, 96세,2017,10,X,7,42.9,10,X,7,42.9
35320, 진안군,100003, 97세,2017,7,X,6,16.7,7,X,6,16.7
35320, 진안군,100004, 98세,2017,X,X,X,,X,X,X,
35320, 진안군,100005, 99세,2017,X,X,X,0,X,X,X,0
35320, 진안군,101,100세이상,2017,5,X,5,0,5,X,5,0
35320, 진안군,102,15세미만,2017,2203,1125,1078,104.4,2199,1123,1076,104.4
35320, 진안군,103,15~64세,2017,13219,7119,6100,116.7,12820,6966,5854,119
35320, 진안군,104,65세이상,2017,7576,3144,4432,70.9,7563,3136,4427,70.8
35320, 진안군,086,85세이상,2017,786,227,559,40.6,785,226,559,40.4
35320, 진안군,126,평균연령,2017,51.6,49.4,53.7,,51.8,49.5,54.1,
35320, 진안군,127,중위연령,2017,55.9,53.2,58.2,,56.2,53.5,58.6,
35330, 무주군,000,합계,2017,23195,11478,11717,98,22912,11382,11530,98.7
35330, 무주군,005,0~4세,2017,621,340,281,121,621,340,281,121
35330, 무주군,005001, 0세,2017,101,46,55,83.6,101,46,55,83.6
35330, 무주군,005002, 1세,2017,115,63,52,121.2,115,63,52,121.2
35330, 무주군,005003, 2세,2017,129,70,59,118.6,129,70,59,118.6
35330, 무주군,005004, 3세,2017,142,91,51,178.4,142,91,51,178.4
35330, 무주군,005005, 4세,2017,134,70,64,109.4,134,70,64,109.4
35330, 무주군,010,5~9세,2017,823,423,400,105.8,823,423,400,105.8
35330, 무주군,010001, 5세,2017,145,78,67,116.4,145,78,67,116.4
35330, 무주군,010002, 6세,2017,193,105,88,119.3,193,105,88,119.3
35330, 무주군,010003, 7세,2017,144,75,69,108.7,144,75,69,108.7
35330, 무주군,010004, 8세,2017,176,78,98,79.6,176,78,98,79.6
35330, 무주군,010005, 9세,2017,165,87,78,111.5,165,87,78,111.5
35330, 무주군,015,10~14세,2017,811,403,408,98.8,811,403,408,98.8
35330, 무주군,015001, 10세,2017,189,88,101,87.1,189,88,101,87.1
35330, 무주군,015002, 11세,2017,163,86,77,111.7,163,86,77,111.7
35330, 무주군,015003, 12세,2017,164,74,90,82.2,164,74,90,82.2
35330, 무주군,015004, 13세,2017,156,84,72,116.7,156,84,72,116.7
35330, 무주군,015005, 14세,2017,139,71,68,104.4,139,71,68,104.4
35330, 무주군,020,15~19세,2017,947,525,422,124.4,946,524,422,124.2
35330, 무주군,020001, 15세,2017,191,91,100,91,191,91,100,91
35330, 무주군,020002, 16세,2017,227,126,101,124.8,226,125,101,123.8
35330, 무주군,020003, 17세,2017,224,129,95,135.8,224,129,95,135.8
35330, 무주군,020004, 18세,2017,179,99,80,123.8,179,99,80,123.8
35330, 무주군,020005, 19세,2017,126,80,46,173.9,126,80,46,173.9
35330, 무주군,025,20~24세,2017,889,551,338,163,857,539,318,169.5
35330, 무주군,025001, 20세,2017,168,114,54,211.1,162,114,48,237.5
35330, 무주군,025002, 21세,2017,165,120,45,266.7,161,118,43,274.4
35330, 무주군,025003, 22세,2017,206,128,78,164.1,203,127,76,167.1
35330, 무주군,025004, 23세,2017,173,98,75,130.7,166,96,70,137.1
35330, 무주군,025005, 24세,2017,177,91,86,105.8,165,84,81,103.7
35330, 무주군,030,25~29세,2017,843,457,386,118.4,799,442,357,123.8
35330, 무주군,030001, 25세,2017,177,85,92,92.4,168,83,85,97.6
35330, 무주군,030002, 26세,2017,197,105,92,114.1,189,103,86,119.8
35330, 무주군,030003, 27세,2017,159,96,63,152.4,155,94,61,154.1
35330, 무주군,030004, 28세,2017,157,90,67,134.3,148,87,61,142.6
35330, 무주군,030005, 29세,2017,153,81,72,112.5,139,75,64,117.2
35330, 무주군,035,30~34세,2017,841,425,416,102.2,800,420,380,110.5
35330, 무주군,035001, 30세,2017,183,90,93,96.8,171,89,82,108.5
35330, 무주군,035002, 31세,2017,165,91,74,123,153,87,66,131.8
35330, 무주군,035003, 32세,2017,152,77,75,102.7,146,77,69,111.6
35330, 무주군,035004, 33세,2017,156,66,90,73.3,151,66,85,77.6
35330, 무주군,035005, 34세,2017,185,101,84,120.2,179,101,78,129.5
35330, 무주군,040,35~39세,2017,1084,562,522,107.7,1056,553,503,109.9
35330, 무주군,040001, 35세,2017,193,108,85,127.1,185,107,78,137.2
35330, 무주군,040002, 36세,2017,223,108,115,93.9,212,103,109,94.5
35330, 무주군,040003, 37세,2017,227,117,110,106.4,226,116,110,105.5
35330, 무주군,040004, 38세,2017,227,126,101,124.8,224,124,100,124
35330, 무주군,040005, 39세,2017,214,103,111,92.8,209,103,106,97.2
35330, 무주군,045,40~44세,2017,1401,777,624,124.5,1375,767,608,126.2
35330, 무주군,045001, 40세,2017,244,130,114,114,241,128,113,113.3
35330, 무주군,045002, 41세,2017,258,133,125,106.4,249,131,118,111
35330, 무주군,045003, 42세,2017,266,158,108,146.3,259,156,103,151.5
35330, 무주군,045004, 43세,2017,324,171,153,111.8,321,171,150,114
35330, 무주군,045005, 44세,2017,309,185,124,149.2,305,181,124,146
35330, 무주군,050,45~49세,2017,1607,934,673,138.8,1580,927,653,142
35330, 무주군,050001, 45세,2017,267,157,110,142.7,262,157,105,149.5
35330, 무주군,050002, 46세,2017,332,191,141,135.5,328,190,138,137.7
35330, 무주군,050003, 47세,2017,310,184,126,146,304,182,122,149.2
35330, 무주군,050004, 48세,2017,332,181,151,119.9,326,179,147,121.8
35330, 무주군,050005, 49세,2017,366,221,145,152.4,360,219,141,155.3
35330, 무주군,055,50~54세,2017,1757,967,790,122.4,1727,957,770,124.3
35330, 무주군,055001, 50세,2017,371,205,166,123.5,365,202,163,123.9
35330, 무주군,055002, 51세,2017,361,195,166,117.5,353,192,161,119.3
35330, 무주군,055003, 52세,2017,355,198,157,126.1,352,197,155,127.1
35330, 무주군,055004, 53세,2017,322,176,146,120.5,315,173,142,121.8
35330, 무주군,055005, 54세,2017,348,193,155,124.5,342,193,149,129.5
35330, 무주군,060,55~59세,2017,2272,1178,1094,107.7,2248,1168,1080,108.1
35330, 무주군,060001, 55세,2017,464,242,222,109,458,240,218,110.1
35330, 무주군,060002, 56세,2017,471,249,222,112.2,468,248,220,112.7
35330, 무주군,060003, 57세,2017,474,244,230,106.1,468,241,227,106.2
35330, 무주군,060004, 58세,2017,436,230,206,111.7,433,228,205,111.2
35330, 무주군,060005, 59세,2017,427,213,214,99.5,421,211,210,100.5
35330, 무주군,065,60~64세,2017,1978,1014,964,105.2,1958,1003,955,105
35330, 무주군,065001, 60세,2017,450,229,221,103.6,444,226,218,103.7
35330, 무주군,065002, 61세,2017,379,203,176,115.3,375,201,174,115.5
35330, 무주군,065003, 62세,2017,437,224,213,105.2,433,221,212,104.2
35330, 무주군,065004, 63세,2017,423,218,205,106.3,419,216,203,106.4
35330, 무주군,065005, 64세,2017,289,140,149,94,287,139,148,93.9
35330, 무주군,070,65~69세,2017,1696,794,902,88,1689,791,898,88.1
35330, 무주군,070001, 65세,2017,377,183,194,94.3,375,182,193,94.3
35330, 무주군,070002, 66세,2017,331,153,178,86,329,152,177,85.9
35330, 무주군,070003, 67세,2017,364,165,199,82.9,363,165,198,83.3
35330, 무주군,070004, 68세,2017,279,139,140,99.3,279,139,140,99.3
35330, 무주군,070005, 69세,2017,345,154,191,80.6,343,153,190,80.5
35330, 무주군,075,70~74세,2017,1569,654,915,71.5,1566,651,915,71.1
35330, 무주군,075001, 70세,2017,353,154,199,77.4,352,153,199,76.9
35330, 무주군,075002, 71세,2017,314,130,184,70.7,314,130,184,70.7
35330, 무주군,075003, 72세,2017,265,108,157,68.8,265,108,157,68.8
35330, 무주군,075004, 73세,2017,283,129,154,83.8,283,129,154,83.8
35330, 무주군,075005, 74세,2017,354,133,221,60.2,352,131,221,59.3
35330, 무주군,080,75~79세,2017,1915,773,1142,67.7,1915,773,1142,67.7
35330, 무주군,080001, 75세,2017,476,184,292,63,476,184,292,63
35330, 무주군,080002, 76세,2017,398,170,228,74.6,398,170,228,74.6
35330, 무주군,080003, 77세,2017,350,152,198,76.8,350,152,198,76.8
35330, 무주군,080004, 78세,2017,352,129,223,57.8,352,129,223,57.8
35330, 무주군,080005, 79세,2017,339,138,201,68.7,339,138,201,68.7
35330, 무주군,085,80~84세,2017,1313,464,849,54.7,1313,464,849,54.7
35330, 무주군,085001, 80세,2017,313,116,197,58.9,313,116,197,58.9
35330, 무주군,085002, 81세,2017,294,116,178,65.2,294,116,178,65.2
35330, 무주군,085003, 82세,2017,267,92,175,52.6,267,92,175,52.6
35330, 무주군,085004, 83세,2017,231,73,158,46.2,231,73,158,46.2
35330, 무주군,085005, 84세,2017,208,67,141,47.5,208,67,141,47.5
35330, 무주군,090,85~89세,2017,583,168,415,40.5,583,168,415,40.5
35330, 무주군,090001, 85세,2017,166,57,109,52.3,166,57,109,52.3
35330, 무주군,090002, 86세,2017,134,46,88,52.3,134,46,88,52.3
35330, 무주군,090003, 87세,2017,110,25,85,29.4,110,25,85,29.4
35330, 무주군,090004, 88세,2017,93,21,72,29.2,93,21,72,29.2
35330, 무주군,090005, 89세,2017,80,19,61,31.1,80,19,61,31.1
35330, 무주군,095,90~94세,2017,190,57,133,42.9,190,57,133,42.9
35330, 무주군,095001, 90세,2017,62,21,41,51.2,62,21,41,51.2
35330, 무주군,095002, 91세,2017,53,13,40,32.5,53,13,40,32.5
35330, 무주군,095003, 92세,2017,37,11,26,42.3,37,11,26,42.3
35330, 무주군,095004, 93세,2017,20,6,14,42.9,20,6,14,42.9
35330, 무주군,095005, 94세,2017,18,6,12,50,18,6,12,50
35330, 무주군,100,95~99세,2017,49,11,38,28.9,49,11,38,28.9
35330, 무주군,100001, 95세,2017,18,7,11,63.6,18,7,11,63.6
35330, 무주군,100002, 96세,2017,9,X,7,28.6,9,X,7,28.6
35330, 무주군,100003, 97세,2017,16,X,15,6.7,16,X,15,6.7
35330, 무주군,100004, 98세,2017,X,X,X,33.3,X,X,X,33.3
35330, 무주군,100005, 99세,2017,X,X,X,0,X,X,X,0
35330, 무주군,101,100세이상,2017,6,X,5,20,6,X,5,20
35330, 무주군,102,15세미만,2017,2255,1166,1089,107.1,2255,1166,1089,107.1
35330, 무주군,103,15~64세,2017,13619,7390,6229,118.6,13346,7300,6046,120.7
35330, 무주군,104,65세이상,2017,7321,2922,4399,66.4,7311,2916,4395,66.3
35330, 무주군,086,85세이상,2017,828,237,591,40.1,828,237,591,40.1
35330, 무주군,126,평균연령,2017,51.1,48.5,53.6,,51.2,48.6,53.9,
35330, 무주군,127,중위연령,2017,54.9,51.7,57.7,,55.1,51.8,58,
35340, 장수군,000,합계,2017,21395,10544,10851,97.2,20935,10326,10609,97.3
35340, 장수군,005,0~4세,2017,634,332,302,109.9,632,331,301,110
35340, 장수군,005001, 0세,2017,99,47,52,90.4,99,47,52,90.4
35340, 장수군,005002, 1세,2017,121,71,50,142,119,70,49,142.9
35340, 장수군,005003, 2세,2017,122,60,62,96.8,122,60,62,96.8
35340, 장수군,005004, 3세,2017,129,63,66,95.5,129,63,66,95.5
35340, 장수군,005005, 4세,2017,163,91,72,126.4,163,91,72,126.4
35340, 장수군,010,5~9세,2017,802,414,388,106.7,802,414,388,106.7
35340, 장수군,010001, 5세,2017,149,77,72,106.9,149,77,72,106.9
35340, 장수군,010002, 6세,2017,173,86,87,98.9,173,86,87,98.9
35340, 장수군,010003, 7세,2017,156,82,74,110.8,156,82,74,110.8
35340, 장수군,010004, 8세,2017,144,81,63,128.6,144,81,63,128.6
35340, 장수군,010005, 9세,2017,180,88,92,95.7,180,88,92,95.7
35340, 장수군,015,10~14세,2017,771,378,393,96.2,771,378,393,96.2
35340, 장수군,015001, 10세,2017,169,81,88,92,169,81,88,92
35340, 장수군,015002, 11세,2017,134,69,65,106.2,134,69,65,106.2
35340, 장수군,015003, 12세,2017,164,83,81,102.5,164,83,81,102.5
35340, 장수군,015004, 13세,2017,150,69,81,85.2,150,69,81,85.2
35340, 장수군,015005, 14세,2017,154,76,78,97.4,154,76,78,97.4
35340, 장수군,020,15~19세,2017,956,514,442,116.3,951,513,438,117.1
35340, 장수군,020001, 15세,2017,150,82,68,120.6,150,82,68,120.6
35340, 장수군,020002, 16세,2017,225,114,111,102.7,225,114,111,102.7
35340, 장수군,020003, 17세,2017,256,118,138,85.5,256,118,138,85.5
35340, 장수군,020004, 18세,2017,184,104,80,130,184,104,80,130
35340, 장수군,020005, 19세,2017,141,96,45,213.3,136,95,41,231.7
35340, 장수군,025,20~24세,2017,837,502,335,149.9,781,476,305,156.1
35340, 장수군,025001, 20세,2017,167,110,57,193,163,108,55,196.4
35340, 장수군,025002, 21세,2017,185,111,74,150,170,101,69,146.4
35340, 장수군,025003, 22세,2017,171,100,71,140.8,162,96,66,145.5
35340, 장수군,025004, 23세,2017,171,96,75,128,156,91,65,140
35340, 장수군,025005, 24세,2017,143,85,58,146.6,130,80,50,160
35340, 장수군,030,25~29세,2017,822,451,371,121.6,713,391,322,121.4
35340, 장수군,030001, 25세,2017,158,79,79,100,143,74,69,107.2
35340, 장수군,030002, 26세,2017,173,96,77,124.7,147,81,66,122.7
35340, 장수군,030003, 27세,2017,163,87,76,114.5,140,73,67,109
35340, 장수군,030004, 28세,2017,168,93,75,124,146,83,63,131.7
35340, 장수군,030005, 29세,2017,160,96,64,150,137,80,57,140.4
35340, 장수군,035,30~34세,2017,844,442,402,110,757,403,354,113.8
35340, 장수군,035001, 30세,2017,162,82,80,102.5,144,73,71,102.8
35340, 장수군,035002, 31세,2017,194,106,88,120.5,177,96,81,118.5
35340, 장수군,035003, 32세,2017,143,67,76,88.2,124,61,63,96.8
35340, 장수군,035004, 33세,2017,163,81,82,98.8,141,73,68,107.4
35340, 장수군,035005, 34세,2017,182,106,76,139.5,171,100,71,140.8
35340, 장수군,040,35~39세,2017,1031,553,478,115.7,986,524,462,113.4
35340, 장수군,040001, 35세,2017,188,96,92,104.3,176,90,86,104.7
35340, 장수군,040002, 36세,2017,194,102,92,110.9,184,95,89,106.7
35340, 장수군,040003, 37세,2017,232,122,110,110.9,223,115,108,106.5
35340, 장수군,040004, 38세,2017,218,125,93,134.4,209,119,90,132.2
35340, 장수군,040005, 39세,2017,199,108,91,118.7,194,105,89,118
35340, 장수군,045,40~44세,2017,1151,652,499,130.7,1123,635,488,130.1
35340, 장수군,045001, 40세,2017,233,135,98,137.8,226,130,96,135.4
35340, 장수군,045002, 41세,2017,194,101,93,108.6,187,99,88,112.5
35340, 장수군,045003, 42세,2017,212,123,89,138.2,208,119,89,133.7
35340, 장수군,045004, 43세,2017,239,133,106,125.5,235,131,104,126
35340, 장수군,045005, 44세,2017,273,160,113,141.6,267,156,111,140.5
35340, 장수군,050,45~49세,2017,1478,818,660,123.9,1435,801,634,126.3
35340, 장수군,050001, 45세,2017,258,135,123,109.8,246,131,115,113.9
35340, 장수군,050002, 46세,2017,306,178,128,139.1,299,175,124,141.1
35340, 장수군,050003, 47세,2017,254,146,108,135.2,246,142,104,136.5
35340, 장수군,050004, 48세,2017,314,177,137,129.2,309,174,135,128.9
35340, 장수군,050005, 49세,2017,346,182,164,111,335,179,156,114.7
35340, 장수군,055,50~54세,2017,1539,848,691,122.7,1513,842,671,125.5
35340, 장수군,055001, 50세,2017,313,174,139,125.2,308,174,134,129.9
35340, 장수군,055002, 51세,2017,303,164,139,118,297,164,133,123.3
35340, 장수군,055003, 52세,2017,362,207,155,133.5,356,203,153,132.7
35340, 장수군,055004, 53세,2017,284,147,137,107.3,281,147,134,109.7
35340, 장수군,055005, 54세,2017,277,156,121,128.9,271,154,117,131.6
35340, 장수군,060,55~59세,2017,1988,1035,953,108.6,1961,1027,934,110
35340, 장수군,060001, 55세,2017,375,207,168,123.2,366,204,162,125.9
35340, 장수군,060002, 56세,2017,398,205,193,106.2,392,204,188,108.5
35340, 장수군,060003, 57세,2017,476,251,225,111.6,471,248,223,111.2
35340, 장수군,060004, 58세,2017,374,184,190,96.8,371,184,187,98.4
35340, 장수군,060005, 59세,2017,365,188,177,106.2,361,187,174,107.5
35340, 장수군,065,60~64세,2017,1861,919,942,97.6,1844,913,931,98.1
35340, 장수군,065001, 60세,2017,367,171,196,87.2,366,171,195,87.7
35340, 장수군,065002, 61세,2017,363,172,191,90.1,362,172,190,90.5
35340, 장수군,065003, 62세,2017,438,221,217,101.8,432,219,213,102.8
35340, 장수군,065004, 63세,2017,363,183,180,101.7,358,181,177,102.3
35340, 장수군,065005, 64세,2017,330,172,158,108.9,326,170,156,109
35340, 장수군,070,65~69세,2017,1721,848,873,97.1,1713,845,868,97.4
35340, 장수군,070001, 65세,2017,366,174,192,90.6,364,173,191,90.6
35340, 장수군,070002, 66세,2017,332,158,174,90.8,331,158,173,91.3
35340, 장수군,070003, 67세,2017,344,183,161,113.7,343,183,160,114.4
35340, 장수군,070004, 68세,2017,321,164,157,104.5,318,163,155,105.2
35340, 장수군,070005, 69세,2017,358,169,189,89.4,357,168,189,88.9
35340, 장수군,075,70~74세,2017,1352,588,764,77,1348,585,763,76.7
35340, 장수군,075001, 70세,2017,314,152,162,93.8,313,151,162,93.2
35340, 장수군,075002, 71세,2017,231,109,122,89.3,230,108,122,88.5
35340, 장수군,075003, 72세,2017,233,100,133,75.2,232,99,133,74.4
35340, 장수군,075004, 73세,2017,276,111,165,67.3,276,111,165,67.3
35340, 장수군,075005, 74세,2017,298,116,182,63.7,297,116,181,64.1
35340, 장수군,080,75~79세,2017,1721,638,1083,58.9,1718,636,1082,58.8
35340, 장수군,080001, 75세,2017,420,161,259,62.2,420,161,259,62.2
35340, 장수군,080002, 76세,2017,349,129,220,58.6,348,128,220,58.2
35340, 장수군,080003, 77세,2017,322,128,194,66,321,127,194,65.5
35340, 장수군,080004, 78세,2017,355,123,232,53,355,123,232,53
35340, 장수군,080005, 79세,2017,275,97,178,54.5,274,97,177,54.8
35340, 장수군,085,80~84세,2017,1182,403,779,51.7,1182,403,779,51.7
35340, 장수군,085001, 80세,2017,255,87,168,51.8,255,87,168,51.8
35340, 장수군,085002, 81세,2017,270,96,174,55.2,270,96,174,55.2
35340, 장수군,085003, 82세,2017,249,78,171,45.6,249,78,171,45.6
35340, 장수군,085004, 83세,2017,245,88,157,56.1,245,88,157,56.1
35340, 장수군,085005, 84세,2017,163,54,109,49.5,163,54,109,49.5
35340, 장수군,090,85~89세,2017,493,156,337,46.3,493,156,337,46.3
35340, 장수군,090001, 85세,2017,167,55,112,49.1,167,55,112,49.1
35340, 장수군,090002, 86세,2017,94,37,57,64.9,94,37,57,64.9
35340, 장수군,090003, 87세,2017,96,20,76,26.3,96,20,76,26.3
35340, 장수군,090004, 88세,2017,60,15,45,33.3,60,15,45,33.3
35340, 장수군,090005, 89세,2017,76,29,47,61.7,76,29,47,61.7
35340, 장수군,095,90~94세,2017,174,49,125,39.2,174,49,125,39.2
35340, 장수군,095001, 90세,2017,68,18,50,36,68,18,50,36
35340, 장수군,095002, 91세,2017,32,12,20,60,32,12,20,60
35340, 장수군,095003, 92세,2017,33,11,22,50,33,11,22,50
35340, 장수군,095004, 93세,2017,22,X,18,22.2,22,X,18,22.2
35340, 장수군,095005, 94세,2017,19,X,15,26.7,19,X,15,26.7
35340, 장수군,100,95~99세,2017,35,X,32,9.4,35,X,32,9.4
35340, 장수군,100001, 95세,2017,14,X,12,16.7,14,X,12,16.7
35340, 장수군,100002, 96세,2017,8,X,7,14.3,8,X,7,14.3
35340, 장수군,100003, 97세,2017,9,X,9,0,9,X,9,0
35340, 장수군,100004, 98세,2017,X,X,X,0,X,X,X,0
35340, 장수군,100005, 99세,2017,X,X,X,0,X,X,X,0
35340, 장수군,101,100세이상,2017,X,X,X,50,X,X,X,50
35340, 장수군,102,15세미만,2017,2207,1124,1083,103.8,2205,1123,1082,103.8
35340, 장수군,103,15~64세,2017,12507,6734,5773,116.6,12064,6525,5539,117.8
35340, 장수군,104,65세이상,2017,6681,2686,3995,67.2,6666,2678,3988,67.2
35340, 장수군,086,85세이상,2017,705,209,496,42.1,705,209,496,42.1
35340, 장수군,126,평균연령,2017,50.4,47.9,52.9,,50.7,48.2,53.2,
35340, 장수군,127,중위연령,2017,54.4,51.3,57.5,,55,51.7,57.9,
35350, 임실군,000,합계,2017,26409,13256,13153,100.8,25950,13045,12905,101.1
35350, 임실군,005,0~4세,2017,844,437,407,107.4,843,437,406,107.6
35350, 임실군,005001, 0세,2017,178,98,80,122.5,178,98,80,122.5
35350, 임실군,005002, 1세,2017,172,87,85,102.4,171,87,84,103.6
35350, 임실군,005003, 2세,2017,164,86,78,110.3,164,86,78,110.3
35350, 임실군,005004, 3세,2017,154,81,73,111,154,81,73,111
35350, 임실군,005005, 4세,2017,176,85,91,93.4,176,85,91,93.4
35350, 임실군,010,5~9세,2017,824,439,385,114,823,439,384,114.3
35350, 임실군,010001, 5세,2017,171,91,80,113.8,171,91,80,113.8
35350, 임실군,010002, 6세,2017,154,86,68,126.5,154,86,68,126.5
35350, 임실군,010003, 7세,2017,147,74,73,101.4,146,74,72,102.8
35350, 임실군,010004, 8세,2017,161,87,74,117.6,161,87,74,117.6
35350, 임실군,010005, 9세,2017,191,101,90,112.2,191,101,90,112.2
35350, 임실군,015,10~14세,2017,798,431,367,117.4,798,431,367,117.4
35350, 임실군,015001, 10세,2017,175,97,78,124.4,175,97,78,124.4
35350, 임실군,015002, 11세,2017,150,68,82,82.9,150,68,82,82.9
35350, 임실군,015003, 12세,2017,145,82,63,130.2,145,82,63,130.2
35350, 임실군,015004, 13세,2017,159,93,66,140.9,159,93,66,140.9
35350, 임실군,015005, 14세,2017,169,91,78,116.7,169,91,78,116.7
35350, 임실군,020,15~19세,2017,1061,599,462,129.7,1056,596,460,129.6
35350, 임실군,020001, 15세,2017,167,93,74,125.7,167,93,74,125.7
35350, 임실군,020002, 16세,2017,210,119,91,130.8,209,118,91,129.7
35350, 임실군,020003, 17세,2017,185,107,78,137.2,185,107,78,137.2
35350, 임실군,020004, 18세,2017,214,111,103,107.8,213,111,102,108.8
35350, 임실군,020005, 19세,2017,285,169,116,145.7,282,167,115,145.2
35350, 임실군,025,20~24세,2017,1316,767,549,139.7,1256,734,522,140.6
35350, 임실군,025001, 20세,2017,307,173,134,129.1,300,168,132,127.3
35350, 임실군,025002, 21세,2017,297,154,143,107.7,287,150,137,109.5
35350, 임실군,025003, 22세,2017,276,170,106,160.4,265,164,101,162.4
35350, 임실군,025004, 23세,2017,223,137,86,159.3,209,131,78,167.9
35350, 임실군,025005, 24세,2017,213,133,80,166.3,195,121,74,163.5
35350, 임실군,030,25~29세,2017,1175,658,517,127.3,1078,608,470,129.4
35350, 임실군,030001, 25세,2017,254,144,110,130.9,231,129,102,126.5
35350, 임실군,030002, 26세,2017,246,140,106,132.1,224,128,96,133.3
35350, 임실군,030003, 27세,2017,227,127,100,127,212,120,92,130.4
35350, 임실군,030004, 28세,2017,232,131,101,129.7,217,124,93,133.3
35350, 임실군,030005, 29세,2017,216,116,100,116,194,107,87,123
35350, 임실군,035,30~34세,2017,1050,555,495,112.1,970,527,443,119
35350, 임실군,035001, 30세,2017,209,117,92,127.2,186,107,79,135.4
35350, 임실군,035002, 31세,2017,208,114,94,121.3,191,108,83,130.1
35350, 임실군,035003, 32세,2017,204,102,102,100,189,97,92,105.4
35350, 임실군,035004, 33세,2017,230,123,107,115,216,118,98,120.4
35350, 임실군,035005, 34세,2017,199,99,100,99,188,97,91,106.6
35350, 임실군,040,35~39세,2017,1234,696,538,129.4,1185,672,513,131
35350, 임실군,040001, 35세,2017,237,128,109,117.4,231,125,106,117.9
35350, 임실군,040002, 36세,2017,241,136,105,129.5,225,127,98,129.6
35350, 임실군,040003, 37세,2017,239,133,106,125.5,231,130,101,128.7
35350, 임실군,040004, 38세,2017,251,141,110,128.2,242,138,104,132.7
35350, 임실군,040005, 39세,2017,266,158,108,146.3,256,152,104,146.2
35350, 임실군,045,40~44세,2017,1275,754,521,144.7,1248,743,505,147.1
35350, 임실군,045001, 40세,2017,226,143,83,172.3,221,140,81,172.8
35350, 임실군,045002, 41세,2017,250,149,101,147.5,246,148,98,151
35350, 임실군,045003, 42세,2017,234,140,94,148.9,226,137,89,153.9
35350, 임실군,045004, 43세,2017,268,149,119,125.2,263,147,116,126.7
35350, 임실군,045005, 44세,2017,297,173,124,139.5,292,171,121,141.3
35350, 임실군,050,45~49세,2017,1695,979,716,136.7,1655,961,694,138.5
35350, 임실군,050001, 45세,2017,290,170,120,141.7,285,167,118,141.5
35350, 임실군,050002, 46세,2017,306,197,109,180.7,301,196,105,186.7
35350, 임실군,050003, 47세,2017,328,186,142,131,315,181,134,135.1
35350, 임실군,050004, 48세,2017,363,192,171,112.3,354,187,167,112
35350, 임실군,050005, 49세,2017,408,234,174,134.5,400,230,170,135.3
35350, 임실군,055,50~54세,2017,1890,1049,841,124.7,1856,1036,820,126.3
35350, 임실군,055001, 50세,2017,355,198,157,126.1,347,195,152,128.3
35350, 임실군,055002, 51세,2017,372,193,179,107.8,368,191,177,107.9
35350, 임실군,055003, 52세,2017,396,231,165,140,387,229,158,144.9
35350, 임실군,055004, 53세,2017,379,208,171,121.6,372,206,166,124.1
35350, 임실군,055005, 54세,2017,388,219,169,129.6,382,215,167,128.7
35350, 임실군,060,55~59세,2017,2368,1229,1139,107.9,2338,1216,1122,108.4
35350, 임실군,060001, 55세,2017,432,227,205,110.7,427,225,202,111.4
35350, 임실군,060002, 56세,2017,465,246,219,112.3,457,243,214,113.6
35350, 임실군,060003, 57세,2017,570,296,274,108,561,291,270,107.8
35350, 임실군,060004, 58세,2017,489,241,248,97.2,486,240,246,97.6
35350, 임실군,060005, 59세,2017,412,219,193,113.5,407,217,190,114.2
35350, 임실군,065,60~64세,2017,2078,1115,963,115.8,2055,1103,952,115.9
35350, 임실군,065001, 60세,2017,446,242,204,118.6,440,239,201,118.9
35350, 임실군,065002, 61세,2017,448,239,209,114.4,443,236,207,114
35350, 임실군,065003, 62세,2017,426,236,190,124.2,422,234,188,124.5
35350, 임실군,065004, 63세,2017,422,220,202,108.9,417,218,199,109.5
35350, 임실군,065005, 64세,2017,336,178,158,112.7,333,176,157,112.1
35350, 임실군,070,65~69세,2017,2025,963,1062,90.7,2019,959,1060,90.5
35350, 임실군,070001, 65세,2017,391,195,196,99.5,391,195,196,99.5
35350, 임실군,070002, 66세,2017,377,170,207,82.1,374,167,207,80.7
35350, 임실군,070003, 67세,2017,445,223,222,100.5,443,222,221,100.5
35350, 임실군,070004, 68세,2017,380,165,215,76.7,379,165,214,77.1
35350, 임실군,070005, 69세,2017,432,210,222,94.6,432,210,222,94.6
35350, 임실군,075,70~74세,2017,1817,808,1009,80.1,1813,808,1005,80.4
35350, 임실군,075001, 70세,2017,456,223,233,95.7,455,223,232,96.1
35350, 임실군,075002, 71세,2017,336,156,180,86.7,335,156,179,87.2
35350, 임실군,075003, 72세,2017,331,138,193,71.5,330,138,192,71.9
35350, 임실군,075004, 73세,2017,308,138,170,81.2,308,138,170,81.2
35350, 임실군,075005, 74세,2017,386,153,233,65.7,385,153,232,65.9
35350, 임실군,080,75~79세,2017,2296,876,1420,61.7,2294,874,1420,61.5
35350, 임실군,080001, 75세,2017,587,222,365,60.8,587,222,365,60.8
35350, 임실군,080002, 76세,2017,445,180,265,67.9,445,180,265,67.9
35350, 임실군,080003, 77세,2017,427,150,277,54.2,427,150,277,54.2
35350, 임실군,080004, 78세,2017,455,182,273,66.7,454,181,273,66.3
35350, 임실군,080005, 79세,2017,382,142,240,59.2,381,141,240,58.8
35350, 임실군,085,80~84세,2017,1624,590,1034,57.1,1624,590,1034,57.1
35350, 임실군,085001, 80세,2017,422,156,266,58.6,422,156,266,58.6
35350, 임실군,085002, 81세,2017,348,134,214,62.6,348,134,214,62.6
35350, 임실군,085003, 82세,2017,335,121,214,56.5,335,121,214,56.5
35350, 임실군,085004, 83세,2017,305,104,201,51.7,305,104,201,51.7
35350, 임실군,085005, 84세,2017,214,75,139,54,214,75,139,54
35350, 임실군,090,85~89세,2017,752,243,509,47.7,752,243,509,47.7
35350, 임실군,090001, 85세,2017,204,68,136,50,204,68,136,50
35350, 임실군,090002, 86세,2017,162,49,113,43.4,162,49,113,43.4
35350, 임실군,090003, 87세,2017,130,41,89,46.1,130,41,89,46.1
35350, 임실군,090004, 88세,2017,136,49,87,56.3,136,49,87,56.3
35350, 임실군,090005, 89세,2017,120,36,84,42.9,120,36,84,42.9
35350, 임실군,095,90~94세,2017,232,62,170,36.5,232,62,170,36.5
35350, 임실군,095001, 90세,2017,85,24,61,39.3,85,24,61,39.3
35350, 임실군,095002, 91세,2017,60,15,45,33.3,60,15,45,33.3
35350, 임실군,095003, 92세,2017,32,7,25,28,32,7,25,28
35350, 임실군,095004, 93세,2017,27,9,18,50,27,9,18,50
35350, 임실군,095005, 94세,2017,28,7,21,33.3,28,7,21,33.3
35350, 임실군,100,95~99세,2017,46,6,40,15,46,6,40,15
35350, 임실군,100001, 95세,2017,17,X,15,13.3,17,X,15,13.3
35350, 임실군,100002, 96세,2017,8,X,7,14.3,8,X,7,14.3
35350, 임실군,100003, 97세,2017,5,X,5,0,5,X,5,0
35350, 임실군,100004, 98세,2017,9,X,6,50,9,X,6,50
35350, 임실군,100005, 99세,2017,7,X,7,0,7,X,7,0
35350, 임실군,101,100세이상,2017,9,X,9,0,9,X,9,0
35350, 임실군,102,15세미만,2017,2466,1307,1159,112.8,2464,1307,1157,113
35350, 임실군,103,15~64세,2017,15142,8401,6741,124.6,14697,8196,6501,126.1
35350, 임실군,104,65세이상,2017,8801,3548,5253,67.5,8789,3542,5247,67.5
35350, 임실군,086,85세이상,2017,1039,311,728,42.7,1039,311,728,42.7
35350, 임실군,126,평균연령,2017,51.2,48.3,54,,51.4,48.5,54.3,
35350, 임실군,127,중위연령,2017,55.1,51.6,58.3,,55.5,51.9,58.7,
35360, 순창군,000,합계,2017,27017,12875,14142,91,26606,12724,13882,91.7
35360, 순창군,005,0~4세,2017,915,472,443,106.5,915,472,443,106.5
35360, 순창군,005001, 0세,2017,201,106,95,111.6,201,106,95,111.6
35360, 순창군,005002, 1세,2017,223,114,109,104.6,223,114,109,104.6
35360, 순창군,005003, 2세,2017,171,90,81,111.1,171,90,81,111.1
35360, 순창군,005004, 3세,2017,152,70,82,85.4,152,70,82,85.4
35360, 순창군,005005, 4세,2017,168,92,76,121.1,168,92,76,121.1
35360, 순창군,010,5~9세,2017,886,453,433,104.6,886,453,433,104.6
35360, 순창군,010001, 5세,2017,177,87,90,96.7,177,87,90,96.7
35360, 순창군,010002, 6세,2017,171,84,87,96.6,171,84,87,96.6
35360, 순창군,010003, 7세,2017,172,96,76,126.3,172,96,76,126.3
35360, 순창군,010004, 8세,2017,180,98,82,119.5,180,98,82,119.5
35360, 순창군,010005, 9세,2017,186,88,98,89.8,186,88,98,89.8
35360, 순창군,015,10~14세,2017,1004,523,481,108.7,1003,523,480,109
35360, 순창군,015001, 10세,2017,225,114,111,102.7,225,114,111,102.7
35360, 순창군,015002, 11세,2017,203,114,89,128.1,202,114,88,129.5
35360, 순창군,015003, 12세,2017,181,97,84,115.5,181,97,84,115.5
35360, 순창군,015004, 13세,2017,197,99,98,101,197,99,98,101
35360, 순창군,015005, 14세,2017,198,99,99,100,198,99,99,100
35360, 순창군,020,15~19세,2017,1136,596,540,110.4,1131,594,537,110.6
35360, 순창군,020001, 15세,2017,218,116,102,113.7,218,116,102,113.7
35360, 순창군,020002, 16세,2017,263,140,123,113.8,262,139,123,113
35360, 순창군,020003, 17세,2017,290,126,164,76.8,290,126,164,76.8
35360, 순창군,020004, 18세,2017,225,118,107,110.3,225,118,107,110.3
35360, 순창군,020005, 19세,2017,140,96,44,218.2,136,95,41,231.7
35360, 순창군,025,20~24세,2017,1019,601,418,143.8,969,587,382,153.7
35360, 순창군,025001, 20세,2017,206,133,73,182.2,205,133,72,184.7
35360, 순창군,025002, 21세,2017,208,138,70,197.1,198,137,61,224.6
35360, 순창군,025003, 22세,2017,220,136,84,161.9,209,129,80,161.3
35360, 순창군,025004, 23세,2017,197,100,97,103.1,187,99,88,112.5
35360, 순창군,025005, 24세,2017,188,94,94,100,170,89,81,109.9
35360, 순창군,030,25~29세,2017,969,431,538,80.1,890,402,488,82.4
35360, 순창군,030001, 25세,2017,192,88,104,84.6,180,82,98,83.7
35360, 순창군,030002, 26세,2017,181,78,103,75.7,170,75,95,78.9
35360, 순창군,030003, 27세,2017,209,95,114,83.3,186,86,100,86
35360, 순창군,030004, 28세,2017,177,72,105,68.6,165,68,97,70.1
35360, 순창군,030005, 29세,2017,210,98,112,87.5,189,91,98,92.9
35360, 순창군,035,30~34세,2017,1045,493,552,89.3,989,470,519,90.6
35360, 순창군,035001, 30세,2017,200,103,97,106.2,188,100,88,113.6
35360, 순창군,035002, 31세,2017,214,90,124,72.6,203,87,116,75
35360, 순창군,035003, 32세,2017,194,93,101,92.1,186,90,96,93.8
35360, 순창군,035004, 33세,2017,206,100,106,94.3,194,94,100,94
35360, 순창군,035005, 34세,2017,231,107,124,86.3,218,99,119,83.2
35360, 순창군,040,35~39세,2017,1317,683,634,107.7,1277,668,609,109.7
35360, 순창군,040001, 35세,2017,248,129,119,108.4,244,128,116,110.3
35360, 순창군,040002, 36세,2017,258,138,120,115,249,133,116,114.7
35360, 순창군,040003, 37세,2017,269,127,142,89.4,259,123,136,90.4
35360, 순창군,040004, 38세,2017,286,149,137,108.8,277,147,130,113.1
35360, 순창군,040005, 39세,2017,256,140,116,120.7,248,137,111,123.4
35360, 순창군,045,40~44세,2017,1498,847,651,130.1,1463,835,628,133
35360, 순창군,045001, 40세,2017,273,136,137,99.3,267,135,132,102.3
35360, 순창군,045002, 41세,2017,266,169,97,174.2,259,168,91,184.6
35360, 순창군,045003, 42세,2017,263,150,113,132.7,261,149,112,133
35360, 순창군,045004, 43세,2017,361,198,163,121.5,354,197,157,125.5
35360, 순창군,045005, 44세,2017,335,194,141,137.6,322,186,136,136.8
35360, 순창군,050,45~49세,2017,1859,1073,786,136.5,1819,1060,759,139.7
35360, 순창군,050001, 45세,2017,332,191,141,135.5,328,189,139,136
35360, 순창군,050002, 46세,2017,391,225,166,135.5,382,223,159,140.3
35360, 순창군,050003, 47세,2017,316,183,133,137.6,306,180,126,142.9
35360, 순창군,050004, 48세,2017,416,236,180,131.1,408,233,175,133.1
35360, 순창군,050005, 49세,2017,404,238,166,143.4,395,235,160,146.9
35360, 순창군,055,50~54세,2017,1882,987,895,110.3,1832,968,864,112
35360, 순창군,055001, 50세,2017,373,202,171,118.1,367,200,167,119.8
35360, 순창군,055002, 51세,2017,396,207,189,109.5,384,204,180,113.3
35360, 순창군,055003, 52세,2017,365,188,177,106.2,360,184,176,104.5
35360, 순창군,055004, 53세,2017,366,186,180,103.3,353,180,173,104
35360, 순창군,055005, 54세,2017,382,204,178,114.6,368,200,168,119
35360, 순창군,060,55~59세,2017,2405,1239,1166,106.3,2379,1228,1151,106.7
35360, 순창군,060001, 55세,2017,450,233,217,107.4,443,230,213,108
35360, 순창군,060002, 56세,2017,477,249,228,109.2,473,249,224,111.2
35360, 순창군,060003, 57세,2017,585,303,282,107.4,578,300,278,107.9
35360, 순창군,060004, 58세,2017,469,238,231,103,463,234,229,102.2
35360, 순창군,060005, 59세,2017,424,216,208,103.8,422,215,207,103.9
35360, 순창군,065,60~64세,2017,2134,1051,1083,97,2121,1045,1076,97.1
35360, 순창군,065001, 60세,2017,427,217,210,103.3,419,214,205,104.4
35360, 순창군,065002, 61세,2017,448,217,231,93.9,447,217,230,94.3
35360, 순창군,065003, 62세,2017,461,235,226,104,459,233,226,103.1
35360, 순창군,065004, 63세,2017,444,218,226,96.5,444,218,226,96.5
35360, 순창군,065005, 64세,2017,354,164,190,86.3,352,163,189,86.2
35360, 순창군,070,65~69세,2017,1933,901,1032,87.3,1925,896,1029,87.1
35360, 순창군,070001, 65세,2017,396,182,214,85,392,180,212,84.9
35360, 순창군,070002, 66세,2017,331,160,171,93.6,330,159,171,93
35360, 순창군,070003, 67세,2017,370,181,189,95.8,370,181,189,95.8
35360, 순창군,070004, 68세,2017,410,185,225,82.2,410,185,225,82.2
35360, 순창군,070005, 69세,2017,426,193,233,82.8,423,191,232,82.3
35360, 순창군,075,70~74세,2017,1929,794,1135,70,1927,794,1133,70.1
35360, 순창군,075001, 70세,2017,449,199,250,79.6,448,199,249,79.9
35360, 순창군,075002, 71세,2017,380,165,215,76.7,379,165,214,77.1
35360, 순창군,075003, 72세,2017,346,151,195,77.4,346,151,195,77.4
35360, 순창군,075004, 73세,2017,357,137,220,62.3,357,137,220,62.3
35360, 순창군,075005, 74세,2017,397,142,255,55.7,397,142,255,55.7
35360, 순창군,080,75~79세,2017,2443,880,1563,56.3,2440,879,1561,56.3
35360, 순창군,080001, 75세,2017,605,205,400,51.3,604,204,400,51
35360, 순창군,080002, 76세,2017,468,176,292,60.3,468,176,292,60.3
35360, 순창군,080003, 77세,2017,455,163,292,55.8,453,163,290,56.2
35360, 순창군,080004, 78세,2017,462,172,290,59.3,462,172,290,59.3
35360, 순창군,080005, 79세,2017,453,164,289,56.7,453,164,289,56.7
35360, 순창군,085,80~84세,2017,1563,562,1001,56.1,1561,561,1000,56.1
35360, 순창군,085001, 80세,2017,362,141,221,63.8,362,141,221,63.8
35360, 순창군,085002, 81세,2017,365,133,232,57.3,364,133,231,57.6
35360, 순창군,085003, 82세,2017,346,131,215,60.9,346,131,215,60.9
35360, 순창군,085004, 83세,2017,292,80,212,37.7,291,79,212,37.3
35360, 순창군,085005, 84세,2017,198,77,121,63.6,198,77,121,63.6
35360, 순창군,090,85~89세,2017,741,211,530,39.8,740,211,529,39.9
35360, 순창군,090001, 85세,2017,211,60,151,39.7,211,60,151,39.7
35360, 순창군,090002, 86세,2017,150,46,104,44.2,150,46,104,44.2
35360, 순창군,090003, 87세,2017,154,38,116,32.8,154,38,116,32.8
35360, 순창군,090004, 88세,2017,116,34,82,41.5,115,34,81,42
35360, 순창군,090005, 89세,2017,110,33,77,42.9,110,33,77,42.9
35360, 순창군,095,90~94세,2017,254,60,194,30.9,254,60,194,30.9
35360, 순창군,095001, 90세,2017,93,19,74,25.7,93,19,74,25.7
35360, 순창군,095002, 91세,2017,48,16,32,50,48,16,32,50
35360, 순창군,095003, 92세,2017,43,13,30,43.3,43,13,30,43.3
35360, 순창군,095004, 93세,2017,34,6,28,21.4,34,6,28,21.4
35360, 순창군,095005, 94세,2017,36,6,30,20,36,6,30,20
35360, 순창군,100,95~99세,2017,74,16,58,27.6,74,16,58,27.6
35360, 순창군,100001, 95세,2017,36,5,31,16.1,36,5,31,16.1
35360, 순창군,100002, 96세,2017,14,5,9,55.6,14,5,9,55.6
35360, 순창군,100003, 97세,2017,16,X,12,33.3,16,X,12,33.3
35360, 순창군,100004, 98세,2017,6,X,X,50,6,X,X,50
35360, 순창군,100005, 99세,2017,X,X,X,0,X,X,X,0
35360, 순창군,101,100세이상,2017,11,X,9,22.2,11,X,9,22.2
35360, 순창군,102,15세미만,2017,2805,1448,1357,106.7,2804,1448,1356,106.8
35360, 순창군,103,15~64세,2017,15264,8001,7263,110.2,14870,7857,7013,112
35360, 순창군,104,65세이상,2017,8948,3426,5522,62,8932,3419,5513,62
35360, 순창군,086,85세이상,2017,1080,289,791,36.5,1079,289,790,36.6
35360, 순창군,126,평균연령,2017,51.1,48.3,53.6,,51.3,48.4,53.9,
35360, 순창군,127,중위연령,2017,54.9,51.3,57.9,,55.3,51.5,58.4,
35370, 고창군,000,합계,2017,54947,27298,27649,98.7,53781,26685,27096,98.5
35370, 고창군,005,0~4세,2017,1391,726,665,109.2,1388,723,665,108.7
35370, 고창군,005001, 0세,2017,243,114,129,88.4,242,113,129,87.6
35370, 고창군,005002, 1세,2017,241,134,107,125.2,240,133,107,124.3
35370, 고창군,005003, 2세,2017,280,138,142,97.2,280,138,142,97.2
35370, 고창군,005004, 3세,2017,325,174,151,115.2,324,173,151,114.6
35370, 고창군,005005, 4세,2017,302,166,136,122.1,302,166,136,122.1
35370, 고창군,010,5~9세,2017,1724,912,812,112.3,1723,911,812,112.2
35370, 고창군,010001, 5세,2017,322,174,148,117.6,321,173,148,116.9
35370, 고창군,010002, 6세,2017,383,200,183,109.3,383,200,183,109.3
35370, 고창군,010003, 7세,2017,315,180,135,133.3,315,180,135,133.3
35370, 고창군,010004, 8세,2017,340,166,174,95.4,340,166,174,95.4
35370, 고창군,010005, 9세,2017,364,192,172,111.6,364,192,172,111.6
35370, 고창군,015,10~14세,2017,1968,1072,896,119.6,1967,1071,896,119.5
35370, 고창군,015001, 10세,2017,324,170,154,110.4,324,170,154,110.4
35370, 고창군,015002, 11세,2017,337,172,165,104.2,337,172,165,104.2
35370, 고창군,015003, 12세,2017,347,182,165,110.3,346,181,165,109.7
35370, 고창군,015004, 13세,2017,439,257,182,141.2,439,257,182,141.2
35370, 고창군,015005, 14세,2017,521,291,230,126.5,521,291,230,126.5
35370, 고창군,020,15~19세,2017,3186,1896,1290,147,3181,1894,1287,147.2
35370, 고창군,020001, 15세,2017,602,343,259,132.4,601,343,258,132.9
35370, 고창군,020002, 16세,2017,768,423,345,122.6,768,423,345,122.6
35370, 고창군,020003, 17세,2017,892,565,327,172.8,892,565,327,172.8
35370, 고창군,020004, 18세,2017,595,355,240,147.9,593,354,239,148.1
35370, 고창군,020005, 19세,2017,329,210,119,176.5,327,209,118,177.1
35370, 고창군,025,20~24세,2017,2333,1432,901,158.9,2211,1372,839,163.5
35370, 고창군,025001, 20세,2017,431,297,134,221.6,426,295,131,225.2
35370, 고창군,025002, 21세,2017,449,303,146,207.5,435,297,138,215.2
35370, 고창군,025003, 22세,2017,478,296,182,162.6,462,292,170,171.8
35370, 고창군,025004, 23세,2017,484,259,225,115.1,447,235,212,110.8
35370, 고창군,025005, 24세,2017,491,277,214,129.4,441,253,188,134.6
35370, 고창군,030,25~29세,2017,2256,1234,1022,120.7,1992,1082,910,118.9
35370, 고창군,030001, 25세,2017,475,258,217,118.9,417,225,192,117.2
35370, 고창군,030002, 26세,2017,433,239,194,123.2,383,210,173,121.4
35370, 고창군,030003, 27세,2017,457,243,214,113.6,409,220,189,116.4
35370, 고창군,030004, 28세,2017,457,256,201,127.4,395,218,177,123.2
35370, 고창군,030005, 29세,2017,434,238,196,121.4,388,209,179,116.8
35370, 고창군,035,30~34세,2017,2153,1195,958,124.7,1914,1057,857,123.3
35370, 고창군,035001, 30세,2017,408,227,181,125.4,359,193,166,116.3
35370, 고창군,035002, 31세,2017,421,247,174,142,368,220,148,148.6
35370, 고창군,035003, 32세,2017,442,221,221,100,388,193,195,99
35370, 고창군,035004, 33세,2017,450,248,202,122.8,404,223,181,123.2
35370, 고창군,035005, 34세,2017,432,252,180,140,395,228,167,136.5
35370, 고창군,040,35~39세,2017,2419,1337,1082,123.6,2296,1263,1033,122.3
35370, 고창군,040001, 35세,2017,470,252,218,115.6,437,233,204,114.2
35370, 고창군,040002, 36세,2017,507,283,224,126.3,487,269,218,123.4
35370, 고창군,040003, 37세,2017,466,245,221,110.9,440,234,206,113.6
35370, 고창군,040004, 38세,2017,501,293,208,140.9,475,276,199,138.7
35370, 고창군,040005, 39세,2017,475,264,211,125.1,457,251,206,121.8
35370, 고창군,045,40~44세,2017,2976,1684,1292,130.3,2893,1649,1244,132.6
35370, 고창군,045001, 40세,2017,508,274,234,117.1,493,266,227,117.2
35370, 고창군,045002, 41세,2017,534,291,243,119.8,518,285,233,122.3
35370, 고창군,045003, 42세,2017,555,335,220,152.3,536,326,210,155.2
35370, 고창군,045004, 43세,2017,667,371,296,125.3,652,366,286,128
35370, 고창군,045005, 44세,2017,712,413,299,138.1,694,406,288,141
35370, 고창군,050,45~49세,2017,3762,2079,1683,123.5,3672,2046,1626,125.8
35370, 고창군,050001, 45세,2017,685,362,323,112.1,664,356,308,115.6
35370, 고창군,050002, 46세,2017,748,446,302,147.7,727,435,292,149
35370, 고창군,050003, 47세,2017,727,391,336,116.4,711,386,325,118.8
35370, 고창군,050004, 48세,2017,777,422,355,118.9,760,415,345,120.3
35370, 고창군,050005, 49세,2017,825,458,367,124.8,810,454,356,127.5
35370, 고창군,055,50~54세,2017,4042,2195,1847,118.8,3950,2152,1798,119.7
35370, 고창군,055001, 50세,2017,752,414,338,122.5,729,406,323,125.7
35370, 고창군,055002, 51세,2017,811,457,354,129.1,799,452,347,130.3
35370, 고창군,055003, 52세,2017,855,457,398,114.8,837,451,386,116.8
35370, 고창군,055004, 53세,2017,807,436,371,117.5,783,425,358,118.7
35370, 고창군,055005, 54세,2017,817,431,386,111.7,802,418,384,108.9
35370, 고창군,060,55~59세,2017,5046,2552,2494,102.3,4992,2527,2465,102.5
35370, 고창군,060001, 55세,2017,922,472,450,104.9,911,468,443,105.6
35370, 고창군,060002, 56세,2017,1054,551,503,109.5,1046,545,501,108.8
35370, 고창군,060003, 57세,2017,1075,516,559,92.3,1063,514,549,93.6
35370, 고창군,060004, 58세,2017,975,485,490,99,959,477,482,99
35370, 고창군,060005, 59세,2017,1020,528,492,107.3,1013,523,490,106.7
35370, 고창군,065,60~64세,2017,4457,2174,2283,95.2,4407,2143,2264,94.7
35370, 고창군,065001, 60세,2017,1011,505,506,99.8,997,497,500,99.4
35370, 고창군,065002, 61세,2017,915,437,478,91.4,902,427,475,89.9
35370, 고창군,065003, 62세,2017,962,483,479,100.8,956,478,478,100
35370, 고창군,065004, 63세,2017,865,418,447,93.5,859,415,444,93.5
35370, 고창군,065005, 64세,2017,704,331,373,88.7,693,326,367,88.8
35370, 고창군,070,65~69세,2017,4104,1963,2141,91.7,4086,1955,2131,91.7
35370, 고창군,070001, 65세,2017,815,387,428,90.4,809,385,424,90.8
35370, 고창군,070002, 66세,2017,748,353,395,89.4,746,353,393,89.8
35370, 고창군,070003, 67세,2017,845,421,424,99.3,843,420,423,99.3
35370, 고창군,070004, 68세,2017,882,416,466,89.3,877,414,463,89.4
35370, 고창군,070005, 69세,2017,814,386,428,90.2,811,383,428,89.5
35370, 고창군,075,70~74세,2017,3916,1750,2166,80.8,3901,1745,2156,80.9
35370, 고창군,075001, 70세,2017,914,446,468,95.3,911,445,466,95.5
35370, 고창군,075002, 71세,2017,729,336,393,85.5,726,335,391,85.7
35370, 고창군,075003, 72세,2017,676,288,388,74.2,673,285,388,73.5
35370, 고창군,075004, 73세,2017,751,324,427,75.9,748,324,424,76.4
35370, 고창군,075005, 74세,2017,846,356,490,72.7,843,356,487,73.1
35370, 고창군,080,75~79세,2017,4507,1716,2791,61.5,4501,1714,2787,61.5
35370, 고창군,080001, 75세,2017,1153,454,699,64.9,1152,454,698,65
35370, 고창군,080002, 76세,2017,903,344,559,61.5,900,343,557,61.6
35370, 고창군,080003, 77세,2017,795,285,510,55.9,794,284,510,55.7
35370, 고창군,080004, 78세,2017,870,341,529,64.5,870,341,529,64.5
35370, 고창군,080005, 79세,2017,786,292,494,59.1,785,292,493,59.2
35370, 고창군,085,80~84세,2017,2858,943,1915,49.2,2858,943,1915,49.2
35370, 고창군,085001, 80세,2017,677,215,462,46.5,677,215,462,46.5
35370, 고창군,085002, 81세,2017,590,193,397,48.6,590,193,397,48.6
35370, 고창군,085003, 82세,2017,658,229,429,53.4,658,229,429,53.4
35370, 고창군,085004, 83세,2017,548,190,358,53.1,548,190,358,53.1
35370, 고창군,085005, 84세,2017,385,116,269,43.1,385,116,269,43.1
35370, 고창군,090,85~89세,2017,1360,344,1016,33.9,1360,344,1016,33.9
35370, 고창군,090001, 85세,2017,377,103,274,37.6,377,103,274,37.6
35370, 고창군,090002, 86세,2017,306,81,225,36,306,81,225,36
35370, 고창군,090003, 87세,2017,299,71,228,31.1,299,71,228,31.1
35370, 고창군,090004, 88세,2017,198,49,149,32.9,198,49,149,32.9
35370, 고창군,090005, 89세,2017,180,40,140,28.6,180,40,140,28.6
35370, 고창군,095,90~94세,2017,379,83,296,28,379,83,296,28
35370, 고창군,095001, 90세,2017,126,22,104,21.2,126,22,104,21.2
35370, 고창군,095002, 91세,2017,98,23,75,30.7,98,23,75,30.7
35370, 고창군,095003, 92세,2017,60,15,45,33.3,60,15,45,33.3
35370, 고창군,095004, 93세,2017,40,15,25,60,40,15,25,60
35370, 고창군,095005, 94세,2017,55,8,47,17,55,8,47,17
35370, 고창군,100,95~99세,2017,104,11,93,11.8,104,11,93,11.8
35370, 고창군,100001, 95세,2017,46,5,41,12.2,46,5,41,12.2
35370, 고창군,100002, 96세,2017,23,X,19,21.1,23,X,19,21.1
35370, 고창군,100003, 97세,2017,18,X,17,5.9,18,X,17,5.9
35370, 고창군,100004, 98세,2017,13,X,12,8.3,13,X,12,8.3
35370, 고창군,100005, 99세,2017,X,X,X,0,X,X,X,0
35370, 고창군,101,100세이상,2017,6,X,6,0,6,X,6,0
35370, 고창군,102,15세미만,2017,5083,2710,2373,114.2,5078,2705,2373,114
35370, 고창군,103,15~64세,2017,32630,17778,14852,119.7,31508,17185,14323,120
35370, 고창군,104,65세이상,2017,17234,6810,10424,65.3,17195,6795,10400,65.3
35370, 고창군,086,85세이상,2017,1849,438,1411,31,1849,438,1411,31
35370, 고창군,126,평균연령,2017,50.4,47.1,53.5,,50.6,47.4,53.8,
35370, 고창군,127,중위연령,2017,54.1,50.2,57.8,,54.6,50.7,58.2,
35380, 부안군,000,합계,2017,51249,25399,25850,98.3,50336,24971,25365,98.4
35380, 부안군,005,0~4세,2017,1407,747,660,113.2,1407,747,660,113.2
35380, 부안군,005001, 0세,2017,275,156,119,131.1,275,156,119,131.1
35380, 부안군,005002, 1세,2017,264,141,123,114.6,264,141,123,114.6
35380, 부안군,005003, 2세,2017,265,141,124,113.7,265,141,124,113.7
35380, 부안군,005004, 3세,2017,296,149,147,101.4,296,149,147,101.4
35380, 부안군,005005, 4세,2017,307,160,147,108.8,307,160,147,108.8
35380, 부안군,010,5~9세,2017,1583,823,760,108.3,1582,823,759,108.4
35380, 부안군,010001, 5세,2017,329,175,154,113.6,329,175,154,113.6
35380, 부안군,010002, 6세,2017,350,186,164,113.4,350,186,164,113.4
35380, 부안군,010003, 7세,2017,294,162,132,122.7,294,162,132,122.7
35380, 부안군,010004, 8세,2017,305,142,163,87.1,304,142,162,87.7
35380, 부안군,010005, 9세,2017,305,158,147,107.5,305,158,147,107.5
35380, 부안군,015,10~14세,2017,1675,878,797,110.2,1670,875,795,110.1
35380, 부안군,015001, 10세,2017,333,184,149,123.5,333,184,149,123.5
35380, 부안군,015002, 11세,2017,306,152,154,98.7,304,151,153,98.7
35380, 부안군,015003, 12세,2017,322,160,162,98.8,322,160,162,98.8
35380, 부안군,015004, 13세,2017,352,201,151,133.1,351,200,151,132.5
35380, 부안군,015005, 14세,2017,362,181,181,100,360,180,180,100
35380, 부안군,020,15~19세,2017,2390,1381,1009,136.9,2377,1373,1004,136.8
35380, 부안군,020001, 15세,2017,417,237,180,131.7,414,236,178,132.6
35380, 부안군,020002, 16세,2017,551,346,205,168.8,551,346,205,168.8
35380, 부안군,020003, 17세,2017,630,362,268,135.1,627,359,268,134
35380, 부안군,020004, 18세,2017,490,256,234,109.4,489,255,234,109
35380, 부안군,020005, 19세,2017,302,180,122,147.5,296,177,119,148.7
35380, 부안군,025,20~24세,2017,2159,1314,845,155.5,2082,1289,793,162.5
35380, 부안군,025001, 20세,2017,401,296,105,281.9,397,294,103,285.4
35380, 부안군,025002, 21세,2017,468,315,153,205.9,454,308,146,211
35380, 부안군,025003, 22세,2017,417,246,171,143.9,401,242,159,152.2
35380, 부안군,025004, 23세,2017,445,230,215,107,428,226,202,111.9
35380, 부안군,025005, 24세,2017,428,227,201,112.9,402,219,183,119.7
35380, 부안군,030,25~29세,2017,2090,1139,951,119.8,1915,1040,875,118.9
35380, 부안군,030001, 25세,2017,405,207,198,104.5,377,197,180,109.4
35380, 부안군,030002, 26세,2017,447,231,216,106.9,409,209,200,104.5
35380, 부안군,030003, 27세,2017,398,215,183,117.5,364,199,165,120.6
35380, 부안군,030004, 28세,2017,431,242,189,128,397,216,181,119.3
35380, 부안군,030005, 29세,2017,409,244,165,147.9,368,219,149,147
35380, 부안군,035,30~34세,2017,2077,1159,918,126.3,1904,1064,840,126.7
35380, 부안군,035001, 30세,2017,392,232,160,145,354,212,142,149.3
35380, 부안군,035002, 31세,2017,426,241,185,130.3,385,222,163,136.2
35380, 부안군,035003, 32세,2017,371,211,160,131.9,344,194,150,129.3
35380, 부안군,035004, 33세,2017,457,243,214,113.6,420,220,200,110
35380, 부안군,035005, 34세,2017,431,232,199,116.6,401,216,185,116.8
35380, 부안군,040,35~39세,2017,2557,1354,1203,112.6,2446,1305,1141,114.4
35380, 부안군,040001, 35세,2017,489,225,264,85.2,471,218,253,86.2
35380, 부안군,040002, 36세,2017,487,269,218,123.4,462,259,203,127.6
35380, 부안군,040003, 37세,2017,556,306,250,122.4,529,293,236,124.2
35380, 부안군,040004, 38세,2017,489,262,227,115.4,472,253,219,115.5
35380, 부안군,040005, 39세,2017,536,292,244,119.7,512,282,230,122.6
35380, 부안군,045,40~44세,2017,2886,1622,1264,128.3,2815,1590,1225,129.8
35380, 부안군,045001, 40세,2017,474,266,208,127.9,460,259,201,128.9
35380, 부안군,045002, 41세,2017,554,318,236,134.7,541,311,230,135.2
35380, 부안군,045003, 42세,2017,519,291,228,127.6,506,287,219,131.1
35380, 부안군,045004, 43세,2017,694,402,292,137.7,677,396,281,140.9
35380, 부안군,045005, 44세,2017,645,345,300,115,631,337,294,114.6
35380, 부안군,050,45~49세,2017,3608,2003,1605,124.8,3516,1962,1554,126.3
35380, 부안군,050001, 45세,2017,661,359,302,118.9,635,349,286,122
35380, 부안군,050002, 46세,2017,743,420,323,130,727,410,317,129.3
35380, 부안군,050003, 47세,2017,703,372,331,112.4,689,366,323,113.3
35380, 부안군,050004, 48세,2017,737,427,310,137.7,715,417,298,139.9
35380, 부안군,050005, 49세,2017,764,425,339,125.4,750,420,330,127.3
35380, 부안군,055,50~54세,2017,3917,2097,1820,115.2,3831,2068,1763,117.3
35380, 부안군,055001, 50세,2017,732,385,347,111,715,381,334,114.1
35380, 부안군,055002, 51세,2017,774,431,343,125.7,755,424,331,128.1
35380, 부안군,055003, 52세,2017,777,425,352,120.7,758,418,340,122.9
35380, 부안군,055004, 53세,2017,814,428,386,110.9,804,423,381,111
35380, 부안군,055005, 54세,2017,820,428,392,109.2,799,422,377,111.9
35380, 부안군,060,55~59세,2017,4829,2415,2414,100,4772,2389,2383,100.3
35380, 부안군,060001, 55세,2017,939,505,434,116.4,920,499,421,118.5
35380, 부안군,060002, 56세,2017,955,436,519,84,947,431,516,83.5
35380, 부안군,060003, 57세,2017,1022,502,520,96.5,1009,494,515,95.9
35380, 부안군,060004, 58세,2017,945,475,470,101.1,936,471,465,101.3
35380, 부안군,060005, 59세,2017,968,497,471,105.5,960,494,466,106
35380, 부안군,065,60~64세,2017,4339,2186,2153,101.5,4305,2174,2131,102
35380, 부안군,065001, 60세,2017,983,520,463,112.3,971,517,454,113.9
35380, 부안군,065002, 61세,2017,870,444,426,104.2,863,442,421,105
35380, 부안군,065003, 62세,2017,937,455,482,94.4,933,452,481,94
35380, 부안군,065004, 63세,2017,872,421,451,93.3,867,419,448,93.5
35380, 부안군,065005, 64세,2017,677,346,331,104.5,671,344,327,105.2
35380, 부안군,070,65~69세,2017,4034,1934,2100,92.1,4021,1927,2094,92
35380, 부안군,070001, 65세,2017,828,407,421,96.7,827,406,421,96.4
35380, 부안군,070002, 66세,2017,764,346,418,82.8,761,344,417,82.5
35380, 부안군,070003, 67세,2017,847,394,453,87,842,393,449,87.5
35380, 부안군,070004, 68세,2017,837,407,430,94.7,836,406,430,94.4
35380, 부안군,070005, 69세,2017,758,380,378,100.5,755,378,377,100.3
35380, 부안군,075,70~74세,2017,3631,1603,2028,79,3629,1602,2027,79
35380, 부안군,075001, 70세,2017,901,408,493,82.8,901,408,493,82.8
35380, 부안군,075002, 71세,2017,701,326,375,86.9,699,325,374,86.9
35380, 부안군,075003, 72세,2017,634,278,356,78.1,634,278,356,78.1
35380, 부안군,075004, 73세,2017,678,288,390,73.8,678,288,390,73.8
35380, 부안군,075005, 74세,2017,717,303,414,73.2,717,303,414,73.2
35380, 부안군,080,75~79세,2017,3739,1433,2306,62.1,3738,1433,2305,62.2
35380, 부안군,080001, 75세,2017,950,382,568,67.3,950,382,568,67.3
35380, 부안군,080002, 76세,2017,702,253,449,56.3,701,253,448,56.5
35380, 부안군,080003, 77세,2017,647,250,397,63,647,250,397,63
35380, 부안군,080004, 78세,2017,746,281,465,60.4,746,281,465,60.4
35380, 부안군,080005, 79세,2017,694,267,427,62.5,694,267,427,62.5
35380, 부안군,085,80~84세,2017,2724,915,1809,50.6,2723,915,1808,50.6
35380, 부안군,085001, 80세,2017,623,239,384,62.2,623,239,384,62.2
35380, 부안군,085002, 81세,2017,566,187,379,49.3,566,187,379,49.3
35380, 부안군,085003, 82세,2017,588,184,404,45.5,588,184,404,45.5
35380, 부안군,085004, 83세,2017,511,164,347,47.3,510,164,346,47.4
35380, 부안군,085005, 84세,2017,436,141,295,47.8,436,141,295,47.8
35380, 부안군,090,85~89세,2017,1194,308,886,34.8,1193,307,886,34.7
35380, 부안군,090001, 85세,2017,309,75,234,32.1,309,75,234,32.1
35380, 부안군,090002, 86세,2017,282,77,205,37.6,282,77,205,37.6
35380, 부안군,090003, 87세,2017,247,69,178,38.8,246,68,178,38.2
35380, 부안군,090004, 88세,2017,194,57,137,41.6,194,57,137,41.6
35380, 부안군,090005, 89세,2017,162,30,132,22.7,162,30,132,22.7
35380, 부안군,095,90~94세,2017,331,71,260,27.3,331,71,260,27.3
35380, 부안군,095001, 90세,2017,137,26,111,23.4,137,26,111,23.4
35380, 부안군,095002, 91세,2017,63,18,45,40,63,18,45,40
35380, 부안군,095003, 92세,2017,57,14,43,32.6,57,14,43,32.6
35380, 부안군,095004, 93세,2017,31,9,22,40.9,31,9,22,40.9
35380, 부안군,095005, 94세,2017,43,X,39,10.3,43,X,39,10.3
35380, 부안군,100,95~99세,2017,70,16,54,29.6,70,16,54,29.6
35380, 부안군,100001, 95세,2017,24,8,16,50,24,8,16,50
35380, 부안군,100002, 96세,2017,14,X,11,27.3,14,X,11,27.3
35380, 부안군,100003, 97세,2017,16,X,15,6.7,16,X,15,6.7
35380, 부안군,100004, 98세,2017,9,X,7,28.6,9,X,7,28.6
35380, 부안군,100005, 99세,2017,7,X,5,40,7,X,5,40
35380, 부안군,101,100세이상,2017,9,X,8,12.5,9,X,8,12.5
35380, 부안군,102,15세미만,2017,4665,2448,2217,110.4,4659,2445,2214,110.4
35380, 부안군,103,15~64세,2017,30852,16670,14182,117.5,29963,16254,13709,118.6
35380, 부안군,104,65세이상,2017,15732,6281,9451,66.5,15714,6272,9442,66.4
35380, 부안군,086,85세이상,2017,1604,396,1208,32.8,1603,395,1208,32.7
35380, 부안군,126,평균연령,2017,50.5,47.6,53.3,,50.7,47.8,53.6,
35380, 부안군,127,중위연령,2017,54.1,50.7,57.3,,54.5,51.1,57.7,
36,전라남도,000,합계,2017,1792319,899077,893242,100.7,1755107,876537,878570,99.8
36,전라남도,005,0~4세,2017,70463,36156,34307,105.4,70290,36064,34226,105.4
36,전라남도,005001, 0세,2017,12393,6454,5939,108.7,12342,6426,5916,108.6
36,전라남도,005002, 1세,2017,13932,7108,6824,104.2,13896,7085,6811,104
36,전라남도,005003, 2세,2017,14588,7496,7092,105.7,14556,7480,7076,105.7
36,전라남도,005004, 3세,2017,14398,7313,7085,103.2,14373,7303,7070,103.3
36,전라남도,005005, 4세,2017,15152,7785,7367,105.7,15123,7770,7353,105.7
36,전라남도,010,5~9세,2017,77847,39799,38048,104.6,77707,39735,37972,104.6
36,전라남도,010001, 5세,2017,16379,8249,8130,101.5,16340,8228,8112,101.4
36,전라남도,010002, 6세,2017,16378,8264,8114,101.8,16348,8252,8096,101.9
36,전라남도,010003, 7세,2017,15035,7878,7157,110.1,15015,7868,7147,110.1
36,전라남도,010004, 8세,2017,14706,7538,7168,105.2,14683,7531,7152,105.3
36,전라남도,010005, 9세,2017,15349,7870,7479,105.2,15321,7856,7465,105.2
36,전라남도,015,10~14세,2017,77604,40141,37463,107.1,77504,40090,37414,107.2
36,전라남도,015001, 10세,2017,15833,8126,7707,105.4,15812,8114,7698,105.4
36,전라남도,015002, 11세,2017,14720,7596,7124,106.6,14704,7590,7114,106.7
36,전라남도,015003, 12세,2017,14407,7414,6993,106,14388,7401,6987,105.9
36,전라남도,015004, 13세,2017,16151,8446,7705,109.6,16127,8433,7694,109.6
36,전라남도,015005, 14세,2017,16493,8559,7934,107.9,16473,8552,7921,108
36,전라남도,020,15~19세,2017,101276,54087,47189,114.6,100754,53845,46909,114.8
36,전라남도,020001, 15세,2017,17605,9175,8430,108.8,17584,9161,8423,108.8
36,전라남도,020002, 16세,2017,21067,11058,10009,110.5,21042,11043,9999,110.4
36,전라남도,020003, 17세,2017,23377,12159,11218,108.4,23322,12135,11187,108.5
36,전라남도,020004, 18세,2017,21039,11221,9818,114.3,20903,11155,9748,114.4
36,전라남도,020005, 19세,2017,18188,10474,7714,135.8,17903,10351,7552,137.1
36,전라남도,025,20~24세,2017,99316,58188,41128,141.5,93977,54839,39138,140.1
36,전라남도,025001, 20세,2017,20588,12390,8198,151.1,20139,12165,7974,152.6
36,전라남도,025002, 21세,2017,21143,12949,8194,158,20386,12492,7894,158.2
36,전라남도,025003, 22세,2017,20069,11906,8163,145.9,18937,11175,7762,144
36,전라남도,025004, 23세,2017,19020,10832,8188,132.3,17656,9936,7720,128.7
36,전라남도,025005, 24세,2017,18496,10111,8385,120.6,16859,9071,7788,116.5
36,전라남도,030,25~29세,2017,85448,46344,39104,118.5,76918,40729,36189,112.5
36,전라남도,030001, 25세,2017,18578,9968,8610,115.8,16830,8793,8037,109.4
36,전라남도,030002, 26세,2017,17290,9458,7832,120.8,15552,8302,7250,114.5
36,전라남도,030003, 27세,2017,17207,9380,7827,119.8,15395,8212,7183,114.3
36,전라남도,030004, 28세,2017,16269,8878,7391,120.1,14627,7805,6822,114.4
36,전라남도,030005, 29세,2017,16104,8660,7444,116.3,14514,7617,6897,110.4
36,전라남도,035,30~34세,2017,92737,48937,43800,111.7,86282,44737,41545,107.7
36,전라남도,035001, 30세,2017,16618,8756,7862,111.4,15121,7796,7325,106.4
36,전라남도,035002, 31세,2017,17382,9212,8170,112.8,15933,8292,7641,108.5
36,전라남도,035003, 32세,2017,17805,9440,8365,112.9,16540,8623,7917,108.9
36,전라남도,035004, 33세,2017,19337,10125,9212,109.9,18195,9383,8812,106.5
36,전라남도,035005, 34세,2017,21595,11404,10191,111.9,20493,10643,9850,108.1
36,전라남도,040,35~39세,2017,116128,61550,54578,112.8,111710,58617,53093,110.4
36,전라남도,040001, 35세,2017,23823,12726,11097,114.7,22750,12021,10729,112
36,전라남도,040002, 36세,2017,22725,12224,10501,116.4,21753,11563,10190,113.5
36,전라남도,040003, 37세,2017,24118,12638,11480,110.1,23301,12106,11195,108.1
36,전라남도,040004, 38세,2017,23540,12329,11211,110,22710,11766,10944,107.5
36,전라남도,040005, 39세,2017,21922,11633,10289,113.1,21196,11161,10035,111.2
36,전라남도,045,40~44세,2017,122230,64817,57413,112.9,119143,62868,56275,111.7
36,전라남도,045001, 40세,2017,22845,11956,10889,109.8,22184,11508,10676,107.8
36,전라남도,045002, 41세,2017,22568,12128,10440,116.2,21882,11706,10176,115
36,전라남도,045003, 42세,2017,23440,12392,11048,112.2,22861,12022,10839,110.9
36,전라남도,045004, 43세,2017,26224,13991,12233,114.4,25661,13647,12014,113.6
36,전라남도,045005, 44세,2017,27153,14350,12803,112.1,26555,13985,12570,111.3
36,전라남도,050,45~49세,2017,144949,77420,67529,114.6,142166,75950,66216,114.7
36,전라남도,050001, 45세,2017,27275,14634,12641,115.8,26698,14305,12393,115.4
36,전라남도,050002, 46세,2017,29579,15866,13713,115.7,29013,15568,13445,115.8
36,전라남도,050003, 47세,2017,28656,15287,13369,114.3,28079,14970,13109,114.2
36,전라남도,050004, 48세,2017,28950,15339,13611,112.7,28408,15076,13332,113.1
36,전라남도,050005, 49세,2017,30489,16294,14195,114.8,29968,16031,13937,115
36,전라남도,055,50~54세,2017,143640,76408,67232,113.6,141303,75379,65924,114.3
36,전라남도,055001, 50세,2017,28252,14986,13266,113,27801,14788,13013,113.6
36,전라남도,055002, 51세,2017,29129,15944,13185,120.9,28673,15728,12945,121.5
36,전라남도,055003, 52세,2017,29030,15417,13613,113.3,28533,15205,13328,114.1
36,전라남도,055004, 53세,2017,27367,14320,13047,109.8,26935,14140,12795,110.5
36,전라남도,055005, 54세,2017,29862,15741,14121,111.5,29361,15518,13843,112.1
36,전라남도,060,55~59세,2017,153229,78047,75182,103.8,151678,77354,74324,104.1
36,전라남도,060001, 55세,2017,28932,15140,13792,109.8,28569,14969,13600,110.1
36,전라남도,060002, 56세,2017,31967,16164,15803,102.3,31661,16030,15631,102.6
36,전라남도,060003, 57세,2017,33699,16994,16705,101.7,33347,16822,16525,101.8
36,전라남도,060004, 58세,2017,30555,15363,15192,101.1,30300,15260,15040,101.5
36,전라남도,060005, 59세,2017,28076,14386,13690,105.1,27801,14273,13528,105.5
36,전라남도,065,60~64세,2017,119939,60069,59870,100.3,118933,59567,59366,100.3
36,전라남도,065001, 60세,2017,27838,14228,13610,104.5,27576,14096,13480,104.6
36,전라남도,065002, 61세,2017,24392,12330,12062,102.2,24168,12224,11944,102.3
36,전라남도,065003, 62세,2017,26232,13105,13127,99.8,26015,12995,13020,99.8
36,전라남도,065004, 63세,2017,22143,10924,11219,97.4,21973,10843,11130,97.4
36,전라남도,065005, 64세,2017,19334,9482,9852,96.2,19201,9409,9792,96.1
36,전라남도,070,65~69세,2017,104820,51048,53772,94.9,104357,50823,53534,94.9
36,전라남도,070001, 65세,2017,22863,11149,11714,95.2,22743,11093,11650,95.2
36,전라남도,070002, 66세,2017,20132,9930,10202,97.3,20024,9884,10140,97.5
36,전라남도,070003, 67세,2017,20790,10130,10660,95,20682,10074,10608,95
36,전라남도,070004, 68세,2017,20756,10120,10636,95.1,20679,10076,10603,95
36,전라남도,070005, 69세,2017,20279,9719,10560,92,20229,9696,10533,92.1
36,전라남도,075,70~74세,2017,89148,39617,49531,80,89002,39557,49445,80
36,전라남도,075001, 70세,2017,21673,10163,11510,88.3,21627,10142,11485,88.3
36,전라남도,075002, 71세,2017,16453,7589,8864,85.6,16422,7579,8843,85.7
36,전라남도,075003, 72세,2017,16816,7371,9445,78,16791,7362,9429,78.1
36,전라남도,075004, 73세,2017,16041,6893,9148,75.3,16022,6883,9139,75.3
36,전라남도,075005, 74세,2017,18165,7601,10564,72,18140,7591,10549,72
36,전라남도,080,75~79세,2017,94255,37121,57134,65,94159,37081,57078,65
36,전라남도,080001, 75세,2017,23544,9769,13775,70.9,23523,9760,13763,70.9
36,전라남도,080002, 76세,2017,19130,7743,11387,68,19100,7735,11365,68.1
36,전라남도,080003, 77세,2017,18159,7009,11150,62.9,18152,7007,11145,62.9
36,전라남도,080004, 78세,2017,17350,6690,10660,62.8,17331,6680,10651,62.7
36,전라남도,080005, 79세,2017,16072,5910,10162,58.2,16053,5899,10154,58.1
36,전라남도,085,80~84세,2017,59382,19650,39732,49.5,59336,19629,39707,49.4
36,전라남도,085001, 80세,2017,14627,5255,9372,56.1,14612,5248,9364,56
36,전라남도,085002, 81세,2017,12696,4377,8319,52.6,12686,4371,8315,52.6
36,전라남도,085003, 82세,2017,12180,3969,8211,48.3,12169,3964,8205,48.3
36,전라남도,085004, 83세,2017,10849,3402,7447,45.7,10847,3401,7446,45.7
36,전라남도,085005, 84세,2017,9030,2647,6383,41.5,9022,2645,6377,41.5
36,전라남도,090,85~89세,2017,29278,7522,21756,34.6,29262,7518,21744,34.6
36,전라남도,090001, 85세,2017,7905,2236,5669,39.4,7901,2235,5666,39.4
36,전라남도,090002, 86세,2017,6404,1650,4754,34.7,6402,1650,4752,34.7
36,전라남도,090003, 87세,2017,6581,1516,5065,29.9,6576,1515,5061,29.9
36,전라남도,090004, 88세,2017,4756,1247,3509,35.5,4753,1246,3507,35.5
36,전라남도,090005, 89세,2017,3632,873,2759,31.6,3630,872,2758,31.6
36,전라남도,095,90~94세,2017,8387,1797,6590,27.3,8384,1796,6588,27.3
36,전라남도,095001, 90세,2017,2676,614,2062,29.8,2676,614,2062,29.8
36,전라남도,095002, 91세,2017,1885,425,1460,29.1,1885,425,1460,29.1
36,전라남도,095003, 92세,2017,1468,332,1136,29.2,1466,332,1134,29.3
36,전라남도,095004, 93세,2017,1066,231,835,27.7,1065,230,835,27.5
36,전라남도,095005, 94세,2017,1292,195,1097,17.8,1292,195,1097,17.8
36,전라남도,100,95~99세,2017,2023,337,1686,20,2022,337,1685,20
36,전라남도,100001, 95세,2017,817,152,665,22.9,817,152,665,22.9
36,전라남도,100002, 96세,2017,493,81,412,19.7,493,81,412,19.7
36,전라남도,100003, 97세,2017,351,49,302,16.2,351,49,302,16.2
36,전라남도,100004, 98세,2017,212,34,178,19.1,212,34,178,19.1
36,전라남도,100005, 99세,2017,150,21,129,16.3,149,21,128,16.4
36,전라남도,101,100세이상,2017,220,22,198,11.1,220,22,198,11.1
36,전라남도,102,15세미만,2017,225914,116096,109818,105.7,225501,115889,109612,105.7
36,전라남도,103,15~64세,2017,1178892,625867,553025,113.2,1142864,603885,538979,112
36,전라남도,104,65세이상,2017,387513,157114,230399,68.2,386742,156763,229979,68.2
36,전라남도,086,85세이상,2017,39908,9678,30230,32,39888,9673,30215,32
36,전라남도,126,평균연령,2017,45,43,47,,45.2,43.2,47.2,
36,전라남도,127,중위연령,2017,46.9,45,49,,47.3,45.5,49.3,
36004, 읍부,000,합계,2017,430043,216052,213991,101,418479,208861,209618,99.6
36004, 읍부,005,0~4세,2017,19048,9695,9353,103.7,18979,9651,9328,103.5
36004, 읍부,005001, 0세,2017,3400,1709,1691,101.1,3380,1696,1684,100.7
36004, 읍부,005002, 1세,2017,3697,1898,1799,105.5,3680,1885,1795,105
36004, 읍부,005003, 2세,2017,3871,1957,1914,102.2,3858,1948,1910,102
36004, 읍부,005004, 3세,2017,3921,1990,1931,103.1,3912,1987,1925,103.2
36004, 읍부,005005, 4세,2017,4159,2141,2018,106.1,4149,2135,2014,106
36004, 읍부,010,5~9세,2017,20727,10628,10099,105.2,20661,10597,10064,105.3
36004, 읍부,010001, 5세,2017,4424,2242,2182,102.7,4403,2231,2172,102.7
36004, 읍부,010002, 6세,2017,4441,2272,2169,104.7,4425,2266,2159,105
36004, 읍부,010003, 7세,2017,3923,2038,1885,108.1,3910,2032,1878,108.2
36004, 읍부,010004, 8세,2017,3888,2020,1868,108.1,3883,2018,1865,108.2
36004, 읍부,010005, 9세,2017,4051,2056,1995,103.1,4040,2050,1990,103
36004, 읍부,015,10~14세,2017,20334,10590,9744,108.7,20291,10561,9730,108.5
36004, 읍부,015001, 10세,2017,4159,2135,2024,105.5,4150,2130,2020,105.4
36004, 읍부,015002, 11세,2017,3925,2056,1869,110,3917,2051,1866,109.9
36004, 읍부,015003, 12세,2017,3823,1975,1848,106.9,3813,1968,1845,106.7
36004, 읍부,015004, 13세,2017,4165,2195,1970,111.4,4156,2189,1967,111.3
36004, 읍부,015005, 14세,2017,4262,2229,2033,109.6,4255,2223,2032,109.4
36004, 읍부,020,15~19세,2017,27400,14343,13057,109.8,27279,14296,12983,110.1
36004, 읍부,020001, 15세,2017,4641,2376,2265,104.9,4631,2371,2260,104.9
36004, 읍부,020002, 16세,2017,6134,3119,3015,103.4,6126,3113,3013,103.3
36004, 읍부,020003, 17세,2017,7009,3557,3452,103,6994,3553,3441,103.3
36004, 읍부,020004, 18세,2017,5377,2816,2561,110,5345,2804,2541,110.4
36004, 읍부,020005, 19세,2017,4239,2475,1764,140.3,4183,2455,1728,142.1
36004, 읍부,025,20~24세,2017,23014,13440,9574,140.4,21640,12563,9077,138.4
36004, 읍부,025001, 20세,2017,4876,2903,1973,147.1,4778,2846,1932,147.3
36004, 읍부,025002, 21세,2017,4984,3097,1887,164.1,4791,2985,1806,165.3
36004, 읍부,025003, 22세,2017,4672,2724,1948,139.8,4381,2542,1839,138.2
36004, 읍부,025004, 23세,2017,4388,2490,1898,131.2,4024,2248,1776,126.6
36004, 읍부,025005, 24세,2017,4094,2226,1868,119.2,3666,1942,1724,112.6
36004, 읍부,030,25~29세,2017,19586,10462,9124,114.7,17162,8824,8338,105.8
36004, 읍부,030001, 25세,2017,4113,2200,1913,115,3652,1884,1768,106.6
36004, 읍부,030002, 26세,2017,3954,2130,1824,116.8,3454,1780,1674,106.3
36004, 읍부,030003, 27세,2017,3927,2113,1814,116.5,3430,1792,1638,109.4
36004, 읍부,030004, 28세,2017,3758,2011,1747,115.1,3266,1684,1582,106.4
36004, 읍부,030005, 29세,2017,3834,2008,1826,110,3360,1684,1676,100.5
36004, 읍부,035,30~34세,2017,22804,11783,11021,106.9,20688,10329,10359,99.7
36004, 읍부,035001, 30세,2017,4058,2028,2030,99.9,3573,1700,1873,90.8
36004, 읍부,035002, 31세,2017,4251,2238,2013,111.2,3775,1909,1866,102.3
36004, 읍부,035003, 32세,2017,4413,2280,2133,106.9,3997,1994,2003,99.6
36004, 읍부,035004, 33세,2017,4722,2420,2302,105.1,4343,2170,2173,99.9
36004, 읍부,035005, 34세,2017,5360,2817,2543,110.8,5000,2556,2444,104.6
36004, 읍부,040,35~39세,2017,29611,15500,14111,109.8,28258,14545,13713,106.1
36004, 읍부,040001, 35세,2017,6085,3219,2866,112.3,5764,2986,2778,107.5
36004, 읍부,040002, 36세,2017,5695,3029,2666,113.6,5359,2787,2572,108.4
36004, 읍부,040003, 37세,2017,6121,3144,2977,105.6,5858,2964,2894,102.4
36004, 읍부,040004, 38세,2017,6029,3128,2901,107.8,5805,2974,2831,105.1
36004, 읍부,040005, 39세,2017,5681,2980,2701,110.3,5472,2834,2638,107.4
36004, 읍부,045,40~44세,2017,31192,16475,14717,111.9,30189,15826,14363,110.2
36004, 읍부,045001, 40세,2017,5808,3024,2784,108.6,5611,2885,2726,105.8
36004, 읍부,045002, 41세,2017,5768,3063,2705,113.2,5537,2912,2625,110.9
36004, 읍부,045003, 42세,2017,5953,3122,2831,110.3,5750,2992,2758,108.5
36004, 읍부,045004, 43세,2017,6815,3641,3174,114.7,6623,3521,3102,113.5
36004, 읍부,045005, 44세,2017,6848,3625,3223,112.5,6668,3516,3152,111.5
36004, 읍부,050,45~49세,2017,35296,19172,16124,118.9,34317,18653,15664,119.1
36004, 읍부,050001, 45세,2017,6741,3614,3127,115.6,6545,3501,3044,115
36004, 읍부,050002, 46세,2017,7389,4047,3342,121.1,7192,3949,3243,121.8
36004, 읍부,050003, 47세,2017,7060,3845,3215,119.6,6848,3733,3115,119.8
36004, 읍부,050004, 48세,2017,6908,3735,3173,117.7,6730,3646,3084,118.2
36004, 읍부,050005, 49세,2017,7198,3931,3267,120.3,7002,3824,3178,120.3
36004, 읍부,055,50~54세,2017,32726,17513,15213,115.1,31910,17126,14784,115.8
36004, 읍부,055001, 50세,2017,6515,3490,3025,115.4,6372,3422,2950,116
36004, 읍부,055002, 51세,2017,6794,3782,3012,125.6,6618,3696,2922,126.5
36004, 읍부,055003, 52세,2017,6517,3452,3065,112.6,6351,3368,2983,112.9
36004, 읍부,055004, 53세,2017,6151,3254,2897,112.3,5992,3181,2811,113.2
36004, 읍부,055005, 54세,2017,6749,3535,3214,110,6577,3459,3118,110.9
36004, 읍부,060,55~59세,2017,34770,17911,16859,106.2,34230,17656,16574,106.5
36004, 읍부,060001, 55세,2017,6710,3489,3221,108.3,6579,3428,3151,108.8
36004, 읍부,060002, 56세,2017,7270,3721,3549,104.8,7187,3681,3506,105
36004, 읍부,060003, 57세,2017,7628,3946,3682,107.2,7484,3873,3611,107.3
36004, 읍부,060004, 58세,2017,6861,3509,3352,104.7,6777,3472,3305,105.1
36004, 읍부,060005, 59세,2017,6301,3246,3055,106.3,6203,3202,3001,106.7
36004, 읍부,065,60~64세,2017,27016,13447,13569,99.1,26645,13264,13381,99.1
36004, 읍부,065001, 60세,2017,6307,3253,3054,106.5,6206,3196,3010,106.2
36004, 읍부,065002, 61세,2017,5479,2828,2651,106.7,5395,2790,2605,107.1
36004, 읍부,065003, 62세,2017,5860,2882,2978,96.8,5787,2847,2940,96.8
36004, 읍부,065004, 63세,2017,5001,2406,2595,92.7,4932,2379,2553,93.2
36004, 읍부,065005, 64세,2017,4369,2078,2291,90.7,4325,2052,2273,90.3
36004, 읍부,070,65~69세,2017,23666,11420,12246,93.3,23500,11341,12159,93.3
36004, 읍부,070001, 65세,2017,5116,2464,2652,92.9,5066,2442,2624,93.1
36004, 읍부,070002, 66세,2017,4600,2245,2355,95.3,4566,2231,2335,95.5
36004, 읍부,070003, 67세,2017,4734,2266,2468,91.8,4692,2247,2445,91.9
36004, 읍부,070004, 68세,2017,4680,2276,2404,94.7,4650,2258,2392,94.4
36004, 읍부,070005, 69세,2017,4536,2169,2367,91.6,4526,2163,2363,91.5
36004, 읍부,075,70~74세,2017,19953,9009,10944,82.3,19896,8988,10908,82.4
36004, 읍부,075001, 70세,2017,4927,2374,2553,93,4909,2366,2543,93
36004, 읍부,075002, 71세,2017,3737,1730,2007,86.2,3727,1727,2000,86.4
36004, 읍부,075003, 72세,2017,3750,1681,2069,81.2,3740,1679,2061,81.5
36004, 읍부,075004, 73세,2017,3526,1542,1984,77.7,3516,1537,1979,77.7
36004, 읍부,075005, 74세,2017,4013,1682,2331,72.2,4004,1679,2325,72.2
36004, 읍부,080,75~79세,2017,20612,8142,12470,65.3,20572,8129,12443,65.3
36004, 읍부,080001, 75세,2017,5174,2147,3027,70.9,5168,2144,3024,70.9
36004, 읍부,080002, 76세,2017,4191,1705,2486,68.6,4176,1702,2474,68.8
36004, 읍부,080003, 77세,2017,3976,1522,2454,62,3973,1521,2452,62
36004, 읍부,080004, 78세,2017,3787,1455,2332,62.4,3779,1453,2326,62.5
36004, 읍부,080005, 79세,2017,3484,1313,2171,60.5,3476,1309,2167,60.4
36004, 읍부,085,80~84세,2017,12979,4361,8618,50.6,12962,4354,8608,50.6
36004, 읍부,085001, 80세,2017,3181,1141,2040,55.9,3172,1136,2036,55.8
36004, 읍부,085002, 81세,2017,2767,979,1788,54.8,2765,978,1787,54.7
36004, 읍부,085003, 82세,2017,2647,894,1753,51,2644,893,1751,51
36004, 읍부,085004, 83세,2017,2446,796,1650,48.2,2446,796,1650,48.2
36004, 읍부,085005, 84세,2017,1938,551,1387,39.7,1935,551,1384,39.8
36004, 읍부,090,85~89세,2017,6816,1672,5144,32.5,6810,1670,5140,32.5
36004, 읍부,090001, 85세,2017,1828,488,1340,36.4,1826,487,1339,36.4
36004, 읍부,090002, 86세,2017,1497,381,1116,34.1,1496,381,1115,34.2
36004, 읍부,090003, 87세,2017,1498,331,1167,28.4,1495,330,1165,28.3
36004, 읍부,090004, 88세,2017,1121,282,839,33.6,1121,282,839,33.6
36004, 읍부,090005, 89세,2017,872,190,682,27.9,872,190,682,27.9
36004, 읍부,095,90~94세,2017,1967,410,1557,26.3,1964,409,1555,26.3
36004, 읍부,095001, 90세,2017,626,143,483,29.6,626,143,483,29.6
36004, 읍부,095002, 91세,2017,424,90,334,26.9,424,90,334,26.9
36004, 읍부,095003, 92세,2017,337,83,254,32.7,335,83,252,32.9
36004, 읍부,095004, 93세,2017,267,55,212,25.9,266,54,212,25.5
36004, 읍부,095005, 94세,2017,313,39,274,14.2,313,39,274,14.2
36004, 읍부,100,95~99세,2017,470,74,396,18.7,470,74,396,18.7
36004, 읍부,100001, 95세,2017,203,33,170,19.4,203,33,170,19.4
36004, 읍부,100002, 96세,2017,105,20,85,23.5,105,20,85,23.5
36004, 읍부,100003, 97세,2017,78,9,69,13,78,9,69,13
36004, 읍부,100004, 98세,2017,45,X,41,9.8,45,X,41,9.8
36004, 읍부,100005, 99세,2017,39,8,31,25.8,39,8,31,25.8
36004, 읍부,101,100세이상,2017,56,5,51,9.8,56,5,51,9.8
36004, 읍부,102,15세미만,2017,60109,30913,29196,105.9,59931,30809,29122,105.8
36004, 읍부,103,15~64세,2017,283415,150046,133369,112.5,272318,143082,129236,110.7
36004, 읍부,104,65세이상,2017,86519,35093,51426,68.2,86230,34970,51260,68.2
36004, 읍부,086,85세이상,2017,9309,2161,7148,30.2,9300,2158,7142,30.2
36004, 읍부,126,평균연령,2017,43.7,41.8,45.5,,43.9,42.1,45.6,
36004, 읍부,127,중위연령,2017,45.2,43.7,46.9,,45.6,44.2,47.2,
36005, 면부,000,합계,2017,576744,285396,291348,98,561468,275696,285772,96.5
36005, 면부,005,0~4세,2017,16419,8331,8088,103,16408,8325,8083,103
36005, 면부,005001, 0세,2017,3119,1631,1488,109.6,3116,1629,1487,109.5
36005, 면부,005002, 1세,2017,3387,1704,1683,101.2,3386,1704,1682,101.3
36005, 면부,005003, 2세,2017,3408,1707,1701,100.4,3406,1705,1701,100.2
36005, 면부,005004, 3세,2017,3178,1602,1576,101.6,3176,1601,1575,101.7
36005, 면부,005005, 4세,2017,3327,1687,1640,102.9,3324,1686,1638,102.9
36005, 면부,010,5~9세,2017,15846,8167,7679,106.4,15826,8161,7665,106.5
36005, 면부,010001, 5세,2017,3431,1737,1694,102.5,3427,1735,1692,102.5
36005, 면부,010002, 6세,2017,3269,1670,1599,104.4,3266,1670,1596,104.6
36005, 면부,010003, 7세,2017,2991,1568,1423,110.2,2988,1566,1422,110.1
36005, 면부,010004, 8세,2017,2992,1555,1437,108.2,2987,1554,1433,108.4
36005, 면부,010005, 9세,2017,3163,1637,1526,107.3,3158,1636,1522,107.5
36005, 면부,015,10~14세,2017,16376,8527,7849,108.6,16355,8518,7837,108.7
36005, 면부,015001, 10세,2017,3309,1673,1636,102.3,3305,1670,1635,102.1
36005, 면부,015002, 11세,2017,2972,1541,1431,107.7,2972,1541,1431,107.7
36005, 면부,015003, 12세,2017,3042,1601,1441,111.1,3039,1599,1440,111
36005, 면부,015004, 13세,2017,3505,1841,1664,110.6,3498,1838,1660,110.7
36005, 면부,015005, 14세,2017,3548,1871,1677,111.6,3541,1870,1671,111.9
36005, 면부,020,15~19세,2017,22077,12168,9909,122.8,21935,12099,9836,123
36005, 면부,020001, 15세,2017,3871,2060,1811,113.7,3866,2056,1810,113.6
36005, 면부,020002, 16세,2017,4444,2416,2028,119.1,4439,2415,2024,119.3
36005, 면부,020003, 17세,2017,4530,2456,2074,118.4,4522,2450,2072,118.2
36005, 면부,020004, 18세,2017,4920,2694,2226,121,4889,2679,2210,121.2
36005, 면부,020005, 19세,2017,4312,2542,1770,143.6,4219,2499,1720,145.3
36005, 면부,025,20~24세,2017,25111,15351,9760,157.3,22447,13507,8940,151.1
36005, 면부,025001, 20세,2017,5143,3197,1946,164.3,4940,3085,1855,166.3
36005, 면부,025002, 21세,2017,5157,3271,1886,173.4,4823,3044,1779,171.1
36005, 면부,025003, 22세,2017,5112,3169,1943,163.1,4527,2747,1780,154.3
36005, 면부,025004, 23세,2017,4837,2918,1919,152.1,4153,2415,1738,139
36005, 면부,025005, 24세,2017,4862,2796,2066,135.3,4004,2216,1788,123.9
36005, 면부,030,25~29세,2017,22832,13017,9815,132.6,18785,10165,8620,117.9
36005, 면부,030001, 25세,2017,4906,2777,2129,130.4,4049,2156,1893,113.9
36005, 면부,030002, 26세,2017,4656,2664,1992,133.7,3819,2058,1761,116.9
36005, 면부,030003, 27세,2017,4693,2698,1995,135.2,3820,2093,1727,121.2
36005, 면부,030004, 28세,2017,4270,2441,1829,133.5,3513,1911,1602,119.3
36005, 면부,030005, 29세,2017,4307,2437,1870,130.3,3584,1947,1637,118.9
36005, 면부,035,30~34세,2017,22853,12664,10189,124.3,20104,10837,9267,116.9
36005, 면부,035001, 30세,2017,4323,2404,1919,125.3,3673,1970,1703,115.7
36005, 면부,035002, 31세,2017,4473,2466,2007,122.9,3852,2061,1791,115.1
36005, 면부,035003, 32세,2017,4356,2394,1962,122,3808,2036,1772,114.9
36005, 면부,035004, 33세,2017,4677,2606,2071,125.8,4204,2292,1912,119.9
36005, 면부,035005, 34세,2017,5024,2794,2230,125.3,4567,2478,2089,118.6
36005, 면부,040,35~39세,2017,26180,15017,11163,134.5,24380,13837,10543,131.2
36005, 면부,040001, 35세,2017,5440,3114,2326,133.9,4988,2824,2164,130.5
36005, 면부,040002, 36세,2017,5134,2945,2189,134.5,4757,2699,2058,131.1
36005, 면부,040003, 37세,2017,5413,3068,2345,130.8,5078,2849,2229,127.8
36005, 면부,040004, 38세,2017,5183,2951,2232,132.2,4839,2717,2122,128
36005, 면부,040005, 39세,2017,5010,2939,2071,141.9,4718,2748,1970,139.5
36005, 면부,045,40~44세,2017,28636,16807,11829,142.1,27580,16171,11409,141.7
36005, 면부,045001, 40세,2017,5235,2986,2249,132.8,4979,2819,2160,130.5
36005, 면부,045002, 41세,2017,5255,3131,2124,147.4,5027,3000,2027,148
36005, 면부,045003, 42세,2017,5362,3139,2223,141.2,5175,3021,2154,140.3
36005, 면부,045004, 43세,2017,6236,3719,2517,147.8,6057,3615,2442,148
36005, 면부,045005, 44세,2017,6548,3832,2716,141.1,6342,3716,2626,141.5
36005, 면부,050,45~49세,2017,37118,21415,15703,136.4,36255,21000,15255,137.7
36005, 면부,050001, 45세,2017,6561,3873,2688,144.1,6386,3782,2604,145.2
36005, 면부,050002, 46세,2017,7279,4282,2997,142.9,7119,4206,2913,144.4
36005, 면부,050003, 47세,2017,7300,4212,3088,136.4,7128,4126,3002,137.4
36005, 면부,050004, 48세,2017,7634,4281,3353,127.7,7451,4203,3248,129.4
36005, 면부,050005, 49세,2017,8344,4767,3577,133.3,8171,4683,3488,134.3
36005, 면부,055,50~54세,2017,43641,24135,19506,123.7,42810,23786,19024,125
36005, 면부,055001, 50세,2017,7992,4430,3562,124.4,7840,4361,3479,125.4
36005, 면부,055002, 51세,2017,8494,4790,3704,129.3,8340,4715,3625,130.1
36005, 면부,055003, 52세,2017,8868,4897,3971,123.3,8671,4829,3842,125.7
36005, 면부,055004, 53세,2017,8721,4794,3927,122.1,8579,4738,3841,123.4
36005, 면부,055005, 54세,2017,9566,5224,4342,120.3,9380,5143,4237,121.4
36005, 면부,060,55~59세,2017,54131,28083,26048,107.8,53596,27858,25738,108.2
36005, 면부,060001, 55세,2017,9605,5143,4462,115.3,9480,5083,4397,115.6
36005, 면부,060002, 56세,2017,10968,5687,5281,107.7,10840,5632,5208,108.1
36005, 면부,060003, 57세,2017,11929,6128,5801,105.6,11818,6073,5745,105.7
36005, 면부,060004, 58세,2017,11185,5749,5436,105.8,11099,5723,5376,106.5
36005, 면부,060005, 59세,2017,10444,5376,5068,106.1,10359,5347,5012,106.7
36005, 면부,065,60~64세,2017,46716,23442,23274,100.7,46395,23275,23120,100.7
36005, 면부,065001, 60세,2017,10423,5368,5055,106.2,10335,5327,5008,106.4
36005, 면부,065002, 61세,2017,9365,4772,4593,103.9,9289,4731,4558,103.8
36005, 면부,065003, 62세,2017,10251,5128,5123,100.1,10178,5088,5090,100
36005, 면부,065004, 63세,2017,8724,4280,4444,96.3,8678,4252,4426,96.1
36005, 면부,065005, 64세,2017,7953,3894,4059,95.9,7915,3877,4038,96
36005, 면부,070,65~69세,2017,46070,22274,23796,93.6,45931,22202,23729,93.6
36005, 면부,070001, 65세,2017,9585,4643,4942,93.9,9555,4623,4932,93.7
36005, 면부,070002, 66세,2017,8543,4133,4410,93.7,8511,4117,4394,93.7
36005, 면부,070003, 67세,2017,9184,4417,4767,92.7,9152,4402,4750,92.7
36005, 면부,070004, 68세,2017,9354,4596,4758,96.6,9329,4583,4746,96.6
36005, 면부,070005, 69세,2017,9404,4485,4919,91.2,9384,4477,4907,91.2
36005, 면부,075,70~74세,2017,43749,18836,24913,75.6,43712,18816,24896,75.6
36005, 면부,075001, 70세,2017,10089,4649,5440,85.5,10078,4643,5435,85.4
36005, 면부,075002, 71세,2017,7730,3506,4224,83,7719,3501,4218,83
36005, 면부,075003, 72세,2017,8326,3481,4845,71.8,8320,3477,4843,71.8
36005, 면부,075004, 73세,2017,8202,3384,4818,70.2,8200,3384,4816,70.3
36005, 면부,075005, 74세,2017,9402,3816,5586,68.3,9395,3811,5584,68.2
36005, 면부,080,75~79세,2017,52434,20350,32084,63.4,52410,20336,32074,63.4
36005, 면부,080001, 75세,2017,12735,5207,7528,69.2,12726,5202,7524,69.1
36005, 면부,080002, 76세,2017,10594,4235,6359,66.6,10587,4232,6355,66.6
36005, 면부,080003, 77세,2017,10096,3819,6277,60.8,10096,3819,6277,60.8
36005, 면부,080004, 78세,2017,9885,3774,6111,61.8,9882,3771,6111,61.7
36005, 면부,080005, 79세,2017,9124,3315,5809,57.1,9119,3312,5807,57
36005, 면부,085,80~84세,2017,34380,11228,23152,48.5,34369,11221,23148,48.5
36005, 면부,085001, 80세,2017,8407,2976,5431,54.8,8404,2974,5430,54.8
36005, 면부,085002, 81세,2017,7340,2508,4832,51.9,7338,2506,4832,51.9
36005, 면부,085003, 82세,2017,7142,2256,4886,46.2,7140,2255,4885,46.2
36005, 면부,085004, 83세,2017,6245,1949,4296,45.4,6243,1948,4295,45.4
36005, 면부,085005, 84세,2017,5246,1539,3707,41.5,5244,1538,3706,41.5
36005, 면부,090,85~89세,2017,16357,4354,12003,36.3,16353,4352,12001,36.3
36005, 면부,090001, 85세,2017,4421,1301,3120,41.7,4421,1301,3120,41.7
36005, 면부,090002, 86세,2017,3549,912,2637,34.6,3548,912,2636,34.6
36005, 면부,090003, 87세,2017,3689,899,2790,32.2,3689,899,2790,32.2
36005, 면부,090004, 88세,2017,2663,723,1940,37.3,2662,722,1940,37.2
36005, 면부,090005, 89세,2017,2035,519,1516,34.2,2033,518,1515,34.2
36005, 면부,095,90~94세,2017,4576,1023,3553,28.8,4576,1023,3553,28.8
36005, 면부,095001, 90세,2017,1446,330,1116,29.6,1446,330,1116,29.6
36005, 면부,095002, 91세,2017,1069,258,811,31.8,1069,258,811,31.8
36005, 면부,095003, 92세,2017,798,185,613,30.2,798,185,613,30.2
36005, 면부,095004, 93세,2017,576,131,445,29.4,576,131,445,29.4
36005, 면부,095005, 94세,2017,687,119,568,21,687,119,568,21
36005, 면부,100,95~99세,2017,1114,194,920,21.1,1113,194,919,21.1
36005, 면부,100001, 95세,2017,437,83,354,23.4,437,83,354,23.4
36005, 면부,100002, 96세,2017,277,47,230,20.4,277,47,230,20.4
36005, 면부,100003, 97세,2017,191,31,160,19.4,191,31,160,19.4
36005, 면부,100004, 98세,2017,131,22,109,20.2,131,22,109,20.2
36005, 면부,100005, 99세,2017,78,11,67,16.4,77,11,66,16.7
36005, 면부,101,100세이상,2017,128,13,115,11.3,128,13,115,11.3
36005, 면부,102,15세미만,2017,48641,25025,23616,106,48589,25004,23585,106
36005, 면부,103,15~64세,2017,329295,182099,147196,123.7,314287,172535,141752,121.7
36005, 면부,104,65세이상,2017,198808,78272,120536,64.9,198592,78157,120435,64.9
36005, 면부,086,85세이상,2017,22175,5584,16591,33.7,22170,5582,16588,33.7
36005, 면부,126,평균연령,2017,52.2,49.1,55.2,,52.7,49.7,55.6,
36005, 면부,127,중위연령,2017,56.2,52.4,59.6,,56.8,53.3,60.1,
36003, 동부,000,합계,2017,785532,397629,387903,102.5,775160,391980,383180,102.3
36003, 동부,005,0~4세,2017,34996,18130,16866,107.5,34903,18088,16815,107.6
36003, 동부,005001, 0세,2017,5874,3114,2760,112.8,5846,3101,2745,113
36003, 동부,005002, 1세,2017,6848,3506,3342,104.9,6830,3496,3334,104.9
36003, 동부,005003, 2세,2017,7309,3832,3477,110.2,7292,3827,3465,110.4
36003, 동부,005004, 3세,2017,7299,3721,3578,104,7285,3715,3570,104.1
36003, 동부,005005, 4세,2017,7666,3957,3709,106.7,7650,3949,3701,106.7
36003, 동부,010,5~9세,2017,41274,21004,20270,103.6,41220,20977,20243,103.6
36003, 동부,010001, 5세,2017,8524,4270,4254,100.4,8510,4262,4248,100.3
36003, 동부,010002, 6세,2017,8668,4322,4346,99.4,8657,4316,4341,99.4
36003, 동부,010003, 7세,2017,8121,4272,3849,111,8117,4270,3847,111
36003, 동부,010004, 8세,2017,7826,3963,3863,102.6,7813,3959,3854,102.7
36003, 동부,010005, 9세,2017,8135,4177,3958,105.5,8123,4170,3953,105.5
36003, 동부,015,10~14세,2017,40894,21024,19870,105.8,40858,21011,19847,105.9
36003, 동부,015001, 10세,2017,8365,4318,4047,106.7,8357,4314,4043,106.7
36003, 동부,015002, 11세,2017,7823,3999,3824,104.6,7815,3998,3817,104.7
36003, 동부,015003, 12세,2017,7542,3838,3704,103.6,7536,3834,3702,103.6
36003, 동부,015004, 13세,2017,8481,4410,4071,108.3,8473,4406,4067,108.3
36003, 동부,015005, 14세,2017,8683,4459,4224,105.6,8677,4459,4218,105.7
36003, 동부,020,15~19세,2017,51799,27576,24223,113.8,51540,27450,24090,113.9
36003, 동부,020001, 15세,2017,9093,4739,4354,108.8,9087,4734,4353,108.8
36003, 동부,020002, 16세,2017,10489,5523,4966,111.2,10477,5515,4962,111.1
36003, 동부,020003, 17세,2017,11838,6146,5692,108,11806,6132,5674,108.1
36003, 동부,020004, 18세,2017,10742,5711,5031,113.5,10669,5672,4997,113.5
36003, 동부,020005, 19세,2017,9637,5457,4180,130.6,9501,5397,4104,131.5
36003, 동부,025,20~24세,2017,51191,29397,21794,134.9,49890,28769,21121,136.2
36003, 동부,025001, 20세,2017,10569,6290,4279,147,10421,6234,4187,148.9
36003, 동부,025002, 21세,2017,11002,6581,4421,148.9,10772,6463,4309,150
36003, 동부,025003, 22세,2017,10285,6013,4272,140.8,10029,5886,4143,142.1
36003, 동부,025004, 23세,2017,9795,5424,4371,124.1,9479,5273,4206,125.4
36003, 동부,025005, 24세,2017,9540,5089,4451,114.3,9189,4913,4276,114.9
36003, 동부,030,25~29세,2017,43030,22865,20165,113.4,40971,21740,19231,113
36003, 동부,030001, 25세,2017,9559,4991,4568,109.3,9129,4753,4376,108.6
36003, 동부,030002, 26세,2017,8680,4664,4016,116.1,8279,4464,3815,117
36003, 동부,030003, 27세,2017,8587,4569,4018,113.7,8145,4327,3818,113.3
36003, 동부,030004, 28세,2017,8241,4426,3815,116,7848,4210,3638,115.7
36003, 동부,030005, 29세,2017,7963,4215,3748,112.5,7570,3986,3584,111.2
36003, 동부,035,30~34세,2017,47080,24490,22590,108.4,45490,23571,21919,107.5
36003, 동부,035001, 30세,2017,8237,4324,3913,110.5,7875,4126,3749,110.1
36003, 동부,035002, 31세,2017,8658,4508,4150,108.6,8306,4322,3984,108.5
36003, 동부,035003, 32세,2017,9036,4766,4270,111.6,8735,4593,4142,110.9
36003, 동부,035004, 33세,2017,9938,5099,4839,105.4,9648,4921,4727,104.1
36003, 동부,035005, 34세,2017,11211,5793,5418,106.9,10926,5609,5317,105.5
36003, 동부,040,35~39세,2017,60337,31033,29304,105.9,59072,30235,28837,104.8
36003, 동부,040001, 35세,2017,12298,6393,5905,108.3,11998,6211,5787,107.3
36003, 동부,040002, 36세,2017,11896,6250,5646,110.7,11637,6077,5560,109.3
36003, 동부,040003, 37세,2017,12584,6426,6158,104.4,12365,6293,6072,103.6
36003, 동부,040004, 38세,2017,12328,6250,6078,102.8,12066,6075,5991,101.4
36003, 동부,040005, 39세,2017,11231,5714,5517,103.6,11006,5579,5427,102.8
36003, 동부,045,40~44세,2017,62402,31535,30867,102.2,61374,30871,30503,101.2
36003, 동부,045001, 40세,2017,11802,5946,5856,101.5,11594,5804,5790,100.2
36003, 동부,045002, 41세,2017,11545,5934,5611,105.8,11318,5794,5524,104.9
36003, 동부,045003, 42세,2017,12125,6131,5994,102.3,11936,6009,5927,101.4
36003, 동부,045004, 43세,2017,13173,6631,6542,101.4,12981,6511,6470,100.6
36003, 동부,045005, 44세,2017,13757,6893,6864,100.4,13545,6753,6792,99.4
36003, 동부,050,45~49세,2017,72535,36833,35702,103.2,71594,36297,35297,102.8
36003, 동부,050001, 45세,2017,13973,7147,6826,104.7,13767,7022,6745,104.1
36003, 동부,050002, 46세,2017,14911,7537,7374,102.2,14702,7413,7289,101.7
36003, 동부,050003, 47세,2017,14296,7230,7066,102.3,14103,7111,6992,101.7
36003, 동부,050004, 48세,2017,14408,7323,7085,103.4,14227,7227,7000,103.2
36003, 동부,050005, 49세,2017,14947,7596,7351,103.3,14795,7524,7271,103.5
36003, 동부,055,50~54세,2017,67273,34760,32513,106.9,66583,34467,32116,107.3
36003, 동부,055001, 50세,2017,13745,7066,6679,105.8,13589,7005,6584,106.4
36003, 동부,055002, 51세,2017,13841,7372,6469,114,13715,7317,6398,114.4
36003, 동부,055003, 52세,2017,13645,7068,6577,107.5,13511,7008,6503,107.8
36003, 동부,055004, 53세,2017,12495,6272,6223,100.8,12364,6221,6143,101.3
36003, 동부,055005, 54세,2017,13547,6982,6565,106.4,13404,6916,6488,106.6
36003, 동부,060,55~59세,2017,64328,32053,32275,99.3,63852,31840,32012,99.5
36003, 동부,060001, 55세,2017,12617,6508,6109,106.5,12510,6458,6052,106.7
36003, 동부,060002, 56세,2017,13729,6756,6973,96.9,13634,6717,6917,97.1
36003, 동부,060003, 57세,2017,14142,6920,7222,95.8,14045,6876,7169,95.9
36003, 동부,060004, 58세,2017,12509,6105,6404,95.3,12424,6065,6359,95.4
36003, 동부,060005, 59세,2017,11331,5764,5567,103.5,11239,5724,5515,103.8
36003, 동부,065,60~64세,2017,46207,23180,23027,100.7,45893,23028,22865,100.7
36003, 동부,065001, 60세,2017,11108,5607,5501,101.9,11035,5573,5462,102
36003, 동부,065002, 61세,2017,9548,4730,4818,98.2,9484,4703,4781,98.4
36003, 동부,065003, 62세,2017,10121,5095,5026,101.4,10050,5060,4990,101.4
36003, 동부,065004, 63세,2017,8418,4238,4180,101.4,8363,4212,4151,101.5
36003, 동부,065005, 64세,2017,7012,3510,3502,100.2,6961,3480,3481,100
36003, 동부,070,65~69세,2017,35084,17354,17730,97.9,34926,17280,17646,97.9
36003, 동부,070001, 65세,2017,8162,4042,4120,98.1,8122,4028,4094,98.4
36003, 동부,070002, 66세,2017,6989,3552,3437,103.3,6947,3536,3411,103.7
36003, 동부,070003, 67세,2017,6872,3447,3425,100.6,6838,3425,3413,100.4
36003, 동부,070004, 68세,2017,6722,3248,3474,93.5,6700,3235,3465,93.4
36003, 동부,070005, 69세,2017,6339,3065,3274,93.6,6319,3056,3263,93.7
36003, 동부,075,70~74세,2017,25446,11772,13674,86.1,25394,11753,13641,86.2
36003, 동부,075001, 70세,2017,6657,3140,3517,89.3,6640,3133,3507,89.3
36003, 동부,075002, 71세,2017,4986,2353,2633,89.4,4976,2351,2625,89.6
36003, 동부,075003, 72세,2017,4740,2209,2531,87.3,4731,2206,2525,87.4
36003, 동부,075004, 73세,2017,4313,1967,2346,83.8,4306,1962,2344,83.7
36003, 동부,075005, 74세,2017,4750,2103,2647,79.4,4741,2101,2640,79.6
36003, 동부,080,75~79세,2017,21209,8629,12580,68.6,21177,8616,12561,68.6
36003, 동부,080001, 75세,2017,5635,2415,3220,75,5629,2414,3215,75.1
36003, 동부,080002, 76세,2017,4345,1803,2542,70.9,4337,1801,2536,71
36003, 동부,080003, 77세,2017,4087,1668,2419,69,4083,1667,2416,69
36003, 동부,080004, 78세,2017,3678,1461,2217,65.9,3670,1456,2214,65.8
36003, 동부,080005, 79세,2017,3464,1282,2182,58.8,3458,1278,2180,58.6
36003, 동부,085,80~84세,2017,12023,4061,7962,51,12005,4054,7951,51
36003, 동부,085001, 80세,2017,3039,1138,1901,59.9,3036,1138,1898,60
36003, 동부,085002, 81세,2017,2589,890,1699,52.4,2583,887,1696,52.3
36003, 동부,085003, 82세,2017,2391,819,1572,52.1,2385,816,1569,52
36003, 동부,085004, 83세,2017,2158,657,1501,43.8,2158,657,1501,43.8
36003, 동부,085005, 84세,2017,1846,557,1289,43.2,1843,556,1287,43.2
36003, 동부,090,85~89세,2017,6105,1496,4609,32.5,6099,1496,4603,32.5
36003, 동부,090001, 85세,2017,1656,447,1209,37,1654,447,1207,37
36003, 동부,090002, 86세,2017,1358,357,1001,35.7,1358,357,1001,35.7
36003, 동부,090003, 87세,2017,1394,286,1108,25.8,1392,286,1106,25.9
36003, 동부,090004, 88세,2017,972,242,730,33.2,970,242,728,33.2
36003, 동부,090005, 89세,2017,725,164,561,29.2,725,164,561,29.2
36003, 동부,095,90~94세,2017,1844,364,1480,24.6,1844,364,1480,24.6
36003, 동부,095001, 90세,2017,604,141,463,30.5,604,141,463,30.5
36003, 동부,095002, 91세,2017,392,77,315,24.4,392,77,315,24.4
36003, 동부,095003, 92세,2017,333,64,269,23.8,333,64,269,23.8
36003, 동부,095004, 93세,2017,223,45,178,25.3,223,45,178,25.3
36003, 동부,095005, 94세,2017,292,37,255,14.5,292,37,255,14.5
36003, 동부,100,95~99세,2017,439,69,370,18.6,439,69,370,18.6
36003, 동부,100001, 95세,2017,177,36,141,25.5,177,36,141,25.5
36003, 동부,100002, 96세,2017,111,14,97,14.4,111,14,97,14.4
36003, 동부,100003, 97세,2017,82,9,73,12.3,82,9,73,12.3
36003, 동부,100004, 98세,2017,36,8,28,28.6,36,8,28,28.6
36003, 동부,100005, 99세,2017,33,X,31,6.5,33,X,31,6.5
36003, 동부,101,100세이상,2017,36,X,32,12.5,36,X,32,12.5
36003, 동부,102,15세미만,2017,117164,60158,57006,105.5,116981,60076,56905,105.6
36003, 동부,103,15~64세,2017,566182,293722,272460,107.8,556259,288268,267991,107.6
36003, 동부,104,65세이상,2017,102186,43749,58437,74.9,101920,43636,58284,74.9
36003, 동부,086,85세이상,2017,8424,1933,6491,29.8,8418,1933,6485,29.8
36003, 동부,126,평균연령,2017,40.4,39.2,41.6,,40.4,39.2,41.7,
36003, 동부,127,중위연령,2017,41.9,40.6,43.2,,42.1,40.7,43.3,
36010, 목포시,000,합계,2017,233948,117464,116484,100.8,230562,115566,114996,100.5
36010, 목포시,005,0~4세,2017,9679,5032,4647,108.3,9642,5016,4626,108.4
36010, 목포시,005001, 0세,2017,1420,736,684,107.6,1408,729,679,107.4
36010, 목포시,005002, 1세,2017,1904,985,919,107.2,1897,981,916,107.1
36010, 목포시,005003, 2세,2017,1978,1060,918,115.5,1973,1059,914,115.9
36010, 목포시,005004, 3세,2017,2103,1079,1024,105.4,2097,1078,1019,105.8
36010, 목포시,005005, 4세,2017,2274,1172,1102,106.4,2267,1169,1098,106.5
36010, 목포시,010,5~9세,2017,12725,6463,6262,103.2,12702,6452,6250,103.2
36010, 목포시,010001, 5세,2017,2620,1322,1298,101.8,2614,1317,1297,101.5
36010, 목포시,010002, 6세,2017,2616,1288,1328,97,2612,1287,1325,97.1
36010, 목포시,010003, 7세,2017,2583,1353,1230,110,2581,1352,1229,110
36010, 목포시,010004, 8세,2017,2449,1241,1208,102.7,2444,1240,1204,103
36010, 목포시,010005, 9세,2017,2457,1259,1198,105.1,2451,1256,1195,105.1
36010, 목포시,015,10~14세,2017,12262,6262,6000,104.4,12251,6257,5994,104.4
36010, 목포시,015001, 10세,2017,2568,1339,1229,109,2563,1336,1227,108.9
36010, 목포시,015002, 11세,2017,2327,1161,1166,99.6,2326,1161,1165,99.7
36010, 목포시,015003, 12세,2017,2269,1153,1116,103.3,2268,1152,1116,103.2
36010, 목포시,015004, 13세,2017,2485,1261,1224,103,2482,1260,1222,103.1
36010, 목포시,015005, 14세,2017,2613,1348,1265,106.6,2612,1348,1264,106.6
36010, 목포시,020,15~19세,2017,14849,7936,6913,114.8,14810,7917,6893,114.9
36010, 목포시,020001, 15세,2017,2654,1363,1291,105.6,2652,1361,1291,105.4
36010, 목포시,020002, 16세,2017,2919,1507,1412,106.7,2918,1506,1412,106.7
36010, 목포시,020003, 17세,2017,3263,1690,1573,107.4,3257,1688,1569,107.6
36010, 목포시,020004, 18세,2017,3110,1680,1430,117.5,3100,1673,1427,117.2
36010, 목포시,020005, 19세,2017,2903,1696,1207,140.5,2883,1689,1194,141.5
36010, 목포시,025,20~24세,2017,15246,8724,6522,133.8,14887,8529,6358,134.1
36010, 목포시,025001, 20세,2017,3234,1939,1295,149.7,3198,1921,1277,150.4
36010, 목포시,025002, 21세,2017,3331,1997,1334,149.7,3276,1966,1310,150.1
36010, 목포시,025003, 22세,2017,3159,1858,1301,142.8,3090,1823,1267,143.9
36010, 목포시,025004, 23세,2017,2892,1573,1319,119.3,2797,1523,1274,119.5
36010, 목포시,025005, 24세,2017,2630,1357,1273,106.6,2526,1296,1230,105.4
36010, 목포시,030,25~29세,2017,11528,5900,5628,104.8,10862,5532,5330,103.8
36010, 목포시,030001, 25세,2017,2624,1348,1276,105.6,2490,1273,1217,104.6
36010, 목포시,030002, 26세,2017,2330,1199,1131,106,2196,1126,1070,105.2
36010, 목포시,030003, 27세,2017,2301,1166,1135,102.7,2150,1092,1058,103.2
36010, 목포시,030004, 28세,2017,2155,1106,1049,105.4,2031,1033,998,103.5
36010, 목포시,030005, 29세,2017,2118,1081,1037,104.2,1995,1008,987,102.1
36010, 목포시,035,30~34세,2017,13649,7016,6633,105.8,13121,6691,6430,104.1
36010, 목포시,035001, 30세,2017,2307,1184,1123,105.4,2183,1107,1076,102.9
36010, 목포시,035002, 31세,2017,2375,1229,1146,107.2,2265,1165,1100,105.9
36010, 목포시,035003, 32세,2017,2670,1377,1293,106.5,2557,1311,1246,105.2
36010, 목포시,035004, 33세,2017,2932,1512,1420,106.5,2838,1450,1388,104.5
36010, 목포시,035005, 34세,2017,3365,1714,1651,103.8,3278,1658,1620,102.3
36010, 목포시,040,35~39세,2017,18676,9852,8824,111.7,18251,9576,8675,110.4
36010, 목포시,040001, 35세,2017,3739,2001,1738,115.1,3645,1939,1706,113.7
36010, 목포시,040002, 36세,2017,3617,1962,1655,118.5,3533,1899,1634,116.2
36010, 목포시,040003, 37세,2017,3921,2027,1894,107,3856,1993,1863,107
36010, 목포시,040004, 38세,2017,3866,2006,1860,107.8,3769,1939,1830,106
36010, 목포시,040005, 39세,2017,3533,1856,1677,110.7,3448,1806,1642,110
36010, 목포시,045,40~44세,2017,19108,9853,9255,106.5,18766,9628,9138,105.4
36010, 목포시,045001, 40세,2017,3629,1842,1787,103.1,3564,1793,1771,101.2
36010, 목포시,045002, 41세,2017,3574,1890,1684,112.2,3491,1837,1654,111.1
36010, 목포시,045003, 42세,2017,3785,1976,1809,109.2,3721,1937,1784,108.6
36010, 목포시,045004, 43세,2017,3981,2039,1942,105,3926,2007,1919,104.6
36010, 목포시,045005, 44세,2017,4139,2106,2033,103.6,4064,2054,2010,102.2
36010, 목포시,050,45~49세,2017,20466,10601,9865,107.5,20142,10418,9724,107.1
36010, 목포시,050001, 45세,2017,4179,2167,2012,107.7,4117,2129,1988,107.1
36010, 목포시,050002, 46세,2017,4318,2260,2058,109.8,4240,2216,2024,109.5
36010, 목포시,050003, 47세,2017,4094,2103,1991,105.6,4014,2053,1961,104.7
36010, 목포시,050004, 48세,2017,4015,2078,1937,107.3,3953,2048,1905,107.5
36010, 목포시,050005, 49세,2017,3860,1993,1867,106.7,3818,1972,1846,106.8
36010, 목포시,055,50~54세,2017,18443,9339,9104,102.6,18185,9227,8958,103
36010, 목포시,055001, 50세,2017,3673,1879,1794,104.7,3619,1856,1763,105.3
36010, 목포시,055002, 51세,2017,3788,1996,1792,111.4,3735,1974,1761,112.1
36010, 목포시,055003, 52세,2017,3785,1945,1840,105.7,3742,1928,1814,106.3
36010, 목포시,055004, 53세,2017,3475,1691,1784,94.8,3419,1668,1751,95.3
36010, 목포시,055005, 54세,2017,3722,1828,1894,96.5,3670,1801,1869,96.4
36010, 목포시,060,55~59세,2017,18935,9238,9697,95.3,18759,9160,9599,95.4
36010, 목포시,060001, 55세,2017,3576,1781,1795,99.2,3530,1760,1770,99.4
36010, 목포시,060002, 56세,2017,4013,1925,2088,92.2,3980,1911,2069,92.4
36010, 목포시,060003, 57세,2017,4097,1933,2164,89.3,4059,1917,2142,89.5
36010, 목포시,060004, 58세,2017,3793,1848,1945,95,3762,1830,1932,94.7
36010, 목포시,060005, 59세,2017,3456,1751,1705,102.7,3428,1742,1686,103.3
36010, 목포시,065,60~64세,2017,14100,6942,7158,97,13998,6892,7106,97
36010, 목포시,065001, 60세,2017,3380,1715,1665,103,3356,1705,1651,103.3
36010, 목포시,065002, 61세,2017,2991,1446,1545,93.6,2972,1436,1536,93.5
36010, 목포시,065003, 62세,2017,3097,1461,1636,89.3,3068,1447,1621,89.3
36010, 목포시,065004, 63세,2017,2390,1205,1185,101.7,2377,1199,1178,101.8
36010, 목포시,065005, 64세,2017,2242,1115,1127,98.9,2225,1105,1120,98.7
36010, 목포시,070,65~69세,2017,11215,5288,5927,89.2,11158,5266,5892,89.4
36010, 목포시,070001, 65세,2017,2559,1209,1350,89.6,2543,1204,1339,89.9
36010, 목포시,070002, 66세,2017,2307,1093,1214,90,2292,1088,1204,90.4
36010, 목포시,070003, 67세,2017,2136,1022,1114,91.7,2126,1018,1108,91.9
36010, 목포시,070004, 68세,2017,2194,1000,1194,83.8,2186,997,1189,83.9
36010, 목포시,070005, 69세,2017,2019,964,1055,91.4,2011,959,1052,91.2
36010, 목포시,075,70~74세,2017,8882,4054,4828,84,8864,4047,4817,84
36010, 목포시,075001, 70세,2017,2177,1015,1162,87.3,2171,1013,1158,87.5
36010, 목포시,075002, 71세,2017,1891,864,1027,84.1,1886,863,1023,84.4
36010, 목포시,075003, 72세,2017,1781,832,949,87.7,1779,831,948,87.7
36010, 목포시,075004, 73세,2017,1521,668,853,78.3,1517,666,851,78.3
36010, 목포시,075005, 74세,2017,1512,675,837,80.6,1511,674,837,80.5
36010, 목포시,080,75~79세,2017,7498,3016,4482,67.3,7482,3010,4472,67.3
36010, 목포시,080001, 75세,2017,2021,873,1148,76,2020,873,1147,76.1
36010, 목포시,080002, 76세,2017,1538,628,910,69,1533,628,905,69.4
36010, 목포시,080003, 77세,2017,1440,571,869,65.7,1439,571,868,65.8
36010, 목포시,080004, 78세,2017,1220,492,728,67.6,1213,487,726,67.1
36010, 목포시,080005, 79세,2017,1279,452,827,54.7,1277,451,826,54.6
36010, 목포시,085,80~84세,2017,3982,1309,2673,49,3979,1309,2670,49
36010, 목포시,085001, 80세,2017,1063,393,670,58.7,1063,393,670,58.7
36010, 목포시,085002, 81세,2017,826,276,550,50.2,825,276,549,50.3
36010, 목포시,085003, 82세,2017,780,246,534,46.1,778,246,532,46.2
36010, 목포시,085004, 83세,2017,716,219,497,44.1,716,219,497,44.1
36010, 목포시,085005, 84세,2017,597,175,422,41.5,597,175,422,41.5
36010, 목포시,090,85~89세,2017,1941,488,1453,33.6,1939,488,1451,33.6
36010, 목포시,090001, 85세,2017,539,152,387,39.3,538,152,386,39.4
36010, 목포시,090002, 86세,2017,410,109,301,36.2,410,109,301,36.2
36010, 목포시,090003, 87세,2017,452,93,359,25.9,452,93,359,25.9
36010, 목포시,090004, 88세,2017,310,75,235,31.9,309,75,234,32.1
36010, 목포시,090005, 89세,2017,230,59,171,34.5,230,59,171,34.5
36010, 목포시,095,90~94세,2017,614,120,494,24.3,614,120,494,24.3
36010, 목포시,095001, 90세,2017,192,50,142,35.2,192,50,142,35.2
36010, 목포시,095002, 91세,2017,125,29,96,30.2,125,29,96,30.2
36010, 목포시,095003, 92세,2017,111,24,87,27.6,111,24,87,27.6
36010, 목포시,095004, 93세,2017,79,8,71,11.3,79,8,71,11.3
36010, 목포시,095005, 94세,2017,107,9,98,9.2,107,9,98,9.2
36010, 목포시,100,95~99세,2017,140,30,110,27.3,140,30,110,27.3
36010, 목포시,100001, 95세,2017,58,15,43,34.9,58,15,43,34.9
36010, 목포시,100002, 96세,2017,31,6,25,24,31,6,25,24
36010, 목포시,100003, 97세,2017,29,5,24,20.8,29,5,24,20.8
36010, 목포시,100004, 98세,2017,12,X,9,33.3,12,X,9,33.3
36010, 목포시,100005, 99세,2017,10,X,9,11.1,10,X,9,11.1
36010, 목포시,101,100세이상,2017,10,X,9,11.1,10,X,9,11.1
36010, 목포시,102,15세미만,2017,34666,17757,16909,105,34595,17725,16870,105.1
36010, 목포시,103,15~64세,2017,165000,85401,79599,107.3,161781,83570,78211,106.9
36010, 목포시,104,65세이상,2017,34282,14306,19976,71.6,34186,14271,19915,71.7
36010, 목포시,086,85세이상,2017,2705,639,2066,30.9,2703,639,2064,31
36010, 목포시,126,평균연령,2017,41,39.6,42.5,,41.1,39.7,42.5,
36010, 목포시,127,중위연령,2017,42.3,40.8,43.8,,42.5,41,43.9,
36020, 여수시,000,합계,2017,271741,139146,132595,104.9,266758,135690,131068,103.5
36020, 여수시,005,0~4세,2017,11412,5913,5499,107.5,11403,5908,5495,107.5
36020, 여수시,005001, 0세,2017,2025,1076,949,113.4,2024,1075,949,113.3
36020, 여수시,005002, 1세,2017,2284,1168,1116,104.7,2281,1165,1116,104.4
36020, 여수시,005003, 2세,2017,2390,1192,1198,99.5,2387,1191,1196,99.6
36020, 여수시,005004, 3세,2017,2310,1209,1101,109.8,2309,1209,1100,109.9
36020, 여수시,005005, 4세,2017,2403,1268,1135,111.7,2402,1268,1134,111.8
36020, 여수시,010,5~9세,2017,12306,6209,6097,101.8,12295,6207,6088,102
36020, 여수시,010001, 5세,2017,2546,1220,1326,92,2543,1219,1324,92.1
36020, 여수시,010002, 6세,2017,2698,1368,1330,102.9,2695,1368,1327,103.1
36020, 여수시,010003, 7세,2017,2328,1212,1116,108.6,2327,1212,1115,108.7
36020, 여수시,010004, 8세,2017,2281,1168,1113,104.9,2280,1168,1112,105
36020, 여수시,010005, 9세,2017,2453,1241,1212,102.4,2450,1240,1210,102.5
36020, 여수시,015,10~14세,2017,12567,6499,6068,107.1,12558,6495,6063,107.1
36020, 여수시,015001, 10세,2017,2540,1267,1273,99.5,2540,1267,1273,99.5
36020, 여수시,015002, 11세,2017,2340,1218,1122,108.6,2338,1218,1120,108.8
36020, 여수시,015003, 12세,2017,2337,1202,1135,105.9,2335,1201,1134,105.9
36020, 여수시,015004, 13세,2017,2685,1432,1253,114.3,2682,1429,1253,114
36020, 여수시,015005, 14세,2017,2665,1380,1285,107.4,2663,1380,1283,107.6
36020, 여수시,020,15~19세,2017,15277,8410,6867,122.5,15237,8388,6849,122.5
36020, 여수시,020001, 15세,2017,2855,1468,1387,105.8,2852,1466,1386,105.8
36020, 여수시,020002, 16세,2017,3219,1775,1444,122.9,3215,1774,1441,123.1
36020, 여수시,020003, 17세,2017,3537,1888,1649,114.5,3529,1886,1643,114.8
36020, 여수시,020004, 18세,2017,3213,1773,1440,123.1,3198,1761,1437,122.5
36020, 여수시,020005, 19세,2017,2453,1506,947,159,2443,1501,942,159.3
36020, 여수시,025,20~24세,2017,15004,9133,5871,155.6,14531,8823,5708,154.6
36020, 여수시,025001, 20세,2017,2959,1946,1013,192.1,2936,1937,999,193.9
36020, 여수시,025002, 21세,2017,3117,2014,1103,182.6,3068,1981,1087,182.2
36020, 여수시,025003, 22세,2017,2954,1812,1142,158.7,2858,1748,1110,157.5
36020, 여수시,025004, 23세,2017,2940,1678,1262,133,2816,1595,1221,130.6
36020, 여수시,025005, 24세,2017,3034,1683,1351,124.6,2853,1562,1291,121
36020, 여수시,030,25~29세,2017,14602,8111,6491,125,13519,7314,6205,117.9
36020, 여수시,030001, 25세,2017,3218,1736,1482,117.1,3003,1579,1424,110.9
36020, 여수시,030002, 26세,2017,2919,1619,1300,124.5,2715,1469,1246,117.9
36020, 여수시,030003, 27세,2017,2937,1621,1316,123.2,2697,1453,1244,116.8
36020, 여수시,030004, 28세,2017,2782,1575,1207,130.5,2576,1421,1155,123
36020, 여수시,030005, 29세,2017,2746,1560,1186,131.5,2528,1392,1136,122.5
36020, 여수시,035,30~34세,2017,15696,8617,7079,121.7,14703,7892,6811,115.9
36020, 여수시,035001, 30세,2017,2831,1607,1224,131.3,2613,1446,1167,123.9
36020, 여수시,035002, 31세,2017,2993,1661,1332,124.7,2765,1498,1267,118.2
36020, 여수시,035003, 32세,2017,2985,1663,1322,125.8,2785,1518,1267,119.8
36020, 여수시,035004, 33세,2017,3212,1741,1471,118.4,3056,1623,1433,113.3
36020, 여수시,035005, 34세,2017,3675,1945,1730,112.4,3484,1807,1677,107.8
36020, 여수시,040,35~39세,2017,19482,10347,9135,113.3,18736,9773,8963,109
36020, 여수시,040001, 35세,2017,4049,2180,1869,116.6,3875,2056,1819,113
36020, 여수시,040002, 36세,2017,3872,2116,1756,120.5,3718,1991,1727,115.3
36020, 여수시,040003, 37세,2017,3938,2074,1864,111.3,3798,1959,1839,106.5
36020, 여수시,040004, 38세,2017,3977,2072,1905,108.8,3820,1953,1867,104.6
36020, 여수시,040005, 39세,2017,3646,1905,1741,109.4,3525,1814,1711,106
36020, 여수시,045,40~44세,2017,20043,10602,9441,112.3,19470,10164,9306,109.2
36020, 여수시,045001, 40세,2017,3717,1962,1755,111.8,3600,1871,1729,108.2
36020, 여수시,045002, 41세,2017,3746,2041,1705,119.7,3637,1963,1674,117.3
36020, 여수시,045003, 42세,2017,3809,1997,1812,110.2,3684,1901,1783,106.6
36020, 여수시,045004, 43세,2017,4309,2239,2070,108.2,4189,2141,2048,104.5
36020, 여수시,045005, 44세,2017,4462,2363,2099,112.6,4360,2288,2072,110.4
36020, 여수시,050,45~49세,2017,23463,12353,11110,111.2,23009,12043,10966,109.8
36020, 여수시,050001, 45세,2017,4507,2419,2088,115.9,4396,2329,2067,112.7
36020, 여수시,050002, 46세,2017,4881,2575,2306,111.7,4787,2507,2280,110
36020, 여수시,050003, 47세,2017,4607,2429,2178,111.5,4511,2368,2143,110.5
36020, 여수시,050004, 48세,2017,4629,2460,2169,113.4,4547,2412,2135,113
36020, 여수시,050005, 49세,2017,4839,2470,2369,104.3,4768,2427,2341,103.7
36020, 여수시,055,50~54세,2017,22875,11871,11004,107.9,22607,11745,10862,108.1
36020, 여수시,055001, 50세,2017,4480,2260,2220,101.8,4426,2233,2193,101.8
36020, 여수시,055002, 51세,2017,4592,2429,2163,112.3,4549,2405,2144,112.2
36020, 여수시,055003, 52세,2017,4553,2384,2169,109.9,4491,2357,2134,110.4
36020, 여수시,055004, 53세,2017,4299,2228,2071,107.6,4246,2208,2038,108.3
36020, 여수시,055005, 54세,2017,4951,2570,2381,107.9,4895,2542,2353,108
36020, 여수시,060,55~59세,2017,23762,11806,11956,98.7,23617,11742,11875,98.9
36020, 여수시,060001, 55세,2017,4557,2371,2186,108.5,4520,2357,2163,109
36020, 여수시,060002, 56세,2017,4946,2390,2556,93.5,4911,2375,2536,93.7
36020, 여수시,060003, 57세,2017,5271,2579,2692,95.8,5246,2567,2679,95.8
36020, 여수시,060004, 58세,2017,4719,2322,2397,96.9,4698,2314,2384,97.1
36020, 여수시,060005, 59세,2017,4269,2144,2125,100.9,4242,2129,2113,100.8
36020, 여수시,065,60~64세,2017,18667,9294,9373,99.2,18566,9248,9318,99.2
36020, 여수시,065001, 60세,2017,4311,2156,2155,100,4290,2146,2144,100.1
36020, 여수시,065002, 61세,2017,3720,1849,1871,98.8,3701,1845,1856,99.4
36020, 여수시,065003, 62세,2017,4201,2104,2097,100.3,4177,2091,2086,100.2
36020, 여수시,065004, 63세,2017,3597,1803,1794,100.5,3572,1790,1782,100.4
36020, 여수시,065005, 64세,2017,2838,1382,1456,94.9,2826,1376,1450,94.9
36020, 여수시,070,65~69세,2017,15554,7778,7776,100,15512,7759,7753,100.1
36020, 여수시,070001, 65세,2017,3593,1779,1814,98.1,3582,1776,1806,98.3
36020, 여수시,070002, 66세,2017,3079,1604,1475,108.7,3068,1600,1468,109
36020, 여수시,070003, 67세,2017,3082,1544,1538,100.4,3074,1538,1536,100.1
36020, 여수시,070004, 68세,2017,2951,1480,1471,100.6,2945,1475,1470,100.3
36020, 여수시,070005, 69세,2017,2849,1371,1478,92.8,2843,1370,1473,93
36020, 여수시,075,70~74세,2017,11390,5283,6107,86.5,11371,5276,6095,86.6
36020, 여수시,075001, 70세,2017,3032,1420,1612,88.1,3025,1416,1609,88
36020, 여수시,075002, 71세,2017,2154,1053,1101,95.6,2149,1053,1096,96.1
36020, 여수시,075003, 72세,2017,2017,914,1103,82.9,2013,913,1100,83
36020, 여수시,075004, 73세,2017,1945,908,1037,87.6,1944,907,1037,87.5
36020, 여수시,075005, 74세,2017,2242,988,1254,78.8,2240,987,1253,78.8
36020, 여수시,080,75~79세,2017,9829,4037,5792,69.7,9822,4033,5789,69.7
36020, 여수시,080001, 75세,2017,2531,1067,1464,72.9,2530,1066,1464,72.8
36020, 여수시,080002, 76세,2017,2040,854,1186,72,2039,853,1186,71.9
36020, 여수시,080003, 77세,2017,1946,800,1146,69.8,1945,800,1145,69.9
36020, 여수시,080004, 78세,2017,1769,723,1046,69.1,1766,722,1044,69.2
36020, 여수시,080005, 79세,2017,1543,593,950,62.4,1542,592,950,62.3
36020, 여수시,085,80~84세,2017,5640,1955,3685,53.1,5632,1952,3680,53
36020, 여수시,085001, 80세,2017,1400,549,851,64.5,1398,549,849,64.7
36020, 여수시,085002, 81세,2017,1211,421,790,53.3,1206,418,788,53
36020, 여수시,085003, 82세,2017,1121,383,738,51.9,1121,383,738,51.9
36020, 여수시,085004, 83세,2017,1007,323,684,47.2,1007,323,684,47.2
36020, 여수시,085005, 84세,2017,901,279,622,44.9,900,279,621,44.9
36020, 여수시,090,85~89세,2017,3034,741,2293,32.3,3032,741,2291,32.3
36020, 여수시,090001, 85세,2017,844,234,610,38.4,844,234,610,38.4
36020, 여수시,090002, 86세,2017,692,170,522,32.6,691,170,521,32.6
36020, 여수시,090003, 87세,2017,672,154,518,29.7,671,154,517,29.8
36020, 여수시,090004, 88세,2017,452,106,346,30.6,452,106,346,30.6
36020, 여수시,090005, 89세,2017,374,77,297,25.9,374,77,297,25.9
36020, 여수시,095,90~94세,2017,900,159,741,21.5,900,159,741,21.5
36020, 여수시,095001, 90세,2017,280,56,224,25,280,56,224,25
36020, 여수시,095002, 91세,2017,193,23,170,13.5,193,23,170,13.5
36020, 여수시,095003, 92세,2017,163,34,129,26.4,163,34,129,26.4
36020, 여수시,095004, 93세,2017,103,25,78,32.1,103,25,78,32.1
36020, 여수시,095005, 94세,2017,161,21,140,15,161,21,140,15
36020, 여수시,100,95~99세,2017,216,25,191,13.1,216,25,191,13.1
36020, 여수시,100001, 95세,2017,91,11,80,13.8,91,11,80,13.8
36020, 여수시,100002, 96세,2017,53,5,48,10.4,53,5,48,10.4
36020, 여수시,100003, 97세,2017,36,6,30,20,36,6,30,20
36020, 여수시,100004, 98세,2017,22,X,19,15.8,22,X,19,15.8
36020, 여수시,100005, 99세,2017,14,X,14,0,14,X,14,0
36020, 여수시,101,100세이상,2017,22,X,19,15.8,22,X,19,15.8
36020, 여수시,102,15세미만,2017,36285,18621,17664,105.4,36256,18610,17646,105.5
36020, 여수시,103,15~64세,2017,188871,100544,88327,113.8,183995,97132,86863,111.8
36020, 여수시,104,65세이상,2017,46585,19981,26604,75.1,46507,19948,26559,75.1
36020, 여수시,086,85세이상,2017,4172,928,3244,28.6,4170,928,3242,28.6
36020, 여수시,126,평균연령,2017,43,41.4,44.7,,43.1,41.6,44.8,
36020, 여수시,127,중위연령,2017,44.9,43.1,46.7,,45.2,43.6,46.9,
36030, 순천시,000,합계,2017,266809,132657,134152,98.9,264677,131712,132965,99.1
36030, 순천시,005,0~4세,2017,11395,5861,5534,105.9,11375,5848,5527,105.8
36030, 순천시,005001, 0세,2017,1907,1013,894,113.3,1903,1010,893,113.1
36030, 순천시,005002, 1세,2017,2162,1083,1079,100.4,2157,1081,1076,100.5
36030, 순천시,005003, 2세,2017,2394,1285,1109,115.9,2389,1282,1107,115.8
36030, 순천시,005004, 3세,2017,2422,1219,1203,101.3,2419,1217,1202,101.2
36030, 순천시,005005, 4세,2017,2510,1261,1249,101,2507,1258,1249,100.7
36030, 순천시,010,5~9세,2017,13536,7007,6529,107.3,13527,7000,6527,107.2
36030, 순천시,010001, 5세,2017,2729,1390,1339,103.8,2727,1390,1337,104
36030, 순천시,010002, 6세,2017,2791,1432,1359,105.4,2787,1428,1359,105.1
36030, 순천시,010003, 7세,2017,2625,1414,1211,116.8,2624,1413,1211,116.7
36030, 순천시,010004, 8세,2017,2651,1346,1305,103.1,2651,1346,1305,103.1
36030, 순천시,010005, 9세,2017,2740,1425,1315,108.4,2738,1423,1315,108.2
36030, 순천시,015,10~14세,2017,14228,7349,6879,106.8,14221,7347,6874,106.9
36030, 순천시,015001, 10세,2017,2840,1470,1370,107.3,2839,1469,1370,107.2
36030, 순천시,015002, 11세,2017,2701,1377,1324,104,2698,1377,1321,104.2
36030, 순천시,015003, 12세,2017,2621,1383,1238,111.7,2620,1383,1237,111.8
36030, 순천시,015004, 13세,2017,3025,1546,1479,104.5,3024,1545,1479,104.5
36030, 순천시,015005, 14세,2017,3041,1573,1468,107.2,3040,1573,1467,107.2
36030, 순천시,020,15~19세,2017,18024,9587,8437,113.6,17950,9540,8410,113.4
36030, 순천시,020001, 15세,2017,3133,1687,1446,116.7,3132,1686,1446,116.6
36030, 순천시,020002, 16세,2017,3624,1994,1630,122.3,3622,1992,1630,122.2
36030, 순천시,020003, 17세,2017,3985,2092,1893,110.5,3973,2082,1891,110.1
36030, 순천시,020004, 18세,2017,3711,1915,1796,106.6,3687,1898,1789,106.1
36030, 순천시,020005, 19세,2017,3571,1899,1672,113.6,3536,1882,1654,113.8
36030, 순천시,025,20~24세,2017,18597,10340,8257,125.2,18293,10217,8076,126.5
36030, 순천시,025001, 20세,2017,3857,2147,1710,125.6,3815,2135,1680,127.1
36030, 순천시,025002, 21세,2017,3953,2228,1725,129.2,3900,2204,1696,130
36030, 순천시,025003, 22세,2017,3854,2154,1700,126.7,3799,2128,1671,127.3
36030, 순천시,025004, 23세,2017,3578,2008,1570,127.9,3507,1977,1530,129.2
36030, 순천시,025005, 24세,2017,3355,1803,1552,116.2,3272,1773,1499,118.3
36030, 순천시,030,25~29세,2017,14120,7398,6722,110.1,13693,7198,6495,110.8
36030, 순천시,030001, 25세,2017,3218,1664,1554,107.1,3144,1631,1513,107.8
36030, 순천시,030002, 26세,2017,2908,1551,1357,114.3,2827,1514,1313,115.3
36030, 순천시,030003, 27세,2017,2834,1513,1321,114.5,2735,1460,1275,114.5
36030, 순천시,030004, 28세,2017,2637,1370,1267,108.1,2546,1335,1211,110.2
36030, 순천시,030005, 29세,2017,2523,1300,1223,106.3,2441,1258,1183,106.3
36030, 순천시,035,30~34세,2017,14799,7379,7420,99.4,14488,7250,7238,100.2
36030, 순천시,035001, 30세,2017,2595,1283,1312,97.8,2514,1246,1268,98.3
36030, 순천시,035002, 31세,2017,2747,1361,1386,98.2,2679,1334,1345,99.2
36030, 순천시,035003, 32세,2017,2831,1442,1389,103.8,2770,1417,1353,104.7
36030, 순천시,035004, 33세,2017,3225,1571,1654,95,3169,1547,1622,95.4
36030, 순천시,035005, 34세,2017,3401,1722,1679,102.6,3356,1706,1650,103.4
36030, 순천시,040,35~39세,2017,18488,9143,9345,97.8,18261,9033,9228,97.9
36030, 순천시,040001, 35세,2017,3741,1878,1863,100.8,3684,1853,1831,101.2
36030, 순천시,040002, 36세,2017,3561,1740,1821,95.6,3520,1724,1796,96
36030, 순천시,040003, 37세,2017,3890,1927,1963,98.2,3849,1906,1943,98.1
36030, 순천시,040004, 38세,2017,3772,1876,1896,98.9,3723,1845,1878,98.2
36030, 순천시,040005, 39세,2017,3524,1722,1802,95.6,3485,1705,1780,95.8
36030, 순천시,045,40~44세,2017,20600,9915,10685,92.8,20425,9834,10591,92.9
36030, 순천시,045001, 40세,2017,3791,1805,1986,90.9,3760,1789,1971,90.8
36030, 순천시,045002, 41세,2017,3733,1774,1959,90.6,3693,1760,1933,91.1
36030, 순천시,045003, 42세,2017,3960,1888,2072,91.1,3931,1874,2057,91.1
36030, 순천시,045004, 43세,2017,4477,2231,2246,99.3,4441,2212,2229,99.2
36030, 순천시,045005, 44세,2017,4639,2217,2422,91.5,4600,2199,2401,91.6
36030, 순천시,050,45~49세,2017,24549,12126,12423,97.6,24371,12057,12314,97.9
36030, 순천시,050001, 45세,2017,4586,2265,2321,97.6,4542,2253,2289,98.4
36030, 순천시,050002, 46세,2017,4911,2453,2458,99.8,4871,2436,2435,100
36030, 순천시,050003, 47세,2017,4806,2379,2427,98,4780,2365,2415,97.9
36030, 순천시,050004, 48세,2017,4882,2364,2518,93.9,4844,2348,2496,94.1
36030, 순천시,050005, 49세,2017,5364,2665,2699,98.7,5334,2655,2679,99.1
36030, 순천시,055,50~54세,2017,23163,11746,11417,102.9,23020,11700,11320,103.4
36030, 순천시,055001, 50세,2017,4664,2342,2322,100.9,4634,2331,2303,101.2
36030, 순천시,055002, 51세,2017,4701,2411,2290,105.3,4678,2405,2273,105.8
36030, 순천시,055003, 52세,2017,4746,2337,2409,97,4712,2326,2386,97.5
36030, 순천시,055004, 53세,2017,4376,2225,2151,103.4,4346,2216,2130,104
36030, 순천시,055005, 54세,2017,4676,2431,2245,108.3,4650,2422,2228,108.7
36030, 순천시,060,55~59세,2017,22170,11246,10924,102.9,22047,11199,10848,103.2
36030, 순천시,060001, 55세,2017,4392,2296,2096,109.5,4366,2283,2083,109.6
36030, 순천시,060002, 56세,2017,4741,2368,2373,99.8,4718,2359,2359,100
36030, 순천시,060003, 57세,2017,4928,2495,2433,102.5,4898,2482,2416,102.7
36030, 순천시,060004, 58세,2017,4321,2107,2214,95.2,4300,2100,2200,95.5
36030, 순천시,060005, 59세,2017,3788,1980,1808,109.5,3765,1975,1790,110.3
36030, 순천시,065,60~64세,2017,14994,7554,7440,101.5,14926,7521,7405,101.6
36030, 순천시,065001, 60세,2017,3605,1791,1814,98.7,3593,1787,1806,98.9
36030, 순천시,065002, 61세,2017,3067,1544,1523,101.4,3049,1535,1514,101.4
36030, 순천시,065003, 62세,2017,3254,1690,1564,108.1,3232,1676,1556,107.7
36030, 순천시,065004, 63세,2017,2803,1376,1427,96.4,2795,1372,1423,96.4
36030, 순천시,065005, 64세,2017,2265,1153,1112,103.7,2257,1151,1106,104.1
36030, 순천시,070,65~69세,2017,11641,5819,5822,99.9,11595,5792,5803,99.8
36030, 순천시,070001, 65세,2017,2659,1323,1336,99,2647,1317,1330,99
36030, 순천시,070002, 66세,2017,2217,1132,1085,104.3,2212,1129,1083,104.2
36030, 순천시,070003, 67세,2017,2351,1190,1161,102.5,2336,1181,1155,102.3
36030, 순천시,070004, 68세,2017,2278,1131,1147,98.6,2271,1126,1145,98.3
36030, 순천시,070005, 69세,2017,2136,1043,1093,95.4,2129,1039,1090,95.3
36030, 순천시,075,70~74세,2017,8727,3969,4758,83.4,8718,3965,4753,83.4
36030, 순천시,075001, 70세,2017,2244,1054,1190,88.6,2243,1054,1189,88.6
36030, 순천시,075002, 71세,2017,1585,775,810,95.7,1584,774,810,95.6
36030, 순천시,075003, 72세,2017,1499,677,822,82.4,1498,677,821,82.5
36030, 순천시,075004, 73세,2017,1534,694,840,82.6,1532,692,840,82.4
36030, 순천시,075005, 74세,2017,1865,769,1096,70.2,1861,768,1093,70.3
36030, 순천시,080,75~79세,2017,8348,3379,4969,68,8342,3376,4966,68
36030, 순천시,080001, 75세,2017,2067,860,1207,71.3,2066,860,1206,71.3
36030, 순천시,080002, 76세,2017,1741,723,1018,71,1740,722,1018,70.9
36030, 순천시,080003, 77세,2017,1560,631,929,67.9,1559,631,928,68
36030, 순천시,080004, 78세,2017,1540,618,922,67,1540,618,922,67
36030, 순천시,080005, 79세,2017,1440,547,893,61.3,1437,545,892,61.1
36030, 순천시,085,80~84세,2017,5600,1859,3741,49.7,5596,1855,3741,49.6
36030, 순천시,085001, 80세,2017,1326,475,851,55.8,1326,475,851,55.8
36030, 순천시,085002, 81세,2017,1205,408,797,51.2,1203,406,797,50.9
36030, 순천시,085003, 82세,2017,1169,401,768,52.2,1168,400,768,52.1
36030, 순천시,085004, 83세,2017,1036,317,719,44.1,1036,317,719,44.1
36030, 순천시,085005, 84세,2017,864,258,606,42.6,863,257,606,42.4
36030, 순천시,090,85~89세,2017,2779,758,2021,37.5,2778,758,2020,37.5
36030, 순천시,090001, 85세,2017,734,215,519,41.4,733,215,518,41.5
36030, 순천시,090002, 86세,2017,616,176,440,40,616,176,440,40
36030, 순천시,090003, 87세,2017,619,150,469,32,619,150,469,32
36030, 순천시,090004, 88세,2017,489,132,357,37,489,132,357,37
36030, 순천시,090005, 89세,2017,321,85,236,36,321,85,236,36
36030, 순천시,095,90~94세,2017,820,188,632,29.7,820,188,632,29.7
36030, 순천시,095001, 90세,2017,274,64,210,30.5,274,64,210,30.5
36030, 순천시,095002, 91세,2017,183,45,138,32.6,183,45,138,32.6
36030, 순천시,095003, 92세,2017,160,36,124,29,160,36,124,29
36030, 순천시,095004, 93세,2017,102,23,79,29.1,102,23,79,29.1
36030, 순천시,095005, 94세,2017,101,20,81,24.7,101,20,81,24.7
36030, 순천시,100,95~99세,2017,211,33,178,18.5,211,33,178,18.5
36030, 순천시,100001, 95세,2017,93,16,77,20.8,93,16,77,20.8
36030, 순천시,100002, 96세,2017,48,6,42,14.3,48,6,42,14.3
36030, 순천시,100003, 97세,2017,34,X,31,9.7,34,X,31,9.7
36030, 순천시,100004, 98세,2017,20,6,14,42.9,20,6,14,42.9
36030, 순천시,100005, 99세,2017,16,X,14,14.3,16,X,14,14.3
36030, 순천시,101,100세이상,2017,20,X,19,5.3,20,X,19,5.3
36030, 순천시,102,15세미만,2017,39159,20217,18942,106.7,39123,20195,18928,106.7
36030, 순천시,103,15~64세,2017,189504,96434,93070,103.6,187474,95549,91925,103.9
36030, 순천시,104,65세이상,2017,38146,16006,22140,72.3,38080,15968,22112,72.2
36030, 순천시,086,85세이상,2017,3830,980,2850,34.4,3829,980,2849,34.4
36030, 순천시,126,평균연령,2017,41,39.6,42.3,,41,39.7,42.4,
36030, 순천시,127,중위연령,2017,42.7,41.3,43.9,,42.8,41.4,44,
36040, 나주시,000,합계,2017,105579,52440,53139,98.7,102467,50692,51775,97.9
36040, 나주시,005,0~4세,2017,5280,2706,2574,105.1,5257,2698,2559,105.4
36040, 나주시,005001, 0세,2017,967,490,477,102.7,957,487,470,103.6
36040, 나주시,005002, 1세,2017,1081,553,528,104.7,1078,552,526,104.9
36040, 나주시,005003, 2세,2017,1125,570,555,102.7,1122,570,552,103.3
36040, 나주시,005004, 3세,2017,1044,551,493,111.8,1042,549,493,111.4
36040, 나주시,005005, 4세,2017,1063,542,521,104,1058,540,518,104.2
36040, 나주시,010,5~9세,2017,4735,2433,2302,105.7,4720,2425,2295,105.7
36040, 나주시,010001, 5세,2017,1126,596,530,112.5,1121,593,528,112.3
36040, 나주시,010002, 6세,2017,985,474,511,92.8,984,473,511,92.6
36040, 나주시,010003, 7세,2017,867,466,401,116.2,867,466,401,116.2
36040, 나주시,010004, 8세,2017,869,445,424,105,863,443,420,105.5
36040, 나주시,010005, 9세,2017,888,452,436,103.7,885,450,435,103.4
36040, 나주시,015,10~14세,2017,3913,2015,1898,106.2,3904,2012,1892,106.3
36040, 나주시,015001, 10세,2017,874,451,423,106.6,874,451,423,106.6
36040, 나주시,015002, 11세,2017,790,433,357,121.3,788,432,356,121.3
36040, 나주시,015003, 12세,2017,697,361,336,107.4,694,359,335,107.2
36040, 나주시,015004, 13세,2017,771,397,374,106.1,769,397,372,106.7
36040, 나주시,015005, 14세,2017,781,373,408,91.4,779,373,406,91.9
36040, 나주시,020,15~19세,2017,5666,2882,2784,103.5,5527,2822,2705,104.3
36040, 나주시,020001, 15세,2017,842,427,415,102.9,839,424,415,102.2
36040, 나주시,020002, 16세,2017,1118,570,548,104,1115,568,547,103.8
36040, 나주시,020003, 17세,2017,1263,624,639,97.7,1257,624,633,98.6
36040, 나주시,020004, 18세,2017,1123,590,533,110.7,1089,578,511,113.1
36040, 나주시,020005, 19세,2017,1320,671,649,103.4,1227,628,599,104.8
36040, 나주시,025,20~24세,2017,5892,3165,2727,116.1,5195,2745,2450,112
36040, 나주시,025001, 20세,2017,1177,592,585,101.2,1083,550,533,103.2
36040, 나주시,025002, 21세,2017,1222,627,595,105.4,1082,550,532,103.4
36040, 나주시,025003, 22세,2017,1206,693,513,135.1,1047,589,458,128.6
36040, 나주시,025004, 23세,2017,1134,635,499,127.3,979,527,452,116.6
36040, 나주시,025005, 24세,2017,1153,618,535,115.5,1004,529,475,111.4
36040, 나주시,030,25~29세,2017,5760,2954,2806,105.3,5084,2560,2524,101.4
36040, 나주시,030001, 25세,2017,1129,565,564,100.2,976,470,506,92.9
36040, 나주시,030002, 26세,2017,1138,596,542,110,1000,520,480,108.3
36040, 나주시,030003, 27세,2017,1144,608,536,113.4,1015,531,484,109.7
36040, 나주시,030004, 28세,2017,1179,592,587,100.9,1060,528,532,99.2
36040, 나주시,030005, 29세,2017,1170,593,577,102.8,1033,511,522,97.9
36040, 나주시,035,30~34세,2017,6649,3427,3222,106.4,6213,3171,3042,104.2
36040, 나주시,035001, 30세,2017,1219,624,595,104.9,1112,567,545,104
36040, 나주시,035002, 31세,2017,1233,608,625,97.3,1147,565,582,97.1
36040, 나주시,035003, 32세,2017,1275,649,626,103.7,1182,596,586,101.7
36040, 나주시,035004, 33세,2017,1382,729,653,111.6,1305,677,628,107.8
36040, 나주시,035005, 34세,2017,1540,817,723,113,1467,766,701,109.3
36040, 나주시,040,35~39세,2017,7974,4236,3738,113.3,7649,4044,3605,112.2
36040, 나주시,040001, 35세,2017,1656,863,793,108.8,1576,815,761,107.1
36040, 나주시,040002, 36세,2017,1668,911,757,120.3,1595,868,727,119.4
36040, 나주시,040003, 37세,2017,1636,838,798,105,1576,801,775,103.4
36040, 나주시,040004, 38세,2017,1596,860,736,116.8,1545,829,716,115.8
36040, 나주시,040005, 39세,2017,1418,764,654,116.8,1357,731,626,116.8
36040, 나주시,045,40~44세,2017,7140,4042,3098,130.5,6943,3919,3024,129.6
36040, 나주시,045001, 40세,2017,1440,793,647,122.6,1400,765,635,120.5
36040, 나주시,045002, 41세,2017,1374,789,585,134.9,1321,755,566,133.4
36040, 나주시,045003, 42세,2017,1419,783,636,123.1,1387,764,623,122.6
36040, 나주시,045004, 43세,2017,1451,822,629,130.7,1419,804,615,130.7
36040, 나주시,045005, 44세,2017,1456,855,601,142.3,1416,831,585,142.1
36040, 나주시,050,45~49세,2017,7254,4034,3220,125.3,7054,3926,3128,125.5
36040, 나주시,050001, 45세,2017,1446,839,607,138.2,1413,822,591,139.1
36040, 나주시,050002, 46세,2017,1480,827,653,126.6,1438,803,635,126.5
36040, 나주시,050003, 47세,2017,1481,851,630,135.1,1435,828,607,136.4
36040, 나주시,050004, 48세,2017,1366,718,648,110.8,1324,693,631,109.8
36040, 나주시,050005, 49세,2017,1481,799,682,117.2,1444,780,664,117.5
36040, 나주시,055,50~54세,2017,7302,3929,3373,116.5,7135,3859,3276,117.8
36040, 나주시,055001, 50세,2017,1413,769,644,119.4,1378,758,620,122.3
36040, 나주시,055002, 51세,2017,1462,798,664,120.2,1427,781,646,120.9
36040, 나주시,055003, 52세,2017,1484,829,655,126.6,1451,812,639,127.1
36040, 나주시,055004, 53세,2017,1401,699,702,99.6,1373,688,685,100.4
36040, 나주시,055005, 54세,2017,1542,834,708,117.8,1506,820,686,119.5
36040, 나주시,060,55~59세,2017,8196,4194,4002,104.8,8084,4147,3937,105.3
36040, 나주시,060001, 55세,2017,1459,772,687,112.4,1438,763,675,113
36040, 나주시,060002, 56세,2017,1688,858,830,103.4,1667,849,818,103.8
36040, 나주시,060003, 57세,2017,1810,917,893,102.7,1781,905,876,103.3
36040, 나주시,060004, 58세,2017,1651,859,792,108.5,1630,850,780,109
36040, 나주시,060005, 59세,2017,1588,788,800,98.5,1568,780,788,99
36040, 나주시,065,60~64세,2017,6763,3397,3366,100.9,6690,3355,3335,100.6
36040, 나주시,065001, 60세,2017,1561,806,755,106.8,1544,797,747,106.7
36040, 나주시,065002, 61세,2017,1377,693,684,101.3,1362,684,678,100.9
36040, 나주시,065003, 62세,2017,1460,734,726,101.1,1446,729,717,101.7
36040, 나주시,065004, 63세,2017,1301,642,659,97.4,1285,631,654,96.5
36040, 나주시,065005, 64세,2017,1064,522,542,96.3,1053,514,539,95.4
36040, 나주시,070,65~69세,2017,5797,2790,3007,92.8,5774,2778,2996,92.7
36040, 나주시,070001, 65세,2017,1270,603,667,90.4,1265,602,663,90.8
36040, 나주시,070002, 66세,2017,1047,518,529,97.9,1038,513,525,97.7
36040, 나주시,070003, 67세,2017,1125,558,567,98.4,1120,553,567,97.5
36040, 나주시,070004, 68세,2017,1204,560,644,87,1202,559,643,86.9
36040, 나주시,070005, 69세,2017,1151,551,600,91.8,1149,551,598,92.1
36040, 나주시,075,70~74세,2017,5270,2297,2973,77.3,5261,2293,2968,77.3
36040, 나주시,075001, 70세,2017,1207,576,631,91.3,1203,574,629,91.3
36040, 나주시,075002, 71세,2017,897,385,512,75.2,895,384,511,75.1
36040, 나주시,075003, 72세,2017,1065,446,619,72.1,1065,446,619,72.1
36040, 나주시,075004, 73세,2017,985,428,557,76.8,985,428,557,76.8
36040, 나주시,075005, 74세,2017,1116,462,654,70.6,1113,461,652,70.7
36040, 나주시,080,75~79세,2017,5570,2099,3471,60.5,5565,2098,3467,60.5
36040, 나주시,080001, 75세,2017,1436,574,862,66.6,1434,574,860,66.7
36040, 나주시,080002, 76세,2017,1102,447,655,68.2,1100,447,653,68.5
36040, 나주시,080003, 77세,2017,1060,402,658,61.1,1059,401,658,60.9
36040, 나주시,080004, 78세,2017,994,337,657,51.3,994,337,657,51.3
36040, 나주시,080005, 79세,2017,978,339,639,53.1,978,339,639,53.1
36040, 나주시,085,80~84세,2017,3733,1202,2531,47.5,3729,1202,2527,47.6
36040, 나주시,085001, 80세,2017,930,311,619,50.2,928,311,617,50.4
36040, 나주시,085002, 81세,2017,762,260,502,51.8,762,260,502,51.8
36040, 나주시,085003, 82세,2017,764,252,512,49.2,763,252,511,49.3
36040, 나주시,085004, 83세,2017,698,216,482,44.8,698,216,482,44.8
36040, 나주시,085005, 84세,2017,579,163,416,39.2,578,163,415,39.3
36040, 나주시,090,85~89세,2017,1921,466,1455,32,1919,466,1453,32.1
36040, 나주시,090001, 85세,2017,478,137,341,40.2,478,137,341,40.2
36040, 나주시,090002, 86세,2017,423,96,327,29.4,423,96,327,29.4
36040, 나주시,090003, 87세,2017,443,89,354,25.1,442,89,353,25.2
36040, 나주시,090004, 88세,2017,320,79,241,32.8,319,79,240,32.9
36040, 나주시,090005, 89세,2017,257,65,192,33.9,257,65,192,33.9
36040, 나주시,095,90~94세,2017,591,133,458,29,591,133,458,29
36040, 나주시,095001, 90세,2017,181,39,142,27.5,181,39,142,27.5
36040, 나주시,095002, 91세,2017,152,30,122,24.6,152,30,122,24.6
36040, 나주시,095003, 92세,2017,104,30,74,40.5,104,30,74,40.5
36040, 나주시,095004, 93세,2017,64,19,45,42.2,64,19,45,42.2
36040, 나주시,095005, 94세,2017,90,15,75,20,90,15,75,20
36040, 나주시,100,95~99세,2017,162,38,124,30.6,162,38,124,30.6
36040, 나주시,100001, 95세,2017,54,14,40,35,54,14,40,35
36040, 나주시,100002, 96세,2017,45,7,38,18.4,45,7,38,18.4
36040, 나주시,100003, 97세,2017,31,7,24,29.2,31,7,24,29.2
36040, 나주시,100004, 98세,2017,15,7,8,87.5,15,7,8,87.5
36040, 나주시,100005, 99세,2017,17,X,14,21.4,17,X,14,21.4
36040, 나주시,101,100세이상,2017,11,X,10,10,11,X,10,10
36040, 나주시,102,15세미만,2017,13928,7154,6774,105.6,13881,7135,6746,105.8
36040, 나주시,103,15~64세,2017,68596,36260,32336,112.1,65574,34548,31026,111.4
36040, 나주시,104,65세이상,2017,23055,9026,14029,64.3,23012,9009,14003,64.3
36040, 나주시,086,85세이상,2017,2685,638,2047,31.2,2683,638,2045,31.2
36040, 나주시,126,평균연령,2017,44.3,42.3,46.3,,44.6,42.6,46.6,
36040, 나주시,127,중위연령,2017,44.8,43,47.3,,45.5,43.7,47.9,
36060, 광양시,000,합계,2017,144010,74408,69602,106.9,142218,73559,68659,107.1
36060, 광양시,005,0~4세,2017,7301,3753,3548,105.8,7288,3746,3542,105.8
36060, 광양시,005001, 0세,2017,1301,721,580,124.3,1297,721,576,125.2
36060, 광양시,005002, 1세,2017,1376,708,668,106,1374,706,668,105.7
36060, 광양시,005003, 2세,2017,1547,794,753,105.4,1544,792,752,105.3
36060, 광양시,005004, 3세,2017,1475,709,766,92.6,1472,707,765,92.4
36060, 광양시,005005, 4세,2017,1602,821,781,105.1,1601,820,781,105
36060, 광양시,010,5~9세,2017,7846,4013,3833,104.7,7834,4007,3827,104.7
36060, 광양시,010001, 5세,2017,1659,848,811,104.6,1657,846,811,104.3
36060, 광양시,010002, 6세,2017,1644,825,819,100.7,1641,824,817,100.9
36060, 광양시,010003, 7세,2017,1574,829,745,111.3,1570,827,743,111.3
36060, 광양시,010004, 8세,2017,1431,723,708,102.1,1429,722,707,102.1
36060, 광양시,010005, 9세,2017,1538,788,750,105.1,1537,788,749,105.2
36060, 광양시,015,10~14세,2017,7382,3812,3570,106.8,7374,3809,3565,106.8
36060, 광양시,015001, 10세,2017,1515,793,722,109.8,1512,792,720,110
36060, 광양시,015002, 11세,2017,1441,727,714,101.8,1441,727,714,101.8
36060, 광양시,015003, 12세,2017,1412,698,714,97.8,1410,696,714,97.5
36060, 광양시,015004, 13세,2017,1471,775,696,111.4,1470,775,695,111.5
36060, 광양시,015005, 14세,2017,1543,819,724,113.1,1541,819,722,113.4
36060, 광양시,020,15~19세,2017,9582,5078,4504,112.7,9558,5066,4492,112.8
36060, 광양시,020001, 15세,2017,1711,897,814,110.2,1710,896,814,110.1
36060, 광양시,020002, 16세,2017,2071,1044,1027,101.7,2066,1039,1027,101.2
36060, 광양시,020003, 17세,2017,2369,1212,1157,104.8,2364,1210,1154,104.9
36060, 광양시,020004, 18세,2017,2000,1067,933,114.4,1993,1066,927,115
36060, 광양시,020005, 19세,2017,1431,858,573,149.7,1425,855,570,150
36060, 광양시,025,20~24세,2017,8617,5181,3436,150.8,8442,5096,3346,152.3
36060, 광양시,025001, 20세,2017,1868,1178,690,170.7,1856,1176,680,172.9
36060, 광양시,025002, 21세,2017,1838,1215,623,195,1818,1205,613,196.6
36060, 광양시,025003, 22세,2017,1660,1002,658,152.3,1623,980,643,152.4
36060, 광양시,025004, 23세,2017,1602,905,697,129.8,1555,881,674,130.7
36060, 광양시,025005, 24세,2017,1649,881,768,114.7,1590,854,736,116
36060, 광양시,030,25~29세,2017,7893,4408,3485,126.5,7534,4243,3291,128.9
36060, 광양시,030001, 25세,2017,1650,923,727,127,1576,882,694,127.1
36060, 광양시,030002, 26세,2017,1623,929,694,133.9,1548,895,653,137.1
36060, 광양시,030003, 27세,2017,1563,848,715,118.6,1494,814,680,119.7
36060, 광양시,030004, 28세,2017,1530,889,641,138.7,1465,861,604,142.5
36060, 광양시,030005, 29세,2017,1527,819,708,115.7,1451,791,660,119.8
36060, 광양시,035,30~34세,2017,8966,4708,4258,110.6,8650,4545,4105,110.7
36060, 광양시,035001, 30세,2017,1519,821,698,117.6,1445,784,661,118.6
36060, 광양시,035002, 31세,2017,1740,920,820,112.2,1668,886,782,113.3
36060, 광양시,035003, 32세,2017,1751,910,841,108.2,1696,879,817,107.6
36060, 광양시,035004, 33세,2017,1827,925,902,102.5,1764,894,870,102.8
36060, 광양시,035005, 34세,2017,2129,1132,997,113.5,2077,1102,975,113
36060, 광양시,040,35~39세,2017,11062,5821,5241,111.1,10870,5730,5140,111.5
36060, 광양시,040001, 35세,2017,2317,1223,1094,111.8,2275,1206,1069,112.8
36060, 광양시,040002, 36세,2017,2114,1136,978,116.2,2064,1115,949,117.5
36060, 광양시,040003, 37세,2017,2358,1253,1105,113.4,2327,1236,1091,113.3
36060, 광양시,040004, 38세,2017,2225,1135,1090,104.1,2188,1116,1072,104.1
36060, 광양시,040005, 39세,2017,2048,1074,974,110.3,2016,1057,959,110.2
36060, 광양시,045,40~44세,2017,11020,5477,5543,98.8,10871,5403,5468,98.8
36060, 광양시,045001, 40세,2017,2108,1056,1052,100.4,2076,1041,1035,100.6
36060, 광양시,045002, 41세,2017,2015,984,1031,95.4,1981,965,1016,95
36060, 광양시,045003, 42세,2017,2094,1055,1039,101.5,2072,1044,1028,101.6
36060, 광양시,045004, 43세,2017,2304,1155,1149,100.5,2280,1147,1133,101.2
36060, 광양시,045005, 44세,2017,2499,1227,1272,96.5,2462,1206,1256,96
36060, 광양시,050,45~49세,2017,14675,7421,7254,102.3,14512,7353,7159,102.7
36060, 광양시,050001, 45세,2017,2501,1260,1241,101.5,2468,1246,1222,102
36060, 광양시,050002, 46세,2017,2927,1403,1524,92.1,2890,1384,1506,91.9
36060, 광양시,050003, 47세,2017,2855,1394,1461,95.4,2828,1379,1449,95.2
36060, 광양시,050004, 48세,2017,3075,1569,1506,104.2,3041,1559,1482,105.2
36060, 광양시,050005, 49세,2017,3317,1795,1522,117.9,3285,1785,1500,119
36060, 광양시,055,50~54세,2017,13686,7679,6007,127.8,13539,7610,5929,128.4
36060, 광양시,055001, 50세,2017,3080,1690,1390,121.6,3049,1673,1376,121.6
36060, 광양시,055002, 51세,2017,2953,1742,1211,143.8,2928,1731,1197,144.6
36060, 광양시,055003, 52세,2017,2774,1566,1208,129.6,2743,1551,1192,130.1
36060, 광양시,055004, 53세,2017,2326,1244,1082,115,2303,1234,1069,115.4
36060, 광양시,055005, 54세,2017,2553,1437,1116,128.8,2516,1421,1095,129.8
36060, 광양시,060,55~59세,2017,11533,6044,5489,110.1,11431,5995,5436,110.3
36060, 광양시,060001, 55세,2017,2346,1282,1064,120.5,2325,1267,1058,119.8
36060, 광양시,060002, 56세,2017,2544,1339,1205,111.1,2527,1331,1196,111.3
36060, 광양시,060003, 57세,2017,2544,1292,1252,103.2,2523,1281,1242,103.1
36060, 광양시,060004, 58세,2017,2132,1076,1056,101.9,2111,1070,1041,102.8
36060, 광양시,060005, 59세,2017,1967,1055,912,115.7,1945,1046,899,116.4
36060, 광양시,065,60~64세,2017,7586,4026,3560,113.1,7508,3990,3518,113.4
36060, 광양시,065001, 60세,2017,1833,1008,825,122.2,1814,1000,814,122.9
36060, 광양시,065002, 61세,2017,1555,827,728,113.6,1540,821,719,114.2
36060, 광양시,065003, 62세,2017,1632,839,793,105.8,1618,833,785,106.1
36060, 광양시,065004, 63세,2017,1452,750,702,106.8,1439,744,695,107.1
36060, 광양시,065005, 64세,2017,1114,602,512,117.6,1097,592,505,117.2
36060, 광양시,070,65~69세,2017,5278,2739,2539,107.9,5245,2723,2522,108
36060, 광양시,070001, 65세,2017,1163,628,535,117.4,1158,625,533,117.3
36060, 광양시,070002, 66세,2017,1086,574,512,112.1,1074,569,505,112.7
36060, 광양시,070003, 67세,2017,1057,554,503,110.1,1048,548,500,109.6
36060, 광양시,070004, 68세,2017,972,491,481,102.1,966,489,477,102.5
36060, 광양시,070005, 69세,2017,1000,492,508,96.9,999,492,507,97
36060, 광양시,075,70~74세,2017,3630,1618,2012,80.4,3618,1617,2001,80.8
36060, 광양시,075001, 70세,2017,1007,492,515,95.5,1003,492,511,96.3
36060, 광양시,075002, 71세,2017,623,299,324,92.3,620,299,321,93.1
36060, 광양시,075003, 72세,2017,618,271,347,78.1,615,270,345,78.3
36060, 광양시,075004, 73세,2017,642,249,393,63.4,642,249,393,63.4
36060, 광양시,075005, 74세,2017,740,307,433,70.9,738,307,431,71.2
36060, 광양시,080,75~79세,2017,3673,1412,2261,62.5,3667,1411,2256,62.5
36060, 광양시,080001, 75세,2017,874,348,526,66.2,872,348,524,66.4
36060, 광양시,080002, 76세,2017,736,279,457,61.1,733,278,455,61.1
36060, 광양시,080003, 77세,2017,690,260,430,60.5,689,260,429,60.6
36060, 광양시,080004, 78세,2017,722,284,438,64.8,722,284,438,64.8
36060, 광양시,080005, 79세,2017,651,241,410,58.8,651,241,410,58.8
36060, 광양시,085,80~84세,2017,2505,830,1675,49.6,2502,827,1675,49.4
36060, 광양시,085001, 80세,2017,606,217,389,55.8,605,216,389,55.5
36060, 광양시,085002, 81세,2017,592,217,375,57.9,592,217,375,57.9
36060, 광양시,085003, 82세,2017,514,166,348,47.7,512,164,348,47.1
36060, 광양시,085004, 83세,2017,425,131,294,44.6,425,131,294,44.6
36060, 광양시,085005, 84세,2017,368,99,269,36.8,368,99,269,36.8
36060, 광양시,090,85~89세,2017,1298,313,985,31.8,1298,313,985,31.8
36060, 광양시,090001, 85세,2017,359,97,262,37,359,97,262,37
36060, 광양시,090002, 86세,2017,307,67,240,27.9,307,67,240,27.9
36060, 광양시,090003, 87세,2017,250,52,198,26.3,250,52,198,26.3
36060, 광양시,090004, 88세,2017,198,53,145,36.6,198,53,145,36.6
36060, 광양시,090005, 89세,2017,184,44,140,31.4,184,44,140,31.4
36060, 광양시,095,90~94세,2017,383,62,321,19.3,383,62,321,19.3
36060, 광양시,095001, 90세,2017,120,23,97,23.7,120,23,97,23.7
36060, 광양시,095002, 91세,2017,97,18,79,22.8,97,18,79,22.8
36060, 광양시,095003, 92세,2017,59,8,51,15.7,59,8,51,15.7
36060, 광양시,095004, 93세,2017,56,8,48,16.7,56,8,48,16.7
36060, 광양시,095005, 94세,2017,51,5,46,10.9,51,5,46,10.9
36060, 광양시,100,95~99세,2017,87,13,74,17.6,87,13,74,17.6
36060, 광양시,100001, 95세,2017,36,6,30,20,36,6,30,20
36060, 광양시,100002, 96세,2017,30,X,26,15.4,30,X,26,15.4
36060, 광양시,100003, 97세,2017,11,X,10,10,11,X,10,10
36060, 광양시,100004, 98세,2017,X,X,X,0,X,X,X,0
36060, 광양시,100005, 99세,2017,7,X,5,40,7,X,5,40
36060, 광양시,101,100세이상,2017,7,X,7,0,7,X,7,0
36060, 광양시,102,15세미만,2017,22529,11578,10951,105.7,22496,11562,10934,105.7
36060, 광양시,103,15~64세,2017,104620,55843,48777,114.5,102915,55031,47884,114.9
36060, 광양시,104,65세이상,2017,16861,6987,9874,70.8,16807,6966,9841,70.8
36060, 광양시,086,85세이상,2017,1775,388,1387,28,1775,388,1387,28
36060, 광양시,126,평균연령,2017,39.9,38.8,41,,39.9,38.8,41.1,
36060, 광양시,127,중위연령,2017,41.6,40.4,42.8,,41.7,40.5,42.9,
36310, 담양군,000,합계,2017,43781,21631,22150,97.7,42518,20952,21566,97.2
36310, 담양군,005,0~4세,2017,1327,661,666,99.2,1326,660,666,99.1
36310, 담양군,005001, 0세,2017,286,144,142,101.4,286,144,142,101.4
36310, 담양군,005002, 1세,2017,261,136,125,108.8,261,136,125,108.8
36310, 담양군,005003, 2세,2017,266,117,149,78.5,266,117,149,78.5
36310, 담양군,005004, 3세,2017,272,140,132,106.1,272,140,132,106.1
36310, 담양군,005005, 4세,2017,242,124,118,105.1,241,123,118,104.2
36310, 담양군,010,5~9세,2017,1236,638,598,106.7,1236,638,598,106.7
36310, 담양군,010001, 5세,2017,258,126,132,95.5,258,126,132,95.5
36310, 담양군,010002, 6세,2017,250,144,106,135.8,250,144,106,135.8
36310, 담양군,010003, 7세,2017,246,113,133,85,246,113,133,85
36310, 담양군,010004, 8세,2017,241,125,116,107.8,241,125,116,107.8
36310, 담양군,010005, 9세,2017,241,130,111,117.1,241,130,111,117.1
36310, 담양군,015,10~14세,2017,1225,619,606,102.1,1222,617,605,102
36310, 담양군,015001, 10세,2017,218,105,113,92.9,217,104,113,92
36310, 담양군,015002, 11세,2017,239,120,119,100.8,238,120,118,101.7
36310, 담양군,015003, 12세,2017,262,132,130,101.5,262,132,130,101.5
36310, 담양군,015004, 13세,2017,256,132,124,106.5,255,131,124,105.6
36310, 담양군,015005, 14세,2017,250,130,120,108.3,250,130,120,108.3
36310, 담양군,020,15~19세,2017,2722,1442,1280,112.7,2716,1440,1276,112.9
36310, 담양군,020001, 15세,2017,345,184,161,114.3,345,184,161,114.3
36310, 담양군,020002, 16세,2017,657,354,303,116.8,657,354,303,116.8
36310, 담양군,020003, 17세,2017,643,335,308,108.8,642,334,308,108.4
36310, 담양군,020004, 18세,2017,611,321,290,110.7,609,320,289,110.7
36310, 담양군,020005, 19세,2017,466,248,218,113.8,463,248,215,115.3
36310, 담양군,025,20~24세,2017,2267,1335,932,143.2,1980,1167,813,143.5
36310, 담양군,025001, 20세,2017,450,260,190,136.8,429,244,185,131.9
36310, 담양군,025002, 21세,2017,513,329,184,178.8,476,303,173,175.1
36310, 담양군,025003, 22세,2017,452,274,178,153.9,398,242,156,155.1
36310, 담양군,025004, 23세,2017,443,262,181,144.8,356,212,144,147.2
36310, 담양군,025005, 24세,2017,409,210,199,105.5,321,166,155,107.1
36310, 담양군,030,25~29세,2017,2107,1084,1023,106,1761,903,858,105.2
36310, 담양군,030001, 25세,2017,493,273,220,124.1,392,215,177,121.5
36310, 담양군,030002, 26세,2017,418,209,209,100,351,176,175,100.6
36310, 담양군,030003, 27세,2017,414,210,204,102.9,351,179,172,104.1
36310, 담양군,030004, 28세,2017,386,182,204,89.2,326,154,172,89.5
36310, 담양군,030005, 29세,2017,396,210,186,112.9,341,179,162,110.5
36310, 담양군,035,30~34세,2017,1936,1003,933,107.5,1726,894,832,107.5
36310, 담양군,035001, 30세,2017,382,191,191,100,333,161,172,93.6
36310, 담양군,035002, 31세,2017,386,199,187,106.4,337,175,162,108
36310, 담양군,035003, 32세,2017,364,186,178,104.5,322,166,156,106.4
36310, 담양군,035004, 33세,2017,392,213,179,119,351,193,158,122.2
36310, 담양군,035005, 34세,2017,412,214,198,108.1,383,199,184,108.2
36310, 담양군,040,35~39세,2017,2016,1100,916,120.1,1884,1024,860,119.1
36310, 담양군,040001, 35세,2017,406,215,191,112.6,376,197,179,110.1
36310, 담양군,040002, 36세,2017,411,210,201,104.5,387,198,189,104.8
36310, 담양군,040003, 37세,2017,419,231,188,122.9,390,214,176,121.6
36310, 담양군,040004, 38세,2017,389,221,168,131.5,361,205,156,131.4
36310, 담양군,040005, 39세,2017,391,223,168,132.7,370,210,160,131.3
36310, 담양군,045,40~44세,2017,2277,1323,954,138.7,2176,1263,913,138.3
36310, 담양군,045001, 40세,2017,386,216,170,127.1,371,209,162,129
36310, 담양군,045002, 41세,2017,382,235,147,159.9,360,221,139,159
36310, 담양군,045003, 42세,2017,467,265,202,131.2,444,249,195,127.7
36310, 담양군,045004, 43세,2017,562,343,219,156.6,538,328,210,156.2
36310, 담양군,045005, 44세,2017,480,264,216,122.2,463,256,207,123.7
36310, 담양군,050,45~49세,2017,2977,1682,1295,129.9,2928,1657,1271,130.4
36310, 담양군,050001, 45세,2017,532,324,208,155.8,522,319,203,157.1
36310, 담양군,050002, 46세,2017,629,372,257,144.7,616,367,249,147.4
36310, 담양군,050003, 47세,2017,579,318,261,121.8,573,314,259,121.2
36310, 담양군,050004, 48세,2017,576,299,277,107.9,567,294,273,107.7
36310, 담양군,050005, 49세,2017,661,369,292,126.4,650,363,287,126.5
36310, 담양군,055,50~54세,2017,3324,1765,1559,113.2,3273,1746,1527,114.3
36310, 담양군,055001, 50세,2017,591,333,258,129.1,586,332,254,130.7
36310, 담양군,055002, 51세,2017,626,342,284,120.4,613,337,276,122.1
36310, 담양군,055003, 52세,2017,685,336,349,96.3,667,333,334,99.7
36310, 담양군,055004, 53세,2017,692,362,330,109.7,685,357,328,108.8
36310, 담양군,055005, 54세,2017,730,392,338,116,722,387,335,115.5
36310, 담양군,060,55~59세,2017,4100,2116,1984,106.7,4062,2101,1961,107.1
36310, 담양군,060001, 55세,2017,744,405,339,119.5,734,400,334,119.8
36310, 담양군,060002, 56세,2017,864,425,439,96.8,855,421,434,97
36310, 담양군,060003, 57세,2017,916,473,443,106.8,908,471,437,107.8
36310, 담양군,060004, 58세,2017,823,439,384,114.3,818,437,381,114.7
36310, 담양군,060005, 59세,2017,753,374,379,98.7,747,372,375,99.2
36310, 담양군,065,60~64세,2017,3465,1709,1756,97.3,3451,1702,1749,97.3
36310, 담양군,065001, 60세,2017,812,421,391,107.7,808,418,390,107.2
36310, 담양군,065002, 61세,2017,655,335,320,104.7,653,334,319,104.7
36310, 담양군,065003, 62세,2017,721,340,381,89.2,718,339,379,89.4
36310, 담양군,065004, 63세,2017,697,328,369,88.9,693,326,367,88.8
36310, 담양군,065005, 64세,2017,580,285,295,96.6,579,285,294,96.9
36310, 담양군,070,65~69세,2017,3123,1519,1604,94.7,3106,1510,1596,94.6
36310, 담양군,070001, 65세,2017,688,350,338,103.6,686,348,338,103
36310, 담양군,070002, 66세,2017,547,258,289,89.3,543,255,288,88.5
36310, 담양군,070003, 67세,2017,632,308,324,95.1,628,307,321,95.6
36310, 담양군,070004, 68세,2017,613,283,330,85.8,608,281,327,85.9
36310, 담양군,070005, 69세,2017,643,320,323,99.1,641,319,322,99.1
36310, 담양군,075,70~74세,2017,2827,1247,1580,78.9,2822,1244,1578,78.8
36310, 담양군,075001, 70세,2017,723,345,378,91.3,720,343,377,91
36310, 담양군,075002, 71세,2017,500,239,261,91.6,498,238,260,91.5
36310, 담양군,075003, 72세,2017,493,224,269,83.3,493,224,269,83.3
36310, 담양군,075004, 73세,2017,497,176,321,54.8,497,176,321,54.8
36310, 담양군,075005, 74세,2017,614,263,351,74.9,614,263,351,74.9
36310, 담양군,080,75~79세,2017,3353,1329,2024,65.7,3352,1328,2024,65.6
36310, 담양군,080001, 75세,2017,883,357,526,67.9,883,357,526,67.9
36310, 담양군,080002, 76세,2017,663,275,388,70.9,662,274,388,70.6
36310, 담양군,080003, 77세,2017,601,228,373,61.1,601,228,373,61.1
36310, 담양군,080004, 78세,2017,660,265,395,67.1,660,265,395,67.1
36310, 담양군,080005, 79세,2017,546,204,342,59.6,546,204,342,59.6
36310, 담양군,085,80~84세,2017,2058,683,1375,49.7,2057,682,1375,49.6
36310, 담양군,085001, 80세,2017,487,171,316,54.1,486,170,316,53.8
36310, 담양군,085002, 81세,2017,458,162,296,54.7,458,162,296,54.7
36310, 담양군,085003, 82세,2017,415,127,288,44.1,415,127,288,44.1
36310, 담양군,085004, 83세,2017,373,122,251,48.6,373,122,251,48.6
36310, 담양군,085005, 84세,2017,325,101,224,45.1,325,101,224,45.1
36310, 담양군,090,85~89세,2017,1017,283,734,38.6,1017,283,734,38.6
36310, 담양군,090001, 85세,2017,263,78,185,42.2,263,78,185,42.2
36310, 담양군,090002, 86세,2017,209,60,149,40.3,209,60,149,40.3
36310, 담양군,090003, 87세,2017,222,62,160,38.8,222,62,160,38.8
36310, 담양군,090004, 88세,2017,178,52,126,41.3,178,52,126,41.3
36310, 담양군,090005, 89세,2017,145,31,114,27.2,145,31,114,27.2
36310, 담양군,095,90~94세,2017,315,68,247,27.5,314,68,246,27.6
36310, 담양군,095001, 90세,2017,97,23,74,31.1,97,23,74,31.1
36310, 담양군,095002, 91세,2017,78,14,64,21.9,78,14,64,21.9
36310, 담양군,095003, 92세,2017,56,13,43,30.2,55,13,42,31
36310, 담양군,095004, 93세,2017,38,10,28,35.7,38,10,28,35.7
36310, 담양군,095005, 94세,2017,46,8,38,21.1,46,8,38,21.1
36310, 담양군,100,95~99세,2017,101,25,76,32.9,101,25,76,32.9
36310, 담양군,100001, 95세,2017,35,11,24,45.8,35,11,24,45.8
36310, 담양군,100002, 96세,2017,25,7,18,38.9,25,7,18,38.9
36310, 담양군,100003, 97세,2017,14,X,14,0,14,X,14,0
36310, 담양군,100004, 98세,2017,16,X,13,23.1,16,X,13,23.1
36310, 담양군,100005, 99세,2017,11,X,7,57.1,11,X,7,57.1
36310, 담양군,101,100세이상,2017,8,X,8,0,8,X,8,0
36310, 담양군,102,15세미만,2017,3788,1918,1870,102.6,3784,1915,1869,102.5
36310, 담양군,103,15~64세,2017,27191,14559,12632,115.3,25957,13897,12060,115.2
36310, 담양군,104,65세이상,2017,12802,5154,7648,67.4,12777,5140,7637,67.3
36310, 담양군,086,85세이상,2017,1441,376,1065,35.3,1440,376,1064,35.3
36310, 담양군,126,평균연령,2017,49.4,46.9,51.7,,49.8,47.4,52.2,
36310, 담양군,127,중위연령,2017,52.9,49.8,55.9,,53.6,50.6,56.5,
36320, 곡성군,000,합계,2017,28768,13927,14841,93.8,28260,13653,14607,93.5
36320, 곡성군,005,0~4세,2017,648,320,328,97.6,648,320,328,97.6
36320, 곡성군,005001, 0세,2017,113,55,58,94.8,113,55,58,94.8
36320, 곡성군,005002, 1세,2017,140,64,76,84.2,140,64,76,84.2
36320, 곡성군,005003, 2세,2017,138,61,77,79.2,138,61,77,79.2
36320, 곡성군,005004, 3세,2017,129,70,59,118.6,129,70,59,118.6
36320, 곡성군,005005, 4세,2017,128,70,58,120.7,128,70,58,120.7
36320, 곡성군,010,5~9세,2017,759,411,348,118.1,757,410,347,118.2
36320, 곡성군,010001, 5세,2017,150,85,65,130.8,149,85,64,132.8
36320, 곡성군,010002, 6세,2017,168,78,90,86.7,167,77,90,85.6
36320, 곡성군,010003, 7세,2017,137,67,70,95.7,137,67,70,95.7
36320, 곡성군,010004, 8세,2017,142,82,60,136.7,142,82,60,136.7
36320, 곡성군,010005, 9세,2017,162,99,63,157.1,162,99,63,157.1
36320, 곡성군,015,10~14세,2017,861,446,415,107.5,860,446,414,107.7
36320, 곡성군,015001, 10세,2017,162,76,86,88.4,161,76,85,89.4
36320, 곡성군,015002, 11세,2017,165,92,73,126,165,92,73,126
36320, 곡성군,015003, 12세,2017,167,87,80,108.8,167,87,80,108.8
36320, 곡성군,015004, 13세,2017,177,91,86,105.8,177,91,86,105.8
36320, 곡성군,015005, 14세,2017,190,100,90,111.1,190,100,90,111.1
36320, 곡성군,020,15~19세,2017,1908,979,929,105.4,1885,962,923,104.2
36320, 곡성군,020001, 15세,2017,226,103,123,83.7,226,103,123,83.7
36320, 곡성군,020002, 16세,2017,337,167,170,98.2,337,167,170,98.2
36320, 곡성군,020003, 17세,2017,422,180,242,74.4,422,180,242,74.4
36320, 곡성군,020004, 18세,2017,404,212,192,110.4,401,210,191,109.9
36320, 곡성군,020005, 19세,2017,519,317,202,156.9,499,302,197,153.3
36320, 곡성군,025,20~24세,2017,1882,1076,806,133.5,1789,1021,768,132.9
36320, 곡성군,025001, 20세,2017,562,317,245,129.4,543,311,232,134.1
36320, 곡성군,025002, 21세,2017,421,228,193,118.1,406,217,189,114.8
36320, 곡성군,025003, 22세,2017,351,205,146,140.4,334,194,140,138.6
36320, 곡성군,025004, 23세,2017,259,164,95,172.6,239,151,88,171.6
36320, 곡성군,025005, 24세,2017,289,162,127,127.6,267,148,119,124.4
36320, 곡성군,030,25~29세,2017,1118,618,500,123.6,997,544,453,120.1
36320, 곡성군,030001, 25세,2017,265,148,117,126.5,237,132,105,125.7
36320, 곡성군,030002, 26세,2017,247,131,116,112.9,230,120,110,109.1
36320, 곡성군,030003, 27세,2017,243,143,100,143,217,130,87,149.4
36320, 곡성군,030004, 28세,2017,172,90,82,109.8,149,75,74,101.4
36320, 곡성군,030005, 29세,2017,191,106,85,124.7,164,87,77,113
36320, 곡성군,035,30~34세,2017,920,495,425,116.5,864,465,399,116.5
36320, 곡성군,035001, 30세,2017,187,96,91,105.5,177,91,86,105.8
36320, 곡성군,035002, 31세,2017,155,81,74,109.5,139,73,66,110.6
36320, 곡성군,035003, 32세,2017,172,97,75,129.3,165,93,72,129.2
36320, 곡성군,035004, 33세,2017,191,95,96,99,181,91,90,101.1
36320, 곡성군,035005, 34세,2017,215,126,89,141.6,202,117,85,137.6
36320, 곡성군,040,35~39세,2017,1155,628,527,119.2,1111,602,509,118.3
36320, 곡성군,040001, 35세,2017,221,121,100,121,211,116,95,122.1
36320, 곡성군,040002, 36세,2017,236,131,105,124.8,225,124,101,122.8
36320, 곡성군,040003, 37세,2017,240,128,112,114.3,230,122,108,113
36320, 곡성군,040004, 38세,2017,228,112,116,96.6,220,107,113,94.7
36320, 곡성군,040005, 39세,2017,230,136,94,144.7,225,133,92,144.6
36320, 곡성군,045,40~44세,2017,1475,807,668,120.8,1434,787,647,121.6
36320, 곡성군,045001, 40세,2017,263,135,128,105.5,255,130,125,104
36320, 곡성군,045002, 41세,2017,272,155,117,132.5,260,149,111,134.2
36320, 곡성군,045003, 42세,2017,280,145,135,107.4,276,144,132,109.1
36320, 곡성군,045004, 43세,2017,339,182,157,115.9,330,178,152,117.1
36320, 곡성군,045005, 44세,2017,321,190,131,145,313,186,127,146.5
36320, 곡성군,050,45~49세,2017,1881,1040,841,123.7,1843,1027,816,125.9
36320, 곡성군,050001, 45세,2017,371,213,158,134.8,362,210,152,138.2
36320, 곡성군,050002, 46세,2017,362,183,179,102.2,357,182,175,104
36320, 곡성군,050003, 47세,2017,368,204,164,124.4,357,201,156,128.8
36320, 곡성군,050004, 48세,2017,392,226,166,136.1,385,222,163,136.2
36320, 곡성군,050005, 49세,2017,388,214,174,123,382,212,170,124.7
36320, 곡성군,055,50~54세,2017,2020,1106,914,121,1980,1087,893,121.7
36320, 곡성군,055001, 50세,2017,371,216,155,139.4,363,213,150,142
36320, 곡성군,055002, 51세,2017,419,227,192,118.2,410,222,188,118.1
36320, 곡성군,055003, 52세,2017,431,246,185,133,424,243,181,134.3
36320, 곡성군,055004, 53세,2017,386,199,187,106.4,379,196,183,107.1
36320, 곡성군,055005, 54세,2017,413,218,195,111.8,404,213,191,111.5
36320, 곡성군,060,55~59세,2017,2555,1330,1225,108.6,2536,1326,1210,109.6
36320, 곡성군,060001, 55세,2017,450,229,221,103.6,445,229,216,106
36320, 곡성군,060002, 56세,2017,524,268,256,104.7,520,266,254,104.7
36320, 곡성군,060003, 57세,2017,564,297,267,111.2,560,297,263,112.9
36320, 곡성군,060004, 58세,2017,530,263,267,98.5,525,261,264,98.9
36320, 곡성군,060005, 59세,2017,487,273,214,127.6,486,273,213,128.2
36320, 곡성군,065,60~64세,2017,2063,1049,1014,103.5,2046,1041,1005,103.6
36320, 곡성군,065001, 60세,2017,486,262,224,117,484,261,223,117
36320, 곡성군,065002, 61세,2017,379,191,188,101.6,375,189,186,101.6
36320, 곡성군,065003, 62세,2017,459,224,235,95.3,454,220,234,94
36320, 곡성군,065004, 63세,2017,389,187,202,92.6,384,186,198,93.9
36320, 곡성군,065005, 64세,2017,350,185,165,112.1,349,185,164,112.8
36320, 곡성군,070,65~69세,2017,2095,987,1108,89.1,2089,984,1105,89
36320, 곡성군,070001, 65세,2017,436,211,225,93.8,433,209,224,93.3
36320, 곡성군,070002, 66세,2017,392,177,215,82.3,392,177,215,82.3
36320, 곡성군,070003, 67세,2017,398,196,202,97,398,196,202,97
36320, 곡성군,070004, 68세,2017,425,209,216,96.8,423,208,215,96.7
36320, 곡성군,070005, 69세,2017,444,194,250,77.6,443,194,249,77.9
36320, 곡성군,075,70~74세,2017,1901,802,1099,73,1897,800,1097,72.9
36320, 곡성군,075001, 70세,2017,450,206,244,84.4,448,205,243,84.4
36320, 곡성군,075002, 71세,2017,367,159,208,76.4,367,159,208,76.4
36320, 곡성군,075003, 72세,2017,334,132,202,65.3,332,131,201,65.2
36320, 곡성군,075004, 73세,2017,350,143,207,69.1,350,143,207,69.1
36320, 곡성군,075005, 74세,2017,400,162,238,68.1,400,162,238,68.1
36320, 곡성군,080,75~79세,2017,2477,919,1558,59,2475,918,1557,59
36320, 곡성군,080001, 75세,2017,605,230,375,61.3,604,230,374,61.5
36320, 곡성군,080002, 76세,2017,493,181,312,58,492,180,312,57.7
36320, 곡성군,080003, 77세,2017,466,167,299,55.9,466,167,299,55.9
36320, 곡성군,080004, 78세,2017,473,176,297,59.3,473,176,297,59.3
36320, 곡성군,080005, 79세,2017,440,165,275,60,440,165,275,60
36320, 곡성군,085,80~84세,2017,1841,618,1223,50.5,1840,617,1223,50.4
36320, 곡성군,085001, 80세,2017,453,169,284,59.5,452,168,284,59.2
36320, 곡성군,085002, 81세,2017,393,122,271,45,393,122,271,45
36320, 곡성군,085003, 82세,2017,412,126,286,44.1,412,126,286,44.1
36320, 곡성군,085004, 83세,2017,333,128,205,62.4,333,128,205,62.4
36320, 곡성군,085005, 84세,2017,250,73,177,41.2,250,73,177,41.2
36320, 곡성군,090,85~89세,2017,875,219,656,33.4,875,219,656,33.4
36320, 곡성군,090001, 85세,2017,237,70,167,41.9,237,70,167,41.9
36320, 곡성군,090002, 86세,2017,198,43,155,27.7,198,43,155,27.7
36320, 곡성군,090003, 87세,2017,180,46,134,34.3,180,46,134,34.3
36320, 곡성군,090004, 88세,2017,131,40,91,44,131,40,91,44
36320, 곡성군,090005, 89세,2017,129,20,109,18.3,129,20,109,18.3
36320, 곡성군,095,90~94세,2017,278,70,208,33.7,278,70,208,33.7
36320, 곡성군,095001, 90세,2017,79,25,54,46.3,79,25,54,46.3
36320, 곡성군,095002, 91세,2017,83,18,65,27.7,83,18,65,27.7
36320, 곡성군,095003, 92세,2017,39,12,27,44.4,39,12,27,44.4
36320, 곡성군,095004, 93세,2017,31,8,23,34.8,31,8,23,34.8
36320, 곡성군,095005, 94세,2017,46,7,39,17.9,46,7,39,17.9
36320, 곡성군,100,95~99세,2017,48,6,42,14.3,48,6,42,14.3
36320, 곡성군,100001, 95세,2017,21,X,17,23.5,21,X,17,23.5
36320, 곡성군,100002, 96세,2017,11,X,10,10,11,X,10,10
36320, 곡성군,100003, 97세,2017,7,X,6,16.7,7,X,6,16.7
36320, 곡성군,100004, 98세,2017,X,X,X,0,X,X,X,0
36320, 곡성군,100005, 99세,2017,5,X,5,0,5,X,5,0
36320, 곡성군,101,100세이상,2017,8,X,7,14.3,8,X,7,14.3
36320, 곡성군,102,15세미만,2017,2268,1177,1091,107.9,2265,1176,1089,108
36320, 곡성군,103,15~64세,2017,16977,9128,7849,116.3,16485,8862,7623,116.3
36320, 곡성군,104,65세이상,2017,9523,3622,5901,61.4,9510,3615,5895,61.3
36320, 곡성군,086,85세이상,2017,1209,296,913,32.4,1209,296,913,32.4
36320, 곡성군,126,평균연령,2017,50.8,47.7,53.7,,51.1,48,54,
36320, 곡성군,127,중위연령,2017,54.4,50.7,57.9,,54.9,51.1,58.3,
36330, 구례군,000,합계,2017,24420,11767,12653,93,24121,11666,12455,93.7
36330, 구례군,005,0~4세,2017,654,337,317,106.3,654,337,317,106.3
36330, 구례군,005001, 0세,2017,118,64,54,118.5,118,64,54,118.5
36330, 구례군,005002, 1세,2017,126,60,66,90.9,126,60,66,90.9
36330, 구례군,005003, 2세,2017,129,62,67,92.5,129,62,67,92.5
36330, 구례군,005004, 3세,2017,117,68,49,138.8,117,68,49,138.8
36330, 구례군,005005, 4세,2017,164,83,81,102.5,164,83,81,102.5
36330, 구례군,010,5~9세,2017,769,401,368,109,769,401,368,109
36330, 구례군,010001, 5세,2017,153,69,84,82.1,153,69,84,82.1
36330, 구례군,010002, 6세,2017,171,83,88,94.3,171,83,88,94.3
36330, 구례군,010003, 7세,2017,138,76,62,122.6,138,76,62,122.6
36330, 구례군,010004, 8세,2017,147,81,66,122.7,147,81,66,122.7
36330, 구례군,010005, 9세,2017,160,92,68,135.3,160,92,68,135.3
36330, 구례군,015,10~14세,2017,837,436,401,108.7,836,435,401,108.5
36330, 구례군,015001, 10세,2017,170,85,85,100,170,85,85,100
36330, 구례군,015002, 11세,2017,156,79,77,102.6,156,79,77,102.6
36330, 구례군,015003, 12세,2017,164,86,78,110.3,164,86,78,110.3
36330, 구례군,015004, 13세,2017,166,92,74,124.3,165,91,74,123
36330, 구례군,015005, 14세,2017,181,94,87,108,181,94,87,108
36330, 구례군,020,15~19세,2017,903,468,435,107.6,899,468,431,108.6
36330, 구례군,020001, 15세,2017,175,90,85,105.9,175,90,85,105.9
36330, 구례군,020002, 16세,2017,193,94,99,94.9,193,94,99,94.9
36330, 구례군,020003, 17세,2017,216,105,111,94.6,216,105,111,94.6
36330, 구례군,020004, 18세,2017,197,113,84,134.5,196,113,83,136.1
36330, 구례군,020005, 19세,2017,122,66,56,117.9,119,66,53,124.5
36330, 구례군,025,20~24세,2017,933,564,369,152.8,891,544,347,156.8
36330, 구례군,025001, 20세,2017,163,113,50,226,160,110,50,220
36330, 구례군,025002, 21세,2017,204,134,70,191.4,199,132,67,197
36330, 구례군,025003, 22세,2017,201,125,76,164.5,187,116,71,163.4
36330, 구례군,025004, 23세,2017,182,99,83,119.3,176,96,80,120
36330, 구례군,025005, 24세,2017,183,93,90,103.3,169,90,79,113.9
36330, 구례군,030,25~29세,2017,804,402,402,100,749,386,363,106.3
36330, 구례군,030001, 25세,2017,164,82,82,100,158,77,81,95.1
36330, 구례군,030002, 26세,2017,165,70,95,73.7,154,67,87,77
36330, 구례군,030003, 27세,2017,171,92,79,116.5,151,88,63,139.7
36330, 구례군,030004, 28세,2017,156,84,72,116.7,148,81,67,120.9
36330, 구례군,030005, 29세,2017,148,74,74,100,138,73,65,112.3
36330, 구례군,035,30~34세,2017,863,447,416,107.5,815,437,378,115.6
36330, 구례군,035001, 30세,2017,162,92,70,131.4,151,88,63,139.7
36330, 구례군,035002, 31세,2017,164,73,91,80.2,153,69,84,82.1
36330, 구례군,035003, 32세,2017,159,82,77,106.5,152,82,70,117.1
36330, 구례군,035004, 33세,2017,168,87,81,107.4,158,85,73,116.4
36330, 구례군,035005, 34세,2017,210,113,97,116.5,201,113,88,128.4
36330, 구례군,040,35~39세,2017,1110,607,503,120.7,1088,601,487,123.4
36330, 구례군,040001, 35세,2017,232,128,104,123.1,225,126,99,127.3
36330, 구례군,040002, 36세,2017,209,126,83,151.8,208,126,82,153.7
36330, 구례군,040003, 37세,2017,224,122,102,119.6,217,119,98,121.4
36330, 구례군,040004, 38세,2017,218,109,109,100,214,108,106,101.9
36330, 구례군,040005, 39세,2017,227,122,105,116.2,224,122,102,119.6
36330, 구례군,045,40~44세,2017,1349,702,647,108.5,1327,696,631,110.3
36330, 구례군,045001, 40세,2017,224,115,109,105.5,220,113,107,105.6
36330, 구례군,045002, 41세,2017,247,112,135,83,241,112,129,86.8
36330, 구례군,045003, 42세,2017,248,128,120,106.7,247,128,119,107.6
36330, 구례군,045004, 43세,2017,305,172,133,129.3,298,170,128,132.8
36330, 구례군,045005, 44세,2017,325,175,150,116.7,321,173,148,116.9
36330, 구례군,050,45~49세,2017,1827,1034,793,130.4,1798,1024,774,132.3
36330, 구례군,050001, 45세,2017,299,163,136,119.9,293,161,132,122
36330, 구례군,050002, 46세,2017,360,219,141,155.3,355,216,139,155.4
36330, 구례군,050003, 47세,2017,365,206,159,129.6,360,203,157,129.3
36330, 구례군,050004, 48세,2017,420,229,191,119.9,414,228,186,122.6
36330, 구례군,050005, 49세,2017,383,217,166,130.7,376,216,160,135
36330, 구례군,055,50~54세,2017,1949,1055,894,118,1923,1046,877,119.3
36330, 구례군,055001, 50세,2017,387,214,173,123.7,383,214,169,126.6
36330, 구례군,055002, 51세,2017,393,216,177,122,386,214,172,124.4
36330, 구례군,055003, 52세,2017,412,219,193,113.5,406,217,189,114.8
36330, 구례군,055004, 53세,2017,376,200,176,113.6,372,197,175,112.6
36330, 구례군,055005, 54세,2017,381,206,175,117.7,376,204,172,118.6
36330, 구례군,060,55~59세,2017,2450,1243,1207,103,2425,1233,1192,103.4
36330, 구례군,060001, 55세,2017,459,245,214,114.5,452,243,209,116.3
36330, 구례군,060002, 56세,2017,508,258,250,103.2,504,258,246,104.9
36330, 구례군,060003, 57세,2017,548,285,263,108.4,541,279,262,106.5
36330, 구례군,060004, 58세,2017,493,245,248,98.8,490,244,246,99.2
36330, 구례군,060005, 59세,2017,442,210,232,90.5,438,209,229,91.3
36330, 구례군,065,60~64세,2017,1943,944,999,94.5,1928,936,992,94.4
36330, 구례군,065001, 60세,2017,418,213,205,103.9,411,209,202,103.5
36330, 구례군,065002, 61세,2017,372,176,196,89.8,368,174,194,89.7
36330, 구례군,065003, 62세,2017,431,229,202,113.4,430,229,201,113.9
36330, 구례군,065004, 63세,2017,401,181,220,82.3,398,179,219,81.7
36330, 구례군,065005, 64세,2017,321,145,176,82.4,321,145,176,82.4
36330, 구례군,070,65~69세,2017,1827,869,958,90.7,1821,867,954,90.9
36330, 구례군,070001, 65세,2017,394,198,196,101,394,198,196,101
36330, 구례군,070002, 66세,2017,363,168,195,86.2,361,167,194,86.1
36330, 구례군,070003, 67세,2017,366,178,188,94.7,364,178,186,95.7
36330, 구례군,070004, 68세,2017,362,160,202,79.2,361,160,201,79.6
36330, 구례군,070005, 69세,2017,342,165,177,93.2,341,164,177,92.7
36330, 구례군,075,70~74세,2017,1785,745,1040,71.6,1783,744,1039,71.6
36330, 구례군,075001, 70세,2017,409,176,233,75.5,408,175,233,75.1
36330, 구례군,075002, 71세,2017,351,157,194,80.9,351,157,194,80.9
36330, 구례군,075003, 72세,2017,314,131,183,71.6,314,131,183,71.6
36330, 구례군,075004, 73세,2017,350,147,203,72.4,350,147,203,72.4
36330, 구례군,075005, 74세,2017,361,134,227,59,360,134,226,59.3
36330, 구례군,080,75~79세,2017,2122,813,1309,62.1,2121,812,1309,62
36330, 구례군,080001, 75세,2017,528,198,330,60,528,198,330,60
36330, 구례군,080002, 76세,2017,439,179,260,68.8,438,178,260,68.5
36330, 구례군,080003, 77세,2017,397,135,262,51.5,397,135,262,51.5
36330, 구례군,080004, 78세,2017,414,160,254,63,414,160,254,63
36330, 구례군,080005, 79세,2017,344,141,203,69.5,344,141,203,69.5
36330, 구례군,085,80~84세,2017,1343,457,886,51.6,1342,456,886,51.5
36330, 구례군,085001, 80세,2017,346,126,220,57.3,346,126,220,57.3
36330, 구례군,085002, 81세,2017,288,106,182,58.2,288,106,182,58.2
36330, 구례군,085003, 82세,2017,278,94,184,51.1,277,93,184,50.5
36330, 구례군,085004, 83세,2017,245,77,168,45.8,245,77,168,45.8
36330, 구례군,085005, 84세,2017,186,54,132,40.9,186,54,132,40.9
36330, 구례군,090,85~89세,2017,708,194,514,37.7,708,194,514,37.7
36330, 구례군,090001, 85세,2017,188,64,124,51.6,188,64,124,51.6
36330, 구례군,090002, 86세,2017,130,40,90,44.4,130,40,90,44.4
36330, 구례군,090003, 87세,2017,189,46,143,32.2,189,46,143,32.2
36330, 구례군,090004, 88세,2017,103,19,84,22.6,103,19,84,22.6
36330, 구례군,090005, 89세,2017,98,25,73,34.2,98,25,73,34.2
36330, 구례군,095,90~94세,2017,197,43,154,27.9,197,43,154,27.9
36330, 구례군,095001, 90세,2017,73,16,57,28.1,73,16,57,28.1
36330, 구례군,095002, 91세,2017,43,8,35,22.9,43,8,35,22.9
36330, 구례군,095003, 92세,2017,40,11,29,37.9,40,11,29,37.9
36330, 구례군,095004, 93세,2017,19,5,14,35.7,19,5,14,35.7
36330, 구례군,095005, 94세,2017,22,X,19,15.8,22,X,19,15.8
36330, 구례군,100,95~99세,2017,40,5,35,14.3,40,5,35,14.3
36330, 구례군,100001, 95세,2017,18,X,17,5.9,18,X,17,5.9
36330, 구례군,100002, 96세,2017,7,X,X,75,7,X,X,75
36330, 구례군,100003, 97세,2017,13,X,12,8.3,13,X,12,8.3
36330, 구례군,100004, 98세,2017,X,X,X,0,X,X,X,0
36330, 구례군,100005, 99세,2017,X,X,X,,X,X,X,
36330, 구례군,101,100세이상,2017,7,X,6,16.7,7,X,6,16.7
36330, 구례군,102,15세미만,2017,2260,1174,1086,108.1,2259,1173,1086,108
36330, 구례군,103,15~64세,2017,14131,7466,6665,112,13843,7371,6472,113.9
36330, 구례군,104,65세이상,2017,8029,3127,4902,63.8,8019,3122,4897,63.8
36330, 구례군,086,85세이상,2017,952,243,709,34.3,952,243,709,34.3
36330, 구례군,126,평균연령,2017,51.9,49.1,54.5,,52,49.2,54.7,
36330, 구례군,127,중위연령,2017,55.5,52.3,58.2,,55.7,52.3,58.6,
36350, 고흥군,000,합계,2017,60984,29552,31432,94,59937,28872,31065,92.9
36350, 고흥군,005,0~4세,2017,1253,616,637,96.7,1253,616,637,96.7
36350, 고흥군,005001, 0세,2017,234,112,122,91.8,234,112,122,91.8
36350, 고흥군,005002, 1세,2017,258,120,138,87,258,120,138,87
36350, 고흥군,005003, 2세,2017,248,122,126,96.8,248,122,126,96.8
36350, 고흥군,005004, 3세,2017,238,116,122,95.1,238,116,122,95.1
36350, 고흥군,005005, 4세,2017,275,146,129,113.2,275,146,129,113.2
36350, 고흥군,010,5~9세,2017,1554,809,745,108.6,1553,808,745,108.5
36350, 고흥군,010001, 5세,2017,323,171,152,112.5,322,170,152,111.8
36350, 고흥군,010002, 6세,2017,316,162,154,105.2,316,162,154,105.2
36350, 고흥군,010003, 7세,2017,308,159,149,106.7,308,159,149,106.7
36350, 고흥군,010004, 8세,2017,300,159,141,112.8,300,159,141,112.8
36350, 고흥군,010005, 9세,2017,307,158,149,106,307,158,149,106
36350, 고흥군,015,10~14세,2017,1746,953,793,120.2,1745,952,793,120.1
36350, 고흥군,015001, 10세,2017,344,181,163,111,344,181,163,111
36350, 고흥군,015002, 11세,2017,336,183,153,119.6,336,183,153,119.6
36350, 고흥군,015003, 12세,2017,355,184,171,107.6,354,183,171,107
36350, 고흥군,015004, 13세,2017,336,190,146,130.1,336,190,146,130.1
36350, 고흥군,015005, 14세,2017,375,215,160,134.4,375,215,160,134.4
36350, 고흥군,020,15~19세,2017,2074,1122,952,117.9,2067,1119,948,118
36350, 고흥군,020001, 15세,2017,426,221,205,107.8,426,221,205,107.8
36350, 고흥군,020002, 16세,2017,441,237,204,116.2,441,237,204,116.2
36350, 고흥군,020003, 17세,2017,460,240,220,109.1,459,239,220,108.6
36350, 고흥군,020004, 18세,2017,436,234,202,115.8,434,234,200,117
36350, 고흥군,020005, 19세,2017,311,190,121,157,307,188,119,158
36350, 고흥군,025,20~24세,2017,2011,1275,736,173.2,1821,1139,682,167
36350, 고흥군,025001, 20세,2017,377,259,118,219.5,368,255,113,225.7
36350, 고흥군,025002, 21세,2017,426,308,118,261,402,290,112,258.9
36350, 고흥군,025003, 22세,2017,380,251,129,194.6,344,226,118,191.5
36350, 고흥군,025004, 23세,2017,413,233,180,129.4,363,196,167,117.4
36350, 고흥군,025005, 24세,2017,415,224,191,117.3,344,172,172,100
36350, 고흥군,030,25~29세,2017,1796,1003,793,126.5,1515,787,728,108.1
36350, 고흥군,030001, 25세,2017,395,224,171,131,318,159,159,100
36350, 고흥군,030002, 26세,2017,342,185,157,117.8,284,143,141,101.4
36350, 고흥군,030003, 27세,2017,362,198,164,120.7,309,154,155,99.4
36350, 고흥군,030004, 28세,2017,318,180,138,130.4,281,152,129,117.8
36350, 고흥군,030005, 29세,2017,379,216,163,132.5,323,179,144,124.3
36350, 고흥군,035,30~34세,2017,1818,987,831,118.8,1632,861,771,111.7
36350, 고흥군,035001, 30세,2017,370,200,170,117.6,324,166,158,105.1
36350, 고흥군,035002, 31세,2017,362,207,155,133.5,309,175,134,130.6
36350, 고흥군,035003, 32세,2017,328,181,147,123.1,293,159,134,118.7
36350, 고흥군,035004, 33세,2017,383,207,176,117.6,354,186,168,110.7
36350, 고흥군,035005, 34세,2017,375,192,183,104.9,352,175,177,98.9
36350, 고흥군,040,35~39세,2017,2327,1268,1059,119.7,2235,1217,1018,119.5
36350, 고흥군,040001, 35세,2017,456,270,186,145.2,433,254,179,141.9
36350, 고흥군,040002, 36세,2017,442,248,194,127.8,425,240,185,129.7
36350, 고흥군,040003, 37세,2017,482,235,247,95.1,458,222,236,94.1
36350, 고흥군,040004, 38세,2017,483,252,231,109.1,469,245,224,109.4
36350, 고흥군,040005, 39세,2017,464,263,201,130.8,450,256,194,132
36350, 고흥군,045,40~44세,2017,2920,1691,1229,137.6,2844,1645,1199,137.2
36350, 고흥군,045001, 40세,2017,522,286,236,121.2,504,275,229,120.1
36350, 고흥군,045002, 41세,2017,548,322,226,142.5,536,314,222,141.4
36350, 고흥군,045003, 42세,2017,520,291,229,127.1,498,278,220,126.4
36350, 고흥군,045004, 43세,2017,671,385,286,134.6,662,381,281,135.6
36350, 고흥군,045005, 44세,2017,659,407,252,161.5,644,397,247,160.7
36350, 고흥군,050,45~49세,2017,3773,2201,1572,140,3715,2179,1536,141.9
36350, 고흥군,050001, 45세,2017,657,381,276,138,649,377,272,138.6
36350, 고흥군,050002, 46세,2017,726,430,296,145.3,713,428,285,150.2
36350, 고흥군,050003, 47세,2017,754,426,328,129.9,750,425,325,130.8
36350, 고흥군,050004, 48세,2017,747,445,302,147.4,732,442,290,152.4
36350, 고흥군,050005, 49세,2017,889,519,370,140.3,871,507,364,139.3
36350, 고흥군,055,50~54세,2017,4351,2354,1997,117.9,4292,2330,1962,118.8
36350, 고흥군,055001, 50세,2017,754,407,347,117.3,742,403,339,118.9
36350, 고흥군,055002, 51세,2017,829,465,364,127.7,817,459,358,128.2
36350, 고흥군,055003, 52세,2017,899,474,425,111.5,887,469,418,112.2
36350, 고흥군,055004, 53세,2017,862,452,410,110.2,851,448,403,111.2
36350, 고흥군,055005, 54세,2017,1007,556,451,123.3,995,551,444,124.1
36350, 고흥군,060,55~59세,2017,5952,3026,2926,103.4,5913,3007,2906,103.5
36350, 고흥군,060001, 55세,2017,1036,559,477,117.2,1024,553,471,117.4
36350, 고흥군,060002, 56세,2017,1188,591,597,99,1179,586,593,98.8
36350, 고흥군,060003, 57세,2017,1254,632,622,101.6,1248,628,620,101.3
36350, 고흥군,060004, 58세,2017,1300,661,639,103.4,1293,658,635,103.6
36350, 고흥군,060005, 59세,2017,1174,583,591,98.6,1169,582,587,99.1
36350, 고흥군,065,60~64세,2017,5413,2655,2758,96.3,5380,2634,2746,95.9
36350, 고흥군,065001, 60세,2017,1143,564,579,97.4,1135,559,576,97
36350, 고흥군,065002, 61세,2017,1018,506,512,98.8,1009,501,508,98.6
36350, 고흥군,065003, 62세,2017,1226,611,615,99.3,1219,608,611,99.5
36350, 고흥군,065004, 63세,2017,1067,518,549,94.4,1060,512,548,93.4
36350, 고흥군,065005, 64세,2017,959,456,503,90.7,957,454,503,90.3
36350, 고흥군,070,65~69세,2017,5691,2751,2940,93.6,5674,2742,2932,93.5
36350, 고흥군,070001, 65세,2017,1133,550,583,94.3,1127,548,579,94.6
36350, 고흥군,070002, 66세,2017,1139,564,575,98.1,1137,564,573,98.4
36350, 고흥군,070003, 67세,2017,1155,539,616,87.5,1150,535,615,87
36350, 고흥군,070004, 68세,2017,1148,549,599,91.7,1145,546,599,91.2
36350, 고흥군,070005, 69세,2017,1116,549,567,96.8,1115,549,566,97
36350, 고흥군,075,70~74세,2017,5211,2287,2924,78.2,5209,2285,2924,78.1
36350, 고흥군,075001, 70세,2017,1310,610,700,87.1,1309,609,700,87
36350, 고흥군,075002, 71세,2017,861,382,479,79.7,860,381,479,79.5
36350, 고흥군,075003, 72세,2017,991,407,584,69.7,991,407,584,69.7
36350, 고흥군,075004, 73세,2017,936,409,527,77.6,936,409,527,77.6
36350, 고흥군,075005, 74세,2017,1113,479,634,75.6,1113,479,634,75.6
36350, 고흥군,080,75~79세,2017,5965,2354,3611,65.2,5963,2353,3610,65.2
36350, 고흥군,080001, 75세,2017,1442,636,806,78.9,1440,635,805,78.9
36350, 고흥군,080002, 76세,2017,1240,509,731,69.6,1240,509,731,69.6
36350, 고흥군,080003, 77세,2017,1199,453,746,60.7,1199,453,746,60.7
36350, 고흥군,080004, 78세,2017,1146,418,728,57.4,1146,418,728,57.4
36350, 고흥군,080005, 79세,2017,938,338,600,56.3,938,338,600,56.3
36350, 고흥군,085,80~84세,2017,4157,1431,2726,52.5,4154,1429,2725,52.4
36350, 고흥군,085001, 80세,2017,1028,376,652,57.7,1026,375,651,57.6
36350, 고흥군,085002, 81세,2017,897,335,562,59.6,896,334,562,59.4
36350, 고흥군,085003, 82세,2017,780,276,504,54.8,780,276,504,54.8
36350, 고흥군,085004, 83세,2017,750,227,523,43.4,750,227,523,43.4
36350, 고흥군,085005, 84세,2017,702,217,485,44.7,702,217,485,44.7
36350, 고흥군,090,85~89세,2017,2193,625,1568,39.9,2193,625,1568,39.9
36350, 고흥군,090001, 85세,2017,625,183,442,41.4,625,183,442,41.4
36350, 고흥군,090002, 86세,2017,439,115,324,35.5,439,115,324,35.5
36350, 고흥군,090003, 87세,2017,484,134,350,38.3,484,134,350,38.3
36350, 고흥군,090004, 88세,2017,418,127,291,43.6,418,127,291,43.6
36350, 고흥군,090005, 89세,2017,227,66,161,41,227,66,161,41
36350, 고흥군,095,90~94세,2017,604,116,488,23.8,604,116,488,23.8
36350, 고흥군,095001, 90세,2017,174,36,138,26.1,174,36,138,26.1
36350, 고흥군,095002, 91세,2017,134,28,106,26.4,134,28,106,26.4
36350, 고흥군,095003, 92세,2017,109,24,85,28.2,109,24,85,28.2
36350, 고흥군,095004, 93세,2017,81,15,66,22.7,81,15,66,22.7
36350, 고흥군,095005, 94세,2017,106,13,93,14,106,13,93,14
36350, 고흥군,100,95~99세,2017,162,27,135,20,162,27,135,20
36350, 고흥군,100001, 95세,2017,63,18,45,40,63,18,45,40
36350, 고흥군,100002, 96세,2017,38,X,34,11.8,38,X,34,11.8
36350, 고흥군,100003, 97세,2017,27,X,26,3.8,27,X,26,3.8
36350, 고흥군,100004, 98세,2017,20,X,18,11.1,20,X,18,11.1
36350, 고흥군,100005, 99세,2017,14,X,12,16.7,14,X,12,16.7
36350, 고흥군,101,100세이상,2017,13,X,12,8.3,13,X,12,8.3
36350, 고흥군,102,15세미만,2017,4553,2378,2175,109.3,4551,2376,2175,109.2
36350, 고흥군,103,15~64세,2017,32435,17582,14853,118.4,31414,16918,14496,116.7
36350, 고흥군,104,65세이상,2017,23996,9592,14404,66.6,23972,9578,14394,66.5
36350, 고흥군,086,85세이상,2017,2972,769,2203,34.9,2972,769,2203,34.9
36350, 고흥군,126,평균연령,2017,55,51.9,58,,55.4,52.3,58.2,
36350, 고흥군,127,중위연령,2017,59.1,55.9,62.6,,59.5,56.4,62.9,
36360, 보성군,000,합계,2017,39942,19109,20833,91.7,39374,18879,20495,92.1
36360, 보성군,005,0~4세,2017,1208,617,591,104.4,1207,617,590,104.6
36360, 보성군,005001, 0세,2017,231,118,113,104.4,231,118,113,104.4
36360, 보성군,005002, 1세,2017,256,117,139,84.2,255,117,138,84.8
36360, 보성군,005003, 2세,2017,253,131,122,107.4,253,131,122,107.4
36360, 보성군,005004, 3세,2017,234,128,106,120.8,234,128,106,120.8
36360, 보성군,005005, 4세,2017,234,123,111,110.8,234,123,111,110.8
36360, 보성군,010,5~9세,2017,1108,551,557,98.9,1107,550,557,98.7
36360, 보성군,010001, 5세,2017,235,134,101,132.7,234,133,101,131.7
36360, 보성군,010002, 6세,2017,263,134,129,103.9,263,134,129,103.9
36360, 보성군,010003, 7세,2017,204,97,107,90.7,204,97,107,90.7
36360, 보성군,010004, 8세,2017,202,90,112,80.4,202,90,112,80.4
36360, 보성군,010005, 9세,2017,204,96,108,88.9,204,96,108,88.9
36360, 보성군,015,10~14세,2017,1272,676,596,113.4,1271,676,595,113.6
36360, 보성군,015001, 10세,2017,258,136,122,111.5,257,136,121,112.4
36360, 보성군,015002, 11세,2017,228,120,108,111.1,228,120,108,111.1
36360, 보성군,015003, 12세,2017,229,120,109,110.1,229,120,109,110.1
36360, 보성군,015004, 13세,2017,273,146,127,115,273,146,127,115
36360, 보성군,015005, 14세,2017,284,154,130,118.5,284,154,130,118.5
36360, 보성군,020,15~19세,2017,1847,970,877,110.6,1833,969,864,112.2
36360, 보성군,020001, 15세,2017,342,171,171,100,341,171,170,100.6
36360, 보성군,020002, 16세,2017,424,217,207,104.8,423,217,206,105.3
36360, 보성군,020003, 17세,2017,472,237,235,100.9,468,237,231,102.6
36360, 보성군,020004, 18세,2017,351,193,158,122.2,346,193,153,126.1
36360, 보성군,020005, 19세,2017,258,152,106,143.4,255,151,104,145.2
36360, 보성군,025,20~24세,2017,1465,920,545,168.8,1383,877,506,173.3
36360, 보성군,025001, 20세,2017,317,201,116,173.3,313,199,114,174.6
36360, 보성군,025002, 21세,2017,336,231,105,220,330,228,102,223.5
36360, 보성군,025003, 22세,2017,271,175,96,182.3,253,167,86,194.2
36360, 보성군,025004, 23세,2017,297,174,123,141.5,272,160,112,142.9
36360, 보성군,025005, 24세,2017,244,139,105,132.4,215,123,92,133.7
36360, 보성군,030,25~29세,2017,1278,660,618,106.8,1129,593,536,110.6
36360, 보성군,030001, 25세,2017,283,138,145,95.2,245,123,122,100.8
36360, 보성군,030002, 26세,2017,242,126,116,108.6,217,114,103,110.7
36360, 보성군,030003, 27세,2017,277,151,126,119.8,241,132,109,121.1
36360, 보성군,030004, 28세,2017,235,127,108,117.6,207,112,95,117.9
36360, 보성군,030005, 29세,2017,241,118,123,95.9,219,112,107,104.7
36360, 보성군,035,30~34세,2017,1356,659,697,94.5,1271,628,643,97.7
36360, 보성군,035001, 30세,2017,288,128,160,80,263,122,141,86.5
36360, 보성군,035002, 31세,2017,277,143,134,106.7,259,134,125,107.2
36360, 보성군,035003, 32세,2017,230,107,123,87,216,102,114,89.5
36360, 보성군,035004, 33세,2017,263,130,133,97.7,250,126,124,101.6
36360, 보성군,035005, 34세,2017,298,151,147,102.7,283,144,139,103.6
36360, 보성군,040,35~39세,2017,1643,856,787,108.8,1588,839,749,112
36360, 보성군,040001, 35세,2017,362,173,189,91.5,345,167,178,93.8
36360, 보성군,040002, 36세,2017,298,163,135,120.7,284,159,125,127.2
36360, 보성군,040003, 37세,2017,345,177,168,105.4,338,175,163,107.4
36360, 보성군,040004, 38세,2017,306,161,145,111,299,160,139,115.1
36360, 보성군,040005, 39세,2017,332,182,150,121.3,322,178,144,123.6
36360, 보성군,045,40~44세,2017,1857,1071,786,136.3,1824,1058,766,138.1
36360, 보성군,045001, 40세,2017,373,201,172,116.9,366,198,168,117.9
36360, 보성군,045002, 41세,2017,339,188,151,124.5,333,187,146,128.1
36360, 보성군,045003, 42세,2017,274,159,115,138.3,269,156,113,138.1
36360, 보성군,045004, 43세,2017,439,250,189,132.3,430,247,183,135
36360, 보성군,045005, 44세,2017,432,273,159,171.7,426,270,156,173.1
36360, 보성군,050,45~49세,2017,2570,1448,1122,129.1,2528,1429,1099,130
36360, 보성군,050001, 45세,2017,452,252,200,126,442,248,194,127.8
36360, 보성군,050002, 46세,2017,497,276,221,124.9,490,274,216,126.9
36360, 보성군,050003, 47세,2017,521,296,225,131.6,514,292,222,131.5
36360, 보성군,050004, 48세,2017,517,292,225,129.8,506,284,222,127.9
36360, 보성군,050005, 49세,2017,583,332,251,132.3,576,331,245,135.1
36360, 보성군,055,50~54세,2017,2879,1574,1305,120.6,2828,1554,1274,122
36360, 보성군,055001, 50세,2017,530,292,238,122.7,518,287,231,124.2
36360, 보성군,055002, 51세,2017,551,327,224,146,543,322,221,145.7
36360, 보성군,055003, 52세,2017,555,288,267,107.9,545,285,260,109.6
36360, 보성군,055004, 53세,2017,596,332,264,125.8,586,328,258,127.1
36360, 보성군,055005, 54세,2017,647,335,312,107.4,636,332,304,109.2
36360, 보성군,060,55~59세,2017,3577,1814,1763,102.9,3557,1806,1751,103.1
36360, 보성군,060001, 55세,2017,653,337,316,106.6,651,336,315,106.7
36360, 보성군,060002, 56세,2017,679,347,332,104.5,673,345,328,105.2
36360, 보성군,060003, 57세,2017,733,358,375,95.5,727,356,371,96
36360, 보성군,060004, 58세,2017,798,410,388,105.7,795,409,386,106
36360, 보성군,060005, 59세,2017,714,362,352,102.8,711,360,351,102.6
36360, 보성군,065,60~64세,2017,3313,1626,1687,96.4,3289,1620,1669,97.1
36360, 보성군,065001, 60세,2017,757,385,372,103.5,750,382,368,103.8
36360, 보성군,065002, 61세,2017,641,326,315,103.5,634,324,310,104.5
36360, 보성군,065003, 62세,2017,731,367,364,100.8,726,366,360,101.7
36360, 보성군,065004, 63세,2017,616,287,329,87.2,614,287,327,87.8
36360, 보성군,065005, 64세,2017,568,261,307,85,565,261,304,85.9
36360, 보성군,070,65~69세,2017,3315,1574,1741,90.4,3310,1572,1738,90.4
36360, 보성군,070001, 65세,2017,677,322,355,90.7,677,322,355,90.7
36360, 보성군,070002, 66세,2017,648,311,337,92.3,646,310,336,92.3
36360, 보성군,070003, 67세,2017,657,302,355,85.1,655,302,353,85.6
36360, 보성군,070004, 68세,2017,664,308,356,86.5,663,307,356,86.2
36360, 보성군,070005, 69세,2017,669,331,338,97.9,669,331,338,97.9
36360, 보성군,075,70~74세,2017,2994,1300,1694,76.7,2991,1298,1693,76.7
36360, 보성군,075001, 70세,2017,715,334,381,87.7,712,332,380,87.4
36360, 보성군,075002, 71세,2017,506,243,263,92.4,506,243,263,92.4
36360, 보성군,075003, 72세,2017,549,234,315,74.3,549,234,315,74.3
36360, 보성군,075004, 73세,2017,516,221,295,74.9,516,221,295,74.9
36360, 보성군,075005, 74세,2017,708,268,440,60.9,708,268,440,60.9
36360, 보성군,080,75~79세,2017,3736,1444,2292,63,3734,1444,2290,63.1
36360, 보성군,080001, 75세,2017,885,351,534,65.7,884,351,533,65.9
36360, 보성군,080002, 76세,2017,748,295,453,65.1,748,295,453,65.1
36360, 보성군,080003, 77세,2017,692,261,431,60.6,692,261,431,60.6
36360, 보성군,080004, 78세,2017,732,290,442,65.6,732,290,442,65.6
36360, 보성군,080005, 79세,2017,679,247,432,57.2,678,247,431,57.3
36360, 보성군,085,80~84세,2017,2615,872,1743,50,2615,872,1743,50
36360, 보성군,085001, 80세,2017,631,221,410,53.9,631,221,410,53.9
36360, 보성군,085002, 81세,2017,555,191,364,52.5,555,191,364,52.5
36360, 보성군,085003, 82세,2017,535,176,359,49,535,176,359,49
36360, 보성군,085004, 83세,2017,491,149,342,43.6,491,149,342,43.6
36360, 보성군,085005, 84세,2017,403,135,268,50.4,403,135,268,50.4
36360, 보성군,090,85~89세,2017,1409,360,1049,34.3,1409,360,1049,34.3
36360, 보성군,090001, 85세,2017,398,108,290,37.2,398,108,290,37.2
36360, 보성군,090002, 86세,2017,299,80,219,36.5,299,80,219,36.5
36360, 보성군,090003, 87세,2017,317,78,239,32.6,317,78,239,32.6
36360, 보성군,090004, 88세,2017,206,53,153,34.6,206,53,153,34.6
36360, 보성군,090005, 89세,2017,189,41,148,27.7,189,41,148,27.7
36360, 보성군,095,90~94세,2017,393,95,298,31.9,393,95,298,31.9
36360, 보성군,095001, 90세,2017,124,34,90,37.8,124,34,90,37.8
36360, 보성군,095002, 91세,2017,96,24,72,33.3,96,24,72,33.3
36360, 보성군,095003, 92세,2017,62,14,48,29.2,62,14,48,29.2
36360, 보성군,095004, 93세,2017,53,14,39,35.9,53,14,39,35.9
36360, 보성군,095005, 94세,2017,58,9,49,18.4,58,9,49,18.4
36360, 보성군,100,95~99세,2017,85,19,66,28.8,85,19,66,28.8
36360, 보성군,100001, 95세,2017,39,6,33,18.2,39,6,33,18.2
36360, 보성군,100002, 96세,2017,16,6,10,60,16,6,10,60
36360, 보성군,100003, 97세,2017,15,X,12,25,15,X,12,25
36360, 보성군,100004, 98세,2017,6,X,5,20,6,X,5,20
36360, 보성군,100005, 99세,2017,9,X,6,50,9,X,6,50
36360, 보성군,101,100세이상,2017,22,X,19,15.8,22,X,19,15.8
36360, 보성군,102,15세미만,2017,3588,1844,1744,105.7,3585,1843,1742,105.8
36360, 보성군,103,15~64세,2017,21785,11598,10187,113.9,21230,11373,9857,115.4
36360, 보성군,104,65세이상,2017,14569,5667,8902,63.7,14559,5663,8896,63.7
36360, 보성군,086,85세이상,2017,1909,477,1432,33.3,1909,477,1432,33.3
36360, 보성군,126,평균연령,2017,52.9,49.8,55.7,,53.1,50,56,
36360, 보성군,127,중위연령,2017,57.2,53.7,60.5,,57.5,53.9,60.9,
36370, 화순군,000,합계,2017,60566,29246,31320,93.4,59422,28713,30709,93.5
36370, 화순군,005,0~4세,2017,1798,905,893,101.3,1791,901,890,101.2
36370, 화순군,005001, 0세,2017,320,162,158,102.5,317,160,157,101.9
36370, 화순군,005002, 1세,2017,315,156,159,98.1,314,156,158,98.7
36370, 화순군,005003, 2세,2017,372,183,189,96.8,370,181,189,95.8
36370, 화순군,005004, 3세,2017,383,184,199,92.5,382,184,198,92.9
36370, 화순군,005005, 4세,2017,408,220,188,117,408,220,188,117
36370, 화순군,010,5~9세,2017,2339,1197,1142,104.8,2334,1194,1140,104.7
36370, 화순군,010001, 5세,2017,457,222,235,94.5,456,221,235,94
36370, 화순군,010002, 6세,2017,476,239,237,100.8,474,239,235,101.7
36370, 화순군,010003, 7세,2017,450,235,215,109.3,449,234,215,108.8
36370, 화순군,010004, 8세,2017,481,251,230,109.1,481,251,230,109.1
36370, 화순군,010005, 9세,2017,475,250,225,111.1,474,249,225,110.7
36370, 화순군,015,10~14세,2017,2723,1429,1294,110.4,2720,1427,1293,110.4
36370, 화순군,015001, 10세,2017,551,276,275,100.4,550,276,274,100.7
36370, 화순군,015002, 11세,2017,493,260,233,111.6,493,260,233,111.6
36370, 화순군,015003, 12세,2017,496,265,231,114.7,495,264,231,114.3
36370, 화순군,015004, 13세,2017,611,326,285,114.4,610,325,285,114
36370, 화순군,015005, 14세,2017,572,302,270,111.9,572,302,270,111.9
36370, 화순군,020,15~19세,2017,3662,1895,1767,107.2,3654,1892,1762,107.4
36370, 화순군,020001, 15세,2017,635,296,339,87.3,633,294,339,86.7
36370, 화순군,020002, 16세,2017,807,381,426,89.4,806,381,425,89.6
36370, 화순군,020003, 17세,2017,903,500,403,124.1,902,500,402,124.4
36370, 화순군,020004, 18세,2017,788,406,382,106.3,788,406,382,106.3
36370, 화순군,020005, 19세,2017,529,312,217,143.8,525,311,214,145.3
36370, 화순군,025,20~24세,2017,3280,1789,1491,120,3060,1670,1390,120.1
36370, 화순군,025001, 20세,2017,692,414,278,148.9,676,406,270,150.4
36370, 화순군,025002, 21세,2017,692,404,288,140.3,657,383,274,139.8
36370, 화순군,025003, 22세,2017,631,327,304,107.6,581,296,285,103.9
36370, 화순군,025004, 23세,2017,627,322,305,105.6,581,302,279,108.2
36370, 화순군,025005, 24세,2017,638,322,316,101.9,565,283,282,100.4
36370, 화순군,030,25~29세,2017,2613,1366,1247,109.5,2382,1251,1131,110.6
36370, 화순군,030001, 25세,2017,614,319,295,108.1,567,296,271,109.2
36370, 화순군,030002, 26세,2017,545,281,264,106.4,496,253,243,104.1
36370, 화순군,030003, 27세,2017,528,283,245,115.5,479,262,217,120.7
36370, 화순군,030004, 28세,2017,470,254,216,117.6,430,236,194,121.6
36370, 화순군,030005, 29세,2017,456,229,227,100.9,410,204,206,99
36370, 화순군,035,30~34세,2017,2375,1222,1153,106,2216,1150,1066,107.9
36370, 화순군,035001, 30세,2017,428,208,220,94.5,384,187,197,94.9
36370, 화순군,035002, 31세,2017,443,218,225,96.9,407,205,202,101.5
36370, 화순군,035003, 32세,2017,449,248,201,123.4,415,232,183,126.8
36370, 화순군,035004, 33세,2017,490,254,236,107.6,467,247,220,112.3
36370, 화순군,035005, 34세,2017,565,294,271,108.5,543,279,264,105.7
36370, 화순군,040,35~39세,2017,3223,1587,1636,97,3098,1525,1573,96.9
36370, 화순군,040001, 35세,2017,615,304,311,97.7,578,286,292,97.9
36370, 화순군,040002, 36세,2017,627,314,313,100.3,604,299,305,98
36370, 화순군,040003, 37세,2017,638,323,315,102.5,614,312,302,103.3
36370, 화순군,040004, 38세,2017,692,334,358,93.3,674,324,350,92.6
36370, 화순군,040005, 39세,2017,651,312,339,92,628,304,324,93.8
36370, 화순군,045,40~44세,2017,3938,1983,1955,101.4,3864,1949,1915,101.8
36370, 화순군,045001, 40세,2017,682,348,334,104.2,672,343,329,104.3
36370, 화순군,045002, 41세,2017,672,341,331,103,653,336,317,106
36370, 화순군,045003, 42세,2017,757,386,371,104,739,379,360,105.3
36370, 화순군,045004, 43세,2017,933,484,449,107.8,917,475,442,107.5
36370, 화순군,045005, 44세,2017,894,424,470,90.2,883,416,467,89.1
36370, 화순군,050,45~49세,2017,5166,2747,2419,113.6,5087,2716,2371,114.6
36370, 화순군,050001, 45세,2017,922,472,450,104.9,907,464,443,104.7
36370, 화순군,050002, 46세,2017,1058,574,484,118.6,1045,568,477,119.1
36370, 화순군,050003, 47세,2017,1100,591,509,116.1,1080,585,495,118.2
36370, 화순군,050004, 48세,2017,1032,530,502,105.6,1018,526,492,106.9
36370, 화순군,050005, 49세,2017,1054,580,474,122.4,1037,573,464,123.5
36370, 화순군,055,50~54세,2017,5018,2687,2331,115.3,4932,2663,2269,117.4
36370, 화순군,055001, 50세,2017,1014,524,490,106.9,997,518,479,108.1
36370, 화순군,055002, 51세,2017,1010,554,456,121.5,993,548,445,123.1
36370, 화순군,055003, 52세,2017,971,533,438,121.7,960,529,431,122.7
36370, 화순군,055004, 53세,2017,979,520,459,113.3,955,518,437,118.5
36370, 화순군,055005, 54세,2017,1044,556,488,113.9,1027,550,477,115.3
36370, 화순군,060,55~59세,2017,5195,2685,2510,107,5128,2660,2468,107.8
36370, 화순군,060001, 55세,2017,980,490,490,100,970,487,483,100.8
36370, 화순군,060002, 56세,2017,1102,599,503,119.1,1087,593,494,120
36370, 화순군,060003, 57세,2017,1132,578,554,104.3,1117,570,547,104.2
36370, 화순군,060004, 58세,2017,1041,550,491,112,1029,546,483,113
36370, 화순군,060005, 59세,2017,940,468,472,99.2,925,464,461,100.7
36370, 화순군,065,60~64세,2017,3945,1978,1967,100.6,3900,1956,1944,100.6
36370, 화순군,065001, 60세,2017,961,480,481,99.8,947,475,472,100.6
36370, 화순군,065002, 61세,2017,749,386,363,106.3,739,380,359,105.8
36370, 화순군,065003, 62세,2017,847,435,412,105.6,836,428,408,104.9
36370, 화순군,065004, 63세,2017,714,346,368,94,707,344,363,94.8
36370, 화순군,065005, 64세,2017,674,331,343,96.5,671,329,342,96.2
36370, 화순군,070,65~69세,2017,3610,1681,1929,87.1,3591,1673,1918,87.2
36370, 화순군,070001, 65세,2017,794,372,422,88.2,787,370,417,88.7
36370, 화순군,070002, 66세,2017,636,301,335,89.9,633,300,333,90.1
36370, 화순군,070003, 67세,2017,700,333,367,90.7,696,331,365,90.7
36370, 화순군,070004, 68세,2017,728,344,384,89.6,726,343,383,89.6
36370, 화순군,070005, 69세,2017,752,331,421,78.6,749,329,420,78.3
36370, 화순군,075,70~74세,2017,3403,1372,2031,67.6,3398,1368,2030,67.4
36370, 화순군,075001, 70세,2017,796,346,450,76.9,795,346,449,77.1
36370, 화순군,075002, 71세,2017,578,245,333,73.6,578,245,333,73.6
36370, 화순군,075003, 72세,2017,656,245,411,59.6,653,242,411,58.9
36370, 화순군,075004, 73세,2017,629,245,384,63.8,629,245,384,63.8
36370, 화순군,075005, 74세,2017,744,291,453,64.2,743,290,453,64
36370, 화순군,080,75~79세,2017,3993,1440,2553,56.4,3984,1437,2547,56.4
36370, 화순군,080001, 75세,2017,1019,388,631,61.5,1018,387,631,61.3
36370, 화순군,080002, 76세,2017,821,305,516,59.1,816,305,511,59.7
36370, 화순군,080003, 77세,2017,738,259,479,54.1,738,259,479,54.1
36370, 화순군,080004, 78세,2017,726,257,469,54.8,726,257,469,54.8
36370, 화순군,080005, 79세,2017,689,231,458,50.4,686,229,457,50.1
36370, 화순군,085,80~84세,2017,2581,822,1759,46.7,2580,821,1759,46.7
36370, 화순군,085001, 80세,2017,647,227,420,54,647,227,420,54
36370, 화순군,085002, 81세,2017,579,190,389,48.8,579,190,389,48.8
36370, 화순군,085003, 82세,2017,535,162,373,43.4,535,162,373,43.4
36370, 화순군,085004, 83세,2017,457,140,317,44.2,456,139,317,43.8
36370, 화순군,085005, 84세,2017,363,103,260,39.6,363,103,260,39.6
36370, 화순군,090,85~89세,2017,1228,343,885,38.8,1228,343,885,38.8
36370, 화순군,090001, 85세,2017,339,92,247,37.2,339,92,247,37.2
36370, 화순군,090002, 86세,2017,261,74,187,39.6,261,74,187,39.6
36370, 화순군,090003, 87세,2017,290,70,220,31.8,290,70,220,31.8
36370, 화순군,090004, 88세,2017,189,60,129,46.5,189,60,129,46.5
36370, 화순군,090005, 89세,2017,149,47,102,46.1,149,47,102,46.1
36370, 화순군,095,90~94세,2017,390,103,287,35.9,389,102,287,35.5
36370, 화순군,095001, 90세,2017,123,35,88,39.8,123,35,88,39.8
36370, 화순군,095002, 91세,2017,100,26,74,35.1,100,26,74,35.1
36370, 화순군,095003, 92세,2017,58,15,43,34.9,58,15,43,34.9
36370, 화순군,095004, 93세,2017,52,17,35,48.6,51,16,35,45.7
36370, 화순군,095005, 94세,2017,57,10,47,21.3,57,10,47,21.3
36370, 화순군,100,95~99세,2017,77,15,62,24.2,77,15,62,24.2
36370, 화순군,100001, 95세,2017,24,X,20,20,24,X,20,20
36370, 화순군,100002, 96세,2017,24,7,17,41.2,24,7,17,41.2
36370, 화순군,100003, 97세,2017,11,X,8,37.5,11,X,8,37.5
36370, 화순군,100004, 98세,2017,10,X,9,11.1,10,X,9,11.1
36370, 화순군,100005, 99세,2017,8,X,8,0,8,X,8,0
36370, 화순군,101,100세이상,2017,9,X,9,0,9,X,9,0
36370, 화순군,102,15세미만,2017,6860,3531,3329,106.1,6845,3522,3323,106
36370, 화순군,103,15~64세,2017,38415,19939,18476,107.9,37321,19432,17889,108.6
36370, 화순군,104,65세이상,2017,15291,5776,9515,60.7,15256,5759,9497,60.6
36370, 화순군,086,85세이상,2017,1704,461,1243,37.1,1703,460,1243,37
36370, 화순군,126,평균연령,2017,47,44.6,49.2,,47.2,44.8,49.5,
36370, 화순군,127,중위연령,2017,49.2,47.3,51.4,,49.5,47.6,51.8,
36380, 장흥군,000,합계,2017,36275,17657,18618,94.8,35624,17376,18248,95.2
36380, 장흥군,005,0~4세,2017,1012,521,491,106.1,1011,521,490,106.3
36380, 장흥군,005001, 0세,2017,155,91,64,142.2,154,91,63,144.4
36380, 장흥군,005002, 1세,2017,182,101,81,124.7,182,101,81,124.7
36380, 장흥군,005003, 2세,2017,218,108,110,98.2,218,108,110,98.2
36380, 장흥군,005004, 3세,2017,212,98,114,86,212,98,114,86
36380, 장흥군,005005, 4세,2017,245,123,122,100.8,245,123,122,100.8
36380, 장흥군,010,5~9세,2017,1117,569,548,103.8,1116,569,547,104
36380, 장흥군,010001, 5세,2017,232,124,108,114.8,232,124,108,114.8
36380, 장흥군,010002, 6세,2017,227,124,103,120.4,227,124,103,120.4
36380, 장흥군,010003, 7세,2017,205,106,99,107.1,205,106,99,107.1
36380, 장흥군,010004, 8세,2017,220,107,113,94.7,220,107,113,94.7
36380, 장흥군,010005, 9세,2017,233,108,125,86.4,232,108,124,87.1
36380, 장흥군,015,10~14세,2017,1268,686,582,117.9,1267,685,582,117.7
36380, 장흥군,015001, 10세,2017,239,131,108,121.3,239,131,108,121.3
36380, 장흥군,015002, 11세,2017,233,131,102,128.4,233,131,102,128.4
36380, 장흥군,015003, 12세,2017,225,125,100,125,225,125,100,125
36380, 장흥군,015004, 13세,2017,277,155,122,127,277,155,122,127
36380, 장흥군,015005, 14세,2017,294,144,150,96,293,143,150,95.3
36380, 장흥군,020,15~19세,2017,1590,844,746,113.1,1582,842,740,113.8
36380, 장흥군,020001, 15세,2017,293,145,148,98,292,145,147,98.6
36380, 장흥군,020002, 16세,2017,334,167,167,100,333,166,167,99.4
36380, 장흥군,020003, 17세,2017,386,217,169,128.4,385,217,168,129.2
36380, 장흥군,020004, 18세,2017,329,163,166,98.2,327,163,164,99.4
36380, 장흥군,020005, 19세,2017,248,152,96,158.3,245,151,94,160.6
36380, 장흥군,025,20~24세,2017,1478,921,557,165.4,1392,873,519,168.2
36380, 장흥군,025001, 20세,2017,310,211,99,213.1,306,209,97,215.5
36380, 장흥군,025002, 21세,2017,319,224,95,235.8,307,216,91,237.4
36380, 장흥군,025003, 22세,2017,301,180,121,148.8,281,171,110,155.5
36380, 장흥군,025004, 23세,2017,288,174,114,152.6,268,164,104,157.7
36380, 장흥군,025005, 24세,2017,260,132,128,103.1,230,113,117,96.6
36380, 장흥군,030,25~29세,2017,1325,675,650,103.8,1187,609,578,105.4
36380, 장흥군,030001, 25세,2017,258,127,131,96.9,243,121,122,99.2
36380, 장흥군,030002, 26세,2017,258,141,117,120.5,241,127,114,111.4
36380, 장흥군,030003, 27세,2017,273,132,141,93.6,232,114,118,96.6
36380, 장흥군,030004, 28세,2017,269,139,130,106.9,236,125,111,112.6
36380, 장흥군,030005, 29세,2017,267,136,131,103.8,235,122,113,108
36380, 장흥군,035,30~34세,2017,1328,692,636,108.8,1228,643,585,109.9
36380, 장흥군,035001, 30세,2017,246,121,125,96.8,231,113,118,95.8
36380, 장흥군,035002, 31세,2017,261,139,122,113.9,239,124,115,107.8
36380, 장흥군,035003, 32세,2017,245,119,126,94.4,224,109,115,94.8
36380, 장흥군,035004, 33세,2017,271,142,129,110.1,250,133,117,113.7
36380, 장흥군,035005, 34세,2017,305,171,134,127.6,284,164,120,136.7
36380, 장흥군,040,35~39세,2017,1685,913,772,118.3,1604,883,721,122.5
36380, 장흥군,040001, 35세,2017,349,195,154,126.6,329,188,141,133.3
36380, 장흥군,040002, 36세,2017,338,186,152,122.4,321,176,145,121.4
36380, 장흥군,040003, 37세,2017,376,208,168,123.8,357,200,157,127.4
36380, 장흥군,040004, 38세,2017,327,177,150,118,312,175,137,127.7
36380, 장흥군,040005, 39세,2017,295,147,148,99.3,285,144,141,102.1
36380, 장흥군,045,40~44세,2017,1912,1056,856,123.4,1860,1040,820,126.8
36380, 장흥군,045001, 40세,2017,341,196,145,135.2,331,193,138,139.9
36380, 장흥군,045002, 41세,2017,352,201,151,133.1,342,196,146,134.2
36380, 장흥군,045003, 42세,2017,360,195,165,118.2,346,192,154,124.7
36380, 장흥군,045004, 43세,2017,416,231,185,124.9,404,229,175,130.9
36380, 장흥군,045005, 44세,2017,443,233,210,111,437,230,207,111.1
36380, 장흥군,050,45~49세,2017,2562,1404,1158,121.2,2506,1388,1118,124.2
36380, 장흥군,050001, 45세,2017,451,240,211,113.7,440,238,202,117.8
36380, 장흥군,050002, 46세,2017,539,291,248,117.3,524,286,238,120.2
36380, 장흥군,050003, 47세,2017,504,292,212,137.7,493,288,205,140.5
36380, 장흥군,050004, 48세,2017,544,296,248,119.4,534,293,241,121.6
36380, 장흥군,050005, 49세,2017,524,285,239,119.2,515,283,232,122
36380, 장흥군,055,50~54세,2017,2847,1534,1313,116.8,2799,1518,1281,118.5
36380, 장흥군,055001, 50세,2017,534,292,242,120.7,525,288,237,121.5
36380, 장흥군,055002, 51세,2017,568,306,262,116.8,561,306,255,120
36380, 장흥군,055003, 52세,2017,581,311,270,115.2,574,308,266,115.8
36380, 장흥군,055004, 53세,2017,543,294,249,118.1,534,290,244,118.9
36380, 장흥군,055005, 54세,2017,621,331,290,114.1,605,326,279,116.8
36380, 장흥군,060,55~59세,2017,3470,1748,1722,101.5,3429,1732,1697,102.1
36380, 장흥군,060001, 55세,2017,624,321,303,105.9,619,320,299,107
36380, 장흥군,060002, 56세,2017,689,339,350,96.9,681,334,347,96.3
36380, 장흥군,060003, 57세,2017,756,390,366,106.6,742,385,357,107.8
36380, 장흥군,060004, 58세,2017,723,364,359,101.4,717,362,355,102
36380, 장흥군,060005, 59세,2017,678,334,344,97.1,670,331,339,97.6
36380, 장흥군,065,60~64세,2017,2941,1437,1504,95.5,2918,1423,1495,95.2
36380, 장흥군,065001, 60세,2017,667,339,328,103.4,662,335,327,102.4
36380, 장흥군,065002, 61세,2017,614,304,310,98.1,609,302,307,98.4
36380, 장흥군,065003, 62세,2017,622,310,312,99.4,618,306,312,98.1
36380, 장흥군,065004, 63세,2017,542,249,293,85,537,247,290,85.2
36380, 장흥군,065005, 64세,2017,496,235,261,90,492,233,259,90
36380, 장흥군,070,65~69세,2017,2714,1326,1388,95.5,2701,1319,1382,95.4
36380, 장흥군,070001, 65세,2017,558,289,269,107.4,555,288,267,107.9
36380, 장흥군,070002, 66세,2017,508,270,238,113.4,505,268,237,113.1
36380, 장흥군,070003, 67세,2017,551,261,290,90,549,261,288,90.6
36380, 장흥군,070004, 68세,2017,523,242,281,86.1,519,239,280,85.4
36380, 장흥군,070005, 69세,2017,574,264,310,85.2,573,263,310,84.8
36380, 장흥군,075,70~74세,2017,2497,1099,1398,78.6,2497,1099,1398,78.6
36380, 장흥군,075001, 70세,2017,603,278,325,85.5,603,278,325,85.5
36380, 장흥군,075002, 71세,2017,456,194,262,74,456,194,262,74
36380, 장흥군,075003, 72세,2017,466,208,258,80.6,466,208,258,80.6
36380, 장흥군,075004, 73세,2017,462,221,241,91.7,462,221,241,91.7
36380, 장흥군,075005, 74세,2017,510,198,312,63.5,510,198,312,63.5
36380, 장흥군,080,75~79세,2017,3020,1198,1822,65.8,3019,1198,1821,65.8
36380, 장흥군,080001, 75세,2017,712,288,424,67.9,712,288,424,67.9
36380, 장흥군,080002, 76세,2017,600,260,340,76.5,600,260,340,76.5
36380, 장흥군,080003, 77세,2017,589,226,363,62.3,589,226,363,62.3
36380, 장흥군,080004, 78세,2017,586,217,369,58.8,585,217,368,59
36380, 장흥군,080005, 79세,2017,533,207,326,63.5,533,207,326,63.5
36380, 장흥군,085,80~84세,2017,2095,682,1413,48.3,2094,682,1412,48.3
36380, 장흥군,085001, 80세,2017,456,159,297,53.5,456,159,297,53.5
36380, 장흥군,085002, 81세,2017,472,155,317,48.9,472,155,317,48.9
36380, 장흥군,085003, 82세,2017,456,154,302,51,455,154,301,51.2
36380, 장흥군,085004, 83세,2017,399,118,281,42,399,118,281,42
36380, 장흥군,085005, 84세,2017,312,96,216,44.4,312,96,216,44.4
36380, 장흥군,090,85~89세,2017,1083,280,803,34.9,1083,280,803,34.9
36380, 장흥군,090001, 85세,2017,298,92,206,44.7,298,92,206,44.7
36380, 장흥군,090002, 86세,2017,235,56,179,31.3,235,56,179,31.3
36380, 장흥군,090003, 87세,2017,217,49,168,29.2,217,49,168,29.2
36380, 장흥군,090004, 88세,2017,206,54,152,35.5,206,54,152,35.5
36380, 장흥군,090005, 89세,2017,127,29,98,29.6,127,29,98,29.6
36380, 장흥군,095,90~94세,2017,261,61,200,30.5,261,61,200,30.5
36380, 장흥군,095001, 90세,2017,81,22,59,37.3,81,22,59,37.3
36380, 장흥군,095002, 91세,2017,55,14,41,34.1,55,14,41,34.1
36380, 장흥군,095003, 92세,2017,40,7,33,21.2,40,7,33,21.2
36380, 장흥군,095004, 93세,2017,33,7,26,26.9,33,7,26,26.9
36380, 장흥군,095005, 94세,2017,52,11,41,26.8,52,11,41,26.8
36380, 장흥군,100,95~99세,2017,61,11,50,22,61,11,50,22
36380, 장흥군,100001, 95세,2017,26,7,19,36.8,26,7,19,36.8
36380, 장흥군,100002, 96세,2017,15,X,13,15.4,15,X,13,15.4
36380, 장흥군,100003, 97세,2017,8,X,7,14.3,8,X,7,14.3
36380, 장흥군,100004, 98세,2017,9,X,9,0,9,X,9,0
36380, 장흥군,100005, 99세,2017,X,X,X,50,X,X,X,50
36380, 장흥군,101,100세이상,2017,9,X,9,0,9,X,9,0
36380, 장흥군,102,15세미만,2017,3397,1776,1621,109.6,3394,1775,1619,109.6
36380, 장흥군,103,15~64세,2017,21138,11224,9914,113.2,20505,10951,9554,114.6
36380, 장흥군,104,65세이상,2017,11740,4657,7083,65.7,11725,4650,7075,65.7
36380, 장흥군,086,85세이상,2017,1414,352,1062,33.1,1414,352,1062,33.1
36380, 장흥군,126,평균연령,2017,51.3,48.5,54,,51.6,48.7,54.4,
36380, 장흥군,127,중위연령,2017,55,51.8,57.9,,55.4,52.1,58.4,
36390, 강진군,000,합계,2017,33637,16212,17425,93,33106,15966,17140,93.2
36390, 강진군,005,0~4세,2017,1112,561,551,101.8,1112,561,551,101.8
36390, 강진군,005001, 0세,2017,210,101,109,92.7,210,101,109,92.7
36390, 강진군,005002, 1세,2017,224,115,109,105.5,224,115,109,105.5
36390, 강진군,005003, 2세,2017,233,113,120,94.2,233,113,120,94.2
36390, 강진군,005004, 3세,2017,224,105,119,88.2,224,105,119,88.2
36390, 강진군,005005, 4세,2017,221,127,94,135.1,221,127,94,135.1
36390, 강진군,010,5~9세,2017,1095,558,537,103.9,1092,558,534,104.5
36390, 강진군,010001, 5세,2017,221,104,117,88.9,221,104,117,88.9
36390, 강진군,010002, 6세,2017,246,134,112,119.6,245,134,111,120.7
36390, 강진군,010003, 7세,2017,191,102,89,114.6,191,102,89,114.6
36390, 강진군,010004, 8세,2017,194,95,99,96,193,95,98,96.9
36390, 강진군,010005, 9세,2017,243,123,120,102.5,242,123,119,103.4
36390, 강진군,015,10~14세,2017,1191,619,572,108.2,1188,617,571,108.1
36390, 강진군,015001, 10세,2017,234,118,116,101.7,232,116,116,100
36390, 강진군,015002, 11세,2017,210,106,104,101.9,210,106,104,101.9
36390, 강진군,015003, 12세,2017,207,118,89,132.6,207,118,89,132.6
36390, 강진군,015004, 13세,2017,258,136,122,111.5,257,136,121,112.4
36390, 강진군,015005, 14세,2017,282,141,141,100,282,141,141,100
36390, 강진군,020,15~19세,2017,1561,864,697,124,1556,864,692,124.9
36390, 강진군,020001, 15세,2017,279,151,128,118,279,151,128,118
36390, 강진군,020002, 16세,2017,373,207,166,124.7,373,207,166,124.7
36390, 강진군,020003, 17세,2017,397,221,176,125.6,397,221,176,125.6
36390, 강진군,020004, 18세,2017,310,174,136,127.9,309,174,135,128.9
36390, 강진군,020005, 19세,2017,202,111,91,122,198,111,87,127.6
36390, 강진군,025,20~24세,2017,1327,821,506,162.3,1266,784,482,162.7
36390, 강진군,025001, 20세,2017,296,202,94,214.9,294,200,94,212.8
36390, 강진군,025002, 21세,2017,255,172,83,207.2,248,168,80,210
36390, 강진군,025003, 22세,2017,271,183,88,208,254,171,83,206
36390, 강진군,025004, 23세,2017,275,144,131,109.9,256,132,124,106.5
36390, 강진군,025005, 24세,2017,230,120,110,109.1,214,113,101,111.9
36390, 강진군,030,25~29세,2017,1267,663,604,109.8,1154,607,547,111
36390, 강진군,030001, 25세,2017,263,138,125,110.4,243,127,116,109.5
36390, 강진군,030002, 26세,2017,242,128,114,112.3,218,117,101,115.8
36390, 강진군,030003, 27세,2017,261,140,121,115.7,247,134,113,118.6
36390, 강진군,030004, 28세,2017,231,117,114,102.6,204,104,100,104
36390, 강진군,030005, 29세,2017,270,140,130,107.7,242,125,117,106.8
36390, 강진군,035,30~34세,2017,1282,639,643,99.4,1186,595,591,100.7
36390, 강진군,035001, 30세,2017,220,110,110,100,193,100,93,107.5
36390, 강진군,035002, 31세,2017,285,139,146,95.2,259,124,135,91.9
36390, 강진군,035003, 32세,2017,244,132,112,117.9,233,127,106,119.8
36390, 강진군,035004, 33세,2017,242,121,121,100,222,112,110,101.8
36390, 강진군,035005, 34세,2017,291,137,154,89,279,132,147,89.8
36390, 강진군,040,35~39세,2017,1464,749,715,104.8,1409,718,691,103.9
36390, 강진군,040001, 35세,2017,324,159,165,96.4,304,147,157,93.6
36390, 강진군,040002, 36세,2017,288,150,138,108.7,277,144,133,108.3
36390, 강진군,040003, 37세,2017,304,158,146,108.2,298,156,142,109.9
36390, 강진군,040004, 38세,2017,285,148,137,108,272,139,133,104.5
36390, 강진군,040005, 39세,2017,263,134,129,103.9,258,132,126,104.8
36390, 강진군,045,40~44세,2017,1699,932,767,121.5,1667,922,745,123.8
36390, 강진군,045001, 40세,2017,315,168,147,114.3,309,167,142,117.6
36390, 강진군,045002, 41세,2017,316,175,141,124.1,309,174,135,128.9
36390, 강진군,045003, 42세,2017,338,176,162,108.6,332,174,158,110.1
36390, 강진군,045004, 43세,2017,339,194,145,133.8,334,193,141,136.9
36390, 강진군,045005, 44세,2017,391,219,172,127.3,383,214,169,126.6
36390, 강진군,050,45~49세,2017,2249,1247,1002,124.5,2205,1231,974,126.4
36390, 강진군,050001, 45세,2017,441,250,191,130.9,432,243,189,128.6
36390, 강진군,050002, 46세,2017,478,286,192,149,468,283,185,153
36390, 강진군,050003, 47세,2017,413,225,188,119.7,405,225,180,125
36390, 강진군,050004, 48세,2017,442,224,218,102.8,435,221,214,103.3
36390, 강진군,050005, 49세,2017,475,262,213,123,465,259,206,125.7
36390, 강진군,055,50~54세,2017,2532,1344,1188,113.1,2485,1327,1158,114.6
36390, 강진군,055001, 50세,2017,432,245,187,131,424,243,181,134.3
36390, 강진군,055002, 51세,2017,491,273,218,125.2,480,270,210,128.6
36390, 강진군,055003, 52세,2017,537,293,244,120.1,525,289,236,122.5
36390, 강진군,055004, 53세,2017,518,261,257,101.6,511,258,253,102
36390, 강진군,055005, 54세,2017,554,272,282,96.5,545,267,278,96
36390, 강진군,060,55~59세,2017,3236,1644,1592,103.3,3203,1630,1573,103.6
36390, 강진군,060001, 55세,2017,588,311,277,112.3,584,310,274,113.1
36390, 강진군,060002, 56세,2017,625,314,311,101,619,310,309,100.3
36390, 강진군,060003, 57세,2017,697,339,358,94.7,686,335,351,95.4
36390, 강진군,060004, 58세,2017,704,363,341,106.5,702,363,339,107.1
36390, 강진군,060005, 59세,2017,622,317,305,103.9,612,312,300,104
36390, 강진군,065,60~64세,2017,2646,1308,1338,97.8,2626,1297,1329,97.6
36390, 강진군,065001, 60세,2017,621,305,316,96.5,617,301,316,95.3
36390, 강진군,065002, 61세,2017,539,267,272,98.2,532,264,268,98.5
36390, 강진군,065003, 62세,2017,556,270,286,94.4,550,267,283,94.3
36390, 강진군,065004, 63세,2017,469,232,237,97.9,468,231,237,97.5
36390, 강진군,065005, 64세,2017,461,234,227,103.1,459,234,225,104
36390, 강진군,070,65~69세,2017,2651,1249,1402,89.1,2638,1243,1395,89.1
36390, 강진군,070001, 65세,2017,547,246,301,81.7,546,245,301,81.4
36390, 강진군,070002, 66세,2017,471,218,253,86.2,465,217,248,87.5
36390, 강진군,070003, 67세,2017,541,260,281,92.5,536,257,279,92.1
36390, 강진군,070004, 68세,2017,531,268,263,101.9,530,267,263,101.5
36390, 강진군,070005, 69세,2017,561,257,304,84.5,561,257,304,84.5
36390, 강진군,075,70~74세,2017,2384,1035,1349,76.7,2381,1034,1347,76.8
36390, 강진군,075001, 70세,2017,548,243,305,79.7,547,243,304,79.9
36390, 강진군,075002, 71세,2017,451,189,262,72.1,450,189,261,72.4
36390, 강진군,075003, 72세,2017,478,197,281,70.1,478,197,281,70.1
36390, 강진군,075004, 73세,2017,433,197,236,83.5,433,197,236,83.5
36390, 강진군,075005, 74세,2017,474,209,265,78.9,473,208,265,78.5
36390, 강진군,080,75~79세,2017,2864,1095,1769,61.9,2861,1094,1767,61.9
36390, 강진군,080001, 75세,2017,663,259,404,64.1,663,259,404,64.1
36390, 강진군,080002, 76세,2017,547,219,328,66.8,546,219,327,67
36390, 강진군,080003, 77세,2017,585,210,375,56,585,210,375,56
36390, 강진군,080004, 78세,2017,539,205,334,61.4,537,204,333,61.3
36390, 강진군,080005, 79세,2017,530,202,328,61.6,530,202,328,61.6
36390, 강진군,085,80~84세,2017,1816,591,1225,48.2,1816,591,1225,48.2
36390, 강진군,085001, 80세,2017,456,162,294,55.1,456,162,294,55.1
36390, 강진군,085002, 81세,2017,382,129,253,51,382,129,253,51
36390, 강진군,085003, 82세,2017,387,137,250,54.8,387,137,250,54.8
36390, 강진군,085004, 83세,2017,318,85,233,36.5,318,85,233,36.5
36390, 강진군,085005, 84세,2017,273,78,195,40,273,78,195,40
36390, 강진군,090,85~89세,2017,959,220,739,29.8,959,220,739,29.8
36390, 강진군,090001, 85세,2017,249,64,185,34.6,249,64,185,34.6
36390, 강진군,090002, 86세,2017,237,57,180,31.7,237,57,180,31.7
36390, 강진군,090003, 87세,2017,218,43,175,24.6,218,43,175,24.6
36390, 강진군,090004, 88세,2017,137,33,104,31.7,137,33,104,31.7
36390, 강진군,090005, 89세,2017,118,23,95,24.2,118,23,95,24.2
36390, 강진군,095,90~94세,2017,243,57,186,30.6,243,57,186,30.6
36390, 강진군,095001, 90세,2017,88,17,71,23.9,88,17,71,23.9
36390, 강진군,095002, 91세,2017,46,13,33,39.4,46,13,33,39.4
36390, 강진군,095003, 92세,2017,45,20,25,80,45,20,25,80
36390, 강진군,095004, 93세,2017,39,X,36,8.3,39,X,36,8.3
36390, 강진군,095005, 94세,2017,25,X,21,19,25,X,21,19
36390, 강진군,100,95~99세,2017,54,16,38,42.1,54,16,38,42.1
36390, 강진군,100001, 95세,2017,22,6,16,37.5,22,6,16,37.5
36390, 강진군,100002, 96세,2017,17,5,12,41.7,17,5,12,41.7
36390, 강진군,100003, 97세,2017,9,X,6,50,9,X,6,50
36390, 강진군,100004, 98세,2017,X,X,X,100,X,X,X,100
36390, 강진군,100005, 99세,2017,X,X,X,0,X,X,X,0
36390, 강진군,101,100세이상,2017,5,X,5,0,5,X,5,0
36390, 강진군,102,15세미만,2017,3398,1738,1660,104.7,3392,1736,1656,104.8
36390, 강진군,103,15~64세,2017,19263,10211,9052,112.8,18757,9975,8782,113.6
36390, 강진군,104,65세이상,2017,10976,4263,6713,63.5,10957,4255,6702,63.5
36390, 강진군,086,85세이상,2017,1261,293,968,30.3,1261,293,968,30.3
36390, 강진군,126,평균연령,2017,50.9,48,53.6,,51.1,48.2,53.9,
36390, 강진군,127,중위연령,2017,55.1,51.8,58,,55.4,52,58.3,
36400, 해남군,000,합계,2017,67123,33016,34107,96.8,65480,32023,33457,95.7
36400, 해남군,005,0~4세,2017,2721,1334,1387,96.2,2720,1333,1387,96.1
36400, 해남군,005001, 0세,2017,624,331,293,113,624,331,293,113
36400, 해남군,005002, 1세,2017,606,297,309,96.1,606,297,309,96.1
36400, 해남군,005003, 2세,2017,546,269,277,97.1,545,268,277,96.8
36400, 해남군,005004, 3세,2017,473,228,245,93.1,473,228,245,93.1
36400, 해남군,005005, 4세,2017,472,209,263,79.5,472,209,263,79.5
36400, 해남군,010,5~9세,2017,2258,1126,1132,99.5,2256,1125,1131,99.5
36400, 해남군,010001, 5세,2017,497,229,268,85.4,496,228,268,85.1
36400, 해남군,010002, 6세,2017,469,237,232,102.2,468,237,231,102.6
36400, 해남군,010003, 7세,2017,386,204,182,112.1,386,204,182,112.1
36400, 해남군,010004, 8세,2017,419,222,197,112.7,419,222,197,112.7
36400, 해남군,010005, 9세,2017,487,234,253,92.5,487,234,253,92.5
36400, 해남군,015,10~14세,2017,2302,1184,1118,105.9,2301,1184,1117,106
36400, 해남군,015001, 10세,2017,428,211,217,97.2,428,211,217,97.2
36400, 해남군,015002, 11세,2017,476,249,227,109.7,476,249,227,109.7
36400, 해남군,015003, 12세,2017,419,210,209,100.5,419,210,209,100.5
36400, 해남군,015004, 13세,2017,479,267,212,125.9,479,267,212,125.9
36400, 해남군,015005, 14세,2017,500,247,253,97.6,499,247,252,98
36400, 해남군,020,15~19세,2017,2729,1523,1206,126.3,2718,1519,1199,126.7
36400, 해남군,020001, 15세,2017,508,267,241,110.8,508,267,241,110.8
36400, 해남군,020002, 16세,2017,591,332,259,128.2,588,331,257,128.8
36400, 해남군,020003, 17세,2017,670,377,293,128.7,669,376,293,128.3
36400, 해남군,020004, 18세,2017,574,308,266,115.8,573,308,265,116.2
36400, 해남군,020005, 19세,2017,386,239,147,162.6,380,237,143,165.7
36400, 해남군,025,20~24세,2017,2540,1548,992,156,2344,1425,919,155.1
36400, 해남군,025001, 20세,2017,509,331,178,186,494,321,173,185.5
36400, 해남군,025002, 21세,2017,537,375,162,231.5,512,358,154,232.5
36400, 해남군,025003, 22세,2017,530,343,187,183.4,488,313,175,178.9
36400, 해남군,025004, 23세,2017,462,250,212,117.9,410,222,188,118.1
36400, 해남군,025005, 24세,2017,502,249,253,98.4,440,211,229,92.1
36400, 해남군,030,25~29세,2017,2508,1345,1163,115.6,2088,1065,1023,104.1
36400, 해남군,030001, 25세,2017,510,270,240,112.5,427,216,211,102.4
36400, 해남군,030002, 26세,2017,510,278,232,119.8,432,226,206,109.7
36400, 해남군,030003, 27세,2017,503,274,229,119.7,414,220,194,113.4
36400, 해남군,030004, 28세,2017,486,262,224,117,407,204,203,100.5
36400, 해남군,030005, 29세,2017,499,261,238,109.7,408,199,209,95.2
36400, 해남군,035,30~34세,2017,2900,1468,1432,102.5,2584,1252,1332,94
36400, 해남군,035001, 30세,2017,548,277,271,102.2,481,232,249,93.2
36400, 해남군,035002, 31세,2017,557,282,275,102.5,492,243,249,97.6
36400, 해남군,035003, 32세,2017,532,281,251,112,461,228,233,97.9
36400, 해남군,035004, 33세,2017,629,306,323,94.7,575,269,306,87.9
36400, 해남군,035005, 34세,2017,634,322,312,103.2,575,280,295,94.9
36400, 해남군,040,35~39세,2017,3438,1747,1691,103.3,3237,1617,1620,99.8
36400, 해남군,040001, 35세,2017,744,369,375,98.4,693,331,362,91.4
36400, 해남군,040002, 36세,2017,670,326,344,94.8,623,298,325,91.7
36400, 해남군,040003, 37세,2017,688,341,347,98.3,653,323,330,97.9
36400, 해남군,040004, 38세,2017,684,353,331,106.6,648,329,319,103.1
36400, 해남군,040005, 39세,2017,652,358,294,121.8,620,336,284,118.3
36400, 해남군,045,40~44세,2017,3804,2125,1679,126.6,3709,2071,1638,126.4
36400, 해남군,045001, 40세,2017,701,374,327,114.4,677,357,320,111.6
36400, 해남군,045002, 41세,2017,753,435,318,136.8,731,421,310,135.8
36400, 해남군,045003, 42세,2017,711,400,311,128.6,696,394,302,130.5
36400, 해남군,045004, 43세,2017,770,446,324,137.7,751,438,313,139.9
36400, 해남군,045005, 44세,2017,869,470,399,117.8,854,461,393,117.3
36400, 해남군,050,45~49세,2017,4656,2621,2035,128.8,4530,2566,1964,130.7
36400, 해남군,050001, 45세,2017,845,474,371,127.8,823,465,358,129.9
36400, 해남군,050002, 46세,2017,965,572,393,145.5,941,563,378,148.9
36400, 해남군,050003, 47세,2017,902,506,396,127.8,874,495,379,130.6
36400, 해남군,050004, 48세,2017,938,514,424,121.2,911,501,410,122.2
36400, 해남군,050005, 49세,2017,1006,555,451,123.1,981,542,439,123.5
36400, 해남군,055,50~54세,2017,5286,2910,2376,122.5,5173,2857,2316,123.4
36400, 해남군,055001, 50세,2017,1007,549,458,119.9,990,542,448,121
36400, 해남군,055002, 51세,2017,1050,589,461,127.8,1033,579,454,127.5
36400, 해남군,055003, 52세,2017,1052,608,444,136.9,1019,590,429,137.5
36400, 해남군,055004, 53세,2017,1067,553,514,107.6,1050,548,502,109.2
36400, 해남군,055005, 54세,2017,1110,611,499,122.4,1081,598,483,123.8
36400, 해남군,060,55~59세,2017,6303,3269,3034,107.7,6226,3229,2997,107.7
36400, 해남군,060001, 55세,2017,1100,575,525,109.5,1081,564,517,109.1
36400, 해남군,060002, 56세,2017,1246,630,616,102.3,1229,624,605,103.1
36400, 해남군,060003, 57세,2017,1366,754,612,123.2,1353,746,607,122.9
36400, 해남군,060004, 58세,2017,1353,667,686,97.2,1342,659,683,96.5
36400, 해남군,060005, 59세,2017,1238,643,595,108.1,1221,636,585,108.7
36400, 해남군,065,60~64세,2017,5364,2643,2721,97.1,5314,2624,2690,97.5
36400, 해남군,065001, 60세,2017,1244,639,605,105.6,1231,634,597,106.2
36400, 해남군,065002, 61세,2017,1140,571,569,100.4,1122,565,557,101.4
36400, 해남군,065003, 62세,2017,1099,551,548,100.5,1090,544,546,99.6
36400, 해남군,065004, 63세,2017,961,462,499,92.6,956,462,494,93.5
36400, 해남군,065005, 64세,2017,920,420,500,84,915,419,496,84.5
36400, 해남군,070,65~69세,2017,5136,2517,2619,96.1,5118,2506,2612,95.9
36400, 해남군,070001, 65세,2017,1078,537,541,99.3,1076,536,540,99.3
36400, 해남군,070002, 66세,2017,975,453,522,86.8,966,448,518,86.5
36400, 해남군,070003, 67세,2017,1003,495,508,97.4,1002,494,508,97.2
36400, 해남군,070004, 68세,2017,1078,545,533,102.3,1074,542,532,101.9
36400, 해남군,070005, 69세,2017,1002,487,515,94.6,1000,486,514,94.6
36400, 해남군,075,70~74세,2017,4668,2063,2605,79.2,4660,2059,2601,79.2
36400, 해남군,075001, 70세,2017,1072,502,570,88.1,1069,501,568,88.2
36400, 해남군,075002, 71세,2017,834,388,446,87,833,387,446,86.8
36400, 해남군,075003, 72세,2017,928,405,523,77.4,925,404,521,77.5
36400, 해남군,075004, 73세,2017,834,346,488,70.9,833,345,488,70.7
36400, 해남군,075005, 74세,2017,1000,422,578,73,1000,422,578,73
36400, 해남군,080,75~79세,2017,5157,2063,3094,66.7,5151,2061,3090,66.7
36400, 해남군,080001, 75세,2017,1254,515,739,69.7,1254,515,739,69.7
36400, 해남군,080002, 76세,2017,1026,411,615,66.8,1024,411,613,67
36400, 해남군,080003, 77세,2017,1043,417,626,66.6,1042,417,625,66.7
36400, 해남군,080004, 78세,2017,979,399,580,68.8,977,398,579,68.7
36400, 해남군,080005, 79세,2017,855,321,534,60.1,854,320,534,59.9
36400, 해남군,085,80~84세,2017,3237,1040,2197,47.3,3236,1040,2196,47.4
36400, 해남군,085001, 80세,2017,844,309,535,57.8,843,309,534,57.9
36400, 해남군,085002, 81세,2017,679,218,461,47.3,679,218,461,47.3
36400, 해남군,085003, 82세,2017,630,189,441,42.9,630,189,441,42.9
36400, 해남군,085004, 83세,2017,590,188,402,46.8,590,188,402,46.8
36400, 해남군,085005, 84세,2017,494,136,358,38,494,136,358,38
36400, 해남군,090,85~89세,2017,1585,387,1198,32.3,1585,387,1198,32.3
36400, 해남군,090001, 85세,2017,413,111,302,36.8,413,111,302,36.8
36400, 해남군,090002, 86세,2017,369,83,286,29,369,83,286,29
36400, 해남군,090003, 87세,2017,365,81,284,28.5,365,81,284,28.5
36400, 해남군,090004, 88세,2017,253,68,185,36.8,253,68,185,36.8
36400, 해남군,090005, 89세,2017,185,44,141,31.2,185,44,141,31.2
36400, 해남군,095,90~94세,2017,419,85,334,25.4,418,85,333,25.5
36400, 해남군,095001, 90세,2017,138,23,115,20,138,23,115,20
36400, 해남군,095002, 91세,2017,93,27,66,40.9,93,27,66,40.9
36400, 해남군,095003, 92세,2017,57,12,45,26.7,56,12,44,27.3
36400, 해남군,095004, 93세,2017,74,13,61,21.3,74,13,61,21.3
36400, 해남군,095005, 94세,2017,57,10,47,21.3,57,10,47,21.3
36400, 해남군,100,95~99세,2017,101,17,84,20.2,101,17,84,20.2
36400, 해남군,100001, 95세,2017,36,8,28,28.6,36,8,28,28.6
36400, 해남군,100002, 96세,2017,23,X,20,15,23,X,20,15
36400, 해남군,100003, 97세,2017,26,X,23,13,26,X,23,13
36400, 해남군,100004, 98세,2017,10,X,9,11.1,10,X,9,11.1
36400, 해남군,100005, 99세,2017,6,X,X,50,6,X,X,50
36400, 해남군,101,100세이상,2017,11,X,10,10,11,X,10,10
36400, 해남군,102,15세미만,2017,7281,3644,3637,100.2,7277,3642,3635,100.2
36400, 해남군,103,15~64세,2017,39528,21199,18329,115.7,37923,20225,17698,114.3
36400, 해남군,104,65세이상,2017,20314,8173,12141,67.3,20280,8156,12124,67.3
36400, 해남군,086,85세이상,2017,2116,490,1626,30.1,2115,490,1625,30.2
36400, 해남군,126,평균연령,2017,49.8,47.4,52.2,,50.2,47.8,52.4,
36400, 해남군,127,중위연령,2017,53.6,50.9,56.5,,54.1,51.5,56.9,
36410, 영암군,000,합계,2017,57679,30540,27139,112.5,52898,27122,25776,105.2
36410, 영암군,005,0~4세,2017,2287,1187,1100,107.9,2240,1158,1082,107
36410, 영암군,005001, 0세,2017,434,217,217,100,420,207,213,97.2
36410, 영암군,005002, 1세,2017,482,255,227,112.3,470,245,225,108.9
36410, 영암군,005003, 2세,2017,456,242,214,113.1,449,239,210,113.8
36410, 영암군,005004, 3세,2017,450,228,222,102.7,444,227,217,104.6
36410, 영암군,005005, 4세,2017,465,245,220,111.4,457,240,217,110.6
36410, 영암군,010,5~9세,2017,2150,1116,1034,107.9,2107,1097,1010,108.6
36410, 영암군,010001, 5세,2017,459,236,223,105.8,446,230,216,106.5
36410, 영암군,010002, 6세,2017,453,217,236,91.9,444,213,231,92.2
36410, 영암군,010003, 7세,2017,416,220,196,112.2,409,217,192,113
36410, 영암군,010004, 8세,2017,418,228,190,120,412,226,186,121.5
36410, 영암군,010005, 9세,2017,404,215,189,113.8,396,211,185,114.1
36410, 영암군,015,10~14세,2017,2150,1147,1003,114.4,2118,1125,993,113.3
36410, 영암군,015001, 10세,2017,448,231,217,106.5,442,227,215,105.6
36410, 영암군,015002, 11세,2017,393,209,184,113.6,386,204,182,112.1
36410, 영암군,015003, 12세,2017,405,214,191,112,400,210,190,110.5
36410, 영암군,015004, 13세,2017,442,234,208,112.5,435,230,205,112.2
36410, 영암군,015005, 14세,2017,462,259,203,127.6,455,254,201,126.4
36410, 영암군,020,15~19세,2017,3049,1569,1480,106,3017,1558,1459,106.8
36410, 영암군,020001, 15세,2017,496,264,232,113.8,490,262,228,114.9
36410, 영암군,020002, 16세,2017,549,286,263,108.7,548,286,262,109.2
36410, 영암군,020003, 17세,2017,671,318,353,90.1,667,315,352,89.5
36410, 영암군,020004, 18세,2017,653,314,339,92.6,644,311,333,93.4
36410, 영암군,020005, 19세,2017,680,387,293,132.1,668,384,284,135.2
36410, 영암군,025,20~24세,2017,3385,1979,1406,140.8,3018,1715,1303,131.6
36410, 영암군,025001, 20세,2017,760,411,349,117.8,736,397,339,117.1
36410, 영암군,025002, 21세,2017,741,435,306,142.2,702,413,289,142.9
36410, 영암군,025003, 22세,2017,662,376,286,131.5,587,323,264,122.3
36410, 영암군,025004, 23세,2017,605,378,227,166.5,512,308,204,151
36410, 영암군,025005, 24세,2017,617,379,238,159.2,481,274,207,132.4
36410, 영암군,030,25~29세,2017,2986,1831,1155,158.5,2020,1065,955,111.5
36410, 영암군,030001, 25세,2017,629,379,250,151.6,481,257,224,114.7
36410, 영암군,030002, 26세,2017,542,334,208,160.6,357,185,172,107.6
36410, 영암군,030003, 27세,2017,625,364,261,139.5,421,210,211,99.5
36410, 영암군,030004, 28세,2017,590,375,215,174.4,366,197,169,116.6
36410, 영암군,030005, 29세,2017,600,379,221,171.5,395,216,179,120.7
36410, 영암군,035,30~34세,2017,3519,2142,1377,155.6,2557,1373,1184,116
36410, 영암군,035001, 30세,2017,662,398,264,150.8,453,232,221,105
36410, 영암군,035002, 31세,2017,653,397,256,155.1,439,226,213,106.1
36410, 영암군,035003, 32세,2017,723,430,293,146.8,528,277,251,110.4
36410, 영암군,035004, 33세,2017,702,424,278,152.5,527,289,238,121.4
36410, 영암군,035005, 34세,2017,779,493,286,172.4,610,349,261,133.7
36410, 영암군,040,35~39세,2017,4001,2506,1495,167.6,3367,2001,1366,146.5
36410, 영암군,040001, 35세,2017,871,538,333,161.6,724,418,306,136.6
36410, 영암군,040002, 36세,2017,819,536,283,189.4,654,408,246,165.9
36410, 영암군,040003, 37세,2017,791,486,305,159.3,680,401,279,143.7
36410, 영암군,040004, 38세,2017,780,465,315,147.6,675,383,292,131.2
36410, 영암군,040005, 39세,2017,740,481,259,185.7,634,391,243,160.9
36410, 영암군,045,40~44세,2017,3945,2362,1583,149.2,3457,2017,1440,140.1
36410, 영암군,045001, 40세,2017,736,429,307,139.7,625,349,276,126.4
36410, 영암군,045002, 41세,2017,734,452,282,160.3,621,367,254,144.5
36410, 영암군,045003, 42세,2017,737,444,293,151.5,662,385,277,139
36410, 영암군,045004, 43세,2017,839,499,340,146.8,749,441,308,143.2
36410, 영암군,045005, 44세,2017,899,538,361,149,800,475,325,146.2
36410, 영암군,050,45~49세,2017,4582,2677,1905,140.5,4152,2412,1740,138.6
36410, 영암군,050001, 45세,2017,907,546,361,151.2,828,500,328,152.4
36410, 영암군,050002, 46세,2017,893,499,394,126.6,809,451,358,126
36410, 영암군,050003, 47세,2017,910,546,364,150,813,484,329,147.1
36410, 영암군,050004, 48세,2017,924,521,403,129.3,846,476,370,128.6
36410, 영암군,050005, 49세,2017,948,565,383,147.5,856,501,355,141.1
36410, 영암군,055,50~54세,2017,4536,2633,1903,138.4,4187,2432,1755,138.6
36410, 영암군,055001, 50세,2017,890,525,365,143.8,824,481,343,140.2
36410, 영암군,055002, 51세,2017,942,559,383,146,857,509,348,146.3
36410, 영암군,055003, 52세,2017,895,517,378,136.8,829,480,349,137.5
36410, 영암군,055004, 53세,2017,868,506,362,139.8,803,469,334,140.4
36410, 영암군,055005, 54세,2017,941,526,415,126.7,874,493,381,129.4
36410, 영암군,060,55~59세,2017,4590,2510,2080,120.7,4385,2389,1996,119.7
36410, 영암군,060001, 55세,2017,930,492,438,112.3,874,461,413,111.6
36410, 영암군,060002, 56세,2017,996,568,428,132.7,967,550,417,131.9
36410, 영암군,060003, 57세,2017,941,507,434,116.8,891,471,420,112.1
36410, 영암군,060004, 58세,2017,924,499,425,117.4,892,484,408,118.6
36410, 영암군,060005, 59세,2017,799,444,355,125.1,761,423,338,125.1
36410, 영암군,065,60~64세,2017,3594,1786,1808,98.8,3467,1722,1745,98.7
36410, 영암군,065001, 60세,2017,825,435,390,111.5,785,413,372,111
36410, 영암군,065002, 61세,2017,769,385,384,100.3,739,371,368,100.8
36410, 영암군,065003, 62세,2017,744,372,372,100,726,361,365,98.9
36410, 영암군,065004, 63세,2017,667,315,352,89.5,643,308,335,91.9
36410, 영암군,065005, 64세,2017,589,279,310,90,574,269,305,88.2
36410, 영암군,070,65~69세,2017,3110,1500,1610,93.2,3065,1479,1586,93.3
36410, 영암군,070001, 65세,2017,665,325,340,95.6,645,315,330,95.5
36410, 영암군,070002, 66세,2017,570,262,308,85.1,567,260,307,84.7
36410, 영암군,070003, 67세,2017,634,297,337,88.1,622,292,330,88.5
36410, 영암군,070004, 68세,2017,642,328,314,104.5,637,326,311,104.8
36410, 영암군,070005, 69세,2017,599,288,311,92.6,594,286,308,92.9
36410, 영암군,075,70~74세,2017,2923,1222,1701,71.8,2898,1215,1683,72.2
36410, 영암군,075001, 70세,2017,636,284,352,80.7,630,281,349,80.5
36410, 영암군,075002, 71세,2017,534,217,317,68.5,530,217,313,69.3
36410, 영암군,075003, 72세,2017,581,260,321,81,578,260,318,81.8
36410, 영암군,075004, 73세,2017,581,231,350,66,575,229,346,66.2
36410, 영암군,075005, 74세,2017,591,230,361,63.7,585,228,357,63.9
36410, 영암군,080,75~79세,2017,3367,1319,2048,64.4,3349,1312,2037,64.4
36410, 영암군,080001, 75세,2017,814,368,446,82.5,809,365,444,82.2
36410, 영암군,080002, 76세,2017,680,252,428,58.9,673,250,423,59.1
36410, 영암군,080003, 77세,2017,655,244,411,59.4,655,244,411,59.4
36410, 영암군,080004, 78세,2017,643,251,392,64,640,249,391,63.7
36410, 영암군,080005, 79세,2017,575,204,371,55,572,204,368,55.4
36410, 영암군,085,80~84세,2017,2192,727,1465,49.6,2186,726,1460,49.7
36410, 영암군,085001, 80세,2017,512,189,323,58.5,510,188,322,58.4
36410, 영암군,085002, 81세,2017,472,157,315,49.8,471,157,314,50
36410, 영암군,085003, 82세,2017,466,141,325,43.4,465,141,324,43.5
36410, 영암군,085004, 83세,2017,405,132,273,48.4,405,132,273,48.4
36410, 영암군,085005, 84세,2017,337,108,229,47.2,335,108,227,47.6
36410, 영암군,090,85~89세,2017,986,254,732,34.7,981,253,728,34.8
36410, 영암군,090001, 85세,2017,269,78,191,40.8,268,78,190,41.1
36410, 영암군,090002, 86세,2017,227,57,170,33.5,226,57,169,33.7
36410, 영암군,090003, 87세,2017,218,56,162,34.6,215,55,160,34.4
36410, 영암군,090004, 88세,2017,168,37,131,28.2,168,37,131,28.2
36410, 영암군,090005, 89세,2017,104,26,78,33.3,104,26,78,33.3
36410, 영암군,095,90~94세,2017,265,63,202,31.2,265,63,202,31.2
36410, 영암군,095001, 90세,2017,88,21,67,31.3,88,21,67,31.3
36410, 영암군,095002, 91세,2017,50,16,34,47.1,50,16,34,47.1
36410, 영암군,095003, 92세,2017,47,10,37,27,47,10,37,27
36410, 영암군,095004, 93세,2017,45,8,37,21.6,45,8,37,21.6
36410, 영암군,095005, 94세,2017,35,8,27,29.6,35,8,27,29.6
36410, 영암군,100,95~99세,2017,54,8,46,17.4,54,8,46,17.4
36410, 영암군,100001, 95세,2017,21,X,18,16.7,21,X,18,16.7
36410, 영암군,100002, 96세,2017,16,X,12,33.3,16,X,12,33.3
36410, 영암군,100003, 97세,2017,9,X,8,12.5,9,X,8,12.5
36410, 영암군,100004, 98세,2017,5,X,5,0,5,X,5,0
36410, 영암군,100005, 99세,2017,X,X,X,0,X,X,X,0
36410, 영암군,101,100세이상,2017,8,X,6,33.3,8,X,6,33.3
36410, 영암군,102,15세미만,2017,6587,3450,3137,110,6465,3380,3085,109.6
36410, 영암군,103,15~64세,2017,38187,21995,16192,135.8,33627,18684,14943,125
36410, 영암군,104,65세이상,2017,12905,5095,7810,65.2,12806,5058,7748,65.3
36410, 영암군,086,85세이상,2017,1313,327,986,33.2,1308,326,982,33.2
36410, 영암군,126,평균연령,2017,45.3,43,48,,46.1,43.9,48.4,
36410, 영암군,127,중위연령,2017,46.5,43.9,50.1,,48.1,45.9,51,
36420, 무안군,000,합계,2017,81420,41022,40398,101.5,79464,39958,39506,101.1
36420, 무안군,005,0~4세,2017,3464,1784,1680,106.2,3459,1781,1678,106.1
36420, 무안군,005001, 0세,2017,520,263,257,102.3,520,263,257,102.3
36420, 무안군,005002, 1세,2017,621,334,287,116.4,620,334,286,116.8
36420, 무안군,005003, 2세,2017,731,382,349,109.5,730,381,349,109.2
36420, 무안군,005004, 3세,2017,736,365,371,98.4,734,363,371,97.8
36420, 무안군,005005, 4세,2017,856,440,416,105.8,855,440,415,106
36420, 무안군,010,5~9세,2017,4424,2240,2184,102.6,4417,2238,2179,102.7
36420, 무안군,010001, 5세,2017,953,483,470,102.8,951,483,468,103.2
36420, 무안군,010002, 6세,2017,886,441,445,99.1,886,441,445,99.1
36420, 무안군,010003, 7세,2017,895,438,457,95.8,892,437,455,96
36420, 무안군,010004, 8세,2017,856,459,397,115.6,854,458,396,115.7
36420, 무안군,010005, 9세,2017,834,419,415,101,834,419,415,101
36420, 무안군,015,10~14세,2017,4023,2073,1950,106.3,4020,2071,1949,106.3
36420, 무안군,015001, 10세,2017,868,463,405,114.3,868,463,405,114.3
36420, 무안군,015002, 11세,2017,753,383,370,103.5,753,383,370,103.5
36420, 무안군,015003, 12세,2017,732,343,389,88.2,731,342,389,87.9
36420, 무안군,015004, 13세,2017,842,445,397,112.1,841,445,396,112.4
36420, 무안군,015005, 14세,2017,828,439,389,112.9,827,438,389,112.6
36420, 무안군,020,15~19세,2017,5539,2974,2565,115.9,5491,2956,2535,116.6
36420, 무안군,020001, 15세,2017,844,455,389,117,844,455,389,117
36420, 무안군,020002, 16세,2017,956,479,477,100.4,955,478,477,100.2
36420, 무안군,020003, 17세,2017,984,504,480,105,982,504,478,105.4
36420, 무안군,020004, 18세,2017,1152,611,541,112.9,1144,608,536,113.4
36420, 무안군,020005, 19세,2017,1603,925,678,136.4,1566,911,655,139.1
36420, 무안군,025,20~24세,2017,6463,3628,2835,128,5947,3333,2614,127.5
36420, 무안군,025001, 20세,2017,1406,716,690,103.8,1339,677,662,102.3
36420, 무안군,025002, 21세,2017,1435,715,720,99.3,1332,656,676,97
36420, 무안군,025003, 22세,2017,1405,786,619,127,1292,722,570,126.7
36420, 무안군,025004, 23세,2017,1186,748,438,170.8,1076,683,393,173.8
36420, 무안군,025005, 24세,2017,1031,663,368,180.2,908,595,313,190.1
36420, 무안군,030,25~29세,2017,3636,1998,1638,122,3225,1747,1478,118.2
36420, 무안군,030001, 25세,2017,870,496,374,132.6,769,437,332,131.6
36420, 무안군,030002, 26세,2017,783,447,336,133,682,390,292,133.6
36420, 무안군,030003, 27세,2017,667,357,310,115.2,583,296,287,103.1
36420, 무안군,030004, 28세,2017,664,355,309,114.9,605,324,281,115.3
36420, 무안군,030005, 29세,2017,652,343,309,111,586,300,286,104.9
36420, 무안군,035,30~34세,2017,4450,2227,2223,100.2,4161,2084,2077,100.3
36420, 무안군,035001, 30세,2017,725,336,389,86.4,663,303,360,84.2
36420, 무안군,035002, 31세,2017,775,422,353,119.5,697,382,315,121.3
36420, 무안군,035003, 32세,2017,897,459,438,104.8,852,435,417,104.3
36420, 무안군,035004, 33세,2017,969,468,501,93.4,911,442,469,94.2
36420, 무안군,035005, 34세,2017,1084,542,542,100,1038,522,516,101.2
36420, 무안군,040,35~39세,2017,6106,3161,2945,107.3,5922,3050,2872,106.2
36420, 무안군,040001, 35세,2017,1241,660,581,113.6,1203,635,568,111.8
36420, 무안군,040002, 36세,2017,1202,605,597,101.3,1162,583,579,100.7
36420, 무안군,040003, 37세,2017,1306,659,647,101.9,1266,638,628,101.6
36420, 무안군,040004, 38세,2017,1208,653,555,117.7,1169,628,541,116.1
36420, 무안군,040005, 39세,2017,1149,584,565,103.4,1122,566,556,101.8
36420, 무안군,045,40~44세,2017,5954,3120,2834,110.1,5821,3050,2771,110.1
36420, 무안군,045001, 40세,2017,1206,598,608,98.4,1169,578,591,97.8
36420, 무안군,045002, 41세,2017,1139,607,532,114.1,1113,593,520,114
36420, 무안군,045003, 42세,2017,1130,588,542,108.5,1102,572,530,107.9
36420, 무안군,045004, 43세,2017,1249,677,572,118.4,1233,668,565,118.2
36420, 무안군,045005, 44세,2017,1230,650,580,112.1,1204,639,565,113.1
36420, 무안군,050,45~49세,2017,6158,3391,2767,122.6,6030,3323,2707,122.8
36420, 무안군,050001, 45세,2017,1161,635,526,120.7,1141,621,520,119.4
36420, 무안군,050002, 46세,2017,1309,748,561,133.3,1291,739,552,133.9
36420, 무안군,050003, 47세,2017,1224,663,561,118.2,1192,647,545,118.7
36420, 무안군,050004, 48세,2017,1205,660,545,121.1,1178,648,530,122.3
36420, 무안군,050005, 49세,2017,1259,685,574,119.3,1228,668,560,119.3
36420, 무안군,055,50~54세,2017,5534,2965,2569,115.4,5424,2919,2505,116.5
36420, 무안군,055001, 50세,2017,1151,602,549,109.7,1131,597,534,111.8
36420, 무안군,055002, 51세,2017,1133,616,517,119.1,1108,604,504,119.8
36420, 무안군,055003, 52세,2017,1107,595,512,116.2,1083,586,497,117.9
36420, 무안군,055004, 53세,2017,1038,587,451,130.2,1023,580,443,130.9
36420, 무안군,055005, 54세,2017,1105,565,540,104.6,1079,552,527,104.7
36420, 무안군,060,55~59세,2017,5743,2965,2778,106.7,5679,2940,2739,107.3
36420, 무안군,060001, 55세,2017,1130,602,528,114,1118,597,521,114.6
36420, 무안군,060002, 56세,2017,1187,626,561,111.6,1174,621,553,112.3
36420, 무안군,060003, 57세,2017,1246,643,603,106.6,1229,638,591,108
36420, 무안군,060004, 58세,2017,1086,536,550,97.5,1075,531,544,97.6
36420, 무안군,060005, 59세,2017,1094,558,536,104.1,1083,553,530,104.3
36420, 무안군,065,60~64세,2017,4602,2266,2336,97,4567,2247,2320,96.9
36420, 무안군,065001, 60세,2017,1064,524,540,97,1053,519,534,97.2
36420, 무안군,065002, 61세,2017,926,463,463,100,918,458,460,99.6
36420, 무안군,065003, 62세,2017,991,468,523,89.5,985,466,519,89.8
36420, 무안군,065004, 63세,2017,856,411,445,92.4,849,407,442,92.1
36420, 무안군,065005, 64세,2017,765,400,365,109.6,762,397,365,108.8
36420, 무안군,070,65~69세,2017,4270,2092,2178,96.1,4255,2085,2170,96.1
36420, 무안군,070001, 65세,2017,909,438,471,93,904,434,470,92.3
36420, 무안군,070002, 66세,2017,818,402,416,96.6,816,402,414,97.1
36420, 무안군,070003, 67세,2017,814,389,425,91.5,812,388,424,91.5
36420, 무안군,070004, 68세,2017,865,433,432,100.2,861,432,429,100.7
36420, 무안군,070005, 69세,2017,864,430,434,99.1,862,429,433,99.1
36420, 무안군,075,70~74세,2017,3573,1616,1957,82.6,3569,1614,1955,82.6
36420, 무안군,075001, 70세,2017,841,401,440,91.1,841,401,440,91.1
36420, 무안군,075002, 71세,2017,703,323,380,85,702,322,380,84.7
36420, 무안군,075003, 72세,2017,707,320,387,82.7,706,320,386,82.9
36420, 무안군,075004, 73세,2017,659,283,376,75.3,658,282,376,75
36420, 무안군,075005, 74세,2017,663,289,374,77.3,662,289,373,77.5
36420, 무안군,080,75~79세,2017,3805,1496,2309,64.8,3804,1495,2309,64.7
36420, 무안군,080001, 75세,2017,994,418,576,72.6,994,418,576,72.6
36420, 무안군,080002, 76세,2017,776,308,468,65.8,776,308,468,65.8
36420, 무안군,080003, 77세,2017,728,277,451,61.4,727,276,451,61.2
36420, 무안군,080004, 78세,2017,659,249,410,60.7,659,249,410,60.7
36420, 무안군,080005, 79세,2017,648,244,404,60.4,648,244,404,60.4
36420, 무안군,085,80~84세,2017,2223,714,1509,47.3,2221,713,1508,47.3
36420, 무안군,085001, 80세,2017,538,188,350,53.7,538,188,350,53.7
36420, 무안군,085002, 81세,2017,437,147,290,50.7,437,147,290,50.7
36420, 무안군,085003, 82세,2017,475,151,324,46.6,473,150,323,46.4
36420, 무안군,085004, 83세,2017,420,132,288,45.8,420,132,288,45.8
36420, 무안군,085005, 84세,2017,353,96,257,37.4,353,96,257,37.4
36420, 무안군,090,85~89세,2017,1086,250,836,29.9,1085,250,835,29.9
36420, 무안군,090001, 85세,2017,275,72,203,35.5,275,72,203,35.5
36420, 무안군,090002, 86세,2017,223,58,165,35.2,223,58,165,35.2
36420, 무안군,090003, 87세,2017,264,45,219,20.5,264,45,219,20.5
36420, 무안군,090004, 88세,2017,181,46,135,34.1,181,46,135,34.1
36420, 무안군,090005, 89세,2017,143,29,114,25.4,142,29,113,25.7
36420, 무안군,095,90~94세,2017,288,53,235,22.6,288,53,235,22.6
36420, 무안군,095001, 90세,2017,82,16,66,24.2,82,16,66,24.2
36420, 무안군,095002, 91세,2017,64,16,48,33.3,64,16,48,33.3
36420, 무안군,095003, 92세,2017,55,10,45,22.2,55,10,45,22.2
36420, 무안군,095004, 93세,2017,37,6,31,19.4,37,6,31,19.4
36420, 무안군,095005, 94세,2017,50,5,45,11.1,50,5,45,11.1
36420, 무안군,100,95~99세,2017,69,9,60,15,69,9,60,15
36420, 무안군,100001, 95세,2017,26,X,22,18.2,26,X,22,18.2
36420, 무안군,100002, 96세,2017,17,X,16,6.3,17,X,16,6.3
36420, 무안군,100003, 97세,2017,8,X,5,60,8,X,5,60
36420, 무안군,100004, 98세,2017,15,X,14,7.1,15,X,14,7.1
36420, 무안군,100005, 99세,2017,X,X,X,0,X,X,X,0
36420, 무안군,101,100세이상,2017,10,X,10,0,10,X,10,0
36420, 무안군,102,15세미만,2017,11911,6097,5814,104.9,11896,6090,5806,104.9
36420, 무안군,103,15~64세,2017,54185,28695,25490,112.6,52267,27649,24618,112.3
36420, 무안군,104,65세이상,2017,15324,6230,9094,68.5,15301,6219,9082,68.5
36420, 무안군,086,85세이상,2017,1453,312,1141,27.3,1452,312,1140,27.4
36420, 무안군,126,평균연령,2017,41.9,40.2,43.7,,42.2,40.4,43.9,
36420, 무안군,127,중위연령,2017,42.2,40.7,43.9,,42.7,41.2,44.3,
36430, 함평군,000,합계,2017,30948,15284,15664,97.6,30172,14830,15342,96.7
36430, 함평군,005,0~4세,2017,848,449,399,112.5,848,449,399,112.5
36430, 함평군,005001, 0세,2017,155,90,65,138.5,155,90,65,138.5
36430, 함평군,005002, 1세,2017,174,98,76,128.9,174,98,76,128.9
36430, 함평군,005003, 2세,2017,162,78,84,92.9,162,78,84,92.9
36430, 함평군,005004, 3세,2017,180,83,97,85.6,180,83,97,85.6
36430, 함평군,005005, 4세,2017,177,100,77,129.9,177,100,77,129.9
36430, 함평군,010,5~9세,2017,866,461,405,113.8,866,461,405,113.8
36430, 함평군,010001, 5세,2017,197,104,93,111.8,197,104,93,111.8
36430, 함평군,010002, 6세,2017,194,106,88,120.5,194,106,88,120.5
36430, 함평군,010003, 7세,2017,151,81,70,115.7,151,81,70,115.7
36430, 함평군,010004, 8세,2017,151,88,63,139.7,151,88,63,139.7
36430, 함평군,010005, 9세,2017,173,82,91,90.1,173,82,91,90.1
36430, 함평군,015,10~14세,2017,943,497,446,111.4,942,497,445,111.7
36430, 함평군,015001, 10세,2017,169,86,83,103.6,169,86,83,103.6
36430, 함평군,015002, 11세,2017,161,81,80,101.3,161,81,80,101.3
36430, 함평군,015003, 12세,2017,171,90,81,111.1,171,90,81,111.1
36430, 함평군,015004, 13세,2017,210,114,96,118.8,209,114,95,120
36430, 함평군,015005, 14세,2017,232,126,106,118.9,232,126,106,118.9
36430, 함평군,020,15~19세,2017,1563,796,767,103.8,1560,795,765,103.9
36430, 함평군,020001, 15세,2017,268,144,124,116.1,268,144,124,116.1
36430, 함평군,020002, 16세,2017,418,192,226,85,418,192,226,85
36430, 함평군,020003, 17세,2017,462,207,255,81.2,462,207,255,81.2
36430, 함평군,020004, 18세,2017,234,142,92,154.3,234,142,92,154.3
36430, 함평군,020005, 19세,2017,181,111,70,158.6,178,110,68,161.8
36430, 함평군,025,20~24세,2017,1208,776,432,179.6,1073,681,392,173.7
36430, 함평군,025001, 20세,2017,219,146,73,200,211,142,69,205.8
36430, 함평군,025002, 21세,2017,248,167,81,206.2,235,161,74,217.6
36430, 함평군,025003, 22세,2017,266,180,86,209.3,229,152,77,197.4
36430, 함평군,025004, 23세,2017,245,145,100,145,210,120,90,133.3
36430, 함평군,025005, 24세,2017,230,138,92,150,188,106,82,129.3
36430, 함평군,030,25~29세,2017,1167,632,535,118.1,968,513,455,112.7
36430, 함평군,030001, 25세,2017,251,145,106,136.8,204,111,93,119.4
36430, 함평군,030002, 26세,2017,242,134,108,124.1,194,108,86,125.6
36430, 함평군,030003, 27세,2017,231,124,107,115.9,188,99,89,111.2
36430, 함평군,030004, 28세,2017,217,118,99,119.2,188,100,88,113.6
36430, 함평군,030005, 29세,2017,226,111,115,96.5,194,95,99,96
36430, 함평군,035,30~34세,2017,1125,626,499,125.5,1003,548,455,120.4
36430, 함평군,035001, 30세,2017,219,116,103,112.6,190,100,90,111.1
36430, 함평군,035002, 31세,2017,227,134,93,144.1,197,115,82,140.2
36430, 함평군,035003, 32세,2017,220,124,96,129.2,198,108,90,120
36430, 함평군,035004, 33세,2017,208,115,93,123.7,188,99,89,111.2
36430, 함평군,035005, 34세,2017,251,137,114,120.2,230,126,104,121.2
36430, 함평군,040,35~39세,2017,1302,729,573,127.2,1217,685,532,128.8
36430, 함평군,040001, 35세,2017,259,137,122,112.3,238,124,114,108.8
36430, 함평군,040002, 36세,2017,261,147,114,128.9,247,139,108,128.7
36430, 함평군,040003, 37세,2017,261,154,107,143.9,250,151,99,152.5
36430, 함평군,040004, 38세,2017,259,142,117,121.4,235,128,107,119.6
36430, 함평군,040005, 39세,2017,262,149,113,131.9,247,143,104,137.5
36430, 함평군,045,40~44세,2017,1584,901,683,131.9,1527,861,666,129.3
36430, 함평군,045001, 40세,2017,267,142,125,113.6,257,133,124,107.3
36430, 함평군,045002, 41세,2017,280,155,125,124,263,144,119,121
36430, 함평군,045003, 42세,2017,329,183,146,125.3,315,174,141,123.4
36430, 함평군,045004, 43세,2017,341,210,131,160.3,336,207,129,160.5
36430, 함평군,045005, 44세,2017,367,211,156,135.3,356,203,153,132.7
36430, 함평군,050,45~49세,2017,1989,1165,824,141.4,1940,1143,797,143.4
36430, 함평군,050001, 45세,2017,369,219,150,146,351,209,142,147.2
36430, 함평군,050002, 46세,2017,398,235,163,144.2,391,233,158,147.5
36430, 함평군,050003, 47세,2017,380,222,158,140.5,374,218,156,139.7
36430, 함평군,050004, 48세,2017,406,227,179,126.8,397,224,173,129.5
36430, 함평군,050005, 49세,2017,436,262,174,150.6,427,259,168,154.2
36430, 함평군,055,50~54세,2017,2363,1355,1008,134.4,2306,1331,975,136.5
36430, 함평군,055001, 50세,2017,470,277,193,143.5,457,271,186,145.7
36430, 함평군,055002, 51세,2017,475,295,180,163.9,466,289,177,163.3
36430, 함평군,055003, 52세,2017,461,256,205,124.9,446,250,196,127.6
36430, 함평군,055004, 53세,2017,433,242,191,126.7,425,239,186,128.5
36430, 함평군,055005, 54세,2017,524,285,239,119.2,512,282,230,122.6
36430, 함평군,060,55~59세,2017,2807,1507,1300,115.9,2780,1498,1282,116.8
36430, 함평군,060001, 55세,2017,509,284,225,126.2,501,281,220,127.7
36430, 함평군,060002, 56세,2017,593,311,282,110.3,584,310,274,113.1
36430, 함평군,060003, 57세,2017,609,327,282,116,604,324,280,115.7
36430, 함평군,060004, 58세,2017,564,311,253,122.9,560,310,250,124
36430, 함평군,060005, 59세,2017,532,274,258,106.2,531,273,258,105.8
36430, 함평군,065,60~64세,2017,2548,1280,1268,100.9,2526,1270,1256,101.1
36430, 함평군,065001, 60세,2017,586,307,279,110,578,303,275,110.2
36430, 함평군,065002, 61세,2017,508,267,241,110.8,502,265,237,111.8
36430, 함평군,065003, 62세,2017,557,271,286,94.8,554,271,283,95.8
36430, 함평군,065004, 63세,2017,449,238,211,112.8,445,235,210,111.9
36430, 함평군,065005, 64세,2017,448,197,251,78.5,447,196,251,78.1
36430, 함평군,070,65~69세,2017,2392,1109,1283,86.4,2379,1101,1278,86.2
36430, 함평군,070001, 65세,2017,519,233,286,81.5,515,229,286,80.1
36430, 함평군,070002, 66세,2017,421,204,217,94,418,202,216,93.5
36430, 함평군,070003, 67세,2017,491,224,267,83.9,489,224,265,84.5
36430, 함평군,070004, 68세,2017,478,238,240,99.2,477,237,240,98.8
36430, 함평군,070005, 69세,2017,483,210,273,76.9,480,209,271,77.1
36430, 함평군,075,70~74세,2017,2334,984,1350,72.9,2333,984,1349,72.9
36430, 함평군,075001, 70세,2017,503,239,264,90.5,503,239,264,90.5
36430, 함평군,075002, 71세,2017,478,208,270,77,478,208,270,77
36430, 함평군,075003, 72세,2017,430,169,261,64.8,429,169,260,65
36430, 함평군,075004, 73세,2017,444,168,276,60.9,444,168,276,60.9
36430, 함평군,075005, 74세,2017,479,200,279,71.7,479,200,279,71.7
36430, 함평군,080,75~79세,2017,2917,1124,1793,62.7,2913,1120,1793,62.5
36430, 함평군,080001, 75세,2017,715,300,415,72.3,713,298,415,71.8
36430, 함평군,080002, 76세,2017,564,223,341,65.4,564,223,341,65.4
36430, 함평군,080003, 77세,2017,580,225,355,63.4,580,225,355,63.4
36430, 함평군,080004, 78세,2017,522,190,332,57.2,522,190,332,57.2
36430, 함평군,080005, 79세,2017,536,186,350,53.1,534,184,350,52.6
36430, 함평군,085,80~84세,2017,1815,588,1227,47.9,1815,588,1227,47.9
36430, 함평군,085001, 80세,2017,442,144,298,48.3,442,144,298,48.3
36430, 함평군,085002, 81세,2017,377,141,236,59.7,377,141,236,59.7
36430, 함평군,085003, 82세,2017,395,114,281,40.6,395,114,281,40.6
36430, 함평군,085004, 83세,2017,345,111,234,47.4,345,111,234,47.4
36430, 함평군,085005, 84세,2017,256,78,178,43.8,256,78,178,43.8
36430, 함평군,090,85~89세,2017,868,241,627,38.4,868,241,627,38.4
36430, 함평군,090001, 85세,2017,213,59,154,38.3,213,59,154,38.3
36430, 함평군,090002, 86세,2017,192,54,138,39.1,192,54,138,39.1
36430, 함평군,090003, 87세,2017,198,55,143,38.5,198,55,143,38.5
36430, 함평군,090004, 88세,2017,155,48,107,44.9,155,48,107,44.9
36430, 함평군,090005, 89세,2017,110,25,85,29.4,110,25,85,29.4
36430, 함평군,095,90~94세,2017,242,54,188,28.7,242,54,188,28.7
36430, 함평군,095001, 90세,2017,76,22,54,40.7,76,22,54,40.7
36430, 함평군,095002, 91세,2017,49,12,37,32.4,49,12,37,32.4
36430, 함평군,095003, 92세,2017,46,5,41,12.2,46,5,41,12.2
36430, 함평군,095004, 93세,2017,25,6,19,31.6,25,6,19,31.6
36430, 함평군,095005, 94세,2017,46,9,37,24.3,46,9,37,24.3
36430, 함평군,100,95~99세,2017,63,10,53,18.9,62,10,52,19.2
36430, 함평군,100001, 95세,2017,22,X,19,15.8,22,X,19,15.8
36430, 함평군,100002, 96세,2017,14,X,11,27.3,14,X,11,27.3
36430, 함평군,100003, 97세,2017,14,X,11,27.3,14,X,11,27.3
36430, 함평군,100004, 98세,2017,8,X,7,14.3,8,X,7,14.3
36430, 함평군,100005, 99세,2017,5,X,5,0,X,X,X,0
36430, 함평군,101,100세이상,2017,X,X,X,0,X,X,X,0
36430, 함평군,102,15세미만,2017,2657,1407,1250,112.6,2656,1407,1249,112.7
36430, 함평군,103,15~64세,2017,17656,9767,7889,123.8,16900,9325,7575,123.1
36430, 함평군,104,65세이상,2017,10635,4110,6525,63,10616,4098,6518,62.9
36430, 함평군,086,85세이상,2017,1177,305,872,35,1176,305,871,35
36430, 함평군,126,평균연령,2017,52,48.9,55,,52.4,49.3,55.4,
36430, 함평군,127,중위연령,2017,56,52.1,59.8,,56.6,52.9,60.4,
36440, 영광군,000,합계,2017,49670,24720,24950,99.1,48660,24153,24507,98.6
36440, 영광군,005,0~4세,2017,1822,935,887,105.4,1821,934,887,105.3
36440, 영광군,005001, 0세,2017,374,186,188,98.9,374,186,188,98.9
36440, 영광군,005002, 1세,2017,409,211,198,106.6,408,210,198,106.1
36440, 영광군,005003, 2세,2017,339,169,170,99.4,339,169,170,99.4
36440, 영광군,005004, 3세,2017,356,187,169,110.7,356,187,169,110.7
36440, 영광군,005005, 4세,2017,344,182,162,112.3,344,182,162,112.3
36440, 영광군,010,5~9세,2017,1872,950,922,103,1871,950,921,103.1
36440, 영광군,010001, 5세,2017,428,216,212,101.9,428,216,212,101.9
36440, 영광군,010002, 6세,2017,381,188,193,97.4,380,188,192,97.9
36440, 영광군,010003, 7세,2017,349,193,156,123.7,349,193,156,123.7
36440, 영광군,010004, 8세,2017,331,162,169,95.9,331,162,169,95.9
36440, 영광군,010005, 9세,2017,383,191,192,99.5,383,191,192,99.5
36440, 영광군,015,10~14세,2017,1854,950,904,105.1,1852,949,903,105.1
36440, 영광군,015001, 10세,2017,382,195,187,104.3,382,195,187,104.3
36440, 영광군,015002, 11세,2017,343,176,167,105.4,343,176,167,105.4
36440, 영광군,015003, 12세,2017,322,170,152,111.8,321,170,151,112.6
36440, 영광군,015004, 13세,2017,398,197,201,98,397,196,201,97.5
36440, 영광군,015005, 14세,2017,409,212,197,107.6,409,212,197,107.6
36440, 영광군,020,15~19세,2017,2532,1362,1170,116.4,2524,1356,1168,116.1
36440, 영광군,020001, 15세,2017,455,237,218,108.7,455,237,218,108.7
36440, 영광군,020002, 16세,2017,612,304,308,98.7,611,303,308,98.4
36440, 영광군,020003, 17세,2017,625,334,291,114.8,625,334,291,114.8
36440, 영광군,020004, 18세,2017,547,301,246,122.4,546,300,246,122
36440, 영광군,020005, 19세,2017,293,186,107,173.8,287,182,105,173.3
36440, 영광군,025,20~24세,2017,2128,1320,808,163.4,1970,1208,762,158.5
36440, 영광군,025001, 20세,2017,417,278,139,200,405,268,137,195.6
36440, 영광군,025002, 21세,2017,438,308,130,236.9,422,295,127,232.3
36440, 영광군,025003, 22세,2017,401,260,141,184.4,369,240,129,186
36440, 영광군,025004, 23세,2017,434,233,201,115.9,391,201,190,105.8
36440, 영광군,025005, 24세,2017,438,241,197,122.3,383,204,179,114
36440, 영광군,030,25~29세,2017,2085,1157,928,124.7,1867,1024,843,121.5
36440, 영광군,030001, 25세,2017,389,209,180,116.1,345,176,169,104.1
36440, 영광군,030002, 26세,2017,410,235,175,134.3,363,204,159,128.3
36440, 영광군,030003, 27세,2017,457,253,204,124,407,225,182,123.6
36440, 영광군,030004, 28세,2017,422,239,183,130.6,380,214,166,128.9
36440, 영광군,030005, 29세,2017,407,221,186,118.8,372,205,167,122.8
36440, 영광군,035,30~34세,2017,2188,1131,1057,107,2039,1061,978,108.5
36440, 영광군,035001, 30세,2017,435,217,218,99.5,392,202,190,106.3
36440, 영광군,035002, 31세,2017,401,216,185,116.8,374,201,173,116.2
36440, 영광군,035003, 32세,2017,429,206,223,92.4,400,194,206,94.2
36440, 영광군,035004, 33세,2017,452,244,208,117.3,419,226,193,117.1
36440, 영광군,035005, 34세,2017,471,248,223,111.2,454,238,216,110.2
36440, 영광군,040,35~39세,2017,2752,1468,1284,114.3,2641,1394,1247,111.8
36440, 영광군,040001, 35세,2017,544,303,241,125.7,517,285,232,122.8
36440, 영광군,040002, 36세,2017,523,263,260,101.2,490,241,249,96.8
36440, 영광군,040003, 37세,2017,547,295,252,117.1,521,278,243,114.4
36440, 영광군,040004, 38세,2017,605,319,286,111.5,592,309,283,109.2
36440, 영광군,040005, 39세,2017,533,288,245,117.6,521,281,240,117.1
36440, 영광군,045,40~44세,2017,2950,1661,1289,128.9,2876,1620,1256,129
36440, 영광군,045001, 40세,2017,502,299,203,147.3,482,285,197,144.7
36440, 영광군,045002, 41세,2017,512,292,220,132.7,495,284,211,134.6
36440, 영광군,045003, 42세,2017,579,319,260,122.7,566,310,256,121.1
36440, 영광군,045004, 43세,2017,675,369,306,120.6,666,364,302,120.5
36440, 영광군,045005, 44세,2017,682,382,300,127.3,667,377,290,130
36440, 영광군,050,45~49세,2017,3594,1990,1604,124.1,3512,1958,1554,126
36440, 영광군,050001, 45세,2017,650,356,294,121.1,633,344,289,119
36440, 영광군,050002, 46세,2017,770,415,355,116.9,757,413,344,120.1
36440, 영광군,050003, 47세,2017,709,403,306,131.7,690,395,295,133.9
36440, 영광군,050004, 48세,2017,702,400,302,132.5,684,393,291,135.1
36440, 영광군,050005, 49세,2017,763,416,347,119.9,748,413,335,123.3
36440, 영광군,055,50~54세,2017,3823,2047,1776,115.3,3750,2021,1729,116.9
36440, 영광군,055001, 50세,2017,745,412,333,123.7,730,408,322,126.7
36440, 영광군,055002, 51세,2017,737,396,341,116.1,721,388,333,116.5
36440, 영광군,055003, 52세,2017,773,407,366,111.2,761,402,359,112
36440, 영광군,055004, 53세,2017,785,437,348,125.6,771,431,340,126.8
36440, 영광군,055005, 54세,2017,783,395,388,101.8,767,392,375,104.5
36440, 영광군,060,55~59세,2017,4361,2267,2094,108.3,4309,2243,2066,108.6
36440, 영광군,060001, 55세,2017,779,406,373,108.8,763,397,366,108.5
36440, 영광군,060002, 56세,2017,904,471,433,108.8,895,469,426,110.1
36440, 영광군,060003, 57세,2017,953,500,453,110.4,944,496,448,110.7
36440, 영광군,060004, 58세,2017,832,411,421,97.6,824,407,417,97.6
36440, 영광군,060005, 59세,2017,893,479,414,115.7,883,474,409,115.9
36440, 영광군,065,60~64세,2017,3740,1845,1895,97.4,3690,1816,1874,96.9
36440, 영광군,065001, 60세,2017,822,423,399,106,808,414,394,105.1
36440, 영광군,065002, 61세,2017,775,400,375,106.7,767,394,373,105.6
36440, 영광군,065003, 62세,2017,824,402,422,95.3,813,397,416,95.4
36440, 영광군,065004, 63세,2017,677,340,337,100.9,668,334,334,100
36440, 영광군,065005, 64세,2017,642,280,362,77.3,634,277,357,77.6
36440, 영광군,070,65~69세,2017,3521,1669,1852,90.1,3499,1656,1843,89.9
36440, 영광군,070001, 65세,2017,727,350,377,92.8,721,346,375,92.3
36440, 영광군,070002, 66세,2017,642,299,343,87.2,638,298,340,87.6
36440, 영광군,070003, 67세,2017,733,343,390,87.9,729,340,389,87.4
36440, 영광군,070004, 68세,2017,732,345,387,89.1,726,341,385,88.6
36440, 영광군,070005, 69세,2017,687,332,355,93.5,685,331,354,93.5
36440, 영광군,075,70~74세,2017,3348,1467,1881,78,3342,1464,1878,78
36440, 영광군,075001, 70세,2017,795,372,423,87.9,793,371,422,87.9
36440, 영광군,075002, 71세,2017,625,278,347,80.1,624,277,347,79.8
36440, 영광군,075003, 72세,2017,618,273,345,79.1,618,273,345,79.1
36440, 영광군,075004, 73세,2017,624,258,366,70.5,621,257,364,70.6
36440, 영광군,075005, 74세,2017,686,286,400,71.5,686,286,400,71.5
36440, 영광군,080,75~79세,2017,3681,1463,2218,66,3681,1463,2218,66
36440, 영광군,080001, 75세,2017,951,410,541,75.8,951,410,541,75.8
36440, 영광군,080002, 76세,2017,737,298,439,67.9,737,298,439,67.9
36440, 영광군,080003, 77세,2017,693,259,434,59.7,693,259,434,59.7
36440, 영광군,080004, 78세,2017,674,259,415,62.4,674,259,415,62.4
36440, 영광군,080005, 79세,2017,626,237,389,60.9,626,237,389,60.9
36440, 영광군,085,80~84세,2017,2167,733,1434,51.1,2165,732,1433,51.1
36440, 영광군,085001, 80세,2017,530,172,358,48,529,171,358,47.8
36440, 영광군,085002, 81세,2017,457,173,284,60.9,457,173,284,60.9
36440, 영광군,085003, 82세,2017,503,165,338,48.8,503,165,338,48.8
36440, 영광군,085004, 83세,2017,385,146,239,61.1,385,146,239,61.1
36440, 영광군,085005, 84세,2017,292,77,215,35.8,291,77,214,36
36440, 영광군,090,85~89세,2017,887,245,642,38.2,886,244,642,38
36440, 영광군,090001, 85세,2017,237,72,165,43.6,236,71,165,43
36440, 영광군,090002, 86세,2017,177,59,118,50,177,59,118,50
36440, 영광군,090003, 87세,2017,206,39,167,23.4,206,39,167,23.4
36440, 영광군,090004, 88세,2017,153,48,105,45.7,153,48,105,45.7
36440, 영광군,090005, 89세,2017,114,27,87,31,114,27,87,31
36440, 영광군,095,90~94세,2017,288,55,233,23.6,288,55,233,23.6
36440, 영광군,095001, 90세,2017,94,21,73,28.8,94,21,73,28.8
36440, 영광군,095002, 91세,2017,42,8,34,23.5,42,8,34,23.5
36440, 영광군,095003, 92세,2017,51,6,45,13.3,51,6,45,13.3
36440, 영광군,095004, 93세,2017,39,10,29,34.5,39,10,29,34.5
36440, 영광군,095005, 94세,2017,62,10,52,19.2,62,10,52,19.2
36440, 영광군,100,95~99세,2017,65,X,61,6.6,65,X,61,6.6
36440, 영광군,100001, 95세,2017,32,X,31,3.2,32,X,31,3.2
36440, 영광군,100002, 96세,2017,14,X,14,0,14,X,14,0
36440, 영광군,100003, 97세,2017,9,X,8,12.5,9,X,8,12.5
36440, 영광군,100004, 98세,2017,7,X,5,40,7,X,5,40
36440, 영광군,100005, 99세,2017,X,X,X,0,X,X,X,0
36440, 영광군,101,100세이상,2017,12,X,11,9.1,12,X,11,9.1
36440, 영광군,102,15세미만,2017,5548,2835,2713,104.5,5544,2833,2711,104.5
36440, 영광군,103,15~64세,2017,30153,16248,13905,116.9,29178,15701,13477,116.5
36440, 영광군,104,65세이상,2017,13969,5637,8332,67.7,13938,5619,8319,67.5
36440, 영광군,086,85세이상,2017,1252,305,947,32.2,1251,304,947,32.1
36440, 영광군,126,평균연령,2017,48.3,45.9,50.7,,48.6,46.2,50.9,
36440, 영광군,127,중위연령,2017,51.4,48.6,54.6,,51.9,49.1,55,
36450, 장성군,000,합계,2017,41663,20843,20820,100.1,40327,20007,20320,98.5
36450, 장성군,005,0~4세,2017,1616,814,802,101.5,1615,813,802,101.4
36450, 장성군,005001, 0세,2017,307,152,155,98.1,306,151,155,97.4
36450, 장성군,005002, 1세,2017,350,173,177,97.7,350,173,177,97.7
36450, 장성군,005003, 2세,2017,351,173,178,97.2,351,173,178,97.2
36450, 장성군,005004, 3세,2017,301,164,137,119.7,301,164,137,119.7
36450, 장성군,005005, 4세,2017,307,152,155,98.1,307,152,155,98.1
36450, 장성군,010,5~9세,2017,1566,819,747,109.6,1564,818,746,109.7
36450, 장성군,010001, 5세,2017,310,150,160,93.8,310,150,160,93.8
36450, 장성군,010002, 6세,2017,341,180,161,111.8,341,180,161,111.8
36450, 장성군,010003, 7세,2017,329,188,141,133.3,328,187,141,132.6
36450, 장성군,010004, 8세,2017,276,138,138,100,276,138,138,100
36450, 장성군,010005, 9세,2017,310,163,147,110.9,309,163,146,111.6
36450, 장성군,015,10~14세,2017,1476,762,714,106.7,1474,762,712,107
36450, 장성군,015001, 10세,2017,314,159,155,102.6,314,159,155,102.6
36450, 장성군,015002, 11세,2017,269,144,125,115.2,269,144,125,115.2
36450, 장성군,015003, 12세,2017,289,148,141,105,288,148,140,105.7
36450, 장성군,015004, 13세,2017,300,162,138,117.4,300,162,138,117.4
36450, 장성군,015005, 14세,2017,304,149,155,96.1,303,149,154,96.8
36450, 장성군,020,15~19세,2017,2275,1204,1071,112.4,2266,1199,1067,112.4
36450, 장성군,020001, 15세,2017,341,183,158,115.8,340,182,158,115.2
36450, 장성군,020002, 16세,2017,506,263,243,108.2,505,263,242,108.7
36450, 장성군,020003, 17세,2017,692,357,335,106.6,691,356,335,106.3
36450, 장성군,020004, 18세,2017,493,255,238,107.1,490,253,237,106.8
36450, 장성군,020005, 19세,2017,243,146,97,150.5,240,145,95,152.6
36450, 장성군,025,20~24세,2017,1761,1052,709,148.4,1567,935,632,147.9
36450, 장성군,025001, 20세,2017,360,237,123,192.7,351,230,121,190.1
36450, 장성군,025002, 21세,2017,342,230,112,205.4,318,213,105,202.9
36450, 장성군,025003, 22세,2017,358,206,152,135.5,313,182,131,138.9
36450, 장성군,025004, 23세,2017,340,180,160,112.5,292,151,141,107.1
36450, 장성군,025005, 24세,2017,361,199,162,122.8,293,159,134,118.7
36450, 장성군,030,25~29세,2017,1952,1082,870,124.4,1637,865,772,112
36450, 장성군,030001, 25세,2017,383,207,176,117.6,314,163,151,107.9
36450, 장성군,030002, 26세,2017,439,240,199,120.6,369,190,179,106.1
36450, 장성군,030003, 27세,2017,425,240,185,129.7,353,193,160,120.6
36450, 장성군,030004, 28세,2017,357,199,158,125.9,296,154,142,108.5
36450, 장성군,030005, 29세,2017,348,196,152,128.9,305,165,140,117.9
36450, 장성군,035,30~34세,2017,1888,1028,860,119.5,1637,861,776,111
36450, 장성군,035001, 30세,2017,300,163,137,119,255,132,123,107.3
36450, 장성군,035002, 31세,2017,386,201,185,108.6,329,164,165,99.4
36450, 장성군,035003, 32세,2017,337,174,163,106.7,296,146,150,97.3
36450, 장성군,035004, 33세,2017,388,224,164,136.6,338,199,139,143.2
36450, 장성군,035005, 34세,2017,477,266,211,126.1,419,220,199,110.6
36450, 장성군,040,35~39세,2017,2402,1336,1066,125.3,2245,1228,1017,120.7
36450, 장성군,040001, 35세,2017,488,263,225,116.9,451,243,208,116.8
36450, 장성군,040002, 36세,2017,463,256,207,123.7,428,230,198,116.2
36450, 장성군,040003, 37세,2017,521,285,236,120.8,490,263,227,115.9
36450, 장성군,040004, 38세,2017,473,274,199,137.7,444,251,193,130.1
36450, 장성군,040005, 39세,2017,457,258,199,129.6,432,241,191,126.2
36450, 장성군,045,40~44세,2017,2394,1359,1035,131.3,2262,1269,993,127.8
36450, 장성군,045001, 40세,2017,471,266,205,129.8,437,240,197,121.8
36450, 장성군,045002, 41세,2017,440,267,173,154.3,419,252,167,150.9
36450, 장성군,045003, 42세,2017,443,245,198,123.7,421,228,193,118.1
36450, 장성군,045004, 43세,2017,489,266,223,119.3,466,251,215,116.7
36450, 장성군,045005, 44세,2017,551,315,236,133.5,519,298,221,134.8
36450, 장성군,050,45~49세,2017,2894,1646,1248,131.9,2811,1599,1212,131.9
36450, 장성군,050001, 45세,2017,554,314,240,130.8,532,300,232,129.3
36450, 장성군,050002, 46세,2017,598,344,254,135.4,585,335,250,134
36450, 장성군,050003, 47세,2017,580,325,255,127.5,560,314,246,127.6
36450, 장성군,050004, 48세,2017,558,325,233,139.5,545,319,226,141.2
36450, 장성군,050005, 49세,2017,604,338,266,127.1,589,331,258,128.3
36450, 장성군,055,50~54세,2017,3110,1692,1418,119.3,3036,1665,1371,121.4
36450, 장성군,055001, 50세,2017,561,316,245,129,549,313,236,132.6
36450, 장성군,055002, 51세,2017,613,343,270,127,607,341,266,128.2
36450, 장성군,055003, 52세,2017,624,337,287,117.4,601,329,272,121
36450, 장성군,055004, 53세,2017,610,326,284,114.8,597,322,275,117.1
36450, 장성군,055005, 54세,2017,702,370,332,111.4,682,360,322,111.8
36450, 장성군,060,55~59세,2017,3530,1813,1717,105.6,3470,1787,1683,106.2
36450, 장성군,060001, 55세,2017,632,326,306,106.5,620,320,300,106.7
36450, 장성군,060002, 56세,2017,759,407,352,115.6,744,399,345,115.7
36450, 장성군,060003, 57세,2017,832,430,402,107,819,423,396,106.8
36450, 장성군,060004, 58세,2017,664,333,331,100.6,653,331,322,102.8
36450, 장성군,060005, 59세,2017,643,317,326,97.2,634,314,320,98.1
36450, 장성군,065,60~64세,2017,3011,1540,1471,104.7,2977,1525,1452,105
36450, 장성군,065001, 60세,2017,687,370,317,116.7,676,363,313,116
36450, 장성군,065002, 61세,2017,588,308,280,110,582,307,275,111.6
36450, 장성군,065003, 62세,2017,703,351,352,99.7,694,348,346,100.6
36450, 장성군,065004, 63세,2017,486,238,248,96,484,237,247,96
36450, 장성군,065005, 64세,2017,547,273,274,99.6,541,270,271,99.6
36450, 장성군,070,65~69세,2017,2892,1333,1559,85.5,2881,1327,1554,85.4
36450, 장성군,070001, 65세,2017,618,291,327,89,615,288,327,88.1
36450, 장성군,070002, 66세,2017,506,234,272,86,503,233,270,86.3
36450, 장성군,070003, 67세,2017,572,252,320,78.8,568,250,318,78.6
36450, 장성군,070004, 68세,2017,595,287,308,93.2,594,287,307,93.5
36450, 장성군,070005, 69세,2017,601,269,332,81,601,269,332,81
36450, 장성군,075,70~74세,2017,2618,1146,1472,77.9,2614,1143,1471,77.7
36450, 장성군,075001, 70세,2017,584,276,308,89.6,584,276,308,89.6
36450, 장성군,075002, 71세,2017,502,232,270,85.9,501,231,270,85.6
36450, 장성군,075003, 72세,2017,463,204,259,78.8,461,203,258,78.7
36450, 장성군,075004, 73세,2017,495,202,293,68.9,495,202,293,68.9
36450, 장성군,075005, 74세,2017,574,232,342,67.8,573,231,342,67.5
36450, 장성군,080,75~79세,2017,3095,1240,1855,66.8,3092,1238,1854,66.8
36450, 장성군,080001, 75세,2017,765,322,443,72.7,764,321,443,72.5
36450, 장성군,080002, 76세,2017,661,295,366,80.6,661,295,366,80.6
36450, 장성군,080003, 77세,2017,580,222,358,62,580,222,358,62
36450, 장성군,080004, 78세,2017,550,200,350,57.1,549,200,349,57.3
36450, 장성군,080005, 79세,2017,539,201,338,59.5,538,200,338,59.2
36450, 장성군,085,80~84세,2017,2040,688,1352,50.9,2038,686,1352,50.7
36450, 장성군,085001, 80세,2017,479,170,309,55,478,169,309,54.7
36450, 장성군,085002, 81세,2017,413,152,261,58.2,413,152,261,58.2
36450, 장성군,085003, 82세,2017,460,153,307,49.8,460,153,307,49.8
36450, 장성군,085004, 83세,2017,390,122,268,45.5,390,122,268,45.5
36450, 장성군,085005, 84세,2017,298,91,207,44,297,90,207,43.5
36450, 장성군,090,85~89세,2017,827,220,607,36.2,825,218,607,35.9
36450, 장성군,090001, 85세,2017,204,61,143,42.7,204,61,143,42.7
36450, 장성군,090002, 86세,2017,186,47,139,33.8,186,47,139,33.8
36450, 장성군,090003, 87세,2017,179,48,131,36.6,179,48,131,36.6
36450, 장성군,090004, 88세,2017,139,32,107,29.9,138,31,107,29
36450, 장성군,090005, 89세,2017,119,32,87,36.8,118,31,87,35.6
36450, 장성군,095,90~94세,2017,254,63,191,33,254,63,191,33
36450, 장성군,095001, 90세,2017,87,18,69,26.1,87,18,69,26.1
36450, 장성군,095002, 91세,2017,60,14,46,30.4,60,14,46,30.4
36450, 장성군,095003, 92세,2017,48,14,34,41.2,48,14,34,41.2
36450, 장성군,095004, 93세,2017,30,12,18,66.7,30,12,18,66.7
36450, 장성군,095005, 94세,2017,29,5,24,20.8,29,5,24,20.8
36450, 장성군,100,95~99세,2017,55,5,50,10,55,5,50,10
36450, 장성군,100001, 95세,2017,22,X,20,10,22,X,20,10
36450, 장성군,100002, 96세,2017,12,X,10,20,12,X,10,20
36450, 장성군,100003, 97세,2017,5,X,X,25,5,X,X,25
36450, 장성군,100004, 98세,2017,8,X,8,0,8,X,8,0
36450, 장성군,100005, 99세,2017,8,X,8,0,8,X,8,0
36450, 장성군,101,100세이상,2017,7,X,6,16.7,7,X,6,16.7
36450, 장성군,102,15세미만,2017,4658,2395,2263,105.8,4653,2393,2260,105.9
36450, 장성군,103,15~64세,2017,25217,13752,11465,119.9,23908,12933,10975,117.8
36450, 장성군,104,65세이상,2017,11788,4696,7092,66.2,11766,4681,7085,66.1
36450, 장성군,086,85세이상,2017,1143,289,854,33.8,1141,287,854,33.6
36450, 장성군,126,평균연령,2017,48.2,45.7,50.6,,48.6,46.1,51,
36450, 장성군,127,중위연령,2017,51.1,47.9,54.6,,51.9,49,55.2,
36460, 완도군,000,합계,2017,48332,24865,23467,106,46315,23298,23017,101.2
36460, 완도군,005,0~4세,2017,1731,901,830,108.6,1728,899,829,108.4
36460, 완도군,005001, 0세,2017,321,170,151,112.6,320,169,151,111.9
36460, 완도군,005002, 1세,2017,354,189,165,114.5,354,189,165,114.5
36460, 완도군,005003, 2세,2017,324,175,149,117.4,323,174,149,116.8
36460, 완도군,005004, 3세,2017,378,190,188,101.1,378,190,188,101.1
36460, 완도군,005005, 4세,2017,354,177,177,100,353,177,176,100.6
36460, 완도군,010,5~9세,2017,1724,897,827,108.5,1722,896,826,108.5
36460, 완도군,010001, 5세,2017,403,203,200,101.5,402,203,199,102
36460, 완도군,010002, 6세,2017,364,199,165,120.6,364,199,165,120.6
36460, 완도군,010003, 7세,2017,355,172,183,94,355,172,183,94
36460, 완도군,010004, 8세,2017,288,148,140,105.7,288,148,140,105.7
36460, 완도군,010005, 9세,2017,314,175,139,125.9,313,174,139,125.2
36460, 완도군,015,10~14세,2017,1684,864,820,105.4,1683,864,819,105.5
36460, 완도군,015001, 10세,2017,340,166,174,95.4,340,166,174,95.4
36460, 완도군,015002, 11세,2017,352,184,168,109.5,352,184,168,109.5
36460, 완도군,015003, 12세,2017,323,166,157,105.7,323,166,157,105.7
36460, 완도군,015004, 13세,2017,361,186,175,106.3,361,186,175,106.3
36460, 완도군,015005, 14세,2017,308,162,146,111,307,162,145,111.7
36460, 완도군,020,15~19세,2017,1746,981,765,128.2,1738,977,761,128.4
36460, 완도군,020001, 15세,2017,342,173,169,102.4,342,173,169,102.4
36460, 완도군,020002, 16세,2017,413,229,184,124.5,413,229,184,124.5
36460, 완도군,020003, 17세,2017,441,248,193,128.5,440,248,192,129.2
36460, 완도군,020004, 18세,2017,350,207,143,144.8,344,203,141,144
36460, 완도군,020005, 19세,2017,200,124,76,163.2,199,124,75,165.3
36460, 완도군,025,20~24세,2017,1623,1109,514,215.8,1312,852,460,185.2
36460, 완도군,025001, 20세,2017,274,196,78,251.3,259,190,69,275.4
36460, 완도군,025002, 21세,2017,309,243,66,368.2,282,226,56,403.6
36460, 완도군,025003, 22세,2017,321,220,101,217.8,256,163,93,175.3
36460, 완도군,025004, 23세,2017,368,237,131,180.9,268,150,118,127.1
36460, 완도군,025005, 24세,2017,351,213,138,154.3,247,123,124,99.2
36460, 완도군,030,25~29세,2017,2028,1245,783,159,1409,727,682,106.6
36460, 완도군,030001, 25세,2017,391,235,156,150.6,264,127,137,92.7
36460, 완도군,030002, 26세,2017,417,262,155,169,264,133,131,101.5
36460, 완도군,030003, 27세,2017,404,269,135,199.3,284,167,117,142.7
36460, 완도군,030004, 28세,2017,425,256,169,151.5,291,145,146,99.3
36460, 완도군,030005, 29세,2017,391,223,168,132.7,306,155,151,102.6
36460, 완도군,035,30~34세,2017,2303,1371,932,147.1,1917,1040,877,118.6
36460, 완도군,035001, 30세,2017,404,243,161,150.9,317,171,146,117.1
36460, 완도군,035002, 31세,2017,446,263,183,143.7,363,191,172,111
36460, 완도군,035003, 32세,2017,462,267,195,136.9,384,205,179,114.5
36460, 완도군,035004, 33세,2017,464,284,180,157.8,392,219,173,126.6
36460, 완도군,035005, 34세,2017,527,314,213,147.4,461,254,207,122.7
36460, 완도군,040,35~39세,2017,2803,1644,1159,141.8,2539,1420,1119,126.9
36460, 완도군,040001, 35세,2017,568,339,229,148,506,286,220,130
36460, 완도군,040002, 36세,2017,555,342,213,160.6,487,283,204,138.7
36460, 완도군,040003, 37세,2017,598,344,254,135.4,541,296,245,120.8
36460, 완도군,040004, 38세,2017,567,311,256,121.5,524,278,246,113
36460, 완도군,040005, 39세,2017,515,308,207,148.8,481,277,204,135.8
36460, 완도군,045,40~44세,2017,2836,1704,1132,150.5,2718,1619,1099,147.3
36460, 완도군,045001, 40세,2017,555,346,209,165.6,518,320,198,161.6
36460, 완도군,045002, 41세,2017,529,322,207,155.6,500,302,198,152.5
36460, 완도군,045003, 42세,2017,519,318,201,158.2,501,305,196,155.6
36460, 완도군,045004, 43세,2017,617,370,247,149.8,595,351,244,143.9
36460, 완도군,045005, 44세,2017,616,348,268,129.9,604,341,263,129.7
36460, 완도군,050,45~49세,2017,3380,1972,1408,140.1,3291,1927,1364,141.3
36460, 완도군,050001, 45세,2017,658,362,296,122.3,643,356,287,124
36460, 완도군,050002, 46세,2017,664,397,267,148.7,651,389,262,148.5
36460, 완도군,050003, 47세,2017,670,389,281,138.4,652,379,273,138.8
36460, 완도군,050004, 48세,2017,667,392,275,142.5,647,382,265,144.2
36460, 완도군,050005, 49세,2017,721,432,289,149.5,698,421,277,152
36460, 완도군,055,50~54세,2017,3540,1924,1616,119.1,3456,1882,1574,119.6
36460, 완도군,055001, 50세,2017,665,366,299,122.4,652,357,295,121
36460, 완도군,055002, 51세,2017,688,407,281,144.8,674,401,273,146.9
36460, 완도군,055003, 52세,2017,673,349,324,107.7,651,341,310,110
36460, 완도군,055004, 53세,2017,714,373,341,109.4,700,366,334,109.6
36460, 완도군,055005, 54세,2017,800,429,371,115.6,779,417,362,115.2
36460, 완도군,060,55~59세,2017,4487,2222,2265,98.1,4418,2196,2222,98.8
36460, 완도군,060001, 55세,2017,863,437,426,102.6,840,427,413,103.4
36460, 완도군,060002, 56세,2017,861,432,429,100.7,849,428,421,101.7
36460, 완도군,060003, 57세,2017,1063,522,541,96.5,1045,515,530,97.2
36460, 완도군,060004, 58세,2017,889,437,452,96.7,879,435,444,98
36460, 완도군,060005, 59세,2017,811,394,417,94.5,805,391,414,94.4
36460, 완도군,065,60~64세,2017,3813,1926,1887,102.1,3780,1907,1873,101.8
36460, 완도군,065001, 60세,2017,848,430,418,102.9,837,422,415,101.7
36460, 완도군,065002, 61세,2017,834,449,385,116.6,826,442,384,115.1
36460, 완도군,065003, 62세,2017,889,439,450,97.6,883,437,446,98
36460, 완도군,065004, 63세,2017,665,330,335,98.5,662,329,333,98.8
36460, 완도군,065005, 64세,2017,577,278,299,93,572,277,295,93.9
36460, 완도군,070,65~69세,2017,3694,1810,1884,96.1,3675,1801,1874,96.1
36460, 완도군,070001, 65세,2017,734,356,378,94.2,731,356,375,94.9
36460, 완도군,070002, 66세,2017,763,388,375,103.5,757,385,372,103.5
36460, 완도군,070003, 67세,2017,734,342,392,87.2,727,339,388,87.4
36460, 완도군,070004, 68세,2017,731,374,357,104.8,729,372,357,104.2
36460, 완도군,070005, 69세,2017,732,350,382,91.6,731,349,382,91.4
36460, 완도군,075,70~74세,2017,3531,1613,1918,84.1,3526,1610,1916,84
36460, 완도군,075001, 70세,2017,808,380,428,88.8,807,379,428,88.6
36460, 완도군,075002, 71세,2017,594,291,303,96,591,290,301,96.3
36460, 완도군,075003, 72세,2017,754,337,417,80.8,754,337,417,80.8
36460, 완도군,075004, 73세,2017,693,316,377,83.8,693,316,377,83.8
36460, 완도군,075005, 74세,2017,682,289,393,73.5,681,288,393,73.3
36460, 완도군,080,75~79세,2017,3804,1588,2216,71.7,3801,1587,2214,71.7
36460, 완도군,080001, 75세,2017,913,424,489,86.7,912,424,488,86.9
36460, 완도군,080002, 76세,2017,768,324,444,73,768,324,444,73
36460, 완도군,080003, 77세,2017,749,308,441,69.8,749,308,441,69.8
36460, 완도군,080004, 78세,2017,715,276,439,62.9,715,276,439,62.9
36460, 완도군,080005, 79세,2017,659,256,403,63.5,657,255,402,63.4
36460, 완도군,085,80~84세,2017,2222,765,1457,52.5,2219,765,1454,52.6
36460, 완도군,085001, 80세,2017,570,220,350,62.9,569,220,349,63
36460, 완도군,085002, 81세,2017,490,177,313,56.5,490,177,313,56.5
36460, 완도군,085003, 82세,2017,406,145,261,55.6,406,145,261,55.6
36460, 완도군,085004, 83세,2017,409,116,293,39.6,408,116,292,39.7
36460, 완도군,085005, 84세,2017,347,107,240,44.6,346,107,239,44.8
36460, 완도군,090,85~89세,2017,1049,274,775,35.4,1049,274,775,35.4
36460, 완도군,090001, 85세,2017,316,98,218,45,316,98,218,45
36460, 완도군,090002, 86세,2017,235,65,170,38.2,235,65,170,38.2
36460, 완도군,090003, 87세,2017,222,46,176,26.1,222,46,176,26.1
36460, 완도군,090004, 88세,2017,156,37,119,31.1,156,37,119,31.1
36460, 완도군,090005, 89세,2017,120,28,92,30.4,120,28,92,30.4
36460, 완도군,095,90~94세,2017,253,46,207,22.2,253,46,207,22.2
36460, 완도군,095001, 90세,2017,83,14,69,20.3,83,14,69,20.3
36460, 완도군,095002, 91세,2017,60,16,44,36.4,60,16,44,36.4
36460, 완도군,095003, 92세,2017,41,7,34,20.6,41,7,34,20.6
36460, 완도군,095004, 93세,2017,30,6,24,25,30,6,24,25
36460, 완도군,095005, 94세,2017,39,X,36,8.3,39,X,36,8.3
36460, 완도군,100,95~99세,2017,74,8,66,12.1,74,8,66,12.1
36460, 완도군,100001, 95세,2017,31,X,27,14.8,31,X,27,14.8
36460, 완도군,100002, 96세,2017,20,X,17,17.6,20,X,17,17.6
36460, 완도군,100003, 97세,2017,14,X,13,7.7,14,X,13,7.7
36460, 완도군,100004, 98세,2017,7,X,7,0,7,X,7,0
36460, 완도군,100005, 99세,2017,X,X,X,0,X,X,X,0
36460, 완도군,101,100세이상,2017,7,X,6,16.7,7,X,6,16.7
36460, 완도군,102,15세미만,2017,5139,2662,2477,107.5,5133,2659,2474,107.5
36460, 완도군,103,15~64세,2017,28559,16098,12461,129.2,26578,14547,12031,120.9
36460, 완도군,104,65세이상,2017,14634,6105,8529,71.6,14604,6092,8512,71.6
36460, 완도군,086,85세이상,2017,1383,329,1054,31.2,1383,329,1054,31.2
36460, 완도군,126,평균연령,2017,49.8,47.1,52.8,,50.5,48.1,53,
36460, 완도군,127,중위연령,2017,53.4,49.4,57.2,,54.5,51.2,57.5,
36470, 진도군,000,합계,2017,29432,14921,14511,102.8,28042,13793,14249,96.8
36470, 진도군,005,0~4세,2017,921,440,481,91.5,919,440,479,91.9
36470, 진도군,005001, 0세,2017,179,64,115,55.7,179,64,115,55.7
36470, 진도군,005002, 1세,2017,170,83,87,95.4,170,83,87,95.4
36470, 진도군,005003, 2세,2017,200,105,95,110.5,200,105,95,110.5
36470, 진도군,005004, 3세,2017,176,95,81,117.3,175,95,80,118.8
36470, 진도군,005005, 4세,2017,196,93,103,90.3,195,93,102,91.2
36470, 진도군,010,5~9세,2017,971,504,467,107.9,971,504,467,107.9
36470, 진도군,010001, 5세,2017,207,116,91,127.5,207,116,91,127.5
36470, 진도군,010002, 6세,2017,235,104,131,79.4,235,104,131,79.4
36470, 진도군,010003, 7세,2017,157,90,67,134.3,157,90,67,134.3
36470, 진도군,010004, 8세,2017,198,105,93,112.9,198,105,93,112.9
36470, 진도군,010005, 9세,2017,174,89,85,104.7,174,89,85,104.7
36470, 진도군,015,10~14세,2017,974,483,491,98.4,974,483,491,98.4
36470, 진도군,015001, 10세,2017,230,114,116,98.3,230,114,116,98.3
36470, 진도군,015002, 11세,2017,180,94,86,109.3,180,94,86,109.3
36470, 진도군,015003, 12세,2017,176,94,82,114.6,176,94,82,114.6
36470, 진도군,015004, 13세,2017,177,82,95,86.3,177,82,95,86.3
36470, 진도군,015005, 14세,2017,211,99,112,88.4,211,99,112,88.4
36470, 진도군,020,15~19세,2017,1097,601,496,121.2,1092,599,493,121.5
36470, 진도군,020001, 15세,2017,237,132,105,125.7,237,132,105,125.7
36470, 진도군,020002, 16세,2017,259,127,132,96.2,259,127,132,96.2
36470, 진도군,020003, 17세,2017,238,131,107,122.4,238,131,107,122.4
36470, 진도군,020004, 18세,2017,234,130,104,125,233,129,104,124
36470, 진도군,020005, 19세,2017,129,81,48,168.8,125,80,45,177.8
36470, 진도군,025,20~24세,2017,1100,785,315,249.2,833,552,281,196.4
36470, 진도군,025001, 20세,2017,175,133,42,316.7,168,128,40,320
36470, 진도군,025002, 21세,2017,229,173,56,308.9,194,147,47,312.8
36470, 진도군,025003, 22세,2017,211,149,62,240.3,159,104,55,189.1
36470, 진도군,025004, 23세,2017,234,161,73,220.5,153,88,65,135.4
36470, 진도군,025005, 24세,2017,251,169,82,206.1,159,85,74,114.9
36470, 진도군,030,25~29세,2017,1378,912,466,195.7,895,481,414,116.2
36470, 진도군,030001, 25세,2017,308,191,117,163.2,209,106,103,102.9
36470, 진도군,030002, 26세,2017,263,179,84,213.1,160,86,74,116.2
36470, 진도군,030003, 27세,2017,293,207,86,240.7,181,106,75,141.3
36470, 진도군,030004, 28세,2017,271,177,94,188.3,176,95,81,117.3
36470, 진도군,030005, 29세,2017,243,158,85,185.9,169,88,81,108.6
36470, 진도군,035,30~34세,2017,1280,766,514,149,1002,539,463,116.4
36470, 진도군,035001, 30세,2017,270,157,113,138.9,193,100,93,107.5
36470, 진도군,035002, 31세,2017,247,146,101,144.6,187,95,92,103.3
36470, 진도군,035003, 32세,2017,238,140,98,142.9,184,97,87,111.5
36470, 진도군,035004, 33세,2017,260,161,99,162.6,221,125,96,130.2
36470, 진도군,035005, 34세,2017,265,162,103,157.3,217,122,95,128.4
36470, 진도군,040,35~39세,2017,1416,830,586,141.6,1281,718,563,127.5
36470, 진도군,040001, 35세,2017,291,181,110,164.5,248,146,102,143.1
36470, 진도군,040002, 36세,2017,264,169,95,177.9,238,147,91,161.5
36470, 진도군,040003, 37세,2017,317,175,142,123.2,292,156,136,114.7
36470, 진도군,040004, 38세,2017,268,145,123,117.9,251,130,121,107.4
36470, 진도군,040005, 39세,2017,276,160,116,137.9,252,139,113,123
36470, 진도군,045,40~44세,2017,1626,937,689,136,1567,899,668,134.6
36470, 진도군,045001, 40세,2017,304,174,130,133.8,295,168,127,132.3
36470, 진도군,045002, 41세,2017,287,165,122,135.2,273,154,119,129.4
36470, 진도군,045003, 42세,2017,336,208,128,162.5,320,198,122,162.3
36470, 진도군,045004, 43세,2017,340,183,157,116.6,329,177,152,116.4
36470, 진도군,045005, 44세,2017,359,207,152,136.2,350,202,148,136.5
36470, 진도군,050,45~49세,2017,1961,1132,829,136.6,1912,1102,810,136
36470, 진도군,050001, 45세,2017,376,217,159,136.5,363,210,153,137.3
36470, 진도군,050002, 46세,2017,380,227,153,148.4,363,216,147,146.9
36470, 진도군,050003, 47세,2017,364,215,149,144.3,361,212,149,142.3
36470, 진도군,050004, 48세,2017,401,237,164,144.5,395,235,160,146.9
36470, 진도군,050005, 49세,2017,440,236,204,115.7,430,229,201,113.9
36470, 진도군,055,50~54세,2017,2218,1225,993,123.4,2172,1203,969,124.1
36470, 진도군,055001, 50세,2017,370,197,173,113.9,362,194,168,115.5
36470, 진도군,055002, 51세,2017,503,300,203,147.8,493,295,198,149
36470, 진도군,055003, 52세,2017,453,245,208,117.8,446,241,205,117.6
36470, 진도군,055004, 53세,2017,464,254,210,121,453,248,205,121
36470, 진도군,055005, 54세,2017,428,229,199,115.1,418,225,193,116.6
36470, 진도군,060,55~59세,2017,2724,1388,1336,103.9,2696,1372,1324,103.6
36470, 진도군,060001, 55세,2017,501,268,233,115,496,265,231,114.7
36470, 진도군,060002, 56세,2017,565,290,275,105.5,557,285,272,104.8
36470, 진도군,060003, 57세,2017,637,308,329,93.6,632,305,327,93.3
36470, 진도군,060004, 58세,2017,506,255,251,101.6,502,252,250,100.8
36470, 진도군,060005, 59세,2017,515,267,248,107.7,509,265,244,108.6
36470, 진도군,065,60~64세,2017,2271,1172,1099,106.6,2249,1160,1089,106.5
36470, 진도군,065001, 60세,2017,514,275,239,115.1,508,274,234,117.1
36470, 진도군,065002, 61세,2017,529,291,238,122.3,527,290,237,122.4
36470, 진도군,065003, 62세,2017,485,250,235,106.4,480,248,232,106.9
36470, 진도군,065004, 63세,2017,362,181,181,100,359,179,180,99.4
36470, 진도군,065005, 64세,2017,381,175,206,85,375,169,206,82
36470, 진도군,070,65~69세,2017,2289,1122,1167,96.1,2274,1117,1157,96.5
36470, 진도군,070001, 65세,2017,465,225,240,93.8,462,224,238,94.1
36470, 진도군,070002, 66세,2017,423,196,227,86.3,421,195,226,86.3
36470, 진도군,070003, 67세,2017,486,245,241,101.7,482,245,237,103.4
36470, 진도군,070004, 68세,2017,451,238,213,111.7,447,236,211,111.8
36470, 진도군,070005, 69세,2017,464,218,246,88.6,462,217,245,88.6
36470, 진도군,075,70~74세,2017,2193,982,1211,81.1,2192,982,1210,81.2
36470, 진도군,075001, 70세,2017,496,247,249,99.2,496,247,249,99.2
36470, 진도군,075002, 71세,2017,377,177,200,88.5,377,177,200,88.5
36470, 진도군,075003, 72세,2017,492,212,280,75.7,492,212,280,75.7
36470, 진도군,075004, 73세,2017,399,178,221,80.5,398,178,220,80.9
36470, 진도군,075005, 74세,2017,429,168,261,64.4,429,168,261,64.4
36470, 진도군,080,75~79세,2017,2667,993,1674,59.3,2667,993,1674,59.3
36470, 진도군,080001, 75세,2017,644,239,405,59,644,239,405,59
36470, 진도군,080002, 76세,2017,541,202,339,59.6,541,202,339,59.6
36470, 진도군,080003, 77세,2017,543,218,325,67.1,543,218,325,67.1
36470, 진도군,080004, 78세,2017,472,197,275,71.6,472,197,275,71.6
36470, 진도군,080005, 79세,2017,467,137,330,41.5,467,137,330,41.5
36470, 진도군,085,80~84세,2017,1439,439,1000,43.9,1439,439,1000,43.9
36470, 진도군,085001, 80세,2017,336,120,216,55.6,336,120,216,55.6
36470, 진도군,085002, 81세,2017,317,105,212,49.5,317,105,212,49.5
36470, 진도군,085003, 82세,2017,297,93,204,45.6,297,93,204,45.6
36470, 진도군,085004, 83세,2017,270,77,193,39.9,270,77,193,39.9
36470, 진도군,085005, 84세,2017,219,44,175,25.1,219,44,175,25.1
36470, 진도군,090,85~89세,2017,692,166,526,31.6,692,166,526,31.6
36470, 진도군,090001, 85세,2017,190,43,147,29.3,190,43,147,29.3
36470, 진도군,090002, 86세,2017,146,39,107,36.4,146,39,107,36.4
36470, 진도군,090003, 87세,2017,160,33,127,26,160,33,127,26
36470, 진도군,090004, 88세,2017,101,23,78,29.5,101,23,78,29.5
36470, 진도군,090005, 89세,2017,95,28,67,41.8,95,28,67,41.8
36470, 진도군,095,90~94세,2017,170,36,134,26.9,170,36,134,26.9
36470, 진도군,095001, 90세,2017,61,15,46,32.6,61,15,46,32.6
36470, 진도군,095002, 91세,2017,37,7,30,23.3,37,7,30,23.3
36470, 진도군,095003, 92세,2017,36,7,29,24.1,36,7,29,24.1
36470, 진도군,095004, 93세,2017,16,X,14,14.3,16,X,14,14.3
36470, 진도군,095005, 94세,2017,20,5,15,33.3,20,5,15,33.3
36470, 진도군,100,95~99세,2017,41,7,34,20.6,41,7,34,20.6
36470, 진도군,100001, 95세,2017,17,X,13,30.8,17,X,13,30.8
36470, 진도군,100002, 96세,2017,7,X,6,16.7,7,X,6,16.7
36470, 진도군,100003, 97세,2017,10,X,9,11.1,10,X,9,11.1
36470, 진도군,100004, 98세,2017,6,X,5,20,6,X,5,20
36470, 진도군,100005, 99세,2017,X,X,X,0,X,X,X,0
36470, 진도군,101,100세이상,2017,X,X,X,33.3,X,X,X,33.3
36470, 진도군,102,15세미만,2017,2866,1427,1439,99.2,2864,1427,1437,99.3
36470, 진도군,103,15~64세,2017,17071,9748,7323,133.1,15699,8625,7074,121.9
36470, 진도군,104,65세이상,2017,9495,3746,5749,65.2,9479,3741,5738,65.2
36470, 진도군,086,85세이상,2017,907,210,697,30.1,907,210,697,30.1
36470, 진도군,126,평균연령,2017,50.7,47.5,54.1,,51.7,48.9,54.4,
36470, 진도군,127,중위연령,2017,54.5,50.4,58.4,,55.8,52.4,58.8,
36480, 신안군,000,합계,2017,35592,18650,16942,110.1,34705,18057,16648,108.5
36480, 신안군,005,0~4세,2017,974,509,465,109.5,973,508,465,109.2
36480, 신안군,005001, 0세,2017,192,98,94,104.3,192,98,94,104.3
36480, 신안군,005002, 1세,2017,197,102,95,107.4,197,102,95,107.4
36480, 신안군,005003, 2세,2017,188,105,83,126.5,187,104,83,125.3
36480, 신안군,005004, 3세,2017,185,97,88,110.2,185,97,88,110.2
36480, 신안군,005005, 4세,2017,212,107,105,101.9,212,107,105,101.9
36480, 신안군,010,5~9세,2017,891,427,464,92,891,427,464,92
36480, 신안군,010001, 5세,2017,216,101,115,87.8,216,101,115,87.8
36480, 신안군,010002, 6세,2017,204,107,97,110.3,204,107,97,110.3
36480, 신안군,010003, 7세,2017,141,63,78,80.8,141,63,78,80.8
36480, 신안군,010004, 8세,2017,161,75,86,87.2,161,75,86,87.2
36480, 신안군,010005, 9세,2017,169,81,88,92,169,81,88,92
36480, 신안군,015,10~14세,2017,723,380,343,110.8,723,380,343,110.8
36480, 신안군,015001, 10세,2017,141,73,68,107.4,141,73,68,107.4
36480, 신안군,015002, 11세,2017,134,69,65,106.2,134,69,65,106.2
36480, 신안군,015003, 12세,2017,129,65,64,101.6,129,65,64,101.6
36480, 신안군,015004, 13세,2017,151,80,71,112.7,151,80,71,112.7
36480, 신안군,015005, 14세,2017,168,93,75,124,168,93,75,124
36480, 신안군,020,15~19세,2017,1081,600,481,124.7,1074,597,477,125.2
36480, 신안군,020001, 15세,2017,198,117,81,144.4,198,117,81,144.4
36480, 신안군,020002, 16세,2017,246,132,114,115.8,246,132,114,115.8
36480, 신안군,020003, 17세,2017,278,142,136,104.4,277,141,136,103.7
36480, 신안군,020004, 18세,2017,219,112,107,104.7,218,112,106,105.7
36480, 신안군,020005, 19세,2017,140,97,43,225.6,135,95,40,237.5
36480, 신안군,025,20~24세,2017,1109,747,362,206.4,983,653,330,197.9
36480, 신안군,025001, 20세,2017,206,163,43,379.1,199,159,40,397.5
36480, 신안군,025002, 21세,2017,237,192,45,426.7,220,180,40,450
36480, 신안군,025003, 22세,2017,224,147,77,190.9,195,125,70,178.6
36480, 신안군,025004, 23세,2017,216,129,87,148.3,179,97,82,118.3
36480, 신안군,025005, 24세,2017,226,116,110,105.5,190,92,98,93.9
36480, 신안군,030,25~29세,2017,1497,900,597,150.8,1243,715,528,135.4
36480, 신안군,030001, 25세,2017,273,151,122,123.8,225,115,110,104.5
36480, 신안군,030002, 26세,2017,307,184,123,149.6,254,139,115,120.9
36480, 신안군,030003, 27세,2017,294,187,107,174.8,246,153,93,164.5
36480, 신안군,030004, 28세,2017,317,192,125,153.6,259,155,104,149
36480, 신안군,030005, 29세,2017,306,186,120,155,259,153,106,144.3
36480, 신안군,035,30~34세,2017,1447,887,560,158.4,1269,757,512,147.9
36480, 신안군,035001, 30세,2017,301,184,117,157.3,254,146,108,135.2
36480, 신안군,035002, 31세,2017,269,173,96,180.2,229,148,81,182.7
36480, 신안군,035003, 32세,2017,264,166,98,169.4,227,142,85,167.1
36480, 신안군,035004, 33세,2017,287,172,115,149.6,259,151,108,139.8
36480, 신안군,035005, 34세,2017,326,192,134,143.3,300,170,130,130.8
36480, 신안군,040,35~39세,2017,1603,1022,581,175.9,1477,939,538,174.5
36480, 신안군,040001, 35세,2017,350,226,124,182.3,314,203,111,182.9
36480, 신안군,040002, 36세,2017,287,187,100,187,263,171,92,185.9
36480, 신안군,040003, 37세,2017,318,198,120,165,300,185,115,160.9
36480, 신안군,040004, 38세,2017,332,204,128,159.4,306,185,121,152.9
36480, 신안군,040005, 39세,2017,316,207,109,189.9,294,195,99,197
36480, 신안군,045,40~44세,2017,1799,1194,605,197.4,1735,1154,581,198.6
36480, 신안군,045001, 40세,2017,312,205,107,191.6,296,191,105,181.9
36480, 신안군,045002, 41세,2017,324,226,98,230.6,310,220,90,244.4
36480, 신안군,045003, 42세,2017,345,243,102,238.2,332,236,96,245.8
36480, 신안군,045004, 43세,2017,378,244,134,182.1,368,238,130,183.1
36480, 신안군,045005, 44세,2017,440,276,164,168.3,429,269,160,168.1
36480, 신안군,050,45~49세,2017,2323,1488,835,178.2,2290,1472,818,180
36480, 신안군,050001, 45세,2017,411,266,145,183.4,401,261,140,186.4
36480, 신안군,050002, 46세,2017,436,280,156,179.5,431,279,152,183.6
36480, 신안군,050003, 47세,2017,470,304,166,183.1,463,300,163,184
36480, 신안군,050004, 48세,2017,512,333,179,186,505,328,177,185.3
36480, 신안군,050005, 49세,2017,494,305,189,161.4,490,304,186,163.4
36480, 신안군,055,50~54세,2017,2841,1674,1167,143.4,2801,1657,1144,144.8
36480, 신안군,055001, 50세,2017,470,279,191,146.1,462,276,186,148.4
36480, 신안군,055002, 51세,2017,605,353,252,140.1,594,348,246,141.5
36480, 신안군,055003, 52세,2017,579,342,237,144.3,570,339,231,146.8
36480, 신안군,055004, 53세,2017,559,335,224,149.6,553,331,222,149.1
36480, 신안군,055005, 54세,2017,628,365,263,138.8,622,363,259,140.2
36480, 신안군,060,55~59세,2017,3553,1972,1581,124.7,3524,1962,1562,125.6
36480, 신안군,060001, 55세,2017,624,351,273,128.6,618,349,269,129.7
36480, 신안군,060002, 56세,2017,745,408,337,121.1,741,406,335,121.2
36480, 신안군,060003, 57세,2017,802,435,367,118.5,794,431,363,118.7
36480, 신안군,060004, 58세,2017,709,407,302,134.8,703,407,296,137.5
36480, 신안군,060005, 59세,2017,673,371,302,122.8,668,369,299,123.4
36480, 신안군,065,60~64세,2017,3157,1692,1465,115.5,3137,1681,1456,115.5
36480, 신안군,065001, 60세,2017,693,380,313,121.4,689,379,310,122.3
36480, 신안군,065002, 61세,2017,646,346,300,115.3,642,343,299,114.7
36480, 신안군,065003, 62세,2017,703,387,316,122.5,698,384,314,122.3
36480, 신안군,065004, 63세,2017,582,305,277,110.1,578,304,274,110.9
36480, 신안군,065005, 64세,2017,533,274,259,105.8,530,271,259,104.6
36480, 신안군,070,65~69세,2017,3005,1526,1479,103.2,2997,1523,1474,103.3
36480, 신안군,070001, 65세,2017,677,314,363,86.5,674,313,361,86.7
36480, 신안군,070002, 66세,2017,574,304,270,112.6,572,304,268,113.4
36480, 신안군,070003, 67세,2017,572,298,274,108.8,571,297,274,108.4
36480, 신안군,070004, 68세,2017,591,307,284,108.1,589,306,283,108.1
36480, 신안군,070005, 69세,2017,591,303,288,105.2,591,303,288,105.2
36480, 신안군,075,70~74세,2017,3059,1416,1643,86.2,3058,1416,1642,86.2
36480, 신안군,075001, 70세,2017,717,367,350,104.9,717,367,350,104.9
36480, 신안군,075002, 71세,2017,586,291,295,98.6,586,291,295,98.6
36480, 신안군,075003, 72세,2017,582,273,309,88.3,582,273,309,88.3
36480, 신안군,075004, 73세,2017,512,205,307,66.8,512,205,307,66.8
36480, 신안군,075005, 74세,2017,662,280,382,73.3,661,280,381,73.5
36480, 신안군,080,75~79세,2017,3314,1300,2014,64.5,3314,1300,2014,64.5
36480, 신안군,080001, 75세,2017,828,344,484,71.1,828,344,484,71.1
36480, 신안군,080002, 76세,2017,669,276,393,70.2,669,276,393,70.2
36480, 신안군,080003, 77세,2017,625,236,389,60.7,625,236,389,60.7
36480, 신안군,080004, 78세,2017,615,227,388,58.5,615,227,388,58.5
36480, 신안군,080005, 79세,2017,577,217,360,60.3,577,217,360,60.3
36480, 신안군,085,80~84세,2017,2081,645,1436,44.9,2081,645,1436,44.9
36480, 신안군,085001, 80세,2017,547,187,360,51.9,547,187,360,51.9
36480, 신안군,085002, 81세,2017,434,135,299,45.2,434,135,299,45.2
36480, 신안군,085003, 82세,2017,402,118,284,41.5,402,118,284,41.5
36480, 신안군,085004, 83세,2017,387,126,261,48.3,387,126,261,48.3
36480, 신안군,085005, 84세,2017,311,79,232,34.1,311,79,232,34.1
36480, 신안군,090,85~89세,2017,853,195,658,29.6,853,195,658,29.6
36480, 신안군,090001, 85세,2017,237,56,181,30.9,237,56,181,30.9
36480, 신안군,090002, 86세,2017,193,45,148,30.4,193,45,148,30.4
36480, 신안군,090003, 87세,2017,216,47,169,27.8,216,47,169,27.8
36480, 신안군,090004, 88세,2017,113,25,88,28.4,113,25,88,28.4
36480, 신안군,090005, 89세,2017,94,22,72,30.6,94,22,72,30.6
36480, 신안군,095,90~94세,2017,219,67,152,44.1,219,67,152,44.1
36480, 신안군,095001, 90세,2017,81,24,57,42.1,81,24,57,42.1
36480, 신안군,095002, 91세,2017,45,19,26,73.1,45,19,26,73.1
36480, 신안군,095003, 92세,2017,41,13,28,46.4,41,13,28,46.4
36480, 신안군,095004, 93세,2017,20,6,14,42.9,20,6,14,42.9
36480, 신안군,095005, 94세,2017,32,5,27,18.5,32,5,27,18.5
36480, 신안군,100,95~99세,2017,57,6,51,11.8,57,6,51,11.8
36480, 신안군,100001, 95세,2017,30,X,26,15.4,30,X,26,15.4
36480, 신안군,100002, 96세,2017,10,X,9,11.1,10,X,9,11.1
36480, 신안군,100003, 97세,2017,11,X,11,0,11,X,11,0
36480, 신안군,100004, 98세,2017,X,X,X,0,X,X,X,0
36480, 신안군,100005, 99세,2017,X,X,X,50,X,X,X,50
36480, 신안군,101,100세이상,2017,6,X,X,100,6,X,X,100
36480, 신안군,102,15세미만,2017,2588,1316,1272,103.5,2587,1315,1272,103.4
36480, 신안군,103,15~64세,2017,20410,12176,8234,147.9,19533,11587,7946,145.8
36480, 신안군,104,65세이상,2017,12594,5158,7436,69.4,12585,5155,7430,69.4
36480, 신안군,086,85세이상,2017,1135,271,864,31.4,1135,271,864,31.4
36480, 신안군,126,평균연령,2017,53.4,50.4,56.7,,53.9,51,57.1,
36480, 신안군,127,중위연령,2017,57.2,53.6,61.4,,57.7,54.4,61.8,
37,경상북도,000,합계,2017,2677058,1353083,1323975,102.2,2613080,1312917,1300163,101
37,경상북도,005,0~4세,2017,103922,53543,50379,106.3,103305,53221,50084,106.3
37,경상북도,005001, 0세,2017,18177,9353,8824,106,18035,9270,8765,105.8
37,경상북도,005002, 1세,2017,20912,10722,10190,105.2,20773,10658,10115,105.4
37,경상북도,005003, 2세,2017,21904,11232,10672,105.2,21792,11177,10615,105.3
37,경상북도,005004, 3세,2017,21182,11003,10179,108.1,21079,10956,10123,108.2
37,경상북도,005005, 4세,2017,21747,11233,10514,106.8,21626,11160,10466,106.6
37,경상북도,010,5~9세,2017,110300,57359,52941,108.3,109952,57195,52757,108.4
37,경상북도,010001, 5세,2017,23437,12139,11298,107.4,23355,12102,11253,107.5
37,경상북도,010002, 6세,2017,22726,11860,10866,109.1,22651,11828,10823,109.3
37,경상북도,010003, 7세,2017,21402,11019,10383,106.1,21330,10985,10345,106.2
37,경상북도,010004, 8세,2017,20790,10894,9896,110.1,20729,10860,9869,110
37,경상북도,010005, 9세,2017,21945,11447,10498,109,21887,11420,10467,109.1
37,경상북도,015,10~14세,2017,107806,56519,51287,110.2,107592,56409,51183,110.2
37,경상북도,015001, 10세,2017,22299,11541,10758,107.3,22248,11510,10738,107.2
37,경상북도,015002, 11세,2017,20650,10890,9760,111.6,20598,10867,9731,111.7
37,경상북도,015003, 12세,2017,20363,10588,9775,108.3,20318,10565,9753,108.3
37,경상북도,015004, 13세,2017,21947,11639,10308,112.9,21915,11623,10292,112.9
37,경상북도,015005, 14세,2017,22547,11861,10686,111,22513,11844,10669,111
37,경상북도,020,15~19세,2017,149154,80243,68911,116.4,147319,79396,67923,116.9
37,경상북도,020001, 15세,2017,24022,12805,11217,114.2,23987,12783,11204,114.1
37,경상북도,020002, 16세,2017,28408,15135,13273,114,28370,15121,13249,114.1
37,경상북도,020003, 17세,2017,31872,17064,14808,115.2,31728,16998,14730,115.4
37,경상북도,020004, 18세,2017,31185,16875,14310,117.9,30721,16668,14053,118.6
37,경상북도,020005, 19세,2017,33667,18364,15303,120,32513,17826,14687,121.4
37,경상북도,025,20~24세,2017,171472,97456,74016,131.7,161828,91754,70074,130.9
37,경상북도,025001, 20세,2017,34637,18753,15884,118.1,33178,18082,15096,119.8
37,경상북도,025002, 21세,2017,35046,19396,15650,123.9,33347,18476,14871,124.2
37,경상북도,025003, 22세,2017,35334,20211,15123,133.6,33402,19084,14318,133.3
37,경상북도,025004, 23세,2017,33702,19811,13891,142.6,31569,18439,13130,140.4
37,경상북도,025005, 24세,2017,32753,19285,13468,143.2,30332,17673,12659,139.6
37,경상북도,030,25~29세,2017,148590,85124,63466,134.1,134837,75915,58922,128.8
37,경상북도,030001, 25세,2017,32149,18429,13720,134.3,29457,16602,12855,129.1
37,경상북도,030002, 26세,2017,29869,17040,12829,132.8,27189,15225,11964,127.3
37,경상북도,030003, 27세,2017,29471,16961,12510,135.6,26641,15084,11557,130.5
37,경상북도,030004, 28세,2017,28509,16418,12091,135.8,25726,14579,11147,130.8
37,경상북도,030005, 29세,2017,28592,16276,12316,132.2,25824,14425,11399,126.5
37,경상북도,035,30~34세,2017,154975,84419,70556,119.6,143193,76287,66906,114
37,경상북도,035001, 30세,2017,29506,16268,13238,122.9,26833,14449,12384,116.7
37,경상북도,035002, 31세,2017,29551,16406,13145,124.8,27134,14736,12398,118.9
37,경상북도,035003, 32세,2017,29981,16510,13471,122.6,27526,14812,12714,116.5
37,경상북도,035004, 33세,2017,31271,16842,14429,116.7,29060,15309,13751,111.3
37,경상북도,035005, 34세,2017,34666,18393,16273,113,32640,16981,15659,108.4
37,경상북도,040,35~39세,2017,184749,97919,86830,112.8,176668,92327,84341,109.5
37,경상북도,040001, 35세,2017,38098,20094,18004,111.6,36097,18701,17396,107.5
37,경상북도,040002, 36세,2017,38033,20222,17811,113.5,36304,19021,17283,110.1
37,경상북도,040003, 37세,2017,38900,20621,18279,112.8,37269,19512,17757,109.9
37,경상북도,040004, 38세,2017,36159,19159,17000,112.7,34689,18114,16575,109.3
37,경상북도,040005, 39세,2017,33559,17823,15736,113.3,32309,16979,15330,110.8
37,경상북도,045,40~44세,2017,188431,98030,90401,108.4,183164,94551,88613,106.7
37,경상북도,045001, 40세,2017,34994,18305,16689,109.7,33837,17528,16309,107.5
37,경상북도,045002, 41세,2017,34737,18284,16453,111.1,33592,17511,16081,108.9
37,경상북도,045003, 42세,2017,37232,19318,17914,107.8,36214,18650,17564,106.2
37,경상북도,045004, 43세,2017,40428,21011,19417,108.2,39438,20379,19059,106.9
37,경상북도,045005, 44세,2017,41040,21112,19928,105.9,40083,20483,19600,104.5
37,경상북도,050,45~49세,2017,217952,113552,104400,108.8,213692,111069,102623,108.2
37,경상북도,050001, 45세,2017,41043,21669,19374,111.8,40112,21086,19026,110.8
37,경상북도,050002, 46세,2017,43411,22840,20571,111,42514,22303,20211,110.4
37,경상북도,050003, 47세,2017,43420,22458,20962,107.1,42562,21954,20608,106.5
37,경상북도,050004, 48세,2017,44144,22946,21198,108.2,43343,22496,20847,107.9
37,경상북도,050005, 49세,2017,45934,23639,22295,106,45161,23230,21931,105.9
37,경상북도,055,50~54세,2017,213011,109670,103341,106.1,209678,107905,101773,106
37,경상북도,055001, 50세,2017,41884,21330,20554,103.8,41202,20960,20242,103.5
37,경상북도,055002, 51세,2017,42556,22374,20182,110.9,41923,22051,19872,111
37,경상북도,055003, 52세,2017,43079,21924,21155,103.6,42384,21551,20833,103.4
37,경상북도,055004, 53세,2017,41473,21422,20051,106.8,40795,21067,19728,106.8
37,경상북도,055005, 54세,2017,44019,22620,21399,105.7,43374,22276,21098,105.6
37,경상북도,060,55~59세,2017,235410,118798,116612,101.9,233142,117651,115491,101.9
37,경상북도,060001, 55세,2017,46475,23930,22545,106.1,45934,23658,22276,106.2
37,경상북도,060002, 56세,2017,50782,25849,24933,103.7,50351,25629,24722,103.7
37,경상북도,060003, 57세,2017,50555,25106,25449,98.7,50067,24873,25194,98.7
37,경상북도,060004, 58세,2017,45549,22640,22909,98.8,45142,22438,22704,98.8
37,경상북도,060005, 59세,2017,42049,21273,20776,102.4,41648,21053,20595,102.2
37,경상북도,065,60~64세,2017,192462,95484,96978,98.5,191033,94774,96259,98.5
37,경상북도,065001, 60세,2017,42618,21590,21028,102.7,42271,21424,20847,102.8
37,경상북도,065002, 61세,2017,40888,20475,20413,100.3,40583,20310,20273,100.2
37,경상북도,065003, 62세,2017,39766,19436,20330,95.6,39477,19281,20196,95.5
37,경상북도,065004, 63세,2017,35654,17650,18004,98,35391,17530,17861,98.1
37,경상북도,065005, 64세,2017,33536,16333,17203,94.9,33311,16229,17082,95
37,경상북도,070,65~69세,2017,149198,72297,76901,94,148540,71980,76560,94
37,경상북도,070001, 65세,2017,35435,16974,18461,91.9,35240,16887,18353,92
37,경상북도,070002, 66세,2017,27451,13245,14206,93.2,27314,13175,14139,93.2
37,경상북도,070003, 67세,2017,27992,13589,14403,94.3,27845,13516,14329,94.3
37,경상북도,070004, 68세,2017,29944,14735,15209,96.9,29855,14695,15160,96.9
37,경상북도,070005, 69세,2017,28376,13754,14622,94.1,28286,13707,14579,94
37,경상북도,075,70~74세,2017,110423,49421,61002,81,110168,49307,60861,81
37,경상북도,075001, 70세,2017,26594,12639,13955,90.6,26527,12609,13918,90.6
37,경상북도,075002, 71세,2017,17488,8309,9179,90.5,17423,8279,9144,90.5
37,경상북도,075003, 72세,2017,19129,8482,10647,79.7,19086,8461,10625,79.6
37,경상북도,075004, 73세,2017,22172,9414,12758,73.8,22126,9396,12730,73.8
37,경상북도,075005, 74세,2017,25040,10577,14463,73.1,25006,10562,14444,73.1
37,경상북도,080,75~79세,2017,114546,45191,69355,65.2,114426,45148,69278,65.2
37,경상북도,080001, 75세,2017,28254,11845,16409,72.2,28230,11836,16394,72.2
37,경상북도,080002, 76세,2017,22463,8989,13474,66.7,22443,8981,13462,66.7
37,경상북도,080003, 77세,2017,21644,8496,13148,64.6,21619,8488,13131,64.6
37,경상북도,080004, 78세,2017,22654,8685,13969,62.2,22627,8676,13951,62.2
37,경상북도,080005, 79세,2017,19531,7176,12355,58.1,19507,7167,12340,58.1
37,경상북도,085,80~84세,2017,75849,25851,49998,51.7,75779,25832,49947,51.7
37,경상북도,085001, 80세,2017,17879,6451,11428,56.4,17853,6440,11413,56.4
37,경상북도,085002, 81세,2017,16962,6031,10931,55.2,16948,6028,10920,55.2
37,경상북도,085003, 82세,2017,16091,5387,10704,50.3,16076,5385,10691,50.4
37,경상북도,085004, 83세,2017,13672,4516,9156,49.3,13662,4514,9148,49.3
37,경상북도,085005, 84세,2017,11245,3466,7779,44.6,11240,3465,7775,44.6
37,경상북도,090,85~89세,2017,34732,9291,25441,36.5,34700,9280,25420,36.5
37,경상북도,090001, 85세,2017,10015,2950,7065,41.8,10007,2948,7059,41.8
37,경상북도,090002, 86세,2017,7687,2117,5570,38,7680,2113,5567,38
37,경상북도,090003, 87세,2017,6790,1753,5037,34.8,6787,1752,5035,34.8
37,경상북도,090004, 88세,2017,5558,1404,4154,33.8,5549,1401,4148,33.8
37,경상북도,090005, 89세,2017,4682,1067,3615,29.5,4677,1066,3611,29.5
37,경상북도,095,90~94세,2017,11293,2468,8825,28,11286,2468,8818,28
37,경상북도,095001, 90세,2017,3806,892,2914,30.6,3804,892,2912,30.6
37,경상북도,095002, 91세,2017,2494,538,1956,27.5,2493,538,1955,27.5
37,경상북도,095003, 92세,2017,2227,490,1737,28.2,2224,490,1734,28.3
37,경상북도,095004, 93세,2017,1457,294,1163,25.3,1457,294,1163,25.3
37,경상북도,095005, 94세,2017,1309,254,1055,24.1,1308,254,1054,24.1
37,경상북도,100,95~99세,2017,2508,405,2103,19.3,2503,405,2098,19.3
37,경상북도,100001, 95세,2017,1019,170,849,20,1018,170,848,20
37,경상북도,100002, 96세,2017,612,107,505,21.2,612,107,505,21.2
37,경상북도,100003, 97세,2017,432,60,372,16.1,431,60,371,16.2
37,경상북도,100004, 98세,2017,257,42,215,19.5,256,42,214,19.6
37,경상북도,100005, 99세,2017,188,26,162,16,186,26,160,16.3
37,경상북도,101,100세이상,2017,275,43,232,18.5,275,43,232,18.5
37,경상북도,102,15세미만,2017,322028,167421,154607,108.3,320849,166825,154024,108.3
37,경상북도,103,15~64세,2017,1856206,980695,875511,112,1794554,941629,852925,110.4
37,경상북도,104,65세이상,2017,498824,204967,293857,69.8,497677,204463,293214,69.7
37,경상북도,086,85세이상,2017,48808,12207,36601,33.4,48764,12196,36568,33.4
37,경상북도,126,평균연령,2017,43.9,42,45.8,,44.1,42.3,46,
37,경상북도,127,중위연령,2017,45.5,43.4,47.6,,46,44,48,
37004, 읍부,000,합계,2017,605455,309249,296206,104.4,585808,296222,289586,102.3
37004, 읍부,005,0~4세,2017,23900,12303,11597,106.1,23734,12217,11517,106.1
37004, 읍부,005001, 0세,2017,4180,2169,2011,107.9,4143,2146,1997,107.5
37004, 읍부,005002, 1세,2017,4773,2422,2351,103,4734,2408,2326,103.5
37004, 읍부,005003, 2세,2017,5035,2626,2409,109,5004,2605,2399,108.6
37004, 읍부,005004, 3세,2017,4908,2513,2395,104.9,4879,2501,2378,105.2
37004, 읍부,005005, 4세,2017,5004,2573,2431,105.8,4974,2557,2417,105.8
37004, 읍부,010,5~9세,2017,25842,13517,12325,109.7,25731,13469,12262,109.8
37004, 읍부,010001, 5세,2017,5383,2866,2517,113.9,5358,2858,2500,114.3
37004, 읍부,010002, 6세,2017,5383,2805,2578,108.8,5361,2798,2563,109.2
37004, 읍부,010003, 7세,2017,4975,2594,2381,108.9,4956,2584,2372,108.9
37004, 읍부,010004, 8세,2017,4972,2592,2380,108.9,4945,2576,2369,108.7
37004, 읍부,010005, 9세,2017,5129,2660,2469,107.7,5111,2653,2458,107.9
37004, 읍부,015,10~14세,2017,25679,13431,12248,109.7,25613,13397,12216,109.7
37004, 읍부,015001, 10세,2017,5310,2705,2605,103.8,5295,2695,2600,103.7
37004, 읍부,015002, 11세,2017,5000,2635,2365,111.4,4985,2628,2357,111.5
37004, 읍부,015003, 12세,2017,4851,2527,2324,108.7,4836,2518,2318,108.6
37004, 읍부,015004, 13세,2017,5156,2766,2390,115.7,5143,2759,2384,115.7
37004, 읍부,015005, 14세,2017,5362,2798,2564,109.1,5354,2797,2557,109.4
37004, 읍부,020,15~19세,2017,37082,19365,17717,109.3,36449,19103,17346,110.1
37004, 읍부,020001, 15세,2017,5687,3028,2659,113.9,5676,3020,2656,113.7
37004, 읍부,020002, 16세,2017,6662,3422,3240,105.6,6651,3418,3233,105.7
37004, 읍부,020003, 17세,2017,7440,3792,3648,103.9,7389,3770,3619,104.2
37004, 읍부,020004, 18세,2017,7887,4133,3754,110.1,7680,4044,3636,111.2
37004, 읍부,020005, 19세,2017,9406,4990,4416,113,9053,4851,4202,115.4
37004, 읍부,025,20~24세,2017,42700,23959,18741,127.8,39949,22268,17681,125.9
37004, 읍부,025001, 20세,2017,8900,4560,4340,105.1,8500,4367,4133,105.7
37004, 읍부,025002, 21세,2017,8738,4560,4178,109.1,8296,4319,3977,108.6
37004, 읍부,025003, 22세,2017,8843,5021,3822,131.4,8303,4700,3603,130.4
37004, 읍부,025004, 23세,2017,8408,5055,3353,150.8,7787,4643,3144,147.7
37004, 읍부,025005, 24세,2017,7811,4763,3048,156.3,7063,4239,2824,150.1
37004, 읍부,030,25~29세,2017,33632,19768,13864,142.6,29498,16807,12691,132.4
37004, 읍부,030001, 25세,2017,7390,4326,3064,141.2,6587,3748,2839,132
37004, 읍부,030002, 26세,2017,6715,3928,2787,140.9,5929,3370,2559,131.7
37004, 읍부,030003, 27세,2017,6640,3893,2747,141.7,5769,3272,2497,131
37004, 읍부,030004, 28세,2017,6489,3823,2666,143.4,5623,3203,2420,132.4
37004, 읍부,030005, 29세,2017,6398,3798,2600,146.1,5590,3214,2376,135.3
37004, 읍부,035,30~34세,2017,35420,19665,15755,124.8,31677,16955,14722,115.2
37004, 읍부,035001, 30세,2017,6803,3840,2963,129.6,5961,3250,2711,119.9
37004, 읍부,035002, 31세,2017,6728,3830,2898,132.2,5963,3269,2694,121.3
37004, 읍부,035003, 32세,2017,6846,3892,2954,131.8,6086,3350,2736,122.4
37004, 읍부,035004, 33세,2017,7191,3933,3258,120.7,6444,3385,3059,110.7
37004, 읍부,035005, 34세,2017,7852,4170,3682,113.3,7223,3701,3522,105.1
37004, 읍부,040,35~39세,2017,43018,22968,20050,114.6,40412,21043,19369,108.6
37004, 읍부,040001, 35세,2017,8710,4647,4063,114.4,8037,4147,3890,106.6
37004, 읍부,040002, 36세,2017,8865,4787,4078,117.4,8302,4364,3938,110.8
37004, 읍부,040003, 37세,2017,9083,4827,4256,113.4,8578,4461,4117,108.4
37004, 읍부,040004, 38세,2017,8501,4494,4007,112.2,8044,4156,3888,106.9
37004, 읍부,040005, 39세,2017,7859,4213,3646,115.6,7451,3915,3536,110.7
37004, 읍부,045,40~44세,2017,44413,23634,20779,113.7,42716,22444,20272,110.7
37004, 읍부,045001, 40세,2017,8355,4409,3946,111.7,7941,4106,3835,107.1
37004, 읍부,045002, 41세,2017,8023,4341,3682,117.9,7657,4079,3578,114
37004, 읍부,045003, 42세,2017,8633,4570,4063,112.5,8318,4359,3959,110.1
37004, 읍부,045004, 43세,2017,9674,5177,4497,115.1,9360,4961,4399,112.8
37004, 읍부,045005, 44세,2017,9728,5137,4591,111.9,9440,4939,4501,109.7
37004, 읍부,050,45~49세,2017,50757,26993,23764,113.6,49413,26163,23250,112.5
37004, 읍부,050001, 45세,2017,9746,5238,4508,116.2,9435,5025,4410,113.9
37004, 읍부,050002, 46세,2017,10312,5493,4819,114,10013,5312,4701,113
37004, 읍부,050003, 47세,2017,9998,5246,4752,110.4,9748,5088,4660,109.2
37004, 읍부,050004, 48세,2017,10194,5478,4716,116.2,9954,5337,4617,115.6
37004, 읍부,050005, 49세,2017,10507,5538,4969,111.5,10263,5401,4862,111.1
37004, 읍부,055,50~54세,2017,47898,25151,22747,110.6,46922,24611,22311,110.3
37004, 읍부,055001, 50세,2017,9553,5013,4540,110.4,9360,4895,4465,109.6
37004, 읍부,055002, 51세,2017,9676,5159,4517,114.2,9499,5062,4437,114.1
37004, 읍부,055003, 52세,2017,9596,4964,4632,107.2,9389,4849,4540,106.8
37004, 읍부,055004, 53세,2017,9320,4896,4424,110.7,9108,4788,4320,110.8
37004, 읍부,055005, 54세,2017,9753,5119,4634,110.5,9566,5017,4549,110.3
37004, 읍부,060,55~59세,2017,50706,26190,24516,106.8,50025,25818,24207,106.7
37004, 읍부,060001, 55세,2017,10242,5434,4808,113,10076,5339,4737,112.7
37004, 읍부,060002, 56세,2017,10945,5764,5181,111.3,10825,5693,5132,110.9
37004, 읍부,060003, 57세,2017,10821,5449,5372,101.4,10671,5369,5302,101.3
37004, 읍부,060004, 58세,2017,9689,4930,4759,103.6,9571,4874,4697,103.8
37004, 읍부,060005, 59세,2017,9009,4613,4396,104.9,8882,4543,4339,104.7
37004, 읍부,065,60~64세,2017,39900,19900,20000,99.5,39472,19664,19808,99.3
37004, 읍부,065001, 60세,2017,9018,4573,4445,102.9,8912,4512,4400,102.5
37004, 읍부,065002, 61세,2017,8340,4226,4114,102.7,8243,4163,4080,102
37004, 읍부,065003, 62세,2017,8279,4073,4206,96.8,8186,4018,4168,96.4
37004, 읍부,065004, 63세,2017,7355,3581,3774,94.9,7275,3547,3728,95.1
37004, 읍부,065005, 64세,2017,6908,3447,3461,99.6,6856,3424,3432,99.8
37004, 읍부,070,65~69세,2017,30979,14945,16034,93.2,30779,14845,15934,93.2
37004, 읍부,070001, 65세,2017,7251,3553,3698,96.1,7198,3529,3669,96.2
37004, 읍부,070002, 66세,2017,5746,2747,2999,91.6,5698,2723,2975,91.5
37004, 읍부,070003, 67세,2017,5812,2793,3019,92.5,5764,2769,2995,92.5
37004, 읍부,070004, 68세,2017,6292,3042,3250,93.6,6268,3031,3237,93.6
37004, 읍부,070005, 69세,2017,5878,2810,3068,91.6,5851,2793,3058,91.3
37004, 읍부,075,70~74세,2017,23259,10241,13018,78.7,23199,10214,12985,78.7
37004, 읍부,075001, 70세,2017,5603,2654,2949,90,5590,2647,2943,89.9
37004, 읍부,075002, 71세,2017,3730,1761,1969,89.4,3715,1754,1961,89.4
37004, 읍부,075003, 72세,2017,4069,1758,2311,76.1,4058,1755,2303,76.2
37004, 읍부,075004, 73세,2017,4646,1940,2706,71.7,4634,1934,2700,71.6
37004, 읍부,075005, 74세,2017,5211,2128,3083,69,5202,2124,3078,69
37004, 읍부,080,75~79세,2017,23946,9281,14665,63.3,23919,9272,14647,63.3
37004, 읍부,080001, 75세,2017,5830,2411,3419,70.5,5825,2410,3415,70.6
37004, 읍부,080002, 76세,2017,4658,1802,2856,63.1,4651,1798,2853,63
37004, 읍부,080003, 77세,2017,4507,1781,2726,65.3,4500,1780,2720,65.4
37004, 읍부,080004, 78세,2017,4877,1788,3089,57.9,4872,1787,3085,57.9
37004, 읍부,080005, 79세,2017,4074,1499,2575,58.2,4071,1497,2574,58.2
37004, 읍부,085,80~84세,2017,15852,5373,10479,51.3,15838,5370,10468,51.3
37004, 읍부,085001, 80세,2017,3778,1349,2429,55.5,3771,1346,2425,55.5
37004, 읍부,085002, 81세,2017,3654,1324,2330,56.8,3653,1324,2329,56.8
37004, 읍부,085003, 82세,2017,3336,1107,2229,49.7,3332,1107,2225,49.8
37004, 읍부,085004, 83세,2017,2774,892,1882,47.4,2772,892,1880,47.4
37004, 읍부,085005, 84세,2017,2310,701,1609,43.6,2310,701,1609,43.6
37004, 읍부,090,85~89세,2017,7328,1920,5408,35.5,7322,1917,5405,35.5
37004, 읍부,090001, 85세,2017,2170,621,1549,40.1,2168,621,1547,40.1
37004, 읍부,090002, 86세,2017,1603,430,1173,36.7,1602,429,1173,36.6
37004, 읍부,090003, 87세,2017,1385,352,1033,34.1,1384,351,1033,34
37004, 읍부,090004, 88세,2017,1180,296,884,33.5,1179,295,884,33.4
37004, 읍부,090005, 89세,2017,990,221,769,28.7,989,221,768,28.8
37004, 읍부,095,90~94세,2017,2535,542,1993,27.2,2532,542,1990,27.2
37004, 읍부,095001, 90세,2017,841,184,657,28,840,184,656,28
37004, 읍부,095002, 91세,2017,592,118,474,24.9,592,118,474,24.9
37004, 읍부,095003, 92세,2017,506,107,399,26.8,505,107,398,26.9
37004, 읍부,095004, 93세,2017,315,74,241,30.7,315,74,241,30.7
37004, 읍부,095005, 94세,2017,281,59,222,26.6,280,59,221,26.7
37004, 읍부,100,95~99세,2017,543,96,447,21.5,542,96,446,21.5
37004, 읍부,100001, 95세,2017,216,35,181,19.3,216,35,181,19.3
37004, 읍부,100002, 96세,2017,130,26,104,25,130,26,104,25
37004, 읍부,100003, 97세,2017,86,14,72,19.4,86,14,72,19.4
37004, 읍부,100004, 98세,2017,76,17,59,28.8,75,17,58,29.3
37004, 읍부,100005, 99세,2017,35,X,31,12.9,35,X,31,12.9
37004, 읍부,101,100세이상,2017,66,7,59,11.9,66,7,59,11.9
37004, 읍부,102,15세미만,2017,75421,39251,36170,108.5,75078,39083,35995,108.6
37004, 읍부,103,15~64세,2017,425526,227593,197933,115,406533,214876,191657,112.1
37004, 읍부,104,65세이상,2017,104508,42405,62103,68.3,104197,42263,61934,68.2
37004, 읍부,086,85세이상,2017,10472,2565,7907,32.4,10462,2562,7900,32.4
37004, 읍부,126,평균연령,2017,42.9,41.1,44.7,,43.2,41.4,44.9,
37004, 읍부,127,중위연령,2017,44.1,42.2,46.1,,44.7,43.1,46.5,
37005, 면부,000,합계,2017,638462,320225,318237,100.6,618010,305778,312232,97.9
37005, 면부,005,0~4세,2017,15178,7829,7349,106.5,15140,7806,7334,106.4
37005, 면부,005001, 0세,2017,2781,1431,1350,106,2769,1423,1346,105.7
37005, 면부,005002, 1세,2017,3146,1622,1524,106.4,3137,1617,1520,106.4
37005, 면부,005003, 2세,2017,3152,1645,1507,109.2,3145,1641,1504,109.1
37005, 면부,005004, 3세,2017,2971,1506,1465,102.8,2967,1502,1465,102.5
37005, 면부,005005, 4세,2017,3128,1625,1503,108.1,3122,1623,1499,108.3
37005, 면부,010,5~9세,2017,14324,7432,6892,107.8,14302,7426,6876,108
37005, 면부,010001, 5세,2017,3152,1600,1552,103.1,3149,1599,1550,103.2
37005, 면부,010002, 6세,2017,2878,1456,1422,102.4,2874,1455,1419,102.5
37005, 면부,010003, 7세,2017,2748,1430,1318,108.5,2741,1428,1313,108.8
37005, 면부,010004, 8세,2017,2620,1371,1249,109.8,2616,1371,1245,110.1
37005, 면부,010005, 9세,2017,2926,1575,1351,116.6,2922,1573,1349,116.6
37005, 면부,015,10~14세,2017,13828,7357,6471,113.7,13806,7344,6462,113.6
37005, 면부,015001, 10세,2017,2890,1470,1420,103.5,2883,1465,1418,103.3
37005, 면부,015002, 11세,2017,2631,1413,1218,116,2626,1411,1215,116.1
37005, 면부,015003, 12세,2017,2581,1386,1195,116,2578,1385,1193,116.1
37005, 면부,015004, 13세,2017,2848,1515,1333,113.7,2845,1512,1333,113.4
37005, 면부,015005, 14세,2017,2878,1573,1305,120.5,2874,1571,1303,120.6
37005, 면부,020,15~19세,2017,20859,11295,9564,118.1,20560,11115,9445,117.7
37005, 면부,020001, 15세,2017,3303,1752,1551,113,3296,1748,1548,112.9
37005, 면부,020002, 16세,2017,3836,2005,1831,109.5,3834,2004,1830,109.5
37005, 면부,020003, 17세,2017,4368,2389,1979,120.7,4344,2375,1969,120.6
37005, 면부,020004, 18세,2017,4420,2432,1988,122.3,4351,2396,1955,122.6
37005, 면부,020005, 19세,2017,4932,2717,2215,122.7,4735,2592,2143,121
37005, 면부,025,20~24세,2017,27491,16399,11092,147.8,24615,14434,10181,141.8
37005, 면부,025001, 20세,2017,5438,3039,2399,126.7,5165,2902,2263,128.2
37005, 면부,025002, 21세,2017,5677,3374,2303,146.5,5244,3092,2152,143.7
37005, 면부,025003, 22세,2017,5632,3376,2256,149.6,5051,2974,2077,143.2
37005, 면부,025004, 23세,2017,5353,3274,2079,157.5,4648,2773,1875,147.9
37005, 면부,025005, 24세,2017,5391,3336,2055,162.3,4507,2693,1814,148.5
37005, 면부,030,25~29세,2017,27443,16775,10668,157.2,22273,12936,9337,138.5
37005, 면부,030001, 25세,2017,5664,3440,2224,154.7,4590,2638,1952,135.1
37005, 면부,030002, 26세,2017,5436,3275,2161,151.6,4424,2495,1929,129.3
37005, 면부,030003, 27세,2017,5512,3361,2151,156.3,4464,2597,1867,139.1
37005, 면부,030004, 28세,2017,5355,3338,2017,165.5,4339,2600,1739,149.5
37005, 면부,030005, 29세,2017,5476,3361,2115,158.9,4456,2606,1850,140.9
37005, 면부,035,30~34세,2017,27110,16299,10811,150.8,22875,13067,9808,133.2
37005, 면부,035001, 30세,2017,5510,3309,2201,150.3,4556,2590,1966,131.7
37005, 면부,035002, 31세,2017,5243,3189,2054,155.3,4388,2539,1849,137.3
37005, 면부,035003, 32세,2017,5294,3247,2047,158.6,4386,2536,1850,137.1
37005, 면부,035004, 33세,2017,5298,3149,2149,146.5,4514,2559,1955,130.9
37005, 면부,035005, 34세,2017,5765,3405,2360,144.3,5031,2843,2188,129.9
37005, 면부,040,35~39세,2017,28724,17096,11628,147,25929,14940,10989,136
37005, 면부,040001, 35세,2017,6150,3540,2610,135.6,5472,3022,2450,123.3
37005, 면부,040002, 36세,2017,5831,3445,2386,144.4,5241,3004,2237,134.3
37005, 면부,040003, 37세,2017,6004,3603,2401,150.1,5412,3146,2266,138.8
37005, 면부,040004, 38세,2017,5599,3400,2199,154.6,5091,2990,2101,142.3
37005, 면부,040005, 39세,2017,5140,3108,2032,153,4713,2778,1935,143.6
37005, 면부,045,40~44세,2017,29346,17657,11689,151.1,27749,16486,11263,146.4
37005, 면부,045001, 40세,2017,5251,3151,2100,150,4905,2901,2004,144.8
37005, 면부,045002, 41세,2017,5444,3373,2071,162.9,5074,3089,1985,155.6
37005, 면부,045003, 42세,2017,5707,3466,2241,154.7,5383,3222,2161,149.1
37005, 면부,045004, 43세,2017,6341,3776,2565,147.2,6053,3578,2475,144.6
37005, 면부,045005, 44세,2017,6603,3891,2712,143.5,6334,3696,2638,140.1
37005, 면부,050,45~49세,2017,39154,22356,16798,133.1,37952,21597,16355,132.1
37005, 면부,050001, 45세,2017,6701,3950,2751,143.6,6451,3787,2664,142.2
37005, 면부,050002, 46세,2017,7527,4449,3078,144.5,7276,4276,3000,142.5
37005, 면부,050003, 47세,2017,7592,4333,3259,133,7331,4176,3155,132.4
37005, 면부,050004, 48세,2017,8334,4688,3646,128.6,8099,4534,3565,127.2
37005, 면부,050005, 49세,2017,9000,4936,4064,121.5,8795,4824,3971,121.5
37005, 면부,055,50~54세,2017,48701,25981,22720,114.4,47772,25502,22270,114.5
37005, 면부,055001, 50세,2017,8793,4691,4102,114.4,8601,4589,4012,114.4
37005, 면부,055002, 51세,2017,9331,5184,4147,125,9145,5089,4056,125.5
37005, 면부,055003, 52세,2017,9933,5298,4635,114.3,9748,5199,4549,114.3
37005, 면부,055004, 53세,2017,9945,5243,4702,111.5,9754,5148,4606,111.8
37005, 면부,055005, 54세,2017,10699,5565,5134,108.4,10524,5477,5047,108.5
37005, 면부,060,55~59세,2017,66207,33789,32418,104.2,65570,33478,32092,104.3
37005, 면부,060001, 55세,2017,12237,6456,5781,111.7,12087,6387,5700,112.1
37005, 면부,060002, 56세,2017,13823,7134,6689,106.7,13704,7082,6622,106.9
37005, 면부,060003, 57세,2017,14353,7130,7223,98.7,14220,7071,7149,98.9
37005, 면부,060004, 58세,2017,13295,6572,6723,97.8,13172,6505,6667,97.6
37005, 면부,060005, 59세,2017,12499,6497,6002,108.2,12387,6433,5954,108
37005, 면부,065,60~64세,2017,63261,31845,31416,101.4,62921,31671,31250,101.3
37005, 면부,065001, 60세,2017,13044,6761,6283,107.6,12963,6725,6238,107.8
37005, 면부,065002, 61세,2017,13229,6736,6493,103.7,13161,6696,6465,103.6
37005, 면부,065003, 62세,2017,13063,6412,6651,96.4,12997,6379,6618,96.4
37005, 면부,065004, 63세,2017,12187,6095,6092,100,12123,6062,6061,100
37005, 면부,065005, 64세,2017,11738,5841,5897,99.1,11677,5809,5868,99
37005, 면부,070,65~69세,2017,55514,27114,28400,95.5,55347,27030,28317,95.5
37005, 면부,070001, 65세,2017,12598,6026,6572,91.7,12553,6003,6550,91.6
37005, 면부,070002, 66세,2017,9983,4877,5106,95.5,9962,4863,5099,95.4
37005, 면부,070003, 67세,2017,10456,5041,5415,93.1,10412,5021,5391,93.1
37005, 면부,070004, 68세,2017,11474,5707,5767,99,11443,5694,5749,99
37005, 면부,070005, 69세,2017,11003,5463,5540,98.6,10977,5449,5528,98.6
37005, 면부,075,70~74세,2017,45544,20280,25264,80.3,45470,20244,25226,80.3
37005, 면부,075001, 70세,2017,10528,5057,5471,92.4,10507,5048,5459,92.5
37005, 면부,075002, 71세,2017,6827,3277,3550,92.3,6811,3270,3541,92.3
37005, 면부,075003, 72세,2017,7886,3473,4413,78.7,7870,3463,4407,78.6
37005, 면부,075004, 73세,2017,9330,3864,5466,70.7,9318,3858,5460,70.7
37005, 면부,075005, 74세,2017,10973,4609,6364,72.4,10964,4605,6359,72.4
37005, 면부,080,75~79세,2017,53981,21325,32656,65.3,53957,21317,32640,65.3
37005, 면부,080001, 75세,2017,12930,5401,7529,71.7,12927,5400,7527,71.7
37005, 면부,080002, 76세,2017,10436,4226,6210,68.1,10434,4225,6209,68
37005, 면부,080003, 77세,2017,10226,3988,6238,63.9,10221,3986,6235,63.9
37005, 면부,080004, 78세,2017,10922,4218,6704,62.9,10912,4215,6697,62.9
37005, 면부,080005, 79세,2017,9467,3492,5975,58.4,9463,3491,5972,58.5
37005, 면부,085,80~84세,2017,37977,13150,24827,53,37961,13142,24819,53
37005, 면부,085001, 80세,2017,8827,3204,5623,57,8822,3200,5622,56.9
37005, 면부,085002, 81세,2017,8341,2969,5372,55.3,8337,2968,5369,55.3
37005, 면부,085003, 82세,2017,8199,2779,5420,51.3,8197,2778,5419,51.3
37005, 면부,085004, 83세,2017,6951,2380,4571,52.1,6949,2379,4570,52.1
37005, 면부,085005, 84세,2017,5659,1818,3841,47.3,5656,1817,3839,47.3
37005, 면부,090,85~89세,2017,17089,4768,12321,38.7,17080,4765,12315,38.7
37005, 면부,090001, 85세,2017,4907,1517,3390,44.7,4904,1516,3388,44.7
37005, 면부,090002, 86세,2017,3790,1082,2708,40,3788,1081,2707,39.9
37005, 면부,090003, 87세,2017,3379,895,2484,36,3378,895,2483,36
37005, 면부,090004, 88세,2017,2767,742,2025,36.6,2766,741,2025,36.6
37005, 면부,090005, 89세,2017,2246,532,1714,31,2244,532,1712,31.1
37005, 면부,095,90~94세,2017,5379,1245,4134,30.1,5379,1245,4134,30.1
37005, 면부,095001, 90세,2017,1815,466,1349,34.5,1815,466,1349,34.5
37005, 면부,095002, 91세,2017,1168,269,899,29.9,1168,269,899,29.9
37005, 면부,095003, 92세,2017,1058,249,809,30.8,1058,249,809,30.8
37005, 면부,095004, 93세,2017,721,133,588,22.6,721,133,588,22.6
37005, 면부,095005, 94세,2017,617,128,489,26.2,617,128,489,26.2
37005, 면부,100,95~99세,2017,1219,207,1012,20.5,1219,207,1012,20.5
37005, 면부,100001, 95세,2017,482,89,393,22.6,482,89,393,22.6
37005, 면부,100002, 96세,2017,290,58,232,25,290,58,232,25
37005, 면부,100003, 97세,2017,235,31,204,15.2,235,31,204,15.2
37005, 면부,100004, 98세,2017,115,16,99,16.2,115,16,99,16.2
37005, 면부,100005, 99세,2017,97,13,84,15.5,97,13,84,15.5
37005, 면부,101,100세이상,2017,133,26,107,24.3,133,26,107,24.3
37005, 면부,102,15세미만,2017,43330,22618,20712,109.2,43248,22576,20672,109.2
37005, 면부,103,15~64세,2017,378296,209492,168804,124.1,358216,195226,162990,119.8
37005, 면부,104,65세이상,2017,216836,88115,128721,68.5,216546,87976,128570,68.4
37005, 면부,086,85세이상,2017,23820,6246,17574,35.5,23811,6243,17568,35.5
37005, 면부,126,평균연령,2017,53.1,50.2,56.1,,53.7,50.9,56.5,
37005, 면부,127,중위연령,2017,57.1,53.8,60.2,,57.7,55,60.6,
37003, 동부,000,합계,2017,1433141,723609,709532,102,1409262,710917,698345,101.8
37003, 동부,005,0~4세,2017,64844,33411,31433,106.3,64431,33198,31233,106.3
37003, 동부,005001, 0세,2017,11216,5753,5463,105.3,11123,5701,5422,105.1
37003, 동부,005002, 1세,2017,12993,6678,6315,105.7,12902,6633,6269,105.8
37003, 동부,005003, 2세,2017,13717,6961,6756,103,13643,6931,6712,103.3
37003, 동부,005004, 3세,2017,13303,6984,6319,110.5,13233,6953,6280,110.7
37003, 동부,005005, 4세,2017,13615,7035,6580,106.9,13530,6980,6550,106.6
37003, 동부,010,5~9세,2017,70134,36410,33724,108,69919,36300,33619,108
37003, 동부,010001, 5세,2017,14902,7673,7229,106.1,14848,7645,7203,106.1
37003, 동부,010002, 6세,2017,14465,7599,6866,110.7,14416,7575,6841,110.7
37003, 동부,010003, 7세,2017,13679,6995,6684,104.7,13633,6973,6660,104.7
37003, 동부,010004, 8세,2017,13198,6931,6267,110.6,13168,6913,6255,110.5
37003, 동부,010005, 9세,2017,13890,7212,6678,108,13854,7194,6660,108
37003, 동부,015,10~14세,2017,68299,35731,32568,109.7,68173,35668,32505,109.7
37003, 동부,015001, 10세,2017,14099,7366,6733,109.4,14070,7350,6720,109.4
37003, 동부,015002, 11세,2017,13019,6842,6177,110.8,12987,6828,6159,110.9
37003, 동부,015003, 12세,2017,12931,6675,6256,106.7,12904,6662,6242,106.7
37003, 동부,015004, 13세,2017,13943,7358,6585,111.7,13927,7352,6575,111.8
37003, 동부,015005, 14세,2017,14307,7490,6817,109.9,14285,7476,6809,109.8
37003, 동부,020,15~19세,2017,91213,49583,41630,119.1,90310,49178,41132,119.6
37003, 동부,020001, 15세,2017,15032,8025,7007,114.5,15015,8015,7000,114.5
37003, 동부,020002, 16세,2017,17910,9708,8202,118.4,17885,9699,8186,118.5
37003, 동부,020003, 17세,2017,20064,10883,9181,118.5,19995,10853,9142,118.7
37003, 동부,020004, 18세,2017,18878,10310,8568,120.3,18690,10228,8462,120.9
37003, 동부,020005, 19세,2017,19329,10657,8672,122.9,18725,10383,8342,124.5
37003, 동부,025,20~24세,2017,101281,57098,44183,129.2,97264,55052,42212,130.4
37003, 동부,025001, 20세,2017,20299,11154,9145,122,19513,10813,8700,124.3
37003, 동부,025002, 21세,2017,20631,11462,9169,125,19807,11065,8742,126.6
37003, 동부,025003, 22세,2017,20859,11814,9045,130.6,20048,11410,8638,132.1
37003, 동부,025004, 23세,2017,19941,11482,8459,135.7,19134,11023,8111,135.9
37003, 동부,025005, 24세,2017,19551,11186,8365,133.7,18762,10741,8021,133.9
37003, 동부,030,25~29세,2017,87515,48581,38934,124.8,83066,46172,36894,125.1
37003, 동부,030001, 25세,2017,19095,10663,8432,126.5,18280,10216,8064,126.7
37003, 동부,030002, 26세,2017,17718,9837,7881,124.8,16836,9360,7476,125.2
37003, 동부,030003, 27세,2017,17319,9707,7612,127.5,16408,9215,7193,128.1
37003, 동부,030004, 28세,2017,16665,9257,7408,125,15764,8776,6988,125.6
37003, 동부,030005, 29세,2017,16718,9117,7601,119.9,15778,8605,7173,120
37003, 동부,035,30~34세,2017,92445,48455,43990,110.2,88641,46265,42376,109.2
37003, 동부,035001, 30세,2017,17193,9119,8074,112.9,16316,8609,7707,111.7
37003, 동부,035002, 31세,2017,17580,9387,8193,114.6,16783,8928,7855,113.7
37003, 동부,035003, 32세,2017,17841,9371,8470,110.6,17054,8926,8128,109.8
37003, 동부,035004, 33세,2017,18782,9760,9022,108.2,18102,9365,8737,107.2
37003, 동부,035005, 34세,2017,21049,10818,10231,105.7,20386,10437,9949,104.9
37003, 동부,040,35~39세,2017,113007,57855,55152,104.9,110327,56344,53983,104.4
37003, 동부,040001, 35세,2017,23238,11907,11331,105.1,22588,11532,11056,104.3
37003, 동부,040002, 36세,2017,23337,11990,11347,105.7,22761,11653,11108,104.9
37003, 동부,040003, 37세,2017,23813,12191,11622,104.9,23279,11905,11374,104.7
37003, 동부,040004, 38세,2017,22059,11265,10794,104.4,21554,10968,10586,103.6
37003, 동부,040005, 39세,2017,20560,10502,10058,104.4,20145,10286,9859,104.3
37003, 동부,045,40~44세,2017,114672,56739,57933,97.9,112699,55621,57078,97.4
37003, 동부,045001, 40세,2017,21388,10745,10643,101,20991,10521,10470,100.5
37003, 동부,045002, 41세,2017,21270,10570,10700,98.8,20861,10343,10518,98.3
37003, 동부,045003, 42세,2017,22892,11282,11610,97.2,22513,11069,11444,96.7
37003, 동부,045004, 43세,2017,24413,12058,12355,97.6,24025,11840,12185,97.2
37003, 동부,045005, 44세,2017,24709,12084,12625,95.7,24309,11848,12461,95.1
37003, 동부,050,45~49세,2017,128041,64203,63838,100.6,126327,63309,63018,100.5
37003, 동부,050001, 45세,2017,24596,12481,12115,103,24226,12274,11952,102.7
37003, 동부,050002, 46세,2017,25572,12898,12674,101.8,25225,12715,12510,101.6
37003, 동부,050003, 47세,2017,25830,12879,12951,99.4,25483,12690,12793,99.2
37003, 동부,050004, 48세,2017,25616,12780,12836,99.6,25290,12625,12665,99.7
37003, 동부,050005, 49세,2017,26427,13165,13262,99.3,26103,13005,13098,99.3
37003, 동부,055,50~54세,2017,116412,58538,57874,101.1,114984,57792,57192,101
37003, 동부,055001, 50세,2017,23538,11626,11912,97.6,23241,11476,11765,97.5
37003, 동부,055002, 51세,2017,23549,12031,11518,104.5,23279,11900,11379,104.6
37003, 동부,055003, 52세,2017,23550,11662,11888,98.1,23247,11503,11744,97.9
37003, 동부,055004, 53세,2017,22208,11283,10925,103.3,21933,11131,10802,103
37003, 동부,055005, 54세,2017,23567,11936,11631,102.6,23284,11782,11502,102.4
37003, 동부,060,55~59세,2017,118497,58819,59678,98.6,117547,58355,59192,98.6
37003, 동부,060001, 55세,2017,23996,12040,11956,100.7,23771,11932,11839,100.8
37003, 동부,060002, 56세,2017,26014,12951,13063,99.1,25822,12854,12968,99.1
37003, 동부,060003, 57세,2017,25381,12527,12854,97.5,25176,12433,12743,97.6
37003, 동부,060004, 58세,2017,22565,11138,11427,97.5,22399,11059,11340,97.5
37003, 동부,060005, 59세,2017,20541,10163,10378,97.9,20379,10077,10302,97.8
37003, 동부,065,60~64세,2017,89301,43739,45562,96,88640,43439,45201,96.1
37003, 동부,065001, 60세,2017,20556,10256,10300,99.6,20396,10187,10209,99.8
37003, 동부,065002, 61세,2017,19319,9513,9806,97,19179,9451,9728,97.2
37003, 동부,065003, 62세,2017,18424,8951,9473,94.5,18294,8884,9410,94.4
37003, 동부,065004, 63세,2017,16112,7974,8138,98,15993,7921,8072,98.1
37003, 동부,065005, 64세,2017,14890,7045,7845,89.8,14778,6996,7782,89.9
37003, 동부,070,65~69세,2017,62705,30238,32467,93.1,62414,30105,32309,93.2
37003, 동부,070001, 65세,2017,15586,7395,8191,90.3,15489,7355,8134,90.4
37003, 동부,070002, 66세,2017,11722,5621,6101,92.1,11654,5589,6065,92.2
37003, 동부,070003, 67세,2017,11724,5755,5969,96.4,11669,5726,5943,96.3
37003, 동부,070004, 68세,2017,12178,5986,6192,96.7,12144,5970,6174,96.7
37003, 동부,070005, 69세,2017,11495,5481,6014,91.1,11458,5465,5993,91.2
37003, 동부,075,70~74세,2017,41620,18900,22720,83.2,41499,18849,22650,83.2
37003, 동부,075001, 70세,2017,10463,4928,5535,89,10430,4914,5516,89.1
37003, 동부,075002, 71세,2017,6931,3271,3660,89.4,6897,3255,3642,89.4
37003, 동부,075003, 72세,2017,7174,3251,3923,82.9,7158,3243,3915,82.8
37003, 동부,075004, 73세,2017,8196,3610,4586,78.7,8174,3604,4570,78.9
37003, 동부,075005, 74세,2017,8856,3840,5016,76.6,8840,3833,5007,76.6
37003, 동부,080,75~79세,2017,36619,14585,22034,66.2,36550,14559,21991,66.2
37003, 동부,080001, 75세,2017,9494,4033,5461,73.9,9478,4026,5452,73.8
37003, 동부,080002, 76세,2017,7369,2961,4408,67.2,7358,2958,4400,67.2
37003, 동부,080003, 77세,2017,6911,2727,4184,65.2,6898,2722,4176,65.2
37003, 동부,080004, 78세,2017,6855,2679,4176,64.2,6843,2674,4169,64.1
37003, 동부,080005, 79세,2017,5990,2185,3805,57.4,5973,2179,3794,57.4
37003, 동부,085,80~84세,2017,22020,7328,14692,49.9,21980,7320,14660,49.9
37003, 동부,085001, 80세,2017,5274,1898,3376,56.2,5260,1894,3366,56.3
37003, 동부,085002, 81세,2017,4967,1738,3229,53.8,4958,1736,3222,53.9
37003, 동부,085003, 82세,2017,4556,1501,3055,49.1,4547,1500,3047,49.2
37003, 동부,085004, 83세,2017,3947,1244,2703,46,3941,1243,2698,46.1
37003, 동부,085005, 84세,2017,3276,947,2329,40.7,3274,947,2327,40.7
37003, 동부,090,85~89세,2017,10315,2603,7712,33.8,10298,2598,7700,33.7
37003, 동부,090001, 85세,2017,2938,812,2126,38.2,2935,811,2124,38.2
37003, 동부,090002, 86세,2017,2294,605,1689,35.8,2290,603,1687,35.7
37003, 동부,090003, 87세,2017,2026,506,1520,33.3,2025,506,1519,33.3
37003, 동부,090004, 88세,2017,1611,366,1245,29.4,1604,365,1239,29.5
37003, 동부,090005, 89세,2017,1446,314,1132,27.7,1444,313,1131,27.7
37003, 동부,095,90~94세,2017,3379,681,2698,25.2,3375,681,2694,25.3
37003, 동부,095001, 90세,2017,1150,242,908,26.7,1149,242,907,26.7
37003, 동부,095002, 91세,2017,734,151,583,25.9,733,151,582,25.9
37003, 동부,095003, 92세,2017,663,134,529,25.3,661,134,527,25.4
37003, 동부,095004, 93세,2017,421,87,334,26,421,87,334,26
37003, 동부,095005, 94세,2017,411,67,344,19.5,411,67,344,19.5
37003, 동부,100,95~99세,2017,746,102,644,15.8,742,102,640,15.9
37003, 동부,100001, 95세,2017,321,46,275,16.7,320,46,274,16.8
37003, 동부,100002, 96세,2017,192,23,169,13.6,192,23,169,13.6
37003, 동부,100003, 97세,2017,111,15,96,15.6,110,15,95,15.8
37003, 동부,100004, 98세,2017,66,9,57,15.8,66,9,57,15.8
37003, 동부,100005, 99세,2017,56,9,47,19.1,54,9,45,20
37003, 동부,101,100세이상,2017,76,10,66,15.2,76,10,66,15.2
37003, 동부,102,15세미만,2017,203277,105552,97725,108,202523,105166,97357,108
37003, 동부,103,15~64세,2017,1052384,543610,508774,106.8,1029805,531527,498278,106.7
37003, 동부,104,65세이상,2017,177480,74447,103033,72.3,176934,74224,102710,72.3
37003, 동부,086,85세이상,2017,14516,3396,11120,30.5,14491,3391,11100,30.5
37003, 동부,126,평균연령,2017,40.3,38.9,41.7,,40.3,38.9,41.8,
37003, 동부,127,중위연령,2017,41.3,39.5,43,,41.6,39.7,43.2,
37010, 포항시,000,합계,2017,506909,256835,250074,102.7,500597,253038,247559,102.2
37010, 포항시,005,0~4세,2017,21360,11047,10313,107.1,21286,11009,10277,107.1
37010, 포항시,005001, 0세,2017,3532,1862,1670,111.5,3515,1855,1660,111.7
37010, 포항시,005002, 1세,2017,4260,2200,2060,106.8,4248,2192,2056,106.6
37010, 포항시,005003, 2세,2017,4583,2383,2200,108.3,4569,2375,2194,108.2
37010, 포항시,005004, 3세,2017,4415,2262,2153,105.1,4404,2257,2147,105.1
37010, 포항시,005005, 4세,2017,4570,2340,2230,104.9,4550,2330,2220,105
37010, 포항시,010,5~9세,2017,23385,12240,11145,109.8,23343,12216,11127,109.8
37010, 포항시,010001, 5세,2017,4968,2657,2311,115,4961,2654,2307,115
37010, 포항시,010002, 6세,2017,4846,2546,2300,110.7,4833,2542,2291,111
37010, 포항시,010003, 7세,2017,4606,2393,2213,108.1,4599,2386,2213,107.8
37010, 포항시,010004, 8세,2017,4437,2321,2116,109.7,4427,2314,2113,109.5
37010, 포항시,010005, 9세,2017,4528,2323,2205,105.4,4523,2320,2203,105.3
37010, 포항시,015,10~14세,2017,22540,11814,10726,110.1,22515,11799,10716,110.1
37010, 포항시,015001, 10세,2017,4602,2379,2223,107,4594,2372,2222,106.8
37010, 포항시,015002, 11세,2017,4320,2263,2057,110,4314,2261,2053,110.1
37010, 포항시,015003, 12세,2017,4302,2294,2008,114.2,4299,2292,2007,114.2
37010, 포항시,015004, 13세,2017,4621,2417,2204,109.7,4617,2415,2202,109.7
37010, 포항시,015005, 14세,2017,4695,2461,2234,110.2,4691,2459,2232,110.2
37010, 포항시,020,15~19세,2017,27938,15155,12783,118.6,27766,15074,12692,118.8
37010, 포항시,020001, 15세,2017,4856,2605,2251,115.7,4853,2603,2250,115.7
37010, 포항시,020002, 16세,2017,5726,3063,2663,115,5723,3061,2662,115
37010, 포항시,020003, 17세,2017,6548,3516,3032,116,6530,3504,3026,115.8
37010, 포항시,020004, 18세,2017,5864,3181,2683,118.6,5825,3166,2659,119.1
37010, 포항시,020005, 19세,2017,4944,2790,2154,129.5,4835,2740,2095,130.8
37010, 포항시,025,20~24세,2017,29621,17171,12450,137.9,28639,16628,12011,138.4
37010, 포항시,025001, 20세,2017,5900,3552,2348,151.3,5699,3457,2242,154.2
37010, 포항시,025002, 21세,2017,6210,3747,2463,152.1,6044,3666,2378,154.2
37010, 포항시,025003, 22세,2017,5892,3347,2545,131.5,5706,3247,2459,132
37010, 포항시,025004, 23세,2017,5775,3240,2535,127.8,5568,3119,2449,127.4
37010, 포항시,025005, 24세,2017,5844,3285,2559,128.4,5622,3139,2483,126.4
37010, 포항시,030,25~29세,2017,27959,15910,12049,132,26670,15090,11580,130.3
37010, 포항시,030001, 25세,2017,5941,3387,2554,132.6,5682,3219,2463,130.7
37010, 포항시,030002, 26세,2017,5648,3260,2388,136.5,5398,3091,2307,134
37010, 포항시,030003, 27세,2017,5635,3229,2406,134.2,5384,3067,2317,132.4
37010, 포항시,030004, 28세,2017,5451,3093,2358,131.2,5185,2936,2249,130.5
37010, 포항시,030005, 29세,2017,5284,2941,2343,125.5,5021,2777,2244,123.8
37010, 포항시,035,30~34세,2017,29940,15889,14051,113.1,28867,15204,13663,111.3
37010, 포항시,035001, 30세,2017,5378,2899,2479,116.9,5136,2743,2393,114.6
37010, 포항시,035002, 31세,2017,5515,3006,2509,119.8,5322,2890,2432,118.8
37010, 포항시,035003, 32세,2017,5755,2995,2760,108.5,5511,2838,2673,106.2
37010, 포항시,035004, 33세,2017,6313,3283,3030,108.3,6094,3142,2952,106.4
37010, 포항시,035005, 34세,2017,6979,3706,3273,113.2,6804,3591,3213,111.8
37010, 포항시,040,35~39세,2017,37462,19277,18185,106,36710,18793,17917,104.9
37010, 포항시,040001, 35세,2017,7710,3969,3741,106.1,7554,3868,3686,104.9
37010, 포항시,040002, 36세,2017,7931,4129,3802,108.6,7765,4027,3738,107.7
37010, 포항시,040003, 37세,2017,7736,3977,3759,105.8,7588,3884,3704,104.9
37010, 포항시,040004, 38세,2017,7319,3702,3617,102.4,7169,3601,3568,100.9
37010, 포항시,040005, 39세,2017,6766,3500,3266,107.2,6634,3413,3221,106
37010, 포항시,045,40~44세,2017,38092,19241,18851,102.1,37488,18824,18664,100.9
37010, 포항시,045001, 40세,2017,7199,3646,3553,102.6,7070,3562,3508,101.5
37010, 포항시,045002, 41세,2017,6677,3407,3270,104.2,6545,3312,3233,102.4
37010, 포항시,045003, 42세,2017,7493,3834,3659,104.8,7381,3757,3624,103.7
37010, 포항시,045004, 43세,2017,8271,4138,4133,100.1,8168,4069,4099,99.3
37010, 포항시,045005, 44세,2017,8452,4216,4236,99.5,8324,4124,4200,98.2
37010, 포항시,050,45~49세,2017,44984,22712,22272,102,44533,22431,22102,101.5
37010, 포항시,050001, 45세,2017,8384,4243,4141,102.5,8280,4173,4107,101.6
37010, 포항시,050002, 46세,2017,8905,4459,4446,100.3,8801,4398,4403,99.9
37010, 포항시,050003, 47세,2017,9132,4556,4576,99.6,9044,4496,4548,98.9
37010, 포항시,050004, 48세,2017,9015,4611,4404,104.7,8933,4558,4375,104.2
37010, 포항시,050005, 49세,2017,9548,4843,4705,102.9,9475,4806,4669,102.9
37010, 포항시,055,50~54세,2017,43609,21686,21923,98.9,43286,21522,21764,98.9
37010, 포항시,055001, 50세,2017,8511,4257,4254,100.1,8455,4226,4229,99.9
37010, 포항시,055002, 51세,2017,8738,4442,4296,103.4,8680,4415,4265,103.5
37010, 포항시,055003, 52세,2017,8977,4376,4601,95.1,8917,4340,4577,94.8
37010, 포항시,055004, 53세,2017,8278,4092,4186,97.8,8211,4061,4150,97.9
37010, 포항시,055005, 54세,2017,9105,4519,4586,98.5,9023,4480,4543,98.6
37010, 포항시,060,55~59세,2017,48447,23788,24659,96.5,48224,23682,24542,96.5
37010, 포항시,060001, 55세,2017,9417,4792,4625,103.6,9366,4766,4600,103.6
37010, 포항시,060002, 56세,2017,10354,5125,5229,98,10319,5114,5205,98.3
37010, 포항시,060003, 57세,2017,10296,5014,5282,94.9,10237,4986,5251,95
37010, 포항시,060004, 58세,2017,9590,4609,4981,92.5,9554,4591,4963,92.5
37010, 포항시,060005, 59세,2017,8790,4248,4542,93.5,8748,4225,4523,93.4
37010, 포항시,065,60~64세,2017,38999,19546,19453,100.5,38827,19456,19371,100.4
37010, 포항시,065001, 60세,2017,8848,4452,4396,101.3,8811,4432,4379,101.2
37010, 포항시,065002, 61세,2017,8264,4036,4228,95.5,8226,4014,4212,95.3
37010, 포항시,065003, 62세,2017,8317,4107,4210,97.6,8287,4091,4196,97.5
37010, 포항시,065004, 63세,2017,7173,3723,3450,107.9,7132,3702,3430,107.9
37010, 포항시,065005, 64세,2017,6397,3228,3169,101.9,6371,3217,3154,102
37010, 포항시,070,65~69세,2017,26510,13373,13137,101.8,26434,13338,13096,101.8
37010, 포항시,070001, 65세,2017,6679,3349,3330,100.6,6660,3344,3316,100.8
37010, 포항시,070002, 66세,2017,5083,2567,2516,102,5066,2557,2509,101.9
37010, 포항시,070003, 67세,2017,4932,2529,2403,105.2,4911,2519,2392,105.3
37010, 포항시,070004, 68세,2017,5086,2560,2526,101.3,5078,2556,2522,101.3
37010, 포항시,070005, 69세,2017,4730,2368,2362,100.3,4719,2362,2357,100.2
37010, 포항시,075,70~74세,2017,17194,8107,9087,89.2,17167,8100,9067,89.3
37010, 포항시,075001, 70세,2017,4403,2176,2227,97.7,4395,2173,2222,97.8
37010, 포항시,075002, 71세,2017,2931,1442,1489,96.8,2927,1441,1486,97
37010, 포항시,075003, 72세,2017,3041,1419,1622,87.5,3034,1417,1617,87.6
37010, 포항시,075004, 73세,2017,3360,1545,1815,85.1,3355,1544,1811,85.3
37010, 포항시,075005, 74세,2017,3459,1525,1934,78.9,3456,1525,1931,79
37010, 포항시,080,75~79세,2017,14427,5869,8558,68.6,14414,5865,8549,68.6
37010, 포항시,080001, 75세,2017,3758,1631,2127,76.7,3756,1631,2125,76.8
37010, 포항시,080002, 76세,2017,2978,1258,1720,73.1,2977,1257,1720,73.1
37010, 포항시,080003, 77세,2017,2722,1097,1625,67.5,2718,1095,1623,67.5
37010, 포항시,080004, 78세,2017,2721,1087,1634,66.5,2717,1086,1631,66.6
37010, 포항시,080005, 79세,2017,2248,796,1452,54.8,2246,796,1450,54.9
37010, 포항시,085,80~84세,2017,8546,2776,5770,48.1,8536,2774,5762,48.1
37010, 포항시,085001, 80세,2017,2066,751,1315,57.1,2060,750,1310,57.3
37010, 포항시,085002, 81세,2017,1928,660,1268,52.1,1927,660,1267,52.1
37010, 포항시,085003, 82세,2017,1708,507,1201,42.2,1706,506,1200,42.2
37010, 포항시,085004, 83세,2017,1553,492,1061,46.4,1553,492,1061,46.4
37010, 포항시,085005, 84세,2017,1291,366,925,39.6,1290,366,924,39.6
37010, 포항시,090,85~89세,2017,4148,939,3209,29.3,4145,938,3207,29.2
37010, 포항시,090001, 85세,2017,1160,298,862,34.6,1159,298,861,34.6
37010, 포항시,090002, 86세,2017,908,215,693,31,908,215,693,31
37010, 포항시,090003, 87세,2017,803,177,626,28.3,803,177,626,28.3
37010, 포항시,090004, 88세,2017,684,142,542,26.2,682,141,541,26.1
37010, 포항시,090005, 89세,2017,593,107,486,22,593,107,486,22
37010, 포항시,095,90~94세,2017,1404,249,1155,21.6,1404,249,1155,21.6
37010, 포항시,095001, 90세,2017,488,83,405,20.5,488,83,405,20.5
37010, 포항시,095002, 91세,2017,298,46,252,18.3,298,46,252,18.3
37010, 포항시,095003, 92세,2017,267,44,223,19.7,267,44,223,19.7
37010, 포항시,095004, 93세,2017,188,40,148,27,188,40,148,27
37010, 포항시,095005, 94세,2017,163,36,127,28.3,163,36,127,28.3
37010, 포항시,100,95~99세,2017,311,41,270,15.2,310,41,269,15.2
37010, 포항시,100001, 95세,2017,132,19,113,16.8,132,19,113,16.8
37010, 포항시,100002, 96세,2017,62,8,54,14.8,62,8,54,14.8
37010, 포항시,100003, 97세,2017,67,6,61,9.8,67,6,61,9.8
37010, 포항시,100004, 98세,2017,29,6,23,26.1,29,6,23,26.1
37010, 포항시,100005, 99세,2017,21,X,19,10.5,20,X,18,11.1
37010, 포항시,101,100세이상,2017,33,5,28,17.9,33,5,28,17.9
37010, 포항시,102,15세미만,2017,67285,35101,32184,109.1,67144,35024,32120,109
37010, 포항시,103,15~64세,2017,367051,190375,176676,107.8,361010,186704,174306,107.1
37010, 포항시,104,65세이상,2017,72573,31359,41214,76.1,72443,31310,41133,76.1
37010, 포항시,086,85세이상,2017,5896,1234,4662,26.5,5892,1233,4659,26.5
37010, 포항시,126,평균연령,2017,42.3,40.9,43.8,,42.4,41,43.9,
37010, 포항시,127,중위연령,2017,44.4,42.7,46.1,,44.6,43,46.2,
37011, 남구,000,합계,2017,239044,124208,114836,108.2,235497,121880,113617,107.3
37011, 남구,005,0~4세,2017,10036,5203,4833,107.7,9997,5184,4813,107.7
37011, 남구,005001, 0세,2017,1657,876,781,112.2,1648,872,776,112.4
37011, 남구,005002, 1세,2017,2022,1056,966,109.3,2018,1053,965,109.1
37011, 남구,005003, 2세,2017,2158,1107,1051,105.3,2152,1105,1047,105.5
37011, 남구,005004, 3세,2017,2088,1083,1005,107.8,2080,1079,1001,107.8
37011, 남구,005005, 4세,2017,2111,1081,1030,105,2099,1075,1024,105
37011, 남구,010,5~9세,2017,11105,5790,5315,108.9,11081,5779,5302,109
37011, 남구,010001, 5세,2017,2363,1248,1115,111.9,2361,1248,1113,112.1
37011, 남구,010002, 6세,2017,2291,1193,1098,108.7,2280,1190,1090,109.2
37011, 남구,010003, 7세,2017,2178,1124,1054,106.6,2174,1120,1054,106.3
37011, 남구,010004, 8세,2017,2103,1112,991,112.2,2099,1110,989,112.2
37011, 남구,010005, 9세,2017,2170,1113,1057,105.3,2167,1111,1056,105.2
37011, 남구,015,10~14세,2017,10449,5479,4970,110.2,10442,5473,4969,110.1
37011, 남구,015001, 10세,2017,2159,1103,1056,104.5,2156,1100,1056,104.2
37011, 남구,015002, 11세,2017,1989,1032,957,107.8,1987,1031,956,107.8
37011, 남구,015003, 12세,2017,2041,1101,940,117.1,2041,1101,940,117.1
37011, 남구,015004, 13세,2017,2144,1113,1031,108,2143,1112,1031,107.9
37011, 남구,015005, 14세,2017,2116,1130,986,114.6,2115,1129,986,114.5
37011, 남구,020,15~19세,2017,12626,7110,5516,128.9,12608,7098,5510,128.8
37011, 남구,020001, 15세,2017,2211,1209,1002,120.7,2210,1208,1002,120.6
37011, 남구,020002, 16세,2017,2760,1518,1242,122.2,2758,1517,1241,122.2
37011, 남구,020003, 17세,2017,2997,1656,1341,123.5,2994,1654,1340,123.4
37011, 남구,020004, 18세,2017,2641,1479,1162,127.3,2636,1475,1161,127
37011, 남구,020005, 19세,2017,2017,1248,769,162.3,2010,1244,766,162.4
37011, 남구,025,20~24세,2017,13212,8033,5179,155.1,12818,7802,5016,155.5
37011, 남구,025001, 20세,2017,2505,1649,856,192.6,2466,1631,835,195.3
37011, 남구,025002, 21세,2017,2742,1760,982,179.2,2686,1736,950,182.7
37011, 남구,025003, 22세,2017,2548,1528,1020,149.8,2478,1492,986,151.3
37011, 남구,025004, 23세,2017,2621,1530,1091,140.2,2516,1459,1057,138
37011, 남구,025005, 24세,2017,2796,1566,1230,127.3,2672,1484,1188,124.9
37011, 남구,030,25~29세,2017,14167,8340,5827,143.1,13383,7801,5582,139.8
37011, 남구,030001, 25세,2017,2974,1732,1242,139.5,2831,1633,1198,136.3
37011, 남구,030002, 26세,2017,2880,1717,1163,147.6,2726,1605,1121,143.2
37011, 남구,030003, 27세,2017,2877,1707,1170,145.9,2722,1603,1119,143.3
37011, 남구,030004, 28세,2017,2747,1615,1132,142.7,2587,1515,1072,141.3
37011, 남구,030005, 29세,2017,2689,1569,1120,140.1,2517,1445,1072,134.8
37011, 남구,035,30~34세,2017,14924,8187,6737,121.5,14224,7706,6518,118.2
37011, 남구,035001, 30세,2017,2755,1521,1234,123.3,2595,1411,1184,119.2
37011, 남구,035002, 31세,2017,2778,1563,1215,128.6,2650,1485,1165,127.5
37011, 남구,035003, 32세,2017,2874,1559,1315,118.6,2710,1446,1264,114.4
37011, 남구,035004, 33세,2017,3086,1681,1405,119.6,2940,1575,1365,115.4
37011, 남구,035005, 34세,2017,3431,1863,1568,118.8,3329,1789,1540,116.2
37011, 남구,040,35~39세,2017,18071,9524,8547,111.4,17587,9176,8411,109.1
37011, 남구,040001, 35세,2017,3723,1970,1753,112.4,3619,1895,1724,109.9
37011, 남구,040002, 36세,2017,3814,2031,1783,113.9,3707,1959,1748,112.1
37011, 남구,040003, 37세,2017,3764,1950,1814,107.5,3680,1889,1791,105.5
37011, 남구,040004, 38세,2017,3525,1847,1678,110.1,3433,1777,1656,107.3
37011, 남구,040005, 39세,2017,3245,1726,1519,113.6,3148,1656,1492,111
37011, 남구,045,40~44세,2017,18167,9482,8685,109.2,17796,9211,8585,107.3
37011, 남구,045001, 40세,2017,3421,1808,1613,112.1,3351,1757,1594,110.2
37011, 남구,045002, 41세,2017,3152,1669,1483,112.5,3056,1600,1456,109.9
37011, 남구,045003, 42세,2017,3593,1837,1756,104.6,3531,1792,1739,103
37011, 남구,045004, 43세,2017,3962,2053,1909,107.5,3899,2011,1888,106.5
37011, 남구,045005, 44세,2017,4039,2115,1924,109.9,3959,2051,1908,107.5
37011, 남구,050,45~49세,2017,21329,11148,10181,109.5,21068,10970,10098,108.6
37011, 남구,050001, 45세,2017,3932,2050,1882,108.9,3870,2002,1868,107.2
37011, 남구,050002, 46세,2017,4184,2159,2025,106.6,4123,2119,2004,105.7
37011, 남구,050003, 47세,2017,4331,2258,2073,108.9,4277,2219,2058,107.8
37011, 남구,050004, 48세,2017,4276,2262,2014,112.3,4233,2233,2000,111.7
37011, 남구,050005, 49세,2017,4606,2419,2187,110.6,4565,2397,2168,110.6
37011, 남구,055,50~54세,2017,20439,10448,9991,104.6,20258,10355,9903,104.6
37011, 남구,055001, 50세,2017,4148,2169,1979,109.6,4113,2147,1966,109.2
37011, 남구,055002, 51세,2017,4108,2139,1969,108.6,4075,2122,1953,108.7
37011, 남구,055003, 52세,2017,4183,2092,2091,100,4144,2069,2075,99.7
37011, 남구,055004, 53세,2017,3806,1918,1888,101.6,3771,1903,1868,101.9
37011, 남구,055005, 54세,2017,4194,2130,2064,103.2,4155,2114,2041,103.6
37011, 남구,060,55~59세,2017,22789,11326,11463,98.8,22668,11262,11406,98.7
37011, 남구,060001, 55세,2017,4394,2263,2131,106.2,4366,2249,2117,106.2
37011, 남구,060002, 56세,2017,4819,2436,2383,102.2,4803,2430,2373,102.4
37011, 남구,060003, 57세,2017,4860,2445,2415,101.2,4824,2425,2399,101.1
37011, 남구,060004, 58세,2017,4543,2204,2339,94.2,4527,2195,2332,94.1
37011, 남구,060005, 59세,2017,4173,1978,2195,90.1,4148,1963,2185,89.8
37011, 남구,065,60~64세,2017,18652,9421,9231,102.1,18554,9371,9183,102
37011, 남구,065001, 60세,2017,4215,2121,2094,101.3,4191,2108,2083,101.2
37011, 남구,065002, 61세,2017,3941,1919,2022,94.9,3920,1907,2013,94.7
37011, 남구,065003, 62세,2017,3980,2007,1973,101.7,3967,2000,1967,101.7
37011, 남구,065004, 63세,2017,3439,1806,1633,110.6,3419,1796,1623,110.7
37011, 남구,065005, 64세,2017,3077,1568,1509,103.9,3057,1560,1497,104.2
37011, 남구,070,65~69세,2017,12751,6491,6260,103.7,12707,6472,6235,103.8
37011, 남구,070001, 65세,2017,3281,1642,1639,100.2,3268,1638,1630,100.5
37011, 남구,070002, 66세,2017,2450,1243,1207,103,2440,1237,1203,102.8
37011, 남구,070003, 67세,2017,2335,1234,1101,112.1,2324,1230,1094,112.4
37011, 남구,070004, 68세,2017,2452,1224,1228,99.7,2447,1221,1226,99.6
37011, 남구,070005, 69세,2017,2233,1148,1085,105.8,2228,1146,1082,105.9
37011, 남구,075,70~74세,2017,8040,3889,4151,93.7,8028,3885,4143,93.8
37011, 남구,075001, 70세,2017,2104,1047,1057,99.1,2100,1045,1055,99.1
37011, 남구,075002, 71세,2017,1357,673,684,98.4,1356,673,683,98.5
37011, 남구,075003, 72세,2017,1433,682,751,90.8,1430,681,749,90.9
37011, 남구,075004, 73세,2017,1548,734,814,90.2,1545,733,812,90.3
37011, 남구,075005, 74세,2017,1598,753,845,89.1,1597,753,844,89.2
37011, 남구,080,75~79세,2017,6428,2685,3743,71.7,6425,2684,3741,71.7
37011, 남구,080001, 75세,2017,1710,787,923,85.3,1709,787,922,85.4
37011, 남구,080002, 76세,2017,1346,582,764,76.2,1346,582,764,76.2
37011, 남구,080003, 77세,2017,1217,489,728,67.2,1217,489,728,67.2
37011, 남구,080004, 78세,2017,1185,471,714,66,1183,470,713,65.9
37011, 남구,080005, 79세,2017,970,356,614,58,970,356,614,58
37011, 남구,085,80~84세,2017,3682,1175,2507,46.9,3677,1174,2503,46.9
37011, 남구,085001, 80세,2017,941,341,600,56.8,938,340,598,56.9
37011, 남구,085002, 81세,2017,849,275,574,47.9,848,275,573,48
37011, 남구,085003, 82세,2017,720,207,513,40.4,719,207,512,40.4
37011, 남구,085004, 83세,2017,640,203,437,46.5,640,203,437,46.5
37011, 남구,085005, 84세,2017,532,149,383,38.9,532,149,383,38.9
37011, 남구,090,85~89세,2017,1545,367,1178,31.2,1545,367,1178,31.2
37011, 남구,090001, 85세,2017,453,116,337,34.4,453,116,337,34.4
37011, 남구,090002, 86세,2017,332,96,236,40.7,332,96,236,40.7
37011, 남구,090003, 87세,2017,298,60,238,25.2,298,60,238,25.2
37011, 남구,090004, 88세,2017,249,48,201,23.9,249,48,201,23.9
37011, 남구,090005, 89세,2017,213,47,166,28.3,213,47,166,28.3
37011, 남구,095,90~94세,2017,512,86,426,20.2,512,86,426,20.2
37011, 남구,095001, 90세,2017,174,29,145,20,174,29,145,20
37011, 남구,095002, 91세,2017,114,15,99,15.2,114,15,99,15.2
37011, 남구,095003, 92세,2017,99,15,84,17.9,99,15,84,17.9
37011, 남구,095004, 93세,2017,67,14,53,26.4,67,14,53,26.4
37011, 남구,095005, 94세,2017,58,13,45,28.9,58,13,45,28.9
37011, 남구,100,95~99세,2017,106,20,86,23.3,105,20,85,23.5
37011, 남구,100001, 95세,2017,40,7,33,21.2,40,7,33,21.2
37011, 남구,100002, 96세,2017,24,X,21,14.3,24,X,21,14.3
37011, 남구,100003, 97세,2017,22,5,17,29.4,22,5,17,29.4
37011, 남구,100004, 98세,2017,10,X,7,42.9,10,X,7,42.9
37011, 남구,100005, 99세,2017,10,X,8,25,9,X,7,28.6
37011, 남구,101,100세이상,2017,14,X,10,40,14,X,10,40
37011, 남구,102,15세미만,2017,31590,16472,15118,109,31520,16436,15084,109
37011, 남구,103,15~64세,2017,174376,93019,81357,114.3,170964,90752,80212,113.1
37011, 남구,104,65세이상,2017,33078,14717,18361,80.2,33013,14692,18321,80.2
37011, 남구,086,85세이상,2017,2177,477,1700,28.1,2176,477,1699,28.1
37011, 남구,126,평균연령,2017,42.2,40.8,43.6,,42.2,40.9,43.7,
37011, 남구,127,중위연령,2017,44.2,42.5,46,,44.4,42.9,46.1,
37012, 북구,000,합계,2017,267865,132627,135238,98.1,265100,131158,133942,97.9
37012, 북구,005,0~4세,2017,11324,5844,5480,106.6,11289,5825,5464,106.6
37012, 북구,005001, 0세,2017,1875,986,889,110.9,1867,983,884,111.2
37012, 북구,005002, 1세,2017,2238,1144,1094,104.6,2230,1139,1091,104.4
37012, 북구,005003, 2세,2017,2425,1276,1149,111.1,2417,1270,1147,110.7
37012, 북구,005004, 3세,2017,2327,1179,1148,102.7,2324,1178,1146,102.8
37012, 북구,005005, 4세,2017,2459,1259,1200,104.9,2451,1255,1196,104.9
37012, 북구,010,5~9세,2017,12280,6450,5830,110.6,12262,6437,5825,110.5
37012, 북구,010001, 5세,2017,2605,1409,1196,117.8,2600,1406,1194,117.8
37012, 북구,010002, 6세,2017,2555,1353,1202,112.6,2553,1352,1201,112.6
37012, 북구,010003, 7세,2017,2428,1269,1159,109.5,2425,1266,1159,109.2
37012, 북구,010004, 8세,2017,2334,1209,1125,107.5,2328,1204,1124,107.1
37012, 북구,010005, 9세,2017,2358,1210,1148,105.4,2356,1209,1147,105.4
37012, 북구,015,10~14세,2017,12091,6335,5756,110.1,12073,6326,5747,110.1
37012, 북구,015001, 10세,2017,2443,1276,1167,109.3,2438,1272,1166,109.1
37012, 북구,015002, 11세,2017,2331,1231,1100,111.9,2327,1230,1097,112.1
37012, 북구,015003, 12세,2017,2261,1193,1068,111.7,2258,1191,1067,111.6
37012, 북구,015004, 13세,2017,2477,1304,1173,111.2,2474,1303,1171,111.3
37012, 북구,015005, 14세,2017,2579,1331,1248,106.7,2576,1330,1246,106.7
37012, 북구,020,15~19세,2017,15312,8045,7267,110.7,15158,7976,7182,111.1
37012, 북구,020001, 15세,2017,2645,1396,1249,111.8,2643,1395,1248,111.8
37012, 북구,020002, 16세,2017,2966,1545,1421,108.7,2965,1544,1421,108.7
37012, 북구,020003, 17세,2017,3551,1860,1691,110,3536,1850,1686,109.7
37012, 북구,020004, 18세,2017,3223,1702,1521,111.9,3189,1691,1498,112.9
37012, 북구,020005, 19세,2017,2927,1542,1385,111.3,2825,1496,1329,112.6
37012, 북구,025,20~24세,2017,16409,9138,7271,125.7,15821,8826,6995,126.2
37012, 북구,025001, 20세,2017,3395,1903,1492,127.5,3233,1826,1407,129.8
37012, 북구,025002, 21세,2017,3468,1987,1481,134.2,3358,1930,1428,135.2
37012, 북구,025003, 22세,2017,3344,1819,1525,119.3,3228,1755,1473,119.1
37012, 북구,025004, 23세,2017,3154,1710,1444,118.4,3052,1660,1392,119.3
37012, 북구,025005, 24세,2017,3048,1719,1329,129.3,2950,1655,1295,127.8
37012, 북구,030,25~29세,2017,13792,7570,6222,121.7,13287,7289,5998,121.5
37012, 북구,030001, 25세,2017,2967,1655,1312,126.1,2851,1586,1265,125.4
37012, 북구,030002, 26세,2017,2768,1543,1225,126,2672,1486,1186,125.3
37012, 북구,030003, 27세,2017,2758,1522,1236,123.1,2662,1464,1198,122.2
37012, 북구,030004, 28세,2017,2704,1478,1226,120.6,2598,1421,1177,120.7
37012, 북구,030005, 29세,2017,2595,1372,1223,112.2,2504,1332,1172,113.7
37012, 북구,035,30~34세,2017,15016,7702,7314,105.3,14643,7498,7145,104.9
37012, 북구,035001, 30세,2017,2623,1378,1245,110.7,2541,1332,1209,110.2
37012, 북구,035002, 31세,2017,2737,1443,1294,111.5,2672,1405,1267,110.9
37012, 북구,035003, 32세,2017,2881,1436,1445,99.4,2801,1392,1409,98.8
37012, 북구,035004, 33세,2017,3227,1602,1625,98.6,3154,1567,1587,98.7
37012, 북구,035005, 34세,2017,3548,1843,1705,108.1,3475,1802,1673,107.7
37012, 북구,040,35~39세,2017,19391,9753,9638,101.2,19123,9617,9506,101.2
37012, 북구,040001, 35세,2017,3987,1999,1988,100.6,3935,1973,1962,100.6
37012, 북구,040002, 36세,2017,4117,2098,2019,103.9,4058,2068,1990,103.9
37012, 북구,040003, 37세,2017,3972,2027,1945,104.2,3908,1995,1913,104.3
37012, 북구,040004, 38세,2017,3794,1855,1939,95.7,3736,1824,1912,95.4
37012, 북구,040005, 39세,2017,3521,1774,1747,101.5,3486,1757,1729,101.6
37012, 북구,045,40~44세,2017,19925,9759,10166,96,19692,9613,10079,95.4
37012, 북구,045001, 40세,2017,3778,1838,1940,94.7,3719,1805,1914,94.3
37012, 북구,045002, 41세,2017,3525,1738,1787,97.3,3489,1712,1777,96.3
37012, 북구,045003, 42세,2017,3900,1997,1903,104.9,3850,1965,1885,104.2
37012, 북구,045004, 43세,2017,4309,2085,2224,93.8,4269,2058,2211,93.1
37012, 북구,045005, 44세,2017,4413,2101,2312,90.9,4365,2073,2292,90.4
37012, 북구,050,45~49세,2017,23655,11564,12091,95.6,23465,11461,12004,95.5
37012, 북구,050001, 45세,2017,4452,2193,2259,97.1,4410,2171,2239,97
37012, 북구,050002, 46세,2017,4721,2300,2421,95,4678,2279,2399,95
37012, 북구,050003, 47세,2017,4801,2298,2503,91.8,4767,2277,2490,91.4
37012, 북구,050004, 48세,2017,4739,2349,2390,98.3,4700,2325,2375,97.9
37012, 북구,050005, 49세,2017,4942,2424,2518,96.3,4910,2409,2501,96.3
37012, 북구,055,50~54세,2017,23170,11238,11932,94.2,23028,11167,11861,94.1
37012, 북구,055001, 50세,2017,4363,2088,2275,91.8,4342,2079,2263,91.9
37012, 북구,055002, 51세,2017,4630,2303,2327,99,4605,2293,2312,99.2
37012, 북구,055003, 52세,2017,4794,2284,2510,91,4773,2271,2502,90.8
37012, 북구,055004, 53세,2017,4472,2174,2298,94.6,4440,2158,2282,94.6
37012, 북구,055005, 54세,2017,4911,2389,2522,94.7,4868,2366,2502,94.6
37012, 북구,060,55~59세,2017,25658,12462,13196,94.4,25556,12420,13136,94.5
37012, 북구,060001, 55세,2017,5023,2529,2494,101.4,5000,2517,2483,101.4
37012, 북구,060002, 56세,2017,5535,2689,2846,94.5,5516,2684,2832,94.8
37012, 북구,060003, 57세,2017,5436,2569,2867,89.6,5413,2561,2852,89.8
37012, 북구,060004, 58세,2017,5047,2405,2642,91,5027,2396,2631,91.1
37012, 북구,060005, 59세,2017,4617,2270,2347,96.7,4600,2262,2338,96.7
37012, 북구,065,60~64세,2017,20347,10125,10222,99.1,20273,10085,10188,99
37012, 북구,065001, 60세,2017,4633,2331,2302,101.3,4620,2324,2296,101.2
37012, 북구,065002, 61세,2017,4323,2117,2206,96,4306,2107,2199,95.8
37012, 북구,065003, 62세,2017,4337,2100,2237,93.9,4320,2091,2229,93.8
37012, 북구,065004, 63세,2017,3734,1917,1817,105.5,3713,1906,1807,105.5
37012, 북구,065005, 64세,2017,3320,1660,1660,100,3314,1657,1657,100
37012, 북구,070,65~69세,2017,13759,6882,6877,100.1,13727,6866,6861,100.1
37012, 북구,070001, 65세,2017,3398,1707,1691,100.9,3392,1706,1686,101.2
37012, 북구,070002, 66세,2017,2633,1324,1309,101.1,2626,1320,1306,101.1
37012, 북구,070003, 67세,2017,2597,1295,1302,99.5,2587,1289,1298,99.3
37012, 북구,070004, 68세,2017,2634,1336,1298,102.9,2631,1335,1296,103
37012, 북구,070005, 69세,2017,2497,1220,1277,95.5,2491,1216,1275,95.4
37012, 북구,075,70~74세,2017,9154,4218,4936,85.5,9139,4215,4924,85.6
37012, 북구,075001, 70세,2017,2299,1129,1170,96.5,2295,1128,1167,96.7
37012, 북구,075002, 71세,2017,1574,769,805,95.5,1571,768,803,95.6
37012, 북구,075003, 72세,2017,1608,737,871,84.6,1604,736,868,84.8
37012, 북구,075004, 73세,2017,1812,811,1001,81,1810,811,999,81.2
37012, 북구,075005, 74세,2017,1861,772,1089,70.9,1859,772,1087,71
37012, 북구,080,75~79세,2017,7999,3184,4815,66.1,7989,3181,4808,66.2
37012, 북구,080001, 75세,2017,2048,844,1204,70.1,2047,844,1203,70.2
37012, 북구,080002, 76세,2017,1632,676,956,70.7,1631,675,956,70.6
37012, 북구,080003, 77세,2017,1505,608,897,67.8,1501,606,895,67.7
37012, 북구,080004, 78세,2017,1536,616,920,67,1534,616,918,67.1
37012, 북구,080005, 79세,2017,1278,440,838,52.5,1276,440,836,52.6
37012, 북구,085,80~84세,2017,4864,1601,3263,49.1,4859,1600,3259,49.1
37012, 북구,085001, 80세,2017,1125,410,715,57.3,1122,410,712,57.6
37012, 북구,085002, 81세,2017,1079,385,694,55.5,1079,385,694,55.5
37012, 북구,085003, 82세,2017,988,300,688,43.6,987,299,688,43.5
37012, 북구,085004, 83세,2017,913,289,624,46.3,913,289,624,46.3
37012, 북구,085005, 84세,2017,759,217,542,40,758,217,541,40.1
37012, 북구,090,85~89세,2017,2603,572,2031,28.2,2600,571,2029,28.1
37012, 북구,090001, 85세,2017,707,182,525,34.7,706,182,524,34.7
37012, 북구,090002, 86세,2017,576,119,457,26,576,119,457,26
37012, 북구,090003, 87세,2017,505,117,388,30.2,505,117,388,30.2
37012, 북구,090004, 88세,2017,435,94,341,27.6,433,93,340,27.4
37012, 북구,090005, 89세,2017,380,60,320,18.8,380,60,320,18.8
37012, 북구,095,90~94세,2017,892,163,729,22.4,892,163,729,22.4
37012, 북구,095001, 90세,2017,314,54,260,20.8,314,54,260,20.8
37012, 북구,095002, 91세,2017,184,31,153,20.3,184,31,153,20.3
37012, 북구,095003, 92세,2017,168,29,139,20.9,168,29,139,20.9
37012, 북구,095004, 93세,2017,121,26,95,27.4,121,26,95,27.4
37012, 북구,095005, 94세,2017,105,23,82,28,105,23,82,28
37012, 북구,100,95~99세,2017,205,21,184,11.4,205,21,184,11.4
37012, 북구,100001, 95세,2017,92,12,80,15,92,12,80,15
37012, 북구,100002, 96세,2017,38,5,33,15.2,38,5,33,15.2
37012, 북구,100003, 97세,2017,45,X,44,2.3,45,X,44,2.3
37012, 북구,100004, 98세,2017,19,X,16,18.8,19,X,16,18.8
37012, 북구,100005, 99세,2017,11,X,11,0,11,X,11,0
37012, 북구,101,100세이상,2017,19,X,18,5.6,19,X,18,5.6
37012, 북구,102,15세미만,2017,35695,18629,17066,109.2,35624,18588,17036,109.1
37012, 북구,103,15~64세,2017,192675,97356,95319,102.1,190046,95952,94094,102
37012, 북구,104,65세이상,2017,39495,16642,22853,72.8,39430,16618,22812,72.8
37012, 북구,086,85세이상,2017,3719,757,2962,25.6,3716,756,2960,25.5
37012, 북구,126,평균연령,2017,42.5,40.9,44,,42.6,41,44.1,
37012, 북구,127,중위연령,2017,44.6,43,46.2,,44.8,43.1,46.3,
37020, 경주시,000,합계,2017,262264,133171,129093,103.2,249043,124646,124397,100.2
37020, 경주시,005,0~4세,2017,8511,4352,4159,104.6,8312,4244,4068,104.3
37020, 경주시,005001, 0세,2017,1470,767,703,109.1,1430,745,685,108.8
37020, 경주시,005002, 1세,2017,1710,853,857,99.5,1672,834,838,99.5
37020, 경주시,005003, 2세,2017,1762,865,897,96.4,1727,845,882,95.8
37020, 경주시,005004, 3세,2017,1769,923,846,109.1,1734,908,826,109.9
37020, 경주시,005005, 4세,2017,1800,944,856,110.3,1749,912,837,109
37020, 경주시,010,5~9세,2017,9835,5028,4807,104.6,9692,4961,4731,104.9
37020, 경주시,010001, 5세,2017,2005,1003,1002,100.1,1980,989,991,99.8
37020, 경주시,010002, 6세,2017,2015,1043,972,107.3,1983,1028,955,107.6
37020, 경주시,010003, 7세,2017,1895,965,930,103.8,1865,954,911,104.7
37020, 경주시,010004, 8세,2017,1893,984,909,108.3,1873,972,901,107.9
37020, 경주시,010005, 9세,2017,2027,1033,994,103.9,1991,1018,973,104.6
37020, 경주시,015,10~14세,2017,10089,5278,4811,109.7,9994,5227,4767,109.6
37020, 경주시,015001, 10세,2017,2029,1055,974,108.3,2008,1041,967,107.7
37020, 경주시,015002, 11세,2017,2018,1052,966,108.9,1993,1041,952,109.3
37020, 경주시,015003, 12세,2017,1891,997,894,111.5,1868,986,882,111.8
37020, 경주시,015004, 13세,2017,2036,1096,940,116.6,2026,1091,935,116.7
37020, 경주시,015005, 14세,2017,2115,1078,1037,104,2099,1068,1031,103.6
37020, 경주시,020,15~19세,2017,14321,7724,6597,117.1,13939,7542,6397,117.9
37020, 경주시,020001, 15세,2017,2255,1205,1050,114.8,2238,1193,1045,114.2
37020, 경주시,020002, 16세,2017,2567,1379,1188,116.1,2556,1374,1182,116.2
37020, 경주시,020003, 17세,2017,2984,1567,1417,110.6,2955,1551,1404,110.5
37020, 경주시,020004, 18세,2017,2986,1614,1372,117.6,2912,1583,1329,119.1
37020, 경주시,020005, 19세,2017,3529,1959,1570,124.8,3278,1841,1437,128.1
37020, 경주시,025,20~24세,2017,18057,10365,7692,134.8,16250,9338,6912,135.1
37020, 경주시,025001, 20세,2017,3785,2027,1758,115.3,3453,1875,1578,118.8
37020, 경주시,025002, 21세,2017,3720,2041,1679,121.6,3364,1863,1501,124.1
37020, 경주시,025003, 22세,2017,3601,2046,1555,131.6,3257,1855,1402,132.3
37020, 경주시,025004, 23세,2017,3488,2102,1386,151.7,3124,1863,1261,147.7
37020, 경주시,025005, 24세,2017,3463,2149,1314,163.5,3052,1882,1170,160.9
37020, 경주시,030,25~29세,2017,14963,8908,6055,147.1,12586,7218,5368,134.5
37020, 경주시,030001, 25세,2017,3252,1954,1298,150.5,2850,1650,1200,137.5
37020, 경주시,030002, 26세,2017,3083,1824,1259,144.9,2614,1492,1122,133
37020, 경주시,030003, 27세,2017,3058,1848,1210,152.7,2562,1502,1060,141.7
37020, 경주시,030004, 28세,2017,2859,1713,1146,149.5,2366,1359,1007,135
37020, 경주시,030005, 29세,2017,2711,1569,1142,137.4,2194,1215,979,124.1
37020, 경주시,035,30~34세,2017,14145,7993,6152,129.9,11742,6270,5472,114.6
37020, 경주시,035001, 30세,2017,2786,1598,1188,134.5,2266,1233,1033,119.4
37020, 경주시,035002, 31세,2017,2610,1515,1095,138.4,2105,1163,942,123.5
37020, 경주시,035003, 32세,2017,2686,1535,1151,133.4,2193,1170,1023,114.4
37020, 경주시,035004, 33세,2017,2866,1589,1277,124.4,2379,1236,1143,108.1
37020, 경주시,035005, 34세,2017,3197,1756,1441,121.9,2799,1468,1331,110.3
37020, 경주시,040,35~39세,2017,17233,9375,7858,119.3,15413,8084,7329,110.3
37020, 경주시,040001, 35세,2017,3465,1911,1554,123,3020,1589,1431,111
37020, 경주시,040002, 36세,2017,3568,1956,1612,121.3,3210,1690,1520,111.2
37020, 경주시,040003, 37세,2017,3594,1920,1674,114.7,3246,1672,1574,106.2
37020, 경주시,040004, 38세,2017,3376,1856,1520,122.1,3023,1612,1411,114.2
37020, 경주시,040005, 39세,2017,3230,1732,1498,115.6,2914,1521,1393,109.2
37020, 경주시,045,40~44세,2017,18570,9762,8808,110.8,17312,8927,8385,106.5
37020, 경주시,045001, 40세,2017,3286,1786,1500,119.1,3010,1593,1417,112.4
37020, 경주시,045002, 41세,2017,3337,1772,1565,113.2,3054,1581,1473,107.3
37020, 경주시,045003, 42세,2017,3660,1948,1712,113.8,3432,1802,1630,110.6
37020, 경주시,045004, 43세,2017,4120,2136,1984,107.7,3867,1980,1887,104.9
37020, 경주시,045005, 44세,2017,4167,2120,2047,103.6,3949,1971,1978,99.6
37020, 경주시,050,45~49세,2017,22432,11722,10710,109.4,21369,11085,10284,107.8
37020, 경주시,050001, 45세,2017,4316,2292,2024,113.2,4071,2132,1939,110
37020, 경주시,050002, 46세,2017,4449,2307,2142,107.7,4236,2182,2054,106.2
37020, 경주시,050003, 47세,2017,4432,2328,2104,110.6,4219,2201,2018,109.1
37020, 경주시,050004, 48세,2017,4451,2311,2140,108,4265,2205,2060,107
37020, 경주시,050005, 49세,2017,4784,2484,2300,108,4578,2365,2213,106.9
37020, 경주시,055,50~54세,2017,21995,11354,10641,106.7,21247,10918,10329,105.7
37020, 경주시,055001, 50세,2017,4333,2210,2123,104.1,4184,2117,2067,102.4
37020, 경주시,055002, 51세,2017,4358,2290,2068,110.7,4216,2211,2005,110.3
37020, 경주시,055003, 52세,2017,4364,2240,2124,105.5,4202,2149,2053,104.7
37020, 경주시,055004, 53세,2017,4303,2190,2113,103.6,4147,2096,2051,102.2
37020, 경주시,055005, 54세,2017,4637,2424,2213,109.5,4498,2345,2153,108.9
37020, 경주시,060,55~59세,2017,23488,11996,11492,104.4,23013,11731,11282,104
37020, 경주시,060001, 55세,2017,4773,2466,2307,106.9,4653,2403,2250,106.8
37020, 경주시,060002, 56세,2017,4963,2549,2414,105.6,4868,2489,2379,104.6
37020, 경주시,060003, 57세,2017,4874,2505,2369,105.7,4776,2452,2324,105.5
37020, 경주시,060004, 58세,2017,4591,2307,2284,101,4518,2271,2247,101.1
37020, 경주시,060005, 59세,2017,4287,2169,2118,102.4,4198,2116,2082,101.6
37020, 경주시,065,60~64세,2017,19339,9435,9904,95.3,19084,9307,9777,95.2
37020, 경주시,065001, 60세,2017,4215,2094,2121,98.7,4136,2056,2080,98.8
37020, 경주시,065002, 61세,2017,4202,2077,2125,97.7,4154,2050,2104,97.4
37020, 경주시,065003, 62세,2017,4016,1922,2094,91.8,3960,1893,2067,91.6
37020, 경주시,065004, 63세,2017,3535,1710,1825,93.7,3492,1690,1802,93.8
37020, 경주시,065005, 64세,2017,3371,1632,1739,93.8,3342,1618,1724,93.9
37020, 경주시,070,65~69세,2017,15142,7153,7989,89.5,15038,7103,7935,89.5
37020, 경주시,070001, 65세,2017,3394,1557,1837,84.8,3358,1536,1822,84.3
37020, 경주시,070002, 66세,2017,2935,1392,1543,90.2,2911,1384,1527,90.6
37020, 경주시,070003, 67세,2017,2885,1341,1544,86.9,2864,1332,1532,86.9
37020, 경주시,070004, 68세,2017,3113,1513,1600,94.6,3100,1507,1593,94.6
37020, 경주시,070005, 69세,2017,2815,1350,1465,92.2,2805,1344,1461,92
37020, 경주시,075,70~74세,2017,11182,4999,6183,80.9,11134,4977,6157,80.8
37020, 경주시,075001, 70세,2017,2673,1248,1425,87.6,2662,1243,1419,87.6
37020, 경주시,075002, 71세,2017,1814,867,947,91.6,1799,860,939,91.6
37020, 경주시,075003, 72세,2017,2068,914,1154,79.2,2062,911,1151,79.1
37020, 경주시,075004, 73세,2017,2166,931,1235,75.4,2154,926,1228,75.4
37020, 경주시,075005, 74세,2017,2461,1039,1422,73.1,2457,1037,1420,73
37020, 경주시,080,75~79세,2017,11094,4270,6824,62.6,11074,4259,6815,62.5
37020, 경주시,080001, 75세,2017,2895,1228,1667,73.7,2889,1224,1665,73.5
37020, 경주시,080002, 76세,2017,2126,814,1312,62,2123,812,1311,61.9
37020, 경주시,080003, 77세,2017,2039,775,1264,61.3,2036,775,1261,61.5
37020, 경주시,080004, 78세,2017,2179,799,1380,57.9,2177,799,1378,58
37020, 경주시,080005, 79세,2017,1855,654,1201,54.5,1849,649,1200,54.1
37020, 경주시,085,80~84세,2017,7335,2378,4957,48,7322,2377,4945,48.1
37020, 경주시,085001, 80세,2017,1793,644,1149,56,1788,643,1145,56.2
37020, 경주시,085002, 81세,2017,1608,532,1076,49.4,1606,532,1074,49.5
37020, 경주시,085003, 82세,2017,1448,450,998,45.1,1446,450,996,45.2
37020, 경주시,085004, 83세,2017,1305,419,886,47.3,1302,419,883,47.5
37020, 경주시,085005, 84세,2017,1181,333,848,39.3,1180,333,847,39.3
37020, 경주시,090,85~89세,2017,3294,833,2461,33.8,3287,832,2455,33.9
37020, 경주시,090001, 85세,2017,978,293,685,42.8,976,293,683,42.9
37020, 경주시,090002, 86세,2017,733,184,549,33.5,733,184,549,33.5
37020, 경주시,090003, 87세,2017,618,148,470,31.5,618,148,470,31.5
37020, 경주시,090004, 88세,2017,536,124,412,30.1,533,123,410,30
37020, 경주시,090005, 89세,2017,429,84,345,24.3,427,84,343,24.5
37020, 경주시,095,90~94세,2017,985,204,781,26.1,982,204,778,26.2
37020, 경주시,095001, 90세,2017,348,69,279,24.7,348,69,279,24.7
37020, 경주시,095002, 91세,2017,178,34,144,23.6,178,34,144,23.6
37020, 경주시,095003, 92세,2017,181,42,139,30.2,178,42,136,30.9
37020, 경주시,095004, 93세,2017,121,33,88,37.5,121,33,88,37.5
37020, 경주시,095005, 94세,2017,157,26,131,19.8,157,26,131,19.8
37020, 경주시,100,95~99세,2017,231,40,191,20.9,230,40,190,21.1
37020, 경주시,100001, 95세,2017,101,18,83,21.7,101,18,83,21.7
37020, 경주시,100002, 96세,2017,59,10,49,20.4,59,10,49,20.4
37020, 경주시,100003, 97세,2017,34,5,29,17.2,33,5,28,17.9
37020, 경주시,100004, 98세,2017,22,5,17,29.4,22,5,17,29.4
37020, 경주시,100005, 99세,2017,15,X,13,15.4,15,X,13,15.4
37020, 경주시,101,100세이상,2017,23,X,21,9.5,23,X,21,9.5
37020, 경주시,102,15세미만,2017,28435,14658,13777,106.4,27998,14432,13566,106.4
37020, 경주시,103,15~64세,2017,184543,98634,85909,114.8,171955,90420,81535,110.9
37020, 경주시,104,65세이상,2017,49286,19879,29407,67.6,49090,19794,29296,67.6
37020, 경주시,086,85세이상,2017,4533,1079,3454,31.2,4522,1078,3444,31.3
37020, 경주시,126,평균연령,2017,44.5,42.4,46.5,,45,43,47,
37020, 경주시,127,중위연령,2017,46.2,44,48.6,,47.2,45.2,49.3,
37030, 김천시,000,합계,2017,140765,70240,70525,99.6,138199,68744,69455,99
37030, 김천시,005,0~4세,2017,5669,2889,2780,103.9,5652,2878,2774,103.7
37030, 김천시,005001, 0세,2017,1029,524,505,103.8,1026,522,504,103.6
37030, 김천시,005002, 1세,2017,1205,611,594,102.9,1200,608,592,102.7
37030, 김천시,005003, 2세,2017,1140,552,588,93.9,1135,550,585,94
37030, 김천시,005004, 3세,2017,1134,588,546,107.7,1134,588,546,107.7
37030, 김천시,005005, 4세,2017,1161,614,547,112.2,1157,610,547,111.5
37030, 김천시,010,5~9세,2017,5728,2995,2733,109.6,5722,2995,2727,109.8
37030, 김천시,010001, 5세,2017,1218,623,595,104.7,1215,623,592,105.2
37030, 김천시,010002, 6세,2017,1173,614,559,109.8,1171,614,557,110.2
37030, 김천시,010003, 7세,2017,1108,563,545,103.3,1107,563,544,103.5
37030, 김천시,010004, 8세,2017,1069,567,502,112.9,1069,567,502,112.9
37030, 김천시,010005, 9세,2017,1160,628,532,118,1160,628,532,118
37030, 김천시,015,10~14세,2017,5335,2796,2539,110.1,5327,2793,2534,110.2
37030, 김천시,015001, 10세,2017,1094,562,532,105.6,1092,562,530,106
37030, 김천시,015002, 11세,2017,1004,558,446,125.1,1002,557,445,125.2
37030, 김천시,015003, 12세,2017,1017,496,521,95.2,1016,495,521,95
37030, 김천시,015004, 13세,2017,1115,584,531,110,1114,584,530,110.2
37030, 김천시,015005, 14세,2017,1105,596,509,117.1,1103,595,508,117.1
37030, 김천시,020,15~19세,2017,7769,4209,3560,118.2,7613,4144,3469,119.5
37030, 김천시,020001, 15세,2017,1271,699,572,122.2,1268,697,571,122.1
37030, 김천시,020002, 16세,2017,1564,879,685,128.3,1560,877,683,128.4
37030, 김천시,020003, 17세,2017,1663,922,741,124.4,1643,917,726,126.3
37030, 김천시,020004, 18세,2017,1659,912,747,122.1,1601,888,713,124.5
37030, 김천시,020005, 19세,2017,1612,797,815,97.8,1541,765,776,98.6
37030, 김천시,025,20~24세,2017,8988,4800,4188,114.6,8475,4525,3950,114.6
37030, 김천시,025001, 20세,2017,1843,883,960,92,1764,844,920,91.7
37030, 김천시,025002, 21세,2017,1942,938,1004,93.4,1834,889,945,94.1
37030, 김천시,025003, 22세,2017,1868,967,901,107.3,1766,921,845,109
37030, 김천시,025004, 23세,2017,1693,1047,646,162.1,1575,974,601,162.1
37030, 김천시,025005, 24세,2017,1642,965,677,142.5,1536,897,639,140.4
37030, 김천시,030,25~29세,2017,7662,4288,3374,127.1,7074,3901,3173,122.9
37030, 김천시,030001, 25세,2017,1682,915,767,119.3,1550,828,722,114.7
37030, 김천시,030002, 26세,2017,1565,882,683,129.1,1449,800,649,123.3
37030, 김천시,030003, 27세,2017,1508,841,667,126.1,1378,761,617,123.3
37030, 김천시,030004, 28세,2017,1458,835,623,134,1347,767,580,132.2
37030, 김천시,030005, 29세,2017,1449,815,634,128.5,1350,745,605,123.1
37030, 김천시,035,30~34세,2017,7713,4124,3589,114.9,7329,3876,3453,112.3
37030, 김천시,035001, 30세,2017,1416,797,619,128.8,1334,742,592,125.3
37030, 김천시,035002, 31세,2017,1473,802,671,119.5,1377,744,633,117.5
37030, 김천시,035003, 32세,2017,1532,804,728,110.4,1450,751,699,107.4
37030, 김천시,035004, 33세,2017,1557,834,723,115.4,1494,794,700,113.4
37030, 김천시,035005, 34세,2017,1735,887,848,104.6,1674,845,829,101.9
37030, 김천시,040,35~39세,2017,9345,4975,4370,113.8,9106,4818,4288,112.4
37030, 김천시,040001, 35세,2017,1973,1029,944,109,1920,990,930,106.5
37030, 김천시,040002, 36세,2017,1970,1061,909,116.7,1907,1020,887,115
37030, 김천시,040003, 37세,2017,1956,1033,923,111.9,1912,1008,904,111.5
37030, 김천시,040004, 38세,2017,1765,949,816,116.3,1719,918,801,114.6
37030, 김천시,040005, 39세,2017,1681,903,778,116.1,1648,882,766,115.1
37030, 김천시,045,40~44세,2017,9228,4837,4391,110.2,9078,4738,4340,109.2
37030, 김천시,045001, 40세,2017,1785,961,824,116.6,1755,942,813,115.9
37030, 김천시,045002, 41세,2017,1692,896,796,112.6,1651,869,782,111.1
37030, 김천시,045003, 42세,2017,1800,950,850,111.8,1773,932,841,110.8
37030, 김천시,045004, 43세,2017,1955,1015,940,108,1925,993,932,106.5
37030, 김천시,045005, 44세,2017,1996,1015,981,103.5,1974,1002,972,103.1
37030, 김천시,050,45~49세,2017,10910,5702,5208,109.5,10766,5626,5140,109.5
37030, 김천시,050001, 45세,2017,2037,1095,942,116.2,2010,1077,933,115.4
37030, 김천시,050002, 46세,2017,2116,1096,1020,107.5,2085,1079,1006,107.3
37030, 김천시,050003, 47세,2017,2201,1161,1040,111.6,2178,1146,1032,111
37030, 김천시,050004, 48세,2017,2260,1166,1094,106.6,2225,1149,1076,106.8
37030, 김천시,050005, 49세,2017,2296,1184,1112,106.5,2268,1175,1093,107.5
37030, 김천시,055,50~54세,2017,10902,5761,5141,112.1,10754,5687,5067,112.2
37030, 김천시,055001, 50세,2017,2180,1140,1040,109.6,2155,1127,1028,109.6
37030, 김천시,055002, 51세,2017,2164,1145,1019,112.4,2137,1131,1006,112.4
37030, 김천시,055003, 52세,2017,2129,1112,1017,109.3,2089,1093,996,109.7
37030, 김천시,055004, 53세,2017,2114,1145,969,118.2,2074,1125,949,118.5
37030, 김천시,055005, 54세,2017,2315,1219,1096,111.2,2299,1211,1088,111.3
37030, 김천시,060,55~59세,2017,12302,6214,6088,102.1,12196,6158,6038,102
37030, 김천시,060001, 55세,2017,2422,1204,1218,98.9,2404,1198,1206,99.3
37030, 김천시,060002, 56세,2017,2706,1385,1321,104.8,2688,1378,1310,105.2
37030, 김천시,060003, 57세,2017,2615,1299,1316,98.7,2592,1284,1308,98.2
37030, 김천시,060004, 58세,2017,2353,1192,1161,102.7,2323,1174,1149,102.2
37030, 김천시,060005, 59세,2017,2206,1134,1072,105.8,2189,1124,1065,105.5
37030, 김천시,065,60~64세,2017,10394,5049,5345,94.5,10346,5029,5317,94.6
37030, 김천시,065001, 60세,2017,2274,1150,1124,102.3,2265,1145,1120,102.2
37030, 김천시,065002, 61세,2017,2198,1082,1116,97,2183,1079,1104,97.7
37030, 김천시,065003, 62세,2017,2099,1009,1090,92.6,2090,1003,1087,92.3
37030, 김천시,065004, 63세,2017,1942,922,1020,90.4,1936,919,1017,90.4
37030, 김천시,065005, 64세,2017,1881,886,995,89,1872,883,989,89.3
37030, 김천시,070,65~69세,2017,8268,3929,4339,90.6,8237,3919,4318,90.8
37030, 김천시,070001, 65세,2017,2030,956,1074,89,2021,954,1067,89.4
37030, 김천시,070002, 66세,2017,1434,662,772,85.8,1426,658,768,85.7
37030, 김천시,070003, 67세,2017,1536,756,780,96.9,1530,753,777,96.9
37030, 김천시,070004, 68세,2017,1674,789,885,89.2,1670,788,882,89.3
37030, 김천시,070005, 69세,2017,1594,766,828,92.5,1590,766,824,93
37030, 김천시,075,70~74세,2017,6210,2740,3470,79,6195,2729,3466,78.7
37030, 김천시,075001, 70세,2017,1533,719,814,88.3,1526,714,812,87.9
37030, 김천시,075002, 71세,2017,1013,459,554,82.9,1010,458,552,83
37030, 김천시,075003, 72세,2017,1010,467,543,86,1008,465,543,85.6
37030, 김천시,075004, 73세,2017,1258,531,727,73,1258,531,727,73
37030, 김천시,075005, 74세,2017,1396,564,832,67.8,1393,561,832,67.4
37030, 김천시,080,75~79세,2017,6626,2499,4127,60.6,6620,2498,4122,60.6
37030, 김천시,080001, 75세,2017,1470,577,893,64.6,1470,577,893,64.6
37030, 김천시,080002, 76세,2017,1303,493,810,60.9,1301,493,808,61
37030, 김천시,080003, 77세,2017,1327,502,825,60.8,1326,501,825,60.7
37030, 김천시,080004, 78세,2017,1325,484,841,57.6,1325,484,841,57.6
37030, 김천시,080005, 79세,2017,1201,443,758,58.4,1198,443,755,58.7
37030, 김천시,085,80~84세,2017,4650,1614,3036,53.2,4649,1613,3036,53.1
37030, 김천시,085001, 80세,2017,1103,400,703,56.9,1103,400,703,56.9
37030, 김천시,085002, 81세,2017,1048,368,680,54.1,1047,367,680,54
37030, 김천시,085003, 82세,2017,1005,357,648,55.1,1005,357,648,55.1
37030, 김천시,085004, 83세,2017,801,267,534,50,801,267,534,50
37030, 김천시,085005, 84세,2017,693,222,471,47.1,693,222,471,47.1
37030, 김천시,090,85~89세,2017,2205,637,1568,40.6,2201,635,1566,40.5
37030, 김천시,090001, 85세,2017,594,178,416,42.8,594,178,416,42.8
37030, 김천시,090002, 86세,2017,487,159,328,48.5,484,157,327,48
37030, 김천시,090003, 87세,2017,463,129,334,38.6,463,129,334,38.6
37030, 김천시,090004, 88세,2017,353,97,256,37.9,353,97,256,37.9
37030, 김천시,090005, 89세,2017,308,74,234,31.6,307,74,233,31.8
37030, 김천시,095,90~94세,2017,666,156,510,30.6,665,156,509,30.6
37030, 김천시,095001, 90세,2017,248,64,184,34.8,247,64,183,35
37030, 김천시,095002, 91세,2017,142,36,106,34,142,36,106,34
37030, 김천시,095003, 92세,2017,121,27,94,28.7,121,27,94,28.7
37030, 김천시,095004, 93세,2017,73,15,58,25.9,73,15,58,25.9
37030, 김천시,095005, 94세,2017,82,14,68,20.6,82,14,68,20.6
37030, 김천시,100,95~99세,2017,177,22,155,14.2,176,22,154,14.3
37030, 김천시,100001, 95세,2017,75,10,65,15.4,74,10,64,15.6
37030, 김천시,100002, 96세,2017,45,7,38,18.4,45,7,38,18.4
37030, 김천시,100003, 97세,2017,30,X,28,7.1,30,X,28,7.1
37030, 김천시,100004, 98세,2017,17,X,16,6.3,17,X,16,6.3
37030, 김천시,100005, 99세,2017,10,X,8,25,10,X,8,25
37030, 김천시,101,100세이상,2017,18,X,14,28.6,18,X,14,28.6
37030, 김천시,102,15세미만,2017,16732,8680,8052,107.8,16701,8666,8035,107.9
37030, 김천시,103,15~64세,2017,95213,49959,45254,110.4,92737,48502,44235,109.6
37030, 김천시,104,65세이상,2017,28820,11601,17219,67.4,28761,11576,17185,67.4
37030, 김천시,086,85세이상,2017,3066,819,2247,36.4,3060,817,2243,36.4
37030, 김천시,126,평균연령,2017,44.7,42.7,46.7,,44.9,42.9,46.8,
37030, 김천시,127,중위연령,2017,46.4,44.2,48.7,,46.8,44.7,49,
37040, 안동시,000,합계,2017,165704,81894,83810,97.7,164012,81043,82969,97.7
37040, 안동시,005,0~4세,2017,6273,3276,2997,109.3,6267,3273,2994,109.3
37040, 안동시,005001, 0세,2017,1230,634,596,106.4,1228,633,595,106.4
37040, 안동시,005002, 1세,2017,1288,684,604,113.2,1285,683,602,113.5
37040, 안동시,005003, 2세,2017,1304,679,625,108.6,1303,678,625,108.5
37040, 안동시,005004, 3세,2017,1160,594,566,104.9,1160,594,566,104.9
37040, 안동시,005005, 4세,2017,1291,685,606,113,1291,685,606,113
37040, 안동시,010,5~9세,2017,6567,3427,3140,109.1,6565,3425,3140,109.1
37040, 안동시,010001, 5세,2017,1409,739,670,110.3,1409,739,670,110.3
37040, 안동시,010002, 6세,2017,1300,697,603,115.6,1299,696,603,115.4
37040, 안동시,010003, 7세,2017,1272,669,603,110.9,1271,668,603,110.8
37040, 안동시,010004, 8세,2017,1246,631,615,102.6,1246,631,615,102.6
37040, 안동시,010005, 9세,2017,1340,691,649,106.5,1340,691,649,106.5
37040, 안동시,015,10~14세,2017,6717,3511,3206,109.5,6713,3510,3203,109.6
37040, 안동시,015001, 10세,2017,1342,688,654,105.2,1342,688,654,105.2
37040, 안동시,015002, 11세,2017,1298,699,599,116.7,1297,698,599,116.5
37040, 안동시,015003, 12세,2017,1276,668,608,109.9,1275,668,607,110
37040, 안동시,015004, 13세,2017,1397,739,658,112.3,1396,739,657,112.5
37040, 안동시,015005, 14세,2017,1404,717,687,104.4,1403,717,686,104.5
37040, 안동시,020,15~19세,2017,10150,5200,4950,105.1,10124,5192,4932,105.3
37040, 안동시,020001, 15세,2017,1580,826,754,109.5,1580,826,754,109.5
37040, 안동시,020002, 16세,2017,1864,979,885,110.6,1864,979,885,110.6
37040, 안동시,020003, 17세,2017,1914,999,915,109.2,1911,997,914,109.1
37040, 안동시,020004, 18세,2017,2146,1114,1032,107.9,2144,1113,1031,108
37040, 안동시,020005, 19세,2017,2646,1282,1364,94,2625,1277,1348,94.7
37040, 안동시,025,20~24세,2017,11309,6084,5225,116.4,11106,5975,5131,116.4
37040, 안동시,025001, 20세,2017,2410,1105,1305,84.7,2386,1091,1295,84.2
37040, 안동시,025002, 21세,2017,2354,1123,1231,91.2,2325,1108,1217,91
37040, 안동시,025003, 22세,2017,2417,1336,1081,123.6,2372,1311,1061,123.6
37040, 안동시,025004, 23세,2017,2147,1324,823,160.9,2094,1290,804,160.4
37040, 안동시,025005, 24세,2017,1981,1196,785,152.4,1929,1175,754,155.8
37040, 안동시,030,25~29세,2017,7720,4321,3399,127.1,7375,4144,3231,128.3
37040, 안동시,030001, 25세,2017,1714,995,719,138.4,1637,958,679,141.1
37040, 안동시,030002, 26세,2017,1572,894,678,131.9,1508,859,649,132.4
37040, 안동시,030003, 27세,2017,1507,848,659,128.7,1448,820,628,130.6
37040, 안동시,030004, 28세,2017,1457,801,656,122.1,1381,762,619,123.1
37040, 안동시,030005, 29세,2017,1470,783,687,114,1401,745,656,113.6
37040, 안동시,035,30~34세,2017,8057,4100,3957,103.6,7754,3937,3817,103.1
37040, 안동시,035001, 30세,2017,1528,781,747,104.6,1463,747,716,104.3
37040, 안동시,035002, 31세,2017,1533,792,741,106.9,1464,752,712,105.6
37040, 안동시,035003, 32세,2017,1510,789,721,109.4,1441,752,689,109.1
37040, 안동시,035004, 33세,2017,1644,848,796,106.5,1587,818,769,106.4
37040, 안동시,035005, 34세,2017,1842,890,952,93.5,1799,868,931,93.2
37040, 안동시,040,35~39세,2017,10080,5037,5043,99.9,9925,4961,4964,99.9
37040, 안동시,040001, 35세,2017,2021,964,1057,91.2,1982,943,1039,90.8
37040, 안동시,040002, 36세,2017,1965,949,1016,93.4,1927,931,996,93.5
37040, 안동시,040003, 37세,2017,2187,1096,1091,100.5,2159,1089,1070,101.8
37040, 안동시,040004, 38세,2017,1949,1010,939,107.6,1925,998,927,107.7
37040, 안동시,040005, 39세,2017,1958,1018,940,108.3,1932,1000,932,107.3
37040, 안동시,045,40~44세,2017,11483,5933,5550,106.9,11339,5852,5487,106.7
37040, 안동시,045001, 40세,2017,2115,1064,1051,101.2,2082,1046,1036,101
37040, 안동시,045002, 41세,2017,2108,1077,1031,104.5,2082,1064,1018,104.5
37040, 안동시,045003, 42세,2017,2357,1159,1198,96.7,2339,1151,1188,96.9
37040, 안동시,045004, 43세,2017,2393,1312,1081,121.4,2358,1292,1066,121.2
37040, 안동시,045005, 44세,2017,2510,1321,1189,111.1,2478,1299,1179,110.2
37040, 안동시,050,45~49세,2017,13068,6861,6207,110.5,12936,6806,6130,111
37040, 안동시,050001, 45세,2017,2373,1259,1114,113,2354,1253,1101,113.8
37040, 안동시,050002, 46세,2017,2612,1389,1223,113.6,2590,1379,1211,113.9
37040, 안동시,050003, 47세,2017,2640,1368,1272,107.5,2605,1355,1250,108.4
37040, 안동시,050004, 48세,2017,2690,1416,1274,111.1,2661,1404,1257,111.7
37040, 안동시,050005, 49세,2017,2753,1429,1324,107.9,2726,1415,1311,107.9
37040, 안동시,055,50~54세,2017,12458,6380,6078,105,12312,6318,5994,105.4
37040, 안동시,055001, 50세,2017,2484,1288,1196,107.7,2442,1267,1175,107.8
37040, 안동시,055002, 51세,2017,2513,1296,1217,106.5,2489,1287,1202,107.1
37040, 안동시,055003, 52세,2017,2449,1247,1202,103.7,2421,1234,1187,104
37040, 안동시,055004, 53세,2017,2425,1234,1191,103.6,2396,1223,1173,104.3
37040, 안동시,055005, 54세,2017,2587,1315,1272,103.4,2564,1307,1257,104
37040, 안동시,060,55~59세,2017,14588,7184,7404,97,14490,7133,7357,97
37040, 안동시,060001, 55세,2017,2663,1308,1355,96.5,2633,1293,1340,96.5
37040, 안동시,060002, 56세,2017,3251,1602,1649,97.1,3237,1595,1642,97.1
37040, 안동시,060003, 57세,2017,3343,1636,1707,95.8,3321,1624,1697,95.7
37040, 안동시,060004, 58세,2017,2675,1308,1367,95.7,2658,1300,1358,95.7
37040, 안동시,060005, 59세,2017,2656,1330,1326,100.3,2641,1321,1320,100.1
37040, 안동시,065,60~64세,2017,12324,5998,6326,94.8,12240,5956,6284,94.8
37040, 안동시,065001, 60세,2017,2711,1380,1331,103.7,2685,1369,1316,104
37040, 안동시,065002, 61세,2017,2604,1326,1278,103.8,2587,1316,1271,103.5
37040, 안동시,065003, 62세,2017,2458,1173,1285,91.3,2439,1162,1277,91
37040, 안동시,065004, 63세,2017,2280,1113,1167,95.4,2269,1106,1163,95.1
37040, 안동시,065005, 64세,2017,2271,1006,1265,79.5,2260,1003,1257,79.8
37040, 안동시,070,65~69세,2017,9862,4814,5048,95.4,9831,4797,5034,95.3
37040, 안동시,070001, 65세,2017,2417,1132,1285,88.1,2404,1127,1277,88.3
37040, 안동시,070002, 66세,2017,1798,842,956,88.1,1793,838,955,87.7
37040, 안동시,070003, 67세,2017,1746,881,865,101.8,1739,878,861,102
37040, 안동시,070004, 68세,2017,1968,998,970,102.9,1965,996,969,102.8
37040, 안동시,070005, 69세,2017,1933,961,972,98.9,1930,958,972,98.6
37040, 안동시,075,70~74세,2017,7816,3491,4325,80.7,7813,3490,4323,80.7
37040, 안동시,075001, 70세,2017,1814,866,948,91.4,1814,866,948,91.4
37040, 안동시,075002, 71세,2017,1227,583,644,90.5,1226,582,644,90.4
37040, 안동시,075003, 72세,2017,1313,584,729,80.1,1313,584,729,80.1
37040, 안동시,075004, 73세,2017,1605,653,952,68.6,1604,653,951,68.7
37040, 안동시,075005, 74세,2017,1857,805,1052,76.5,1856,805,1051,76.6
37040, 안동시,080,75~79세,2017,8223,3393,4830,70.2,8219,3391,4828,70.2
37040, 안동시,080001, 75세,2017,2091,916,1175,78,2089,915,1174,77.9
37040, 안동시,080002, 76세,2017,1595,665,930,71.5,1595,665,930,71.5
37040, 안동시,080003, 77세,2017,1546,635,911,69.7,1545,635,910,69.8
37040, 안동시,080004, 78세,2017,1629,656,973,67.4,1629,656,973,67.4
37040, 안동시,080005, 79세,2017,1362,521,841,62,1361,520,841,61.8
37040, 안동시,085,80~84세,2017,5288,1926,3362,57.3,5285,1926,3359,57.3
37040, 안동시,085001, 80세,2017,1178,451,727,62,1177,451,726,62.1
37040, 안동시,085002, 81세,2017,1148,444,704,63.1,1146,444,702,63.2
37040, 안동시,085003, 82세,2017,1188,445,743,59.9,1188,445,743,59.9
37040, 안동시,085004, 83세,2017,966,325,641,50.7,966,325,641,50.7
37040, 안동시,085005, 84세,2017,808,261,547,47.7,808,261,547,47.7
37040, 안동시,090,85~89세,2017,2630,715,1915,37.3,2627,714,1913,37.3
37040, 안동시,090001, 85세,2017,756,230,526,43.7,755,230,525,43.8
37040, 안동시,090002, 86세,2017,559,153,406,37.7,558,152,406,37.4
37040, 안동시,090003, 87세,2017,518,114,404,28.2,517,114,403,28.3
37040, 안동시,090004, 88세,2017,432,139,293,47.4,432,139,293,47.4
37040, 안동시,090005, 89세,2017,365,79,286,27.6,365,79,286,27.6
37040, 안동시,095,90~94세,2017,900,210,690,30.4,900,210,690,30.4
37040, 안동시,095001, 90세,2017,282,65,217,30,282,65,217,30
37040, 안동시,095002, 91세,2017,218,56,162,34.6,218,56,162,34.6
37040, 안동시,095003, 92세,2017,185,44,141,31.2,185,44,141,31.2
37040, 안동시,095004, 93세,2017,107,22,85,25.9,107,22,85,25.9
37040, 안동시,095005, 94세,2017,108,23,85,27.1,108,23,85,27.1
37040, 안동시,100,95~99세,2017,170,30,140,21.4,170,30,140,21.4
37040, 안동시,100001, 95세,2017,62,10,52,19.2,62,10,52,19.2
37040, 안동시,100002, 96세,2017,47,8,39,20.5,47,8,39,20.5
37040, 안동시,100003, 97세,2017,26,7,19,36.8,26,7,19,36.8
37040, 안동시,100004, 98세,2017,18,X,15,20,18,X,15,20
37040, 안동시,100005, 99세,2017,17,X,15,13.3,17,X,15,13.3
37040, 안동시,101,100세이상,2017,21,X,18,16.7,21,X,18,16.7
37040, 안동시,102,15세미만,2017,19557,10214,9343,109.3,19545,10208,9337,109.3
37040, 안동시,103,15~64세,2017,111237,57098,54139,105.5,109601,56274,53327,105.5
37040, 안동시,104,65세이상,2017,34910,14582,20328,71.7,34866,14561,20305,71.7
37040, 안동시,086,85세이상,2017,3721,958,2763,34.7,3718,957,2761,34.7
37040, 안동시,126,평균연령,2017,44.9,43.1,46.6,,45,43.2,46.7,
37040, 안동시,127,중위연령,2017,46.8,45,48.7,,47,45.2,48.8,
37050, 구미시,000,합계,2017,423003,218610,204393,107,416306,214675,201631,106.5
37050, 구미시,005,0~4세,2017,22611,11664,10947,106.5,22518,11618,10900,106.6
37050, 구미시,005001, 0세,2017,3857,1975,1882,104.9,3829,1959,1870,104.8
37050, 구미시,005002, 1세,2017,4453,2261,2192,103.1,4429,2250,2179,103.3
37050, 구미시,005003, 2세,2017,4872,2500,2372,105.4,4858,2497,2361,105.8
37050, 구미시,005004, 3세,2017,4669,2471,2198,112.4,4651,2462,2189,112.5
37050, 구미시,005005, 4세,2017,4760,2457,2303,106.7,4751,2450,2301,106.5
37050, 구미시,010,5~9세,2017,23666,12304,11362,108.3,23626,12283,11343,108.3
37050, 구미시,010001, 5세,2017,5168,2657,2511,105.8,5154,2650,2504,105.8
37050, 구미시,010002, 6세,2017,4985,2645,2340,113,4980,2642,2338,113
37050, 구미시,010003, 7세,2017,4563,2327,2236,104.1,4555,2324,2231,104.2
37050, 구미시,010004, 8세,2017,4327,2292,2035,112.6,4320,2288,2032,112.6
37050, 구미시,010005, 9세,2017,4623,2383,2240,106.4,4617,2379,2238,106.3
37050, 구미시,015,10~14세,2017,22198,11565,10633,108.8,22183,11558,10625,108.8
37050, 구미시,015001, 10세,2017,4700,2451,2249,109,4695,2448,2247,108.9
37050, 구미시,015002, 11세,2017,4176,2160,2016,107.1,4174,2160,2014,107.2
37050, 구미시,015003, 12세,2017,4187,2145,2042,105,4184,2144,2040,105.1
37050, 구미시,015004, 13세,2017,4424,2334,2090,111.7,4422,2332,2090,111.6
37050, 구미시,015005, 14세,2017,4711,2475,2236,110.7,4708,2474,2234,110.7
37050, 구미시,020,15~19세,2017,27992,15464,12528,123.4,27906,15422,12484,123.5
37050, 구미시,020001, 15세,2017,4705,2468,2237,110.3,4703,2467,2236,110.3
37050, 구미시,020002, 16세,2017,5636,2987,2649,112.8,5633,2987,2646,112.9
37050, 구미시,020003, 17세,2017,6257,3373,2884,117,6251,3373,2878,117.2
37050, 구미시,020004, 18세,2017,5952,3346,2606,128.4,5937,3337,2600,128.3
37050, 구미시,020005, 19세,2017,5442,3290,2152,152.9,5382,3258,2124,153.4
37050, 구미시,025,20~24세,2017,31478,18024,13454,134,30755,17563,13192,133.1
37050, 구미시,025001, 20세,2017,6021,3503,2518,139.1,5950,3470,2480,139.9
37050, 구미시,025002, 21세,2017,5957,3469,2488,139.4,5844,3403,2441,139.4
37050, 구미시,025003, 22세,2017,6516,3799,2717,139.8,6374,3706,2668,138.9
37050, 구미시,025004, 23세,2017,6514,3642,2872,126.8,6342,3531,2811,125.6
37050, 구미시,025005, 24세,2017,6470,3611,2859,126.3,6245,3453,2792,123.7
37050, 구미시,030,25~29세,2017,30379,16658,13721,121.4,28937,15757,13180,119.6
37050, 구미시,030001, 25세,2017,6415,3464,2951,117.4,6165,3296,2869,114.9
37050, 구미시,030002, 26세,2017,5924,3192,2732,116.8,5677,3045,2632,115.7
37050, 구미시,030003, 27세,2017,5969,3310,2659,124.5,5667,3109,2558,121.5
37050, 구미시,030004, 28세,2017,5840,3260,2580,126.4,5530,3073,2457,125.1
37050, 구미시,030005, 29세,2017,6231,3432,2799,122.6,5898,3234,2664,121.4
37050, 구미시,035,30~34세,2017,34555,18409,16146,114,33231,17580,15651,112.3
37050, 구미시,035001, 30세,2017,6590,3491,3099,112.6,6287,3296,2991,110.2
37050, 구미시,035002, 31세,2017,6808,3679,3129,117.6,6530,3497,3033,115.3
37050, 구미시,035003, 32세,2017,6748,3653,3095,118,6483,3499,2984,117.3
37050, 구미시,035004, 33세,2017,6805,3570,3235,110.4,6575,3420,3155,108.4
37050, 구미시,035005, 34세,2017,7604,4016,3588,111.9,7356,3868,3488,110.9
37050, 구미시,040,35~39세,2017,39500,20724,18776,110.4,38559,20162,18397,109.6
37050, 구미시,040001, 35세,2017,8303,4380,3923,111.6,8054,4237,3817,111
37050, 구미시,040002, 36세,2017,8140,4253,3887,109.4,7934,4135,3799,108.8
37050, 구미시,040003, 37세,2017,8496,4483,4013,111.7,8292,4353,3939,110.5
37050, 구미시,040004, 38세,2017,7641,4008,3633,110.3,7501,3918,3583,109.3
37050, 구미시,040005, 39세,2017,6920,3600,3320,108.4,6778,3519,3259,108
37050, 구미시,045,40~44세,2017,36482,18019,18463,97.6,35890,17682,18208,97.1
37050, 구미시,045001, 40세,2017,7199,3664,3535,103.6,7063,3583,3480,103
37050, 구미시,045002, 41세,2017,7014,3487,3527,98.9,6903,3425,3478,98.5
37050, 구미시,045003, 42세,2017,7123,3455,3668,94.2,7011,3391,3620,93.7
37050, 구미시,045004, 43세,2017,7578,3733,3845,97.1,7459,3666,3793,96.7
37050, 구미시,045005, 44세,2017,7568,3680,3888,94.7,7454,3617,3837,94.3
37050, 구미시,050,45~49세,2017,39203,19724,19479,101.3,38704,19456,19248,101.1
37050, 구미시,050001, 45세,2017,7559,3858,3701,104.2,7443,3797,3646,104.1
37050, 구미시,050002, 46세,2017,7820,4068,3752,108.4,7720,4009,3711,108
37050, 구미시,050003, 47세,2017,7959,3953,4006,98.7,7855,3892,3963,98.2
37050, 구미시,050004, 48세,2017,8016,3988,4028,99,7917,3940,3977,99.1
37050, 구미시,050005, 49세,2017,7849,3857,3992,96.6,7769,3818,3951,96.6
37050, 구미시,055,50~54세,2017,33667,17393,16274,106.9,33290,17193,16097,106.8
37050, 구미시,055001, 50세,2017,7070,3385,3685,91.9,6994,3347,3647,91.8
37050, 구미시,055002, 51세,2017,6787,3535,3252,108.7,6715,3500,3215,108.9
37050, 구미시,055003, 52세,2017,6913,3592,3321,108.2,6837,3551,3286,108.1
37050, 구미시,055004, 53세,2017,6404,3423,2981,114.8,6331,3382,2949,114.7
37050, 구미시,055005, 54세,2017,6493,3458,3035,113.9,6413,3413,3000,113.8
37050, 구미시,060,55~59세,2017,29668,15583,14085,110.6,29406,15452,13954,110.7
37050, 구미시,060001, 55세,2017,6486,3426,3060,112,6425,3395,3030,112
37050, 구미시,060002, 56세,2017,6747,3547,3200,110.8,6700,3518,3182,110.6
37050, 구미시,060003, 57세,2017,6463,3386,3077,110,6414,3367,3047,110.5
37050, 구미시,060004, 58세,2017,5370,2789,2581,108.1,5320,2770,2550,108.6
37050, 구미시,060005, 59세,2017,4602,2435,2167,112.4,4547,2402,2145,112
37050, 구미시,065,60~64세,2017,18358,9521,8837,107.7,18196,9449,8747,108
37050, 구미시,065001, 60세,2017,4458,2320,2138,108.5,4417,2303,2114,108.9
37050, 구미시,065002, 61세,2017,4060,2181,1879,116.1,4020,2160,1860,116.1
37050, 구미시,065003, 62세,2017,3680,1889,1791,105.5,3652,1877,1775,105.7
37050, 구미시,065004, 63세,2017,3201,1635,1566,104.4,3177,1625,1552,104.7
37050, 구미시,065005, 64세,2017,2959,1496,1463,102.3,2930,1484,1446,102.6
37050, 구미시,070,65~69세,2017,11288,5533,5755,96.1,11214,5499,5715,96.2
37050, 구미시,070001, 65세,2017,2999,1486,1513,98.2,2968,1470,1498,98.1
37050, 구미시,070002, 66세,2017,2035,971,1064,91.3,2023,967,1056,91.6
37050, 구미시,070003, 67세,2017,2101,1043,1058,98.6,2088,1037,1051,98.7
37050, 구미시,070004, 68세,2017,2131,1094,1037,105.5,2123,1091,1032,105.7
37050, 구미시,070005, 69세,2017,2022,939,1083,86.7,2012,934,1078,86.6
37050, 구미시,075,70~74세,2017,7387,3273,4114,79.6,7354,3261,4093,79.7
37050, 구미시,075001, 70세,2017,1866,911,955,95.4,1858,909,949,95.8
37050, 구미시,075002, 71세,2017,1220,582,638,91.2,1211,578,633,91.3
37050, 구미시,075003, 72세,2017,1233,523,710,73.7,1227,520,707,73.6
37050, 구미시,075004, 73세,2017,1445,605,840,72,1438,604,834,72.4
37050, 구미시,075005, 74세,2017,1623,652,971,67.1,1620,650,970,67
37050, 구미시,080,75~79세,2017,6928,2583,4345,59.4,6909,2576,4333,59.5
37050, 구미시,080001, 75세,2017,1771,713,1058,67.4,1767,711,1056,67.3
37050, 구미시,080002, 76세,2017,1346,483,863,56,1344,483,861,56.1
37050, 구미시,080003, 77세,2017,1274,501,773,64.8,1271,500,771,64.9
37050, 구미시,080004, 78세,2017,1366,468,898,52.1,1359,465,894,52
37050, 구미시,080005, 79세,2017,1171,418,753,55.5,1168,417,751,55.5
37050, 구미시,085,80~84세,2017,4534,1437,3097,46.4,4526,1433,3093,46.3
37050, 구미시,085001, 80세,2017,1063,349,714,48.9,1059,346,713,48.5
37050, 구미시,085002, 81세,2017,990,336,654,51.4,988,335,653,51.3
37050, 구미시,085003, 82세,2017,1016,317,699,45.4,1015,317,698,45.4
37050, 구미시,085004, 83세,2017,824,256,568,45.1,823,256,567,45.1
37050, 구미시,085005, 84세,2017,641,179,462,38.7,641,179,462,38.7
37050, 구미시,090,85~89세,2017,2187,549,1638,33.5,2184,548,1636,33.5
37050, 구미시,090001, 85세,2017,632,180,452,39.8,631,179,452,39.6
37050, 구미시,090002, 86세,2017,503,137,366,37.4,502,137,365,37.5
37050, 구미시,090003, 87세,2017,408,95,313,30.4,408,95,313,30.4
37050, 구미시,090004, 88세,2017,335,69,266,25.9,334,69,265,26
37050, 구미시,090005, 89세,2017,309,68,241,28.2,309,68,241,28.2
37050, 구미시,095,90~94세,2017,729,159,570,27.9,726,159,567,28
37050, 구미시,095001, 90세,2017,254,59,195,30.3,253,59,194,30.4
37050, 구미시,095002, 91세,2017,170,40,130,30.8,169,40,129,31
37050, 구미시,095003, 92세,2017,127,28,99,28.3,127,28,99,28.3
37050, 구미시,095004, 93세,2017,97,19,78,24.4,97,19,78,24.4
37050, 구미시,095005, 94세,2017,81,13,68,19.1,80,13,67,19.4
37050, 구미시,100,95~99세,2017,179,23,156,14.7,178,23,155,14.8
37050, 구미시,100001, 95세,2017,82,8,74,10.8,82,8,74,10.8
37050, 구미시,100002, 96세,2017,34,6,28,21.4,34,6,28,21.4
37050, 구미시,100003, 97세,2017,35,5,30,16.7,35,5,30,16.7
37050, 구미시,100004, 98세,2017,19,X,16,18.8,18,X,15,20
37050, 구미시,100005, 99세,2017,9,X,8,12.5,9,X,8,12.5
37050, 구미시,101,100세이상,2017,14,X,13,7.7,14,X,13,7.7
37050, 구미시,102,15세미만,2017,68475,35533,32942,107.9,68327,35459,32868,107.9
37050, 구미시,103,15~64세,2017,321282,169519,151763,111.7,314874,165716,149158,111.1
37050, 구미시,104,65세이상,2017,33246,13558,19688,68.9,33105,13500,19605,68.9
37050, 구미시,086,85세이상,2017,3109,732,2377,30.8,3102,731,2371,30.8
37050, 구미시,126,평균연령,2017,37,36,38.1,,37,36,38.1,
37050, 구미시,127,중위연령,2017,37.3,36.2,38.4,,37.4,36.3,38.5,
37060, 영주시,000,합계,2017,108443,54415,54028,100.7,107198,53777,53421,100.7
37060, 영주시,005,0~4세,2017,3249,1684,1565,107.6,3240,1677,1563,107.3
37060, 영주시,005001, 0세,2017,536,257,279,92.1,534,255,279,91.4
37060, 영주시,005002, 1세,2017,655,337,318,106,652,334,318,105
37060, 영주시,005003, 2세,2017,670,342,328,104.3,669,341,328,104
37060, 영주시,005004, 3세,2017,702,390,312,125,700,389,311,125.1
37060, 영주시,005005, 4세,2017,686,358,328,109.1,685,358,327,109.5
37060, 영주시,010,5~9세,2017,4144,2074,2070,100.2,4139,2070,2069,100
37060, 영주시,010001, 5세,2017,846,437,409,106.8,845,436,409,106.6
37060, 영주시,010002, 6세,2017,804,400,404,99,803,399,404,98.8
37060, 영주시,010003, 7세,2017,839,428,411,104.1,838,427,411,103.9
37060, 영주시,010004, 8세,2017,795,399,396,100.8,794,399,395,101
37060, 영주시,010005, 9세,2017,860,410,450,91.1,859,409,450,90.9
37060, 영주시,015,10~14세,2017,4369,2292,2077,110.4,4366,2289,2077,110.2
37060, 영주시,015001, 10세,2017,839,415,424,97.9,838,414,424,97.6
37060, 영주시,015002, 11세,2017,844,464,380,122.1,843,463,380,121.8
37060, 영주시,015003, 12세,2017,852,465,387,120.2,852,465,387,120.2
37060, 영주시,015004, 13세,2017,922,496,426,116.4,921,495,426,116.2
37060, 영주시,015005, 14세,2017,912,452,460,98.3,912,452,460,98.3
37060, 영주시,020,15~19세,2017,6763,3828,2935,130.4,6736,3814,2922,130.5
37060, 영주시,020001, 15세,2017,1004,543,461,117.8,1003,542,461,117.6
37060, 영주시,020002, 16세,2017,1296,732,564,129.8,1294,732,562,130.2
37060, 영주시,020003, 17세,2017,1460,833,627,132.9,1458,832,626,132.9
37060, 영주시,020004, 18세,2017,1387,809,578,140,1383,807,576,140.1
37060, 영주시,020005, 19세,2017,1616,911,705,129.2,1598,901,697,129.3
37060, 영주시,025,20~24세,2017,7179,4382,2797,156.7,6931,4237,2694,157.3
37060, 영주시,025001, 20세,2017,1568,861,707,121.8,1518,831,687,121
37060, 영주시,025002, 21세,2017,1533,873,660,132.3,1471,835,636,131.3
37060, 영주시,025003, 22세,2017,1507,941,566,166.3,1451,908,543,167.2
37060, 영주시,025004, 23세,2017,1365,919,446,206.1,1323,895,428,209.1
37060, 영주시,025005, 24세,2017,1206,788,418,188.5,1168,768,400,192
37060, 영주시,030,25~29세,2017,4426,2625,1801,145.8,4180,2508,1672,150
37060, 영주시,030001, 25세,2017,1079,686,393,174.6,1038,663,375,176.8
37060, 영주시,030002, 26세,2017,872,526,346,152,820,498,322,154.7
37060, 영주시,030003, 27세,2017,877,499,378,132,812,471,341,138.1
37060, 영주시,030004, 28세,2017,781,456,325,140.3,743,438,305,143.6
37060, 영주시,030005, 29세,2017,817,458,359,127.6,767,438,329,133.1
37060, 영주시,035,30~34세,2017,4346,2306,2040,113,4154,2208,1946,113.5
37060, 영주시,035001, 30세,2017,792,431,361,119.4,743,400,343,116.6
37060, 영주시,035002, 31세,2017,808,434,374,116,766,418,348,120.1
37060, 영주시,035003, 32세,2017,847,468,379,123.5,803,444,359,123.7
37060, 영주시,035004, 33세,2017,861,441,420,105,832,432,400,108
37060, 영주시,035005, 34세,2017,1038,532,506,105.1,1010,514,496,103.6
37060, 영주시,040,35~39세,2017,5925,3070,2855,107.5,5810,3005,2805,107.1
37060, 영주시,040001, 35세,2017,1148,605,543,111.4,1118,588,530,110.9
37060, 영주시,040002, 36세,2017,1164,591,573,103.1,1136,576,560,102.9
37060, 영주시,040003, 37세,2017,1227,622,605,102.8,1196,603,593,101.7
37060, 영주시,040004, 38세,2017,1239,661,578,114.4,1222,652,570,114.4
37060, 영주시,040005, 39세,2017,1147,591,556,106.3,1138,586,552,106.2
37060, 영주시,045,40~44세,2017,7029,3576,3453,103.6,6934,3530,3404,103.7
37060, 영주시,045001, 40세,2017,1248,654,594,110.1,1227,643,584,110.1
37060, 영주시,045002, 41세,2017,1317,656,661,99.2,1299,647,652,99.2
37060, 영주시,045003, 42세,2017,1409,715,694,103,1389,703,686,102.5
37060, 영주시,045004, 43세,2017,1468,734,734,100,1453,728,725,100.4
37060, 영주시,045005, 44세,2017,1587,817,770,106.1,1566,809,757,106.9
37060, 영주시,050,45~49세,2017,8386,4475,3911,114.4,8316,4450,3866,115.1
37060, 영주시,050001, 45세,2017,1520,828,692,119.7,1509,823,686,120
37060, 영주시,050002, 46세,2017,1600,870,730,119.2,1590,868,722,120.2
37060, 영주시,050003, 47세,2017,1672,865,807,107.2,1654,858,796,107.8
37060, 영주시,050004, 48세,2017,1766,948,818,115.9,1746,941,805,116.9
37060, 영주시,050005, 49세,2017,1828,964,864,111.6,1817,960,857,112
37060, 영주시,055,50~54세,2017,8265,4173,4092,102,8192,4141,4051,102.2
37060, 영주시,055001, 50세,2017,1610,777,833,93.3,1601,773,828,93.4
37060, 영주시,055002, 51세,2017,1688,884,804,110,1670,876,794,110.3
37060, 영주시,055003, 52세,2017,1641,824,817,100.9,1630,817,813,100.5
37060, 영주시,055004, 53세,2017,1628,837,791,105.8,1612,833,779,106.9
37060, 영주시,055005, 54세,2017,1698,851,847,100.5,1679,842,837,100.6
37060, 영주시,060,55~59세,2017,10130,5020,5110,98.2,10058,4986,5072,98.3
37060, 영주시,060001, 55세,2017,1911,981,930,105.5,1899,976,923,105.7
37060, 영주시,060002, 56세,2017,2250,1125,1125,100,2226,1114,1112,100.2
37060, 영주시,060003, 57세,2017,2278,1114,1164,95.7,2267,1109,1158,95.8
37060, 영주시,060004, 58세,2017,1869,915,954,95.9,1850,907,943,96.2
37060, 영주시,060005, 59세,2017,1822,885,937,94.5,1816,880,936,94
37060, 영주시,065,60~64세,2017,9058,4370,4688,93.2,9002,4342,4660,93.2
37060, 영주시,065001, 60세,2017,1979,975,1004,97.1,1964,970,994,97.6
37060, 영주시,065002, 61세,2017,1825,879,946,92.9,1814,872,942,92.6
37060, 영주시,065003, 62세,2017,1815,884,931,95,1805,877,928,94.5
37060, 영주시,065004, 63세,2017,1792,857,935,91.7,1779,852,927,91.9
37060, 영주시,065005, 64세,2017,1647,775,872,88.9,1640,771,869,88.7
37060, 영주시,070,65~69세,2017,7232,3496,3736,93.6,7209,3481,3728,93.4
37060, 영주시,070001, 65세,2017,1727,782,945,82.8,1720,779,941,82.8
37060, 영주시,070002, 66세,2017,1252,594,658,90.3,1248,591,657,90
37060, 영주시,070003, 67세,2017,1377,695,682,101.9,1372,691,681,101.5
37060, 영주시,070004, 68세,2017,1440,720,720,100,1436,717,719,99.7
37060, 영주시,070005, 69세,2017,1436,705,731,96.4,1433,703,730,96.3
37060, 영주시,075,70~74세,2017,5526,2498,3028,82.5,5520,2494,3026,82.4
37060, 영주시,075001, 70세,2017,1287,630,657,95.9,1284,627,657,95.4
37060, 영주시,075002, 71세,2017,775,358,417,85.9,774,358,416,86.1
37060, 영주시,075003, 72세,2017,945,417,528,79,945,417,528,79
37060, 영주시,075004, 73세,2017,1214,519,695,74.7,1213,518,695,74.5
37060, 영주시,075005, 74세,2017,1305,574,731,78.5,1304,574,730,78.6
37060, 영주시,080,75~79세,2017,6001,2476,3525,70.2,5999,2475,3524,70.2
37060, 영주시,080001, 75세,2017,1455,625,830,75.3,1455,625,830,75.3
37060, 영주시,080002, 76세,2017,1165,491,674,72.8,1164,491,673,73
37060, 영주시,080003, 77세,2017,1084,427,657,65,1084,427,657,65
37060, 영주시,080004, 78세,2017,1239,518,721,71.8,1239,518,721,71.8
37060, 영주시,080005, 79세,2017,1058,415,643,64.5,1057,414,643,64.4
37060, 영주시,085,80~84세,2017,3793,1385,2408,57.5,3791,1385,2406,57.6
37060, 영주시,085001, 80세,2017,869,341,528,64.6,869,341,528,64.6
37060, 영주시,085002, 81세,2017,879,349,530,65.8,879,349,530,65.8
37060, 영주시,085003, 82세,2017,806,284,522,54.4,805,284,521,54.5
37060, 영주시,085004, 83세,2017,686,238,448,53.1,685,238,447,53.2
37060, 영주시,085005, 84세,2017,553,173,380,45.5,553,173,380,45.5
37060, 영주시,090,85~89세,2017,1833,498,1335,37.3,1832,498,1334,37.3
37060, 영주시,090001, 85세,2017,511,150,361,41.6,510,150,360,41.7
37060, 영주시,090002, 86세,2017,418,117,301,38.9,418,117,301,38.9
37060, 영주시,090003, 87세,2017,339,96,243,39.5,339,96,243,39.5
37060, 영주시,090004, 88세,2017,310,75,235,31.9,310,75,235,31.9
37060, 영주시,090005, 89세,2017,255,60,195,30.8,255,60,195,30.8
37060, 영주시,095,90~94세,2017,607,143,464,30.8,607,143,464,30.8
37060, 영주시,095001, 90세,2017,181,50,131,38.2,181,50,131,38.2
37060, 영주시,095002, 91세,2017,140,36,104,34.6,140,36,104,34.6
37060, 영주시,095003, 92세,2017,129,28,101,27.7,129,28,101,27.7
37060, 영주시,095004, 93세,2017,91,14,77,18.2,91,14,77,18.2
37060, 영주시,095005, 94세,2017,66,15,51,29.4,66,15,51,29.4
37060, 영주시,100,95~99세,2017,164,41,123,33.3,164,41,123,33.3
37060, 영주시,100001, 95세,2017,54,15,39,38.5,54,15,39,38.5
37060, 영주시,100002, 96세,2017,39,7,32,21.9,39,7,32,21.9
37060, 영주시,100003, 97세,2017,42,11,31,35.5,42,11,31,35.5
37060, 영주시,100004, 98세,2017,15,5,10,50,15,5,10,50
37060, 영주시,100005, 99세,2017,14,X,11,27.3,14,X,11,27.3
37060, 영주시,101,100세이상,2017,18,X,15,20,18,X,15,20
37060, 영주시,102,15세미만,2017,11762,6050,5712,105.9,11745,6036,5709,105.7
37060, 영주시,103,15~64세,2017,71507,37825,33682,112.3,70313,37221,33092,112.5
37060, 영주시,104,65세이상,2017,25174,10540,14634,72,25140,10520,14620,72
37060, 영주시,086,85세이상,2017,2622,685,1937,35.4,2621,685,1936,35.4
37060, 영주시,126,평균연령,2017,46.5,44.2,48.7,,46.6,44.3,48.9,
37060, 영주시,127,중위연령,2017,49.1,46.6,51.8,,49.3,46.8,52.1,
37070, 영천시,000,합계,2017,97675,49918,47757,104.5,93770,47024,46746,100.6
37070, 영천시,005,0~4세,2017,3010,1538,1472,104.5,2988,1532,1456,105.2
37070, 영천시,005001, 0세,2017,577,290,287,101,571,287,284,101.1
37070, 영천시,005002, 1세,2017,583,292,291,100.3,575,291,284,102.5
37070, 영천시,005003, 2세,2017,649,328,321,102.2,648,328,320,102.5
37070, 영천시,005004, 3세,2017,603,320,283,113.1,601,320,281,113.9
37070, 영천시,005005, 4세,2017,598,308,290,106.2,593,306,287,106.6
37070, 영천시,010,5~9세,2017,3033,1594,1439,110.8,3021,1589,1432,111
37070, 영천시,010001, 5세,2017,645,304,341,89.1,641,303,338,89.6
37070, 영천시,010002, 6세,2017,589,314,275,114.2,588,313,275,113.8
37070, 영천시,010003, 7세,2017,587,302,285,106,584,301,283,106.4
37070, 영천시,010004, 8세,2017,596,334,262,127.5,593,332,261,127.2
37070, 영천시,010005, 9세,2017,616,340,276,123.2,615,340,275,123.6
37070, 영천시,015,10~14세,2017,3113,1630,1483,109.9,3106,1628,1478,110.1
37070, 영천시,015001, 10세,2017,659,351,308,114,658,351,307,114.3
37070, 영천시,015002, 11세,2017,570,279,291,95.9,569,279,290,96.2
37070, 영천시,015003, 12세,2017,574,277,297,93.3,573,277,296,93.6
37070, 영천시,015004, 13세,2017,645,348,297,117.2,643,348,295,118
37070, 영천시,015005, 14세,2017,665,375,290,129.3,663,373,290,128.6
37070, 영천시,020,15~19세,2017,3871,2178,1693,128.6,3784,2125,1659,128.1
37070, 영천시,020001, 15세,2017,670,375,295,127.1,667,375,292,128.4
37070, 영천시,020002, 16세,2017,805,452,353,128,803,452,351,128.8
37070, 영천시,020003, 17세,2017,851,478,373,128.2,847,477,370,128.9
37070, 영천시,020004, 18세,2017,808,445,363,122.6,799,438,361,121.3
37070, 영천시,020005, 19세,2017,737,428,309,138.5,668,383,285,134.4
37070, 영천시,025,20~24세,2017,4913,3057,1856,164.7,4405,2687,1718,156.4
37070, 영천시,025001, 20세,2017,890,545,345,158,820,507,313,162
37070, 영천시,025002, 21세,2017,995,648,347,186.7,935,610,325,187.7
37070, 영천시,025003, 22세,2017,1055,668,387,172.6,944,580,364,159.3
37070, 영천시,025004, 23세,2017,995,612,383,159.8,859,510,349,146.1
37070, 영천시,025005, 24세,2017,978,584,394,148.2,847,480,367,130.8
37070, 영천시,030,25~29세,2017,5085,3141,1944,161.6,4165,2409,1756,137.2
37070, 영천시,030001, 25세,2017,1060,655,405,161.7,885,512,373,137.3
37070, 영천시,030002, 26세,2017,1031,625,406,153.9,847,477,370,128.9
37070, 영천시,030003, 27세,2017,1012,658,354,185.9,818,501,317,158
37070, 영천시,030004, 28세,2017,977,584,393,148.6,808,462,346,133.5
37070, 영천시,030005, 29세,2017,1005,619,386,160.4,807,457,350,130.6
37070, 영천시,035,30~34세,2017,5170,3045,2125,143.3,4378,2397,1981,121
37070, 영천시,035001, 30세,2017,1018,594,424,140.1,829,441,388,113.7
37070, 영천시,035002, 31세,2017,980,587,393,149.4,821,449,372,120.7
37070, 영천시,035003, 32세,2017,1010,602,408,147.5,852,473,379,124.8
37070, 영천시,035004, 33세,2017,1010,610,400,152.5,878,502,376,133.5
37070, 영천시,035005, 34세,2017,1152,652,500,130.4,998,532,466,114.2
37070, 영천시,040,35~39세,2017,5842,3296,2546,129.5,5247,2817,2430,115.9
37070, 영천시,040001, 35세,2017,1209,702,507,138.5,1066,588,478,123
37070, 영천시,040002, 36세,2017,1246,687,559,122.9,1122,587,535,109.7
37070, 영천시,040003, 37세,2017,1227,697,530,131.5,1099,592,507,116.8
37070, 영천시,040004, 38세,2017,1147,642,505,127.1,1032,547,485,112.8
37070, 영천시,040005, 39세,2017,1013,568,445,127.6,928,503,425,118.4
37070, 영천시,045,40~44세,2017,5958,3281,2677,122.6,5649,3050,2599,117.4
37070, 영천시,045001, 40세,2017,980,525,455,115.4,916,475,441,107.7
37070, 영천시,045002, 41세,2017,1139,667,472,141.3,1064,610,454,134.4
37070, 영천시,045003, 42세,2017,1222,688,534,128.8,1160,642,518,123.9
37070, 영천시,045004, 43세,2017,1347,732,615,119,1295,691,604,114.4
37070, 영천시,045005, 44세,2017,1270,669,601,111.3,1214,632,582,108.6
37070, 영천시,050,45~49세,2017,7432,3928,3504,112.1,7192,3772,3420,110.3
37070, 영천시,050001, 45세,2017,1381,733,648,113.1,1331,700,631,110.9
37070, 영천시,050002, 46세,2017,1483,790,693,114,1424,751,673,111.6
37070, 영천시,050003, 47세,2017,1404,745,659,113.1,1365,721,644,112
37070, 영천시,050004, 48세,2017,1513,773,740,104.5,1468,739,729,101.4
37070, 영천시,050005, 49세,2017,1651,887,764,116.1,1604,861,743,115.9
37070, 영천시,055,50~54세,2017,7887,4148,3739,110.9,7710,4054,3656,110.9
37070, 영천시,055001, 50세,2017,1532,831,701,118.5,1506,818,688,118.9
37070, 영천시,055002, 51세,2017,1622,860,762,112.9,1590,840,750,112
37070, 영천시,055003, 52세,2017,1476,745,731,101.9,1443,730,713,102.4
37070, 영천시,055004, 53세,2017,1635,852,783,108.8,1594,827,767,107.8
37070, 영천시,055005, 54세,2017,1622,860,762,112.9,1577,839,738,113.7
37070, 영천시,060,55~59세,2017,9226,4632,4594,100.8,9112,4567,4545,100.5
37070, 영천시,060001, 55세,2017,1758,901,857,105.1,1740,887,853,104
37070, 영천시,060002, 56세,2017,1970,1006,964,104.4,1943,991,952,104.1
37070, 영천시,060003, 57세,2017,1893,898,995,90.3,1867,886,981,90.3
37070, 영천시,060004, 58세,2017,1965,997,968,103,1939,981,958,102.4
37070, 영천시,060005, 59세,2017,1640,830,810,102.5,1623,822,801,102.6
37070, 영천시,065,60~64세,2017,8318,4155,4163,99.8,8249,4124,4125,100
37070, 영천시,065001, 60세,2017,1767,932,835,111.6,1752,923,829,111.3
37070, 영천시,065002, 61세,2017,1763,892,871,102.4,1756,889,867,102.5
37070, 영천시,065003, 62세,2017,1722,854,868,98.4,1704,844,860,98.1
37070, 영천시,065004, 63세,2017,1517,757,760,99.6,1504,752,752,100
37070, 영천시,065005, 64세,2017,1549,720,829,86.9,1533,716,817,87.6
37070, 영천시,070,65~69세,2017,7321,3540,3781,93.6,7291,3524,3767,93.5
37070, 영천시,070001, 65세,2017,1609,749,860,87.1,1599,743,856,86.8
37070, 영천시,070002, 66세,2017,1412,695,717,96.9,1405,691,714,96.8
37070, 영천시,070003, 67세,2017,1411,687,724,94.9,1405,685,720,95.1
37070, 영천시,070004, 68세,2017,1457,705,752,93.8,1452,702,750,93.6
37070, 영천시,070005, 69세,2017,1432,704,728,96.7,1430,703,727,96.7
37070, 영천시,075,70~74세,2017,5522,2443,3079,79.3,5512,2439,3073,79.4
37070, 영천시,075001, 70세,2017,1258,596,662,90,1255,595,660,90.2
37070, 영천시,075002, 71세,2017,858,399,459,86.9,854,398,456,87.3
37070, 영천시,075003, 72세,2017,998,436,562,77.6,997,435,562,77.4
37070, 영천시,075004, 73세,2017,1135,487,648,75.2,1134,486,648,75
37070, 영천시,075005, 74세,2017,1273,525,748,70.2,1272,525,747,70.3
37070, 영천시,080,75~79세,2017,5918,2343,3575,65.5,5911,2342,3569,65.6
37070, 영천시,080001, 75세,2017,1523,650,873,74.5,1522,650,872,74.5
37070, 영천시,080002, 76세,2017,1168,463,705,65.7,1167,463,704,65.8
37070, 영천시,080003, 77세,2017,1093,430,663,64.9,1092,430,662,65
37070, 영천시,080004, 78세,2017,1143,443,700,63.3,1143,443,700,63.3
37070, 영천시,080005, 79세,2017,991,357,634,56.3,987,356,631,56.4
37070, 영천시,085,80~84세,2017,3927,1361,2566,53,3921,1360,2561,53.1
37070, 영천시,085001, 80세,2017,935,347,588,59,932,346,586,59
37070, 영천시,085002, 81세,2017,885,319,566,56.4,884,319,565,56.5
37070, 영천시,085003, 82세,2017,807,270,537,50.3,806,270,536,50.4
37070, 영천시,085004, 83세,2017,732,254,478,53.1,731,254,477,53.2
37070, 영천시,085005, 84세,2017,568,171,397,43.1,568,171,397,43.1
37070, 영천시,090,85~89세,2017,1643,492,1151,42.7,1643,492,1151,42.7
37070, 영천시,090001, 85세,2017,508,164,344,47.7,508,164,344,47.7
37070, 영천시,090002, 86세,2017,368,103,265,38.9,368,103,265,38.9
37070, 영천시,090003, 87세,2017,324,109,215,50.7,324,109,215,50.7
37070, 영천시,090004, 88세,2017,239,61,178,34.3,239,61,178,34.3
37070, 영천시,090005, 89세,2017,204,55,149,36.9,204,55,149,36.9
37070, 영천시,095,90~94세,2017,394,101,293,34.5,394,101,293,34.5
37070, 영천시,095001, 90세,2017,131,37,94,39.4,131,37,94,39.4
37070, 영천시,095002, 91세,2017,99,27,72,37.5,99,27,72,37.5
37070, 영천시,095003, 92세,2017,82,23,59,39,82,23,59,39
37070, 영천시,095004, 93세,2017,51,10,41,24.4,51,10,41,24.4
37070, 영천시,095005, 94세,2017,31,X,27,14.8,31,X,27,14.8
37070, 영천시,100,95~99세,2017,85,13,72,18.1,85,13,72,18.1
37070, 영천시,100001, 95세,2017,33,5,28,17.9,33,5,28,17.9
37070, 영천시,100002, 96세,2017,25,5,20,25,25,5,20,25
37070, 영천시,100003, 97세,2017,10,X,10,0,10,X,10,0
37070, 영천시,100004, 98세,2017,14,X,11,27.3,14,X,11,27.3
37070, 영천시,100005, 99세,2017,X,X,X,0,X,X,X,0
37070, 영천시,101,100세이상,2017,7,X,5,40,7,X,5,40
37070, 영천시,102,15세미만,2017,9156,4762,4394,108.4,9115,4749,4366,108.8
37070, 영천시,103,15~64세,2017,63702,34861,28841,120.9,59891,32002,27889,114.7
37070, 영천시,104,65세이상,2017,24817,10295,14522,70.9,24764,10273,14491,70.9
37070, 영천시,086,85세이상,2017,2129,608,1521,40,2129,608,1521,40
37070, 영천시,126,평균연령,2017,48.2,45.8,50.8,,48.8,46.5,51.1,
37070, 영천시,127,중위연령,2017,50.9,47.9,54.2,,51.9,49.4,54.7,
37080, 상주시,000,합계,2017,98189,48296,49893,96.8,97106,47811,49295,97
37080, 상주시,005,0~4세,2017,2643,1376,1267,108.6,2634,1370,1264,108.4
37080, 상주시,005001, 0세,2017,462,236,226,104.4,459,234,225,104
37080, 상주시,005002, 1세,2017,503,259,244,106.1,502,258,244,105.7
37080, 상주시,005003, 2세,2017,553,296,257,115.2,550,294,256,114.8
37080, 상주시,005004, 3세,2017,537,287,250,114.8,536,286,250,114.4
37080, 상주시,005005, 4세,2017,588,298,290,102.8,587,298,289,103.1
37080, 상주시,010,5~9세,2017,3266,1711,1555,110,3264,1709,1555,109.9
37080, 상주시,010001, 5세,2017,632,347,285,121.8,632,347,285,121.8
37080, 상주시,010002, 6세,2017,634,322,312,103.2,634,322,312,103.2
37080, 상주시,010003, 7세,2017,636,332,304,109.2,635,331,304,108.9
37080, 상주시,010004, 8세,2017,651,329,322,102.2,651,329,322,102.2
37080, 상주시,010005, 9세,2017,713,381,332,114.8,712,380,332,114.5
37080, 상주시,015,10~14세,2017,3513,1842,1671,110.2,3512,1842,1670,110.3
37080, 상주시,015001, 10세,2017,724,387,337,114.8,723,387,336,115.2
37080, 상주시,015002, 11세,2017,670,337,333,101.2,670,337,333,101.2
37080, 상주시,015003, 12세,2017,674,348,326,106.7,674,348,326,106.7
37080, 상주시,015004, 13세,2017,669,351,318,110.4,669,351,318,110.4
37080, 상주시,015005, 14세,2017,776,419,357,117.4,776,419,357,117.4
37080, 상주시,020,15~19세,2017,5149,2904,2245,129.4,5145,2901,2244,129.3
37080, 상주시,020001, 15세,2017,814,449,365,123,814,449,365,123
37080, 상주시,020002, 16세,2017,1053,559,494,113.2,1053,559,494,113.2
37080, 상주시,020003, 17세,2017,1215,683,532,128.4,1214,682,532,128.2
37080, 상주시,020004, 18세,2017,1024,552,472,116.9,1024,552,472,116.9
37080, 상주시,020005, 19세,2017,1043,661,382,173,1040,659,381,173
37080, 상주시,025,20~24세,2017,5335,3280,2055,159.6,5177,3187,1990,160.2
37080, 상주시,025001, 20세,2017,1119,677,442,153.2,1104,669,435,153.8
37080, 상주시,025002, 21세,2017,1122,642,480,133.8,1094,626,468,133.8
37080, 상주시,025003, 22세,2017,1102,696,406,171.4,1075,676,399,169.4
37080, 상주시,025004, 23세,2017,1048,673,375,179.5,1006,652,354,184.2
37080, 상주시,025005, 24세,2017,944,592,352,168.2,898,564,334,168.9
37080, 상주시,030,25~29세,2017,3869,2222,1647,134.9,3670,2136,1534,139.2
37080, 상주시,030001, 25세,2017,831,507,324,156.5,794,491,303,162
37080, 상주시,030002, 26세,2017,846,480,366,131.1,800,458,342,133.9
37080, 상주시,030003, 27세,2017,725,418,307,136.2,683,395,288,137.2
37080, 상주시,030004, 28세,2017,736,429,307,139.7,690,412,278,148.2
37080, 상주시,030005, 29세,2017,731,388,343,113.1,703,380,323,117.6
37080, 상주시,035,30~34세,2017,3840,2107,1733,121.6,3654,2034,1620,125.6
37080, 상주시,035001, 30세,2017,718,400,318,125.8,666,386,280,137.9
37080, 상주시,035002, 31세,2017,801,438,363,120.7,756,417,339,123
37080, 상주시,035003, 32세,2017,701,400,301,132.9,665,384,281,136.7
37080, 상주시,035004, 33세,2017,787,430,357,120.4,760,420,340,123.5
37080, 상주시,035005, 34세,2017,833,439,394,111.4,807,427,380,112.4
37080, 상주시,040,35~39세,2017,4640,2435,2205,110.4,4533,2397,2136,112.2
37080, 상주시,040001, 35세,2017,941,475,466,101.9,916,469,447,104.9
37080, 상주시,040002, 36세,2017,934,511,423,120.8,912,500,412,121.4
37080, 상주시,040003, 37세,2017,975,502,473,106.1,950,495,455,108.8
37080, 상주시,040004, 38세,2017,939,495,444,111.5,920,486,434,112
37080, 상주시,040005, 39세,2017,851,452,399,113.3,835,447,388,115.2
37080, 상주시,045,40~44세,2017,5528,2853,2675,106.7,5459,2819,2640,106.8
37080, 상주시,045001, 40세,2017,935,461,474,97.3,923,455,468,97.2
37080, 상주시,045002, 41세,2017,963,502,461,108.9,950,495,455,108.8
37080, 상주시,045003, 42세,2017,1124,579,545,106.2,1112,574,538,106.7
37080, 상주시,045004, 43세,2017,1239,652,587,111.1,1225,644,581,110.8
37080, 상주시,045005, 44세,2017,1267,659,608,108.4,1249,651,598,108.9
37080, 상주시,050,45~49세,2017,6946,3719,3227,115.2,6859,3683,3176,116
37080, 상주시,050001, 45세,2017,1255,645,610,105.7,1237,637,600,106.2
37080, 상주시,050002, 46세,2017,1416,761,655,116.2,1402,753,649,116
37080, 상주시,050003, 47세,2017,1366,728,638,114.1,1344,721,623,115.7
37080, 상주시,050004, 48세,2017,1360,760,600,126.7,1340,751,589,127.5
37080, 상주시,050005, 49세,2017,1549,825,724,114,1536,821,715,114.8
37080, 상주시,055,50~54세,2017,7722,4002,3720,107.6,7620,3956,3664,108
37080, 상주시,055001, 50세,2017,1438,746,692,107.8,1417,740,677,109.3
37080, 상주시,055002, 51세,2017,1500,817,683,119.6,1479,806,673,119.8
37080, 상주시,055003, 52세,2017,1497,735,762,96.5,1478,726,752,96.5
37080, 상주시,055004, 53세,2017,1596,814,782,104.1,1573,804,769,104.6
37080, 상주시,055005, 54세,2017,1691,890,801,111.1,1673,880,793,111
37080, 상주시,060,55~59세,2017,9629,4790,4839,99,9571,4765,4806,99.1
37080, 상주시,060001, 55세,2017,1743,886,857,103.4,1729,882,847,104.1
37080, 상주시,060002, 56세,2017,1973,996,977,101.9,1960,990,970,102.1
37080, 상주시,060003, 57세,2017,2131,1035,1096,94.4,2118,1029,1089,94.5
37080, 상주시,060004, 58세,2017,1917,934,983,95,1913,932,981,95
37080, 상주시,060005, 59세,2017,1865,939,926,101.4,1851,932,919,101.4
37080, 상주시,065,60~64세,2017,8551,4189,4362,96,8497,4168,4329,96.3
37080, 상주시,065001, 60세,2017,1825,942,883,106.7,1813,937,876,107
37080, 상주시,065002, 61세,2017,1809,882,927,95.1,1798,876,922,95
37080, 상주시,065003, 62세,2017,1768,864,904,95.6,1760,861,899,95.8
37080, 상주시,065004, 63세,2017,1638,776,862,90,1626,774,852,90.8
37080, 상주시,065005, 64세,2017,1511,725,786,92.2,1500,720,780,92.3
37080, 상주시,070,65~69세,2017,7295,3499,3796,92.2,7265,3485,3780,92.2
37080, 상주시,070001, 65세,2017,1713,802,911,88,1705,799,906,88.2
37080, 상주시,070002, 66세,2017,1187,560,627,89.3,1182,556,626,88.8
37080, 상주시,070003, 67세,2017,1385,661,724,91.3,1377,658,719,91.5
37080, 상주시,070004, 68세,2017,1574,791,783,101,1573,790,783,100.9
37080, 상주시,070005, 69세,2017,1436,685,751,91.2,1428,682,746,91.4
37080, 상주시,075,70~74세,2017,5610,2446,3164,77.3,5602,2441,3161,77.2
37080, 상주시,075001, 70세,2017,1385,645,740,87.2,1383,645,738,87.4
37080, 상주시,075002, 71세,2017,869,415,454,91.4,866,413,453,91.2
37080, 상주시,075003, 72세,2017,933,407,526,77.4,931,405,526,77
37080, 상주시,075004, 73세,2017,1107,422,685,61.6,1106,421,685,61.5
37080, 상주시,075005, 74세,2017,1316,557,759,73.4,1316,557,759,73.4
37080, 상주시,080,75~79세,2017,6850,2562,4288,59.7,6847,2560,4287,59.7
37080, 상주시,080001, 75세,2017,1658,643,1015,63.3,1658,643,1015,63.3
37080, 상주시,080002, 76세,2017,1299,483,816,59.2,1299,483,816,59.2
37080, 상주시,080003, 77세,2017,1319,481,838,57.4,1318,481,837,57.5
37080, 상주시,080004, 78세,2017,1371,500,871,57.4,1369,498,871,57.2
37080, 상주시,080005, 79세,2017,1203,455,748,60.8,1203,455,748,60.8
37080, 상주시,085,80~84세,2017,4719,1601,3118,51.3,4715,1600,3115,51.4
37080, 상주시,085001, 80세,2017,1136,407,729,55.8,1136,407,729,55.8
37080, 상주시,085002, 81세,2017,1049,347,702,49.4,1048,347,701,49.5
37080, 상주시,085003, 82세,2017,993,354,639,55.4,991,353,638,55.3
37080, 상주시,085004, 83세,2017,869,292,577,50.6,869,292,577,50.6
37080, 상주시,085005, 84세,2017,672,201,471,42.7,671,201,470,42.8
37080, 상주시,090,85~89세,2017,2132,573,1559,36.8,2130,573,1557,36.8
37080, 상주시,090001, 85세,2017,608,180,428,42.1,608,180,428,42.1
37080, 상주시,090002, 86세,2017,469,132,337,39.2,469,132,337,39.2
37080, 상주시,090003, 87세,2017,433,108,325,33.2,432,108,324,33.3
37080, 상주시,090004, 88세,2017,342,86,256,33.6,341,86,255,33.7
37080, 상주시,090005, 89세,2017,280,67,213,31.5,280,67,213,31.5
37080, 상주시,095,90~94세,2017,764,161,603,26.7,764,161,603,26.7
37080, 상주시,095001, 90세,2017,252,57,195,29.2,252,57,195,29.2
37080, 상주시,095002, 91세,2017,171,34,137,24.8,171,34,137,24.8
37080, 상주시,095003, 92세,2017,153,38,115,33,153,38,115,33
37080, 상주시,095004, 93세,2017,100,15,85,17.6,100,15,85,17.6
37080, 상주시,095005, 94세,2017,88,17,71,23.9,88,17,71,23.9
37080, 상주시,100,95~99세,2017,176,21,155,13.5,176,21,155,13.5
37080, 상주시,100001, 95세,2017,77,11,66,16.7,77,11,66,16.7
37080, 상주시,100002, 96세,2017,47,6,41,14.6,47,6,41,14.6
37080, 상주시,100003, 97세,2017,28,X,25,12,28,X,25,12
37080, 상주시,100004, 98세,2017,12,X,11,9.1,12,X,11,9.1
37080, 상주시,100005, 99세,2017,12,X,12,0,12,X,12,0
37080, 상주시,101,100세이상,2017,12,X,9,33.3,12,X,9,33.3
37080, 상주시,102,15세미만,2017,9422,4929,4493,109.7,9410,4921,4489,109.6
37080, 상주시,103,15~64세,2017,61209,32501,28708,113.2,60185,32046,28139,113.9
37080, 상주시,104,65세이상,2017,27558,10866,16692,65.1,27511,10844,16667,65.1
37080, 상주시,086,85세이상,2017,3084,758,2326,32.6,3082,758,2324,32.6
37080, 상주시,126,평균연령,2017,49.3,46.4,52.1,,49.4,46.5,52.3,
37080, 상주시,127,중위연령,2017,53,49.6,56.1,,53.2,49.8,56.3,
37090, 문경시,000,합계,2017,70016,34275,35741,95.9,69207,33908,35299,96.1
37090, 문경시,005,0~4세,2017,2183,1128,1055,106.9,2179,1126,1053,106.9
37090, 문경시,005001, 0세,2017,402,208,194,107.2,401,207,194,106.7
37090, 문경시,005002, 1세,2017,431,220,211,104.3,431,220,211,104.3
37090, 문경시,005003, 2세,2017,442,213,229,93,441,213,228,93.4
37090, 문경시,005004, 3세,2017,434,232,202,114.9,434,232,202,114.9
37090, 문경시,005005, 4세,2017,474,255,219,116.4,472,254,218,116.5
37090, 문경시,010,5~9세,2017,2413,1301,1112,117,2406,1297,1109,117
37090, 문경시,010001, 5세,2017,475,246,229,107.4,473,244,229,106.6
37090, 문경시,010002, 6세,2017,538,299,239,125.1,536,298,238,125.2
37090, 문경시,010003, 7세,2017,452,235,217,108.3,451,235,216,108.8
37090, 문경시,010004, 8세,2017,453,243,210,115.7,451,242,209,115.8
37090, 문경시,010005, 9세,2017,495,278,217,128.1,495,278,217,128.1
37090, 문경시,015,10~14세,2017,2573,1397,1176,118.8,2571,1396,1175,118.8
37090, 문경시,015001, 10세,2017,506,270,236,114.4,505,270,235,114.9
37090, 문경시,015002, 11세,2017,481,268,213,125.8,481,268,213,125.8
37090, 문경시,015003, 12세,2017,487,257,230,111.7,487,257,230,111.7
37090, 문경시,015004, 13세,2017,518,282,236,119.5,517,281,236,119.1
37090, 문경시,015005, 14세,2017,581,320,261,122.6,581,320,261,122.6
37090, 문경시,020,15~19세,2017,3681,2052,1629,126,3674,2049,1625,126.1
37090, 문경시,020001, 15세,2017,667,350,317,110.4,667,350,317,110.4
37090, 문경시,020002, 16세,2017,819,470,349,134.7,818,469,349,134.4
37090, 문경시,020003, 17세,2017,937,523,414,126.3,935,522,413,126.4
37090, 문경시,020004, 18세,2017,724,403,321,125.5,723,402,321,125.2
37090, 문경시,020005, 19세,2017,534,306,228,134.2,531,306,225,136
37090, 문경시,025,20~24세,2017,2968,1724,1244,138.6,2870,1678,1192,140.8
37090, 문경시,025001, 20세,2017,629,392,237,165.4,620,390,230,169.6
37090, 문경시,025002, 21세,2017,681,395,286,138.1,665,388,277,140.1
37090, 문경시,025003, 22세,2017,621,363,258,140.7,600,356,244,145.9
37090, 문경시,025004, 23세,2017,495,277,218,127.1,476,263,213,123.5
37090, 문경시,025005, 24세,2017,542,297,245,121.2,509,281,228,123.2
37090, 문경시,030,25~29세,2017,2543,1375,1168,117.7,2397,1310,1087,120.5
37090, 문경시,030001, 25세,2017,538,285,253,112.6,512,276,236,116.9
37090, 문경시,030002, 26세,2017,470,248,222,111.7,448,235,213,110.3
37090, 문경시,030003, 27세,2017,528,301,227,132.6,490,283,207,136.7
37090, 문경시,030004, 28세,2017,473,241,232,103.9,449,231,218,106
37090, 문경시,030005, 29세,2017,534,300,234,128.2,498,285,213,133.8
37090, 문경시,035,30~34세,2017,3011,1635,1376,118.8,2868,1556,1312,118.6
37090, 문경시,035001, 30세,2017,585,326,259,125.9,549,311,238,130.7
37090, 문경시,035002, 31세,2017,543,297,246,120.7,515,278,237,117.3
37090, 문경시,035003, 32세,2017,577,322,255,126.3,542,301,241,124.9
37090, 문경시,035004, 33세,2017,662,351,311,112.9,637,335,302,110.9
37090, 문경시,035005, 34세,2017,644,339,305,111.1,625,331,294,112.6
37090, 문경시,040,35~39세,2017,3672,1888,1784,105.8,3589,1857,1732,107.2
37090, 문경시,040001, 35세,2017,742,353,389,90.7,722,345,377,91.5
37090, 문경시,040002, 36세,2017,717,368,349,105.4,701,360,341,105.6
37090, 문경시,040003, 37세,2017,775,423,352,120.2,759,420,339,123.9
37090, 문경시,040004, 38세,2017,729,387,342,113.2,711,379,332,114.2
37090, 문경시,040005, 39세,2017,709,357,352,101.4,696,353,343,102.9
37090, 문경시,045,40~44세,2017,4302,2271,2031,111.8,4232,2237,1995,112.1
37090, 문경시,045001, 40세,2017,739,397,342,116.1,730,394,336,117.3
37090, 문경시,045002, 41세,2017,800,421,379,111.1,790,416,374,111.2
37090, 문경시,045003, 42세,2017,900,471,429,109.8,880,460,420,109.5
37090, 문경시,045004, 43세,2017,968,513,455,112.7,954,506,448,112.9
37090, 문경시,045005, 44세,2017,895,469,426,110.1,878,461,417,110.6
37090, 문경시,050,45~49세,2017,4894,2614,2280,114.6,4834,2590,2244,115.4
37090, 문경시,050001, 45세,2017,923,507,416,121.9,914,504,410,122.9
37090, 문경시,050002, 46세,2017,932,486,446,109,925,483,442,109.3
37090, 문경시,050003, 47세,2017,974,519,455,114.1,962,513,449,114.3
37090, 문경시,050004, 48세,2017,1015,535,480,111.5,998,531,467,113.7
37090, 문경시,050005, 49세,2017,1050,567,483,117.4,1035,559,476,117.4
37090, 문경시,055,50~54세,2017,5464,2763,2701,102.3,5398,2732,2666,102.5
37090, 문경시,055001, 50세,2017,1022,526,496,106,1013,521,492,105.9
37090, 문경시,055002, 51세,2017,1033,521,512,101.8,1025,518,507,102.2
37090, 문경시,055003, 52세,2017,1067,527,540,97.6,1051,521,530,98.3
37090, 문경시,055004, 53세,2017,1126,580,546,106.2,1112,574,538,106.7
37090, 문경시,055005, 54세,2017,1216,609,607,100.3,1197,598,599,99.8
37090, 문경시,060,55~59세,2017,6769,3378,3391,99.6,6719,3366,3353,100.4
37090, 문경시,060001, 55세,2017,1237,641,596,107.6,1229,641,588,109
37090, 문경시,060002, 56세,2017,1400,697,703,99.1,1389,694,695,99.9
37090, 문경시,060003, 57세,2017,1481,738,743,99.3,1472,736,736,100
37090, 문경시,060004, 58세,2017,1309,631,678,93.1,1301,629,672,93.6
37090, 문경시,060005, 59세,2017,1342,671,671,100,1328,666,662,100.6
37090, 문경시,065,60~64세,2017,6374,3055,3319,92,6330,3037,3293,92.2
37090, 문경시,065001, 60세,2017,1378,660,718,91.9,1370,658,712,92.4
37090, 문경시,065002, 61세,2017,1381,681,700,97.3,1370,677,693,97.7
37090, 문경시,065003, 62세,2017,1292,639,653,97.9,1282,633,649,97.5
37090, 문경시,065004, 63세,2017,1168,556,612,90.8,1157,551,606,90.9
37090, 문경시,065005, 64세,2017,1155,519,636,81.6,1151,518,633,81.8
37090, 문경시,070,65~69세,2017,5241,2482,2759,90,5225,2474,2751,89.9
37090, 문경시,070001, 65세,2017,1196,568,628,90.4,1192,567,625,90.7
37090, 문경시,070002, 66세,2017,917,430,487,88.3,913,428,485,88.2
37090, 문경시,070003, 67세,2017,1051,495,556,89,1045,491,554,88.6
37090, 문경시,070004, 68세,2017,1106,527,579,91,1105,527,578,91.2
37090, 문경시,070005, 69세,2017,971,462,509,90.8,970,461,509,90.6
37090, 문경시,075,70~74세,2017,4241,1830,2411,75.9,4231,1823,2408,75.7
37090, 문경시,075001, 70세,2017,985,461,524,88,981,459,522,87.9
37090, 문경시,075002, 71세,2017,694,310,384,80.7,692,309,383,80.7
37090, 문경시,075003, 72세,2017,756,347,409,84.8,753,344,409,84.1
37090, 문경시,075004, 73세,2017,817,313,504,62.1,816,312,504,61.9
37090, 문경시,075005, 74세,2017,989,399,590,67.6,989,399,590,67.6
37090, 문경시,080,75~79세,2017,4624,1862,2762,67.4,4622,1861,2761,67.4
37090, 문경시,080001, 75세,2017,1079,467,612,76.3,1079,467,612,76.3
37090, 문경시,080002, 76세,2017,949,389,560,69.5,948,389,559,69.6
37090, 문경시,080003, 77세,2017,915,377,538,70.1,914,376,538,69.9
37090, 문경시,080004, 78세,2017,868,336,532,63.2,868,336,532,63.2
37090, 문경시,080005, 79세,2017,813,293,520,56.3,813,293,520,56.3
37090, 문경시,085,80~84세,2017,3083,1016,2067,49.2,3082,1015,2067,49.1
37090, 문경시,085001, 80세,2017,733,241,492,49,733,241,492,49
37090, 문경시,085002, 81세,2017,713,254,459,55.3,712,253,459,55.1
37090, 문경시,085003, 82세,2017,645,217,428,50.7,645,217,428,50.7
37090, 문경시,085004, 83세,2017,539,170,369,46.1,539,170,369,46.1
37090, 문경시,085005, 84세,2017,453,134,319,42,453,134,319,42
37090, 문경시,090,85~89세,2017,1346,367,979,37.5,1346,367,979,37.5
37090, 문경시,090001, 85세,2017,337,93,244,38.1,337,93,244,38.1
37090, 문경시,090002, 86세,2017,308,88,220,40,308,88,220,40
37090, 문경시,090003, 87세,2017,285,79,206,38.3,285,79,206,38.3
37090, 문경시,090004, 88세,2017,226,61,165,37,226,61,165,37
37090, 문경시,090005, 89세,2017,190,46,144,31.9,190,46,144,31.9
37090, 문경시,095,90~94세,2017,505,113,392,28.8,505,113,392,28.8
37090, 문경시,095001, 90세,2017,163,42,121,34.7,163,42,121,34.7
37090, 문경시,095002, 91세,2017,117,22,95,23.2,117,22,95,23.2
37090, 문경시,095003, 92세,2017,101,26,75,34.7,101,26,75,34.7
37090, 문경시,095004, 93세,2017,58,10,48,20.8,58,10,48,20.8
37090, 문경시,095005, 94세,2017,66,13,53,24.5,66,13,53,24.5
37090, 문경시,100,95~99세,2017,108,20,88,22.7,108,20,88,22.7
37090, 문경시,100001, 95세,2017,48,12,36,33.3,48,12,36,33.3
37090, 문경시,100002, 96세,2017,27,X,24,12.5,27,X,24,12.5
37090, 문경시,100003, 97세,2017,17,X,13,30.8,17,X,13,30.8
37090, 문경시,100004, 98세,2017,7,X,7,0,7,X,7,0
37090, 문경시,100005, 99세,2017,9,X,8,12.5,9,X,8,12.5
37090, 문경시,101,100세이상,2017,21,X,17,23.5,21,X,17,23.5
37090, 문경시,102,15세미만,2017,7169,3826,3343,114.4,7156,3819,3337,114.4
37090, 문경시,103,15~64세,2017,43678,22755,20923,108.8,42911,22412,20499,109.3
37090, 문경시,104,65세이상,2017,19169,7694,11475,67.1,19140,7677,11463,67
37090, 문경시,086,85세이상,2017,1980,504,1476,34.1,1980,504,1476,34.1
37090, 문경시,126,평균연령,2017,49,46.4,51.5,,49.1,46.5,51.7,
37090, 문경시,127,중위연령,2017,52.7,49.6,55.5,,52.9,49.7,55.8,
37100, 경산시,000,합계,2017,282626,142697,139929,102,272087,136357,135730,100.5
37100, 경산시,005,0~4세,2017,11545,5876,5669,103.7,11421,5814,5607,103.7
37100, 경산시,005001, 0세,2017,2027,1033,994,103.9,1995,1013,982,103.2
37100, 경산시,005002, 1세,2017,2400,1241,1159,107.1,2373,1229,1144,107.4
37100, 경산시,005003, 2세,2017,2366,1193,1173,101.7,2342,1183,1159,102.1
37100, 경산시,005004, 3세,2017,2401,1212,1189,101.9,2378,1203,1175,102.4
37100, 경산시,005005, 4세,2017,2351,1197,1154,103.7,2333,1186,1147,103.4
37100, 경산시,010,5~9세,2017,11289,5852,5437,107.6,11243,5834,5409,107.9
37100, 경산시,010001, 5세,2017,2448,1234,1214,101.6,2432,1229,1203,102.2
37100, 경산시,010002, 6세,2017,2412,1279,1133,112.9,2402,1274,1128,112.9
37100, 경산시,010003, 7세,2017,2143,1082,1061,102,2133,1078,1055,102.2
37100, 경산시,010004, 8세,2017,2135,1119,1016,110.1,2127,1116,1011,110.4
37100, 경산시,010005, 9세,2017,2151,1138,1013,112.3,2149,1137,1012,112.4
37100, 경산시,015,10~14세,2017,10512,5523,4989,110.7,10489,5510,4979,110.7
37100, 경산시,015001, 10세,2017,2240,1162,1078,107.8,2235,1158,1077,107.5
37100, 경산시,015002, 11세,2017,2023,1077,946,113.8,2020,1076,944,114
37100, 경산시,015003, 12세,2017,1899,956,943,101.4,1892,951,941,101.1
37100, 경산시,015004, 13세,2017,2207,1168,1039,112.4,2202,1166,1036,112.5
37100, 경산시,015005, 14세,2017,2143,1160,983,118,2140,1159,981,118.1
37100, 경산시,020,15~19세,2017,20842,10425,10417,100.1,20090,10103,9987,101.2
37100, 경산시,020001, 15세,2017,2369,1245,1124,110.8,2366,1243,1123,110.7
37100, 경산시,020002, 16세,2017,2778,1447,1331,108.7,2770,1444,1326,108.9
37100, 경산시,020003, 17세,2017,3108,1669,1439,116,3065,1652,1413,116.9
37100, 경산시,020004, 18세,2017,4444,2231,2213,100.8,4238,2141,2097,102.1
37100, 경산시,020005, 19세,2017,8143,3833,4310,88.9,7651,3623,4028,89.9
37100, 경산시,025,20~24세,2017,29628,15258,14370,106.2,26972,13802,13170,104.8
37100, 경산시,025001, 20세,2017,6316,2567,3749,68.5,5787,2334,3453,67.6
37100, 경산시,025002, 21세,2017,6230,2686,3544,75.8,5703,2407,3296,73
37100, 경산시,025003, 22세,2017,6298,3310,2988,110.8,5770,3034,2736,110.9
37100, 경산시,025004, 23세,2017,5645,3416,2229,153.3,5127,3099,2028,152.8
37100, 경산시,025005, 24세,2017,5139,3279,1860,176.3,4585,2928,1657,176.7
37100, 경산시,030,25~29세,2017,19521,11403,8118,140.5,17271,9994,7277,137.3
37100, 경산시,030001, 25세,2017,4683,2816,1867,150.8,4145,2483,1662,149.4
37100, 경산시,030002, 26세,2017,4139,2408,1731,139.1,3689,2137,1552,137.7
37100, 경산시,030003, 27세,2017,3785,2171,1614,134.5,3338,1898,1440,131.8
37100, 경산시,030004, 28세,2017,3556,2024,1532,132.1,3123,1748,1375,127.1
37100, 경산시,030005, 29세,2017,3358,1984,1374,144.4,2976,1728,1248,138.5
37100, 경산시,035,30~34세,2017,18085,9867,8218,120.1,16466,8765,7701,113.8
37100, 경산시,035001, 30세,2017,3510,1925,1585,121.5,3112,1675,1437,116.6
37100, 경산시,035002, 31세,2017,3388,1892,1496,126.5,3073,1664,1409,118.1
37100, 경산시,035003, 32세,2017,3566,2006,1560,128.6,3239,1772,1467,120.8
37100, 경산시,035004, 33세,2017,3594,1972,1622,121.6,3282,1771,1511,117.2
37100, 경산시,035005, 34세,2017,4027,2072,1955,106,3760,1883,1877,100.3
37100, 경산시,040,35~39세,2017,20732,10962,9770,112.2,19728,10252,9476,108.2
37100, 경산시,040001, 35세,2017,4277,2254,2023,111.4,4024,2065,1959,105.4
37100, 경산시,040002, 36세,2017,4318,2335,1983,117.8,4087,2172,1915,113.4
37100, 경산시,040003, 37세,2017,4352,2300,2052,112.1,4164,2172,1992,109
37100, 경산시,040004, 38세,2017,4072,2103,1969,106.8,3875,1965,1910,102.9
37100, 경산시,040005, 39세,2017,3713,1970,1743,113,3578,1878,1700,110.5
37100, 경산시,045,40~44세,2017,20656,10793,9863,109.4,20002,10339,9663,107
37100, 경산시,045001, 40세,2017,3744,1980,1764,112.2,3605,1877,1728,108.6
37100, 경산시,045002, 41세,2017,3924,2069,1855,111.5,3787,1986,1801,110.3
37100, 경산시,045003, 42세,2017,4009,2107,1902,110.8,3873,2007,1866,107.6
37100, 경산시,045004, 43세,2017,4448,2322,2126,109.2,4332,2244,2088,107.5
37100, 경산시,045005, 44세,2017,4531,2315,2216,104.5,4405,2225,2180,102.1
37100, 경산시,050,45~49세,2017,22683,11484,11199,102.5,22183,11168,11015,101.4
37100, 경산시,050001, 45세,2017,4392,2259,2133,105.9,4285,2193,2092,104.8
37100, 경산시,050002, 46세,2017,4778,2451,2327,105.3,4665,2371,2294,103.4
37100, 경산시,050003, 47세,2017,4360,2212,2148,103,4261,2146,2115,101.5
37100, 경산시,050004, 48세,2017,4403,2213,2190,101.1,4319,2165,2154,100.5
37100, 경산시,050005, 49세,2017,4750,2349,2401,97.8,4653,2293,2360,97.2
37100, 경산시,055,50~54세,2017,20970,10657,10313,103.3,20578,10436,10142,102.9
37100, 경산시,055001, 50세,2017,4248,2158,2090,103.3,4157,2101,2056,102.2
37100, 경산시,055002, 51세,2017,4276,2269,2007,113.1,4200,2225,1975,112.7
37100, 경산시,055003, 52세,2017,4284,2118,2166,97.8,4205,2079,2126,97.8
37100, 경산시,055004, 53세,2017,3969,2003,1966,101.9,3901,1964,1937,101.4
37100, 경산시,055005, 54세,2017,4193,2109,2084,101.2,4115,2067,2048,100.9
37100, 경산시,060,55~59세,2017,21474,10721,10753,99.7,21231,10595,10636,99.6
37100, 경산시,060001, 55세,2017,4430,2237,2193,102,4368,2204,2164,101.8
37100, 경산시,060002, 56세,2017,4683,2326,2357,98.7,4636,2302,2334,98.6
37100, 경산시,060003, 57세,2017,4469,2202,2267,97.1,4423,2181,2242,97.3
37100, 경산시,060004, 58세,2017,4261,2131,2130,100,4211,2107,2104,100.1
37100, 경산시,060005, 59세,2017,3631,1825,1806,101.1,3593,1801,1792,100.5
37100, 경산시,065,60~64세,2017,16453,8015,8438,95,16298,7931,8367,94.8
37100, 경산시,065001, 60세,2017,3774,1875,1899,98.7,3746,1859,1887,98.5
37100, 경산시,065002, 61세,2017,3460,1712,1748,97.9,3428,1694,1734,97.7
37100, 경산시,065003, 62세,2017,3455,1661,1794,92.6,3423,1644,1779,92.4
37100, 경산시,065004, 63세,2017,2979,1437,1542,93.2,2948,1421,1527,93.1
37100, 경산시,065005, 64세,2017,2785,1330,1455,91.4,2753,1313,1440,91.2
37100, 경산시,070,65~69세,2017,12713,5926,6787,87.3,12652,5899,6753,87.4
37100, 경산시,070001, 65세,2017,2988,1397,1591,87.8,2971,1388,1583,87.7
37100, 경산시,070002, 66세,2017,2398,1134,1264,89.7,2380,1127,1253,89.9
37100, 경산시,070003, 67세,2017,2340,1102,1238,89,2328,1095,1233,88.8
37100, 경산시,070004, 68세,2017,2569,1195,1374,87,2561,1192,1369,87.1
37100, 경산시,070005, 69세,2017,2418,1098,1320,83.2,2412,1097,1315,83.4
37100, 경산시,075,70~74세,2017,8881,3990,4891,81.6,8848,3977,4871,81.6
37100, 경산시,075001, 70세,2017,2230,1004,1226,81.9,2223,1002,1221,82.1
37100, 경산시,075002, 71세,2017,1419,694,725,95.7,1410,690,720,95.8
37100, 경산시,075003, 72세,2017,1520,682,838,81.4,1515,680,835,81.4
37100, 경산시,075004, 73세,2017,1805,776,1029,75.4,1800,774,1026,75.4
37100, 경산시,075005, 74세,2017,1907,834,1073,77.7,1900,831,1069,77.7
37100, 경산시,080,75~79세,2017,8364,3351,5013,66.8,8347,3346,5001,66.9
37100, 경산시,080001, 75세,2017,2122,916,1206,76,2116,915,1201,76.2
37100, 경산시,080002, 76세,2017,1662,676,986,68.6,1659,674,985,68.4
37100, 경산시,080003, 77세,2017,1608,599,1009,59.4,1604,598,1006,59.4
37100, 경산시,080004, 78세,2017,1594,632,962,65.7,1592,631,961,65.7
37100, 경산시,080005, 79세,2017,1378,528,850,62.1,1376,528,848,62.3
37100, 경산시,085,80~84세,2017,5214,1818,3396,53.5,5208,1817,3391,53.6
37100, 경산시,085001, 80세,2017,1228,433,795,54.5,1227,433,794,54.5
37100, 경산시,085002, 81세,2017,1178,436,742,58.8,1177,436,741,58.8
37100, 경산시,085003, 82세,2017,1089,373,716,52.1,1086,373,713,52.3
37100, 경산시,085004, 83세,2017,943,310,633,49,942,309,633,48.8
37100, 경산시,085005, 84세,2017,776,266,510,52.2,776,266,510,52.2
37100, 경산시,090,85~89세,2017,2191,599,1592,37.6,2188,598,1590,37.6
37100, 경산시,090001, 85세,2017,675,190,485,39.2,675,190,485,39.2
37100, 경산시,090002, 86세,2017,479,140,339,41.3,479,140,339,41.3
37100, 경산시,090003, 87세,2017,435,106,329,32.2,435,106,329,32.2
37100, 경산시,090004, 88세,2017,323,85,238,35.7,322,85,237,35.9
37100, 경산시,090005, 89세,2017,279,78,201,38.8,277,77,200,38.5
37100, 경산시,095,90~94세,2017,716,148,568,26.1,716,148,568,26.1
37100, 경산시,095001, 90세,2017,263,61,202,30.2,263,61,202,30.2
37100, 경산시,095002, 91세,2017,153,30,123,24.4,153,30,123,24.4
37100, 경산시,095003, 92세,2017,126,22,104,21.2,126,22,104,21.2
37100, 경산시,095004, 93세,2017,94,19,75,25.3,94,19,75,25.3
37100, 경산시,095005, 94세,2017,80,16,64,25,80,16,64,25
37100, 경산시,100,95~99세,2017,143,26,117,22.2,142,26,116,22.4
37100, 경산시,100001, 95세,2017,61,12,49,24.5,61,12,49,24.5
37100, 경산시,100002, 96세,2017,36,5,31,16.1,36,5,31,16.1
37100, 경산시,100003, 97세,2017,16,X,14,14.3,16,X,14,14.3
37100, 경산시,100004, 98세,2017,15,X,13,15.4,15,X,13,15.4
37100, 경산시,100005, 99세,2017,15,5,10,50,14,5,9,55.6
37100, 경산시,101,100세이상,2017,14,X,11,27.3,14,X,11,27.3
37100, 경산시,102,15세미만,2017,33346,17251,16095,107.2,33153,17158,15995,107.3
37100, 경산시,103,15~64세,2017,211044,109585,101459,108,200819,103385,97434,106.1
37100, 경산시,104,65세이상,2017,38236,15861,22375,70.9,38115,15814,22301,70.9
37100, 경산시,086,85세이상,2017,3064,776,2288,33.9,3060,775,2285,33.9
37100, 경산시,126,평균연령,2017,40.2,38.9,41.5,,40.5,39.2,41.8,
37100, 경산시,127,중위연령,2017,39.8,38.1,41.7,,40.7,39,42.4,
37310, 군위군,000,합계,2017,22230,11309,10921,103.6,21559,10805,10754,100.5
37310, 군위군,005,0~4세,2017,424,247,177,139.5,420,245,175,140
37310, 군위군,005001, 0세,2017,91,54,37,145.9,91,54,37,145.9
37310, 군위군,005002, 1세,2017,83,50,33,151.5,82,50,32,156.3
37310, 군위군,005003, 2세,2017,87,49,38,128.9,85,48,37,129.7
37310, 군위군,005004, 3세,2017,86,43,43,100,86,43,43,100
37310, 군위군,005005, 4세,2017,77,51,26,196.2,76,50,26,192.3
37310, 군위군,010,5~9세,2017,439,233,206,113.1,439,233,206,113.1
37310, 군위군,010001, 5세,2017,103,49,54,90.7,103,49,54,90.7
37310, 군위군,010002, 6세,2017,76,43,33,130.3,76,43,33,130.3
37310, 군위군,010003, 7세,2017,74,35,39,89.7,74,35,39,89.7
37310, 군위군,010004, 8세,2017,86,49,37,132.4,86,49,37,132.4
37310, 군위군,010005, 9세,2017,100,57,43,132.6,100,57,43,132.6
37310, 군위군,015,10~14세,2017,427,228,199,114.6,425,227,198,114.6
37310, 군위군,015001, 10세,2017,91,48,43,111.6,90,48,42,114.3
37310, 군위군,015002, 11세,2017,84,43,41,104.9,84,43,41,104.9
37310, 군위군,015003, 12세,2017,90,49,41,119.5,90,49,41,119.5
37310, 군위군,015004, 13세,2017,72,39,33,118.2,71,38,33,115.2
37310, 군위군,015005, 14세,2017,90,49,41,119.5,90,49,41,119.5
37310, 군위군,020,15~19세,2017,653,355,298,119.1,651,354,297,119.2
37310, 군위군,020001, 15세,2017,120,67,53,126.4,120,67,53,126.4
37310, 군위군,020002, 16세,2017,119,53,66,80.3,119,53,66,80.3
37310, 군위군,020003, 17세,2017,162,85,77,110.4,161,84,77,109.1
37310, 군위군,020004, 18세,2017,133,75,58,129.3,133,75,58,129.3
37310, 군위군,020005, 19세,2017,119,75,44,170.5,118,75,43,174.4
37310, 군위군,025,20~24세,2017,779,472,307,153.7,696,412,284,145.1
37310, 군위군,025001, 20세,2017,164,97,67,144.8,153,92,61,150.8
37310, 군위군,025002, 21세,2017,131,84,47,178.7,120,74,46,160.9
37310, 군위군,025003, 22세,2017,157,94,63,149.2,141,85,56,151.8
37310, 군위군,025004, 23세,2017,169,98,71,138,150,85,65,130.8
37310, 군위군,025005, 24세,2017,158,99,59,167.8,132,76,56,135.7
37310, 군위군,030,25~29세,2017,866,558,308,181.2,676,407,269,151.3
37310, 군위군,030001, 25세,2017,190,132,58,227.6,153,101,52,194.2
37310, 군위군,030002, 26세,2017,156,100,56,178.6,119,72,47,153.2
37310, 군위군,030003, 27세,2017,179,113,66,171.2,142,83,59,140.7
37310, 군위군,030004, 28세,2017,173,111,62,179,131,78,53,147.2
37310, 군위군,030005, 29세,2017,168,102,66,154.5,131,73,58,125.9
37310, 군위군,035,30~34세,2017,854,520,334,155.7,694,390,304,128.3
37310, 군위군,035001, 30세,2017,191,124,67,185.1,152,94,58,162.1
37310, 군위군,035002, 31세,2017,162,96,66,145.5,128,66,62,106.5
37310, 군위군,035003, 32세,2017,168,109,59,184.7,137,84,53,158.5
37310, 군위군,035004, 33세,2017,153,96,57,168.4,123,66,57,115.8
37310, 군위군,035005, 34세,2017,180,95,85,111.8,154,80,74,108.1
37310, 군위군,040,35~39세,2017,883,522,361,144.6,802,457,345,132.5
37310, 군위군,040001, 35세,2017,167,102,65,156.9,145,80,65,123.1
37310, 군위군,040002, 36세,2017,177,108,69,156.5,160,93,67,138.8
37310, 군위군,040003, 37세,2017,183,102,81,125.9,162,89,73,121.9
37310, 군위군,040004, 38세,2017,191,113,78,144.9,178,103,75,137.3
37310, 군위군,040005, 39세,2017,165,97,68,142.6,157,92,65,141.5
37310, 군위군,045,40~44세,2017,911,547,364,150.3,866,515,351,146.7
37310, 군위군,045001, 40세,2017,153,99,54,183.3,144,92,52,176.9
37310, 군위군,045002, 41세,2017,185,109,76,143.4,177,102,75,136
37310, 군위군,045003, 42세,2017,183,107,76,140.8,174,100,74,135.1
37310, 군위군,045004, 43세,2017,179,106,73,145.2,168,99,69,143.5
37310, 군위군,045005, 44세,2017,211,126,85,148.2,203,122,81,150.6
37310, 군위군,050,45~49세,2017,1303,738,565,130.6,1263,712,551,129.2
37310, 군위군,050001, 45세,2017,237,134,103,130.1,229,127,102,124.5
37310, 군위군,050002, 46세,2017,244,135,109,123.9,231,127,104,122.1
37310, 군위군,050003, 47세,2017,242,139,103,135,234,134,100,134
37310, 군위군,050004, 48세,2017,290,171,119,143.7,283,168,115,146.1
37310, 군위군,050005, 49세,2017,290,159,131,121.4,286,156,130,120
37310, 군위군,055,50~54세,2017,1743,965,778,124,1720,951,769,123.7
37310, 군위군,055001, 50세,2017,299,180,119,151.3,293,176,117,150.4
37310, 군위군,055002, 51세,2017,328,186,142,131,325,183,142,128.9
37310, 군위군,055003, 52세,2017,381,207,174,119,378,206,172,119.8
37310, 군위군,055004, 53세,2017,361,201,160,125.6,353,197,156,126.3
37310, 군위군,055005, 54세,2017,374,191,183,104.4,371,189,182,103.8
37310, 군위군,060,55~59세,2017,2304,1212,1092,111,2282,1202,1080,111.3
37310, 군위군,060001, 55세,2017,444,250,194,128.9,437,246,191,128.8
37310, 군위군,060002, 56세,2017,451,234,217,107.8,446,232,214,108.4
37310, 군위군,060003, 57세,2017,489,252,237,106.3,483,249,234,106.4
37310, 군위군,060004, 58세,2017,496,253,243,104.1,495,252,243,103.7
37310, 군위군,060005, 59세,2017,424,223,201,110.9,421,223,198,112.6
37310, 군위군,065,60~64세,2017,2321,1216,1105,110,2311,1209,1102,109.7
37310, 군위군,065001, 60세,2017,485,256,229,111.8,482,253,229,110.5
37310, 군위군,065002, 61세,2017,510,268,242,110.7,508,266,242,109.9
37310, 군위군,065003, 62세,2017,477,246,231,106.5,477,246,231,106.5
37310, 군위군,065004, 63세,2017,431,223,208,107.2,429,222,207,107.2
37310, 군위군,065005, 64세,2017,418,223,195,114.4,415,222,193,115
37310, 군위군,070,65~69세,2017,2135,1043,1092,95.5,2130,1041,1089,95.6
37310, 군위군,070001, 65세,2017,514,246,268,91.8,513,246,267,92.1
37310, 군위군,070002, 66세,2017,391,192,199,96.5,390,192,198,97
37310, 군위군,070003, 67세,2017,380,169,211,80.1,379,169,210,80.5
37310, 군위군,070004, 68세,2017,429,234,195,120,427,232,195,119
37310, 군위군,070005, 69세,2017,421,202,219,92.2,421,202,219,92.2
37310, 군위군,075,70~74세,2017,1811,830,981,84.6,1808,828,980,84.5
37310, 군위군,075001, 70세,2017,444,224,220,101.8,444,224,220,101.8
37310, 군위군,075002, 71세,2017,259,131,128,102.3,259,131,128,102.3
37310, 군위군,075003, 72세,2017,337,146,191,76.4,335,145,190,76.3
37310, 군위군,075004, 73세,2017,348,150,198,75.8,348,150,198,75.8
37310, 군위군,075005, 74세,2017,423,179,244,73.4,422,178,244,73
37310, 군위군,080,75~79세,2017,2100,857,1243,68.9,2099,856,1243,68.9
37310, 군위군,080001, 75세,2017,504,215,289,74.4,504,215,289,74.4
37310, 군위군,080002, 76세,2017,400,171,229,74.7,400,171,229,74.7
37310, 군위군,080003, 77세,2017,407,167,240,69.6,407,167,240,69.6
37310, 군위군,080004, 78세,2017,397,155,242,64,396,154,242,63.6
37310, 군위군,080005, 79세,2017,392,149,243,61.3,392,149,243,61.3
37310, 군위군,085,80~84세,2017,1490,542,948,57.2,1490,542,948,57.2
37310, 군위군,085001, 80세,2017,331,132,199,66.3,331,132,199,66.3
37310, 군위군,085002, 81세,2017,327,120,207,58,327,120,207,58
37310, 군위군,085003, 82세,2017,356,122,234,52.1,356,122,234,52.1
37310, 군위군,085004, 83세,2017,269,92,177,52,269,92,177,52
37310, 군위군,085005, 84세,2017,207,76,131,58,207,76,131,58
37310, 군위군,090,85~89세,2017,599,183,416,44,599,183,416,44
37310, 군위군,090001, 85세,2017,193,70,123,56.9,193,70,123,56.9
37310, 군위군,090002, 86세,2017,130,35,95,36.8,130,35,95,36.8
37310, 군위군,090003, 87세,2017,117,40,77,51.9,117,40,77,51.9
37310, 군위군,090004, 88세,2017,91,21,70,30,91,21,70,30
37310, 군위군,090005, 89세,2017,68,17,51,33.3,68,17,51,33.3
37310, 군위군,095,90~94세,2017,149,35,114,30.7,149,35,114,30.7
37310, 군위군,095001, 90세,2017,61,14,47,29.8,61,14,47,29.8
37310, 군위군,095002, 91세,2017,33,8,25,32,33,8,25,32
37310, 군위군,095003, 92세,2017,27,8,19,42.1,27,8,19,42.1
37310, 군위군,095004, 93세,2017,19,X,15,26.7,19,X,15,26.7
37310, 군위군,095005, 94세,2017,9,X,8,12.5,9,X,8,12.5
37310, 군위군,100,95~99세,2017,37,6,31,19.4,37,6,31,19.4
37310, 군위군,100001, 95세,2017,14,X,14,0,14,X,14,0
37310, 군위군,100002, 96세,2017,7,X,5,40,7,X,5,40
37310, 군위군,100003, 97세,2017,6,X,6,0,6,X,6,0
37310, 군위군,100004, 98세,2017,6,X,X,50,6,X,X,50
37310, 군위군,100005, 99세,2017,X,X,X,100,X,X,X,100
37310, 군위군,101,100세이상,2017,X,X,X,0,X,X,X,0
37310, 군위군,102,15세미만,2017,1290,708,582,121.6,1284,705,579,121.8
37310, 군위군,103,15~64세,2017,12617,7105,5512,128.9,11961,6609,5352,123.5
37310, 군위군,104,65세이상,2017,8323,3496,4827,72.4,8314,3491,4823,72.4
37310, 군위군,086,85세이상,2017,787,224,563,39.8,787,224,563,39.8
37310, 군위군,126,평균연령,2017,55,52.1,58,,55.7,53,58.4,
37310, 군위군,127,중위연령,2017,58.9,56.1,62,,59.6,57.1,62.3,
37320, 의성군,000,합계,2017,50082,24203,25879,93.5,49306,23769,25537,93.1
37320, 의성군,005,0~4세,2017,1067,568,499,113.8,1065,567,498,113.9
37320, 의성군,005001, 0세,2017,226,123,103,119.4,226,123,103,119.4
37320, 의성군,005002, 1세,2017,248,127,121,105,248,127,121,105
37320, 의성군,005003, 2세,2017,196,102,94,108.5,195,102,93,109.7
37320, 의성군,005004, 3세,2017,210,114,96,118.8,209,113,96,117.7
37320, 의성군,005005, 4세,2017,187,102,85,120,187,102,85,120
37320, 의성군,010,5~9세,2017,1024,529,495,106.9,1020,528,492,107.3
37320, 의성군,010001, 5세,2017,208,106,102,103.9,208,106,102,103.9
37320, 의성군,010002, 6세,2017,199,91,108,84.3,198,91,107,85
37320, 의성군,010003, 7세,2017,192,105,87,120.7,191,105,86,122.1
37320, 의성군,010004, 8세,2017,193,99,94,105.3,193,99,94,105.3
37320, 의성군,010005, 9세,2017,232,128,104,123.1,230,127,103,123.3
37320, 의성군,015,10~14세,2017,1092,567,525,108,1090,565,525,107.6
37320, 의성군,015001, 10세,2017,205,97,108,89.8,205,97,108,89.8
37320, 의성군,015002, 11세,2017,215,115,100,115,214,114,100,114
37320, 의성군,015003, 12세,2017,213,113,100,113,213,113,100,113
37320, 의성군,015004, 13세,2017,241,127,114,111.4,240,126,114,110.5
37320, 의성군,015005, 14세,2017,218,115,103,111.7,218,115,103,111.7
37320, 의성군,020,15~19세,2017,1252,683,569,120,1249,681,568,119.9
37320, 의성군,020001, 15세,2017,250,133,117,113.7,250,133,117,113.7
37320, 의성군,020002, 16세,2017,267,144,123,117.1,267,144,123,117.1
37320, 의성군,020003, 17세,2017,269,128,141,90.8,268,127,141,90.1
37320, 의성군,020004, 18세,2017,268,137,131,104.6,266,136,130,104.6
37320, 의성군,020005, 19세,2017,198,141,57,247.4,198,141,57,247.4
37320, 의성군,025,20~24세,2017,1547,926,621,149.1,1445,871,574,151.7
37320, 의성군,025001, 20세,2017,266,173,93,186,257,171,86,198.8
37320, 의성군,025002, 21세,2017,290,197,93,211.8,279,188,91,206.6
37320, 의성군,025003, 22세,2017,350,203,147,138.1,323,190,133,142.9
37320, 의성군,025004, 23세,2017,311,179,132,135.6,283,164,119,137.8
37320, 의성군,025005, 24세,2017,330,174,156,111.5,303,158,145,109
37320, 의성군,030,25~29세,2017,1680,1005,675,148.9,1521,912,609,149.8
37320, 의성군,030001, 25세,2017,348,202,146,138.4,322,186,136,136.8
37320, 의성군,030002, 26세,2017,339,205,134,153,305,181,124,146
37320, 의성군,030003, 27세,2017,332,205,127,161.4,300,189,111,170.3
37320, 의성군,030004, 28세,2017,337,200,137,146,304,181,123,147.2
37320, 의성군,030005, 29세,2017,324,193,131,147.3,290,175,115,152.2
37320, 의성군,035,30~34세,2017,1647,934,713,131,1515,852,663,128.5
37320, 의성군,035001, 30세,2017,331,180,151,119.2,306,165,141,117
37320, 의성군,035002, 31세,2017,323,180,143,125.9,290,158,132,119.7
37320, 의성군,035003, 32세,2017,351,211,140,150.7,324,196,128,153.1
37320, 의성군,035004, 33세,2017,308,174,134,129.9,283,156,127,122.8
37320, 의성군,035005, 34세,2017,334,189,145,130.3,312,177,135,131.1
37320, 의성군,040,35~39세,2017,1821,1011,810,124.8,1733,959,774,123.9
37320, 의성군,040001, 35세,2017,382,197,185,106.5,361,185,176,105.1
37320, 의성군,040002, 36세,2017,364,208,156,133.3,348,198,150,132
37320, 의성군,040003, 37세,2017,339,190,149,127.5,323,179,144,124.3
37320, 의성군,040004, 38세,2017,387,210,177,118.6,369,202,167,121
37320, 의성군,040005, 39세,2017,349,206,143,144.1,332,195,137,142.3
37320, 의성군,045,40~44세,2017,2026,1178,848,138.9,1951,1137,814,139.7
37320, 의성군,045001, 40세,2017,360,205,155,132.3,345,197,148,133.1
37320, 의성군,045002, 41세,2017,356,219,137,159.9,341,211,130,162.3
37320, 의성군,045003, 42세,2017,399,232,167,138.9,385,224,161,139.1
37320, 의성군,045004, 43세,2017,428,256,172,148.8,412,246,166,148.2
37320, 의성군,045005, 44세,2017,483,266,217,122.6,468,259,209,123.9
37320, 의성군,050,45~49세,2017,2820,1578,1242,127.1,2761,1548,1213,127.6
37320, 의성군,050001, 45세,2017,505,286,219,130.6,493,282,211,133.6
37320, 의성군,050002, 46세,2017,515,281,234,120.1,502,277,225,123.1
37320, 의성군,050003, 47세,2017,542,301,241,124.9,531,295,236,125
37320, 의성군,050004, 48세,2017,620,349,271,128.8,612,342,270,126.7
37320, 의성군,050005, 49세,2017,638,361,277,130.3,623,352,271,129.9
37320, 의성군,055,50~54세,2017,3669,1935,1734,111.6,3618,1912,1706,112.1
37320, 의성군,055001, 50세,2017,673,376,297,126.6,661,372,289,128.7
37320, 의성군,055002, 51세,2017,697,404,293,137.9,688,399,289,138.1
37320, 의성군,055003, 52세,2017,781,396,385,102.9,771,393,378,104
37320, 의성군,055004, 53세,2017,727,350,377,92.8,718,347,371,93.5
37320, 의성군,055005, 54세,2017,791,409,382,107.1,780,401,379,105.8
37320, 의성군,060,55~59세,2017,5421,2727,2694,101.2,5376,2704,2672,101.2
37320, 의성군,060001, 55세,2017,1047,540,507,106.5,1033,535,498,107.4
37320, 의성군,060002, 56세,2017,1047,527,520,101.3,1045,526,519,101.3
37320, 의성군,060003, 57세,2017,1159,564,595,94.8,1147,557,590,94.4
37320, 의성군,060004, 58세,2017,1057,546,511,106.8,1052,544,508,107.1
37320, 의성군,060005, 59세,2017,1111,550,561,98,1099,542,557,97.3
37320, 의성군,065,60~64세,2017,5405,2683,2722,98.6,5377,2666,2711,98.3
37320, 의성군,065001, 60세,2017,1128,588,540,108.9,1118,582,536,108.6
37320, 의성군,065002, 61세,2017,1100,571,529,107.9,1094,567,527,107.6
37320, 의성군,065003, 62세,2017,1081,501,580,86.4,1081,501,580,86.4
37320, 의성군,065004, 63세,2017,1056,520,536,97,1051,518,533,97.2
37320, 의성군,065005, 64세,2017,1040,503,537,93.7,1033,498,535,93.1
37320, 의성군,070,65~69세,2017,4823,2289,2534,90.3,4807,2281,2526,90.3
37320, 의성군,070001, 65세,2017,1073,518,555,93.3,1072,518,554,93.5
37320, 의성군,070002, 66세,2017,917,447,470,95.1,914,445,469,94.9
37320, 의성군,070003, 67세,2017,904,419,485,86.4,898,416,482,86.3
37320, 의성군,070004, 68세,2017,982,456,526,86.7,979,454,525,86.5
37320, 의성군,070005, 69세,2017,947,449,498,90.2,944,448,496,90.3
37320, 의성군,075,70~74세,2017,4050,1765,2285,77.2,4044,1763,2281,77.3
37320, 의성군,075001, 70세,2017,905,405,500,81,905,405,500,81
37320, 의성군,075002, 71세,2017,581,278,303,91.7,577,277,300,92.3
37320, 의성군,075003, 72세,2017,671,289,382,75.7,670,288,382,75.4
37320, 의성군,075004, 73세,2017,843,356,487,73.1,842,356,486,73.3
37320, 의성군,075005, 74세,2017,1050,437,613,71.3,1050,437,613,71.3
37320, 의성군,080,75~79세,2017,4988,2007,2981,67.3,4986,2006,2980,67.3
37320, 의성군,080001, 75세,2017,1220,516,704,73.3,1220,516,704,73.3
37320, 의성군,080002, 76세,2017,941,384,557,68.9,941,384,557,68.9
37320, 의성군,080003, 77세,2017,861,360,501,71.9,860,359,501,71.7
37320, 의성군,080004, 78세,2017,1084,439,645,68.1,1083,439,644,68.2
37320, 의성군,080005, 79세,2017,882,308,574,53.7,882,308,574,53.7
37320, 의성군,085,80~84세,2017,3578,1228,2350,52.3,3578,1228,2350,52.3
37320, 의성군,085001, 80세,2017,842,293,549,53.4,842,293,549,53.4
37320, 의성군,085002, 81세,2017,774,290,484,59.9,774,290,484,59.9
37320, 의성군,085003, 82세,2017,775,269,506,53.2,775,269,506,53.2
37320, 의성군,085004, 83세,2017,671,222,449,49.4,671,222,449,49.4
37320, 의성군,085005, 84세,2017,516,154,362,42.5,516,154,362,42.5
37320, 의성군,090,85~89세,2017,1535,439,1096,40.1,1533,438,1095,40
37320, 의성군,090001, 85세,2017,466,147,319,46.1,465,147,318,46.2
37320, 의성군,090002, 86세,2017,324,95,229,41.5,324,95,229,41.5
37320, 의성군,090003, 87세,2017,292,91,201,45.3,292,91,201,45.3
37320, 의성군,090004, 88세,2017,241,60,181,33.1,240,59,181,32.6
37320, 의성군,090005, 89세,2017,212,46,166,27.7,212,46,166,27.7
37320, 의성군,095,90~94세,2017,517,134,383,35,517,134,383,35
37320, 의성군,095001, 90세,2017,176,55,121,45.5,176,55,121,45.5
37320, 의성군,095002, 91세,2017,118,31,87,35.6,118,31,87,35.6
37320, 의성군,095003, 92세,2017,109,25,84,29.8,109,25,84,29.8
37320, 의성군,095004, 93세,2017,62,10,52,19.2,62,10,52,19.2
37320, 의성군,095005, 94세,2017,52,13,39,33.3,52,13,39,33.3
37320, 의성군,100,95~99세,2017,108,15,93,16.1,108,15,93,16.1
37320, 의성군,100001, 95세,2017,44,8,36,22.2,44,8,36,22.2
37320, 의성군,100002, 96세,2017,23,5,18,27.8,23,5,18,27.8
37320, 의성군,100003, 97세,2017,23,X,23,0,23,X,23,0
37320, 의성군,100004, 98세,2017,15,X,13,15.4,15,X,13,15.4
37320, 의성군,100005, 99세,2017,X,X,X,0,X,X,X,0
37320, 의성군,101,100세이상,2017,12,X,10,20,12,X,10,20
37320, 의성군,102,15세미만,2017,3183,1664,1519,109.5,3175,1660,1515,109.6
37320, 의성군,103,15~64세,2017,27288,14660,12628,116.1,26546,14242,12304,115.8
37320, 의성군,104,65세이상,2017,19611,7879,11732,67.2,19585,7867,11718,67.1
37320, 의성군,086,85세이상,2017,2172,590,1582,37.3,2170,589,1581,37.3
37320, 의성군,126,평균연령,2017,56,53,58.8,,56.3,53.3,59.1,
37320, 의성군,127,중위연령,2017,60,57.2,62.8,,60.3,57.5,63,
37330, 청송군,000,합계,2017,24441,12056,12385,97.3,24155,11957,12198,98
37330, 청송군,005,0~4세,2017,609,290,319,90.9,609,290,319,90.9
37330, 청송군,005001, 0세,2017,125,59,66,89.4,125,59,66,89.4
37330, 청송군,005002, 1세,2017,111,56,55,101.8,111,56,55,101.8
37330, 청송군,005003, 2세,2017,127,63,64,98.4,127,63,64,98.4
37330, 청송군,005004, 3세,2017,129,62,67,92.5,129,62,67,92.5
37330, 청송군,005005, 4세,2017,117,50,67,74.6,117,50,67,74.6
37330, 청송군,010,5~9세,2017,572,306,266,115,572,306,266,115
37330, 청송군,010001, 5세,2017,130,64,66,97,130,64,66,97
37330, 청송군,010002, 6세,2017,119,68,51,133.3,119,68,51,133.3
37330, 청송군,010003, 7세,2017,95,46,49,93.9,95,46,49,93.9
37330, 청송군,010004, 8세,2017,118,61,57,107,118,61,57,107
37330, 청송군,010005, 9세,2017,110,67,43,155.8,110,67,43,155.8
37330, 청송군,015,10~14세,2017,623,327,296,110.5,623,327,296,110.5
37330, 청송군,015001, 10세,2017,109,49,60,81.7,109,49,60,81.7
37330, 청송군,015002, 11세,2017,104,52,52,100,104,52,52,100
37330, 청송군,015003, 12세,2017,123,67,56,119.6,123,67,56,119.6
37330, 청송군,015004, 13세,2017,137,78,59,132.2,137,78,59,132.2
37330, 청송군,015005, 14세,2017,150,81,69,117.4,150,81,69,117.4
37330, 청송군,020,15~19세,2017,735,408,327,124.8,730,407,323,126
37330, 청송군,020001, 15세,2017,142,66,76,86.8,142,66,76,86.8
37330, 청송군,020002, 16세,2017,151,82,69,118.8,151,82,69,118.8
37330, 청송군,020003, 17세,2017,193,118,75,157.3,192,117,75,156
37330, 청송군,020004, 18세,2017,136,72,64,112.5,133,72,61,118
37330, 청송군,020005, 19세,2017,113,70,43,162.8,112,70,42,166.7
37330, 청송군,025,20~24세,2017,774,472,302,156.3,745,465,280,166.1
37330, 청송군,025001, 20세,2017,131,96,35,274.3,129,96,33,290.9
37330, 청송군,025002, 21세,2017,171,122,49,249,166,120,46,260.9
37330, 청송군,025003, 22세,2017,146,76,70,108.6,141,75,66,113.6
37330, 청송군,025004, 23세,2017,175,86,89,96.6,166,84,82,102.4
37330, 청송군,025005, 24세,2017,151,92,59,155.9,143,90,53,169.8
37330, 청송군,030,25~29세,2017,852,499,353,141.4,797,482,315,153
37330, 청송군,030001, 25세,2017,198,118,80,147.5,184,116,68,170.6
37330, 청송군,030002, 26세,2017,157,80,77,103.9,149,77,72,106.9
37330, 청송군,030003, 27세,2017,168,90,78,115.4,153,87,66,131.8
37330, 청송군,030004, 28세,2017,161,99,62,159.7,152,96,56,171.4
37330, 청송군,030005, 29세,2017,168,112,56,200,159,106,53,200
37330, 청송군,035,30~34세,2017,888,505,383,131.9,845,494,351,140.7
37330, 청송군,035001, 30세,2017,166,98,68,144.1,161,97,64,151.6
37330, 청송군,035002, 31세,2017,182,109,73,149.3,171,106,65,163.1
37330, 청송군,035003, 32세,2017,167,102,65,156.9,157,100,57,175.4
37330, 청송군,035004, 33세,2017,166,85,81,104.9,157,82,75,109.3
37330, 청송군,035005, 34세,2017,207,111,96,115.6,199,109,90,121.1
37330, 청송군,040,35~39세,2017,996,539,457,117.9,964,526,438,120.1
37330, 청송군,040001, 35세,2017,198,95,103,92.2,187,90,97,92.8
37330, 청송군,040002, 36세,2017,214,122,92,132.6,206,119,87,136.8
37330, 청송군,040003, 37세,2017,222,126,96,131.3,214,124,90,137.8
37330, 청송군,040004, 38세,2017,181,94,87,108,179,93,86,108.1
37330, 청송군,040005, 39세,2017,181,102,79,129.1,178,100,78,128.2
37330, 청송군,045,40~44세,2017,1136,636,500,127.2,1111,625,486,128.6
37330, 청송군,045001, 40세,2017,207,117,90,130,203,116,87,133.3
37330, 청송군,045002, 41세,2017,213,118,95,124.2,209,116,93,124.7
37330, 청송군,045003, 42세,2017,220,121,99,122.2,215,118,97,121.6
37330, 청송군,045004, 43세,2017,254,144,110,130.9,244,141,103,136.9
37330, 청송군,045005, 44세,2017,242,136,106,128.3,240,134,106,126.4
37330, 청송군,050,45~49세,2017,1622,900,722,124.7,1599,895,704,127.1
37330, 청송군,050001, 45세,2017,267,152,115,132.2,263,151,112,134.8
37330, 청송군,050002, 46세,2017,279,157,122,128.7,273,154,119,129.4
37330, 청송군,050003, 47세,2017,337,183,154,118.8,334,183,151,121.2
37330, 청송군,050004, 48세,2017,370,217,153,141.8,365,216,149,145
37330, 청송군,050005, 49세,2017,369,191,178,107.3,364,191,173,110.4
37330, 청송군,055,50~54세,2017,2028,1067,961,111,2003,1056,947,111.5
37330, 청송군,055001, 50세,2017,368,194,174,111.5,361,191,170,112.4
37330, 청송군,055002, 51세,2017,394,214,180,118.9,388,212,176,120.5
37330, 청송군,055003, 52세,2017,425,226,199,113.6,419,222,197,112.7
37330, 청송군,055004, 53세,2017,396,208,188,110.6,393,206,187,110.2
37330, 청송군,055005, 54세,2017,445,225,220,102.3,442,225,217,103.7
37330, 청송군,060,55~59세,2017,2659,1341,1318,101.7,2639,1334,1305,102.2
37330, 청송군,060001, 55세,2017,520,263,257,102.3,513,261,252,103.6
37330, 청송군,060002, 56세,2017,544,283,261,108.4,540,283,257,110.1
37330, 청송군,060003, 57세,2017,555,273,282,96.8,551,273,278,98.2
37330, 청송군,060004, 58세,2017,519,253,266,95.1,517,251,266,94.4
37330, 청송군,060005, 59세,2017,521,269,252,106.7,518,266,252,105.6
37330, 청송군,065,60~64세,2017,2491,1232,1259,97.9,2481,1224,1257,97.4
37330, 청송군,065001, 60세,2017,521,256,265,96.6,520,255,265,96.2
37330, 청송군,065002, 61세,2017,538,257,281,91.5,535,254,281,90.4
37330, 청송군,065003, 62세,2017,496,244,252,96.8,492,242,250,96.8
37330, 청송군,065004, 63세,2017,465,237,228,103.9,464,236,228,103.5
37330, 청송군,065005, 64세,2017,471,238,233,102.1,470,237,233,101.7
37330, 청송군,070,65~69세,2017,2208,1082,1126,96.1,2204,1081,1123,96.3
37330, 청송군,070001, 65세,2017,501,226,275,82.2,498,225,273,82.4
37330, 청송군,070002, 66세,2017,430,218,212,102.8,430,218,212,102.8
37330, 청송군,070003, 67세,2017,410,207,203,102,410,207,203,102
37330, 청송군,070004, 68세,2017,421,214,207,103.4,421,214,207,103.4
37330, 청송군,070005, 69세,2017,446,217,229,94.8,445,217,228,95.2
37330, 청송군,075,70~74세,2017,1916,849,1067,79.6,1905,844,1061,79.5
37330, 청송군,075001, 70세,2017,434,202,232,87.1,431,202,229,88.2
37330, 청송군,075002, 71세,2017,281,122,159,76.7,278,120,158,75.9
37330, 청송군,075003, 72세,2017,342,161,181,89,340,160,180,88.9
37330, 청송군,075004, 73세,2017,413,174,239,72.8,412,173,239,72.4
37330, 청송군,075005, 74세,2017,446,190,256,74.2,444,189,255,74.1
37330, 청송군,080,75~79세,2017,2145,856,1289,66.4,2142,855,1287,66.4
37330, 청송군,080001, 75세,2017,521,205,316,64.9,520,204,316,64.6
37330, 청송군,080002, 76세,2017,430,173,257,67.3,430,173,257,67.3
37330, 청송군,080003, 77세,2017,401,168,233,72.1,400,168,232,72.4
37330, 청송군,080004, 78세,2017,446,173,273,63.4,446,173,273,63.4
37330, 청송군,080005, 79세,2017,347,137,210,65.2,346,137,209,65.6
37330, 청송군,085,80~84세,2017,1333,499,834,59.8,1332,498,834,59.7
37330, 청송군,085001, 80세,2017,304,108,196,55.1,303,107,196,54.6
37330, 청송군,085002, 81세,2017,315,126,189,66.7,315,126,189,66.7
37330, 청송군,085003, 82세,2017,299,110,189,58.2,299,110,189,58.2
37330, 청송군,085004, 83세,2017,238,87,151,57.6,238,87,151,57.6
37330, 청송군,085005, 84세,2017,177,68,109,62.4,177,68,109,62.4
37330, 청송군,090,85~89세,2017,622,199,423,47,622,199,423,47
37330, 청송군,090001, 85세,2017,189,71,118,60.2,189,71,118,60.2
37330, 청송군,090002, 86세,2017,147,49,98,50,147,49,98,50
37330, 청송군,090003, 87세,2017,100,25,75,33.3,100,25,75,33.3
37330, 청송군,090004, 88세,2017,96,27,69,39.1,96,27,69,39.1
37330, 청송군,090005, 89세,2017,90,27,63,42.9,90,27,63,42.9
37330, 청송군,095,90~94세,2017,185,42,143,29.4,185,42,143,29.4
37330, 청송군,095001, 90세,2017,57,16,41,39,57,16,41,39
37330, 청송군,095002, 91세,2017,57,13,44,29.5,57,13,44,29.5
37330, 청송군,095003, 92세,2017,36,8,28,28.6,36,8,28,28.6
37330, 청송군,095004, 93세,2017,22,X,19,15.8,22,X,19,15.8
37330, 청송군,095005, 94세,2017,13,X,11,18.2,13,X,11,18.2
37330, 청송군,100,95~99세,2017,42,7,35,20,42,7,35,20
37330, 청송군,100001, 95세,2017,9,X,6,50,9,X,6,50
37330, 청송군,100002, 96세,2017,14,X,12,16.7,14,X,12,16.7
37330, 청송군,100003, 97세,2017,8,X,6,33.3,8,X,6,33.3
37330, 청송군,100004, 98세,2017,7,X,7,0,7,X,7,0
37330, 청송군,100005, 99세,2017,X,X,X,0,X,X,X,0
37330, 청송군,101,100세이상,2017,5,X,5,0,5,X,5,0
37330, 청송군,102,15세미만,2017,1804,923,881,104.8,1804,923,881,104.8
37330, 청송군,103,15~64세,2017,14181,7599,6582,115.5,13914,7508,6406,117.2
37330, 청송군,104,65세이상,2017,8456,3534,4922,71.8,8437,3526,4911,71.8
37330, 청송군,086,85세이상,2017,854,248,606,40.9,854,248,606,40.9
37330, 청송군,126,평균연령,2017,53.7,51.3,56.1,,53.9,51.4,56.3,
37330, 청송군,127,중위연령,2017,57.6,55.3,60,,57.8,55.4,60.3,
37340, 영양군,000,합계,2017,16579,7980,8599,92.8,16336,7914,8422,94
37340, 영양군,005,0~4세,2017,444,228,216,105.6,444,228,216,105.6
37340, 영양군,005001, 0세,2017,93,49,44,111.4,93,49,44,111.4
37340, 영양군,005002, 1세,2017,72,46,26,176.9,72,46,26,176.9
37340, 영양군,005003, 2세,2017,100,42,58,72.4,100,42,58,72.4
37340, 영양군,005004, 3세,2017,92,45,47,95.7,92,45,47,95.7
37340, 영양군,005005, 4세,2017,87,46,41,112.2,87,46,41,112.2
37340, 영양군,010,5~9세,2017,431,234,197,118.8,431,234,197,118.8
37340, 영양군,010001, 5세,2017,77,44,33,133.3,77,44,33,133.3
37340, 영양군,010002, 6세,2017,78,49,29,169,78,49,29,169
37340, 영양군,010003, 7세,2017,99,47,52,90.4,99,47,52,90.4
37340, 영양군,010004, 8세,2017,74,42,32,131.3,74,42,32,131.3
37340, 영양군,010005, 9세,2017,103,52,51,102,103,52,51,102
37340, 영양군,015,10~14세,2017,462,234,228,102.6,462,234,228,102.6
37340, 영양군,015001, 10세,2017,110,54,56,96.4,110,54,56,96.4
37340, 영양군,015002, 11세,2017,79,43,36,119.4,79,43,36,119.4
37340, 영양군,015003, 12세,2017,89,43,46,93.5,89,43,46,93.5
37340, 영양군,015004, 13세,2017,85,44,41,107.3,85,44,41,107.3
37340, 영양군,015005, 14세,2017,99,50,49,102,99,50,49,102
37340, 영양군,020,15~19세,2017,745,288,457,63,743,288,455,63.3
37340, 영양군,020001, 15세,2017,114,58,56,103.6,114,58,56,103.6
37340, 영양군,020002, 16세,2017,170,55,115,47.8,169,55,114,48.2
37340, 영양군,020003, 17세,2017,262,75,187,40.1,262,75,187,40.1
37340, 영양군,020004, 18세,2017,137,55,82,67.1,136,55,81,67.9
37340, 영양군,020005, 19세,2017,62,45,17,264.7,62,45,17,264.7
37340, 영양군,025,20~24세,2017,491,311,180,172.8,467,306,161,190.1
37340, 영양군,025001, 20세,2017,85,67,18,372.2,84,67,17,394.1
37340, 영양군,025002, 21세,2017,93,62,31,200,92,62,30,206.7
37340, 영양군,025003, 22세,2017,113,71,42,169,108,71,37,191.9
37340, 영양군,025004, 23세,2017,109,63,46,137,100,61,39,156.4
37340, 영양군,025005, 24세,2017,91,48,43,111.6,83,45,38,118.4
37340, 영양군,030,25~29세,2017,525,271,254,106.7,477,258,219,117.8
37340, 영양군,030001, 25세,2017,116,55,61,90.2,105,49,56,87.5
37340, 영양군,030002, 26세,2017,107,57,50,114,96,55,41,134.1
37340, 영양군,030003, 27세,2017,100,45,55,81.8,87,42,45,93.3
37340, 영양군,030004, 28세,2017,103,58,45,128.9,97,57,40,142.5
37340, 영양군,030005, 29세,2017,99,56,43,130.2,92,55,37,148.6
37340, 영양군,035,30~34세,2017,547,272,275,98.9,514,267,247,108.1
37340, 영양군,035001, 30세,2017,111,57,54,105.6,106,57,49,116.3
37340, 영양군,035002, 31세,2017,129,63,66,95.5,120,61,59,103.4
37340, 영양군,035003, 32세,2017,79,35,44,79.5,70,33,37,89.2
37340, 영양군,035004, 33세,2017,99,57,42,135.7,97,57,40,142.5
37340, 영양군,035005, 34세,2017,129,60,69,87,121,59,62,95.2
37340, 영양군,040,35~39세,2017,657,344,313,109.9,634,340,294,115.6
37340, 영양군,040001, 35세,2017,127,62,65,95.4,119,61,58,105.2
37340, 영양군,040002, 36세,2017,127,71,56,126.8,121,70,51,137.3
37340, 영양군,040003, 37세,2017,142,63,79,79.7,140,63,77,81.8
37340, 영양군,040004, 38세,2017,117,64,53,120.8,115,63,52,121.2
37340, 영양군,040005, 39세,2017,144,84,60,140,139,83,56,148.2
37340, 영양군,045,40~44세,2017,799,472,327,144.3,780,468,312,150
37340, 영양군,045001, 40세,2017,138,78,60,130,132,78,54,144.4
37340, 영양군,045002, 41세,2017,139,83,56,148.2,136,81,55,147.3
37340, 영양군,045003, 42세,2017,153,83,70,118.6,148,81,67,120.9
37340, 영양군,045004, 43세,2017,178,111,67,165.7,175,111,64,173.4
37340, 영양군,045005, 44세,2017,191,117,74,158.1,189,117,72,162.5
37340, 영양군,050,45~49세,2017,1136,659,477,138.2,1113,649,464,139.9
37340, 영양군,050001, 45세,2017,200,113,87,129.9,195,111,84,132.1
37340, 영양군,050002, 46세,2017,226,139,87,159.8,223,138,85,162.4
37340, 영양군,050003, 47세,2017,229,123,106,116,225,122,103,118.4
37340, 영양군,050004, 48세,2017,242,149,93,160.2,239,147,92,159.8
37340, 영양군,050005, 49세,2017,239,135,104,129.8,231,131,100,131
37340, 영양군,055,50~54세,2017,1271,667,604,110.4,1245,658,587,112.1
37340, 영양군,055001, 50세,2017,207,117,90,130,200,116,84,138.1
37340, 영양군,055002, 51세,2017,277,149,128,116.4,274,149,125,119.2
37340, 영양군,055003, 52세,2017,252,131,121,108.3,248,128,120,106.7
37340, 영양군,055004, 53세,2017,237,129,108,119.4,230,126,104,121.2
37340, 영양군,055005, 54세,2017,298,141,157,89.8,293,139,154,90.3
37340, 영양군,060,55~59세,2017,1726,876,850,103.1,1701,868,833,104.2
37340, 영양군,060001, 55세,2017,313,161,152,105.9,308,159,149,106.7
37340, 영양군,060002, 56세,2017,405,208,197,105.6,399,206,193,106.7
37340, 영양군,060003, 57세,2017,385,185,200,92.5,380,184,196,93.9
37340, 영양군,060004, 58세,2017,291,157,134,117.2,284,154,130,118.5
37340, 영양군,060005, 59세,2017,332,165,167,98.8,330,165,165,100
37340, 영양군,065,60~64세,2017,1617,805,812,99.1,1605,798,807,98.9
37340, 영양군,065001, 60세,2017,318,139,179,77.7,315,138,177,78
37340, 영양군,065002, 61세,2017,348,172,176,97.7,347,172,175,98.3
37340, 영양군,065003, 62세,2017,353,188,165,113.9,350,186,164,113.4
37340, 영양군,065004, 63세,2017,304,153,151,101.3,300,150,150,100
37340, 영양군,065005, 64세,2017,294,153,141,108.5,293,152,141,107.8
37340, 영양군,070,65~69세,2017,1410,679,731,92.9,1404,678,726,93.4
37340, 영양군,070001, 65세,2017,304,148,156,94.9,302,148,154,96.1
37340, 영양군,070002, 66세,2017,242,113,129,87.6,242,113,129,87.6
37340, 영양군,070003, 67세,2017,248,111,137,81,246,110,136,80.9
37340, 영양군,070004, 68세,2017,323,163,160,101.9,321,163,158,103.2
37340, 영양군,070005, 69세,2017,293,144,149,96.6,293,144,149,96.6
37340, 영양군,075,70~74세,2017,1244,543,701,77.5,1244,543,701,77.5
37340, 영양군,075001, 70세,2017,239,112,127,88.2,239,112,127,88.2
37340, 영양군,075002, 71세,2017,201,91,110,82.7,201,91,110,82.7
37340, 영양군,075003, 72세,2017,227,96,131,73.3,227,96,131,73.3
37340, 영양군,075004, 73세,2017,259,106,153,69.3,259,106,153,69.3
37340, 영양군,075005, 74세,2017,318,138,180,76.7,318,138,180,76.7
37340, 영양군,080,75~79세,2017,1519,621,898,69.2,1518,621,897,69.2
37340, 영양군,080001, 75세,2017,362,156,206,75.7,362,156,206,75.7
37340, 영양군,080002, 76세,2017,320,133,187,71.1,320,133,187,71.1
37340, 영양군,080003, 77세,2017,296,125,171,73.1,295,125,170,73.5
37340, 영양군,080004, 78세,2017,293,120,173,69.4,293,120,173,69.4
37340, 영양군,080005, 79세,2017,248,87,161,54,248,87,161,54
37340, 영양군,085,80~84세,2017,937,307,630,48.7,936,307,629,48.8
37340, 영양군,085001, 80세,2017,232,76,156,48.7,232,76,156,48.7
37340, 영양군,085002, 81세,2017,198,68,130,52.3,198,68,130,52.3
37340, 영양군,085003, 82세,2017,212,72,140,51.4,211,72,139,51.8
37340, 영양군,085004, 83세,2017,159,46,113,40.7,159,46,113,40.7
37340, 영양군,085005, 84세,2017,136,45,91,49.5,136,45,91,49.5
37340, 영양군,090,85~89세,2017,451,128,323,39.6,451,128,323,39.6
37340, 영양군,090001, 85세,2017,123,39,84,46.4,123,39,84,46.4
37340, 영양군,090002, 86세,2017,115,24,91,26.4,115,24,91,26.4
37340, 영양군,090003, 87세,2017,77,25,52,48.1,77,25,52,48.1
37340, 영양군,090004, 88세,2017,67,23,44,52.3,67,23,44,52.3
37340, 영양군,090005, 89세,2017,69,17,52,32.7,69,17,52,32.7
37340, 영양군,095,90~94세,2017,133,33,100,33,133,33,100,33
37340, 영양군,095001, 90세,2017,39,9,30,30,39,9,30,30
37340, 영양군,095002, 91세,2017,37,8,29,27.6,37,8,29,27.6
37340, 영양군,095003, 92세,2017,19,5,14,35.7,19,5,14,35.7
37340, 영양군,095004, 93세,2017,19,7,12,58.3,19,7,12,58.3
37340, 영양군,095005, 94세,2017,19,X,15,26.7,19,X,15,26.7
37340, 영양군,100,95~99세,2017,29,8,21,38.1,29,8,21,38.1
37340, 영양군,100001, 95세,2017,10,X,7,42.9,10,X,7,42.9
37340, 영양군,100002, 96세,2017,9,X,6,50,9,X,6,50
37340, 영양군,100003, 97세,2017,X,X,X,0,X,X,X,0
37340, 영양군,100004, 98세,2017,X,X,X,100,X,X,X,100
37340, 영양군,100005, 99세,2017,5,X,X,25,5,X,X,25
37340, 영양군,101,100세이상,2017,5,X,5,0,5,X,5,0
37340, 영양군,102,15세미만,2017,1337,696,641,108.6,1337,696,641,108.6
37340, 영양군,103,15~64세,2017,9514,4965,4549,109.1,9279,4900,4379,111.9
37340, 영양군,104,65세이상,2017,5728,2319,3409,68,5720,2318,3402,68.1
37340, 영양군,086,85세이상,2017,618,169,449,37.6,618,169,449,37.6
37340, 영양군,126,평균연령,2017,53.1,51,55.1,,53.3,51.1,55.5,
37340, 영양군,127,중위연령,2017,57.2,55.1,59.5,,57.4,55.2,60,
37350, 영덕군,000,합계,2017,36148,17427,18721,93.1,35079,16623,18456,90.1
37350, 영덕군,005,0~4세,2017,954,477,477,100,953,476,477,99.8
37350, 영덕군,005001, 0세,2017,205,96,109,88.1,205,96,109,88.1
37350, 영덕군,005002, 1세,2017,167,85,82,103.7,166,84,82,102.4
37350, 영덕군,005003, 2세,2017,195,100,95,105.3,195,100,95,105.3
37350, 영덕군,005004, 3세,2017,197,97,100,97,197,97,100,97
37350, 영덕군,005005, 4세,2017,190,99,91,108.8,190,99,91,108.8
37350, 영덕군,010,5~9세,2017,915,467,448,104.2,915,467,448,104.2
37350, 영덕군,010001, 5세,2017,198,102,96,106.3,198,102,96,106.3
37350, 영덕군,010002, 6세,2017,169,83,86,96.5,169,83,86,96.5
37350, 영덕군,010003, 7세,2017,204,107,97,110.3,204,107,97,110.3
37350, 영덕군,010004, 8세,2017,181,94,87,108,181,94,87,108
37350, 영덕군,010005, 9세,2017,163,81,82,98.8,163,81,82,98.8
37350, 영덕군,015,10~14세,2017,1071,551,520,106,1068,550,518,106.2
37350, 영덕군,015001, 10세,2017,224,119,105,113.3,224,119,105,113.3
37350, 영덕군,015002, 11세,2017,207,104,103,101,206,104,102,102
37350, 영덕군,015003, 12세,2017,202,103,99,104,200,102,98,104.1
37350, 영덕군,015004, 13세,2017,222,112,110,101.8,222,112,110,101.8
37350, 영덕군,015005, 14세,2017,216,113,103,109.7,216,113,103,109.7
37350, 영덕군,020,15~19세,2017,1086,574,512,112.1,1083,573,510,112.4
37350, 영덕군,020001, 15세,2017,227,120,107,112.1,227,120,107,112.1
37350, 영덕군,020002, 16세,2017,229,112,117,95.7,229,112,117,95.7
37350, 영덕군,020003, 17세,2017,272,138,134,103,271,138,133,103.8
37350, 영덕군,020004, 18세,2017,237,124,113,109.7,237,124,113,109.7
37350, 영덕군,020005, 19세,2017,121,80,41,195.1,119,79,40,197.5
37350, 영덕군,025,20~24세,2017,1196,773,423,182.7,1057,660,397,166.2
37350, 영덕군,025001, 20세,2017,209,155,54,287,207,154,53,290.6
37350, 영덕군,025002, 21세,2017,245,168,77,218.2,226,152,74,205.4
37350, 영덕군,025003, 22세,2017,256,169,87,194.3,219,137,82,167.1
37350, 영덕군,025004, 23세,2017,239,141,98,143.9,199,110,89,123.6
37350, 영덕군,025005, 24세,2017,247,140,107,130.8,206,107,99,108.1
37350, 영덕군,030,25~29세,2017,1339,818,521,157,1079,617,462,133.5
37350, 영덕군,030001, 25세,2017,299,175,124,141.1,234,128,106,120.8
37350, 영덕군,030002, 26세,2017,281,194,87,223,219,138,81,170.4
37350, 영덕군,030003, 27세,2017,274,168,106,158.5,220,125,95,131.6
37350, 영덕군,030004, 28세,2017,258,155,103,150.5,217,127,90,141.1
37350, 영덕군,030005, 29세,2017,227,126,101,124.8,189,99,90,110
37350, 영덕군,035,30~34세,2017,1441,810,631,128.4,1203,631,572,110.3
37350, 영덕군,035001, 30세,2017,258,149,109,136.7,208,110,98,112.2
37350, 영덕군,035002, 31세,2017,263,154,109,141.3,210,112,98,114.3
37350, 영덕군,035003, 32세,2017,285,155,130,119.2,239,123,116,106
37350, 영덕군,035004, 33세,2017,303,161,142,113.4,256,130,126,103.2
37350, 영덕군,035005, 34세,2017,332,191,141,135.5,290,156,134,116.4
37350, 영덕군,040,35~39세,2017,1655,935,720,129.9,1499,806,693,116.3
37350, 영덕군,040001, 35세,2017,351,193,158,122.2,311,166,145,114.5
37350, 영덕군,040002, 36세,2017,314,172,142,121.1,288,149,139,107.2
37350, 영덕군,040003, 37세,2017,350,209,141,148.2,314,177,137,129.2
37350, 영덕군,040004, 38세,2017,328,184,144,127.8,297,157,140,112.1
37350, 영덕군,040005, 39세,2017,312,177,135,131.1,289,157,132,118.9
37350, 영덕군,045,40~44세,2017,1830,1042,788,132.2,1728,959,769,124.7
37350, 영덕군,045001, 40세,2017,340,176,164,107.3,319,160,159,100.6
37350, 영덕군,045002, 41세,2017,359,208,151,137.7,331,187,144,129.9
37350, 영덕군,045003, 42세,2017,310,175,135,129.6,288,155,133,116.5
37350, 영덕군,045004, 43세,2017,404,231,173,133.5,389,220,169,130.2
37350, 영덕군,045005, 44세,2017,417,252,165,152.7,401,237,164,144.5
37350, 영덕군,050,45~49세,2017,2438,1405,1033,136,2361,1346,1015,132.6
37350, 영덕군,050001, 45세,2017,459,278,181,153.6,436,260,176,147.7
37350, 영덕군,050002, 46세,2017,464,255,209,122,453,248,205,121
37350, 영덕군,050003, 47세,2017,485,293,192,152.6,467,276,191,144.5
37350, 영덕군,050004, 48세,2017,481,278,203,136.9,469,268,201,133.3
37350, 영덕군,050005, 49세,2017,549,301,248,121.4,536,294,242,121.5
37350, 영덕군,055,50~54세,2017,2771,1427,1344,106.2,2724,1411,1313,107.5
37350, 영덕군,055001, 50세,2017,473,257,216,119,466,257,209,123
37350, 영덕군,055002, 51세,2017,538,272,266,102.3,527,268,259,103.5
37350, 영덕군,055003, 52세,2017,556,291,265,109.8,542,287,255,112.5
37350, 영덕군,055004, 53세,2017,550,272,278,97.8,543,267,276,96.7
37350, 영덕군,055005, 54세,2017,654,335,319,105,646,332,314,105.7
37350, 영덕군,060,55~59세,2017,3503,1712,1791,95.6,3483,1704,1779,95.8
37350, 영덕군,060001, 55세,2017,629,327,302,108.3,626,326,300,108.7
37350, 영덕군,060002, 56세,2017,734,372,362,102.8,731,371,360,103.1
37350, 영덕군,060003, 57세,2017,761,359,402,89.3,756,355,401,88.5
37350, 영덕군,060004, 58세,2017,678,303,375,80.8,677,302,375,80.5
37350, 영덕군,060005, 59세,2017,701,351,350,100.3,693,350,343,102
37350, 영덕군,065,60~64세,2017,3456,1630,1826,89.3,3443,1622,1821,89.1
37350, 영덕군,065001, 60세,2017,705,322,383,84.1,701,320,381,84
37350, 영덕군,065002, 61세,2017,713,355,358,99.2,709,353,356,99.2
37350, 영덕군,065003, 62세,2017,701,333,368,90.5,699,331,368,89.9
37350, 영덕군,065004, 63세,2017,672,304,368,82.6,671,303,368,82.3
37350, 영덕군,065005, 64세,2017,665,316,349,90.5,663,315,348,90.5
37350, 영덕군,070,65~69세,2017,3147,1450,1697,85.4,3141,1446,1695,85.3
37350, 영덕군,070001, 65세,2017,665,305,360,84.7,665,305,360,84.7
37350, 영덕군,070002, 66세,2017,588,288,300,96,587,288,299,96.3
37350, 영덕군,070003, 67세,2017,554,247,307,80.5,551,244,307,79.5
37350, 영덕군,070004, 68세,2017,682,330,352,93.8,681,330,351,94
37350, 영덕군,070005, 69세,2017,658,280,378,74.1,657,279,378,73.8
37350, 영덕군,075,70~74세,2017,2802,1152,1650,69.8,2800,1151,1649,69.8
37350, 영덕군,075001, 70세,2017,603,281,322,87.3,603,281,322,87.3
37350, 영덕군,075002, 71세,2017,385,171,214,79.9,385,171,214,79.9
37350, 영덕군,075003, 72세,2017,462,172,290,59.3,462,172,290,59.3
37350, 영덕군,075004, 73세,2017,571,197,374,52.7,570,196,374,52.4
37350, 영덕군,075005, 74세,2017,781,331,450,73.6,780,331,449,73.7
37350, 영덕군,080,75~79세,2017,3256,1208,2048,59,3254,1208,2046,59
37350, 영덕군,080001, 75세,2017,780,311,469,66.3,780,311,469,66.3
37350, 영덕군,080002, 76세,2017,646,232,414,56,646,232,414,56
37350, 영덕군,080003, 77세,2017,608,228,380,60,607,228,379,60.2
37350, 영덕군,080004, 78세,2017,657,233,424,55,656,233,423,55.1
37350, 영덕군,080005, 79세,2017,565,204,361,56.5,565,204,361,56.5
37350, 영덕군,085,80~84세,2017,2024,673,1351,49.8,2024,673,1351,49.8
37350, 영덕군,085001, 80세,2017,489,172,317,54.3,489,172,317,54.3
37350, 영덕군,085002, 81세,2017,484,179,305,58.7,484,179,305,58.7
37350, 영덕군,085003, 82세,2017,406,127,279,45.5,406,127,279,45.5
37350, 영덕군,085004, 83세,2017,356,110,246,44.7,356,110,246,44.7
37350, 영덕군,085005, 84세,2017,289,85,204,41.7,289,85,204,41.7
37350, 영덕군,090,85~89세,2017,916,253,663,38.2,916,253,663,38.2
37350, 영덕군,090001, 85세,2017,255,89,166,53.6,255,89,166,53.6
37350, 영덕군,090002, 86세,2017,204,53,151,35.1,204,53,151,35.1
37350, 영덕군,090003, 87세,2017,169,44,125,35.2,169,44,125,35.2
37350, 영덕군,090004, 88세,2017,168,46,122,37.7,168,46,122,37.7
37350, 영덕군,090005, 89세,2017,120,21,99,21.2,120,21,99,21.2
37350, 영덕군,095,90~94세,2017,299,58,241,24.1,299,58,241,24.1
37350, 영덕군,095001, 90세,2017,95,18,77,23.4,95,18,77,23.4
37350, 영덕군,095002, 91세,2017,49,9,40,22.5,49,9,40,22.5
37350, 영덕군,095003, 92세,2017,81,17,64,26.6,81,17,64,26.6
37350, 영덕군,095004, 93세,2017,38,7,31,22.6,38,7,31,22.6
37350, 영덕군,095005, 94세,2017,36,7,29,24.1,36,7,29,24.1
37350, 영덕군,100,95~99세,2017,45,12,33,36.4,45,12,33,36.4
37350, 영덕군,100001, 95세,2017,19,8,11,72.7,19,8,11,72.7
37350, 영덕군,100002, 96세,2017,12,X,11,9.1,12,X,11,9.1
37350, 영덕군,100003, 97세,2017,7,X,6,16.7,7,X,6,16.7
37350, 영덕군,100004, 98세,2017,X,X,X,100,X,X,X,100
37350, 영덕군,100005, 99세,2017,5,X,X,25,5,X,X,25
37350, 영덕군,101,100세이상,2017,X,X,X,0,X,X,X,0
37350, 영덕군,102,15세미만,2017,2940,1495,1445,103.5,2936,1493,1443,103.5
37350, 영덕군,103,15~64세,2017,20715,11126,9589,116,19660,10329,9331,110.7
37350, 영덕군,104,65세이상,2017,12493,4806,7687,62.5,12483,4801,7682,62.5
37350, 영덕군,086,85세이상,2017,1264,323,941,34.3,1264,323,941,34.3
37350, 영덕군,126,평균연령,2017,53.1,49.8,56.1,,53.6,50.6,56.4,
37350, 영덕군,127,중위연령,2017,57,53.2,60.4,,57.7,54.4,60.7,
37360, 청도군,000,합계,2017,41278,19885,21393,93,40090,19296,20794,92.8
37360, 청도군,005,0~4세,2017,775,391,384,101.8,775,391,384,101.8
37360, 청도군,005001, 0세,2017,142,70,72,97.2,142,70,72,97.2
37360, 청도군,005002, 1세,2017,163,85,78,109,163,85,78,109
37360, 청도군,005003, 2세,2017,160,79,81,97.5,160,79,81,97.5
37360, 청도군,005004, 3세,2017,150,79,71,111.3,150,79,71,111.3
37360, 청도군,005005, 4세,2017,160,78,82,95.1,160,78,82,95.1
37360, 청도군,010,5~9세,2017,911,468,443,105.6,909,467,442,105.7
37360, 청도군,010001, 5세,2017,176,97,79,122.8,176,97,79,122.8
37360, 청도군,010002, 6세,2017,196,91,105,86.7,195,91,104,87.5
37360, 청도군,010003, 7세,2017,163,88,75,117.3,163,88,75,117.3
37360, 청도군,010004, 8세,2017,182,90,92,97.8,182,90,92,97.8
37360, 청도군,010005, 9세,2017,194,102,92,110.9,193,101,92,109.8
37360, 청도군,015,10~14세,2017,997,512,485,105.6,996,512,484,105.8
37360, 청도군,015001, 10세,2017,204,97,107,90.7,204,97,107,90.7
37360, 청도군,015002, 11세,2017,188,95,93,102.2,188,95,93,102.2
37360, 청도군,015003, 12세,2017,178,83,95,87.4,177,83,94,88.3
37360, 청도군,015004, 13세,2017,211,123,88,139.8,211,123,88,139.8
37360, 청도군,015005, 14세,2017,216,114,102,111.8,216,114,102,111.8
37360, 청도군,020,15~19세,2017,1910,973,937,103.8,1908,972,936,103.8
37360, 청도군,020001, 15세,2017,284,147,137,107.3,283,146,137,106.6
37360, 청도군,020002, 16세,2017,442,224,218,102.8,442,224,218,102.8
37360, 청도군,020003, 17세,2017,618,273,345,79.1,618,273,345,79.1
37360, 청도군,020004, 18세,2017,339,197,142,138.7,338,197,141,139.7
37360, 청도군,020005, 19세,2017,227,132,95,138.9,227,132,95,138.9
37360, 청도군,025,20~24세,2017,1567,904,663,136.3,1368,826,542,152.4
37360, 청도군,025001, 20세,2017,259,148,111,133.3,252,147,105,140
37360, 청도군,025002, 21세,2017,309,189,120,157.5,287,184,103,178.6
37360, 청도군,025003, 22세,2017,318,185,133,139.1,276,167,109,153.2
37360, 청도군,025004, 23세,2017,350,193,157,122.9,292,170,122,139.3
37360, 청도군,025005, 24세,2017,331,189,142,133.1,261,158,103,153.4
37360, 청도군,030,25~29세,2017,1677,920,757,121.5,1290,732,558,131.2
37360, 청도군,030001, 25세,2017,349,183,166,110.2,269,152,117,129.9
37360, 청도군,030002, 26세,2017,331,181,150,120.7,247,139,108,128.7
37360, 청도군,030003, 27세,2017,359,189,170,111.2,279,151,128,118
37360, 청도군,030004, 28세,2017,342,196,146,134.2,268,154,114,135.1
37360, 청도군,030005, 29세,2017,296,171,125,136.8,227,136,91,149.5
37360, 청도군,035,30~34세,2017,1483,833,650,128.2,1264,697,567,122.9
37360, 청도군,035001, 30세,2017,316,193,123,156.9,258,156,102,152.9
37360, 청도군,035002, 31세,2017,301,163,138,118.1,247,128,119,107.6
37360, 청도군,035003, 32세,2017,258,143,115,124.3,225,121,104,116.3
37360, 청도군,035004, 33세,2017,302,158,144,109.7,261,133,128,103.9
37360, 청도군,035005, 34세,2017,306,176,130,135.4,273,159,114,139.5
37360, 청도군,040,35~39세,2017,1800,922,878,105,1684,863,821,105.1
37360, 청도군,040001, 35세,2017,387,189,198,95.5,362,178,184,96.7
37360, 청도군,040002, 36세,2017,372,180,192,93.8,349,169,180,93.9
37360, 청도군,040003, 37세,2017,383,201,182,110.4,351,183,168,108.9
37360, 청도군,040004, 38세,2017,340,178,162,109.9,321,167,154,108.4
37360, 청도군,040005, 39세,2017,318,174,144,120.8,301,166,135,123
37360, 청도군,045,40~44세,2017,1880,1068,812,131.5,1813,1035,778,133
37360, 청도군,045001, 40세,2017,316,177,139,127.3,298,169,129,131
37360, 청도군,045002, 41세,2017,370,214,156,137.2,356,209,147,142.2
37360, 청도군,045003, 42세,2017,363,201,162,124.1,346,193,153,126.1
37360, 청도군,045004, 43세,2017,394,240,154,155.8,380,230,150,153.3
37360, 청도군,045005, 44세,2017,437,236,201,117.4,433,234,199,117.6
37360, 청도군,050,45~49세,2017,2562,1383,1179,117.3,2504,1351,1153,117.2
37360, 청도군,050001, 45세,2017,474,250,224,111.6,460,241,219,110
37360, 청도군,050002, 46세,2017,465,260,205,126.8,457,257,200,128.5
37360, 청도군,050003, 47세,2017,511,272,239,113.8,498,264,234,112.8
37360, 청도군,050004, 48세,2017,542,289,253,114.2,529,280,249,112.4
37360, 청도군,050005, 49세,2017,570,312,258,120.9,560,309,251,123.1
37360, 청도군,055,50~54세,2017,3069,1577,1492,105.7,3022,1555,1467,106
37360, 청도군,055001, 50세,2017,536,260,276,94.2,530,256,274,93.4
37360, 청도군,055002, 51세,2017,572,307,265,115.8,562,303,259,117
37360, 청도군,055003, 52세,2017,638,341,297,114.8,627,335,292,114.7
37360, 청도군,055004, 53세,2017,690,357,333,107.2,679,354,325,108.9
37360, 청도군,055005, 54세,2017,633,312,321,97.2,624,307,317,96.8
37360, 청도군,060,55~59세,2017,4417,2198,2219,99.1,4371,2178,2193,99.3
37360, 청도군,060001, 55세,2017,813,437,376,116.2,801,430,371,115.9
37360, 청도군,060002, 56세,2017,846,430,416,103.4,839,428,411,104.1
37360, 청도군,060003, 57세,2017,995,457,538,84.9,983,454,529,85.8
37360, 청도군,060004, 58세,2017,959,487,472,103.2,950,481,469,102.6
37360, 청도군,060005, 59세,2017,804,387,417,92.8,798,385,413,93.2
37360, 청도군,065,60~64세,2017,4187,2053,2134,96.2,4163,2045,2118,96.6
37360, 청도군,065001, 60세,2017,838,444,394,112.7,831,441,390,113.1
37360, 청도군,065002, 61세,2017,844,406,438,92.7,837,405,432,93.8
37360, 청도군,065003, 62세,2017,897,412,485,84.9,890,408,482,84.6
37360, 청도군,065004, 63세,2017,810,392,418,93.8,809,392,417,94
37360, 청도군,065005, 64세,2017,798,399,399,100,796,399,397,100.5
37360, 청도군,070,65~69세,2017,4007,1947,2060,94.5,3994,1941,2053,94.5
37360, 청도군,070001, 65세,2017,911,445,466,95.5,908,444,464,95.7
37360, 청도군,070002, 66세,2017,766,339,427,79.4,764,338,426,79.3
37360, 청도군,070003, 67세,2017,783,365,418,87.3,781,363,418,86.8
37360, 청도군,070004, 68세,2017,832,417,415,100.5,828,415,413,100.5
37360, 청도군,070005, 69세,2017,715,381,334,114.1,713,381,332,114.8
37360, 청도군,075,70~74세,2017,2845,1298,1547,83.9,2841,1295,1546,83.8
37360, 청도군,075001, 70세,2017,695,343,352,97.4,693,342,351,97.4
37360, 청도군,075002, 71세,2017,440,206,234,88,439,205,234,87.6
37360, 청도군,075003, 72세,2017,441,210,231,90.9,441,210,231,90.9
37360, 청도군,075004, 73세,2017,574,237,337,70.3,574,237,337,70.3
37360, 청도군,075005, 74세,2017,695,302,393,76.8,694,301,393,76.6
37360, 청도군,080,75~79세,2017,3243,1252,1991,62.9,3240,1250,1990,62.8
37360, 청도군,080001, 75세,2017,748,306,442,69.2,748,306,442,69.2
37360, 청도군,080002, 76세,2017,647,263,384,68.5,645,261,384,68
37360, 청도군,080003, 77세,2017,620,237,383,61.9,620,237,383,61.9
37360, 청도군,080004, 78세,2017,601,225,376,59.8,600,225,375,60
37360, 청도군,080005, 79세,2017,627,221,406,54.4,627,221,406,54.4
37360, 청도군,085,80~84세,2017,2452,810,1642,49.3,2452,810,1642,49.3
37360, 청도군,085001, 80세,2017,579,206,373,55.2,579,206,373,55.2
37360, 청도군,085002, 81세,2017,552,181,371,48.8,552,181,371,48.8
37360, 청도군,085003, 82세,2017,485,153,332,46.1,485,153,332,46.1
37360, 청도군,085004, 83세,2017,424,145,279,52,424,145,279,52
37360, 청도군,085005, 84세,2017,412,125,287,43.6,412,125,287,43.6
37360, 청도군,090,85~89세,2017,1075,279,796,35.1,1075,279,796,35.1
37360, 청도군,090001, 85세,2017,338,85,253,33.6,338,85,253,33.6
37360, 청도군,090002, 86세,2017,237,63,174,36.2,237,63,174,36.2
37360, 청도군,090003, 87세,2017,206,56,150,37.3,206,56,150,37.3
37360, 청도군,090004, 88세,2017,168,36,132,27.3,168,36,132,27.3
37360, 청도군,090005, 89세,2017,126,39,87,44.8,126,39,87,44.8
37360, 청도군,095,90~94세,2017,353,83,270,30.7,353,83,270,30.7
37360, 청도군,095001, 90세,2017,114,29,85,34.1,114,29,85,34.1
37360, 청도군,095002, 91세,2017,81,20,61,32.8,81,20,61,32.8
37360, 청도군,095003, 92세,2017,64,14,50,28,64,14,50,28
37360, 청도군,095004, 93세,2017,48,12,36,33.3,48,12,36,33.3
37360, 청도군,095005, 94세,2017,46,8,38,21.1,46,8,38,21.1
37360, 청도군,100,95~99세,2017,61,14,47,29.8,61,14,47,29.8
37360, 청도군,100001, 95세,2017,22,X,18,22.2,22,X,18,22.2
37360, 청도군,100002, 96세,2017,15,X,13,15.4,15,X,13,15.4
37360, 청도군,100003, 97세,2017,11,X,7,57.1,11,X,7,57.1
37360, 청도군,100004, 98세,2017,7,X,X,75,7,X,X,75
37360, 청도군,100005, 99세,2017,6,X,5,20,6,X,5,20
37360, 청도군,101,100세이상,2017,7,X,7,0,7,X,7,0
37360, 청도군,102,15세미만,2017,2683,1371,1312,104.5,2680,1370,1310,104.6
37360, 청도군,103,15~64세,2017,24552,12831,11721,109.5,23387,12254,11133,110.1
37360, 청도군,104,65세이상,2017,14043,5683,8360,68,14023,5672,8351,67.9
37360, 청도군,086,85세이상,2017,1496,376,1120,33.6,1496,376,1120,33.6
37360, 청도군,126,평균연령,2017,53.1,50.6,55.5,,53.7,51.1,56.1,
37360, 청도군,127,중위연령,2017,57.4,55,59.5,,57.9,55.6,60.2,
37370, 고령군,000,합계,2017,33094,17236,15858,108.7,30941,15536,15405,100.9
37370, 고령군,005,0~4세,2017,1002,508,494,102.8,996,503,493,102
37370, 고령군,005001, 0세,2017,157,74,83,89.2,156,73,83,88
37370, 고령군,005002, 1세,2017,203,110,93,118.3,202,109,93,117.2
37370, 고령군,005003, 2세,2017,219,115,104,110.6,216,113,103,109.7
37370, 고령군,005004, 3세,2017,217,114,103,110.7,217,114,103,110.7
37370, 고령군,005005, 4세,2017,206,95,111,85.6,205,94,111,84.7
37370, 고령군,010,5~9세,2017,974,504,470,107.2,970,504,466,108.2
37370, 고령군,010001, 5세,2017,208,107,101,105.9,208,107,101,105.9
37370, 고령군,010002, 6세,2017,163,73,90,81.1,161,73,88,83
37370, 고령군,010003, 7세,2017,200,110,90,122.2,200,110,90,122.2
37370, 고령군,010004, 8세,2017,197,101,96,105.2,195,101,94,107.4
37370, 고령군,010005, 9세,2017,206,113,93,121.5,206,113,93,121.5
37370, 고령군,015,10~14세,2017,1017,546,471,115.9,1013,545,468,116.5
37370, 고령군,015001, 10세,2017,220,124,96,129.2,219,123,96,128.1
37370, 고령군,015002, 11세,2017,197,97,100,97,195,97,98,99
37370, 고령군,015003, 12세,2017,196,113,83,136.1,195,113,82,137.8
37370, 고령군,015004, 13세,2017,188,103,85,121.2,188,103,85,121.2
37370, 고령군,015005, 14세,2017,216,109,107,101.9,216,109,107,101.9
37370, 고령군,020,15~19세,2017,1202,667,535,124.7,1195,665,530,125.5
37370, 고령군,020001, 15세,2017,201,103,98,105.1,201,103,98,105.1
37370, 고령군,020002, 16세,2017,267,138,129,107,265,137,128,107
37370, 고령군,020003, 17세,2017,250,147,103,142.7,250,147,103,142.7
37370, 고령군,020004, 18세,2017,267,154,113,136.3,267,154,113,136.3
37370, 고령군,020005, 19세,2017,217,125,92,135.9,212,124,88,140.9
37370, 고령군,025,20~24세,2017,1466,906,560,161.8,1252,731,521,140.3
37370, 고령군,025001, 20세,2017,238,136,102,133.3,229,133,96,138.5
37370, 고령군,025002, 21세,2017,301,190,111,171.2,263,157,106,148.1
37370, 고령군,025003, 22세,2017,295,181,114,158.8,254,150,104,144.2
37370, 고령군,025004, 23세,2017,275,169,106,159.4,223,124,99,125.3
37370, 고령군,025005, 24세,2017,357,230,127,181.1,283,167,116,144
37370, 고령군,030,25~29세,2017,1688,1098,590,186.1,1169,659,510,129.2
37370, 고령군,030001, 25세,2017,320,203,117,173.5,230,125,105,119
37370, 고령군,030002, 26세,2017,334,221,113,195.6,234,135,99,136.4
37370, 고령군,030003, 27세,2017,334,208,126,165.1,233,127,106,119.8
37370, 고령군,030004, 28세,2017,361,240,121,198.3,250,145,105,138.1
37370, 고령군,030005, 29세,2017,339,226,113,200,222,127,95,133.7
37370, 고령군,035,30~34세,2017,1710,1089,621,175.4,1188,657,531,123.7
37370, 고령군,035001, 30세,2017,336,214,122,175.4,220,121,99,122.2
37370, 고령군,035002, 31세,2017,345,218,127,171.7,248,137,111,123.4
37370, 고령군,035003, 32세,2017,335,219,116,188.8,222,122,100,122
37370, 고령군,035004, 33세,2017,337,219,118,185.6,237,135,102,132.4
37370, 고령군,035005, 34세,2017,357,219,138,158.7,261,142,119,119.3
37370, 고령군,040,35~39세,2017,1916,1104,812,136,1566,810,756,107.1
37370, 고령군,040001, 35세,2017,419,239,180,132.8,319,158,161,98.1
37370, 고령군,040002, 36세,2017,405,237,168,141.1,330,172,158,108.9
37370, 고령군,040003, 37세,2017,368,213,155,137.4,309,164,145,113.1
37370, 고령군,040004, 38세,2017,371,201,170,118.2,311,147,164,89.6
37370, 고령군,040005, 39세,2017,353,214,139,154,297,169,128,132
37370, 고령군,045,40~44세,2017,2043,1164,879,132.4,1860,1018,842,120.9
37370, 고령군,045001, 40세,2017,359,217,142,152.8,308,174,134,129.9
37370, 고령군,045002, 41세,2017,375,221,154,143.5,329,182,147,123.8
37370, 고령군,045003, 42세,2017,396,217,179,121.2,367,196,171,114.6
37370, 고령군,045004, 43세,2017,452,245,207,118.4,424,224,200,112
37370, 고령군,045005, 44세,2017,461,264,197,134,432,242,190,127.4
37370, 고령군,050,45~49세,2017,2506,1429,1077,132.7,2372,1336,1036,129
37370, 고령군,050001, 45세,2017,447,256,191,134,418,236,182,129.7
37370, 고령군,050002, 46세,2017,547,319,228,139.9,521,300,221,135.7
37370, 고령군,050003, 47세,2017,479,269,210,128.1,446,247,199,124.1
37370, 고령군,050004, 48세,2017,527,306,221,138.5,504,289,215,134.4
37370, 고령군,050005, 49세,2017,506,279,227,122.9,483,264,219,120.5
37370, 고령군,055,50~54세,2017,2679,1447,1232,117.5,2590,1393,1197,116.4
37370, 고령군,055001, 50세,2017,484,264,220,120,468,255,213,119.7
37370, 고령군,055002, 51세,2017,521,293,228,128.5,504,283,221,128.1
37370, 고령군,055003, 52세,2017,546,288,258,111.6,529,279,250,111.6
37370, 고령군,055004, 53세,2017,554,300,254,118.1,534,286,248,115.3
37370, 고령군,055005, 54세,2017,574,302,272,111,555,290,265,109.4
37370, 고령군,060,55~59세,2017,3251,1725,1526,113,3194,1695,1499,113.1
37370, 고령군,060001, 55세,2017,661,355,306,116,643,346,297,116.5
37370, 고령군,060002, 56세,2017,674,369,305,121,664,363,301,120.6
37370, 고령군,060003, 57세,2017,692,342,350,97.7,677,335,342,98
37370, 고령군,060004, 58세,2017,664,352,312,112.8,656,348,308,113
37370, 고령군,060005, 59세,2017,560,307,253,121.3,554,303,251,120.7
37370, 고령군,065,60~64세,2017,2753,1429,1324,107.9,2722,1415,1307,108.3
37370, 고령군,065001, 60세,2017,588,319,269,118.6,579,316,263,120.2
37370, 고령군,065002, 61세,2017,579,295,284,103.9,576,293,283,103.5
37370, 고령군,065003, 62세,2017,574,291,283,102.8,567,288,279,103.2
37370, 고령군,065004, 63세,2017,536,287,249,115.3,532,285,247,115.4
37370, 고령군,065005, 64세,2017,476,237,239,99.2,468,233,235,99.1
37370, 고령군,070,65~69세,2017,2471,1195,1276,93.7,2450,1184,1266,93.5
37370, 고령군,070001, 65세,2017,574,287,287,100,568,285,283,100.7
37370, 고령군,070002, 66세,2017,477,222,255,87.1,473,220,253,87
37370, 고령군,070003, 67세,2017,475,229,246,93.1,471,227,244,93
37370, 고령군,070004, 68세,2017,496,243,253,96,492,241,251,96
37370, 고령군,070005, 69세,2017,449,214,235,91.1,446,211,235,89.8
37370, 고령군,075,70~74세,2017,1877,853,1024,83.3,1871,851,1020,83.4
37370, 고령군,075001, 70세,2017,460,227,233,97.4,458,226,232,97.4
37370, 고령군,075002, 71세,2017,323,149,174,85.6,322,148,174,85.1
37370, 고령군,075003, 72세,2017,298,130,168,77.4,297,130,167,77.8
37370, 고령군,075004, 73세,2017,389,179,210,85.2,388,179,209,85.6
37370, 고령군,075005, 74세,2017,407,168,239,70.3,406,168,238,70.6
37370, 고령군,080,75~79세,2017,2111,776,1335,58.1,2108,775,1333,58.1
37370, 고령군,080001, 75세,2017,471,181,290,62.4,471,181,290,62.4
37370, 고령군,080002, 76세,2017,411,154,257,59.9,411,154,257,59.9
37370, 고령군,080003, 77세,2017,415,163,252,64.7,413,162,251,64.5
37370, 고령군,080004, 78세,2017,450,162,288,56.3,450,162,288,56.3
37370, 고령군,080005, 79세,2017,364,116,248,46.8,363,116,247,47
37370, 고령군,085,80~84세,2017,1519,545,974,56,1517,544,973,55.9
37370, 고령군,085001, 80세,2017,359,143,216,66.2,358,142,216,65.7
37370, 고령군,085002, 81세,2017,332,138,194,71.1,332,138,194,71.1
37370, 고령군,085003, 82세,2017,317,116,201,57.7,317,116,201,57.7
37370, 고령군,085004, 83세,2017,287,83,204,40.7,286,83,203,40.9
37370, 고령군,085005, 84세,2017,224,65,159,40.9,224,65,159,40.9
37370, 고령군,090,85~89세,2017,664,189,475,39.8,663,189,474,39.9
37370, 고령군,090001, 85세,2017,194,62,132,47,194,62,132,47
37370, 고령군,090002, 86세,2017,168,50,118,42.4,167,50,117,42.7
37370, 고령군,090003, 87세,2017,115,22,93,23.7,115,22,93,23.7
37370, 고령군,090004, 88세,2017,98,33,65,50.8,98,33,65,50.8
37370, 고령군,090005, 89세,2017,89,22,67,32.8,89,22,67,32.8
37370, 고령군,095,90~94세,2017,198,49,149,32.9,198,49,149,32.9
37370, 고령군,095001, 90세,2017,73,20,53,37.7,73,20,53,37.7
37370, 고령군,095002, 91세,2017,41,6,35,17.1,41,6,35,17.1
37370, 고령군,095003, 92세,2017,45,12,33,36.4,45,12,33,36.4
37370, 고령군,095004, 93세,2017,22,6,16,37.5,22,6,16,37.5
37370, 고령군,095005, 94세,2017,17,5,12,41.7,17,5,12,41.7
37370, 고령군,100,95~99세,2017,46,13,33,39.4,46,13,33,39.4
37370, 고령군,100001, 95세,2017,21,X,18,16.7,21,X,18,16.7
37370, 고령군,100002, 96세,2017,11,X,7,57.1,11,X,7,57.1
37370, 고령군,100003, 97세,2017,10,X,6,66.7,10,X,6,66.7
37370, 고령군,100004, 98세,2017,X,X,X,0,X,X,X,0
37370, 고령군,100005, 99세,2017,X,X,X,200,X,X,X,200
37370, 고령군,101,100세이상,2017,X,X,X,0,X,X,X,0
37370, 고령군,102,15세미만,2017,2993,1558,1435,108.6,2979,1552,1427,108.8
37370, 고령군,103,15~64세,2017,21214,12058,9156,131.7,19108,10379,8729,118.9
37370, 고령군,104,65세이상,2017,8887,3620,5267,68.7,8854,3605,5249,68.7
37370, 고령군,086,85세이상,2017,909,251,658,38.1,908,251,657,38.2
37370, 고령군,126,평균연령,2017,49.2,46.5,52.1,,50.2,47.9,52.5,
37370, 고령군,127,중위연령,2017,52,48.6,55.6,,53.7,51.3,56.2,
37380, 성주군,000,합계,2017,41225,21271,19954,106.6,39264,19824,19440,102
37380, 성주군,005,0~4세,2017,1187,608,579,105,1184,607,577,105.2
37380, 성주군,005001, 0세,2017,261,133,128,103.9,261,133,128,103.9
37380, 성주군,005002, 1세,2017,259,133,126,105.6,258,133,125,106.4
37380, 성주군,005003, 2세,2017,242,129,113,114.2,241,128,113,113.3
37380, 성주군,005004, 3세,2017,210,110,100,110,209,110,99,111.1
37380, 성주군,005005, 4세,2017,215,103,112,92,215,103,112,92
37380, 성주군,010,5~9세,2017,994,505,489,103.3,994,505,489,103.3
37380, 성주군,010001, 5세,2017,222,105,117,89.7,222,105,117,89.7
37380, 성주군,010002, 6세,2017,215,107,108,99.1,215,107,108,99.1
37380, 성주군,010003, 7세,2017,166,79,87,90.8,166,79,87,90.8
37380, 성주군,010004, 8세,2017,181,93,88,105.7,181,93,88,105.7
37380, 성주군,010005, 9세,2017,210,121,89,136,210,121,89,136
37380, 성주군,015,10~14세,2017,978,555,423,131.2,975,554,421,131.6
37380, 성주군,015001, 10세,2017,186,97,89,109,186,97,89,109
37380, 성주군,015002, 11세,2017,204,120,84,142.9,204,120,84,142.9
37380, 성주군,015003, 12세,2017,182,96,86,111.6,182,96,86,111.6
37380, 성주군,015004, 13세,2017,189,120,69,173.9,187,119,68,175
37380, 성주군,015005, 14세,2017,217,122,95,128.4,216,122,94,129.8
37380, 성주군,020,15~19세,2017,1288,673,615,109.4,1281,669,612,109.3
37380, 성주군,020001, 15세,2017,216,109,107,101.9,216,109,107,101.9
37380, 성주군,020002, 16세,2017,278,138,140,98.6,278,138,140,98.6
37380, 성주군,020003, 17세,2017,296,141,155,91,295,141,154,91.6
37380, 성주군,020004, 18세,2017,286,145,141,102.8,284,144,140,102.9
37380, 성주군,020005, 19세,2017,212,140,72,194.4,208,137,71,193
37380, 성주군,025,20~24세,2017,1804,1168,636,183.6,1583,1001,582,172
37380, 성주군,025001, 20세,2017,297,193,104,185.6,289,193,96,201
37380, 성주군,025002, 21세,2017,341,241,100,241,315,224,91,246.2
37380, 성주군,025003, 22세,2017,349,229,120,190.8,305,194,111,174.8
37380, 성주군,025004, 23세,2017,413,254,159,159.7,362,214,148,144.6
37380, 성주군,025005, 24세,2017,404,251,153,164.1,312,176,136,129.4
37380, 성주군,030,25~29세,2017,2261,1384,877,157.8,1697,945,752,125.7
37380, 성주군,030001, 25세,2017,475,289,186,155.4,365,200,165,121.2
37380, 성주군,030002, 26세,2017,418,243,175,138.9,319,168,151,111.3
37380, 성주군,030003, 27세,2017,465,290,175,165.7,349,202,147,137.4
37380, 성주군,030004, 28세,2017,428,266,162,164.2,306,172,134,128.4
37380, 성주군,030005, 29세,2017,475,296,179,165.4,358,203,155,131
37380, 성주군,035,30~34세,2017,1949,1163,786,148,1536,829,707,117.3
37380, 성주군,035001, 30세,2017,385,244,141,173,291,166,125,132.8
37380, 성주군,035002, 31세,2017,391,241,150,160.7,293,163,130,125.4
37380, 성주군,035003, 32세,2017,392,231,161,143.5,303,157,146,107.5
37380, 성주군,035004, 33세,2017,397,232,165,140.6,325,174,151,115.2
37380, 성주군,035005, 34세,2017,384,215,169,127.2,324,169,155,109
37380, 성주군,040,35~39세,2017,2017,1187,830,143,1749,968,781,123.9
37380, 성주군,040001, 35세,2017,446,248,198,125.3,383,195,188,103.7
37380, 성주군,040002, 36세,2017,353,211,142,148.6,295,161,134,120.1
37380, 성주군,040003, 37세,2017,443,268,175,153.1,384,223,161,138.5
37380, 성주군,040004, 38세,2017,405,241,164,147,359,204,155,131.6
37380, 성주군,040005, 39세,2017,370,219,151,145,328,185,143,129.4
37380, 성주군,045,40~44세,2017,2164,1293,871,148.5,1994,1175,819,143.5
37380, 성주군,045001, 40세,2017,388,241,147,163.9,349,217,132,164.4
37380, 성주군,045002, 41세,2017,401,256,145,176.6,369,230,139,165.5
37380, 성주군,045003, 42세,2017,420,236,184,128.3,385,210,175,120
37380, 성주군,045004, 43세,2017,475,270,205,131.7,449,252,197,127.9
37380, 성주군,045005, 44세,2017,480,290,190,152.6,442,266,176,151.1
37380, 성주군,050,45~49세,2017,2823,1593,1230,129.5,2714,1529,1185,129
37380, 성주군,050001, 45세,2017,502,290,212,136.8,478,273,205,133.2
37380, 성주군,050002, 46세,2017,501,282,219,128.8,473,265,208,127.4
37380, 성주군,050003, 47세,2017,541,305,236,129.2,517,293,224,130.8
37380, 성주군,050004, 48세,2017,603,346,257,134.6,584,336,248,135.5
37380, 성주군,050005, 49세,2017,676,370,306,120.9,662,362,300,120.7
37380, 성주군,055,50~54세,2017,3513,1858,1655,112.3,3414,1806,1608,112.3
37380, 성주군,055001, 50세,2017,657,331,326,101.5,632,316,316,100
37380, 성주군,055002, 51세,2017,650,354,296,119.6,634,346,288,120.1
37380, 성주군,055003, 52세,2017,755,410,345,118.8,727,396,331,119.6
37380, 성주군,055004, 53세,2017,714,366,348,105.2,702,362,340,106.5
37380, 성주군,055005, 54세,2017,737,397,340,116.8,719,386,333,115.9
37380, 성주군,060,55~59세,2017,4583,2360,2223,106.2,4523,2331,2192,106.3
37380, 성주군,060001, 55세,2017,878,460,418,110,862,451,411,109.7
37380, 성주군,060002, 56세,2017,997,531,466,113.9,983,525,458,114.6
37380, 성주군,060003, 57세,2017,975,461,514,89.7,962,456,506,90.1
37380, 성주군,060004, 58세,2017,960,478,482,99.2,954,475,479,99.2
37380, 성주군,060005, 59세,2017,773,430,343,125.4,762,424,338,125.4
37380, 성주군,065,60~64세,2017,3809,1977,1832,107.9,3783,1965,1818,108.1
37380, 성주군,065001, 60세,2017,784,425,359,118.4,779,422,357,118.2
37380, 성주군,065002, 61세,2017,782,426,356,119.7,774,421,353,119.3
37380, 성주군,065003, 62세,2017,833,391,442,88.5,828,390,438,89
37380, 성주군,065004, 63세,2017,690,353,337,104.7,687,353,334,105.7
37380, 성주군,065005, 64세,2017,720,382,338,113,715,379,336,112.8
37380, 성주군,070,65~69세,2017,3512,1704,1808,94.2,3499,1699,1800,94.4
37380, 성주군,070001, 65세,2017,815,372,443,84,812,372,440,84.5
37380, 성주군,070002, 66세,2017,627,307,320,95.9,624,306,318,96.2
37380, 성주군,070003, 67세,2017,693,333,360,92.5,690,331,359,92.2
37380, 성주군,070004, 68세,2017,706,356,350,101.7,704,355,349,101.7
37380, 성주군,070005, 69세,2017,671,336,335,100.3,669,335,334,100.3
37380, 성주군,075,70~74세,2017,2485,1164,1321,88.1,2482,1163,1319,88.2
37380, 성주군,075001, 70세,2017,632,311,321,96.9,632,311,321,96.9
37380, 성주군,075002, 71세,2017,405,190,215,88.4,404,190,214,88.8
37380, 성주군,075003, 72세,2017,399,194,205,94.6,398,194,204,95.1
37380, 성주군,075004, 73세,2017,481,213,268,79.5,481,213,268,79.5
37380, 성주군,075005, 74세,2017,568,256,312,82.1,567,255,312,81.7
37380, 성주군,080,75~79세,2017,2628,1126,1502,75,2627,1126,1501,75
37380, 성주군,080001, 75세,2017,615,266,349,76.2,614,266,348,76.4
37380, 성주군,080002, 76세,2017,509,236,273,86.4,509,236,273,86.4
37380, 성주군,080003, 77세,2017,499,200,299,66.9,499,200,299,66.9
37380, 성주군,080004, 78세,2017,551,246,305,80.7,551,246,305,80.7
37380, 성주군,080005, 79세,2017,454,178,276,64.5,454,178,276,64.5
37380, 성주군,085,80~84세,2017,1896,608,1288,47.2,1895,607,1288,47.1
37380, 성주군,085001, 80세,2017,376,144,232,62.1,375,143,232,61.6
37380, 성주군,085002, 81세,2017,444,137,307,44.6,444,137,307,44.6
37380, 성주군,085003, 82세,2017,424,122,302,40.4,424,122,302,40.4
37380, 성주군,085004, 83세,2017,352,114,238,47.9,352,114,238,47.9
37380, 성주군,085005, 84세,2017,300,91,209,43.5,300,91,209,43.5
37380, 성주군,090,85~89세,2017,962,270,692,39,962,270,692,39
37380, 성주군,090001, 85세,2017,279,89,190,46.8,279,89,190,46.8
37380, 성주군,090002, 86세,2017,195,54,141,38.3,195,54,141,38.3
37380, 성주군,090003, 87세,2017,196,49,147,33.3,196,49,147,33.3
37380, 성주군,090004, 88세,2017,154,45,109,41.3,154,45,109,41.3
37380, 성주군,090005, 89세,2017,138,33,105,31.4,138,33,105,31.4
37380, 성주군,095,90~94세,2017,300,65,235,27.7,300,65,235,27.7
37380, 성주군,095001, 90세,2017,97,24,73,32.9,97,24,73,32.9
37380, 성주군,095002, 91세,2017,67,11,56,19.6,67,11,56,19.6
37380, 성주군,095003, 92세,2017,64,16,48,33.3,64,16,48,33.3
37380, 성주군,095004, 93세,2017,43,10,33,30.3,43,10,33,30.3
37380, 성주군,095005, 94세,2017,29,X,25,16,29,X,25,16
37380, 성주군,100,95~99세,2017,69,9,60,15,69,9,60,15
37380, 성주군,100001, 95세,2017,26,X,22,18.2,26,X,22,18.2
37380, 성주군,100002, 96세,2017,16,X,13,23.1,16,X,13,23.1
37380, 성주군,100003, 97세,2017,12,X,10,20,12,X,10,20
37380, 성주군,100004, 98세,2017,12,X,12,0,12,X,12,0
37380, 성주군,100005, 99세,2017,X,X,X,0,X,X,X,0
37380, 성주군,101,100세이상,2017,X,X,X,50,X,X,X,50
37380, 성주군,102,15세미만,2017,3159,1668,1491,111.9,3153,1666,1487,112
37380, 성주군,103,15~64세,2017,26211,14656,11555,126.8,24274,13218,11056,119.6
37380, 성주군,104,65세이상,2017,11855,4947,6908,71.6,11837,4940,6897,71.6
37380, 성주군,086,85세이상,2017,1334,345,989,34.9,1334,345,989,34.9
37380, 성주군,126,평균연령,2017,50.8,48.2,53.6,,51.6,49.3,54,
37380, 성주군,127,중위연령,2017,54.5,51.5,57.2,,55.6,53.2,57.6,
37390, 칠곡군,000,합계,2017,121778,63665,58113,109.6,116921,60325,56596,106.6
37390, 칠곡군,005,0~4세,2017,5994,3139,2855,109.9,5958,3120,2838,109.9
37390, 칠곡군,005001, 0세,2017,1040,548,492,111.4,1035,543,492,110.4
37390, 칠곡군,005002, 1세,2017,1248,634,614,103.3,1236,632,604,104.6
37390, 칠곡군,005003, 2세,2017,1279,684,595,115,1274,680,594,114.5
37390, 칠곡군,005004, 3세,2017,1163,609,554,109.9,1157,605,552,109.6
37390, 칠곡군,005005, 4세,2017,1264,664,600,110.7,1256,660,596,110.7
37390, 칠곡군,010,5~9세,2017,6151,3168,2983,106.2,6121,3153,2968,106.2
37390, 칠곡군,010001, 5세,2017,1308,685,623,110,1300,681,619,110
37390, 칠곡군,010002, 6세,2017,1275,635,640,99.2,1271,634,637,99.5
37390, 칠곡군,010003, 7세,2017,1240,638,602,106,1233,633,600,105.5
37390, 칠곡군,010004, 8세,2017,1122,585,537,108.9,1114,580,534,108.6
37390, 칠곡군,010005, 9세,2017,1206,625,581,107.6,1203,625,578,108.1
37390, 칠곡군,015,10~14세,2017,5733,3017,2716,111.1,5718,3009,2709,111.1
37390, 칠곡군,015001, 10세,2017,1255,643,612,105.1,1251,642,609,105.4
37390, 칠곡군,015002, 11세,2017,1098,595,503,118.3,1092,590,502,117.5
37390, 칠곡군,015003, 12세,2017,1099,597,502,118.9,1097,595,502,118.5
37390, 칠곡군,015004, 13세,2017,1123,587,536,109.5,1122,587,535,109.7
37390, 칠곡군,015005, 14세,2017,1158,595,563,105.7,1156,595,561,106.1
37390, 칠곡군,020,15~19세,2017,6788,3681,3107,118.5,6695,3628,3067,118.3
37390, 칠곡군,020001, 15세,2017,1242,661,581,113.8,1241,660,581,113.6
37390, 칠곡군,020002, 16세,2017,1302,662,640,103.4,1302,662,640,103.4
37390, 칠곡군,020003, 17세,2017,1391,723,668,108.2,1382,718,664,108.1
37390, 칠곡군,020004, 18세,2017,1375,775,600,129.2,1332,753,579,130.1
37390, 칠곡군,020005, 19세,2017,1478,860,618,139.2,1438,835,603,138.5
37390, 칠곡군,025,20~24세,2017,7661,4304,3357,128.2,7214,3985,3229,123.4
37390, 칠곡군,025001, 20세,2017,1536,882,654,134.9,1520,872,648,134.6
37390, 칠곡군,025002, 21세,2017,1494,914,580,157.6,1422,868,554,156.7
37390, 칠곡군,025003, 22세,2017,1536,894,642,139.3,1441,826,615,134.3
37390, 칠곡군,025004, 23세,2017,1569,832,737,112.9,1449,746,703,106.1
37390, 칠곡군,025005, 24세,2017,1526,782,744,105.1,1382,673,709,94.9
37390, 칠곡군,030,25~29세,2017,8263,4634,3629,127.7,7143,3823,3320,115.2
37390, 칠곡군,030001, 25세,2017,1671,855,816,104.8,1484,715,769,93
37390, 칠곡군,030002, 26세,2017,1544,827,717,115.3,1323,662,661,100.2
37390, 칠곡군,030003, 27세,2017,1598,886,712,124.4,1372,719,653,110.1
37390, 칠곡군,030004, 28세,2017,1662,1008,654,154.1,1419,834,585,142.6
37390, 칠곡군,030005, 29세,2017,1788,1058,730,144.9,1545,893,652,137
37390, 칠곡군,035,30~34세,2017,9746,5551,4195,132.3,8674,4781,3893,122.8
37390, 칠곡군,035001, 30세,2017,1974,1135,839,135.3,1744,958,786,121.9
37390, 칠곡군,035002, 31세,2017,1901,1103,798,138.2,1697,964,733,131.5
37390, 칠곡군,035003, 32세,2017,1887,1094,793,138,1666,950,716,132.7
37390, 칠곡군,035004, 33세,2017,1905,1070,835,128.1,1699,919,780,117.8
37390, 칠곡군,035005, 34세,2017,2079,1149,930,123.5,1868,990,878,112.8
37390, 칠곡군,040,35~39세,2017,11159,6194,4965,124.8,10373,5618,4755,118.1
37390, 칠곡군,040001, 35세,2017,2354,1313,1041,126.1,2143,1162,981,118.5
37390, 칠곡군,040002, 36세,2017,2306,1289,1017,126.7,2139,1171,968,121
37390, 칠곡군,040003, 37세,2017,2384,1344,1040,129.2,2229,1232,997,123.6
37390, 칠곡군,040004, 38세,2017,2146,1190,956,124.5,2011,1084,927,116.9
37390, 칠곡군,040005, 39세,2017,1969,1058,911,116.1,1851,969,882,109.9
37390, 칠곡군,045,40~44세,2017,10469,5622,4847,116,10071,5362,4709,113.9
37390, 칠곡군,045001, 40세,2017,2051,1088,963,113,1946,1017,929,109.5
37390, 칠곡군,045002, 41세,2017,1907,1046,861,121.5,1820,981,839,116.9
37390, 칠곡군,045003, 42세,2017,2126,1127,999,112.8,2043,1083,960,112.8
37390, 칠곡군,045004, 43세,2017,2240,1208,1032,117.1,2168,1162,1006,115.5
37390, 칠곡군,045005, 44세,2017,2145,1153,992,116.2,2094,1119,975,114.8
37390, 칠곡군,050,45~49세,2017,10499,5647,4852,116.4,10202,5472,4730,115.7
37390, 칠곡군,050001, 45세,2017,2167,1188,979,121.3,2100,1136,964,117.8
37390, 칠곡군,050002, 46세,2017,2131,1178,953,123.6,2056,1138,918,124
37390, 칠곡군,050003, 47세,2017,2091,1127,964,116.9,2035,1096,939,116.7
37390, 칠곡군,050004, 48세,2017,2055,1078,977,110.3,2008,1053,955,110.3
37390, 칠곡군,050005, 49세,2017,2055,1076,979,109.9,2003,1049,954,110
37390, 칠곡군,055,50~54세,2017,8908,4811,4097,117.4,8678,4667,4011,116.4
37390, 칠곡군,055001, 50세,2017,1871,986,885,111.4,1813,950,863,110.1
37390, 칠곡군,055002, 51세,2017,1863,1016,847,120,1819,992,827,120
37390, 칠곡군,055003, 52세,2017,1832,992,840,118.1,1779,953,826,115.4
37390, 칠곡군,055004, 53세,2017,1677,931,746,124.8,1634,906,728,124.5
37390, 칠곡군,055005, 54세,2017,1665,886,779,113.7,1633,866,767,112.9
37390, 칠곡군,060,55~59세,2017,8498,4505,3993,112.8,8345,4419,3926,112.6
37390, 칠곡군,060001, 55세,2017,1825,983,842,116.7,1788,960,828,115.9
37390, 칠곡군,060002, 56세,2017,1867,996,871,114.4,1846,982,864,113.7
37390, 칠곡군,060003, 57세,2017,1819,950,869,109.3,1786,935,851,109.9
37390, 칠곡군,060004, 58세,2017,1545,787,758,103.8,1511,765,746,102.5
37390, 칠곡군,060005, 59세,2017,1442,789,653,120.8,1414,777,637,122
37390, 칠곡군,065,60~64세,2017,6161,3065,3096,99,6070,3009,3061,98.3
37390, 칠곡군,065001, 60세,2017,1434,746,688,108.4,1419,738,681,108.4
37390, 칠곡군,065002, 61세,2017,1358,684,674,101.5,1333,665,668,99.6
37390, 칠곡군,065003, 62세,2017,1260,611,649,94.1,1238,597,641,93.1
37390, 칠곡군,065004, 63세,2017,1148,547,601,91,1129,539,590,91.4
37390, 칠곡군,065005, 64세,2017,961,477,484,98.6,951,470,481,97.7
37390, 칠곡군,070,65~69세,2017,4600,2265,2335,97,4543,2230,2313,96.4
37390, 칠곡군,070001, 65세,2017,1113,562,551,102,1100,556,544,102.2
37390, 칠곡군,070002, 66세,2017,799,390,409,95.4,788,380,408,93.1
37390, 칠곡군,070003, 67세,2017,854,429,425,100.9,843,423,420,100.7
37390, 칠곡군,070004, 68세,2017,948,445,503,88.5,938,442,496,89.1
37390, 칠곡군,070005, 69세,2017,886,439,447,98.2,874,429,445,96.4
37390, 칠곡군,075,70~74세,2017,3417,1437,1980,72.6,3399,1430,1969,72.6
37390, 칠곡군,075001, 70세,2017,818,375,443,84.7,813,371,442,83.9
37390, 칠곡군,075002, 71세,2017,551,243,308,78.9,548,241,307,78.5
37390, 칠곡군,075003, 72세,2017,632,256,376,68.1,629,256,373,68.6
37390, 칠곡군,075004, 73세,2017,642,273,369,74,637,272,365,74.5
37390, 칠곡군,075005, 74세,2017,774,290,484,59.9,772,290,482,60.2
37390, 칠곡군,080,75~79세,2017,3675,1365,2310,59.1,3669,1364,2305,59.2
37390, 칠곡군,080001, 75세,2017,899,351,548,64.1,898,351,547,64.2
37390, 칠곡군,080002, 76세,2017,707,273,434,62.9,704,272,432,63
37390, 칠곡군,080003, 77세,2017,704,268,436,61.5,704,268,436,61.5
37390, 칠곡군,080004, 78세,2017,758,254,504,50.4,756,254,502,50.6
37390, 칠곡군,080005, 79세,2017,607,219,388,56.4,607,219,388,56.4
37390, 칠곡군,085,80~84세,2017,2463,852,1611,52.9,2457,849,1608,52.8
37390, 칠곡군,085001, 80세,2017,596,214,382,56,594,212,382,55.5
37390, 칠곡군,085002, 81세,2017,545,188,357,52.7,543,188,355,53
37390, 칠곡군,085003, 82세,2017,517,175,342,51.2,516,175,341,51.3
37390, 칠곡군,085004, 83세,2017,439,162,277,58.5,439,162,277,58.5
37390, 칠곡군,085005, 84세,2017,366,113,253,44.7,365,112,253,44.3
37390, 칠곡군,090,85~89세,2017,1107,309,798,38.7,1105,307,798,38.5
37390, 칠곡군,090001, 85세,2017,328,87,241,36.1,328,87,241,36.1
37390, 칠곡군,090002, 86세,2017,245,81,164,49.4,244,80,164,48.8
37390, 칠곡군,090003, 87세,2017,210,60,150,40,209,59,150,39.3
37390, 칠곡군,090004, 88세,2017,178,48,130,36.9,178,48,130,36.9
37390, 칠곡군,090005, 89세,2017,146,33,113,29.2,146,33,113,29.2
37390, 칠곡군,095,90~94세,2017,377,90,287,31.4,377,90,287,31.4
37390, 칠곡군,095001, 90세,2017,122,33,89,37.1,122,33,89,37.1
37390, 칠곡군,095002, 91세,2017,78,21,57,36.8,78,21,57,36.8
37390, 칠곡군,095003, 92세,2017,74,21,53,39.6,74,21,53,39.6
37390, 칠곡군,095004, 93세,2017,59,10,49,20.4,59,10,49,20.4
37390, 칠곡군,095005, 94세,2017,44,5,39,12.8,44,5,39,12.8
37390, 칠곡군,100,95~99세,2017,92,8,84,9.5,92,8,84,9.5
37390, 칠곡군,100001, 95세,2017,39,X,38,2.6,39,X,38,2.6
37390, 칠곡군,100002, 96세,2017,26,X,22,18.2,26,X,22,18.2
37390, 칠곡군,100003, 97세,2017,12,X,11,9.1,12,X,11,9.1
37390, 칠곡군,100004, 98세,2017,8,X,7,14.3,8,X,7,14.3
37390, 칠곡군,100005, 99세,2017,7,X,6,16.7,7,X,6,16.7
37390, 칠곡군,101,100세이상,2017,17,X,16,6.3,17,X,16,6.3
37390, 칠곡군,102,15세미만,2017,17878,9324,8554,109,17797,9282,8515,109
37390, 칠곡군,103,15~64세,2017,88152,48014,40138,119.6,83465,44764,38701,115.7
37390, 칠곡군,104,65세이상,2017,15748,6327,9421,67.2,15659,6279,9380,66.9
37390, 칠곡군,086,85세이상,2017,1593,408,1185,34.4,1591,406,1185,34.3
37390, 칠곡군,126,평균연령,2017,39.9,38.4,41.4,,40.1,38.7,41.6,
37390, 칠곡군,127,중위연령,2017,39.7,38.3,41.3,,40.3,39,41.7,
37400, 예천군,000,합계,2017,46321,22674,23647,95.9,45728,22423,23305,96.2
37400, 예천군,005,0~4세,2017,1636,837,799,104.8,1632,835,797,104.8
37400, 예천군,005001, 0세,2017,249,128,121,105.8,247,127,120,105.8
37400, 예천군,005002, 1세,2017,330,172,158,108.9,329,171,158,108.2
37400, 예천군,005003, 2세,2017,367,188,179,105,366,188,178,105.6
37400, 예천군,005004, 3세,2017,309,160,149,107.4,309,160,149,107.4
37400, 예천군,005005, 4세,2017,381,189,192,98.4,381,189,192,98.4
37400, 예천군,010,5~9세,2017,1710,914,796,114.8,1708,914,794,115.1
37400, 예천군,010001, 5세,2017,377,203,174,116.7,376,203,173,117.3
37400, 예천군,010002, 6세,2017,359,176,183,96.2,359,176,183,96.2
37400, 예천군,010003, 7세,2017,325,173,152,113.8,324,173,151,114.6
37400, 예천군,010004, 8세,2017,331,184,147,125.2,331,184,147,125.2
37400, 예천군,010005, 9세,2017,318,178,140,127.1,318,178,140,127.1
37400, 예천군,015,10~14세,2017,1558,824,734,112.3,1558,824,734,112.3
37400, 예천군,015001, 10세,2017,339,180,159,113.2,339,180,159,113.2
37400, 예천군,015002, 11세,2017,311,172,139,123.7,311,172,139,123.7
37400, 예천군,015003, 12세,2017,290,150,140,107.1,290,150,140,107.1
37400, 예천군,015004, 13세,2017,329,167,162,103.1,329,167,162,103.1
37400, 예천군,015005, 14세,2017,289,155,134,115.7,289,155,134,115.7
37400, 예천군,020,15~19세,2017,1600,857,743,115.3,1597,856,741,115.5
37400, 예천군,020001, 15세,2017,326,185,141,131.2,326,185,141,131.2
37400, 예천군,020002, 16세,2017,322,157,165,95.2,321,157,164,95.7
37400, 예천군,020003, 17세,2017,334,176,158,111.4,334,176,158,111.4
37400, 예천군,020004, 18세,2017,302,146,156,93.6,300,145,155,93.5
37400, 예천군,020005, 19세,2017,316,193,123,156.9,316,193,123,156.9
37400, 예천군,025,20~24세,2017,1728,1087,641,169.6,1666,1057,609,173.6
37400, 예천군,025001, 20세,2017,381,244,137,178.1,378,242,136,177.9
37400, 예천군,025002, 21세,2017,351,235,116,202.6,341,231,110,210
37400, 예천군,025003, 22세,2017,335,230,105,219,325,226,99,228.3
37400, 예천군,025004, 23세,2017,342,204,138,147.8,325,192,133,144.4
37400, 예천군,025005, 24세,2017,319,174,145,120,297,166,131,126.7
37400, 예천군,030,25~29세,2017,1641,876,765,114.5,1512,819,693,118.2
37400, 예천군,030001, 25세,2017,309,159,150,106,287,149,138,108
37400, 예천군,030002, 26세,2017,323,179,144,124.3,290,161,129,124.8
37400, 예천군,030003, 27세,2017,315,189,126,150,289,178,111,160.4
37400, 예천군,030004, 28세,2017,360,180,180,100,332,169,163,103.7
37400, 예천군,030005, 29세,2017,334,169,165,102.4,314,162,152,106.6
37400, 예천군,035,30~34세,2017,1903,1003,900,111.4,1824,967,857,112.8
37400, 예천군,035001, 30세,2017,366,189,177,106.8,349,182,167,109
37400, 예천군,035002, 31세,2017,366,208,158,131.6,347,199,148,134.5
37400, 예천군,035003, 32세,2017,370,196,174,112.6,350,185,165,112.1
37400, 예천군,035004, 33세,2017,384,202,182,111,372,197,175,112.6
37400, 예천군,035005, 34세,2017,417,208,209,99.5,406,204,202,101
37400, 예천군,040,35~39세,2017,2497,1312,1185,110.7,2424,1282,1142,112.3
37400, 예천군,040001, 35세,2017,491,258,233,110.7,471,247,224,110.3
37400, 예천군,040002, 36세,2017,489,240,249,96.4,477,234,243,96.3
37400, 예천군,040003, 37세,2017,519,260,259,100.4,499,255,244,104.5
37400, 예천군,040004, 38세,2017,523,291,232,125.4,516,288,228,126.3
37400, 예천군,040005, 39세,2017,475,263,212,124.1,461,258,203,127.1
37400, 예천군,045,40~44세,2017,2530,1410,1120,125.9,2485,1391,1094,127.1
37400, 예천군,045001, 40세,2017,487,251,236,106.4,477,246,231,106.5
37400, 예천군,045002, 41세,2017,499,282,217,130,487,277,210,131.9
37400, 예천군,045003, 42세,2017,492,286,206,138.8,486,283,203,139.4
37400, 예천군,045004, 43세,2017,520,289,231,125.1,511,285,226,126.1
37400, 예천군,045005, 44세,2017,532,302,230,131.3,524,300,224,133.9
37400, 예천군,050,45~49세,2017,2801,1569,1232,127.4,2753,1554,1199,129.6
37400, 예천군,050001, 45세,2017,522,327,195,167.7,509,323,186,173.7
37400, 예천군,050002, 46세,2017,548,332,216,153.7,544,330,214,154.2
37400, 예천군,050003, 47세,2017,539,280,259,108.1,525,278,247,112.6
37400, 예천군,050004, 48세,2017,584,304,280,108.6,575,300,275,109.1
37400, 예천군,050005, 49세,2017,608,326,282,115.6,600,323,277,116.6
37400, 예천군,055,50~54세,2017,3224,1671,1553,107.6,3163,1647,1516,108.6
37400, 예천군,055001, 50세,2017,577,316,261,121.1,561,310,251,123.5
37400, 예천군,055002, 51세,2017,630,329,301,109.3,617,325,292,111.3
37400, 예천군,055003, 52세,2017,627,321,306,104.9,618,317,301,105.3
37400, 예천군,055004, 53세,2017,698,377,321,117.4,685,373,312,119.6
37400, 예천군,055005, 54세,2017,692,328,364,90.1,682,322,360,89.4
37400, 예천군,060,55~59세,2017,4233,2142,2091,102.4,4198,2123,2075,102.3
37400, 예천군,060001, 55세,2017,754,366,388,94.3,746,363,383,94.8
37400, 예천군,060002, 56세,2017,903,476,427,111.5,894,469,425,110.4
37400, 예천군,060003, 57세,2017,923,458,465,98.5,916,452,464,97.4
37400, 예천군,060004, 58세,2017,779,382,397,96.2,773,381,392,97.2
37400, 예천군,060005, 59세,2017,874,460,414,111.1,869,458,411,111.4
37400, 예천군,065,60~64세,2017,4225,2047,2178,94,4193,2036,2157,94.4
37400, 예천군,065001, 60세,2017,874,421,453,92.9,865,418,447,93.5
37400, 예천군,065002, 61세,2017,877,448,429,104.4,871,446,425,104.9
37400, 예천군,065003, 62세,2017,851,374,477,78.4,845,373,472,79
37400, 예천군,065004, 63세,2017,822,396,426,93,815,393,422,93.1
37400, 예천군,065005, 64세,2017,801,408,393,103.8,797,406,391,103.8
37400, 예천군,070,65~69세,2017,3680,1772,1908,92.9,3668,1770,1898,93.3
37400, 예천군,070001, 65세,2017,826,415,411,101,824,414,410,101
37400, 예천군,070002, 66세,2017,638,306,332,92.2,636,306,330,92.7
37400, 예천군,070003, 67세,2017,724,316,408,77.5,720,316,404,78.2
37400, 예천군,070004, 68세,2017,741,356,385,92.5,740,356,384,92.7
37400, 예천군,070005, 69세,2017,751,379,372,101.9,748,378,370,102.2
37400, 예천군,075,70~74세,2017,3015,1357,1658,81.8,3010,1354,1656,81.8
37400, 예천군,075001, 70세,2017,737,358,379,94.5,735,357,378,94.4
37400, 예천군,075002, 71세,2017,408,193,215,89.8,408,193,215,89.8
37400, 예천군,075003, 72세,2017,498,223,275,81.1,498,223,275,81.1
37400, 예천군,075004, 73세,2017,643,282,361,78.1,642,281,361,77.8
37400, 예천군,075005, 74세,2017,729,301,428,70.3,727,300,427,70.3
37400, 예천군,080,75~79세,2017,3854,1563,2291,68.2,3852,1562,2290,68.2
37400, 예천군,080001, 75세,2017,950,404,546,74,950,404,546,74
37400, 예천군,080002, 76세,2017,718,294,424,69.3,718,294,424,69.3
37400, 예천군,080003, 77세,2017,715,296,419,70.6,715,296,419,70.6
37400, 예천군,080004, 78세,2017,780,286,494,57.9,778,285,493,57.8
37400, 예천군,080005, 79세,2017,691,283,408,69.4,691,283,408,69.4
37400, 예천군,085,80~84세,2017,2806,1005,1801,55.8,2805,1004,1801,55.7
37400, 예천군,085001, 80세,2017,664,256,408,62.7,664,256,408,62.7
37400, 예천군,085002, 81세,2017,599,198,401,49.4,599,198,401,49.4
37400, 예천군,085003, 82세,2017,656,245,411,59.6,656,245,411,59.6
37400, 예천군,085004, 83세,2017,522,175,347,50.4,521,174,347,50.1
37400, 예천군,085005, 84세,2017,365,131,234,56,365,131,234,56
37400, 예천군,090,85~89세,2017,1143,312,831,37.5,1143,312,831,37.5
37400, 예천군,090001, 85세,2017,336,114,222,51.4,336,114,222,51.4
37400, 예천군,090002, 86세,2017,229,66,163,40.5,229,66,163,40.5
37400, 예천군,090003, 87세,2017,238,54,184,29.3,238,54,184,29.3
37400, 예천군,090004, 88세,2017,191,44,147,29.9,191,44,147,29.9
37400, 예천군,090005, 89세,2017,149,34,115,29.6,149,34,115,29.6
37400, 예천군,095,90~94세,2017,424,101,323,31.3,424,101,323,31.3
37400, 예천군,095001, 90세,2017,150,38,112,33.9,150,38,112,33.9
37400, 예천군,095002, 91세,2017,88,20,68,29.4,88,20,68,29.4
37400, 예천군,095003, 92세,2017,79,20,59,33.9,79,20,59,33.9
37400, 예천군,095004, 93세,2017,60,10,50,20,60,10,50,20
37400, 예천군,095005, 94세,2017,47,13,34,38.2,47,13,34,38.2
37400, 예천군,100,95~99세,2017,94,12,82,14.6,94,12,82,14.6
37400, 예천군,100001, 95세,2017,36,X,33,9.1,36,X,33,9.1
37400, 예천군,100002, 96세,2017,19,7,12,58.3,19,7,12,58.3
37400, 예천군,100003, 97세,2017,17,X,16,6.3,17,X,16,6.3
37400, 예천군,100004, 98세,2017,14,X,13,7.7,14,X,13,7.7
37400, 예천군,100005, 99세,2017,8,X,8,0,8,X,8,0
37400, 예천군,101,100세이상,2017,19,X,16,18.8,19,X,16,18.8
37400, 예천군,102,15세미만,2017,4904,2575,2329,110.6,4898,2573,2325,110.7
37400, 예천군,103,15~64세,2017,26382,13974,12408,112.6,25815,13732,12083,113.6
37400, 예천군,104,65세이상,2017,15035,6125,8910,68.7,15015,6118,8897,68.8
37400, 예천군,086,85세이상,2017,1680,428,1252,34.2,1680,428,1252,34.2
37400, 예천군,126,평균연령,2017,51.1,48.4,53.7,,51.3,48.5,53.9,
37400, 예천군,127,중위연령,2017,55.4,52,58.2,,55.7,52.2,58.5,
37410, 봉화군,000,합계,2017,31082,15350,15732,97.6,30722,15217,15505,98.1
37410, 봉화군,005,0~4세,2017,871,462,409,113,871,462,409,113
37410, 봉화군,005001, 0세,2017,165,86,79,108.9,165,86,79,108.9
37410, 봉화군,005002, 1세,2017,166,86,80,107.5,166,86,80,107.5
37410, 봉화군,005003, 2세,2017,187,110,77,142.9,187,110,77,142.9
37410, 봉화군,005004, 3세,2017,176,87,89,97.8,176,87,89,97.8
37410, 봉화군,005005, 4세,2017,177,93,84,110.7,177,93,84,110.7
37410, 봉화군,010,5~9세,2017,866,454,412,110.2,866,454,412,110.2
37410, 봉화군,010001, 5세,2017,197,103,94,109.6,197,103,94,109.6
37410, 봉화군,010002, 6세,2017,184,87,97,89.7,184,87,97,89.7
37410, 봉화군,010003, 7세,2017,155,81,74,109.5,155,81,74,109.5
37410, 봉화군,010004, 8세,2017,163,94,69,136.2,163,94,69,136.2
37410, 봉화군,010005, 9세,2017,167,89,78,114.1,167,89,78,114.1
37410, 봉화군,015,10~14세,2017,882,452,430,105.1,881,452,429,105.4
37410, 봉화군,015001, 10세,2017,181,73,108,67.6,181,73,108,67.6
37410, 봉화군,015002, 11세,2017,174,86,88,97.7,173,86,87,98.9
37410, 봉화군,015003, 12세,2017,156,81,75,108,156,81,75,108
37410, 봉화군,015004, 13세,2017,185,106,79,134.2,185,106,79,134.2
37410, 봉화군,015005, 14세,2017,186,106,80,132.5,186,106,80,132.5
37410, 봉화군,020,15~19세,2017,994,548,446,122.9,993,547,446,122.6
37410, 봉화군,020001, 15세,2017,208,121,87,139.1,208,121,87,139.1
37410, 봉화군,020002, 16세,2017,220,114,106,107.5,220,114,106,107.5
37410, 봉화군,020003, 17세,2017,247,133,114,116.7,247,133,114,116.7
37410, 봉화군,020004, 18세,2017,211,110,101,108.9,211,110,101,108.9
37410, 봉화군,020005, 19세,2017,108,70,38,184.2,107,69,38,181.6
37410, 봉화군,025,20~24세,2017,936,570,366,155.7,887,554,333,166.4
37410, 봉화군,025001, 20세,2017,189,131,58,225.9,185,131,54,242.6
37410, 봉화군,025002, 21세,2017,191,131,60,218.3,181,127,54,235.2
37410, 봉화군,025003, 22세,2017,193,117,76,153.9,186,115,71,162
37410, 봉화군,025004, 23세,2017,177,96,81,118.5,165,92,73,126
37410, 봉화군,025005, 24세,2017,186,95,91,104.4,170,89,81,109.9
37410, 봉화군,030,25~29세,2017,930,493,437,112.8,865,471,394,119.5
37410, 봉화군,030001, 25세,2017,188,99,89,111.2,172,91,81,112.3
37410, 봉화군,030002, 26세,2017,183,83,100,83,170,80,90,88.9
37410, 봉화군,030003, 27세,2017,191,108,83,130.1,175,102,73,139.7
37410, 봉화군,030004, 28세,2017,173,95,78,121.8,164,92,72,127.8
37410, 봉화군,030005, 29세,2017,195,108,87,124.1,184,106,78,135.9
37410, 봉화군,035,30~34세,2017,1084,564,520,108.5,1020,544,476,114.3
37410, 봉화군,035001, 30세,2017,181,100,81,123.5,165,96,69,139.1
37410, 봉화군,035002, 31세,2017,210,113,97,116.5,200,109,91,119.8
37410, 봉화군,035003, 32세,2017,202,102,100,102,187,99,88,112.5
37410, 봉화군,035004, 33세,2017,231,123,108,113.9,218,119,99,120.2
37410, 봉화군,035005, 34세,2017,260,126,134,94,250,121,129,93.8
37410, 봉화군,040,35~39세,2017,1324,744,580,128.3,1289,732,557,131.4
37410, 봉화군,040001, 35세,2017,258,132,126,104.8,251,131,120,109.2
37410, 봉화군,040002, 36세,2017,262,144,118,122,246,138,108,127.8
37410, 봉화군,040003, 37세,2017,278,160,118,135.6,273,157,116,135.3
37410, 봉화군,040004, 38세,2017,281,164,117,140.2,275,162,113,143.4
37410, 봉화군,040005, 39세,2017,245,144,101,142.6,244,144,100,144
37410, 봉화군,045,40~44세,2017,1530,866,664,130.4,1500,852,648,131.5
37410, 봉화군,045001, 40세,2017,266,149,117,127.4,263,147,116,126.7
37410, 봉화군,045002, 41세,2017,281,164,117,140.2,272,160,112,142.9
37410, 봉화군,045003, 42세,2017,313,177,136,130.1,306,173,133,130.1
37410, 봉화군,045004, 43세,2017,348,197,151,130.5,341,195,146,133.6
37410, 봉화군,045005, 44세,2017,322,179,143,125.2,318,177,141,125.5
37410, 봉화군,050,45~49세,2017,2027,1137,890,127.8,1990,1121,869,129
37410, 봉화군,050001, 45세,2017,343,212,131,161.8,338,209,129,162
37410, 봉화군,050002, 46세,2017,397,238,159,149.7,388,233,155,150.3
37410, 봉화군,050003, 47세,2017,383,210,173,121.4,381,210,171,122.8
37410, 봉화군,050004, 48세,2017,438,235,203,115.8,427,233,194,120.1
37410, 봉화군,050005, 49세,2017,466,242,224,108,456,236,220,107.3
37410, 봉화군,055,50~54세,2017,2518,1322,1196,110.5,2486,1311,1175,111.6
37410, 봉화군,055001, 50세,2017,442,245,197,124.4,437,244,193,126.4
37410, 봉화군,055002, 51세,2017,480,264,216,122.2,472,261,211,123.7
37410, 봉화군,055003, 52세,2017,531,271,260,104.2,524,268,256,104.7
37410, 봉화군,055004, 53세,2017,492,259,233,111.2,485,256,229,111.8
37410, 봉화군,055005, 54세,2017,573,283,290,97.6,568,282,286,98.6
37410, 봉화군,060,55~59세,2017,3458,1780,1678,106.1,3435,1769,1666,106.2
37410, 봉화군,060001, 55세,2017,672,380,292,130.1,667,376,291,129.2
37410, 봉화군,060002, 56세,2017,712,380,332,114.5,706,379,327,115.9
37410, 봉화군,060003, 57세,2017,763,358,405,88.4,761,357,404,88.4
37410, 봉화군,060004, 58세,2017,633,305,328,93,626,302,324,93.2
37410, 봉화군,060005, 59세,2017,678,357,321,111.2,675,355,320,110.9
37410, 봉화군,065,60~64세,2017,3094,1610,1484,108.5,3079,1606,1473,109
37410, 봉화군,065001, 60세,2017,670,349,321,108.7,666,349,317,110.1
37410, 봉화군,065002, 61세,2017,609,329,280,117.5,606,328,278,118
37410, 봉화군,065003, 62세,2017,694,359,335,107.2,691,357,334,106.9
37410, 봉화군,065004, 63세,2017,594,309,285,108.4,591,308,283,108.8
37410, 봉화군,065005, 64세,2017,527,264,263,100.4,525,264,261,101.1
37410, 봉화군,070,65~69세,2017,2647,1311,1336,98.1,2640,1306,1334,97.9
37410, 봉화군,070001, 65세,2017,586,291,295,98.6,584,289,295,98
37410, 봉화군,070002, 66세,2017,497,258,239,107.9,496,257,239,107.5
37410, 봉화군,070003, 67세,2017,490,229,261,87.7,489,229,260,88.1
37410, 봉화군,070004, 68세,2017,522,263,259,101.5,521,262,259,101.2
37410, 봉화군,070005, 69세,2017,552,270,282,95.7,550,269,281,95.7
37410, 봉화군,075,70~74세,2017,2217,968,1249,77.5,2217,968,1249,77.5
37410, 봉화군,075001, 70세,2017,539,243,296,82.1,539,243,296,82.1
37410, 봉화군,075002, 71세,2017,281,149,132,112.9,281,149,132,112.9
37410, 봉화군,075003, 72세,2017,393,163,230,70.9,393,163,230,70.9
37410, 봉화군,075004, 73세,2017,474,207,267,77.5,474,207,267,77.5
37410, 봉화군,075005, 74세,2017,530,206,324,63.6,530,206,324,63.6
37410, 봉화군,080,75~79세,2017,2595,1046,1549,67.5,2595,1046,1549,67.5
37410, 봉화군,080001, 75세,2017,572,239,333,71.8,572,239,333,71.8
37410, 봉화군,080002, 76세,2017,500,202,298,67.8,500,202,298,67.8
37410, 봉화군,080003, 77세,2017,547,227,320,70.9,547,227,320,70.9
37410, 봉화군,080004, 78세,2017,493,210,283,74.2,493,210,283,74.2
37410, 봉화군,080005, 79세,2017,483,168,315,53.3,483,168,315,53.3
37410, 봉화군,085,80~84세,2017,1877,674,1203,56,1877,674,1203,56
37410, 봉화군,085001, 80세,2017,415,146,269,54.3,415,146,269,54.3
37410, 봉화군,085002, 81세,2017,423,168,255,65.9,423,168,255,65.9
37410, 봉화군,085003, 82세,2017,433,143,290,49.3,433,143,290,49.3
37410, 봉화군,085004, 83세,2017,337,122,215,56.7,337,122,215,56.7
37410, 봉화군,085005, 84세,2017,269,95,174,54.6,269,95,174,54.6
37410, 봉화군,090,85~89세,2017,852,271,581,46.6,851,270,581,46.5
37410, 봉화군,090001, 85세,2017,229,76,153,49.7,228,75,153,49
37410, 봉화군,090002, 86세,2017,179,53,126,42.1,179,53,126,42.1
37410, 봉화군,090003, 87세,2017,189,63,126,50,189,63,126,50
37410, 봉화군,090004, 88세,2017,142,43,99,43.4,142,43,99,43.4
37410, 봉화군,090005, 89세,2017,113,36,77,46.8,113,36,77,46.8
37410, 봉화군,095,90~94세,2017,299,60,239,25.1,299,60,239,25.1
37410, 봉화군,095001, 90세,2017,96,23,73,31.5,96,23,73,31.5
37410, 봉화군,095002, 91세,2017,67,11,56,19.6,67,11,56,19.6
37410, 봉화군,095003, 92세,2017,68,10,58,17.2,68,10,58,17.2
37410, 봉화군,095004, 93세,2017,33,10,23,43.5,33,10,23,43.5
37410, 봉화군,095005, 94세,2017,35,6,29,20.7,35,6,29,20.7
37410, 봉화군,100,95~99세,2017,70,13,57,22.8,70,13,57,22.8
37410, 봉화군,100001, 95세,2017,23,9,14,64.3,23,9,14,64.3
37410, 봉화군,100002, 96세,2017,21,X,18,16.7,21,X,18,16.7
37410, 봉화군,100003, 97세,2017,8,X,8,0,8,X,8,0
37410, 봉화군,100004, 98세,2017,8,X,7,14.3,8,X,7,14.3
37410, 봉화군,100005, 99세,2017,10,X,10,0,10,X,10,0
37410, 봉화군,101,100세이상,2017,11,5,6,83.3,11,5,6,83.3
37410, 봉화군,102,15세미만,2017,2619,1368,1251,109.4,2618,1368,1250,109.4
37410, 봉화군,103,15~64세,2017,17895,9634,8261,116.6,17544,9507,8037,118.3
37410, 봉화군,104,65세이상,2017,10568,4348,6220,69.9,10560,4342,6218,69.8
37410, 봉화군,086,85세이상,2017,1232,349,883,39.5,1231,348,883,39.4
37410, 봉화군,126,평균연령,2017,53.4,50.9,55.8,,53.6,51,56.1,
37410, 봉화군,127,중위연령,2017,57.3,55.2,59.5,,57.4,55.3,59.8,
37420, 울진군,000,합계,2017,48504,24852,23652,105.1,46961,23542,23419,100.5
37420, 울진군,005,0~4세,2017,1680,843,837,100.7,1678,841,837,100.5
37420, 울진군,005001, 0세,2017,270,133,137,97.1,270,133,137,97.1
37420, 울진군,005002, 1세,2017,335,155,180,86.1,335,155,180,86.1
37420, 울진군,005003, 2세,2017,346,189,157,120.4,346,189,157,120.4
37420, 울진군,005004, 3세,2017,371,181,190,95.3,369,179,190,94.2
37420, 울진군,005005, 4세,2017,358,185,173,106.9,358,185,173,106.9
37420, 울진군,010,5~9세,2017,1734,915,819,111.7,1733,915,818,111.9
37420, 울진군,010001, 5세,2017,365,203,162,125.3,364,203,161,126.1
37420, 울진군,010002, 6세,2017,347,165,182,90.7,347,165,182,90.7
37420, 울진군,010003, 7세,2017,341,189,152,124.3,341,189,152,124.3
37420, 울진군,010004, 8세,2017,313,160,153,104.6,313,160,153,104.6
37420, 울진군,010005, 9세,2017,368,198,170,116.5,368,198,170,116.5
37420, 울진군,015,10~14세,2017,1771,937,834,112.4,1771,937,834,112.4
37420, 울진군,015001, 10세,2017,389,220,169,130.2,389,220,169,130.2
37420, 울진군,015002, 11세,2017,340,186,154,120.8,340,186,154,120.8
37420, 울진군,015003, 12세,2017,335,163,172,94.8,335,163,172,94.8
37420, 울진군,015004, 13세,2017,368,197,171,115.2,368,197,171,115.2
37420, 울진군,015005, 14세,2017,339,171,168,101.8,339,171,168,101.8
37420, 울진군,020,15~19세,2017,2190,1270,920,138,2183,1264,919,137.5
37420, 울진군,020001, 15세,2017,456,248,208,119.2,455,248,207,119.8
37420, 울진군,020002, 16세,2017,490,287,203,141.4,490,287,203,141.4
37420, 울진군,020003, 17세,2017,576,336,240,140,574,334,240,139.2
37420, 울진군,020004, 18세,2017,448,246,202,121.8,447,245,202,121.3
37420, 울진군,020005, 19세,2017,220,153,67,228.4,217,150,67,223.9
37420, 울진군,025,20~24세,2017,1711,1182,529,223.4,1551,1046,505,207.1
37420, 울진군,025001, 20세,2017,338,267,71,376.1,331,264,67,394
37420, 울진군,025002, 21세,2017,336,263,73,360.3,328,256,72,355.6
37420, 울진군,025003, 22세,2017,334,234,100,234,300,205,95,215.8
37420, 울진군,025004, 23세,2017,343,204,139,146.8,297,161,136,118.4
37420, 울진군,025005, 24세,2017,360,214,146,146.6,295,160,135,118.5
37420, 울진군,030,25~29세,2017,2292,1441,851,169.3,1881,1084,797,136
37420, 울진군,030001, 25세,2017,418,247,171,144.4,326,171,155,110.3
37420, 울진군,030002, 26세,2017,452,276,176,156.8,382,217,165,131.5
37420, 울진군,030003, 27세,2017,456,292,164,178,379,227,152,149.3
37420, 울진군,030004, 28세,2017,464,316,148,213.5,374,236,138,171
37420, 울진군,030005, 29세,2017,502,310,192,161.5,420,233,187,124.6
37420, 울진군,035,30~34세,2017,2410,1442,968,149,2059,1127,932,120.9
37420, 울진군,035001, 30세,2017,493,300,193,155.4,418,235,183,128.4
37420, 울진군,035002, 31세,2017,441,265,176,150.6,381,214,167,128.1
37420, 울진군,035003, 32세,2017,461,280,181,154.7,384,210,174,120.7
37420, 울진군,035004, 33세,2017,479,286,193,148.2,412,226,186,121.5
37420, 울진군,035005, 34세,2017,536,311,225,138.2,464,242,222,109
37420, 울진군,040,35~39세,2017,3046,1721,1325,129.9,2811,1500,1311,114.4
37420, 울진군,040001, 35세,2017,619,352,267,131.8,567,302,265,114
37420, 울진군,040002, 36세,2017,578,324,254,127.6,531,279,252,110.7
37420, 울진군,040003, 37세,2017,640,350,290,120.7,590,304,286,106.3
37420, 울진군,040004, 38세,2017,621,356,265,134.3,572,311,261,119.2
37420, 울진군,040005, 39세,2017,588,339,249,136.1,551,304,247,123.1
37420, 울진군,045,40~44세,2017,3147,1772,1375,128.9,2997,1634,1363,119.9
37420, 울진군,045001, 40세,2017,586,308,278,110.8,562,286,276,103.6
37420, 울진군,045002, 41세,2017,559,337,222,151.8,521,300,221,135.7
37420, 울진군,045003, 42세,2017,640,368,272,135.3,602,334,268,124.6
37420, 울진군,045004, 43세,2017,620,334,286,116.8,595,311,284,109.5
37420, 울진군,045005, 44세,2017,742,425,317,134.1,717,403,314,128.3
37420, 울진군,050,45~49세,2017,3708,2093,1615,129.6,3607,2013,1594,126.3
37420, 울진군,050001, 45세,2017,651,379,272,139.3,631,364,267,136.3
37420, 울진군,050002, 46세,2017,819,482,337,143,792,458,334,137.1
37420, 울진군,050003, 47세,2017,752,433,319,135.7,735,419,316,132.6
37420, 울진군,050004, 48세,2017,745,403,342,117.8,722,384,338,113.6
37420, 울진군,050005, 49세,2017,741,396,345,114.8,727,388,339,114.5
37420, 울진군,055,50~54세,2017,3859,2125,1734,122.5,3817,2105,1712,123
37420, 울진군,055001, 50세,2017,728,404,324,124.7,716,398,318,125.2
37420, 울진군,055002, 51세,2017,753,424,329,128.9,741,419,322,130.1
37420, 울진군,055003, 52세,2017,781,420,361,116.3,776,416,360,115.6
37420, 울진군,055004, 53세,2017,759,422,337,125.2,748,418,330,126.7
37420, 울진군,055005, 54세,2017,838,455,383,118.8,836,454,382,118.8
37420, 울진군,060,55~59세,2017,4642,2380,2262,105.2,4603,2363,2240,105.5
37420, 울진군,060001, 55세,2017,891,448,443,101.1,881,443,438,101.1
37420, 울진군,060002, 56세,2017,1087,577,510,113.1,1076,573,503,113.9
37420, 울진군,060003, 57세,2017,997,505,492,102.6,985,500,485,103.1
37420, 울진군,060004, 58세,2017,859,424,435,97.5,856,422,434,97.2
37420, 울진군,060005, 59세,2017,808,426,382,111.5,805,425,380,111.8
37420, 울진군,065,60~64세,2017,3959,1963,1996,98.3,3939,1952,1987,98.2
37420, 울진군,065001, 60세,2017,849,438,411,106.6,846,436,410,106.3
37420, 울진군,065002, 61세,2017,898,429,469,91.5,893,427,466,91.6
37420, 울진군,065003, 62세,2017,760,386,374,103.2,756,385,371,103.8
37420, 울진군,065004, 63세,2017,762,371,391,94.9,758,368,390,94.4
37420, 울진군,065005, 64세,2017,690,339,351,96.6,686,336,350,96
37420, 울진군,070,65~69세,2017,3060,1502,1558,96.4,3045,1496,1549,96.6
37420, 울진군,070001, 65세,2017,656,311,345,90.1,652,309,343,90.1
37420, 울진군,070002, 66세,2017,493,242,251,96.4,491,241,250,96.4
37420, 울진군,070003, 67세,2017,597,297,300,99,593,295,298,99
37420, 울진군,070004, 68세,2017,637,314,323,97.2,634,313,321,97.5
37420, 울진군,070005, 69세,2017,677,338,339,99.7,675,338,337,100.3
37420, 울진군,075,70~74세,2017,2676,1154,1522,75.8,2673,1153,1520,75.9
37420, 울진군,075001, 70세,2017,534,240,294,81.6,534,240,294,81.6
37420, 울진군,075002, 71세,2017,456,233,223,104.5,456,233,223,104.5
37420, 울진군,075003, 72세,2017,514,203,311,65.3,513,203,310,65.5
37420, 울진군,075004, 73세,2017,525,210,315,66.7,523,209,314,66.6
37420, 울진군,075005, 74세,2017,647,268,379,70.7,647,268,379,70.7
37420, 울진군,080,75~79세,2017,2989,1120,1869,59.9,2987,1120,1867,60
37420, 울진군,080001, 75세,2017,688,275,413,66.6,688,275,413,66.6
37420, 울진군,080002, 76세,2017,567,221,346,63.9,567,221,346,63.9
37420, 울진군,080003, 77세,2017,574,200,374,53.5,574,200,374,53.5
37420, 울진군,080004, 78세,2017,628,222,406,54.7,626,222,404,55
37420, 울진군,080005, 79세,2017,532,202,330,61.2,532,202,330,61.2
37420, 울진군,085,80~84세,2017,2138,700,1438,48.7,2134,700,1434,48.8
37420, 울진군,085001, 80세,2017,526,177,349,50.7,525,177,348,50.9
37420, 울진군,085002, 81세,2017,479,161,318,50.6,479,161,318,50.6
37420, 울진군,085003, 82세,2017,458,136,322,42.2,457,136,321,42.4
37420, 울진군,085004, 83세,2017,358,123,235,52.3,357,123,234,52.6
37420, 울진군,085005, 84세,2017,317,103,214,48.1,316,103,213,48.4
37420, 울진군,090,85~89세,2017,1062,218,844,25.8,1062,218,844,25.8
37420, 울진군,090001, 85세,2017,289,54,235,23,289,54,235,23
37420, 울진군,090002, 86세,2017,250,57,193,29.5,250,57,193,29.5
37420, 울진군,090003, 87세,2017,224,53,171,31,224,53,171,31
37420, 울진군,090004, 88세,2017,164,32,132,24.2,164,32,132,24.2
37420, 울진군,090005, 89세,2017,135,22,113,19.5,135,22,113,19.5
37420, 울진군,095,90~94세,2017,358,62,296,20.9,358,62,296,20.9
37420, 울진군,095001, 90세,2017,107,23,84,27.4,107,23,84,27.4
37420, 울진군,095002, 91세,2017,83,14,69,20.3,83,14,69,20.3
37420, 울진군,095003, 92세,2017,84,11,73,15.1,84,11,73,15.1
37420, 울진군,095004, 93세,2017,48,6,42,14.3,48,6,42,14.3
37420, 울진군,095005, 94세,2017,36,8,28,28.6,36,8,28,28.6
37420, 울진군,100,95~99세,2017,64,11,53,20.8,64,11,53,20.8
37420, 울진군,100001, 95세,2017,30,X,26,15.4,30,X,26,15.4
37420, 울진군,100002, 96세,2017,16,6,10,60,16,6,10,60
37420, 울진군,100003, 97세,2017,7,X,7,0,7,X,7,0
37420, 울진군,100004, 98세,2017,7,X,6,16.7,7,X,6,16.7
37420, 울진군,100005, 99세,2017,X,X,X,0,X,X,X,0
37420, 울진군,101,100세이상,2017,8,X,7,14.3,8,X,7,14.3
37420, 울진군,102,15세미만,2017,5185,2695,2490,108.2,5182,2693,2489,108.2
37420, 울진군,103,15~64세,2017,30964,17389,13575,128.1,29448,16088,13360,120.4
37420, 울진군,104,65세이상,2017,12355,4768,7587,62.8,12331,4761,7570,62.9
37420, 울진군,086,85세이상,2017,1492,292,1200,24.3,1492,292,1200,24.3
37420, 울진군,126,평균연령,2017,48.2,45.1,51.5,,48.7,45.7,51.6,
37420, 울진군,127,중위연령,2017,50.8,47.1,55,,51.7,48.5,55.2,
37430, 울릉군,000,합계,2017,8702,4824,3878,124.4,8493,4663,3830,121.7
37430, 울릉군,005,0~4세,2017,225,115,110,104.5,223,115,108,106.5
37430, 울릉군,005001, 0세,2017,31,14,17,82.4,31,14,17,82.4
37430, 울릉군,005002, 1세,2017,39,25,14,178.6,38,25,13,192.3
37430, 울릉군,005003, 2세,2017,58,31,27,114.8,58,31,27,114.8
37430, 울릉군,005004, 3세,2017,48,23,25,92,47,23,24,95.8
37430, 울릉군,005005, 4세,2017,49,22,27,81.5,49,22,27,81.5
37430, 울릉군,010,5~9세,2017,253,136,117,116.2,253,136,117,116.2
37430, 울릉군,010001, 5세,2017,54,24,30,80,54,24,30,80
37430, 울릉군,010002, 6세,2017,50,33,17,194.1,50,33,17,194.1
37430, 울릉군,010003, 7세,2017,47,25,22,113.6,47,25,22,113.6
37430, 울릉군,010004, 8세,2017,47,23,24,95.8,47,23,24,95.8
37430, 울릉군,010005, 9세,2017,55,31,24,129.2,55,31,24,129.2
37430, 울릉군,015,10~14세,2017,236,121,115,105.2,236,121,115,105.2
37430, 울릉군,015001, 10세,2017,51,20,31,64.5,51,20,31,64.5
37430, 울릉군,015002, 11세,2017,45,25,20,125,45,25,20,125
37430, 울릉군,015003, 12세,2017,51,27,24,112.5,51,27,24,112.5
37430, 울릉군,015004, 13세,2017,43,21,22,95.5,43,21,22,95.5
37430, 울릉군,015005, 14세,2017,46,28,18,155.6,46,28,18,155.6
37430, 울릉군,020,15~19세,2017,235,127,108,117.6,234,126,108,116.7
37430, 울릉군,020001, 15세,2017,45,22,23,95.7,45,22,23,95.7
37430, 울릉군,020002, 16세,2017,43,22,21,104.8,43,22,21,104.8
37430, 울릉군,020003, 17세,2017,65,28,37,75.7,65,28,37,75.7
37430, 울릉군,020004, 18세,2017,52,32,20,160,51,31,20,155
37430, 울릉군,020005, 19세,2017,30,23,7,328.6,30,23,7,328.6
37430, 울릉군,025,20~24세,2017,336,236,100,236,317,220,97,226.8
37430, 울릉군,025001, 20세,2017,63,52,11,472.7,63,52,11,472.7
37430, 울릉군,025002, 21세,2017,49,38,11,345.5,48,38,10,380
37430, 울릉군,025003, 22세,2017,75,55,20,275,68,49,19,257.9
37430, 울릉군,025004, 23세,2017,65,40,25,160,64,40,24,166.7
37430, 울릉군,025005, 24세,2017,84,51,33,154.5,74,41,33,124.2
37430, 울릉군,030,25~29세,2017,449,276,173,159.5,405,239,166,144
37430, 울릉군,030001, 25세,2017,73,48,25,192,68,43,25,172
37430, 울릉군,030002, 26세,2017,94,55,39,141,86,48,38,126.3
37430, 울릉군,030003, 27세,2017,96,55,41,134.1,83,45,38,118.4
37430, 울릉군,030004, 28세,2017,99,58,41,141.5,90,50,40,125
37430, 울릉군,030005, 29세,2017,87,60,27,222.2,78,53,25,212
37430, 울릉군,035,30~34세,2017,451,258,193,133.7,414,224,190,117.9
37430, 울릉군,035001, 30세,2017,77,43,34,126.5,70,38,32,118.8
37430, 울릉군,035002, 31세,2017,78,51,27,188.9,73,47,26,180.8
37430, 울릉군,035003, 32세,2017,94,59,35,168.6,83,48,35,137.1
37430, 울릉군,035004, 33세,2017,108,51,57,89.5,102,45,57,78.9
37430, 울릉군,035005, 34세,2017,94,54,40,135,86,46,40,115
37430, 울릉군,040,35~39세,2017,547,345,202,170.8,520,320,200,160
37430, 울릉군,040001, 35세,2017,110,72,38,189.5,102,64,38,168.4
37430, 울릉군,040002, 36세,2017,119,76,43,176.7,113,70,43,162.8
37430, 울릉군,040003, 37세,2017,124,82,42,195.2,116,74,42,176.2
37430, 울릉군,040004, 38세,2017,92,60,32,187.5,89,57,32,178.1
37430, 울릉군,040005, 39세,2017,102,55,47,117,100,55,45,122.2
37430, 울릉군,045,40~44세,2017,638,394,244,161.5,625,382,243,157.2
37430, 울릉군,045001, 40세,2017,113,61,52,117.3,110,59,51,115.7
37430, 울릉군,045002, 41세,2017,122,73,49,149,119,70,49,142.9
37430, 울릉군,045003, 42세,2017,120,82,38,215.8,119,81,38,213.2
37430, 울릉군,045004, 43세,2017,149,93,56,166.1,146,90,56,160.7
37430, 울릉군,045005, 44세,2017,134,85,49,173.5,131,82,49,167.3
37430, 울릉군,050,45~49세,2017,769,480,289,166.1,761,476,285,167
37430, 울릉군,050001, 45세,2017,129,85,44,193.2,128,84,44,190.9
37430, 울릉군,050002, 46세,2017,164,105,59,178,163,105,58,181
37430, 울릉군,050003, 47세,2017,149,88,61,144.3,147,88,59,149.2
37430, 울릉군,050004, 48세,2017,158,100,58,172.4,154,97,57,170.2
37430, 울릉군,050005, 49세,2017,169,102,67,152.2,169,102,67,152.2
37430, 울릉군,055,50~54세,2017,820,481,339,141.9,811,476,335,142.1
37430, 울릉군,055001, 50세,2017,141,82,59,139,140,82,58,141.4
37430, 울릉군,055002, 51세,2017,174,103,71,145.1,171,102,69,147.8
37430, 울릉군,055003, 52세,2017,177,114,63,181,173,111,62,179
37430, 울릉군,055004, 53세,2017,140,80,60,133.3,140,80,60,133.3
37430, 울릉군,055005, 54세,2017,188,102,86,118.6,187,101,86,117.4
37430, 울릉군,060,55~59세,2017,994,534,460,116.1,972,526,446,117.9
37430, 울릉군,060001, 55세,2017,188,118,70,168.6,183,117,66,177.3
37430, 울릉군,060002, 56세,2017,218,108,110,98.2,216,107,109,98.2
37430, 울릉군,060003, 57세,2017,199,115,84,136.9,193,112,81,138.3
37430, 울릉군,060004, 58세,2017,209,100,109,91.7,204,99,105,94.3
37430, 울릉군,060005, 59세,2017,180,93,87,106.9,176,91,85,107.1
37430, 울릉군,065,60~64세,2017,816,441,375,117.6,798,428,370,115.7
37430, 울릉군,065001, 60세,2017,195,107,88,121.6,191,104,87,119.5
37430, 울릉군,065002, 61세,2017,166,87,79,110.1,164,86,78,110.3
37430, 울릉군,065003, 62세,2017,167,98,69,142,161,92,69,133.3
37430, 울릉군,065004, 63세,2017,139,72,67,107.5,135,71,64,110.9
37430, 울릉군,065005, 64세,2017,149,77,72,106.9,147,75,72,104.2
37430, 울릉군,070,65~69세,2017,626,313,313,100,619,308,311,99
37430, 울릉군,070001, 65세,2017,145,70,75,93.3,144,69,75,92
37430, 울릉군,070002, 66세,2017,135,76,59,128.8,132,74,58,127.6
37430, 울릉군,070003, 67세,2017,116,48,68,70.6,115,47,68,69.1
37430, 울릉군,070004, 68세,2017,107,52,55,94.5,106,52,54,96.3
37430, 울릉군,070005, 69세,2017,123,67,56,119.6,122,66,56,117.9
37430, 울릉군,075,70~74세,2017,499,234,265,88.3,498,233,265,87.9
37430, 울릉군,075001, 70세,2017,120,62,58,106.9,120,62,58,106.9
37430, 울릉군,075002, 71세,2017,97,44,53,83,96,43,53,81.1
37430, 울릉군,075003, 72세,2017,98,43,55,78.2,98,43,55,78.2
37430, 울릉군,075004, 73세,2017,98,48,50,96,98,48,50,96
37430, 울릉군,075005, 74세,2017,86,37,49,75.5,86,37,49,75.5
37430, 울릉군,080,75~79세,2017,388,186,202,92.1,387,186,201,92.5
37430, 울릉군,080001, 75세,2017,102,54,48,112.5,102,54,48,112.5
37430, 울릉군,080002, 76세,2017,76,38,38,100,75,38,37,102.7
37430, 울릉군,080003, 77세,2017,70,33,37,89.2,70,33,37,89.2
37430, 울릉군,080004, 78세,2017,81,37,44,84.1,81,37,44,84.1
37430, 울릉군,080005, 79세,2017,59,24,35,68.6,59,24,35,68.6
37430, 울릉군,085,80~84세,2017,247,96,151,63.6,247,96,151,63.6
37430, 울릉군,085001, 80세,2017,62,20,42,47.6,62,20,42,47.6
37430, 울릉군,085002, 81세,2017,64,32,32,100,64,32,32,100
37430, 울릉군,085003, 82세,2017,48,23,25,92,48,23,25,92
37430, 울릉군,085004, 83세,2017,42,12,30,40,42,12,30,40
37430, 울릉군,085005, 84세,2017,31,9,22,40.9,31,9,22,40.9
37430, 울릉군,090,85~89세,2017,135,39,96,40.6,135,39,96,40.6
37430, 울릉군,090001, 85세,2017,37,11,26,42.3,37,11,26,42.3
37430, 울릉군,090002, 86세,2017,32,9,23,39.1,32,9,23,39.1
37430, 울릉군,090003, 87세,2017,31,10,21,47.6,31,10,21,47.6
37430, 울릉군,090004, 88세,2017,20,7,13,53.8,20,7,13,53.8
37430, 울릉군,090005, 89세,2017,15,X,13,15.4,15,X,13,15.4
37430, 울릉군,095,90~94세,2017,31,12,19,63.2,31,12,19,63.2
37430, 울릉군,095001, 90세,2017,9,X,6,50,9,X,6,50
37430, 울릉군,095002, 91세,2017,9,5,X,125,9,5,X,125
37430, 울릉군,095003, 92세,2017,5,X,X,25,5,X,X,25
37430, 울릉군,095004, 93세,2017,X,X,X,100,X,X,X,100
37430, 울릉군,095005, 94세,2017,X,X,X,33.3,X,X,X,33.3
37430, 울릉군,100,95~99세,2017,7,X,7,0,7,X,7,0
37430, 울릉군,100001, 95세,2017,X,X,X,0,X,X,X,0
37430, 울릉군,100002, 96세,2017,X,X,X,0,X,X,X,0
37430, 울릉군,100003, 97세,2017,X,X,X,0,X,X,X,0
37430, 울릉군,100004, 98세,2017,X,X,X,,X,X,X,
37430, 울릉군,100005, 99세,2017,X,X,X,0,X,X,X,0
37430, 울릉군,101,100세이상,2017,X,X,X,,X,X,X,
37430, 울릉군,102,15세미만,2017,714,372,342,108.8,712,372,340,109.4
37430, 울릉군,103,15~64세,2017,6055,3572,2483,143.9,5857,3417,2440,140
37430, 울릉군,104,65세이상,2017,1933,880,1053,83.6,1924,874,1050,83.2
37430, 울릉군,086,85세이상,2017,173,51,122,41.8,173,51,122,41.8
37430, 울릉군,126,평균연령,2017,48.7,47.1,50.6,,48.9,47.4,50.7,
37430, 울릉군,127,중위연령,2017,51.4,49.3,54.4,,51.7,49.7,54.4,
38,경상남도,000,합계,2017,3345293,1702150,1643143,103.6,3254221,1639600,1614621,101.5
38,경상남도,005,0~4세,2017,144635,74315,70320,105.7,143688,73837,69851,105.7
38,경상남도,005001, 0세,2017,24583,12659,11924,106.2,24401,12571,11830,106.3
38,경상남도,005002, 1세,2017,28226,14428,13798,104.6,28032,14336,13696,104.7
38,경상남도,005003, 2세,2017,30276,15572,14704,105.9,30068,15454,14614,105.7
38,경상남도,005004, 3세,2017,30724,15788,14936,105.7,30525,15689,14836,105.7
38,경상남도,005005, 4세,2017,30826,15868,14958,106.1,30662,15787,14875,106.1
38,경상남도,010,5~9세,2017,162159,83639,78520,106.5,161552,83333,78219,106.5
38,경상남도,010001, 5세,2017,33709,17365,16344,106.2,33557,17288,16269,106.3
38,경상남도,010002, 6세,2017,33187,17069,16118,105.9,33062,17003,16059,105.9
38,경상남도,010003, 7세,2017,31912,16540,15372,107.6,31795,16479,15316,107.6
38,경상남도,010004, 8세,2017,30857,15988,14869,107.5,30754,15941,14813,107.6
38,경상남도,010005, 9세,2017,32494,16677,15817,105.4,32384,16622,15762,105.5
38,경상남도,015,10~14세,2017,155405,81344,74061,109.8,155034,81163,73871,109.9
38,경상남도,015001, 10세,2017,32863,17035,15828,107.6,32778,16991,15787,107.6
38,경상남도,015002, 11세,2017,29782,15503,14279,108.6,29699,15463,14236,108.6
38,경상남도,015003, 12세,2017,29170,15193,13977,108.7,29102,15157,13945,108.7
38,경상남도,015004, 13세,2017,31506,16621,14885,111.7,31442,16591,14851,111.7
38,경상남도,015005, 14세,2017,32084,16992,15092,112.6,32013,16961,15052,112.7
38,경상남도,020,15~19세,2017,187833,100527,87306,115.1,186796,99981,86815,115.2
38,경상남도,020001, 15세,2017,33492,17674,15818,111.7,33415,17637,15778,111.8
38,경상남도,020002, 16세,2017,38042,20088,17954,111.9,37959,20033,17926,111.8
38,경상남도,020003, 17세,2017,42010,22007,20003,110,41901,21942,19959,109.9
38,경상남도,020004, 18세,2017,38987,20858,18129,115.1,38781,20743,18038,115
38,경상남도,020005, 19세,2017,35302,19900,15402,129.2,34740,19626,15114,129.9
38,경상남도,025,20~24세,2017,200573,115751,84822,136.5,191438,109998,81440,135.1
38,경상남도,025001, 20세,2017,38846,22487,16359,137.5,37989,22079,15910,138.8
38,경상남도,025002, 21세,2017,41320,24555,16765,146.5,40056,23833,16223,146.9
38,경상남도,025003, 22세,2017,40776,23612,17164,137.6,38945,22485,16460,136.6
38,경상남도,025004, 23세,2017,39915,22672,17243,131.5,37638,21200,16438,129
38,경상남도,025005, 24세,2017,39716,22425,17291,129.7,36810,20401,16409,124.3
38,경상남도,030,25~29세,2017,190998,107683,83315,129.2,171338,93245,78093,119.4
38,경상남도,030001, 25세,2017,40069,22277,17792,125.2,36602,19803,16799,117.9
38,경상남도,030002, 26세,2017,38442,21600,16842,128.3,34635,18841,15794,119.3
38,경상남도,030003, 27세,2017,38019,21743,16276,133.6,33819,18648,15171,122.9
38,경상남도,030004, 28세,2017,37479,21270,16209,131.2,33457,18278,15179,120.4
38,경상남도,030005, 29세,2017,36989,20793,16196,128.4,32825,17675,15150,116.7
38,경상남도,035,30~34세,2017,211996,116345,95651,121.6,192691,101537,91154,111.4
38,경상남도,035001, 30세,2017,38646,21334,17312,123.2,34220,18041,16179,111.5
38,경상남도,035002, 31세,2017,39765,22337,17428,128.2,35648,19205,16443,116.8
38,경상남도,035003, 32세,2017,40988,22770,18218,125,37053,19677,17376,113.2
38,경상남도,035004, 33세,2017,43916,23811,20105,118.4,40344,21053,19291,109.1
38,경상남도,035005, 34세,2017,48681,26093,22588,115.5,45426,23561,21865,107.8
38,경상남도,040,35~39세,2017,264841,140405,124436,112.8,252281,130903,121378,107.8
38,경상남도,040001, 35세,2017,53229,28260,24969,113.2,50108,25880,24228,106.8
38,경상남도,040002, 36세,2017,54224,29021,25203,115.1,51586,27012,24574,109.9
38,경상남도,040003, 37세,2017,56143,29482,26661,110.6,53704,27621,26083,105.9
38,경상남도,040004, 38세,2017,52498,27797,24701,112.5,50219,26096,24123,108.2
38,경상남도,040005, 39세,2017,48747,25845,22902,112.9,46664,24294,22370,108.6
38,경상남도,045,40~44세,2017,263101,136577,126524,107.9,255008,130845,124163,105.4
38,경상남도,045001, 40세,2017,48964,25636,23328,109.9,47194,24325,22869,106.4
38,경상남도,045002, 41세,2017,48558,25524,23034,110.8,46776,24198,22578,107.2
38,경상남도,045003, 42세,2017,51858,26788,25070,106.9,50210,25636,24574,104.3
38,경상남도,045004, 43세,2017,55718,28856,26862,107.4,54249,27836,26413,105.4
38,경상남도,045005, 44세,2017,58003,29773,28230,105.5,56579,28850,27729,104
38,경상남도,050,45~49세,2017,298226,153413,144813,105.9,291407,149204,142203,104.9
38,경상남도,050001, 45세,2017,56377,29661,26716,111,54898,28681,26217,109.4
38,경상남도,050002, 46세,2017,60795,31396,29399,106.8,59351,30465,28886,105.5
38,경상남도,050003, 47세,2017,60176,30888,29288,105.5,58782,30040,28742,104.5
38,경상남도,050004, 48세,2017,60262,30915,29347,105.3,59002,30195,28807,104.8
38,경상남도,050005, 49세,2017,60616,30553,30063,101.6,59374,29823,29551,100.9
38,경상남도,055,50~54세,2017,271244,139171,132073,105.4,265874,136245,129629,105.1
38,경상남도,055001, 50세,2017,56043,28137,27906,100.8,54948,27523,27425,100.4
38,경상남도,055002, 51세,2017,55436,29054,26382,110.1,54396,28468,25928,109.8
38,경상남도,055003, 52세,2017,55577,28177,27400,102.8,54503,27592,26911,102.5
38,경상남도,055004, 53세,2017,49694,25400,24294,104.6,48659,24860,23799,104.5
38,경상남도,055005, 54세,2017,54494,28403,26091,108.9,53368,27802,25566,108.7
38,경상남도,060,55~59세,2017,286687,144897,141790,102.2,283267,143085,140182,102.1
38,경상남도,060001, 55세,2017,58528,30026,28502,105.3,57629,29532,28097,105.1
38,경상남도,060002, 56세,2017,62837,31379,31458,99.7,62206,31054,31152,99.7
38,경상남도,060003, 57세,2017,60892,30387,30505,99.6,60146,30011,30135,99.6
38,경상남도,060004, 58세,2017,53436,27096,26340,102.9,52844,26772,26072,102.7
38,경상남도,060005, 59세,2017,50994,26009,24985,104.1,50442,25716,24726,104
38,경상남도,065,60~64세,2017,217121,108098,109023,99.2,214953,106966,107987,99.1
38,경상남도,065001, 60세,2017,49953,25207,24746,101.9,49443,24920,24523,101.6
38,경상남도,065002, 61세,2017,46466,23219,23247,99.9,45989,22974,23015,99.8
38,경상남도,065003, 62세,2017,46955,22965,23990,95.7,46516,22729,23787,95.6
38,경상남도,065004, 63세,2017,39560,19928,19632,101.5,39151,19736,19415,101.7
38,경상남도,065005, 64세,2017,34187,16779,17408,96.4,33854,16607,17247,96.3
38,경상남도,070,65~69세,2017,156386,75945,80441,94.4,155452,75479,79973,94.4
38,경상남도,070001, 65세,2017,37274,18310,18964,96.6,37025,18186,18839,96.5
38,경상남도,070002, 66세,2017,29634,14316,15318,93.5,29424,14218,15206,93.5
38,경상남도,070003, 67세,2017,29719,14482,15237,95,29508,14368,15140,94.9
38,경상남도,070004, 68세,2017,30193,14639,15554,94.1,30028,14553,15475,94
38,경상남도,070005, 69세,2017,29566,14198,15368,92.4,29467,14154,15313,92.4
38,경상남도,075,70~74세,2017,113432,50648,62784,80.7,113114,50508,62606,80.7
38,경상남도,075001, 70세,2017,27615,12872,14743,87.3,27508,12825,14683,87.3
38,경상남도,075002, 71세,2017,20355,9530,10825,88,20286,9497,10789,88
38,경상남도,075003, 72세,2017,20796,9265,11531,80.3,20744,9244,11500,80.4
38,경상남도,075004, 73세,2017,21932,9517,12415,76.7,21875,9491,12384,76.6
38,경상남도,075005, 74세,2017,22734,9464,13270,71.3,22701,9451,13250,71.3
38,경상남도,080,75~79세,2017,106396,40862,65534,62.4,106206,40786,65420,62.3
38,경상남도,080001, 75세,2017,25533,10345,15188,68.1,25495,10328,15167,68.1
38,경상남도,080002, 76세,2017,22255,8813,13442,65.6,22215,8799,13416,65.6
38,경상남도,080003, 77세,2017,20791,7902,12889,61.3,20745,7884,12861,61.3
38,경상남도,080004, 78세,2017,20393,7544,12849,58.7,20367,7530,12837,58.7
38,경상남도,080005, 79세,2017,17424,6258,11166,56,17384,6245,11139,56.1
38,경상남도,085,80~84세,2017,69562,22358,47204,47.4,69472,22326,47146,47.4
38,경상남도,085001, 80세,2017,17011,5940,11071,53.7,16987,5932,11055,53.7
38,경상남도,085002, 81세,2017,15405,5177,10228,50.6,15386,5169,10217,50.6
38,경상남도,085003, 82세,2017,14341,4585,9756,47,14323,4580,9743,47
38,경상남도,085004, 83세,2017,12440,3708,8732,42.5,12420,3701,8719,42.4
38,경상남도,085005, 84세,2017,10365,2948,7417,39.7,10356,2944,7412,39.7
38,경상남도,090,85~89세,2017,32897,7910,24987,31.7,32869,7904,24965,31.7
38,경상남도,090001, 85세,2017,9505,2498,7007,35.7,9497,2498,6999,35.7
38,경상남도,090002, 86세,2017,7368,1801,5567,32.4,7364,1800,5564,32.4
38,경상남도,090003, 87세,2017,6442,1418,5024,28.2,6435,1417,5018,28.2
38,경상남도,090004, 88세,2017,5479,1287,4192,30.7,5474,1285,4189,30.7
38,경상남도,090005, 89세,2017,4103,906,3197,28.3,4099,904,3195,28.3
38,경상남도,095,90~94세,2017,9817,1932,7885,24.5,9801,1928,7873,24.5
38,경상남도,095001, 90세,2017,3236,695,2541,27.4,3230,694,2536,27.4
38,경상남도,095002, 91세,2017,2289,452,1837,24.6,2286,450,1836,24.5
38,경상남도,095003, 92세,2017,1958,347,1611,21.5,1954,347,1607,21.6
38,경상남도,095004, 93세,2017,1224,242,982,24.6,1222,242,980,24.7
38,경상남도,095005, 94세,2017,1110,196,914,21.4,1109,195,914,21.3
38,경상남도,100,95~99세,2017,1784,307,1477,20.8,1781,305,1476,20.7
38,경상남도,100001, 95세,2017,758,130,628,20.7,758,130,628,20.7
38,경상남도,100002, 96세,2017,438,73,365,20,437,72,365,19.7
38,경상남도,100003, 97세,2017,317,48,269,17.8,315,47,268,17.5
38,경상남도,100004, 98세,2017,148,32,116,27.6,148,32,116,27.6
38,경상남도,100005, 99세,2017,123,24,99,24.2,123,24,99,24.2
38,경상남도,101,100세이상,2017,200,23,177,13,199,22,177,12.4
38,경상남도,102,15세미만,2017,462199,239298,222901,107.4,460274,238333,221941,107.4
38,경상남도,103,15~64세,2017,2392620,1262867,1129753,111.8,2305053,1202009,1103044,109
38,경상남도,104,65세이상,2017,490474,199985,290489,68.8,488894,199258,289636,68.8
38,경상남도,086,85세이상,2017,44698,10172,34526,29.5,44650,10159,34491,29.5
38,경상남도,126,평균연령,2017,41.8,40.2,43.4,,41.9,40.3,43.5,
38,경상남도,127,중위연령,2017,43.1,41.2,44.9,,43.5,41.9,45.1,
38004, 읍부,000,합계,2017,493742,248558,245184,101.4,482702,241405,241297,100
38004, 읍부,005,0~4세,2017,24891,12744,12147,104.9,24758,12677,12081,104.9
38004, 읍부,005001, 0세,2017,4199,2175,2024,107.5,4179,2162,2017,107.2
38004, 읍부,005002, 1세,2017,4902,2522,2380,106,4872,2509,2363,106.2
38004, 읍부,005003, 2세,2017,5236,2678,2558,104.7,5216,2670,2546,104.9
38004, 읍부,005004, 3세,2017,5293,2683,2610,102.8,5260,2666,2594,102.8
38004, 읍부,005005, 4세,2017,5261,2686,2575,104.3,5231,2670,2561,104.3
38004, 읍부,010,5~9세,2017,27356,14095,13261,106.3,27246,14047,13199,106.4
38004, 읍부,010001, 5세,2017,5755,2960,2795,105.9,5725,2944,2781,105.9
38004, 읍부,010002, 6세,2017,5679,2911,2768,105.2,5658,2903,2755,105.4
38004, 읍부,010003, 7세,2017,5375,2778,2597,107,5361,2774,2587,107.2
38004, 읍부,010004, 8세,2017,5145,2642,2503,105.6,5126,2632,2494,105.5
38004, 읍부,010005, 9세,2017,5402,2804,2598,107.9,5376,2794,2582,108.2
38004, 읍부,015,10~14세,2017,25121,13110,12011,109.1,25057,13076,11981,109.1
38004, 읍부,015001, 10세,2017,5330,2826,2504,112.9,5317,2819,2498,112.9
38004, 읍부,015002, 11세,2017,4856,2493,2363,105.5,4843,2484,2359,105.3
38004, 읍부,015003, 12세,2017,4801,2461,2340,105.2,4789,2454,2335,105.1
38004, 읍부,015004, 13세,2017,5058,2615,2443,107,5048,2610,2438,107.1
38004, 읍부,015005, 14세,2017,5076,2715,2361,115,5060,2709,2351,115.2
38004, 읍부,020,15~19세,2017,28861,15608,13253,117.8,28769,15564,13205,117.9
38004, 읍부,020001, 15세,2017,5195,2766,2429,113.9,5188,2765,2423,114.1
38004, 읍부,020002, 16세,2017,5963,3178,2785,114.1,5951,3170,2781,114
38004, 읍부,020003, 17세,2017,6583,3456,3127,110.5,6570,3450,3120,110.6
38004, 읍부,020004, 18세,2017,5898,3220,2678,120.2,5871,3210,2661,120.6
38004, 읍부,020005, 19세,2017,5222,2988,2234,133.8,5189,2969,2220,133.7
38004, 읍부,025,20~24세,2017,27946,16110,11836,136.1,27046,15538,11508,135
38004, 읍부,025001, 20세,2017,5799,3335,2464,135.3,5728,3296,2432,135.5
38004, 읍부,025002, 21세,2017,5877,3545,2332,152,5766,3480,2286,152.2
38004, 읍부,025003, 22세,2017,5624,3328,2296,144.9,5434,3208,2226,144.1
38004, 읍부,025004, 23세,2017,5357,3039,2318,131.1,5129,2896,2233,129.7
38004, 읍부,025005, 24세,2017,5289,2863,2426,118,4989,2658,2331,114
38004, 읍부,030,25~29세,2017,25823,13957,11866,117.6,23548,12371,11177,110.7
38004, 읍부,030001, 25세,2017,5342,2852,2490,114.5,4953,2595,2358,110.1
38004, 읍부,030002, 26세,2017,5100,2770,2330,118.9,4656,2463,2193,112.3
38004, 읍부,030003, 27세,2017,5142,2800,2342,119.6,4660,2465,2195,112.3
38004, 읍부,030004, 28세,2017,5085,2773,2312,119.9,4645,2453,2192,111.9
38004, 읍부,030005, 29세,2017,5154,2762,2392,115.5,4634,2395,2239,107
38004, 읍부,035,30~34세,2017,31229,16197,15032,107.8,28919,14525,14394,100.9
38004, 읍부,035001, 30세,2017,5486,2832,2654,106.7,4949,2458,2491,98.7
38004, 읍부,035002, 31세,2017,5732,3031,2701,112.2,5221,2668,2553,104.5
38004, 읍부,035003, 32세,2017,5971,3148,2823,111.5,5514,2807,2707,103.7
38004, 읍부,035004, 33세,2017,6570,3370,3200,105.3,6140,3054,3086,99
38004, 읍부,035005, 34세,2017,7470,3816,3654,104.4,7095,3538,3557,99.5
38004, 읍부,040,35~39세,2017,41196,20996,20200,103.9,39706,19944,19762,100.9
38004, 읍부,040001, 35세,2017,8249,4192,4057,103.3,7889,3924,3965,99
38004, 읍부,040002, 36세,2017,8329,4261,4068,104.7,8017,4041,3976,101.6
38004, 읍부,040003, 37세,2017,8756,4481,4275,104.8,8467,4278,4189,102.1
38004, 읍부,040004, 38세,2017,8162,4137,4025,102.8,7899,3953,3946,100.2
38004, 읍부,040005, 39세,2017,7700,3925,3775,104,7434,3748,3686,101.7
38004, 읍부,045,40~44세,2017,40063,20644,19419,106.3,39016,19941,19075,104.5
38004, 읍부,045001, 40세,2017,7664,3916,3748,104.5,7447,3766,3681,102.3
38004, 읍부,045002, 41세,2017,7492,3888,3604,107.9,7248,3719,3529,105.4
38004, 읍부,045003, 42세,2017,7889,4084,3805,107.3,7678,3944,3734,105.6
38004, 읍부,045004, 43세,2017,8420,4386,4034,108.7,8235,4257,3978,107
38004, 읍부,045005, 44세,2017,8598,4370,4228,103.4,8408,4255,4153,102.5
38004, 읍부,050,45~49세,2017,44026,22789,21237,107.3,43143,22278,20865,106.8
38004, 읍부,050001, 45세,2017,8489,4402,4087,107.7,8317,4303,4014,107.2
38004, 읍부,050002, 46세,2017,9055,4708,4347,108.3,8871,4605,4266,107.9
38004, 읍부,050003, 47세,2017,8823,4577,4246,107.8,8644,4473,4171,107.2
38004, 읍부,050004, 48세,2017,8824,4596,4228,108.7,8654,4496,4158,108.1
38004, 읍부,050005, 49세,2017,8835,4506,4329,104.1,8657,4401,4256,103.4
38004, 읍부,055,50~54세,2017,38074,19665,18409,106.8,37352,19295,18057,106.9
38004, 읍부,055001, 50세,2017,7860,3963,3897,101.7,7719,3883,3836,101.2
38004, 읍부,055002, 51세,2017,7785,4120,3665,112.4,7624,4034,3590,112.4
38004, 읍부,055003, 52세,2017,7730,3929,3801,103.4,7613,3870,3743,103.4
38004, 읍부,055004, 53세,2017,7158,3724,3434,108.4,7004,3657,3347,109.3
38004, 읍부,055005, 54세,2017,7541,3929,3612,108.8,7392,3851,3541,108.8
38004, 읍부,060,55~59세,2017,39646,20079,19567,102.6,39140,19824,19316,102.6
38004, 읍부,060001, 55세,2017,8212,4255,3957,107.5,8086,4186,3900,107.3
38004, 읍부,060002, 56세,2017,8656,4328,4328,100,8559,4280,4279,100
38004, 읍부,060003, 57세,2017,8391,4220,4171,101.2,8272,4171,4101,101.7
38004, 읍부,060004, 58세,2017,7386,3727,3659,101.9,7304,3675,3629,101.3
38004, 읍부,060005, 59세,2017,7001,3549,3452,102.8,6919,3512,3407,103.1
38004, 읍부,065,60~64세,2017,29966,14750,15216,96.9,29652,14588,15064,96.8
38004, 읍부,065001, 60세,2017,6962,3468,3494,99.3,6884,3422,3462,98.8
38004, 읍부,065002, 61세,2017,6450,3169,3281,96.6,6383,3136,3247,96.6
38004, 읍부,065003, 62세,2017,6351,3087,3264,94.6,6281,3048,3233,94.3
38004, 읍부,065004, 63세,2017,5476,2717,2759,98.5,5420,2690,2730,98.5
38004, 읍부,065005, 64세,2017,4727,2309,2418,95.5,4684,2292,2392,95.8
38004, 읍부,070,65~69세,2017,21963,10538,11425,92.2,21845,10491,11354,92.4
38004, 읍부,070001, 65세,2017,5200,2504,2696,92.9,5168,2490,2678,93
38004, 읍부,070002, 66세,2017,4125,1964,2161,90.9,4098,1954,2144,91.1
38004, 읍부,070003, 67세,2017,4211,2007,2204,91.1,4184,1995,2189,91.1
38004, 읍부,070004, 68세,2017,4268,2064,2204,93.6,4249,2057,2192,93.8
38004, 읍부,070005, 69세,2017,4159,1999,2160,92.5,4146,1995,2151,92.7
38004, 읍부,075,70~74세,2017,15782,6997,8785,79.6,15744,6980,8764,79.6
38004, 읍부,075001, 70세,2017,3802,1769,2033,87,3790,1764,2026,87.1
38004, 읍부,075002, 71세,2017,2885,1374,1511,90.9,2874,1368,1506,90.8
38004, 읍부,075003, 72세,2017,2878,1259,1619,77.8,2872,1258,1614,77.9
38004, 읍부,075004, 73세,2017,3024,1288,1736,74.2,3020,1286,1734,74.2
38004, 읍부,075005, 74세,2017,3193,1307,1886,69.3,3188,1304,1884,69.2
38004, 읍부,080,75~79세,2017,15149,5686,9463,60.1,15131,5681,9450,60.1
38004, 읍부,080001, 75세,2017,3540,1369,2171,63.1,3534,1366,2168,63
38004, 읍부,080002, 76세,2017,3210,1251,1959,63.9,3204,1251,1953,64.1
38004, 읍부,080003, 77세,2017,2958,1121,1837,61,2953,1120,1833,61.1
38004, 읍부,080004, 78세,2017,2948,1059,1889,56.1,2947,1058,1889,56
38004, 읍부,080005, 79세,2017,2493,886,1607,55.1,2493,886,1607,55.1
38004, 읍부,085,80~84세,2017,10059,3159,6900,45.8,10046,3153,6893,45.7
38004, 읍부,085001, 80세,2017,2469,842,1627,51.8,2464,839,1625,51.6
38004, 읍부,085002, 81세,2017,2219,720,1499,48,2218,720,1498,48.1
38004, 읍부,085003, 82세,2017,2053,601,1452,41.4,2050,599,1451,41.3
38004, 읍부,085004, 83세,2017,1776,524,1252,41.9,1772,523,1249,41.9
38004, 읍부,085005, 84세,2017,1542,472,1070,44.1,1542,472,1070,44.1
38004, 읍부,090,85~89세,2017,4843,1130,3713,30.4,4838,1128,3710,30.4
38004, 읍부,090001, 85세,2017,1343,342,1001,34.2,1342,342,1000,34.2
38004, 읍부,090002, 86세,2017,1064,247,817,30.2,1064,247,817,30.2
38004, 읍부,090003, 87세,2017,1000,223,777,28.7,1000,223,777,28.7
38004, 읍부,090004, 88세,2017,826,194,632,30.7,824,193,631,30.6
38004, 읍부,090005, 89세,2017,610,124,486,25.5,608,123,485,25.4
38004, 읍부,095,90~94세,2017,1436,258,1178,21.9,1434,258,1176,21.9
38004, 읍부,095001, 90세,2017,503,98,405,24.2,501,98,403,24.3
38004, 읍부,095002, 91세,2017,315,45,270,16.7,315,45,270,16.7
38004, 읍부,095003, 92세,2017,269,49,220,22.3,269,49,220,22.3
38004, 읍부,095004, 93세,2017,186,39,147,26.5,186,39,147,26.5
38004, 읍부,095005, 94세,2017,163,27,136,19.9,163,27,136,19.9
38004, 읍부,100,95~99세,2017,277,43,234,18.4,277,43,234,18.4
38004, 읍부,100001, 95세,2017,113,17,96,17.7,113,17,96,17.7
38004, 읍부,100002, 96세,2017,74,11,63,17.5,74,11,63,17.5
38004, 읍부,100003, 97세,2017,47,8,39,20.5,47,8,39,20.5
38004, 읍부,100004, 98세,2017,20,5,15,33.3,20,5,15,33.3
38004, 읍부,100005, 99세,2017,23,X,21,9.5,23,X,21,9.5
38004, 읍부,101,100세이상,2017,35,X,32,9.4,35,X,32,9.4
38004, 읍부,102,15세미만,2017,77368,39949,37419,106.8,77061,39800,37261,106.8
38004, 읍부,103,15~64세,2017,346830,180795,166035,108.9,336291,173868,162423,107
38004, 읍부,104,65세이상,2017,69544,27814,41730,66.7,69350,27737,41613,66.7
38004, 읍부,086,85세이상,2017,6591,1434,5157,27.8,6584,1432,5152,27.8
38004, 읍부,126,평균연령,2017,40.8,39.2,42.4,,40.9,39.3,42.4,
38004, 읍부,127,중위연령,2017,41.9,40.4,43.5,,42.2,40.8,43.6,
38005, 면부,000,합계,2017,687237,349557,337680,103.5,654655,324611,330044,98.4
38005, 면부,005,0~4세,2017,22935,11817,11118,106.3,22834,11758,11076,106.2
38005, 면부,005001, 0세,2017,3936,2032,1904,106.7,3910,2017,1893,106.6
38005, 면부,005002, 1세,2017,4494,2266,2228,101.7,4473,2253,2220,101.5
38005, 면부,005003, 2세,2017,4789,2445,2344,104.3,4766,2430,2336,104
38005, 면부,005004, 3세,2017,4902,2518,2384,105.6,4884,2509,2375,105.6
38005, 면부,005005, 4세,2017,4814,2556,2258,113.2,4801,2549,2252,113.2
38005, 면부,010,5~9세,2017,24440,12672,11768,107.7,24384,12643,11741,107.7
38005, 면부,010001, 5세,2017,5176,2721,2455,110.8,5163,2715,2448,110.9
38005, 면부,010002, 6세,2017,4973,2615,2358,110.9,4962,2608,2354,110.8
38005, 면부,010003, 7세,2017,4806,2496,2310,108.1,4794,2487,2307,107.8
38005, 면부,010004, 8세,2017,4666,2389,2277,104.9,4654,2384,2270,105
38005, 면부,010005, 9세,2017,4819,2451,2368,103.5,4811,2449,2362,103.7
38005, 면부,015,10~14세,2017,21281,11143,10138,109.9,21234,11121,10113,110
38005, 면부,015001, 10세,2017,4746,2476,2270,109.1,4737,2472,2265,109.1
38005, 면부,015002, 11세,2017,4133,2157,1976,109.2,4122,2150,1972,109
38005, 면부,015003, 12세,2017,3969,2032,1937,104.9,3960,2028,1932,105
38005, 면부,015004, 13세,2017,4192,2244,1948,115.2,4184,2241,1943,115.3
38005, 면부,015005, 14세,2017,4241,2234,2007,111.3,4231,2230,2001,111.4
38005, 면부,020,15~19세,2017,25453,13897,11556,120.3,25290,13814,11476,120.4
38005, 면부,020001, 15세,2017,4541,2442,2099,116.3,4528,2432,2096,116
38005, 면부,020002, 16세,2017,5524,2915,2609,111.7,5511,2910,2601,111.9
38005, 면부,020003, 17세,2017,6136,3178,2958,107.4,6108,3160,2948,107.2
38005, 면부,020004, 18세,2017,5278,2862,2416,118.5,5251,2845,2406,118.2
38005, 면부,020005, 19세,2017,3974,2500,1474,169.6,3892,2467,1425,173.1
38005, 면부,025,20~24세,2017,28997,18172,10825,167.9,25179,15557,9622,161.7
38005, 면부,025001, 20세,2017,5112,3360,1752,191.8,4889,3257,1632,199.6
38005, 면부,025002, 21세,2017,5814,3849,1965,195.9,5332,3573,1759,203.1
38005, 면부,025003, 22세,2017,5875,3604,2271,158.7,5089,3089,2000,154.5
38005, 면부,025004, 23세,2017,6001,3586,2415,148.5,4994,2869,2125,135
38005, 면부,025005, 24세,2017,6195,3773,2422,155.8,4875,2769,2106,131.5
38005, 면부,030,25~29세,2017,33205,20488,12717,161.1,24949,13917,11032,126.2
38005, 면부,030001, 25세,2017,6584,4020,2564,156.8,5094,2842,2252,126.2
38005, 면부,030002, 26세,2017,6536,4040,2496,161.9,4943,2808,2135,131.5
38005, 면부,030003, 27세,2017,6722,4202,2520,166.7,4910,2767,2143,129.1
38005, 면부,030004, 28세,2017,6648,4081,2567,159,5010,2755,2255,122.2
38005, 면부,030005, 29세,2017,6715,4145,2570,161.3,4992,2745,2247,122.2
38005, 면부,035,30~34세,2017,37613,22458,15155,148.2,29808,15916,13892,114.6
38005, 면부,035001, 30세,2017,6863,4169,2694,154.8,5076,2710,2366,114.5
38005, 면부,035002, 31세,2017,7064,4371,2693,162.3,5416,2990,2426,123.2
38005, 면부,035003, 32세,2017,7227,4399,2828,155.6,5609,3014,2595,116.1
38005, 면부,035004, 33세,2017,7919,4641,3278,141.6,6468,3415,3053,111.9
38005, 면부,035005, 34세,2017,8540,4878,3662,133.2,7239,3787,3452,109.7
38005, 면부,040,35~39세,2017,43831,25395,18436,137.7,39110,21474,17636,121.8
38005, 면부,040001, 35세,2017,9061,5257,3804,138.2,7866,4255,3611,117.8
38005, 면부,040002, 36세,2017,9081,5221,3860,135.3,8096,4391,3705,118.5
38005, 면부,040003, 37세,2017,9296,5320,3976,133.8,8344,4530,3814,118.8
38005, 면부,040004, 38세,2017,8518,4996,3522,141.9,7681,4314,3367,128.1
38005, 면부,040005, 39세,2017,7875,4601,3274,140.5,7123,3984,3139,126.9
38005, 면부,045,40~44세,2017,40931,23746,17185,138.2,38212,21629,16583,130.4
38005, 면부,045001, 40세,2017,7801,4488,3313,135.5,7138,3943,3195,123.4
38005, 면부,045002, 41세,2017,7678,4601,3077,149.5,7065,4104,2961,138.6
38005, 면부,045003, 42세,2017,8076,4669,3407,137,7538,4267,3271,130.4
38005, 면부,045004, 43세,2017,8374,4869,3505,138.9,7914,4517,3397,133
38005, 면부,045005, 44세,2017,9002,5119,3883,131.8,8557,4798,3759,127.6
38005, 면부,050,45~49세,2017,47460,26671,20789,128.3,45601,25397,20204,125.7
38005, 면부,050001, 45세,2017,8615,5028,3587,140.2,8168,4713,3455,136.4
38005, 면부,050002, 46세,2017,9364,5341,4023,132.8,8973,5059,3914,129.3
38005, 면부,050003, 47세,2017,9547,5349,4198,127.4,9161,5083,4078,124.6
38005, 면부,050004, 48세,2017,9807,5470,4337,126.1,9479,5274,4205,125.4
38005, 면부,050005, 49세,2017,10127,5483,4644,118.1,9820,5268,4552,115.7
38005, 면부,055,50~54세,2017,51343,27333,24010,113.8,50019,26554,23465,113.2
38005, 면부,055001, 50세,2017,9937,5299,4638,114.3,9640,5115,4525,113
38005, 면부,055002, 51세,2017,10241,5610,4631,121.1,10003,5468,4535,120.6
38005, 면부,055003, 52세,2017,10557,5592,4965,112.6,10274,5433,4841,112.2
38005, 면부,055004, 53세,2017,9767,5086,4681,108.7,9543,4954,4589,108
38005, 면부,055005, 54세,2017,10841,5746,5095,112.8,10559,5584,4975,112.2
38005, 면부,060,55~59세,2017,65868,33579,32289,104,65004,33098,31906,103.7
38005, 면부,060001, 55세,2017,12604,6606,5998,110.1,12394,6482,5912,109.6
38005, 면부,060002, 56세,2017,14127,7118,7009,101.6,13965,7033,6932,101.5
38005, 면부,060003, 57세,2017,14051,7038,7013,100.4,13860,6927,6933,99.9
38005, 면부,060004, 58세,2017,12600,6375,6225,102.4,12451,6294,6157,102.2
38005, 면부,060005, 59세,2017,12486,6442,6044,106.6,12334,6362,5972,106.5
38005, 면부,065,60~64세,2017,58796,29488,29308,100.6,58273,29202,29071,100.5
38005, 면부,065001, 60세,2017,12883,6550,6333,103.4,12767,6484,6283,103.2
38005, 면부,065002, 61세,2017,12433,6361,6072,104.8,12324,6306,6018,104.8
38005, 면부,065003, 62세,2017,12684,6260,6424,97.4,12571,6196,6375,97.2
38005, 면부,065004, 63세,2017,10914,5473,5441,100.6,10814,5421,5393,100.5
38005, 면부,065005, 64세,2017,9882,4844,5038,96.1,9797,4795,5002,95.9
38005, 면부,070,65~69세,2017,48461,23832,24629,96.8,48253,23713,24540,96.6
38005, 면부,070001, 65세,2017,11016,5471,5545,98.7,10958,5436,5522,98.4
38005, 면부,070002, 66세,2017,9072,4412,4660,94.7,9032,4393,4639,94.7
38005, 면부,070003, 67세,2017,9210,4539,4671,97.2,9160,4509,4651,96.9
38005, 면부,070004, 68세,2017,9653,4807,4846,99.2,9614,4782,4832,99
38005, 면부,070005, 69세,2017,9510,4603,4907,93.8,9489,4593,4896,93.8
38005, 면부,075,70~74세,2017,39666,17362,22304,77.8,39607,17340,22267,77.9
38005, 면부,075001, 70세,2017,9174,4321,4853,89,9154,4315,4839,89.2
38005, 면부,075002, 71세,2017,6787,3136,3651,85.9,6772,3128,3644,85.8
38005, 면부,075003, 72세,2017,7315,3157,4158,75.9,7304,3153,4151,76
38005, 면부,075004, 73세,2017,7936,3338,4598,72.6,7927,3335,4592,72.6
38005, 면부,075005, 74세,2017,8454,3410,5044,67.6,8450,3409,5041,67.6
38005, 면부,080,75~79세,2017,44357,16536,27821,59.4,44322,16520,27802,59.4
38005, 면부,080001, 75세,2017,10175,4014,6161,65.2,10167,4011,6156,65.2
38005, 면부,080002, 76세,2017,9106,3512,5594,62.8,9097,3507,5590,62.7
38005, 면부,080003, 77세,2017,8676,3185,5491,58,8666,3180,5486,58
38005, 면부,080004, 78세,2017,8776,3149,5627,56,8773,3148,5625,56
38005, 면부,080005, 79세,2017,7624,2676,4948,54.1,7619,2674,4945,54.1
38005, 면부,085,80~84세,2017,31678,10048,21630,46.5,31668,10044,21624,46.4
38005, 면부,085001, 80세,2017,7537,2591,4946,52.4,7536,2590,4946,52.4
38005, 면부,085002, 81세,2017,6898,2295,4603,49.9,6897,2294,4603,49.8
38005, 면부,085003, 82세,2017,6521,2075,4446,46.7,6519,2075,4444,46.7
38005, 면부,085004, 83세,2017,5850,1736,4114,42.2,5845,1734,4111,42.2
38005, 면부,085005, 84세,2017,4872,1351,3521,38.4,4871,1351,3520,38.4
38005, 면부,090,85~89세,2017,15372,3806,11566,32.9,15365,3804,11561,32.9
38005, 면부,090001, 85세,2017,4457,1207,3250,37.1,4455,1207,3248,37.2
38005, 면부,090002, 86세,2017,3528,893,2635,33.9,3528,893,2635,33.9
38005, 면부,090003, 87세,2017,2972,672,2300,29.2,2969,671,2298,29.2
38005, 면부,090004, 88세,2017,2507,591,1916,30.8,2506,591,1915,30.9
38005, 면부,090005, 89세,2017,1908,443,1465,30.2,1907,442,1465,30.2
38005, 면부,095,90~94세,2017,4612,956,3656,26.1,4606,953,3653,26.1
38005, 면부,095001, 90세,2017,1522,339,1183,28.7,1519,338,1181,28.6
38005, 면부,095002, 91세,2017,1096,246,850,28.9,1095,245,850,28.8
38005, 면부,095003, 92세,2017,907,158,749,21.1,907,158,749,21.1
38005, 면부,095004, 93세,2017,550,112,438,25.6,549,112,437,25.6
38005, 면부,095005, 94세,2017,537,101,436,23.2,536,100,436,22.9
38005, 면부,100,95~99세,2017,847,145,702,20.7,847,145,702,20.7
38005, 면부,100001, 95세,2017,356,65,291,22.3,356,65,291,22.3
38005, 면부,100002, 96세,2017,221,37,184,20.1,221,37,184,20.1
38005, 면부,100003, 97세,2017,149,24,125,19.2,149,24,125,19.2
38005, 면부,100004, 98세,2017,67,10,57,17.5,67,10,57,17.5
38005, 면부,100005, 99세,2017,54,9,45,20,54,9,45,20
38005, 면부,101,100세이상,2017,91,13,78,16.7,90,12,78,15.4
38005, 면부,102,15세미만,2017,68656,35632,33024,107.9,68452,35522,32930,107.9
38005, 면부,103,15~64세,2017,433497,241227,192270,125.5,401445,216558,184887,117.1
38005, 면부,104,65세이상,2017,185084,72698,112386,64.7,184758,72531,112227,64.6
38005, 면부,086,85세이상,2017,20922,4920,16002,30.7,20908,4914,15994,30.7
38005, 면부,126,평균연령,2017,48.9,45.9,51.9,,49.6,46.8,52.3,
38005, 면부,127,중위연령,2017,51.7,47.9,55.9,,53.1,49.8,56.3,
38003, 동부,000,합계,2017,2164314,1104035,1060279,104.1,2116864,1073584,1043280,102.9
38003, 동부,005,0~4세,2017,96809,49754,47055,105.7,96096,49402,46694,105.8
38003, 동부,005001, 0세,2017,16448,8452,7996,105.7,16312,8392,7920,106
38003, 동부,005002, 1세,2017,18830,9640,9190,104.9,18687,9574,9113,105.1
38003, 동부,005003, 2세,2017,20251,10449,9802,106.6,20086,10354,9732,106.4
38003, 동부,005004, 3세,2017,20529,10587,9942,106.5,20381,10514,9867,106.6
38003, 동부,005005, 4세,2017,20751,10626,10125,104.9,20630,10568,10062,105
38003, 동부,010,5~9세,2017,110363,56872,53491,106.3,109922,56643,53279,106.3
38003, 동부,010001, 5세,2017,22778,11684,11094,105.3,22669,11629,11040,105.3
38003, 동부,010002, 6세,2017,22535,11543,10992,105,22442,11492,10950,104.9
38003, 동부,010003, 7세,2017,21731,11266,10465,107.7,21640,11218,10422,107.6
38003, 동부,010004, 8세,2017,21046,10957,10089,108.6,20974,10925,10049,108.7
38003, 동부,010005, 9세,2017,22273,11422,10851,105.3,22197,11379,10818,105.2
38003, 동부,015,10~14세,2017,109003,57091,51912,110,108743,56966,51777,110
38003, 동부,015001, 10세,2017,22787,11733,11054,106.1,22724,11700,11024,106.1
38003, 동부,015002, 11세,2017,20793,10853,9940,109.2,20734,10829,9905,109.3
38003, 동부,015003, 12세,2017,20400,10700,9700,110.3,20353,10675,9678,110.3
38003, 동부,015004, 13세,2017,22256,11762,10494,112.1,22210,11740,10470,112.1
38003, 동부,015005, 14세,2017,22767,12043,10724,112.3,22722,12022,10700,112.4
38003, 동부,020,15~19세,2017,133519,71022,62497,113.6,132737,70603,62134,113.6
38003, 동부,020001, 15세,2017,23756,12466,11290,110.4,23699,12440,11259,110.5
38003, 동부,020002, 16세,2017,26555,13995,12560,111.4,26497,13953,12544,111.2
38003, 동부,020003, 17세,2017,29291,15373,13918,110.5,29223,15332,13891,110.4
38003, 동부,020004, 18세,2017,27811,14776,13035,113.4,27659,14688,12971,113.2
38003, 동부,020005, 19세,2017,26106,14412,11694,123.2,25659,14190,11469,123.7
38003, 동부,025,20~24세,2017,143630,81469,62161,131.1,139213,78903,60310,130.8
38003, 동부,025001, 20세,2017,27935,15792,12143,130.1,27372,15526,11846,131.1
38003, 동부,025002, 21세,2017,29629,17161,12468,137.6,28958,16780,12178,137.8
38003, 동부,025003, 22세,2017,29277,16680,12597,132.4,28422,16188,12234,132.3
38003, 동부,025004, 23세,2017,28557,16047,12510,128.3,27515,15435,12080,127.8
38003, 동부,025005, 24세,2017,28232,15789,12443,126.9,26946,14974,11972,125.1
38003, 동부,030,25~29세,2017,131970,73238,58732,124.7,122841,66957,55884,119.8
38003, 동부,030001, 25세,2017,28143,15405,12738,120.9,26555,14366,12189,117.9
38003, 동부,030002, 26세,2017,26806,14790,12016,123.1,25036,13570,11466,118.3
38003, 동부,030003, 27세,2017,26155,14741,11414,129.1,24249,13416,10833,123.8
38003, 동부,030004, 28세,2017,25746,14416,11330,127.2,23802,13070,10732,121.8
38003, 동부,030005, 29세,2017,25120,13886,11234,123.6,23199,12535,10664,117.5
38003, 동부,035,30~34세,2017,143154,77690,65464,118.7,133964,71096,62868,113.1
38003, 동부,035001, 30세,2017,26297,14333,11964,119.8,24195,12873,11322,113.7
38003, 동부,035002, 31세,2017,26969,14935,12034,124.1,25011,13547,11464,118.2
38003, 동부,035003, 32세,2017,27790,15223,12567,121.1,25930,13856,12074,114.8
38003, 동부,035004, 33세,2017,29427,15800,13627,115.9,27736,14584,13152,110.9
38003, 동부,035005, 34세,2017,32671,17399,15272,113.9,31092,16236,14856,109.3
38003, 동부,040,35~39세,2017,179814,94014,85800,109.6,173465,89485,83980,106.6
38003, 동부,040001, 35세,2017,35919,18811,17108,110,34353,17701,16652,106.3
38003, 동부,040002, 36세,2017,36814,19539,17275,113.1,35473,18580,16893,110
38003, 동부,040003, 37세,2017,38091,19681,18410,106.9,36893,18813,18080,104.1
38003, 동부,040004, 38세,2017,35818,18664,17154,108.8,34639,17829,16810,106.1
38003, 동부,040005, 39세,2017,33172,17319,15853,109.2,32107,16562,15545,106.5
38003, 동부,045,40~44세,2017,182107,92187,89920,102.5,177780,89275,88505,100.9
38003, 동부,045001, 40세,2017,33499,17232,16267,105.9,32609,16616,15993,103.9
38003, 동부,045002, 41세,2017,33388,17035,16353,104.2,32463,16375,16088,101.8
38003, 동부,045003, 42세,2017,35893,18035,17858,101,34994,17425,17569,99.2
38003, 동부,045004, 43세,2017,38924,19601,19323,101.4,38100,19062,19038,100.1
38003, 동부,045005, 44세,2017,40403,20284,20119,100.8,39614,19797,19817,99.9
38003, 동부,050,45~49세,2017,206740,103953,102787,101.1,202663,101529,101134,100.4
38003, 동부,050001, 45세,2017,39273,20231,19042,106.2,38413,19665,18748,104.9
38003, 동부,050002, 46세,2017,42376,21347,21029,101.5,41507,20801,20706,100.5
38003, 동부,050003, 47세,2017,41806,20962,20844,100.6,40977,20484,20493,100
38003, 동부,050004, 48세,2017,41631,20849,20782,100.3,40869,20425,20444,99.9
38003, 동부,050005, 49세,2017,41654,20564,21090,97.5,40897,20154,20743,97.2
38003, 동부,055,50~54세,2017,181827,92173,89654,102.8,178503,90396,88107,102.6
38003, 동부,055001, 50세,2017,38246,18875,19371,97.4,37589,18525,19064,97.2
38003, 동부,055002, 51세,2017,37410,19324,18086,106.8,36769,18966,17803,106.5
38003, 동부,055003, 52세,2017,37290,18656,18634,100.1,36616,18289,18327,99.8
38003, 동부,055004, 53세,2017,32769,16590,16179,102.5,32112,16249,15863,102.4
38003, 동부,055005, 54세,2017,36112,18728,17384,107.7,35417,18367,17050,107.7
38003, 동부,060,55~59세,2017,181173,91239,89934,101.5,179123,90163,88960,101.4
38003, 동부,060001, 55세,2017,37712,19165,18547,103.3,37149,18864,18285,103.2
38003, 동부,060002, 56세,2017,40054,19933,20121,99.1,39682,19741,19941,99
38003, 동부,060003, 57세,2017,38450,19129,19321,99,38014,18913,19101,99
38003, 동부,060004, 58세,2017,33450,16994,16456,103.3,33089,16803,16286,103.2
38003, 동부,060005, 59세,2017,31507,16018,15489,103.4,31189,15842,15347,103.2
38003, 동부,065,60~64세,2017,128359,63860,64499,99,127028,63176,63852,98.9
38003, 동부,065001, 60세,2017,30108,15189,14919,101.8,29792,15014,14778,101.6
38003, 동부,065002, 61세,2017,27583,13689,13894,98.5,27282,13532,13750,98.4
38003, 동부,065003, 62세,2017,27920,13618,14302,95.2,27664,13485,14179,95.1
38003, 동부,065004, 63세,2017,23170,11738,11432,102.7,22917,11625,11292,102.9
38003, 동부,065005, 64세,2017,19578,9626,9952,96.7,19373,9520,9853,96.6
38003, 동부,070,65~69세,2017,85962,41575,44387,93.7,85354,41275,44079,93.6
38003, 동부,070001, 65세,2017,21058,10335,10723,96.4,20899,10260,10639,96.4
38003, 동부,070002, 66세,2017,16437,7940,8497,93.4,16294,7871,8423,93.4
38003, 동부,070003, 67세,2017,16298,7936,8362,94.9,16164,7864,8300,94.7
38003, 동부,070004, 68세,2017,16272,7768,8504,91.3,16165,7714,8451,91.3
38003, 동부,070005, 69세,2017,15897,7596,8301,91.5,15832,7566,8266,91.5
38003, 동부,075,70~74세,2017,57984,26289,31695,82.9,57763,26188,31575,82.9
38003, 동부,075001, 70세,2017,14639,6782,7857,86.3,14564,6746,7818,86.3
38003, 동부,075002, 71세,2017,10683,5020,5663,88.6,10640,5001,5639,88.7
38003, 동부,075003, 72세,2017,10603,4849,5754,84.3,10568,4833,5735,84.3
38003, 동부,075004, 73세,2017,10972,4891,6081,80.4,10928,4870,6058,80.4
38003, 동부,075005, 74세,2017,11087,4747,6340,74.9,11063,4738,6325,74.9
38003, 동부,080,75~79세,2017,46890,18640,28250,66,46753,18585,28168,66
38003, 동부,080001, 75세,2017,11818,4962,6856,72.4,11794,4951,6843,72.4
38003, 동부,080002, 76세,2017,9939,4050,5889,68.8,9914,4041,5873,68.8
38003, 동부,080003, 77세,2017,9157,3596,5561,64.7,9126,3584,5542,64.7
38003, 동부,080004, 78세,2017,8669,3336,5333,62.6,8647,3324,5323,62.4
38003, 동부,080005, 79세,2017,7307,2696,4611,58.5,7272,2685,4587,58.5
38003, 동부,085,80~84세,2017,27825,9151,18674,49,27758,9129,18629,49
38003, 동부,085001, 80세,2017,7005,2507,4498,55.7,6987,2503,4484,55.8
38003, 동부,085002, 81세,2017,6288,2162,4126,52.4,6271,2155,4116,52.4
38003, 동부,085003, 82세,2017,5767,1909,3858,49.5,5754,1906,3848,49.5
38003, 동부,085004, 83세,2017,4814,1448,3366,43,4803,1444,3359,43
38003, 동부,085005, 84세,2017,3951,1125,2826,39.8,3943,1121,2822,39.7
38003, 동부,090,85~89세,2017,12682,2974,9708,30.6,12666,2972,9694,30.7
38003, 동부,090001, 85세,2017,3705,949,2756,34.4,3700,949,2751,34.5
38003, 동부,090002, 86세,2017,2776,661,2115,31.3,2772,660,2112,31.3
38003, 동부,090003, 87세,2017,2470,523,1947,26.9,2466,523,1943,26.9
38003, 동부,090004, 88세,2017,2146,502,1644,30.5,2144,501,1643,30.5
38003, 동부,090005, 89세,2017,1585,339,1246,27.2,1584,339,1245,27.2
38003, 동부,095,90~94세,2017,3769,718,3051,23.5,3761,717,3044,23.6
38003, 동부,095001, 90세,2017,1211,258,953,27.1,1210,258,952,27.1
38003, 동부,095002, 91세,2017,878,161,717,22.5,876,160,716,22.3
38003, 동부,095003, 92세,2017,782,140,642,21.8,778,140,638,21.9
38003, 동부,095004, 93세,2017,488,91,397,22.9,487,91,396,23
38003, 동부,095005, 94세,2017,410,68,342,19.9,410,68,342,19.9
38003, 동부,100,95~99세,2017,660,119,541,22,657,117,540,21.7
38003, 동부,100001, 95세,2017,289,48,241,19.9,289,48,241,19.9
38003, 동부,100002, 96세,2017,143,25,118,21.2,142,24,118,20.3
38003, 동부,100003, 97세,2017,121,16,105,15.2,119,15,104,14.4
38003, 동부,100004, 98세,2017,61,17,44,38.6,61,17,44,38.6
38003, 동부,100005, 99세,2017,46,13,33,39.4,46,13,33,39.4
38003, 동부,101,100세이상,2017,74,7,67,10.4,74,7,67,10.4
38003, 동부,102,15세미만,2017,316175,163717,152458,107.4,314761,163011,151750,107.4
38003, 동부,103,15~64세,2017,1612293,840845,771448,109,1567317,811583,755734,107.4
38003, 동부,104,65세이상,2017,235846,99473,136373,72.9,234786,98990,135796,72.9
38003, 동부,086,85세이상,2017,17185,3818,13367,28.6,17158,3813,13345,28.6
38003, 동부,126,평균연령,2017,39.7,38.5,41,,39.8,38.6,41,
38003, 동부,127,중위연령,2017,41,39.5,42.6,,41.3,39.8,42.7,
38030, 진주시,000,합계,2017,353209,176672,176537,100.1,347571,173208,174363,99.3
38030, 진주시,005,0~4세,2017,14156,7383,6773,109,14106,7357,6749,109
38030, 진주시,005001, 0세,2017,2390,1215,1175,103.4,2379,1210,1169,103.5
38030, 진주시,005002, 1세,2017,2710,1435,1275,112.5,2697,1428,1269,112.5
38030, 진주시,005003, 2세,2017,2956,1513,1443,104.9,2944,1506,1438,104.7
38030, 진주시,005004, 3세,2017,3098,1605,1493,107.5,3086,1598,1488,107.4
38030, 진주시,005005, 4세,2017,3002,1615,1387,116.4,3000,1615,1385,116.6
38030, 진주시,010,5~9세,2017,16598,8710,7888,110.4,16577,8700,7877,110.4
38030, 진주시,010001, 5세,2017,3321,1705,1616,105.5,3313,1702,1611,105.6
38030, 진주시,010002, 6세,2017,3399,1810,1589,113.9,3395,1808,1587,113.9
38030, 진주시,010003, 7세,2017,3289,1756,1533,114.5,3286,1754,1532,114.5
38030, 진주시,010004, 8세,2017,3172,1669,1503,111,3170,1668,1502,111.1
38030, 진주시,010005, 9세,2017,3417,1770,1647,107.5,3413,1768,1645,107.5
38030, 진주시,015,10~14세,2017,16899,8858,8041,110.2,16889,8852,8037,110.1
38030, 진주시,015001, 10세,2017,3492,1761,1731,101.7,3490,1759,1731,101.6
38030, 진주시,015002, 11세,2017,3182,1678,1504,111.6,3179,1677,1502,111.7
38030, 진주시,015003, 12세,2017,3120,1642,1478,111.1,3119,1642,1477,111.2
38030, 진주시,015004, 13세,2017,3568,1934,1634,118.4,3565,1931,1634,118.2
38030, 진주시,015005, 14세,2017,3537,1843,1694,108.8,3536,1843,1693,108.9
38030, 진주시,020,15~19세,2017,23458,12473,10985,113.5,23232,12365,10867,113.8
38030, 진주시,020001, 15세,2017,3722,2036,1686,120.8,3716,2032,1684,120.7
38030, 진주시,020002, 16세,2017,4291,2318,1973,117.5,4283,2314,1969,117.5
38030, 진주시,020003, 17세,2017,4581,2473,2108,117.3,4575,2469,2106,117.2
38030, 진주시,020004, 18세,2017,4842,2566,2276,112.7,4791,2541,2250,112.9
38030, 진주시,020005, 19세,2017,6022,3080,2942,104.7,5867,3009,2858,105.3
38030, 진주시,025,20~24세,2017,28521,15970,12551,127.2,27607,15454,12153,127.2
38030, 진주시,025001, 20세,2017,5577,2752,2825,97.4,5442,2686,2756,97.5
38030, 진주시,025002, 21세,2017,5887,3146,2741,114.8,5742,3062,2680,114.3
38030, 진주시,025003, 22세,2017,6085,3506,2579,135.9,5913,3404,2509,135.7
38030, 진주시,025004, 23세,2017,5734,3445,2289,150.5,5506,3315,2191,151.3
38030, 진주시,025005, 24세,2017,5238,3121,2117,147.4,5004,2987,2017,148.1
38030, 진주시,030,25~29세,2017,20942,11738,9204,127.5,19675,10949,8726,125.5
38030, 진주시,030001, 25세,2017,4780,2783,1997,139.4,4540,2635,1905,138.3
38030, 진주시,030002, 26세,2017,4265,2402,1863,128.9,4016,2256,1760,128.2
38030, 진주시,030003, 27세,2017,4088,2267,1821,124.5,3786,2082,1704,122.2
38030, 진주시,030004, 28세,2017,4050,2252,1798,125.3,3798,2080,1718,121.1
38030, 진주시,030005, 29세,2017,3759,2034,1725,117.9,3535,1896,1639,115.7
38030, 진주시,035,30~34세,2017,20661,10733,9928,108.1,19609,9976,9633,103.6
38030, 진주시,035001, 30세,2017,3992,2081,1911,108.9,3746,1915,1831,104.6
38030, 진주시,035002, 31세,2017,4009,2152,1857,115.9,3784,1984,1800,110.2
38030, 진주시,035003, 32세,2017,3847,2056,1791,114.8,3632,1899,1733,109.6
38030, 진주시,035004, 33세,2017,4184,2114,2070,102.1,4002,1989,2013,98.8
38030, 진주시,035005, 34세,2017,4629,2330,2299,101.3,4445,2189,2256,97
38030, 진주시,040,35~39세,2017,25375,12855,12520,102.7,24715,12391,12324,100.5
38030, 진주시,040001, 35세,2017,5037,2552,2485,102.7,4872,2431,2441,99.6
38030, 진주시,040002, 36세,2017,5027,2538,2489,102,4876,2435,2441,99.8
38030, 진주시,040003, 37세,2017,5330,2706,2624,103.1,5197,2614,2583,101.2
38030, 진주시,040004, 38세,2017,5149,2638,2511,105.1,5029,2560,2469,103.7
38030, 진주시,040005, 39세,2017,4832,2421,2411,100.4,4741,2351,2390,98.4
38030, 진주시,045,40~44세,2017,26784,13366,13418,99.6,26421,13138,13283,98.9
38030, 진주시,045001, 40세,2017,4826,2409,2417,99.7,4750,2350,2400,97.9
38030, 진주시,045002, 41세,2017,5036,2524,2512,100.5,4934,2463,2471,99.7
38030, 진주시,045003, 42세,2017,5210,2612,2598,100.5,5142,2569,2573,99.8
38030, 진주시,045004, 43세,2017,5703,2798,2905,96.3,5646,2764,2882,95.9
38030, 진주시,045005, 44세,2017,6009,3023,2986,101.2,5949,2992,2957,101.2
38030, 진주시,050,45~49세,2017,30698,15392,15306,100.6,30347,15190,15157,100.2
38030, 진주시,050001, 45세,2017,5696,2908,2788,104.3,5612,2859,2753,103.9
38030, 진주시,050002, 46세,2017,6120,3053,3067,99.5,6060,3016,3044,99.1
38030, 진주시,050003, 47세,2017,6346,3160,3186,99.2,6279,3116,3163,98.5
38030, 진주시,050004, 48세,2017,6349,3170,3179,99.7,6280,3135,3145,99.7
38030, 진주시,050005, 49세,2017,6187,3101,3086,100.5,6116,3064,3052,100.4
38030, 진주시,055,50~54세,2017,26909,13444,13465,99.8,26604,13295,13309,99.9
38030, 진주시,055001, 50세,2017,5697,2773,2924,94.8,5629,2740,2889,94.8
38030, 진주시,055002, 51세,2017,5516,2870,2646,108.5,5457,2838,2619,108.4
38030, 진주시,055003, 52세,2017,5509,2720,2789,97.5,5460,2694,2766,97.4
38030, 진주시,055004, 53세,2017,4744,2330,2414,96.5,4676,2297,2379,96.6
38030, 진주시,055005, 54세,2017,5443,2751,2692,102.2,5382,2726,2656,102.6
38030, 진주시,060,55~59세,2017,29334,14336,14998,95.6,29138,14236,14902,95.5
38030, 진주시,060001, 55세,2017,5881,2945,2936,100.3,5826,2918,2908,100.3
38030, 진주시,060002, 56세,2017,6748,3286,3462,94.9,6715,3269,3446,94.9
38030, 진주시,060003, 57세,2017,6226,2950,3276,90,6185,2931,3254,90.1
38030, 진주시,060004, 58세,2017,5218,2572,2646,97.2,5188,2553,2635,96.9
38030, 진주시,060005, 59세,2017,5261,2583,2678,96.5,5224,2565,2659,96.5
38030, 진주시,065,60~64세,2017,22202,10890,11312,96.3,22084,10833,11251,96.3
38030, 진주시,065001, 60세,2017,5057,2540,2517,100.9,5024,2525,2499,101
38030, 진주시,065002, 61세,2017,4658,2351,2307,101.9,4629,2335,2294,101.8
38030, 진주시,065003, 62세,2017,4826,2242,2584,86.8,4806,2231,2575,86.6
38030, 진주시,065004, 63세,2017,4183,2119,2064,102.7,4162,2113,2049,103.1
38030, 진주시,065005, 64세,2017,3478,1638,1840,89,3463,1629,1834,88.8
38030, 진주시,070,65~69세,2017,16268,7630,8638,88.3,16207,7598,8609,88.3
38030, 진주시,070001, 65세,2017,3761,1777,1984,89.6,3742,1765,1977,89.3
38030, 진주시,070002, 66세,2017,2970,1416,1554,91.1,2956,1407,1549,90.8
38030, 진주시,070003, 67세,2017,3230,1521,1709,89,3215,1515,1700,89.1
38030, 진주시,070004, 68세,2017,3171,1453,1718,84.6,3163,1449,1714,84.5
38030, 진주시,070005, 69세,2017,3136,1463,1673,87.4,3131,1462,1669,87.6
38030, 진주시,075,70~74세,2017,12272,5538,6734,82.2,12247,5526,6721,82.2
38030, 진주시,075001, 70세,2017,2931,1380,1551,89,2922,1376,1546,89
38030, 진주시,075002, 71세,2017,2266,1045,1221,85.6,2262,1043,1219,85.6
38030, 진주시,075003, 72세,2017,2280,1043,1237,84.3,2275,1041,1234,84.4
38030, 진주시,075004, 73세,2017,2399,1051,1348,78,2393,1047,1346,77.8
38030, 진주시,075005, 74세,2017,2396,1019,1377,74,2395,1019,1376,74.1
38030, 진주시,080,75~79세,2017,10869,4243,6626,64,10857,4237,6620,64
38030, 진주시,080001, 75세,2017,2609,1076,1533,70.2,2605,1074,1531,70.2
38030, 진주시,080002, 76세,2017,2279,941,1338,70.3,2277,940,1337,70.3
38030, 진주시,080003, 77세,2017,2164,833,1331,62.6,2163,832,1331,62.5
38030, 진주시,080004, 78세,2017,2056,770,1286,59.9,2052,768,1284,59.8
38030, 진주시,080005, 79세,2017,1761,623,1138,54.7,1760,623,1137,54.8
38030, 진주시,085,80~84세,2017,6768,2119,4649,45.6,6763,2118,4645,45.6
38030, 진주시,085001, 80세,2017,1642,588,1054,55.8,1640,588,1052,55.9
38030, 진주시,085002, 81세,2017,1550,498,1052,47.3,1548,497,1051,47.3
38030, 진주시,085003, 82세,2017,1406,431,975,44.2,1406,431,975,44.2
38030, 진주시,085004, 83세,2017,1201,354,847,41.8,1201,354,847,41.8
38030, 진주시,085005, 84세,2017,969,248,721,34.4,968,248,720,34.4
38030, 진주시,090,85~89세,2017,3269,762,2507,30.4,3268,761,2507,30.4
38030, 진주시,090001, 85세,2017,946,244,702,34.8,946,244,702,34.8
38030, 진주시,090002, 86세,2017,729,181,548,33,729,181,548,33
38030, 진주시,090003, 87세,2017,632,122,510,23.9,632,122,510,23.9
38030, 진주시,090004, 88세,2017,536,123,413,29.8,536,123,413,29.8
38030, 진주시,090005, 89세,2017,426,92,334,27.5,425,91,334,27.2
38030, 진주시,095,90~94세,2017,996,192,804,23.9,996,192,804,23.9
38030, 진주시,095001, 90세,2017,322,62,260,23.8,322,62,260,23.8
38030, 진주시,095002, 91세,2017,233,47,186,25.3,233,47,186,25.3
38030, 진주시,095003, 92세,2017,214,38,176,21.6,214,38,176,21.6
38030, 진주시,095004, 93세,2017,124,29,95,30.5,124,29,95,30.5
38030, 진주시,095005, 94세,2017,103,16,87,18.4,103,16,87,18.4
38030, 진주시,100,95~99세,2017,205,35,170,20.6,204,35,169,20.7
38030, 진주시,100001, 95세,2017,86,13,73,17.8,86,13,73,17.8
38030, 진주시,100002, 96세,2017,55,10,45,22.2,55,10,45,22.2
38030, 진주시,100003, 97세,2017,34,X,30,13.3,33,X,29,13.8
38030, 진주시,100004, 98세,2017,17,6,11,54.5,17,6,11,54.5
38030, 진주시,100005, 99세,2017,13,X,11,18.2,13,X,11,18.2
38030, 진주시,101,100세이상,2017,25,5,20,25,25,5,20,25
38030, 진주시,102,15세미만,2017,47653,24951,22702,109.9,47572,24909,22663,109.9
38030, 진주시,103,15~64세,2017,254884,131197,123687,106.1,249432,127827,121605,105.1
38030, 진주시,104,65세이상,2017,50672,20524,30148,68.1,50567,20472,30095,68
38030, 진주시,086,85세이상,2017,4495,994,3501,28.4,4493,993,3500,28.4
38030, 진주시,126,평균연령,2017,41,39.3,42.8,,41.1,39.4,42.9,
38030, 진주시,127,중위연령,2017,42,39.8,44,,42.3,40.2,44.2,
38050, 통영시,000,합계,2017,132962,68376,64586,105.9,128549,64913,63636,102
38050, 통영시,005,0~4세,2017,5618,2829,2789,101.4,5608,2821,2787,101.2
38050, 통영시,005001, 0세,2017,899,437,462,94.6,897,435,462,94.2
38050, 통영시,005002, 1세,2017,1049,528,521,101.3,1049,528,521,101.3
38050, 통영시,005003, 2세,2017,1203,598,605,98.8,1200,595,605,98.3
38050, 통영시,005004, 3세,2017,1204,600,604,99.3,1204,600,604,99.3
38050, 통영시,005005, 4세,2017,1263,666,597,111.6,1258,663,595,111.4
38050, 통영시,010,5~9세,2017,7284,3732,3552,105.1,7272,3724,3548,105
38050, 통영시,010001, 5세,2017,1454,730,724,100.8,1450,727,723,100.6
38050, 통영시,010002, 6세,2017,1508,771,737,104.6,1504,768,736,104.3
38050, 통영시,010003, 7세,2017,1496,778,718,108.4,1496,778,718,108.4
38050, 통영시,010004, 8세,2017,1381,729,652,111.8,1380,728,652,111.7
38050, 통영시,010005, 9세,2017,1445,724,721,100.4,1442,723,719,100.6
38050, 통영시,015,10~14세,2017,6175,3219,2956,108.9,6168,3216,2952,108.9
38050, 통영시,015001, 10세,2017,1372,697,675,103.3,1372,697,675,103.3
38050, 통영시,015002, 11세,2017,1177,617,560,110.2,1175,616,559,110.2
38050, 통영시,015003, 12세,2017,1183,616,567,108.6,1183,616,567,108.6
38050, 통영시,015004, 13세,2017,1184,632,552,114.5,1180,630,550,114.5
38050, 통영시,015005, 14세,2017,1259,657,602,109.1,1258,657,601,109.3
38050, 통영시,020,15~19세,2017,6439,3492,2947,118.5,6418,3479,2939,118.4
38050, 통영시,020001, 15세,2017,1290,669,621,107.7,1289,668,621,107.6
38050, 통영시,020002, 16세,2017,1421,732,689,106.2,1419,731,688,106.3
38050, 통영시,020003, 17세,2017,1527,768,759,101.2,1522,765,757,101.1
38050, 통영시,020004, 18세,2017,1321,734,587,125,1317,731,586,124.7
38050, 통영시,020005, 19세,2017,880,589,291,202.4,871,584,287,203.5
38050, 통영시,025,20~24세,2017,5861,3618,2243,161.3,5494,3347,2147,155.9
38050, 통영시,025001, 20세,2017,1106,739,367,201.4,1082,721,361,199.7
38050, 통영시,025002, 21세,2017,1220,798,422,189.1,1182,773,409,189
38050, 통영시,025003, 22세,2017,1151,701,450,155.8,1093,667,426,156.6
38050, 통영시,025004, 23세,2017,1135,666,469,142,1038,593,445,133.3
38050, 통영시,025005, 24세,2017,1249,714,535,133.5,1099,593,506,117.2
38050, 통영시,030,25~29세,2017,6194,3509,2685,130.7,5287,2757,2530,109
38050, 통영시,030001, 25세,2017,1269,699,570,122.6,1118,576,542,106.3
38050, 통영시,030002, 26세,2017,1187,674,513,131.4,1012,530,482,110
38050, 통영시,030003, 27세,2017,1235,681,554,122.9,1032,518,514,100.8
38050, 통영시,030004, 28세,2017,1243,712,531,134.1,1056,555,501,110.8
38050, 통영시,030005, 29세,2017,1260,743,517,143.7,1069,578,491,117.7
38050, 통영시,035,30~34세,2017,8201,4549,3652,124.6,7210,3698,3512,105.3
38050, 통영시,035001, 30세,2017,1411,783,628,124.7,1188,604,584,103.4
38050, 통영시,035002, 31세,2017,1415,817,598,136.6,1230,660,570,115.8
38050, 통영시,035003, 32세,2017,1531,844,687,122.9,1326,663,663,100
38050, 통영시,035004, 33세,2017,1865,1050,815,128.8,1658,867,791,109.6
38050, 통영시,035005, 34세,2017,1979,1055,924,114.2,1808,904,904,100
38050, 통영시,040,35~39세,2017,11316,6268,5048,124.2,10601,5644,4957,113.9
38050, 통영시,040001, 35세,2017,2289,1266,1023,123.8,2093,1099,994,110.6
38050, 통영시,040002, 36세,2017,2297,1253,1044,120,2155,1125,1030,109.2
38050, 통영시,040003, 37세,2017,2454,1358,1096,123.9,2333,1253,1080,116
38050, 통영시,040004, 38세,2017,2206,1225,981,124.9,2081,1115,966,115.4
38050, 통영시,040005, 39세,2017,2070,1166,904,129,1939,1052,887,118.6
38050, 통영시,045,40~44세,2017,10979,6083,4896,124.2,10500,5696,4804,118.6
38050, 통영시,045001, 40세,2017,2132,1159,973,119.1,2019,1062,957,111
38050, 통영시,045002, 41세,2017,2027,1155,872,132.5,1927,1069,858,124.6
38050, 통영시,045003, 42세,2017,2231,1243,988,125.8,2128,1162,966,120.3
38050, 통영시,045004, 43세,2017,2219,1248,971,128.5,2134,1180,954,123.7
38050, 통영시,045005, 44세,2017,2370,1278,1092,117,2292,1223,1069,114.4
38050, 통영시,050,45~49세,2017,11498,6208,5290,117.4,11122,5940,5182,114.6
38050, 통영시,050001, 45세,2017,2290,1274,1016,125.4,2189,1198,991,120.9
38050, 통영시,050002, 46세,2017,2334,1246,1088,114.5,2248,1180,1068,110.5
38050, 통영시,050003, 47세,2017,2318,1258,1060,118.7,2247,1206,1041,115.9
38050, 통영시,050004, 48세,2017,2224,1181,1043,113.2,2170,1152,1018,113.2
38050, 통영시,050005, 49세,2017,2332,1249,1083,115.3,2268,1204,1064,113.2
38050, 통영시,055,50~54세,2017,10255,5235,5020,104.3,10009,5103,4906,104
38050, 통영시,055001, 50세,2017,2115,1071,1044,102.6,2067,1046,1021,102.4
38050, 통영시,055002, 51세,2017,2021,1016,1005,101.1,1980,987,993,99.4
38050, 통영시,055003, 52세,2017,2081,1054,1027,102.6,2018,1025,993,103.2
38050, 통영시,055004, 53세,2017,1903,985,918,107.3,1858,961,897,107.1
38050, 통영시,055005, 54세,2017,2135,1109,1026,108.1,2086,1084,1002,108.2
38050, 통영시,060,55~59세,2017,12193,5954,6239,95.4,12057,5876,6181,95.1
38050, 통영시,060001, 55세,2017,2395,1178,1217,96.8,2364,1160,1204,96.3
38050, 통영시,060002, 56세,2017,2636,1276,1360,93.8,2609,1259,1350,93.3
38050, 통영시,060003, 57세,2017,2632,1258,1374,91.6,2604,1244,1360,91.5
38050, 통영시,060004, 58세,2017,2353,1163,1190,97.7,2327,1148,1179,97.4
38050, 통영시,060005, 59세,2017,2177,1079,1098,98.3,2153,1065,1088,97.9
38050, 통영시,065,60~64세,2017,9639,4686,4953,94.6,9556,4645,4911,94.6
38050, 통영시,065001, 60세,2017,2128,1024,1104,92.8,2110,1018,1092,93.2
38050, 통영시,065002, 61세,2017,2122,1050,1072,97.9,2110,1044,1066,97.9
38050, 통영시,065003, 62세,2017,2087,1008,1079,93.4,2068,998,1070,93.3
38050, 통영시,065004, 63세,2017,1757,860,897,95.9,1741,852,889,95.8
38050, 통영시,065005, 64세,2017,1545,744,801,92.9,1527,733,794,92.3
38050, 통영시,070,65~69세,2017,7423,3683,3740,98.5,7383,3667,3716,98.7
38050, 통영시,070001, 65세,2017,1764,902,862,104.6,1754,897,857,104.7
38050, 통영시,070002, 66세,2017,1479,727,752,96.7,1471,724,747,96.9
38050, 통영시,070003, 67세,2017,1306,645,661,97.6,1299,641,658,97.4
38050, 통영시,070004, 68세,2017,1424,720,704,102.3,1419,719,700,102.7
38050, 통영시,070005, 69세,2017,1450,689,761,90.5,1440,686,754,91
38050, 통영시,075,70~74세,2017,5121,2367,2754,85.9,5108,2360,2748,85.9
38050, 통영시,075001, 70세,2017,1265,609,656,92.8,1261,608,653,93.1
38050, 통영시,075002, 71세,2017,855,423,432,97.9,849,418,431,97
38050, 통영시,075003, 72세,2017,1026,481,545,88.3,1024,480,544,88.2
38050, 통영시,075004, 73세,2017,932,401,531,75.5,931,401,530,75.7
38050, 통영시,075005, 74세,2017,1043,453,590,76.8,1043,453,590,76.8
38050, 통영시,080,75~79세,2017,4422,1675,2747,61,4419,1674,2745,61
38050, 통영시,080001, 75세,2017,1152,464,688,67.4,1152,464,688,67.4
38050, 통영시,080002, 76세,2017,972,379,593,63.9,972,379,593,63.9
38050, 통영시,080003, 77세,2017,854,326,528,61.7,853,326,527,61.9
38050, 통영시,080004, 78세,2017,793,302,491,61.5,792,301,491,61.3
38050, 통영시,080005, 79세,2017,651,204,447,45.6,650,204,446,45.7
38050, 통영시,085,80~84세,2017,2676,897,1779,50.4,2671,895,1776,50.4
38050, 통영시,085001, 80세,2017,678,243,435,55.9,678,243,435,55.9
38050, 통영시,085002, 81세,2017,608,219,389,56.3,607,219,388,56.4
38050, 통영시,085003, 82세,2017,558,194,364,53.3,557,194,363,53.4
38050, 통영시,085004, 83세,2017,435,130,305,42.6,433,128,305,42
38050, 통영시,085005, 84세,2017,397,111,286,38.8,396,111,285,38.9
38050, 통영시,090,85~89세,2017,1244,307,937,32.8,1244,307,937,32.8
38050, 통영시,090001, 85세,2017,356,98,258,38,356,98,258,38
38050, 통영시,090002, 86세,2017,301,72,229,31.4,301,72,229,31.4
38050, 통영시,090003, 87세,2017,234,56,178,31.5,234,56,178,31.5
38050, 통영시,090004, 88세,2017,191,39,152,25.7,191,39,152,25.7
38050, 통영시,090005, 89세,2017,162,42,120,35,162,42,120,35
38050, 통영시,095,90~94세,2017,355,59,296,19.9,353,58,295,19.7
38050, 통영시,095001, 90세,2017,127,19,108,17.6,126,19,107,17.8
38050, 통영시,095002, 91세,2017,80,15,65,23.1,79,14,65,21.5
38050, 통영시,095003, 92세,2017,74,15,59,25.4,74,15,59,25.4
38050, 통영시,095004, 93세,2017,39,6,33,18.2,39,6,33,18.2
38050, 통영시,095005, 94세,2017,35,X,31,12.9,35,X,31,12.9
38050, 통영시,100,95~99세,2017,63,6,57,10.5,63,6,57,10.5
38050, 통영시,100001, 95세,2017,36,X,32,12.5,36,X,32,12.5
38050, 통영시,100002, 96세,2017,13,X,12,8.3,13,X,12,8.3
38050, 통영시,100003, 97세,2017,X,X,X,0,X,X,X,0
38050, 통영시,100004, 98세,2017,8,X,8,0,8,X,8,0
38050, 통영시,100005, 99세,2017,X,X,X,100,X,X,X,100
38050, 통영시,101,100세이상,2017,6,X,6,0,6,X,6,0
38050, 통영시,102,15세미만,2017,19077,9780,9297,105.2,19048,9761,9287,105.1
38050, 통영시,103,15~64세,2017,92575,49602,42973,115.4,88254,46185,42069,109.8
38050, 통영시,104,65세이상,2017,21310,8994,12316,73,21247,8967,12280,73
38050, 통영시,086,85세이상,2017,1668,372,1296,28.7,1666,371,1295,28.6
38050, 통영시,126,평균연령,2017,42.8,41.2,44.4,,43,41.5,44.5,
38050, 통영시,127,중위연령,2017,44.3,42.5,46.5,,44.9,43.4,46.6,
38060, 사천시,000,합계,2017,111655,57102,54553,104.7,108077,54372,53705,101.2
38060, 사천시,005,0~4세,2017,4602,2384,2218,107.5,4577,2369,2208,107.3
38060, 사천시,005001, 0세,2017,768,395,373,105.9,765,393,372,105.6
38060, 사천시,005002, 1세,2017,907,484,423,114.4,900,477,423,112.8
38060, 사천시,005003, 2세,2017,927,456,471,96.8,921,453,468,96.8
38060, 사천시,005004, 3세,2017,1021,516,505,102.2,1016,515,501,102.8
38060, 사천시,005005, 4세,2017,979,533,446,119.5,975,531,444,119.6
38060, 사천시,010,5~9세,2017,5563,2857,2706,105.6,5540,2846,2694,105.6
38060, 사천시,010001, 5세,2017,1100,562,538,104.5,1093,561,532,105.5
38060, 사천시,010002, 6세,2017,1129,613,516,118.8,1127,611,516,118.4
38060, 사천시,010003, 7세,2017,1117,563,554,101.6,1113,560,553,101.3
38060, 사천시,010004, 8세,2017,1103,544,559,97.3,1098,542,556,97.5
38060, 사천시,010005, 9세,2017,1114,575,539,106.7,1109,572,537,106.5
38060, 사천시,015,10~14세,2017,4943,2550,2393,106.6,4927,2545,2382,106.8
38060, 사천시,015001, 10세,2017,1071,546,525,104,1066,544,522,104.2
38060, 사천시,015002, 11세,2017,993,514,479,107.3,990,513,477,107.5
38060, 사천시,015003, 12세,2017,903,454,449,101.1,900,453,447,101.3
38060, 사천시,015004, 13세,2017,978,506,472,107.2,975,505,470,107.4
38060, 사천시,015005, 14세,2017,998,530,468,113.2,996,530,466,113.7
38060, 사천시,020,15~19세,2017,5253,2921,2332,125.3,5226,2905,2321,125.2
38060, 사천시,020001, 15세,2017,1018,516,502,102.8,1014,513,501,102.4
38060, 사천시,020002, 16세,2017,1171,614,557,110.2,1169,614,555,110.6
38060, 사천시,020003, 17세,2017,1284,684,600,114,1278,680,598,113.7
38060, 사천시,020004, 18세,2017,1017,564,453,124.5,1012,562,450,124.9
38060, 사천시,020005, 19세,2017,763,543,220,246.8,753,536,217,247
38060, 사천시,025,20~24세,2017,5072,3390,1682,201.5,4783,3180,1603,198.4
38060, 사천시,025001, 20세,2017,948,674,274,246,935,666,269,247.6
38060, 사천시,025002, 21세,2017,995,721,274,263.1,969,703,266,264.3
38060, 사천시,025003, 22세,2017,1095,744,351,212,1033,697,336,207.4
38060, 사천시,025004, 23세,2017,1060,668,392,170.4,971,607,364,166.8
38060, 사천시,025005, 24세,2017,974,583,391,149.1,875,507,368,137.8
38060, 사천시,030,25~29세,2017,5558,3402,2156,157.8,4824,2809,2015,139.4
38060, 사천시,030001, 25세,2017,1083,618,465,132.9,964,530,434,122.1
38060, 사천시,030002, 26세,2017,1085,689,396,174,949,574,375,153.1
38060, 사천시,030003, 27세,2017,1160,706,454,155.5,998,579,419,138.2
38060, 사천시,030004, 28세,2017,1171,728,443,164.3,1018,604,414,145.9
38060, 사천시,030005, 29세,2017,1059,661,398,166.1,895,522,373,139.9
38060, 사천시,035,30~34세,2017,6413,3629,2784,130.4,5667,3003,2664,112.7
38060, 사천시,035001, 30세,2017,1096,620,476,130.3,936,488,448,108.9
38060, 사천시,035002, 31세,2017,1219,731,488,149.8,1063,597,466,128.1
38060, 사천시,035003, 32세,2017,1178,651,527,123.5,1027,529,498,106.2
38060, 사천시,035004, 33세,2017,1350,771,579,133.2,1205,652,553,117.9
38060, 사천시,035005, 34세,2017,1570,856,714,119.9,1436,737,699,105.4
38060, 사천시,040,35~39세,2017,8843,4706,4137,113.8,8270,4233,4037,104.9
38060, 사천시,040001, 35세,2017,1757,970,787,123.3,1615,845,770,109.7
38060, 사천시,040002, 36세,2017,1779,937,842,111.3,1646,834,812,102.7
38060, 사천시,040003, 37세,2017,1845,961,884,108.7,1741,871,870,100.1
38060, 사천시,040004, 38세,2017,1769,930,839,110.8,1675,855,820,104.3
38060, 사천시,040005, 39세,2017,1693,908,785,115.7,1593,828,765,108.2
38060, 사천시,045,40~44세,2017,8873,4845,4028,120.3,8441,4500,3941,114.2
38060, 사천시,045001, 40세,2017,1727,942,785,120,1638,871,767,113.6
38060, 사천시,045002, 41세,2017,1649,936,713,131.3,1555,863,692,124.7
38060, 사천시,045003, 42세,2017,1724,892,832,107.2,1626,816,810,100.7
38060, 사천시,045004, 43세,2017,1824,1007,817,123.3,1752,949,803,118.2
38060, 사천시,045005, 44세,2017,1949,1068,881,121.2,1870,1001,869,115.2
38060, 사천시,050,45~49세,2017,9258,5046,4212,119.8,8987,4855,4132,117.5
38060, 사천시,050001, 45세,2017,1853,1052,801,131.3,1781,1002,779,128.6
38060, 사천시,050002, 46세,2017,1960,1086,874,124.3,1901,1041,860,121
38060, 사천시,050003, 47세,2017,1835,986,849,116.1,1778,948,830,114.2
38060, 사천시,050004, 48세,2017,1855,986,869,113.5,1814,957,857,111.7
38060, 사천시,050005, 49세,2017,1755,936,819,114.3,1713,907,806,112.5
38060, 사천시,055,50~54세,2017,8201,4354,3847,113.2,8013,4246,3767,112.7
38060, 사천시,055001, 50세,2017,1684,856,828,103.4,1645,834,811,102.8
38060, 사천시,055002, 51세,2017,1710,937,773,121.2,1678,919,759,121.1
38060, 사천시,055003, 52세,2017,1709,898,811,110.7,1666,873,793,110.1
38060, 사천시,055004, 53세,2017,1440,751,689,109,1413,738,675,109.3
38060, 사천시,055005, 54세,2017,1658,912,746,122.3,1611,882,729,121
38060, 사천시,060,55~59세,2017,9472,4704,4768,98.7,9328,4626,4702,98.4
38060, 사천시,060001, 55세,2017,1877,984,893,110.2,1837,960,877,109.5
38060, 사천시,060002, 56세,2017,2112,1045,1067,97.9,2075,1028,1047,98.2
38060, 사천시,060003, 57세,2017,2008,981,1027,95.5,1987,969,1018,95.2
38060, 사천시,060004, 58세,2017,1718,841,877,95.9,1690,826,864,95.6
38060, 사천시,060005, 59세,2017,1757,853,904,94.4,1739,843,896,94.1
38060, 사천시,065,60~64세,2017,7903,3822,4081,93.7,7844,3787,4057,93.3
38060, 사천시,065001, 60세,2017,1732,823,909,90.5,1717,814,903,90.1
38060, 사천시,065002, 61세,2017,1611,793,818,96.9,1596,783,813,96.3
38060, 사천시,065003, 62세,2017,1820,854,966,88.4,1806,847,959,88.3
38060, 사천시,065004, 63세,2017,1571,806,765,105.4,1565,803,762,105.4
38060, 사천시,065005, 64세,2017,1169,546,623,87.6,1160,540,620,87.1
38060, 사천시,070,65~69세,2017,6372,3002,3370,89.1,6339,2984,3355,88.9
38060, 사천시,070001, 65세,2017,1405,679,726,93.5,1396,674,722,93.4
38060, 사천시,070002, 66세,2017,1222,556,666,83.5,1217,555,662,83.8
38060, 사천시,070003, 67세,2017,1251,596,655,91,1244,593,651,91.1
38060, 사천시,070004, 68세,2017,1245,581,664,87.5,1238,576,662,87
38060, 사천시,070005, 69세,2017,1249,590,659,89.5,1244,586,658,89.1
38060, 사천시,075,70~74세,2017,5052,2187,2865,76.3,5041,2182,2859,76.3
38060, 사천시,075001, 70세,2017,1207,548,659,83.2,1202,545,657,83
38060, 사천시,075002, 71세,2017,908,415,493,84.2,903,413,490,84.3
38060, 사천시,075003, 72세,2017,982,400,582,68.7,982,400,582,68.7
38060, 사천시,075004, 73세,2017,968,406,562,72.2,967,406,561,72.4
38060, 사천시,075005, 74세,2017,987,418,569,73.5,987,418,569,73.5
38060, 사천시,080,75~79세,2017,4765,1804,2961,60.9,4761,1803,2958,61
38060, 사천시,080001, 75세,2017,1102,416,686,60.6,1102,416,686,60.6
38060, 사천시,080002, 76세,2017,1032,428,604,70.9,1031,427,604,70.7
38060, 사천시,080003, 77세,2017,924,328,596,55,922,328,594,55.2
38060, 사천시,080004, 78세,2017,926,358,568,63,925,358,567,63.1
38060, 사천시,080005, 79세,2017,781,274,507,54,781,274,507,54
38060, 사천시,085,80~84세,2017,3279,1061,2218,47.8,3278,1061,2217,47.9
38060, 사천시,085001, 80세,2017,814,301,513,58.7,813,301,512,58.8
38060, 사천시,085002, 81세,2017,796,261,535,48.8,796,261,535,48.8
38060, 사천시,085003, 82세,2017,641,202,439,46,641,202,439,46
38060, 사천시,085004, 83세,2017,563,168,395,42.5,563,168,395,42.5
38060, 사천시,085005, 84세,2017,465,129,336,38.4,465,129,336,38.4
38060, 사천시,090,85~89세,2017,1573,336,1237,27.2,1571,336,1235,27.2
38060, 사천시,090001, 85세,2017,476,114,362,31.5,476,114,362,31.5
38060, 사천시,090002, 86세,2017,373,84,289,29.1,372,84,288,29.2
38060, 사천시,090003, 87세,2017,281,59,222,26.6,281,59,222,26.6
38060, 사천시,090004, 88세,2017,250,40,210,19,249,40,209,19.1
38060, 사천시,090005, 89세,2017,193,39,154,25.3,193,39,154,25.3
38060, 사천시,095,90~94세,2017,543,85,458,18.6,543,85,458,18.6
38060, 사천시,095001, 90세,2017,182,36,146,24.7,182,36,146,24.7
38060, 사천시,095002, 91세,2017,120,14,106,13.2,120,14,106,13.2
38060, 사천시,095003, 92세,2017,124,22,102,21.6,124,22,102,21.6
38060, 사천시,095004, 93세,2017,66,X,62,6.5,66,X,62,6.5
38060, 사천시,095005, 94세,2017,51,9,42,21.4,51,9,42,21.4
38060, 사천시,100,95~99세,2017,105,17,88,19.3,105,17,88,19.3
38060, 사천시,100001, 95세,2017,48,X,44,9.1,48,X,44,9.1
38060, 사천시,100002, 96세,2017,26,6,20,30,26,6,20,30
38060, 사천시,100003, 97세,2017,16,X,12,33.3,16,X,12,33.3
38060, 사천시,100004, 98세,2017,10,X,7,42.9,10,X,7,42.9
38060, 사천시,100005, 99세,2017,5,X,5,0,5,X,5,0
38060, 사천시,101,100세이상,2017,12,X,12,0,12,X,12,0
38060, 사천시,102,15세미만,2017,15108,7791,7317,106.5,15044,7760,7284,106.5
38060, 사천시,103,15~64세,2017,74846,40819,34027,120,71383,38144,33239,114.8
38060, 사천시,104,65세이상,2017,21701,8492,13209,64.3,21650,8468,13182,64.2
38060, 사천시,086,85세이상,2017,2233,438,1795,24.4,2231,438,1793,24.4
38060, 사천시,126,평균연령,2017,44.2,41.7,46.7,,44.4,42,46.8,
38060, 사천시,127,중위연령,2017,45.4,42.9,48.4,,46,43.8,48.6,
38070, 김해시,000,합계,2017,536456,275718,260738,105.7,513069,258718,254351,101.7
38070, 김해시,005,0~4세,2017,25358,12939,12419,104.2,25076,12800,12276,104.3
38070, 김해시,005001, 0세,2017,4134,2118,2016,105.1,4080,2093,1987,105.3
38070, 김해시,005002, 1세,2017,4923,2522,2401,105,4864,2501,2363,105.8
38070, 김해시,005003, 2세,2017,5288,2722,2566,106.1,5231,2690,2541,105.9
38070, 김해시,005004, 3세,2017,5539,2799,2740,102.2,5480,2770,2710,102.2
38070, 김해시,005005, 4세,2017,5474,2778,2696,103,5421,2746,2675,102.7
38070, 김해시,010,5~9세,2017,29574,15060,14514,103.8,29382,14967,14415,103.8
38070, 김해시,010001, 5세,2017,6063,3020,3043,99.2,6014,2996,3018,99.3
38070, 김해시,010002, 6세,2017,5913,2971,2942,101,5874,2950,2924,100.9
38070, 김해시,010003, 7세,2017,5852,3009,2843,105.8,5813,2990,2823,105.9
38070, 김해시,010004, 8세,2017,5680,2932,2748,106.7,5650,2919,2731,106.9
38070, 김해시,010005, 9세,2017,6066,3128,2938,106.5,6031,3112,2919,106.6
38070, 김해시,015,10~14세,2017,29972,15716,14256,110.2,29859,15660,14199,110.3
38070, 김해시,015001, 10세,2017,6355,3247,3108,104.5,6329,3237,3092,104.7
38070, 김해시,015002, 11세,2017,5780,3015,2765,109,5756,3001,2755,108.9
38070, 김해시,015003, 12세,2017,5674,3012,2662,113.1,5647,2997,2650,113.1
38070, 김해시,015004, 13세,2017,5988,3169,2819,112.4,5973,3161,2812,112.4
38070, 김해시,015005, 14세,2017,6175,3273,2902,112.8,6154,3264,2890,112.9
38070, 김해시,020,15~19세,2017,33954,17874,16080,111.2,33650,17698,15952,110.9
38070, 김해시,020001, 15세,2017,6234,3255,2979,109.3,6208,3244,2964,109.4
38070, 김해시,020002, 16세,2017,6808,3552,3256,109.1,6784,3533,3251,108.7
38070, 김해시,020003, 17세,2017,7313,3760,3553,105.8,7288,3745,3543,105.7
38070, 김해시,020004, 18세,2017,7101,3745,3356,111.6,7051,3717,3334,111.5
38070, 김해시,020005, 19세,2017,6498,3562,2936,121.3,6319,3459,2860,120.9
38070, 김해시,025,20~24세,2017,36125,20447,15678,130.4,33794,18707,15087,124
38070, 김해시,025001, 20세,2017,7145,4011,3134,128,6918,3877,3041,127.5
38070, 김해시,025002, 21세,2017,7357,4229,3128,135.2,7043,4009,3034,132.1
38070, 김해시,025003, 22세,2017,7283,4078,3205,127.2,6841,3741,3100,120.7
38070, 김해시,025004, 23세,2017,7205,4001,3204,124.9,6605,3544,3061,115.8
38070, 김해시,025005, 24세,2017,7135,4128,3007,137.3,6387,3536,2851,124
38070, 김해시,030,25~29세,2017,32653,18538,14115,131.3,27533,14581,12952,112.6
38070, 김해시,030001, 25세,2017,7070,3987,3083,129.3,6149,3271,2878,113.7
38070, 김해시,030002, 26세,2017,6760,3820,2940,129.9,5762,3065,2697,113.6
38070, 김해시,030003, 27세,2017,6483,3772,2711,139.1,5398,2910,2488,117
38070, 김해시,030004, 28세,2017,6177,3526,2651,133,5162,2759,2403,114.8
38070, 김해시,030005, 29세,2017,6163,3433,2730,125.8,5062,2576,2486,103.6
38070, 김해시,035,30~34세,2017,35570,19659,15911,123.6,30356,15505,14851,104.4
38070, 김해시,035001, 30세,2017,6347,3582,2765,129.5,5164,2661,2503,106.3
38070, 김해시,035002, 31세,2017,6640,3714,2926,126.9,5539,2854,2685,106.3
38070, 김해시,035003, 32세,2017,6959,3935,3024,130.1,5893,3054,2839,107.6
38070, 김해시,035004, 33세,2017,7383,4039,3344,120.8,6398,3244,3154,102.9
38070, 김해시,035005, 34세,2017,8241,4389,3852,113.9,7362,3692,3670,100.6
38070, 김해시,040,35~39세,2017,46688,24322,22366,108.7,43385,21744,21641,100.5
38070, 김해시,040001, 35세,2017,9146,4828,4318,111.8,8327,4173,4154,100.5
38070, 김해시,040002, 36세,2017,9524,5038,4486,112.3,8795,4462,4333,103
38070, 김해시,040003, 37세,2017,9800,5079,4721,107.6,9174,4572,4602,99.3
38070, 김해시,040004, 38세,2017,9438,4878,4560,107,8833,4433,4400,100.8
38070, 김해시,040005, 39세,2017,8780,4499,4281,105.1,8256,4104,4152,98.8
38070, 김해시,045,40~44세,2017,48815,24440,24375,100.3,46730,22925,23805,96.3
38070, 김해시,045001, 40세,2017,8878,4496,4382,102.6,8412,4139,4273,96.9
38070, 김해시,045002, 41세,2017,8838,4489,4349,103.2,8379,4134,4245,97.4
38070, 김해시,045003, 42세,2017,9749,4857,4892,99.3,9322,4557,4765,95.6
38070, 김해시,045004, 43세,2017,10515,5253,5262,99.8,10129,4973,5156,96.5
38070, 김해시,045005, 44세,2017,10835,5345,5490,97.4,10488,5122,5366,95.5
38070, 김해시,050,45~49세,2017,54789,27754,27035,102.7,53143,26716,26427,101.1
38070, 김해시,050001, 45세,2017,10576,5362,5214,102.8,10233,5127,5106,100.4
38070, 김해시,050002, 46세,2017,11534,5865,5669,103.5,11166,5631,5535,101.7
38070, 김해시,050003, 47세,2017,10909,5533,5376,102.9,10575,5321,5254,101.3
38070, 김해시,050004, 48세,2017,10831,5495,5336,103,10537,5323,5214,102.1
38070, 김해시,050005, 49세,2017,10939,5499,5440,101.1,10632,5314,5318,99.9
38070, 김해시,055,50~54세,2017,45594,23678,21916,108,44312,22936,21376,107.3
38070, 김해시,055001, 50세,2017,9974,5048,4926,102.5,9701,4887,4814,101.5
38070, 김해시,055002, 51세,2017,9483,4958,4525,109.6,9228,4809,4419,108.8
38070, 김해시,055003, 52세,2017,9255,4759,4496,105.8,9014,4614,4400,104.9
38070, 김해시,055004, 53세,2017,8247,4261,3986,106.9,7988,4122,3866,106.6
38070, 김해시,055005, 54세,2017,8635,4652,3983,116.8,8381,4504,3877,116.2
38070, 김해시,060,55~59세,2017,40219,21158,19061,111,39465,20719,18746,110.5
38070, 김해시,060001, 55세,2017,8825,4723,4102,115.1,8602,4597,4005,114.8
38070, 김해시,060002, 56세,2017,8915,4623,4292,107.7,8774,4543,4231,107.4
38070, 김해시,060003, 57세,2017,8416,4410,4006,110.1,8254,4322,3932,109.9
38070, 김해시,060004, 58세,2017,7321,3855,3466,111.2,7212,3786,3426,110.5
38070, 김해시,060005, 59세,2017,6742,3547,3195,111,6623,3471,3152,110.1
38070, 김해시,065,60~64세,2017,26673,13627,13046,104.5,26232,13401,12831,104.4
38070, 김해시,065001, 60세,2017,6525,3369,3156,106.7,6426,3312,3114,106.4
38070, 김해시,065002, 61세,2017,5744,2940,2804,104.9,5649,2889,2760,104.7
38070, 김해시,065003, 62세,2017,5628,2875,2753,104.4,5542,2830,2712,104.4
38070, 김해시,065004, 63세,2017,4788,2472,2316,106.7,4696,2432,2264,107.4
38070, 김해시,065005, 64세,2017,3988,1971,2017,97.7,3919,1938,1981,97.8
38070, 김해시,070,65~69세,2017,17550,8407,9143,92,17359,8305,9054,91.7
38070, 김해시,070001, 65세,2017,4248,2101,2147,97.9,4187,2073,2114,98.1
38070, 김해시,070002, 66세,2017,3367,1621,1746,92.8,3325,1598,1727,92.5
38070, 김해시,070003, 67세,2017,3405,1670,1735,96.3,3367,1646,1721,95.6
38070, 김해시,070004, 68세,2017,3248,1541,1707,90.3,3211,1518,1693,89.7
38070, 김해시,070005, 69세,2017,3282,1474,1808,81.5,3269,1470,1799,81.7
38070, 김해시,075,70~74세,2017,12119,5355,6764,79.2,12062,5332,6730,79.2
38070, 김해시,075001, 70세,2017,2994,1336,1658,80.6,2975,1327,1648,80.5
38070, 김해시,075002, 71세,2017,2192,1020,1172,87,2177,1016,1161,87.5
38070, 김해시,075003, 72세,2017,2167,953,1214,78.5,2157,950,1207,78.7
38070, 김해시,075004, 73세,2017,2378,1037,1341,77.3,2369,1033,1336,77.3
38070, 김해시,075005, 74세,2017,2388,1009,1379,73.2,2384,1006,1378,73
38070, 김해시,080,75~79세,2017,10417,3932,6485,60.6,10376,3916,6460,60.6
38070, 김해시,080001, 75세,2017,2612,1047,1565,66.9,2602,1043,1559,66.9
38070, 김해시,080002, 76세,2017,2170,822,1348,61,2158,819,1339,61.2
38070, 김해시,080003, 77세,2017,2042,762,1280,59.5,2034,759,1275,59.5
38070, 김해시,080004, 78세,2017,1957,721,1236,58.3,1954,719,1235,58.2
38070, 김해시,080005, 79세,2017,1636,580,1056,54.9,1628,576,1052,54.8
38070, 김해시,085,80~84세,2017,6369,1932,4437,43.5,6348,1927,4421,43.6
38070, 김해시,085001, 80세,2017,1553,504,1049,48,1546,502,1044,48.1
38070, 김해시,085002, 81세,2017,1385,450,935,48.1,1381,448,933,48
38070, 김해시,085003, 82세,2017,1313,393,920,42.7,1309,392,917,42.7
38070, 김해시,085004, 83세,2017,1144,329,815,40.4,1138,329,809,40.7
38070, 김해시,085005, 84세,2017,974,256,718,35.7,974,256,718,35.7
38070, 김해시,090,85~89세,2017,3013,683,2330,29.3,3006,683,2323,29.4
38070, 김해시,090001, 85세,2017,869,226,643,35.1,865,226,639,35.4
38070, 김해시,090002, 86세,2017,652,152,500,30.4,651,152,499,30.5
38070, 김해시,090003, 87세,2017,629,131,498,26.3,628,131,497,26.4
38070, 김해시,090004, 88세,2017,483,105,378,27.8,483,105,378,27.8
38070, 김해시,090005, 89세,2017,380,69,311,22.2,379,69,310,22.3
38070, 김해시,095,90~94세,2017,849,172,677,25.4,847,172,675,25.5
38070, 김해시,095001, 90세,2017,298,66,232,28.4,296,66,230,28.7
38070, 김해시,095002, 91세,2017,192,43,149,28.9,192,43,149,28.9
38070, 김해시,095003, 92세,2017,160,27,133,20.3,160,27,133,20.3
38070, 김해시,095004, 93세,2017,100,20,80,25,100,20,80,25
38070, 김해시,095005, 94세,2017,99,16,83,19.3,99,16,83,19.3
38070, 김해시,100,95~99세,2017,141,23,118,19.5,140,22,118,18.6
38070, 김해시,100001, 95세,2017,59,8,51,15.7,59,8,51,15.7
38070, 김해시,100002, 96세,2017,37,X,33,12.1,37,X,33,12.1
38070, 김해시,100003, 97세,2017,24,X,20,20,23,X,20,15
38070, 김해시,100004, 98세,2017,11,X,8,37.5,11,X,8,37.5
38070, 김해시,100005, 99세,2017,10,X,6,66.7,10,X,6,66.7
38070, 김해시,101,100세이상,2017,14,X,12,16.7,14,X,12,16.7
38070, 김해시,102,15세미만,2017,84904,43715,41189,106.1,84317,43427,40890,106.2
38070, 김해시,103,15~64세,2017,401080,211497,189583,111.6,378600,194932,183668,106.1
38070, 김해시,104,65세이상,2017,50472,20506,29966,68.4,50152,20359,29793,68.3
38070, 김해시,086,85세이상,2017,4017,880,3137,28.1,4007,879,3128,28.1
38070, 김해시,126,평균연령,2017,38.5,37.5,39.6,,38.7,37.7,39.7,
38070, 김해시,127,중위연령,2017,39.8,38.5,41.1,,40.4,39.4,41.4,
38080, 밀양시,000,합계,2017,103894,50665,53229,95.2,100913,49212,51701,95.2
38080, 밀양시,005,0~4세,2017,3075,1512,1563,96.7,3065,1508,1557,96.9
38080, 밀양시,005001, 0세,2017,615,295,320,92.2,613,295,318,92.8
38080, 밀양시,005002, 1세,2017,657,311,346,89.9,656,310,346,89.6
38080, 밀양시,005003, 2세,2017,582,309,273,113.2,581,308,273,112.8
38080, 밀양시,005004, 3세,2017,595,301,294,102.4,590,299,291,102.7
38080, 밀양시,005005, 4세,2017,626,296,330,89.7,625,296,329,90
38080, 밀양시,010,5~9세,2017,3474,1799,1675,107.4,3471,1798,1673,107.5
38080, 밀양시,010001, 5세,2017,685,372,313,118.8,684,371,313,118.5
38080, 밀양시,010002, 6세,2017,670,328,342,95.9,669,328,341,96.2
38080, 밀양시,010003, 7세,2017,683,365,318,114.8,683,365,318,114.8
38080, 밀양시,010004, 8세,2017,658,346,312,110.9,658,346,312,110.9
38080, 밀양시,010005, 9세,2017,778,388,390,99.5,777,388,389,99.7
38080, 밀양시,015,10~14세,2017,3716,1917,1799,106.6,3712,1916,1796,106.7
38080, 밀양시,015001, 10세,2017,772,400,372,107.5,770,400,370,108.1
38080, 밀양시,015002, 11세,2017,699,355,344,103.2,699,355,344,103.2
38080, 밀양시,015003, 12세,2017,702,359,343,104.7,702,359,343,104.7
38080, 밀양시,015004, 13세,2017,750,402,348,115.5,749,401,348,115.2
38080, 밀양시,015005, 14세,2017,793,401,392,102.3,792,401,391,102.6
38080, 밀양시,020,15~19세,2017,4599,2480,2119,117,4563,2471,2092,118.1
38080, 밀양시,020001, 15세,2017,823,446,377,118.3,823,446,377,118.3
38080, 밀양시,020002, 16세,2017,933,499,434,115,929,497,432,115
38080, 밀양시,020003, 17세,2017,1062,550,512,107.4,1060,548,512,107
38080, 밀양시,020004, 18세,2017,973,510,463,110.2,969,508,461,110.2
38080, 밀양시,020005, 19세,2017,808,475,333,142.6,782,472,310,152.3
38080, 밀양시,025,20~24세,2017,5667,3199,2468,129.6,4897,2985,1912,156.1
38080, 밀양시,025001, 20세,2017,1038,581,457,127.1,963,576,387,148.8
38080, 밀양시,025002, 21세,2017,1223,705,518,136.1,1051,670,381,175.9
38080, 밀양시,025003, 22세,2017,1152,641,511,125.4,968,597,371,160.9
38080, 밀양시,025004, 23세,2017,1185,648,537,120.7,989,581,408,142.4
38080, 밀양시,025005, 24세,2017,1069,624,445,140.2,926,561,365,153.7
38080, 밀양시,030,25~29세,2017,4738,2666,2072,128.7,4028,2259,1769,127.7
38080, 밀양시,030001, 25세,2017,1041,576,465,123.9,901,513,388,132.2
38080, 밀양시,030002, 26세,2017,972,555,417,133.1,828,465,363,128.1
38080, 밀양시,030003, 27세,2017,929,530,399,132.8,767,437,330,132.4
38080, 밀양시,030004, 28세,2017,910,505,405,124.7,774,418,356,117.4
38080, 밀양시,030005, 29세,2017,886,500,386,129.5,758,426,332,128.3
38080, 밀양시,035,30~34세,2017,4913,2639,2274,116.1,4394,2311,2083,110.9
38080, 밀양시,035001, 30세,2017,902,471,431,109.3,781,396,385,102.9
38080, 밀양시,035002, 31세,2017,1012,560,452,123.9,893,479,414,115.7
38080, 밀양시,035003, 32세,2017,923,495,428,115.7,824,433,391,110.7
38080, 밀양시,035004, 33세,2017,1022,554,468,118.4,926,494,432,114.4
38080, 밀양시,035005, 34세,2017,1054,559,495,112.9,970,509,461,110.4
38080, 밀양시,040,35~39세,2017,5759,3052,2707,112.7,5483,2880,2603,110.6
38080, 밀양시,040001, 35세,2017,1115,612,503,121.7,1050,571,479,119.2
38080, 밀양시,040002, 36세,2017,1199,639,560,114.1,1145,609,536,113.6
38080, 밀양시,040003, 37세,2017,1160,576,584,98.6,1097,534,563,94.8
38080, 밀양시,040004, 38세,2017,1188,637,551,115.6,1135,601,534,112.5
38080, 밀양시,040005, 39세,2017,1097,588,509,115.5,1056,565,491,115.1
38080, 밀양시,045,40~44세,2017,6071,3206,2865,111.9,5887,3091,2796,110.6
38080, 밀양시,045001, 40세,2017,1109,571,538,106.1,1061,542,519,104.4
38080, 밀양시,045002, 41세,2017,1099,587,512,114.6,1048,553,495,111.7
38080, 밀양시,045003, 42세,2017,1151,630,521,120.9,1122,610,512,119.1
38080, 밀양시,045004, 43세,2017,1330,704,626,112.5,1300,686,614,111.7
38080, 밀양시,045005, 44세,2017,1382,714,668,106.9,1356,700,656,106.7
38080, 밀양시,050,45~49세,2017,7519,3884,3635,106.9,7366,3808,3558,107
38080, 밀양시,050001, 45세,2017,1391,732,659,111.1,1356,715,641,111.5
38080, 밀양시,050002, 46세,2017,1532,801,731,109.6,1495,780,715,109.1
38080, 밀양시,050003, 47세,2017,1438,720,718,100.3,1412,706,706,100
38080, 밀양시,050004, 48세,2017,1530,785,745,105.4,1498,773,725,106.6
38080, 밀양시,050005, 49세,2017,1628,846,782,108.2,1605,834,771,108.2
38080, 밀양시,055,50~54세,2017,8586,4247,4339,97.9,8474,4204,4270,98.5
38080, 밀양시,055001, 50세,2017,1655,798,857,93.1,1634,788,846,93.1
38080, 밀양시,055002, 51세,2017,1712,863,849,101.6,1693,858,835,102.8
38080, 밀양시,055003, 52세,2017,1666,778,888,87.6,1648,773,875,88.3
38080, 밀양시,055004, 53세,2017,1699,873,826,105.7,1672,861,811,106.2
38080, 밀양시,055005, 54세,2017,1854,935,919,101.7,1827,924,903,102.3
38080, 밀양시,060,55~59세,2017,10654,5233,5421,96.5,10550,5189,5361,96.8
38080, 밀양시,060001, 55세,2017,2057,1028,1029,99.9,2026,1016,1010,100.6
38080, 밀양시,060002, 56세,2017,2185,1088,1097,99.2,2168,1083,1085,99.8
38080, 밀양시,060003, 57세,2017,2184,1080,1104,97.8,2165,1072,1093,98.1
38080, 밀양시,060004, 58세,2017,2079,1010,1069,94.5,2058,997,1061,94
38080, 밀양시,060005, 59세,2017,2149,1027,1122,91.5,2133,1021,1112,91.8
38080, 밀양시,065,60~64세,2017,9698,4725,4973,95,9644,4704,4940,95.2
38080, 밀양시,065001, 60세,2017,2221,1070,1151,93,2203,1063,1140,93.2
38080, 밀양시,065002, 61세,2017,2083,1039,1044,99.5,2076,1037,1039,99.8
38080, 밀양시,065003, 62세,2017,2009,990,1019,97.2,1998,984,1014,97
38080, 밀양시,065004, 63세,2017,1779,856,923,92.7,1764,851,913,93.2
38080, 밀양시,065005, 64세,2017,1606,770,836,92.1,1603,769,834,92.2
38080, 밀양시,070,65~69세,2017,7664,3632,4032,90.1,7637,3620,4017,90.1
38080, 밀양시,070001, 65세,2017,1828,884,944,93.6,1821,880,941,93.5
38080, 밀양시,070002, 66세,2017,1533,702,831,84.5,1526,701,825,85
38080, 밀양시,070003, 67세,2017,1409,677,732,92.5,1403,672,731,91.9
38080, 밀양시,070004, 68세,2017,1464,711,753,94.4,1461,709,752,94.3
38080, 밀양시,070005, 69세,2017,1430,658,772,85.2,1426,658,768,85.7
38080, 밀양시,075,70~74세,2017,5735,2500,3235,77.3,5723,2497,3226,77.4
38080, 밀양시,075001, 70세,2017,1386,624,762,81.9,1382,623,759,82.1
38080, 밀양시,075002, 71세,2017,997,459,538,85.3,994,458,536,85.4
38080, 밀양시,075003, 72세,2017,1052,489,563,86.9,1049,489,560,87.3
38080, 밀양시,075004, 73세,2017,1092,446,646,69,1092,446,646,69
38080, 밀양시,075005, 74세,2017,1208,482,726,66.4,1206,481,725,66.3
38080, 밀양시,080,75~79세,2017,5701,2103,3598,58.4,5697,2101,3596,58.4
38080, 밀양시,080001, 75세,2017,1383,562,821,68.5,1383,562,821,68.5
38080, 밀양시,080002, 76세,2017,1186,443,743,59.6,1185,443,742,59.7
38080, 밀양시,080003, 77세,2017,1022,377,645,58.4,1021,376,645,58.3
38080, 밀양시,080004, 78세,2017,1127,397,730,54.4,1127,397,730,54.4
38080, 밀양시,080005, 79세,2017,983,324,659,49.2,981,323,658,49.1
38080, 밀양시,085,80~84세,2017,3979,1303,2676,48.7,3977,1303,2674,48.7
38080, 밀양시,085001, 80세,2017,1009,352,657,53.6,1009,352,657,53.6
38080, 밀양시,085002, 81세,2017,826,278,548,50.7,826,278,548,50.7
38080, 밀양시,085003, 82세,2017,831,275,556,49.5,830,275,555,49.5
38080, 밀양시,085004, 83세,2017,720,232,488,47.5,719,232,487,47.6
38080, 밀양시,085005, 84세,2017,593,166,427,38.9,593,166,427,38.9
38080, 밀양시,090,85~89세,2017,1761,455,1306,34.8,1760,454,1306,34.8
38080, 밀양시,090001, 85세,2017,542,148,394,37.6,542,148,394,37.6
38080, 밀양시,090002, 86세,2017,374,103,271,38,374,103,271,38
38080, 밀양시,090003, 87세,2017,340,84,256,32.8,340,84,256,32.8
38080, 밀양시,090004, 88세,2017,304,73,231,31.6,303,72,231,31.2
38080, 밀양시,090005, 89세,2017,201,47,154,30.5,201,47,154,30.5
38080, 밀양시,095,90~94세,2017,489,97,392,24.7,489,97,392,24.7
38080, 밀양시,095001, 90세,2017,173,36,137,26.3,173,36,137,26.3
38080, 밀양시,095002, 91세,2017,108,24,84,28.6,108,24,84,28.6
38080, 밀양시,095003, 92세,2017,97,12,85,14.1,97,12,85,14.1
38080, 밀양시,095004, 93세,2017,51,12,39,30.8,51,12,39,30.8
38080, 밀양시,095005, 94세,2017,60,13,47,27.7,60,13,47,27.7
38080, 밀양시,100,95~99세,2017,89,16,73,21.9,89,16,73,21.9
38080, 밀양시,100001, 95세,2017,33,X,29,13.8,33,X,29,13.8
38080, 밀양시,100002, 96세,2017,24,6,18,33.3,24,6,18,33.3
38080, 밀양시,100003, 97세,2017,18,X,14,28.6,18,X,14,28.6
38080, 밀양시,100004, 98세,2017,10,X,10,0,10,X,10,0
38080, 밀양시,100005, 99세,2017,X,X,X,100,X,X,X,100
38080, 밀양시,101,100세이상,2017,7,X,7,0,7,X,7,0
38080, 밀양시,102,15세미만,2017,10265,5228,5037,103.8,10248,5222,5026,103.9
38080, 밀양시,103,15~64세,2017,68204,35331,32873,107.5,65286,33902,31384,108
38080, 밀양시,104,65세이상,2017,25425,10106,15319,66,25379,10088,15291,66
38080, 밀양시,086,85세이상,2017,2346,568,1778,31.9,2345,567,1778,31.9
38080, 밀양시,126,평균연령,2017,48,45.7,50.2,,48.4,46.1,50.7,
38080, 밀양시,127,중위연령,2017,51.4,48.8,54,,52.2,49.5,54.7,
38090, 거제시,000,합계,2017,257847,139356,118491,117.6,247869,132176,115693,114.2
38090, 거제시,005,0~4세,2017,16300,8374,7926,105.7,16092,8272,7820,105.8
38090, 거제시,005001, 0세,2017,2751,1440,1311,109.8,2705,1420,1285,110.5
38090, 거제시,005002, 1세,2017,3255,1623,1632,99.4,3223,1608,1615,99.6
38090, 거제시,005003, 2세,2017,3544,1834,1710,107.3,3501,1804,1697,106.3
38090, 거제시,005004, 3세,2017,3342,1704,1638,104,3299,1683,1616,104.1
38090, 거제시,005005, 4세,2017,3408,1773,1635,108.4,3364,1757,1607,109.3
38090, 거제시,010,5~9세,2017,16352,8452,7900,107,16186,8368,7818,107
38090, 거제시,010001, 5세,2017,3554,1886,1668,113.1,3520,1870,1650,113.3
38090, 거제시,010002, 6세,2017,3508,1763,1745,101,3473,1746,1727,101.1
38090, 거제시,010003, 7세,2017,3279,1686,1593,105.8,3244,1670,1574,106.1
38090, 거제시,010004, 8세,2017,2984,1552,1432,108.4,2957,1537,1420,108.2
38090, 거제시,010005, 9세,2017,3027,1565,1462,107,2992,1545,1447,106.8
38090, 거제시,015,10~14세,2017,13519,7021,6498,108,13439,6984,6455,108.2
38090, 거제시,015001, 10세,2017,3014,1576,1438,109.6,2997,1567,1430,109.6
38090, 거제시,015002, 11세,2017,2666,1352,1314,102.9,2645,1343,1302,103.1
38090, 거제시,015003, 12세,2017,2464,1272,1192,106.7,2449,1264,1185,106.7
38090, 거제시,015004, 13세,2017,2688,1428,1260,113.3,2676,1423,1253,113.6
38090, 거제시,015005, 14세,2017,2687,1393,1294,107.7,2672,1387,1285,107.9
38090, 거제시,020,15~19세,2017,14045,7632,6413,119,13977,7590,6387,118.8
38090, 거제시,020001, 15세,2017,2828,1497,1331,112.5,2816,1490,1326,112.4
38090, 거제시,020002, 16세,2017,3152,1706,1446,118,3141,1697,1444,117.5
38090, 거제시,020003, 17세,2017,3438,1847,1591,116.1,3428,1841,1587,116
38090, 거제시,020004, 18세,2017,2803,1502,1301,115.4,2794,1495,1299,115.1
38090, 거제시,020005, 19세,2017,1824,1080,744,145.2,1798,1067,731,146
38090, 거제시,025,20~24세,2017,11871,7259,4612,157.4,11247,6837,4410,155
38090, 거제시,025001, 20세,2017,2312,1535,777,197.6,2265,1508,757,199.2
38090, 거제시,025002, 21세,2017,2455,1617,838,193,2389,1570,819,191.7
38090, 거제시,025003, 22세,2017,2408,1434,974,147.2,2286,1361,925,147.1
38090, 거제시,025004, 23세,2017,2306,1332,974,136.8,2143,1229,914,134.5
38090, 거제시,025005, 24세,2017,2390,1341,1049,127.8,2164,1169,995,117.5
38090, 거제시,030,25~29세,2017,14979,8710,6269,138.9,13061,7224,5837,123.8
38090, 거제시,030001, 25세,2017,2608,1441,1167,123.5,2286,1192,1094,109
38090, 거제시,030002, 26세,2017,2701,1540,1161,132.6,2341,1263,1078,117.2
38090, 거제시,030003, 27세,2017,3067,1858,1209,153.7,2654,1529,1125,135.9
38090, 거제시,030004, 28세,2017,3214,1890,1324,142.7,2796,1579,1217,129.7
38090, 거제시,030005, 29세,2017,3389,1981,1408,140.7,2984,1661,1323,125.5
38090, 거제시,035,30~34세,2017,23047,13213,9834,134.4,20907,11518,9389,122.7
38090, 거제시,035001, 30세,2017,3796,2160,1636,132,3347,1802,1545,116.6
38090, 거제시,035002, 31세,2017,4321,2556,1765,144.8,3856,2181,1675,130.2
38090, 거제시,035003, 32세,2017,4588,2607,1981,131.6,4159,2260,1899,119
38090, 거제시,035004, 33세,2017,4884,2750,2134,128.9,4487,2442,2045,119.4
38090, 거제시,035005, 34세,2017,5458,3140,2318,135.5,5058,2833,2225,127.3
38090, 거제시,040,35~39세,2017,27749,15897,11852,134.1,26167,14671,11496,127.6
38090, 거제시,040001, 35세,2017,5759,3269,2490,131.3,5377,2970,2407,123.4
38090, 거제시,040002, 36세,2017,5877,3400,2477,137.3,5547,3143,2404,130.7
38090, 거제시,040003, 37세,2017,5959,3423,2536,135,5640,3176,2464,128.9
38090, 거제시,040004, 38세,2017,5348,3062,2286,133.9,5057,2829,2228,127
38090, 거제시,040005, 39세,2017,4806,2743,2063,133,4546,2553,1993,128.1
38090, 거제시,045,40~44세,2017,24610,13568,11042,122.9,23631,12846,10785,119.1
38090, 거제시,045001, 40세,2017,4730,2651,2079,127.5,4529,2500,2029,123.2
38090, 거제시,045002, 41세,2017,4800,2639,2161,122.1,4597,2479,2118,117
38090, 거제시,045003, 42세,2017,4733,2594,2139,121.3,4529,2447,2082,117.5
38090, 거제시,045004, 43세,2017,5099,2777,2322,119.6,4910,2642,2268,116.5
38090, 거제시,045005, 44세,2017,5248,2907,2341,124.2,5066,2778,2288,121.4
38090, 거제시,050,45~49세,2017,24117,13552,10565,128.3,23358,13044,10314,126.5
38090, 거제시,050001, 45세,2017,5053,2908,2145,135.6,4885,2785,2100,132.6
38090, 거제시,050002, 46세,2017,5153,2948,2205,133.7,4995,2843,2152,132.1
38090, 거제시,050003, 47세,2017,4845,2714,2131,127.4,4694,2615,2079,125.8
38090, 거제시,050004, 48세,2017,4609,2569,2040,125.9,4451,2465,1986,124.1
38090, 거제시,050005, 49세,2017,4457,2413,2044,118.1,4333,2336,1997,117
38090, 거제시,055,50~54세,2017,18823,10380,8443,122.9,18241,10042,8199,122.5
38090, 거제시,055001, 50세,2017,4113,2260,1853,122,3995,2188,1807,121.1
38090, 거제시,055002, 51세,2017,4082,2364,1718,137.6,3974,2305,1669,138.1
38090, 거제시,055003, 52세,2017,3928,2154,1774,121.4,3802,2084,1718,121.3
38090, 거제시,055004, 53세,2017,3202,1720,1482,116.1,3092,1658,1434,115.6
38090, 거제시,055005, 54세,2017,3498,1882,1616,116.5,3378,1807,1571,115
38090, 거제시,060,55~59세,2017,18210,9417,8793,107.1,17816,9175,8641,106.2
38090, 거제시,060001, 55세,2017,3718,1936,1782,108.6,3623,1867,1756,106.3
38090, 거제시,060002, 56세,2017,3939,1893,2046,92.5,3864,1847,2017,91.6
38090, 거제시,060003, 57세,2017,3882,1947,1935,100.6,3793,1900,1893,100.4
38090, 거제시,060004, 58세,2017,3404,1839,1565,117.5,3331,1796,1535,117
38090, 거제시,060005, 59세,2017,3267,1802,1465,123,3205,1765,1440,122.6
38090, 거제시,065,60~64세,2017,12623,6687,5936,112.7,12343,6511,5832,111.6
38090, 거제시,065001, 60세,2017,3183,1765,1418,124.5,3115,1723,1392,123.8
38090, 거제시,065002, 61세,2017,2813,1493,1320,113.1,2750,1453,1297,112
38090, 거제시,065003, 62세,2017,2694,1407,1287,109.3,2635,1369,1266,108.1
38090, 거제시,065004, 63세,2017,2105,1104,1001,110.3,2058,1074,984,109.1
38090, 거제시,065005, 64세,2017,1828,918,910,100.9,1785,892,893,99.9
38090, 거제시,070,65~69세,2017,7852,4077,3775,108,7744,4016,3728,107.7
38090, 거제시,070001, 65세,2017,2058,1047,1011,103.6,2032,1032,1000,103.2
38090, 거제시,070002, 66세,2017,1473,769,704,109.2,1449,756,693,109.1
38090, 거제시,070003, 67세,2017,1420,742,678,109.4,1394,728,666,109.3
38090, 거제시,070004, 68세,2017,1487,758,729,104,1467,745,722,103.2
38090, 거제시,070005, 69세,2017,1414,761,653,116.5,1402,755,647,116.7
38090, 거제시,075,70~74세,2017,4883,2290,2593,88.3,4847,2270,2577,88.1
38090, 거제시,075001, 70세,2017,1299,644,655,98.3,1289,638,651,98
38090, 거제시,075002, 71세,2017,810,405,405,100,805,402,403,99.8
38090, 거제시,075003, 72세,2017,893,407,486,83.7,886,403,483,83.4
38090, 거제시,075004, 73세,2017,879,397,482,82.4,871,393,478,82.2
38090, 거제시,075005, 74세,2017,1002,437,565,77.3,996,434,562,77.2
38090, 거제시,080,75~79세,2017,4192,1602,2590,61.9,4156,1588,2568,61.8
38090, 거제시,080001, 75세,2017,1104,447,657,68,1095,444,651,68.2
38090, 거제시,080002, 76세,2017,872,343,529,64.8,866,341,525,65
38090, 거제시,080003, 77세,2017,749,304,445,68.3,742,300,442,67.9
38090, 거제시,080004, 78세,2017,804,272,532,51.1,797,268,529,50.7
38090, 거제시,080005, 79세,2017,663,236,427,55.3,656,235,421,55.8
38090, 거제시,085,80~84세,2017,2774,842,1932,43.6,2761,838,1923,43.6
38090, 거제시,085001, 80세,2017,665,228,437,52.2,663,227,436,52.1
38090, 거제시,085002, 81세,2017,625,206,419,49.2,620,203,417,48.7
38090, 거제시,085003, 82세,2017,569,165,404,40.8,565,165,400,41.3
38090, 거제시,085004, 83세,2017,475,134,341,39.3,474,134,340,39.4
38090, 거제시,085005, 84세,2017,440,109,331,32.9,439,109,330,33
38090, 거제시,090,85~89세,2017,1409,300,1109,27.1,1405,299,1106,27
38090, 거제시,090001, 85세,2017,395,99,296,33.4,394,99,295,33.6
38090, 거제시,090002, 86세,2017,322,79,243,32.5,320,78,242,32.2
38090, 거제시,090003, 87세,2017,269,43,226,19,268,43,225,19.1
38090, 거제시,090004, 88세,2017,256,50,206,24.3,256,50,206,24.3
38090, 거제시,090005, 89세,2017,167,29,138,21,167,29,138,21
38090, 거제시,095,90~94세,2017,411,70,341,20.5,410,70,340,20.6
38090, 거제시,095001, 90세,2017,102,21,81,25.9,102,21,81,25.9
38090, 거제시,095002, 91세,2017,105,19,86,22.1,105,19,86,22.1
38090, 거제시,095003, 92세,2017,91,13,78,16.7,91,13,78,16.7
38090, 거제시,095004, 93세,2017,74,7,67,10.4,73,7,66,10.6
38090, 거제시,095005, 94세,2017,39,10,29,34.5,39,10,29,34.5
38090, 거제시,100,95~99세,2017,75,13,62,21,75,13,62,21
38090, 거제시,100001, 95세,2017,30,X,26,15.4,30,X,26,15.4
38090, 거제시,100002, 96세,2017,24,6,18,33.3,24,6,18,33.3
38090, 거제시,100003, 97세,2017,13,X,10,30,13,X,10,30
38090, 거제시,100004, 98세,2017,5,X,5,0,5,X,5,0
38090, 거제시,100005, 99세,2017,X,X,X,0,X,X,X,0
38090, 거제시,101,100세이상,2017,6,X,6,0,6,X,6,0
38090, 거제시,102,15세미만,2017,46171,23847,22324,106.8,45717,23624,22093,106.9
38090, 거제시,103,15~64세,2017,190074,106315,83759,126.9,180748,99458,81290,122.3
38090, 거제시,104,65세이상,2017,21602,9194,12408,74.1,21404,9094,12310,73.9
38090, 거제시,086,85세이상,2017,1901,383,1518,25.2,1896,382,1514,25.2
38090, 거제시,126,평균연령,2017,37.5,36.7,38.3,,37.5,36.8,38.3,
38090, 거제시,127,중위연령,2017,38.2,37.7,39,,38.5,38,39.1,
38100, 양산시,000,합계,2017,332596,167514,165082,101.5,325137,162548,162589,100
38100, 양산시,005,0~4세,2017,18180,9276,8904,104.2,18086,9227,8859,104.2
38100, 양산시,005001, 0세,2017,3187,1647,1540,106.9,3177,1641,1536,106.8
38100, 양산시,005002, 1세,2017,3578,1835,1743,105.3,3560,1825,1735,105.2
38100, 양산시,005003, 2세,2017,3837,1937,1900,101.9,3811,1923,1888,101.9
38100, 양산시,005004, 3세,2017,3867,2021,1846,109.5,3845,2010,1835,109.5
38100, 양산시,005005, 4세,2017,3711,1836,1875,97.9,3693,1828,1865,98
38100, 양산시,010,5~9세,2017,18227,9355,8872,105.4,18178,9328,8850,105.4
38100, 양산시,010001, 5세,2017,3991,2078,1913,108.6,3977,2068,1909,108.3
38100, 양산시,010002, 6세,2017,3873,1961,1912,102.6,3861,1955,1906,102.6
38100, 양산시,010003, 7세,2017,3546,1784,1762,101.2,3537,1780,1757,101.3
38100, 양산시,010004, 8세,2017,3332,1726,1606,107.5,3322,1721,1601,107.5
38100, 양산시,010005, 9세,2017,3485,1806,1679,107.6,3481,1804,1677,107.6
38100, 양산시,015,10~14세,2017,15701,8014,7687,104.3,15661,7992,7669,104.2
38100, 양산시,015001, 10세,2017,3415,1731,1684,102.8,3404,1725,1679,102.7
38100, 양산시,015002, 11세,2017,3082,1556,1526,102,3075,1554,1521,102.2
38100, 양산시,015003, 12세,2017,2980,1512,1468,103,2972,1506,1466,102.7
38100, 양산시,015004, 13세,2017,3149,1599,1550,103.2,3141,1594,1547,103
38100, 양산시,015005, 14세,2017,3075,1616,1459,110.8,3069,1613,1456,110.8
38100, 양산시,020,15~19세,2017,18492,9446,9046,104.4,18428,9409,9019,104.3
38100, 양산시,020001, 15세,2017,3285,1657,1628,101.8,3277,1654,1623,101.9
38100, 양산시,020002, 16세,2017,3776,1907,1869,102,3769,1902,1867,101.9
38100, 양산시,020003, 17세,2017,4130,1965,2165,90.8,4115,1955,2160,90.5
38100, 양산시,020004, 18세,2017,3825,1972,1853,106.4,3816,1965,1851,106.2
38100, 양산시,020005, 19세,2017,3476,1945,1531,127,3451,1933,1518,127.3
38100, 양산시,025,20~24세,2017,19317,10788,8529,126.5,18680,10361,8319,124.5
38100, 양산시,025001, 20세,2017,3684,2104,1580,133.2,3632,2080,1552,134
38100, 양산시,025002, 21세,2017,4076,2391,1685,141.9,3985,2324,1661,139.9
38100, 양산시,025003, 22세,2017,3904,2185,1719,127.1,3786,2103,1683,125
38100, 양산시,025004, 23세,2017,3735,2042,1693,120.6,3584,1938,1646,117.7
38100, 양산시,025005, 24세,2017,3918,2066,1852,111.6,3693,1916,1777,107.8
38100, 양산시,030,25~29세,2017,19914,10567,9347,113.1,18347,9439,8908,106
38100, 양산시,030001, 25세,2017,4100,2094,2006,104.4,3814,1889,1925,98.1
38100, 양산시,030002, 26세,2017,4011,2148,1863,115.3,3729,1947,1782,109.3
38100, 양산시,030003, 27세,2017,3908,2141,1767,121.2,3597,1919,1678,114.4
38100, 양산시,030004, 28세,2017,3967,2126,1841,115.5,3630,1866,1764,105.8
38100, 양산시,030005, 29세,2017,3928,2058,1870,110.1,3577,1818,1759,103.4
38100, 양산시,035,30~34세,2017,23486,12290,11196,109.8,21952,11179,10773,103.8
38100, 양산시,035001, 30세,2017,4174,2115,2059,102.7,3803,1855,1948,95.2
38100, 양산시,035002, 31세,2017,4168,2174,1994,109,3860,1958,1902,102.9
38100, 양산시,035003, 32세,2017,4469,2417,2052,117.8,4175,2198,1977,111.2
38100, 양산시,035004, 33세,2017,5045,2638,2407,109.6,4737,2410,2327,103.6
38100, 양산시,035005, 34세,2017,5630,2946,2684,109.8,5377,2758,2619,105.3
38100, 양산시,040,35~39세,2017,30683,15798,14885,106.1,29607,15027,14580,103.1
38100, 양산시,040001, 35세,2017,6265,3204,3061,104.7,5991,3017,2974,101.4
38100, 양산시,040002, 36세,2017,6307,3259,3048,106.9,6089,3103,2986,103.9
38100, 양산시,040003, 37세,2017,6620,3418,3202,106.7,6415,3268,3147,103.8
38100, 양산시,040004, 38세,2017,6020,3045,2975,102.4,5825,2901,2924,99.2
38100, 양산시,040005, 39세,2017,5471,2872,2599,110.5,5287,2738,2549,107.4
38100, 양산시,045,40~44세,2017,28308,14504,13804,105.1,27623,14040,13583,103.4
38100, 양산시,045001, 40세,2017,5568,2877,2691,106.9,5427,2779,2648,104.9
38100, 양산시,045002, 41세,2017,5231,2678,2553,104.9,5077,2563,2514,101.9
38100, 양산시,045003, 42세,2017,5770,2973,2797,106.3,5604,2861,2743,104.3
38100, 양산시,045004, 43세,2017,5840,2995,2845,105.3,5729,2921,2808,104
38100, 양산시,045005, 44세,2017,5899,2981,2918,102.2,5786,2916,2870,101.6
38100, 양산시,050,45~49세,2017,30098,15047,15051,100,29463,14674,14789,99.2
38100, 양산시,050001, 45세,2017,5907,3083,2824,109.2,5761,2987,2774,107.7
38100, 양산시,050002, 46세,2017,5969,3026,2943,102.8,5842,2947,2895,101.8
38100, 양산시,050003, 47세,2017,6150,3030,3120,97.1,6005,2951,3054,96.6
38100, 양산시,050004, 48세,2017,6063,3015,3048,98.9,5964,2965,2999,98.9
38100, 양산시,050005, 49세,2017,6009,2893,3116,92.8,5891,2824,3067,92.1
38100, 양산시,055,50~54세,2017,26521,13562,12959,104.7,26052,13318,12734,104.6
38100, 양산시,055001, 50세,2017,5559,2716,2843,95.5,5462,2666,2796,95.4
38100, 양산시,055002, 51세,2017,5430,2828,2602,108.7,5324,2765,2559,108.1
38100, 양산시,055003, 52세,2017,5421,2770,2651,104.5,5321,2715,2606,104.2
38100, 양산시,055004, 53세,2017,4880,2509,2371,105.8,4808,2469,2339,105.6
38100, 양산시,055005, 54세,2017,5231,2739,2492,109.9,5137,2703,2434,111.1
38100, 양산시,060,55~59세,2017,26385,13303,13082,101.7,26089,13142,12947,101.5
38100, 양산시,060001, 55세,2017,5449,2789,2660,104.8,5372,2747,2625,104.6
38100, 양산시,060002, 56세,2017,5803,2929,2874,101.9,5759,2908,2851,102
38100, 양산시,060003, 57세,2017,5537,2823,2714,104,5466,2781,2685,103.6
38100, 양산시,060004, 58세,2017,4947,2460,2487,98.9,4889,2429,2460,98.7
38100, 양산시,060005, 59세,2017,4649,2302,2347,98.1,4603,2277,2326,97.9
38100, 양산시,065,60~64세,2017,19191,9401,9790,96,19015,9313,9702,96
38100, 양산시,065001, 60세,2017,4477,2242,2235,100.3,4441,2220,2221,100
38100, 양산시,065002, 61세,2017,4013,1951,2062,94.6,3967,1934,2033,95.1
38100, 양산시,065003, 62세,2017,4161,2011,2150,93.5,4127,1991,2136,93.2
38100, 양산시,065004, 63세,2017,3504,1692,1812,93.4,3468,1676,1792,93.5
38100, 양산시,065005, 64세,2017,3036,1505,1531,98.3,3012,1492,1520,98.2
38100, 양산시,070,65~69세,2017,13349,6445,6904,93.4,13255,6399,6856,93.3
38100, 양산시,070001, 65세,2017,3218,1552,1666,93.2,3198,1541,1657,93
38100, 양산시,070002, 66세,2017,2495,1232,1263,97.5,2472,1223,1249,97.9
38100, 양산시,070003, 67세,2017,2648,1309,1339,97.8,2627,1299,1328,97.8
38100, 양산시,070004, 68세,2017,2462,1173,1289,91,2445,1164,1281,90.9
38100, 양산시,070005, 69세,2017,2526,1179,1347,87.5,2513,1172,1341,87.4
38100, 양산시,075,70~74세,2017,9394,4226,5168,81.8,9374,4220,5154,81.9
38100, 양산시,075001, 70세,2017,2243,993,1250,79.4,2235,991,1244,79.7
38100, 양산시,075002, 71세,2017,1722,767,955,80.3,1720,767,953,80.5
38100, 양산시,075003, 72세,2017,1739,813,926,87.8,1735,811,924,87.8
38100, 양산시,075004, 73세,2017,1737,813,924,88,1735,813,922,88.2
38100, 양산시,075005, 74세,2017,1953,840,1113,75.5,1949,838,1111,75.4
38100, 양산시,080,75~79세,2017,7947,3184,4763,66.8,7934,3176,4758,66.8
38100, 양산시,080001, 75세,2017,1992,845,1147,73.7,1989,842,1147,73.4
38100, 양산시,080002, 76세,2017,1632,661,971,68.1,1630,660,970,68
38100, 양산시,080003, 77세,2017,1618,635,983,64.6,1615,634,981,64.6
38100, 양산시,080004, 78세,2017,1497,591,906,65.2,1495,590,905,65.2
38100, 양산시,080005, 79세,2017,1208,452,756,59.8,1205,450,755,59.6
38100, 양산시,085,80~84세,2017,4604,1626,2978,54.6,4596,1622,2974,54.5
38100, 양산시,085001, 80세,2017,1149,414,735,56.3,1146,413,733,56.3
38100, 양산시,085002, 81세,2017,1034,382,652,58.6,1033,382,651,58.7
38100, 양산시,085003, 82세,2017,970,351,619,56.7,969,350,619,56.5
38100, 양산시,085004, 83세,2017,793,260,533,48.8,791,258,533,48.4
38100, 양산시,085005, 84세,2017,658,219,439,49.9,657,219,438,50
38100, 양산시,090,85~89세,2017,2007,512,1495,34.2,2005,512,1493,34.3
38100, 양산시,090001, 85세,2017,573,155,418,37.1,572,155,417,37.2
38100, 양산시,090002, 86세,2017,431,108,323,33.4,431,108,323,33.4
38100, 양산시,090003, 87세,2017,393,101,292,34.6,393,101,292,34.6
38100, 양산시,090004, 88세,2017,356,91,265,34.3,355,91,264,34.5
38100, 양산시,090005, 89세,2017,254,57,197,28.9,254,57,197,28.9
38100, 양산시,095,90~94세,2017,669,150,519,28.9,669,150,519,28.9
38100, 양산시,095001, 90세,2017,221,61,160,38.1,221,61,160,38.1
38100, 양산시,095002, 91세,2017,150,24,126,19,150,24,126,19
38100, 양산시,095003, 92세,2017,128,27,101,26.7,128,27,101,26.7
38100, 양산시,095004, 93세,2017,90,20,70,28.6,90,20,70,28.6
38100, 양산시,095005, 94세,2017,80,18,62,29,80,18,62,29
38100, 양산시,100,95~99세,2017,109,18,91,19.8,109,18,91,19.8
38100, 양산시,100001, 95세,2017,49,10,39,25.6,49,10,39,25.6
38100, 양산시,100002, 96세,2017,26,X,23,13,26,X,23,13
38100, 양산시,100003, 97세,2017,18,X,14,28.6,18,X,14,28.6
38100, 양산시,100004, 98세,2017,10,X,9,11.1,10,X,9,11.1
38100, 양산시,100005, 99세,2017,6,X,6,0,6,X,6,0
38100, 양산시,101,100세이상,2017,14,X,12,16.7,14,X,12,16.7
38100, 양산시,102,15세미만,2017,52108,26645,25463,104.6,51925,26547,25378,104.6
38100, 양산시,103,15~64세,2017,242395,124706,117689,106,235256,119902,115354,103.9
38100, 양산시,104,65세이상,2017,38093,16163,21930,73.7,37956,16099,21857,73.7
38100, 양산시,086,85세이상,2017,2799,682,2117,32.2,2797,682,2115,32.2
38100, 양산시,126,평균연령,2017,39.6,38.5,40.6,,39.6,38.6,40.6,
38100, 양산시,127,중위연령,2017,40.4,39.4,41.5,,40.7,39.7,41.7,
38110, 창원시,000,합계,2017,1045559,533529,512030,104.2,1026091,520856,505235,103.1
38110, 창원시,005,0~4세,2017,44494,22999,21495,107,44281,22893,21388,107
38110, 창원시,005001, 0세,2017,7639,3953,3686,107.2,7594,3932,3662,107.4
38110, 창원시,005002, 1세,2017,8695,4440,4255,104.3,8645,4416,4229,104.4
38110, 창원시,005003, 2세,2017,9302,4847,4455,108.8,9253,4824,4429,108.9
38110, 창원시,005004, 3세,2017,9323,4851,4472,108.5,9281,4829,4452,108.5
38110, 창원시,005005, 4세,2017,9535,4908,4627,106.1,9508,4892,4616,106
38110, 창원시,010,5~9세,2017,49479,25500,23979,106.3,49387,25449,23938,106.3
38110, 창원시,010001, 5세,2017,10487,5417,5070,106.8,10462,5405,5057,106.9
38110, 창원시,010002, 6세,2017,10075,5208,4867,107,10062,5199,4863,106.9
38110, 창원시,010003, 7세,2017,9626,4989,4637,107.6,9605,4974,4631,107.4
38110, 창원시,010004, 8세,2017,9434,4903,4531,108.2,9415,4896,4519,108.3
38110, 창원시,010005, 9세,2017,9857,4983,4874,102.2,9843,4975,4868,102.2
38110, 창원시,015,10~14세,2017,48405,25530,22875,111.6,48340,25499,22841,111.6
38110, 창원시,015001, 10세,2017,10054,5296,4758,111.3,10039,5286,4753,111.2
38110, 창원시,015002, 11세,2017,9191,4835,4356,111,9177,4829,4348,111.1
38110, 창원시,015003, 12세,2017,9034,4710,4324,108.9,9024,4706,4318,109
38110, 창원시,015004, 13세,2017,9965,5224,4741,110.2,9952,5221,4731,110.4
38110, 창원시,015005, 14세,2017,10161,5465,4696,116.4,10148,5457,4691,116.3
38110, 창원시,020,15~19세,2017,60019,32277,27742,116.3,59807,32162,27645,116.3
38110, 창원시,020001, 15세,2017,10482,5546,4936,112.4,10465,5539,4926,112.4
38110, 창원시,020002, 16세,2017,11792,6265,5527,113.4,11775,6254,5521,113.3
38110, 창원시,020003, 17세,2017,13234,7093,6141,115.5,13204,7077,6127,115.5
38110, 창원시,020004, 18세,2017,12607,6754,5853,115.4,12557,6721,5836,115.2
38110, 창원시,020005, 19세,2017,11904,6619,5285,125.2,11806,6571,5235,125.5
38110, 창원시,025,20~24세,2017,68200,38512,29688,129.7,66471,37511,28960,129.5
38110, 창원시,025001, 20세,2017,13167,7472,5695,131.2,12973,7398,5575,132.7
38110, 창원시,025002, 21세,2017,13968,8121,5847,138.9,13724,7999,5725,139.7
38110, 창원시,025003, 22세,2017,13598,7707,5891,130.8,13234,7500,5734,130.8
38110, 창원시,025004, 23세,2017,13715,7609,6106,124.6,13355,7394,5961,124
38110, 창원시,025005, 24세,2017,13752,7603,6149,123.6,13185,7220,5965,121
38110, 창원시,030,25~29세,2017,66596,37148,29448,126.1,62619,34325,28294,121.3
38110, 창원시,030001, 25세,2017,14110,7778,6332,122.8,13477,7361,6116,120.4
38110, 창원시,030002, 26세,2017,13518,7467,6051,123.4,12744,6915,5829,118.6
38110, 창원시,030003, 27세,2017,13300,7519,5781,130.1,12446,6918,5528,125.1
38110, 창원시,030004, 28세,2017,12982,7314,5668,129,12101,6676,5425,123.1
38110, 창원시,030005, 29세,2017,12686,7070,5616,125.9,11851,6455,5396,119.6
38110, 창원시,035,30~34세,2017,69621,38236,31385,121.8,65593,35275,30318,116.4
38110, 창원시,035001, 30세,2017,13055,7261,5794,125.3,12120,6595,5525,119.4
38110, 창원시,035002, 31세,2017,13127,7380,5747,128.4,12223,6728,5495,122.4
38110, 창원시,035003, 32세,2017,13646,7529,6117,123.1,12797,6890,5907,116.6
38110, 창원시,035004, 33세,2017,14079,7640,6439,118.7,13384,7120,6264,113.7
38110, 창원시,035005, 34세,2017,15714,8426,7288,115.6,15069,7942,7127,111.4
38110, 창원시,040,35~39세,2017,84377,44262,40115,110.3,81914,42508,39406,107.9
38110, 창원시,040001, 35세,2017,17137,9000,8137,110.6,16520,8568,7952,107.7
38110, 창원시,040002, 36세,2017,17389,9260,8129,113.9,16876,8886,7990,111.2
38110, 창원시,040003, 37세,2017,17889,9200,8689,105.9,17421,8868,8553,103.7
38110, 창원시,040004, 38세,2017,16554,8662,7892,109.8,16101,8343,7758,107.5
38110, 창원시,040005, 39세,2017,15408,8140,7268,112,14996,7843,7153,109.6
38110, 창원시,045,40~44세,2017,82194,42033,40161,104.7,80479,40884,39595,103.3
38110, 창원시,045001, 40세,2017,15392,8015,7377,108.6,15019,7752,7267,106.7
38110, 창원시,045002, 41세,2017,15105,7877,7228,109,14754,7625,7129,107
38110, 창원시,045003, 42세,2017,16048,8138,7910,102.9,15721,7916,7805,101.4
38110, 창원시,045004, 43세,2017,17536,8902,8634,103.1,17206,8691,8515,102.1
38110, 창원시,045005, 44세,2017,18113,9101,9012,101,17779,8900,8879,100.2
38110, 창원시,050,45~49세,2017,95883,47535,48348,98.3,94159,46508,47651,97.6
38110, 창원시,050001, 45세,2017,17631,9001,8630,104.3,17287,8775,8512,103.1
38110, 창원시,050002, 46세,2017,19284,9526,9758,97.6,18905,9284,9621,96.5
38110, 창원시,050003, 47세,2017,19366,9607,9759,98.4,19013,9414,9599,98.1
38110, 창원시,050004, 48세,2017,19659,9771,9888,98.8,19344,9587,9757,98.3
38110, 창원시,050005, 49세,2017,19943,9630,10313,93.4,19610,9448,10162,93
38110, 창원시,055,50~54세,2017,90178,44959,45219,99.4,88760,44175,44585,99.1
38110, 창원시,055001, 50세,2017,18222,8837,9385,94.2,17955,8681,9274,93.6
38110, 창원시,055002, 51세,2017,18300,9273,9027,102.7,18021,9114,8907,102.3
38110, 창원시,055003, 52세,2017,18644,9203,9441,97.5,18361,9047,9314,97.1
38110, 창원시,055004, 53세,2017,16564,8264,8300,99.6,16272,8103,8169,99.2
38110, 창원시,055005, 54세,2017,18448,9382,9066,103.5,18151,9230,8921,103.5
38110, 창원시,060,55~59세,2017,94401,47539,46862,101.4,93558,47131,46427,101.5
38110, 창원시,060001, 55세,2017,19394,9803,9591,102.2,19171,9694,9477,102.3
38110, 창원시,060002, 56세,2017,20680,10335,10345,99.9,20530,10265,10265,100
38110, 창원시,060003, 57세,2017,20296,10076,10220,98.6,20113,9990,10123,98.7
38110, 창원시,060004, 58세,2017,17620,8934,8686,102.9,17464,8862,8602,103
38110, 창원시,060005, 59세,2017,16411,8391,8020,104.6,16280,8320,7960,104.5
38110, 창원시,065,60~64세,2017,68585,34072,34513,98.7,68028,33794,34234,98.7
38110, 창원시,065001, 60세,2017,15805,7875,7930,99.3,15670,7799,7871,99.1
38110, 창원시,065002, 61세,2017,14771,7216,7555,95.5,14646,7152,7494,95.4
38110, 창원시,065003, 62세,2017,14976,7282,7694,94.6,14867,7232,7635,94.7
38110, 창원시,065004, 63세,2017,12305,6302,6003,105,12212,6263,5949,105.3
38110, 창원시,065005, 64세,2017,10728,5397,5331,101.2,10633,5348,5285,101.2
38110, 창원시,070,65~69세,2017,45403,22481,22922,98.1,45168,22372,22796,98.1
38110, 창원시,070001, 65세,2017,11260,5670,5590,101.4,11205,5644,5561,101.5
38110, 창원시,070002, 66세,2017,8740,4241,4499,94.3,8678,4214,4464,94.4
38110, 창원시,070003, 67세,2017,8515,4183,4332,96.6,8459,4154,4305,96.5
38110, 창원시,070004, 68세,2017,8688,4305,4383,98.2,8647,4289,4358,98.4
38110, 창원시,070005, 69세,2017,8200,4082,4118,99.1,8179,4071,4108,99.1
38110, 창원시,075,70~74세,2017,29727,13808,15919,86.7,29626,13765,15861,86.8
38110, 창원시,075001, 70세,2017,7611,3661,3950,92.7,7575,3644,3931,92.7
38110, 창원시,075002, 71세,2017,5507,2700,2807,96.2,5491,2692,2799,96.2
38110, 창원시,075003, 72세,2017,5355,2454,2901,84.6,5341,2447,2894,84.6
38110, 창원시,075004, 73세,2017,5669,2569,3100,82.9,5646,2559,3087,82.9
38110, 창원시,075005, 74세,2017,5585,2424,3161,76.7,5573,2423,3150,76.9
38110, 창원시,080,75~79세,2017,23978,9765,14213,68.7,23922,9745,14177,68.7
38110, 창원시,080001, 75세,2017,5939,2586,3353,77.1,5932,2582,3350,77.1
38110, 창원시,080002, 76세,2017,5144,2149,2995,71.8,5134,2145,2989,71.8
38110, 창원시,080003, 77세,2017,4679,1861,2818,66,4663,1856,2807,66.1
38110, 창원시,080004, 78세,2017,4401,1701,2700,63,4395,1698,2697,63
38110, 창원시,080005, 79세,2017,3815,1468,2347,62.5,3798,1464,2334,62.7
38110, 창원시,085,80~84세,2017,14730,4820,9910,48.6,14704,4810,9894,48.6
38110, 창원시,085001, 80세,2017,3653,1286,2367,54.3,3648,1286,2362,54.4
38110, 창원시,085002, 81세,2017,3273,1131,2142,52.8,3267,1129,2138,52.8
38110, 창원시,085003, 82세,2017,3073,1016,2057,49.4,3067,1014,2053,49.4
38110, 창원시,085004, 83세,2017,2617,772,1845,41.8,2613,770,1843,41.8
38110, 창원시,085005, 84세,2017,2114,615,1499,41,2109,611,1498,40.8
38110, 창원시,090,85~89세,2017,6894,1611,5283,30.5,6888,1610,5278,30.5
38110, 창원시,090001, 85세,2017,1998,518,1480,35,1997,518,1479,35
38110, 창원시,090002, 86세,2017,1517,347,1170,29.7,1517,347,1170,29.7
38110, 창원시,090003, 87세,2017,1351,275,1076,25.6,1348,275,1073,25.6
38110, 창원시,090004, 88세,2017,1174,286,888,32.2,1173,285,888,32.1
38110, 창원시,090005, 89세,2017,854,185,669,27.7,853,185,668,27.7
38110, 창원시,095,90~94세,2017,1998,381,1617,23.6,1991,380,1611,23.6
38110, 창원시,095001, 90세,2017,631,133,498,26.7,631,133,498,26.7
38110, 창원시,095002, 91세,2017,474,91,383,23.8,472,90,382,23.6
38110, 창원시,095003, 92세,2017,424,76,348,21.8,420,76,344,22.1
38110, 창원시,095004, 93세,2017,244,48,196,24.5,243,48,195,24.6
38110, 창원시,095005, 94세,2017,225,33,192,17.2,225,33,192,17.2
38110, 창원시,100,95~99세,2017,352,59,293,20.1,351,58,293,19.8
38110, 창원시,100001, 95세,2017,149,28,121,23.1,149,28,121,23.1
38110, 창원시,100002, 96세,2017,79,10,69,14.5,78,9,69,13
38110, 창원시,100003, 97세,2017,65,5,60,8.3,65,5,60,8.3
38110, 창원시,100004, 98세,2017,29,9,20,45,29,9,20,45
38110, 창원시,100005, 99세,2017,30,7,23,30.4,30,7,23,30.4
38110, 창원시,101,100세이상,2017,45,X,43,4.7,45,X,43,4.7
38110, 창원시,102,15세미만,2017,142378,74029,68349,108.3,142008,73841,68167,108.3
38110, 창원시,103,15~64세,2017,780054,406573,373481,108.9,761388,394273,367115,107.4
38110, 창원시,104,65세이상,2017,123127,52927,70200,75.4,122695,52742,69953,75.4
38110, 창원시,086,85세이상,2017,9289,2053,7236,28.4,9275,2050,7225,28.4
38110, 창원시,126,평균연령,2017,40.7,39.4,42,,40.7,39.5,42,
38110, 창원시,127,중위연령,2017,42.1,40.3,43.8,,42.3,40.6,43.9,
38111, 의창구,000,합계,2017,250560,128181,122379,104.7,245726,125171,120555,103.8
38111, 의창구,005,0~4세,2017,10379,5354,5025,106.5,10327,5325,5002,106.5
38111, 의창구,005001, 0세,2017,1875,992,883,112.3,1866,987,879,112.3
38111, 의창구,005002, 1세,2017,1998,1013,985,102.8,1983,1004,979,102.6
38111, 의창구,005003, 2세,2017,2203,1129,1074,105.1,2195,1126,1069,105.3
38111, 의창구,005004, 3세,2017,2152,1137,1015,112,2142,1131,1011,111.9
38111, 의창구,005005, 4세,2017,2151,1083,1068,101.4,2141,1077,1064,101.2
38111, 의창구,010,5~9세,2017,10934,5642,5292,106.6,10902,5622,5280,106.5
38111, 의창구,010001, 5세,2017,2334,1188,1146,103.7,2326,1184,1142,103.7
38111, 의창구,010002, 6세,2017,2236,1180,1056,111.7,2229,1174,1055,111.3
38111, 의창구,010003, 7세,2017,2153,1121,1032,108.6,2144,1116,1028,108.6
38111, 의창구,010004, 8세,2017,2094,1053,1041,101.2,2091,1052,1039,101.3
38111, 의창구,010005, 9세,2017,2117,1100,1017,108.2,2112,1096,1016,107.9
38111, 의창구,015,10~14세,2017,10341,5462,4879,111.9,10329,5460,4869,112.1
38111, 의창구,015001, 10세,2017,2092,1094,998,109.6,2091,1093,998,109.5
38111, 의창구,015002, 11세,2017,1937,997,940,106.1,1934,997,937,106.4
38111, 의창구,015003, 12세,2017,1932,1054,878,120,1929,1053,876,120.2
38111, 의창구,015004, 13세,2017,2180,1150,1030,111.7,2177,1150,1027,112
38111, 의창구,015005, 14세,2017,2200,1167,1033,113,2198,1167,1031,113.2
38111, 의창구,020,15~19세,2017,14942,8120,6822,119,14897,8101,6796,119.2
38111, 의창구,020001, 15세,2017,2384,1337,1047,127.7,2377,1333,1044,127.7
38111, 의창구,020002, 16세,2017,2800,1468,1332,110.2,2796,1466,1330,110.2
38111, 의창구,020003, 17세,2017,3250,1766,1484,119,3247,1765,1482,119.1
38111, 의창구,020004, 18세,2017,3174,1706,1468,116.2,3167,1703,1464,116.3
38111, 의창구,020005, 19세,2017,3334,1843,1491,123.6,3310,1834,1476,124.3
38111, 의창구,025,20~24세,2017,19112,10752,8360,128.6,18653,10491,8162,128.5
38111, 의창구,025001, 20세,2017,3662,2022,1640,123.3,3601,2004,1597,125.5
38111, 의창구,025002, 21세,2017,3862,2201,1661,132.5,3802,2171,1631,133.1
38111, 의창구,025003, 22세,2017,3897,2262,1635,138.3,3814,2207,1607,137.3
38111, 의창구,025004, 23세,2017,3893,2176,1717,126.7,3793,2117,1676,126.3
38111, 의창구,025005, 24세,2017,3798,2091,1707,122.5,3643,1992,1651,120.7
38111, 의창구,030,25~29세,2017,17132,9504,7628,124.6,16159,8829,7330,120.5
38111, 의창구,030001, 25세,2017,3814,2116,1698,124.6,3646,2004,1642,122
38111, 의창구,030002, 26세,2017,3622,1996,1626,122.8,3424,1857,1567,118.5
38111, 의창구,030003, 27세,2017,3407,1910,1497,127.6,3193,1760,1433,122.8
38111, 의창구,030004, 28세,2017,3191,1812,1379,131.4,2977,1667,1310,127.3
38111, 의창구,030005, 29세,2017,3098,1670,1428,116.9,2919,1541,1378,111.8
38111, 의창구,035,30~34세,2017,16488,8981,7507,119.6,15584,8348,7236,115.4
38111, 의창구,035001, 30세,2017,3038,1708,1330,128.4,2812,1555,1257,123.7
38111, 의창구,035002, 31세,2017,3158,1783,1375,129.7,2957,1646,1311,125.6
38111, 의창구,035003, 32세,2017,3313,1806,1507,119.8,3113,1666,1447,115.1
38111, 의창구,035004, 33세,2017,3285,1720,1565,109.9,3146,1619,1527,106
38111, 의창구,035005, 34세,2017,3694,1964,1730,113.5,3556,1862,1694,109.9
38111, 의창구,040,35~39세,2017,19409,10269,9140,112.4,18794,9858,8936,110.3
38111, 의창구,040001, 35세,2017,4073,2162,1911,113.1,3912,2054,1858,110.5
38111, 의창구,040002, 36세,2017,4047,2121,1926,110.1,3935,2037,1898,107.3
38111, 의창구,040003, 37세,2017,4157,2179,1978,110.2,4034,2099,1935,108.5
38111, 의창구,040004, 38세,2017,3574,1897,1677,113.1,3465,1828,1637,111.7
38111, 의창구,040005, 39세,2017,3558,1910,1648,115.9,3448,1840,1608,114.4
38111, 의창구,045,40~44세,2017,18675,9571,9104,105.1,18230,9295,8935,104
38111, 의창구,045001, 40세,2017,3376,1789,1587,112.7,3290,1735,1555,111.6
38111, 의창구,045002, 41세,2017,3483,1829,1654,110.6,3388,1764,1624,108.6
38111, 의창구,045003, 42세,2017,3586,1844,1742,105.9,3494,1783,1711,104.2
38111, 의창구,045004, 43세,2017,3971,2007,1964,102.2,3888,1955,1933,101.1
38111, 의창구,045005, 44세,2017,4259,2102,2157,97.5,4170,2058,2112,97.4
38111, 의창구,050,45~49세,2017,23661,11357,12304,92.3,23229,11117,12112,91.8
38111, 의창구,050001, 45세,2017,4199,2129,2070,102.9,4121,2084,2037,102.3
38111, 의창구,050002, 46세,2017,4609,2184,2425,90.1,4527,2138,2389,89.5
38111, 의창구,050003, 47세,2017,4779,2297,2482,92.5,4686,2235,2451,91.2
38111, 의창구,050004, 48세,2017,4973,2382,2591,91.9,4886,2340,2546,91.9
38111, 의창구,050005, 49세,2017,5101,2365,2736,86.4,5009,2320,2689,86.3
38111, 의창구,055,50~54세,2017,23522,11611,11911,97.5,23126,11386,11740,97
38111, 의창구,055001, 50세,2017,4757,2233,2524,88.5,4681,2191,2490,88
38111, 의창구,055002, 51세,2017,4776,2357,2419,97.4,4695,2303,2392,96.3
38111, 의창구,055003, 52세,2017,5001,2476,2525,98.1,4914,2429,2485,97.7
38111, 의창구,055004, 53세,2017,4249,2097,2152,97.4,4171,2055,2116,97.1
38111, 의창구,055005, 54세,2017,4739,2448,2291,106.9,4665,2408,2257,106.7
38111, 의창구,060,55~59세,2017,23591,12145,11446,106.1,23381,12045,11336,106.3
38111, 의창구,060001, 55세,2017,5018,2595,2423,107.1,4961,2569,2392,107.4
38111, 의창구,060002, 56세,2017,5255,2702,2553,105.8,5214,2685,2529,106.2
38111, 의창구,060003, 57세,2017,5065,2568,2497,102.8,5018,2547,2471,103.1
38111, 의창구,060004, 58세,2017,4291,2216,2075,106.8,4257,2197,2060,106.7
38111, 의창구,060005, 59세,2017,3962,2064,1898,108.7,3931,2047,1884,108.7
38111, 의창구,065,60~64세,2017,15957,8004,7953,100.6,15831,7940,7891,100.6
38111, 의창구,065001, 60세,2017,3765,1871,1894,98.8,3731,1850,1881,98.4
38111, 의창구,065002, 61세,2017,3522,1747,1775,98.4,3497,1736,1761,98.6
38111, 의창구,065003, 62세,2017,3375,1676,1699,98.6,3349,1664,1685,98.8
38111, 의창구,065004, 63세,2017,2825,1446,1379,104.9,2808,1439,1369,105.1
38111, 의창구,065005, 64세,2017,2470,1264,1206,104.8,2446,1251,1195,104.7
38111, 의창구,070,65~69세,2017,9861,5080,4781,106.3,9775,5038,4737,106.4
38111, 의창구,070001, 65세,2017,2539,1318,1221,107.9,2517,1308,1209,108.2
38111, 의창구,070002, 66세,2017,1926,972,954,101.9,1906,963,943,102.1
38111, 의창구,070003, 67세,2017,1842,961,881,109.1,1822,949,873,108.7
38111, 의창구,070004, 68세,2017,1821,942,879,107.2,1806,938,868,108.1
38111, 의창구,070005, 69세,2017,1733,887,846,104.8,1724,880,844,104.3
38111, 의창구,075,70~74세,2017,6075,2908,3167,91.8,6053,2903,3150,92.2
38111, 의창구,075001, 70세,2017,1577,784,793,98.9,1568,782,786,99.5
38111, 의창구,075002, 71세,2017,1100,559,541,103.3,1095,558,537,103.9
38111, 의창구,075003, 72세,2017,1074,511,563,90.8,1073,510,563,90.6
38111, 의창구,075004, 73세,2017,1125,522,603,86.6,1121,521,600,86.8
38111, 의창구,075005, 74세,2017,1199,532,667,79.8,1196,532,664,80.1
38111, 의창구,080,75~79세,2017,4967,1936,3031,63.9,4952,1931,3021,63.9
38111, 의창구,080001, 75세,2017,1247,531,716,74.2,1245,530,715,74.1
38111, 의창구,080002, 76세,2017,1031,422,609,69.3,1026,420,606,69.3
38111, 의창구,080003, 77세,2017,996,380,616,61.7,994,380,614,61.9
38111, 의창구,080004, 78세,2017,902,322,580,55.5,900,321,579,55.4
38111, 의창구,080005, 79세,2017,791,281,510,55.1,787,280,507,55.2
38111, 의창구,085,80~84세,2017,3321,1028,2293,44.8,3315,1026,2289,44.8
38111, 의창구,085001, 80세,2017,783,257,526,48.9,782,257,525,49
38111, 의창구,085002, 81세,2017,695,241,454,53.1,692,240,452,53.1
38111, 의창구,085003, 82세,2017,766,260,506,51.4,765,260,505,51.5
38111, 의창구,085004, 83세,2017,597,141,456,30.9,597,141,456,30.9
38111, 의창구,085005, 84세,2017,480,129,351,36.8,479,128,351,36.5
38111, 의창구,090,85~89세,2017,1614,353,1261,28,1612,353,1259,28
38111, 의창구,090001, 85세,2017,486,110,376,29.3,485,110,375,29.3
38111, 의창구,090002, 86세,2017,351,83,268,31,351,83,268,31
38111, 의창구,090003, 87세,2017,311,63,248,25.4,310,63,247,25.5
38111, 의창구,090004, 88세,2017,265,58,207,28,265,58,207,28
38111, 의창구,090005, 89세,2017,201,39,162,24.1,201,39,162,24.1
38111, 의창구,095,90~94세,2017,478,92,386,23.8,476,91,385,23.6
38111, 의창구,095001, 90세,2017,164,27,137,19.7,164,27,137,19.7
38111, 의창구,095002, 91세,2017,110,22,88,25,109,21,88,23.9
38111, 의창구,095003, 92세,2017,104,26,78,33.3,104,26,78,33.3
38111, 의창구,095004, 93세,2017,46,8,38,21.1,45,8,37,21.6
38111, 의창구,095005, 94세,2017,54,9,45,20,54,9,45,20
38111, 의창구,100,95~99세,2017,88,11,77,14.3,88,11,77,14.3
38111, 의창구,100001, 95세,2017,42,6,36,16.7,42,6,36,16.7
38111, 의창구,100002, 96세,2017,15,X,14,7.1,15,X,14,7.1
38111, 의창구,100003, 97세,2017,18,X,17,5.9,18,X,17,5.9
38111, 의창구,100004, 98세,2017,5,X,X,25,5,X,X,25
38111, 의창구,100005, 99세,2017,8,X,6,33.3,8,X,6,33.3
38111, 의창구,101,100세이상,2017,13,X,12,8.3,13,X,12,8.3
38111, 의창구,102,15세미만,2017,31654,16458,15196,108.3,31558,16407,15151,108.3
38111, 의창구,103,15~64세,2017,192489,100314,92175,108.8,187884,97410,90474,107.7
38111, 의창구,104,65세이상,2017,26417,11409,15008,76,26284,11354,14930,76
38111, 의창구,086,85세이상,2017,2193,457,1736,26.3,2189,456,1733,26.3
38111, 의창구,126,평균연령,2017,40.4,39.2,41.7,,40.5,39.3,41.7,
38111, 의창구,127,중위연령,2017,41.9,40,43.8,,42.2,40.3,43.9,
38112, 성산구,000,합계,2017,226726,118239,108487,109,221789,114631,107158,107
38112, 성산구,005,0~4세,2017,9178,4684,4494,104.2,9136,4664,4472,104.3
38112, 성산구,005001, 0세,2017,1589,823,766,107.4,1579,820,759,108
38112, 성산구,005002, 1세,2017,1834,928,906,102.4,1826,923,903,102.2
38112, 성산구,005003, 2세,2017,1925,993,932,106.5,1918,991,927,106.9
38112, 성산구,005004, 3세,2017,1892,958,934,102.6,1881,953,928,102.7
38112, 성산구,005005, 4세,2017,1938,982,956,102.7,1932,977,955,102.3
38112, 성산구,010,5~9세,2017,10643,5497,5146,106.8,10626,5489,5137,106.9
38112, 성산구,010001, 5세,2017,2190,1120,1070,104.7,2186,1118,1068,104.7
38112, 성산구,010002, 6세,2017,2126,1091,1035,105.4,2124,1090,1034,105.4
38112, 성산구,010003, 7세,2017,2043,1055,988,106.8,2039,1052,987,106.6
38112, 성산구,010004, 8세,2017,2055,1095,960,114.1,2050,1094,956,114.4
38112, 성산구,010005, 9세,2017,2229,1136,1093,103.9,2227,1135,1092,103.9
38112, 성산구,015,10~14세,2017,11780,6294,5486,114.7,11763,6285,5478,114.7
38112, 성산구,015001, 10세,2017,2346,1267,1079,117.4,2343,1264,1079,117.1
38112, 성산구,015002, 11세,2017,2168,1159,1009,114.9,2166,1158,1008,114.9
38112, 성산구,015003, 12세,2017,2220,1174,1046,112.2,2218,1173,1045,112.2
38112, 성산구,015004, 13세,2017,2420,1274,1146,111.2,2415,1273,1142,111.5
38112, 성산구,015005, 14세,2017,2626,1420,1206,117.7,2621,1417,1204,117.7
38112, 성산구,020,15~19세,2017,15125,8427,6698,125.8,15090,8411,6679,125.9
38112, 성산구,020001, 15세,2017,2741,1422,1319,107.8,2738,1422,1316,108.1
38112, 성산구,020002, 16세,2017,3175,1728,1447,119.4,3171,1725,1446,119.3
38112, 성산구,020003, 17세,2017,3632,2091,1541,135.7,3628,2088,1540,135.6
38112, 성산구,020004, 18세,2017,3167,1772,1395,127,3161,1769,1392,127.1
38112, 성산구,020005, 19세,2017,2410,1414,996,142,2392,1407,985,142.8
38112, 성산구,025,20~24세,2017,16182,9464,6718,140.9,15828,9207,6621,139.1
38112, 성산구,025001, 20세,2017,2913,1818,1095,166,2893,1805,1088,165.9
38112, 성산구,025002, 21세,2017,3373,2096,1277,164.1,3328,2068,1260,164.1
38112, 성산구,025003, 22세,2017,3172,1850,1322,139.9,3105,1799,1306,137.7
38112, 성산구,025004, 23세,2017,3324,1835,1489,123.2,3240,1774,1466,121
38112, 성산구,025005, 24세,2017,3400,1865,1535,121.5,3262,1761,1501,117.3
38112, 성산구,030,25~29세,2017,17875,10230,7645,133.8,16724,9300,7424,125.3
38112, 성산구,030001, 25세,2017,3624,1989,1635,121.7,3453,1864,1589,117.3
38112, 성산구,030002, 26세,2017,3644,2017,1627,124,3416,1833,1583,115.8
38112, 성산구,030003, 27세,2017,3572,2096,1476,142,3352,1915,1437,133.3
38112, 성산구,030004, 28세,2017,3550,2081,1469,141.7,3292,1871,1421,131.7
38112, 성산구,030005, 29세,2017,3485,2047,1438,142.4,3211,1817,1394,130.3
38112, 성산구,035,30~34세,2017,17052,9894,7158,138.2,15830,8904,6926,128.6
38112, 성산구,035001, 30세,2017,3560,2117,1443,146.7,3286,1898,1388,136.7
38112, 성산구,035002, 31세,2017,3395,2007,1388,144.6,3119,1787,1332,134.2
38112, 성산구,035003, 32세,2017,3351,1996,1355,147.3,3090,1781,1309,136.1
38112, 성산구,035004, 33세,2017,3254,1843,1411,130.6,3043,1669,1374,121.5
38112, 성산구,035005, 34세,2017,3492,1931,1561,123.7,3292,1769,1523,116.2
38112, 성산구,040,35~39세,2017,17264,8866,8398,105.6,16571,8331,8240,101.1
38112, 성산구,040001, 35세,2017,3479,1808,1671,108.2,3307,1674,1633,102.5
38112, 성산구,040002, 36세,2017,3519,1850,1669,110.8,3358,1730,1628,106.3
38112, 성산구,040003, 37세,2017,3573,1802,1771,101.8,3450,1711,1739,98.4
38112, 성산구,040004, 38세,2017,3468,1763,1705,103.4,3335,1655,1680,98.5
38112, 성산구,040005, 39세,2017,3225,1643,1582,103.9,3121,1561,1560,100.1
38112, 성산구,045,40~44세,2017,18373,8701,9672,90,17977,8429,9548,88.3
38112, 성산구,045001, 40세,2017,3358,1653,1705,97,3262,1584,1678,94.4
38112, 성산구,045002, 41세,2017,3307,1605,1702,94.3,3245,1562,1683,92.8
38112, 성산구,045003, 42세,2017,3482,1614,1868,86.4,3399,1560,1839,84.8
38112, 성산구,045004, 43세,2017,3989,1869,2120,88.2,3909,1817,2092,86.9
38112, 성산구,045005, 44세,2017,4237,1960,2277,86.1,4162,1906,2256,84.5
38112, 성산구,050,45~49세,2017,24227,11438,12789,89.4,23848,11195,12653,88.5
38112, 성산구,050001, 45세,2017,4359,2101,2258,93,4281,2044,2237,91.4
38112, 성산구,050002, 46세,2017,4857,2310,2547,90.7,4778,2259,2519,89.7
38112, 성산구,050003, 47세,2017,4955,2345,2610,89.8,4871,2296,2575,89.2
38112, 성산구,050004, 48세,2017,4981,2321,2660,87.3,4900,2265,2635,86
38112, 성산구,050005, 49세,2017,5075,2361,2714,87,5018,2331,2687,86.8
38112, 성산구,055,50~54세,2017,22831,11287,11544,97.8,22547,11128,11419,97.5
38112, 성산구,055001, 50세,2017,4608,2165,2443,88.6,4555,2133,2422,88.1
38112, 성산구,055002, 51세,2017,4612,2316,2296,100.9,4561,2289,2272,100.7
38112, 성산구,055003, 52세,2017,4822,2363,2459,96.1,4764,2331,2433,95.8
38112, 성산구,055004, 53세,2017,4169,2061,2108,97.8,4112,2028,2084,97.3
38112, 성산구,055005, 54세,2017,4620,2382,2238,106.4,4555,2347,2208,106.3
38112, 성산구,060,55~59세,2017,20985,11290,9695,116.5,20813,11206,9607,116.6
38112, 성산구,060001, 55세,2017,4642,2389,2253,106,4596,2366,2230,106.1
38112, 성산구,060002, 56세,2017,4832,2472,2360,104.7,4801,2457,2344,104.8
38112, 성산구,060003, 57세,2017,4603,2492,2111,118,4566,2476,2090,118.5
38112, 성산구,060004, 58세,2017,3657,2085,1572,132.6,3627,2072,1555,133.2
38112, 성산구,060005, 59세,2017,3251,1852,1399,132.4,3223,1835,1388,132.2
38112, 성산구,065,60~64세,2017,11110,5932,5178,114.6,11009,5882,5127,114.7
38112, 성산구,065001, 60세,2017,2827,1539,1288,119.5,2801,1522,1279,119
38112, 성산구,065002, 61세,2017,2463,1261,1202,104.9,2437,1249,1188,105.1
38112, 성산구,065003, 62세,2017,2370,1229,1141,107.7,2350,1221,1129,108.1
38112, 성산구,065004, 63세,2017,1800,997,803,124.2,1787,992,795,124.8
38112, 성산구,065005, 64세,2017,1650,906,744,121.8,1634,898,736,122
38112, 성산구,070,65~69세,2017,5800,3085,2715,113.6,5767,3070,2697,113.8
38112, 성산구,070001, 65세,2017,1530,850,680,125,1522,846,676,125.1
38112, 성산구,070002, 66세,2017,1216,646,570,113.3,1205,639,566,112.9
38112, 성산구,070003, 67세,2017,1050,590,460,128.3,1043,588,455,129.2
38112, 성산구,070004, 68세,2017,1044,518,526,98.5,1040,516,524,98.5
38112, 성산구,070005, 69세,2017,960,481,479,100.4,957,481,476,101.1
38112, 성산구,075,70~74세,2017,3193,1523,1670,91.2,3170,1511,1659,91.1
38112, 성산구,075001, 70세,2017,905,475,430,110.5,899,471,428,110
38112, 성산구,075002, 71세,2017,613,303,310,97.7,608,300,308,97.4
38112, 성산구,075003, 72세,2017,543,265,278,95.3,540,264,276,95.7
38112, 성산구,075004, 73세,2017,563,237,326,72.7,558,233,325,71.7
38112, 성산구,075005, 74세,2017,569,243,326,74.5,565,243,322,75.5
38112, 성산구,080,75~79세,2017,2508,954,1554,61.4,2499,950,1549,61.3
38112, 성산구,080001, 75세,2017,614,262,352,74.4,613,262,351,74.6
38112, 성산구,080002, 76세,2017,512,202,310,65.2,511,201,310,64.8
38112, 성산구,080003, 77세,2017,495,172,323,53.3,491,170,321,53
38112, 성산구,080004, 78세,2017,476,161,315,51.1,476,161,315,51.1
38112, 성산구,080005, 79세,2017,411,157,254,61.8,408,156,252,61.9
38112, 성산구,085,80~84세,2017,1614,473,1141,41.5,1609,470,1139,41.3
38112, 성산구,085001, 80세,2017,377,122,255,47.8,376,122,254,48
38112, 성산구,085002, 81세,2017,353,104,249,41.8,353,104,249,41.8
38112, 성산구,085003, 82세,2017,354,100,254,39.4,353,99,254,39
38112, 성산구,085004, 83세,2017,288,75,213,35.2,287,74,213,34.7
38112, 성산구,085005, 84세,2017,242,72,170,42.4,240,71,169,42
38112, 성산구,090,85~89세,2017,733,148,585,25.3,730,147,583,25.2
38112, 성산구,090001, 85세,2017,203,36,167,21.6,203,36,167,21.6
38112, 성산구,090002, 86세,2017,156,35,121,28.9,156,35,121,28.9
38112, 성산구,090003, 87세,2017,149,25,124,20.2,148,25,123,20.3
38112, 성산구,090004, 88세,2017,133,33,100,33,132,32,100,32
38112, 성산구,090005, 89세,2017,92,19,73,26,91,19,72,26.4
38112, 성산구,095,90~94세,2017,220,48,172,27.9,219,48,171,28.1
38112, 성산구,095001, 90세,2017,69,19,50,38,69,19,50,38
38112, 성산구,095002, 91세,2017,46,6,40,15,46,6,40,15
38112, 성산구,095003, 92세,2017,46,12,34,35.3,45,12,33,36.4
38112, 성산구,095004, 93세,2017,34,7,27,25.9,34,7,27,25.9
38112, 성산구,095005, 94세,2017,25,X,21,19,25,X,21,19
38112, 성산구,100,95~99세,2017,31,X,27,14.8,31,X,27,14.8
38112, 성산구,100001, 95세,2017,16,X,15,6.7,16,X,15,6.7
38112, 성산구,100002, 96세,2017,X,X,X,33.3,X,X,X,33.3
38112, 성산구,100003, 97세,2017,X,X,X,0,X,X,X,0
38112, 성산구,100004, 98세,2017,6,X,5,20,6,X,5,20
38112, 성산구,100005, 99세,2017,X,X,X,50,X,X,X,50
38112, 성산구,101,100세이상,2017,X,X,X,0,X,X,X,0
38112, 성산구,102,15세미만,2017,31601,16475,15126,108.9,31525,16438,15087,109
38112, 성산구,103,15~64세,2017,181024,95529,85495,111.7,176237,91993,84244,109.2
38112, 성산구,104,65세이상,2017,14101,6235,7866,79.3,14027,6200,7827,79.2
38112, 성산구,086,85세이상,2017,986,200,786,25.4,982,199,783,25.4
38112, 성산구,126,평균연령,2017,38.1,37.2,39.1,,38.1,37.3,39.1,
38112, 성산구,127,중위연령,2017,39.5,37.5,41.5,,39.8,38,41.5,
38113, 마산합포구,000,합계,2017,178751,89417,89334,100.1,176168,87852,88316,99.5
38113, 마산합포구,005,0~4세,2017,6874,3593,3281,109.5,6857,3587,3270,109.7
38113, 마산합포구,005001, 0세,2017,1176,618,558,110.8,1172,617,555,111.2
38113, 마산합포구,005002, 1세,2017,1357,721,636,113.4,1355,721,634,113.7
38113, 마산합포구,005003, 2세,2017,1409,719,690,104.2,1403,717,686,104.5
38113, 마산합포구,005004, 3세,2017,1444,764,680,112.4,1440,761,679,112.1
38113, 마산합포구,005005, 4세,2017,1488,771,717,107.5,1487,771,716,107.7
38113, 마산합포구,010,5~9세,2017,7141,3664,3477,105.4,7135,3663,3472,105.5
38113, 마산합포구,010001, 5세,2017,1591,833,758,109.9,1589,833,756,110.2
38113, 마산합포구,010002, 6세,2017,1520,757,763,99.2,1520,757,763,99.2
38113, 마산합포구,010003, 7세,2017,1345,682,663,102.9,1345,682,663,102.9
38113, 마산합포구,010004, 8세,2017,1354,711,643,110.6,1351,710,641,110.8
38113, 마산합포구,010005, 9세,2017,1331,681,650,104.8,1330,681,649,104.9
38113, 마산합포구,015,10~14세,2017,6586,3412,3174,107.5,6577,3408,3169,107.5
38113, 마산합포구,015001, 10세,2017,1401,714,687,103.9,1399,713,686,103.9
38113, 마산합포구,015002, 11세,2017,1257,637,620,102.7,1254,635,619,102.6
38113, 마산합포구,015003, 12세,2017,1206,636,570,111.6,1205,636,569,111.8
38113, 마산합포구,015004, 13세,2017,1350,690,660,104.5,1349,690,659,104.7
38113, 마산합포구,015005, 14세,2017,1372,735,637,115.4,1370,734,636,115.4
38113, 마산합포구,020,15~19세,2017,9379,4917,4462,110.2,9315,4883,4432,110.2
38113, 마산합포구,020001, 15세,2017,1471,722,749,96.4,1467,722,745,96.9
38113, 마산합포구,020002, 16세,2017,1695,878,817,107.5,1693,877,816,107.5
38113, 마산합포구,020003, 17세,2017,1921,978,943,103.7,1913,975,938,103.9
38113, 마산합포구,020004, 18세,2017,2003,1045,958,109.1,1983,1031,952,108.3
38113, 마산합포구,020005, 19세,2017,2289,1294,995,130.1,2259,1278,981,130.3
38113, 마산합포구,025,20~24세,2017,11234,6316,4918,128.4,10862,6145,4717,130.3
38113, 마산합포구,025001, 20세,2017,2155,1182,973,121.5,2099,1166,933,125
38113, 마산합포구,025002, 21세,2017,2271,1280,991,129.2,2203,1257,946,132.9
38113, 마산합포구,025003, 22세,2017,2406,1342,1064,126.1,2306,1298,1008,128.8
38113, 마산합포구,025004, 23세,2017,2253,1269,984,129,2190,1233,957,128.8
38113, 마산합포구,025005, 24세,2017,2149,1243,906,137.2,2064,1191,873,136.4
38113, 마산합포구,030,25~29세,2017,9779,5492,4287,128.1,9288,5180,4108,126.1
38113, 마산합포구,030001, 25세,2017,2138,1204,934,128.9,2058,1153,905,127.4
38113, 마산합포구,030002, 26세,2017,1977,1129,848,133.1,1877,1062,815,130.3
38113, 마산합포구,030003, 27세,2017,1924,1061,863,122.9,1823,1004,819,122.6
38113, 마산합포구,030004, 28세,2017,1924,1086,838,129.6,1818,1015,803,126.4
38113, 마산합포구,030005, 29세,2017,1816,1012,804,125.9,1712,946,766,123.5
38113, 마산합포구,035,30~34세,2017,10773,5830,4943,117.9,10309,5494,4815,114.1
38113, 마산합포구,035001, 30세,2017,1921,1019,902,113,1835,959,876,109.5
38113, 마산합포구,035002, 31세,2017,1995,1102,893,123.4,1892,1031,861,119.7
38113, 마산합포구,035003, 32세,2017,2170,1186,984,120.5,2066,1107,959,115.4
38113, 마산합포구,035004, 33세,2017,2207,1202,1005,119.6,2121,1139,982,116
38113, 마산합포구,035005, 34세,2017,2480,1321,1159,114,2395,1258,1137,110.6
38113, 마산합포구,040,35~39세,2017,13650,7299,6351,114.9,13354,7093,6261,113.3
38113, 마산합포구,040001, 35세,2017,2795,1465,1330,110.2,2727,1418,1309,108.3
38113, 마산합포구,040002, 36세,2017,2855,1595,1260,126.6,2785,1548,1237,125.1
38113, 마산합포구,040003, 37세,2017,2928,1511,1417,106.6,2860,1461,1399,104.4
38113, 마산합포구,040004, 38세,2017,2699,1430,1269,112.7,2662,1408,1254,112.3
38113, 마산합포구,040005, 39세,2017,2373,1298,1075,120.7,2320,1258,1062,118.5
38113, 마산합포구,045,40~44세,2017,12282,6587,5695,115.7,12029,6414,5615,114.2
38113, 마산합포구,045001, 40세,2017,2351,1302,1049,124.1,2284,1253,1031,121.5
38113, 마산합포구,045002, 41세,2017,2228,1201,1027,116.9,2177,1161,1016,114.3
38113, 마산합포구,045003, 42세,2017,2471,1330,1141,116.6,2420,1292,1128,114.5
38113, 마산합포구,045004, 43세,2017,2545,1343,1202,111.7,2499,1319,1180,111.8
38113, 마산합포구,045005, 44세,2017,2687,1411,1276,110.6,2649,1389,1260,110.2
38113, 마산합포구,050,45~49세,2017,14066,7100,6966,101.9,13858,6978,6880,101.4
38113, 마산합포구,050001, 45세,2017,2529,1335,1194,111.8,2477,1298,1179,110.1
38113, 마산합포구,050002, 46세,2017,2811,1405,1406,99.9,2764,1373,1391,98.7
38113, 마산합포구,050003, 47세,2017,2832,1452,1380,105.2,2795,1440,1355,106.3
38113, 마산합포구,050004, 48세,2017,2918,1454,1464,99.3,2891,1441,1450,99.4
38113, 마산합포구,050005, 49세,2017,2976,1454,1522,95.5,2931,1426,1505,94.8
38113, 마산합포구,055,50~54세,2017,13701,6806,6895,98.7,13529,6721,6808,98.7
38113, 마산합포구,055001, 50세,2017,2716,1360,1356,100.3,2687,1343,1344,99.9
38113, 마산합포구,055002, 51세,2017,2714,1397,1317,106.1,2679,1378,1301,105.9
38113, 마산합포구,055003, 52세,2017,2842,1395,1447,96.4,2813,1381,1432,96.4
38113, 마산합포구,055004, 53세,2017,2553,1266,1287,98.4,2511,1248,1263,98.8
38113, 마산합포구,055005, 54세,2017,2876,1388,1488,93.3,2839,1371,1468,93.4
38113, 마산합포구,060,55~59세,2017,16922,8002,8920,89.7,16827,7951,8876,89.6
38113, 마산합포구,060001, 55세,2017,3213,1557,1656,94,3188,1544,1644,93.9
38113, 마산합포구,060002, 56세,2017,3541,1650,1891,87.3,3527,1642,1885,87.1
38113, 마산합포구,060003, 57세,2017,3549,1657,1892,87.6,3522,1643,1879,87.4
38113, 마산합포구,060004, 58세,2017,3421,1602,1819,88.1,3403,1594,1809,88.1
38113, 마산합포구,060005, 59세,2017,3198,1536,1662,92.4,3187,1528,1659,92.1
38113, 마산합포구,065,60~64세,2017,14840,7117,7723,92.2,14758,7077,7681,92.1
38113, 마산합포구,065001, 60세,2017,3197,1544,1653,93.4,3172,1532,1640,93.4
38113, 마산합포구,065002, 61세,2017,3155,1471,1684,87.4,3139,1463,1676,87.3
38113, 마산합포구,065003, 62세,2017,3330,1573,1757,89.5,3315,1565,1750,89.4
38113, 마산합포구,065004, 63세,2017,2782,1397,1385,100.9,2767,1389,1378,100.8
38113, 마산합포구,065005, 64세,2017,2376,1132,1244,91,2365,1128,1237,91.2
38113, 마산합포구,070,65~69세,2017,10929,5281,5648,93.5,10903,5268,5635,93.5
38113, 마산합포구,070001, 65세,2017,2603,1242,1361,91.3,2594,1238,1356,91.3
38113, 마산합포구,070002, 66세,2017,2005,962,1043,92.2,2000,960,1040,92.3
38113, 마산합포구,070003, 67세,2017,2122,1016,1106,91.9,2116,1012,1104,91.7
38113, 마산합포구,070004, 68세,2017,2167,1072,1095,97.9,2162,1069,1093,97.8
38113, 마산합포구,070005, 69세,2017,2032,989,1043,94.8,2031,989,1042,94.9
38113, 마산합포구,075,70~74세,2017,7738,3453,4285,80.6,7721,3446,4275,80.6
38113, 마산합포구,075001, 70세,2017,1923,870,1053,82.6,1916,868,1048,82.8
38113, 마산합포구,075002, 71세,2017,1402,644,758,85,1401,644,757,85.1
38113, 마산합포구,075003, 72세,2017,1446,646,800,80.8,1441,643,798,80.6
38113, 마산합포구,075004, 73세,2017,1503,675,828,81.5,1500,673,827,81.4
38113, 마산합포구,075005, 74세,2017,1464,618,846,73,1463,618,845,73.1
38113, 마산합포구,080,75~79세,2017,6390,2639,3751,70.4,6385,2636,3749,70.3
38113, 마산합포구,080001, 75세,2017,1575,705,870,81,1575,705,870,81
38113, 마산합포구,080002, 76세,2017,1444,609,835,72.9,1444,609,835,72.9
38113, 마산합포구,080003, 77세,2017,1227,502,725,69.2,1224,499,725,68.8
38113, 마산합포구,080004, 78세,2017,1151,437,714,61.2,1151,437,714,61.2
38113, 마산합포구,080005, 79세,2017,993,386,607,63.6,991,386,605,63.8
38113, 마산합포구,085,80~84세,2017,3907,1301,2606,49.9,3904,1301,2603,50
38113, 마산합포구,085001, 80세,2017,1010,362,648,55.9,1008,362,646,56
38113, 마산합포구,085002, 81세,2017,900,303,597,50.8,900,303,597,50.8
38113, 마산합포구,085003, 82세,2017,741,257,484,53.1,741,257,484,53.1
38113, 마산합포구,085004, 83세,2017,695,225,470,47.9,694,225,469,48
38113, 마산합포구,085005, 84세,2017,561,154,407,37.8,561,154,407,37.8
38113, 마산합포구,090,85~89세,2017,1901,482,1419,34,1901,482,1419,34
38113, 마산합포구,090001, 85세,2017,545,165,380,43.4,545,165,380,43.4
38113, 마산합포구,090002, 86세,2017,423,100,323,31,423,100,323,31
38113, 마산합포구,090003, 87세,2017,400,86,314,27.4,400,86,314,27.4
38113, 마산합포구,090004, 88세,2017,314,86,228,37.7,314,86,228,37.7
38113, 마산합포구,090005, 89세,2017,219,45,174,25.9,219,45,174,25.9
38113, 마산합포구,095,90~94세,2017,550,107,443,24.2,548,107,441,24.3
38113, 마산합포구,095001, 90세,2017,170,41,129,31.8,170,41,129,31.8
38113, 마산합포구,095002, 91세,2017,132,29,103,28.2,132,29,103,28.2
38113, 마산합포구,095003, 92세,2017,113,13,100,13,111,13,98,13.3
38113, 마산합포구,095004, 93세,2017,68,14,54,25.9,68,14,54,25.9
38113, 마산합포구,095005, 94세,2017,67,10,57,17.5,67,10,57,17.5
38113, 마산합포구,100,95~99세,2017,96,19,77,24.7,95,18,77,23.4
38113, 마산합포구,100001, 95세,2017,40,9,31,29,40,9,31,29
38113, 마산합포구,100002, 96세,2017,27,X,24,12.5,26,X,24,8.3
38113, 마산합포구,100003, 97세,2017,13,X,12,8.3,13,X,12,8.3
38113, 마산합포구,100004, 98세,2017,10,5,5,100,10,5,5,100
38113, 마산합포구,100005, 99세,2017,6,X,5,20,6,X,5,20
38113, 마산합포구,101,100세이상,2017,13,X,13,0,13,X,13,0
38113, 마산합포구,102,15세미만,2017,20601,10669,9932,107.4,20569,10658,9911,107.5
38113, 마산합포구,103,15~64세,2017,126626,65466,61160,107,124129,63936,60193,106.2
38113, 마산합포구,104,65세이상,2017,31524,13282,18242,72.8,31470,13258,18212,72.8
38113, 마산합포구,086,85세이상,2017,2560,608,1952,31.1,2557,607,1950,31.1
38113, 마산합포구,126,평균연령,2017,43.9,42.2,45.7,,44,42.3,45.8,
38113, 마산합포구,127,중위연령,2017,45.7,43.3,48.1,,46,43.6,48.3,
38114, 마산회원구,000,합계,2017,202864,101910,100954,100.9,200094,100275,99819,100.5
38114, 마산회원구,005,0~4세,2017,7391,3806,3585,106.2,7372,3796,3576,106.2
38114, 마산회원구,005001, 0세,2017,1187,605,582,104,1182,603,579,104.1
38114, 마산회원구,005002, 1세,2017,1401,703,698,100.7,1395,701,694,101
38114, 마산회원구,005003, 2세,2017,1581,814,767,106.1,1577,811,766,105.9
38114, 마산회원구,005004, 3세,2017,1581,842,739,113.9,1578,840,738,113.8
38114, 마산회원구,005005, 4세,2017,1641,842,799,105.4,1640,841,799,105.3
38114, 마산회원구,010,5~9세,2017,9117,4787,4330,110.6,9103,4780,4323,110.6
38114, 마산회원구,010001, 5세,2017,1861,971,890,109.1,1854,967,887,109
38114, 마산회원구,010002, 6세,2017,1844,998,846,118,1844,998,846,118
38114, 마산회원구,010003, 7세,2017,1797,922,875,105.4,1794,920,874,105.3
38114, 마산회원구,010004, 8세,2017,1740,948,792,119.7,1738,948,790,120
38114, 마산회원구,010005, 9세,2017,1875,948,927,102.3,1873,947,926,102.3
38114, 마산회원구,015,10~14세,2017,9451,4961,4490,110.5,9447,4959,4488,110.5
38114, 마산회원구,015001, 10세,2017,1939,1047,892,117.4,1937,1046,891,117.4
38114, 마산회원구,015002, 11세,2017,1799,948,851,111.4,1797,947,850,111.4
38114, 마산회원구,015003, 12세,2017,1785,892,893,99.9,1785,892,893,99.9
38114, 마산회원구,015004, 13세,2017,1935,988,947,104.3,1935,988,947,104.3
38114, 마산회원구,015005, 14세,2017,1993,1086,907,119.7,1993,1086,907,119.7
38114, 마산회원구,020,15~19세,2017,11347,5971,5376,111.1,11305,5945,5360,110.9
38114, 마산회원구,020001, 15세,2017,1960,1045,915,114.2,1960,1045,915,114.2
38114, 마산회원구,020002, 16세,2017,2141,1151,990,116.3,2138,1149,989,116.2
38114, 마산회원구,020003, 17세,2017,2399,1272,1127,112.9,2389,1267,1122,112.9
38114, 마산회원구,020004, 18세,2017,2366,1236,1130,109.4,2356,1228,1128,108.9
38114, 마산회원구,020005, 19세,2017,2481,1267,1214,104.4,2462,1256,1206,104.1
38114, 마산회원구,025,20~24세,2017,13173,7002,6171,113.5,12919,6874,6045,113.7
38114, 마산회원구,025001, 20세,2017,2789,1437,1352,106.3,2760,1423,1337,106.4
38114, 마산회원구,025002, 21세,2017,2732,1500,1232,121.8,2693,1476,1217,121.3
38114, 마산회원구,025003, 22세,2017,2540,1334,1206,110.6,2481,1307,1174,111.3
38114, 마산회원구,025004, 23세,2017,2527,1358,1169,116.2,2472,1339,1133,118.2
38114, 마산회원구,025005, 24세,2017,2585,1373,1212,113.3,2513,1329,1184,112.2
38114, 마산회원구,030,25~29세,2017,11637,6347,5290,120,11069,5981,5088,117.6
38114, 마산회원구,030001, 25세,2017,2543,1385,1158,119.6,2465,1344,1121,119.9
38114, 마산회원구,030002, 26세,2017,2366,1289,1077,119.7,2249,1211,1038,116.7
38114, 마산회원구,030003, 27세,2017,2335,1287,1048,122.8,2192,1189,1003,118.5
38114, 마산회원구,030004, 28세,2017,2250,1221,1029,118.7,2126,1137,989,115
38114, 마산회원구,030005, 29세,2017,2143,1165,978,119.1,2037,1100,937,117.4
38114, 마산회원구,035,30~34세,2017,11687,6245,5442,114.8,11149,5895,5254,112.2
38114, 마산회원구,035001, 30세,2017,2188,1150,1038,110.8,2057,1066,991,107.6
38114, 마산회원구,035002, 31세,2017,2117,1151,966,119.2,1987,1061,926,114.6
38114, 마산회원구,035003, 32세,2017,2219,1173,1046,112.1,2118,1110,1008,110.1
38114, 마산회원구,035004, 33세,2017,2458,1329,1129,117.7,2355,1263,1092,115.7
38114, 마산회원구,035005, 34세,2017,2705,1442,1263,114.2,2632,1395,1237,112.8
38114, 마산회원구,040,35~39세,2017,15410,8046,7364,109.3,15120,7864,7256,108.4
38114, 마산회원구,040001, 35세,2017,3047,1595,1452,109.8,2974,1553,1421,109.3
38114, 마산회원구,040002, 36세,2017,3113,1638,1475,111.1,3047,1593,1454,109.6
38114, 마산회원구,040003, 37세,2017,3241,1684,1557,108.2,3190,1653,1537,107.5
38114, 마산회원구,040004, 38세,2017,3076,1614,1462,110.4,3021,1577,1444,109.2
38114, 마산회원구,040005, 39세,2017,2933,1515,1418,106.8,2888,1488,1400,106.3
38114, 마산회원구,045,40~44세,2017,15711,8012,7699,104.1,15500,7879,7621,103.4
38114, 마산회원구,045001, 40세,2017,2974,1496,1478,101.2,2930,1468,1462,100.4
38114, 마산회원구,045002, 41세,2017,2826,1473,1353,108.9,2778,1440,1338,107.6
38114, 마산회원구,045003, 42세,2017,3094,1543,1551,99.5,3051,1515,1536,98.6
38114, 마산회원구,045004, 43세,2017,3374,1751,1623,107.9,3343,1734,1609,107.8
38114, 마산회원구,045005, 44세,2017,3443,1749,1694,103.2,3398,1722,1676,102.7
38114, 마산회원구,050,45~49세,2017,18094,9109,8985,101.4,17816,8949,8867,100.9
38114, 마산회원구,050001, 45세,2017,3271,1680,1591,105.6,3215,1646,1569,104.9
38114, 마산회원구,050002, 46세,2017,3637,1806,1831,98.6,3566,1762,1804,97.7
38114, 마산회원구,050003, 47세,2017,3647,1839,1808,101.7,3596,1812,1784,101.6
38114, 마산회원구,050004, 48세,2017,3761,1941,1820,106.6,3711,1912,1799,106.3
38114, 마산회원구,050005, 49세,2017,3778,1843,1935,95.2,3728,1817,1911,95.1
38114, 마산회원구,055,50~54세,2017,17112,8538,8574,99.6,16881,8416,8465,99.4
38114, 마산회원구,055001, 50세,2017,3493,1719,1774,96.9,3453,1695,1758,96.4
38114, 마산회원구,055002, 51세,2017,3572,1844,1728,106.7,3519,1818,1701,106.9
38114, 마산회원구,055003, 52세,2017,3458,1672,1786,93.6,3416,1647,1769,93.1
38114, 마산회원구,055004, 53세,2017,3127,1565,1562,100.2,3086,1542,1544,99.9
38114, 마산회원구,055005, 54세,2017,3462,1738,1724,100.8,3407,1714,1693,101.2
38114, 마산회원구,060,55~59세,2017,18960,9300,9660,96.3,18815,9229,9586,96.3
38114, 마산회원구,060001, 55세,2017,3889,1926,1963,98.1,3849,1903,1946,97.8
38114, 마산회원구,060002, 56세,2017,4081,2073,2008,103.2,4062,2063,1999,103.2
38114, 마산회원구,060003, 57세,2017,4054,1935,2119,91.3,4020,1922,2098,91.6
38114, 마산회원구,060004, 58세,2017,3536,1720,1816,94.7,3510,1707,1803,94.7
38114, 마산회원구,060005, 59세,2017,3400,1646,1754,93.8,3374,1634,1740,93.9
38114, 마산회원구,065,60~64세,2017,15370,7426,7944,93.5,15265,7375,7890,93.5
38114, 마산회원구,065001, 60세,2017,3492,1684,1808,93.1,3468,1669,1799,92.8
38114, 마산회원구,065002, 61세,2017,3212,1539,1673,92,3184,1525,1659,91.9
38114, 마산회원구,065003, 62세,2017,3396,1616,1780,90.8,3379,1610,1769,91
38114, 마산회원구,065004, 63세,2017,2799,1379,1420,97.1,2776,1367,1409,97
38114, 마산회원구,065005, 64세,2017,2471,1208,1263,95.6,2458,1204,1254,96
38114, 마산회원구,070,65~69세,2017,11015,5254,5761,91.2,10981,5239,5742,91.2
38114, 마산회원구,070001, 65세,2017,2678,1331,1347,98.8,2672,1328,1344,98.8
38114, 마산회원구,070002, 66세,2017,2107,969,1138,85.1,2096,965,1131,85.3
38114, 마산회원구,070003, 67세,2017,2066,933,1133,82.3,2056,926,1130,81.9
38114, 마산회원구,070004, 68세,2017,2114,1002,1112,90.1,2111,1002,1109,90.4
38114, 마산회원구,070005, 69세,2017,2050,1019,1031,98.8,2046,1018,1028,99
38114, 마산회원구,075,70~74세,2017,7177,3404,3773,90.2,7157,3396,3761,90.3
38114, 마산회원구,075001, 70세,2017,1834,893,941,94.9,1828,890,938,94.9
38114, 마산회원구,075002, 71세,2017,1317,662,655,101.1,1314,660,654,100.9
38114, 마산회원구,075003, 72세,2017,1277,599,678,88.3,1274,598,676,88.5
38114, 마산회원구,075004, 73세,2017,1429,661,768,86.1,1423,660,763,86.5
38114, 마산회원구,075005, 74세,2017,1320,589,731,80.6,1318,588,730,80.5
38114, 마산회원구,080,75~79세,2017,5421,2304,3117,73.9,5412,2303,3109,74.1
38114, 마산회원구,080001, 75세,2017,1331,592,739,80.1,1330,591,739,80
38114, 마산회원구,080002, 76세,2017,1214,529,685,77.2,1214,529,685,77.2
38114, 마산회원구,080003, 77세,2017,1039,431,608,70.9,1035,431,604,71.4
38114, 마산회원구,080004, 78세,2017,990,416,574,72.5,989,416,573,72.6
38114, 마산회원구,080005, 79세,2017,847,336,511,65.8,844,336,508,66.1
38114, 마산회원구,085,80~84세,2017,3014,1023,1991,51.4,3007,1020,1987,51.3
38114, 마산회원구,085001, 80세,2017,730,272,458,59.4,729,272,457,59.5
38114, 마산회원구,085002, 81세,2017,698,249,449,55.5,697,249,448,55.6
38114, 마산회원구,085003, 82세,2017,637,210,427,49.2,634,209,425,49.2
38114, 마산회원구,085004, 83세,2017,521,169,352,48,520,168,352,47.7
38114, 마산회원구,085005, 84세,2017,428,123,305,40.3,427,122,305,40
38114, 마산회원구,090,85~89세,2017,1329,298,1031,28.9,1328,298,1030,28.9
38114, 마산회원구,090001, 85세,2017,377,104,273,38.1,377,104,273,38.1
38114, 마산회원구,090002, 86세,2017,310,56,254,22,310,56,254,22
38114, 마산회원구,090003, 87세,2017,245,50,195,25.6,244,50,194,25.8
38114, 마산회원구,090004, 88세,2017,233,47,186,25.3,233,47,186,25.3
38114, 마산회원구,090005, 89세,2017,164,41,123,33.3,164,41,123,33.3
38114, 마산회원구,095,90~94세,2017,372,65,307,21.2,372,65,307,21.2
38114, 마산회원구,095001, 90세,2017,123,23,100,23,123,23,100,23
38114, 마산회원구,095002, 91세,2017,82,12,70,17.1,82,12,70,17.1
38114, 마산회원구,095003, 92세,2017,83,13,70,18.6,83,13,70,18.6
38114, 마산회원구,095004, 93세,2017,44,11,33,33.3,44,11,33,33.3
38114, 마산회원구,095005, 94세,2017,40,6,34,17.6,40,6,34,17.6
38114, 마산회원구,100,95~99세,2017,71,12,59,20.3,71,12,59,20.3
38114, 마산회원구,100001, 95세,2017,27,5,22,22.7,27,5,22,22.7
38114, 마산회원구,100002, 96세,2017,19,X,15,26.7,19,X,15,26.7
38114, 마산회원구,100003, 97세,2017,14,X,13,7.7,14,X,13,7.7
38114, 마산회원구,100004, 98세,2017,5,X,5,0,5,X,5,0
38114, 마산회원구,100005, 99세,2017,6,X,X,50,6,X,X,50
38114, 마산회원구,101,100세이상,2017,5,X,5,0,5,X,5,0
38114, 마산회원구,102,15세미만,2017,25959,13554,12405,109.3,25922,13535,12387,109.3
38114, 마산회원구,103,15~64세,2017,148501,75996,72505,104.8,145839,74407,71432,104.2
38114, 마산회원구,104,65세이상,2017,28404,12360,16044,77,28333,12333,16000,77.1
38114, 마산회원구,086,85세이상,2017,1777,375,1402,26.7,1776,375,1401,26.8
38114, 마산회원구,126,평균연령,2017,42.1,40.9,43.3,,42.2,40.9,43.4,
38114, 마산회원구,127,중위연령,2017,44,42.5,45.5,,44.1,42.7,45.6,
38115, 진해구,000,합계,2017,186658,95782,90876,105.4,182314,92927,89387,104
38115, 진해구,005,0~4세,2017,10672,5562,5110,108.8,10589,5521,5068,108.9
38115, 진해구,005001, 0세,2017,1812,915,897,102,1795,905,890,101.7
38115, 진해구,005002, 1세,2017,2105,1075,1030,104.4,2086,1067,1019,104.7
38115, 진해구,005003, 2세,2017,2184,1192,992,120.2,2160,1179,981,120.2
38115, 진해구,005004, 3세,2017,2254,1150,1104,104.2,2240,1144,1096,104.4
38115, 진해구,005005, 4세,2017,2317,1230,1087,113.2,2308,1226,1082,113.3
38115, 진해구,010,5~9세,2017,11644,5910,5734,103.1,11621,5895,5726,103
38115, 진해구,010001, 5세,2017,2511,1305,1206,108.2,2507,1303,1204,108.2
38115, 진해구,010002, 6세,2017,2349,1182,1167,101.3,2345,1180,1165,101.3
38115, 진해구,010003, 7세,2017,2288,1209,1079,112,2283,1204,1079,111.6
38115, 진해구,010004, 8세,2017,2191,1096,1095,100.1,2185,1092,1093,99.9
38115, 진해구,010005, 9세,2017,2305,1118,1187,94.2,2301,1116,1185,94.2
38115, 진해구,015,10~14세,2017,10247,5401,4846,111.5,10224,5387,4837,111.4
38115, 진해구,015001, 10세,2017,2276,1174,1102,106.5,2269,1170,1099,106.5
38115, 진해구,015002, 11세,2017,2030,1094,936,116.9,2026,1092,934,116.9
38115, 진해구,015003, 12세,2017,1891,954,937,101.8,1887,952,935,101.8
38115, 진해구,015004, 13세,2017,2080,1122,958,117.1,2076,1120,956,117.2
38115, 진해구,015005, 14세,2017,1970,1057,913,115.8,1966,1053,913,115.3
38115, 진해구,020,15~19세,2017,9226,4842,4384,110.4,9200,4822,4378,110.1
38115, 진해구,020001, 15세,2017,1926,1020,906,112.6,1923,1017,906,112.3
38115, 진해구,020002, 16세,2017,1981,1040,941,110.5,1977,1037,940,110.3
38115, 진해구,020003, 17세,2017,2032,986,1046,94.3,2027,982,1045,94
38115, 진해구,020004, 18세,2017,1897,995,902,110.3,1890,990,900,110
38115, 진해구,020005, 19세,2017,1390,801,589,136,1383,796,587,135.6
38115, 진해구,025,20~24세,2017,8499,4978,3521,141.4,8209,4794,3415,140.4
38115, 진해구,025001, 20세,2017,1648,1013,635,159.5,1620,1000,620,161.3
38115, 진해구,025002, 21세,2017,1730,1044,686,152.2,1698,1027,671,153.1
38115, 진해구,025003, 22세,2017,1583,919,664,138.4,1528,889,639,139.1
38115, 진해구,025004, 23세,2017,1718,971,747,130,1660,931,729,127.7
38115, 진해구,025005, 24세,2017,1820,1031,789,130.7,1703,947,756,125.3
38115, 진해구,030,25~29세,2017,10173,5575,4598,121.2,9379,5035,4344,115.9
38115, 진해구,030001, 25세,2017,1991,1084,907,119.5,1855,996,859,115.9
38115, 진해구,030002, 26세,2017,1909,1036,873,118.7,1778,952,826,115.3
38115, 진해구,030003, 27세,2017,2062,1165,897,129.9,1886,1050,836,125.6
38115, 진해구,030004, 28세,2017,2067,1114,953,116.9,1888,986,902,109.3
38115, 진해구,030005, 29세,2017,2144,1176,968,121.5,1972,1051,921,114.1
38115, 진해구,035,30~34세,2017,13621,7286,6335,115,12721,6634,6087,109
38115, 진해구,035001, 30세,2017,2348,1267,1081,117.2,2130,1117,1013,110.3
38115, 진해구,035002, 31세,2017,2462,1337,1125,118.8,2268,1203,1065,113
38115, 진해구,035003, 32세,2017,2593,1368,1225,111.7,2410,1226,1184,103.5
38115, 진해구,035004, 33세,2017,2875,1546,1329,116.3,2719,1430,1289,110.9
38115, 진해구,035005, 34세,2017,3343,1768,1575,112.3,3194,1658,1536,107.9
38115, 진해구,040,35~39세,2017,18644,9782,8862,110.4,18075,9362,8713,107.4
38115, 진해구,040001, 35세,2017,3743,1970,1773,111.1,3600,1869,1731,108
38115, 진해구,040002, 36세,2017,3855,2056,1799,114.3,3751,1978,1773,111.6
38115, 진해구,040003, 37세,2017,3990,2024,1966,103,3887,1944,1943,100.1
38115, 진해구,040004, 38세,2017,3737,1958,1779,110.1,3618,1875,1743,107.6
38115, 진해구,040005, 39세,2017,3319,1774,1545,114.8,3219,1696,1523,111.4
38115, 진해구,045,40~44세,2017,17153,9162,7991,114.7,16743,8867,7876,112.6
38115, 진해구,045001, 40세,2017,3333,1775,1558,113.9,3253,1712,1541,111.1
38115, 진해구,045002, 41세,2017,3261,1769,1492,118.6,3166,1698,1468,115.7
38115, 진해구,045003, 42세,2017,3415,1807,1608,112.4,3357,1766,1591,111
38115, 진해구,045004, 43세,2017,3657,1932,1725,112,3567,1866,1701,109.7
38115, 진해구,045005, 44세,2017,3487,1879,1608,116.9,3400,1825,1575,115.9
38115, 진해구,050,45~49세,2017,15835,8531,7304,116.8,15408,8269,7139,115.8
38115, 진해구,050001, 45세,2017,3273,1756,1517,115.8,3193,1703,1490,114.3
38115, 진해구,050002, 46세,2017,3370,1821,1549,117.6,3270,1752,1518,115.4
38115, 진해구,050003, 47세,2017,3153,1674,1479,113.2,3065,1631,1434,113.7
38115, 진해구,050004, 48세,2017,3026,1673,1353,123.7,2956,1629,1327,122.8
38115, 진해구,050005, 49세,2017,3013,1607,1406,114.3,2924,1554,1370,113.4
38115, 진해구,055,50~54세,2017,13012,6717,6295,106.7,12677,6524,6153,106
38115, 진해구,055001, 50세,2017,2648,1360,1288,105.6,2579,1319,1260,104.7
38115, 진해구,055002, 51세,2017,2626,1359,1267,107.3,2567,1326,1241,106.8
38115, 진해구,055003, 52세,2017,2521,1297,1224,106,2454,1259,1195,105.4
38115, 진해구,055004, 53세,2017,2466,1275,1191,107.1,2392,1230,1162,105.9
38115, 진해구,055005, 54세,2017,2751,1426,1325,107.6,2685,1390,1295,107.3
38115, 진해구,060,55~59세,2017,13943,6802,7141,95.3,13722,6700,7022,95.4
38115, 진해구,060001, 55세,2017,2632,1336,1296,103.1,2577,1312,1265,103.7
38115, 진해구,060002, 56세,2017,2971,1438,1533,93.8,2926,1418,1508,94
38115, 진해구,060003, 57세,2017,3025,1424,1601,88.9,2987,1402,1585,88.5
38115, 진해구,060004, 58세,2017,2715,1311,1404,93.4,2667,1292,1375,94
38115, 진해구,060005, 59세,2017,2600,1293,1307,98.9,2565,1276,1289,99
38115, 진해구,065,60~64세,2017,11308,5593,5715,97.9,11165,5520,5645,97.8
38115, 진해구,065001, 60세,2017,2524,1237,1287,96.1,2498,1226,1272,96.4
38115, 진해구,065002, 61세,2017,2419,1198,1221,98.1,2389,1179,1210,97.4
38115, 진해구,065003, 62세,2017,2505,1188,1317,90.2,2474,1172,1302,90
38115, 진해구,065004, 63세,2017,2099,1083,1016,106.6,2074,1076,998,107.8
38115, 진해구,065005, 64세,2017,1761,887,874,101.5,1730,867,863,100.5
38115, 진해구,070,65~69세,2017,7798,3781,4017,94.1,7742,3757,3985,94.3
38115, 진해구,070001, 65세,2017,1910,929,981,94.7,1900,924,976,94.7
38115, 진해구,070002, 66세,2017,1486,692,794,87.2,1471,687,784,87.6
38115, 진해구,070003, 67세,2017,1435,683,752,90.8,1422,679,743,91.4
38115, 진해구,070004, 68세,2017,1542,771,771,100,1528,764,764,100
38115, 진해구,070005, 69세,2017,1425,706,719,98.2,1421,703,718,97.9
38115, 진해구,075,70~74세,2017,5544,2520,3024,83.3,5525,2509,3016,83.2
38115, 진해구,075001, 70세,2017,1372,639,733,87.2,1364,633,731,86.6
38115, 진해구,075002, 71세,2017,1075,532,543,98,1073,530,543,97.6
38115, 진해구,075003, 72세,2017,1015,433,582,74.4,1013,432,581,74.4
38115, 진해구,075004, 73세,2017,1049,474,575,82.4,1044,472,572,82.5
38115, 진해구,075005, 74세,2017,1033,442,591,74.8,1031,442,589,75
38115, 진해구,080,75~79세,2017,4692,1932,2760,70,4674,1925,2749,70
38115, 진해구,080001, 75세,2017,1172,496,676,73.4,1169,494,675,73.2
38115, 진해구,080002, 76세,2017,943,387,556,69.6,939,386,553,69.8
38115, 진해구,080003, 77세,2017,922,376,546,68.9,919,376,543,69.2
38115, 진해구,080004, 78세,2017,882,365,517,70.6,879,363,516,70.3
38115, 진해구,080005, 79세,2017,773,308,465,66.2,768,306,462,66.2
38115, 진해구,085,80~84세,2017,2874,995,1879,53,2869,993,1876,52.9
38115, 진해구,085001, 80세,2017,753,273,480,56.9,753,273,480,56.9
38115, 진해구,085002, 81세,2017,627,234,393,59.5,625,233,392,59.4
38115, 진해구,085003, 82세,2017,575,189,386,49,574,189,385,49.1
38115, 진해구,085004, 83세,2017,516,162,354,45.8,515,162,353,45.9
38115, 진해구,085005, 84세,2017,403,137,266,51.5,402,136,266,51.1
38115, 진해구,090,85~89세,2017,1317,330,987,33.4,1317,330,987,33.4
38115, 진해구,090001, 85세,2017,387,103,284,36.3,387,103,284,36.3
38115, 진해구,090002, 86세,2017,277,73,204,35.8,277,73,204,35.8
38115, 진해구,090003, 87세,2017,246,51,195,26.2,246,51,195,26.2
38115, 진해구,090004, 88세,2017,229,62,167,37.1,229,62,167,37.1
38115, 진해구,090005, 89세,2017,178,41,137,29.9,178,41,137,29.9
38115, 진해구,095,90~94세,2017,378,69,309,22.3,376,69,307,22.5
38115, 진해구,095001, 90세,2017,105,23,82,28,105,23,82,28
38115, 진해구,095002, 91세,2017,104,22,82,26.8,103,22,81,27.2
38115, 진해구,095003, 92세,2017,78,12,66,18.2,77,12,65,18.5
38115, 진해구,095004, 93세,2017,52,8,44,18.2,52,8,44,18.2
38115, 진해구,095005, 94세,2017,39,X,35,11.4,39,X,35,11.4
38115, 진해구,100,95~99세,2017,66,13,53,24.5,66,13,53,24.5
38115, 진해구,100001, 95세,2017,24,7,17,41.2,24,7,17,41.2
38115, 진해구,100002, 96세,2017,14,X,13,7.7,14,X,13,7.7
38115, 진해구,100003, 97세,2017,18,X,16,12.5,18,X,16,12.5
38115, 진해구,100004, 98세,2017,X,X,X,200,X,X,X,200
38115, 진해구,100005, 99세,2017,7,X,6,16.7,7,X,6,16.7
38115, 진해구,101,100세이상,2017,12,X,11,9.1,12,X,11,9.1
38115, 진해구,102,15세미만,2017,32563,16873,15690,107.5,32434,16803,15631,107.5
38115, 진해구,103,15~64세,2017,131414,69268,62146,111.5,127299,66527,60772,109.5
38115, 진해구,104,65세이상,2017,22681,9641,13040,73.9,22581,9597,12984,73.9
38115, 진해구,086,85세이상,2017,1773,413,1360,30.4,1771,413,1358,30.4
38115, 진해구,126,평균연령,2017,39.5,38.3,40.7,,39.5,38.4,40.7,
38115, 진해구,127,중위연령,2017,40.2,39.2,41.3,,40.3,39.4,41.4,
38310, 의령군,000,합계,2017,26292,12747,13545,94.1,25355,12159,13196,92.1
38310, 의령군,005,0~4세,2017,623,343,280,122.5,620,342,278,123
38310, 의령군,005001, 0세,2017,123,72,51,141.2,123,72,51,141.2
38310, 의령군,005002, 1세,2017,116,51,65,78.5,116,51,65,78.5
38310, 의령군,005003, 2세,2017,128,72,56,128.6,127,72,55,130.9
38310, 의령군,005004, 3세,2017,131,79,52,151.9,130,79,51,154.9
38310, 의령군,005005, 4세,2017,125,69,56,123.2,124,68,56,121.4
38310, 의령군,010,5~9세,2017,668,353,315,112.1,667,353,314,112.4
38310, 의령군,010001, 5세,2017,153,90,63,142.9,153,90,63,142.9
38310, 의령군,010002, 6세,2017,131,60,71,84.5,131,60,71,84.5
38310, 의령군,010003, 7세,2017,120,56,64,87.5,120,56,64,87.5
38310, 의령군,010004, 8세,2017,138,76,62,122.6,137,76,61,124.6
38310, 의령군,010005, 9세,2017,126,71,55,129.1,126,71,55,129.1
38310, 의령군,015,10~14세,2017,721,385,336,114.6,720,384,336,114.3
38310, 의령군,015001, 10세,2017,139,66,73,90.4,139,66,73,90.4
38310, 의령군,015002, 11세,2017,122,72,50,144,121,71,50,142
38310, 의령군,015003, 12세,2017,137,78,59,132.2,137,78,59,132.2
38310, 의령군,015004, 13세,2017,169,84,85,98.8,169,84,85,98.8
38310, 의령군,015005, 14세,2017,154,85,69,123.2,154,85,69,123.2
38310, 의령군,020,15~19세,2017,955,516,439,117.5,948,514,434,118.4
38310, 의령군,020001, 15세,2017,185,91,94,96.8,185,91,94,96.8
38310, 의령군,020002, 16세,2017,185,99,86,115.1,185,99,86,115.1
38310, 의령군,020003, 17세,2017,250,136,114,119.3,247,136,111,122.5
38310, 의령군,020004, 18세,2017,208,112,96,116.7,208,112,96,116.7
38310, 의령군,020005, 19세,2017,127,78,49,159.2,123,76,47,161.7
38310, 의령군,025,20~24세,2017,992,584,408,143.1,901,536,365,146.8
38310, 의령군,025001, 20세,2017,188,127,61,208.2,185,126,59,213.6
38310, 의령군,025002, 21세,2017,206,114,92,123.9,194,109,85,128.2
38310, 의령군,025003, 22세,2017,184,120,64,187.5,173,115,58,198.3
38310, 의령군,025004, 23세,2017,193,109,84,129.8,168,95,73,130.1
38310, 의령군,025005, 24세,2017,221,114,107,106.5,181,91,90,101.1
38310, 의령군,030,25~29세,2017,1092,595,497,119.7,853,447,406,110.1
38310, 의령군,030001, 25세,2017,230,130,100,130,176,98,78,125.6
38310, 의령군,030002, 26세,2017,215,114,101,112.9,176,91,85,107.1
38310, 의령군,030003, 27세,2017,220,120,100,120,174,90,84,107.1
38310, 의령군,030004, 28세,2017,214,116,98,118.4,162,85,77,110.4
38310, 의령군,030005, 29세,2017,213,115,98,117.3,165,83,82,101.2
38310, 의령군,035,30~34세,2017,1063,601,462,130.1,836,447,389,114.9
38310, 의령군,035001, 30세,2017,220,133,87,152.9,166,99,67,147.8
38310, 의령군,035002, 31세,2017,222,121,101,119.8,175,88,87,101.1
38310, 의령군,035003, 32세,2017,181,100,81,123.5,140,75,65,115.4
38310, 의령군,035004, 33세,2017,213,123,90,136.7,170,88,82,107.3
38310, 의령군,035005, 34세,2017,227,124,103,120.4,185,97,88,110.2
38310, 의령군,040,35~39세,2017,1150,639,511,125,1047,564,483,116.8
38310, 의령군,040001, 35세,2017,207,109,98,111.2,183,94,89,105.6
38310, 의령군,040002, 36세,2017,243,128,115,111.3,228,115,113,101.8
38310, 의령군,040003, 37세,2017,242,129,113,114.2,218,113,105,107.6
38310, 의령군,040004, 38세,2017,246,145,101,143.6,225,127,98,129.6
38310, 의령군,040005, 39세,2017,212,128,84,152.4,193,115,78,147.4
38310, 의령군,045,40~44세,2017,1316,751,565,132.9,1233,695,538,129.2
38310, 의령군,045001, 40세,2017,211,117,94,124.5,197,111,86,129.1
38310, 의령군,045002, 41세,2017,240,138,102,135.3,216,119,97,122.7
38310, 의령군,045003, 42세,2017,274,146,128,114.1,259,135,124,108.9
38310, 의령군,045004, 43세,2017,292,176,116,151.7,276,167,109,153.2
38310, 의령군,045005, 44세,2017,299,174,125,139.2,285,163,122,133.6
38310, 의령군,050,45~49세,2017,1706,986,720,136.9,1651,954,697,136.9
38310, 의령군,050001, 45세,2017,284,153,131,116.8,272,147,125,117.6
38310, 의령군,050002, 46세,2017,330,195,135,144.4,325,193,132,146.2
38310, 의령군,050003, 47세,2017,328,195,133,146.6,314,186,128,145.3
38310, 의령군,050004, 48세,2017,389,238,151,157.6,373,228,145,157.2
38310, 의령군,050005, 49세,2017,375,205,170,120.6,367,200,167,119.8
38310, 의령군,055,50~54세,2017,1901,1035,866,119.5,1847,1008,839,120.1
38310, 의령군,055001, 50세,2017,365,199,166,119.9,354,192,162,118.5
38310, 의령군,055002, 51세,2017,376,204,172,118.6,365,198,167,118.6
38310, 의령군,055003, 52세,2017,401,217,184,117.9,389,211,178,118.5
38310, 의령군,055004, 53세,2017,364,197,167,118,356,195,161,121.1
38310, 의령군,055005, 54세,2017,395,218,177,123.2,383,212,171,124
38310, 의령군,060,55~59세,2017,2604,1360,1244,109.3,2564,1336,1228,108.8
38310, 의령군,060001, 55세,2017,508,267,241,110.8,499,260,239,108.8
38310, 의령군,060002, 56세,2017,553,298,255,116.9,546,294,252,116.7
38310, 의령군,060003, 57세,2017,545,275,270,101.9,536,269,267,100.7
38310, 의령군,060004, 58세,2017,499,264,235,112.3,494,260,234,111.1
38310, 의령군,060005, 59세,2017,499,256,243,105.3,489,253,236,107.2
38310, 의령군,065,60~64세,2017,2350,1186,1164,101.9,2328,1174,1154,101.7
38310, 의령군,065001, 60세,2017,507,272,235,115.7,505,270,235,114.9
38310, 의령군,065002, 61세,2017,505,256,249,102.8,500,255,245,104.1
38310, 의령군,065003, 62세,2017,536,266,270,98.5,529,261,268,97.4
38310, 의령군,065004, 63세,2017,436,213,223,95.5,432,211,221,95.5
38310, 의령군,065005, 64세,2017,366,179,187,95.7,362,177,185,95.7
38310, 의령군,070,65~69세,2017,2097,1016,1081,94,2089,1010,1079,93.6
38310, 의령군,070001, 65세,2017,502,255,247,103.2,500,253,247,102.4
38310, 의령군,070002, 66세,2017,365,178,187,95.2,364,177,187,94.7
38310, 의령군,070003, 67세,2017,406,191,215,88.8,404,189,215,87.9
38310, 의령군,070004, 68세,2017,430,196,234,83.8,430,196,234,83.8
38310, 의령군,070005, 69세,2017,394,196,198,99,391,195,196,99.5
38310, 의령군,075,70~74세,2017,1795,731,1064,68.7,1793,730,1063,68.7
38310, 의령군,075001, 70세,2017,385,177,208,85.1,384,177,207,85.5
38310, 의령군,075002, 71세,2017,306,142,164,86.6,305,141,164,86
38310, 의령군,075003, 72세,2017,320,131,189,69.3,320,131,189,69.3
38310, 의령군,075004, 73세,2017,359,132,227,58.1,359,132,227,58.1
38310, 의령군,075005, 74세,2017,425,149,276,54,425,149,276,54
38310, 의령군,080,75~79세,2017,2280,823,1457,56.5,2280,823,1457,56.5
38310, 의령군,080001, 75세,2017,501,185,316,58.5,501,185,316,58.5
38310, 의령군,080002, 76세,2017,493,173,320,54.1,493,173,320,54.1
38310, 의령군,080003, 77세,2017,448,159,289,55,448,159,289,55
38310, 의령군,080004, 78세,2017,450,163,287,56.8,450,163,287,56.8
38310, 의령군,080005, 79세,2017,388,143,245,58.4,388,143,245,58.4
38310, 의령군,085,80~84세,2017,1802,551,1251,44,1801,550,1251,44
38310, 의령군,085001, 80세,2017,431,149,282,52.8,431,149,282,52.8
38310, 의령군,085002, 81세,2017,409,120,289,41.5,409,120,289,41.5
38310, 의령군,085003, 82세,2017,372,114,258,44.2,371,113,258,43.8
38310, 의령군,085004, 83세,2017,318,84,234,35.9,318,84,234,35.9
38310, 의령군,085005, 84세,2017,272,84,188,44.7,272,84,188,44.7
38310, 의령군,090,85~89세,2017,893,221,672,32.9,893,221,672,32.9
38310, 의령군,090001, 85세,2017,268,63,205,30.7,268,63,205,30.7
38310, 의령군,090002, 86세,2017,198,50,148,33.8,198,50,148,33.8
38310, 의령군,090003, 87세,2017,172,42,130,32.3,172,42,130,32.3
38310, 의령군,090004, 88세,2017,146,33,113,29.2,146,33,113,29.2
38310, 의령군,090005, 89세,2017,109,33,76,43.4,109,33,76,43.4
38310, 의령군,095,90~94세,2017,236,58,178,32.6,236,58,178,32.6
38310, 의령군,095001, 90세,2017,77,17,60,28.3,77,17,60,28.3
38310, 의령군,095002, 91세,2017,58,14,44,31.8,58,14,44,31.8
38310, 의령군,095003, 92세,2017,42,11,31,35.5,42,11,31,35.5
38310, 의령군,095004, 93세,2017,28,8,20,40,28,8,20,40
38310, 의령군,095005, 94세,2017,31,8,23,34.8,31,8,23,34.8
38310, 의령군,100,95~99세,2017,46,13,33,39.4,46,13,33,39.4
38310, 의령군,100001, 95세,2017,20,6,14,42.9,20,6,14,42.9
38310, 의령군,100002, 96세,2017,8,X,6,33.3,8,X,6,33.3
38310, 의령군,100003, 97세,2017,10,X,7,42.9,10,X,7,42.9
38310, 의령군,100004, 98세,2017,X,X,X,50,X,X,X,50
38310, 의령군,100005, 99세,2017,5,X,X,25,5,X,X,25
38310, 의령군,101,100세이상,2017,X,X,X,0,X,X,X,0
38310, 의령군,102,15세미만,2017,2012,1081,931,116.1,2007,1079,928,116.3
38310, 의령군,103,15~64세,2017,15129,8253,6876,120,14208,7675,6533,117.5
38310, 의령군,104,65세이상,2017,9151,3413,5738,59.5,9140,3405,5735,59.4
38310, 의령군,086,85세이상,2017,1177,292,885,33,1177,292,885,33
38310, 의령군,126,평균연령,2017,53.1,49.6,56.4,,53.7,50.2,57,
38310, 의령군,127,중위연령,2017,56.8,53,60.5,,57.6,54.2,61.2,
38320, 함안군,000,합계,2017,67906,35444,32462,109.2,63614,31955,31659,100.9
38320, 함안군,005,0~4세,2017,2452,1248,1204,103.7,2436,1239,1197,103.5
38320, 함안군,005001, 0세,2017,392,207,185,111.9,388,204,184,110.9
38320, 함안군,005002, 1세,2017,478,241,237,101.7,474,239,235,101.7
38320, 함안군,005003, 2세,2017,513,261,252,103.6,508,260,248,104.8
38320, 함안군,005004, 3세,2017,515,250,265,94.3,513,248,265,93.6
38320, 함안군,005005, 4세,2017,554,289,265,109.1,553,288,265,108.7
38320, 함안군,010,5~9세,2017,3102,1553,1549,100.3,3088,1548,1540,100.5
38320, 함안군,010001, 5세,2017,587,289,298,97,586,288,298,96.6
38320, 함안군,010002, 6세,2017,616,294,322,91.3,609,293,316,92.7
38320, 함안군,010003, 7세,2017,591,309,282,109.6,590,309,281,110
38320, 함안군,010004, 8세,2017,648,328,320,102.5,645,326,319,102.2
38320, 함안군,010005, 9세,2017,660,333,327,101.8,658,332,326,101.8
38320, 함안군,015,10~14세,2017,2853,1526,1327,115,2846,1522,1324,115
38320, 함안군,015001, 10세,2017,618,318,300,106,618,318,300,106
38320, 함안군,015002, 11세,2017,553,295,258,114.3,552,294,258,114
38320, 함안군,015003, 12세,2017,564,291,273,106.6,563,290,273,106.2
38320, 함안군,015004, 13세,2017,541,301,240,125.4,538,300,238,126.1
38320, 함안군,015005, 14세,2017,577,321,256,125.4,575,320,255,125.5
38320, 함안군,020,15~19세,2017,3172,1687,1485,113.6,3148,1673,1475,113.4
38320, 함안군,020001, 15세,2017,583,314,269,116.7,582,314,268,117.2
38320, 함안군,020002, 16세,2017,685,352,333,105.7,681,349,332,105.1
38320, 함안군,020003, 17세,2017,753,362,391,92.6,750,360,390,92.3
38320, 함안군,020004, 18세,2017,613,331,282,117.4,607,329,278,118.3
38320, 함안군,020005, 19세,2017,538,328,210,156.2,528,321,207,155.1
38320, 함안군,025,20~24세,2017,3267,2062,1205,171.1,2851,1719,1132,151.9
38320, 함안군,025001, 20세,2017,600,403,197,204.6,575,384,191,201
38320, 함안군,025002, 21세,2017,626,427,199,214.6,578,388,190,204.2
38320, 함안군,025003, 22세,2017,676,415,261,159,574,328,246,133.3
38320, 함안군,025004, 23세,2017,636,386,250,154.4,530,298,232,128.4
38320, 함안군,025005, 24세,2017,729,431,298,144.6,594,321,273,117.6
38320, 함안군,030,25~29세,2017,3705,2350,1355,173.4,2590,1396,1194,116.9
38320, 함안군,030001, 25세,2017,760,474,286,165.7,564,308,256,120.3
38320, 함안군,030002, 26세,2017,712,459,253,181.4,498,281,217,129.5
38320, 함안군,030003, 27세,2017,757,489,268,182.5,524,288,236,122
38320, 함안군,030004, 28세,2017,713,454,259,175.3,487,254,233,109
38320, 함안군,030005, 29세,2017,763,474,289,164,517,265,252,105.2
38320, 함안군,035,30~34세,2017,3986,2405,1581,152.1,2970,1516,1454,104.3
38320, 함안군,035001, 30세,2017,759,491,268,183.2,507,272,235,115.7
38320, 함안군,035002, 31세,2017,750,475,275,172.7,541,291,250,116.4
38320, 함안군,035003, 32세,2017,791,499,292,170.9,583,310,273,113.6
38320, 함안군,035004, 33세,2017,776,435,341,127.6,602,288,314,91.7
38320, 함안군,035005, 34세,2017,910,505,405,124.7,737,355,382,92.9
38320, 함안군,040,35~39세,2017,4802,2716,2086,130.2,4132,2159,1973,109.4
38320, 함안군,040001, 35세,2017,929,538,391,137.6,759,392,367,106.8
38320, 함안군,040002, 36세,2017,940,529,411,128.7,822,432,390,110.8
38320, 함안군,040003, 37세,2017,1057,587,470,124.9,918,475,443,107.2
38320, 함안군,040004, 38세,2017,935,543,392,138.5,818,445,373,119.3
38320, 함안군,040005, 39세,2017,941,519,422,123,815,415,400,103.8
38320, 함안군,045,40~44세,2017,4972,2800,2172,128.9,4610,2500,2110,118.5
38320, 함안군,045001, 40세,2017,978,546,432,126.4,886,467,419,111.5
38320, 함안군,045002, 41세,2017,932,533,399,133.6,843,457,386,118.4
38320, 함안군,045003, 42세,2017,1030,581,449,129.4,964,529,435,121.6
38320, 함안군,045004, 43세,2017,1017,579,438,132.2,961,531,430,123.5
38320, 함안군,045005, 44세,2017,1015,561,454,123.6,956,516,440,117.3
38320, 함안군,050,45~49세,2017,5432,3035,2397,126.6,5180,2856,2324,122.9
38320, 함안군,050001, 45세,2017,1071,606,465,130.3,1011,565,446,126.7
38320, 함안군,050002, 46세,2017,1141,635,506,125.5,1090,597,493,121.1
38320, 함안군,050003, 47세,2017,1085,603,482,125.1,1026,558,468,119.2
38320, 함안군,050004, 48세,2017,1050,586,464,126.3,998,552,446,123.8
38320, 함안군,050005, 49세,2017,1085,605,480,126,1055,584,471,124
38320, 함안군,055,50~54세,2017,5219,2823,2396,117.8,5033,2713,2320,116.9
38320, 함안군,055001, 50세,2017,1044,578,466,124,1003,554,449,123.4
38320, 함안군,055002, 51세,2017,1073,592,481,123.1,1035,566,469,120.7
38320, 함안군,055003, 52세,2017,1044,532,512,103.9,1007,511,496,103
38320, 함안군,055004, 53세,2017,992,545,447,121.9,962,527,435,121.1
38320, 함안군,055005, 54세,2017,1066,576,490,117.6,1026,555,471,117.8
38320, 함안군,060,55~59세,2017,5982,3153,2829,111.5,5891,3102,2789,111.2
38320, 함안군,060001, 55세,2017,1158,617,541,114,1135,601,534,112.5
38320, 함안군,060002, 56세,2017,1288,659,629,104.8,1271,651,620,105
38320, 함안군,060003, 57세,2017,1217,629,588,107,1198,617,581,106.2
38320, 함안군,060004, 58세,2017,1130,607,523,116.1,1114,599,515,116.3
38320, 함안군,060005, 59세,2017,1189,641,548,117,1173,634,539,117.6
38320, 함안군,065,60~64세,2017,5196,2672,2524,105.9,5120,2624,2496,105.1
38320, 함안군,065001, 60세,2017,1150,594,556,106.8,1135,585,550,106.4
38320, 함안군,065002, 61세,2017,1105,560,545,102.8,1087,550,537,102.4
38320, 함안군,065003, 62세,2017,1087,590,497,118.7,1066,576,490,117.6
38320, 함안군,065004, 63세,2017,988,481,507,94.9,973,471,502,93.8
38320, 함안군,065005, 64세,2017,866,447,419,106.7,859,442,417,106
38320, 함안군,070,65~69세,2017,3905,1936,1969,98.3,3871,1918,1953,98.2
38320, 함안군,070001, 65세,2017,886,410,476,86.1,876,404,472,85.6
38320, 함안군,070002, 66세,2017,687,352,335,105.1,682,349,333,104.8
38320, 함안군,070003, 67세,2017,809,400,409,97.8,800,396,404,98
38320, 함안군,070004, 68세,2017,739,366,373,98.1,733,364,369,98.6
38320, 함안군,070005, 69세,2017,784,408,376,108.5,780,405,375,108
38320, 함안군,075,70~74세,2017,2935,1292,1643,78.6,2926,1285,1641,78.3
38320, 함안군,075001, 70세,2017,699,338,361,93.6,696,335,361,92.8
38320, 함안군,075002, 71세,2017,498,230,268,85.8,496,229,267,85.8
38320, 함안군,075003, 72세,2017,518,214,304,70.4,517,213,304,70.1
38320, 함안군,075004, 73세,2017,610,260,350,74.3,610,260,350,74.3
38320, 함안군,075005, 74세,2017,610,250,360,69.4,607,248,359,69.1
38320, 함안군,080,75~79세,2017,3293,1173,2120,55.3,3291,1173,2118,55.4
38320, 함안군,080001, 75세,2017,741,288,453,63.6,741,288,453,63.6
38320, 함안군,080002, 76세,2017,730,267,463,57.7,729,267,462,57.8
38320, 함안군,080003, 77세,2017,655,236,419,56.3,654,236,418,56.5
38320, 함안군,080004, 78세,2017,608,199,409,48.7,608,199,409,48.7
38320, 함안군,080005, 79세,2017,559,183,376,48.7,559,183,376,48.7
38320, 함안군,085,80~84세,2017,2250,708,1542,45.9,2248,707,1541,45.9
38320, 함안군,085001, 80세,2017,567,190,377,50.4,566,189,377,50.1
38320, 함안군,085002, 81세,2017,464,155,309,50.2,464,155,309,50.2
38320, 함안군,085003, 82세,2017,453,139,314,44.3,453,139,314,44.3
38320, 함안군,085004, 83세,2017,431,133,298,44.6,430,133,297,44.8
38320, 함안군,085005, 84세,2017,335,91,244,37.3,335,91,244,37.3
38320, 함안군,090,85~89세,2017,1058,243,815,29.8,1058,243,815,29.8
38320, 함안군,090001, 85세,2017,312,84,228,36.8,312,84,228,36.8
38320, 함안군,090002, 86세,2017,228,52,176,29.5,228,52,176,29.5
38320, 함안군,090003, 87세,2017,187,43,144,29.9,187,43,144,29.9
38320, 함안군,090004, 88세,2017,181,37,144,25.7,181,37,144,25.7
38320, 함안군,090005, 89세,2017,150,27,123,22,150,27,123,22
38320, 함안군,095,90~94세,2017,279,52,227,22.9,279,52,227,22.9
38320, 함안군,095001, 90세,2017,79,14,65,21.5,79,14,65,21.5
38320, 함안군,095002, 91세,2017,71,15,56,26.8,71,15,56,26.8
38320, 함안군,095003, 92세,2017,59,12,47,25.5,59,12,47,25.5
38320, 함안군,095004, 93세,2017,39,8,31,25.8,39,8,31,25.8
38320, 함안군,095005, 94세,2017,31,X,28,10.7,31,X,28,10.7
38320, 함안군,100,95~99세,2017,42,10,32,31.3,42,10,32,31.3
38320, 함안군,100001, 95세,2017,18,7,11,63.6,18,7,11,63.6
38320, 함안군,100002, 96세,2017,9,X,8,12.5,9,X,8,12.5
38320, 함안군,100003, 97세,2017,7,X,5,40,7,X,5,40
38320, 함안군,100004, 98세,2017,X,X,X,0,X,X,X,0
38320, 함안군,100005, 99세,2017,5,X,5,0,5,X,5,0
38320, 함안군,101,100세이상,2017,X,X,X,0,X,X,X,0
38320, 함안군,102,15세미만,2017,8407,4327,4080,106.1,8370,4309,4061,106.1
38320, 함안군,103,15~64세,2017,45733,25703,20030,128.3,41525,22258,19267,115.5
38320, 함안군,104,65세이상,2017,13766,5414,8352,64.8,13719,5388,8331,64.7
38320, 함안군,086,85세이상,2017,1383,305,1078,28.3,1383,305,1078,28.3
38320, 함안군,126,평균연령,2017,45,42.7,47.5,,45.7,43.7,47.8,
38320, 함안군,127,중위연령,2017,46.5,43.9,49.7,,48,46.2,50.2,
38330, 창녕군,000,합계,2017,62544,31527,31017,101.6,59569,29505,30064,98.1
38330, 창녕군,005,0~4세,2017,1863,974,889,109.6,1837,959,878,109.2
38330, 창녕군,005001, 0세,2017,359,184,175,105.1,354,180,174,103.4
38330, 창녕군,005002, 1세,2017,370,201,169,118.9,363,197,166,118.7
38330, 창녕군,005003, 2세,2017,357,185,172,107.6,353,182,171,106.4
38330, 창녕군,005004, 3세,2017,373,189,184,102.7,367,187,180,103.9
38330, 창녕군,005005, 4세,2017,404,215,189,113.8,400,213,187,113.9
38330, 창녕군,010,5~9세,2017,1928,1014,914,110.9,1905,1002,903,111
38330, 창녕군,010001, 5세,2017,403,211,192,109.9,396,207,189,109.5
38330, 창녕군,010002, 6세,2017,413,217,196,110.7,407,213,194,109.8
38330, 창녕군,010003, 7세,2017,368,196,172,114,366,195,171,114
38330, 창녕군,010004, 8세,2017,370,195,175,111.4,367,194,173,112.1
38330, 창녕군,010005, 9세,2017,374,195,179,108.9,369,193,176,109.7
38330, 창녕군,015,10~14세,2017,1826,1000,826,121.1,1815,995,820,121.3
38330, 창녕군,015001, 10세,2017,396,230,166,138.6,392,227,165,137.6
38330, 창녕군,015002, 11세,2017,360,186,174,106.9,357,185,172,107.6
38330, 창녕군,015003, 12세,2017,334,188,146,128.8,333,188,145,129.7
38330, 창녕군,015004, 13세,2017,348,199,149,133.6,347,198,149,132.9
38330, 창녕군,015005, 14세,2017,388,197,191,103.1,386,197,189,104.2
38330, 창녕군,020,15~19세,2017,2849,1581,1268,124.7,2838,1576,1262,124.9
38330, 창녕군,020001, 15세,2017,471,255,216,118.1,471,255,216,118.1
38330, 창녕군,020002, 16세,2017,676,366,310,118.1,675,366,309,118.4
38330, 창녕군,020003, 17세,2017,701,374,327,114.4,700,373,327,114.1
38330, 창녕군,020004, 18세,2017,596,339,257,131.9,591,336,255,131.8
38330, 창녕군,020005, 19세,2017,405,247,158,156.3,401,246,155,158.7
38330, 창녕군,025,20~24세,2017,2843,1764,1079,163.5,2538,1552,986,157.4
38330, 창녕군,025001, 20세,2017,494,322,172,187.2,481,314,167,188
38330, 창녕군,025002, 21세,2017,613,411,202,203.5,575,386,189,204.2
38330, 창녕군,025003, 22세,2017,587,365,222,164.4,524,330,194,170.1
38330, 창녕군,025004, 23세,2017,544,323,221,146.2,462,259,203,127.6
38330, 창녕군,025005, 24세,2017,605,343,262,130.9,496,263,233,112.9
38330, 창녕군,030,25~29세,2017,3186,1976,1210,163.3,2453,1441,1012,142.4
38330, 창녕군,030001, 25세,2017,653,389,264,147.3,506,281,225,124.9
38330, 창녕군,030002, 26세,2017,663,408,255,160,519,302,217,139.2
38330, 창녕군,030003, 27세,2017,630,383,247,155.1,483,275,208,132.2
38330, 창녕군,030004, 28세,2017,637,406,231,175.8,515,322,193,166.8
38330, 창녕군,030005, 29세,2017,603,390,213,183.1,430,261,169,154.4
38330, 창녕군,035,30~34세,2017,3113,1842,1271,144.9,2497,1373,1124,122.2
38330, 창녕군,035001, 30세,2017,614,388,226,171.7,464,278,186,149.5
38330, 창녕군,035002, 31세,2017,618,371,247,150.2,485,268,217,123.5
38330, 창녕군,035003, 32세,2017,572,348,224,155.4,452,258,194,133
38330, 창녕군,035004, 33세,2017,649,369,280,131.8,547,292,255,114.5
38330, 창녕군,035005, 34세,2017,660,366,294,124.5,549,277,272,101.8
38330, 창녕군,040,35~39세,2017,3525,1977,1548,127.7,3127,1703,1424,119.6
38330, 창녕군,040001, 35세,2017,726,392,334,117.4,639,327,312,104.8
38330, 창녕군,040002, 36세,2017,690,417,273,152.7,608,364,244,149.2
38330, 창녕군,040003, 37세,2017,755,421,334,126,666,359,307,116.9
38330, 창녕군,040004, 38세,2017,702,386,316,122.2,635,340,295,115.3
38330, 창녕군,040005, 39세,2017,652,361,291,124.1,579,313,266,117.7
38330, 창녕군,045,40~44세,2017,3361,1931,1430,135,3113,1764,1349,130.8
38330, 창녕군,045001, 40세,2017,596,357,239,149.4,547,322,225,143.1
38330, 창녕군,045002, 41세,2017,599,353,246,143.5,543,317,226,140.3
38330, 창녕군,045003, 42세,2017,669,375,294,127.6,615,344,271,126.9
38330, 창녕군,045004, 43세,2017,730,421,309,136.2,682,385,297,129.6
38330, 창녕군,045005, 44세,2017,767,425,342,124.3,726,396,330,120
38330, 창녕군,050,45~49세,2017,4364,2453,1911,128.4,4171,2335,1836,127.2
38330, 창녕군,050001, 45세,2017,758,407,351,116,713,382,331,115.4
38330, 창녕군,050002, 46세,2017,868,498,370,134.6,824,472,352,134.1
38330, 창녕군,050003, 47세,2017,863,519,344,150.9,829,494,335,147.5
38330, 창녕군,050004, 48세,2017,915,492,423,116.3,882,474,408,116.2
38330, 창녕군,050005, 49세,2017,960,537,423,127,923,513,410,125.1
38330, 창녕군,055,50~54세,2017,4934,2575,2359,109.2,4773,2487,2286,108.8
38330, 창녕군,055001, 50세,2017,915,489,426,114.8,873,460,413,111.4
38330, 창녕군,055002, 51세,2017,948,524,424,123.6,926,515,411,125.3
38330, 창녕군,055003, 52세,2017,965,522,443,117.8,935,506,429,117.9
38330, 창녕군,055004, 53세,2017,1014,489,525,93.1,984,479,505,94.9
38330, 창녕군,055005, 54세,2017,1092,551,541,101.8,1055,527,528,99.8
38330, 창녕군,060,55~59세,2017,6218,3133,3085,101.6,6084,3064,3020,101.5
38330, 창녕군,060001, 55세,2017,1203,617,586,105.3,1171,601,570,105.4
38330, 창녕군,060002, 56세,2017,1218,584,634,92.1,1189,565,624,90.5
38330, 창녕군,060003, 57세,2017,1356,668,688,97.1,1328,657,671,97.9
38330, 창녕군,060004, 58세,2017,1257,639,618,103.4,1232,625,607,103
38330, 창녕군,060005, 59세,2017,1184,625,559,111.8,1164,616,548,112.4
38330, 창녕군,065,60~64세,2017,5539,2719,2820,96.4,5455,2676,2779,96.3
38330, 창녕군,065001, 60세,2017,1267,647,620,104.4,1249,634,615,103.1
38330, 창녕군,065002, 61세,2017,1195,604,591,102.2,1178,596,582,102.4
38330, 창녕군,065003, 62세,2017,1195,562,633,88.8,1177,553,624,88.6
38330, 창녕군,065004, 63세,2017,981,483,498,97,965,475,490,96.9
38330, 창녕군,065005, 64세,2017,901,423,478,88.5,886,418,468,89.3
38330, 창녕군,070,65~69세,2017,4530,2175,2355,92.4,4511,2170,2341,92.7
38330, 창녕군,070001, 65세,2017,1065,508,557,91.2,1059,508,551,92.2
38330, 창녕군,070002, 66세,2017,831,405,426,95.1,827,402,425,94.6
38330, 창녕군,070003, 67세,2017,892,425,467,91,886,423,463,91.4
38330, 창녕군,070004, 68세,2017,882,417,465,89.7,881,417,464,89.9
38330, 창녕군,070005, 69세,2017,860,420,440,95.5,858,420,438,95.9
38330, 창녕군,075,70~74세,2017,3715,1605,2110,76.1,3711,1604,2107,76.1
38330, 창녕군,075001, 70세,2017,878,423,455,93,878,423,455,93
38330, 창녕군,075002, 71세,2017,654,303,351,86.3,651,302,349,86.5
38330, 창녕군,075003, 72세,2017,651,288,363,79.3,651,288,363,79.3
38330, 창녕군,075004, 73세,2017,748,290,458,63.3,747,290,457,63.5
38330, 창녕군,075005, 74세,2017,784,301,483,62.3,784,301,483,62.3
38330, 창녕군,080,75~79세,2017,4221,1517,2704,56.1,4218,1516,2702,56.1
38330, 창녕군,080001, 75세,2017,929,348,581,59.9,927,348,579,60.1
38330, 창녕군,080002, 76세,2017,889,338,551,61.3,889,338,551,61.3
38330, 창녕군,080003, 77세,2017,794,287,507,56.6,793,286,507,56.4
38330, 창녕군,080004, 78세,2017,805,272,533,51,805,272,533,51
38330, 창녕군,080005, 79세,2017,804,272,532,51.1,804,272,532,51.1
38330, 창녕군,085,80~84세,2017,2822,892,1930,46.2,2819,890,1929,46.1
38330, 창녕군,085001, 80세,2017,676,244,432,56.5,675,243,432,56.3
38330, 창녕군,085002, 81세,2017,584,190,394,48.2,584,190,394,48.2
38330, 창녕군,085003, 82세,2017,577,194,383,50.7,577,194,383,50.7
38330, 창녕군,085004, 83세,2017,530,138,392,35.2,528,137,391,35
38330, 창녕군,085005, 84세,2017,455,126,329,38.3,455,126,329,38.3
38330, 창녕군,090,85~89세,2017,1325,336,989,34,1324,336,988,34
38330, 창녕군,090001, 85세,2017,416,124,292,42.5,416,124,292,42.5
38330, 창녕군,090002, 86세,2017,284,67,217,30.9,284,67,217,30.9
38330, 창녕군,090003, 87세,2017,249,60,189,31.7,249,60,189,31.7
38330, 창녕군,090004, 88세,2017,216,51,165,30.9,215,51,164,31.1
38330, 창녕군,090005, 89세,2017,160,34,126,27,160,34,126,27
38330, 창녕군,095,90~94세,2017,325,52,273,19,323,51,272,18.8
38330, 창녕군,095001, 90세,2017,109,18,91,19.8,108,18,90,20
38330, 창녕군,095002, 91세,2017,88,18,70,25.7,88,18,70,25.7
38330, 창녕군,095003, 92세,2017,48,8,40,20,48,8,40,20
38330, 창녕군,095004, 93세,2017,41,5,36,13.9,41,5,36,13.9
38330, 창녕군,095005, 94세,2017,39,X,36,8.3,38,X,36,5.6
38330, 창녕군,100,95~99세,2017,52,10,42,23.8,52,10,42,23.8
38330, 창녕군,100001, 95세,2017,23,X,19,21.1,23,X,19,21.1
38330, 창녕군,100002, 96세,2017,8,X,6,33.3,8,X,6,33.3
38330, 창녕군,100003, 97세,2017,13,X,11,18.2,13,X,11,18.2
38330, 창녕군,100004, 98세,2017,X,X,X,0,X,X,X,0
38330, 창녕군,100005, 99세,2017,5,X,X,66.7,5,X,X,66.7
38330, 창녕군,101,100세이상,2017,5,X,X,25,5,X,X,25
38330, 창녕군,102,15세미만,2017,5617,2988,2629,113.7,5557,2956,2601,113.6
38330, 창녕군,103,15~64세,2017,39932,21951,17981,122.1,37049,19971,17078,116.9
38330, 창녕군,104,65세이상,2017,16995,6588,10407,63.3,16963,6578,10385,63.3
38330, 창녕군,086,85세이상,2017,1707,399,1308,30.5,1704,398,1306,30.5
38330, 창녕군,126,평균연령,2017,49.2,46,52.4,,49.8,46.8,52.8,
38330, 창녕군,127,중위연령,2017,52.6,48.6,56.3,,53.8,50.1,56.9,
38340, 고성군,000,합계,2017,52439,26681,25758,103.6,50639,25410,25229,100.7
38340, 고성군,005,0~4세,2017,1502,737,765,96.3,1498,734,764,96.1
38340, 고성군,005001, 0세,2017,217,114,103,110.7,217,114,103,110.7
38340, 고성군,005002, 1세,2017,271,145,126,115.1,270,144,126,114.3
38340, 고성군,005003, 2세,2017,322,147,175,84,321,146,175,83.4
38340, 고성군,005004, 3세,2017,338,163,175,93.1,337,162,175,92.6
38340, 고성군,005005, 4세,2017,354,168,186,90.3,353,168,185,90.8
38340, 고성군,010,5~9세,2017,1933,1006,927,108.5,1932,1005,927,108.4
38340, 고성군,010001, 5세,2017,386,197,189,104.2,385,196,189,103.7
38340, 고성군,010002, 6세,2017,403,210,193,108.8,403,210,193,108.8
38340, 고성군,010003, 7세,2017,389,216,173,124.9,389,216,173,124.9
38340, 고성군,010004, 8세,2017,358,185,173,106.9,358,185,173,106.9
38340, 고성군,010005, 9세,2017,397,198,199,99.5,397,198,199,99.5
38340, 고성군,015,10~14세,2017,1827,958,869,110.2,1821,953,868,109.8
38340, 고성군,015001, 10세,2017,365,222,143,155.2,364,221,143,154.5
38340, 고성군,015002, 11세,2017,358,185,173,106.9,356,183,173,105.8
38340, 고성군,015003, 12세,2017,365,177,188,94.1,363,176,187,94.1
38340, 고성군,015004, 13세,2017,356,181,175,103.4,356,181,175,103.4
38340, 고성군,015005, 14세,2017,383,193,190,101.6,382,192,190,101.1
38340, 고성군,020,15~19세,2017,2646,1606,1040,154.4,2639,1604,1035,155
38340, 고성군,020001, 15세,2017,445,251,194,129.4,444,251,193,130.1
38340, 고성군,020002, 16세,2017,657,408,249,163.9,657,408,249,163.9
38340, 고성군,020003, 17세,2017,788,499,289,172.7,788,499,289,172.7
38340, 고성군,020004, 18세,2017,478,274,204,134.3,474,273,201,135.8
38340, 고성군,020005, 19세,2017,278,174,104,167.3,276,173,103,168
38340, 고성군,025,20~24세,2017,2046,1290,756,170.6,1899,1193,706,169
38340, 고성군,025001, 20세,2017,385,284,101,281.2,383,283,100,283
38340, 고성군,025002, 21세,2017,461,311,150,207.3,449,301,148,203.4
38340, 고성군,025003, 22세,2017,410,266,144,184.7,377,243,134,181.3
38340, 고성군,025004, 23세,2017,400,220,180,122.2,352,185,167,110.8
38340, 고성군,025005, 24세,2017,390,209,181,115.5,338,181,157,115.3
38340, 고성군,030,25~29세,2017,2150,1263,887,142.4,1754,971,783,124
38340, 고성군,030001, 25세,2017,456,272,184,147.8,391,223,168,132.7
38340, 고성군,030002, 26세,2017,430,256,174,147.1,351,202,149,135.6
38340, 고성군,030003, 27세,2017,413,244,169,144.4,327,183,144,127.1
38340, 고성군,030004, 28세,2017,442,255,187,136.4,357,191,166,115.1
38340, 고성군,030005, 29세,2017,409,236,173,136.4,328,172,156,110.3
38340, 고성군,035,30~34세,2017,2561,1520,1041,146,2114,1171,943,124.2
38340, 고성군,035001, 30세,2017,447,267,180,148.3,351,197,154,127.9
38340, 고성군,035002, 31세,2017,458,283,175,161.7,370,218,152,143.4
38340, 고성군,035003, 32세,2017,514,301,213,141.3,418,221,197,112.2
38340, 고성군,035004, 33세,2017,552,316,236,133.9,456,241,215,112.1
38340, 고성군,035005, 34세,2017,590,353,237,148.9,519,294,225,130.7
38340, 고성군,040,35~39세,2017,3129,1855,1274,145.6,2855,1628,1227,132.7
38340, 고성군,040001, 35세,2017,630,382,248,154,562,324,238,136.1
38340, 고성군,040002, 36세,2017,632,350,282,124.1,581,307,274,112
38340, 고성군,040003, 37세,2017,670,399,271,147.2,613,352,261,134.9
38340, 고성군,040004, 38세,2017,630,392,238,164.7,578,348,230,151.3
38340, 고성군,040005, 39세,2017,567,332,235,141.3,521,297,224,132.6
38340, 고성군,045,40~44세,2017,3107,1715,1392,123.2,2946,1601,1345,119
38340, 고성군,045001, 40세,2017,543,298,245,121.6,507,273,234,116.7
38340, 고성군,045002, 41세,2017,579,319,260,122.7,549,298,251,118.7
38340, 고성군,045003, 42세,2017,628,339,289,117.3,593,314,279,112.5
38340, 고성군,045004, 43세,2017,644,357,287,124.4,613,335,278,120.5
38340, 고성군,045005, 44세,2017,713,402,311,129.3,684,381,303,125.7
38340, 고성군,050,45~49세,2017,3935,2197,1738,126.4,3801,2121,1680,126.3
38340, 고성군,050001, 45세,2017,696,404,292,138.4,671,391,280,139.6
38340, 고성군,050002, 46세,2017,843,443,400,110.8,814,424,390,108.7
38340, 고성군,050003, 47세,2017,843,476,367,129.7,812,459,353,130
38340, 고성군,050004, 48세,2017,760,442,318,139,735,430,305,141
38340, 고성군,050005, 49세,2017,793,432,361,119.7,769,417,352,118.5
38340, 고성군,055,50~54세,2017,3983,2146,1837,116.8,3879,2097,1782,117.7
38340, 고성군,055001, 50세,2017,791,462,329,140.4,776,452,324,139.5
38340, 고성군,055002, 51세,2017,778,411,367,112,758,402,356,112.9
38340, 고성군,055003, 52세,2017,811,405,406,99.8,784,391,393,99.5
38340, 고성군,055004, 53세,2017,774,432,342,126.3,752,426,326,130.7
38340, 고성군,055005, 54세,2017,829,436,393,110.9,809,426,383,111.2
38340, 고성군,060,55~59세,2017,4964,2506,2458,102,4915,2484,2431,102.2
38340, 고성군,060001, 55세,2017,969,491,478,102.7,956,484,472,102.5
38340, 고성군,060002, 56세,2017,1061,535,526,101.7,1051,529,522,101.3
38340, 고성군,060003, 57세,2017,1069,532,537,99.1,1055,527,528,99.8
38340, 고성군,060004, 58세,2017,959,482,477,101,954,481,473,101.7
38340, 고성군,060005, 59세,2017,906,466,440,105.9,899,463,436,106.2
38340, 고성군,065,60~64세,2017,4459,2224,2235,99.5,4411,2199,2212,99.4
38340, 고성군,065001, 60세,2017,956,506,450,112.4,941,497,444,111.9
38340, 고성군,065002, 61세,2017,954,490,464,105.6,942,487,455,107
38340, 고성군,065003, 62세,2017,930,431,499,86.4,925,428,497,86.1
38340, 고성군,065004, 63세,2017,871,435,436,99.8,859,428,431,99.3
38340, 고성군,065005, 64세,2017,748,362,386,93.8,744,359,385,93.2
38340, 고성군,070,65~69세,2017,3824,1874,1950,96.1,3812,1867,1945,96
38340, 고성군,070001, 65세,2017,855,416,439,94.8,855,416,439,94.8
38340, 고성군,070002, 66세,2017,742,368,374,98.4,740,367,373,98.4
38340, 고성군,070003, 67세,2017,705,326,379,86,697,322,375,85.9
38340, 고성군,070004, 68세,2017,761,388,373,104,760,387,373,103.8
38340, 고성군,070005, 69세,2017,761,376,385,97.7,760,375,385,97.4
38340, 고성군,075,70~74세,2017,3123,1379,1744,79.1,3118,1379,1739,79.3
38340, 고성군,075001, 70세,2017,749,351,398,88.2,748,351,397,88.4
38340, 고성군,075002, 71세,2017,536,235,301,78.1,536,235,301,78.1
38340, 고성군,075003, 72세,2017,615,255,360,70.8,613,255,358,71.2
38340, 고성군,075004, 73세,2017,567,259,308,84.1,565,259,306,84.6
38340, 고성군,075005, 74세,2017,656,279,377,74,656,279,377,74
38340, 고성군,080,75~79세,2017,3250,1235,2015,61.3,3249,1235,2014,61.3
38340, 고성군,080001, 75세,2017,726,278,448,62.1,726,278,448,62.1
38340, 고성군,080002, 76세,2017,669,260,409,63.6,669,260,409,63.6
38340, 고성군,080003, 77세,2017,653,259,394,65.7,652,259,393,65.9
38340, 고성군,080004, 78세,2017,675,246,429,57.3,675,246,429,57.3
38340, 고성군,080005, 79세,2017,527,192,335,57.3,527,192,335,57.3
38340, 고성군,085,80~84세,2017,2406,815,1591,51.2,2403,813,1590,51.1
38340, 고성군,085001, 80세,2017,542,191,351,54.4,540,189,351,53.8
38340, 고성군,085002, 81세,2017,547,200,347,57.6,547,200,347,57.6
38340, 고성군,085003, 82세,2017,501,180,321,56.1,501,180,321,56.1
38340, 고성군,085004, 83세,2017,433,135,298,45.3,432,135,297,45.5
38340, 고성군,085005, 84세,2017,383,109,274,39.8,383,109,274,39.8
38340, 고성군,090,85~89세,2017,1179,275,904,30.4,1179,275,904,30.4
38340, 고성군,090001, 85세,2017,325,69,256,27,325,69,256,27
38340, 고성군,090002, 86세,2017,265,63,202,31.2,265,63,202,31.2
38340, 고성군,090003, 87세,2017,239,55,184,29.9,239,55,184,29.9
38340, 고성군,090004, 88세,2017,205,56,149,37.6,205,56,149,37.6
38340, 고성군,090005, 89세,2017,145,32,113,28.3,145,32,113,28.3
38340, 고성군,095,90~94세,2017,344,70,274,25.5,343,70,273,25.6
38340, 고성군,095001, 90세,2017,109,24,85,28.2,108,24,84,28.6
38340, 고성군,095002, 91세,2017,98,17,81,21,98,17,81,21
38340, 고성군,095003, 92세,2017,55,9,46,19.6,55,9,46,19.6
38340, 고성군,095004, 93세,2017,41,12,29,41.4,41,12,29,41.4
38340, 고성군,095005, 94세,2017,41,8,33,24.2,41,8,33,24.2
38340, 고성군,100,95~99세,2017,61,10,51,19.6,61,10,51,19.6
38340, 고성군,100001, 95세,2017,24,5,19,26.3,24,5,19,26.3
38340, 고성군,100002, 96세,2017,18,X,16,12.5,18,X,16,12.5
38340, 고성군,100003, 97세,2017,11,X,10,10,11,X,10,10
38340, 고성군,100004, 98세,2017,X,X,X,100,X,X,X,100
38340, 고성군,100005, 99세,2017,X,X,X,0,X,X,X,0
38340, 고성군,101,100세이상,2017,10,X,10,0,10,X,10,0
38340, 고성군,102,15세미만,2017,5262,2701,2561,105.5,5251,2692,2559,105.2
38340, 고성군,103,15~64세,2017,32980,18322,14658,125,31213,17069,14144,120.7
38340, 고성군,104,65세이상,2017,14197,5658,8539,66.3,14175,5649,8526,66.3
38340, 고성군,086,85세이상,2017,1594,355,1239,28.7,1593,355,1238,28.7
38340, 고성군,126,평균연령,2017,48.8,45.9,51.8,,49.3,46.4,52.1,
38340, 고성군,127,중위연령,2017,51.8,48.2,55.7,,52.7,49.3,56.2,
38350, 남해군,000,합계,2017,42986,20813,22173,93.9,42024,20060,21964,91.3
38350, 남해군,005,0~4세,2017,780,399,381,104.7,779,399,380,105
38350, 남해군,005001, 0세,2017,134,74,60,123.3,134,74,60,123.3
38350, 남해군,005002, 1세,2017,143,59,84,70.2,142,59,83,71.1
38350, 남해군,005003, 2세,2017,166,95,71,133.8,166,95,71,133.8
38350, 남해군,005004, 3세,2017,188,103,85,121.2,188,103,85,121.2
38350, 남해군,005005, 4세,2017,149,68,81,84,149,68,81,84
38350, 남해군,010,5~9세,2017,1084,598,486,123,1081,596,485,122.9
38350, 남해군,010001, 5세,2017,194,98,96,102.1,193,97,96,101
38350, 남해군,010002, 6세,2017,208,129,79,163.3,208,129,79,163.3
38350, 남해군,010003, 7세,2017,225,115,110,104.5,224,114,110,103.6
38350, 남해군,010004, 8세,2017,223,122,101,120.8,222,122,100,122
38350, 남해군,010005, 9세,2017,234,134,100,134,234,134,100,134
38350, 남해군,015,10~14세,2017,1268,655,613,106.9,1266,653,613,106.5
38350, 남해군,015001, 10세,2017,246,127,119,106.7,245,126,119,105.9
38350, 남해군,015002, 11세,2017,225,114,111,102.7,225,114,111,102.7
38350, 남해군,015003, 12세,2017,246,125,121,103.3,246,125,121,103.3
38350, 남해군,015004, 13세,2017,276,145,131,110.7,276,145,131,110.7
38350, 남해군,015005, 14세,2017,275,144,131,109.9,274,143,131,109.2
38350, 남해군,020,15~19세,2017,2106,1144,962,118.9,2102,1142,960,119
38350, 남해군,020001, 15세,2017,358,209,149,140.3,357,208,149,139.6
38350, 남해군,020002, 16세,2017,406,191,215,88.8,405,191,214,89.3
38350, 남해군,020003, 17세,2017,556,290,266,109,556,290,266,109
38350, 남해군,020004, 18세,2017,471,257,214,120.1,469,256,213,120.2
38350, 남해군,020005, 19세,2017,315,197,118,166.9,315,197,118,166.9
38350, 남해군,025,20~24세,2017,1846,1252,594,210.8,1721,1144,577,198.3
38350, 남해군,025001, 20세,2017,379,244,135,180.7,370,235,135,174.1
38350, 남해군,025002, 21세,2017,359,255,104,245.2,349,246,103,238.8
38350, 남해군,025003, 22세,2017,405,286,119,240.3,381,268,113,237.2
38350, 남해군,025004, 23세,2017,358,239,119,200.8,326,211,115,183.5
38350, 남해군,025005, 24세,2017,345,228,117,194.9,295,184,111,165.8
38350, 남해군,030,25~29세,2017,1502,912,590,154.6,1275,706,569,124.1
38350, 남해군,030001, 25세,2017,321,198,123,161,277,155,122,127
38350, 남해군,030002, 26세,2017,313,180,133,135.3,269,139,130,106.9
38350, 남해군,030003, 27세,2017,321,198,123,161,270,150,120,125
38350, 남해군,030004, 28세,2017,271,171,100,171,229,137,92,148.9
38350, 남해군,030005, 29세,2017,276,165,111,148.6,230,125,105,119
38350, 남해군,035,30~34세,2017,1377,799,578,138.2,1166,626,540,115.9
38350, 남해군,035001, 30세,2017,274,161,113,142.5,220,117,103,113.6
38350, 남해군,035002, 31세,2017,258,153,105,145.7,218,121,97,124.7
38350, 남해군,035003, 32세,2017,263,167,96,174,213,124,89,139.3
38350, 남해군,035004, 33세,2017,273,151,122,123.8,237,125,112,111.6
38350, 남해군,035005, 34세,2017,309,167,142,117.6,278,139,139,100
38350, 남해군,040,35~39세,2017,1632,883,749,117.9,1502,774,728,106.3
38350, 남해군,040001, 35세,2017,312,166,146,113.7,279,141,138,102.2
38350, 남해군,040002, 36세,2017,354,195,159,122.6,322,167,155,107.7
38350, 남해군,040003, 37세,2017,337,173,164,105.5,312,152,160,95
38350, 남해군,040004, 38세,2017,321,177,144,122.9,300,159,141,112.8
38350, 남해군,040005, 39세,2017,308,172,136,126.5,289,155,134,115.7
38350, 남해군,045,40~44세,2017,2143,1162,981,118.5,2059,1094,965,113.4
38350, 남해군,045001, 40세,2017,333,181,152,119.1,319,168,151,111.3
38350, 남해군,045002, 41세,2017,389,214,175,122.3,368,199,169,117.8
38350, 남해군,045003, 42세,2017,430,231,199,116.1,413,216,197,109.6
38350, 남해군,045004, 43세,2017,451,253,198,127.8,431,237,194,122.2
38350, 남해군,045005, 44세,2017,540,283,257,110.1,528,274,254,107.9
38350, 남해군,050,45~49세,2017,2888,1612,1276,126.3,2837,1580,1257,125.7
38350, 남해군,050001, 45세,2017,519,287,232,123.7,507,279,228,122.4
38350, 남해군,050002, 46세,2017,592,355,237,149.8,582,348,234,148.7
38350, 남해군,050003, 47세,2017,560,312,248,125.8,556,309,247,125.1
38350, 남해군,050004, 48세,2017,624,335,289,115.9,610,326,284,114.8
38350, 남해군,050005, 49세,2017,593,323,270,119.6,582,318,264,120.5
38350, 남해군,055,50~54세,2017,3112,1641,1471,111.6,3084,1631,1453,112.3
38350, 남해군,055001, 50세,2017,558,301,257,117.1,549,300,249,120.5
38350, 남해군,055002, 51세,2017,619,350,269,130.1,615,348,267,130.3
38350, 남해군,055003, 52세,2017,639,331,308,107.5,633,329,304,108.2
38350, 남해군,055004, 53세,2017,621,309,312,99,618,307,311,98.7
38350, 남해군,055005, 54세,2017,675,350,325,107.7,669,347,322,107.8
38350, 남해군,060,55~59세,2017,4304,2135,2169,98.4,4267,2125,2142,99.2
38350, 남해군,060001, 55세,2017,879,448,431,103.9,875,448,427,104.9
38350, 남해군,060002, 56세,2017,932,444,488,91,925,442,483,91.5
38350, 남해군,060003, 57세,2017,908,461,447,103.1,900,458,442,103.6
38350, 남해군,060004, 58세,2017,780,363,417,87.1,770,360,410,87.8
38350, 남해군,060005, 59세,2017,805,419,386,108.5,797,417,380,109.7
38350, 남해군,065,60~64세,2017,3798,1847,1951,94.7,3772,1834,1938,94.6
38350, 남해군,065001, 60세,2017,854,419,435,96.3,854,419,435,96.3
38350, 남해군,065002, 61세,2017,764,383,381,100.5,757,380,377,100.8
38350, 남해군,065003, 62세,2017,850,395,455,86.8,844,392,452,86.7
38350, 남해군,065004, 63세,2017,667,327,340,96.2,658,321,337,95.3
38350, 남해군,065005, 64세,2017,663,323,340,95,659,322,337,95.5
38350, 남해군,070,65~69세,2017,3597,1694,1903,89,3581,1686,1895,89
38350, 남해군,070001, 65세,2017,774,358,416,86.1,768,355,413,86
38350, 남해군,070002, 66세,2017,723,330,393,84,723,330,393,84
38350, 남해군,070003, 67세,2017,607,303,304,99.7,604,301,303,99.3
38350, 남해군,070004, 68세,2017,807,386,421,91.7,803,385,418,92.1
38350, 남해군,070005, 69세,2017,686,317,369,85.9,683,315,368,85.6
38350, 남해군,075,70~74세,2017,3098,1383,1715,80.6,3091,1379,1712,80.5
38350, 남해군,075001, 70세,2017,721,341,380,89.7,719,341,378,90.2
38350, 남해군,075002, 71세,2017,597,284,313,90.7,596,283,313,90.4
38350, 남해군,075003, 72세,2017,595,274,321,85.4,594,274,320,85.6
38350, 남해군,075004, 73세,2017,552,241,311,77.5,549,238,311,76.5
38350, 남해군,075005, 74세,2017,633,243,390,62.3,633,243,390,62.3
38350, 남해군,080,75~79세,2017,3645,1385,2260,61.3,3637,1381,2256,61.2
38350, 남해군,080001, 75세,2017,845,321,524,61.3,844,321,523,61.4
38350, 남해군,080002, 76세,2017,749,289,460,62.8,745,287,458,62.7
38350, 남해군,080003, 77세,2017,733,278,455,61.1,730,276,454,60.8
38350, 남해군,080004, 78세,2017,722,272,450,60.4,722,272,450,60.4
38350, 남해군,080005, 79세,2017,596,225,371,60.6,596,225,371,60.6
38350, 남해군,085,80~84세,2017,2711,849,1862,45.6,2711,849,1862,45.6
38350, 남해군,085001, 80세,2017,628,211,417,50.6,628,211,417,50.6
38350, 남해군,085002, 81세,2017,548,172,376,45.7,548,172,376,45.7
38350, 남해군,085003, 82세,2017,575,168,407,41.3,575,168,407,41.3
38350, 남해군,085004, 83세,2017,537,168,369,45.5,537,168,369,45.5
38350, 남해군,085005, 84세,2017,423,130,293,44.4,423,130,293,44.4
38350, 남해군,090,85~89세,2017,1501,362,1139,31.8,1500,361,1139,31.7
38350, 남해군,090001, 85세,2017,424,113,311,36.3,424,113,311,36.3
38350, 남해군,090002, 86세,2017,355,85,270,31.5,355,85,270,31.5
38350, 남해군,090003, 87세,2017,310,81,229,35.4,309,80,229,34.9
38350, 남해군,090004, 88세,2017,236,45,191,23.6,236,45,191,23.6
38350, 남해군,090005, 89세,2017,176,38,138,27.5,176,38,138,27.5
38350, 남해군,095,90~94세,2017,495,91,404,22.5,494,90,404,22.3
38350, 남해군,095001, 90세,2017,159,36,123,29.3,158,35,123,28.5
38350, 남해군,095002, 91세,2017,114,23,91,25.3,114,23,91,25.3
38350, 남해군,095003, 92세,2017,106,18,88,20.5,106,18,88,20.5
38350, 남해군,095004, 93세,2017,63,5,58,8.6,63,5,58,8.6
38350, 남해군,095005, 94세,2017,53,9,44,20.5,53,9,44,20.5
38350, 남해군,100,95~99세,2017,92,10,82,12.2,92,10,82,12.2
38350, 남해군,100001, 95세,2017,48,X,44,9.1,48,X,44,9.1
38350, 남해군,100002, 96세,2017,22,X,18,22.2,22,X,18,22.2
38350, 남해군,100003, 97세,2017,11,X,10,10,11,X,10,10
38350, 남해군,100004, 98세,2017,X,X,X,33.3,X,X,X,33.3
38350, 남해군,100005, 99세,2017,7,X,7,0,7,X,7,0
38350, 남해군,101,100세이상,2017,7,X,7,0,7,X,7,0
38350, 남해군,102,15세미만,2017,3132,1652,1480,111.6,3126,1648,1478,111.5
38350, 남해군,103,15~64세,2017,24708,13387,11321,118.2,23785,12656,11129,113.7
38350, 남해군,104,65세이상,2017,15146,5774,9372,61.6,15113,5756,9357,61.5
38350, 남해군,086,85세이상,2017,2095,463,1632,28.4,2093,461,1632,28.2
38350, 남해군,126,평균연령,2017,53.2,49.4,56.7,,53.6,50,56.9,
38350, 남해군,127,중위연령,2017,56.9,53,60.5,,57.4,54.1,60.7,
38360, 하동군,000,합계,2017,43441,21214,22227,95.4,42801,20944,21857,95.8
38360, 하동군,005,0~4세,2017,1019,522,497,105,1019,522,497,105
38360, 하동군,005001, 0세,2017,184,96,88,109.1,184,96,88,109.1
38360, 하동군,005002, 1세,2017,198,84,114,73.7,198,84,114,73.7
38360, 하동군,005003, 2세,2017,222,119,103,115.5,222,119,103,115.5
38360, 하동군,005004, 3세,2017,221,116,105,110.5,221,116,105,110.5
38360, 하동군,005005, 4세,2017,194,107,87,123,194,107,87,123
38360, 하동군,010,5~9세,2017,1295,683,612,111.6,1294,683,611,111.8
38360, 하동군,010001, 5세,2017,235,118,117,100.9,235,118,117,100.9
38360, 하동군,010002, 6세,2017,246,141,105,134.3,246,141,105,134.3
38360, 하동군,010003, 7세,2017,257,138,119,116,257,138,119,116
38360, 하동군,010004, 8세,2017,251,114,137,83.2,251,114,137,83.2
38360, 하동군,010005, 9세,2017,306,172,134,128.4,305,172,133,129.3
38360, 하동군,015,10~14세,2017,1423,779,644,121,1423,779,644,121
38360, 하동군,015001, 10세,2017,268,156,112,139.3,268,156,112,139.3
38360, 하동군,015002, 11세,2017,283,154,129,119.4,283,154,129,119.4
38360, 하동군,015003, 12세,2017,284,148,136,108.8,284,148,136,108.8
38360, 하동군,015004, 13세,2017,293,161,132,122,293,161,132,122
38360, 하동군,015005, 14세,2017,295,160,135,118.5,295,160,135,118.5
38360, 하동군,020,15~19세,2017,1591,909,682,133.3,1586,907,679,133.6
38360, 하동군,020001, 15세,2017,316,174,142,122.5,316,174,142,122.5
38360, 하동군,020002, 16세,2017,317,163,154,105.8,317,163,154,105.8
38360, 하동군,020003, 17세,2017,369,207,162,127.8,367,205,162,126.5
38360, 하동군,020004, 18세,2017,350,200,150,133.3,349,200,149,134.2
38360, 하동군,020005, 19세,2017,239,165,74,223,237,165,72,229.2
38360, 하동군,025,20~24세,2017,1681,1071,610,175.6,1584,1038,546,190.1
38360, 하동군,025001, 20세,2017,344,249,95,262.1,332,244,88,277.3
38360, 하동군,025002, 21세,2017,386,284,102,278.4,374,280,94,297.9
38360, 하동군,025003, 22세,2017,304,187,117,159.8,281,177,104,170.2
38360, 하동군,025004, 23세,2017,305,166,139,119.4,288,163,125,130.4
38360, 하동군,025005, 24세,2017,342,185,157,117.8,309,174,135,128.9
38360, 하동군,030,25~29세,2017,1702,925,777,119,1528,847,681,124.4
38360, 하동군,030001, 25세,2017,340,175,165,106.1,306,161,145,111
38360, 하동군,030002, 26세,2017,363,209,154,135.7,321,190,131,145
38360, 하동군,030003, 27세,2017,311,173,138,125.4,274,154,120,128.3
38360, 하동군,030004, 28세,2017,340,168,172,97.7,312,156,156,100
38360, 하동군,030005, 29세,2017,348,200,148,135.1,315,186,129,144.2
38360, 하동군,035,30~34세,2017,1478,801,677,118.3,1375,756,619,122.1
38360, 하동군,035001, 30세,2017,302,169,133,127.1,276,160,116,137.9
38360, 하동군,035002, 31세,2017,278,155,123,126,258,142,116,122.4
38360, 하동군,035003, 32세,2017,249,135,114,118.4,227,128,99,129.3
38360, 하동군,035004, 33세,2017,354,188,166,113.3,335,180,155,116.1
38360, 하동군,035005, 34세,2017,295,154,141,109.2,279,146,133,109.8
38360, 하동군,040,35~39세,2017,1826,979,847,115.6,1775,950,825,115.2
38360, 하동군,040001, 35세,2017,367,197,170,115.9,356,191,165,115.8
38360, 하동군,040002, 36세,2017,344,179,165,108.5,331,172,159,108.2
38360, 하동군,040003, 37세,2017,355,194,161,120.5,346,189,157,120.4
38360, 하동군,040004, 38세,2017,381,217,164,132.3,369,210,159,132.1
38360, 하동군,040005, 39세,2017,379,192,187,102.7,373,188,185,101.6
38360, 하동군,045,40~44세,2017,2329,1261,1068,118.1,2287,1245,1042,119.5
38360, 하동군,045001, 40세,2017,350,179,171,104.7,342,177,165,107.3
38360, 하동군,045002, 41세,2017,403,237,166,142.8,397,233,164,142.1
38360, 하동군,045003, 42세,2017,469,243,226,107.5,455,239,216,110.6
38360, 하동군,045004, 43세,2017,508,277,231,119.9,500,273,227,120.3
38360, 하동군,045005, 44세,2017,599,325,274,118.6,593,323,270,119.6
38360, 하동군,050,45~49세,2017,3249,1796,1453,123.6,3212,1781,1431,124.5
38360, 하동군,050001, 45세,2017,535,296,239,123.8,530,291,239,121.8
38360, 하동군,050002, 46세,2017,611,331,280,118.2,603,329,274,120.1
38360, 하동군,050003, 47세,2017,703,394,309,127.5,701,393,308,127.6
38360, 하동군,050004, 48세,2017,692,400,292,137,682,396,286,138.5
38360, 하동군,050005, 49세,2017,708,375,333,112.6,696,372,324,114.8
38360, 하동군,055,50~54세,2017,3518,1848,1670,110.7,3470,1829,1641,111.5
38360, 하동군,055001, 50세,2017,714,382,332,115.1,701,377,324,116.4
38360, 하동군,055002, 51세,2017,675,366,309,118.4,665,362,303,119.5
38360, 하동군,055003, 52세,2017,690,348,342,101.8,685,346,339,102.1
38360, 하동군,055004, 53세,2017,659,326,333,97.9,653,324,329,98.5
38360, 하동군,055005, 54세,2017,780,426,354,120.3,766,420,346,121.4
38360, 하동군,060,55~59세,2017,4569,2329,2240,104,4521,2309,2212,104.4
38360, 하동군,060001, 55세,2017,910,476,434,109.7,898,471,427,110.3
38360, 하동군,060002, 56세,2017,983,483,500,96.6,977,481,496,97
38360, 하동군,060003, 57세,2017,977,506,471,107.4,965,501,464,108
38360, 하동군,060004, 58세,2017,827,419,408,102.7,818,415,403,103
38360, 하동군,060005, 59세,2017,872,445,427,104.2,863,441,422,104.5
38360, 하동군,065,60~64세,2017,3975,1995,1980,100.8,3952,1986,1966,101
38360, 하동군,065001, 60세,2017,842,430,412,104.4,837,430,407,105.7
38360, 하동군,065002, 61세,2017,834,447,387,115.5,826,442,384,115.1
38360, 하동군,065003, 62세,2017,861,421,440,95.7,857,418,439,95.2
38360, 하동군,065004, 63세,2017,762,384,378,101.6,758,383,375,102.1
38360, 하동군,065005, 64세,2017,676,313,363,86.2,674,313,361,86.7
38360, 하동군,070,65~69세,2017,3379,1612,1767,91.2,3371,1610,1761,91.4
38360, 하동군,070001, 65세,2017,704,336,368,91.3,700,334,366,91.3
38360, 하동군,070002, 66세,2017,650,312,338,92.3,648,312,336,92.9
38360, 하동군,070003, 67세,2017,657,320,337,95,657,320,337,95
38360, 하동군,070004, 68세,2017,679,318,361,88.1,678,318,360,88.3
38360, 하동군,070005, 69세,2017,689,326,363,89.8,688,326,362,90.1
38360, 하동군,075,70~74세,2017,2934,1276,1658,77,2931,1274,1657,76.9
38360, 하동군,075001, 70세,2017,676,302,374,80.7,675,301,374,80.5
38360, 하동군,075002, 71세,2017,516,235,281,83.6,514,234,280,83.6
38360, 하동군,075003, 72세,2017,543,223,320,69.7,543,223,320,69.7
38360, 하동군,075004, 73세,2017,610,266,344,77.3,610,266,344,77.3
38360, 하동군,075005, 74세,2017,589,250,339,73.7,589,250,339,73.7
38360, 하동군,080,75~79세,2017,3328,1216,2112,57.6,3328,1216,2112,57.6
38360, 하동군,080001, 75세,2017,777,289,488,59.2,777,289,488,59.2
38360, 하동군,080002, 76세,2017,641,250,391,63.9,641,250,391,63.9
38360, 하동군,080003, 77세,2017,662,235,427,55,662,235,427,55
38360, 하동군,080004, 78세,2017,702,252,450,56,702,252,450,56
38360, 하동군,080005, 79세,2017,546,190,356,53.4,546,190,356,53.4
38360, 하동군,085,80~84세,2017,2408,767,1641,46.7,2408,767,1641,46.7
38360, 하동군,085001, 80세,2017,590,216,374,57.8,590,216,374,57.8
38360, 하동군,085002, 81세,2017,548,165,383,43.1,548,165,383,43.1
38360, 하동군,085003, 82세,2017,507,154,353,43.6,507,154,353,43.6
38360, 하동군,085004, 83세,2017,444,142,302,47,444,142,302,47
38360, 하동군,085005, 84세,2017,319,90,229,39.3,319,90,229,39.3
38360, 하동군,090,85~89세,2017,1257,341,916,37.2,1257,341,916,37.2
38360, 하동군,090001, 85세,2017,367,105,262,40.1,367,105,262,40.1
38360, 하동군,090002, 86세,2017,295,86,209,41.1,295,86,209,41.1
38360, 하동군,090003, 87세,2017,249,65,184,35.3,249,65,184,35.3
38360, 하동군,090004, 88세,2017,196,50,146,34.2,196,50,146,34.2
38360, 하동군,090005, 89세,2017,150,35,115,30.4,150,35,115,30.4
38360, 하동군,095,90~94세,2017,407,88,319,27.6,407,88,319,27.6
38360, 하동군,095001, 90세,2017,146,35,111,31.5,146,35,111,31.5
38360, 하동군,095002, 91세,2017,103,23,80,28.8,103,23,80,28.8
38360, 하동군,095003, 92세,2017,65,9,56,16.1,65,9,56,16.1
38360, 하동군,095004, 93세,2017,49,13,36,36.1,49,13,36,36.1
38360, 하동군,095005, 94세,2017,44,8,36,22.2,44,8,36,22.2
38360, 하동군,100,95~99세,2017,62,15,47,31.9,62,15,47,31.9
38360, 하동군,100001, 95세,2017,23,8,15,53.3,23,8,15,53.3
38360, 하동군,100002, 96세,2017,12,X,8,50,12,X,8,50
38360, 하동군,100003, 97세,2017,12,X,10,20,12,X,10,20
38360, 하동군,100004, 98세,2017,8,X,8,0,8,X,8,0
38360, 하동군,100005, 99세,2017,7,X,6,16.7,7,X,6,16.7
38360, 하동군,101,100세이상,2017,11,X,10,10,11,X,10,10
38360, 하동군,102,15세미만,2017,3737,1984,1753,113.2,3736,1984,1752,113.2
38360, 하동군,103,15~64세,2017,25918,13914,12004,115.9,25290,13648,11642,117.2
38360, 하동군,104,65세이상,2017,13786,5316,8470,62.8,13775,5312,8463,62.8
38360, 하동군,086,85세이상,2017,1737,445,1292,34.4,1737,445,1292,34.4
38360, 하동군,126,평균연령,2017,52,48.9,55,,52.2,49,55.3,
38360, 하동군,127,중위연령,2017,55.7,52.4,58.4,,55.9,52.6,58.8,
38370, 산청군,000,합계,2017,34033,16459,17574,93.7,33278,16120,17158,94
38370, 산청군,005,0~4세,2017,910,482,428,112.6,908,481,427,112.6
38370, 산청군,005001, 0세,2017,200,104,96,108.3,200,104,96,108.3
38370, 산청군,005002, 1세,2017,178,86,92,93.5,178,86,92,93.5
38370, 산청군,005003, 2세,2017,201,117,84,139.3,201,117,84,139.3
38370, 산청군,005004, 3세,2017,156,85,71,119.7,155,84,71,118.3
38370, 산청군,005005, 4세,2017,175,90,85,105.9,174,90,84,107.1
38370, 산청군,010,5~9세,2017,860,484,376,128.7,858,484,374,129.4
38370, 산청군,010001, 5세,2017,173,93,80,116.3,173,93,80,116.3
38370, 산청군,010002, 6세,2017,162,100,62,161.3,162,100,62,161.3
38370, 산청군,010003, 7세,2017,179,97,82,118.3,178,97,81,119.8
38370, 산청군,010004, 8세,2017,169,86,83,103.6,168,86,82,104.9
38370, 산청군,010005, 9세,2017,177,108,69,156.5,177,108,69,156.5
38370, 산청군,015,10~14세,2017,1021,526,495,106.3,1016,525,491,106.9
38370, 산청군,015001, 10세,2017,221,111,110,100.9,220,111,109,101.8
38370, 산청군,015002, 11세,2017,187,97,90,107.8,186,97,89,109
38370, 산청군,015003, 12세,2017,200,98,102,96.1,200,98,102,96.1
38370, 산청군,015004, 13세,2017,191,100,91,109.9,191,100,91,109.9
38370, 산청군,015005, 14세,2017,222,120,102,117.6,219,119,100,119
38370, 산청군,020,15~19세,2017,1357,688,669,102.8,1350,687,663,103.6
38370, 산청군,020001, 15세,2017,242,118,124,95.2,242,118,124,95.2
38370, 산청군,020002, 16세,2017,307,157,150,104.7,307,157,150,104.7
38370, 산청군,020003, 17세,2017,332,147,185,79.5,331,147,184,79.9
38370, 산청군,020004, 18세,2017,300,153,147,104.1,299,152,147,103.4
38370, 산청군,020005, 19세,2017,176,113,63,179.4,171,113,58,194.8
38370, 산청군,025,20~24세,2017,1189,688,501,137.3,1078,664,414,160.4
38370, 산청군,025001, 20세,2017,232,151,81,186.4,225,151,74,204.1
38370, 산청군,025002, 21세,2017,231,159,72,220.8,221,157,64,245.3
38370, 산청군,025003, 22세,2017,228,130,98,132.7,210,128,82,156.1
38370, 산청군,025004, 23세,2017,250,126,124,101.6,209,116,93,124.7
38370, 산청군,025005, 24세,2017,248,122,126,96.8,213,112,101,110.9
38370, 산청군,030,25~29세,2017,1279,691,588,117.5,1062,591,471,125.5
38370, 산청군,030001, 25세,2017,268,138,130,106.2,216,115,101,113.9
38370, 산청군,030002, 26세,2017,249,130,119,109.2,202,112,90,124.4
38370, 산청군,030003, 27세,2017,224,125,99,126.3,189,108,81,133.3
38370, 산청군,030004, 28세,2017,264,135,129,104.7,232,120,112,107.1
38370, 산청군,030005, 29세,2017,274,163,111,146.8,223,136,87,156.3
38370, 산청군,035,30~34세,2017,1212,631,581,108.6,1083,571,512,111.5
38370, 산청군,035001, 30세,2017,243,124,119,104.2,207,106,101,105
38370, 산청군,035002, 31세,2017,223,116,107,108.4,196,105,91,115.4
38370, 산청군,035003, 32세,2017,243,130,113,115,215,117,98,119.4
38370, 산청군,035004, 33세,2017,254,138,116,119,228,125,103,121.4
38370, 산청군,035005, 34세,2017,249,123,126,97.6,237,118,119,99.2
38370, 산청군,040,35~39세,2017,1437,819,618,132.5,1353,764,589,129.7
38370, 산청군,040001, 35세,2017,285,163,122,133.6,265,151,114,132.5
38370, 산청군,040002, 36세,2017,308,185,123,150.4,286,169,117,144.4
38370, 산청군,040003, 37세,2017,298,165,133,124.1,281,154,127,121.3
38370, 산청군,040004, 38세,2017,277,151,126,119.8,265,144,121,119
38370, 산청군,040005, 39세,2017,269,155,114,136,256,146,110,132.7
38370, 산청군,045,40~44세,2017,1567,850,717,118.5,1525,831,694,119.7
38370, 산청군,045001, 40세,2017,265,147,118,124.6,258,144,114,126.3
38370, 산청군,045002, 41세,2017,255,135,120,112.5,246,131,115,113.9
38370, 산청군,045003, 42세,2017,288,156,132,118.2,281,150,131,114.5
38370, 산청군,045004, 43세,2017,360,197,163,120.9,353,196,157,124.8
38370, 산청군,045005, 44세,2017,399,215,184,116.8,387,210,177,118.6
38370, 산청군,050,45~49세,2017,2361,1299,1062,122.3,2318,1276,1042,122.5
38370, 산청군,050001, 45세,2017,368,218,150,145.3,361,215,146,147.3
38370, 산청군,050002, 46세,2017,442,260,182,142.9,437,257,180,142.8
38370, 산청군,050003, 47세,2017,481,245,236,103.8,468,239,229,104.4
38370, 산청군,050004, 48세,2017,537,300,237,126.6,529,296,233,127
38370, 산청군,050005, 49세,2017,533,276,257,107.4,523,269,254,105.9
38370, 산청군,055,50~54세,2017,2661,1462,1199,121.9,2619,1441,1178,122.3
38370, 산청군,055001, 50세,2017,522,276,246,112.2,518,275,243,113.2
38370, 산청군,055002, 51세,2017,562,328,234,140.2,548,322,226,142.5
38370, 산청군,055003, 52세,2017,554,295,259,113.9,544,291,253,115
38370, 산청군,055004, 53세,2017,482,267,215,124.2,477,263,214,122.9
38370, 산청군,055005, 54세,2017,541,296,245,120.8,532,290,242,119.8
38370, 산청군,060,55~59세,2017,3503,1801,1702,105.8,3477,1794,1683,106.6
38370, 산청군,060001, 55세,2017,690,364,326,111.7,686,362,324,111.7
38370, 산청군,060002, 56세,2017,773,402,371,108.4,768,401,367,109.3
38370, 산청군,060003, 57세,2017,745,369,376,98.1,738,365,373,97.9
38370, 산청군,060004, 58세,2017,615,306,309,99,613,306,307,99.7
38370, 산청군,060005, 59세,2017,680,360,320,112.5,672,360,312,115.4
38370, 산청군,065,60~64세,2017,3257,1622,1635,99.2,3233,1607,1626,98.8
38370, 산청군,065001, 60세,2017,658,334,324,103.1,653,330,323,102.2
38370, 산청군,065002, 61세,2017,681,353,328,107.6,675,349,326,107.1
38370, 산청군,065003, 62세,2017,723,353,370,95.4,716,350,366,95.6
38370, 산청군,065004, 63세,2017,630,305,325,93.8,625,302,323,93.5
38370, 산청군,065005, 64세,2017,565,277,288,96.2,564,276,288,95.8
38370, 산청군,070,65~69세,2017,2668,1350,1318,102.4,2654,1340,1314,102
38370, 산청군,070001, 65세,2017,596,295,301,98,592,293,299,98
38370, 산청군,070002, 66세,2017,483,241,242,99.6,480,239,241,99.2
38370, 산청군,070003, 67세,2017,512,249,263,94.7,510,247,263,93.9
38370, 산청군,070004, 68세,2017,527,278,249,111.6,522,274,248,110.5
38370, 산청군,070005, 69세,2017,550,287,263,109.1,550,287,263,109.1
38370, 산청군,075,70~74세,2017,2458,1040,1418,73.3,2454,1039,1415,73.4
38370, 산청군,075001, 70세,2017,554,264,290,91,553,264,289,91.3
38370, 산청군,075002, 71세,2017,429,187,242,77.3,427,186,241,77.2
38370, 산청군,075003, 72세,2017,440,185,255,72.5,439,185,254,72.8
38370, 산청군,075004, 73세,2017,523,218,305,71.5,523,218,305,71.5
38370, 산청군,075005, 74세,2017,512,186,326,57.1,512,186,326,57.1
38370, 산청군,080,75~79세,2017,2901,1059,1842,57.5,2899,1058,1841,57.5
38370, 산청군,080001, 75세,2017,652,255,397,64.2,651,255,396,64.4
38370, 산청군,080002, 76세,2017,583,227,356,63.8,583,227,356,63.8
38370, 산청군,080003, 77세,2017,571,195,376,51.9,571,195,376,51.9
38370, 산청군,080004, 78세,2017,544,197,347,56.8,543,196,347,56.5
38370, 산청군,080005, 79세,2017,551,185,366,50.5,551,185,366,50.5
38370, 산청군,085,80~84세,2017,2063,639,1424,44.9,2063,639,1424,44.9
38370, 산청군,085001, 80세,2017,475,149,326,45.7,475,149,326,45.7
38370, 산청군,085002, 81세,2017,466,150,316,47.5,466,150,316,47.5
38370, 산청군,085003, 82세,2017,432,138,294,46.9,432,138,294,46.9
38370, 산청군,085004, 83세,2017,367,105,262,40.1,367,105,262,40.1
38370, 산청군,085005, 84세,2017,323,97,226,42.9,323,97,226,42.9
38370, 산청군,090,85~89세,2017,965,258,707,36.5,964,258,706,36.5
38370, 산청군,090001, 85세,2017,282,85,197,43.1,282,85,197,43.1
38370, 산청군,090002, 86세,2017,213,56,157,35.7,213,56,157,35.7
38370, 산청군,090003, 87세,2017,185,42,143,29.4,184,42,142,29.6
38370, 산청군,090004, 88세,2017,158,48,110,43.6,158,48,110,43.6
38370, 산청군,090005, 89세,2017,127,27,100,27,127,27,100,27
38370, 산청군,095,90~94세,2017,298,52,246,21.1,298,52,246,21.1
38370, 산청군,095001, 90세,2017,103,19,84,22.6,103,19,84,22.6
38370, 산청군,095002, 91세,2017,57,10,47,21.3,57,10,47,21.3
38370, 산청군,095003, 92세,2017,62,6,56,10.7,62,6,56,10.7
38370, 산청군,095004, 93세,2017,33,9,24,37.5,33,9,24,37.5
38370, 산청군,095005, 94세,2017,43,8,35,22.9,43,8,35,22.9
38370, 산청군,100,95~99세,2017,61,16,45,35.6,61,16,45,35.6
38370, 산청군,100001, 95세,2017,28,8,20,40,28,8,20,40
38370, 산청군,100002, 96세,2017,17,X,14,21.4,17,X,14,21.4
38370, 산청군,100003, 97세,2017,9,X,6,50,9,X,6,50
38370, 산청군,100004, 98세,2017,5,X,X,25,5,X,X,25
38370, 산청군,100005, 99세,2017,X,X,X,100,X,X,X,100
38370, 산청군,101,100세이상,2017,5,X,X,66.7,5,X,X,66.7
38370, 산청군,102,15세미만,2017,2791,1492,1299,114.9,2782,1490,1292,115.3
38370, 산청군,103,15~64세,2017,19823,10551,9272,113.8,19098,10226,8872,115.3
38370, 산청군,104,65세이상,2017,11419,4416,7003,63.1,11398,4404,6994,63
38370, 산청군,086,85세이상,2017,1329,328,1001,32.8,1328,328,1000,32.8
38370, 산청군,126,평균연령,2017,52.7,49.7,55.5,,53.1,50,56.1,
38370, 산청군,127,중위연령,2017,56.6,53.6,59.5,,57,54.1,60.1,
38380, 함양군,000,합계,2017,37942,18185,19757,92,37436,17942,19494,92
38380, 함양군,005,0~4세,2017,968,485,483,100.4,967,485,482,100.6
38380, 함양군,005001, 0세,2017,165,77,88,87.5,165,77,88,87.5
38380, 함양군,005002, 1세,2017,175,91,84,108.3,174,91,83,109.6
38380, 함양군,005003, 2세,2017,202,95,107,88.8,202,95,107,88.8
38380, 함양군,005004, 3세,2017,204,103,101,102,204,103,101,102
38380, 함양군,005005, 4세,2017,222,119,103,115.5,222,119,103,115.5
38380, 함양군,010,5~9세,2017,1217,638,579,110.2,1214,637,577,110.4
38380, 함양군,010001, 5세,2017,227,127,100,127,227,127,100,127
38380, 함양군,010002, 6세,2017,208,105,103,101.9,207,104,103,101
38380, 함양군,010003, 7세,2017,262,144,118,122,261,144,117,123.1
38380, 함양군,010004, 8세,2017,239,117,122,95.9,239,117,122,95.9
38380, 함양군,010005, 9세,2017,281,145,136,106.6,280,145,135,107.4
38380, 함양군,015,10~14세,2017,1399,734,665,110.4,1397,733,664,110.4
38380, 함양군,015001, 10세,2017,285,152,133,114.3,285,152,133,114.3
38380, 함양군,015002, 11세,2017,285,149,136,109.6,284,148,136,108.8
38380, 함양군,015003, 12세,2017,257,133,124,107.3,257,133,124,107.3
38380, 함양군,015004, 13세,2017,278,155,123,126,278,155,123,126
38380, 함양군,015005, 14세,2017,294,145,149,97.3,293,145,148,98
38380, 함양군,020,15~19세,2017,1745,911,834,109.2,1742,910,832,109.4
38380, 함양군,020001, 15세,2017,300,150,150,100,300,150,150,100
38380, 함양군,020002, 16세,2017,407,212,195,108.7,407,212,195,108.7
38380, 함양군,020003, 17세,2017,493,236,257,91.8,493,236,257,91.8
38380, 함양군,020004, 18세,2017,331,173,158,109.5,330,173,157,110.2
38380, 함양군,020005, 19세,2017,214,140,74,189.2,212,139,73,190.4
38380, 함양군,025,20~24세,2017,1345,819,526,155.7,1303,802,501,160.1
38380, 함양군,025001, 20세,2017,276,201,75,268,272,200,72,277.8
38380, 함양군,025002, 21세,2017,304,205,99,207.1,300,203,97,209.3
38380, 함양군,025003, 22세,2017,275,164,111,147.7,265,159,106,150
38380, 함양군,025004, 23세,2017,253,134,119,112.6,241,129,112,115.2
38380, 함양군,025005, 24세,2017,237,115,122,94.3,225,111,114,97.4
38380, 함양군,030,25~29세,2017,1188,632,556,113.7,1101,587,514,114.2
38380, 함양군,030001, 25세,2017,230,115,115,100,217,110,107,102.8
38380, 함양군,030002, 26세,2017,250,129,121,106.6,229,118,111,106.3
38380, 함양군,030003, 27세,2017,252,138,114,121.1,233,130,103,126.2
38380, 함양군,030004, 28세,2017,197,102,95,107.4,185,95,90,105.6
38380, 함양군,030005, 29세,2017,259,148,111,133.3,237,134,103,130.1
38380, 함양군,035,30~34세,2017,1375,737,638,115.5,1282,685,597,114.7
38380, 함양군,035001, 30세,2017,253,131,122,107.4,239,126,113,111.5
38380, 함양군,035002, 31세,2017,249,142,107,132.7,230,133,97,137.1
38380, 함양군,035003, 32세,2017,300,168,132,127.3,276,153,123,124.4
38380, 함양군,035004, 33세,2017,275,143,132,108.3,253,129,124,104
38380, 함양군,035005, 34세,2017,298,153,145,105.5,284,144,140,102.9
38380, 함양군,040,35~39세,2017,1711,891,820,108.7,1653,859,794,108.2
38380, 함양군,040001, 35세,2017,328,158,170,92.9,313,149,164,90.9
38380, 함양군,040002, 36세,2017,346,202,144,140.3,335,192,143,134.3
38380, 함양군,040003, 37세,2017,350,179,171,104.7,340,174,166,104.8
38380, 함양군,040004, 38세,2017,351,179,172,104.1,340,174,166,104.8
38380, 함양군,040005, 39세,2017,336,173,163,106.1,325,170,155,109.7
38380, 함양군,045,40~44세,2017,2045,1123,922,121.8,1996,1104,892,123.8
38380, 함양군,045001, 40세,2017,354,185,169,109.5,340,179,161,111.2
38380, 함양군,045002, 41세,2017,333,172,161,106.8,322,168,154,109.1
38380, 함양군,045003, 42세,2017,419,237,182,130.2,410,234,176,133
38380, 함양군,045004, 43세,2017,445,255,190,134.2,437,253,184,137.5
38380, 함양군,045005, 44세,2017,494,274,220,124.5,487,270,217,124.4
38380, 함양군,050,45~49세,2017,2888,1579,1309,120.6,2844,1559,1285,121.3
38380, 함양군,050001, 45세,2017,470,270,200,135,466,269,197,136.5
38380, 함양군,050002, 46세,2017,574,321,253,126.9,571,320,251,127.5
38380, 함양군,050003, 47세,2017,595,324,271,119.6,581,318,263,120.9
38380, 함양군,050004, 48세,2017,627,324,303,106.9,613,319,294,108.5
38380, 함양군,050005, 49세,2017,622,340,282,120.6,613,333,280,118.9
38380, 함양군,055,50~54세,2017,3001,1620,1381,117.3,2959,1600,1359,117.7
38380, 함양군,055001, 50세,2017,578,303,275,110.2,566,299,267,112
38380, 함양군,055002, 51세,2017,554,307,247,124.3,549,303,246,123.2
38380, 함양군,055003, 52세,2017,653,366,287,127.5,651,366,285,128.4
38380, 함양군,055004, 53세,2017,605,324,281,115.3,595,321,274,117.2
38380, 함양군,055005, 54세,2017,611,320,291,110,598,311,287,108.4
38380, 함양군,060,55~59세,2017,3624,1820,1804,100.9,3595,1806,1789,101
38380, 함양군,060001, 55세,2017,696,353,343,102.9,690,352,338,104.1
38380, 함양군,060002, 56세,2017,780,401,379,105.8,775,400,375,106.7
38380, 함양군,060003, 57세,2017,806,405,401,101,798,399,399,100
38380, 함양군,060004, 58세,2017,703,365,338,108,697,361,336,107.4
38380, 함양군,060005, 59세,2017,639,296,343,86.3,635,294,341,86.2
38380, 함양군,065,60~64세,2017,3356,1634,1722,94.9,3324,1623,1701,95.4
38380, 함양군,065001, 60세,2017,721,358,363,98.6,714,356,358,99.4
38380, 함양군,065002, 61세,2017,761,357,404,88.4,755,356,399,89.2
38380, 함양군,065003, 62세,2017,765,376,389,96.7,758,372,386,96.4
38380, 함양군,065004, 63세,2017,595,292,303,96.4,585,289,296,97.6
38380, 함양군,065005, 64세,2017,514,251,263,95.4,512,250,262,95.4
38380, 함양군,070,65~69세,2017,2882,1372,1510,90.9,2870,1368,1502,91.1
38380, 함양군,070001, 65세,2017,665,326,339,96.2,659,323,336,96.1
38380, 함양군,070002, 66세,2017,510,234,276,84.8,507,234,273,85.7
38380, 함양군,070003, 67세,2017,538,255,283,90.1,537,255,282,90.4
38380, 함양군,070004, 68세,2017,593,291,302,96.4,591,290,301,96.3
38380, 함양군,070005, 69세,2017,576,266,310,85.8,576,266,310,85.8
38380, 함양군,075,70~74세,2017,2566,1001,1565,64,2561,997,1564,63.7
38380, 함양군,075001, 70세,2017,587,241,346,69.7,586,241,345,69.9
38380, 함양군,075002, 71세,2017,429,186,243,76.5,428,185,243,76.1
38380, 함양군,075003, 72세,2017,462,178,284,62.7,461,177,284,62.3
38380, 함양군,075004, 73세,2017,536,221,315,70.2,535,220,315,69.8
38380, 함양군,075005, 74세,2017,552,175,377,46.4,551,174,377,46.2
38380, 함양군,080,75~79세,2017,3102,1178,1924,61.2,3099,1176,1923,61.2
38380, 함양군,080001, 75세,2017,684,273,411,66.4,683,272,411,66.2
38380, 함양군,080002, 76세,2017,605,230,375,61.3,605,230,375,61.3
38380, 함양군,080003, 77세,2017,625,241,384,62.8,624,241,383,62.9
38380, 함양군,080004, 78세,2017,629,230,399,57.6,629,230,399,57.6
38380, 함양군,080005, 79세,2017,559,204,355,57.5,558,203,355,57.2
38380, 함양군,085,80~84세,2017,2109,673,1436,46.9,2109,673,1436,46.9
38380, 함양군,085001, 80세,2017,548,219,329,66.6,548,219,329,66.6
38380, 함양군,085002, 81세,2017,468,150,318,47.2,468,150,318,47.2
38380, 함양군,085003, 82세,2017,407,116,291,39.9,407,116,291,39.9
38380, 함양군,085004, 83세,2017,385,117,268,43.7,385,117,268,43.7
38380, 함양군,085005, 84세,2017,301,71,230,30.9,301,71,230,30.9
38380, 함양군,090,85~89세,2017,996,234,762,30.7,995,234,761,30.7
38380, 함양군,090001, 85세,2017,268,72,196,36.7,267,72,195,36.9
38380, 함양군,090002, 86세,2017,248,58,190,30.5,248,58,190,30.5
38380, 함양군,090003, 87세,2017,204,37,167,22.2,204,37,167,22.2
38380, 함양군,090004, 88세,2017,146,37,109,33.9,146,37,109,33.9
38380, 함양군,090005, 89세,2017,130,30,100,30,130,30,100,30
38380, 함양군,095,90~94세,2017,358,90,268,33.6,358,90,268,33.6
38380, 함양군,095001, 90세,2017,129,28,101,27.7,129,28,101,27.7
38380, 함양군,095002, 91세,2017,80,24,56,42.9,80,24,56,42.9
38380, 함양군,095003, 92세,2017,65,15,50,30,65,15,50,30
38380, 함양군,095004, 93세,2017,42,11,31,35.5,42,11,31,35.5
38380, 함양군,095005, 94세,2017,42,12,30,40,42,12,30,40
38380, 함양군,100,95~99세,2017,59,11,48,22.9,59,11,48,22.9
38380, 함양군,100001, 95세,2017,22,5,17,29.4,22,5,17,29.4
38380, 함양군,100002, 96세,2017,16,X,12,33.3,16,X,12,33.3
38380, 함양군,100003, 97세,2017,10,X,9,11.1,10,X,9,11.1
38380, 함양군,100004, 98세,2017,7,X,6,16.7,7,X,6,16.7
38380, 함양군,100005, 99세,2017,X,X,X,0,X,X,X,0
38380, 함양군,101,100세이상,2017,8,X,5,60,8,X,5,60
38380, 함양군,102,15세미만,2017,3584,1857,1727,107.5,3578,1855,1723,107.7
38380, 함양군,103,15~64세,2017,22278,11766,10512,111.9,21799,11535,10264,112.4
38380, 함양군,104,65세이상,2017,12080,4562,7518,60.7,12059,4552,7507,60.6
38380, 함양군,086,85세이상,2017,1421,338,1083,31.2,1420,338,1082,31.2
38380, 함양군,126,평균연령,2017,51.4,48.4,54.2,,51.6,48.5,54.4,
38380, 함양군,127,중위연령,2017,55.1,51.8,58.1,,55.4,52,58.4,
38390, 거창군,000,합계,2017,60083,29491,30592,96.4,59456,29177,30279,96.4
38390, 거창군,005,0~4세,2017,1862,964,898,107.3,1861,964,897,107.5
38390, 거창군,005001, 0세,2017,294,160,134,119.4,294,160,134,119.4
38390, 거창군,005002, 1세,2017,362,194,168,115.5,362,194,168,115.5
38390, 거창군,005003, 2세,2017,359,178,181,98.3,359,178,181,98.3
38390, 거창군,005004, 3세,2017,421,216,205,105.4,421,216,205,105.4
38390, 거창군,005005, 4세,2017,426,216,210,102.9,425,216,209,103.3
38390, 거창군,010,5~9세,2017,2458,1295,1163,111.3,2458,1295,1163,111.3
38390, 거창군,010001, 5세,2017,480,263,217,121.2,480,263,217,121.2
38390, 거창군,010002, 6세,2017,505,266,239,111.3,505,266,239,111.3
38390, 거창군,010003, 7세,2017,457,248,209,118.7,457,248,209,118.7
38390, 거창군,010004, 8세,2017,501,258,243,106.2,501,258,243,106.2
38390, 거창군,010005, 9세,2017,515,260,255,102,515,260,255,102
38390, 거창군,015,10~14세,2017,2543,1329,1214,109.5,2542,1329,1213,109.6
38390, 거창군,015001, 10세,2017,525,266,259,102.7,525,266,259,102.7
38390, 거창군,015002, 11세,2017,430,219,211,103.8,430,219,211,103.8
38390, 거창군,015003, 12세,2017,501,261,240,108.8,501,261,240,108.8
38390, 거창군,015004, 13세,2017,543,284,259,109.7,542,284,258,110.1
38390, 거창군,015005, 14세,2017,544,299,245,122,544,299,245,122
38390, 거창군,020,15~19세,2017,3614,2036,1578,129,3608,2035,1573,129.4
38390, 거창군,020001, 15세,2017,630,327,303,107.9,630,327,303,107.9
38390, 거창군,020002, 16세,2017,737,380,357,106.4,735,379,356,106.5
38390, 거창군,020003, 17세,2017,846,430,416,103.4,846,430,416,103.4
38390, 거창군,020004, 18세,2017,796,473,323,146.4,794,473,321,147.4
38390, 거창군,020005, 19세,2017,605,426,179,238,603,426,177,240.7
38390, 거창군,025,20~24세,2017,3227,2117,1110,190.7,3166,2090,1076,194.2
38390, 거창군,025001, 20세,2017,649,413,236,175,643,410,233,176
38390, 거창군,025002, 21세,2017,635,453,182,248.9,625,450,175,257.1
38390, 거창군,025003, 22세,2017,734,513,221,232.1,722,506,216,234.3
38390, 거창군,025004, 23세,2017,630,410,220,186.4,617,403,214,188.3
38390, 거창군,025005, 24세,2017,579,328,251,130.7,559,321,238,134.9
38390, 거창군,030,25~29세,2017,2218,1264,954,132.5,2095,1197,898,133.3
38390, 거창군,030001, 25세,2017,469,256,213,120.2,448,246,202,121.8
38390, 거창군,030002, 26세,2017,451,267,184,145.1,422,247,175,141.1
38390, 거창군,030003, 27세,2017,454,252,202,124.8,428,244,184,132.6
38390, 거창군,030004, 28세,2017,416,241,175,137.7,400,232,168,138.1
38390, 거창군,030005, 29세,2017,428,248,180,137.8,397,228,169,134.9
38390, 거창군,035,30~34세,2017,2488,1288,1200,107.3,2372,1226,1146,107
38390, 거창군,035001, 30세,2017,487,252,235,107.2,456,241,215,112.1
38390, 거창군,035002, 31세,2017,505,273,232,117.7,472,254,218,116.5
38390, 거창군,035003, 32세,2017,450,224,226,99.1,428,211,217,97.2
38390, 거창군,035004, 33세,2017,479,245,234,104.7,464,236,228,103.5
38390, 거창군,035005, 34세,2017,567,294,273,107.7,552,284,268,106
38390, 거창군,040,35~39세,2017,3120,1568,1552,101,3043,1520,1523,99.8
38390, 거창군,040001, 35세,2017,623,298,325,91.7,598,283,315,89.8
38390, 거창군,040002, 36세,2017,625,330,295,111.9,613,321,292,109.9
38390, 거창군,040003, 37세,2017,661,317,344,92.2,643,307,336,91.4
38390, 거창군,040004, 38세,2017,630,333,297,112.1,619,325,294,110.5
38390, 거창군,040005, 39세,2017,581,290,291,99.7,570,284,286,99.3
38390, 거창군,045,40~44세,2017,3639,1833,1806,101.5,3599,1812,1787,101.4
38390, 거창군,045001, 40세,2017,628,317,311,101.9,616,307,309,99.4
38390, 거창군,045002, 41세,2017,683,343,340,100.9,675,341,334,102.1
38390, 거창군,045003, 42세,2017,676,347,329,105.5,673,346,327,105.8
38390, 거창군,045004, 43세,2017,787,411,376,109.3,780,409,371,110.2
38390, 거창군,045005, 44세,2017,865,415,450,92.2,855,409,446,91.7
38390, 거창군,050,45~49세,2017,4669,2418,2251,107.4,4624,2402,2222,108.1
38390, 거창군,050001, 45세,2017,791,414,377,109.8,781,411,370,111.1
38390, 거창군,050002, 46세,2017,946,499,447,111.6,941,497,444,111.9
38390, 거창군,050003, 47세,2017,944,499,445,112.1,936,496,440,112.7
38390, 거창군,050004, 48세,2017,957,494,463,106.7,946,491,455,107.9
38390, 거창군,050005, 49세,2017,1031,512,519,98.7,1020,507,513,98.8
38390, 거창군,055,50~54세,2017,4644,2425,2219,109.3,4583,2401,2182,110
38390, 거창군,055001, 50세,2017,926,474,452,104.9,916,472,444,106.3
38390, 거창군,055002, 51세,2017,939,499,440,113.4,933,497,436,114
38390, 거창군,055003, 52세,2017,982,481,501,96,964,474,490,96.7
38390, 거창군,055004, 53세,2017,859,462,397,116.4,849,458,391,117.1
38390, 거창군,055005, 54세,2017,938,509,429,118.6,921,500,421,118.8
38390, 거창군,060,55~59세,2017,5540,2722,2818,96.6,5488,2699,2789,96.8
38390, 거창군,060001, 55세,2017,1101,567,534,106.2,1090,561,529,106
38390, 거창군,060002, 56세,2017,1205,583,622,93.7,1195,578,617,93.7
38390, 거창군,060003, 57세,2017,1154,572,582,98.3,1144,570,574,99.3
38390, 거창군,060004, 58세,2017,1105,528,577,91.5,1097,522,575,90.8
38390, 거창군,060005, 59세,2017,975,472,503,93.8,962,468,494,94.7
38390, 거창군,065,60~64세,2017,4707,2340,2367,98.9,4674,2321,2353,98.6
38390, 거창군,065001, 60세,2017,1034,518,516,100.4,1021,509,512,99.4
38390, 거창군,065002, 61세,2017,992,494,498,99.2,990,492,498,98.8
38390, 거창군,065003, 62세,2017,982,517,465,111.2,975,513,462,111
38390, 거창군,065004, 63세,2017,885,425,460,92.4,882,424,458,92.6
38390, 거창군,065005, 64세,2017,814,386,428,90.2,806,383,423,90.5
38390, 거창군,070,65~69세,2017,3881,1789,2092,85.5,3872,1784,2088,85.4
38390, 거창군,070001, 65세,2017,900,418,482,86.7,898,418,480,87.1
38390, 거창군,070002, 66세,2017,659,305,354,86.2,659,305,354,86.2
38390, 거창군,070003, 67세,2017,691,320,371,86.3,689,318,371,85.7
38390, 거창군,070004, 68세,2017,806,378,428,88.3,802,376,426,88.3
38390, 거창군,070005, 69세,2017,825,368,457,80.5,824,367,457,80.3
38390, 거창군,075,70~74세,2017,3198,1333,1865,71.5,3198,1333,1865,71.5
38390, 거창군,075001, 70세,2017,698,327,371,88.1,698,327,371,88.1
38390, 거창군,075002, 71세,2017,573,251,322,78,573,251,322,78
38390, 거창군,075003, 72세,2017,558,228,330,69.1,558,228,330,69.1
38390, 거창군,075004, 73세,2017,681,255,426,59.9,681,255,426,59.9
38390, 거창군,075005, 74세,2017,688,272,416,65.4,688,272,416,65.4
38390, 거창군,080,75~79세,2017,3813,1441,2372,60.8,3812,1441,2371,60.8
38390, 거창군,080001, 75세,2017,833,308,525,58.7,833,308,525,58.7
38390, 거창군,080002, 76세,2017,758,298,460,64.8,758,298,460,64.8
38390, 거창군,080003, 77세,2017,746,280,466,60.1,746,280,466,60.1
38390, 거창군,080004, 78세,2017,799,300,499,60.1,798,300,498,60.2
38390, 거창군,080005, 79세,2017,677,255,422,60.4,677,255,422,60.4
38390, 거창군,085,80~84세,2017,2709,889,1820,48.8,2709,889,1820,48.8
38390, 거창군,085001, 80세,2017,630,202,428,47.2,630,202,428,47.2
38390, 거창군,085002, 81세,2017,629,220,409,53.8,629,220,409,53.8
38390, 거창군,085003, 82세,2017,523,156,367,42.5,523,156,367,42.5
38390, 거창군,085004, 83세,2017,467,157,310,50.6,467,157,310,50.6
38390, 거창군,085005, 84세,2017,460,154,306,50.3,460,154,306,50.3
38390, 거창군,090,85~89세,2017,1251,329,922,35.7,1251,329,922,35.7
38390, 거창군,090001, 85세,2017,312,78,234,33.3,312,78,234,33.3
38390, 거창군,090002, 86세,2017,299,89,210,42.4,299,89,210,42.4
38390, 거창군,090003, 87세,2017,267,66,201,32.8,267,66,201,32.8
38390, 거창군,090004, 88세,2017,220,54,166,32.5,220,54,166,32.5
38390, 거창군,090005, 89세,2017,153,42,111,37.8,153,42,111,37.8
38390, 거창군,095,90~94세,2017,402,95,307,30.9,402,95,307,30.9
38390, 거창군,095001, 90세,2017,143,37,106,34.9,143,37,106,34.9
38390, 거창군,095002, 91세,2017,92,19,73,26,92,19,73,26
38390, 거창군,095003, 92세,2017,73,14,59,23.7,73,14,59,23.7
38390, 거창군,095004, 93세,2017,53,15,38,39.5,53,15,38,39.5
38390, 거창군,095005, 94세,2017,41,10,31,32.3,41,10,31,32.3
38390, 거창군,100,95~99세,2017,86,12,74,16.2,86,12,74,16.2
38390, 거창군,100001, 95세,2017,29,X,28,3.6,29,X,28,3.6
38390, 거창군,100002, 96세,2017,21,X,17,23.5,21,X,17,23.5
38390, 거창군,100003, 97세,2017,24,X,20,20,24,X,20,20
38390, 거창군,100004, 98세,2017,6,X,5,20,6,X,5,20
38390, 거창군,100005, 99세,2017,6,X,X,50,6,X,X,50
38390, 거창군,101,100세이상,2017,14,X,10,40,13,X,10,30
38390, 거창군,102,15세미만,2017,6863,3588,3275,109.6,6861,3588,3273,109.6
38390, 거창군,103,15~64세,2017,37866,20011,17855,112.1,37252,19703,17549,112.3
38390, 거창군,104,65세이상,2017,15354,5892,9462,62.3,15343,5886,9457,62.2
38390, 거창군,086,85세이상,2017,1753,440,1313,33.5,1752,439,1313,33.4
38390, 거창군,126,평균연령,2017,47.4,44.5,50.3,,47.5,44.5,50.4,
38390, 거창군,127,중위연령,2017,50.2,47.3,53.4,,50.4,47.4,53.7,
38400, 합천군,000,합계,2017,43449,20657,22792,90.6,42773,20325,22448,90.5
38400, 합천군,005,0~4세,2017,873,465,408,114,872,465,407,114.3
38400, 합천군,005001, 0세,2017,132,71,61,116.4,132,71,61,116.4
38400, 합천군,005002, 1세,2017,161,98,63,155.6,161,98,63,155.6
38400, 합천군,005003, 2세,2017,167,87,80,108.8,167,87,80,108.8
38400, 합천군,005004, 3세,2017,188,87,101,86.1,188,87,101,86.1
38400, 합천군,005005, 4세,2017,225,122,103,118.4,224,122,102,119.6
38400, 합천군,010,5~9세,2017,1063,550,513,107.2,1062,550,512,107.4
38400, 합천군,010001, 5세,2017,216,109,107,101.9,216,109,107,101.9
38400, 합천군,010002, 6세,2017,220,122,98,124.5,219,122,97,125.8
38400, 합천군,010003, 7세,2017,176,91,85,107.1,176,91,85,107.1
38400, 합천군,010004, 8세,2017,216,106,110,96.4,216,106,110,96.4
38400, 합천군,010005, 9세,2017,235,122,113,108,235,122,113,108
38400, 합천군,015,10~14세,2017,1194,627,567,110.6,1193,626,567,110.4
38400, 합천군,015001, 10세,2017,255,133,122,109,255,133,122,109
38400, 합천군,015002, 11세,2017,209,110,99,111.1,209,110,99,111.1
38400, 합천군,015003, 12세,2017,222,117,105,111.4,222,117,105,111.4
38400, 합천군,015004, 13세,2017,241,117,124,94.4,241,117,124,94.4
38400, 합천군,015005, 14세,2017,267,150,117,128.2,266,149,117,127.4
38400, 합천군,020,15~19세,2017,1539,854,685,124.7,1534,854,680,125.6
38400, 합천군,020001, 15세,2017,280,163,117,139.3,280,163,117,139.3
38400, 합천군,020002, 16세,2017,321,167,154,108.4,321,167,154,108.4
38400, 합천군,020003, 17세,2017,353,186,167,111.4,353,186,167,111.4
38400, 합천군,020004, 18세,2017,355,199,156,127.6,353,199,154,129.2
38400, 합천군,020005, 19세,2017,230,139,91,152.7,227,139,88,158
38400, 합천군,025,20~24세,2017,1503,921,582,158.2,1424,878,546,160.8
38400, 합천군,025001, 20세,2017,322,225,97,232,313,220,93,236.6
38400, 합천군,025002, 21세,2017,318,208,110,189.1,306,203,103,197.1
38400, 합천군,025003, 22세,2017,297,170,127,133.9,284,161,123,130.9
38400, 합천군,025004, 23세,2017,271,148,123,120.3,254,140,114,122.8
38400, 합천군,025005, 24세,2017,295,170,125,136,267,154,113,136.3
38400, 합천군,030,25~29세,2017,1402,797,605,131.7,1253,719,534,134.6
38400, 합천군,030001, 25세,2017,281,154,127,121.3,252,139,113,123
38400, 합천군,030002, 26세,2017,297,153,144,106.3,267,144,123,117.1
38400, 합천군,030003, 27세,2017,267,147,120,122.5,239,134,105,127.6
38400, 합천군,030004, 28세,2017,271,169,102,165.7,243,149,94,158.5
38400, 합천군,030005, 29세,2017,286,174,112,155.4,252,153,99,154.5
38400, 합천군,035,30~34세,2017,1431,773,658,117.5,1308,701,607,115.5
38400, 합천군,035001, 30세,2017,274,145,129,112.4,249,129,120,107.5
38400, 합천군,035002, 31세,2017,293,164,129,127.1,255,144,111,129.7
38400, 합천군,035003, 32세,2017,284,164,120,136.7,268,154,114,135.1
38400, 합천군,035004, 33세,2017,279,147,132,111.4,255,131,124,105.6
38400, 합천군,035005, 34세,2017,301,153,148,103.4,281,143,138,103.6
38400, 합천군,040,35~39세,2017,1719,918,801,114.6,1652,884,768,115.1
38400, 합천군,040001, 35세,2017,317,156,161,96.9,309,154,155,99.4
38400, 합천군,040002, 36세,2017,343,182,161,113,331,176,155,113.5
38400, 합천군,040003, 37세,2017,361,197,164,120.1,349,190,159,119.5
38400, 합천군,040004, 38세,2017,353,197,156,126.3,334,187,147,127.2
38400, 합천군,040005, 39세,2017,345,186,159,117,329,177,152,116.4
38400, 합천군,045,40~44세,2017,1988,1106,882,125.4,1928,1079,849,127.1
38400, 합천군,045001, 40세,2017,344,189,155,121.9,327,182,145,125.5
38400, 합천군,045002, 41세,2017,360,195,165,118.2,346,186,160,116.3
38400, 합천군,045003, 42세,2017,359,194,165,117.6,353,191,162,117.9
38400, 합천군,045004, 43세,2017,418,246,172,143,410,244,166,147
38400, 합천군,045005, 44세,2017,507,282,225,125.3,492,276,216,127.8
38400, 합천군,050,45~49세,2017,2874,1620,1254,129.2,2824,1605,1219,131.7
38400, 합천군,050001, 45세,2017,488,286,202,141.6,482,283,199,142.2
38400, 합천군,050002, 46세,2017,562,308,254,121.3,552,306,246,124.4
38400, 합천군,050003, 47세,2017,567,313,254,123.2,556,311,245,126.9
38400, 합천군,050004, 48세,2017,591,332,259,128.2,576,326,250,130.4
38400, 합천군,050005, 49세,2017,666,381,285,133.7,658,379,279,135.8
38400, 합천군,055,50~54세,2017,3204,1737,1467,118.4,3162,1719,1443,119.1
38400, 합천군,055001, 50세,2017,611,314,297,105.7,604,312,292,106.8
38400, 합천군,055002, 51세,2017,658,364,294,123.8,647,360,287,125.4
38400, 합천군,055003, 52세,2017,625,344,281,122.4,621,342,279,122.6
38400, 합천군,055004, 53세,2017,645,356,289,123.2,634,351,283,124
38400, 합천군,055005, 54세,2017,665,359,306,117.3,656,354,302,117.2
38400, 합천군,060,55~59세,2017,4511,2294,2217,103.5,4464,2272,2192,103.6
38400, 합천군,060001, 55세,2017,818,440,378,116.4,808,433,375,115.5
38400, 합천군,060002, 56세,2017,1026,515,511,100.8,1015,511,504,101.4
38400, 합천군,060003, 57세,2017,934,445,489,91,917,439,478,91.8
38400, 합천군,060004, 58세,2017,901,449,452,99.3,896,446,450,99.1
38400, 합천군,060005, 59세,2017,832,445,387,115,828,443,385,115.1
38400, 합천군,065,60~64세,2017,3970,1949,2021,96.4,3938,1934,2004,96.5
38400, 합천군,065001, 60세,2017,836,421,415,101.4,828,416,412,101
38400, 합천군,065002, 61세,2017,860,442,418,105.7,856,440,416,105.8
38400, 합천군,065003, 62세,2017,825,385,440,87.5,820,384,436,88.1
38400, 합천군,065004, 63세,2017,753,372,381,97.6,748,368,380,96.8
38400, 합천군,065005, 64세,2017,696,329,367,89.6,686,326,360,90.6
38400, 합천군,070,65~69세,2017,3742,1770,1972,89.8,3729,1765,1964,89.9
38400, 합천군,070001, 65세,2017,785,376,409,91.9,783,376,407,92.4
38400, 합천군,070002, 66세,2017,705,327,378,86.5,700,325,375,86.7
38400, 합천군,070003, 67세,2017,718,350,368,95.1,716,349,367,95.1
38400, 합천군,070004, 68세,2017,780,379,401,94.5,777,377,400,94.3
38400, 합천군,070005, 69세,2017,754,338,416,81.3,753,338,415,81.4
38400, 합천군,075,70~74세,2017,3307,1337,1970,67.9,3303,1336,1967,67.9
38400, 합천군,075001, 70세,2017,732,313,419,74.7,730,313,417,75.1
38400, 합천군,075002, 71세,2017,560,243,317,76.7,559,242,317,76.3
38400, 합천군,075003, 72세,2017,600,249,351,70.9,599,249,350,71.1
38400, 합천군,075004, 73세,2017,692,255,437,58.4,692,255,437,58.4
38400, 합천군,075005, 74세,2017,723,277,446,62.1,723,277,446,62.1
38400, 합천군,080,75~79세,2017,4272,1527,2745,55.6,4271,1527,2744,55.6
38400, 합천군,080001, 75세,2017,952,357,595,60,952,357,595,60
38400, 합천군,080002, 76세,2017,851,315,536,58.8,850,315,535,58.9
38400, 합천군,080003, 77세,2017,852,306,546,56,852,306,546,56
38400, 합천군,080004, 78세,2017,898,301,597,50.4,898,301,597,50.4
38400, 합천군,080005, 79세,2017,719,248,471,52.7,719,248,471,52.7
38400, 합천군,085,80~84세,2017,3103,975,2128,45.8,3103,975,2128,45.8
38400, 합천군,085001, 80세,2017,761,253,508,49.8,761,253,508,49.8
38400, 합천군,085002, 81세,2017,645,230,415,55.4,645,230,415,55.4
38400, 합천군,085003, 82세,2017,633,199,434,45.9,633,199,434,45.9
38400, 합천군,085004, 83세,2017,580,150,430,34.9,580,150,430,34.9
38400, 합천군,085005, 84세,2017,484,143,341,41.9,484,143,341,41.9
38400, 합천군,090,85~89세,2017,1302,345,957,36.1,1301,344,957,35.9
38400, 합천군,090001, 85세,2017,376,103,273,37.7,376,103,273,37.7
38400, 합천군,090002, 86세,2017,284,69,215,32.1,284,69,215,32.1
38400, 합천군,090003, 87세,2017,251,56,195,28.7,251,56,195,28.7
38400, 합천군,090004, 88세,2017,225,69,156,44.2,225,69,156,44.2
38400, 합천군,090005, 89세,2017,166,48,118,40.7,165,47,118,39.8
38400, 합천군,095,90~94세,2017,363,78,285,27.4,363,78,285,27.4
38400, 합천군,095001, 90세,2017,126,33,93,35.5,126,33,93,35.5
38400, 합천군,095002, 91세,2017,66,12,54,22.2,66,12,54,22.2
38400, 합천군,095003, 92세,2017,71,15,56,26.8,71,15,56,26.8
38400, 합천군,095004, 93세,2017,47,10,37,27,47,10,37,27
38400, 합천군,095005, 94세,2017,53,8,45,17.8,53,8,45,17.8
38400, 합천군,100,95~99세,2017,84,13,71,18.3,84,13,71,18.3
38400, 합천군,100001, 95세,2017,33,7,26,26.9,33,7,26,26.9
38400, 합천군,100002, 96세,2017,23,X,22,4.5,23,X,22,4.5
38400, 합천군,100003, 97세,2017,18,X,17,5.9,18,X,17,5.9
38400, 합천군,100004, 98세,2017,5,X,X,150,5,X,X,150
38400, 합천군,100005, 99세,2017,5,X,X,25,5,X,X,25
38400, 합천군,101,100세이상,2017,5,X,X,25,5,X,X,25
38400, 합천군,102,15세미만,2017,3130,1642,1488,110.3,3127,1641,1486,110.4
38400, 합천군,103,15~64세,2017,24141,12969,11172,116.1,23487,12645,10842,116.6
38400, 합천군,104,65세이상,2017,16178,6046,10132,59.7,16159,6039,10120,59.7
38400, 합천군,086,85세이상,2017,1754,437,1317,33.2,1753,436,1317,33.1
38400, 합천군,126,평균연령,2017,54.5,51,57.7,,54.7,51.2,57.9,
38400, 합천군,127,중위연령,2017,58.2,54.9,61.8,,58.5,55.2,62.2,
39,제주특별자치도,000,합계,2017,641757,324015,317742,102,621357,312363,308994,101.1
39,제주특별자치도,005,0~4세,2017,29813,15363,14450,106.3,29491,15192,14299,106.2
39,제주특별자치도,005001, 0세,2017,5179,2707,2472,109.5,5108,2680,2428,110.4
39,제주특별자치도,005002, 1세,2017,5843,3037,2806,108.2,5768,2996,2772,108.1
39,제주특별자치도,005003, 2세,2017,6083,3158,2925,108,6023,3125,2898,107.8
39,제주특별자치도,005004, 3세,2017,6313,3208,3105,103.3,6246,3168,3078,102.9
39,제주특별자치도,005005, 4세,2017,6395,3253,3142,103.5,6346,3223,3123,103.2
39,제주특별자치도,010,5~9세,2017,33995,17539,16456,106.6,33780,17437,16343,106.7
39,제주특별자치도,010001, 5세,2017,7063,3592,3471,103.5,7011,3569,3442,103.7
39,제주특별자치도,010002, 6세,2017,6896,3562,3334,106.8,6864,3549,3315,107.1
39,제주특별자치도,010003, 7세,2017,6710,3520,3190,110.3,6666,3493,3173,110.1
39,제주특별자치도,010004, 8세,2017,6527,3385,3142,107.7,6486,3366,3120,107.9
39,제주특별자치도,010005, 9세,2017,6799,3480,3319,104.9,6753,3460,3293,105.1
39,제주특별자치도,015,10~14세,2017,33940,17806,16134,110.4,33783,17728,16055,110.4
39,제주특별자치도,015001, 10세,2017,7184,3673,3511,104.6,7152,3653,3499,104.4
39,제주특별자치도,015002, 11세,2017,6539,3417,3122,109.4,6499,3400,3099,109.7
39,제주특별자치도,015003, 12세,2017,6381,3419,2962,115.4,6353,3405,2948,115.5
39,제주특별자치도,015004, 13세,2017,6826,3623,3203,113.1,6796,3606,3190,113
39,제주특별자치도,015005, 14세,2017,7010,3674,3336,110.1,6983,3664,3319,110.4
39,제주특별자치도,020,15~19세,2017,37604,19729,17875,110.4,37088,19479,17609,110.6
39,제주특별자치도,020001, 15세,2017,6910,3689,3221,114.5,6885,3678,3207,114.7
39,제주특별자치도,020002, 16세,2017,7759,4090,3669,111.5,7715,4068,3647,111.5
39,제주특별자치도,020003, 17세,2017,8462,4399,4063,108.3,8412,4374,4038,108.3
39,제주특별자치도,020004, 18세,2017,7582,3967,3615,109.7,7479,3913,3566,109.7
39,제주특별자치도,020005, 19세,2017,6891,3584,3307,108.4,6597,3446,3151,109.4
39,제주특별자치도,025,20~24세,2017,40351,22127,18224,121.4,37261,20197,17064,118.4
39,제주특별자치도,025001, 20세,2017,7785,4413,3372,130.9,7339,4177,3162,132.1
39,제주특별자치도,025002, 21세,2017,8055,4632,3423,135.3,7543,4324,3219,134.3
39,제주특별자치도,025003, 22세,2017,8013,4332,3681,117.7,7404,3956,3448,114.7
39,제주특별자치도,025004, 23세,2017,8178,4373,3805,114.9,7461,3914,3547,110.3
39,제주특별자치도,025005, 24세,2017,8320,4377,3943,111,7514,3826,3688,103.7
39,제주특별자치도,030,25~29세,2017,37087,19702,17385,113.3,33070,17252,15818,109.1
39,제주특별자치도,030001, 25세,2017,8175,4409,3766,117.1,7377,3898,3479,112
39,제주특별자치도,030002, 26세,2017,7675,4025,3650,110.3,6908,3537,3371,104.9
39,제주특별자치도,030003, 27세,2017,7417,3933,3484,112.9,6561,3422,3139,109
39,제주특별자치도,030004, 28세,2017,7023,3689,3334,110.6,6233,3233,3000,107.8
39,제주특별자치도,030005, 29세,2017,6797,3646,3151,115.7,5991,3162,2829,111.8
39,제주특별자치도,035,30~34세,2017,39400,20401,18999,107.4,35888,18358,17530,104.7
39,제주특별자치도,035001, 30세,2017,7224,3794,3430,110.6,6384,3333,3051,109.2
39,제주특별자치도,035002, 31세,2017,7301,3827,3474,110.2,6531,3384,3147,107.5
39,제주특별자치도,035003, 32세,2017,7632,3968,3664,108.3,6968,3561,3407,104.5
39,제주특별자치도,035004, 33세,2017,8213,4209,4004,105.1,7567,3821,3746,102
39,제주특별자치도,035005, 34세,2017,9030,4603,4427,104,8438,4259,4179,101.9
39,제주특별자치도,040,35~39세,2017,50475,25838,24637,104.9,47747,24216,23531,102.9
39,제주특별자치도,040001, 35세,2017,10215,5250,4965,105.7,9565,4858,4707,103.2
39,제주특별자치도,040002, 36세,2017,10358,5340,5018,106.4,9795,4979,4816,103.4
39,제주특별자치도,040003, 37세,2017,10404,5362,5042,106.3,9867,5042,4825,104.5
39,제주특별자치도,040004, 38세,2017,10389,5259,5130,102.5,9865,4969,4896,101.5
39,제주특별자치도,040005, 39세,2017,9109,4627,4482,103.2,8655,4368,4287,101.9
39,제주특별자치도,045,40~44세,2017,52454,27370,25084,109.1,50724,26411,24313,108.6
39,제주특별자치도,045001, 40세,2017,9749,5046,4703,107.3,9350,4819,4531,106.4
39,제주특별자치도,045002, 41세,2017,9792,5228,4564,114.5,9428,5031,4397,114.4
39,제주특별자치도,045003, 42세,2017,10144,5286,4858,108.8,9796,5095,4701,108.4
39,제주특별자치도,045004, 43세,2017,11390,5992,5398,111,11066,5815,5251,110.7
39,제주특별자치도,045005, 44세,2017,11379,5818,5561,104.6,11084,5651,5433,104
39,제주특별자치도,050,45~49세,2017,58762,30640,28122,109,57416,29902,27514,108.7
39,제주특별자치도,050001, 45세,2017,11826,6118,5708,107.2,11537,5955,5582,106.7
39,제주특별자치도,050002, 46세,2017,12460,6521,5939,109.8,12171,6358,5813,109.4
39,제주특별자치도,050003, 47세,2017,11663,6062,5601,108.2,11396,5917,5479,108
39,제주특별자치도,050004, 48세,2017,11436,6025,5411,111.3,11179,5893,5286,111.5
39,제주특별자치도,050005, 49세,2017,11377,5914,5463,108.3,11133,5779,5354,107.9
39,제주특별자치도,055,50~54세,2017,51683,26967,24716,109.1,50731,26507,24224,109.4
39,제주특별자치도,055001, 50세,2017,10362,5400,4962,108.8,10162,5295,4867,108.8
39,제주특별자치도,055002, 51세,2017,10690,5665,5025,112.7,10506,5577,4929,113.1
39,제주특별자치도,055003, 52세,2017,9980,5199,4781,108.7,9785,5100,4685,108.9
39,제주특별자치도,055004, 53세,2017,9966,5212,4754,109.6,9785,5134,4651,110.4
39,제주특별자치도,055005, 54세,2017,10685,5491,5194,105.7,10493,5401,5092,106.1
39,제주특별자치도,060,55~59세,2017,48614,24800,23814,104.1,47911,24471,23440,104.4
39,제주특별자치도,060001, 55세,2017,10160,5254,4906,107.1,10001,5173,4828,107.1
39,제주특별자치도,060002, 56세,2017,10027,5055,4972,101.7,9902,4997,4905,101.9
39,제주특별자치도,060003, 57세,2017,10254,5235,5019,104.3,10107,5161,4946,104.3
39,제주특별자치도,060004, 58세,2017,9331,4706,4625,101.8,9193,4645,4548,102.1
39,제주특별자치도,060005, 59세,2017,8842,4550,4292,106,8708,4495,4213,106.7
39,제주특별자치도,065,60~64세,2017,37152,18463,18689,98.8,36545,18177,18368,99
39,제주특별자치도,065001, 60세,2017,8544,4313,4231,101.9,8408,4249,4159,102.2
39,제주특별자치도,065002, 61세,2017,8153,4115,4038,101.9,8009,4052,3957,102.4
39,제주특별자치도,065003, 62세,2017,8217,4038,4179,96.6,8095,3978,4117,96.6
39,제주특별자치도,065004, 63세,2017,6678,3328,3350,99.3,6550,3269,3281,99.6
39,제주특별자치도,065005, 64세,2017,5560,2669,2891,92.3,5483,2629,2854,92.1
39,제주특별자치도,070,65~69세,2017,26604,12867,13737,93.7,26334,12754,13580,93.9
39,제주특별자치도,070001, 65세,2017,5876,2878,2998,96,5812,2858,2954,96.8
39,제주특별자치도,070002, 66세,2017,5104,2517,2587,97.3,5029,2483,2546,97.5
39,제주특별자치도,070003, 67세,2017,5091,2395,2696,88.8,5043,2372,2671,88.8
39,제주특별자치도,070004, 68세,2017,5134,2443,2691,90.8,5084,2421,2663,90.9
39,제주특별자치도,070005, 69세,2017,5399,2634,2765,95.3,5366,2620,2746,95.4
39,제주특별자치도,075,70~74세,2017,22178,10284,11894,86.5,22064,10216,11848,86.2
39,제주특별자치도,075001, 70세,2017,5196,2465,2731,90.3,5160,2447,2713,90.2
39,제주특별자치도,075002, 71세,2017,4524,2123,2401,88.4,4497,2105,2392,88
39,제주특별자치도,075003, 72세,2017,4205,1991,2214,89.9,4189,1982,2207,89.8
39,제주특별자치도,075004, 73세,2017,4212,1927,2285,84.3,4195,1916,2279,84.1
39,제주특별자치도,075005, 74세,2017,4041,1778,2263,78.6,4023,1766,2257,78.2
39,제주특별자치도,080,75~79세,2017,19070,7883,11187,70.5,19022,7866,11156,70.5
39,제주특별자치도,080001, 75세,2017,4353,1923,2430,79.1,4342,1920,2422,79.3
39,제주특별자치도,080002, 76세,2017,4123,1752,2371,73.9,4109,1745,2364,73.8
39,제주특별자치도,080003, 77세,2017,3633,1468,2165,67.8,3628,1466,2162,67.8
39,제주특별자치도,080004, 78세,2017,3611,1440,2171,66.3,3599,1435,2164,66.3
39,제주특별자치도,080005, 79세,2017,3350,1300,2050,63.4,3344,1300,2044,63.6
39,제주특별자치도,085,80~84세,2017,13232,4486,8746,51.3,13189,4463,8726,51.1
39,제주특별자치도,085001, 80세,2017,3066,1128,1938,58.2,3051,1119,1932,57.9
39,제주특별자치도,085002, 81세,2017,2697,964,1733,55.6,2692,962,1730,55.6
39,제주특별자치도,085003, 82세,2017,2649,918,1731,53,2638,913,1725,52.9
39,제주특별자치도,085004, 83세,2017,2535,827,1708,48.4,2529,823,1706,48.2
39,제주특별자치도,085005, 84세,2017,2285,649,1636,39.7,2279,646,1633,39.6
39,제주특별자치도,090,85~89세,2017,6265,1368,4897,27.9,6247,1359,4888,27.8
39,제주특별자치도,090001, 85세,2017,1768,455,1313,34.7,1762,454,1308,34.7
39,제주특별자치도,090002, 86세,2017,1355,332,1023,32.5,1351,331,1020,32.5
39,제주특별자치도,090003, 87세,2017,1340,268,1072,25,1334,263,1071,24.6
39,제주특별자치도,090004, 88세,2017,1028,197,831,23.7,1027,196,831,23.6
39,제주특별자치도,090005, 89세,2017,774,116,658,17.6,773,115,658,17.5
39,제주특별자치도,095,90~94세,2017,2182,294,1888,15.6,2174,293,1881,15.6
39,제주특별자치도,095001, 90세,2017,623,87,536,16.2,620,87,533,16.3
39,제주특별자치도,095002, 91세,2017,422,72,350,20.6,420,71,349,20.3
39,제주특별자치도,095003, 92세,2017,333,46,287,16,331,46,285,16.1
39,제주특별자치도,095004, 93세,2017,237,45,192,23.4,236,45,191,23.6
39,제주특별자치도,095005, 94세,2017,567,44,523,8.4,567,44,523,8.4
39,제주특별자치도,100,95~99세,2017,791,84,707,11.9,787,81,706,11.5
39,제주특별자치도,100001, 95세,2017,316,41,275,14.9,315,40,275,14.5
39,제주특별자치도,100002, 96세,2017,213,15,198,7.6,213,15,198,7.6
39,제주특별자치도,100003, 97세,2017,118,14,104,13.5,118,14,104,13.5
39,제주특별자치도,100004, 98세,2017,87,7,80,8.8,85,6,79,7.6
39,제주특별자치도,100005, 99세,2017,57,7,50,14,56,6,50,12
39,제주특별자치도,101,100세이상,2017,105,X,101,4,105,X,101,4
39,제주특별자치도,102,15세미만,2017,97748,50708,47040,107.8,97054,50357,46697,107.8
39,제주특별자치도,103,15~64세,2017,453582,236037,217545,108.5,434381,224970,209411,107.4
39,제주특별자치도,104,65세이상,2017,90427,37270,53157,70.1,89922,37036,52886,70
39,제주특별자치도,086,85세이상,2017,9343,1750,7593,23,9313,1737,7576,22.9
39,제주특별자치도,126,평균연령,2017,40.8,39.4,42.2,,41,39.6,42.3,
39,제주특별자치도,127,중위연령,2017,41.9,40.7,43.1,,42.4,41.3,43.5,
39004, 읍부,000,합계,2017,141557,72832,68725,106,134232,68053,66179,102.8
39004, 읍부,005,0~4세,2017,5198,2746,2452,112,5084,2684,2400,111.8
39004, 읍부,005001, 0세,2017,832,458,374,122.5,812,450,362,124.3
39004, 읍부,005002, 1세,2017,1043,541,502,107.8,1011,523,488,107.2
39004, 읍부,005003, 2세,2017,1071,588,483,121.7,1051,576,475,121.3
39004, 읍부,005004, 3세,2017,1071,558,513,108.8,1045,544,501,108.6
39004, 읍부,005005, 4세,2017,1181,601,580,103.6,1165,591,574,103
39004, 읍부,010,5~9세,2017,6576,3435,3141,109.4,6482,3397,3085,110.1
39004, 읍부,010001, 5세,2017,1305,685,620,110.5,1279,675,604,111.8
39004, 읍부,010002, 6세,2017,1320,702,618,113.6,1309,698,611,114.2
39004, 읍부,010003, 7세,2017,1258,660,598,110.4,1237,648,589,110
39004, 읍부,010004, 8세,2017,1325,702,623,112.7,1311,696,615,113.2
39004, 읍부,010005, 9세,2017,1368,686,682,100.6,1346,680,666,102.1
39004, 읍부,015,10~14세,2017,6266,3322,2944,112.8,6205,3291,2914,112.9
39004, 읍부,015001, 10세,2017,1351,662,689,96.1,1339,653,686,95.2
39004, 읍부,015002, 11세,2017,1267,691,576,120,1249,682,567,120.3
39004, 읍부,015003, 12세,2017,1178,628,550,114.2,1172,626,546,114.7
39004, 읍부,015004, 13세,2017,1256,684,572,119.6,1242,676,566,119.4
39004, 읍부,015005, 14세,2017,1214,657,557,118,1203,654,549,119.1
39004, 읍부,020,15~19세,2017,6931,3712,3219,115.3,6727,3617,3110,116.3
39004, 읍부,020001, 15세,2017,1250,679,571,118.9,1241,675,566,119.3
39004, 읍부,020002, 16세,2017,1387,740,647,114.4,1369,730,639,114.2
39004, 읍부,020003, 17세,2017,1553,802,751,106.8,1527,792,735,107.8
39004, 읍부,020004, 18세,2017,1370,745,625,119.2,1333,725,608,119.2
39004, 읍부,020005, 19세,2017,1371,746,625,119.4,1257,695,562,123.7
39004, 읍부,025,20~24세,2017,7891,4670,3221,145,6731,3812,2919,130.6
39004, 읍부,025001, 20세,2017,1552,946,606,156.1,1397,856,541,158.2
39004, 읍부,025002, 21세,2017,1547,941,606,155.3,1384,825,559,147.6
39004, 읍부,025003, 22세,2017,1502,862,640,134.7,1285,694,591,117.4
39004, 읍부,025004, 23세,2017,1577,942,635,148.3,1289,720,569,126.5
39004, 읍부,025005, 24세,2017,1713,979,734,133.4,1376,717,659,108.8
39004, 읍부,030,25~29세,2017,7403,4319,3084,140,5930,3235,2695,120
39004, 읍부,030001, 25세,2017,1606,949,657,144.4,1298,716,582,123
39004, 읍부,030002, 26세,2017,1550,885,665,133.1,1253,656,597,109.9
39004, 읍부,030003, 27세,2017,1484,845,639,132.2,1187,631,556,113.5
39004, 읍부,030004, 28세,2017,1423,847,576,147,1126,635,491,129.3
39004, 읍부,030005, 29세,2017,1340,793,547,145,1066,597,469,127.3
39004, 읍부,035,30~34세,2017,7574,4205,3369,124.8,6277,3312,2965,111.7
39004, 읍부,035001, 30세,2017,1428,821,607,135.3,1151,636,515,123.5
39004, 읍부,035002, 31세,2017,1407,770,637,120.9,1118,580,538,107.8
39004, 읍부,035003, 32세,2017,1478,814,664,122.6,1210,629,581,108.3
39004, 읍부,035004, 33세,2017,1569,869,700,124.1,1339,698,641,108.9
39004, 읍부,035005, 34세,2017,1692,931,761,122.3,1459,769,690,111.4
39004, 읍부,040,35~39세,2017,10174,5407,4767,113.4,9166,4717,4449,106
39004, 읍부,040001, 35세,2017,1949,1068,881,121.2,1711,894,817,109.4
39004, 읍부,040002, 36세,2017,2083,1102,981,112.3,1852,941,911,103.3
39004, 읍부,040003, 37세,2017,2115,1124,991,113.4,1924,991,933,106.2
39004, 읍부,040004, 38세,2017,2130,1117,1013,110.3,1938,994,944,105.3
39004, 읍부,040005, 39세,2017,1897,996,901,110.5,1741,897,844,106.3
39004, 읍부,045,40~44세,2017,10988,6034,4954,121.8,10353,5647,4706,120
39004, 읍부,045001, 40세,2017,2033,1122,911,123.2,1898,1031,867,118.9
39004, 읍부,045002, 41세,2017,2074,1147,927,123.7,1906,1043,863,120.9
39004, 읍부,045003, 42세,2017,2167,1188,979,121.3,2051,1116,935,119.4
39004, 읍부,045004, 43세,2017,2426,1354,1072,126.3,2308,1285,1023,125.6
39004, 읍부,045005, 44세,2017,2288,1223,1065,114.8,2190,1172,1018,115.1
39004, 읍부,050,45~49세,2017,12230,6780,5450,124.4,11783,6537,5246,124.6
39004, 읍부,050001, 45세,2017,2386,1325,1061,124.9,2279,1262,1017,124.1
39004, 읍부,050002, 46세,2017,2624,1475,1149,128.4,2535,1426,1109,128.6
39004, 읍부,050003, 47세,2017,2367,1336,1031,129.6,2285,1286,999,128.7
39004, 읍부,050004, 48세,2017,2388,1320,1068,123.6,2300,1280,1020,125.5
39004, 읍부,050005, 49세,2017,2465,1324,1141,116,2384,1283,1101,116.5
39004, 읍부,055,50~54세,2017,11563,6265,5298,118.3,11264,6120,5144,119
39004, 읍부,055001, 50세,2017,2199,1195,1004,119,2129,1161,968,119.9
39004, 읍부,055002, 51세,2017,2341,1277,1064,120,2278,1247,1031,121
39004, 읍부,055003, 52세,2017,2268,1213,1055,115,2215,1183,1032,114.6
39004, 읍부,055004, 53세,2017,2332,1284,1048,122.5,2270,1256,1014,123.9
39004, 읍부,055005, 54세,2017,2423,1296,1127,115,2372,1273,1099,115.8
39004, 읍부,060,55~59세,2017,11617,6055,5562,108.9,11393,5949,5444,109.3
39004, 읍부,060001, 55세,2017,2399,1265,1134,111.6,2345,1238,1107,111.8
39004, 읍부,060002, 56세,2017,2338,1200,1138,105.4,2296,1180,1116,105.7
39004, 읍부,060003, 57세,2017,2464,1268,1196,106,2412,1240,1172,105.8
39004, 읍부,060004, 58세,2017,2242,1175,1067,110.1,2208,1162,1046,111.1
39004, 읍부,060005, 59세,2017,2174,1147,1027,111.7,2132,1129,1003,112.6
39004, 읍부,065,60~64세,2017,9298,4756,4542,104.7,9119,4670,4449,105
39004, 읍부,065001, 60세,2017,2098,1099,999,110,2065,1084,981,110.5
39004, 읍부,065002, 61세,2017,1979,1034,945,109.4,1934,1016,918,110.7
39004, 읍부,065003, 62세,2017,2097,1041,1056,98.6,2067,1026,1041,98.6
39004, 읍부,065004, 63세,2017,1732,895,837,106.9,1686,873,813,107.4
39004, 읍부,065005, 64세,2017,1392,687,705,97.4,1367,671,696,96.4
39004, 읍부,070,65~69세,2017,7096,3468,3628,95.6,7030,3443,3587,96
39004, 읍부,070001, 65세,2017,1534,750,784,95.7,1519,746,773,96.5
39004, 읍부,070002, 66세,2017,1361,694,667,104,1344,686,658,104.3
39004, 읍부,070003, 67세,2017,1306,599,707,84.7,1291,593,698,85
39004, 읍부,070004, 68세,2017,1431,694,737,94.2,1419,689,730,94.4
39004, 읍부,070005, 69세,2017,1464,731,733,99.7,1457,729,728,100.1
39004, 읍부,075,70~74세,2017,6527,3012,3515,85.7,6501,2991,3510,85.2
39004, 읍부,075001, 70세,2017,1475,728,747,97.5,1465,721,744,96.9
39004, 읍부,075002, 71세,2017,1358,648,710,91.3,1353,643,710,90.6
39004, 읍부,075003, 72세,2017,1237,568,669,84.9,1232,565,667,84.7
39004, 읍부,075004, 73세,2017,1228,541,687,78.7,1224,537,687,78.2
39004, 읍부,075005, 74세,2017,1229,527,702,75.1,1227,525,702,74.8
39004, 읍부,080,75~79세,2017,6336,2553,3783,67.5,6324,2551,3773,67.6
39004, 읍부,080001, 75세,2017,1351,608,743,81.8,1350,608,742,81.9
39004, 읍부,080002, 76세,2017,1328,549,779,70.5,1325,548,777,70.5
39004, 읍부,080003, 77세,2017,1222,462,760,60.8,1221,462,759,60.9
39004, 읍부,080004, 78세,2017,1253,502,751,66.8,1250,501,749,66.9
39004, 읍부,080005, 79세,2017,1182,432,750,57.6,1178,432,746,57.9
39004, 읍부,085,80~84세,2017,4586,1483,3103,47.8,4569,1474,3095,47.6
39004, 읍부,085001, 80세,2017,1019,366,653,56,1015,364,651,55.9
39004, 읍부,085002, 81세,2017,940,317,623,50.9,938,316,622,50.8
39004, 읍부,085003, 82세,2017,888,302,586,51.5,885,302,583,51.8
39004, 읍부,085004, 83세,2017,907,270,637,42.4,904,267,637,41.9
39004, 읍부,085005, 84세,2017,832,228,604,37.7,827,225,602,37.4
39004, 읍부,090,85~89세,2017,2242,480,1762,27.2,2238,477,1761,27.1
39004, 읍부,090001, 85세,2017,675,160,515,31.1,674,159,515,30.9
39004, 읍부,090002, 86세,2017,460,106,354,29.9,459,106,353,30
39004, 읍부,090003, 87세,2017,495,95,400,23.8,494,94,400,23.5
39004, 읍부,090004, 88세,2017,351,71,280,25.4,351,71,280,25.4
39004, 읍부,090005, 89세,2017,261,48,213,22.5,260,47,213,22.1
39004, 읍부,095,90~94세,2017,746,104,642,16.2,742,103,639,16.1
39004, 읍부,095001, 90세,2017,213,26,187,13.9,211,26,185,14.1
39004, 읍부,095002, 91세,2017,141,31,110,28.2,140,30,110,27.3
39004, 읍부,095003, 92세,2017,124,17,107,15.9,123,17,106,16
39004, 읍부,095004, 93세,2017,68,17,51,33.3,68,17,51,33.3
39004, 읍부,095005, 94세,2017,200,13,187,7,200,13,187,7
39004, 읍부,100,95~99세,2017,281,25,256,9.8,280,25,255,9.8
39004, 읍부,100001, 95세,2017,119,15,104,14.4,119,15,104,14.4
39004, 읍부,100002, 96세,2017,63,X,59,6.8,63,X,59,6.8
39004, 읍부,100003, 97세,2017,45,X,42,7.1,45,X,42,7.1
39004, 읍부,100004, 98세,2017,35,X,33,6.1,34,X,32,6.3
39004, 읍부,100005, 99세,2017,19,X,18,5.6,19,X,18,5.6
39004, 읍부,101,100세이상,2017,34,X,33,3,34,X,33,3
39004, 읍부,102,15세미만,2017,18040,9503,8537,111.3,17771,9372,8399,111.6
39004, 읍부,103,15~64세,2017,95669,52203,43466,120.1,88743,47616,41127,115.8
39004, 읍부,104,65세이상,2017,27848,11126,16722,66.5,27718,11065,16653,66.4
39004, 읍부,086,85세이상,2017,3303,610,2693,22.7,3294,606,2688,22.5
39004, 읍부,126,평균연령,2017,44.4,42.3,46.7,,45,42.9,47.1,
39004, 읍부,127,중위연령,2017,45.7,43.8,48,,46.7,45.2,48.7,
39005, 면부,000,합계,2017,33683,17417,16266,107.1,32033,16270,15763,103.2
39005, 면부,005,0~4세,2017,1115,564,551,102.4,1101,557,544,102.4
39005, 면부,005001, 0세,2017,206,97,109,89,203,96,107,89.7
39005, 면부,005002, 1세,2017,203,101,102,99,202,101,101,100
39005, 면부,005003, 2세,2017,238,114,124,91.9,234,112,122,91.8
39005, 면부,005004, 3세,2017,226,117,109,107.3,224,115,109,105.5
39005, 면부,005005, 4세,2017,242,135,107,126.2,238,133,105,126.7
39005, 면부,010,5~9세,2017,1281,677,604,112.1,1278,676,602,112.3
39005, 면부,010001, 5세,2017,273,137,136,100.7,272,137,135,101.5
39005, 면부,010002, 6세,2017,263,132,131,100.8,263,132,131,100.8
39005, 면부,010003, 7세,2017,251,149,102,146.1,251,149,102,146.1
39005, 면부,010004, 8세,2017,229,115,114,100.9,228,114,114,100
39005, 면부,010005, 9세,2017,265,144,121,119,264,144,120,120
39005, 면부,015,10~14세,2017,1142,634,508,124.8,1126,627,499,125.7
39005, 면부,015001, 10세,2017,267,162,105,154.3,265,161,104,154.8
39005, 면부,015002, 11세,2017,212,124,88,140.9,206,123,83,148.2
39005, 면부,015003, 12세,2017,218,111,107,103.7,218,111,107,103.7
39005, 면부,015004, 13세,2017,220,125,95,131.6,216,123,93,132.3
39005, 면부,015005, 14세,2017,225,112,113,99.1,221,109,112,97.3
39005, 면부,020,15~19세,2017,1399,740,659,112.3,1369,723,646,111.9
39005, 면부,020001, 15세,2017,255,149,106,140.6,248,147,101,145.5
39005, 면부,020002, 16세,2017,300,156,144,108.3,296,154,142,108.5
39005, 면부,020003, 17세,2017,315,158,157,100.6,312,155,157,98.7
39005, 면부,020004, 18세,2017,268,139,129,107.8,267,139,128,108.6
39005, 면부,020005, 19세,2017,261,138,123,112.2,246,128,118,108.5
39005, 면부,025,20~24세,2017,1900,1081,819,132,1669,905,764,118.5
39005, 면부,025001, 20세,2017,334,197,137,143.8,313,183,130,140.8
39005, 면부,025002, 21세,2017,367,212,155,136.8,325,182,143,127.3
39005, 면부,025003, 22세,2017,368,211,157,134.4,325,182,143,127.3
39005, 면부,025004, 23세,2017,393,216,177,122,347,180,167,107.8
39005, 면부,025005, 24세,2017,438,245,193,126.9,359,178,181,98.3
39005, 면부,030,25~29세,2017,1924,1101,823,133.8,1560,836,724,115.5
39005, 면부,030001, 25세,2017,424,251,173,145.1,349,198,151,131.1
39005, 면부,030002, 26세,2017,424,243,181,134.3,350,181,169,107.1
39005, 면부,030003, 27세,2017,414,232,182,127.5,338,175,163,107.4
39005, 면부,030004, 28세,2017,360,194,166,116.9,293,147,146,100.7
39005, 면부,030005, 29세,2017,302,181,121,149.6,230,135,95,142.1
39005, 면부,035,30~34세,2017,1713,1005,708,141.9,1401,775,626,123.8
39005, 면부,035001, 30세,2017,332,206,126,163.5,249,148,101,146.5
39005, 면부,035002, 31세,2017,331,188,143,131.5,261,140,121,115.7
39005, 면부,035003, 32세,2017,326,189,137,138,268,140,128,109.4
39005, 면부,035004, 33세,2017,320,196,124,158.1,269,158,111,142.3
39005, 면부,035005, 34세,2017,404,226,178,127,354,189,165,114.5
39005, 면부,040,35~39세,2017,2258,1291,967,133.5,1985,1082,903,119.8
39005, 면부,040001, 35세,2017,446,253,193,131.1,380,201,179,112.3
39005, 면부,040002, 36세,2017,461,267,194,137.6,410,227,183,124
39005, 면부,040003, 37세,2017,449,251,198,126.8,383,200,183,109.3
39005, 면부,040004, 38세,2017,474,260,214,121.5,427,225,202,111.4
39005, 면부,040005, 39세,2017,428,260,168,154.8,385,229,156,146.8
39005, 면부,045,40~44세,2017,2390,1440,950,151.6,2243,1338,905,147.8
39005, 면부,045001, 40세,2017,480,275,205,134.1,439,247,192,128.6
39005, 면부,045002, 41세,2017,463,281,182,154.4,433,265,168,157.7
39005, 면부,045003, 42세,2017,426,266,160,166.3,395,242,153,158.2
39005, 면부,045004, 43세,2017,512,317,195,162.6,488,299,189,158.2
39005, 면부,045005, 44세,2017,509,301,208,144.7,488,285,203,140.4
39005, 면부,050,45~49세,2017,2813,1632,1181,138.2,2704,1570,1134,138.4
39005, 면부,050001, 45세,2017,519,311,208,149.5,494,294,200,147
39005, 면부,050002, 46세,2017,597,330,267,123.6,570,312,258,120.9
39005, 면부,050003, 47세,2017,532,306,226,135.4,515,299,216,138.4
39005, 면부,050004, 48세,2017,560,335,225,148.9,537,322,215,149.8
39005, 면부,050005, 49세,2017,605,350,255,137.3,588,343,245,140
39005, 면부,055,50~54세,2017,2796,1536,1260,121.9,2734,1508,1226,123
39005, 면부,055001, 50세,2017,512,257,255,100.8,496,247,249,99.2
39005, 면부,055002, 51세,2017,549,324,225,144,537,320,217,147.5
39005, 면부,055003, 52세,2017,554,311,243,128,543,306,237,129.1
39005, 면부,055004, 53세,2017,534,298,236,126.3,526,295,231,127.7
39005, 면부,055005, 54세,2017,647,346,301,115,632,340,292,116.4
39005, 면부,060,55~59세,2017,2896,1533,1363,112.5,2855,1514,1341,112.9
39005, 면부,060001, 55세,2017,590,320,270,118.5,576,311,265,117.4
39005, 면부,060002, 56세,2017,572,299,273,109.5,565,297,268,110.8
39005, 면부,060003, 57세,2017,587,321,266,120.7,579,317,262,121
39005, 면부,060004, 58세,2017,575,289,286,101,568,287,281,102.1
39005, 면부,060005, 59세,2017,572,304,268,113.4,567,302,265,114
39005, 면부,065,60~64세,2017,2485,1209,1276,94.7,2459,1195,1264,94.5
39005, 면부,065001, 60세,2017,580,293,287,102.1,573,290,283,102.5
39005, 면부,065002, 61세,2017,557,274,283,96.8,548,267,281,95
39005, 면부,065003, 62세,2017,505,244,261,93.5,502,242,260,93.1
39005, 면부,065004, 63세,2017,468,220,248,88.7,462,218,244,89.3
39005, 면부,065005, 64세,2017,375,178,197,90.4,374,178,196,90.8
39005, 면부,070,65~69세,2017,1978,978,1000,97.8,1964,974,990,98.4
39005, 면부,070001, 65세,2017,412,212,200,106,403,209,194,107.7
39005, 면부,070002, 66세,2017,362,197,165,119.4,362,197,165,119.4
39005, 면부,070003, 67세,2017,390,182,208,87.5,388,181,207,87.4
39005, 면부,070004, 68세,2017,388,174,214,81.3,386,174,212,82.1
39005, 면부,070005, 69세,2017,426,213,213,100,425,213,212,100.5
39005, 면부,075,70~74세,2017,1721,778,943,82.5,1717,774,943,82.1
39005, 면부,075001, 70세,2017,366,174,192,90.6,366,174,192,90.6
39005, 면부,075002, 71세,2017,368,177,191,92.7,366,175,191,91.6
39005, 면부,075003, 72세,2017,308,146,162,90.1,307,145,162,89.5
39005, 면부,075004, 73세,2017,348,147,201,73.1,347,146,201,72.6
39005, 면부,075005, 74세,2017,331,134,197,68,331,134,197,68
39005, 면부,080,75~79세,2017,1765,685,1080,63.4,1762,683,1079,63.3
39005, 면부,080001, 75세,2017,383,175,208,84.1,381,174,207,84.1
39005, 면부,080002, 76세,2017,388,155,233,66.5,388,155,233,66.5
39005, 면부,080003, 77세,2017,315,120,195,61.5,315,120,195,61.5
39005, 면부,080004, 78세,2017,338,122,216,56.5,337,121,216,56
39005, 면부,080005, 79세,2017,341,113,228,49.6,341,113,228,49.6
39005, 면부,085,80~84세,2017,1281,403,878,45.9,1280,403,877,46
39005, 면부,085001, 80세,2017,295,95,200,47.5,294,95,199,47.7
39005, 면부,085002, 81세,2017,258,97,161,60.2,258,97,161,60.2
39005, 면부,085003, 82세,2017,275,90,185,48.6,275,90,185,48.6
39005, 면부,085004, 83세,2017,235,66,169,39.1,235,66,169,39.1
39005, 면부,085005, 84세,2017,218,55,163,33.7,218,55,163,33.7
39005, 면부,090,85~89세,2017,556,109,447,24.4,556,109,447,24.4
39005, 면부,090001, 85세,2017,160,41,119,34.5,160,41,119,34.5
39005, 면부,090002, 86세,2017,133,23,110,20.9,133,23,110,20.9
39005, 면부,090003, 87세,2017,116,20,96,20.8,116,20,96,20.8
39005, 면부,090004, 88세,2017,94,16,78,20.5,94,16,78,20.5
39005, 면부,090005, 89세,2017,53,9,44,20.5,53,9,44,20.5
39005, 면부,095,90~94세,2017,203,15,188,8,203,15,188,8
39005, 면부,095001, 90세,2017,55,7,48,14.6,55,7,48,14.6
39005, 면부,095002, 91세,2017,38,X,35,8.6,38,X,35,8.6
39005, 면부,095003, 92세,2017,23,X,22,4.5,23,X,22,4.5
39005, 면부,095004, 93세,2017,17,X,16,6.3,17,X,16,6.3
39005, 면부,095005, 94세,2017,70,X,67,4.5,70,X,67,4.5
39005, 면부,100,95~99세,2017,56,6,50,12,56,6,50,12
39005, 면부,100001, 95세,2017,23,X,20,15,23,X,20,15
39005, 면부,100002, 96세,2017,18,X,18,0,18,X,18,0
39005, 면부,100003, 97세,2017,7,X,6,16.7,7,X,6,16.7
39005, 면부,100004, 98세,2017,X,X,X,33.3,X,X,X,33.3
39005, 면부,100005, 99세,2017,X,X,X,33.3,X,X,X,33.3
39005, 면부,101,100세이상,2017,11,X,11,0,11,X,11,0
39005, 면부,102,15세미만,2017,3538,1875,1663,112.7,3505,1860,1645,113.1
39005, 면부,103,15~64세,2017,22574,12568,10006,125.6,20979,11446,9533,120.1
39005, 면부,104,65세이상,2017,7571,2974,4597,64.7,7549,2964,4585,64.6
39005, 면부,086,85세이상,2017,826,130,696,18.7,826,130,696,18.7
39005, 면부,126,평균연령,2017,46.5,44,49.1,,47.1,44.7,49.6,
39005, 면부,127,중위연령,2017,48.1,45.6,51.5,,49.3,47,52.3,
39003, 동부,000,합계,2017,466517,233766,232751,100.4,455092,228040,227052,100.4
39003, 동부,005,0~4세,2017,23500,12053,11447,105.3,23306,11951,11355,105.2
39003, 동부,005001, 0세,2017,4141,2152,1989,108.2,4093,2134,1959,108.9
39003, 동부,005002, 1세,2017,4597,2395,2202,108.8,4555,2372,2183,108.7
39003, 동부,005003, 2세,2017,4774,2456,2318,106,4738,2437,2301,105.9
39003, 동부,005004, 3세,2017,5016,2533,2483,102,4977,2509,2468,101.7
39003, 동부,005005, 4세,2017,4972,2517,2455,102.5,4943,2499,2444,102.3
39003, 동부,010,5~9세,2017,26138,13427,12711,105.6,26020,13364,12656,105.6
39003, 동부,010001, 5세,2017,5485,2770,2715,102,5460,2757,2703,102
39003, 동부,010002, 6세,2017,5313,2728,2585,105.5,5292,2719,2573,105.7
39003, 동부,010003, 7세,2017,5201,2711,2490,108.9,5178,2696,2482,108.6
39003, 동부,010004, 8세,2017,4973,2568,2405,106.8,4947,2556,2391,106.9
39003, 동부,010005, 9세,2017,5166,2650,2516,105.3,5143,2636,2507,105.1
39003, 동부,015,10~14세,2017,26532,13850,12682,109.2,26452,13810,12642,109.2
39003, 동부,015001, 10세,2017,5566,2849,2717,104.9,5548,2839,2709,104.8
39003, 동부,015002, 11세,2017,5060,2602,2458,105.9,5044,2595,2449,106
39003, 동부,015003, 12세,2017,4985,2680,2305,116.3,4963,2668,2295,116.3
39003, 동부,015004, 13세,2017,5350,2814,2536,111,5338,2807,2531,110.9
39003, 동부,015005, 14세,2017,5571,2905,2666,109,5559,2901,2658,109.1
39003, 동부,020,15~19세,2017,29274,15277,13997,109.1,28992,15139,13853,109.3
39003, 동부,020001, 15세,2017,5405,2861,2544,112.5,5396,2856,2540,112.4
39003, 동부,020002, 16세,2017,6072,3194,2878,111,6050,3184,2866,111.1
39003, 동부,020003, 17세,2017,6594,3439,3155,109,6573,3427,3146,108.9
39003, 동부,020004, 18세,2017,5944,3083,2861,107.8,5879,3049,2830,107.7
39003, 동부,020005, 19세,2017,5259,2700,2559,105.5,5094,2623,2471,106.2
39003, 동부,025,20~24세,2017,30560,16376,14184,115.5,28861,15480,13381,115.7
39003, 동부,025001, 20세,2017,5899,3270,2629,124.4,5629,3138,2491,126
39003, 동부,025002, 21세,2017,6141,3479,2662,130.7,5834,3317,2517,131.8
39003, 동부,025003, 22세,2017,6143,3259,2884,113,5794,3080,2714,113.5
39003, 동부,025004, 23세,2017,6208,3215,2993,107.4,5825,3014,2811,107.2
39003, 동부,025005, 24세,2017,6169,3153,3016,104.5,5779,2931,2848,102.9
39003, 동부,030,25~29세,2017,27760,14282,13478,106,25580,13181,12399,106.3
39003, 동부,030001, 25세,2017,6145,3209,2936,109.3,5730,2984,2746,108.7
39003, 동부,030002, 26세,2017,5701,2897,2804,103.3,5305,2700,2605,103.6
39003, 동부,030003, 27세,2017,5519,2856,2663,107.2,5036,2616,2420,108.1
39003, 동부,030004, 28세,2017,5240,2648,2592,102.2,4814,2451,2363,103.7
39003, 동부,030005, 29세,2017,5155,2672,2483,107.6,4695,2430,2265,107.3
39003, 동부,035,30~34세,2017,30113,15191,14922,101.8,28210,14271,13939,102.4
39003, 동부,035001, 30세,2017,5464,2767,2697,102.6,4984,2549,2435,104.7
39003, 동부,035002, 31세,2017,5563,2869,2694,106.5,5152,2664,2488,107.1
39003, 동부,035003, 32세,2017,5828,2965,2863,103.6,5490,2792,2698,103.5
39003, 동부,035004, 33세,2017,6324,3144,3180,98.9,5959,2965,2994,99
39003, 동부,035005, 34세,2017,6934,3446,3488,98.8,6625,3301,3324,99.3
39003, 동부,040,35~39세,2017,38043,19140,18903,101.3,36596,18417,18179,101.3
39003, 동부,040001, 35세,2017,7820,3929,3891,101,7474,3763,3711,101.4
39003, 동부,040002, 36세,2017,7814,3971,3843,103.3,7533,3811,3722,102.4
39003, 동부,040003, 37세,2017,7840,3987,3853,103.5,7560,3851,3709,103.8
39003, 동부,040004, 38세,2017,7785,3882,3903,99.5,7500,3750,3750,100
39003, 동부,040005, 39세,2017,6784,3371,3413,98.8,6529,3242,3287,98.6
39003, 동부,045,40~44세,2017,39076,19896,19180,103.7,38128,19426,18702,103.9
39003, 동부,045001, 40세,2017,7236,3649,3587,101.7,7013,3541,3472,102
39003, 동부,045002, 41세,2017,7255,3800,3455,110,7089,3723,3366,110.6
39003, 동부,045003, 42세,2017,7551,3832,3719,103,7350,3737,3613,103.4
39003, 동부,045004, 43세,2017,8452,4321,4131,104.6,8270,4231,4039,104.8
39003, 동부,045005, 44세,2017,8582,4294,4288,100.1,8406,4194,4212,99.6
39003, 동부,050,45~49세,2017,43719,22228,21491,103.4,42929,21795,21134,103.1
39003, 동부,050001, 45세,2017,8921,4482,4439,101,8764,4399,4365,100.8
39003, 동부,050002, 46세,2017,9239,4716,4523,104.3,9066,4620,4446,103.9
39003, 동부,050003, 47세,2017,8764,4420,4344,101.7,8596,4332,4264,101.6
39003, 동부,050004, 48세,2017,8488,4370,4118,106.1,8342,4291,4051,105.9
39003, 동부,050005, 49세,2017,8307,4240,4067,104.3,8161,4153,4008,103.6
39003, 동부,055,50~54세,2017,37324,19166,18158,105.6,36733,18879,17854,105.7
39003, 동부,055001, 50세,2017,7651,3948,3703,106.6,7537,3887,3650,106.5
39003, 동부,055002, 51세,2017,7800,4064,3736,108.8,7691,4010,3681,108.9
39003, 동부,055003, 52세,2017,7158,3675,3483,105.5,7027,3611,3416,105.7
39003, 동부,055004, 53세,2017,7100,3630,3470,104.6,6989,3583,3406,105.2
39003, 동부,055005, 54세,2017,7615,3849,3766,102.2,7489,3788,3701,102.4
39003, 동부,060,55~59세,2017,34101,17212,16889,101.9,33663,17008,16655,102.1
39003, 동부,060001, 55세,2017,7171,3669,3502,104.8,7080,3624,3456,104.9
39003, 동부,060002, 56세,2017,7117,3556,3561,99.9,7041,3520,3521,100
39003, 동부,060003, 57세,2017,7203,3646,3557,102.5,7116,3604,3512,102.6
39003, 동부,060004, 58세,2017,6514,3242,3272,99.1,6417,3196,3221,99.2
39003, 동부,060005, 59세,2017,6096,3099,2997,103.4,6009,3064,2945,104
39003, 동부,065,60~64세,2017,25369,12498,12871,97.1,24967,12312,12655,97.3
39003, 동부,065001, 60세,2017,5866,2921,2945,99.2,5770,2875,2895,99.3
39003, 동부,065002, 61세,2017,5617,2807,2810,99.9,5527,2769,2758,100.4
39003, 동부,065003, 62세,2017,5615,2753,2862,96.2,5526,2710,2816,96.2
39003, 동부,065004, 63세,2017,4478,2213,2265,97.7,4402,2178,2224,97.9
39003, 동부,065005, 64세,2017,3793,1804,1989,90.7,3742,1780,1962,90.7
39003, 동부,070,65~69세,2017,17530,8421,9109,92.4,17340,8337,9003,92.6
39003, 동부,070001, 65세,2017,3930,1916,2014,95.1,3890,1903,1987,95.8
39003, 동부,070002, 66세,2017,3381,1626,1755,92.6,3323,1600,1723,92.9
39003, 동부,070003, 67세,2017,3395,1614,1781,90.6,3364,1598,1766,90.5
39003, 동부,070004, 68세,2017,3315,1575,1740,90.5,3279,1558,1721,90.5
39003, 동부,070005, 69세,2017,3509,1690,1819,92.9,3484,1678,1806,92.9
39003, 동부,075,70~74세,2017,13930,6494,7436,87.3,13846,6451,7395,87.2
39003, 동부,075001, 70세,2017,3355,1563,1792,87.2,3329,1552,1777,87.3
39003, 동부,075002, 71세,2017,2798,1298,1500,86.5,2778,1287,1491,86.3
39003, 동부,075003, 72세,2017,2660,1277,1383,92.3,2650,1272,1378,92.3
39003, 동부,075004, 73세,2017,2636,1239,1397,88.7,2624,1233,1391,88.6
39003, 동부,075005, 74세,2017,2481,1117,1364,81.9,2465,1107,1358,81.5
39003, 동부,080,75~79세,2017,10969,4645,6324,73.5,10936,4632,6304,73.5
39003, 동부,080001, 75세,2017,2619,1140,1479,77.1,2611,1138,1473,77.3
39003, 동부,080002, 76세,2017,2407,1048,1359,77.1,2396,1042,1354,77
39003, 동부,080003, 77세,2017,2096,886,1210,73.2,2092,884,1208,73.2
39003, 동부,080004, 78세,2017,2020,816,1204,67.8,2012,813,1199,67.8
39003, 동부,080005, 79세,2017,1827,755,1072,70.4,1825,755,1070,70.6
39003, 동부,085,80~84세,2017,7365,2600,4765,54.6,7340,2586,4754,54.4
39003, 동부,085001, 80세,2017,1752,667,1085,61.5,1742,660,1082,61
39003, 동부,085002, 81세,2017,1499,550,949,58,1496,549,947,58
39003, 동부,085003, 82세,2017,1486,526,960,54.8,1478,521,957,54.4
39003, 동부,085004, 83세,2017,1393,491,902,54.4,1390,490,900,54.4
39003, 동부,085005, 84세,2017,1235,366,869,42.1,1234,366,868,42.2
39003, 동부,090,85~89세,2017,3467,779,2688,29,3453,773,2680,28.8
39003, 동부,090001, 85세,2017,933,254,679,37.4,928,254,674,37.7
39003, 동부,090002, 86세,2017,762,203,559,36.3,759,202,557,36.3
39003, 동부,090003, 87세,2017,729,153,576,26.6,724,149,575,25.9
39003, 동부,090004, 88세,2017,583,110,473,23.3,582,109,473,23
39003, 동부,090005, 89세,2017,460,59,401,14.7,460,59,401,14.7
39003, 동부,095,90~94세,2017,1233,175,1058,16.5,1229,175,1054,16.6
39003, 동부,095001, 90세,2017,355,54,301,17.9,354,54,300,18
39003, 동부,095002, 91세,2017,243,38,205,18.5,242,38,204,18.6
39003, 동부,095003, 92세,2017,186,28,158,17.7,185,28,157,17.8
39003, 동부,095004, 93세,2017,152,27,125,21.6,151,27,124,21.8
39003, 동부,095005, 94세,2017,297,28,269,10.4,297,28,269,10.4
39003, 동부,100,95~99세,2017,454,53,401,13.2,451,50,401,12.5
39003, 동부,100001, 95세,2017,174,23,151,15.2,173,22,151,14.6
39003, 동부,100002, 96세,2017,132,11,121,9.1,132,11,121,9.1
39003, 동부,100003, 97세,2017,66,10,56,17.9,66,10,56,17.9
39003, 동부,100004, 98세,2017,48,X,44,9.1,47,X,44,6.8
39003, 동부,100005, 99세,2017,34,5,29,17.2,33,X,29,13.8
39003, 동부,101,100세이상,2017,60,X,57,5.3,60,X,57,5.3
39003, 동부,102,15세미만,2017,76170,39330,36840,106.8,75778,39125,36653,106.7
39003, 동부,103,15~64세,2017,335339,171266,164073,104.4,324659,165908,158751,104.5
39003, 동부,104,65세이상,2017,55008,23170,31838,72.8,54655,23007,31648,72.7
39003, 동부,086,85세이상,2017,5214,1010,4204,24,5193,1001,4192,23.9
39003, 동부,126,평균연령,2017,39.2,38.1,40.3,,39.3,38.2,40.4,
39003, 동부,127,중위연령,2017,40.2,39.2,41.1,,40.5,39.5,41.5,
39010, 제주시,000,합계,2017,472399,237860,234539,101.4,458437,230130,228307,100.8
39010, 제주시,005,0~4세,2017,22731,11757,10974,107.1,22522,11644,10878,107
39010, 제주시,005001, 0세,2017,3935,2061,1874,110,3887,2043,1844,110.8
39010, 제주시,005002, 1세,2017,4424,2293,2131,107.6,4374,2267,2107,107.6
39010, 제주시,005003, 2세,2017,4610,2403,2207,108.9,4576,2383,2193,108.7
39010, 제주시,005004, 3세,2017,4869,2485,2384,104.2,4822,2457,2365,103.9
39010, 제주시,005005, 4세,2017,4893,2515,2378,105.8,4863,2494,2369,105.3
39010, 제주시,010,5~9세,2017,25661,13231,12430,106.4,25530,13166,12364,106.5
39010, 제주시,010001, 5세,2017,5391,2704,2687,100.6,5362,2690,2672,100.7
39010, 제주시,010002, 6세,2017,5197,2668,2529,105.5,5177,2660,2517,105.7
39010, 제주시,010003, 7세,2017,5072,2676,2396,111.7,5046,2658,2388,111.3
39010, 제주시,010004, 8세,2017,4942,2586,2356,109.8,4916,2574,2342,109.9
39010, 제주시,010005, 9세,2017,5059,2597,2462,105.5,5029,2584,2445,105.7
39010, 제주시,015,10~14세,2017,25858,13525,12333,109.7,25768,13477,12291,109.6
39010, 제주시,015001, 10세,2017,5410,2777,2633,105.5,5394,2768,2626,105.4
39010, 제주시,015002, 11세,2017,4947,2554,2393,106.7,4928,2545,2383,106.8
39010, 제주시,015003, 12세,2017,4853,2609,2244,116.3,4835,2596,2239,115.9
39010, 제주시,015004, 13세,2017,5199,2743,2456,111.7,5180,2731,2449,111.5
39010, 제주시,015005, 14세,2017,5449,2842,2607,109,5431,2837,2594,109.4
39010, 제주시,020,15~19세,2017,29065,15242,13823,110.3,28636,15032,13604,110.5
39010, 제주시,020001, 15세,2017,5227,2802,2425,115.5,5212,2795,2417,115.6
39010, 제주시,020002, 16세,2017,5874,3076,2798,109.9,5841,3059,2782,110
39010, 제주시,020003, 17세,2017,6383,3347,3036,110.2,6344,3327,3017,110.3
39010, 제주시,020004, 18세,2017,5896,3098,2798,110.7,5803,3050,2753,110.8
39010, 제주시,020005, 19세,2017,5685,2919,2766,105.5,5436,2801,2635,106.3
39010, 제주시,025,20~24세,2017,31394,17050,14344,118.9,29111,15682,13429,116.8
39010, 제주시,025001, 20세,2017,6110,3366,2744,122.7,5750,3186,2564,124.3
39010, 제주시,025002, 21세,2017,6315,3563,2752,129.5,5927,3336,2591,128.8
39010, 제주시,025003, 22세,2017,6243,3370,2873,117.3,5788,3094,2694,114.8
39010, 제주시,025004, 23세,2017,6354,3409,2945,115.8,5827,3081,2746,112.2
39010, 제주시,025005, 24세,2017,6372,3342,3030,110.3,5819,2985,2834,105.3
39010, 제주시,030,25~29세,2017,27919,14655,13264,110.5,25176,13068,12108,107.9
39010, 제주시,030001, 25세,2017,6166,3294,2872,114.7,5615,2967,2648,112
39010, 제주시,030002, 26세,2017,5818,3023,2795,108.2,5297,2710,2587,104.8
39010, 제주시,030003, 27세,2017,5534,2940,2594,113.3,4936,2591,2345,110.5
39010, 제주시,030004, 28세,2017,5271,2705,2566,105.4,4748,2428,2320,104.7
39010, 제주시,030005, 29세,2017,5130,2693,2437,110.5,4580,2372,2208,107.4
39010, 제주시,035,30~34세,2017,29975,15374,14601,105.3,27660,14094,13566,103.9
39010, 제주시,035001, 30세,2017,5467,2823,2644,106.8,4905,2539,2366,107.3
39010, 제주시,035002, 31세,2017,5571,2896,2675,108.3,5050,2603,2447,106.4
39010, 제주시,035003, 32세,2017,5823,3008,2815,106.9,5392,2745,2647,103.7
39010, 제주시,035004, 33세,2017,6208,3158,3050,103.5,5792,2925,2867,102
39010, 제주시,035005, 34세,2017,6906,3489,3417,102.1,6521,3282,3239,101.3
39010, 제주시,040,35~39세,2017,38096,19364,18732,103.4,36271,18326,17945,102.1
39010, 제주시,040001, 35세,2017,7770,3985,3785,105.3,7325,3722,3603,103.3
39010, 제주시,040002, 36세,2017,7758,3952,3806,103.8,7377,3719,3658,101.7
39010, 제주시,040003, 37세,2017,7911,4072,3839,106.1,7553,3864,3689,104.7
39010, 제주시,040004, 38세,2017,7800,3911,3889,100.6,7461,3740,3721,100.5
39010, 제주시,040005, 39세,2017,6857,3444,3413,100.9,6555,3281,3274,100.2
39010, 제주시,045,40~44세,2017,39190,20218,18972,106.6,38085,19612,18473,106.2
39010, 제주시,045001, 40세,2017,7328,3776,3552,106.3,7072,3629,3443,105.4
39010, 제주시,045002, 41세,2017,7174,3840,3334,115.2,6957,3724,3233,115.2
39010, 제주시,045003, 42세,2017,7616,3872,3744,103.4,7380,3746,3634,103.1
39010, 제주시,045004, 43세,2017,8494,4407,4087,107.8,8289,4298,3991,107.7
39010, 제주시,045005, 44세,2017,8578,4323,4255,101.6,8387,4215,4172,101
39010, 제주시,050,45~49세,2017,43832,22532,21300,105.8,42914,22027,20887,105.5
39010, 제주시,050001, 45세,2017,8894,4526,4368,103.6,8700,4415,4285,103
39010, 제주시,050002, 46세,2017,9245,4750,4495,105.7,9037,4632,4405,105.2
39010, 제주시,050003, 47세,2017,8713,4440,4273,103.9,8523,4343,4180,103.9
39010, 제주시,050004, 48세,2017,8562,4472,4090,109.3,8391,4381,4010,109.3
39010, 제주시,050005, 49세,2017,8418,4344,4074,106.6,8263,4256,4007,106.2
39010, 제주시,055,50~54세,2017,37783,19605,18178,107.9,37149,19297,17852,108.1
39010, 제주시,055001, 50세,2017,7671,3968,3703,107.2,7546,3903,3643,107.1
39010, 제주시,055002, 51세,2017,7889,4167,3722,112,7772,4107,3665,112.1
39010, 제주시,055003, 52세,2017,7247,3747,3500,107.1,7119,3682,3437,107.1
39010, 제주시,055004, 53세,2017,7247,3752,3495,107.4,7121,3699,3422,108.1
39010, 제주시,055005, 54세,2017,7729,3971,3758,105.7,7591,3906,3685,106
39010, 제주시,060,55~59세,2017,34658,17589,17069,103,34173,17361,16812,103.3
39010, 제주시,060001, 55세,2017,7315,3722,3593,103.6,7205,3666,3539,103.6
39010, 제주시,060002, 56세,2017,7184,3617,3567,101.4,7105,3579,3526,101.5
39010, 제주시,060003, 57세,2017,7290,3713,3577,103.8,7183,3661,3522,103.9
39010, 제주시,060004, 58세,2017,6650,3351,3299,101.6,6555,3306,3249,101.8
39010, 제주시,060005, 59세,2017,6219,3186,3033,105,6125,3149,2976,105.8
39010, 제주시,065,60~64세,2017,25899,12898,13001,99.2,25461,12693,12768,99.4
39010, 제주시,065001, 60세,2017,6029,3064,2965,103.3,5929,3017,2912,103.6
39010, 제주시,065002, 61세,2017,5633,2829,2804,100.9,5531,2783,2748,101.3
39010, 제주시,065003, 62세,2017,5836,2875,2961,97.1,5748,2835,2913,97.3
39010, 제주시,065004, 63세,2017,4585,2290,2295,99.8,4495,2249,2246,100.1
39010, 제주시,065005, 64세,2017,3816,1840,1976,93.1,3758,1809,1949,92.8
39010, 제주시,070,65~69세,2017,17976,8683,9293,93.4,17784,8601,9183,93.7
39010, 제주시,070001, 65세,2017,4009,1967,2042,96.3,3971,1956,2015,97.1
39010, 제주시,070002, 66세,2017,3481,1692,1789,94.6,3419,1663,1756,94.7
39010, 제주시,070003, 67세,2017,3481,1648,1833,89.9,3444,1630,1814,89.9
39010, 제주시,070004, 68세,2017,3404,1622,1782,91,3370,1607,1763,91.2
39010, 제주시,070005, 69세,2017,3601,1754,1847,95,3580,1745,1835,95.1
39010, 제주시,075,70~74세,2017,14873,6877,7996,86,14792,6828,7964,85.7
39010, 제주시,075001, 70세,2017,3475,1628,1847,88.1,3449,1615,1834,88.1
39010, 제주시,075002, 71세,2017,3075,1442,1633,88.3,3057,1429,1628,87.8
39010, 제주시,075003, 72세,2017,2747,1308,1439,90.9,2737,1302,1435,90.7
39010, 제주시,075004, 73세,2017,2848,1301,1547,84.1,2837,1294,1543,83.9
39010, 제주시,075005, 74세,2017,2728,1198,1530,78.3,2712,1188,1524,78
39010, 제주시,080,75~79세,2017,12417,5134,7283,70.5,12380,5121,7259,70.5
39010, 제주시,080001, 75세,2017,2776,1229,1547,79.4,2769,1228,1541,79.7
39010, 제주시,080002, 76세,2017,2683,1155,1528,75.6,2671,1148,1523,75.4
39010, 제주시,080003, 77세,2017,2362,947,1415,66.9,2359,946,1413,66.9
39010, 제주시,080004, 78세,2017,2397,940,1457,64.5,2387,936,1451,64.5
39010, 제주시,080005, 79세,2017,2199,863,1336,64.6,2194,863,1331,64.8
39010, 제주시,085,80~84세,2017,8642,2915,5727,50.9,8616,2899,5717,50.7
39010, 제주시,085001, 80세,2017,1997,737,1260,58.5,1988,732,1256,58.3
39010, 제주시,085002, 81세,2017,1803,624,1179,52.9,1798,622,1176,52.9
39010, 제주시,085003, 82세,2017,1702,606,1096,55.3,1696,602,1094,55
39010, 제주시,085004, 83세,2017,1638,527,1111,47.4,1636,525,1111,47.3
39010, 제주시,085005, 84세,2017,1502,421,1081,38.9,1498,418,1080,38.7
39010, 제주시,090,85~89세,2017,4283,941,3342,28.2,4268,933,3335,28
39010, 제주시,090001, 85세,2017,1176,304,872,34.9,1172,303,869,34.9
39010, 제주시,090002, 86세,2017,933,244,689,35.4,929,243,686,35.4
39010, 제주시,090003, 87세,2017,938,182,756,24.1,932,177,755,23.4
39010, 제주시,090004, 88세,2017,713,137,576,23.8,713,137,576,23.8
39010, 제주시,090005, 89세,2017,523,74,449,16.5,522,73,449,16.3
39010, 제주시,095,90~94세,2017,1532,208,1324,15.7,1528,208,1320,15.8
39010, 제주시,095001, 90세,2017,445,69,376,18.4,443,69,374,18.4
39010, 제주시,095002, 91세,2017,289,46,243,18.9,289,46,243,18.9
39010, 제주시,095003, 92세,2017,228,31,197,15.7,227,31,196,15.8
39010, 제주시,095004, 93세,2017,173,32,141,22.7,172,32,140,22.9
39010, 제주시,095005, 94세,2017,397,30,367,8.2,397,30,367,8.2
39010, 제주시,100,95~99세,2017,541,58,483,12,539,57,482,11.8
39010, 제주시,100001, 95세,2017,219,27,192,14.1,218,26,192,13.5
39010, 제주시,100002, 96세,2017,144,12,132,9.1,144,12,132,9.1
39010, 제주시,100003, 97세,2017,86,12,74,16.2,86,12,74,16.2
39010, 제주시,100004, 98세,2017,61,X,57,7,60,X,56,7.1
39010, 제주시,100005, 99세,2017,31,X,28,10.7,31,X,28,10.7
39010, 제주시,101,100세이상,2017,74,X,70,5.7,74,X,70,5.7
39010, 제주시,102,15세미만,2017,74250,38513,35737,107.8,73820,38287,35533,107.8
39010, 제주시,103,15~64세,2017,337811,174527,163284,106.9,324636,167192,157444,106.2
39010, 제주시,104,65세이상,2017,60338,24820,35518,69.9,59981,24651,35330,69.8
39010, 제주시,086,85세이상,2017,6430,1211,5219,23.2,6409,1202,5207,23.1
39010, 제주시,126,평균연령,2017,39.9,38.6,41.2,,40,38.7,41.3,
39010, 제주시,127,중위연령,2017,40.8,39.6,42,,41.2,40.2,42.4,
39020, 서귀포시,000,합계,2017,169358,86155,83203,103.5,162920,82233,80687,101.9
39020, 서귀포시,005,0~4세,2017,7082,3606,3476,103.7,6969,3548,3421,103.7
39020, 서귀포시,005001, 0세,2017,1244,646,598,108,1221,637,584,109.1
39020, 서귀포시,005002, 1세,2017,1419,744,675,110.2,1394,729,665,109.6
39020, 서귀포시,005003, 2세,2017,1473,755,718,105.2,1447,742,705,105.2
39020, 서귀포시,005004, 3세,2017,1444,723,721,100.3,1424,711,713,99.7
39020, 서귀포시,005005, 4세,2017,1502,738,764,96.6,1483,729,754,96.7
39020, 서귀포시,010,5~9세,2017,8334,4308,4026,107,8250,4271,3979,107.3
39020, 서귀포시,010001, 5세,2017,1672,888,784,113.3,1649,879,770,114.2
39020, 서귀포시,010002, 6세,2017,1699,894,805,111.1,1687,889,798,111.4
39020, 서귀포시,010003, 7세,2017,1638,844,794,106.3,1620,835,785,106.4
39020, 서귀포시,010004, 8세,2017,1585,799,786,101.7,1570,792,778,101.8
39020, 서귀포시,010005, 9세,2017,1740,883,857,103,1724,876,848,103.3
39020, 서귀포시,015,10~14세,2017,8082,4281,3801,112.6,8015,4251,3764,112.9
39020, 서귀포시,015001, 10세,2017,1774,896,878,102.1,1758,885,873,101.4
39020, 서귀포시,015002, 11세,2017,1592,863,729,118.4,1571,855,716,119.4
39020, 서귀포시,015003, 12세,2017,1528,810,718,112.8,1518,809,709,114.1
39020, 서귀포시,015004, 13세,2017,1627,880,747,117.8,1616,875,741,118.1
39020, 서귀포시,015005, 14세,2017,1561,832,729,114.1,1552,827,725,114.1
39020, 서귀포시,020,15~19세,2017,8539,4487,4052,110.7,8452,4447,4005,111
39020, 서귀포시,020001, 15세,2017,1683,887,796,111.4,1673,883,790,111.8
39020, 서귀포시,020002, 16세,2017,1885,1014,871,116.4,1874,1009,865,116.6
39020, 서귀포시,020003, 17세,2017,2079,1052,1027,102.4,2068,1047,1021,102.5
39020, 서귀포시,020004, 18세,2017,1686,869,817,106.4,1676,863,813,106.2
39020, 서귀포시,020005, 19세,2017,1206,665,541,122.9,1161,645,516,125
39020, 서귀포시,025,20~24세,2017,8957,5077,3880,130.9,8150,4515,3635,124.2
39020, 서귀포시,025001, 20세,2017,1675,1047,628,166.7,1589,991,598,165.7
39020, 서귀포시,025002, 21세,2017,1740,1069,671,159.3,1616,988,628,157.3
39020, 서귀포시,025003, 22세,2017,1770,962,808,119.1,1616,862,754,114.3
39020, 서귀포시,025004, 23세,2017,1824,964,860,112.1,1634,833,801,104
39020, 서귀포시,025005, 24세,2017,1948,1035,913,113.4,1695,841,854,98.5
39020, 서귀포시,030,25~29세,2017,9168,5047,4121,122.5,7894,4184,3710,112.8
39020, 서귀포시,030001, 25세,2017,2009,1115,894,124.7,1762,931,831,112
39020, 서귀포시,030002, 26세,2017,1857,1002,855,117.2,1611,827,784,105.5
39020, 서귀포시,030003, 27세,2017,1883,993,890,111.6,1625,831,794,104.7
39020, 서귀포시,030004, 28세,2017,1752,984,768,128.1,1485,805,680,118.4
39020, 서귀포시,030005, 29세,2017,1667,953,714,133.5,1411,790,621,127.2
39020, 서귀포시,035,30~34세,2017,9425,5027,4398,114.3,8228,4264,3964,107.6
39020, 서귀포시,035001, 30세,2017,1757,971,786,123.5,1479,794,685,115.9
39020, 서귀포시,035002, 31세,2017,1730,931,799,116.5,1481,781,700,111.6
39020, 서귀포시,035003, 32세,2017,1809,960,849,113.1,1576,816,760,107.4
39020, 서귀포시,035004, 33세,2017,2005,1051,954,110.2,1775,896,879,101.9
39020, 서귀포시,035005, 34세,2017,2124,1114,1010,110.3,1917,977,940,103.9
39020, 서귀포시,040,35~39세,2017,12379,6474,5905,109.6,11476,5890,5586,105.4
39020, 서귀포시,040001, 35세,2017,2445,1265,1180,107.2,2240,1136,1104,102.9
39020, 서귀포시,040002, 36세,2017,2600,1388,1212,114.5,2418,1260,1158,108.8
39020, 서귀포시,040003, 37세,2017,2493,1290,1203,107.2,2314,1178,1136,103.7
39020, 서귀포시,040004, 38세,2017,2589,1348,1241,108.6,2404,1229,1175,104.6
39020, 서귀포시,040005, 39세,2017,2252,1183,1069,110.7,2100,1087,1013,107.3
39020, 서귀포시,045,40~44세,2017,13264,7152,6112,117,12639,6799,5840,116.4
39020, 서귀포시,045001, 40세,2017,2421,1270,1151,110.3,2278,1190,1088,109.4
39020, 서귀포시,045002, 41세,2017,2618,1388,1230,112.8,2471,1307,1164,112.3
39020, 서귀포시,045003, 42세,2017,2528,1414,1114,126.9,2416,1349,1067,126.4
39020, 서귀포시,045004, 43세,2017,2896,1585,1311,120.9,2777,1517,1260,120.4
39020, 서귀포시,045005, 44세,2017,2801,1495,1306,114.5,2697,1436,1261,113.9
39020, 서귀포시,050,45~49세,2017,14930,8108,6822,118.9,14502,7875,6627,118.8
39020, 서귀포시,050001, 45세,2017,2932,1592,1340,118.8,2837,1540,1297,118.7
39020, 서귀포시,050002, 46세,2017,3215,1771,1444,122.6,3134,1726,1408,122.6
39020, 서귀포시,050003, 47세,2017,2950,1622,1328,122.1,2873,1574,1299,121.2
39020, 서귀포시,050004, 48세,2017,2874,1553,1321,117.6,2788,1512,1276,118.5
39020, 서귀포시,050005, 49세,2017,2959,1570,1389,113,2870,1523,1347,113.1
39020, 서귀포시,055,50~54세,2017,13900,7362,6538,112.6,13582,7210,6372,113.2
39020, 서귀포시,055001, 50세,2017,2691,1432,1259,113.7,2616,1392,1224,113.7
39020, 서귀포시,055002, 51세,2017,2801,1498,1303,115,2734,1470,1264,116.3
39020, 서귀포시,055003, 52세,2017,2733,1452,1281,113.3,2666,1418,1248,113.6
39020, 서귀포시,055004, 53세,2017,2719,1460,1259,116,2664,1435,1229,116.8
39020, 서귀포시,055005, 54세,2017,2956,1520,1436,105.8,2902,1495,1407,106.3
39020, 서귀포시,060,55~59세,2017,13956,7211,6745,106.9,13738,7110,6628,107.3
39020, 서귀포시,060001, 55세,2017,2845,1532,1313,116.7,2796,1507,1289,116.9
39020, 서귀포시,060002, 56세,2017,2843,1438,1405,102.3,2797,1418,1379,102.8
39020, 서귀포시,060003, 57세,2017,2964,1522,1442,105.5,2924,1500,1424,105.3
39020, 서귀포시,060004, 58세,2017,2681,1355,1326,102.2,2638,1339,1299,103.1
39020, 서귀포시,060005, 59세,2017,2623,1364,1259,108.3,2583,1346,1237,108.8
39020, 서귀포시,065,60~64세,2017,11253,5565,5688,97.8,11084,5484,5600,97.9
39020, 서귀포시,065001, 60세,2017,2515,1249,1266,98.7,2479,1232,1247,98.8
39020, 서귀포시,065002, 61세,2017,2520,1286,1234,104.2,2478,1269,1209,105
39020, 서귀포시,065003, 62세,2017,2381,1163,1218,95.5,2347,1143,1204,94.9
39020, 서귀포시,065004, 63세,2017,2093,1038,1055,98.4,2055,1020,1035,98.6
39020, 서귀포시,065005, 64세,2017,1744,829,915,90.6,1725,820,905,90.6
39020, 서귀포시,070,65~69세,2017,8628,4184,4444,94.1,8550,4153,4397,94.5
39020, 서귀포시,070001, 65세,2017,1867,911,956,95.3,1841,902,939,96.1
39020, 서귀포시,070002, 66세,2017,1623,825,798,103.4,1610,820,790,103.8
39020, 서귀포시,070003, 67세,2017,1610,747,863,86.6,1599,742,857,86.6
39020, 서귀포시,070004, 68세,2017,1730,821,909,90.3,1714,814,900,90.4
39020, 서귀포시,070005, 69세,2017,1798,880,918,95.9,1786,875,911,96
39020, 서귀포시,075,70~74세,2017,7305,3407,3898,87.4,7272,3388,3884,87.2
39020, 서귀포시,075001, 70세,2017,1721,837,884,94.7,1711,832,879,94.7
39020, 서귀포시,075002, 71세,2017,1449,681,768,88.7,1440,676,764,88.5
39020, 서귀포시,075003, 72세,2017,1458,683,775,88.1,1452,680,772,88.1
39020, 서귀포시,075004, 73세,2017,1364,626,738,84.8,1358,622,736,84.5
39020, 서귀포시,075005, 74세,2017,1313,580,733,79.1,1311,578,733,78.9
39020, 서귀포시,080,75~79세,2017,6653,2749,3904,70.4,6642,2745,3897,70.4
39020, 서귀포시,080001, 75세,2017,1577,694,883,78.6,1573,692,881,78.5
39020, 서귀포시,080002, 76세,2017,1440,597,843,70.8,1438,597,841,71
39020, 서귀포시,080003, 77세,2017,1271,521,750,69.5,1269,520,749,69.4
39020, 서귀포시,080004, 78세,2017,1214,500,714,70,1212,499,713,70
39020, 서귀포시,080005, 79세,2017,1151,437,714,61.2,1150,437,713,61.3
39020, 서귀포시,085,80~84세,2017,4590,1571,3019,52,4573,1564,3009,52
39020, 서귀포시,085001, 80세,2017,1069,391,678,57.7,1063,387,676,57.2
39020, 서귀포시,085002, 81세,2017,894,340,554,61.4,894,340,554,61.4
39020, 서귀포시,085003, 82세,2017,947,312,635,49.1,942,311,631,49.3
39020, 서귀포시,085004, 83세,2017,897,300,597,50.3,893,298,595,50.1
39020, 서귀포시,085005, 84세,2017,783,228,555,41.1,781,228,553,41.2
39020, 서귀포시,090,85~89세,2017,1982,427,1555,27.5,1979,426,1553,27.4
39020, 서귀포시,090001, 85세,2017,592,151,441,34.2,590,151,439,34.4
39020, 서귀포시,090002, 86세,2017,422,88,334,26.3,422,88,334,26.3
39020, 서귀포시,090003, 87세,2017,402,86,316,27.2,402,86,316,27.2
39020, 서귀포시,090004, 88세,2017,315,60,255,23.5,314,59,255,23.1
39020, 서귀포시,090005, 89세,2017,251,42,209,20.1,251,42,209,20.1
39020, 서귀포시,095,90~94세,2017,650,86,564,15.2,646,85,561,15.2
39020, 서귀포시,095001, 90세,2017,178,18,160,11.3,177,18,159,11.3
39020, 서귀포시,095002, 91세,2017,133,26,107,24.3,131,25,106,23.6
39020, 서귀포시,095003, 92세,2017,105,15,90,16.7,104,15,89,16.9
39020, 서귀포시,095004, 93세,2017,64,13,51,25.5,64,13,51,25.5
39020, 서귀포시,095005, 94세,2017,170,14,156,9,170,14,156,9
39020, 서귀포시,100,95~99세,2017,250,26,224,11.6,248,24,224,10.7
39020, 서귀포시,100001, 95세,2017,97,14,83,16.9,97,14,83,16.9
39020, 서귀포시,100002, 96세,2017,69,X,66,4.5,69,X,66,4.5
39020, 서귀포시,100003, 97세,2017,32,X,30,6.7,32,X,30,6.7
39020, 서귀포시,100004, 98세,2017,26,X,23,13,25,X,23,8.7
39020, 서귀포시,100005, 99세,2017,26,X,22,18.2,25,X,22,13.6
39020, 서귀포시,101,100세이상,2017,31,X,31,0,31,X,31,0
39020, 서귀포시,102,15세미만,2017,23498,12195,11303,107.9,23234,12070,11164,108.1
39020, 서귀포시,103,15~64세,2017,115771,61510,54261,113.4,109745,57778,51967,111.2
39020, 서귀포시,104,65세이상,2017,30089,12450,17639,70.6,29941,12385,17556,70.5
39020, 서귀포시,086,85세이상,2017,2913,539,2374,22.7,2904,535,2369,22.6
39020, 서귀포시,126,평균연령,2017,43.3,41.6,44.9,,43.6,42,45.2,
39020, 서귀포시,127,중위연령,2017,44.8,43.4,46.3,,45.5,44.3,46.8,
