C행정구역별(읍면동),행정구역별(읍면동),C연령별,연령별,시점,총인구(명),총인구_남자(명),총인구_여자(명),총인구_성비,내국인(명),내국인_남자(명),내국인_여자(명),내국인_성비
00,전국,000,합계,2021,51738071,25850044,25888027,99.9,50088104,24943537,25144567,99.2
00,전국,005,0~4세,2021,1570409,805852,764557,105.4,1536204,788406,747798,105.4
00,전국,005001, 0세,2021,268270,137541,130729,105.2,262792,134770,128022,105.3
00,전국,005002, 1세,2021,283322,145031,138291,104.9,277092,141882,135210,104.9
00,전국,005003, 2세,2021,311976,160201,151775,105.6,304854,156542,148312,105.5
00,전국,005004, 3세,2021,337520,173319,164201,105.6,330026,169456,160570,105.5
00,전국,005005, 4세,2021,369321,189760,179561,105.7,361440,185756,175684,105.7
00,전국,010,5~9세,2021,2212372,1133426,1078946,105,2180368,1117345,1063023,105.1
00,전국,010001, 5세,2021,419046,214341,204705,104.7,410637,210098,200539,104.8
00,전국,010002, 6세,2021,439867,225389,214478,105.1,432708,221771,210937,105.1
00,전국,010003, 7세,2021,434619,222501,212118,104.9,428475,219427,209048,105
00,전국,010004, 8세,2021,440419,225512,214907,104.9,435089,222868,212221,105
00,전국,010005, 9세,2021,478421,245683,232738,105.6,473459,243181,230278,105.6
00,전국,015,10~14세,2021,2304690,1186319,1118371,106.1,2286676,1177079,1109597,106.1
00,전국,015001, 10세,2021,471455,242245,229210,105.7,467364,240115,227249,105.7
00,전국,015002, 11세,2021,453823,234059,219764,106.5,450056,232127,217929,106.5
00,전국,015003, 12세,2021,439409,226486,212923,106.4,435880,224698,211182,106.4
00,전국,015004, 13세,2021,463980,238586,225394,105.9,460584,236836,223748,105.8
00,전국,015005, 14세,2021,476023,244943,231080,106,472792,243303,229489,106
00,전국,020,15~19세,2021,2313299,1198911,1114388,107.6,2288333,1187703,1100630,107.9
00,전국,020001, 15세,2021,435591,225371,210220,107.2,432771,223951,208820,107.2
00,전국,020002, 16세,2021,428825,221765,207060,107.1,426270,220511,205759,107.2
00,전국,020003, 17세,2021,467414,242392,225022,107.7,464550,240987,223563,107.8
00,전국,020004, 18세,2021,479117,248408,230709,107.7,474133,246245,227888,108.1
00,전국,020005, 19세,2021,502352,260975,241377,108.1,490609,256009,234600,109.1
00,전국,025,20~24세,2021,3223654,1681183,1542471,109,3066118,1602890,1463228,109.5
00,전국,025001, 20세,2021,581562,301949,279613,108,561097,293468,267629,109.7
00,전국,025002, 21세,2021,647713,337405,310308,108.7,619365,324609,294756,110.1
00,전국,025003, 22세,2021,633711,331828,301883,109.9,602566,316468,286098,110.6
00,전국,025004, 23세,2021,666271,347988,318283,109.3,628953,328420,300533,109.3
00,전국,025005, 24세,2021,694397,362013,332384,108.9,654137,339925,314212,108.2
00,전국,030,25~29세,2021,3663127,1954718,1708409,114.4,3439492,1822691,1616801,112.7
00,전국,030001, 25세,2021,716581,379595,336986,112.6,674507,355469,319038,111.4
00,전국,030002, 26세,2021,726778,387844,338934,114.4,682692,362162,320530,113
00,전국,030003, 27세,2021,735105,394648,340457,115.9,690853,368420,322433,114.3
00,전국,030004, 28세,2021,738497,395652,342845,115.4,692657,368233,324424,113.5
00,전국,030005, 29세,2021,746166,396979,349187,113.7,698783,368407,330376,111.5
00,전국,035,30~34세,2021,3332272,1759768,1572504,111.9,3080905,1609294,1471611,109.4
00,전국,035001, 30세,2021,704354,373597,330757,113,656408,344828,311580,110.7
00,전국,035002, 31세,2021,675917,359639,316278,113.7,624510,328812,295698,111.2
00,전국,035003, 32세,2021,657406,349145,308261,113.3,607041,318982,288059,110.7
00,전국,035004, 33세,2021,644865,339004,305861,110.8,594240,308968,285272,108.3
00,전국,035005, 34세,2021,649730,338383,311347,108.7,598706,307704,291002,105.7
00,전국,040,35~39세,2021,3622347,1877724,1744623,107.6,3408007,1748821,1659186,105.4
00,전국,040001, 35세,2021,657905,344548,313357,110,609806,315741,294065,107.4
00,전국,040002, 36세,2021,668088,348497,319591,109,623078,321371,301707,106.5
00,전국,040003, 37세,2021,696625,361136,335489,107.6,654394,335658,318736,105.3
00,전국,040004, 38세,2021,766395,395334,371061,106.5,726796,371427,355369,104.5
00,전국,040005, 39세,2021,833334,428209,405125,105.7,793933,404624,389309,103.9
00,전국,045,40~44세,2021,3981710,2038116,1943594,104.9,3831323,1949291,1882032,103.6
00,전국,045001, 40세,2021,829062,428494,400568,107,795468,408372,387096,105.5
00,전국,045002, 41세,2021,848217,433354,414863,104.5,816493,414430,402063,103.1
00,전국,045003, 42세,2021,804965,411039,393926,104.3,773379,392332,381047,103
00,전국,045004, 43세,2021,738074,378001,360073,105,709770,361502,348268,103.8
00,전국,045005, 44세,2021,761392,387228,374164,103.5,736213,372655,363558,102.5
00,전국,050,45~49세,2021,4134223,2100431,2033792,103.3,4010015,2030757,1979258,102.6
00,전국,050001, 45세,2021,746101,381818,364283,104.8,721011,367294,353717,103.8
00,전국,050002, 46세,2021,785743,397847,387896,102.6,762185,384631,377554,101.9
00,전국,050003, 47세,2021,860062,437536,422526,103.6,836248,424259,411989,103
00,전국,050004, 48세,2021,869891,437510,432381,101.2,844623,423547,421076,100.6
00,전국,050005, 49세,2021,872426,445720,426706,104.5,845948,431026,414922,103.9
00,전국,055,50~54세,2021,4477633,2243979,2233654,100.5,4350920,2177577,2173343,100.2
00,전국,055001, 50세,2021,930514,471885,458629,102.9,903172,457122,446050,102.5
00,전국,055002, 51세,2021,899019,453874,445145,102,871570,439280,432290,101.6
00,전국,055003, 52세,2021,910746,456391,454355,100.4,885135,443131,442004,100.3
00,전국,055004, 53세,2021,907800,451243,456557,98.8,882509,438076,444433,98.6
00,전국,055005, 54세,2021,829554,410586,418968,98,808534,399968,408566,97.9
00,전국,060,55~59세,2021,4097916,2064943,2032973,101.6,3976114,2004426,1971688,101.7
00,전국,060001, 55세,2021,813882,415426,398456,104.3,790809,403846,386963,104.4
00,전국,060002, 56세,2021,837827,417928,419899,99.5,812985,405440,407545,99.5
00,전국,060003, 57세,2021,777888,390396,387492,100.7,753645,378414,375231,100.8
00,전국,060004, 58세,2021,829575,419493,410082,102.3,801487,405582,395905,102.4
00,전국,060005, 59세,2021,838744,421700,417044,101.1,817188,411144,406044,101.3
00,전국,065,60~64세,2021,4097858,2016321,2081537,96.9,4013702,1975945,2037757,97
00,전국,065001, 60세,2021,907607,447384,460223,97.2,893470,440855,452615,97.4
00,전국,065002, 61세,2021,899568,439514,460054,95.5,879178,429733,449445,95.6
00,전국,065003, 62세,2021,803675,395141,408534,96.7,787304,387211,400093,96.8
00,전국,065004, 63세,2021,748006,369914,378092,97.8,731108,361761,369347,97.9
00,전국,065005, 64세,2021,739002,364368,374634,97.3,722642,356385,366257,97.3
00,전국,070,65~69세,2021,2976607,1433783,1542824,92.9,2925766,1409896,1515870,93
00,전국,070001, 65세,2021,668977,326381,342596,95.3,655713,320082,335631,95.4
00,전국,070002, 66세,2021,687752,330195,357557,92.3,675766,324433,351333,92.3
00,전국,070003, 67세,2021,572102,276735,295367,93.7,561757,271927,289830,93.8
00,전국,070004, 68세,2021,501919,239821,262098,91.5,493712,236026,257686,91.6
00,전국,070005, 69세,2021,545857,260651,285206,91.4,538818,257428,281390,91.5
00,전국,075,70~74세,2021,2089644,975415,1114229,87.5,2069571,966856,1102715,87.7
00,전국,075001, 70세,2021,399844,189116,210728,89.7,394102,186541,207561,89.9
00,전국,075002, 71세,2021,428548,201514,227034,88.8,423820,199469,224351,88.9
00,전국,075003, 72세,2021,432422,202524,229898,88.1,428265,200755,227510,88.2
00,전국,075004, 73세,2021,416571,194124,222447,87.3,413722,192959,220763,87.4
00,전국,075005, 74세,2021,412259,188137,224122,83.9,409662,187132,222530,84.1
00,전국,080,75~79세,2021,1584604,685723,898881,76.3,1576830,683137,893693,76.4
00,전국,080001, 75세,2021,308717,140944,167773,84,306651,140204,166447,84.2
00,전국,080002, 76세,2021,301410,133481,167929,79.5,299766,132895,166871,79.6
00,전국,080003, 77세,2021,305722,131271,174451,75.2,304265,130784,173481,75.4
00,전국,080004, 78세,2021,310597,131306,179291,73.2,309261,130921,178340,73.4
00,전국,080005, 79세,2021,358158,148721,209437,71,356887,148333,208554,71.1
00,전국,085,80~84세,2021,1178836,447622,731214,61.2,1173715,446293,727422,61.4
00,전국,085001, 80세,2021,281414,113525,167889,67.6,280130,113154,166976,67.8
00,전국,085002, 81세,2021,251595,97612,153983,63.4,250457,97308,153149,63.5
00,전국,085003, 82세,2021,244560,92585,151975,60.9,243545,92352,151193,61.1
00,전국,085004, 83세,2021,212641,77566,135075,57.4,211699,77353,134346,57.6
00,전국,085005, 84세,2021,188626,66334,122292,54.2,187884,66126,121758,54.3
00,전국,090,85~89세,2021,617681,189457,428224,44.2,615617,188955,426662,44.3
00,전국,090001, 85세,2021,165744,55511,110233,50.4,165098,55352,109746,50.4
00,전국,090002, 86세,2021,149902,47368,102534,46.2,149416,47243,102173,46.2
00,전국,090003, 87세,2021,121763,36762,85001,43.2,121365,36665,84700,43.3
00,전국,090004, 88세,2021,98106,27863,70243,39.7,97793,27793,70000,39.7
00,전국,090005, 89세,2021,82166,21953,60213,36.5,81945,21902,60043,36.5
00,전국,095,90~94세,2021,208758,47148,161610,29.2,208193,47024,161169,29.2
00,전국,095001, 90세,2021,60286,14828,45458,32.6,60117,14795,45322,32.6
00,전국,095002, 91세,2021,52520,11667,40853,28.6,52358,11639,40719,28.6
00,전국,095003, 92세,2021,41374,9568,31806,30.1,41265,9540,31725,30.1
00,전국,095004, 93세,2021,31573,6538,25035,26.1,31501,6513,24988,26.1
00,전국,095005, 94세,2021,23005,4547,18458,24.6,22952,4537,18415,24.6
00,전국,100,95~99세,2021,43868,8149,35719,22.8,43717,8116,35601,22.8
00,전국,100001, 95세,2021,14471,2662,11809,22.5,14430,2652,11778,22.5
00,전국,100002, 96세,2021,11143,1960,9183,21.3,11109,1954,9155,21.3
00,전국,100003, 97세,2021,7192,1441,5751,25.1,7161,1435,5726,25.1
00,전국,100004, 98세,2021,6762,1323,5439,24.3,6734,1316,5418,24.3
00,전국,100005, 99세,2021,4300,763,3537,21.6,4283,759,3524,21.5
00,전국,101,100세이상,2021,6563,1056,5507,19.2,6518,1035,5483,18.9
00,전국,102,15세미만,2021,6087471,3125597,2961874,105.5,6003248,3082830,2920418,105.6
00,전국,103,15~64세,2021,36944039,18936094,18007945,105.2,35464929,18109395,17355534,104.3
00,전국,104,65세이상,2021,8706561,3788353,4918208,77,8619927,3751312,4868615,77.1
00,전국,086,85세이상,2021,876870,245810,631060,39,874045,245130,628915,39
00,전국,126,평균연령,2021,43.5,42.3,44.7,,43.6,42.5,44.8,
00,전국,127,중위연령,2021,44.5,43.1,46,,44.9,43.6,46.3,
04,읍부,000,합계,2021,5183834,2658474,2525360,105.3,4977540,2531672,2445868,103.5
04,읍부,005,0~4세,2021,173499,88943,84556,105.2,169742,87046,82696,105.3
04,읍부,005001, 0세,2021,28286,14573,13713,106.3,27665,14258,13407,106.3
04,읍부,005002, 1세,2021,31703,16295,15408,105.8,31021,15953,15068,105.9
04,읍부,005003, 2세,2021,34861,17965,16896,106.3,34081,17554,16527,106.2
04,읍부,005004, 3세,2021,37647,19065,18582,102.6,36828,18673,18155,102.9
04,읍부,005005, 4세,2021,41002,21045,19957,105.5,40147,20608,19539,105.5
04,읍부,010,5~9세,2021,247952,127247,120705,105.4,244490,125516,118974,105.5
04,읍부,010001, 5세,2021,46513,23817,22696,104.9,45633,23376,22257,105
04,읍부,010002, 6세,2021,48854,25266,23588,107.1,48078,24872,23206,107.2
04,읍부,010003, 7세,2021,48651,24868,23783,104.6,47961,24532,23429,104.7
04,읍부,010004, 8세,2021,49681,25472,24209,105.2,49098,25173,23925,105.2
04,읍부,010005, 9세,2021,54253,27824,26429,105.3,53720,27563,26157,105.4
04,읍부,015,10~14세,2021,256517,132293,124224,106.5,254468,131258,123210,106.5
04,읍부,015001, 10세,2021,53583,27579,26004,106.1,53134,27363,25771,106.2
04,읍부,015002, 11세,2021,50846,26283,24563,107,50432,26069,24363,107
04,읍부,015003, 12세,2021,48855,25196,23659,106.5,48437,24981,23456,106.5
04,읍부,015004, 13세,2021,51456,26602,24854,107,51071,26409,24662,107.1
04,읍부,015005, 14세,2021,51777,26633,25144,105.9,51394,26436,24958,105.9
04,읍부,020,15~19세,2021,245513,128292,117221,109.4,243076,127077,115999,109.6
04,읍부,020001, 15세,2021,47269,24569,22700,108.2,46958,24404,22554,108.2
04,읍부,020002, 16세,2021,46816,24373,22443,108.6,46510,24244,22266,108.9
04,읍부,020003, 17세,2021,50718,26280,24438,107.5,50408,26119,24289,107.5
04,읍부,020004, 18세,2021,50550,26214,24336,107.7,50021,25968,24053,108
04,읍부,020005, 19세,2021,50160,26856,23304,115.2,49179,26342,22837,115.3
04,읍부,025,20~24세,2021,292784,163952,128832,127.3,275913,153985,121928,126.3
04,읍부,025001, 20세,2021,56339,30721,25618,119.9,54669,29915,24754,120.8
04,읍부,025002, 21세,2021,60997,33852,27145,124.7,58315,32465,25850,125.6
04,읍부,025003, 22세,2021,57735,32197,25538,126.1,54489,30333,24156,125.6
04,읍부,025004, 23세,2021,57936,32869,25067,131.1,53697,30253,23444,129
04,읍부,025005, 24세,2021,59777,34313,25464,134.8,54743,31019,23724,130.7
04,읍부,030,25~29세,2021,309699,179610,130089,138.1,276192,156395,119797,130.6
04,읍부,030001, 25세,2021,60601,35295,25306,139.5,54795,31264,23531,132.9
04,읍부,030002, 26세,2021,61451,35909,25542,140.6,55078,31508,23570,133.7
04,읍부,030003, 27세,2021,61443,36063,25380,142.1,54692,31326,23366,134.1
04,읍부,030004, 28세,2021,62243,35969,26274,136.9,55115,31058,24057,129.1
04,읍부,030005, 29세,2021,63961,36374,27587,131.9,56512,31239,25273,123.6
04,읍부,035,30~34세,2021,302753,167899,134854,124.5,265198,142624,122574,116.4
04,읍부,035001, 30세,2021,60978,34455,26523,129.9,53683,29506,24177,122
04,읍부,035002, 31세,2021,60450,34084,26366,129.3,52669,28818,23851,120.8
04,읍부,035003, 32세,2021,59301,33173,26128,127,51768,28101,23667,118.7
04,읍부,035004, 33세,2021,59762,32702,27060,120.8,52245,27683,24562,112.7
04,읍부,035005, 34세,2021,62262,33485,28777,116.4,54833,28516,26317,108.4
04,읍부,040,35~39세,2021,361552,192041,169511,113.3,330229,171444,158785,108
04,읍부,040001, 35세,2021,63211,33958,29253,116.1,56259,29374,26885,109.3
04,읍부,040002, 36세,2021,65602,35405,30197,117.2,58949,31028,27921,111.1
04,읍부,040003, 37세,2021,69872,37175,32697,113.7,63640,33065,30575,108.1
04,읍부,040004, 38세,2021,77190,40686,36504,111.5,71383,36811,34572,106.5
04,읍부,040005, 39세,2021,85677,44817,40860,109.7,79998,41166,38832,106
04,읍부,045,40~44세,2021,414946,217814,197132,110.5,393985,204648,189337,108.1
04,읍부,045001, 40세,2021,85408,45414,39994,113.6,80472,42250,38222,110.5
04,읍부,045002, 41세,2021,88391,46027,42364,108.6,83925,43226,40699,106.2
04,읍부,045003, 42세,2021,83711,43720,39991,109.3,79416,41032,38384,106.9
04,읍부,045004, 43세,2021,77699,40847,36852,110.8,73822,38407,35415,108.4
04,읍부,045005, 44세,2021,79737,41806,37931,110.2,76350,39733,36617,108.5
04,읍부,050,45~49세,2021,423114,223975,199139,112.5,407559,214943,192616,111.6
04,읍부,050001, 45세,2021,77237,40926,36311,112.7,73936,38926,35010,111.2
04,읍부,050002, 46세,2021,81380,42751,38629,110.7,78325,40946,37379,109.5
04,읍부,050003, 47세,2021,88498,46957,41541,113,85435,45209,40226,112.4
04,읍부,050004, 48세,2021,88456,46533,41923,111,85425,44806,40619,110.3
04,읍부,050005, 49세,2021,87543,46808,40735,114.9,84438,45056,39382,114.4
04,읍부,055,50~54세,2021,442283,232770,209513,111.1,428375,225244,203131,110.9
04,읍부,055001, 50세,2021,92757,49438,43319,114.1,89644,47682,41962,113.6
04,읍부,055002, 51세,2021,88619,47000,41619,112.9,85542,45296,40246,112.5
04,읍부,055003, 52세,2021,89970,47275,42695,110.7,87183,45802,41381,110.7
04,읍부,055004, 53세,2021,89728,46924,42804,109.6,87035,45504,41531,109.6
04,읍부,055005, 54세,2021,81209,42133,39076,107.8,78971,40960,38011,107.8
04,읍부,060,55~59세,2021,402417,210599,191818,109.8,391070,204753,186317,109.9
04,읍부,060001, 55세,2021,81456,43418,38038,114.1,79109,42211,36898,114.4
04,읍부,060002, 56세,2021,82123,42570,39553,107.6,79685,41278,38407,107.5
04,읍부,060003, 57세,2021,76044,39725,36319,109.4,73774,38550,35224,109.4
04,읍부,060004, 58세,2021,80312,41918,38394,109.2,77890,40685,37205,109.4
04,읍부,060005, 59세,2021,82482,42968,39514,108.7,80612,42029,38583,108.9
04,읍부,065,60~64세,2021,402239,203112,199127,102,395357,199757,195600,102.1
04,읍부,065001, 60세,2021,89897,45637,44260,103.1,88587,45021,43566,103.3
04,읍부,065002, 61세,2021,87759,44161,43598,101.3,86127,43374,42753,101.5
04,읍부,065003, 62세,2021,78840,39689,39151,101.4,77509,39046,38463,101.5
04,읍부,065004, 63세,2021,73103,37029,36074,102.6,71742,36340,35402,102.6
04,읍부,065005, 64세,2021,72640,36596,36044,101.5,71392,35976,35416,101.6
04,읍부,070,65~69세,2021,293061,142975,150086,95.3,289319,141153,148166,95.3
04,읍부,070001, 65세,2021,65585,32657,32928,99.2,64586,32178,32408,99.3
04,읍부,070002, 66세,2021,67228,32717,34511,94.8,66344,32274,34070,94.7
04,읍부,070003, 67세,2021,56379,27331,29048,94.1,55639,26980,28659,94.1
04,읍부,070004, 68세,2021,49308,24019,25289,95,48684,23712,24972,95
04,읍부,070005, 69세,2021,54561,26251,28310,92.7,54066,26009,28057,92.7
04,읍부,075,70~74세,2021,211989,99723,112266,88.8,210328,99016,111312,89
04,읍부,075001, 70세,2021,40640,19278,21362,90.2,40195,19077,21118,90.3
04,읍부,075002, 71세,2021,42861,20155,22706,88.8,42476,19980,22496,88.8
04,읍부,075003, 72세,2021,43982,20718,23264,89.1,43661,20585,23076,89.2
04,읍부,075004, 73세,2021,42379,19935,22444,88.8,42112,19829,22283,89
04,읍부,075005, 74세,2021,42127,19637,22490,87.3,41884,19545,22339,87.5
04,읍부,080,75~79세,2021,166538,70894,95644,74.1,165875,70655,95220,74.2
04,읍부,080001, 75세,2021,31553,14531,17022,85.4,31381,14467,16914,85.5
04,읍부,080002, 76세,2021,31192,13721,17471,78.5,31049,13669,17380,78.6
04,읍부,080003, 77세,2021,31894,13487,18407,73.3,31788,13445,18343,73.3
04,읍부,080004, 78세,2021,33243,13643,19600,69.6,33114,13598,19516,69.7
04,읍부,080005, 79세,2021,38656,15512,23144,67,38543,15476,23067,67.1
04,읍부,085,80~84세,2021,132642,48437,84205,57.5,132228,48317,83911,57.6
04,읍부,085001, 80세,2021,30812,11963,18849,63.5,30707,11928,18779,63.5
04,읍부,085002, 81세,2021,28187,10544,17643,59.8,28100,10524,17576,59.9
04,읍부,085003, 82세,2021,27844,10064,17780,56.6,27762,10041,17721,56.7
04,읍부,085004, 83세,2021,24280,8554,15726,54.4,24203,8538,15665,54.5
04,읍부,085005, 84세,2021,21519,7312,14207,51.5,21456,7286,14170,51.4
04,읍부,090,85~89세,2021,73162,21493,51669,41.6,73014,21448,51566,41.6
04,읍부,090001, 85세,2021,19299,6215,13084,47.5,19256,6200,13056,47.5
04,읍부,090002, 86세,2021,17694,5327,12367,43.1,17646,5315,12331,43.1
04,읍부,090003, 87세,2021,14496,4234,10262,41.3,14469,4223,10246,41.2
04,읍부,090004, 88세,2021,11633,3215,8418,38.2,11617,3210,8407,38.2
04,읍부,090005, 89세,2021,10040,2502,7538,33.2,10026,2500,7526,33.2
04,읍부,095,90~94세,2021,24864,5347,19517,27.4,24827,5339,19488,27.4
04,읍부,095001, 90세,2021,7174,1671,5503,30.4,7162,1668,5494,30.4
04,읍부,095002, 91세,2021,6307,1347,4960,27.2,6301,1346,4955,27.2
04,읍부,095003, 92세,2021,4940,1095,3845,28.5,4930,1094,3836,28.5
04,읍부,095004, 93세,2021,3691,732,2959,24.7,3684,729,2955,24.7
04,읍부,095005, 94세,2021,2752,502,2250,22.3,2750,502,2248,22.3
04,읍부,100,95~99세,2021,5496,934,4562,20.5,5483,932,4551,20.5
04,읍부,100001, 95세,2021,1790,304,1486,20.5,1786,303,1483,20.4
04,읍부,100002, 96세,2021,1413,228,1185,19.2,1407,227,1180,19.2
04,읍부,100003, 97세,2021,868,179,689,26,867,179,688,26
04,읍부,100004, 98세,2021,887,139,748,18.6,885,139,746,18.6
04,읍부,100005, 99세,2021,538,84,454,18.5,538,84,454,18.5
04,읍부,101,100세이상,2021,814,124,690,18,812,122,690,17.7
04,읍부,102,15세미만,2021,677968,348483,329485,105.8,668700,343820,324880,105.8
04,읍부,103,15~64세,2021,3597300,1920064,1677236,114.5,3406954,1800870,1606084,112.1
04,읍부,104,65세이상,2021,908566,389927,518639,75.2,901886,386982,514904,75.2
04,읍부,086,85세이상,2021,104336,27898,76438,36.5,104136,27841,76295,36.5
04,읍부,126,평균연령,2021,43.6,42.2,45,,43.8,42.4,45.2,
04,읍부,127,중위연령,2021,44.8,43.3,46.5,,45.5,44.1,46.9,
05,면부,000,합계,2021,4534456,2352247,2182209,107.8,4292808,2182704,2110104,103.4
05,면부,005,0~4세,2021,93238,47524,45714,104,91319,46605,44714,104.2
05,면부,005001, 0세,2021,16054,8175,7879,103.8,15679,8002,7677,104.2
05,면부,005002, 1세,2021,17344,8854,8490,104.3,16968,8656,8312,104.1
05,면부,005003, 2세,2021,18734,9550,9184,104,18371,9375,8996,104.2
05,면부,005004, 3세,2021,19940,10131,9809,103.3,19538,9951,9587,103.8
05,면부,005005, 4세,2021,21166,10814,10352,104.5,20763,10621,10142,104.7
05,면부,010,5~9세,2021,125054,64400,60654,106.2,123309,63544,59765,106.3
05,면부,010001, 5세,2021,23583,12090,11493,105.2,23109,11865,11244,105.5
05,면부,010002, 6세,2021,24331,12514,11817,105.9,23946,12327,11619,106.1
05,면부,010003, 7세,2021,24607,12584,12023,104.7,24296,12420,11876,104.6
05,면부,010004, 8세,2021,25302,13077,12225,107,25014,12933,12081,107.1
05,면부,010005, 9세,2021,27231,14135,13096,107.9,26944,13999,12945,108.1
05,면부,015,10~14세,2021,131219,68466,62753,109.1,130115,67902,62213,109.1
05,면부,015001, 10세,2021,27325,14332,12993,110.3,27080,14217,12863,110.5
05,면부,015002, 11세,2021,26019,13490,12529,107.7,25793,13382,12411,107.8
05,면부,015003, 12세,2021,24737,12902,11835,109,24533,12789,11744,108.9
05,면부,015004, 13세,2021,26434,13765,12669,108.7,26200,13645,12555,108.7
05,면부,015005, 14세,2021,26704,13977,12727,109.8,26509,13869,12640,109.7
05,면부,020,15~19세,2021,138641,74497,64144,116.1,136821,73543,63278,116.2
05,면부,020001, 15세,2021,24600,12971,11629,111.5,24432,12890,11542,111.7
05,면부,020002, 16세,2021,25433,13403,12030,111.4,25277,13313,11964,111.3
05,면부,020003, 17세,2021,28370,15109,13261,113.9,28178,15021,13157,114.2
05,면부,020004, 18세,2021,28502,15275,13227,115.5,28096,15054,13042,115.4
05,면부,020005, 19세,2021,31736,17739,13997,126.7,30838,17265,13573,127.2
05,면부,025,20~24세,2021,194940,117263,77677,151,173868,103006,70862,145.4
05,면부,025001, 20세,2021,35159,20154,15005,134.3,33702,19363,14339,135
05,면부,025002, 21세,2021,38174,22027,16147,136.4,35772,20602,15170,135.8
05,면부,025003, 22세,2021,38040,22864,15176,150.7,34368,20424,13944,146.5
05,면부,025004, 23세,2021,40517,25154,15363,163.7,34591,21045,13546,155.4
05,면부,025005, 24세,2021,43050,27064,15986,169.3,35435,21572,13863,155.6
05,면부,030,25~29세,2021,228286,146419,81867,178.8,177340,107715,69625,154.7
05,면부,030001, 25세,2021,44035,28270,15765,179.3,35104,21542,13562,158.8
05,면부,030002, 26세,2021,45205,29155,16050,181.7,35245,21619,13626,158.7
05,면부,030003, 27세,2021,45901,29550,16351,180.7,35640,21744,13896,156.5
05,면부,030004, 28세,2021,46279,29667,16612,178.6,35539,21541,13998,153.9
05,면부,030005, 29세,2021,46866,29777,17089,174.2,35812,21269,14543,146.2
05,면부,035,30~34세,2021,217383,133917,83466,160.4,165441,94574,70867,133.5
05,면부,035001, 30세,2021,44704,28065,16639,168.7,33880,19806,14074,140.7
05,면부,035002, 31세,2021,44809,27947,16862,165.7,33721,19631,14090,139.3
05,면부,035003, 32세,2021,42963,26732,16231,164.7,32578,18742,13836,135.5
05,면부,035004, 33세,2021,42414,25749,16665,154.5,32376,18248,14128,129.2
05,면부,035005, 34세,2021,42493,25424,17069,148.9,32886,18147,14739,123.1
05,면부,040,35~39세,2021,228725,134621,94104,143.1,189576,105388,84188,125.2
05,면부,040001, 35세,2021,42384,25450,16934,150.3,33499,18759,14740,127.3
05,면부,040002, 36세,2021,42712,25357,17355,146.1,34187,18968,15219,124.6
05,면부,040003, 37세,2021,44202,25941,18261,142.1,36480,20189,16291,123.9
05,면부,040004, 38세,2021,47796,27933,19863,140.6,40658,22572,18086,124.8
05,면부,040005, 39세,2021,51631,29940,21691,138,44752,24900,19852,125.4
05,면부,045,40~44세,2021,243646,141789,101857,139.2,218999,124312,94687,131.3
05,면부,045001, 40세,2021,50069,29133,20936,139.2,44139,24818,19321,128.5
05,면부,045002, 41세,2021,51777,29992,21785,137.7,46203,26011,20192,128.8
05,면부,045003, 42세,2021,48850,28442,20408,139.4,43792,24843,18949,131.1
05,면부,045004, 43세,2021,45747,26816,18931,141.7,41497,23860,17637,135.3
05,면부,045005, 44세,2021,47203,27406,19797,138.4,43368,24780,18588,133.3
05,면부,050,45~49세,2021,269700,155898,113802,137,253785,145511,108274,134.4
05,면부,050001, 45세,2021,47257,27738,19519,142.1,43566,25179,18387,136.9
05,면부,050002, 46세,2021,50204,29088,21116,137.8,46935,26949,19986,134.8
05,면부,050003, 47세,2021,56033,32521,23512,138.3,52931,30527,22404,136.3
05,면부,050004, 48세,2021,57949,33048,24901,132.7,55096,31235,23861,130.9
05,면부,050005, 49세,2021,58257,33503,24754,135.3,55257,31621,23636,133.8
05,면부,055,50~54세,2021,346591,189999,156592,121.3,334508,183021,151487,120.8
05,면부,055001, 50세,2021,64976,36862,28114,131.1,62225,35190,27035,130.2
05,면부,055002, 51세,2021,64827,36191,28636,126.4,62247,34679,27568,125.8
05,면부,055003, 52세,2021,70797,38858,31939,121.7,68342,37477,30865,121.4
05,면부,055004, 53세,2021,74155,39949,34206,116.8,71801,38617,33184,116.4
05,면부,055005, 54세,2021,71836,38139,33697,113.2,69893,37058,32835,112.9
05,면부,060,55~59세,2021,403031,214676,188355,114,393719,209715,184004,114
05,면부,060001, 55세,2021,74556,40678,33878,120.1,72629,39634,32995,120.1
05,면부,060002, 56세,2021,79758,42724,37034,115.4,77776,41657,36119,115.3
05,면부,060003, 57세,2021,75504,39691,35813,110.8,73651,38728,34923,110.9
05,면부,060004, 58세,2021,83179,44147,39032,113.1,81138,43049,38089,113
05,면부,060005, 59세,2021,90034,47436,42598,111.4,88525,46647,41878,111.4
05,면부,065,60~64세,2021,493071,254316,238755,106.5,487758,251559,236199,106.5
05,면부,065001, 60세,2021,104748,54015,50733,106.5,103717,53490,50227,106.5
05,면부,065002, 61세,2021,106272,54096,52176,103.7,104991,53422,51569,103.6
05,면부,065003, 62세,2021,96689,49731,46958,105.9,95647,49210,46437,106
05,면부,065004, 63세,2021,92249,47930,44319,108.1,91217,47378,43839,108.1
05,면부,065005, 64세,2021,93113,48544,44569,108.9,92186,48059,44127,108.9
05,면부,070,65~69세,2021,400174,202402,197772,102.3,397471,201068,196403,102.4
05,면부,070001, 65세,2021,86805,44813,41992,106.7,86090,44452,41638,106.8
05,면부,070002, 66세,2021,89998,45567,44431,102.6,89334,45240,44094,102.6
05,면부,070003, 67세,2021,77588,39193,38395,102.1,77050,38927,38123,102.1
05,면부,070004, 68세,2021,68212,34234,33978,100.8,67784,34019,33765,100.8
05,면부,070005, 69세,2021,77571,38595,38976,99,77213,38430,38783,99.1
05,면부,075,70~74세,2021,310931,151270,159661,94.7,309833,150754,159079,94.8
05,면부,075001, 70세,2021,58364,28539,29825,95.7,58091,28404,29687,95.7
05,면부,075002, 71세,2021,62749,30621,32128,95.3,62484,30498,31986,95.3
05,면부,075003, 72세,2021,64225,31695,32530,97.4,63995,31589,32406,97.5
05,면부,075004, 73세,2021,62586,30576,32010,95.5,62395,30485,31910,95.5
05,면부,075005, 74세,2021,63007,29839,33168,90,62868,29778,33090,90
05,면부,080,75~79세,2021,269041,113196,155845,72.6,268593,113024,155569,72.7
05,면부,080001, 75세,2021,46483,21795,24688,88.3,46353,21736,24617,88.3
05,면부,080002, 76세,2021,48262,21144,27118,78,48167,21111,27056,78
05,면부,080003, 77세,2021,51097,21118,29979,70.4,51013,21083,29930,70.4
05,면부,080004, 78세,2021,54783,22162,32621,67.9,54709,22138,32571,68
05,면부,080005, 79세,2021,68416,26977,41439,65.1,68351,26956,41395,65.1
05,면부,085,80~84세,2021,242236,87457,154779,56.5,241948,87369,154579,56.5
05,면부,085001, 80세,2021,54451,20961,33490,62.6,54378,20943,33435,62.6
05,면부,085002, 81세,2021,50198,18571,31627,58.7,50137,18548,31589,58.7
05,면부,085003, 82세,2021,51161,18423,32738,56.3,51108,18408,32700,56.3
05,면부,085004, 83세,2021,45089,15556,29533,52.7,45028,15539,29489,52.7
05,면부,085005, 84세,2021,41337,13946,27391,50.9,41297,13931,27366,50.9
05,면부,090,85~89세,2021,140777,41704,99073,42.1,140680,41671,99009,42.1
05,면부,090001, 85세,2021,37077,12091,24986,48.4,37061,12085,24976,48.4
05,면부,090002, 86세,2021,34057,10354,23703,43.7,34034,10347,23687,43.7
05,면부,090003, 87세,2021,28140,8178,19962,41,28115,8168,19947,40.9
05,면부,090004, 88세,2021,22677,6165,16512,37.3,22654,6158,16496,37.3
05,면부,090005, 89세,2021,18826,4916,13910,35.3,18816,4913,13903,35.3
05,면부,095,90~94세,2021,46720,10362,36358,28.5,46685,10355,36330,28.5
05,면부,095001, 90세,2021,13871,3371,10500,32.1,13863,3369,10494,32.1
05,면부,095002, 91세,2021,11822,2524,9298,27.1,11809,2521,9288,27.1
05,면부,095003, 92세,2021,9082,2036,7046,28.9,9076,2035,7041,28.9
05,면부,095004, 93세,2021,6963,1410,5553,25.4,6958,1409,5549,25.4
05,면부,095005, 94세,2021,4982,1021,3961,25.8,4979,1021,3958,25.8
05,면부,100,95~99세,2021,9621,1857,7764,23.9,9612,1856,7756,23.9
05,면부,100001, 95세,2021,3233,611,2622,23.3,3231,611,2620,23.3
05,면부,100002, 96세,2021,2425,473,1952,24.2,2423,473,1950,24.3
05,면부,100003, 97세,2021,1572,321,1251,25.7,1572,321,1251,25.7
05,면부,100004, 98세,2021,1472,297,1175,25.3,1469,296,1173,25.2
05,면부,100005, 99세,2021,919,155,764,20.3,917,155,762,20.3
05,면부,101,100세이상,2021,1431,214,1217,17.6,1428,212,1216,17.4
05,면부,102,15세미만,2021,349511,180390,169121,106.7,344743,178051,166692,106.8
05,면부,103,15~64세,2021,2764014,1563395,1200619,130.2,2531815,1398344,1133471,123.4
05,면부,104,65세이상,2021,1420931,608462,812469,74.9,1416250,606309,809941,74.9
05,면부,086,85세이상,2021,198549,54137,144412,37.5,198405,54094,144311,37.5
05,면부,126,평균연령,2021,51.8,49.3,54.6,,52.7,50.4,55.2,
05,면부,127,중위연령,2021,55.7,52.5,59.1,,57,54.4,59.8,
03,동부,000,합계,2021,42019781,20839323,21180458,98.4,40817756,20229161,20588595,98.3
03,동부,005,0~4세,2021,1303672,669385,634287,105.5,1275143,654755,620388,105.5
03,동부,005001, 0세,2021,223930,114793,109137,105.2,219448,112510,106938,105.2
03,동부,005002, 1세,2021,234275,119882,114393,104.8,229103,117273,111830,104.9
03,동부,005003, 2세,2021,258381,132686,125695,105.6,252402,129613,122789,105.6
03,동부,005004, 3세,2021,279933,144123,135810,106.1,273660,140832,132828,106
03,동부,005005, 4세,2021,307153,157901,149252,105.8,300530,154527,146003,105.8
03,동부,010,5~9세,2021,1839366,941779,897587,104.9,1812569,928285,884284,105
03,동부,010001, 5세,2021,348950,178434,170516,104.6,341895,174857,167038,104.7
03,동부,010002, 6세,2021,366682,187609,179073,104.8,360684,184572,176112,104.8
03,동부,010003, 7세,2021,361361,185049,176312,105,356218,182475,173743,105
03,동부,010004, 8세,2021,365436,186963,178473,104.8,360977,184762,176215,104.9
03,동부,010005, 9세,2021,396937,203724,193213,105.4,392795,201619,191176,105.5
03,동부,015,10~14세,2021,1916954,985560,931394,105.8,1902093,977919,924174,105.8
03,동부,015001, 10세,2021,390547,200334,190213,105.3,387150,198535,188615,105.3
03,동부,015002, 11세,2021,376958,194286,182672,106.4,373831,192676,181155,106.4
03,동부,015003, 12세,2021,365817,188388,177429,106.2,362910,186928,175982,106.2
03,동부,015004, 13세,2021,386090,198219,187871,105.5,383313,196782,186531,105.5
03,동부,015005, 14세,2021,397542,204333,193209,105.8,394889,202998,191891,105.8
03,동부,020,15~19세,2021,1929145,996122,933023,106.8,1908436,987083,921353,107.1
03,동부,020001, 15세,2021,363722,187831,175891,106.8,361381,186657,174724,106.8
03,동부,020002, 16세,2021,356576,183989,172587,106.6,354483,182954,171529,106.7
03,동부,020003, 17세,2021,388326,201003,187323,107.3,385964,199847,186117,107.4
03,동부,020004, 18세,2021,400065,206919,193146,107.1,396016,205223,190793,107.6
03,동부,020005, 19세,2021,420456,216380,204076,106,410592,212402,198190,107.2
03,동부,025,20~24세,2021,2735930,1399968,1335962,104.8,2616337,1345899,1270438,105.9
03,동부,025001, 20세,2021,490064,251074,238990,105.1,472726,244190,228536,106.8
03,동부,025002, 21세,2021,548542,281526,267016,105.4,525278,271542,253736,107
03,동부,025003, 22세,2021,537936,276767,261169,106,513709,265711,247998,107.1
03,동부,025004, 23세,2021,567818,289965,277853,104.4,540665,277122,263543,105.2
03,동부,025005, 24세,2021,591570,300636,290934,103.3,563959,287334,276625,103.9
03,동부,030,25~29세,2021,3125142,1628689,1496453,108.8,2985960,1558581,1427379,109.2
03,동부,030001, 25세,2021,611945,316030,295915,106.8,584608,302663,281945,107.3
03,동부,030002, 26세,2021,620122,322780,297342,108.6,592369,309035,283334,109.1
03,동부,030003, 27세,2021,627761,329035,298726,110.1,600521,315350,285171,110.6
03,동부,030004, 28세,2021,629975,330016,299959,110,602003,315634,286369,110.2
03,동부,030005, 29세,2021,635339,330828,304511,108.6,606459,315899,290560,108.7
03,동부,035,30~34세,2021,2812136,1457952,1354184,107.7,2650266,1372096,1278170,107.3
03,동부,035001, 30세,2021,598672,311077,287595,108.2,568845,295516,273329,108.1
03,동부,035002, 31세,2021,570658,297608,273050,109,538120,280363,257757,108.8
03,동부,035003, 32세,2021,555142,289240,265902,108.8,522695,272139,250556,108.6
03,동부,035004, 33세,2021,542689,280553,262136,107,509619,263037,246582,106.7
03,동부,035005, 34세,2021,544975,279474,265501,105.3,510987,261041,249946,104.4
03,동부,040,35~39세,2021,3032070,1551062,1481008,104.7,2888202,1471989,1416213,103.9
03,동부,040001, 35세,2021,552310,285140,267170,106.7,520048,267608,252440,106
03,동부,040002, 36세,2021,559774,287735,272039,105.8,529942,271375,258567,105
03,동부,040003, 37세,2021,582551,298020,284531,104.7,554274,282404,271870,103.9
03,동부,040004, 38세,2021,641409,326715,314694,103.8,614755,312044,302711,103.1
03,동부,040005, 39세,2021,696026,353452,342574,103.2,669183,338558,330625,102.4
03,동부,045,40~44세,2021,3323118,1678513,1644605,102.1,3218339,1620331,1598008,101.4
03,동부,045001, 40세,2021,693585,353947,339638,104.2,670857,341304,329553,103.6
03,동부,045002, 41세,2021,708049,357335,350714,101.9,686365,345193,341172,101.2
03,동부,045003, 42세,2021,672404,338877,333527,101.6,650171,326457,323714,100.8
03,동부,045004, 43세,2021,614628,310338,304290,102,594451,299235,295216,101.4
03,동부,045005, 44세,2021,634452,318016,316436,100.5,616495,308142,308353,99.9
03,동부,050,45~49세,2021,3441409,1720558,1720851,100,3348671,1670303,1678368,99.5
03,동부,050001, 45세,2021,621607,313154,308453,101.5,603509,303189,300320,101
03,동부,050002, 46세,2021,654159,326008,328151,99.3,636925,316736,320189,98.9
03,동부,050003, 47세,2021,715531,358058,357473,100.2,697882,348523,349359,99.8
03,동부,050004, 48세,2021,723486,357929,365557,97.9,704102,347506,356596,97.5
03,동부,050005, 49세,2021,726626,365409,361217,101.2,706253,354349,351904,100.7
03,동부,055,50~54세,2021,3688759,1821210,1867549,97.5,3588037,1769312,1818725,97.3
03,동부,055001, 50세,2021,772781,385585,387196,99.6,751303,374250,377053,99.3
03,동부,055002, 51세,2021,745573,370683,374890,98.9,723781,359305,364476,98.6
03,동부,055003, 52세,2021,749979,370258,379721,97.5,729610,359852,369758,97.3
03,동부,055004, 53세,2021,743917,364370,379547,96,723673,353955,369718,95.7
03,동부,055005, 54세,2021,676509,330314,346195,95.4,659670,321950,337720,95.3
03,동부,060,55~59세,2021,3292468,1639668,1652800,99.2,3191325,1589958,1601367,99.3
03,동부,060001, 55세,2021,657870,331330,326540,101.5,639071,322001,317070,101.6
03,동부,060002, 56세,2021,675946,332634,343312,96.9,655524,322505,333019,96.8
03,동부,060003, 57세,2021,626340,310980,315360,98.6,606220,301136,305084,98.7
03,동부,060004, 58세,2021,666084,333428,332656,100.2,642459,321848,320611,100.4
03,동부,060005, 59세,2021,666228,331296,334932,98.9,648051,322468,325583,99
03,동부,065,60~64세,2021,3202548,1558893,1643655,94.8,3130587,1524629,1605958,94.9
03,동부,065001, 60세,2021,712962,347732,365230,95.2,701166,342344,358822,95.4
03,동부,065002, 61세,2021,705537,341257,364280,93.7,688060,332937,355123,93.8
03,동부,065003, 62세,2021,628146,305721,322425,94.8,614148,298955,315193,94.8
03,동부,065004, 63세,2021,582654,284955,297699,95.7,568149,278043,290106,95.8
03,동부,065005, 64세,2021,573249,279228,294021,95,559064,272350,286714,95
03,동부,070,65~69세,2021,2283372,1088406,1194966,91.1,2238976,1067675,1171301,91.2
03,동부,070001, 65세,2021,516587,248911,267676,93,505037,243452,261585,93.1
03,동부,070002, 66세,2021,530526,251911,278615,90.4,520088,246919,273169,90.4
03,동부,070003, 67세,2021,438135,210211,227924,92.2,429068,206020,223048,92.4
03,동부,070004, 68세,2021,384399,181568,202831,89.5,377244,178295,198949,89.6
03,동부,070005, 69세,2021,413725,195805,217920,89.9,407539,192989,214550,90
03,동부,075,70~74세,2021,1566724,724422,842302,86,1549410,717086,832324,86.2
03,동부,075001, 70세,2021,300840,141299,159541,88.6,295816,139060,156756,88.7
03,동부,075002, 71세,2021,322938,150738,172200,87.5,318860,148991,169869,87.7
03,동부,075003, 72세,2021,324215,150111,174104,86.2,320609,148581,172028,86.4
03,동부,075004, 73세,2021,311606,143613,167993,85.5,309215,142645,166570,85.6
03,동부,075005, 74세,2021,307125,138661,168464,82.3,304910,137809,167101,82.5
03,동부,080,75~79세,2021,1149025,501633,647392,77.5,1142362,499458,642904,77.7
03,동부,080001, 75세,2021,230681,104618,126063,83,228917,104001,124916,83.3
03,동부,080002, 76세,2021,221956,98616,123340,80,220550,98115,122435,80.1
03,동부,080003, 77세,2021,222731,96666,126065,76.7,221464,96256,125208,76.9
03,동부,080004, 78세,2021,222571,95501,127070,75.2,221438,95185,126253,75.4
03,동부,080005, 79세,2021,251086,106232,144854,73.3,249993,105901,144092,73.5
03,동부,085,80~84세,2021,803958,311728,492230,63.3,799539,310607,488932,63.5
03,동부,085001, 80세,2021,196151,80601,115550,69.8,195045,80283,114762,70
03,동부,085002, 81세,2021,173210,68497,104713,65.4,172220,68236,103984,65.6
03,동부,085003, 82세,2021,165555,64098,101457,63.2,164675,63903,100772,63.4
03,동부,085004, 83세,2021,143272,53456,89816,59.5,142468,53276,89192,59.7
03,동부,085005, 84세,2021,125770,45076,80694,55.9,125131,44909,80222,56
03,동부,090,85~89세,2021,403742,126260,277482,45.5,401923,125836,276087,45.6
03,동부,090001, 85세,2021,109368,37205,72163,51.6,108781,37067,71714,51.7
03,동부,090002, 86세,2021,98151,31687,66464,47.7,97736,31581,66155,47.7
03,동부,090003, 87세,2021,79127,24350,54777,44.5,78781,24274,54507,44.5
03,동부,090004, 88세,2021,63796,18483,45313,40.8,63522,18425,45097,40.9
03,동부,090005, 89세,2021,53300,14535,38765,37.5,53103,14489,38614,37.5
03,동부,095,90~94세,2021,137174,31439,105735,29.7,136681,31330,105351,29.7
03,동부,095001, 90세,2021,39241,9786,29455,33.2,39092,9758,29334,33.3
03,동부,095002, 91세,2021,34391,7796,26595,29.3,34248,7772,26476,29.4
03,동부,095003, 92세,2021,27352,6437,20915,30.8,27259,6411,20848,30.8
03,동부,095004, 93세,2021,20919,4396,16523,26.6,20859,4375,16484,26.5
03,동부,095005, 94세,2021,15271,3024,12247,24.7,15223,3014,12209,24.7
03,동부,100,95~99세,2021,28751,5358,23393,22.9,28622,5328,23294,22.9
03,동부,100001, 95세,2021,9448,1747,7701,22.7,9413,1738,7675,22.6
03,동부,100002, 96세,2021,7305,1259,6046,20.8,7279,1254,6025,20.8
03,동부,100003, 97세,2021,4752,941,3811,24.7,4722,935,3787,24.7
03,동부,100004, 98세,2021,4403,887,3516,25.2,4380,881,3499,25.2
03,동부,100005, 99세,2021,2843,524,2319,22.6,2828,520,2308,22.5
03,동부,101,100세이상,2021,4318,718,3600,19.9,4278,701,3577,19.6
03,동부,102,15세미만,2021,5059992,2596724,2463268,105.4,4989805,2560959,2428846,105.4
03,동부,103,15~64세,2021,30582725,15452635,15130090,102.1,29526160,14910181,14615979,102
03,동부,104,65세이상,2021,6377064,2789964,3587100,77.8,6301791,2758021,3543770,77.8
03,동부,086,85세이상,2021,573985,163775,410210,39.9,571504,163195,408309,40
03,동부,126,평균연령,2021,42.6,41.5,43.6,,42.7,41.6,43.7,
03,동부,127,중위연령,2021,43.4,42.2,44.6,,43.6,42.4,44.9,
11,서울특별시,000,합계,2021,9472127,4584251,4887876,93.8,9125047,4421687,4703360,94
11,서울특별시,005,0~4세,2021,250141,128920,121221,106.4,243382,125436,117946,106.4
11,서울특별시,005001, 0세,2021,45996,23703,22293,106.3,45069,23222,21847,106.3
11,서울특별시,005002, 1세,2021,46043,23736,22307,106.4,44967,23180,21787,106.4
11,서울특별시,005003, 2세,2021,49774,25871,23903,108.2,48386,25146,23240,108.2
11,서울특별시,005004, 3세,2021,52027,26958,25069,107.5,50504,26183,24321,107.7
11,서울특별시,005005, 4세,2021,56301,28652,27649,103.6,54456,27705,26751,103.6
11,서울특별시,010,5~9세,2021,331179,169694,161485,105.1,323578,165820,157758,105.1
11,서울특별시,010001, 5세,2021,63685,32565,31120,104.6,61704,31540,30164,104.6
11,서울특별시,010002, 6세,2021,66005,33727,32278,104.5,64261,32835,31426,104.5
11,서울특별시,010003, 7세,2021,64811,33194,31617,105,63425,32495,30930,105.1
11,서울특별시,010004, 8세,2021,65617,33750,31867,105.9,64330,33107,31223,106
11,서울특별시,010005, 9세,2021,71061,36458,34603,105.4,69858,35843,34015,105.4
11,서울특별시,015,10~14세,2021,351446,180642,170804,105.8,347167,178449,168718,105.8
11,서울특별시,015001, 10세,2021,69685,35737,33948,105.3,68710,35232,33478,105.2
11,서울특별시,015002, 11세,2021,68431,35195,33236,105.9,67573,34753,32820,105.9
11,서울특별시,015003, 12세,2021,66819,34314,32505,105.6,65996,33893,32103,105.6
11,서울특별시,015004, 13세,2021,72020,37061,34959,106,71191,36644,34547,106.1
11,서울특별시,015005, 14세,2021,74491,38335,36156,106,73697,37927,35770,106
11,서울특별시,020,15~19세,2021,382368,192797,189571,101.7,375229,190154,185075,102.7
11,서울특별시,020001, 15세,2021,69002,35724,33278,107.4,68311,35360,32951,107.3
11,서울특별시,020002, 16세,2021,68088,35194,32894,107,67462,34878,32584,107
11,서울특별시,020003, 17세,2021,75245,38594,36651,105.3,74424,38206,36218,105.5
11,서울특별시,020004, 18세,2021,78728,39616,39112,101.3,77188,39092,38096,102.6
11,서울특별시,020005, 19세,2021,91305,43669,47636,91.7,87844,42618,45226,94.2
11,서울특별시,025,20~24세,2021,638048,293222,344826,85,599600,280267,319333,87.8
11,서울특별시,025001, 20세,2021,107565,50278,57287,87.8,101620,48458,53162,91.2
11,서울특별시,025002, 21세,2021,121590,56104,65486,85.7,114013,53665,60348,88.9
11,서울특별시,025003, 22세,2021,123652,57261,66391,86.2,115996,54686,61310,89.2
11,서울특별시,025004, 23세,2021,137480,62717,74763,83.9,128757,59620,69137,86.2
11,서울특별시,025005, 24세,2021,147761,66862,80899,82.6,139214,63838,75376,84.7
11,서울특별시,030,25~29세,2021,832518,402877,429641,93.8,795367,388194,407173,95.3
11,서울특별시,030001, 25세,2021,157958,73301,84657,86.6,149895,70387,79508,88.5
11,서울특별시,030002, 26세,2021,163311,78268,85043,92,155562,75327,80235,93.9
11,서울특별시,030003, 27세,2021,169366,82703,86663,95.4,162159,79874,82285,97.1
11,서울특별시,030004, 28세,2021,170488,84145,86343,97.5,163383,81164,82219,98.7
11,서울특별시,030005, 29세,2021,171395,84460,86935,97.2,164368,81442,82926,98.2
11,서울특별시,035,30~34세,2021,736967,367728,369239,99.6,699372,349939,349433,100.1
11,서울특별시,035001, 30세,2021,161835,80159,81676,98.1,154777,76986,77791,99
11,서울특별시,035002, 31세,2021,151666,75886,75780,100.1,143925,72285,71640,100.9
11,서울특별시,035003, 32세,2021,145375,72886,72489,100.5,137815,69393,68422,101.4
11,서울특별시,035004, 33세,2021,140505,70182,70323,99.8,133035,66553,66482,100.1
11,서울특별시,035005, 34세,2021,137586,68615,68971,99.5,129820,64722,65098,99.4
11,서울특별시,040,35~39세,2021,706701,355541,351160,101.2,673812,338518,335294,101
11,서울특별시,040001, 35세,2021,136114,68498,67616,101.3,128780,64710,64070,101
11,서울특별시,040002, 36세,2021,135121,68134,66987,101.7,128423,64678,63745,101.5
11,서울특별시,040003, 37세,2021,136338,68596,67742,101.3,129931,65282,64649,101
11,서울특별시,040004, 38세,2021,145460,73258,72202,101.5,139269,70072,69197,101.3
11,서울특별시,040005, 39세,2021,153668,77055,76613,100.6,147409,73776,73633,100.2
11,서울특별시,045,40~44세,2021,714467,356604,357863,99.6,688927,342895,346032,99.1
11,서울특별시,045001, 40세,2021,151641,76862,74779,102.8,146365,74120,72245,102.6
11,서울특별시,045002, 41세,2021,152438,76023,76415,99.5,147276,73261,74015,99
11,서울특별시,045003, 42세,2021,144714,71996,72718,99,139333,69075,70258,98.3
11,서울특별시,045004, 43세,2021,130329,64908,65421,99.2,125135,62062,63073,98.4
11,서울특별시,045005, 44세,2021,135345,66815,68530,97.5,130818,64377,66441,96.9
11,서울특별시,050,45~49세,2021,736451,365576,370875,98.6,710486,351502,358984,97.9
11,서울특별시,050001, 45세,2021,133035,66350,66685,99.5,128298,63770,64528,98.8
11,서울특별시,050002, 46세,2021,139080,68958,70122,98.3,134497,66479,68018,97.7
11,서울특별시,050003, 47세,2021,151595,75383,76212,98.9,146631,72693,73938,98.3
11,서울특별시,050004, 48세,2021,154888,76136,78752,96.7,149284,73067,76217,95.9
11,서울특별시,050005, 49세,2021,157853,78749,79104,99.6,151776,75493,76283,99
11,서울특별시,055,50~54세,2021,789330,385892,403438,95.7,756912,369219,387693,95.2
11,서울특별시,055001, 50세,2021,168054,83231,84823,98.1,161385,79750,81635,97.7
11,서울특별시,055002, 51세,2021,161069,79169,81900,96.7,154242,75674,78568,96.3
11,서울특별시,055003, 52세,2021,160677,78830,81847,96.3,154068,75395,78673,95.8
11,서울특별시,055004, 53세,2021,156537,75921,80616,94.2,149861,72465,77396,93.6
11,서울특별시,055005, 54세,2021,142993,68741,74252,92.6,137356,65935,71421,92.3
11,서울특별시,060,55~59세,2021,712584,348429,364155,95.7,675899,330108,345791,95.5
11,서울특별시,060001, 55세,2021,138128,68779,69349,99.2,131642,65490,66152,99
11,서울특별시,060002, 56세,2021,145089,70093,74996,93.5,137910,66501,71409,93.1
11,서울특별시,060003, 57세,2021,138228,67188,71040,94.6,130832,63539,67293,94.4
11,서울특별시,060004, 58세,2021,146479,71671,74808,95.8,137666,67276,70390,95.6
11,서울특별시,060005, 59세,2021,144660,70698,73962,95.6,137849,67302,70547,95.4
11,서울특별시,065,60~64세,2021,725537,343100,382437,89.7,698385,329934,368451,89.5
11,서울특별시,065001, 60세,2021,153329,72626,80703,90,149036,70640,78396,90.1
11,서울특별시,065002, 61세,2021,157275,73800,83475,88.4,150764,70639,80125,88.2
11,서울특별시,065003, 62세,2021,143367,68028,75339,90.3,138066,65398,72668,90
11,서울특별시,065004, 63세,2021,136068,64650,71418,90.5,130502,61977,68525,90.4
11,서울특별시,065005, 64세,2021,135498,63996,71502,89.5,130017,61280,68737,89.2
11,서울특별시,070,65~69세,2021,559016,261152,297864,87.7,542479,253206,289273,87.5
11,서울특별시,070001, 65세,2021,123660,58032,65628,88.4,119377,55975,63402,88.3
11,서울특별시,070002, 66세,2021,129798,60167,69631,86.4,125853,58223,67630,86.1
11,서울특별시,070003, 67세,2021,107807,50545,57262,88.3,104430,48935,55495,88.2
11,서울특별시,070004, 68세,2021,95693,44644,51049,87.5,93034,43385,49649,87.4
11,서울특별시,070005, 69세,2021,102058,47764,54294,88,99785,46688,53097,87.9
11,서울특별시,075,70~74세,2021,394383,181034,213349,84.9,388323,178387,209936,85
11,서울특별시,075001, 70세,2021,73263,34074,39189,86.9,71507,33264,38243,87
11,서울특별시,075002, 71세,2021,81425,37664,43761,86.1,79970,36985,42985,86
11,서울특별시,075003, 72세,2021,81834,37446,44388,84.4,80580,36897,43683,84.5
11,서울특별시,075004, 73세,2021,78614,36096,42518,84.9,77761,35773,41988,85.2
11,서울특별시,075005, 74세,2021,79247,35754,43493,82.2,78505,35468,43037,82.4
11,서울특별시,080,75~79세,2021,292472,130873,161599,81,290174,130118,160056,81.3
11,서울특별시,080001, 75세,2021,60936,27367,33569,81.5,60310,27132,33178,81.8
11,서울특별시,080002, 76세,2021,57610,25931,31679,81.9,57125,25769,31356,82.2
11,서울특별시,080003, 77세,2021,56308,25043,31265,80.1,55893,24899,30994,80.3
11,서울특별시,080004, 78세,2021,55273,24685,30588,80.7,54885,24579,30306,81.1
11,서울특별시,080005, 79세,2021,62345,27847,34498,80.7,61961,27739,34222,81.1
11,서울특별시,085,80~84세,2021,191672,79801,111871,71.3,190071,79417,110654,71.8
11,서울특별시,085001, 80세,2021,48211,21184,27027,78.4,47842,21084,26758,78.8
11,서울특별시,085002, 81세,2021,41745,17645,24100,73.2,41379,17546,23833,73.6
11,서울특별시,085003, 82세,2021,39159,16255,22904,71,38826,16189,22637,71.5
11,서울특별시,085004, 83세,2021,33494,13503,19991,67.5,33207,13440,19767,68
11,서울특별시,085005, 84세,2021,29063,11214,17849,62.8,28817,11158,17659,63.2
11,서울특별시,090,85~89세,2021,89382,30895,58487,52.8,88701,30731,57970,53
11,서울특별시,090001, 85세,2021,24726,9239,15487,59.7,24518,9191,15327,60
11,서울특별시,090002, 86세,2021,22003,7781,14222,54.7,21849,7734,14115,54.8
11,서울특별시,090003, 87세,2021,17206,5805,11401,50.9,17081,5773,11308,51.1
11,서울특별시,090004, 88세,2021,13893,4482,9411,47.6,13781,4459,9322,47.8
11,서울특별시,090005, 89세,2021,11554,3588,7966,45,11472,3574,7898,45.3
11,서울특별시,095,90~94세,2021,30015,7814,22201,35.2,29816,7761,22055,35.2
11,서울특별시,095001, 90세,2021,8450,2368,6082,38.9,8387,2353,6034,39
11,서울특별시,095002, 91세,2021,7447,1934,5513,35.1,7386,1919,5467,35.1
11,서울특별시,095003, 92세,2021,6024,1608,4416,36.4,5995,1601,4394,36.4
11,서울특별시,095004, 93세,2021,4652,1139,3513,32.4,4628,1129,3499,32.3
11,서울특별시,095005, 94세,2021,3442,765,2677,28.6,3420,759,2661,28.5
11,서울특별시,100,95~99세,2021,6463,1435,5028,28.5,6407,1419,4988,28.4
11,서울특별시,100001, 95세,2021,2127,448,1679,26.7,2115,444,1671,26.6
11,서울특별시,100002, 96세,2021,1570,330,1240,26.6,1558,328,1230,26.7
11,서울특별시,100003, 97세,2021,1122,257,865,29.7,1107,254,853,29.8
11,서울특별시,100004, 98세,2021,1020,276,744,37.1,1008,271,737,36.8
11,서울특별시,100005, 99세,2021,624,124,500,24.8,619,122,497,24.5
11,서울특별시,101,100세이상,2021,987,225,762,29.5,960,213,747,28.5
11,서울특별시,102,15세미만,2021,932766,479256,453510,105.7,914127,469705,444422,105.7
11,서울특별시,103,15~64세,2021,6974971,3411766,3563205,95.7,6673989,3270730,3403259,96.1
11,서울특별시,104,65세이상,2021,1564390,693229,871161,79.6,1536931,681252,855679,79.6
11,서울특별시,086,85세이상,2021,126847,40369,86478,46.7,125884,40124,85760,46.8
11,서울특별시,126,평균연령,2021,43.4,42.6,44.1,,43.5,42.7,44.2,
11,서울특별시,127,중위연령,2021,43.4,42.7,44.2,,43.6,42.7,44.5,
11010, 종로구,000,합계,2021,148857,71367,77490,92.1,137913,66679,71234,93.6
11010, 종로구,005,0~4세,2021,2790,1397,1393,100.3,2677,1343,1334,100.7
11010, 종로구,005001, 0세,2021,507,258,249,103.6,492,252,240,105
11010, 종로구,005002, 1세,2021,504,259,245,105.7,488,250,238,105
11010, 종로구,005003, 2세,2021,554,276,278,99.3,531,263,268,98.1
11010, 종로구,005004, 3세,2021,567,288,279,103.2,543,278,265,104.9
11010, 종로구,005005, 4세,2021,658,316,342,92.4,623,300,323,92.9
11010, 종로구,010,5~9세,2021,4039,2040,1999,102.1,3926,1981,1945,101.9
11010, 종로구,010001, 5세,2021,755,380,375,101.3,721,365,356,102.5
11010, 종로구,010002, 6세,2021,789,410,379,108.2,772,402,370,108.6
11010, 종로구,010003, 7세,2021,816,392,424,92.5,789,379,410,92.4
11010, 종로구,010004, 8세,2021,779,401,378,106.1,764,393,371,105.9
11010, 종로구,010005, 9세,2021,900,457,443,103.2,880,442,438,100.9
11010, 종로구,015,10~14세,2021,4588,2284,2304,99.1,4522,2256,2266,99.6
11010, 종로구,015001, 10세,2021,876,436,440,99.1,862,430,432,99.5
11010, 종로구,015002, 11세,2021,894,445,449,99.1,873,439,434,101.2
11010, 종로구,015003, 12세,2021,892,435,457,95.2,882,431,451,95.6
11010, 종로구,015004, 13세,2021,932,473,459,103.1,919,466,453,102.9
11010, 종로구,015005, 14세,2021,994,495,499,99.2,986,490,496,98.8
11010, 종로구,020,15~19세,2021,6938,3461,3477,99.5,6523,3322,3201,103.8
11010, 종로구,020001, 15세,2021,946,494,452,109.3,931,487,444,109.7
11010, 종로구,020002, 16세,2021,956,510,446,114.3,939,499,440,113.4
11010, 종로구,020003, 17세,2021,1392,776,616,126,1370,770,600,128.3
11010, 종로구,020004, 18세,2021,1523,795,728,109.2,1434,765,669,114.3
11010, 종로구,020005, 19세,2021,2121,886,1235,71.7,1849,801,1048,76.4
11010, 종로구,025,20~24세,2021,13844,5863,7981,73.5,10888,4871,6017,81
11010, 종로구,025001, 20세,2021,2470,1006,1464,68.7,1936,834,1102,75.7
11010, 종로구,025002, 21세,2021,2674,1074,1600,67.1,2068,882,1186,74.4
11010, 종로구,025003, 22세,2021,2744,1117,1627,68.7,2137,933,1204,77.5
11010, 종로구,025004, 23세,2021,2961,1320,1641,80.4,2336,1077,1259,85.5
11010, 종로구,025005, 24세,2021,2995,1346,1649,81.6,2411,1145,1266,90.4
11010, 종로구,030,25~29세,2021,14243,7192,7051,102,12610,6477,6133,105.6
11010, 종로구,030001, 25세,2021,3055,1517,1538,98.6,2616,1339,1277,104.9
11010, 종로구,030002, 26세,2021,2902,1446,1456,99.3,2559,1299,1260,103.1
11010, 종로구,030003, 27세,2021,2785,1372,1413,97.1,2503,1239,1264,98
11010, 종로구,030004, 28세,2021,2816,1492,1324,112.7,2507,1349,1158,116.5
11010, 종로구,030005, 29세,2021,2685,1365,1320,103.4,2425,1251,1174,106.6
11010, 종로구,035,30~34세,2021,10782,5416,5366,100.9,9635,4878,4757,102.5
11010, 종로구,035001, 30세,2021,2413,1248,1165,107.1,2185,1138,1047,108.7
11010, 종로구,035002, 31세,2021,2314,1173,1141,102.8,2081,1070,1011,105.8
11010, 종로구,035003, 32세,2021,2036,1018,1018,100,1796,906,890,101.8
11010, 종로구,035004, 33세,2021,2033,1051,982,107,1808,936,872,107.3
11010, 종로구,035005, 34세,2021,1986,926,1060,87.4,1765,828,937,88.4
11010, 종로구,040,35~39세,2021,9502,4744,4758,99.7,8598,4285,4313,99.4
11010, 종로구,040001, 35세,2021,1802,908,894,101.6,1584,785,799,98.2
11010, 종로구,040002, 36세,2021,1845,934,911,102.5,1683,857,826,103.8
11010, 종로구,040003, 37세,2021,1863,933,930,100.3,1677,836,841,99.4
11010, 종로구,040004, 38세,2021,1935,972,963,100.9,1769,893,876,101.9
11010, 종로구,040005, 39세,2021,2057,997,1060,94.1,1885,914,971,94.1
11010, 종로구,045,40~44세,2021,9816,4756,5060,94,9105,4393,4712,93.2
11010, 종로구,045001, 40세,2021,2124,1028,1096,93.8,1953,942,1011,93.2
11010, 종로구,045002, 41세,2021,2061,993,1068,93,1919,920,999,92.1
11010, 종로구,045003, 42세,2021,1980,988,992,99.6,1844,917,927,98.9
11010, 종로구,045004, 43세,2021,1785,891,894,99.7,1658,819,839,97.6
11010, 종로구,045005, 44세,2021,1866,856,1010,84.8,1731,795,936,84.9
11010, 종로구,050,45~49세,2021,10965,5355,5610,95.5,10317,5027,5290,95
11010, 종로구,050001, 45세,2021,1899,946,953,99.3,1773,882,891,99
11010, 종로구,050002, 46세,2021,2018,976,1042,93.7,1910,916,994,92.2
11010, 종로구,050003, 47세,2021,2203,1074,1129,95.1,2072,1011,1061,95.3
11010, 종로구,050004, 48세,2021,2389,1130,1259,89.8,2240,1051,1189,88.4
11010, 종로구,050005, 49세,2021,2456,1229,1227,100.2,2322,1167,1155,101
11010, 종로구,055,50~54세,2021,12631,6118,6513,93.9,11967,5801,6166,94.1
11010, 종로구,055001, 50세,2021,2634,1355,1279,105.9,2487,1279,1208,105.9
11010, 종로구,055002, 51세,2021,2602,1237,1365,90.6,2461,1170,1291,90.6
11010, 종로구,055003, 52세,2021,2518,1213,1305,93,2389,1150,1239,92.8
11010, 종로구,055004, 53세,2021,2516,1184,1332,88.9,2379,1128,1251,90.2
11010, 종로구,055005, 54세,2021,2361,1129,1232,91.6,2251,1074,1177,91.2
11010, 종로구,060,55~59세,2021,11673,5864,5809,100.9,11003,5562,5441,102.2
11010, 종로구,060001, 55세,2021,2238,1092,1146,95.3,2112,1041,1071,97.2
11010, 종로구,060002, 56세,2021,2384,1185,1199,98.8,2243,1122,1121,100.1
11010, 종로구,060003, 57세,2021,2313,1149,1164,98.7,2166,1074,1092,98.4
11010, 종로구,060004, 58세,2021,2424,1222,1202,101.7,2285,1160,1125,103.1
11010, 종로구,060005, 59세,2021,2314,1216,1098,110.7,2197,1165,1032,112.9
11010, 종로구,065,60~64세,2021,11187,5467,5720,95.6,10740,5281,5459,96.7
11010, 종로구,065001, 60세,2021,2508,1233,1275,96.7,2443,1208,1235,97.8
11010, 종로구,065002, 61세,2021,2414,1118,1296,86.3,2313,1072,1241,86.4
11010, 종로구,065003, 62세,2021,2181,1094,1087,100.6,2086,1057,1029,102.7
11010, 종로구,065004, 63세,2021,2008,1010,998,101.2,1919,975,944,103.3
11010, 종로구,065005, 64세,2021,2076,1012,1064,95.1,1979,969,1010,95.9
11010, 종로구,070,65~69세,2021,8394,4104,4290,95.7,8129,3972,4157,95.5
11010, 종로구,070001, 65세,2021,1895,926,969,95.6,1822,891,931,95.7
11010, 종로구,070002, 66세,2021,1908,939,969,96.9,1845,902,943,95.7
11010, 종로구,070003, 67세,2021,1620,793,827,95.9,1571,770,801,96.1
11010, 종로구,070004, 68세,2021,1460,709,751,94.4,1416,693,723,95.9
11010, 종로구,070005, 69세,2021,1511,737,774,95.2,1475,716,759,94.3
11010, 종로구,075,70~74세,2021,5932,2664,3268,81.5,5833,2621,3212,81.6
11010, 종로구,075001, 70세,2021,1043,474,569,83.3,1011,462,549,84.2
11010, 종로구,075002, 71세,2021,1199,541,658,82.2,1172,529,643,82.3
11010, 종로구,075003, 72세,2021,1232,561,671,83.6,1212,550,662,83.1
11010, 종로구,075004, 73세,2021,1210,538,672,80.1,1200,533,667,79.9
11010, 종로구,075005, 74세,2021,1248,550,698,78.8,1238,547,691,79.2
11010, 종로구,080,75~79세,2021,5121,2164,2957,73.2,5079,2151,2928,73.5
11010, 종로구,080001, 75세,2021,964,412,552,74.6,960,410,550,74.5
11010, 종로구,080002, 76세,2021,994,422,572,73.8,983,420,563,74.6
11010, 종로구,080003, 77세,2021,1016,408,608,67.1,1006,405,601,67.4
11010, 종로구,080004, 78세,2021,999,434,565,76.8,996,432,564,76.6
11010, 종로구,080005, 79세,2021,1148,488,660,73.9,1134,484,650,74.5
11010, 종로구,085,80~84세,2021,3754,1552,2202,70.5,3721,1540,2181,70.6
11010, 종로구,085001, 80세,2021,914,398,516,77.1,906,393,513,76.6
11010, 종로구,085002, 81세,2021,801,333,468,71.2,791,331,460,72
11010, 종로구,085003, 82세,2021,796,325,471,69,792,324,468,69.2
11010, 종로구,085004, 83세,2021,671,270,401,67.3,665,269,396,67.9
11010, 종로구,085005, 84세,2021,572,226,346,65.3,567,223,344,64.8
11010, 종로구,090,85~89세,2021,1813,684,1129,60.6,1803,681,1122,60.7
11010, 종로구,090001, 85세,2021,508,205,303,67.7,506,205,301,68.1
11010, 종로구,090002, 86세,2021,451,166,285,58.2,448,164,284,57.7
11010, 종로구,090003, 87세,2021,347,137,210,65.2,344,136,208,65.4
11010, 종로구,090004, 88세,2021,276,94,182,51.6,276,94,182,51.6
11010, 종로구,090005, 89세,2021,231,82,149,55,229,82,147,55.8
11010, 종로구,095,90~94세,2021,671,182,489,37.2,665,179,486,36.8
11010, 종로구,095001, 90세,2021,196,63,133,47.4,194,62,132,47
11010, 종로구,095002, 91세,2021,159,39,120,32.5,159,39,120,32.5
11010, 종로구,095003, 92세,2021,140,44,96,45.8,138,42,96,43.8
11010, 종로구,095004, 93세,2021,94,15,79,19,92,15,77,19.5
11010, 종로구,095005, 94세,2021,82,21,61,34.4,82,21,61,34.4
11010, 종로구,100,95~99세,2021,153,51,102,50,153,51,102,50
11010, 종로구,100001, 95세,2021,44,15,29,51.7,44,15,29,51.7
11010, 종로구,100002, 96세,2021,40,12,28,42.9,40,12,28,42.9
11010, 종로구,100003, 97세,2021,25,10,15,66.7,25,10,15,66.7
11010, 종로구,100004, 98세,2021,22,8,14,57.1,22,8,14,57.1
11010, 종로구,100005, 99세,2021,22,6,16,37.5,22,6,16,37.5
11010, 종로구,101,100세이상,2021,21,9,12,75,19,7,12,58.3
11010, 종로구,102,15세미만,2021,11417,5721,5696,100.4,11125,5580,5545,100.6
11010, 종로구,103,15~64세,2021,111581,54236,57345,94.6,101386,49897,51489,96.9
11010, 종로구,104,65세이상,2021,25859,11410,14449,79,25402,11202,14200,78.9
11010, 종로구,086,85세이상,2021,2658,926,1732,53.5,2640,918,1722,53.3
11010, 종로구,126,평균연령,2021,43.9,43.4,44.4,,44.6,43.9,45.3,
11010, 종로구,127,중위연령,2021,43.9,43.3,44.4,,45.3,44.4,46,
11020, 중구,000,합계,2021,126310,60657,65653,92.4,114942,55338,59604,92.8
11020, 중구,005,0~4세,2021,3118,1624,1494,108.7,2908,1503,1405,107
11020, 중구,005001, 0세,2021,613,313,300,104.3,581,297,284,104.6
11020, 중구,005002, 1세,2021,624,329,295,111.5,597,313,284,110.2
11020, 중구,005003, 2세,2021,589,318,271,117.3,545,291,254,114.6
11020, 중구,005004, 3세,2021,614,321,293,109.6,569,293,276,106.2
11020, 중구,005005, 4세,2021,678,343,335,102.4,616,309,307,100.7
11020, 중구,010,5~9세,2021,3368,1744,1624,107.4,3124,1627,1497,108.7
11020, 중구,010001, 5세,2021,737,379,358,105.9,670,347,323,107.4
11020, 중구,010002, 6세,2021,683,358,325,110.2,629,334,295,113.2
11020, 중구,010003, 7세,2021,643,322,321,100.3,603,303,300,101
11020, 중구,010004, 8세,2021,636,324,312,103.8,597,299,298,100.3
11020, 중구,010005, 9세,2021,669,361,308,117.2,625,344,281,122.4
11020, 중구,015,10~14세,2021,2913,1451,1462,99.2,2753,1354,1399,96.8
11020, 중구,015001, 10세,2021,646,312,334,93.4,602,287,315,91.1
11020, 중구,015002, 11세,2021,565,291,274,106.2,537,276,261,105.7
11020, 중구,015003, 12세,2021,495,253,242,104.5,463,232,231,100.4
11020, 중구,015004, 13세,2021,607,296,311,95.2,579,279,300,93
11020, 중구,015005, 14세,2021,600,299,301,99.3,572,280,292,95.9
11020, 중구,020,15~19세,2021,3663,1650,2013,82,3419,1547,1872,82.6
11020, 중구,020001, 15세,2021,510,274,236,116.1,487,262,225,116.4
11020, 중구,020002, 16세,2021,568,274,294,93.2,546,265,281,94.3
11020, 중구,020003, 17세,2021,743,316,427,74,715,303,412,73.5
11020, 중구,020004, 18세,2021,718,337,381,88.5,669,321,348,92.2
11020, 중구,020005, 19세,2021,1124,449,675,66.5,1002,396,606,65.3
11020, 중구,025,20~24세,2021,9468,4040,5428,74.4,7586,3296,4290,76.8
11020, 중구,025001, 20세,2021,1478,600,878,68.3,1240,521,719,72.5
11020, 중구,025002, 21세,2021,1791,754,1037,72.7,1452,632,820,77.1
11020, 중구,025003, 22세,2021,1862,794,1068,74.3,1437,608,829,73.3
11020, 중구,025004, 23세,2021,2054,910,1144,79.5,1605,710,895,79.3
11020, 중구,025005, 24세,2021,2283,982,1301,75.5,1852,825,1027,80.3
11020, 중구,030,25~29세,2021,12170,5818,6352,91.6,10533,5064,5469,92.6
11020, 중구,030001, 25세,2021,2286,1043,1243,83.9,1899,881,1018,86.5
11020, 중구,030002, 26세,2021,2294,1104,1190,92.8,1919,932,987,94.4
11020, 중구,030003, 27세,2021,2479,1202,1277,94.1,2180,1058,1122,94.3
11020, 중구,030004, 28세,2021,2522,1201,1321,90.9,2226,1054,1172,89.9
11020, 중구,030005, 29세,2021,2589,1268,1321,96,2309,1139,1170,97.4
11020, 중구,035,30~34세,2021,11071,5530,5541,99.8,9763,4880,4883,99.9
11020, 중구,035001, 30세,2021,2428,1200,1228,97.7,2188,1086,1102,98.5
11020, 중구,035002, 31세,2021,2260,1124,1136,98.9,1984,983,1001,98.2
11020, 중구,035003, 32세,2021,2124,1068,1056,101.1,1869,939,930,101
11020, 중구,035004, 33세,2021,2166,1040,1126,92.4,1894,906,988,91.7
11020, 중구,035005, 34세,2021,2093,1098,995,110.4,1828,966,862,112.1
11020, 중구,040,35~39세,2021,10223,5188,5035,103,9072,4586,4486,102.2
11020, 중구,040001, 35세,2021,2091,1060,1031,102.8,1810,902,908,99.3
11020, 중구,040002, 36세,2021,2008,996,1012,98.4,1763,886,877,101
11020, 중구,040003, 37세,2021,2010,1022,988,103.4,1811,915,896,102.1
11020, 중구,040004, 38세,2021,2032,1030,1002,102.8,1838,929,909,102.2
11020, 중구,040005, 39세,2021,2082,1080,1002,107.8,1850,954,896,106.5
11020, 중구,045,40~44세,2021,8925,4618,4307,107.2,8071,4144,3927,105.5
11020, 중구,045001, 40세,2021,1968,1035,933,110.9,1781,928,853,108.8
11020, 중구,045002, 41세,2021,1992,1016,976,104.1,1827,919,908,101.2
11020, 중구,045003, 42세,2021,1757,909,848,107.2,1579,809,770,105.1
11020, 중구,045004, 43세,2021,1630,881,749,117.6,1444,771,673,114.6
11020, 중구,045005, 44세,2021,1578,777,801,97,1440,717,723,99.2
11020, 중구,050,45~49세,2021,8627,4356,4271,102,7862,3964,3898,101.7
11020, 중구,050001, 45세,2021,1570,825,745,110.7,1402,734,668,109.9
11020, 중구,050002, 46세,2021,1644,847,797,106.3,1512,783,729,107.4
11020, 중구,050003, 47세,2021,1759,894,865,103.4,1609,820,789,103.9
11020, 중구,050004, 48세,2021,1736,821,915,89.7,1595,754,841,89.7
11020, 중구,050005, 49세,2021,1918,969,949,102.1,1744,873,871,100.2
11020, 중구,055,50~54세,2021,10293,5031,5262,95.6,9508,4669,4839,96.5
11020, 중구,055001, 50세,2021,2118,1047,1071,97.8,1954,963,991,97.2
11020, 중구,055002, 51세,2021,2025,965,1060,91,1851,892,959,93
11020, 중구,055003, 52세,2021,2094,1051,1043,100.8,1949,982,967,101.6
11020, 중구,055004, 53세,2021,2157,1029,1128,91.2,1982,943,1039,90.8
11020, 중구,055005, 54세,2021,1899,939,960,97.8,1772,889,883,100.7
11020, 중구,060,55~59세,2021,9840,4853,4987,97.3,9050,4511,4539,99.4
11020, 중구,060001, 55세,2021,1781,895,886,101,1642,829,813,102
11020, 중구,060002, 56세,2021,1969,949,1020,93,1809,871,938,92.9
11020, 중구,060003, 57세,2021,1969,949,1020,93,1811,886,925,95.8
11020, 중구,060004, 58세,2021,2076,1042,1034,100.8,1891,960,931,103.1
11020, 중구,060005, 59세,2021,2045,1018,1027,99.1,1897,965,932,103.5
11020, 중구,065,60~64세,2021,9996,4869,5127,95,9343,4584,4759,96.3
11020, 중구,065001, 60세,2021,2104,1028,1076,95.5,2000,980,1020,96.1
11020, 중구,065002, 61세,2021,2161,1063,1098,96.8,2013,992,1021,97.2
11020, 중구,065003, 62세,2021,1965,951,1014,93.8,1842,901,941,95.7
11020, 중구,065004, 63세,2021,1841,867,974,89,1698,809,889,91
11020, 중구,065005, 64세,2021,1925,960,965,99.5,1790,902,888,101.6
11020, 중구,070,65~69세,2021,7770,3701,4069,91,7359,3529,3830,92.1
11020, 중구,070001, 65세,2021,1792,876,916,95.6,1698,842,856,98.4
11020, 중구,070002, 66세,2021,1781,843,938,89.9,1691,803,888,90.4
11020, 중구,070003, 67세,2021,1495,726,769,94.4,1404,684,720,95
11020, 중구,070004, 68세,2021,1336,623,713,87.4,1258,590,668,88.3
11020, 중구,070005, 69세,2021,1366,633,733,86.4,1308,610,698,87.4
11020, 중구,075,70~74세,2021,5484,2535,2949,86,5329,2474,2855,86.7
11020, 중구,075001, 70세,2021,996,480,516,93,948,457,491,93.1
11020, 중구,075002, 71세,2021,1132,541,591,91.5,1099,530,569,93.1
11020, 중구,075003, 72세,2021,1128,517,611,84.6,1096,504,592,85.1
11020, 중구,075004, 73세,2021,1105,514,591,87,1088,510,578,88.2
11020, 중구,075005, 74세,2021,1123,483,640,75.5,1098,473,625,75.7
11020, 중구,080,75~79세,2021,4291,1832,2459,74.5,4239,1812,2427,74.7
11020, 중구,080001, 75세,2021,822,332,490,67.8,809,327,482,67.8
11020, 중구,080002, 76세,2021,854,384,470,81.7,850,384,466,82.4
11020, 중구,080003, 77세,2021,852,376,476,79,837,367,470,78.1
11020, 중구,080004, 78세,2021,814,343,471,72.8,802,340,462,73.6
11020, 중구,080005, 79세,2021,949,397,552,71.9,941,394,547,72
11020, 중구,085,80~84세,2021,2999,1180,1819,64.9,2961,1163,1798,64.7
11020, 중구,085001, 80세,2021,754,309,445,69.4,748,307,441,69.6
11020, 중구,085002, 81세,2021,634,257,377,68.2,624,250,374,66.8
11020, 중구,085003, 82세,2021,641,258,383,67.4,634,256,378,67.7
11020, 중구,085004, 83세,2021,517,200,317,63.1,510,196,314,62.4
11020, 중구,085005, 84세,2021,453,156,297,52.5,445,154,291,52.9
11020, 중구,090,85~89세,2021,1442,457,985,46.4,1423,452,971,46.5
11020, 중구,090001, 85세,2021,413,142,271,52.4,407,142,265,53.6
11020, 중구,090002, 86세,2021,342,121,221,54.8,334,118,216,54.6
11020, 중구,090003, 87세,2021,275,75,200,37.5,271,74,197,37.6
11020, 중구,090004, 88세,2021,223,61,162,37.7,222,60,162,37
11020, 중구,090005, 89세,2021,189,58,131,44.3,189,58,131,44.3
11020, 중구,095,90~94세,2021,530,152,378,40.2,523,151,372,40.6
11020, 중구,095001, 90세,2021,141,45,96,46.9,138,45,93,48.4
11020, 중구,095002, 91세,2021,118,28,90,31.1,114,27,87,31
11020, 중구,095003, 92세,2021,114,36,78,46.2,114,36,78,46.2
11020, 중구,095004, 93세,2021,95,26,69,37.7,95,26,69,37.7
11020, 중구,095005, 94세,2021,62,17,45,37.8,62,17,45,37.8
11020, 중구,100,95~99세,2021,105,23,82,28,103,23,80,28.8
11020, 중구,100001, 95세,2021,36,5,31,16.1,36,5,31,16.1
11020, 중구,100002, 96세,2021,21,5,16,31.3,21,5,16,31.3
11020, 중구,100003, 97세,2021,22,9,13,69.2,21,9,12,75
11020, 중구,100004, 98세,2021,10,X,8,25,10,X,8,25
11020, 중구,100005, 99세,2021,16,X,14,14.3,15,X,13,15.4
11020, 중구,101,100세이상,2021,14,5,9,55.6,13,5,8,62.5
11020, 중구,102,15세미만,2021,9399,4819,4580,105.2,8785,4484,4301,104.3
11020, 중구,103,15~64세,2021,94276,45953,48323,95.1,84207,41245,42962,96
11020, 중구,104,65세이상,2021,22635,9885,12750,77.5,21950,9609,12341,77.9
11020, 중구,086,85세이상,2021,2091,637,1454,43.8,2062,631,1431,44.1
11020, 중구,126,평균연령,2021,44.6,44,45.1,,45.3,44.6,45.9,
11020, 중구,127,중위연령,2021,43.9,43.4,44.5,,45.2,44.5,45.9,
11030, 용산구,000,합계,2021,221688,106910,114778,93.1,205288,98233,107055,91.8
11030, 용산구,005,0~4세,2021,6610,3408,3202,106.4,5693,2947,2746,107.3
11030, 용산구,005001, 0세,2021,1256,683,573,119.2,1150,624,526,118.6
11030, 용산구,005002, 1세,2021,1165,596,569,104.7,1064,545,519,105
11030, 용산구,005003, 2세,2021,1306,693,613,113.1,1146,610,536,113.8
11030, 용산구,005004, 3세,2021,1398,710,688,103.2,1151,586,565,103.7
11030, 용산구,005005, 4세,2021,1485,726,759,95.7,1182,582,600,97
11030, 용산구,010,5~9세,2021,7574,3869,3705,104.4,6289,3239,3050,106.2
11030, 용산구,010001, 5세,2021,1661,831,830,100.1,1330,675,655,103.1
11030, 용산구,010002, 6세,2021,1620,828,792,104.5,1254,643,611,105.2
11030, 용산구,010003, 7세,2021,1468,752,716,105,1223,632,591,106.9
11030, 용산구,010004, 8세,2021,1345,677,668,101.3,1168,588,580,101.4
11030, 용산구,010005, 9세,2021,1480,781,699,111.7,1314,701,613,114.4
11030, 용산구,015,10~14세,2021,6756,3381,3375,100.2,6167,3099,3068,101
11030, 용산구,015001, 10세,2021,1352,687,665,103.3,1199,614,585,105
11030, 용산구,015002, 11세,2021,1364,690,674,102.4,1245,641,604,106.1
11030, 용산구,015003, 12세,2021,1266,624,642,97.2,1156,562,594,94.6
11030, 용산구,015004, 13세,2021,1355,654,701,93.3,1250,605,645,93.8
11030, 용산구,015005, 14세,2021,1419,726,693,104.8,1317,677,640,105.8
11030, 용산구,020,15~19세,2021,7084,3525,3559,99,6722,3364,3358,100.2
11030, 용산구,020001, 15세,2021,1286,652,634,102.8,1198,609,589,103.4
11030, 용산구,020002, 16세,2021,1323,683,640,106.7,1256,650,606,107.3
11030, 용산구,020003, 17세,2021,1427,746,681,109.5,1355,708,647,109.4
11030, 용산구,020004, 18세,2021,1395,691,704,98.2,1351,674,677,99.6
11030, 용산구,020005, 19세,2021,1653,753,900,83.7,1562,723,839,86.2
11030, 용산구,025,20~24세,2021,13666,5970,7696,77.6,12553,5449,7104,76.7
11030, 용산구,025001, 20세,2021,2283,987,1296,76.2,2140,919,1221,75.3
11030, 용산구,025002, 21세,2021,2619,1144,1475,77.6,2421,1063,1358,78.3
11030, 용산구,025003, 22세,2021,2676,1196,1480,80.8,2456,1091,1365,79.9
11030, 용산구,025004, 23세,2021,2895,1263,1632,77.4,2627,1138,1489,76.4
11030, 용산구,025005, 24세,2021,3193,1380,1813,76.1,2909,1238,1671,74.1
11030, 용산구,030,25~29세,2021,20270,9582,10688,89.7,18432,8623,9809,87.9
11030, 용산구,030001, 25세,2021,3451,1546,1905,81.2,3130,1371,1759,77.9
11030, 용산구,030002, 26세,2021,3797,1722,2075,83,3458,1548,1910,81
11030, 용산구,030003, 27세,2021,4089,1942,2147,90.5,3726,1756,1970,89.1
11030, 용산구,030004, 28세,2021,4383,2131,2252,94.6,4004,1929,2075,93
11030, 용산구,030005, 29세,2021,4550,2241,2309,97.1,4114,2019,2095,96.4
11030, 용산구,035,30~34세,2021,20341,10211,10130,100.8,18257,9078,9179,98.9
11030, 용산구,035001, 30세,2021,4507,2227,2280,97.7,4072,2007,2065,97.2
11030, 용산구,035002, 31세,2021,4203,2146,2057,104.3,3802,1931,1871,103.2
11030, 용산구,035003, 32세,2021,3954,2014,1940,103.8,3573,1792,1781,100.6
11030, 용산구,035004, 33세,2021,3953,1966,1987,98.9,3478,1701,1777,95.7
11030, 용산구,035005, 34세,2021,3724,1858,1866,99.6,3332,1647,1685,97.7
11030, 용산구,040,35~39세,2021,18855,9570,9285,103.1,16874,8414,8460,99.5
11030, 용산구,040001, 35세,2021,3798,1924,1874,102.7,3405,1689,1716,98.4
11030, 용산구,040002, 36세,2021,3685,1893,1792,105.6,3247,1637,1610,101.7
11030, 용산구,040003, 37세,2021,3743,1910,1833,104.2,3336,1671,1665,100.4
11030, 용산구,040004, 38세,2021,3746,1898,1848,102.7,3365,1677,1688,99.3
11030, 용산구,040005, 39세,2021,3883,1945,1938,100.4,3521,1740,1781,97.7
11030, 용산구,045,40~44세,2021,16947,8610,8337,103.3,15333,7680,7653,100.4
11030, 용산구,045001, 40세,2021,3788,1982,1806,109.7,3465,1806,1659,108.9
11030, 용산구,045002, 41세,2021,3694,1854,1840,100.8,3343,1655,1688,98
11030, 용산구,045003, 42세,2021,3302,1671,1631,102.5,2971,1476,1495,98.7
11030, 용산구,045004, 43세,2021,3140,1604,1536,104.4,2798,1404,1394,100.7
11030, 용산구,045005, 44세,2021,3023,1499,1524,98.4,2756,1339,1417,94.5
11030, 용산구,050,45~49세,2021,16726,8269,8457,97.8,15463,7549,7914,95.4
11030, 용산구,050001, 45세,2021,2999,1494,1505,99.3,2734,1341,1393,96.3
11030, 용산구,050002, 46세,2021,3047,1511,1536,98.4,2794,1368,1426,95.9
11030, 용산구,050003, 47세,2021,3403,1706,1697,100.5,3170,1563,1607,97.3
11030, 용산구,050004, 48세,2021,3495,1738,1757,98.9,3256,1597,1659,96.3
11030, 용산구,050005, 49세,2021,3782,1820,1962,92.8,3509,1680,1829,91.9
11030, 용산구,055,50~54세,2021,18623,9116,9507,95.9,17439,8433,9006,93.6
11030, 용산구,055001, 50세,2021,3960,1944,2016,96.4,3693,1783,1910,93.4
11030, 용산구,055002, 51세,2021,3820,1865,1955,95.4,3580,1730,1850,93.5
11030, 용산구,055003, 52세,2021,3866,1924,1942,99.1,3616,1765,1851,95.4
11030, 용산구,055004, 53세,2021,3689,1820,1869,97.4,3450,1691,1759,96.1
11030, 용산구,055005, 54세,2021,3288,1563,1725,90.6,3100,1464,1636,89.5
11030, 용산구,060,55~59세,2021,16528,8212,8316,98.7,15609,7733,7876,98.2
11030, 용산구,060001, 55세,2021,3145,1605,1540,104.2,2962,1511,1451,104.1
11030, 용산구,060002, 56세,2021,3369,1621,1748,92.7,3188,1528,1660,92
11030, 용산구,060003, 57세,2021,3193,1598,1595,100.2,3000,1496,1504,99.5
11030, 용산구,060004, 58세,2021,3423,1668,1755,95,3214,1561,1653,94.4
11030, 용산구,060005, 59세,2021,3398,1720,1678,102.5,3245,1637,1608,101.8
11030, 용산구,065,60~64세,2021,16016,7743,8273,93.6,15424,7471,7953,93.9
11030, 용산구,065001, 60세,2021,3421,1676,1745,96,3295,1617,1678,96.4
11030, 용산구,065002, 61세,2021,3444,1626,1818,89.4,3306,1566,1740,90
11030, 용산구,065003, 62세,2021,3159,1530,1629,93.9,3059,1482,1577,94
11030, 용산구,065004, 63세,2021,2992,1475,1517,97.2,2871,1416,1455,97.3
11030, 용산구,065005, 64세,2021,3000,1436,1564,91.8,2893,1390,1503,92.5
11030, 용산구,070,65~69세,2021,11923,5622,6301,89.2,11584,5476,6108,89.7
11030, 용산구,070001, 65세,2021,2737,1312,1425,92.1,2655,1275,1380,92.4
11030, 용산구,070002, 66세,2021,2753,1296,1457,88.9,2677,1262,1415,89.2
11030, 용산구,070003, 67세,2021,2320,1129,1191,94.8,2251,1099,1152,95.4
11030, 용산구,070004, 68세,2021,2026,965,1061,91,1971,942,1029,91.5
11030, 용산구,070005, 69세,2021,2087,920,1167,78.8,2030,898,1132,79.3
11030, 용산구,075,70~74세,2021,8394,3800,4594,82.7,8234,3722,4512,82.5
11030, 용산구,075001, 70세,2021,1544,713,831,85.8,1492,694,798,87
11030, 용산구,075002, 71세,2021,1727,794,933,85.1,1699,777,922,84.3
11030, 용산구,075003, 72세,2021,1756,816,940,86.8,1722,795,927,85.8
11030, 용산구,075004, 73세,2021,1715,790,925,85.4,1693,778,915,85
11030, 용산구,075005, 74세,2021,1652,687,965,71.2,1628,678,950,71.4
11030, 용산구,080,75~79세,2021,6764,2860,3904,73.3,6690,2824,3866,73
11030, 용산구,080001, 75세,2021,1342,560,782,71.6,1319,548,771,71.1
11030, 용산구,080002, 76세,2021,1314,584,730,80,1299,575,724,79.4
11030, 용산구,080003, 77세,2021,1306,508,798,63.7,1295,505,790,63.9
11030, 용산구,080004, 78세,2021,1285,560,725,77.2,1273,555,718,77.3
11030, 용산구,080005, 79세,2021,1517,648,869,74.6,1504,641,863,74.3
11030, 용산구,085,80~84세,2021,5014,1968,3046,64.6,4965,1951,3014,64.7
11030, 용산구,085001, 80세,2021,1182,483,699,69.1,1173,481,692,69.5
11030, 용산구,085002, 81세,2021,1052,431,621,69.4,1045,426,619,68.8
11030, 용산구,085003, 82세,2021,1007,393,614,64,993,386,607,63.6
11030, 용산구,085004, 83세,2021,961,347,614,56.5,954,346,608,56.9
11030, 용산구,085005, 84세,2021,812,314,498,63.1,800,312,488,63.9
11030, 용산구,090,85~89세,2021,2546,868,1678,51.7,2523,859,1664,51.6
11030, 용산구,090001, 85세,2021,720,241,479,50.3,714,238,476,50
11030, 용산구,090002, 86세,2021,596,227,369,61.5,590,223,367,60.8
11030, 용산구,090003, 87세,2021,499,170,329,51.7,497,168,329,51.1
11030, 용산구,090004, 88세,2021,401,126,275,45.8,396,126,270,46.7
11030, 용산구,090005, 89세,2021,330,104,226,46,326,104,222,46.8
11030, 용산구,095,90~94세,2021,843,262,581,45.1,836,260,576,45.1
11030, 용산구,095001, 90세,2021,239,88,151,58.3,238,88,150,58.7
11030, 용산구,095002, 91세,2021,195,66,129,51.2,193,66,127,52
11030, 용산구,095003, 92세,2021,190,54,136,39.7,188,54,134,40.3
11030, 용산구,095004, 93세,2021,135,40,95,42.1,134,39,95,41.1
11030, 용산구,095005, 94세,2021,84,14,70,20,83,13,70,18.6
11030, 용산구,100,95~99세,2021,182,58,124,46.8,176,56,120,46.7
11030, 용산구,100001, 95세,2021,53,11,42,26.2,52,10,42,23.8
11030, 용산구,100002, 96세,2021,36,17,19,89.5,34,16,18,88.9
11030, 용산구,100003, 97세,2021,34,13,21,61.9,33,13,20,65
11030, 용산구,100004, 98세,2021,41,15,26,57.7,39,15,24,62.5
11030, 용산구,100005, 99세,2021,18,X,16,12.5,18,X,16,12.5
11030, 용산구,101,100세이상,2021,26,6,20,30,25,6,19,31.6
11030, 용산구,102,15세미만,2021,20940,10658,10282,103.7,18149,9285,8864,104.7
11030, 용산구,103,15~64세,2021,165056,80808,84248,95.9,152106,73794,78312,94.2
11030, 용산구,104,65세이상,2021,35692,15444,20248,76.3,35033,15154,19879,76.2
11030, 용산구,086,85세이상,2021,3597,1194,2403,49.7,3560,1181,2379,49.6
11030, 용산구,126,평균연령,2021,43.4,42.7,44.1,,44.1,43.4,44.8,
11030, 용산구,127,중위연령,2021,42.7,42.1,43.3,,43.7,43,44.4,
11040, 성동구,000,합계,2021,286469,139181,147288,94.5,276273,134666,141607,95.1
11040, 성동구,005,0~4세,2021,9376,4799,4577,104.9,9185,4706,4479,105.1
11040, 성동구,005001, 0세,2021,1817,920,897,102.6,1793,909,884,102.8
11040, 성동구,005002, 1세,2021,1818,947,871,108.7,1784,930,854,108.9
11040, 성동구,005003, 2세,2021,1869,984,885,111.2,1834,966,868,111.3
11040, 성동구,005004, 3세,2021,1888,948,940,100.9,1853,932,921,101.2
11040, 성동구,005005, 4세,2021,1984,1000,984,101.6,1921,969,952,101.8
11040, 성동구,010,5~9세,2021,9740,4920,4820,102.1,9541,4819,4722,102.1
11040, 성동구,010001, 5세,2021,2071,1056,1015,104,2017,1027,990,103.7
11040, 성동구,010002, 6세,2021,1997,1016,981,103.6,1949,994,955,104.1
11040, 성동구,010003, 7세,2021,1943,957,986,97.1,1899,937,962,97.4
11040, 성동구,010004, 8세,2021,1842,957,885,108.1,1815,940,875,107.4
11040, 성동구,010005, 9세,2021,1887,934,953,98,1861,921,940,98
11040, 성동구,015,10~14세,2021,8361,4250,4111,103.4,8255,4201,4054,103.6
11040, 성동구,015001, 10세,2021,1732,877,855,102.6,1710,864,846,102.1
11040, 성동구,015002, 11세,2021,1617,817,800,102.1,1587,805,782,102.9
11040, 성동구,015003, 12세,2021,1504,767,737,104.1,1486,759,727,104.4
11040, 성동구,015004, 13세,2021,1719,877,842,104.2,1702,872,830,105.1
11040, 성동구,015005, 14세,2021,1789,912,877,104,1770,901,869,103.7
11040, 성동구,020,15~19세,2021,10111,4861,5250,92.6,9818,4752,5066,93.8
11040, 성동구,020001, 15세,2021,1632,823,809,101.7,1621,817,804,101.6
11040, 성동구,020002, 16세,2021,1647,812,835,97.2,1629,804,825,97.5
11040, 성동구,020003, 17세,2021,1808,915,893,102.5,1779,899,880,102.2
11040, 성동구,020004, 18세,2021,2033,932,1101,84.7,1963,906,1057,85.7
11040, 성동구,020005, 19세,2021,2991,1379,1612,85.5,2826,1326,1500,88.4
11040, 성동구,025,20~24세,2021,21265,10043,11222,89.5,19377,9359,10018,93.4
11040, 성동구,025001, 20세,2021,3506,1660,1846,89.9,3190,1547,1643,94.2
11040, 성동구,025002, 21세,2021,4009,1833,2176,84.2,3642,1695,1947,87.1
11040, 성동구,025003, 22세,2021,4170,1986,2184,90.9,3803,1853,1950,95
11040, 성동구,025004, 23세,2021,4655,2204,2451,89.9,4220,2056,2164,95
11040, 성동구,025005, 24세,2021,4925,2360,2565,92,4522,2208,2314,95.4
11040, 성동구,030,25~29세,2021,26259,13255,13004,101.9,24841,12683,12158,104.3
11040, 성동구,030001, 25세,2021,5331,2678,2653,100.9,4968,2535,2433,104.2
11040, 성동구,030002, 26세,2021,5316,2715,2601,104.4,4985,2576,2409,106.9
11040, 성동구,030003, 27세,2021,5165,2621,2544,103,4909,2530,2379,106.3
11040, 성동구,030004, 28세,2021,5197,2632,2565,102.6,4963,2539,2424,104.7
11040, 성동구,030005, 29세,2021,5250,2609,2641,98.8,5016,2503,2513,99.6
11040, 성동구,035,30~34세,2021,23416,11288,12128,93.1,22341,10774,11567,93.1
11040, 성동구,035001, 30세,2021,4838,2382,2456,97,4615,2282,2333,97.8
11040, 성동구,035002, 31세,2021,4798,2319,2479,93.5,4590,2221,2369,93.8
11040, 성동구,035003, 32세,2021,4612,2214,2398,92.3,4389,2106,2283,92.2
11040, 성동구,035004, 33세,2021,4647,2199,2448,89.8,4445,2098,2347,89.4
11040, 성동구,035005, 34세,2021,4521,2174,2347,92.6,4302,2067,2235,92.5
11040, 성동구,040,35~39세,2021,23654,12000,11654,103,22728,11537,11191,103.1
11040, 성동구,040001, 35세,2021,4608,2301,2307,99.7,4414,2211,2203,100.4
11040, 성동구,040002, 36세,2021,4640,2335,2305,101.3,4438,2232,2206,101.2
11040, 성동구,040003, 37세,2021,4657,2397,2260,106.1,4475,2306,2169,106.3
11040, 성동구,040004, 38세,2021,4766,2406,2360,101.9,4609,2332,2277,102.4
11040, 성동구,040005, 39세,2021,4983,2561,2422,105.7,4792,2456,2336,105.1
11040, 성동구,045,40~44세,2021,21408,10916,10492,104,20669,10539,10130,104
11040, 성동구,045001, 40세,2021,4792,2453,2339,104.9,4639,2361,2278,103.6
11040, 성동구,045002, 41세,2021,4718,2410,2308,104.4,4556,2325,2231,104.2
11040, 성동구,045003, 42세,2021,4264,2164,2100,103,4106,2089,2017,103.6
11040, 성동구,045004, 43세,2021,3769,1921,1848,104,3623,1848,1775,104.1
11040, 성동구,045005, 44세,2021,3865,1968,1897,103.7,3745,1916,1829,104.8
11040, 성동구,050,45~49세,2021,20715,10268,10447,98.3,20008,9938,10070,98.7
11040, 성동구,050001, 45세,2021,3814,1975,1839,107.4,3675,1904,1771,107.5
11040, 성동구,050002, 46세,2021,3895,1887,2008,94,3784,1831,1953,93.8
11040, 성동구,050003, 47세,2021,4170,2052,2118,96.9,4046,1998,2048,97.6
11040, 성동구,050004, 48세,2021,4387,2180,2207,98.8,4235,2113,2122,99.6
11040, 성동구,050005, 49세,2021,4449,2174,2275,95.6,4268,2092,2176,96.1
11040, 성동구,055,50~54세,2021,23627,11449,12178,94,22854,11064,11790,93.8
11040, 성동구,055001, 50세,2021,4857,2326,2531,91.9,4714,2257,2457,91.9
11040, 성동구,055002, 51세,2021,4861,2380,2481,95.9,4675,2290,2385,96
11040, 성동구,055003, 52세,2021,4779,2293,2486,92.2,4630,2221,2409,92.2
11040, 성동구,055004, 53세,2021,4800,2356,2444,96.4,4639,2275,2364,96.2
11040, 성동구,055005, 54세,2021,4330,2094,2236,93.6,4196,2021,2175,92.9
11040, 성동구,060,55~59세,2021,21859,10820,11039,98,21113,10471,10642,98.4
11040, 성동구,060001, 55세,2021,4186,2089,2097,99.6,4047,2023,2024,100
11040, 성동구,060002, 56세,2021,4420,2121,2299,92.3,4259,2045,2214,92.4
11040, 성동구,060003, 57세,2021,4216,2108,2108,100,4086,2048,2038,100.5
11040, 성동구,060004, 58세,2021,4516,2200,2316,95,4354,2129,2225,95.7
11040, 성동구,060005, 59세,2021,4521,2302,2219,103.7,4367,2226,2141,104
11040, 성동구,065,60~64세,2021,21682,10628,11054,96.1,21120,10389,10731,96.8
11040, 성동구,065001, 60세,2021,4659,2291,2368,96.7,4565,2250,2315,97.2
11040, 성동구,065002, 61세,2021,4831,2346,2485,94.4,4713,2299,2414,95.2
11040, 성동구,065003, 62세,2021,4213,2060,2153,95.7,4105,2014,2091,96.3
11040, 성동구,065004, 63세,2021,3999,1989,2010,99,3869,1928,1941,99.3
11040, 성동구,065005, 64세,2021,3980,1942,2038,95.3,3868,1898,1970,96.3
11040, 성동구,070,65~69세,2021,15663,7411,8252,89.8,15301,7241,8060,89.8
11040, 성동구,070001, 65세,2021,3590,1691,1899,89,3487,1645,1842,89.3
11040, 성동구,070002, 66세,2021,3614,1695,1919,88.3,3537,1660,1877,88.4
11040, 성동구,070003, 67세,2021,3084,1469,1615,91,3003,1433,1570,91.3
11040, 성동구,070004, 68세,2021,2600,1258,1342,93.7,2545,1229,1316,93.4
11040, 성동구,070005, 69세,2021,2775,1298,1477,87.9,2729,1274,1455,87.6
11040, 성동구,075,70~74세,2021,11092,5053,6039,83.7,10966,5004,5962,83.9
11040, 성동구,075001, 70세,2021,2097,969,1128,85.9,2054,951,1103,86.2
11040, 성동구,075002, 71세,2021,2290,1063,1227,86.6,2257,1048,1209,86.7
11040, 성동구,075003, 72세,2021,2239,1004,1235,81.3,2220,997,1223,81.5
11040, 성동구,075004, 73세,2021,2182,1001,1181,84.8,2167,996,1171,85.1
11040, 성동구,075005, 74세,2021,2284,1016,1268,80.1,2268,1012,1256,80.6
11040, 성동구,080,75~79세,2021,8686,3734,4952,75.4,8640,3714,4926,75.4
11040, 성동구,080001, 75세,2021,1769,755,1014,74.5,1752,748,1004,74.5
11040, 성동구,080002, 76세,2021,1658,685,973,70.4,1648,681,967,70.4
11040, 성동구,080003, 77세,2021,1653,726,927,78.3,1643,721,922,78.2
11040, 성동구,080004, 78세,2021,1679,726,953,76.2,1673,724,949,76.3
11040, 성동구,080005, 79세,2021,1927,842,1085,77.6,1924,840,1084,77.5
11040, 성동구,085,80~84세,2021,5845,2323,3522,66,5824,2319,3505,66.2
11040, 성동구,085001, 80세,2021,1471,631,840,75.1,1464,629,835,75.3
11040, 성동구,085002, 81세,2021,1255,479,776,61.7,1250,478,772,61.9
11040, 성동구,085003, 82세,2021,1186,484,702,68.9,1182,484,698,69.3
11040, 성동구,085004, 83세,2021,1022,390,632,61.7,1021,390,631,61.8
11040, 성동구,085005, 84세,2021,911,339,572,59.3,907,338,569,59.4
11040, 성동구,090,85~89세,2021,2673,914,1759,52,2662,910,1752,51.9
11040, 성동구,090001, 85세,2021,790,273,517,52.8,787,272,515,52.8
11040, 성동구,090002, 86세,2021,614,219,395,55.4,611,217,394,55.1
11040, 성동구,090003, 87세,2021,569,205,364,56.3,564,204,360,56.7
11040, 성동구,090004, 88세,2021,390,116,274,42.3,390,116,274,42.3
11040, 성동구,090005, 89세,2021,310,101,209,48.3,310,101,209,48.3
11040, 성동구,095,90~94세,2021,850,209,641,32.6,847,208,639,32.6
11040, 성동구,095001, 90세,2021,249,63,186,33.9,247,62,185,33.5
11040, 성동구,095002, 91세,2021,212,51,161,31.7,212,51,161,31.7
11040, 성동구,095003, 92세,2021,160,41,119,34.5,160,41,119,34.5
11040, 성동구,095004, 93세,2021,117,27,90,30,117,27,90,30
11040, 성동구,095005, 94세,2021,112,27,85,31.8,111,27,84,32.1
11040, 성동구,100,95~99세,2021,159,33,126,26.2,156,32,124,25.8
11040, 성동구,100001, 95세,2021,45,7,38,18.4,45,7,38,18.4
11040, 성동구,100002, 96세,2021,39,6,33,18.2,39,6,33,18.2
11040, 성동구,100003, 97세,2021,30,9,21,42.9,30,9,21,42.9
11040, 성동구,100004, 98세,2021,26,7,19,36.8,24,6,18,33.3
11040, 성동구,100005, 99세,2021,19,X,15,26.7,18,X,14,28.6
11040, 성동구,101,100세이상,2021,28,7,21,33.3,27,6,21,28.6
11040, 성동구,102,15세미만,2021,27477,13969,13508,103.4,26981,13726,13255,103.6
11040, 성동구,103,15~64세,2021,213996,105528,108468,97.3,204869,101506,103363,98.2
11040, 성동구,104,65세이상,2021,44996,19684,25312,77.8,44423,19434,24989,77.8
11040, 성동구,086,85세이상,2021,3710,1163,2547,45.7,3692,1156,2536,45.6
11040, 성동구,126,평균연령,2021,43,42.3,43.7,,43.2,42.4,44,
11040, 성동구,127,중위연령,2021,42.4,41.7,43.1,,42.7,41.9,43.6,
11050, 광진구,000,합계,2021,347099,166469,180630,92.2,328395,158337,170058,93.1
11050, 광진구,005,0~4세,2021,7719,3973,3746,106.1,7373,3792,3581,105.9
11050, 광진구,005001, 0세,2021,1506,762,744,102.4,1445,734,711,103.2
11050, 광진구,005002, 1세,2021,1378,700,678,103.2,1306,660,646,102.2
11050, 광진구,005003, 2세,2021,1578,825,753,109.6,1500,784,716,109.5
11050, 광진구,005004, 3세,2021,1574,827,747,110.7,1505,787,718,109.6
11050, 광진구,005005, 4세,2021,1683,859,824,104.2,1617,827,790,104.7
11050, 광진구,010,5~9세,2021,10169,5220,4949,105.5,9854,5069,4785,105.9
11050, 광진구,010001, 5세,2021,1859,974,885,110.1,1781,933,848,110
11050, 광진구,010002, 6세,2021,2027,1029,998,103.1,1962,995,967,102.9
11050, 광진구,010003, 7세,2021,1983,1031,952,108.3,1910,1000,910,109.9
11050, 광진구,010004, 8세,2021,2059,1037,1022,101.5,2011,1017,994,102.3
11050, 광진구,010005, 9세,2021,2241,1149,1092,105.2,2190,1124,1066,105.4
11050, 광진구,015,10~14세,2021,11499,5881,5618,104.7,11292,5768,5524,104.4
11050, 광진구,015001, 10세,2021,2235,1120,1115,100.4,2187,1093,1094,99.9
11050, 광진구,015002, 11세,2021,2233,1185,1048,113.1,2188,1160,1028,112.8
11050, 광진구,015003, 12세,2021,2146,1100,1046,105.2,2107,1085,1022,106.2
11050, 광진구,015004, 13세,2021,2366,1220,1146,106.5,2329,1196,1133,105.6
11050, 광진구,015005, 14세,2021,2519,1256,1263,99.4,2481,1234,1247,99
11050, 광진구,020,15~19세,2021,13263,6548,6715,97.5,12790,6390,6400,99.8
11050, 광진구,020001, 15세,2021,2275,1159,1116,103.9,2258,1151,1107,104
11050, 광진구,020002, 16세,2021,2299,1172,1127,104,2273,1155,1118,103.3
11050, 광진구,020003, 17세,2021,2482,1255,1227,102.3,2421,1230,1191,103.3
11050, 광진구,020004, 18세,2021,2715,1331,1384,96.2,2612,1298,1314,98.8
11050, 광진구,020005, 19세,2021,3492,1631,1861,87.6,3226,1556,1670,93.2
11050, 광진구,025,20~24세,2021,28856,12753,16103,79.2,25758,11702,14056,83.3
11050, 광진구,025001, 20세,2021,4446,2003,2443,82,3896,1839,2057,89.4
11050, 광진구,025002, 21세,2021,5341,2307,3034,76,4681,2083,2598,80.2
11050, 광진구,025003, 22세,2021,5631,2512,3119,80.5,5007,2320,2687,86.3
11050, 광진구,025004, 23세,2021,6530,2863,3667,78.1,5906,2630,3276,80.3
11050, 광진구,025005, 24세,2021,6908,3068,3840,79.9,6268,2830,3438,82.3
11050, 광진구,030,25~29세,2021,38397,18177,20220,89.9,35931,17228,18703,92.1
11050, 광진구,030001, 25세,2021,7519,3379,4140,81.6,6880,3157,3723,84.8
11050, 광진구,030002, 26세,2021,7638,3609,4029,89.6,7090,3403,3687,92.3
11050, 광진구,030003, 27세,2021,7854,3641,4213,86.4,7385,3468,3917,88.5
11050, 광진구,030004, 28세,2021,7738,3821,3917,97.5,7305,3628,3677,98.7
11050, 광진구,030005, 29세,2021,7648,3727,3921,95.1,7271,3572,3699,96.6
11050, 광진구,035,30~34세,2021,30235,14985,15250,98.3,28287,14082,14205,99.1
11050, 광진구,035001, 30세,2021,6926,3439,3487,98.6,6535,3262,3273,99.7
11050, 광진구,035002, 31세,2021,6380,3189,3191,99.9,5931,2996,2935,102.1
11050, 광진구,035003, 32세,2021,5980,2948,3032,97.2,5605,2782,2823,98.5
11050, 광진구,035004, 33세,2021,5599,2761,2838,97.3,5248,2591,2657,97.5
11050, 광진구,035005, 34세,2021,5350,2648,2702,98,4968,2451,2517,97.4
11050, 광진구,040,35~39세,2021,25764,12784,12980,98.5,24274,12073,12201,99
11050, 광진구,040001, 35세,2021,5177,2584,2593,99.7,4859,2429,2430,100
11050, 광진구,040002, 36세,2021,5037,2525,2512,100.5,4710,2368,2342,101.1
11050, 광진구,040003, 37세,2021,4924,2435,2489,97.8,4631,2285,2346,97.4
11050, 광진구,040004, 38세,2021,5154,2596,2558,101.5,4881,2471,2410,102.5
11050, 광진구,040005, 39세,2021,5472,2644,2828,93.5,5193,2520,2673,94.3
11050, 광진구,045,40~44세,2021,24651,12275,12376,99.2,23512,11680,11832,98.7
11050, 광진구,045001, 40세,2021,5278,2634,2644,99.6,5039,2515,2524,99.6
11050, 광진구,045002, 41세,2021,5184,2599,2585,100.5,4961,2474,2487,99.5
11050, 광진구,045003, 42세,2021,4979,2414,2565,94.1,4749,2307,2442,94.5
11050, 광진구,045004, 43세,2021,4424,2236,2188,102.2,4189,2113,2076,101.8
11050, 광진구,045005, 44세,2021,4786,2392,2394,99.9,4574,2271,2303,98.6
11050, 광진구,050,45~49세,2021,25359,12503,12856,97.3,24216,11947,12269,97.4
11050, 광진구,050001, 45세,2021,4587,2273,2314,98.2,4378,2165,2213,97.8
11050, 광진구,050002, 46세,2021,4768,2361,2407,98.1,4566,2258,2308,97.8
11050, 광진구,050003, 47세,2021,5203,2546,2657,95.8,4968,2433,2535,96
11050, 광진구,050004, 48세,2021,5308,2581,2727,94.6,5074,2473,2601,95.1
11050, 광진구,050005, 49세,2021,5493,2742,2751,99.7,5230,2618,2612,100.2
11050, 광진구,055,50~54세,2021,28495,13624,14871,91.6,26901,12898,14003,92.1
11050, 광진구,055001, 50세,2021,5943,2872,3071,93.5,5629,2725,2904,93.8
11050, 광진구,055002, 51세,2021,5722,2739,2983,91.8,5403,2601,2802,92.8
11050, 광진구,055003, 52세,2021,5723,2681,3042,88.1,5386,2530,2856,88.6
11050, 광진구,055004, 53세,2021,5810,2780,3030,91.7,5476,2632,2844,92.5
11050, 광진구,055005, 54세,2021,5297,2552,2745,93,5007,2410,2597,92.8
11050, 광진구,060,55~59세,2021,26284,12829,13455,95.3,24357,11935,12422,96.1
11050, 광진구,060001, 55세,2021,5171,2488,2683,92.7,4834,2329,2505,93
11050, 광진구,060002, 56세,2021,5347,2624,2723,96.4,4993,2458,2535,97
11050, 광진구,060003, 57세,2021,5046,2467,2579,95.7,4649,2274,2375,95.7
11050, 광진구,060004, 58세,2021,5434,2682,2752,97.5,4954,2463,2491,98.9
11050, 광진구,060005, 59세,2021,5286,2568,2718,94.5,4927,2411,2516,95.8
11050, 광진구,065,60~64세,2021,25846,12260,13586,90.2,24478,11618,12860,90.3
11050, 광진구,065001, 60세,2021,5502,2558,2944,86.9,5283,2470,2813,87.8
11050, 광진구,065002, 61세,2021,5672,2703,2969,91,5321,2533,2788,90.9
11050, 광진구,065003, 62세,2021,5093,2411,2682,89.9,4820,2281,2539,89.8
11050, 광진구,065004, 63세,2021,4887,2327,2560,90.9,4603,2197,2406,91.3
11050, 광진구,065005, 64세,2021,4692,2261,2431,93,4451,2137,2314,92.4
11050, 광진구,070,65~69세,2021,18782,8896,9886,90,18057,8561,9496,90.2
11050, 광진구,070001, 65세,2021,4239,1999,2240,89.2,4065,1913,2152,88.9
11050, 광진구,070002, 66세,2021,4399,2058,2341,87.9,4221,1977,2244,88.1
11050, 광진구,070003, 67세,2021,3583,1725,1858,92.8,3432,1660,1772,93.7
11050, 광진구,070004, 68세,2021,3131,1506,1625,92.7,3011,1447,1564,92.5
11050, 광진구,070005, 69세,2021,3430,1608,1822,88.3,3328,1564,1764,88.7
11050, 광진구,075,70~74세,2021,12467,5711,6756,84.5,12209,5600,6609,84.7
11050, 광진구,075001, 70세,2021,2337,1082,1255,86.2,2256,1048,1208,86.8
11050, 광진구,075002, 71세,2021,2508,1174,1334,88,2449,1147,1302,88.1
11050, 광진구,075003, 72세,2021,2546,1175,1371,85.7,2492,1153,1339,86.1
11050, 광진구,075004, 73세,2021,2576,1168,1408,83,2535,1148,1387,82.8
11050, 광진구,075005, 74세,2021,2500,1112,1388,80.1,2477,1104,1373,80.4
11050, 광진구,080,75~79세,2021,9305,4255,5050,84.3,9206,4216,4990,84.5
11050, 광진구,080001, 75세,2021,1967,926,1041,89,1936,914,1022,89.4
11050, 광진구,080002, 76세,2021,1810,853,957,89.1,1792,846,946,89.4
11050, 광진구,080003, 77세,2021,1829,808,1021,79.1,1815,803,1012,79.3
11050, 광진구,080004, 78세,2021,1746,781,965,80.9,1728,778,950,81.9
11050, 광진구,080005, 79세,2021,1953,887,1066,83.2,1935,875,1060,82.5
11050, 광진구,085,80~84세,2021,6151,2609,3542,73.7,6084,2598,3486,74.5
11050, 광진구,085001, 80세,2021,1524,670,854,78.5,1512,666,846,78.7
11050, 광진구,085002, 81세,2021,1346,597,749,79.7,1336,595,741,80.3
11050, 광진구,085003, 82세,2021,1263,538,725,74.2,1248,538,710,75.8
11050, 광진구,085004, 83세,2021,1096,452,644,70.2,1077,448,629,71.2
11050, 광진구,085005, 84세,2021,922,352,570,61.8,911,351,560,62.7
11050, 광진구,090,85~89세,2021,2726,903,1823,49.5,2691,897,1794,50
11050, 광진구,090001, 85세,2021,753,263,490,53.7,741,262,479,54.7
11050, 광진구,090002, 86세,2021,676,238,438,54.3,672,236,436,54.1
11050, 광진구,090003, 87세,2021,531,174,357,48.7,524,172,352,48.9
11050, 광진구,090004, 88세,2021,390,124,266,46.6,380,123,257,47.9
11050, 광진구,090005, 89세,2021,376,104,272,38.2,374,104,270,38.5
11050, 광진구,095,90~94세,2021,887,225,662,34,883,225,658,34.2
11050, 광진구,095001, 90세,2021,239,64,175,36.6,237,64,173,37
11050, 광진구,095002, 91세,2021,210,58,152,38.2,210,58,152,38.2
11050, 광진구,095003, 92세,2021,192,48,144,33.3,191,48,143,33.6
11050, 광진구,095004, 93세,2021,141,26,115,22.6,140,26,114,22.8
11050, 광진구,095005, 94세,2021,105,29,76,38.2,105,29,76,38.2
11050, 광진구,100,95~99세,2021,203,47,156,30.1,202,47,155,30.3
11050, 광진구,100001, 95세,2021,65,13,52,25,65,13,52,25
11050, 광진구,100002, 96세,2021,45,16,29,55.2,45,16,29,55.2
11050, 광진구,100003, 97세,2021,43,9,34,26.5,42,9,33,27.3
11050, 광진구,100004, 98세,2021,26,5,21,23.8,26,5,21,23.8
11050, 광진구,100005, 99세,2021,24,X,20,20,24,X,20,20
11050, 광진구,101,100세이상,2021,41,11,30,36.7,40,11,29,37.9
11050, 광진구,102,15세미만,2021,29387,15074,14313,105.3,28519,14629,13890,105.3
11050, 광진구,103,15~64세,2021,267150,128738,138412,93,250504,121553,128951,94.3
11050, 광진구,104,65세이상,2021,50562,22657,27905,81.2,49372,22155,27217,81.4
11050, 광진구,086,85세이상,2021,3857,1186,2671,44.4,3816,1180,2636,44.8
11050, 광진구,126,평균연령,2021,42.5,42,42.9,,42.7,42.1,43.2,
11050, 광진구,127,중위연령,2021,41.5,41.1,41.8,,41.7,41.2,42.2,
11060, 동대문구,000,합계,2021,348201,169409,178792,94.8,329092,161761,167331,96.7
11060, 동대문구,005,0~4세,2021,8800,4462,4338,102.9,8633,4385,4248,103.2
11060, 동대문구,005001, 0세,2021,1605,817,788,103.7,1570,804,766,105
11060, 동대문구,005002, 1세,2021,1677,852,825,103.3,1642,840,802,104.7
11060, 동대문구,005003, 2세,2021,1807,893,914,97.7,1770,871,899,96.9
11060, 동대문구,005004, 3세,2021,1821,921,900,102.3,1788,906,882,102.7
11060, 동대문구,005005, 4세,2021,1890,979,911,107.5,1863,964,899,107.2
11060, 동대문구,010,5~9세,2021,10630,5480,5150,106.4,10439,5405,5034,107.4
11060, 동대문구,010001, 5세,2021,2138,1111,1027,108.2,2078,1087,991,109.7
11060, 동대문구,010002, 6세,2021,2166,1093,1073,101.9,2122,1077,1045,103.1
11060, 동대문구,010003, 7세,2021,2051,1052,999,105.3,2025,1045,980,106.6
11060, 동대문구,010004, 8세,2021,2128,1108,1020,108.6,2093,1094,999,109.5
11060, 동대문구,010005, 9세,2021,2147,1116,1031,108.2,2121,1102,1019,108.1
11060, 동대문구,015,10~14세,2021,10424,5373,5051,106.4,10331,5322,5009,106.2
11060, 동대문구,015001, 10세,2021,2144,1110,1034,107.4,2124,1095,1029,106.4
11060, 동대문구,015002, 11세,2021,2044,1080,964,112,2028,1072,956,112.1
11060, 동대문구,015003, 12세,2021,1978,1012,966,104.8,1959,1002,957,104.7
11060, 동대문구,015004, 13세,2021,2128,1060,1068,99.3,2105,1049,1056,99.3
11060, 동대문구,015005, 14세,2021,2130,1111,1019,109,2115,1104,1011,109.2
11060, 동대문구,020,15~19세,2021,13267,6310,6957,90.7,12522,6107,6415,95.2
11060, 동대문구,020001, 15세,2021,2055,1058,997,106.1,2035,1049,986,106.4
11060, 동대문구,020002, 16세,2021,1964,1004,960,104.6,1941,998,943,105.8
11060, 동대문구,020003, 17세,2021,2144,1078,1066,101.1,2116,1070,1046,102.3
11060, 동대문구,020004, 18세,2021,2697,1266,1431,88.5,2499,1222,1277,95.7
11060, 동대문구,020005, 19세,2021,4407,1904,2503,76.1,3931,1768,2163,81.7
11060, 동대문구,025,20~24세,2021,34611,14812,19799,74.8,28692,12785,15907,80.4
11060, 동대문구,025001, 20세,2021,5653,2262,3391,66.7,4787,2008,2779,72.3
11060, 동대문구,025002, 21세,2021,6392,2549,3843,66.3,5268,2167,3101,69.9
11060, 동대문구,025003, 22세,2021,6924,2891,4033,71.7,5709,2481,3228,76.9
11060, 동대문구,025004, 23세,2021,7853,3514,4339,81,6412,2980,3432,86.8
11060, 동대문구,025005, 24세,2021,7789,3596,4193,85.8,6516,3149,3367,93.5
11060, 동대문구,030,25~29세,2021,34193,17529,16664,105.2,30717,16185,14532,111.4
11060, 동대문구,030001, 25세,2021,7628,3699,3929,94.1,6586,3349,3237,103.5
11060, 동대문구,030002, 26세,2021,7227,3710,3517,105.5,6436,3410,3026,112.7
11060, 동대문구,030003, 27세,2021,6805,3562,3243,109.8,6139,3302,2837,116.4
11060, 동대문구,030004, 28세,2021,6392,3377,3015,112,5891,3162,2729,115.9
11060, 동대문구,030005, 29세,2021,6141,3181,2960,107.5,5665,2962,2703,109.6
11060, 동대문구,035,30~34세,2021,25602,13095,12507,104.7,23654,12225,11429,107
11060, 동대문구,035001, 30세,2021,5610,2912,2698,107.9,5190,2717,2473,109.9
11060, 동대문구,035002, 31세,2021,5306,2678,2628,101.9,4898,2499,2399,104.2
11060, 동대문구,035003, 32세,2021,5095,2625,2470,106.3,4673,2433,2240,108.6
11060, 동대문구,035004, 33세,2021,4800,2403,2397,100.3,4454,2252,2202,102.3
11060, 동대문구,035005, 34세,2021,4791,2477,2314,107,4439,2324,2115,109.9
11060, 동대문구,040,35~39세,2021,24673,12682,11991,105.8,23276,12049,11227,107.3
11060, 동대문구,040001, 35세,2021,4709,2445,2264,108,4376,2285,2091,109.3
11060, 동대문구,040002, 36세,2021,4675,2380,2295,103.7,4416,2266,2150,105.4
11060, 동대문구,040003, 37세,2021,4720,2418,2302,105,4447,2296,2151,106.7
11060, 동대문구,040004, 38세,2021,5238,2693,2545,105.8,4973,2574,2399,107.3
11060, 동대문구,040005, 39세,2021,5331,2746,2585,106.2,5064,2628,2436,107.9
11060, 동대문구,045,40~44세,2021,24282,12575,11707,107.4,23245,12058,11187,107.8
11060, 동대문구,045001, 40세,2021,5274,2723,2551,106.7,5080,2631,2449,107.4
11060, 동대문구,045002, 41세,2021,5151,2693,2458,109.6,4926,2580,2346,110
11060, 동대문구,045003, 42세,2021,4892,2537,2355,107.7,4656,2418,2238,108
11060, 동대문구,045004, 43세,2021,4414,2320,2094,110.8,4213,2214,1999,110.8
11060, 동대문구,045005, 44세,2021,4551,2302,2249,102.4,4370,2215,2155,102.8
11060, 동대문구,050,45~49세,2021,23928,12223,11705,104.4,22988,11786,11202,105.2
11060, 동대문구,050001, 45세,2021,4318,2200,2118,103.9,4136,2125,2011,105.7
11060, 동대문구,050002, 46세,2021,4557,2354,2203,106.9,4402,2284,2118,107.8
11060, 동대문구,050003, 47세,2021,4859,2523,2336,108,4668,2426,2242,108.2
11060, 동대문구,050004, 48세,2021,4977,2477,2500,99.1,4777,2389,2388,100
11060, 동대문구,050005, 49세,2021,5217,2669,2548,104.7,5005,2562,2443,104.9
11060, 동대문구,055,50~54세,2021,26451,13093,13358,98,25477,12678,12799,99.1
11060, 동대문구,055001, 50세,2021,5551,2835,2716,104.4,5342,2738,2604,105.1
11060, 동대문구,055002, 51세,2021,5432,2701,2731,98.9,5228,2602,2626,99.1
11060, 동대문구,055003, 52세,2021,5420,2616,2804,93.3,5201,2534,2667,95
11060, 동대문구,055004, 53세,2021,5179,2570,2609,98.5,4993,2491,2502,99.6
11060, 동대문구,055005, 54세,2021,4869,2371,2498,94.9,4713,2313,2400,96.4
11060, 동대문구,060,55~59세,2021,24680,12361,12319,100.3,23723,11917,11806,100.9
11060, 동대문구,060001, 55세,2021,4896,2547,2349,108.4,4700,2464,2236,110.2
11060, 동대문구,060002, 56세,2021,5009,2497,2512,99.4,4804,2395,2409,99.4
11060, 동대문구,060003, 57세,2021,4690,2313,2377,97.3,4508,2225,2283,97.5
11060, 동대문구,060004, 58세,2021,5046,2520,2526,99.8,4833,2424,2409,100.6
11060, 동대문구,060005, 59세,2021,5039,2484,2555,97.2,4878,2409,2469,97.6
11060, 동대문구,065,60~64세,2021,26047,12517,13530,92.5,25430,12238,13192,92.8
11060, 동대문구,065001, 60세,2021,5451,2637,2814,93.7,5355,2593,2762,93.9
11060, 동대문구,065002, 61세,2021,5615,2656,2959,89.8,5472,2591,2881,89.9
11060, 동대문구,065003, 62세,2021,5148,2503,2645,94.6,5026,2442,2584,94.5
11060, 동대문구,065004, 63세,2021,4898,2384,2514,94.8,4777,2335,2442,95.6
11060, 동대문구,065005, 64세,2021,4935,2337,2598,90,4800,2277,2523,90.2
11060, 동대문구,070,65~69세,2021,20570,9767,10803,90.4,20191,9601,10590,90.7
11060, 동대문구,070001, 65세,2021,4524,2188,2336,93.7,4430,2152,2278,94.5
11060, 동대문구,070002, 66세,2021,4771,2264,2507,90.3,4673,2221,2452,90.6
11060, 동대문구,070003, 67세,2021,3943,1887,2056,91.8,3871,1851,2020,91.6
11060, 동대문구,070004, 68세,2021,3566,1690,1876,90.1,3509,1669,1840,90.7
11060, 동대문구,070005, 69세,2021,3766,1738,2028,85.7,3708,1708,2000,85.4
11060, 동대문구,075,70~74세,2021,14991,6853,8138,84.2,14833,6775,8058,84.1
11060, 동대문구,075001, 70세,2021,2793,1314,1479,88.8,2753,1293,1460,88.6
11060, 동대문구,075002, 71세,2021,3061,1477,1584,93.2,3023,1457,1566,93
11060, 동대문구,075003, 72세,2021,3030,1399,1631,85.8,2995,1383,1612,85.8
11060, 동대문구,075004, 73세,2021,2991,1300,1691,76.9,2968,1287,1681,76.6
11060, 동대문구,075005, 74세,2021,3116,1363,1753,77.8,3094,1355,1739,77.9
11060, 동대문구,080,75~79세,2021,12046,5287,6759,78.2,11998,5274,6724,78.4
11060, 동대문구,080001, 75세,2021,2416,1074,1342,80,2399,1067,1332,80.1
11060, 동대문구,080002, 76세,2021,2362,1045,1317,79.3,2352,1044,1308,79.8
11060, 동대문구,080003, 77세,2021,2290,963,1327,72.6,2279,960,1319,72.8
11060, 동대문구,080004, 78세,2021,2356,1078,1278,84.4,2351,1077,1274,84.5
11060, 동대문구,080005, 79세,2021,2622,1127,1495,75.4,2617,1126,1491,75.5
11060, 동대문구,085,80~84세,2021,8005,3311,4694,70.5,7960,3300,4660,70.8
11060, 동대문구,085001, 80세,2021,2048,903,1145,78.9,2039,899,1140,78.9
11060, 동대문구,085002, 81세,2021,1739,701,1038,67.5,1726,699,1027,68.1
11060, 동대문구,085003, 82세,2021,1595,672,923,72.8,1591,672,919,73.1
11060, 동대문구,085004, 83세,2021,1455,588,867,67.8,1448,586,862,68
11060, 동대문구,085005, 84세,2021,1168,447,721,62,1156,444,712,62.4
11060, 동대문구,090,85~89세,2021,3682,1321,2361,56,3668,1314,2354,55.8
11060, 동대문구,090001, 85세,2021,1048,406,642,63.2,1046,405,641,63.2
11060, 동대문구,090002, 86세,2021,886,319,567,56.3,881,317,564,56.2
11060, 동대문구,090003, 87세,2021,714,257,457,56.2,711,254,457,55.6
11060, 동대문구,090004, 88세,2021,570,181,389,46.5,567,180,387,46.5
11060, 동대문구,090005, 89세,2021,464,158,306,51.6,463,158,305,51.8
11060, 동대문구,095,90~94세,2021,1049,293,756,38.8,1046,293,753,38.9
11060, 동대문구,095001, 90세,2021,301,88,213,41.3,298,88,210,41.9
11060, 동대문구,095002, 91세,2021,282,76,206,36.9,282,76,206,36.9
11060, 동대문구,095003, 92세,2021,198,60,138,43.5,198,60,138,43.5
11060, 동대문구,095004, 93세,2021,154,43,111,38.7,154,43,111,38.7
11060, 동대문구,095005, 94세,2021,114,26,88,29.5,114,26,88,29.5
11060, 동대문구,100,95~99세,2021,225,54,171,31.6,224,53,171,31
11060, 동대문구,100001, 95세,2021,58,12,46,26.1,57,11,46,23.9
11060, 동대문구,100002, 96세,2021,63,18,45,40,63,18,45,40
11060, 동대문구,100003, 97세,2021,38,7,31,22.6,38,7,31,22.6
11060, 동대문구,100004, 98세,2021,47,12,35,34.3,47,12,35,34.3
11060, 동대문구,100005, 99세,2021,19,5,14,35.7,19,5,14,35.7
11060, 동대문구,101,100세이상,2021,45,11,34,32.4,45,11,34,32.4
11060, 동대문구,102,15세미만,2021,29854,15315,14539,105.3,29403,15112,14291,105.7
11060, 동대문구,103,15~64세,2021,257734,127197,130537,97.4,239724,120028,119696,100.3
11060, 동대문구,104,65세이상,2021,60613,26897,33716,79.8,59965,26621,33344,79.8
11060, 동대문구,086,85세이상,2021,5001,1679,3322,50.5,4983,1671,3312,50.5
11060, 동대문구,126,평균연령,2021,43.2,42.7,43.8,,43.8,43,44.6,
11060, 동대문구,127,중위연령,2021,42.3,41.8,42.8,,43.4,42.5,44.4,
11070, 중랑구,000,합계,2021,380307,186364,193943,96.1,373443,183625,189818,96.7
11070, 중랑구,005,0~4세,2021,9688,4944,4744,104.2,9506,4850,4656,104.2
11070, 중랑구,005001, 0세,2021,1825,925,900,102.8,1793,908,885,102.6
11070, 중랑구,005002, 1세,2021,1761,921,840,109.6,1719,897,822,109.1
11070, 중랑구,005003, 2세,2021,1946,966,980,98.6,1912,948,964,98.3
11070, 중랑구,005004, 3세,2021,2046,1076,970,110.9,2011,1062,949,111.9
11070, 중랑구,005005, 4세,2021,2110,1056,1054,100.2,2071,1035,1036,99.9
11070, 중랑구,010,5~9세,2021,11763,6094,5669,107.5,11595,5999,5596,107.2
11070, 중랑구,010001, 5세,2021,2354,1238,1116,110.9,2313,1213,1100,110.3
11070, 중랑구,010002, 6세,2021,2382,1244,1138,109.3,2348,1222,1126,108.5
11070, 중랑구,010003, 7세,2021,2230,1142,1088,105,2196,1119,1077,103.9
11070, 중랑구,010004, 8세,2021,2294,1176,1118,105.2,2266,1165,1101,105.8
11070, 중랑구,010005, 9세,2021,2503,1294,1209,107,2472,1280,1192,107.4
11070, 중랑구,015,10~14세,2021,11695,5978,5717,104.6,11596,5924,5672,104.4
11070, 중랑구,015001, 10세,2021,2393,1228,1165,105.4,2378,1221,1157,105.5
11070, 중랑구,015002, 11세,2021,2326,1203,1123,107.1,2306,1193,1113,107.2
11070, 중랑구,015003, 12세,2021,2167,1098,1069,102.7,2144,1090,1054,103.4
11070, 중랑구,015004, 13세,2021,2380,1191,1189,100.2,2353,1174,1179,99.6
11070, 중랑구,015005, 14세,2021,2429,1258,1171,107.4,2415,1246,1169,106.6
11070, 중랑구,020,15~19세,2021,12907,6554,6353,103.2,12809,6506,6303,103.2
11070, 중랑구,020001, 15세,2021,2377,1272,1105,115.1,2365,1265,1100,115
11070, 중랑구,020002, 16세,2021,2332,1209,1123,107.7,2321,1203,1118,107.6
11070, 중랑구,020003, 17세,2021,2574,1278,1296,98.6,2558,1271,1287,98.8
11070, 중랑구,020004, 18세,2021,2786,1371,1415,96.9,2761,1357,1404,96.7
11070, 중랑구,020005, 19세,2021,2838,1424,1414,100.7,2804,1410,1394,101.1
11070, 중랑구,025,20~24세,2021,21817,10771,11046,97.5,21305,10593,10712,98.9
11070, 중랑구,025001, 20세,2021,3502,1818,1684,108,3445,1801,1644,109.5
11070, 중랑구,025002, 21세,2021,4107,2049,2058,99.6,4023,2017,2006,100.5
11070, 중랑구,025003, 22세,2021,4243,2070,2173,95.3,4137,2031,2106,96.4
11070, 중랑구,025004, 23세,2021,4711,2329,2382,97.8,4580,2290,2290,100
11070, 중랑구,025005, 24세,2021,5254,2505,2749,91.1,5120,2454,2666,92
11070, 중랑구,030,25~29세,2021,32110,15624,16486,94.8,31270,15325,15945,96.1
11070, 중랑구,030001, 25세,2021,5727,2762,2965,93.2,5581,2712,2869,94.5
11070, 중랑구,030002, 26세,2021,6184,2980,3204,93,6023,2921,3102,94.2
11070, 중랑구,030003, 27세,2021,6551,3154,3397,92.8,6387,3103,3284,94.5
11070, 중랑구,030004, 28세,2021,6713,3328,3385,98.3,6529,3257,3272,99.5
11070, 중랑구,030005, 29세,2021,6935,3400,3535,96.2,6750,3332,3418,97.5
11070, 중랑구,035,30~34세,2021,29131,14697,14434,101.8,28111,14303,13808,103.6
11070, 중랑구,035001, 30세,2021,6243,3033,3210,94.5,6053,2963,3090,95.9
11070, 중랑구,035002, 31세,2021,6017,3017,3000,100.6,5819,2941,2878,102.2
11070, 중랑구,035003, 32세,2021,5764,2960,2804,105.6,5543,2872,2671,107.5
11070, 중랑구,035004, 33세,2021,5653,2922,2731,107,5439,2843,2596,109.5
11070, 중랑구,035005, 34세,2021,5454,2765,2689,102.8,5257,2684,2573,104.3
11070, 중랑구,040,35~39세,2021,27544,14267,13277,107.5,26754,13934,12820,108.7
11070, 중랑구,040001, 35세,2021,5390,2757,2633,104.7,5215,2685,2530,106.1
11070, 중랑구,040002, 36세,2021,5271,2720,2551,106.6,5098,2646,2452,107.9
11070, 중랑구,040003, 37세,2021,5356,2780,2576,107.9,5213,2712,2501,108.4
11070, 중랑구,040004, 38세,2021,5579,2920,2659,109.8,5415,2858,2557,111.8
11070, 중랑구,040005, 39세,2021,5948,3090,2858,108.1,5813,3033,2780,109.1
11070, 중랑구,045,40~44세,2021,27114,14226,12888,110.4,26577,14017,12560,111.6
11070, 중랑구,045001, 40세,2021,5900,3112,2788,111.6,5779,3068,2711,113.2
11070, 중랑구,045002, 41세,2021,6001,3136,2865,109.5,5889,3090,2799,110.4
11070, 중랑구,045003, 42세,2021,5448,2863,2585,110.8,5331,2817,2514,112.1
11070, 중랑구,045004, 43세,2021,4764,2505,2259,110.9,4667,2462,2205,111.7
11070, 중랑구,045005, 44세,2021,5001,2610,2391,109.2,4911,2580,2331,110.7
11070, 중랑구,050,45~49세,2021,27093,13620,13473,101.1,26573,13418,13155,102
11070, 중랑구,050001, 45세,2021,4781,2475,2306,107.3,4676,2435,2241,108.7
11070, 중랑구,050002, 46세,2021,5056,2565,2491,103,4959,2525,2434,103.7
11070, 중랑구,050003, 47세,2021,5583,2807,2776,101.1,5483,2774,2709,102.4
11070, 중랑구,050004, 48세,2021,5772,2861,2911,98.3,5660,2815,2845,98.9
11070, 중랑구,050005, 49세,2021,5901,2912,2989,97.4,5795,2869,2926,98.1
11070, 중랑구,055,50~54세,2021,33019,15996,17023,94,32432,15747,16685,94.4
11070, 중랑구,055001, 50세,2021,6630,3346,3284,101.9,6491,3285,3206,102.5
11070, 중랑구,055002, 51세,2021,6432,3150,3282,96,6311,3096,3215,96.3
11070, 중랑구,055003, 52세,2021,6729,3255,3474,93.7,6604,3207,3397,94.4
11070, 중랑구,055004, 53세,2021,6837,3200,3637,88,6720,3152,3568,88.3
11070, 중랑구,055005, 54세,2021,6391,3045,3346,91,6306,3007,3299,91.1
11070, 중랑구,060,55~59세,2021,32709,15964,16745,95.3,32095,15721,16374,96
11070, 중랑구,060001, 55세,2021,6287,3072,3215,95.6,6161,3025,3136,96.5
11070, 중랑구,060002, 56세,2021,6632,3199,3433,93.2,6499,3154,3345,94.3
11070, 중랑구,060003, 57세,2021,6271,3075,3196,96.2,6165,3029,3136,96.6
11070, 중랑구,060004, 58세,2021,6703,3250,3453,94.1,6561,3198,3363,95.1
11070, 중랑구,060005, 59세,2021,6816,3368,3448,97.7,6709,3315,3394,97.7
11070, 중랑구,065,60~64세,2021,34050,16415,17635,93.1,33650,16268,17382,93.6
11070, 중랑구,065001, 60세,2021,7506,3596,3910,92,7433,3568,3865,92.3
11070, 중랑구,065002, 61세,2021,7433,3590,3843,93.4,7350,3560,3790,93.9
11070, 중랑구,065003, 62세,2021,6679,3242,3437,94.3,6591,3215,3376,95.2
11070, 중랑구,065004, 63세,2021,6259,3048,3211,94.9,6177,3014,3163,95.3
11070, 중랑구,065005, 64세,2021,6173,2939,3234,90.9,6099,2911,3188,91.3
11070, 중랑구,070,65~69세,2021,25473,12169,13304,91.5,25181,12046,13135,91.7
11070, 중랑구,070001, 65세,2021,5635,2688,2947,91.2,5569,2658,2911,91.3
11070, 중랑구,070002, 66세,2021,5932,2808,3124,89.9,5866,2778,3088,90
11070, 중랑구,070003, 67세,2021,4968,2417,2551,94.7,4905,2391,2514,95.1
11070, 중랑구,070004, 68세,2021,4328,2051,2277,90.1,4276,2034,2242,90.7
11070, 중랑구,070005, 69세,2021,4610,2205,2405,91.7,4565,2185,2380,91.8
11070, 중랑구,075,70~74세,2021,17645,8152,9493,85.9,17526,8104,9422,86
11070, 중랑구,075001, 70세,2021,3326,1555,1771,87.8,3297,1544,1753,88.1
11070, 중랑구,075002, 71세,2021,3601,1690,1911,88.4,3578,1683,1895,88.8
11070, 중랑구,075003, 72세,2021,3672,1704,1968,86.6,3647,1691,1956,86.5
11070, 중랑구,075004, 73세,2021,3511,1602,1909,83.9,3483,1592,1891,84.2
11070, 중랑구,075005, 74세,2021,3535,1601,1934,82.8,3521,1594,1927,82.7
11070, 중랑구,080,75~79세,2021,13138,5829,7309,79.8,13088,5818,7270,80
11070, 중랑구,080001, 75세,2021,2724,1234,1490,82.8,2710,1233,1477,83.5
11070, 중랑구,080002, 76세,2021,2553,1136,1417,80.2,2542,1131,1411,80.2
11070, 중랑구,080003, 77세,2021,2550,1120,1430,78.3,2540,1118,1422,78.6
11070, 중랑구,080004, 78세,2021,2452,1096,1356,80.8,2441,1093,1348,81.1
11070, 중랑구,080005, 79세,2021,2859,1243,1616,76.9,2855,1243,1612,77.1
11070, 중랑구,085,80~84세,2021,8354,3543,4811,73.6,8329,3533,4796,73.7
11070, 중랑구,085001, 80세,2021,2140,957,1183,80.9,2137,955,1182,80.8
11070, 중랑구,085002, 81세,2021,1841,782,1059,73.8,1831,777,1054,73.7
11070, 중랑구,085003, 82세,2021,1716,719,997,72.1,1712,717,995,72.1
11070, 중랑구,085004, 83세,2021,1444,580,864,67.1,1438,579,859,67.4
11070, 중랑구,085005, 84세,2021,1213,505,708,71.3,1211,505,706,71.5
11070, 중랑구,090,85~89세,2021,3605,1217,2388,51,3600,1217,2383,51.1
11070, 중랑구,090001, 85세,2021,1040,397,643,61.7,1038,397,641,61.9
11070, 중랑구,090002, 86세,2021,894,287,607,47.3,893,287,606,47.4
11070, 중랑구,090003, 87세,2021,693,232,461,50.3,693,232,461,50.3
11070, 중랑구,090004, 88세,2021,553,165,388,42.5,551,165,386,42.7
11070, 중랑구,090005, 89세,2021,425,136,289,47.1,425,136,289,47.1
11070, 중랑구,095,90~94세,2021,1175,258,917,28.1,1170,256,914,28
11070, 중랑구,095001, 90세,2021,344,79,265,29.8,341,78,263,29.7
11070, 중랑구,095002, 91세,2021,290,58,232,25,288,57,231,24.7
11070, 중랑구,095003, 92세,2021,213,43,170,25.3,213,43,170,25.3
11070, 중랑구,095004, 93세,2021,198,42,156,26.9,198,42,156,26.9
11070, 중랑구,095005, 94세,2021,130,36,94,38.3,130,36,94,38.3
11070, 중랑구,100,95~99세,2021,242,42,200,21,241,42,199,21.1
11070, 중랑구,100001, 95세,2021,76,15,61,24.6,75,15,60,25
11070, 중랑구,100002, 96세,2021,59,8,51,15.7,59,8,51,15.7
11070, 중랑구,100003, 97세,2021,42,7,35,20,42,7,35,20
11070, 중랑구,100004, 98세,2021,43,9,34,26.5,43,9,34,26.5
11070, 중랑구,100005, 99세,2021,22,X,19,15.8,22,X,19,15.8
11070, 중랑구,101,100세이상,2021,35,X,31,12.9,35,X,31,12.9
11070, 중랑구,102,15세미만,2021,33146,17016,16130,105.5,32697,16773,15924,105.3
11070, 중랑구,103,15~64세,2021,277494,138134,139360,99.1,271576,135832,135744,100.1
11070, 중랑구,104,65세이상,2021,69667,31214,38453,81.2,69170,31020,38150,81.3
11070, 중랑구,086,85세이상,2021,5057,1521,3536,43,5046,1519,3527,43.1
11070, 중랑구,126,평균연령,2021,45.2,44.3,46,,45.3,44.4,46.1,
11070, 중랑구,127,중위연령,2021,46.3,45,47.6,,46.5,45.1,47.8,
11080, 성북구,000,합계,2021,435509,207428,228081,90.9,422428,202349,220079,91.9
11080, 성북구,005,0~4세,2021,11485,5926,5559,106.6,11278,5822,5456,106.7
11080, 성북구,005001, 0세,2021,1995,1059,936,113.1,1969,1042,927,112.4
11080, 성북구,005002, 1세,2021,2115,1074,1041,103.2,2081,1061,1020,104
11080, 성북구,005003, 2세,2021,2317,1197,1120,106.9,2273,1174,1099,106.8
11080, 성북구,005004, 3세,2021,2371,1240,1131,109.6,2329,1220,1109,110
11080, 성북구,005005, 4세,2021,2687,1356,1331,101.9,2626,1325,1301,101.8
11080, 성북구,010,5~9세,2021,15757,8001,7756,103.2,15568,7901,7667,103.1
11080, 성북구,010001, 5세,2021,3001,1508,1493,101,2955,1483,1472,100.7
11080, 성북구,010002, 6세,2021,3186,1621,1565,103.6,3146,1600,1546,103.5
11080, 성북구,010003, 7세,2021,3096,1565,1531,102.2,3059,1546,1513,102.2
11080, 성북구,010004, 8세,2021,3086,1544,1542,100.1,3047,1525,1522,100.2
11080, 성북구,010005, 9세,2021,3388,1763,1625,108.5,3361,1747,1614,108.2
11080, 성북구,015,10~14세,2021,16588,8518,8070,105.6,16487,8462,8025,105.4
11080, 성북구,015001, 10세,2021,3411,1735,1676,103.5,3382,1724,1658,104
11080, 성북구,015002, 11세,2021,3244,1631,1613,101.1,3224,1617,1607,100.6
11080, 성북구,015003, 12세,2021,3065,1581,1484,106.5,3052,1572,1480,106.2
11080, 성북구,015004, 13세,2021,3302,1722,1580,109,3284,1711,1573,108.8
11080, 성북구,015005, 14세,2021,3566,1849,1717,107.7,3545,1838,1707,107.7
11080, 성북구,020,15~19세,2021,21123,10174,10949,92.9,20382,9965,10417,95.7
11080, 성북구,020001, 15세,2021,3241,1628,1613,100.9,3218,1618,1600,101.1
11080, 성북구,020002, 16세,2021,3238,1720,1518,113.3,3224,1714,1510,113.5
11080, 성북구,020003, 17세,2021,3661,1868,1793,104.2,3612,1858,1754,105.9
11080, 성북구,020004, 18세,2021,4333,2104,2229,94.4,4103,2033,2070,98.2
11080, 성북구,020005, 19세,2021,6650,2854,3796,75.2,6225,2742,3483,78.7
11080, 성북구,025,20~24세,2021,39295,16619,22676,73.3,35670,15497,20173,76.8
11080, 성북구,025001, 20세,2021,7320,2904,4416,65.8,6689,2739,3950,69.3
11080, 성북구,025002, 21세,2021,7764,3024,4740,63.8,6982,2806,4176,67.2
11080, 성북구,025003, 22세,2021,7775,3285,4490,73.2,7044,3069,3975,77.2
11080, 성북구,025004, 23세,2021,8246,3614,4632,78,7457,3343,4114,81.3
11080, 성북구,025005, 24세,2021,8190,3792,4398,86.2,7498,3540,3958,89.4
11080, 성북구,030,25~29세,2021,36509,18161,18348,99,34293,17309,16984,101.9
11080, 성북구,030001, 25세,2021,7870,3776,4094,92.2,7281,3561,3720,95.7
11080, 성북구,030002, 26세,2021,7602,3733,3869,96.5,7063,3533,3530,100.1
11080, 성북구,030003, 27세,2021,7340,3752,3588,104.6,6938,3595,3343,107.5
11080, 성북구,030004, 28세,2021,6858,3506,3352,104.6,6516,3368,3148,107
11080, 성북구,030005, 29세,2021,6839,3394,3445,98.5,6495,3252,3243,100.3
11080, 성북구,035,30~34세,2021,28749,14366,14383,99.9,27296,13751,13545,101.5
11080, 성북구,035001, 30세,2021,6243,3153,3090,102,5958,3053,2905,105.1
11080, 성북구,035002, 31세,2021,5876,2921,2955,98.8,5559,2787,2772,100.5
11080, 성북구,035003, 32세,2021,5641,2855,2786,102.5,5336,2731,2605,104.8
11080, 성북구,035004, 33세,2021,5553,2747,2806,97.9,5256,2619,2637,99.3
11080, 성북구,035005, 34세,2021,5436,2690,2746,98,5187,2561,2626,97.5
11080, 성북구,040,35~39세,2021,29948,14907,15041,99.1,28838,14408,14430,99.8
11080, 성북구,040001, 35세,2021,5547,2774,2773,100,5302,2661,2641,100.8
11080, 성북구,040002, 36세,2021,5675,2826,2849,99.2,5444,2713,2731,99.3
11080, 성북구,040003, 37세,2021,5775,2915,2860,101.9,5549,2819,2730,103.3
11080, 성북구,040004, 38세,2021,6342,3116,3226,96.6,6122,3027,3095,97.8
11080, 성북구,040005, 39세,2021,6609,3276,3333,98.3,6421,3188,3233,98.6
11080, 성북구,045,40~44세,2021,31385,15506,15879,97.7,30510,15130,15380,98.4
11080, 성북구,045001, 40세,2021,6706,3363,3343,100.6,6514,3284,3230,101.7
11080, 성북구,045002, 41세,2021,6650,3248,3402,95.5,6456,3168,3288,96.4
11080, 성북구,045003, 42세,2021,6523,3214,3309,97.1,6346,3133,3213,97.5
11080, 성북구,045004, 43세,2021,5636,2797,2839,98.5,5476,2729,2747,99.3
11080, 성북구,045005, 44세,2021,5870,2884,2986,96.6,5718,2816,2902,97
11080, 성북구,050,45~49세,2021,34345,16792,17553,95.7,33633,16480,17153,96.1
11080, 성북구,050001, 45세,2021,6025,2965,3060,96.9,5883,2904,2979,97.5
11080, 성북구,050002, 46세,2021,6446,3117,3329,93.6,6309,3061,3248,94.2
11080, 성북구,050003, 47세,2021,7122,3516,3606,97.5,6995,3455,3540,97.6
11080, 성북구,050004, 48세,2021,7282,3521,3761,93.6,7131,3445,3686,93.5
11080, 성북구,050005, 49세,2021,7470,3673,3797,96.7,7315,3615,3700,97.7
11080, 성북구,055,50~54세,2021,36206,17784,18422,96.5,35552,17485,18067,96.8
11080, 성북구,055001, 50세,2021,7707,3770,3937,95.8,7568,3709,3859,96.1
11080, 성북구,055002, 51세,2021,7569,3709,3860,96.1,7433,3649,3784,96.4
11080, 성북구,055003, 52세,2021,7399,3646,3753,97.1,7258,3572,3686,96.9
11080, 성북구,055004, 53세,2021,7083,3528,3555,99.2,6958,3471,3487,99.5
11080, 성북구,055005, 54세,2021,6448,3131,3317,94.4,6335,3084,3251,94.9
11080, 성북구,060,55~59세,2021,30422,14703,15719,93.5,29938,14491,15447,93.8
11080, 성북구,060001, 55세,2021,6066,3005,3061,98.2,5958,2957,3001,98.5
11080, 성북구,060002, 56세,2021,6246,3044,3202,95.1,6155,3001,3154,95.1
11080, 성북구,060003, 57세,2021,5929,2843,3086,92.1,5851,2810,3041,92.4
11080, 성북구,060004, 58세,2021,6069,2928,3141,93.2,5956,2878,3078,93.5
11080, 성북구,060005, 59세,2021,6112,2883,3229,89.3,6018,2845,3173,89.7
11080, 성북구,065,60~64세,2021,31103,14699,16404,89.6,30774,14543,16231,89.6
11080, 성북구,065001, 60세,2021,6591,3173,3418,92.8,6524,3145,3379,93.1
11080, 성북구,065002, 61세,2021,6786,3120,3666,85.1,6702,3075,3627,84.8
11080, 성북구,065003, 62세,2021,6099,2939,3160,93,6034,2909,3125,93.1
11080, 성북구,065004, 63세,2021,5844,2780,3064,90.7,5787,2759,3028,91.1
11080, 성북구,065005, 64세,2021,5783,2687,3096,86.8,5727,2655,3072,86.4
11080, 성북구,070,65~69세,2021,24138,11188,12950,86.4,23923,11094,12829,86.5
11080, 성북구,070001, 65세,2021,5346,2510,2836,88.5,5298,2486,2812,88.4
11080, 성북구,070002, 66세,2021,5579,2529,3050,82.9,5518,2505,3013,83.1
11080, 성북구,070003, 67세,2021,4611,2171,2440,89,4579,2156,2423,89
11080, 성북구,070004, 68세,2021,4111,1878,2233,84.1,4073,1863,2210,84.3
11080, 성북구,070005, 69세,2021,4491,2100,2391,87.8,4455,2084,2371,87.9
11080, 성북구,075,70~74세,2021,17564,7724,9840,78.5,17471,7678,9793,78.4
11080, 성북구,075001, 70세,2021,3068,1405,1663,84.5,3047,1394,1653,84.3
11080, 성북구,075002, 71세,2021,3642,1645,1997,82.4,3617,1633,1984,82.3
11080, 성북구,075003, 72세,2021,3704,1612,2092,77.1,3679,1603,2076,77.2
11080, 성북구,075004, 73세,2021,3505,1481,2024,73.2,3495,1475,2020,73
11080, 성북구,075005, 74세,2021,3645,1581,2064,76.6,3633,1573,2060,76.4
11080, 성북구,080,75~79세,2021,14445,6184,8261,74.9,14413,6171,8242,74.9
11080, 성북구,080001, 75세,2021,2885,1209,1676,72.1,2873,1205,1668,72.2
11080, 성북구,080002, 76세,2021,2726,1159,1567,74,2722,1157,1565,73.9
11080, 성북구,080003, 77세,2021,2807,1201,1606,74.8,2800,1198,1602,74.8
11080, 성북구,080004, 78세,2021,2805,1223,1582,77.3,2801,1222,1579,77.4
11080, 성북구,080005, 79세,2021,3222,1392,1830,76.1,3217,1389,1828,76
11080, 성북구,085,80~84세,2021,9985,4060,5925,68.5,9963,4054,5909,68.6
11080, 성북구,085001, 80세,2021,2489,1061,1428,74.3,2485,1060,1425,74.4
11080, 성북구,085002, 81세,2021,2171,872,1299,67.1,2165,870,1295,67.2
11080, 성북구,085003, 82세,2021,2048,832,1216,68.4,2040,829,1211,68.5
11080, 성북구,085004, 83세,2021,1747,705,1042,67.7,1745,705,1040,67.8
11080, 성북구,085005, 84세,2021,1530,590,940,62.8,1528,590,938,62.9
11080, 성북구,090,85~89세,2021,4607,1645,2962,55.5,4589,1639,2950,55.6
11080, 성북구,090001, 85세,2021,1281,483,798,60.5,1276,482,794,60.7
11080, 성북구,090002, 86세,2021,1180,417,763,54.7,1176,414,762,54.3
11080, 성북구,090003, 87세,2021,886,318,568,56,882,317,565,56.1
11080, 성북구,090004, 88세,2021,684,235,449,52.3,682,235,447,52.6
11080, 성북구,090005, 89세,2021,576,192,384,50,573,191,382,50
11080, 성북구,095,90~94세,2021,1526,396,1130,35,1525,396,1129,35.1
11080, 성북구,095001, 90세,2021,424,120,304,39.5,424,120,304,39.5
11080, 성북구,095002, 91세,2021,394,110,284,38.7,394,110,284,38.7
11080, 성북구,095003, 92세,2021,294,76,218,34.9,293,76,217,35
11080, 성북구,095004, 93세,2021,241,58,183,31.7,241,58,183,31.7
11080, 성북구,095005, 94세,2021,173,32,141,22.7,173,32,141,22.7
11080, 성북구,100,95~99세,2021,297,68,229,29.7,294,67,227,29.5
11080, 성북구,100001, 95세,2021,105,25,80,31.3,103,24,79,30.4
11080, 성북구,100002, 96세,2021,74,12,62,19.4,74,12,62,19.4
11080, 성북구,100003, 97세,2021,42,7,35,20,42,7,35,20
11080, 성북구,100004, 98세,2021,51,17,34,50,50,17,33,51.5
11080, 성북구,100005, 99세,2021,25,7,18,38.9,25,7,18,38.9
11080, 성북구,101,100세이상,2021,32,7,25,28,31,6,25,24
11080, 성북구,102,15세미만,2021,43830,22445,21385,105,43333,22185,21148,104.9
11080, 성북구,103,15~64세,2021,319085,153711,165374,92.9,306886,149059,157827,94.4
11080, 성북구,104,65세이상,2021,72594,31272,41322,75.7,72209,31105,41104,75.7
11080, 성북구,086,85세이상,2021,6462,2116,4346,48.7,6439,2108,4331,48.7
11080, 성북구,126,평균연령,2021,42.8,42.1,43.5,,43.1,42.3,43.9,
11080, 성북구,127,중위연령,2021,42.8,42.1,43.4,,43.4,42.5,44.3,
11090, 강북구,000,합계,2021,292611,141265,151346,93.3,287693,139416,148277,94
11090, 강북구,005,0~4세,2021,5796,2973,2823,105.3,5703,2928,2775,105.5
11090, 강북구,005001, 0세,2021,981,486,495,98.2,966,478,488,98
11090, 강북구,005002, 1세,2021,1023,531,492,107.9,1003,521,482,108.1
11090, 강북구,005003, 2세,2021,1102,593,509,116.5,1084,585,499,117.2
11090, 강북구,005004, 3세,2021,1298,678,620,109.4,1276,666,610,109.2
11090, 강북구,005005, 4세,2021,1392,685,707,96.9,1374,678,696,97.4
11090, 강북구,010,5~9세,2021,8297,4296,4001,107.4,8225,4262,3963,107.5
11090, 강북구,010001, 5세,2021,1575,809,766,105.6,1565,804,761,105.7
11090, 강북구,010002, 6세,2021,1568,806,762,105.8,1554,803,751,106.9
11090, 강북구,010003, 7세,2021,1577,804,773,104,1565,798,767,104
11090, 강북구,010004, 8세,2021,1736,925,811,114.1,1714,912,802,113.7
11090, 강북구,010005, 9세,2021,1841,952,889,107.1,1827,945,882,107.1
11090, 강북구,015,10~14세,2021,9351,4777,4574,104.4,9316,4765,4551,104.7
11090, 강북구,015001, 10세,2021,1870,944,926,101.9,1865,943,922,102.3
11090, 강북구,015002, 11세,2021,1829,946,883,107.1,1817,940,877,107.2
11090, 강북구,015003, 12세,2021,1832,938,894,104.9,1826,936,890,105.2
11090, 강북구,015004, 13세,2021,1844,933,911,102.4,1838,931,907,102.6
11090, 강북구,015005, 14세,2021,1976,1016,960,105.8,1970,1015,955,106.3
11090, 강북구,020,15~19세,2021,10650,5364,5286,101.5,10576,5339,5237,101.9
11090, 강북구,020001, 15세,2021,1921,1000,921,108.6,1915,998,917,108.8
11090, 강북구,020002, 16세,2021,1921,963,958,100.5,1918,961,957,100.4
11090, 강북구,020003, 17세,2021,2098,1053,1045,100.8,2092,1051,1041,101
11090, 강북구,020004, 18세,2021,2300,1175,1125,104.4,2283,1168,1115,104.8
11090, 강북구,020005, 19세,2021,2410,1173,1237,94.8,2368,1161,1207,96.2
11090, 강북구,025,20~24세,2021,18597,8512,10085,84.4,17980,8282,9698,85.4
11090, 강북구,025001, 20세,2021,3081,1466,1615,90.8,2975,1426,1549,92.1
11090, 강북구,025002, 21세,2021,3572,1675,1897,88.3,3451,1629,1822,89.4
11090, 강북구,025003, 22세,2021,3657,1620,2037,79.5,3523,1567,1956,80.1
11090, 강북구,025004, 23세,2021,4021,1809,2212,81.8,3894,1759,2135,82.4
11090, 강북구,025005, 24세,2021,4266,1942,2324,83.6,4137,1901,2236,85
11090, 강북구,030,25~29세,2021,22644,11383,11261,101.1,22008,11172,10836,103.1
11090, 강북구,030001, 25세,2021,4438,2116,2322,91.1,4316,2082,2234,93.2
11090, 강북구,030002, 26세,2021,4529,2302,2227,103.4,4400,2256,2144,105.2
11090, 강북구,030003, 27세,2021,4683,2359,2324,101.5,4550,2320,2230,104
11090, 강북구,030004, 28세,2021,4491,2300,2191,105,4370,2257,2113,106.8
11090, 강북구,030005, 29세,2021,4503,2306,2197,105,4372,2257,2115,106.7
11090, 강북구,035,30~34세,2021,18486,9531,8955,106.4,17817,9297,8520,109.1
11090, 강북구,035001, 30세,2021,4224,2115,2109,100.3,4085,2065,2020,102.2
11090, 강북구,035002, 31세,2021,3715,1936,1779,108.8,3590,1898,1692,112.2
11090, 강북구,035003, 32세,2021,3730,1907,1823,104.6,3585,1859,1726,107.7
11090, 강북구,035004, 33세,2021,3451,1793,1658,108.1,3307,1743,1564,111.4
11090, 강북구,035005, 34세,2021,3366,1780,1586,112.2,3250,1732,1518,114.1
11090, 강북구,040,35~39세,2021,18318,9567,8751,109.3,17794,9387,8407,111.7
11090, 강북구,040001, 35세,2021,3373,1784,1589,112.3,3243,1745,1498,116.5
11090, 강북구,040002, 36세,2021,3440,1783,1657,107.6,3343,1750,1593,109.9
11090, 강북구,040003, 37세,2021,3534,1853,1681,110.2,3424,1817,1607,113.1
11090, 강북구,040004, 38세,2021,3768,1984,1784,111.2,3679,1954,1725,113.3
11090, 강북구,040005, 39세,2021,4203,2163,2040,106,4105,2121,1984,106.9
11090, 강북구,045,40~44세,2021,20032,10435,9597,108.7,19660,10302,9358,110.1
11090, 강북구,045001, 40세,2021,4023,2153,1870,115.1,3943,2121,1822,116.4
11090, 강북구,045002, 41세,2021,4280,2247,2033,110.5,4203,2221,1982,112.1
11090, 강북구,045003, 42세,2021,4102,2131,1971,108.1,4027,2104,1923,109.4
11090, 강북구,045004, 43세,2021,3683,1869,1814,103,3612,1847,1765,104.6
11090, 강북구,045005, 44세,2021,3944,2035,1909,106.6,3875,2009,1866,107.7
11090, 강북구,050,45~49세,2021,22426,11323,11103,102,22075,11183,10892,102.7
11090, 강북구,050001, 45세,2021,3835,1946,1889,103,3774,1925,1849,104.1
11090, 강북구,050002, 46세,2021,4138,2089,2049,102,4068,2061,2007,102.7
11090, 강북구,050003, 47세,2021,4609,2271,2338,97.1,4536,2241,2295,97.6
11090, 강북구,050004, 48세,2021,4891,2480,2411,102.9,4814,2445,2369,103.2
11090, 강북구,050005, 49세,2021,4953,2537,2416,105,4883,2511,2372,105.9
11090, 강북구,055,50~54세,2021,25651,12479,13172,94.7,25280,12329,12951,95.2
11090, 강북구,055001, 50세,2021,5381,2658,2723,97.6,5301,2627,2674,98.2
11090, 강북구,055002, 51세,2021,5126,2532,2594,97.6,5058,2504,2554,98
11090, 강북구,055003, 52세,2021,5194,2494,2700,92.4,5111,2460,2651,92.8
11090, 강북구,055004, 53세,2021,5150,2475,2675,92.5,5076,2445,2631,92.9
11090, 강북구,055005, 54세,2021,4800,2320,2480,93.5,4734,2293,2441,93.9
11090, 강북구,060,55~59세,2021,24026,11648,12378,94.1,23609,11476,12133,94.6
11090, 강북구,060001, 55세,2021,4544,2204,2340,94.2,4465,2171,2294,94.6
11090, 강북구,060002, 56세,2021,4927,2311,2616,88.3,4848,2271,2577,88.1
11090, 강북구,060003, 57세,2021,4617,2242,2375,94.4,4533,2216,2317,95.6
11090, 강북구,060004, 58세,2021,5029,2495,2534,98.5,4932,2451,2481,98.8
11090, 강북구,060005, 59세,2021,4909,2396,2513,95.3,4831,2367,2464,96.1
11090, 강북구,065,60~64세,2021,25680,12054,13626,88.5,25339,11913,13426,88.7
11090, 강북구,065001, 60세,2021,5484,2548,2936,86.8,5432,2526,2906,86.9
11090, 강북구,065002, 61세,2021,5577,2520,3057,82.4,5493,2486,3007,82.7
11090, 강북구,065003, 62세,2021,5053,2404,2649,90.8,4988,2379,2609,91.2
11090, 강북구,065004, 63세,2021,4835,2298,2537,90.6,4768,2269,2499,90.8
11090, 강북구,065005, 64세,2021,4731,2284,2447,93.3,4658,2253,2405,93.7
11090, 강북구,070,65~69세,2021,20435,9371,11064,84.7,20231,9288,10943,84.9
11090, 강북구,070001, 65세,2021,4425,2062,2363,87.3,4389,2050,2339,87.6
11090, 강북구,070002, 66세,2021,4770,2202,2568,85.7,4717,2178,2539,85.8
11090, 강북구,070003, 67세,2021,3946,1797,2149,83.6,3898,1773,2125,83.4
11090, 강북구,070004, 68세,2021,3435,1551,1884,82.3,3401,1539,1862,82.7
11090, 강북구,070005, 69세,2021,3859,1759,2100,83.8,3826,1748,2078,84.1
11090, 강북구,075,70~74세,2021,15967,6920,9047,76.5,15888,6883,9005,76.4
11090, 강북구,075001, 70세,2021,2920,1291,1629,79.3,2897,1282,1615,79.4
11090, 강북구,075002, 71세,2021,3146,1336,1810,73.8,3120,1325,1795,73.8
11090, 강북구,075003, 72세,2021,3334,1449,1885,76.9,3327,1444,1883,76.7
11090, 강북구,075004, 73세,2021,3255,1416,1839,77,3244,1408,1836,76.7
11090, 강북구,075005, 74세,2021,3312,1428,1884,75.8,3300,1424,1876,75.9
11090, 강북구,080,75~79세,2021,12876,5480,7396,74.1,12843,5469,7374,74.2
11090, 강북구,080001, 75세,2021,2490,1054,1436,73.4,2477,1048,1429,73.3
11090, 강북구,080002, 76세,2021,2517,1030,1487,69.3,2506,1028,1478,69.6
11090, 강북구,080003, 77세,2021,2487,1088,1399,77.8,2483,1087,1396,77.9
11090, 강북구,080004, 78세,2021,2491,1035,1456,71.1,2486,1033,1453,71.1
11090, 강북구,080005, 79세,2021,2891,1273,1618,78.7,2891,1273,1618,78.7
11090, 강북구,085,80~84세,2021,8410,3476,4934,70.4,8391,3468,4923,70.4
11090, 강북구,085001, 80세,2021,2225,969,1256,77.1,2220,966,1254,77
11090, 강북구,085002, 81세,2021,1786,751,1035,72.6,1783,749,1034,72.4
11090, 강북구,085003, 82세,2021,1737,676,1061,63.7,1732,674,1058,63.7
11090, 강북구,085004, 83세,2021,1466,585,881,66.4,1461,584,877,66.6
11090, 강북구,085005, 84세,2021,1196,495,701,70.6,1195,495,700,70.7
11090, 강북구,090,85~89세,2021,3593,1318,2275,57.9,3586,1316,2270,58
11090, 강북구,090001, 85세,2021,1107,433,674,64.2,1106,433,673,64.3
11090, 강북구,090002, 86세,2021,888,341,547,62.3,884,339,545,62.2
11090, 강북구,090003, 87세,2021,681,234,447,52.3,680,234,446,52.5
11090, 강북구,090004, 88세,2021,507,184,323,57,506,184,322,57.1
11090, 강북구,090005, 89세,2021,410,126,284,44.4,410,126,284,44.4
11090, 강북구,095,90~94세,2021,1094,292,802,36.4,1091,291,800,36.4
11090, 강북구,095001, 90세,2021,297,84,213,39.4,296,84,212,39.6
11090, 강북구,095002, 91세,2021,279,70,209,33.5,278,70,208,33.7
11090, 강북구,095003, 92세,2021,230,65,165,39.4,229,64,165,38.8
11090, 강북구,095004, 93세,2021,165,47,118,39.8,165,47,118,39.8
11090, 강북구,095005, 94세,2021,123,26,97,26.8,123,26,97,26.8
11090, 강북구,100,95~99세,2021,246,57,189,30.2,245,57,188,30.3
11090, 강북구,100001, 95세,2021,80,24,56,42.9,80,24,56,42.9
11090, 강북구,100002, 96세,2021,60,9,51,17.6,59,9,50,18
11090, 강북구,100003, 97세,2021,45,6,39,15.4,45,6,39,15.4
11090, 강북구,100004, 98세,2021,36,13,23,56.5,36,13,23,56.5
11090, 강북구,100005, 99세,2021,25,5,20,25,25,5,20,25
11090, 강북구,101,100세이상,2021,36,9,27,33.3,36,9,27,33.3
11090, 강북구,102,15세미만,2021,23444,12046,11398,105.7,23244,11955,11289,105.9
11090, 강북구,103,15~64세,2021,206510,102296,104214,98.2,202138,100680,101458,99.2
11090, 강북구,104,65세이상,2021,62657,26923,35734,75.3,62311,26781,35530,75.4
11090, 강북구,086,85세이상,2021,4969,1676,3293,50.9,4958,1673,3285,50.9
11090, 강북구,126,평균연령,2021,46.6,45.5,47.6,,46.7,45.5,47.8,
11090, 강북구,127,중위연령,2021,48.3,46.9,49.7,,48.5,47,50,
11100, 도봉구,000,합계,2021,309200,149413,159787,93.5,306168,148314,157854,94
11100, 도봉구,005,0~4세,2021,6948,3631,3317,109.5,6898,3603,3295,109.3
11100, 도봉구,005001, 0세,2021,1166,611,555,110.1,1159,608,551,110.3
11100, 도봉구,005002, 1세,2021,1214,645,569,113.4,1204,638,566,112.7
11100, 도봉구,005003, 2세,2021,1440,758,682,111.1,1429,749,680,110.1
11100, 도봉구,005004, 3세,2021,1494,791,703,112.5,1481,786,695,113.1
11100, 도봉구,005005, 4세,2021,1634,826,808,102.2,1625,822,803,102.4
11100, 도봉구,010,5~9세,2021,9900,5140,4760,108,9869,5123,4746,107.9
11100, 도봉구,010001, 5세,2021,1862,963,899,107.1,1855,961,894,107.5
11100, 도봉구,010002, 6세,2021,1989,1037,952,108.9,1976,1028,948,108.4
11100, 도봉구,010003, 7세,2021,1959,1012,947,106.9,1957,1010,947,106.7
11100, 도봉구,010004, 8세,2021,1909,1000,909,110,1904,997,907,109.9
11100, 도봉구,010005, 9세,2021,2181,1128,1053,107.1,2177,1127,1050,107.3
11100, 도봉구,015,10~14세,2021,10964,5657,5307,106.6,10933,5642,5291,106.6
11100, 도봉구,015001, 10세,2021,2198,1118,1080,103.5,2189,1115,1074,103.8
11100, 도봉구,015002, 11세,2021,2125,1092,1033,105.7,2118,1089,1029,105.8
11100, 도봉구,015003, 12세,2021,2023,1049,974,107.7,2017,1044,973,107.3
11100, 도봉구,015004, 13세,2021,2190,1146,1044,109.8,2186,1145,1041,110
11100, 도봉구,015005, 14세,2021,2428,1252,1176,106.5,2423,1249,1174,106.4
11100, 도봉구,020,15~19세,2021,12350,6235,6115,102,12308,6224,6084,102.3
11100, 도봉구,020001, 15세,2021,2176,1146,1030,111.3,2171,1144,1027,111.4
11100, 도봉구,020002, 16세,2021,2190,1124,1066,105.4,2187,1123,1064,105.5
11100, 도봉구,020003, 17세,2021,2588,1345,1243,108.2,2583,1344,1239,108.5
11100, 도봉구,020004, 18세,2021,2622,1301,1321,98.5,2616,1300,1316,98.8
11100, 도봉구,020005, 19세,2021,2774,1319,1455,90.7,2751,1313,1438,91.3
11100, 도봉구,025,20~24세,2021,19079,9263,9816,94.4,18745,9158,9587,95.5
11100, 도봉구,025001, 20세,2021,3297,1669,1628,102.5,3265,1658,1607,103.2
11100, 도봉구,025002, 21세,2021,3741,1818,1923,94.5,3687,1795,1892,94.9
11100, 도봉구,025003, 22세,2021,3766,1821,1945,93.6,3700,1801,1899,94.8
11100, 도봉구,025004, 23세,2021,4016,1896,2120,89.4,3918,1867,2051,91
11100, 도봉구,025005, 24세,2021,4259,2059,2200,93.6,4175,2037,2138,95.3
11100, 도봉구,030,25~29세,2021,22057,11126,10931,101.8,21642,10997,10645,103.3
11100, 도봉구,030001, 25세,2021,4346,2131,2215,96.2,4254,2103,2151,97.8
11100, 도봉구,030002, 26세,2021,4339,2181,2158,101.1,4270,2163,2107,102.7
11100, 도봉구,030003, 27세,2021,4423,2246,2177,103.2,4344,2216,2128,104.1
11100, 도봉구,030004, 28세,2021,4488,2325,2163,107.5,4412,2295,2117,108.4
11100, 도봉구,030005, 29세,2021,4461,2243,2218,101.1,4362,2220,2142,103.6
11100, 도봉구,035,30~34세,2021,18682,9454,9228,102.4,18230,9309,8921,104.3
11100, 도봉구,035001, 30세,2021,4121,2061,2060,100,4042,2041,2001,102
11100, 도봉구,035002, 31세,2021,3805,1944,1861,104.5,3705,1915,1790,107
11100, 도봉구,035003, 32세,2021,3710,1887,1823,103.5,3610,1855,1755,105.7
11100, 도봉구,035004, 33세,2021,3541,1782,1759,101.3,3445,1741,1704,102.2
11100, 도봉구,035005, 34세,2021,3505,1780,1725,103.2,3428,1757,1671,105.1
11100, 도봉구,040,35~39세,2021,19513,9999,9514,105.1,19164,9877,9287,106.4
11100, 도봉구,040001, 35세,2021,3499,1787,1712,104.4,3435,1761,1674,105.2
11100, 도봉구,040002, 36세,2021,3687,1856,1831,101.4,3610,1831,1779,102.9
11100, 도봉구,040003, 37세,2021,3689,1918,1771,108.3,3620,1897,1723,110.1
11100, 도봉구,040004, 38세,2021,4141,2144,1997,107.4,4075,2126,1949,109.1
11100, 도봉구,040005, 39세,2021,4497,2294,2203,104.1,4424,2262,2162,104.6
11100, 도봉구,045,40~44세,2021,20931,10555,10376,101.7,20673,10458,10215,102.4
11100, 도봉구,045001, 40세,2021,4404,2229,2175,102.5,4348,2204,2144,102.8
11100, 도봉구,045002, 41세,2021,4476,2273,2203,103.2,4440,2260,2180,103.7
11100, 도봉구,045003, 42세,2021,4248,2155,2093,103,4193,2133,2060,103.5
11100, 도봉구,045004, 43세,2021,3783,1873,1910,98.1,3720,1851,1869,99
11100, 도봉구,045005, 44세,2021,4020,2025,1995,101.5,3972,2010,1962,102.4
11100, 도봉구,050,45~49세,2021,23636,11564,12072,95.8,23386,11467,11919,96.2
11100, 도봉구,050001, 45세,2021,4092,2037,2055,99.1,4032,2019,2013,100.3
11100, 도봉구,050002, 46세,2021,4378,2097,2281,91.9,4334,2085,2249,92.7
11100, 도봉구,050003, 47세,2021,4872,2425,2447,99.1,4826,2404,2422,99.3
11100, 도봉구,050004, 48세,2021,5091,2410,2681,89.9,5045,2390,2655,90
11100, 도봉구,050005, 49세,2021,5203,2595,2608,99.5,5149,2569,2580,99.6
11100, 도봉구,055,50~54세,2021,27928,13118,14810,88.6,27691,13014,14677,88.7
11100, 도봉구,055001, 50세,2021,5736,2748,2988,92,5670,2716,2954,91.9
11100, 도봉구,055002, 51세,2021,5596,2644,2952,89.6,5548,2627,2921,89.9
11100, 도봉구,055003, 52세,2021,5622,2623,2999,87.5,5580,2604,2976,87.5
11100, 도봉구,055004, 53세,2021,5703,2667,3036,87.8,5659,2648,3011,87.9
11100, 도봉구,055005, 54세,2021,5271,2436,2835,85.9,5234,2419,2815,85.9
11100, 도봉구,060,55~59세,2021,26273,12554,13719,91.5,26084,12481,13603,91.8
11100, 도봉구,060001, 55세,2021,5119,2494,2625,95,5085,2483,2602,95.4
11100, 도봉구,060002, 56세,2021,5346,2506,2840,88.2,5303,2483,2820,88
11100, 도봉구,060003, 57세,2021,4961,2332,2629,88.7,4922,2316,2606,88.9
11100, 도봉구,060004, 58세,2021,5391,2658,2733,97.3,5347,2643,2704,97.7
11100, 도봉구,060005, 59세,2021,5456,2564,2892,88.7,5427,2556,2871,89
11100, 도봉구,065,60~64세,2021,28400,13296,15104,88,28231,13227,15004,88.2
11100, 도봉구,065001, 60세,2021,5932,2733,3199,85.4,5897,2716,3181,85.4
11100, 도봉구,065002, 61세,2021,6096,2820,3276,86.1,6057,2803,3254,86.1
11100, 도봉구,065003, 62세,2021,5653,2637,3016,87.4,5625,2628,2997,87.7
11100, 도봉구,065004, 63세,2021,5313,2485,2828,87.9,5281,2475,2806,88.2
11100, 도봉구,065005, 64세,2021,5406,2621,2785,94.1,5371,2605,2766,94.2
11100, 도봉구,070,65~69세,2021,21729,10298,11431,90.1,21612,10252,11360,90.2
11100, 도봉구,070001, 65세,2021,4810,2254,2556,88.2,4782,2242,2540,88.3
11100, 도봉구,070002, 66세,2021,5136,2428,2708,89.7,5115,2420,2695,89.8
11100, 도봉구,070003, 67세,2021,4204,2005,2199,91.2,4175,1996,2179,91.6
11100, 도봉구,070004, 68세,2021,3581,1726,1855,93,3563,1719,1844,93.2
11100, 도봉구,070005, 69세,2021,3998,1885,2113,89.2,3977,1875,2102,89.2
11100, 도봉구,075,70~74세,2021,15210,7133,8077,88.3,15158,7107,8051,88.3
11100, 도봉구,075001, 70세,2021,2863,1379,1484,92.9,2849,1373,1476,93
11100, 도봉구,075002, 71세,2021,3133,1481,1652,89.6,3120,1473,1647,89.4
11100, 도봉구,075003, 72세,2021,3016,1408,1608,87.6,3006,1401,1605,87.3
11100, 도봉구,075004, 73세,2021,3139,1480,1659,89.2,3133,1478,1655,89.3
11100, 도봉구,075005, 74세,2021,3059,1385,1674,82.7,3050,1382,1668,82.9
11100, 도봉구,080,75~79세,2021,11853,5281,6572,80.4,11831,5275,6556,80.5
11100, 도봉구,080001, 75세,2021,2415,1105,1310,84.4,2412,1104,1308,84.4
11100, 도봉구,080002, 76세,2021,2287,1026,1261,81.4,2281,1023,1258,81.3
11100, 도봉구,080003, 77세,2021,2218,982,1236,79.4,2214,981,1233,79.6
11100, 도봉구,080004, 78세,2021,2289,993,1296,76.6,2286,992,1294,76.7
11100, 도봉구,080005, 79세,2021,2644,1175,1469,80,2638,1175,1463,80.3
11100, 도봉구,085,80~84세,2021,8248,3439,4809,71.5,8232,3436,4796,71.6
11100, 도봉구,085001, 80세,2021,2082,938,1144,82,2079,937,1142,82
11100, 도봉구,085002, 81세,2021,1763,720,1043,69,1761,719,1042,69
11100, 도봉구,085003, 82세,2021,1713,719,994,72.3,1706,719,987,72.8
11100, 도봉구,085004, 83세,2021,1413,578,835,69.2,1411,577,834,69.2
11100, 도봉구,085005, 84세,2021,1277,484,793,61,1275,484,791,61.2
11100, 도봉구,090,85~89세,2021,3827,1238,2589,47.8,3822,1237,2585,47.9
11100, 도봉구,090001, 85세,2021,1037,365,672,54.3,1035,364,671,54.2
11100, 도봉구,090002, 86세,2021,900,316,584,54.1,899,316,583,54.2
11100, 도봉구,090003, 87세,2021,708,218,490,44.5,708,218,490,44.5
11100, 도봉구,090004, 88세,2021,653,202,451,44.8,651,202,449,45
11100, 도봉구,090005, 89세,2021,529,137,392,34.9,529,137,392,34.9
11100, 도봉구,095,90~94세,2021,1338,358,980,36.5,1332,357,975,36.6
11100, 도봉구,095001, 90세,2021,369,109,260,41.9,367,109,258,42.2
11100, 도봉구,095002, 91세,2021,308,79,229,34.5,305,78,227,34.4
11100, 도봉구,095003, 92세,2021,283,68,215,31.6,282,68,214,31.8
11100, 도봉구,095004, 93세,2021,216,64,152,42.1,216,64,152,42.1
11100, 도봉구,095005, 94세,2021,162,38,124,30.6,162,38,124,30.6
11100, 도봉구,100,95~99세,2021,288,63,225,28,284,62,222,27.9
11100, 도봉구,100001, 95세,2021,100,25,75,33.3,98,25,73,34.2
11100, 도봉구,100002, 96세,2021,62,13,49,26.5,61,13,48,27.1
11100, 도봉구,100003, 97세,2021,48,7,41,17.1,48,7,41,17.1
11100, 도봉구,100004, 98세,2021,53,15,38,39.5,52,14,38,36.8
11100, 도봉구,100005, 99세,2021,25,X,22,13.6,25,X,22,13.6
11100, 도봉구,101,100세이상,2021,46,11,35,31.4,43,8,35,22.9
11100, 도봉구,102,15세미만,2021,27812,14428,13384,107.8,27700,14368,13332,107.8
11100, 도봉구,103,15~64세,2021,218849,107164,111685,96,216154,106212,109942,96.6
11100, 도봉구,104,65세이상,2021,62539,27821,34718,80.1,62314,27734,34580,80.2
11100, 도봉구,086,85세이상,2021,5499,1670,3829,43.6,5481,1664,3817,43.6
11100, 도봉구,126,평균연령,2021,46.1,45,47.1,,46.1,45,47.2,
11100, 도봉구,127,중위연령,2021,48.2,46.8,49.4,,48.3,46.8,49.6,
11110, 노원구,000,합계,2021,503929,242171,261758,92.5,498257,239746,258511,92.7
11110, 노원구,005,0~4세,2021,12262,6359,5903,107.7,12158,6303,5855,107.7
11110, 노원구,005001, 0세,2021,2250,1181,1069,110.5,2238,1174,1064,110.3
11110, 노원구,005002, 1세,2021,2232,1178,1054,111.8,2212,1168,1044,111.9
11110, 노원구,005003, 2세,2021,2394,1253,1141,109.8,2374,1243,1131,109.9
11110, 노원구,005004, 3세,2021,2491,1281,1210,105.9,2467,1270,1197,106.1
11110, 노원구,005005, 4세,2021,2895,1466,1429,102.6,2867,1448,1419,102
11110, 노원구,010,5~9세,2021,18031,9259,8772,105.6,17932,9206,8726,105.5
11110, 노원구,010001, 5세,2021,3236,1606,1630,98.5,3215,1593,1622,98.2
11110, 노원구,010002, 6세,2021,3482,1786,1696,105.3,3456,1774,1682,105.5
11110, 노원구,010003, 7세,2021,3585,1837,1748,105.1,3564,1828,1736,105.3
11110, 노원구,010004, 8세,2021,3640,1900,1740,109.2,3623,1889,1734,108.9
11110, 노원구,010005, 9세,2021,4088,2130,1958,108.8,4074,2122,1952,108.7
11110, 노원구,015,10~14세,2021,22773,11795,10978,107.4,22730,11771,10959,107.4
11110, 노원구,015001, 10세,2021,4175,2142,2033,105.4,4165,2138,2027,105.5
11110, 노원구,015002, 11세,2021,4264,2197,2067,106.3,4254,2190,2064,106.1
11110, 노원구,015003, 12세,2021,4323,2241,2082,107.6,4312,2235,2077,107.6
11110, 노원구,015004, 13세,2021,4883,2567,2316,110.8,4877,2563,2314,110.8
11110, 노원구,015005, 14세,2021,5128,2648,2480,106.8,5122,2645,2477,106.8
11110, 노원구,020,15~19세,2021,27272,13972,13300,105.1,26989,13868,13121,105.7
11110, 노원구,020001, 15세,2021,4868,2547,2321,109.7,4859,2542,2317,109.7
11110, 노원구,020002, 16세,2021,4955,2579,2376,108.5,4944,2571,2373,108.3
11110, 노원구,020003, 17세,2021,5333,2761,2572,107.3,5317,2754,2563,107.5
11110, 노원구,020004, 18세,2021,5580,2897,2683,108,5520,2869,2651,108.2
11110, 노원구,020005, 19세,2021,6536,3188,3348,95.2,6349,3132,3217,97.4
11110, 노원구,025,20~24세,2021,38712,19171,19541,98.1,37420,18589,18831,98.7
11110, 노원구,025001, 20세,2021,7390,3474,3916,88.7,7162,3395,3767,90.1
11110, 노원구,025002, 21세,2021,7915,3780,4135,91.4,7682,3685,3997,92.2
11110, 노원구,025003, 22세,2021,7651,3786,3865,98,7375,3650,3725,98
11110, 노원구,025004, 23세,2021,7993,4086,3907,104.6,7709,3952,3757,105.2
11110, 노원구,025005, 24세,2021,7763,4045,3718,108.8,7492,3907,3585,109
11110, 노원구,030,25~29세,2021,34480,17818,16662,106.9,33601,17414,16187,107.6
11110, 노원구,030001, 25세,2021,7351,3854,3497,110.2,7134,3748,3386,110.7
11110, 노원구,030002, 26세,2021,6966,3616,3350,107.9,6779,3528,3251,108.5
11110, 노원구,030003, 27세,2021,6804,3562,3242,109.9,6614,3469,3145,110.3
11110, 노원구,030004, 28세,2021,6768,3486,3282,106.2,6626,3427,3199,107.1
11110, 노원구,030005, 29세,2021,6591,3300,3291,100.3,6448,3242,3206,101.1
11110, 노원구,035,30~34세,2021,29886,14984,14902,100.6,29185,14714,14471,101.7
11110, 노원구,035001, 30세,2021,6293,3142,3151,99.7,6128,3072,3056,100.5
11110, 노원구,035002, 31세,2021,6043,3005,3038,98.9,5906,2960,2946,100.5
11110, 노원구,035003, 32세,2021,5956,2967,2989,99.3,5826,2914,2912,100.1
11110, 노원구,035004, 33세,2021,5837,2938,2899,101.3,5704,2882,2822,102.1
11110, 노원구,035005, 34세,2021,5757,2932,2825,103.8,5621,2886,2735,105.5
11110, 노원구,040,35~39세,2021,31736,15715,16021,98.1,31181,15480,15701,98.6
11110, 노원구,040001, 35세,2021,5882,2938,2944,99.8,5767,2884,2883,100
11110, 노원구,040002, 36세,2021,5856,2931,2925,100.2,5723,2866,2857,100.3
11110, 노원구,040003, 37세,2021,6113,3020,3093,97.6,6013,2976,3037,98
11110, 노원구,040004, 38세,2021,6689,3295,3394,97.1,6580,3258,3322,98.1
11110, 노원구,040005, 39세,2021,7196,3531,3665,96.3,7098,3496,3602,97.1
11110, 노원구,045,40~44세,2021,36604,17491,19113,91.5,36199,17315,18884,91.7
11110, 노원구,045001, 40세,2021,7171,3563,3608,98.8,7079,3524,3555,99.1
11110, 노원구,045002, 41세,2021,7662,3609,4053,89,7582,3578,4004,89.4
11110, 노원구,045003, 42세,2021,7379,3557,3822,93.1,7296,3524,3772,93.4
11110, 노원구,045004, 43세,2021,6885,3313,3572,92.7,6806,3271,3535,92.5
11110, 노원구,045005, 44세,2021,7507,3449,4058,85,7436,3418,4018,85.1
11110, 노원구,050,45~49세,2021,42866,20339,22527,90.3,42535,20194,22341,90.4
11110, 노원구,050001, 45세,2021,7255,3460,3795,91.2,7187,3428,3759,91.2
11110, 노원구,050002, 46세,2021,8167,3806,4361,87.3,8086,3771,4315,87.4
11110, 노원구,050003, 47세,2021,8947,4281,4666,91.7,8886,4256,4630,91.9
11110, 노원구,050004, 48세,2021,9200,4389,4811,91.2,9147,4374,4773,91.6
11110, 노원구,050005, 49세,2021,9297,4403,4894,90,9229,4365,4864,89.7
11110, 노원구,055,50~54세,2021,46149,22296,23853,93.5,45831,22162,23669,93.6
11110, 노원구,055001, 50세,2021,10054,4832,5222,92.5,9988,4804,5184,92.7
11110, 노원구,055002, 51세,2021,9580,4632,4948,93.6,9511,4604,4907,93.8
11110, 노원구,055003, 52세,2021,9305,4542,4763,95.4,9230,4511,4719,95.6
11110, 노원구,055004, 53세,2021,9079,4354,4725,92.1,9028,4332,4696,92.2
11110, 노원구,055005, 54세,2021,8131,3936,4195,93.8,8074,3911,4163,93.9
11110, 노원구,060,55~59세,2021,38420,18517,19903,93,38148,18408,19740,93.3
11110, 노원구,060001, 55세,2021,7720,3810,3910,97.4,7667,3784,3883,97.5
11110, 노원구,060002, 56세,2021,7767,3688,4079,90.4,7712,3666,4046,90.6
11110, 노원구,060003, 57세,2021,7308,3560,3748,95,7258,3539,3719,95.2
11110, 노원구,060004, 58세,2021,7818,3691,4127,89.4,7755,3676,4079,90.1
11110, 노원구,060005, 59세,2021,7807,3768,4039,93.3,7756,3743,4013,93.3
11110, 노원구,065,60~64세,2021,39056,18150,20906,86.8,38877,18086,20791,87
11110, 노원구,065001, 60세,2021,8420,3984,4436,89.8,8387,3974,4413,90.1
11110, 노원구,065002, 61세,2021,8373,3879,4494,86.3,8328,3863,4465,86.5
11110, 노원구,065003, 62세,2021,7604,3484,4120,84.6,7572,3470,4102,84.6
11110, 노원구,065004, 63세,2021,7417,3429,3988,86,7381,3416,3965,86.2
11110, 노원구,065005, 64세,2021,7242,3374,3868,87.2,7209,3363,3846,87.4
11110, 노원구,070,65~69세,2021,30126,13973,16153,86.5,30010,13935,16075,86.7
11110, 노원구,070001, 65세,2021,6704,3091,3613,85.6,6674,3081,3593,85.8
11110, 노원구,070002, 66세,2021,7001,3157,3844,82.1,6975,3148,3827,82.3
11110, 노원구,070003, 67세,2021,5856,2766,3090,89.5,5828,2757,3071,89.8
11110, 노원구,070004, 68세,2021,5005,2358,2647,89.1,4987,2352,2635,89.3
11110, 노원구,070005, 69세,2021,5560,2601,2959,87.9,5546,2597,2949,88.1
11110, 노원구,075,70~74세,2021,20783,9305,11478,81.1,20737,9289,11448,81.1
11110, 노원구,075001, 70세,2021,3877,1751,2126,82.4,3864,1746,2118,82.4
11110, 노원구,075002, 71세,2021,4308,1986,2322,85.5,4301,1983,2318,85.5
11110, 노원구,075003, 72세,2021,4292,1929,2363,81.6,4279,1924,2355,81.7
11110, 노원구,075004, 73세,2021,4102,1840,2262,81.3,4095,1840,2255,81.6
11110, 노원구,075005, 74세,2021,4204,1799,2405,74.8,4198,1796,2402,74.8
11110, 노원구,080,75~79세,2021,15789,6604,9185,71.9,15760,6590,9170,71.9
11110, 노원구,080001, 75세,2021,3208,1339,1869,71.6,3200,1335,1865,71.6
11110, 노원구,080002, 76세,2021,3021,1321,1700,77.7,3018,1320,1698,77.7
11110, 노원구,080003, 77세,2021,2999,1233,1766,69.8,2992,1228,1764,69.6
11110, 노원구,080004, 78세,2021,3086,1286,1800,71.4,3078,1283,1795,71.5
11110, 노원구,080005, 79세,2021,3475,1425,2050,69.5,3472,1424,2048,69.5
11110, 노원구,085,80~84세,2021,11166,4168,6998,59.6,11155,4167,6988,59.6
11110, 노원구,085001, 80세,2021,2762,1060,1702,62.3,2761,1060,1701,62.3
11110, 노원구,085002, 81세,2021,2401,953,1448,65.8,2399,953,1446,65.9
11110, 노원구,085003, 82세,2021,2278,852,1426,59.7,2271,851,1420,59.9
11110, 노원구,085004, 83세,2021,2014,698,1316,53,2013,698,1315,53.1
11110, 노원구,085005, 84세,2021,1711,605,1106,54.7,1711,605,1106,54.7
11110, 노원구,090,85~89세,2021,5470,1701,3769,45.1,5466,1701,3765,45.2
11110, 노원구,090001, 85세,2021,1469,502,967,51.9,1468,502,966,52
11110, 노원구,090002, 86세,2021,1300,385,915,42.1,1300,385,915,42.1
11110, 노원구,090003, 87세,2021,1098,331,767,43.2,1096,331,765,43.3
11110, 노원구,090004, 88세,2021,881,270,611,44.2,880,270,610,44.3
11110, 노원구,090005, 89세,2021,722,213,509,41.8,722,213,509,41.8
11110, 노원구,095,90~94세,2021,1889,470,1419,33.1,1886,470,1416,33.2
11110, 노원구,095001, 90세,2021,545,136,409,33.3,544,136,408,33.3
11110, 노원구,095002, 91세,2021,471,123,348,35.3,470,123,347,35.4
11110, 노원구,095003, 92세,2021,355,95,260,36.5,355,95,260,36.5
11110, 노원구,095004, 93세,2021,301,76,225,33.8,301,76,225,33.8
11110, 노원구,095005, 94세,2021,217,40,177,22.6,216,40,176,22.7
11110, 노원구,100,95~99세,2021,393,76,317,24,392,76,316,24.1
11110, 노원구,100001, 95세,2021,133,16,117,13.7,133,16,117,13.7
11110, 노원구,100002, 96세,2021,87,16,71,22.5,86,16,70,22.9
11110, 노원구,100003, 97세,2021,70,18,52,34.6,70,18,52,34.6
11110, 노원구,100004, 98세,2021,65,15,50,30,65,15,50,30
11110, 노원구,100005, 99세,2021,38,11,27,40.7,38,11,27,40.7
11110, 노원구,101,100세이상,2021,66,8,58,13.8,65,8,57,14
11110, 노원구,102,15세미만,2021,53066,27413,25653,106.9,52820,27280,25540,106.8
11110, 노원구,103,15~64세,2021,365181,178453,186728,95.6,359966,176230,183736,95.9
11110, 노원구,104,65세이상,2021,85682,36305,49377,73.5,85471,36236,49235,73.6
11110, 노원구,086,85세이상,2021,7818,2255,5563,40.5,7809,2255,5554,40.6
11110, 노원구,126,평균연령,2021,43.6,42.2,44.8,,43.7,42.3,44.9,
11110, 노원구,127,중위연령,2021,45,43.4,46.4,,45.2,43.6,46.6,
11120, 은평구,000,합계,2021,457385,218155,239230,91.2,451661,215799,235862,91.5
11120, 은평구,005,0~4세,2021,11566,5967,5599,106.6,11451,5909,5542,106.6
11120, 은평구,005001, 0세,2021,2096,1111,985,112.8,2077,1101,976,112.8
11120, 은평구,005002, 1세,2021,2119,1083,1036,104.5,2099,1073,1026,104.6
11120, 은평구,005003, 2세,2021,2260,1164,1096,106.2,2241,1152,1089,105.8
11120, 은평구,005004, 3세,2021,2482,1246,1236,100.8,2457,1237,1220,101.4
11120, 은평구,005005, 4세,2021,2609,1363,1246,109.4,2577,1346,1231,109.3
11120, 은평구,010,5~9세,2021,15697,8067,7630,105.7,15582,8009,7573,105.8
11120, 은평구,010001, 5세,2021,2991,1527,1464,104.3,2968,1517,1451,104.5
11120, 은평구,010002, 6세,2021,3228,1622,1606,101,3202,1608,1594,100.9
11120, 은평구,010003, 7세,2021,2982,1540,1442,106.8,2955,1529,1426,107.2
11120, 은평구,010004, 8세,2021,3080,1616,1464,110.4,3065,1609,1456,110.5
11120, 은평구,010005, 9세,2021,3416,1762,1654,106.5,3392,1746,1646,106.1
11120, 은평구,015,10~14세,2021,17025,8750,8275,105.7,16944,8713,8231,105.9
11120, 은평구,015001, 10세,2021,3334,1696,1638,103.5,3324,1693,1631,103.8
11120, 은평구,015002, 11세,2021,3306,1699,1607,105.7,3296,1692,1604,105.5
11120, 은평구,015003, 12세,2021,3270,1667,1603,104,3255,1661,1594,104.2
11120, 은평구,015004, 13세,2021,3425,1741,1684,103.4,3400,1731,1669,103.7
11120, 은평구,015005, 14세,2021,3690,1947,1743,111.7,3669,1936,1733,111.7
11120, 은평구,020,15~19세,2021,18655,9464,9191,103,18524,9398,9126,103
11120, 은평구,020001, 15세,2021,3463,1774,1689,105,3442,1761,1681,104.8
11120, 은평구,020002, 16세,2021,3396,1783,1613,110.5,3374,1772,1602,110.6
11120, 은평구,020003, 17세,2021,3937,1962,1975,99.3,3912,1949,1963,99.3
11120, 은평구,020004, 18세,2021,4029,2063,1966,104.9,4002,2048,1954,104.8
11120, 은평구,020005, 19세,2021,3830,1882,1948,96.6,3794,1868,1926,97
11120, 은평구,025,20~24세,2021,26637,12758,13879,91.9,26312,12667,13645,92.8
11120, 은평구,025001, 20세,2021,4497,2228,2269,98.2,4451,2215,2236,99.1
11120, 은평구,025002, 21세,2021,5075,2545,2530,100.6,5016,2526,2490,101.4
11120, 은평구,025003, 22세,2021,5211,2573,2638,97.5,5159,2556,2603,98.2
11120, 은평구,025004, 23세,2021,5637,2632,3005,87.6,5557,2608,2949,88.4
11120, 은평구,025005, 24세,2021,6217,2780,3437,80.9,6129,2762,3367,82
11120, 은평구,030,25~29세,2021,36192,16994,19198,88.5,35544,16778,18766,89.4
11120, 은평구,030001, 25세,2021,6653,3028,3625,83.5,6552,3001,3551,84.5
11120, 은평구,030002, 26세,2021,6980,3308,3672,90.1,6869,3269,3600,90.8
11120, 은평구,030003, 27세,2021,7421,3519,3902,90.2,7283,3473,3810,91.2
11120, 은평구,030004, 28세,2021,7520,3465,4055,85.5,7374,3422,3952,86.6
11120, 은평구,030005, 29세,2021,7618,3674,3944,93.2,7466,3613,3853,93.8
11120, 은평구,035,30~34세,2021,32382,15625,16757,93.2,31602,15334,16268,94.3
11120, 은평구,035001, 30세,2021,7196,3404,3792,89.8,7067,3362,3705,90.7
11120, 은평구,035002, 31세,2021,6659,3243,3416,94.9,6478,3167,3311,95.7
11120, 은평구,035003, 32세,2021,6193,3019,3174,95.1,6044,2972,3072,96.7
11120, 은평구,035004, 33세,2021,6209,3008,3201,94,6052,2947,3105,94.9
11120, 은평구,035005, 34세,2021,6125,2951,3174,93,5961,2886,3075,93.9
11120, 은평구,040,35~39세,2021,32890,16380,16510,99.2,32202,16081,16121,99.8
11120, 은평구,040001, 35세,2021,6044,2959,3085,95.9,5892,2892,3000,96.4
11120, 은평구,040002, 36세,2021,6177,3082,3095,99.6,6047,3033,3014,100.6
11120, 은평구,040003, 37세,2021,6313,3120,3193,97.7,6168,3063,3105,98.6
11120, 은평구,040004, 38세,2021,6996,3492,3504,99.7,6865,3432,3433,100
11120, 은평구,040005, 39세,2021,7360,3727,3633,102.6,7230,3661,3569,102.6
11120, 은평구,045,40~44세,2021,34516,17186,17330,99.2,34017,16973,17044,99.6
11120, 은평구,045001, 40세,2021,7396,3764,3632,103.6,7283,3723,3560,104.6
11120, 은평구,045002, 41세,2021,7464,3706,3758,98.6,7361,3662,3699,99
11120, 은평구,045003, 42세,2021,6908,3412,3496,97.6,6797,3369,3428,98.3
11120, 은평구,045004, 43세,2021,6171,3064,3107,98.6,6070,3014,3056,98.6
11120, 은평구,045005, 44세,2021,6577,3240,3337,97.1,6506,3205,3301,97.1
11120, 은평구,050,45~49세,2021,36477,17894,18583,96.3,36046,17699,18347,96.5
11120, 은평구,050001, 45세,2021,6456,3226,3230,99.9,6363,3178,3185,99.8
11120, 은평구,050002, 46세,2021,6763,3273,3490,93.8,6681,3241,3440,94.2
11120, 은평구,050003, 47세,2021,7578,3695,3883,95.2,7491,3656,3835,95.3
11120, 은평구,050004, 48세,2021,7769,3816,3953,96.5,7699,3783,3916,96.6
11120, 은평구,050005, 49세,2021,7911,3884,4027,96.4,7812,3841,3971,96.7
11120, 은평구,055,50~54세,2021,39285,18894,20391,92.7,38769,18670,20099,92.9
11120, 은평구,055001, 50세,2021,8413,4113,4300,95.7,8302,4065,4237,95.9
11120, 은평구,055002, 51세,2021,7877,3765,4112,91.6,7756,3716,4040,92
11120, 은평구,055003, 52세,2021,8103,3927,4176,94,8001,3876,4125,94
11120, 은평구,055004, 53세,2021,7768,3702,4066,91,7664,3661,4003,91.5
11120, 은평구,055005, 54세,2021,7124,3387,3737,90.6,7046,3352,3694,90.7
11120, 은평구,060,55~59세,2021,34888,16568,18320,90.4,34374,16339,18035,90.6
11120, 은평구,060001, 55세,2021,6832,3303,3529,93.6,6750,3265,3485,93.7
11120, 은평구,060002, 56세,2021,6986,3233,3753,86.1,6879,3191,3688,86.5
11120, 은평구,060003, 57세,2021,6782,3255,3527,92.3,6667,3206,3461,92.6
11120, 은평구,060004, 58세,2021,7067,3340,3727,89.6,6956,3287,3669,89.6
11120, 은평구,060005, 59세,2021,7221,3437,3784,90.8,7122,3390,3732,90.8
11120, 은평구,065,60~64세,2021,36701,17018,19683,86.5,36329,16853,19476,86.5
11120, 은평구,065001, 60세,2021,7790,3612,4178,86.5,7722,3582,4140,86.5
11120, 은평구,065002, 61세,2021,7944,3629,4315,84.1,7876,3599,4277,84.1
11120, 은평구,065003, 62세,2021,7367,3498,3869,90.4,7276,3454,3822,90.4
11120, 은평구,065004, 63세,2021,6834,3159,3675,86,6763,3129,3634,86.1
11120, 은평구,065005, 64세,2021,6766,3120,3646,85.6,6692,3089,3603,85.7
11120, 은평구,070,65~69세,2021,28412,12951,15461,83.8,28137,12830,15307,83.8
11120, 은평구,070001, 65세,2021,6281,2903,3378,85.9,6211,2877,3334,86.3
11120, 은평구,070002, 66세,2021,6502,3011,3491,86.3,6438,2986,3452,86.5
11120, 은평구,070003, 67세,2021,5513,2435,3078,79.1,5461,2412,3049,79.1
11120, 은평구,070004, 68세,2021,4991,2209,2782,79.4,4942,2184,2758,79.2
11120, 은평구,070005, 69세,2021,5125,2393,2732,87.6,5085,2371,2714,87.4
11120, 은평구,075,70~74세,2021,21111,9330,11781,79.2,20992,9279,11713,79.2
11120, 은평구,075001, 70세,2021,3858,1710,2148,79.6,3829,1695,2134,79.4
11120, 은평구,075002, 71세,2021,4281,1910,2371,80.6,4252,1896,2356,80.5
11120, 은평구,075003, 72세,2021,4364,1903,2461,77.3,4341,1898,2443,77.7
11120, 은평구,075004, 73세,2021,4263,1889,2374,79.6,4239,1882,2357,79.8
11120, 은평구,075005, 74세,2021,4345,1918,2427,79,4331,1908,2423,78.7
11120, 은평구,080,75~79세,2021,16669,7232,9437,76.6,16615,7209,9406,76.6
11120, 은평구,080001, 75세,2021,3391,1498,1893,79.1,3376,1490,1886,79
11120, 은평구,080002, 76세,2021,3212,1400,1812,77.3,3205,1397,1808,77.3
11120, 은평구,080003, 77세,2021,3163,1347,1816,74.2,3154,1344,1810,74.3
11120, 은평구,080004, 78세,2021,3230,1367,1863,73.4,3218,1362,1856,73.4
11120, 은평구,080005, 79세,2021,3673,1620,2053,78.9,3662,1616,2046,79
11120, 은평구,085,80~84세,2021,11356,4781,6575,72.7,11312,4767,6545,72.8
11120, 은평구,085001, 80세,2021,2809,1259,1550,81.2,2801,1256,1545,81.3
11120, 은평구,085002, 81세,2021,2507,1101,1406,78.3,2498,1099,1399,78.6
11120, 은평구,085003, 82세,2021,2322,929,1393,66.7,2316,927,1389,66.7
11120, 은평구,085004, 83세,2021,1953,784,1169,67.1,1941,779,1162,67
11120, 은평구,085005, 84세,2021,1765,708,1057,67,1756,706,1050,67.2
11120, 은평구,090,85~89세,2021,5006,1789,3217,55.6,4995,1786,3209,55.7
11120, 은평구,090001, 85세,2021,1477,549,928,59.2,1475,549,926,59.3
11120, 은평구,090002, 86세,2021,1238,461,777,59.3,1235,460,775,59.4
11120, 은평구,090003, 87세,2021,954,354,600,59,951,353,598,59
11120, 은평구,090004, 88세,2021,751,233,518,45,749,233,516,45.2
11120, 은평구,090005, 89세,2021,586,192,394,48.7,585,191,394,48.5
11120, 은평구,095,90~94세,2021,1570,423,1147,36.9,1565,422,1143,36.9
11120, 은평구,095001, 90세,2021,465,130,335,38.8,464,130,334,38.9
11120, 은평구,095002, 91세,2021,362,86,276,31.2,361,85,276,30.8
11120, 은평구,095003, 92세,2021,320,105,215,48.8,319,105,214,49.1
11120, 은평구,095004, 93세,2021,242,66,176,37.5,241,66,175,37.7
11120, 은평구,095005, 94세,2021,181,36,145,24.8,180,36,144,25
11120, 은평구,100,95~99세,2021,314,78,236,33.1,313,77,236,32.6
11120, 은평구,100001, 95세,2021,105,24,81,29.6,104,23,81,28.4
11120, 은평구,100002, 96세,2021,79,17,62,27.4,79,17,62,27.4
11120, 은평구,100003, 97세,2021,61,16,45,35.6,61,16,45,35.6
11120, 은평구,100004, 98세,2021,50,15,35,42.9,50,15,35,42.9
11120, 은평구,100005, 99세,2021,19,6,13,46.2,19,6,13,46.2
11120, 은평구,101,100세이상,2021,36,6,30,20,36,6,30,20
11120, 은평구,102,15세미만,2021,44288,22784,21504,106,43977,22631,21346,106
11120, 은평구,103,15~64세,2021,328623,158781,169842,93.5,323719,156792,166927,93.9
11120, 은평구,104,65세이상,2021,84474,36590,47884,76.4,83965,36376,47589,76.4
11120, 은평구,086,85세이상,2021,6926,2296,4630,49.6,6909,2291,4618,49.6
11120, 은평구,126,평균연령,2021,44.7,43.7,45.6,,44.7,43.7,45.6,
11120, 은평구,127,중위연령,2021,45.5,44.3,46.6,,45.6,44.4,46.7,
11130, 서대문구,000,합계,2021,314547,146558,167989,87.2,299912,141184,158728,88.9
11130, 서대문구,005,0~4세,2021,8274,4285,3989,107.4,8020,4144,3876,106.9
11130, 서대문구,005001, 0세,2021,1531,772,759,101.7,1508,760,748,101.6
11130, 서대문구,005002, 1세,2021,1548,766,782,98,1521,751,770,97.5
11130, 서대문구,005003, 2세,2021,1560,839,721,116.4,1511,815,696,117.1
11130, 서대문구,005004, 3세,2021,1717,922,795,116,1654,887,767,115.6
11130, 서대문구,005005, 4세,2021,1918,986,932,105.8,1826,931,895,104
11130, 서대문구,010,5~9세,2021,10731,5374,5357,100.3,10339,5182,5157,100.5
11130, 서대문구,010001, 5세,2021,2149,1067,1082,98.6,2032,1019,1013,100.6
11130, 서대문구,010002, 6세,2021,2202,1103,1099,100.4,2108,1053,1055,99.8
11130, 서대문구,010003, 7세,2021,2145,1057,1088,97.2,2078,1022,1056,96.8
11130, 서대문구,010004, 8세,2021,2044,1032,1012,102,1985,998,987,101.1
11130, 서대문구,010005, 9세,2021,2191,1115,1076,103.6,2136,1090,1046,104.2
11130, 서대문구,015,10~14세,2021,10188,5105,5083,100.4,9959,4991,4968,100.5
11130, 서대문구,015001, 10세,2021,2052,1011,1041,97.1,2004,986,1018,96.9
11130, 서대문구,015002, 11세,2021,2035,1039,996,104.3,1987,1014,973,104.2
11130, 서대문구,015003, 12세,2021,1995,1007,988,101.9,1960,990,970,102.1
11130, 서대문구,015004, 13세,2021,1982,1003,979,102.5,1940,983,957,102.7
11130, 서대문구,015005, 14세,2021,2124,1045,1079,96.8,2068,1018,1050,97
11130, 서대문구,020,15~19세,2021,13393,6096,7297,83.5,12753,5899,6854,86.1
11130, 서대문구,020001, 15세,2021,2125,1072,1053,101.8,2082,1051,1031,101.9
11130, 서대문구,020002, 16세,2021,2044,999,1045,95.6,2001,981,1020,96.2
11130, 서대문구,020003, 17세,2021,2367,1227,1140,107.6,2319,1203,1116,107.8
11130, 서대문구,020004, 18세,2021,2741,1283,1458,88,2603,1245,1358,91.7
11130, 서대문구,020005, 19세,2021,4116,1515,2601,58.2,3748,1419,2329,60.9
11130, 서대문구,025,20~24세,2021,30630,11710,18920,61.9,26587,10708,15879,67.4
11130, 서대문구,025001, 20세,2021,5404,1851,3553,52.1,4692,1678,3014,55.7
11130, 서대문구,025002, 21세,2021,6194,2145,4049,53,5213,1927,3286,58.6
11130, 서대문구,025003, 22세,2021,6060,2361,3699,63.8,5284,2187,3097,70.6
11130, 서대문구,025004, 23세,2021,6405,2618,3787,69.1,5609,2388,3221,74.1
11130, 서대문구,025005, 24세,2021,6567,2735,3832,71.4,5789,2528,3261,77.5
11130, 서대문구,030,25~29세,2021,30126,14416,15710,91.8,27716,13686,14030,97.5
11130, 서대문구,030001, 25세,2021,6568,2973,3595,82.7,5918,2800,3118,89.8
11130, 서대문구,030002, 26세,2021,6351,3004,3347,89.8,5780,2834,2946,96.2
11130, 서대문구,030003, 27세,2021,5991,2914,3077,94.7,5550,2772,2778,99.8
11130, 서대문구,030004, 28세,2021,5786,2855,2931,97.4,5385,2718,2667,101.9
11130, 서대문구,030005, 29세,2021,5430,2670,2760,96.7,5083,2562,2521,101.6
11130, 서대문구,035,30~34세,2021,23010,11146,11864,93.9,21552,10559,10993,96.1
11130, 서대문구,035001, 30세,2021,5272,2570,2702,95.1,4972,2456,2516,97.6
11130, 서대문구,035002, 31세,2021,4646,2270,2376,95.5,4317,2130,2187,97.4
11130, 서대문구,035003, 32세,2021,4456,2177,2279,95.5,4163,2069,2094,98.8
11130, 서대문구,035004, 33세,2021,4324,2055,2269,90.6,4056,1940,2116,91.7
11130, 서대문구,035005, 34세,2021,4312,2074,2238,92.7,4044,1964,2080,94.4
11130, 서대문구,040,35~39세,2021,22063,10942,11121,98.4,20928,10430,10498,99.4
11130, 서대문구,040001, 35세,2021,4202,2089,2113,98.9,3946,1975,1971,100.2
11130, 서대문구,040002, 36세,2021,4330,2158,2172,99.4,4094,2043,2051,99.6
11130, 서대문구,040003, 37세,2021,4176,2030,2146,94.6,3969,1936,2033,95.2
11130, 서대문구,040004, 38세,2021,4558,2313,2245,103,4347,2214,2133,103.8
11130, 서대문구,040005, 39세,2021,4797,2352,2445,96.2,4572,2262,2310,97.9
11130, 서대문구,045,40~44세,2021,21815,10816,10999,98.3,20914,10432,10482,99.5
11130, 서대문구,045001, 40세,2021,4751,2392,2359,101.4,4543,2304,2239,102.9
11130, 서대문구,045002, 41세,2021,4622,2249,2373,94.8,4447,2180,2267,96.2
11130, 서대문구,045003, 42세,2021,4344,2178,2166,100.6,4158,2103,2055,102.3
11130, 서대문구,045004, 43세,2021,3968,1954,2014,97,3802,1887,1915,98.5
11130, 서대문구,045005, 44세,2021,4130,2043,2087,97.9,3964,1958,2006,97.6
11130, 서대문구,050,45~49세,2021,22726,11133,11593,96,21947,10755,11192,96.1
11130, 서대문구,050001, 45세,2021,4003,1989,2014,98.8,3870,1933,1937,99.8
11130, 서대문구,050002, 46세,2021,4276,2129,2147,99.2,4130,2057,2073,99.2
11130, 서대문구,050003, 47세,2021,4685,2278,2407,94.6,4532,2207,2325,94.9
11130, 서대문구,050004, 48세,2021,4714,2242,2472,90.7,4551,2155,2396,89.9
11130, 서대문구,050005, 49세,2021,5048,2495,2553,97.7,4864,2403,2461,97.6
11130, 서대문구,055,50~54세,2021,25241,12180,13061,93.3,24505,11821,12684,93.2
11130, 서대문구,055001, 50세,2021,5394,2690,2704,99.5,5207,2598,2609,99.6
11130, 서대문구,055002, 51세,2021,5153,2473,2680,92.3,4979,2387,2592,92.1
11130, 서대문구,055003, 52세,2021,5128,2451,2677,91.6,4999,2389,2610,91.5
11130, 서대문구,055004, 53세,2021,4964,2397,2567,93.4,4822,2329,2493,93.4
11130, 서대문구,055005, 54세,2021,4602,2169,2433,89.1,4498,2118,2380,89
11130, 서대문구,060,55~59세,2021,22032,10629,11403,93.2,21446,10350,11096,93.3
11130, 서대문구,060001, 55세,2021,4305,2211,2094,105.6,4182,2155,2027,106.3
11130, 서대문구,060002, 56세,2021,4559,2102,2457,85.6,4435,2034,2401,84.7
11130, 서대문구,060003, 57세,2021,4282,2003,2279,87.9,4174,1955,2219,88.1
11130, 서대문구,060004, 58세,2021,4487,2171,2316,93.7,4366,2115,2251,94
11130, 서대문구,060005, 59세,2021,4399,2142,2257,94.9,4289,2091,2198,95.1
11130, 서대문구,065,60~64세,2021,22250,10546,11704,90.1,21764,10311,11453,90
11130, 서대문구,065001, 60세,2021,4769,2249,2520,89.2,4666,2207,2459,89.8
11130, 서대문구,065002, 61세,2021,4787,2226,2561,86.9,4683,2176,2507,86.8
11130, 서대문구,065003, 62세,2021,4431,2130,2301,92.6,4343,2088,2255,92.6
11130, 서대문구,065004, 63세,2021,4196,2036,2160,94.3,4093,1986,2107,94.3
11130, 서대문구,065005, 64세,2021,4067,1905,2162,88.1,3979,1854,2125,87.2
11130, 서대문구,070,65~69세,2021,16670,7735,8935,86.6,16363,7590,8773,86.5
11130, 서대문구,070001, 65세,2021,3695,1736,1959,88.6,3626,1704,1922,88.7
11130, 서대문구,070002, 66세,2021,3872,1792,2080,86.2,3803,1760,2043,86.1
11130, 서대문구,070003, 67세,2021,3184,1476,1708,86.4,3127,1448,1679,86.2
11130, 서대문구,070004, 68세,2021,2882,1350,1532,88.1,2818,1316,1502,87.6
11130, 서대문구,070005, 69세,2021,3037,1381,1656,83.4,2989,1362,1627,83.7
11130, 서대문구,075,70~74세,2021,12426,5329,7097,75.1,12289,5267,7022,75
11130, 서대문구,075001, 70세,2021,2202,1011,1191,84.9,2166,993,1173,84.7
11130, 서대문구,075002, 71세,2021,2553,1075,1478,72.7,2520,1058,1462,72.4
11130, 서대문구,075003, 72세,2021,2535,1056,1479,71.4,2507,1042,1465,71.1
11130, 서대문구,075004, 73세,2021,2434,1033,1401,73.7,2415,1025,1390,73.7
11130, 서대문구,075005, 74세,2021,2702,1154,1548,74.5,2681,1149,1532,75
11130, 서대문구,080,75~79세,2021,10442,4426,6016,73.6,10375,4395,5980,73.5
11130, 서대문구,080001, 75세,2021,2068,915,1153,79.4,2055,907,1148,79
11130, 서대문구,080002, 76세,2021,1999,847,1152,73.5,1978,836,1142,73.2
11130, 서대문구,080003, 77세,2021,1966,811,1155,70.2,1953,807,1146,70.4
11130, 서대문구,080004, 78세,2021,2014,824,1190,69.2,2004,819,1185,69.1
11130, 서대문구,080005, 79세,2021,2395,1029,1366,75.3,2385,1026,1359,75.5
11130, 서대문구,085,80~84세,2021,7594,3033,4561,66.5,7551,3022,4529,66.7
11130, 서대문구,085001, 80세,2021,1853,765,1088,70.3,1835,759,1076,70.5
11130, 서대문구,085002, 81세,2021,1673,657,1016,64.7,1667,654,1013,64.6
11130, 서대문구,085003, 82세,2021,1586,637,949,67.1,1576,636,940,67.7
11130, 서대문구,085004, 83세,2021,1342,528,814,64.9,1340,528,812,65
11130, 서대문구,085005, 84세,2021,1140,446,694,64.3,1133,445,688,64.7
11130, 서대문구,090,85~89세,2021,3574,1293,2281,56.7,3553,1282,2271,56.5
11130, 서대문구,090001, 85세,2021,1015,385,630,61.1,1007,380,627,60.6
11130, 서대문구,090002, 86세,2021,938,340,598,56.9,935,338,597,56.6
11130, 서대문구,090003, 87세,2021,671,242,429,56.4,666,240,426,56.3
11130, 서대문구,090004, 88세,2021,511,180,331,54.4,507,178,329,54.1
11130, 서대문구,090005, 89세,2021,439,146,293,49.8,438,146,292,50
11130, 서대문구,095,90~94세,2021,1100,304,796,38.2,1093,302,791,38.2
11130, 서대문구,095001, 90세,2021,301,87,214,40.7,298,86,212,40.6
11130, 서대문구,095002, 91세,2021,301,89,212,42,301,89,212,42
11130, 서대문구,095003, 92세,2021,214,63,151,41.7,212,63,149,42.3
11130, 서대문구,095004, 93세,2021,153,42,111,37.8,153,42,111,37.8
11130, 서대문구,095005, 94세,2021,131,23,108,21.3,129,22,107,20.6
11130, 서대문구,100,95~99세,2021,221,52,169,30.8,218,51,167,30.5
11130, 서대문구,100001, 95세,2021,76,25,51,49,76,25,51,49
11130, 서대문구,100002, 96세,2021,52,10,42,23.8,51,10,41,24.4
11130, 서대문구,100003, 97세,2021,40,X,36,11.1,39,X,35,11.4
11130, 서대문구,100004, 98세,2021,26,6,20,30,25,5,20,25
11130, 서대문구,100005, 99세,2021,27,7,20,35,27,7,20,35
11130, 서대문구,101,100세이상,2021,41,8,33,24.2,40,7,33,21.2
11130, 서대문구,102,15세미만,2021,29193,14764,14429,102.3,28318,14317,14001,102.3
11130, 서대문구,103,15~64세,2021,233286,109614,123672,88.6,220112,104951,115161,91.1
11130, 서대문구,104,65세이상,2021,52068,22180,29888,74.2,51482,21916,29566,74.1
11130, 서대문구,086,85세이상,2021,4936,1657,3279,50.5,4904,1642,3262,50.3
11130, 서대문구,126,평균연령,2021,42.7,42.3,43.1,,43.2,42.6,43.8,
11130, 서대문구,127,중위연령,2021,41.9,41.8,42,,42.7,42.2,43.3,
11140, 마포구,000,합계,2021,365192,170867,194325,87.9,352832,165874,186958,88.7
11140, 마포구,005,0~4세,2021,10524,5468,5056,108.1,10282,5332,4950,107.7
11140, 마포구,005001, 0세,2021,1976,1047,929,112.7,1953,1033,920,112.3
11140, 마포구,005002, 1세,2021,1938,1024,914,112,1902,1003,899,111.6
11140, 마포구,005003, 2세,2021,2114,1099,1015,108.3,2068,1070,998,107.2
11140, 마포구,005004, 3세,2021,2193,1122,1071,104.8,2133,1088,1045,104.1
11140, 마포구,005005, 4세,2021,2303,1176,1127,104.3,2226,1138,1088,104.6
11140, 마포구,010,5~9세,2021,12931,6561,6370,103,12611,6394,6217,102.8
11140, 마포구,010001, 5세,2021,2677,1394,1283,108.7,2596,1352,1244,108.7
11140, 마포구,010002, 6세,2021,2637,1325,1312,101,2553,1281,1272,100.7
11140, 마포구,010003, 7세,2021,2527,1270,1257,101,2473,1240,1233,100.6
11140, 마포구,010004, 8세,2021,2439,1219,1220,99.9,2384,1191,1193,99.8
11140, 마포구,010005, 9세,2021,2651,1353,1298,104.2,2605,1330,1275,104.3
11140, 마포구,015,10~14세,2021,12943,6552,6391,102.5,12800,6477,6323,102.4
11140, 마포구,015001, 10세,2021,2547,1283,1264,101.5,2512,1264,1248,101.3
11140, 마포구,015002, 11세,2021,2435,1231,1204,102.2,2416,1221,1195,102.2
11140, 마포구,015003, 12세,2021,2505,1283,1222,105,2469,1265,1204,105.1
11140, 마포구,015004, 13세,2021,2667,1341,1326,101.1,2640,1330,1310,101.5
11140, 마포구,015005, 14세,2021,2789,1414,1375,102.8,2763,1397,1366,102.3
11140, 마포구,020,15~19세,2021,13756,6764,6992,96.7,13392,6639,6753,98.3
11140, 마포구,020001, 15세,2021,2480,1231,1249,98.6,2447,1208,1239,97.5
11140, 마포구,020002, 16세,2021,2451,1266,1185,106.8,2425,1253,1172,106.9
11140, 마포구,020003, 17세,2021,2582,1267,1315,96.3,2536,1242,1294,96
11140, 마포구,020004, 18세,2021,2751,1395,1356,102.9,2670,1377,1293,106.5
11140, 마포구,020005, 19세,2021,3492,1605,1887,85.1,3314,1559,1755,88.8
11140, 마포구,025,20~24세,2021,27839,11719,16120,72.7,25353,11095,14258,77.8
11140, 마포구,025001, 20세,2021,4340,1932,2408,80.2,3997,1857,2140,86.8
11140, 마포구,025002, 21세,2021,5257,2172,3085,70.4,4704,2029,2675,75.9
11140, 마포구,025003, 22세,2021,5330,2238,3092,72.4,4854,2128,2726,78.1
11140, 마포구,025004, 23세,2021,6179,2579,3600,71.6,5602,2432,3170,76.7
11140, 마포구,025005, 24세,2021,6733,2798,3935,71.1,6196,2649,3547,74.7
11140, 마포구,030,25~29세,2021,37371,16888,20483,82.4,35352,16264,19088,85.2
11140, 마포구,030001, 25세,2021,7189,3107,4082,76.1,6732,2975,3757,79.2
11140, 마포구,030002, 26세,2021,7426,3276,4150,78.9,6980,3153,3827,82.4
11140, 마포구,030003, 27세,2021,7529,3494,4035,86.6,7140,3363,3777,89
11140, 마포구,030004, 28세,2021,7530,3491,4039,86.4,7147,3365,3782,89
11140, 마포구,030005, 29세,2021,7697,3520,4177,84.3,7353,3408,3945,86.4
11140, 마포구,035,30~34세,2021,32613,15047,17566,85.7,31133,14422,16711,86.3
11140, 마포구,035001, 30세,2021,7217,3331,3886,85.7,6927,3219,3708,86.8
11140, 마포구,035002, 31세,2021,6641,3025,3616,83.7,6280,2899,3381,85.7
11140, 마포구,035003, 32세,2021,6470,3013,3457,87.2,6178,2883,3295,87.5
11140, 마포구,035004, 33세,2021,6133,2877,3256,88.4,5886,2762,3124,88.4
11140, 마포구,035005, 34세,2021,6152,2801,3351,83.6,5862,2659,3203,83
11140, 마포구,040,35~39세,2021,30990,15004,15986,93.9,29760,14390,15370,93.6
11140, 마포구,040001, 35세,2021,6153,2907,3246,89.6,5903,2781,3122,89.1
11140, 마포구,040002, 36세,2021,6034,2934,3100,94.6,5790,2809,2981,94.2
11140, 마포구,040003, 37세,2021,6004,2884,3120,92.4,5745,2755,2990,92.1
11140, 마포구,040004, 38세,2021,6261,3053,3208,95.2,6026,2930,3096,94.6
11140, 마포구,040005, 39세,2021,6538,3226,3312,97.4,6296,3115,3181,97.9
11140, 마포구,045,40~44세,2021,28826,14033,14793,94.9,27906,13555,14351,94.5
11140, 마포구,045001, 40세,2021,6325,3155,3170,99.5,6114,3045,3069,99.2
11140, 마포구,045002, 41세,2021,6085,2991,3094,96.7,5888,2879,3009,95.7
11140, 마포구,045003, 42세,2021,5773,2788,2985,93.4,5589,2695,2894,93.1
11140, 마포구,045004, 43세,2021,5147,2516,2631,95.6,4969,2429,2540,95.6
11140, 마포구,045005, 44세,2021,5496,2583,2913,88.7,5346,2507,2839,88.3
11140, 마포구,050,45~49세,2021,29286,14204,15082,94.2,28543,13834,14709,94.1
11140, 마포구,050001, 45세,2021,5381,2541,2840,89.5,5236,2470,2766,89.3
11140, 마포구,050002, 46세,2021,5613,2773,2840,97.6,5448,2690,2758,97.5
11140, 마포구,050003, 47세,2021,5970,2916,3054,95.5,5829,2849,2980,95.6
11140, 마포구,050004, 48세,2021,6135,2909,3226,90.2,5986,2830,3156,89.7
11140, 마포구,050005, 49세,2021,6187,3065,3122,98.2,6044,2995,3049,98.2
11140, 마포구,055,50~54세,2021,29004,14052,14952,94,28287,13680,14607,93.7
11140, 마포구,055001, 50세,2021,6394,3104,3290,94.3,6237,3021,3216,93.9
11140, 마포구,055002, 51세,2021,6064,2979,3085,96.6,5915,2907,3008,96.6
11140, 마포구,055003, 52세,2021,5920,2919,3001,97.3,5791,2846,2945,96.6
11140, 마포구,055004, 53세,2021,5540,2637,2903,90.8,5388,2557,2831,90.3
11140, 마포구,055005, 54세,2021,5086,2413,2673,90.3,4956,2349,2607,90.1
11140, 마포구,060,55~59세,2021,24016,11772,12244,96.1,23353,11448,11905,96.2
11140, 마포구,060001, 55세,2021,4691,2365,2326,101.7,4568,2306,2262,101.9
11140, 마포구,060002, 56세,2021,5094,2452,2642,92.8,4962,2391,2571,93
11140, 마포구,060003, 57세,2021,4676,2300,2376,96.8,4527,2228,2299,96.9
11140, 마포구,060004, 58세,2021,4839,2337,2502,93.4,4695,2265,2430,93.2
11140, 마포구,060005, 59세,2021,4716,2318,2398,96.7,4601,2258,2343,96.4
11140, 마포구,065,60~64세,2021,22895,10738,12157,88.3,22441,10532,11909,88.4
11140, 마포구,065001, 60세,2021,4971,2409,2562,94,4890,2371,2519,94.1
11140, 마포구,065002, 61세,2021,5052,2369,2683,88.3,4940,2324,2616,88.8
11140, 마포구,065003, 62세,2021,4518,2097,2421,86.6,4439,2065,2374,87
11140, 마포구,065004, 63세,2021,4124,1926,2198,87.6,4036,1885,2151,87.6
11140, 마포구,065005, 64세,2021,4230,1937,2293,84.5,4136,1887,2249,83.9
11140, 마포구,070,65~69세,2021,17137,7830,9307,84.1,16812,7680,9132,84.1
11140, 마포구,070001, 65세,2021,3830,1755,2075,84.6,3751,1721,2030,84.8
11140, 마포구,070002, 66세,2021,4019,1879,2140,87.8,3941,1842,2099,87.8
11140, 마포구,070003, 67세,2021,3217,1454,1763,82.5,3148,1422,1726,82.4
11140, 마포구,070004, 68세,2021,2908,1307,1601,81.6,2852,1279,1573,81.3
11140, 마포구,070005, 69세,2021,3163,1435,1728,83,3120,1416,1704,83.1
11140, 마포구,075,70~74세,2021,12558,5299,7259,73,12419,5232,7187,72.8
11140, 마포구,075001, 70세,2021,2172,939,1233,76.2,2135,921,1214,75.9
11140, 마포구,075002, 71세,2021,2578,1097,1481,74.1,2551,1081,1470,73.5
11140, 마포구,075003, 72세,2021,2637,1111,1526,72.8,2610,1096,1514,72.4
11140, 마포구,075004, 73세,2021,2562,1076,1486,72.4,2532,1065,1467,72.6
11140, 마포구,075005, 74세,2021,2609,1076,1533,70.2,2591,1069,1522,70.2
11140, 마포구,080,75~79세,2021,10397,4348,6049,71.9,10346,4331,6015,72
11140, 마포구,080001, 75세,2021,1983,796,1187,67.1,1968,791,1177,67.2
11140, 마포구,080002, 76세,2021,2061,849,1212,70,2052,845,1207,70
11140, 마포구,080003, 77세,2021,2001,848,1153,73.5,1993,845,1148,73.6
11140, 마포구,080004, 78세,2021,1999,862,1137,75.8,1991,859,1132,75.9
11140, 마포구,080005, 79세,2021,2353,993,1360,73,2342,991,1351,73.4
11140, 마포구,085,80~84세,2021,7300,2960,4340,68.2,7264,2950,4314,68.4
11140, 마포구,085001, 80세,2021,1756,738,1018,72.5,1742,732,1010,72.5
11140, 마포구,085002, 81세,2021,1632,660,972,67.9,1624,657,967,67.9
11140, 마포구,085003, 82세,2021,1460,605,855,70.8,1455,604,851,71
11140, 마포구,085004, 83세,2021,1257,506,751,67.4,1252,506,746,67.8
11140, 마포구,085005, 84세,2021,1195,451,744,60.6,1191,451,740,60.9
11140, 마포구,090,85~89세,2021,3446,1231,2215,55.6,3433,1227,2206,55.6
11140, 마포구,090001, 85세,2021,958,373,585,63.8,951,370,581,63.7
11140, 마포구,090002, 86세,2021,854,307,547,56.1,852,306,546,56
11140, 마포구,090003, 87세,2021,616,190,426,44.6,616,190,426,44.6
11140, 마포구,090004, 88세,2021,554,205,349,58.7,552,205,347,59.1
11140, 마포구,090005, 89세,2021,464,156,308,50.6,462,156,306,51
11140, 마포구,095,90~94세,2021,1115,338,777,43.5,1105,334,771,43.3
11140, 마포구,095001, 90세,2021,328,105,223,47.1,324,104,220,47.3
11140, 마포구,095002, 91세,2021,281,86,195,44.1,277,84,193,43.5
11140, 마포구,095003, 92세,2021,213,63,150,42,212,62,150,41.3
11140, 마포구,095004, 93세,2021,188,55,133,41.4,188,55,133,41.4
11140, 마포구,095005, 94세,2021,105,29,76,38.2,104,29,75,38.7
11140, 마포구,100,95~99세,2021,212,51,161,31.7,211,51,160,31.9
11140, 마포구,100001, 95세,2021,69,18,51,35.3,69,18,51,35.3
11140, 마포구,100002, 96세,2021,57,10,47,21.3,56,10,46,21.7
11140, 마포구,100003, 97세,2021,32,9,23,39.1,32,9,23,39.1
11140, 마포구,100004, 98세,2021,30,10,20,50,30,10,20,50
11140, 마포구,100005, 99세,2021,24,X,20,20,24,X,20,20
11140, 마포구,101,100세이상,2021,33,8,25,32,29,7,22,31.8
11140, 마포구,102,15세미만,2021,36398,18581,17817,104.3,35693,18203,17490,104.1
11140, 마포구,103,15~64세,2021,276596,130221,146375,89,265520,125859,139661,90.1
11140, 마포구,104,65세이상,2021,52198,22065,30133,73.2,51619,21812,29807,73.2
11140, 마포구,086,85세이상,2021,4806,1628,3178,51.2,4778,1619,3159,51.3
11140, 마포구,126,평균연령,2021,41.8,41.2,42.3,,42,41.3,42.6,
11140, 마포구,127,중위연령,2021,40.6,40.5,40.7,,40.9,40.6,41.2,
11150, 양천구,000,합계,2021,433373,211970,221403,95.7,428082,209715,218367,96
11150, 양천구,005,0~4세,2021,10725,5599,5126,109.2,10661,5568,5093,109.3
11150, 양천구,005001, 0세,2021,1868,962,906,106.2,1857,953,904,105.4
11150, 양천구,005002, 1세,2021,1855,1001,854,117.2,1842,995,847,117.5
11150, 양천구,005003, 2세,2021,2131,1137,994,114.4,2118,1132,986,114.8
11150, 양천구,005004, 3세,2021,2236,1131,1105,102.4,2226,1126,1100,102.4
11150, 양천구,005005, 4세,2021,2635,1368,1267,108,2618,1362,1256,108.4
11150, 양천구,010,5~9세,2021,18313,9355,8958,104.4,18224,9313,8911,104.5
11150, 양천구,010001, 5세,2021,3104,1551,1553,99.9,3082,1541,1541,100
11150, 양천구,010002, 6세,2021,3407,1766,1641,107.6,3394,1761,1633,107.8
11150, 양천구,010003, 7세,2021,3622,1836,1786,102.8,3609,1827,1782,102.5
11150, 양천구,010004, 8세,2021,3900,2025,1875,108,3876,2013,1863,108.1
11150, 양천구,010005, 9세,2021,4280,2177,2103,103.5,4263,2171,2092,103.8
11150, 양천구,015,10~14세,2021,23699,12383,11316,109.4,23624,12343,11281,109.4
11150, 양천구,015001, 10세,2021,4294,2229,2065,107.9,4278,2221,2057,108
11150, 양천구,015002, 11세,2021,4542,2360,2182,108.2,4527,2351,2176,108
11150, 양천구,015003, 12세,2021,4587,2409,2178,110.6,4577,2404,2173,110.6
11150, 양천구,015004, 13세,2021,5070,2634,2436,108.1,5056,2627,2429,108.2
11150, 양천구,015005, 14세,2021,5206,2751,2455,112.1,5186,2740,2446,112
11150, 양천구,020,15~19세,2021,23400,12131,11269,107.6,23354,12108,11246,107.7
11150, 양천구,020001, 15세,2021,4663,2440,2223,109.8,4653,2437,2216,110
11150, 양천구,020002, 16세,2021,4621,2398,2223,107.9,4615,2396,2219,108
11150, 양천구,020003, 17세,2021,4933,2594,2339,110.9,4923,2586,2337,110.7
11150, 양천구,020004, 18세,2021,4784,2430,2354,103.2,4779,2428,2351,103.3
11150, 양천구,020005, 19세,2021,4399,2269,2130,106.5,4384,2261,2123,106.5
11150, 양천구,025,20~24세,2021,25169,12886,12283,104.9,24966,12823,12143,105.6
11150, 양천구,025001, 20세,2021,4676,2472,2204,112.2,4652,2468,2184,113
11150, 양천구,025002, 21세,2021,5074,2685,2389,112.4,5051,2675,2376,112.6
11150, 양천구,025003, 22세,2021,5059,2613,2446,106.8,5018,2597,2421,107.3
11150, 양천구,025004, 23세,2021,4984,2454,2530,97,4925,2439,2486,98.1
11150, 양천구,025005, 24세,2021,5376,2662,2714,98.1,5320,2644,2676,98.8
11150, 양천구,030,25~29세,2021,29025,14405,14620,98.5,28554,14248,14306,99.6
11150, 양천구,030001, 25세,2021,5649,2783,2866,97.1,5570,2761,2809,98.3
11150, 양천구,030002, 26세,2021,5706,2866,2840,100.9,5606,2838,2768,102.5
11150, 양천구,030003, 27세,2021,5877,2887,2990,96.6,5786,2853,2933,97.3
11150, 양천구,030004, 28세,2021,5939,2970,2969,100,5846,2938,2908,101
11150, 양천구,030005, 29세,2021,5854,2899,2955,98.1,5746,2858,2888,99
11150, 양천구,035,30~34세,2021,25677,12894,12783,100.9,25060,12641,12419,101.8
11150, 양천구,035001, 30세,2021,5726,2857,2869,99.6,5618,2822,2796,100.9
11150, 양천구,035002, 31세,2021,5169,2665,2504,106.4,5039,2614,2425,107.8
11150, 양천구,035003, 32세,2021,5067,2543,2524,100.8,4945,2494,2451,101.8
11150, 양천구,035004, 33세,2021,4865,2398,2467,97.2,4745,2343,2402,97.5
11150, 양천구,035005, 34세,2021,4850,2431,2419,100.5,4713,2368,2345,101
11150, 양천구,040,35~39세,2021,28512,13947,14565,95.8,27904,13671,14233,96.1
11150, 양천구,040001, 35세,2021,5044,2497,2547,98,4913,2447,2466,99.2
11150, 양천구,040002, 36세,2021,5257,2603,2654,98.1,5121,2539,2582,98.3
11150, 양천구,040003, 37세,2021,5499,2701,2798,96.5,5382,2644,2738,96.6
11150, 양천구,040004, 38세,2021,6083,2902,3181,91.2,5972,2847,3125,91.1
11150, 양천구,040005, 39세,2021,6629,3244,3385,95.8,6516,3194,3322,96.1
11150, 양천구,045,40~44세,2021,34962,16514,18448,89.5,34460,16294,18166,89.7
11150, 양천구,045001, 40세,2021,6922,3319,3603,92.1,6823,3278,3545,92.5
11150, 양천구,045002, 41세,2021,7185,3408,3777,90.2,7084,3356,3728,90
11150, 양천구,045003, 42세,2021,7129,3402,3727,91.3,7024,3361,3663,91.8
11150, 양천구,045004, 43세,2021,6723,3124,3599,86.8,6626,3084,3542,87.1
11150, 양천구,045005, 44세,2021,7003,3261,3742,87.1,6903,3215,3688,87.2
11150, 양천구,050,45~49세,2021,39237,18964,20273,93.5,38765,18753,20012,93.7
11150, 양천구,050001, 45세,2021,7078,3417,3661,93.3,6996,3387,3609,93.8
11150, 양천구,050002, 46세,2021,7500,3535,3965,89.2,7409,3494,3915,89.2
11150, 양천구,050003, 47세,2021,8203,4027,4176,96.4,8113,3989,4124,96.7
11150, 양천구,050004, 48세,2021,8248,3957,4291,92.2,8139,3906,4233,92.3
11150, 양천구,050005, 49세,2021,8208,4028,4180,96.4,8108,3977,4131,96.3
11150, 양천구,055,50~54세,2021,40237,19900,20337,97.9,39698,19657,20041,98.1
11150, 양천구,055001, 50세,2021,8855,4429,4426,100.1,8747,4379,4368,100.3
11150, 양천구,055002, 51세,2021,8278,4045,4233,95.6,8160,3992,4168,95.8
11150, 양천구,055003, 52세,2021,8225,4150,4075,101.8,8127,4107,4020,102.2
11150, 양천구,055004, 53세,2021,7767,3803,3964,95.9,7655,3753,3902,96.2
11150, 양천구,055005, 54세,2021,7112,3473,3639,95.4,7009,3426,3583,95.6
11150, 양천구,060,55~59세,2021,34267,16896,17371,97.3,33644,16622,17022,97.7
11150, 양천구,060001, 55세,2021,6883,3403,3480,97.8,6758,3358,3400,98.8
11150, 양천구,060002, 56세,2021,7058,3426,3632,94.3,6925,3364,3561,94.5
11150, 양천구,060003, 57세,2021,6579,3256,3323,98,6451,3197,3254,98.2
11150, 양천구,060004, 58세,2021,6867,3413,3454,98.8,6723,3350,3373,99.3
11150, 양천구,060005, 59세,2021,6880,3398,3482,97.6,6787,3353,3434,97.6
11150, 양천구,065,60~64세,2021,33616,16045,17571,91.3,33186,15852,17334,91.5
11150, 양천구,065001, 60세,2021,7338,3534,3804,92.9,7265,3501,3764,93
11150, 양천구,065002, 61세,2021,7243,3520,3723,94.5,7148,3475,3673,94.6
11150, 양천구,065003, 62세,2021,6591,3101,3490,88.9,6498,3056,3442,88.8
11150, 양천구,065004, 63세,2021,6288,2973,3315,89.7,6200,2936,3264,90
11150, 양천구,065005, 64세,2021,6156,2917,3239,90.1,6075,2884,3191,90.4
11150, 양천구,070,65~69세,2021,25623,12188,13435,90.7,25325,12057,13268,90.9
11150, 양천구,070001, 65세,2021,5592,2611,2981,87.6,5513,2578,2935,87.8
11150, 양천구,070002, 66세,2021,6103,2860,3243,88.2,6030,2826,3204,88.2
11150, 양천구,070003, 67세,2021,4947,2428,2519,96.4,4884,2400,2484,96.6
11150, 양천구,070004, 68세,2021,4334,2074,2260,91.8,4294,2057,2237,92
11150, 양천구,070005, 69세,2021,4647,2215,2432,91.1,4604,2196,2408,91.2
11150, 양천구,075,70~74세,2021,17233,8333,8900,93.6,17087,8265,8822,93.7
11150, 양천구,075001, 70세,2021,3274,1589,1685,94.3,3237,1572,1665,94.4
11150, 양천구,075002, 71세,2021,3686,1828,1858,98.4,3653,1810,1843,98.2
11150, 양천구,075003, 72세,2021,3612,1741,1871,93.1,3580,1728,1852,93.3
11150, 양천구,075004, 73세,2021,3394,1625,1769,91.9,3373,1616,1757,92
11150, 양천구,075005, 74세,2021,3267,1550,1717,90.3,3244,1539,1705,90.3
11150, 양천구,080,75~79세,2021,11407,5168,6239,82.8,11362,5154,6208,83
11150, 양천구,080001, 75세,2021,2434,1121,1313,85.4,2423,1117,1306,85.5
11150, 양천구,080002, 76세,2021,2275,1040,1235,84.2,2269,1038,1231,84.3
11150, 양천구,080003, 77세,2021,2237,1011,1226,82.5,2225,1008,1217,82.8
11150, 양천구,080004, 78세,2021,2130,983,1147,85.7,2121,979,1142,85.7
11150, 양천구,080005, 79세,2021,2331,1013,1318,76.9,2324,1012,1312,77.1
11150, 양천구,085,80~84세,2021,7248,2907,4341,67,7211,2897,4314,67.2
11150, 양천구,085001, 80세,2021,1832,825,1007,81.9,1822,823,999,82.4
11150, 양천구,085002, 81세,2021,1556,621,935,66.4,1548,619,929,66.6
11150, 양천구,085003, 82세,2021,1484,579,905,64,1475,576,899,64.1
11150, 양천구,085004, 83세,2021,1272,507,765,66.3,1267,506,761,66.5
11150, 양천구,085005, 84세,2021,1104,375,729,51.4,1099,373,726,51.4
11150, 양천구,090,85~89세,2021,3497,1075,2422,44.4,3476,1072,2404,44.6
11150, 양천구,090001, 85세,2021,943,318,625,50.9,934,318,616,51.6
11150, 양천구,090002, 86세,2021,833,258,575,44.9,827,256,571,44.8
11150, 양천구,090003, 87세,2021,679,203,476,42.6,675,203,472,43
11150, 양천구,090004, 88세,2021,576,174,402,43.3,574,173,401,43.1
11150, 양천구,090005, 89세,2021,466,122,344,35.5,466,122,344,35.5
11150, 양천구,095,90~94세,2021,1218,323,895,36.1,1213,320,893,35.8
11150, 양천구,095001, 90세,2021,346,81,265,30.6,344,80,264,30.3
11150, 양천구,095002, 91세,2021,318,74,244,30.3,317,73,244,29.9
11150, 양천구,095003, 92세,2021,237,68,169,40.2,237,68,169,40.2
11150, 양천구,095004, 93세,2021,188,62,126,49.2,186,61,125,48.8
11150, 양천구,095005, 94세,2021,129,38,91,41.8,129,38,91,41.8
11150, 양천구,100,95~99세,2021,276,49,227,21.6,276,49,227,21.6
11150, 양천구,100001, 95세,2021,81,9,72,12.5,81,9,72,12.5
11150, 양천구,100002, 96세,2021,79,17,62,27.4,79,17,62,27.4
11150, 양천구,100003, 97세,2021,35,6,29,20.7,35,6,29,20.7
11150, 양천구,100004, 98세,2021,49,14,35,40,49,14,35,40
11150, 양천구,100005, 99세,2021,32,X,29,10.3,32,X,29,10.3
11150, 양천구,101,100세이상,2021,32,8,24,33.3,32,8,24,33.3
11150, 양천구,102,15세미만,2021,52737,27337,25400,107.6,52509,27224,25285,107.7
11150, 양천구,103,15~64세,2021,314102,154582,159520,96.9,309591,152669,156922,97.3
11150, 양천구,104,65세이상,2021,66534,30051,36483,82.4,65982,29822,36160,82.5
11150, 양천구,086,85세이상,2021,5023,1455,3568,40.8,4997,1449,3548,40.8
11150, 양천구,126,평균연령,2021,42.9,42,43.7,,42.8,41.9,43.7,
11150, 양천구,127,중위연령,2021,44.6,43.7,45.4,,44.6,43.7,45.4,
11160, 강서구,000,합계,2021,559837,268530,291307,92.2,551470,264921,286549,92.5
11160, 강서구,005,0~4세,2021,15849,8077,7772,103.9,15658,7977,7681,103.9
11160, 강서구,005001, 0세,2021,2918,1477,1441,102.5,2891,1460,1431,102
11160, 강서구,005002, 1세,2021,3058,1546,1512,102.2,3023,1526,1497,101.9
11160, 강서구,005003, 2세,2021,3203,1647,1556,105.8,3161,1625,1536,105.8
11160, 강서구,005004, 3세,2021,3236,1669,1567,106.5,3194,1650,1544,106.9
11160, 강서구,005005, 4세,2021,3434,1738,1696,102.5,3389,1716,1673,102.6
11160, 강서구,010,5~9세,2021,20528,10441,10087,103.5,20388,10376,10012,103.6
11160, 강서구,010001, 5세,2021,4030,2056,1974,104.2,3994,2046,1948,105
11160, 강서구,010002, 6세,2021,4062,2049,2013,101.8,4022,2024,1998,101.3
11160, 강서구,010003, 7세,2021,3968,2008,1960,102.4,3949,1999,1950,102.5
11160, 강서구,010004, 8세,2021,4046,2071,1975,104.9,4027,2063,1964,105
11160, 강서구,010005, 9세,2021,4422,2257,2165,104.2,4396,2244,2152,104.3
11160, 강서구,015,10~14세,2021,20309,10460,9849,106.2,20228,10418,9810,106.2
11160, 강서구,015001, 10세,2021,4194,2172,2022,107.4,4178,2165,2013,107.6
11160, 강서구,015002, 11세,2021,3924,2056,1868,110.1,3905,2045,1860,109.9
11160, 강서구,015003, 12세,2021,3797,1989,1808,110,3781,1978,1803,109.7
11160, 강서구,015004, 13세,2021,4198,2104,2094,100.5,4180,2096,2084,100.6
11160, 강서구,015005, 14세,2021,4196,2139,2057,104,4184,2134,2050,104.1
11160, 강서구,020,15~19세,2021,20766,10477,10289,101.8,20697,10450,10247,102
11160, 강서구,020001, 15세,2021,3925,2013,1912,105.3,3917,2010,1907,105.4
11160, 강서구,020002, 16세,2021,3878,1952,1926,101.3,3867,1949,1918,101.6
11160, 강서구,020003, 17세,2021,4306,2195,2111,104,4284,2188,2096,104.4
11160, 강서구,020004, 18세,2021,4386,2185,2201,99.3,4378,2180,2198,99.2
11160, 강서구,020005, 19세,2021,4271,2132,2139,99.7,4251,2123,2128,99.8
11160, 강서구,025,20~24세,2021,30901,14324,16577,86.4,30572,14221,16351,87
11160, 강서구,025001, 20세,2021,5074,2532,2542,99.6,5037,2517,2520,99.9
11160, 강서구,025002, 21세,2021,5791,2912,2879,101.1,5736,2894,2842,101.8
11160, 강서구,025003, 22세,2021,5754,2742,3012,91,5694,2723,2971,91.7
11160, 강서구,025004, 23세,2021,6568,2944,3624,81.2,6487,2924,3563,82.1
11160, 강서구,025005, 24세,2021,7714,3194,4520,70.7,7618,3163,4455,71
11160, 강서구,030,25~29세,2021,51782,23325,28457,82,50892,23012,27880,82.5
11160, 강서구,030001, 25세,2021,8678,3728,4950,75.3,8555,3684,4871,75.6
11160, 강서구,030002, 26세,2021,9888,4288,5600,76.6,9723,4228,5495,76.9
11160, 강서구,030003, 27세,2021,10518,4742,5776,82.1,10338,4693,5645,83.1
11160, 강서구,030004, 28세,2021,11197,5168,6029,85.7,10969,5080,5889,86.3
11160, 강서구,030005, 29세,2021,11501,5399,6102,88.5,11307,5327,5980,89.1
11160, 강서구,035,30~34세,2021,50053,24745,25308,97.8,48832,24232,24600,98.5
11160, 강서구,035001, 30세,2021,11044,5252,5792,90.7,10825,5172,5653,91.5
11160, 강서구,035002, 31세,2021,10548,5238,5310,98.6,10317,5128,5189,98.8
11160, 강서구,035003, 32세,2021,9936,4928,5008,98.4,9687,4832,4855,99.5
11160, 강서구,035004, 33세,2021,9503,4761,4742,100.4,9231,4643,4588,101.2
11160, 강서구,035005, 34세,2021,9022,4566,4456,102.5,8772,4457,4315,103.3
11160, 강서구,040,35~39세,2021,46237,23673,22564,104.9,45162,23187,21975,105.5
11160, 강서구,040001, 35세,2021,9213,4658,4555,102.3,8958,4546,4412,103
11160, 강서구,040002, 36세,2021,8845,4540,4305,105.5,8618,4446,4172,106.6
11160, 강서구,040003, 37세,2021,8868,4542,4326,105,8665,4450,4215,105.6
11160, 강서구,040004, 38세,2021,9477,4900,4577,107.1,9292,4819,4473,107.7
11160, 강서구,040005, 39세,2021,9834,5033,4801,104.8,9629,4926,4703,104.7
11160, 강서구,045,40~44세,2021,44214,22338,21876,102.1,43501,22000,21501,102.3
11160, 강서구,045001, 40세,2021,9483,4944,4539,108.9,9323,4875,4448,109.6
11160, 강서구,045002, 41세,2021,9600,4841,4759,101.7,9440,4769,4671,102.1
11160, 강서구,045003, 42세,2021,9073,4537,4536,100,8921,4468,4453,100.3
11160, 강서구,045004, 43세,2021,7897,3913,3984,98.2,7761,3844,3917,98.1
11160, 강서구,045005, 44세,2021,8161,4103,4058,101.1,8056,4044,4012,100.8
11160, 강서구,050,45~49세,2021,42237,21096,21141,99.8,41626,20817,20809,100
11160, 강서구,050001, 45세,2021,7816,3922,3894,100.7,7687,3851,3836,100.4
11160, 강서구,050002, 46세,2021,8131,4056,4075,99.5,8013,4010,4003,100.2
11160, 강서구,050003, 47세,2021,8803,4308,4495,95.8,8705,4260,4445,95.8
11160, 강서구,050004, 48세,2021,8839,4461,4378,101.9,8714,4401,4313,102
11160, 강서구,050005, 49세,2021,8648,4349,4299,101.2,8507,4295,4212,102
11160, 강서구,055,50~54세,2021,42348,20472,21876,93.6,41629,20142,21487,93.7
11160, 강서구,055001, 50세,2021,9029,4435,4594,96.5,8885,4361,4524,96.4
11160, 강서구,055002, 51세,2021,8549,4182,4367,95.8,8391,4108,4283,95.9
11160, 강서구,055003, 52세,2021,8697,4256,4441,95.8,8563,4193,4370,95.9
11160, 강서구,055004, 53세,2021,8449,4031,4418,91.2,8297,3972,4325,91.8
11160, 강서구,055005, 54세,2021,7624,3568,4056,88,7493,3508,3985,88
11160, 강서구,060,55~59세,2021,40212,18937,21275,89,39329,18540,20789,89.2
11160, 강서구,060001, 55세,2021,7636,3630,4006,90.6,7488,3558,3930,90.5
11160, 강서구,060002, 56세,2021,8104,3801,4303,88.3,7921,3719,4202,88.5
11160, 강서구,060003, 57세,2021,7704,3560,4144,85.9,7530,3489,4041,86.3
11160, 강서구,060004, 58세,2021,8262,3880,4382,88.5,8075,3804,4271,89.1
11160, 강서구,060005, 59세,2021,8506,4066,4440,91.6,8315,3970,4345,91.4
11160, 강서구,065,60~64세,2021,44292,20415,23877,85.5,43635,20116,23519,85.5
11160, 강서구,065001, 60세,2021,9332,4293,5039,85.2,9222,4244,4978,85.3
11160, 강서구,065002, 61세,2021,9436,4284,5152,83.2,9299,4213,5086,82.8
11160, 강서구,065003, 62세,2021,8905,4234,4671,90.6,8782,4177,4605,90.7
11160, 강서구,065004, 63세,2021,8314,3791,4523,83.8,8174,3730,4444,83.9
11160, 강서구,065005, 64세,2021,8305,3813,4492,84.9,8158,3752,4406,85.2
11160, 강서구,070,65~69세,2021,33935,15571,18364,84.8,33489,15372,18117,84.8
11160, 강서구,070001, 65세,2021,7478,3439,4039,85.1,7375,3390,3985,85.1
11160, 강서구,070002, 66세,2021,7915,3538,4377,80.8,7813,3490,4323,80.7
11160, 강서구,070003, 67세,2021,6451,2940,3511,83.7,6346,2899,3447,84.1
11160, 강서구,070004, 68세,2021,5860,2758,3102,88.9,5792,2726,3066,88.9
11160, 강서구,070005, 69세,2021,6231,2896,3335,86.8,6163,2867,3296,87
11160, 강서구,075,70~74세,2021,23309,11004,12305,89.4,23123,10933,12190,89.7
11160, 강서구,075001, 70세,2021,4357,2039,2318,88,4306,2023,2283,88.6
11160, 강서구,075002, 71세,2021,4888,2288,2600,88,4839,2266,2573,88.1
11160, 강서구,075003, 72세,2021,4864,2285,2579,88.6,4827,2271,2556,88.8
11160, 강서구,075004, 73세,2021,4543,2175,2368,91.8,4517,2167,2350,92.2
11160, 강서구,075005, 74세,2021,4657,2217,2440,90.9,4634,2206,2428,90.9
11160, 강서구,080,75~79세,2021,15552,7179,8373,85.7,15471,7152,8319,86
11160, 강서구,080001, 75세,2021,3357,1599,1758,91,3342,1592,1750,91
11160, 강서구,080002, 76세,2021,3220,1517,1703,89.1,3200,1511,1689,89.5
11160, 강서구,080003, 77세,2021,3014,1404,1610,87.2,2996,1397,1599,87.4
11160, 강서구,080004, 78세,2021,2811,1244,1567,79.4,2796,1242,1554,79.9
11160, 강서구,080005, 79세,2021,3150,1415,1735,81.6,3137,1410,1727,81.6
11160, 강서구,085,80~84세,2021,10005,3924,6081,64.5,9961,3913,6048,64.7
11160, 강서구,085001, 80세,2021,2442,1022,1420,72,2433,1017,1416,71.8
11160, 강서구,085002, 81세,2021,2229,931,1298,71.7,2216,930,1286,72.3
11160, 강서구,085003, 82세,2021,2084,793,1291,61.4,2076,791,1285,61.6
11160, 강서구,085004, 83세,2021,1721,656,1065,61.6,1715,654,1061,61.6
11160, 강서구,085005, 84세,2021,1529,522,1007,51.8,1521,521,1000,52.1
11160, 강서구,090,85~89세,2021,4960,1543,3417,45.2,4942,1537,3405,45.1
11160, 강서구,090001, 85세,2021,1289,418,871,48,1287,417,870,47.9
11160, 강서구,090002, 86세,2021,1257,417,840,49.6,1256,417,839,49.7
11160, 강서구,090003, 87세,2021,925,280,645,43.4,920,277,643,43.1
11160, 강서구,090004, 88세,2021,822,248,574,43.2,816,247,569,43.4
11160, 강서구,090005, 89세,2021,667,180,487,37,663,179,484,37
11160, 강서구,095,90~94세,2021,1851,416,1435,29,1840,413,1427,28.9
11160, 강서구,095001, 90세,2021,490,129,361,35.7,484,126,358,35.2
11160, 강서구,095002, 91세,2021,459,103,356,28.9,456,103,353,29.2
11160, 강서구,095003, 92세,2021,396,89,307,29,396,89,307,29
11160, 강서구,095004, 93세,2021,290,50,240,20.8,289,50,239,20.9
11160, 강서구,095005, 94세,2021,216,45,171,26.3,215,45,170,26.5
11160, 강서구,100,95~99세,2021,440,98,342,28.7,438,98,340,28.8
11160, 강서구,100001, 95세,2021,149,31,118,26.3,149,31,118,26.3
11160, 강서구,100002, 96세,2021,115,24,91,26.4,114,24,90,26.7
11160, 강서구,100003, 97세,2021,84,22,62,35.5,83,22,61,36.1
11160, 강서구,100004, 98세,2021,51,12,39,30.8,51,12,39,30.8
11160, 강서구,100005, 99세,2021,41,9,32,28.1,41,9,32,28.1
11160, 강서구,101,100세이상,2021,57,15,42,35.7,57,15,42,35.7
11160, 강서구,102,15세미만,2021,56686,28978,27708,104.6,56274,28771,27503,104.6
11160, 강서구,103,15~64세,2021,413042,199802,213240,93.7,405875,196717,209158,94.1
11160, 강서구,104,65세이상,2021,90109,39750,50359,78.9,89321,39433,49888,79
11160, 강서구,086,85세이상,2021,7308,2072,5236,39.6,7277,2063,5214,39.6
11160, 강서구,126,평균연령,2021,43.1,42.3,43.8,,43.1,42.3,43.9,
11160, 강서구,127,중위연령,2021,42.5,41.8,43.2,,42.5,41.8,43.3,
11170, 구로구,000,합계,2021,426220,212275,213945,99.2,383334,188733,194601,97
11170, 구로구,005,0~4세,2021,12393,6394,5999,106.6,11587,5990,5597,107
11170, 구로구,005001, 0세,2021,2306,1178,1128,104.4,2183,1114,1069,104.2
11170, 구로구,005002, 1세,2021,2307,1223,1084,112.8,2180,1150,1030,111.7
11170, 구로구,005003, 2세,2021,2514,1287,1227,104.9,2316,1195,1121,106.6
11170, 구로구,005004, 3세,2021,2589,1345,1244,108.1,2430,1271,1159,109.7
11170, 구로구,005005, 4세,2021,2677,1361,1316,103.4,2478,1260,1218,103.4
11170, 구로구,010,5~9세,2021,14628,7439,7189,103.5,13863,7044,6819,103.3
11170, 구로구,010001, 5세,2021,2852,1477,1375,107.4,2659,1363,1296,105.2
11170, 구로구,010002, 6세,2021,2961,1475,1486,99.3,2818,1409,1409,100
11170, 구로구,010003, 7세,2021,2814,1456,1358,107.2,2682,1390,1292,107.6
11170, 구로구,010004, 8세,2021,2962,1511,1451,104.1,2805,1436,1369,104.9
11170, 구로구,010005, 9세,2021,3039,1520,1519,100.1,2899,1446,1453,99.5
11170, 구로구,015,10~14세,2021,14270,7239,7031,103,13770,6986,6784,103
11170, 구로구,015001, 10세,2021,2957,1498,1459,102.7,2860,1448,1412,102.5
11170, 구로구,015002, 11세,2021,2874,1493,1381,108.1,2780,1436,1344,106.8
11170, 구로구,015003, 12세,2021,2688,1346,1342,100.3,2596,1302,1294,100.6
11170, 구로구,015004, 13세,2021,2853,1448,1405,103.1,2752,1397,1355,103.1
11170, 구로구,015005, 14세,2021,2898,1454,1444,100.7,2782,1403,1379,101.7
11170, 구로구,020,15~19세,2021,14417,7543,6874,109.7,14088,7358,6730,109.3
11170, 구로구,020001, 15세,2021,2692,1430,1262,113.3,2624,1394,1230,113.3
11170, 구로구,020002, 16세,2021,2580,1398,1182,118.3,2526,1365,1161,117.6
11170, 구로구,020003, 17세,2021,2992,1576,1416,111.3,2919,1533,1386,110.6
11170, 구로구,020004, 18세,2021,2979,1533,1446,106,2918,1501,1417,105.9
11170, 구로구,020005, 19세,2021,3174,1606,1568,102.4,3101,1565,1536,101.9
11170, 구로구,025,20~24세,2021,22195,10850,11345,95.6,21274,10408,10866,95.8
11170, 구로구,025001, 20세,2021,3668,1934,1734,111.5,3549,1877,1672,112.3
11170, 구로구,025002, 21세,2021,4262,2107,2155,97.8,4103,2036,2067,98.5
11170, 구로구,025003, 22세,2021,4197,2058,2139,96.2,3997,1956,2041,95.8
11170, 구로구,025004, 23세,2021,4745,2281,2464,92.6,4541,2184,2357,92.7
11170, 구로구,025005, 24세,2021,5323,2470,2853,86.6,5084,2355,2729,86.3
11170, 구로구,030,25~29세,2021,32534,15878,16656,95.3,30576,14974,15602,96
11170, 구로구,030001, 25세,2021,5806,2708,3098,87.4,5533,2584,2949,87.6
11170, 구로구,030002, 26세,2021,6208,2959,3249,91.1,5868,2819,3049,92.5
11170, 구로구,030003, 27세,2021,6672,3310,3362,98.5,6300,3138,3162,99.2
11170, 구로구,030004, 28세,2021,6742,3344,3398,98.4,6311,3137,3174,98.8
11170, 구로구,030005, 29세,2021,7106,3557,3549,100.2,6564,3296,3268,100.9
11170, 구로구,035,30~34세,2021,33607,17106,16501,103.7,29733,15044,14689,102.4
11170, 구로구,035001, 30세,2021,6880,3420,3460,98.8,6249,3097,3152,98.3
11170, 구로구,035002, 31세,2021,6715,3388,3327,101.8,5970,2990,2980,100.3
11170, 구로구,035003, 32세,2021,6680,3427,3253,105.3,5912,3024,2888,104.7
11170, 구로구,035004, 33세,2021,6631,3446,3185,108.2,5831,3016,2815,107.1
11170, 구로구,035005, 34세,2021,6701,3425,3276,104.5,5771,2917,2854,102.2
11170, 구로구,040,35~39세,2021,32993,17350,15643,110.9,29056,15037,14019,107.3
11170, 구로구,040001, 35세,2021,6433,3353,3080,108.9,5554,2847,2707,105.2
11170, 구로구,040002, 36세,2021,6291,3335,2956,112.8,5516,2893,2623,110.3
11170, 구로구,040003, 37세,2021,6435,3333,3102,107.4,5669,2883,2786,103.5
11170, 구로구,040004, 38세,2021,6766,3614,3152,114.7,6010,3163,2847,111.1
11170, 구로구,040005, 39세,2021,7068,3715,3353,110.8,6307,3251,3056,106.4
11170, 구로구,045,40~44세,2021,32584,17124,15460,110.8,29421,15177,14244,106.6
11170, 구로구,045001, 40세,2021,6931,3623,3308,109.5,6334,3282,3052,107.5
11170, 구로구,045002, 41세,2021,6929,3622,3307,109.5,6318,3244,3074,105.5
11170, 구로구,045003, 42세,2021,6678,3504,3174,110.4,6002,3068,2934,104.6
11170, 구로구,045004, 43세,2021,5968,3141,2827,111.1,5273,2717,2556,106.3
11170, 구로구,045005, 44세,2021,6078,3234,2844,113.7,5494,2866,2628,109.1
11170, 구로구,050,45~49세,2021,33001,17356,15645,110.9,29148,14885,14263,104.4
11170, 구로구,050001, 45세,2021,6054,3185,2869,111,5395,2739,2656,103.1
11170, 구로구,050002, 46세,2021,6041,3213,2828,113.6,5411,2799,2612,107.2
11170, 구로구,050003, 47세,2021,6773,3535,3238,109.2,6024,3067,2957,103.7
11170, 구로구,050004, 48세,2021,7097,3727,3370,110.6,6238,3185,3053,104.3
11170, 구로구,050005, 49세,2021,7036,3696,3340,110.7,6080,3095,2985,103.7
11170, 구로구,055,50~54세,2021,36272,18329,17943,102.2,30747,15181,15566,97.5
11170, 구로구,055001, 50세,2021,7498,3819,3679,103.8,6420,3218,3202,100.5
11170, 구로구,055002, 51세,2021,7349,3726,3623,102.8,6162,3058,3104,98.5
11170, 구로구,055003, 52세,2021,7353,3721,3632,102.5,6209,3055,3154,96.9
11170, 구로구,055004, 53세,2021,7282,3602,3680,97.9,6124,2924,3200,91.4
11170, 구로구,055005, 54세,2021,6790,3461,3329,104,5832,2926,2906,100.7
11170, 구로구,060,55~59세,2021,36070,18107,17963,100.8,29079,14225,14854,95.8
11170, 구로구,060001, 55세,2021,6725,3428,3297,104,5594,2746,2848,96.4
11170, 구로구,060002, 56세,2021,7273,3680,3593,102.4,5898,2920,2978,98.1
11170, 구로구,060003, 57세,2021,7043,3454,3589,96.2,5611,2710,2901,93.4
11170, 구로구,060004, 58세,2021,7652,3866,3786,102.1,5887,2880,3007,95.8
11170, 구로구,060005, 59세,2021,7377,3679,3698,99.5,6089,2969,3120,95.2
11170, 구로구,065,60~64세,2021,36366,17568,18798,93.5,31125,14746,16379,90
11170, 구로구,065001, 60세,2021,7394,3617,3777,95.8,6624,3223,3401,94.8
11170, 구로구,065002, 61세,2021,8049,3847,4202,91.6,6738,3148,3590,87.7
11170, 구로구,065003, 62세,2021,7132,3435,3697,92.9,6130,2865,3265,87.7
11170, 구로구,065004, 63세,2021,6915,3366,3549,94.8,5805,2769,3036,91.2
11170, 구로구,065005, 64세,2021,6876,3303,3573,92.4,5828,2741,3087,88.8
11170, 구로구,070,65~69세,2021,28120,13234,14886,88.9,24991,11614,13377,86.8
11170, 구로구,070001, 65세,2021,6165,2919,3246,89.9,5352,2512,2840,88.5
11170, 구로구,070002, 66세,2021,6468,3063,3405,90,5724,2645,3079,85.9
11170, 구로구,070003, 67세,2021,5558,2594,2964,87.5,4889,2258,2631,85.8
11170, 구로구,070004, 68세,2021,4989,2326,2663,87.3,4488,2069,2419,85.5
11170, 구로구,070005, 69세,2021,4940,2332,2608,89.4,4538,2130,2408,88.5
11170, 구로구,075,70~74세,2021,19537,9320,10217,91.2,18444,8824,9620,91.7
11170, 구로구,075001, 70세,2021,3760,1796,1964,91.4,3446,1647,1799,91.6
11170, 구로구,075002, 71세,2021,4092,1925,2167,88.8,3816,1783,2033,87.7
11170, 구로구,075003, 72세,2021,4102,1961,2141,91.6,3878,1855,2023,91.7
11170, 구로구,075004, 73세,2021,3767,1815,1952,93,3618,1767,1851,95.5
11170, 구로구,075005, 74세,2021,3816,1823,1993,91.5,3686,1772,1914,92.6
11170, 구로구,080,75~79세,2021,13415,6173,7242,85.2,13027,6064,6963,87.1
11170, 구로구,080001, 75세,2021,2829,1317,1512,87.1,2732,1282,1450,88.4
11170, 구로구,080002, 76세,2021,2637,1206,1431,84.3,2565,1187,1378,86.1
11170, 구로구,080003, 77세,2021,2577,1217,1360,89.5,2503,1193,1310,91.1
11170, 구로구,080004, 78세,2021,2518,1146,1372,83.5,2448,1133,1315,86.2
11170, 구로구,080005, 79세,2021,2854,1287,1567,82.1,2779,1269,1510,84
11170, 구로구,085,80~84세,2021,8469,3572,4897,72.9,8203,3519,4684,75.1
11170, 구로구,085001, 80세,2021,2105,954,1151,82.9,2047,938,1109,84.6
11170, 구로구,085002, 81세,2021,1839,778,1061,73.3,1782,769,1013,75.9
11170, 구로구,085003, 82세,2021,1776,764,1012,75.5,1722,757,965,78.4
11170, 구로구,085004, 83세,2021,1514,601,913,65.8,1462,589,873,67.5
11170, 구로구,085005, 84세,2021,1235,475,760,62.5,1190,466,724,64.4
11170, 구로구,090,85~89세,2021,3853,1341,2512,53.4,3736,1310,2426,54
11170, 구로구,090001, 85세,2021,1060,405,655,61.8,1022,395,627,63
11170, 구로구,090002, 86세,2021,995,348,647,53.8,975,342,633,54
11170, 구로구,090003, 87세,2021,731,231,500,46.2,706,225,481,46.8
11170, 구로구,090004, 88세,2021,590,201,389,51.7,572,196,376,52.1
11170, 구로구,090005, 89세,2021,477,156,321,48.6,461,152,309,49.2
11170, 구로구,095,90~94세,2021,1203,294,909,32.3,1178,289,889,32.5
11170, 구로구,095001, 90세,2021,346,90,256,35.2,339,89,250,35.6
11170, 구로구,095002, 91세,2021,313,78,235,33.2,306,77,229,33.6
11170, 구로구,095003, 92세,2021,225,59,166,35.5,221,58,163,35.6
11170, 구로구,095004, 93세,2021,179,39,140,27.9,175,37,138,26.8
11170, 구로구,095005, 94세,2021,140,28,112,25,137,28,109,25.7
11170, 구로구,100,95~99세,2021,263,51,212,24.1,258,51,207,24.6
11170, 구로구,100001, 95세,2021,89,15,74,20.3,87,15,72,20.8
11170, 구로구,100002, 96세,2021,52,10,42,23.8,52,10,42,23.8
11170, 구로구,100003, 97세,2021,43,9,34,26.5,41,9,32,28.1
11170, 구로구,100004, 98세,2021,50,11,39,28.2,49,11,38,28.9
11170, 구로구,100005, 99세,2021,29,6,23,26.1,29,6,23,26.1
11170, 구로구,101,100세이상,2021,30,7,23,30.4,30,7,23,30.4
11170, 구로구,102,15세미만,2021,41291,21072,20219,104.2,39220,20020,19200,104.3
11170, 구로구,103,15~64세,2021,310039,157211,152828,102.9,274247,137035,137212,99.9
11170, 구로구,104,65세이상,2021,74890,33992,40898,83.1,69867,31678,38189,83
11170, 구로구,086,85세이상,2021,5349,1693,3656,46.3,5202,1657,3545,46.7
11170, 구로구,126,평균연령,2021,44.6,43.9,45.3,,44.3,43.5,45,
11170, 구로구,127,중위연령,2021,45.6,44.8,46.5,,44.7,43.7,45.7,
11180, 금천구,000,합계,2021,247398,125468,121930,102.9,222191,111914,110277,101.5
11180, 금천구,005,0~4세,2021,5726,2974,2752,108.1,5232,2716,2516,107.9
11180, 금천구,005001, 0세,2021,1072,550,522,105.4,1002,512,490,104.5
11180, 금천구,005002, 1세,2021,1083,551,532,103.6,985,510,475,107.4
11180, 금천구,005003, 2세,2021,1152,617,535,115.3,1037,553,484,114.3
11180, 금천구,005004, 3세,2021,1176,611,565,108.1,1081,559,522,107.1
11180, 금천구,005005, 4세,2021,1243,645,598,107.9,1127,582,545,106.8
11180, 금천구,010,5~9세,2021,6724,3439,3285,104.7,6236,3195,3041,105.1
11180, 금천구,010001, 5세,2021,1385,704,681,103.4,1248,631,617,102.3
11180, 금천구,010002, 6세,2021,1383,701,682,102.8,1295,653,642,101.7
11180, 금천구,010003, 7세,2021,1273,663,610,108.7,1187,624,563,110.8
11180, 금천구,010004, 8세,2021,1229,626,603,103.8,1148,588,560,105
11180, 금천구,010005, 9세,2021,1454,745,709,105.1,1358,699,659,106.1
11180, 금천구,015,10~14세,2021,6476,3282,3194,102.8,6189,3136,3053,102.7
11180, 금천구,015001, 10세,2021,1309,656,653,100.5,1225,613,612,100.2
11180, 금천구,015002, 11세,2021,1296,668,628,106.4,1235,640,595,107.6
11180, 금천구,015003, 12세,2021,1232,612,620,98.7,1180,587,593,99
11180, 금천구,015004, 13세,2021,1261,664,597,111.2,1216,642,574,111.8
11180, 금천구,015005, 14세,2021,1378,682,696,98,1333,654,679,96.3
11180, 금천구,020,15~19세,2021,7303,3639,3664,99.3,7141,3555,3586,99.1
11180, 금천구,020001, 15세,2021,1287,654,633,103.3,1253,636,617,103.1
11180, 금천구,020002, 16세,2021,1374,704,670,105.1,1332,678,654,103.7
11180, 금천구,020003, 17세,2021,1474,705,769,91.7,1442,694,748,92.8
11180, 금천구,020004, 18세,2021,1541,736,805,91.4,1517,723,794,91.1
11180, 금천구,020005, 19세,2021,1627,840,787,106.7,1597,824,773,106.6
11180, 금천구,025,20~24세,2021,13412,6349,7063,89.9,12943,6143,6800,90.3
11180, 금천구,025001, 20세,2021,1930,975,955,102.1,1875,944,931,101.4
11180, 금천구,025002, 21세,2021,2361,1185,1176,100.8,2278,1153,1125,102.5
11180, 금천구,025003, 22세,2021,2521,1225,1296,94.5,2440,1191,1249,95.4
11180, 금천구,025004, 23세,2021,3062,1406,1656,84.9,2955,1363,1592,85.6
11180, 금천구,025005, 24세,2021,3538,1558,1980,78.7,3395,1492,1903,78.4
11180, 금천구,030,25~29세,2021,24017,12115,11902,101.8,22795,11565,11230,103
11180, 금천구,030001, 25세,2021,4140,1910,2230,85.7,3973,1833,2140,85.7
11180, 금천구,030002, 26세,2021,4514,2223,2291,97,4309,2126,2183,97.4
11180, 금천구,030003, 27세,2021,5064,2535,2529,100.2,4827,2446,2381,102.7
11180, 금천구,030004, 28세,2021,5168,2725,2443,111.5,4871,2595,2276,114
11180, 금천구,030005, 29세,2021,5131,2722,2409,113,4815,2565,2250,114
11180, 금천구,035,30~34세,2021,21591,11869,9722,122.1,19251,10655,8596,124
11180, 금천구,035001, 30세,2021,4913,2678,2235,119.8,4522,2472,2050,120.6
11180, 금천구,035002, 31세,2021,4544,2501,2043,122.4,4079,2255,1824,123.6
11180, 금천구,035003, 32세,2021,4217,2369,1848,128.2,3768,2147,1621,132.4
11180, 금천구,035004, 33세,2021,3995,2196,1799,122.1,3514,1953,1561,125.1
11180, 금천구,035005, 34세,2021,3922,2125,1797,118.3,3368,1828,1540,118.7
11180, 금천구,040,35~39세,2021,18155,10148,8007,126.7,15855,8829,7026,125.7
11180, 금천구,040001, 35세,2021,3810,2178,1632,133.5,3283,1886,1397,135
11180, 금천구,040002, 36세,2021,3557,1993,1564,127.4,3086,1712,1374,124.6
11180, 금천구,040003, 37세,2021,3497,1925,1572,122.5,3060,1683,1377,122.2
11180, 금천구,040004, 38세,2021,3593,1982,1611,123,3163,1749,1414,123.7
11180, 금천구,040005, 39세,2021,3698,2070,1628,127.1,3263,1799,1464,122.9
11180, 금천구,045,40~44세,2021,16449,9050,7399,122.3,14652,7964,6688,119.1
11180, 금천구,045001, 40세,2021,3512,1961,1551,126.4,3163,1763,1400,125.9
11180, 금천구,045002, 41세,2021,3570,1969,1601,123,3210,1763,1447,121.8
11180, 금천구,045003, 42세,2021,3354,1821,1533,118.8,2961,1568,1393,112.6
11180, 금천구,045004, 43세,2021,3081,1673,1408,118.8,2690,1429,1261,113.3
11180, 금천구,045005, 44세,2021,2932,1626,1306,124.5,2628,1441,1187,121.4
11180, 금천구,050,45~49세,2021,17975,9426,8549,110.3,15577,7997,7580,105.5
11180, 금천구,050001, 45세,2021,3037,1586,1451,109.3,2649,1346,1303,103.3
11180, 금천구,050002, 46세,2021,3325,1765,1560,113.1,2904,1520,1384,109.8
11180, 금천구,050003, 47세,2021,3643,1943,1700,114.3,3214,1678,1536,109.2
11180, 금천구,050004, 48세,2021,3889,2020,1869,108.1,3304,1672,1632,102.5
11180, 금천구,050005, 49세,2021,4081,2112,1969,107.3,3506,1781,1725,103.2
11180, 금천구,055,50~54세,2021,21930,11069,10861,101.9,18494,9103,9391,96.9
11180, 금천구,055001, 50세,2021,4382,2277,2105,108.2,3658,1865,1793,104
11180, 금천구,055002, 51세,2021,4408,2245,2163,103.8,3713,1838,1875,98
11180, 금천구,055003, 52세,2021,4493,2281,2212,103.1,3756,1871,1885,99.3
11180, 금천구,055004, 53세,2021,4527,2272,2255,100.8,3844,1865,1979,94.2
11180, 금천구,055005, 54세,2021,4120,1994,2126,93.8,3523,1664,1859,89.5
11180, 금천구,060,55~59세,2021,23141,11839,11302,104.8,19114,9576,9538,100.4
11180, 금천구,060001, 55세,2021,4462,2313,2149,107.6,3741,1879,1862,100.9
11180, 금천구,060002, 56세,2021,4645,2354,2291,102.7,3871,1913,1958,97.7
11180, 금천구,060003, 57세,2021,4496,2299,2197,104.6,3681,1848,1833,100.8
11180, 금천구,060004, 58세,2021,4870,2476,2394,103.4,3898,1962,1936,101.3
11180, 금천구,060005, 59세,2021,4668,2397,2271,105.5,3923,1974,1949,101.3
11180, 금천구,065,60~64세,2021,22285,11066,11219,98.6,19363,9569,9794,97.7
11180, 금천구,065001, 60세,2021,4692,2306,2386,96.6,4277,2089,2188,95.5
11180, 금천구,065002, 61세,2021,4980,2525,2455,102.9,4237,2146,2091,102.6
11180, 금천구,065003, 62세,2021,4490,2217,2273,97.5,3941,1921,2020,95.1
11180, 금천구,065004, 63세,2021,4173,2071,2102,98.5,3575,1790,1785,100.3
11180, 금천구,065005, 64세,2021,3950,1947,2003,97.2,3333,1623,1710,94.9
11180, 금천구,070,65~69세,2021,15919,7687,8232,93.4,14191,6791,7400,91.8
11180, 금천구,070001, 65세,2021,3628,1824,1804,101.1,3196,1583,1613,98.1
11180, 금천구,070002, 66세,2021,3679,1741,1938,89.8,3250,1523,1727,88.2
11180, 금천구,070003, 67세,2021,3176,1520,1656,91.8,2821,1328,1493,88.9
11180, 금천구,070004, 68세,2021,2633,1256,1377,91.2,2365,1131,1234,91.7
11180, 금천구,070005, 69세,2021,2803,1346,1457,92.4,2559,1226,1333,92
11180, 금천구,075,70~74세,2021,10927,5175,5752,90,10247,4877,5370,90.8
11180, 금천구,075001, 70세,2021,2131,1049,1082,97,1939,953,986,96.7
11180, 금천구,075002, 71세,2021,2351,1116,1235,90.4,2170,1039,1131,91.9
11180, 금천구,075003, 72세,2021,2229,1045,1184,88.3,2098,982,1116,88
11180, 금천구,075004, 73세,2021,2072,959,1113,86.2,1980,931,1049,88.8
11180, 금천구,075005, 74세,2021,2144,1006,1138,88.4,2060,972,1088,89.3
11180, 금천구,080,75~79세,2021,7599,3448,4151,83.1,7378,3385,3993,84.8
11180, 금천구,080001, 75세,2021,1569,706,863,81.8,1498,686,812,84.5
11180, 금천구,080002, 76세,2021,1565,723,842,85.9,1516,712,804,88.6
11180, 금천구,080003, 77세,2021,1469,645,824,78.3,1435,631,804,78.5
11180, 금천구,080004, 78세,2021,1422,671,751,89.3,1384,660,724,91.2
11180, 금천구,080005, 79세,2021,1574,703,871,80.7,1545,696,849,82
11180, 금천구,085,80~84세,2021,4765,1985,2780,71.4,4607,1963,2644,74.2
11180, 금천구,085001, 80세,2021,1243,530,713,74.3,1200,526,674,78
11180, 금천구,085002, 81세,2021,1060,448,612,73.2,1029,441,588,75
11180, 금천구,085003, 82세,2021,1023,423,600,70.5,989,422,567,74.4
11180, 금천구,085004, 83세,2021,783,324,459,70.6,755,320,435,73.6
11180, 금천구,085005, 84세,2021,656,260,396,65.7,634,254,380,66.8
11180, 금천구,090,85~89세,2021,2128,705,1423,49.5,2063,693,1370,50.6
11180, 금천구,090001, 85세,2021,582,210,372,56.5,561,205,356,57.6
11180, 금천구,090002, 86세,2021,531,178,353,50.4,512,175,337,51.9
11180, 금천구,090003, 87세,2021,431,140,291,48.1,421,137,284,48.2
11180, 금천구,090004, 88세,2021,322,93,229,40.6,314,92,222,41.4
11180, 금천구,090005, 89세,2021,262,84,178,47.2,255,84,171,49.1
11180, 금천구,095,90~94세,2021,704,162,542,29.9,694,162,532,30.5
11180, 금천구,095001, 90세,2021,217,68,149,45.6,216,68,148,45.9
11180, 금천구,095002, 91세,2021,174,39,135,28.9,169,39,130,30
11180, 금천구,095003, 92세,2021,116,23,93,24.7,114,23,91,25.3
11180, 금천구,095004, 93세,2021,111,21,90,23.3,109,21,88,23.9
11180, 금천구,095005, 94세,2021,86,11,75,14.7,86,11,75,14.7
11180, 금천구,100,95~99세,2021,144,33,111,29.7,142,32,110,29.1
11180, 금천구,100001, 95세,2021,39,6,33,18.2,39,6,33,18.2
11180, 금천구,100002, 96세,2021,36,6,30,20,36,6,30,20
11180, 금천구,100003, 97세,2021,28,8,20,40,26,7,19,36.8
11180, 금천구,100004, 98세,2021,23,8,15,53.3,23,8,15,53.3
11180, 금천구,100005, 99세,2021,18,5,13,38.5,18,5,13,38.5
11180, 금천구,101,100세이상,2021,28,8,20,40,27,8,19,42.1
11180, 금천구,102,15세미만,2021,18926,9695,9231,105,17657,9047,8610,105.1
11180, 금천구,103,15~64세,2021,186258,96570,89688,107.7,165185,84956,80229,105.9
11180, 금천구,104,65세이상,2021,42214,19203,23011,83.5,39349,17911,21438,83.5
11180, 금천구,086,85세이상,2021,3004,908,2096,43.3,2926,895,2031,44.1
11180, 금천구,126,평균연령,2021,45.1,44.4,45.9,,44.8,44,45.6,
11180, 금천구,127,중위연령,2021,46.2,44.9,47.6,,45.3,43.7,46.9,
11190, 영등포구,000,합계,2021,402984,200027,202957,98.6,359642,176870,182772,96.8
11190, 영등포구,005,0~4세,2021,12593,6469,6124,105.6,11826,6093,5733,106.3
11190, 영등포구,005001, 0세,2021,2412,1264,1148,110.1,2311,1215,1096,110.9
11190, 영등포구,005002, 1세,2021,2384,1227,1157,106.1,2235,1154,1081,106.8
11190, 영등포구,005003, 2세,2021,2557,1302,1255,103.7,2387,1218,1169,104.2
11190, 영등포구,005004, 3세,2021,2639,1337,1302,102.7,2463,1247,1216,102.5
11190, 영등포구,005005, 4세,2021,2601,1339,1262,106.1,2430,1259,1171,107.5
11190, 영등포구,010,5~9세,2021,13197,6748,6449,104.6,12383,6319,6064,104.2
11190, 영등포구,010001, 5세,2021,2881,1436,1445,99.4,2682,1329,1353,98.2
11190, 영등포구,010002, 6세,2021,2774,1430,1344,106.4,2595,1331,1264,105.3
11190, 영등포구,010003, 7세,2021,2534,1325,1209,109.6,2382,1248,1134,110.1
11190, 영등포구,010004, 8세,2021,2428,1261,1167,108.1,2287,1186,1101,107.7
11190, 영등포구,010005, 9세,2021,2580,1296,1284,100.9,2437,1225,1212,101.1
11190, 영등포구,015,10~14세,2021,11180,5725,5455,104.9,10678,5462,5216,104.7
11190, 영등포구,015001, 10세,2021,2343,1166,1177,99.1,2239,1111,1128,98.5
11190, 영등포구,015002, 11세,2021,2195,1082,1113,97.2,2101,1030,1071,96.2
11190, 영등포구,015003, 12세,2021,2078,1092,986,110.8,1974,1039,935,111.1
11190, 영등포구,015004, 13세,2021,2305,1206,1099,109.7,2194,1147,1047,109.6
11190, 영등포구,015005, 14세,2021,2259,1179,1080,109.2,2170,1135,1035,109.7
11190, 영등포구,020,15~19세,2021,11544,6112,5432,112.5,11136,5914,5222,113.3
11190, 영등포구,020001, 15세,2021,2165,1173,992,118.2,2079,1126,953,118.2
11190, 영등포구,020002, 16세,2021,2126,1119,1007,111.1,2048,1082,966,112
11190, 영등포구,020003, 17세,2021,2362,1264,1098,115.1,2287,1220,1067,114.3
11190, 영등포구,020004, 18세,2021,2378,1282,1096,117,2303,1246,1057,117.9
11190, 영등포구,020005, 19세,2021,2513,1274,1239,102.8,2419,1240,1179,105.2
11190, 영등포구,025,20~24세,2021,20657,9408,11249,83.6,19760,9039,10721,84.3
11190, 영등포구,025001, 20세,2021,3215,1580,1635,96.6,3089,1526,1563,97.6
11190, 영등포구,025002, 21세,2021,3550,1696,1854,91.5,3424,1642,1782,92.1
11190, 영등포구,025003, 22세,2021,3928,1869,2059,90.8,3785,1810,1975,91.6
11190, 영등포구,025004, 23세,2021,4671,2031,2640,76.9,4426,1933,2493,77.5
11190, 영등포구,025005, 24세,2021,5293,2232,3061,72.9,5036,2128,2908,73.2
11190, 영등포구,030,25~29세,2021,37904,17640,20264,87.1,35825,16665,19160,87
11190, 영등포구,030001, 25세,2021,6259,2660,3599,73.9,5952,2529,3423,73.9
11190, 영등포구,030002, 26세,2021,6972,3133,3839,81.6,6617,2989,3628,82.4
11190, 영등포구,030003, 27세,2021,7690,3667,4023,91.2,7288,3476,3812,91.2
11190, 영등포구,030004, 28세,2021,8258,3936,4322,91.1,7743,3696,4047,91.3
11190, 영등포구,030005, 29세,2021,8725,4244,4481,94.7,8225,3975,4250,93.5
11190, 영등포구,035,30~34세,2021,39283,19936,19347,103,35419,17812,17607,101.2
11190, 영등포구,035001, 30세,2021,8495,4190,4305,97.3,7874,3856,4018,96
11190, 영등포구,035002, 31세,2021,7955,4008,3947,101.5,7218,3611,3607,100.1
11190, 영등포구,035003, 32세,2021,7739,3994,3745,106.6,6993,3596,3397,105.9
11190, 영등포구,035004, 33세,2021,7640,3973,3667,108.3,6841,3525,3316,106.3
11190, 영등포구,035005, 34세,2021,7454,3771,3683,102.4,6493,3224,3269,98.6
11190, 영등포구,040,35~39세,2021,34904,18435,16469,111.9,31177,16246,14931,108.8
11190, 영등포구,040001, 35세,2021,7182,3803,3379,112.5,6332,3304,3028,109.1
11190, 영등포구,040002, 36세,2021,6975,3682,3293,111.8,6248,3261,2987,109.2
11190, 영등포구,040003, 37세,2021,6722,3567,3155,113.1,6020,3155,2865,110.1
11190, 영등포구,040004, 38세,2021,6843,3614,3229,111.9,6140,3191,2949,108.2
11190, 영등포구,040005, 39세,2021,7182,3769,3413,110.4,6437,3335,3102,107.5
11190, 영등포구,045,40~44세,2021,30057,15973,14084,113.4,26830,13966,12864,108.6
11190, 영등포구,045001, 40세,2021,6658,3573,3085,115.8,6029,3198,2831,113
11190, 영등포구,045002, 41세,2021,6449,3395,3054,111.2,5827,3015,2812,107.2
11190, 영등포구,045003, 42세,2021,6092,3278,2814,116.5,5407,2841,2566,110.7
11190, 영등포구,045004, 43세,2021,5339,2825,2514,112.4,4647,2393,2254,106.2
11190, 영등포구,045005, 44세,2021,5519,2902,2617,110.9,4920,2519,2401,104.9
11190, 영등포구,050,45~49세,2021,29216,15347,13869,110.7,25405,13015,12390,105
11190, 영등포구,050001, 45세,2021,5447,2888,2559,112.9,4799,2488,2311,107.7
11190, 영등포구,050002, 46세,2021,5319,2803,2516,111.4,4734,2441,2293,106.5
11190, 영등포구,050003, 47세,2021,5960,3142,2818,111.5,5228,2695,2533,106.4
11190, 영등포구,050004, 48세,2021,6202,3248,2954,110,5282,2668,2614,102.1
11190, 영등포구,050005, 49세,2021,6288,3266,3022,108.1,5362,2723,2639,103.2
11190, 영등포구,055,50~54세,2021,33153,16839,16314,103.2,27514,13732,13782,99.6
11190, 영등포구,055001, 50세,2021,6858,3495,3363,103.9,5770,2890,2880,100.3
11190, 영등포구,055002, 51세,2021,6705,3471,3234,107.3,5520,2822,2698,104.6
11190, 영등포구,055003, 52세,2021,6780,3369,3411,98.8,5638,2756,2882,95.6
11190, 영등포구,055004, 53세,2021,6681,3462,3219,107.5,5476,2763,2713,101.8
11190, 영등포구,055005, 54세,2021,6129,3042,3087,98.5,5110,2501,2609,95.9
11190, 영등포구,060,55~59세,2021,32937,16791,16146,104,25721,13031,12690,102.7
11190, 영등포구,060001, 55세,2021,6279,3202,3077,104.1,5060,2568,2492,103
11190, 영등포구,060002, 56세,2021,6507,3289,3218,102.2,5158,2582,2576,100.2
11190, 영등포구,060003, 57세,2021,6596,3352,3244,103.3,5122,2582,2540,101.7
11190, 영등포구,060004, 58세,2021,6984,3638,3346,108.7,5154,2661,2493,106.7
11190, 영등포구,060005, 59세,2021,6571,3310,3261,101.5,5227,2638,2589,101.9
11190, 영등포구,065,60~64세,2021,31756,15571,16185,96.2,26404,12820,13584,94.4
11190, 영등포구,065001, 60세,2021,6461,3110,3351,92.8,5648,2713,2935,92.4
11190, 영등포구,065002, 61세,2021,6963,3351,3612,92.8,5700,2725,2975,91.6
11190, 영등포구,065003, 62세,2021,6295,3105,3190,97.3,5211,2538,2673,94.9
11190, 영등포구,065004, 63세,2021,6035,3038,2997,101.4,4956,2457,2499,98.3
11190, 영등포구,065005, 64세,2021,6002,2967,3035,97.8,4889,2387,2502,95.4
11190, 영등포구,070,65~69세,2021,23435,11296,12139,93.1,20214,9647,10567,91.3
11190, 영등포구,070001, 65세,2021,5343,2673,2670,100.1,4422,2183,2239,97.5
11190, 영등포구,070002, 66세,2021,5489,2635,2854,92.3,4729,2234,2495,89.5
11190, 영등포구,070003, 67세,2021,4526,2154,2372,90.8,3888,1831,2057,89
11190, 영등포구,070004, 68세,2021,3909,1856,2053,90.4,3400,1601,1799,89
11190, 영등포구,070005, 69세,2021,4168,1978,2190,90.3,3775,1798,1977,90.9
11190, 영등포구,075,70~74세,2021,16023,7439,8584,86.7,15018,7003,8015,87.4
11190, 영등포구,075001, 70세,2021,3088,1455,1633,89.1,2778,1313,1465,89.6
11190, 영등포구,075002, 71세,2021,3401,1526,1875,81.4,3154,1412,1742,81.1
11190, 영등포구,075003, 72세,2021,3361,1585,1776,89.2,3132,1486,1646,90.3
11190, 영등포구,075004, 73세,2021,3087,1456,1631,89.3,2970,1408,1562,90.1
11190, 영등포구,075005, 74세,2021,3086,1417,1669,84.9,2984,1384,1600,86.5
11190, 영등포구,080,75~79세,2021,11668,5173,6495,79.6,11306,5067,6239,81.2
11190, 영등포구,080001, 75세,2021,2454,1131,1323,85.5,2358,1096,1262,86.8
11190, 영등포구,080002, 76세,2021,2248,1028,1220,84.3,2161,1001,1160,86.3
11190, 영등포구,080003, 77세,2021,2204,950,1254,75.8,2146,933,1213,76.9
11190, 영등포구,080004, 78세,2021,2215,953,1262,75.5,2159,938,1221,76.8
11190, 영등포구,080005, 79세,2021,2547,1111,1436,77.4,2482,1099,1383,79.5
11190, 영등포구,085,80~84세,2021,7998,3304,4694,70.4,7711,3249,4462,72.8
11190, 영등포구,085001, 80세,2021,1942,831,1111,74.8,1871,818,1053,77.7
11190, 영등포구,085002, 81세,2021,1712,707,1005,70.3,1646,691,955,72.4
11190, 영등포구,085003, 82세,2021,1638,688,950,72.4,1575,678,897,75.6
11190, 영등포구,085004, 83세,2021,1417,566,851,66.5,1364,558,806,69.2
11190, 영등포구,085005, 84세,2021,1289,512,777,65.9,1255,504,751,67.1
11190, 영등포구,090,85~89세,2021,3961,1426,2535,56.3,3833,1401,2432,57.6
11190, 영등포구,090001, 85세,2021,1089,434,655,66.3,1053,428,625,68.5
11190, 영등포구,090002, 86세,2021,985,381,604,63.1,953,374,579,64.6
11190, 영등포구,090003, 87세,2021,781,262,519,50.5,761,260,501,51.9
11190, 영등포구,090004, 88세,2021,626,191,435,43.9,602,185,417,44.4
11190, 영등포구,090005, 89세,2021,480,158,322,49.1,464,154,310,49.7
11190, 영등포구,095,90~94세,2021,1225,328,897,36.6,1197,323,874,37
11190, 영등포구,095001, 90세,2021,360,106,254,41.7,352,104,248,41.9
11190, 영등포구,095002, 91세,2021,317,80,237,33.8,308,79,229,34.5
11190, 영등포구,095003, 92세,2021,235,65,170,38.2,231,65,166,39.2
11190, 영등포구,095004, 93세,2021,183,48,135,35.6,180,47,133,35.3
11190, 영등포구,095005, 94세,2021,130,29,101,28.7,126,28,98,28.6
11190, 영등포구,100,95~99세,2021,254,57,197,28.9,247,56,191,29.3
11190, 영등포구,100001, 95세,2021,75,20,55,36.4,74,20,54,37
11190, 영등포구,100002, 96세,2021,59,10,49,20.4,57,10,47,21.3
11190, 영등포구,100003, 97세,2021,46,9,37,24.3,45,9,36,25
11190, 영등포구,100004, 98세,2021,52,11,41,26.8,50,10,40,25
11190, 영등포구,100005, 99세,2021,22,7,15,46.7,21,7,14,50
11190, 영등포구,101,100세이상,2021,39,10,29,34.5,38,10,28,35.7
11190, 영등포구,102,15세미만,2021,36970,18942,18028,105.1,34887,17874,17013,105.1
11190, 영등포구,103,15~64세,2021,301411,152052,149359,101.8,265191,132240,132951,99.5
11190, 영등포구,104,65세이상,2021,64603,29033,35570,81.6,59564,26756,32808,81.6
11190, 영등포구,086,85세이상,2021,5479,1821,3658,49.8,5315,1790,3525,50.8
11190, 영등포구,126,평균연령,2021,43.8,43.2,44.3,,43.3,42.7,43.8,
11190, 영등포구,127,중위연령,2021,43.2,42.8,43.7,,42,41.6,42.4,
11200, 동작구,000,합계,2021,388094,187311,200783,93.3,373671,180871,192800,93.8
11200, 동작구,005,0~4세,2021,9997,5130,4867,105.4,9827,5049,4778,105.7
11200, 동작구,005001, 0세,2021,1837,962,875,109.9,1805,950,855,111.1
11200, 동작구,005002, 1세,2021,1845,947,898,105.5,1813,933,880,106
11200, 동작구,005003, 2세,2021,1990,1070,920,116.3,1954,1052,902,116.6
11200, 동작구,005004, 3세,2021,2084,1048,1036,101.2,2048,1027,1021,100.6
11200, 동작구,005005, 4세,2021,2241,1103,1138,96.9,2207,1087,1120,97.1
11200, 동작구,010,5~9세,2021,12584,6422,6162,104.2,12424,6337,6087,104.1
11200, 동작구,010001, 5세,2021,2515,1282,1233,104,2472,1254,1218,103
11200, 동작구,010002, 6세,2021,2634,1324,1310,101.1,2605,1312,1293,101.5
11200, 동작구,010003, 7세,2021,2436,1258,1178,106.8,2406,1238,1168,106
11200, 동작구,010004, 8세,2021,2476,1261,1215,103.8,2443,1247,1196,104.3
11200, 동작구,010005, 9세,2021,2523,1297,1226,105.8,2498,1286,1212,106.1
11200, 동작구,015,10~14세,2021,12243,6345,5898,107.6,12145,6298,5847,107.7
11200, 동작구,015001, 10세,2021,2532,1247,1285,97,2501,1232,1269,97.1
11200, 동작구,015002, 11세,2021,2434,1293,1141,113.3,2415,1284,1131,113.5
11200, 동작구,015003, 12세,2021,2340,1198,1142,104.9,2325,1190,1135,104.8
11200, 동작구,015004, 13세,2021,2422,1269,1153,110.1,2400,1259,1141,110.3
11200, 동작구,015005, 14세,2021,2515,1338,1177,113.7,2504,1333,1171,113.8
11200, 동작구,020,15~19세,2021,14687,7319,7368,99.3,14375,7226,7149,101.1
11200, 동작구,020001, 15세,2021,2336,1184,1152,102.8,2318,1173,1145,102.4
11200, 동작구,020002, 16세,2021,2440,1242,1198,103.7,2427,1236,1191,103.8
11200, 동작구,020003, 17세,2021,2594,1350,1244,108.5,2577,1343,1234,108.8
11200, 동작구,020004, 18세,2021,2977,1471,1506,97.7,2908,1453,1455,99.9
11200, 동작구,020005, 19세,2021,4340,2072,2268,91.4,4145,2021,2124,95.2
11200, 동작구,025,20~24세,2021,30672,14008,16664,84.1,28694,13396,15298,87.6
11200, 동작구,025001, 20세,2021,5001,2256,2745,82.2,4669,2173,2496,87.1
11200, 동작구,025002, 21세,2021,5475,2414,3061,78.9,5086,2286,2800,81.6
11200, 동작구,025003, 22세,2021,5891,2733,3158,86.5,5534,2632,2902,90.7
11200, 동작구,025004, 23세,2021,6984,3196,3788,84.4,6529,3049,3480,87.6
11200, 동작구,025005, 24세,2021,7321,3409,3912,87.1,6876,3256,3620,89.9
11200, 동작구,030,25~29세,2021,39430,19470,19960,97.5,37754,18833,18921,99.5
11200, 동작구,030001, 25세,2021,7819,3741,4078,91.7,7390,3594,3796,94.7
11200, 동작구,030002, 26세,2021,7865,3927,3938,99.7,7489,3783,3706,102.1
11200, 동작구,030003, 27세,2021,8065,4051,4014,100.9,7757,3929,3828,102.6
11200, 동작구,030004, 28세,2021,7889,3821,4068,93.9,7596,3715,3881,95.7
11200, 동작구,030005, 29세,2021,7792,3930,3862,101.8,7522,3812,3710,102.7
11200, 동작구,035,30~34세,2021,32154,16268,15886,102.4,30744,15578,15166,102.7
11200, 동작구,035001, 30세,2021,7271,3647,3624,100.6,6995,3521,3474,101.4
11200, 동작구,035002, 31세,2021,6774,3437,3337,103,6481,3296,3185,103.5
11200, 동작구,035003, 32세,2021,6198,3149,3049,103.3,5919,3010,2909,103.5
11200, 동작구,035004, 33세,2021,6065,3042,3023,100.6,5787,2908,2879,101
11200, 동작구,035005, 34세,2021,5846,2993,2853,104.9,5562,2843,2719,104.6
11200, 동작구,040,35~39세,2021,28632,14514,14118,102.8,27428,13880,13548,102.5
11200, 동작구,040001, 35세,2021,5612,2819,2793,100.9,5338,2672,2666,100.2
11200, 동작구,040002, 36세,2021,5553,2839,2714,104.6,5323,2712,2611,103.9
11200, 동작구,040003, 37세,2021,5486,2797,2689,104,5252,2680,2572,104.2
11200, 동작구,040004, 38세,2021,5915,2963,2952,100.4,5665,2832,2833,100
11200, 동작구,040005, 39세,2021,6066,3096,2970,104.2,5850,2984,2866,104.1
11200, 동작구,045,40~44세,2021,27861,14149,13712,103.2,26911,13635,13276,102.7
11200, 동작구,045001, 40세,2021,5881,3075,2806,109.6,5696,2976,2720,109.4
11200, 동작구,045002, 41세,2021,6021,3049,2972,102.6,5841,2950,2891,102
11200, 동작구,045003, 42세,2021,5662,2905,2757,105.4,5452,2775,2677,103.7
11200, 동작구,045004, 43세,2021,5113,2532,2581,98.1,4924,2432,2492,97.6
11200, 동작구,045005, 44세,2021,5184,2588,2596,99.7,4998,2502,2496,100.2
11200, 동작구,050,45~49세,2021,27995,14065,13930,101,27029,13538,13491,100.3
11200, 동작구,050001, 45세,2021,5208,2630,2578,102,5035,2535,2500,101.4
11200, 동작구,050002, 46세,2021,5329,2675,2654,100.8,5154,2573,2581,99.7
11200, 동작구,050003, 47세,2021,5763,2953,2810,105.1,5583,2856,2727,104.7
11200, 동작구,050004, 48세,2021,5772,2801,2971,94.3,5570,2703,2867,94.3
11200, 동작구,050005, 49세,2021,5923,3006,2917,103.1,5687,2871,2816,102
11200, 동작구,055,50~54세,2021,30290,14487,15803,91.7,28961,13851,15110,91.7
11200, 동작구,055001, 50세,2021,6363,3098,3265,94.9,6096,2950,3146,93.8
11200, 동작구,055002, 51세,2021,6126,2983,3143,94.9,5857,2857,3000,95.2
11200, 동작구,055003, 52세,2021,6230,3000,3230,92.9,5938,2850,3088,92.3
11200, 동작구,055004, 53세,2021,6042,2844,3198,88.9,5758,2722,3036,89.7
11200, 동작구,055005, 54세,2021,5529,2562,2967,86.3,5312,2472,2840,87
11200, 동작구,060,55~59세,2021,27837,13313,14524,91.7,26224,12555,13669,91.9
11200, 동작구,060001, 55세,2021,5347,2579,2768,93.2,5065,2455,2610,94.1
11200, 동작구,060002, 56세,2021,5533,2602,2931,88.8,5241,2463,2778,88.7
11200, 동작구,060003, 57세,2021,5518,2677,2841,94.2,5201,2513,2688,93.5
11200, 동작구,060004, 58세,2021,5800,2778,3022,91.9,5384,2588,2796,92.6
11200, 동작구,060005, 59세,2021,5639,2677,2962,90.4,5333,2536,2797,90.7
11200, 동작구,065,60~64세,2021,28769,13275,15494,85.7,27438,12657,14781,85.6
11200, 동작구,065001, 60세,2021,5975,2742,3233,84.8,5790,2659,3131,84.9
11200, 동작구,065002, 61세,2021,6289,2927,3362,87.1,5959,2766,3193,86.6
11200, 동작구,065003, 62세,2021,5639,2609,3030,86.1,5377,2501,2876,87
11200, 동작구,065004, 63세,2021,5461,2471,2990,82.6,5179,2340,2839,82.4
11200, 동작구,065005, 64세,2021,5405,2526,2879,87.7,5133,2391,2742,87.2
11200, 동작구,070,65~69세,2021,22410,10320,12090,85.4,21632,9957,11675,85.3
11200, 동작구,070001, 65세,2021,4920,2272,2648,85.8,4727,2180,2547,85.6
11200, 동작구,070002, 66세,2021,5201,2387,2814,84.8,5012,2300,2712,84.8
11200, 동작구,070003, 67세,2021,4242,1967,2275,86.5,4096,1896,2200,86.2
11200, 동작구,070004, 68세,2021,3903,1810,2093,86.5,3769,1753,2016,87
11200, 동작구,070005, 69세,2021,4144,1884,2260,83.4,4028,1828,2200,83.1
11200, 동작구,075,70~74세,2021,16651,7331,9320,78.7,16388,7230,9158,78.9
11200, 동작구,075001, 70세,2021,3140,1378,1762,78.2,3069,1349,1720,78.4
11200, 동작구,075002, 71세,2021,3397,1534,1863,82.3,3321,1504,1817,82.8
11200, 동작구,075003, 72세,2021,3403,1443,1960,73.6,3341,1420,1921,73.9
11200, 동작구,075004, 73세,2021,3354,1494,1860,80.3,3323,1481,1842,80.4
11200, 동작구,075005, 74세,2021,3357,1482,1875,79,3334,1476,1858,79.4
11200, 동작구,080,75~79세,2021,12523,5618,6905,81.4,12436,5588,6848,81.6
11200, 동작구,080001, 75세,2021,2694,1129,1565,72.1,2677,1122,1555,72.2
11200, 동작구,080002, 76세,2021,2431,1050,1381,76,2413,1043,1370,76.1
11200, 동작구,080003, 77세,2021,2396,1082,1314,82.3,2378,1075,1303,82.5
11200, 동작구,080004, 78세,2021,2346,1099,1247,88.1,2328,1094,1234,88.7
11200, 동작구,080005, 79세,2021,2656,1258,1398,90,2640,1254,1386,90.5
11200, 동작구,085,80~84세,2021,8157,3526,4631,76.1,8102,3517,4585,76.7
11200, 동작구,085001, 80세,2021,2035,917,1118,82,2022,916,1106,82.8
11200, 동작구,085002, 81세,2021,1815,798,1017,78.5,1803,797,1006,79.2
11200, 동작구,085003, 82세,2021,1675,727,948,76.7,1668,725,943,76.9
11200, 동작구,085004, 83세,2021,1379,597,782,76.3,1370,595,775,76.8
11200, 동작구,085005, 84세,2021,1253,487,766,63.6,1239,484,755,64.1
11200, 동작구,090,85~89세,2021,3690,1337,2353,56.8,3658,1334,2324,57.4
11200, 동작구,090001, 85세,2021,1054,415,639,64.9,1043,414,629,65.8
11200, 동작구,090002, 86세,2021,875,318,557,57.1,869,318,551,57.7
11200, 동작구,090003, 87세,2021,744,272,472,57.6,739,270,469,57.6
11200, 동작구,090004, 88세,2021,564,185,379,48.8,558,185,373,49.6
11200, 동작구,090005, 89세,2021,453,147,306,48,449,147,302,48.7
11200, 동작구,095,90~94세,2021,1205,334,871,38.3,1196,333,863,38.6
11200, 동작구,095001, 90세,2021,344,108,236,45.8,342,108,234,46.2
11200, 동작구,095002, 91세,2021,308,80,228,35.1,305,79,226,35
11200, 동작구,095003, 92세,2021,247,73,174,42,246,73,173,42.2
11200, 동작구,095004, 93세,2021,171,46,125,36.8,170,46,124,37.1
11200, 동작구,095005, 94세,2021,135,27,108,25,133,27,106,25.5
11200, 동작구,100,95~99세,2021,265,68,197,34.5,265,68,197,34.5
11200, 동작구,100001, 95세,2021,91,24,67,35.8,91,24,67,35.8
11200, 동작구,100002, 96세,2021,59,13,46,28.3,59,13,46,28.3
11200, 동작구,100003, 97세,2021,52,16,36,44.4,52,16,36,44.4
11200, 동작구,100004, 98세,2021,39,13,26,50,39,13,26,50
11200, 동작구,100005, 99세,2021,24,X,22,9.1,24,X,22,9.1
11200, 동작구,101,100세이상,2021,42,12,30,40,40,11,29,37.9
11200, 동작구,102,15세미만,2021,34824,17897,16927,105.7,34396,17684,16712,105.8
11200, 동작구,103,15~64세,2021,288327,140868,147459,95.5,275558,135149,140409,96.3
11200, 동작구,104,65세이상,2021,64943,28546,36397,78.4,63717,28038,35679,78.6
11200, 동작구,086,85세이상,2021,5202,1751,3451,50.7,5159,1746,3413,51.2
11200, 동작구,126,평균연령,2021,43.2,42.3,44,,43.2,42.3,44.1,
11200, 동작구,127,중위연령,2021,42.3,41.4,43.4,,42.3,41.3,43.5,
11210, 관악구,000,합계,2021,495777,247814,247963,99.9,473263,237734,235529,100.9
11210, 관악구,005,0~4세,2021,8934,4565,4369,104.5,8597,4398,4199,104.7
11210, 관악구,005001, 0세,2021,1651,829,822,100.9,1607,809,798,101.4
11210, 관악구,005002, 1세,2021,1715,856,859,99.7,1662,829,833,99.5
11210, 관악구,005003, 2세,2021,1762,887,875,101.4,1696,855,841,101.7
11210, 관악구,005004, 3세,2021,1794,960,834,115.1,1706,913,793,115.1
11210, 관악구,005005, 4세,2021,2012,1033,979,105.5,1926,992,934,106.2
11210, 관악구,010,5~9세,2021,11257,5813,5444,106.8,10926,5642,5284,106.8
11210, 관악구,010001, 5세,2021,2155,1117,1038,107.6,2070,1069,1001,106.8
11210, 관악구,010002, 6세,2021,2307,1195,1112,107.5,2238,1161,1077,107.8
11210, 관악구,010003, 7세,2021,2186,1143,1043,109.6,2138,1118,1020,109.6
11210, 관악구,010004, 8세,2021,2246,1127,1119,100.7,2172,1097,1075,102
11210, 관악구,010005, 9세,2021,2363,1231,1132,108.7,2308,1197,1111,107.7
11210, 관악구,015,10~14세,2021,11860,6079,5781,105.2,11659,5979,5680,105.3
11210, 관악구,015001, 10세,2021,2421,1233,1188,103.8,2384,1214,1170,103.8
11210, 관악구,015002, 11세,2021,2309,1172,1137,103.1,2265,1150,1115,103.1
11210, 관악구,015003, 12세,2021,2182,1145,1037,110.4,2140,1127,1013,111.3
11210, 관악구,015004, 13세,2021,2402,1233,1169,105.5,2364,1211,1153,105
11210, 관악구,015005, 14세,2021,2546,1296,1250,103.7,2506,1277,1229,103.9
11210, 관악구,020,15~19세,2021,15735,8114,7621,106.5,15357,7997,7360,108.7
11210, 관악구,020001, 15세,2021,2398,1254,1144,109.6,2359,1240,1119,110.8
11210, 관악구,020002, 16세,2021,2443,1211,1232,98.3,2412,1198,1214,98.7
11210, 관악구,020003, 17세,2021,2715,1379,1336,103.2,2673,1364,1309,104.2
11210, 관악구,020004, 18세,2021,3230,1659,1571,105.6,3158,1641,1517,108.2
11210, 관악구,020005, 19세,2021,4949,2611,2338,111.7,4755,2554,2201,116
11210, 관악구,025,20~24세,2021,40382,17824,22558,79,38547,17224,21323,80.8
11210, 관악구,025001, 20세,2021,5372,2539,2833,89.6,5127,2454,2673,91.8
11210, 관악구,025002, 21세,2021,6570,2988,3582,83.4,6228,2874,3354,85.7
11210, 관악구,025003, 22세,2021,7440,3258,4182,77.9,7074,3124,3950,79.1
11210, 관악구,025004, 23세,2021,9621,4160,5461,76.2,9199,4035,5164,78.1
11210, 관악구,025005, 24세,2021,11379,4879,6500,75.1,10919,4737,6182,76.6
11210, 관악구,030,25~29세,2021,72474,36632,35842,102.2,69735,35652,34083,104.6
11210, 관악구,030001, 25세,2021,13566,6121,7445,82.2,13031,5958,7073,84.2
11210, 관악구,030002, 26세,2021,14318,6987,7331,95.3,13780,6813,6967,97.8
11210, 관악구,030003, 27세,2021,15402,7954,7448,106.8,14790,7734,7056,109.6
11210, 관악구,030004, 28세,2021,14878,7906,6972,113.4,14344,7691,6653,115.6
11210, 관악구,030005, 29세,2021,14310,7664,6646,115.3,13790,7456,6334,117.7
11210, 관악구,035,30~34세,2021,51210,28310,22900,123.6,48590,27120,21470,126.3
11210, 관악구,035001, 30세,2021,12744,7041,5703,123.5,12207,6829,5378,127
11210, 관악구,035002, 31세,2021,11217,6133,5084,120.6,10639,5868,4771,123
11210, 관악구,035003, 32세,2021,10088,5579,4509,123.7,9540,5344,4196,127.4
11210, 관악구,035004, 33세,2021,8965,4983,3982,125.1,8489,4764,3725,127.9
11210, 관악구,035005, 34세,2021,8196,4574,3622,126.3,7715,4315,3400,126.9
11210, 관악구,040,35~39세,2021,36408,19937,16471,121,34407,18906,15501,122
11210, 관악구,040001, 35세,2021,7600,4166,3434,121.3,7130,3936,3194,123.2
11210, 관악구,040002, 36세,2021,7155,3908,3247,120.4,6761,3711,3050,121.7
11210, 관악구,040003, 37세,2021,6972,3815,3157,120.8,6571,3605,2966,121.5
11210, 관악구,040004, 38세,2021,7126,3930,3196,123,6765,3731,3034,123
11210, 관악구,040005, 39세,2021,7555,4118,3437,119.8,7180,3923,3257,120.4
11210, 관악구,045,40~44세,2021,32640,17592,15048,116.9,31229,16851,14378,117.2
11210, 관악구,045001, 40세,2021,7133,3921,3212,122.1,6843,3760,3083,122
11210, 관악구,045002, 41세,2021,7198,3914,3284,119.2,6913,3767,3146,119.7
11210, 관악구,045003, 42세,2021,6485,3518,2967,118.6,6177,3352,2825,118.7
11210, 관악구,045004, 43세,2021,5855,3069,2786,110.2,5593,2945,2648,111.2
11210, 관악구,045005, 44세,2021,5969,3170,2799,113.3,5703,3027,2676,113.1
11210, 관악구,050,45~49세,2021,32681,17428,15253,114.3,31042,16590,14452,114.8
11210, 관악구,050001, 45세,2021,5846,3193,2653,120.4,5572,3059,2513,121.7
11210, 관악구,050002, 46세,2021,6181,3291,2890,113.9,5899,3133,2766,113.3
11210, 관악구,050003, 47세,2021,6721,3546,3175,111.7,6419,3394,3025,112.2
11210, 관악구,050004, 48세,2021,6866,3685,3181,115.8,6508,3503,3005,116.6
11210, 관악구,050005, 49세,2021,7067,3713,3354,110.7,6644,3501,3143,111.4
11210, 관악구,055,50~54세,2021,35112,17564,17548,100.1,32874,16503,16371,100.8
11210, 관악구,055001, 50세,2021,7464,3860,3604,107.1,7045,3671,3374,108.8
11210, 관악구,055002, 51세,2021,7098,3670,3428,107.1,6613,3439,3174,108.3
11210, 관악구,055003, 52세,2021,7084,3531,3553,99.4,6633,3301,3332,99.1
11210, 관악구,055004, 53세,2021,6970,3410,3560,95.8,6504,3180,3324,95.7
11210, 관악구,055005, 54세,2021,6496,3093,3403,90.9,6079,2912,3167,91.9
11210, 관악구,060,55~59세,2021,33564,16673,16891,98.7,30775,15370,15405,99.8
11210, 관악구,060001, 55세,2021,6391,3301,3090,106.8,5921,3070,2851,107.7
11210, 관악구,060002, 56세,2021,6871,3354,3517,95.4,6322,3119,3203,97.4
11210, 관악구,060003, 57세,2021,6436,3193,3243,98.5,5869,2931,2938,99.8
11210, 관악구,060004, 58세,2021,6902,3425,3477,98.5,6224,3093,3131,98.8
11210, 관악구,060005, 59세,2021,6964,3400,3564,95.4,6439,3157,3282,96.2
11210, 관악구,065,60~64세,2021,34334,16107,18227,88.4,32332,15143,17189,88.1
11210, 관악구,065001, 60세,2021,7124,3405,3719,91.6,6798,3250,3548,91.6
11210, 관악구,065002, 61세,2021,7594,3522,4072,86.5,7104,3296,3808,86.6
11210, 관악구,065003, 62세,2021,6817,3177,3640,87.3,6441,2980,3461,86.1
11210, 관악구,065004, 63세,2021,6410,3053,3357,90.9,6025,2881,3144,91.6
11210, 관악구,065005, 64세,2021,6389,2950,3439,85.8,5964,2736,3228,84.8
11210, 관악구,070,65~69세,2021,27421,12504,14917,83.8,26216,11970,14246,84
11210, 관악구,070001, 65세,2021,5980,2727,3253,83.8,5672,2606,3066,85
11210, 관악구,070002, 66세,2021,6237,2857,3380,84.5,5943,2717,3226,84.2
11210, 관악구,070003, 67세,2021,5342,2443,2899,84.3,5082,2332,2750,84.8
11210, 관악구,070004, 68세,2021,4626,2039,2587,78.8,4440,1949,2491,78.2
11210, 관악구,070005, 69세,2021,5236,2438,2798,87.1,5079,2366,2713,87.2
11210, 관악구,075,70~74세,2021,20969,9560,11409,83.8,20546,9368,11178,83.8
11210, 관악구,075001, 70세,2021,3954,1798,2156,83.4,3810,1723,2087,82.6
11210, 관악구,075002, 71세,2021,4323,2067,2256,91.6,4237,2022,2215,91.3
11210, 관악구,075003, 72세,2021,4391,1997,2394,83.4,4302,1963,2339,83.9
11210, 관악구,075004, 73세,2021,4156,1847,2309,80,4095,1823,2272,80.2
11210, 관악구,075005, 74세,2021,4145,1851,2294,80.7,4102,1837,2265,81.1
11210, 관악구,080,75~79세,2021,15682,7061,8621,81.9,15510,7015,8495,82.6
11210, 관악구,080001, 75세,2021,3191,1407,1784,78.9,3143,1392,1751,79.5
11210, 관악구,080002, 76세,2021,3091,1402,1689,83,3051,1390,1661,83.7
11210, 관악구,080003, 77세,2021,3017,1350,1667,81,2989,1344,1645,81.7
11210, 관악구,080004, 78세,2021,3018,1366,1652,82.7,2988,1359,1629,83.4
11210, 관악구,080005, 79세,2021,3365,1536,1829,84,3339,1530,1809,84.6
11210, 관악구,085,80~84세,2021,9682,4258,5424,78.5,9552,4224,5328,79.3
11210, 관악구,085001, 80세,2021,2551,1175,1376,85.4,2528,1169,1359,86
11210, 관악구,085002, 81세,2021,2143,939,1204,78,2106,930,1176,79.1
11210, 관악구,085003, 82세,2021,1991,903,1088,83,1961,896,1065,84.1
11210, 관악구,085004, 83세,2021,1642,698,944,73.9,1623,694,929,74.7
11210, 관악구,085005, 84세,2021,1355,543,812,66.9,1334,535,799,67
11210, 관악구,090,85~89세,2021,3923,1446,2477,58.4,3878,1439,2439,59
11210, 관악구,090001, 85세,2021,1126,462,664,69.6,1111,459,652,70.4
11210, 관악구,090002, 86세,2021,991,366,625,58.6,978,364,614,59.3
11210, 관악구,090003, 87세,2021,713,260,453,57.4,707,259,448,57.8
11210, 관악구,090004, 88세,2021,589,196,393,49.9,582,196,386,50.8
11210, 관악구,090005, 89세,2021,504,162,342,47.4,500,161,339,47.5
11210, 관악구,095,90~94세,2021,1229,300,929,32.3,1212,296,916,32.3
11210, 관악구,095001, 90세,2021,359,89,270,33,353,89,264,33.7
11210, 관악구,095002, 91세,2021,308,85,223,38.1,303,84,219,38.4
11210, 관악구,095003, 92세,2021,254,57,197,28.9,252,57,195,29.2
11210, 관악구,095004, 93세,2021,184,39,145,26.9,181,36,145,24.8
11210, 관악구,095005, 94세,2021,124,30,94,31.9,123,30,93,32.3
11210, 관악구,100,95~99세,2021,238,40,198,20.2,237,40,197,20.3
11210, 관악구,100001, 95세,2021,78,9,69,13,78,9,69,13
11210, 관악구,100002, 96세,2021,50,5,45,11.1,50,5,45,11.1
11210, 관악구,100003, 97세,2021,45,8,37,21.6,44,8,36,22.2
11210, 관악구,100004, 98세,2021,46,11,35,31.4,46,11,35,31.4
11210, 관악구,100005, 99세,2021,19,7,12,58.3,19,7,12,58.3
11210, 관악구,101,100세이상,2021,42,7,35,20,42,7,35,20
11210, 관악구,102,15세미만,2021,32051,16457,15594,105.5,31182,16019,15163,105.6
11210, 관악구,103,15~64세,2021,384540,196181,188359,104.2,364888,187356,177532,105.5
11210, 관악구,104,65세이상,2021,79186,35176,44010,79.9,77193,34359,42834,80.2
11210, 관악구,086,85세이상,2021,5432,1793,3639,49.3,5369,1782,3587,49.7
11210, 관악구,126,평균연령,2021,42.7,42,43.5,,42.7,41.9,43.5,
11210, 관악구,127,중위연령,2021,40,39.2,40.9,,39.8,39,40.9,
11220, 서초구,000,합계,2021,392302,187435,204867,91.5,385150,183941,201209,91.4
11220, 서초구,005,0~4세,2021,11939,6166,5773,106.8,11661,6003,5658,106.1
11220, 서초구,005001, 0세,2021,2145,1077,1068,100.8,2110,1056,1054,100.2
11220, 서초구,005002, 1세,2021,2071,1089,982,110.9,2044,1072,972,110.3
11220, 서초구,005003, 2세,2021,2276,1191,1085,109.8,2226,1164,1062,109.6
11220, 서초구,005004, 3세,2021,2622,1400,1222,114.6,2557,1359,1198,113.4
11220, 서초구,005005, 4세,2021,2825,1409,1416,99.5,2724,1352,1372,98.5
11220, 서초구,010,5~9세,2021,18716,9625,9091,105.9,18253,9368,8885,105.4
11220, 서초구,010001, 5세,2021,3302,1666,1636,101.8,3180,1595,1585,100.6
11220, 서초구,010002, 6세,2021,3622,1847,1775,104.1,3503,1778,1725,103.1
11220, 서초구,010003, 7세,2021,3711,1934,1777,108.8,3622,1883,1739,108.3
11220, 서초구,010004, 8세,2021,3884,2026,1858,109,3809,1995,1814,110
11220, 서초구,010005, 9세,2021,4197,2152,2045,105.2,4139,2117,2022,104.7
11220, 서초구,015,10~14세,2021,21402,10881,10521,103.4,21164,10752,10412,103.3
11220, 서초구,015001, 10세,2021,4188,2188,2000,109.4,4137,2157,1980,108.9
11220, 서초구,015002, 11세,2021,4214,2159,2055,105.1,4165,2134,2031,105.1
11220, 서초구,015003, 12세,2021,4213,2130,2083,102.3,4159,2101,2058,102.1
11220, 서초구,015004, 13세,2021,4407,2257,2150,105,4361,2230,2131,104.6
11220, 서초구,015005, 14세,2021,4380,2147,2233,96.1,4342,2130,2212,96.3
11220, 서초구,020,15~19세,2021,19250,9719,9531,102,19094,9641,9453,102
11220, 서초구,020001, 15세,2021,4034,2080,1954,106.4,3989,2051,1938,105.8
11220, 서초구,020002, 16세,2021,3648,1889,1759,107.4,3631,1879,1752,107.2
11220, 서초구,020003, 17세,2021,4085,2042,2043,100,4047,2020,2027,99.7
11220, 서초구,020004, 18세,2021,3734,1896,1838,103.2,3711,1885,1826,103.2
11220, 서초구,020005, 19세,2021,3749,1812,1937,93.5,3716,1806,1910,94.6
11220, 서초구,025,20~24세,2021,22208,10565,11643,90.7,21846,10423,11423,91.2
11220, 서초구,025001, 20세,2021,4233,2031,2202,92.2,4177,2016,2161,93.3
11220, 서초구,025002, 21세,2021,4492,2224,2268,98.1,4437,2206,2231,98.9
11220, 서초구,025003, 22세,2021,4291,2038,2253,90.5,4225,2009,2216,90.7
11220, 서초구,025004, 23세,2021,4460,2134,2326,91.7,4379,2100,2279,92.1
11220, 서초구,025005, 24세,2021,4732,2138,2594,82.4,4628,2092,2536,82.5
11220, 서초구,030,25~29세,2021,26948,12623,14325,88.1,26237,12340,13897,88.8
11220, 서초구,030001, 25세,2021,4994,2236,2758,81.1,4870,2188,2682,81.6
11220, 서초구,030002, 26세,2021,5176,2408,2768,87,5019,2347,2672,87.8
11220, 서초구,030003, 27세,2021,5397,2558,2839,90.1,5251,2510,2741,91.6
11220, 서초구,030004, 28세,2021,5591,2670,2921,91.4,5448,2615,2833,92.3
11220, 서초구,030005, 29세,2021,5790,2751,3039,90.5,5649,2680,2969,90.3
11220, 서초구,035,30~34세,2021,27464,12822,14642,87.6,26621,12389,14232,87.1
11220, 서초구,035001, 30세,2021,5814,2769,3045,90.9,5662,2693,2969,90.7
11220, 서초구,035002, 31세,2021,5354,2595,2759,94.1,5185,2504,2681,93.4
11220, 서초구,035003, 32세,2021,5486,2526,2960,85.3,5298,2438,2860,85.2
11220, 서초구,035004, 33세,2021,5351,2459,2892,85,5181,2370,2811,84.3
11220, 서초구,035005, 34세,2021,5459,2473,2986,82.8,5295,2384,2911,81.9
11220, 서초구,040,35~39세,2021,29554,13675,15879,86.1,28711,13223,15488,85.4
11220, 서초구,040001, 35세,2021,5387,2484,2903,85.6,5214,2390,2824,84.6
11220, 서초구,040002, 36세,2021,5351,2483,2868,86.6,5186,2397,2789,85.9
11220, 서초구,040003, 37세,2021,5705,2657,3048,87.2,5552,2571,2981,86.2
11220, 서초구,040004, 38세,2021,6281,2865,3416,83.9,6106,2775,3331,83.3
11220, 서초구,040005, 39세,2021,6830,3186,3644,87.4,6653,3090,3563,86.7
11220, 서초구,045,40~44세,2021,34610,15959,18651,85.6,33838,15569,18269,85.2
11220, 서초구,045001, 40세,2021,6995,3228,3767,85.7,6825,3136,3689,85
11220, 서초구,045002, 41세,2021,7165,3293,3872,85,7001,3209,3792,84.6
11220, 서초구,045003, 42세,2021,6995,3231,3764,85.8,6840,3162,3678,86
11220, 서초구,045004, 43세,2021,6510,3006,3504,85.8,6377,2937,3440,85.4
11220, 서초구,045005, 44세,2021,6945,3201,3744,85.5,6795,3125,3670,85.1
11220, 서초구,050,45~49세,2021,36202,17399,18803,92.5,35560,17041,18519,92
11220, 서초구,050001, 45세,2021,6790,3124,3666,85.2,6662,3059,3603,84.9
11220, 서초구,050002, 46세,2021,6867,3336,3531,94.5,6718,3255,3463,94
11220, 서초구,050003, 47세,2021,7536,3606,3930,91.8,7414,3535,3879,91.1
11220, 서초구,050004, 48세,2021,7500,3630,3870,93.8,7391,3570,3821,93.4
11220, 서초구,050005, 49세,2021,7509,3703,3806,97.3,7375,3622,3753,96.5
11220, 서초구,055,50~54세,2021,34163,16917,17246,98.1,33578,16628,16950,98.1
11220, 서초구,055001, 50세,2021,7729,3826,3903,98,7589,3757,3832,98
11220, 서초구,055002, 51세,2021,7310,3614,3696,97.8,7187,3554,3633,97.8
11220, 서초구,055003, 52세,2021,6928,3524,3404,103.5,6827,3472,3355,103.5
11220, 서초구,055004, 53세,2021,6474,3142,3332,94.3,6359,3092,3267,94.6
11220, 서초구,055005, 54세,2021,5722,2811,2911,96.6,5616,2753,2863,96.2
11220, 서초구,060,55~59세,2021,26277,12808,13469,95.1,25802,12596,13206,95.4
11220, 서초구,060001, 55세,2021,5142,2576,2566,100.4,5048,2528,2520,100.3
11220, 서초구,060002, 56세,2021,5478,2685,2793,96.1,5380,2645,2735,96.7
11220, 서초구,060003, 57세,2021,5259,2574,2685,95.9,5166,2534,2632,96.3
11220, 서초구,060004, 58세,2021,5302,2516,2786,90.3,5209,2482,2727,91
11220, 서초구,060005, 59세,2021,5096,2457,2639,93.1,4999,2407,2592,92.9
11220, 서초구,065,60~64세,2021,25673,11935,13738,86.9,25292,11787,13505,87.3
11220, 서초구,065001, 60세,2021,5277,2455,2822,87,5203,2429,2774,87.6
11220, 서초구,065002, 61세,2021,5358,2503,2855,87.7,5281,2472,2809,88
11220, 서초구,065003, 62세,2021,5127,2348,2779,84.5,5051,2318,2733,84.8
11220, 서초구,065004, 63세,2021,4904,2351,2553,92.1,4822,2314,2508,92.3
11220, 서초구,065005, 64세,2021,5007,2278,2729,83.5,4935,2254,2681,84.1
11220, 서초구,070,65~69세,2021,20969,9588,11381,84.2,20765,9505,11260,84.4
11220, 서초구,070001, 65세,2021,4505,2093,2412,86.8,4442,2064,2378,86.8
11220, 서초구,070002, 66세,2021,4863,2187,2676,81.7,4821,2174,2647,82.1
11220, 서초구,070003, 67세,2021,3982,1841,2141,86,3945,1821,2124,85.7
11220, 서초구,070004, 68세,2021,3785,1706,2079,82.1,3758,1697,2061,82.3
11220, 서초구,070005, 69세,2021,3834,1761,2073,84.9,3799,1749,2050,85.3
11220, 서초구,075,70~74세,2021,15116,6961,8155,85.4,15027,6923,8104,85.4
11220, 서초구,075001, 70세,2021,2729,1285,1444,89,2705,1272,1433,88.8
11220, 서초구,075002, 71세,2021,3090,1410,1680,83.9,3073,1404,1669,84.1
11220, 서초구,075003, 72세,2021,3220,1455,1765,82.4,3206,1448,1758,82.4
11220, 서초구,075004, 73세,2021,3072,1447,1625,89,3055,1442,1613,89.4
11220, 서초구,075005, 74세,2021,3005,1364,1641,83.1,2988,1357,1631,83.2
11220, 서초구,080,75~79세,2021,10807,5182,5625,92.1,10754,5163,5591,92.3
11220, 서초구,080001, 75세,2021,2472,1136,1336,85,2460,1131,1329,85.1
11220, 서초구,080002, 76세,2021,2196,1048,1148,91.3,2184,1045,1139,91.7
11220, 서초구,080003, 77세,2021,2120,1029,1091,94.3,2107,1023,1084,94.4
11220, 서초구,080004, 78세,2021,1960,944,1016,92.9,1950,941,1009,93.3
11220, 서초구,080005, 79세,2021,2059,1025,1034,99.1,2053,1023,1030,99.3
11220, 서초구,085,80~84세,2021,6409,2974,3435,86.6,6375,2962,3413,86.8
11220, 서초구,085001, 80세,2021,1663,800,863,92.7,1654,799,855,93.5
11220, 서초구,085002, 81세,2021,1403,651,752,86.6,1395,646,749,86.2
11220, 서초구,085003, 82세,2021,1242,588,654,89.9,1237,585,652,89.7
11220, 서초구,085004, 83세,2021,1099,521,578,90.1,1093,520,573,90.8
11220, 서초구,085005, 84세,2021,1002,414,588,70.4,996,412,584,70.5
11220, 서초구,090,85~89세,2021,3132,1230,1902,64.7,3119,1227,1892,64.9
11220, 서초구,090001, 85세,2021,811,350,461,75.9,809,349,460,75.9
11220, 서초구,090002, 86세,2021,807,330,477,69.2,803,329,474,69.4
11220, 서초구,090003, 87세,2021,589,216,373,57.9,587,216,371,58.2
11220, 서초구,090004, 88세,2021,480,181,299,60.5,479,181,298,60.7
11220, 서초구,090005, 89세,2021,445,153,292,52.4,441,152,289,52.6
11220, 서초구,095,90~94세,2021,1138,327,811,40.3,1135,325,810,40.1
11220, 서초구,095001, 90세,2021,283,86,197,43.7,283,86,197,43.7
11220, 서초구,095002, 91세,2021,258,74,184,40.2,258,74,184,40.2
11220, 서초구,095003, 92세,2021,236,79,157,50.3,236,79,157,50.3
11220, 서초구,095004, 93세,2021,215,51,164,31.1,214,51,163,31.3
11220, 서초구,095005, 94세,2021,146,37,109,33.9,144,35,109,32.1
11220, 서초구,100,95~99세,2021,287,70,217,32.3,283,69,214,32.2
11220, 서초구,100001, 95세,2021,99,23,76,30.3,99,23,76,30.3
11220, 서초구,100002, 96세,2021,73,21,52,40.4,72,20,52,38.5
11220, 서초구,100003, 97세,2021,51,11,40,27.5,49,11,38,28.9
11220, 서초구,100004, 98세,2021,41,14,27,51.9,40,14,26,53.8
11220, 서초구,100005, 99세,2021,23,X,22,4.5,23,X,22,4.5
11220, 서초구,101,100세이상,2021,38,9,29,31,35,7,28,25
11220, 서초구,102,15세미만,2021,52057,26672,25385,105.1,51078,26123,24955,104.7
11220, 서초구,103,15~64세,2021,282349,134422,147927,90.9,276579,131637,144942,90.8
11220, 서초구,104,65세이상,2021,57896,26341,31555,83.5,57493,26181,31312,83.6
11220, 서초구,086,85세이상,2021,4595,1636,2959,55.3,4572,1628,2944,55.3
11220, 서초구,126,평균연령,2021,41.8,41.2,42.4,,41.9,41.3,42.4,
11220, 서초구,127,중위연령,2021,42.6,42.3,42.9,,42.8,42.5,43,
11230, 강남구,000,합계,2021,503019,240842,262177,91.9,494171,236619,257552,91.9
11230, 강남구,005,0~4세,2021,11979,6192,5787,107,11805,6092,5713,106.6
11230, 강남구,005001, 0세,2021,2143,1076,1067,100.8,2132,1070,1062,100.8
11230, 강남구,005002, 1세,2021,2121,1092,1029,106.1,2108,1084,1024,105.9
11230, 강남구,005003, 2세,2021,2310,1224,1086,112.7,2284,1211,1073,112.9
11230, 강남구,005004, 3세,2021,2495,1321,1174,112.5,2451,1299,1152,112.8
11230, 강남구,005005, 4세,2021,2910,1479,1431,103.4,2830,1428,1402,101.9
11230, 강남구,010,5~9세,2021,20653,10634,10019,106.1,20381,10476,9905,105.8
11230, 강남구,010001, 5세,2021,3373,1698,1675,101.4,3291,1654,1637,101
11230, 강남구,010002, 6세,2021,3772,1931,1841,104.9,3717,1897,1820,104.2
11230, 강남구,010003, 7세,2021,4136,2155,1981,108.8,4088,2126,1962,108.4
11230, 강남구,010004, 8세,2021,4500,2351,2149,109.4,4448,2321,2127,109.1
11230, 강남구,010005, 9세,2021,4872,2499,2373,105.3,4837,2478,2359,105
11230, 강남구,015,10~14세,2021,27618,14469,13149,110,27490,14391,13099,109.9
11230, 강남구,015001, 10세,2021,5160,2742,2418,113.4,5126,2719,2407,113
11230, 강남구,015002, 11세,2021,5101,2637,2464,107,5082,2624,2458,106.8
11230, 강남구,015003, 12세,2021,5412,2858,2554,111.9,5388,2844,2544,111.8
11230, 강남구,015004, 13세,2021,5959,3117,2842,109.7,5936,3107,2829,109.8
11230, 강남구,015005, 14세,2021,5986,3115,2871,108.5,5958,3097,2861,108.2
11230, 강남구,020,15~19세,2021,26126,13599,12527,108.6,25939,13508,12431,108.7
11230, 강남구,020001, 15세,2021,5347,2832,2515,112.6,5317,2815,2502,112.5
11230, 강남구,020002, 16세,2021,5214,2765,2449,112.9,5184,2747,2437,112.7
11230, 강남구,020003, 17세,2021,5494,2895,2599,111.4,5460,2872,2588,111
11230, 강남구,020004, 18세,2021,5303,2741,2562,107,5269,2725,2544,107.1
11230, 강남구,020005, 19세,2021,4768,2366,2402,98.5,4709,2349,2360,99.5
11230, 강남구,025,20~24세,2021,28192,13583,14609,93,27534,13373,14161,94.4
11230, 강남구,025001, 20세,2021,5314,2687,2627,102.3,5248,2668,2580,103.4
11230, 강남구,025002, 21세,2021,5643,2904,2739,106,5545,2877,2668,107.8
11230, 강남구,025003, 22세,2021,5305,2614,2691,97.1,5160,2561,2599,98.5
11230, 강남구,025004, 23세,2021,5848,2733,3115,87.7,5677,2686,2991,89.8
11230, 강남구,025005, 24세,2021,6082,2645,3437,77,5904,2581,3323,77.7
11230, 강남구,030,25~29세,2021,37089,17265,19824,87.1,35764,16729,19035,87.9
11230, 강남구,030001, 25세,2021,6671,2993,3678,81.4,6440,2918,3522,82.9
11230, 강남구,030002, 26세,2021,6923,3137,3786,82.9,6654,3037,3617,84
11230, 강남구,030003, 27세,2021,7648,3624,4024,90.1,7375,3516,3859,91.1
11230, 강남구,030004, 28세,2021,7861,3787,4074,93,7587,3659,3928,93.2
11230, 강남구,030005, 29세,2021,7986,3724,4262,87.4,7708,3599,4109,87.6
11230, 강남구,035,30~34세,2021,36758,17335,19423,89.2,35434,16688,18746,89
11230, 강남구,035001, 30세,2021,7849,3722,4127,90.2,7580,3600,3980,90.5
11230, 강남구,035002, 31세,2021,7524,3611,3913,92.3,7244,3474,3770,92.1
11230, 강남구,035003, 32세,2021,7427,3518,3909,90,7153,3384,3769,89.8
11230, 강남구,035004, 33세,2021,6998,3289,3709,88.7,6736,3151,3585,87.9
11230, 강남구,035005, 34세,2021,6960,3195,3765,84.9,6721,3079,3642,84.5
11230, 강남구,040,35~39세,2021,37496,17179,20317,84.6,36388,16578,19810,83.7
11230, 강남구,040001, 35세,2021,6949,3242,3707,87.5,6711,3112,3599,86.5
11230, 강남구,040002, 36세,2021,7007,3256,3751,86.8,6781,3121,3660,85.3
11230, 강남구,040003, 37세,2021,7231,3305,3926,84.2,7003,3180,3823,83.2
11230, 강남구,040004, 38세,2021,7845,3580,4265,83.9,7630,3468,4162,83.3
11230, 강남구,040005, 39세,2021,8464,3796,4668,81.3,8263,3697,4566,81
11230, 강남구,045,40~44세,2021,44353,20121,24232,83,43504,19640,23864,82.3
11230, 강남구,045001, 40세,2021,8875,4026,4849,83,8702,3935,4767,82.5
11230, 강남구,045002, 41세,2021,8976,4092,4884,83.8,8787,3981,4806,82.8
11230, 강남구,045003, 42세,2021,9085,4052,5033,80.5,8901,3947,4954,79.7
11230, 강남구,045004, 43세,2021,8458,3891,4567,85.2,8296,3790,4506,84.1
11230, 강남구,045005, 44세,2021,8959,4060,4899,82.9,8818,3987,4831,82.5
11230, 강남구,050,45~49세,2021,47523,22620,24903,90.8,46835,22244,24591,90.5
11230, 강남구,050001, 45세,2021,8849,4048,4801,84.3,8718,3974,4744,83.8
11230, 강남구,050002, 46세,2021,9219,4332,4887,88.6,9095,4264,4831,88.3
11230, 강남구,050003, 47세,2021,9771,4668,5103,91.5,9611,4573,5038,90.8
11230, 강남구,050004, 48세,2021,9758,4642,5116,90.7,9637,4578,5059,90.5
11230, 강남구,050005, 49세,2021,9926,4930,4996,98.7,9774,4855,4919,98.7
11230, 강남구,055,50~54세,2021,44652,22375,22277,100.4,44036,22059,21977,100.4
11230, 강남구,055001, 50세,2021,10202,5131,5071,101.2,10059,5051,5008,100.9
11230, 강남구,055002, 51세,2021,9580,4772,4808,99.3,9456,4708,4748,99.2
11230, 강남구,055003, 52세,2021,9146,4652,4494,103.5,9019,4587,4432,103.5
11230, 강남구,055004, 53세,2021,8205,4180,4025,103.9,8103,4126,3977,103.7
11230, 강남구,055005, 54세,2021,7519,3640,3879,93.8,7399,3587,3812,94.1
11230, 강남구,060,55~59세,2021,33683,16724,16959,98.6,33140,16488,16652,99
11230, 강남구,060001, 55세,2021,6707,3456,3251,106.3,6601,3411,3190,106.9
11230, 강남구,060002, 56세,2021,7158,3509,3649,96.2,7058,3472,3586,96.8
11230, 강남구,060003, 57세,2021,6658,3190,3468,92,6555,3147,3408,92.3
11230, 강남구,060004, 58세,2021,6841,3401,3440,98.9,6728,3351,3377,99.2
11230, 강남구,060005, 59세,2021,6319,3168,3151,100.5,6198,3107,3091,100.5
11230, 강남구,065,60~64세,2021,32333,14980,17353,86.3,31885,14813,17072,86.8
11230, 강남구,065001, 60세,2021,6697,3163,3534,89.5,6617,3131,3486,89.8
11230, 강남구,065002, 61세,2021,6827,3190,3637,87.7,6713,3148,3565,88.3
11230, 강남구,065003, 62세,2021,6239,2877,3362,85.6,6145,2842,3303,86
11230, 강남구,065004, 63세,2021,6241,2825,3416,82.7,6163,2801,3362,83.3
11230, 강남구,065005, 64세,2021,6329,2925,3404,85.9,6247,2891,3356,86.1
11230, 강남구,070,65~69세,2021,27444,12358,15086,81.9,27145,12234,14911,82
11230, 강남구,070001, 65세,2021,5902,2686,3216,83.5,5825,2661,3164,84.1
11230, 강남구,070002, 66세,2021,6216,2731,3485,78.4,6153,2704,3449,78.4
11230, 강남구,070003, 67세,2021,5281,2427,2854,85,5224,2405,2819,85.3
11230, 강남구,070004, 68세,2021,4887,2184,2703,80.8,4841,2164,2677,80.8
11230, 강남구,070005, 69세,2021,5158,2330,2828,82.4,5102,2300,2802,82.1
11230, 강남구,075,70~74세,2021,19690,9069,10621,85.4,19582,9026,10556,85.5
11230, 강남구,075001, 70세,2021,3477,1626,1851,87.8,3453,1619,1834,88.3
11230, 강남구,075002, 71세,2021,4041,1777,2264,78.5,4019,1769,2250,78.6
11230, 강남구,075003, 72세,2021,4128,1906,2222,85.8,4109,1899,2210,85.9
11230, 강남구,075004, 73세,2021,4096,1954,2142,91.2,4078,1946,2132,91.3
11230, 강남구,075005, 74세,2021,3948,1806,2142,84.3,3923,1793,2130,84.2
11230, 강남구,080,75~79세,2021,13690,6694,6996,95.7,13636,6669,6967,95.7
11230, 강남구,080001, 75세,2021,3209,1539,1670,92.2,3192,1530,1662,92.1
11230, 강남구,080002, 76세,2021,2809,1371,1438,95.3,2800,1364,1436,95
11230, 강남구,080003, 77세,2021,2659,1296,1363,95.1,2653,1294,1359,95.2
11230, 강남구,080004, 78세,2021,2431,1182,1249,94.6,2425,1180,1245,94.8
11230, 강남구,080005, 79세,2021,2582,1306,1276,102.4,2566,1301,1265,102.8
11230, 강남구,085,80~84세,2021,8056,3727,4329,86.1,8022,3711,4311,86.1
11230, 강남구,085001, 80세,2021,2075,993,1082,91.8,2067,989,1078,91.7
11230, 강남구,085002, 81세,2021,1767,830,937,88.6,1762,828,934,88.7
11230, 강남구,085003, 82세,2021,1539,730,809,90.2,1532,726,806,90.1
11230, 강남구,085004, 83세,2021,1438,644,794,81.1,1428,640,788,81.2
11230, 강남구,085005, 84세,2021,1237,530,707,75,1233,528,705,74.9
11230, 강남구,090,85~89세,2021,3795,1435,2360,60.8,3778,1427,2351,60.7
11230, 강남구,090001, 85세,2021,990,426,564,75.5,986,424,562,75.4
11230, 강남구,090002, 86세,2021,922,354,568,62.3,919,352,567,62.1
11230, 강남구,090003, 87세,2021,726,257,469,54.8,723,256,467,54.8
11230, 강남구,090004, 88세,2021,599,209,390,53.6,596,207,389,53.2
11230, 강남구,090005, 89세,2021,558,189,369,51.2,554,188,366,51.4
11230, 강남구,095,90~94세,2021,1482,388,1094,35.5,1470,380,1090,34.9
11230, 강남구,095001, 90세,2021,414,120,294,40.8,412,118,294,40.1
11230, 강남구,095002, 91세,2021,372,104,268,38.8,366,101,265,38.1
11230, 강남구,095003, 92세,2021,296,76,220,34.5,294,75,219,34.2
11230, 강남구,095004, 93세,2021,213,42,171,24.6,211,40,171,23.4
11230, 강남구,095005, 94세,2021,187,46,141,32.6,187,46,141,32.6
11230, 강남구,100,95~99세,2021,348,80,268,29.9,346,78,268,29.1
11230, 강남구,100001, 95세,2021,117,28,89,31.5,117,28,89,31.5
11230, 강남구,100002, 96세,2021,99,22,77,28.6,99,22,77,28.6
11230, 강남구,100003, 97세,2021,57,14,43,32.6,56,13,43,30.2
11230, 강남구,100004, 98세,2021,47,11,36,30.6,47,11,36,30.6
11230, 강남구,100005, 99세,2021,28,5,23,21.7,27,X,23,17.4
11230, 강남구,101,100세이상,2021,59,15,44,34.1,57,15,42,35.7
11230, 강남구,102,15세미만,2021,60250,31295,28955,108.1,59676,30959,28717,107.8
11230, 강남구,103,15~64세,2021,368205,175781,192424,91.4,360459,172120,188339,91.4
11230, 강남구,104,65세이상,2021,74564,33766,40798,82.8,74036,33540,40496,82.8
11230, 강남구,086,85세이상,2021,5684,1918,3766,50.9,5651,1900,3751,50.7
11230, 강남구,126,평균연령,2021,42.1,41.5,42.8,,42.2,41.5,42.8,
11230, 강남구,127,중위연령,2021,42.9,42.5,43.1,,43,42.6,43.3,
11240, 송파구,000,합계,2021,634720,305449,329271,92.8,624977,300957,324020,92.9
11240, 송파구,005,0~4세,2021,20225,10465,9760,107.2,20035,10359,9676,107.1
11240, 송파구,005001, 0세,2021,3733,1920,1813,105.9,3707,1905,1802,105.7
11240, 송파구,005002, 1세,2021,3695,1889,1806,104.6,3675,1877,1798,104.4
11240, 송파구,005003, 2세,2021,4042,2100,1942,108.1,4006,2078,1928,107.8
11240, 송파구,005004, 3세,2021,4194,2178,2016,108,4136,2151,1985,108.4
11240, 송파구,005005, 4세,2021,4561,2378,2183,108.9,4511,2348,2163,108.6
11240, 송파구,010,5~9세,2021,26847,13733,13114,104.7,26611,13614,12997,104.7
11240, 송파구,010001, 5세,2021,5344,2804,2540,110.4,5276,2764,2512,110
11240, 송파구,010002, 6세,2021,5322,2727,2595,105.1,5264,2707,2557,105.9
11240, 송파구,010003, 7세,2021,5175,2640,2535,104.1,5134,2622,2512,104.4
11240, 송파구,010004, 8세,2021,5248,2646,2602,101.7,5217,2624,2593,101.2
11240, 송파구,010005, 9세,2021,5758,2916,2842,102.6,5720,2897,2823,102.6
11240, 송파구,015,10~14세,2021,27242,13899,13343,104.2,27126,13844,13282,104.2
11240, 송파구,015001, 10세,2021,5547,2912,2635,110.5,5519,2896,2623,110.4
11240, 송파구,015002, 11세,2021,5468,2752,2716,101.3,5448,2742,2706,101.3
11240, 송파구,015003, 12세,2021,5156,2583,2573,100.4,5130,2571,2559,100.5
11240, 송파구,015004, 13세,2021,5429,2776,2653,104.6,5407,2768,2639,104.9
11240, 송파구,015005, 14세,2021,5642,2876,2766,104,5622,2867,2755,104.1
11240, 송파구,020,15~19세,2021,26702,13660,13042,104.7,26582,13598,12984,104.7
11240, 송파구,020001, 15세,2021,5277,2663,2614,101.9,5261,2651,2610,101.6
11240, 송파구,020002, 16세,2021,5088,2606,2482,105,5069,2597,2472,105.1
11240, 송파구,020003, 17세,2021,5378,2754,2624,105,5362,2745,2617,104.9
11240, 송파구,020004, 18세,2021,5496,2808,2688,104.5,5472,2795,2677,104.4
11240, 송파구,020005, 19세,2021,5463,2829,2634,107.4,5418,2810,2608,107.7
11240, 송파구,025,20~24세,2021,35793,17427,18366,94.9,35366,17284,18082,95.6
11240, 송파구,025001, 20세,2021,6283,3238,3045,106.3,6226,3213,3013,106.6
11240, 송파구,025002, 21세,2021,7190,3698,3492,105.9,7136,3676,3460,106.2
11240, 송파구,025003, 22세,2021,6864,3421,3443,99.4,6788,3396,3392,100.1
11240, 송파구,025004, 23세,2021,7323,3379,3944,85.7,7222,3342,3880,86.1
11240, 송파구,025005, 24세,2021,8133,3691,4442,83.1,7994,3657,4337,84.3
11240, 송파구,030,25~29세,2021,50261,23259,27002,86.1,49319,22912,26407,86.8
11240, 송파구,030001, 25세,2021,8752,3891,4861,80,8620,3845,4775,80.5
11240, 송파구,030002, 26세,2021,9581,4478,5103,87.8,9398,4414,4984,88.6
11240, 송파구,030003, 27세,2021,10290,4788,5502,87,10109,4714,5395,87.4
11240, 송파구,030004, 28세,2021,10700,4967,5733,86.6,10464,4885,5579,87.6
11240, 송파구,030005, 29세,2021,10938,5135,5803,88.5,10728,5054,5674,89.1
11240, 송파구,035,30~34세,2021,50886,24333,26553,91.6,49680,23773,25907,91.8
11240, 송파구,035001, 30세,2021,10539,4932,5607,88,10351,4836,5515,87.7
11240, 송파구,035002, 31세,2021,10298,4890,5408,90.4,10060,4794,5266,91
11240, 송파구,035003, 32세,2021,10208,4897,5311,92.2,9940,4782,5158,92.7
11240, 송파구,035004, 33세,2021,9893,4790,5103,93.9,9661,4680,4981,94
11240, 송파구,035005, 34세,2021,9948,4824,5124,94.1,9668,4681,4987,93.9
11240, 송파구,040,35~39세,2021,52144,25022,27122,92.3,50955,24430,26525,92.1
11240, 송파구,040001, 35세,2021,9943,4722,5221,90.4,9676,4597,5079,90.5
11240, 송파구,040002, 36세,2021,9946,4755,5191,91.6,9696,4631,5065,91.4
11240, 송파구,040003, 37세,2021,10051,4821,5230,92.2,9825,4714,5111,92.2
11240, 송파구,040004, 38세,2021,10808,5198,5610,92.7,10569,5075,5494,92.4
11240, 송파구,040005, 39세,2021,11396,5526,5870,94.1,11189,5413,5776,93.7
11240, 송파구,045,40~44세,2021,52195,25155,27040,93,51401,24747,26654,92.8
11240, 송파구,045001, 40세,2021,11234,5521,5713,96.6,11051,5426,5625,96.5
11240, 송파구,045002, 41세,2021,11362,5413,5949,91,11221,5348,5873,91.1
11240, 송파구,045003, 42세,2021,10578,5007,5571,89.9,10422,4930,5492,89.8
11240, 송파구,045004, 43세,2021,9385,4585,4800,95.5,9209,4488,4721,95.1
11240, 송파구,045005, 44세,2021,9636,4629,5007,92.5,9498,4555,4943,92.2
11240, 송파구,050,45~49세,2021,50257,24545,25712,95.5,49486,24134,25352,95.2
11240, 송파구,050001, 45세,2021,9343,4645,4698,98.9,9217,4570,4647,98.3
11240, 송파구,050002, 46세,2021,9690,4786,4904,97.6,9559,4723,4836,97.7
11240, 송파구,050003, 47세,2021,10336,5102,5234,97.5,10172,5026,5146,97.7
11240, 송파구,050004, 48세,2021,10340,4893,5447,89.8,10187,4808,5379,89.4
11240, 송파구,050005, 49세,2021,10548,5119,5429,94.3,10351,5007,5344,93.7
11240, 송파구,055,50~54세,2021,52416,25140,27276,92.2,51394,24653,26741,92.2
11240, 송파구,055001, 50세,2021,11276,5369,5907,90.9,11059,5258,5801,90.6
11240, 송파구,055002, 51세,2021,10499,5156,5343,96.5,10305,5054,5251,96.2
11240, 송파구,055003, 52세,2021,10694,5161,5533,93.3,10497,5070,5427,93.4
11240, 송파구,055004, 53세,2021,10460,4932,5528,89.2,10226,4829,5397,89.5
11240, 송파구,055005, 54세,2021,9487,4522,4965,91.1,9307,4442,4865,91.3
11240, 송파구,060,55~59세,2021,46860,22541,24319,92.7,45790,22064,23726,93
11240, 송파구,060001, 55세,2021,9054,4460,4594,97.1,8847,4374,4473,97.8
11240, 송파구,060002, 56세,2021,9648,4601,5047,91.2,9428,4498,4930,91.2
11240, 송파구,060003, 57세,2021,9099,4328,4771,90.7,8874,4234,4640,91.3
11240, 송파구,060004, 58세,2021,9648,4648,5000,93,9426,4547,4879,93.2
11240, 송파구,060005, 59세,2021,9411,4504,4907,91.8,9215,4411,4804,91.8
11240, 송파구,065,60~64세,2021,48328,22477,25851,86.9,47523,22127,25396,87.1
11240, 송파구,065001, 60세,2021,10188,4691,5497,85.3,10056,4644,5412,85.8
11240, 송파구,065002, 61세,2021,10308,4735,5573,85,10123,4648,5475,84.9
11240, 송파구,065003, 62세,2021,9603,4516,5087,88.8,9436,4440,4996,88.9
11240, 송파구,065004, 63세,2021,9063,4243,4820,88,8895,4175,4720,88.5
11240, 송파구,065005, 64세,2021,9166,4292,4874,88.1,9013,4220,4793,88
11240, 송파구,070,65~69세,2021,37754,17887,19867,90,37259,17650,19609,90
11240, 송파구,070001, 65세,2021,8253,3849,4404,87.4,8109,3782,4327,87.4
11240, 송파구,070002, 66세,2021,8900,4165,4735,88,8774,4109,4665,88.1
11240, 송파구,070003, 67세,2021,7239,3408,3831,89,7150,3370,3780,89.2
11240, 송파구,070004, 68세,2021,6516,3102,3414,90.9,6444,3067,3377,90.8
11240, 송파구,070005, 69세,2021,6846,3363,3483,96.6,6782,3322,3460,96
11240, 송파구,075,70~74세,2021,24498,11980,12518,95.7,24305,11899,12406,95.9
11240, 송파구,075001, 70세,2021,4716,2266,2450,92.5,4665,2243,2422,92.6
11240, 송파구,075002, 71세,2021,5116,2524,2592,97.4,5075,2504,2571,97.4
11240, 송파구,075003, 72세,2021,5102,2493,2609,95.6,5061,2479,2582,96
11240, 송파구,075004, 73세,2021,4685,2308,2377,97.1,4654,2295,2359,97.3
11240, 송파구,075005, 74세,2021,4879,2389,2490,95.9,4850,2378,2472,96.2
11240, 송파구,080,75~79세,2021,15952,7694,8258,93.2,15867,7661,8206,93.4
11240, 송파구,080001, 75세,2021,3581,1733,1848,93.8,3557,1724,1833,94.1
11240, 송파구,080002, 76세,2021,3253,1569,1684,93.2,3227,1558,1669,93.3
11240, 송파구,080003, 77세,2021,3096,1499,1597,93.9,3082,1493,1589,94
11240, 송파구,080004, 78세,2021,2892,1397,1495,93.4,2884,1395,1489,93.7
11240, 송파구,080005, 79세,2021,3130,1496,1634,91.6,3117,1491,1626,91.7
11240, 송파구,085,80~84세,2021,9370,4090,5280,77.5,9318,4073,5245,77.7
11240, 송파구,085001, 80세,2021,2402,1089,1313,82.9,2391,1085,1306,83.1
11240, 송파구,085002, 81세,2021,2082,955,1127,84.7,2063,948,1115,85
11240, 송파구,085003, 82세,2021,1847,808,1039,77.8,1842,806,1036,77.8
11240, 송파구,085004, 83세,2021,1576,658,918,71.7,1565,654,911,71.8
11240, 송파구,085005, 84세,2021,1463,580,883,65.7,1457,580,877,66.1
11240, 송파구,090,85~89세,2021,4788,1597,3191,50,4769,1594,3175,50.2
11240, 송파구,090001, 85세,2021,1225,441,784,56.3,1217,439,778,56.4
11240, 송파구,090002, 86세,2021,1143,407,736,55.3,1141,407,734,55.4
11240, 송파구,090003, 87세,2021,940,330,610,54.1,936,330,606,54.5
11240, 송파구,090004, 88세,2021,789,221,568,38.9,788,220,568,38.7
11240, 송파구,090005, 89세,2021,691,198,493,40.2,687,198,489,40.5
11240, 송파구,095,90~94세,2021,1738,454,1284,35.4,1731,452,1279,35.3
11240, 송파구,095001, 90세,2021,491,138,353,39.1,491,138,353,39.1
11240, 송파구,095002, 91세,2021,406,102,304,33.6,403,102,301,33.9
11240, 송파구,095003, 92세,2021,373,95,278,34.2,371,94,277,33.9
11240, 송파구,095004, 93세,2021,258,67,191,35.1,258,67,191,35.1
11240, 송파구,095005, 94세,2021,210,52,158,32.9,208,51,157,32.5
11240, 송파구,100,95~99세,2021,409,80,329,24.3,406,78,328,23.8
11240, 송파구,100001, 95세,2021,154,25,129,19.4,154,25,129,19.4
11240, 송파구,100002, 96세,2021,104,21,83,25.3,103,21,82,25.6
11240, 송파구,100003, 97세,2021,60,17,43,39.5,59,16,43,37.2
11240, 송파구,100004, 98세,2021,56,11,45,24.4,56,11,45,24.4
11240, 송파구,100005, 99세,2021,35,6,29,20.7,34,5,29,17.2
11240, 송파구,101,100세이상,2021,55,11,44,25,54,11,43,25.6
11240, 송파구,102,15세미만,2021,74314,38097,36217,105.2,73772,37817,35955,105.2
11240, 송파구,103,15~64세,2021,465842,223559,242283,92.3,457496,219722,237774,92.4
11240, 송파구,104,65세이상,2021,94564,43793,50771,86.3,93709,43418,50291,86.3
11240, 송파구,086,85세이상,2021,6990,2142,4848,44.2,6960,2135,4825,44.2
11240, 송파구,126,평균연령,2021,42.4,41.8,42.9,,42.3,41.7,42.9,
11240, 송파구,127,중위연령,2021,42.4,42,42.8,,42.4,42,42.8,
11250, 강동구,000,합계,2021,451099,220916,230183,96,444799,218091,226708,96.2
11250, 강동구,005,0~4세,2021,14825,7673,7152,107.3,14728,7624,7104,107.3
11250, 강동구,005001, 0세,2021,2787,1463,1324,110.5,2770,1454,1316,110.5
11250, 강동구,005002, 1세,2021,2793,1410,1383,102,2778,1400,1378,101.6
11250, 강동구,005003, 2세,2021,3001,1551,1450,107,2983,1542,1441,107
11250, 강동구,005004, 3세,2021,3008,1587,1421,111.7,2995,1583,1412,112.1
11250, 강동구,005005, 4세,2021,3236,1662,1574,105.6,3202,1645,1557,105.7
11250, 강동구,010,5~9세,2021,19105,9980,9125,109.4,18995,9920,9075,109.3
11250, 강동구,010001, 5세,2021,3678,1931,1747,110.5,3654,1918,1736,110.5
11250, 강동구,010002, 6세,2021,3805,2004,1801,111.3,3779,1988,1791,111
11250, 강동구,010003, 7세,2021,3951,2043,1908,107.1,3932,2032,1900,106.9
11250, 강동구,010004, 8세,2021,3681,1929,1752,110.1,3662,1920,1742,110.2
11250, 강동구,010005, 9세,2021,3990,2073,1917,108.1,3968,2062,1906,108.2
11250, 강동구,015,10~14세,2021,19079,10128,8951,113.1,19009,10095,8914,113.2
11250, 강동구,015001, 10세,2021,3775,1995,1780,112.1,3760,1989,1771,112.3
11250, 강동구,015002, 11세,2021,3793,1977,1816,108.9,3774,1968,1806,109
11250, 강동구,015003, 12세,2021,3673,1897,1776,106.8,3658,1886,1772,106.4
11250, 강동구,015004, 13세,2021,3934,2129,1805,118,3923,2125,1798,118.2
11250, 강동구,015005, 14세,2021,3904,2130,1774,120.1,3894,2127,1767,120.4
11250, 강동구,020,15~19세,2021,18006,9506,8500,111.8,17939,9479,8460,112
11250, 강동구,020001, 15세,2021,3523,1871,1652,113.3,3512,1865,1647,113.2
11250, 강동구,020002, 16세,2021,3392,1812,1580,114.7,3373,1802,1571,114.7
11250, 강동구,020003, 17세,2021,3776,1993,1783,111.8,3765,1989,1776,112
11250, 강동구,020004, 18세,2021,3697,1934,1763,109.7,3689,1932,1757,110
11250, 강동구,020005, 19세,2021,3618,1896,1722,110.1,3600,1891,1709,110.6
11250, 강동구,025,20~24세,2021,24151,11994,12157,98.7,23872,11882,11990,99.1
11250, 강동구,025001, 20세,2021,4132,2174,1958,111,4106,2165,1941,111.5
11250, 강동구,025002, 21세,2021,4731,2422,2309,104.9,4699,2410,2289,105.3
11250, 강동구,025003, 22세,2021,4702,2440,2262,107.9,4656,2412,2244,107.5
11250, 강동구,025004, 23세,2021,5058,2362,2696,87.6,4985,2335,2650,88.1
11250, 강동구,025005, 24세,2021,5528,2596,2932,88.5,5426,2560,2866,89.3
11250, 강동구,030,25~29세,2021,34033,16302,17731,91.9,33426,16059,17367,92.5
11250, 강동구,030001, 25세,2021,6212,2921,3291,88.8,6114,2879,3235,89
11250, 강동구,030002, 26세,2021,6609,3156,3453,91.4,6488,3108,3380,92
11250, 강동구,030003, 27세,2021,6824,3247,3577,90.8,6690,3201,3489,91.7
11250, 강동구,030004, 28세,2021,7063,3441,3622,95,6949,3383,3566,94.9
11250, 강동구,030005, 29세,2021,7325,3537,3788,93.4,7185,3488,3697,94.3
11250, 강동구,035,30~34세,2021,33898,16735,17163,97.5,33145,16401,16744,98
11250, 강동구,035001, 30세,2021,7029,3434,3595,95.5,6877,3365,3512,95.8
11250, 강동구,035002, 31세,2021,6905,3430,3475,98.7,6753,3354,3399,98.7
11250, 강동구,035003, 32세,2021,6608,3284,3324,98.8,6470,3229,3241,99.6
11250, 강동구,035004, 33세,2021,6700,3303,3397,97.2,6547,3239,3308,97.9
11250, 강동구,035005, 34세,2021,6656,3284,3372,97.4,6498,3214,3284,97.9
11250, 강동구,040,35~39세,2021,35993,17912,18081,99.1,35326,17600,17726,99.3
11250, 강동구,040001, 35세,2021,6666,3359,3307,101.6,6520,3288,3232,101.7
11250, 강동구,040002, 36세,2021,6824,3387,3437,98.5,6681,3318,3363,98.7
11250, 강동구,040003, 37세,2021,6995,3498,3497,100,6854,3433,3421,100.4
11250, 강동구,040004, 38세,2021,7518,3798,3720,102.1,7413,3747,3666,102.2
11250, 강동구,040005, 39세,2021,7990,3870,4120,93.9,7858,3814,4044,94.3
11250, 강동구,045,40~44세,2021,37290,18631,18659,99.8,36789,18376,18413,99.8
11250, 강동구,045001, 40세,2021,8117,4085,4032,101.3,8016,4035,3981,101.4
11250, 강동구,045002, 41세,2021,7943,4003,3940,101.6,7836,3948,3888,101.5
11250, 강동구,045003, 42세,2021,7684,3760,3924,95.8,7584,3709,3875,95.7
11250, 강동구,045004, 43세,2021,6801,3405,3396,100.3,6692,3344,3348,99.9
11250, 강동구,045005, 44세,2021,6745,3378,3367,100.3,6661,3340,3321,100.6
11250, 강동구,050,45~49세,2021,34952,17487,17465,100.1,34421,17247,17174,100.4
11250, 강동구,050001, 45세,2021,6552,3360,3192,105.3,6449,3319,3130,106
11250, 강동구,050002, 46세,2021,6712,3381,3331,101.5,6618,3336,3282,101.6
11250, 강동구,050003, 47세,2021,7123,3569,3554,100.4,7037,3527,3510,100.5
11250, 강동구,050004, 48세,2021,7231,3517,3714,94.7,7104,3459,3645,94.9
11250, 강동구,050005, 49세,2021,7334,3660,3674,99.6,7213,3606,3607,100
11250, 강동구,055,50~54세,2021,36154,17570,18584,94.5,35494,17259,18235,94.6
11250, 강동구,055001, 50세,2021,7626,3852,3774,102.1,7474,3780,3694,102.3
11250, 강동구,055002, 51세,2021,7308,3534,3774,93.6,7169,3469,3700,93.8
11250, 강동구,055003, 52세,2021,7247,3550,3697,96,7116,3486,3630,96
11250, 강동구,055004, 53세,2021,7405,3544,3861,91.8,7281,3484,3797,91.8
11250, 강동구,055005, 54세,2021,6568,3090,3478,88.8,6454,3040,3414,89
11250, 강동구,060,55~59세,2021,34086,16506,17580,93.9,33379,16198,17181,94.3
11250, 강동구,060001, 55세,2021,6521,3251,3270,99.4,6386,3200,3186,100.4
11250, 강동구,060002, 56세,2021,6759,3260,3499,93.2,6619,3196,3423,93.4
11250, 강동구,060003, 57세,2021,6587,3111,3476,89.5,6455,3052,3403,89.7
11250, 강동구,060004, 58세,2021,7029,3426,3603,95.1,6859,3348,3511,95.4
11250, 강동구,060005, 59세,2021,7190,3458,3732,92.7,7060,3402,3658,93
11250, 강동구,065,60~64세,2021,36876,17261,19615,88,36262,16990,19272,88.2
11250, 강동구,065001, 60세,2021,7743,3583,4160,86.1,7644,3550,4094,86.7
11250, 강동구,065002, 61세,2021,8043,3731,4312,86.5,7895,3663,4232,86.6
11250, 강동구,065003, 62세,2021,7366,3429,3937,87.1,7248,3375,3873,87.1
11250, 강동구,065004, 63세,2021,6817,3255,3562,91.4,6685,3191,3494,91.3
11250, 강동구,065005, 64세,2021,6907,3263,3644,89.5,6790,3211,3579,89.7
11250, 강동구,070,65~69세,2021,28764,13503,15261,88.5,28362,13314,15048,88.5
11250, 강동구,070001, 65세,2021,6391,2948,3443,85.6,6287,2899,3388,85.6
11250, 강동구,070002, 66세,2021,6690,3102,3588,86.5,6587,3059,3528,86.7
11250, 강동구,070003, 67세,2021,5519,2573,2946,87.3,5452,2543,2909,87.4
11250, 강동구,070004, 68세,2021,4891,2352,2539,92.6,4821,2315,2506,92.4
11250, 강동구,070005, 69세,2021,5273,2528,2745,92.1,5215,2498,2717,91.9
11250, 강동구,075,70~74세,2021,18806,9054,9752,92.8,18672,9004,9668,93.1
11250, 강동구,075001, 70세,2021,3541,1720,1821,94.5,3501,1697,1804,94.1
11250, 강동구,075002, 71세,2021,3881,1859,2022,91.9,3855,1852,2003,92.5
11250, 강동구,075003, 72세,2021,3937,1891,2046,92.4,3913,1885,2028,92.9
11250, 강동구,075004, 73세,2021,3838,1888,1950,96.8,3811,1880,1931,97.4
11250, 강동구,075005, 74세,2021,3609,1696,1913,88.7,3592,1690,1902,88.9
11250, 강동구,080,75~79세,2021,12355,5967,6388,93.4,12304,5951,6353,93.7
11250, 강동구,080001, 75세,2021,2702,1340,1362,98.4,2682,1333,1349,98.8
11250, 강동구,080002, 76세,2021,2517,1236,1281,96.5,2511,1233,1278,96.5
11250, 강동구,080003, 77세,2021,2382,1141,1241,91.9,2375,1139,1236,92.2
11250, 강동구,080004, 78세,2021,2285,1092,1193,91.5,2274,1089,1185,91.9
11250, 강동구,080005, 79세,2021,2469,1158,1311,88.3,2462,1157,1305,88.7
11250, 강동구,085,80~84세,2021,7332,3131,4201,74.5,7297,3121,4176,74.7
11250, 강동구,085001, 80세,2021,1912,907,1005,90.2,1905,904,1001,90.3
11250, 강동구,085002, 81세,2021,1538,693,845,82,1529,690,839,82.2
11250, 강동구,085003, 82세,2021,1512,613,899,68.2,1501,610,891,68.5
11250, 강동구,085004, 83세,2021,1295,520,775,67.1,1289,519,770,67.4
11250, 강동구,085005, 84세,2021,1075,398,677,58.8,1073,398,675,59
11250, 강동구,090,85~89세,2021,3645,1181,2464,47.9,3635,1179,2456,48
11250, 강동구,090001, 85세,2021,941,343,598,57.4,938,342,596,57.4
11250, 강동구,090002, 86세,2021,907,280,627,44.7,906,280,626,44.7
11250, 강동구,090003, 87세,2021,705,217,488,44.5,703,217,486,44.7
11250, 강동구,090004, 88세,2021,592,207,385,53.8,591,206,385,53.5
11250, 강동구,090005, 89세,2021,500,134,366,36.6,497,134,363,36.9
11250, 강동구,095,90~94세,2021,1385,326,1059,30.8,1383,324,1059,30.6
11250, 강동구,095001, 90세,2021,362,92,270,34.1,361,91,270,33.7
11250, 강동구,095002, 91세,2021,352,96,256,37.5,351,95,256,37.1
11250, 강동구,095003, 92세,2021,293,63,230,27.4,293,63,230,27.4
11250, 강동구,095004, 93세,2021,220,47,173,27.2,220,47,173,27.2
11250, 강동구,095005, 94세,2021,158,28,130,21.5,158,28,130,21.5
11250, 강동구,100,95~99세,2021,299,56,243,23,297,55,242,22.7
11250, 강동구,100001, 95세,2021,110,23,87,26.4,109,23,86,26.7
11250, 강동구,100002, 96세,2021,70,12,58,20.7,70,12,58,20.7
11250, 강동구,100003, 97세,2021,49,6,43,14,49,6,43,14
11250, 강동구,100004, 98세,2021,40,11,29,37.9,39,10,29,34.5
11250, 강동구,100005, 99세,2021,30,X,26,15.4,30,X,26,15.4
11250, 강동구,101,100세이상,2021,65,13,52,25,64,13,51,25.5
11250, 강동구,102,15세미만,2021,53009,27781,25228,110.1,52732,27639,25093,110.1
11250, 강동구,103,15~64세,2021,325439,159904,165535,96.6,320053,157491,162562,96.9
11250, 강동구,104,65세이상,2021,72651,33231,39420,84.3,72014,32961,39053,84.4
11250, 강동구,086,85세이상,2021,5394,1576,3818,41.3,5379,1571,3808,41.3
11250, 강동구,126,평균연령,2021,43,42.2,43.9,,43,42.2,43.9,
11250, 강동구,127,중위연령,2021,43.4,42.6,44.3,,43.4,42.5,44.3,
21,부산광역시,000,합계,2021,3324335,1624745,1699590,95.6,3271001,1596087,1674914,95.3
21,부산광역시,005,0~4세,2021,89025,45642,43383,105.2,88406,45331,43075,105.2
21,부산광역시,005001, 0세,2021,14691,7583,7108,106.7,14601,7537,7064,106.7
21,부산광역시,005002, 1세,2021,15806,8175,7631,107.1,15672,8106,7566,107.1
21,부산광역시,005003, 2세,2021,17336,8791,8545,102.9,17226,8727,8499,102.7
21,부산광역시,005004, 3세,2021,19531,10012,9519,105.2,19390,9943,9447,105.3
21,부산광역시,005005, 4세,2021,21661,11081,10580,104.7,21517,11018,10499,104.9
21,부산광역시,010,5~9세,2021,129223,66301,62922,105.4,128575,66002,62573,105.5
21,부산광역시,010001, 5세,2021,24649,12577,12072,104.2,24467,12487,11980,104.2
21,부산광역시,010002, 6세,2021,25905,13288,12617,105.3,25752,13226,12526,105.6
21,부산광역시,010003, 7세,2021,25513,13127,12386,106,25399,13067,12332,106
21,부산광역시,010004, 8세,2021,25495,13065,12430,105.1,25400,13025,12375,105.3
21,부산광역시,010005, 9세,2021,27661,14244,13417,106.2,27557,14197,13360,106.3
21,부산광역시,015,10~14세,2021,129029,66262,62767,105.6,128694,66093,62601,105.6
21,부산광역시,015001, 10세,2021,27129,13797,13332,103.5,27069,13766,13303,103.5
21,부산광역시,015002, 11세,2021,25626,13250,12376,107.1,25552,13215,12337,107.1
21,부산광역시,015003, 12세,2021,24403,12583,11820,106.5,24339,12549,11790,106.4
21,부산광역시,015004, 13세,2021,25653,13183,12470,105.7,25583,13148,12435,105.7
21,부산광역시,015005, 14세,2021,26218,13449,12769,105.3,26151,13415,12736,105.3
21,부산광역시,020,15~19세,2021,133751,69252,64499,107.4,132658,68801,63857,107.7
21,부산광역시,020001, 15세,2021,24068,12453,11615,107.2,23999,12423,11576,107.3
21,부산광역시,020002, 16세,2021,24030,12451,11579,107.5,23934,12405,11529,107.6
21,부산광역시,020003, 17세,2021,26384,13707,12677,108.1,26294,13658,12636,108.1
21,부산광역시,020004, 18세,2021,28063,14674,13389,109.6,27866,14599,13267,110
21,부산광역시,020005, 19세,2021,31206,15967,15239,104.8,30565,15716,14849,105.8
21,부산광역시,025,20~24세,2021,208829,107261,101568,105.6,199849,102976,96873,106.3
21,부산광역시,025001, 20세,2021,36556,18417,18139,101.5,35304,17934,17370,103.2
21,부산광역시,025002, 21세,2021,41578,20825,20753,100.3,39932,20121,19811,101.6
21,부산광역시,025003, 22세,2021,41804,21692,20112,107.9,39863,20724,19139,108.3
21,부산광역시,025004, 23세,2021,44138,23029,21109,109.1,42024,21936,20088,109.2
21,부산광역시,025005, 24세,2021,44753,23298,21455,108.6,42726,22261,20465,108.8
21,부산광역시,030,25~29세,2021,225547,118753,106794,111.2,216226,113654,102572,110.8
21,부산광역시,030001, 25세,2021,45983,24427,21556,113.3,43993,23380,20613,113.4
21,부산광역시,030002, 26세,2021,44797,23613,21184,111.5,42920,22608,20312,111.3
21,부산광역시,030003, 27세,2021,45064,23628,21436,110.2,43228,22621,20607,109.8
21,부산광역시,030004, 28세,2021,44735,23654,21081,112.2,42871,22590,20281,111.4
21,부산광역시,030005, 29세,2021,44968,23431,21537,108.8,43214,22455,20759,108.2
21,부산광역시,035,30~34세,2021,195096,101304,93792,108,186247,96125,90122,106.7
21,부산광역시,035001, 30세,2021,41738,21802,19936,109.4,39967,20796,19171,108.5
21,부산광역시,035002, 31세,2021,40029,20894,19135,109.2,38179,19825,18354,108
21,부산광역시,035003, 32세,2021,38918,20306,18612,109.1,37160,19254,17906,107.5
21,부산광역시,035004, 33세,2021,37165,19200,17965,106.9,35428,18180,17248,105.4
21,부산광역시,035005, 34세,2021,37246,19102,18144,105.3,35513,18070,17443,103.6
21,부산광역시,040,35~39세,2021,212116,108897,103219,105.5,204935,104626,100309,104.3
21,부산광역시,040001, 35세,2021,37553,19568,17985,108.8,35958,18637,17321,107.6
21,부산광역시,040002, 36세,2021,38365,19787,18578,106.5,36899,18903,17996,105
21,부산광역시,040003, 37세,2021,40753,20910,19843,105.4,39293,20035,19258,104
21,부산광역시,040004, 38세,2021,45538,23163,22375,103.5,44193,22369,21824,102.5
21,부산광역시,040005, 39세,2021,49907,25469,24438,104.2,48592,24682,23910,103.2
21,부산광역시,045,40~44세,2021,243155,123791,119364,103.7,238335,120956,117379,103
21,부산광역시,045001, 40세,2021,51153,26158,24995,104.7,50060,25499,24561,103.8
21,부산광역시,045002, 41세,2021,52711,26858,25853,103.9,51718,26283,25435,103.3
21,부산광역시,045003, 42세,2021,49422,24943,24479,101.9,48431,24356,24075,101.2
21,부산광역시,045004, 43세,2021,44847,22966,21881,105,43950,22453,21497,104.4
21,부산광역시,045005, 44세,2021,45022,22866,22156,103.2,44176,22365,21811,102.5
21,부산광역시,050,45~49세,2021,246880,123585,123295,100.2,243304,121644,121660,100
21,부산광역시,050001, 45세,2021,43521,21996,21525,102.2,42747,21590,21157,102
21,부산광역시,050002, 46세,2021,47137,23590,23547,100.2,46388,23186,23202,99.9
21,부산광역시,050003, 47세,2021,51314,25790,25524,101,50597,25398,25199,100.8
21,부산광역시,050004, 48세,2021,52099,25751,26348,97.7,51378,25359,26019,97.5
21,부산광역시,050005, 49세,2021,52809,26458,26351,100.4,52194,26111,26083,100.1
21,부산광역시,055,50~54세,2021,275962,133756,142206,94.1,273058,132276,140782,94
21,부산광역시,055001, 50세,2021,55831,27433,28398,96.6,55168,27064,28104,96.3
21,부산광역시,055002, 51세,2021,55341,27139,28202,96.2,54681,26808,27873,96.2
21,부산광역시,055003, 52세,2021,55498,26908,28590,94.1,54903,26611,28292,94.1
21,부산광역시,055004, 53세,2021,56425,27225,29200,93.2,55895,26974,28921,93.3
21,부산광역시,055005, 54세,2021,52867,25051,27816,90.1,52411,24819,27592,89.9
21,부산광역시,060,55~59세,2021,266432,128220,138212,92.8,264353,127209,137144,92.8
21,부산광역시,060001, 55세,2021,51640,25363,26277,96.5,51172,25128,26044,96.5
21,부산광역시,060002, 56세,2021,52257,24762,27495,90.1,51832,24557,27275,90
21,부산광역시,060003, 57세,2021,49479,23826,25653,92.9,49084,23640,25444,92.9
21,부산광역시,060004, 58세,2021,55184,26599,28585,93.1,54765,26386,28379,93
21,부산광역시,060005, 59세,2021,57872,27670,30202,91.6,57500,27498,30002,91.7
21,부산광역시,065,60~64세,2021,299182,140499,158683,88.5,297782,139857,157925,88.6
21,부산광역시,065001, 60세,2021,63903,29801,34102,87.4,63641,29677,33964,87.4
21,부산광역시,065002, 61세,2021,64228,29866,34362,86.9,63890,29716,34174,87
21,부산광역시,065003, 62세,2021,58385,27535,30850,89.3,58134,27423,30711,89.3
21,부산광역시,065004, 63세,2021,55886,26484,29402,90.1,55597,26354,29243,90.1
21,부산광역시,065005, 64세,2021,56780,26813,29967,89.5,56520,26687,29833,89.5
21,부산광역시,070,65~69세,2021,238468,111574,126894,87.9,237629,111185,126444,87.9
21,부산광역시,070001, 65세,2021,52485,24653,27832,88.6,52280,24555,27725,88.6
21,부산광역시,070002, 66세,2021,55328,25543,29785,85.8,55152,25467,29685,85.8
21,부산광역시,070003, 67세,2021,45806,22021,23785,92.6,45622,21932,23690,92.6
21,부산광역시,070004, 68세,2021,40969,18882,22087,85.5,40821,18814,22007,85.5
21,부산광역시,070005, 69세,2021,43880,20475,23405,87.5,43754,20417,23337,87.5
21,부산광역시,075,70~74세,2021,172378,78884,93494,84.4,172003,78717,93286,84.4
21,부산광역시,075001, 70세,2021,34880,16162,18718,86.3,34781,16114,18667,86.3
21,부산광역시,075002, 71세,2021,35069,16230,18839,86.2,34978,16196,18782,86.2
21,부산광역시,075003, 72세,2021,35767,16295,19472,83.7,35685,16256,19429,83.7
21,부산광역시,075004, 73세,2021,34253,15615,18638,83.8,34202,15592,18610,83.8
21,부산광역시,075005, 74세,2021,32409,14582,17827,81.8,32357,14559,17798,81.8
21,부산광역시,080,75~79세,2021,121326,53545,67781,79,121173,53467,67706,79
21,부산광역시,080001, 75세,2021,23905,10992,12913,85.1,23868,10972,12896,85.1
21,부산광역시,080002, 76세,2021,23338,10448,12890,81.1,23307,10431,12876,81
21,부산광역시,080003, 77세,2021,24057,10624,13433,79.1,24032,10612,13420,79.1
21,부산광역시,080004, 78세,2021,24210,10546,13664,77.2,24186,10536,13650,77.2
21,부산광역시,080005, 79세,2021,25816,10935,14881,73.5,25780,10916,14864,73.4
21,부산광역시,085,80~84세,2021,83456,32240,51216,62.9,83352,32206,51146,63
21,부산광역시,085001, 80세,2021,20885,8520,12365,68.9,20858,8510,12348,68.9
21,부산광역시,085002, 81세,2021,18502,7313,11189,65.4,18474,7307,11167,65.4
21,부산광역시,085003, 82세,2021,17338,6653,10685,62.3,17320,6645,10675,62.2
21,부산광역시,085004, 83세,2021,14110,5263,8847,59.5,14096,5259,8837,59.5
21,부산광역시,085005, 84세,2021,12621,4491,8130,55.2,12604,4485,8119,55.2
21,부산광역시,090,85~89세,2021,38874,11789,27085,43.5,38839,11780,27059,43.5
21,부산광역시,090001, 85세,2021,10654,3574,7080,50.5,10643,3570,7073,50.5
21,부산광역시,090002, 86세,2021,9479,2902,6577,44.1,9475,2902,6573,44.2
21,부산광역시,090003, 87세,2021,7669,2287,5382,42.5,7662,2286,5376,42.5
21,부산광역시,090004, 88세,2021,5989,1723,4266,40.4,5981,1722,4259,40.4
21,부산광역시,090005, 89세,2021,5083,1303,3780,34.5,5078,1300,3778,34.4
21,부산광역시,095,90~94세,2021,12756,2721,10035,27.1,12745,2716,10029,27.1
21,부산광역시,095001, 90세,2021,3713,890,2823,31.5,3710,889,2821,31.5
21,부산광역시,095002, 91세,2021,3003,644,2359,27.3,3000,642,2358,27.2
21,부산광역시,095003, 92세,2021,2591,574,2017,28.5,2589,573,2016,28.4
21,부산광역시,095004, 93세,2021,2003,369,1634,22.6,2001,369,1632,22.6
21,부산광역시,095005, 94세,2021,1446,244,1202,20.3,1445,243,1202,20.2
21,부산광역시,100,95~99세,2021,2513,421,2092,20.1,2503,419,2084,20.1
21,부산광역시,100001, 95세,2021,836,141,695,20.3,833,140,693,20.2
21,부산광역시,100002, 96세,2021,672,99,573,17.3,670,98,572,17.1
21,부산광역시,100003, 97세,2021,415,71,344,20.6,415,71,344,20.6
21,부산광역시,100004, 98세,2021,349,56,293,19.1,345,56,289,19.4
21,부산광역시,100005, 99세,2021,241,54,187,28.9,240,54,186,29
21,부산광역시,101,100세이상,2021,337,48,289,16.6,335,47,288,16.3
21,부산광역시,102,15세미만,2021,347277,178205,169072,105.4,345675,177426,168249,105.5
21,부산광역시,103,15~64세,2021,2306950,1155318,1151632,100.3,2256747,1128124,1128623,100
21,부산광역시,104,65세이상,2021,670108,291222,378886,76.9,668579,290537,378042,76.9
21,부산광역시,086,85세이상,2021,54480,14979,39501,37.9,54422,14962,39460,37.9
21,부산광역시,126,평균연령,2021,45.3,43.9,46.6,,45.5,44.1,46.8,
21,부산광역시,127,중위연령,2021,47.1,45.2,48.8,,47.4,45.6,49.1,
21004, 읍부,000,합계,2021,142497,70424,72073,97.7,140263,68954,71309,96.7
21004, 읍부,005,0~4세,2021,5632,2913,2719,107.1,5617,2902,2715,106.9
21004, 읍부,005001, 0세,2021,803,419,384,109.1,801,418,383,109.1
21004, 읍부,005002, 1세,2021,1004,517,487,106.2,1003,516,487,106
21004, 읍부,005003, 2세,2021,1065,560,505,110.9,1058,554,504,109.9
21004, 읍부,005004, 3세,2021,1273,628,645,97.4,1270,625,645,96.9
21004, 읍부,005005, 4세,2021,1487,789,698,113,1485,789,696,113.4
21004, 읍부,010,5~9세,2021,9106,4656,4450,104.6,9084,4646,4438,104.7
21004, 읍부,010001, 5세,2021,1703,841,862,97.6,1702,840,862,97.4
21004, 읍부,010002, 6세,2021,1824,916,908,100.9,1819,913,906,100.8
21004, 읍부,010003, 7세,2021,1812,943,869,108.5,1807,942,865,108.9
21004, 읍부,010004, 8세,2021,1803,925,878,105.4,1799,924,875,105.6
21004, 읍부,010005, 9세,2021,1964,1031,933,110.5,1957,1027,930,110.4
21004, 읍부,015,10~14세,2021,8458,4370,4088,106.9,8453,4368,4085,106.9
21004, 읍부,015001, 10세,2021,1917,965,952,101.4,1916,964,952,101.3
21004, 읍부,015002, 11세,2021,1702,874,828,105.6,1702,874,828,105.6
21004, 읍부,015003, 12세,2021,1575,820,755,108.6,1572,819,753,108.8
21004, 읍부,015004, 13세,2021,1623,875,748,117,1622,875,747,117.1
21004, 읍부,015005, 14세,2021,1641,836,805,103.9,1641,836,805,103.9
21004, 읍부,020,15~19세,2021,6753,3539,3214,110.1,6743,3534,3209,110.1
21004, 읍부,020001, 15세,2021,1389,719,670,107.3,1386,716,670,106.9
21004, 읍부,020002, 16세,2021,1356,720,636,113.2,1354,720,634,113.6
21004, 읍부,020003, 17세,2021,1457,757,700,108.1,1457,757,700,108.1
21004, 읍부,020004, 18세,2021,1422,738,684,107.9,1418,736,682,107.9
21004, 읍부,020005, 19세,2021,1129,605,524,115.5,1128,605,523,115.7
21004, 읍부,025,20~24세,2021,6135,3253,2882,112.9,5989,3158,2831,111.6
21004, 읍부,025001, 20세,2021,1180,695,485,143.3,1167,688,479,143.6
21004, 읍부,025002, 21세,2021,1217,641,576,111.3,1204,632,572,110.5
21004, 읍부,025003, 22세,2021,1218,619,599,103.3,1188,599,589,101.7
21004, 읍부,025004, 23세,2021,1194,610,584,104.5,1152,580,572,101.4
21004, 읍부,025005, 24세,2021,1326,688,638,107.8,1278,659,619,106.5
21004, 읍부,030,25~29세,2021,7282,3902,3380,115.4,6875,3622,3253,111.3
21004, 읍부,030001, 25세,2021,1372,729,643,113.4,1305,687,618,111.2
21004, 읍부,030002, 26세,2021,1466,780,686,113.7,1393,728,665,109.5
21004, 읍부,030003, 27세,2021,1417,770,647,119,1341,718,623,115.2
21004, 읍부,030004, 28세,2021,1498,782,716,109.2,1403,718,685,104.8
21004, 읍부,030005, 29세,2021,1529,841,688,122.2,1433,771,662,116.5
21004, 읍부,035,30~34세,2021,8169,4261,3908,109,7674,3905,3769,103.6
21004, 읍부,035001, 30세,2021,1633,877,756,116,1532,802,730,109.9
21004, 읍부,035002, 31세,2021,1564,842,722,116.6,1463,778,685,113.6
21004, 읍부,035003, 32세,2021,1547,825,722,114.3,1463,758,705,107.5
21004, 읍부,035004, 33세,2021,1689,856,833,102.8,1572,766,806,95
21004, 읍부,035005, 34세,2021,1736,861,875,98.4,1644,801,843,95
21004, 읍부,040,35~39세,2021,11340,5607,5733,97.8,10907,5313,5594,95
21004, 읍부,040001, 35세,2021,1803,887,916,96.8,1711,822,889,92.5
21004, 읍부,040002, 36세,2021,1959,997,962,103.6,1868,934,934,100
21004, 읍부,040003, 37세,2021,2232,1096,1136,96.5,2133,1026,1107,92.7
21004, 읍부,040004, 38세,2021,2467,1196,1271,94.1,2386,1143,1243,92
21004, 읍부,040005, 39세,2021,2879,1431,1448,98.8,2809,1388,1421,97.7
21004, 읍부,045,40~44세,2021,14632,7371,7261,101.5,14394,7215,7179,100.5
21004, 읍부,045001, 40세,2021,3039,1511,1528,98.9,2961,1458,1503,97
21004, 읍부,045002, 41세,2021,3223,1601,1622,98.7,3180,1571,1609,97.6
21004, 읍부,045003, 42세,2021,2986,1522,1464,104,2942,1494,1448,103.2
21004, 읍부,045004, 43세,2021,2693,1355,1338,101.3,2657,1332,1325,100.5
21004, 읍부,045005, 44세,2021,2691,1382,1309,105.6,2654,1360,1294,105.1
21004, 읍부,050,45~49세,2021,12844,6591,6253,105.4,12686,6495,6191,104.9
21004, 읍부,050001, 45세,2021,2517,1279,1238,103.3,2486,1257,1229,102.3
21004, 읍부,050002, 46세,2021,2622,1343,1279,105,2590,1326,1264,104.9
21004, 읍부,050003, 47세,2021,2664,1364,1300,104.9,2631,1345,1286,104.6
21004, 읍부,050004, 48세,2021,2541,1286,1255,102.5,2503,1264,1239,102
21004, 읍부,050005, 49세,2021,2500,1319,1181,111.7,2476,1303,1173,111.1
21004, 읍부,055,50~54세,2021,10862,5591,5271,106.1,10726,5515,5211,105.8
21004, 읍부,055001, 50세,2021,2470,1326,1144,115.9,2430,1299,1131,114.9
21004, 읍부,055002, 51세,2021,2281,1190,1091,109.1,2255,1179,1076,109.6
21004, 읍부,055003, 52세,2021,2190,1106,1084,102,2159,1092,1067,102.3
21004, 읍부,055004, 53세,2021,2013,989,1024,96.6,1987,973,1014,96
21004, 읍부,055005, 54세,2021,1908,980,928,105.6,1895,972,923,105.3
21004, 읍부,060,55~59세,2021,8744,4372,4372,100,8677,4330,4347,99.6
21004, 읍부,060001, 55세,2021,1784,949,835,113.7,1765,939,826,113.7
21004, 읍부,060002, 56세,2021,1740,832,908,91.6,1727,824,903,91.3
21004, 읍부,060003, 57세,2021,1632,849,783,108.4,1618,837,781,107.2
21004, 읍부,060004, 58세,2021,1729,840,889,94.5,1717,835,882,94.7
21004, 읍부,060005, 59세,2021,1859,902,957,94.3,1850,895,955,93.7
21004, 읍부,065,60~64세,2021,9364,4325,5039,85.8,9316,4302,5014,85.8
21004, 읍부,065001, 60세,2021,1867,894,973,91.9,1861,890,971,91.7
21004, 읍부,065002, 61세,2021,2008,928,1080,85.9,1997,922,1075,85.8
21004, 읍부,065003, 62세,2021,1914,903,1011,89.3,1902,899,1003,89.6
21004, 읍부,065004, 63세,2021,1727,788,939,83.9,1714,780,934,83.5
21004, 읍부,065005, 64세,2021,1848,812,1036,78.4,1842,811,1031,78.7
21004, 읍부,070,65~69세,2021,7791,3494,4297,81.3,7766,3484,4282,81.4
21004, 읍부,070001, 65세,2021,1675,750,925,81.1,1664,746,918,81.3
21004, 읍부,070002, 66세,2021,1766,795,971,81.9,1761,794,967,82.1
21004, 읍부,070003, 67세,2021,1522,697,825,84.5,1519,694,825,84.1
21004, 읍부,070004, 68세,2021,1366,593,773,76.7,1362,592,770,76.9
21004, 읍부,070005, 69세,2021,1462,659,803,82.1,1460,658,802,82
21004, 읍부,075,70~74세,2021,5867,2676,3191,83.9,5848,2669,3179,84
21004, 읍부,075001, 70세,2021,1212,592,620,95.5,1207,589,618,95.3
21004, 읍부,075002, 71세,2021,1145,500,645,77.5,1141,499,642,77.7
21004, 읍부,075003, 72세,2021,1188,521,667,78.1,1183,520,663,78.4
21004, 읍부,075004, 73세,2021,1192,545,647,84.2,1190,544,646,84.2
21004, 읍부,075005, 74세,2021,1130,518,612,84.6,1127,517,610,84.8
21004, 읍부,080,75~79세,2021,4322,1857,2465,75.3,4315,1851,2464,75.1
21004, 읍부,080001, 75세,2021,877,374,503,74.4,873,370,503,73.6
21004, 읍부,080002, 76세,2021,838,353,485,72.8,837,352,485,72.6
21004, 읍부,080003, 77세,2021,888,381,507,75.1,887,381,506,75.3
21004, 읍부,080004, 78세,2021,824,361,463,78,823,360,463,77.8
21004, 읍부,080005, 79세,2021,895,388,507,76.5,895,388,507,76.5
21004, 읍부,085,80~84세,2021,2987,1086,1901,57.1,2986,1086,1900,57.2
21004, 읍부,085001, 80세,2021,690,278,412,67.5,690,278,412,67.5
21004, 읍부,085002, 81세,2021,664,246,418,58.9,663,246,417,59
21004, 읍부,085003, 82세,2021,649,228,421,54.2,649,228,421,54.2
21004, 읍부,085004, 83세,2021,525,185,340,54.4,525,185,340,54.4
21004, 읍부,085005, 84세,2021,459,149,310,48.1,459,149,310,48.1
21004, 읍부,090,85~89세,2021,1521,432,1089,39.7,1521,432,1089,39.7
21004, 읍부,090001, 85세,2021,405,116,289,40.1,405,116,289,40.1
21004, 읍부,090002, 86세,2021,355,114,241,47.3,355,114,241,47.3
21004, 읍부,090003, 87세,2021,301,79,222,35.6,301,79,222,35.6
21004, 읍부,090004, 88세,2021,247,69,178,38.8,247,69,178,38.8
21004, 읍부,090005, 89세,2021,213,54,159,34,213,54,159,34
21004, 읍부,095,90~94세,2021,531,112,419,26.7,530,112,418,26.8
21004, 읍부,095001, 90세,2021,166,45,121,37.2,166,45,121,37.2
21004, 읍부,095002, 91세,2021,133,28,105,26.7,133,28,105,26.7
21004, 읍부,095003, 92세,2021,90,23,67,34.3,90,23,67,34.3
21004, 읍부,095004, 93세,2021,80,12,68,17.6,79,12,67,17.9
21004, 읍부,095005, 94세,2021,62,X,58,6.9,62,X,58,6.9
21004, 읍부,100,95~99세,2021,133,13,120,10.8,133,13,120,10.8
21004, 읍부,100001, 95세,2021,43,6,37,16.2,43,6,37,16.2
21004, 읍부,100002, 96세,2021,39,X,37,5.4,39,X,37,5.4
21004, 읍부,100003, 97세,2021,22,X,21,4.8,22,X,21,4.8
21004, 읍부,100004, 98세,2021,16,X,14,14.3,16,X,14,14.3
21004, 읍부,100005, 99세,2021,13,X,11,18.2,13,X,11,18.2
21004, 읍부,101,100세이상,2021,24,X,21,14.3,23,X,21,9.5
21004, 읍부,102,15세미만,2021,23196,11939,11257,106.1,23154,11916,11238,106
21004, 읍부,103,15~64세,2021,96125,48812,47313,103.2,93987,47389,46598,101.7
21004, 읍부,104,65세이상,2021,23176,9673,13503,71.6,23122,9649,13473,71.6
21004, 읍부,086,85세이상,2021,2209,560,1649,34,2207,559,1648,33.9
21004, 읍부,126,평균연령,2021,41.8,40.4,43.2,,41.9,40.4,43.2,
21004, 읍부,127,중위연령,2021,42.7,41.7,43.8,,42.9,42,43.9,
21005, 면부,000,합계,2021,30405,15036,15369,97.8,30167,14911,15256,97.7
21005, 면부,005,0~4세,2021,1690,817,873,93.6,1683,817,866,94.3
21005, 면부,005001, 0세,2021,313,159,154,103.2,312,159,153,103.9
21005, 면부,005002, 1세,2021,293,139,154,90.3,292,139,153,90.8
21005, 면부,005003, 2세,2021,341,175,166,105.4,341,175,166,105.4
21005, 면부,005004, 3세,2021,360,169,191,88.5,356,169,187,90.4
21005, 면부,005005, 4세,2021,383,175,208,84.1,382,175,207,84.5
21005, 면부,010,5~9세,2021,1846,925,921,100.4,1841,924,917,100.8
21005, 면부,010001, 5세,2021,404,189,215,87.9,404,189,215,87.9
21005, 면부,010002, 6세,2021,379,197,182,108.2,377,197,180,109.4
21005, 면부,010003, 7세,2021,412,211,201,105,410,210,200,105
21005, 면부,010004, 8세,2021,337,168,169,99.4,337,168,169,99.4
21005, 면부,010005, 9세,2021,314,160,154,103.9,313,160,153,104.6
21005, 면부,015,10~14세,2021,1201,600,601,99.8,1201,600,601,99.8
21005, 면부,015001, 10세,2021,317,160,157,101.9,317,160,157,101.9
21005, 면부,015002, 11세,2021,276,135,141,95.7,276,135,141,95.7
21005, 면부,015003, 12세,2021,209,102,107,95.3,209,102,107,95.3
21005, 면부,015004, 13세,2021,223,107,116,92.2,223,107,116,92.2
21005, 면부,015005, 14세,2021,176,96,80,120,176,96,80,120
21005, 면부,020,15~19세,2021,881,464,417,111.3,881,464,417,111.3
21005, 면부,020001, 15세,2021,200,103,97,106.2,200,103,97,106.2
21005, 면부,020002, 16세,2021,175,88,87,101.1,175,88,87,101.1
21005, 면부,020003, 17세,2021,166,95,71,133.8,166,95,71,133.8
21005, 면부,020004, 18세,2021,166,79,87,90.8,166,79,87,90.8
21005, 면부,020005, 19세,2021,174,99,75,132,174,99,75,132
21005, 면부,025,20~24세,2021,1259,774,485,159.6,1248,767,481,159.5
21005, 면부,025001, 20세,2021,236,156,80,195,234,155,79,196.2
21005, 면부,025002, 21세,2021,259,171,88,194.3,257,170,87,195.4
21005, 면부,025003, 22세,2021,255,154,101,152.5,254,153,101,151.5
21005, 면부,025004, 23세,2021,257,165,92,179.3,255,163,92,177.2
21005, 면부,025005, 24세,2021,252,128,124,103.2,248,126,122,103.3
21005, 면부,030,25~29세,2021,1508,796,712,111.8,1475,781,694,112.5
21005, 면부,030001, 25세,2021,282,148,134,110.4,275,145,130,111.5
21005, 면부,030002, 26세,2021,267,143,124,115.3,264,141,123,114.6
21005, 면부,030003, 27세,2021,278,144,134,107.5,274,143,131,109.2
21005, 면부,030004, 28세,2021,339,189,150,126,325,183,142,128.9
21005, 면부,030005, 29세,2021,342,172,170,101.2,337,169,168,100.6
21005, 면부,035,30~34세,2021,2091,992,1099,90.3,2043,961,1082,88.8
21005, 면부,035001, 30세,2021,368,171,197,86.8,358,165,193,85.5
21005, 면부,035002, 31세,2021,413,205,208,98.6,405,202,203,99.5
21005, 면부,035003, 32세,2021,390,189,201,94,381,183,198,92.4
21005, 면부,035004, 33세,2021,458,215,243,88.5,448,209,239,87.4
21005, 면부,035005, 34세,2021,462,212,250,84.8,451,202,249,81.1
21005, 면부,040,35~39세,2021,2803,1417,1386,102.2,2768,1400,1368,102.3
21005, 면부,040001, 35세,2021,503,239,264,90.5,494,235,259,90.7
21005, 면부,040002, 36세,2021,483,232,251,92.4,476,229,247,92.7
21005, 면부,040003, 37세,2021,553,287,266,107.9,547,284,263,108
21005, 면부,040004, 38세,2021,622,324,298,108.7,617,323,294,109.9
21005, 면부,040005, 39세,2021,642,335,307,109.1,634,329,305,107.9
21005, 면부,045,40~44세,2021,2643,1336,1307,102.2,2612,1316,1296,101.5
21005, 면부,045001, 40세,2021,637,338,299,113,630,332,298,111.4
21005, 면부,045002, 41세,2021,623,325,298,109.1,617,322,295,109.2
21005, 면부,045003, 42세,2021,535,259,276,93.8,527,256,271,94.5
21005, 면부,045004, 43세,2021,445,212,233,91,438,207,231,89.6
21005, 면부,045005, 44세,2021,403,202,201,100.5,400,199,201,99
21005, 면부,050,45~49세,2021,2134,1106,1028,107.6,2120,1098,1022,107.4
21005, 면부,050001, 45세,2021,413,229,184,124.5,412,229,183,125.1
21005, 면부,050002, 46세,2021,413,224,189,118.5,409,223,186,119.9
21005, 면부,050003, 47세,2021,419,216,203,106.4,415,212,203,104.4
21005, 면부,050004, 48세,2021,423,214,209,102.4,419,211,208,101.4
21005, 면부,050005, 49세,2021,466,223,243,91.8,465,223,242,92.1
21005, 면부,055,50~54세,2021,2355,1182,1173,100.8,2337,1173,1164,100.8
21005, 면부,055001, 50세,2021,485,258,227,113.7,479,255,224,113.8
21005, 면부,055002, 51세,2021,480,241,239,100.8,474,238,236,100.8
21005, 면부,055003, 52세,2021,453,229,224,102.2,450,227,223,101.8
21005, 면부,055004, 53세,2021,491,244,247,98.8,489,243,246,98.8
21005, 면부,055005, 54세,2021,446,210,236,89,445,210,235,89.4
21005, 면부,060,55~59세,2021,2292,1098,1194,92,2276,1090,1186,91.9
21005, 면부,060001, 55세,2021,459,223,236,94.5,457,222,235,94.5
21005, 면부,060002, 56세,2021,433,187,246,76,432,186,246,75.6
21005, 면부,060003, 57세,2021,436,210,226,92.9,431,209,222,94.1
21005, 면부,060004, 58세,2021,505,254,251,101.2,501,251,250,100.4
21005, 면부,060005, 59세,2021,459,224,235,95.3,455,222,233,95.3
21005, 면부,065,60~64세,2021,2536,1190,1346,88.4,2528,1187,1341,88.5
21005, 면부,065001, 60세,2021,534,244,290,84.1,533,243,290,83.8
21005, 면부,065002, 61세,2021,539,270,269,100.4,535,269,266,101.1
21005, 면부,065003, 62세,2021,484,213,271,78.6,484,213,271,78.6
21005, 면부,065004, 63세,2021,477,233,244,95.5,476,232,244,95.1
21005, 면부,065005, 64세,2021,502,230,272,84.6,500,230,270,85.2
21005, 면부,070,65~69세,2021,1902,919,983,93.5,1899,919,980,93.8
21005, 면부,070001, 65세,2021,420,198,222,89.2,420,198,222,89.2
21005, 면부,070002, 66세,2021,448,234,214,109.3,446,234,212,110.4
21005, 면부,070003, 67세,2021,362,173,189,91.5,361,173,188,92
21005, 면부,070004, 68세,2021,312,138,174,79.3,312,138,174,79.3
21005, 면부,070005, 69세,2021,360,176,184,95.7,360,176,184,95.7
21005, 면부,075,70~74세,2021,1358,674,684,98.5,1353,669,684,97.8
21005, 면부,075001, 70세,2021,286,132,154,85.7,286,132,154,85.7
21005, 면부,075002, 71세,2021,274,137,137,100,273,136,137,99.3
21005, 면부,075003, 72세,2021,281,144,137,105.1,280,143,137,104.4
21005, 면부,075004, 73세,2021,252,127,125,101.6,251,126,125,100.8
21005, 면부,075005, 74세,2021,265,134,131,102.3,263,132,131,100.8
21005, 면부,080,75~79세,2021,860,403,457,88.2,859,403,456,88.4
21005, 면부,080001, 75세,2021,174,82,92,89.1,174,82,92,89.1
21005, 면부,080002, 76세,2021,174,90,84,107.1,173,90,83,108.4
21005, 면부,080003, 77세,2021,154,83,71,116.9,154,83,71,116.9
21005, 면부,080004, 78세,2021,185,90,95,94.7,185,90,95,94.7
21005, 면부,080005, 79세,2021,173,58,115,50.4,173,58,115,50.4
21005, 면부,085,80~84세,2021,613,234,379,61.7,610,233,377,61.8
21005, 면부,085001, 80세,2021,138,58,80,72.5,136,57,79,72.2
21005, 면부,085002, 81세,2021,144,48,96,50,143,48,95,50.5
21005, 면부,085003, 82세,2021,140,55,85,64.7,140,55,85,64.7
21005, 면부,085004, 83세,2021,107,44,63,69.8,107,44,63,69.8
21005, 면부,085005, 84세,2021,84,29,55,52.7,84,29,55,52.7
21005, 면부,090,85~89세,2021,302,77,225,34.2,302,77,225,34.2
21005, 면부,090001, 85세,2021,72,27,45,60,72,27,45,60
21005, 면부,090002, 86세,2021,71,15,56,26.8,71,15,56,26.8
21005, 면부,090003, 87세,2021,55,10,45,22.2,55,10,45,22.2
21005, 면부,090004, 88세,2021,53,14,39,35.9,53,14,39,35.9
21005, 면부,090005, 89세,2021,51,11,40,27.5,51,11,40,27.5
21005, 면부,095,90~94세,2021,103,30,73,41.1,103,30,73,41.1
21005, 면부,095001, 90세,2021,31,10,21,47.6,31,10,21,47.6
21005, 면부,095002, 91세,2021,26,6,20,30,26,6,20,30
21005, 면부,095003, 92세,2021,16,X,12,33.3,16,X,12,33.3
21005, 면부,095004, 93세,2021,24,7,17,41.2,24,7,17,41.2
21005, 면부,095005, 94세,2021,6,X,X,100,6,X,X,100
21005, 면부,100,95~99세,2021,20,X,18,11.1,20,X,18,11.1
21005, 면부,100001, 95세,2021,5,X,X,25,5,X,X,25
21005, 면부,100002, 96세,2021,X,X,X,0,X,X,X,0
21005, 면부,100003, 97세,2021,6,X,6,0,6,X,6,0
21005, 면부,100004, 98세,2021,X,X,X,0,X,X,X,0
21005, 면부,100005, 99세,2021,5,X,X,25,5,X,X,25
21005, 면부,101,100세이상,2021,8,X,8,0,8,X,8,0
21005, 면부,102,15세미만,2021,4737,2342,2395,97.8,4725,2341,2384,98.2
21005, 면부,103,15~64세,2021,20502,10355,10147,102,20288,10237,10051,101.9
21005, 면부,104,65세이상,2021,5166,2339,2827,82.7,5154,2333,2821,82.7
21005, 면부,086,85세이상,2021,433,109,324,33.6,433,109,324,33.6
21005, 면부,126,평균연령,2021,42.8,41.8,43.7,,42.8,41.8,43.8,
21005, 면부,127,중위연령,2021,43.3,42.3,44.4,,43.4,42.3,44.5,
21003, 동부,000,합계,2021,3151433,1539285,1612148,95.5,3100571,1512222,1588349,95.2
21003, 동부,005,0~4세,2021,81703,41912,39791,105.3,81106,41612,39494,105.4
21003, 동부,005001, 0세,2021,13575,7005,6570,106.6,13488,6960,6528,106.6
21003, 동부,005002, 1세,2021,14509,7519,6990,107.6,14377,7451,6926,107.6
21003, 동부,005003, 2세,2021,15930,8056,7874,102.3,15827,7998,7829,102.2
21003, 동부,005004, 3세,2021,17898,9215,8683,106.1,17764,9149,8615,106.2
21003, 동부,005005, 4세,2021,19791,10117,9674,104.6,19650,10054,9596,104.8
21003, 동부,010,5~9세,2021,118271,60720,57551,105.5,117650,60432,57218,105.6
21003, 동부,010001, 5세,2021,22542,11547,10995,105,22361,11458,10903,105.1
21003, 동부,010002, 6세,2021,23702,12175,11527,105.6,23556,12116,11440,105.9
21003, 동부,010003, 7세,2021,23289,11973,11316,105.8,23182,11915,11267,105.8
21003, 동부,010004, 8세,2021,23355,11972,11383,105.2,23264,11933,11331,105.3
21003, 동부,010005, 9세,2021,25383,13053,12330,105.9,25287,13010,12277,106
21003, 동부,015,10~14세,2021,119370,61292,58078,105.5,119040,61125,57915,105.5
21003, 동부,015001, 10세,2021,24895,12672,12223,103.7,24836,12642,12194,103.7
21003, 동부,015002, 11세,2021,23648,12241,11407,107.3,23574,12206,11368,107.4
21003, 동부,015003, 12세,2021,22619,11661,10958,106.4,22558,11628,10930,106.4
21003, 동부,015004, 13세,2021,23807,12201,11606,105.1,23738,12166,11572,105.1
21003, 동부,015005, 14세,2021,24401,12517,11884,105.3,24334,12483,11851,105.3
21003, 동부,020,15~19세,2021,126117,65249,60868,107.2,125034,64803,60231,107.6
21003, 동부,020001, 15세,2021,22479,11631,10848,107.2,22413,11604,10809,107.4
21003, 동부,020002, 16세,2021,22499,11643,10856,107.2,22405,11597,10808,107.3
21003, 동부,020003, 17세,2021,24761,12855,11906,108,24671,12806,11865,107.9
21003, 동부,020004, 18세,2021,26475,13857,12618,109.8,26282,13784,12498,110.3
21003, 동부,020005, 19세,2021,29903,15263,14640,104.3,29263,15012,14251,105.3
21003, 동부,025,20~24세,2021,201435,103234,98201,105.1,192612,99051,93561,105.9
21003, 동부,025001, 20세,2021,35140,17566,17574,100,33903,17091,16812,101.7
21003, 동부,025002, 21세,2021,40102,20013,20089,99.6,38471,19319,19152,100.9
21003, 동부,025003, 22세,2021,40331,20919,19412,107.8,38421,19972,18449,108.3
21003, 동부,025004, 23세,2021,42687,22254,20433,108.9,40617,21193,19424,109.1
21003, 동부,025005, 24세,2021,43175,22482,20693,108.6,41200,21476,19724,108.9
21003, 동부,030,25~29세,2021,216757,114055,102702,111.1,207876,109251,98625,110.8
21003, 동부,030001, 25세,2021,44329,23550,20779,113.3,42413,22548,19865,113.5
21003, 동부,030002, 26세,2021,43064,22690,20374,111.4,41263,21739,19524,111.3
21003, 동부,030003, 27세,2021,43369,22714,20655,110,41613,21760,19853,109.6
21003, 동부,030004, 28세,2021,42898,22683,20215,112.2,41143,21689,19454,111.5
21003, 동부,030005, 29세,2021,43097,22418,20679,108.4,41444,21515,19929,108
21003, 동부,035,30~34세,2021,184836,96051,88785,108.2,176530,91259,85271,107
21003, 동부,035001, 30세,2021,39737,20754,18983,109.3,38077,19829,18248,108.7
21003, 동부,035002, 31세,2021,38052,19847,18205,109,36311,18845,17466,107.9
21003, 동부,035003, 32세,2021,36981,19292,17689,109.1,35316,18313,17003,107.7
21003, 동부,035004, 33세,2021,35018,18129,16889,107.3,33408,17205,16203,106.2
21003, 동부,035005, 34세,2021,35048,18029,17019,105.9,33418,17067,16351,104.4
21003, 동부,040,35~39세,2021,197973,101873,96100,106,191260,97913,93347,104.9
21003, 동부,040001, 35세,2021,35247,18442,16805,109.7,33753,17580,16173,108.7
21003, 동부,040002, 36세,2021,35923,18558,17365,106.9,34555,17740,16815,105.5
21003, 동부,040003, 37세,2021,37968,19527,18441,105.9,36613,18725,17888,104.7
21003, 동부,040004, 38세,2021,42449,21643,20806,104,41190,20903,20287,103
21003, 동부,040005, 39세,2021,46386,23703,22683,104.5,45149,22965,22184,103.5
21003, 동부,045,40~44세,2021,225880,115084,110796,103.9,221329,112425,108904,103.2
21003, 동부,045001, 40세,2021,47477,24309,23168,104.9,46469,23709,22760,104.2
21003, 동부,045002, 41세,2021,48865,24932,23933,104.2,47921,24390,23531,103.7
21003, 동부,045003, 42세,2021,45901,23162,22739,101.9,44962,22606,22356,101.1
21003, 동부,045004, 43세,2021,41709,21399,20310,105.4,40855,20914,19941,104.9
21003, 동부,045005, 44세,2021,41928,21282,20646,103.1,41122,20806,20316,102.4
21003, 동부,050,45~49세,2021,231902,115888,116014,99.9,228498,114051,114447,99.7
21003, 동부,050001, 45세,2021,40591,20488,20103,101.9,39849,20104,19745,101.8
21003, 동부,050002, 46세,2021,44102,22023,22079,99.7,43389,21637,21752,99.5
21003, 동부,050003, 47세,2021,48231,24210,24021,100.8,47551,23841,23710,100.6
21003, 동부,050004, 48세,2021,49135,24251,24884,97.5,48456,23884,24572,97.2
21003, 동부,050005, 49세,2021,49843,24916,24927,100,49253,24585,24668,99.7
21003, 동부,055,50~54세,2021,262745,126983,135762,93.5,259995,125588,134407,93.4
21003, 동부,055001, 50세,2021,52876,25849,27027,95.6,52259,25510,26749,95.4
21003, 동부,055002, 51세,2021,52580,25708,26872,95.7,51952,25391,26561,95.6
21003, 동부,055003, 52세,2021,52855,25573,27282,93.7,52294,25292,27002,93.7
21003, 동부,055004, 53세,2021,53921,25992,27929,93.1,53419,25758,27661,93.1
21003, 동부,055005, 54세,2021,50513,23861,26652,89.5,50071,23637,26434,89.4
21003, 동부,060,55~59세,2021,255396,122750,132646,92.5,253400,121789,131611,92.5
21003, 동부,060001, 55세,2021,49397,24191,25206,96,48950,23967,24983,95.9
21003, 동부,060002, 56세,2021,50084,23743,26341,90.1,49673,23547,26126,90.1
21003, 동부,060003, 57세,2021,47411,22767,24644,92.4,47035,22594,24441,92.4
21003, 동부,060004, 58세,2021,52950,25505,27445,92.9,52547,25300,27247,92.9
21003, 동부,060005, 59세,2021,55554,26544,29010,91.5,55195,26381,28814,91.6
21003, 동부,065,60~64세,2021,287282,134984,152298,88.6,285938,134368,151570,88.7
21003, 동부,065001, 60세,2021,61502,28663,32839,87.3,61247,28544,32703,87.3
21003, 동부,065002, 61세,2021,61681,28668,33013,86.8,61358,28525,32833,86.9
21003, 동부,065003, 62세,2021,55987,26419,29568,89.3,55748,26311,29437,89.4
21003, 동부,065004, 63세,2021,53682,25463,28219,90.2,53407,25342,28065,90.3
21003, 동부,065005, 64세,2021,54430,25771,28659,89.9,54178,25646,28532,89.9
21003, 동부,070,65~69세,2021,228775,107161,121614,88.1,227964,106782,121182,88.1
21003, 동부,070001, 65세,2021,50390,23705,26685,88.8,50196,23611,26585,88.8
21003, 동부,070002, 66세,2021,53114,24514,28600,85.7,52945,24439,28506,85.7
21003, 동부,070003, 67세,2021,43922,21151,22771,92.9,43742,21065,22677,92.9
21003, 동부,070004, 68세,2021,39291,18151,21140,85.9,39147,18084,21063,85.9
21003, 동부,070005, 69세,2021,42058,19640,22418,87.6,41934,19583,22351,87.6
21003, 동부,075,70~74세,2021,165153,75534,89619,84.3,164802,75379,89423,84.3
21003, 동부,075001, 70세,2021,33382,15438,17944,86,33288,15393,17895,86
21003, 동부,075002, 71세,2021,33650,15593,18057,86.4,33564,15561,18003,86.4
21003, 동부,075003, 72세,2021,34298,15630,18668,83.7,34222,15593,18629,83.7
21003, 동부,075004, 73세,2021,32809,14943,17866,83.6,32761,14922,17839,83.6
21003, 동부,075005, 74세,2021,31014,13930,17084,81.5,30967,13910,17057,81.6
21003, 동부,080,75~79세,2021,116144,51285,64859,79.1,115999,51213,64786,79
21003, 동부,080001, 75세,2021,22854,10536,12318,85.5,22821,10520,12301,85.5
21003, 동부,080002, 76세,2021,22326,10005,12321,81.2,22297,9989,12308,81.2
21003, 동부,080003, 77세,2021,23015,10160,12855,79,22991,10148,12843,79
21003, 동부,080004, 78세,2021,23201,10095,13106,77,23178,10086,13092,77
21003, 동부,080005, 79세,2021,24748,10489,14259,73.6,24712,10470,14242,73.5
21003, 동부,085,80~84세,2021,79856,30920,48936,63.2,79756,30887,48869,63.2
21003, 동부,085001, 80세,2021,20057,8184,11873,68.9,20032,8175,11857,68.9
21003, 동부,085002, 81세,2021,17694,7019,10675,65.8,17668,7013,10655,65.8
21003, 동부,085003, 82세,2021,16549,6370,10179,62.6,16531,6362,10169,62.6
21003, 동부,085004, 83세,2021,13478,5034,8444,59.6,13464,5030,8434,59.6
21003, 동부,085005, 84세,2021,12078,4313,7765,55.5,12061,4307,7754,55.5
21003, 동부,090,85~89세,2021,37051,11280,25771,43.8,37016,11271,25745,43.8
21003, 동부,090001, 85세,2021,10177,3431,6746,50.9,10166,3427,6739,50.9
21003, 동부,090002, 86세,2021,9053,2773,6280,44.2,9049,2773,6276,44.2
21003, 동부,090003, 87세,2021,7313,2198,5115,43,7306,2197,5109,43
21003, 동부,090004, 88세,2021,5689,1640,4049,40.5,5681,1639,4042,40.5
21003, 동부,090005, 89세,2021,4819,1238,3581,34.6,4814,1235,3579,34.5
21003, 동부,095,90~94세,2021,12122,2579,9543,27,12112,2574,9538,27
21003, 동부,095001, 90세,2021,3516,835,2681,31.1,3513,834,2679,31.1
21003, 동부,095002, 91세,2021,2844,610,2234,27.3,2841,608,2233,27.2
21003, 동부,095003, 92세,2021,2485,547,1938,28.2,2483,546,1937,28.2
21003, 동부,095004, 93세,2021,1899,350,1549,22.6,1898,350,1548,22.6
21003, 동부,095005, 94세,2021,1378,237,1141,20.8,1377,236,1141,20.7
21003, 동부,100,95~99세,2021,2360,406,1954,20.8,2350,404,1946,20.8
21003, 동부,100001, 95세,2021,788,134,654,20.5,785,133,652,20.4
21003, 동부,100002, 96세,2021,630,97,533,18.2,628,96,532,18
21003, 동부,100003, 97세,2021,387,70,317,22.1,387,70,317,22.1
21003, 동부,100004, 98세,2021,332,54,278,19.4,328,54,274,19.7
21003, 동부,100005, 99세,2021,223,51,172,29.7,222,51,171,29.8
21003, 동부,101,100세이상,2021,305,45,260,17.3,304,45,259,17.4
21003, 동부,102,15세미만,2021,319344,163924,155420,105.5,317796,163169,154627,105.5
21003, 동부,103,15~64세,2021,2190323,1096151,1094172,100.2,2142472,1070498,1071974,99.9
21003, 동부,104,65세이상,2021,641766,279210,362556,77,640303,278555,361748,77
21003, 동부,086,85세이상,2021,51838,14310,37528,38.1,51782,14294,37488,38.1
21003, 동부,126,평균연령,2021,45.5,44.1,46.8,,45.7,44.3,47,
21003, 동부,127,중위연령,2021,47.4,45.5,49.1,,47.7,45.9,49.4,
21010, 중구,000,합계,2021,41539,20493,21046,97.4,39289,19016,20273,93.8
21010, 중구,005,0~4세,2021,446,238,208,114.4,438,231,207,111.6
21010, 중구,005001, 0세,2021,73,36,37,97.3,70,34,36,94.4
21010, 중구,005002, 1세,2021,80,41,39,105.1,78,39,39,100
21010, 중구,005003, 2세,2021,75,40,35,114.3,74,39,35,111.4
21010, 중구,005004, 3세,2021,96,54,42,128.6,95,53,42,126.2
21010, 중구,005005, 4세,2021,122,67,55,121.8,121,66,55,120
21010, 중구,010,5~9세,2021,698,373,325,114.8,685,362,323,112.1
21010, 중구,010001, 5세,2021,117,67,50,134,113,65,48,135.4
21010, 중구,010002, 6세,2021,137,78,59,132.2,134,75,59,127.1
21010, 중구,010003, 7세,2021,139,72,67,107.5,137,70,67,104.5
21010, 중구,010004, 8세,2021,156,73,83,88,153,70,83,84.3
21010, 중구,010005, 9세,2021,149,83,66,125.8,148,82,66,124.2
21010, 중구,015,10~14세,2021,814,412,402,102.5,801,405,396,102.3
21010, 중구,015001, 10세,2021,168,89,79,112.7,165,87,78,111.5
21010, 중구,015002, 11세,2021,160,76,84,90.5,157,75,82,91.5
21010, 중구,015003, 12세,2021,154,85,69,123.2,153,85,68,125
21010, 중구,015004, 13세,2021,166,91,75,121.3,163,89,74,120.3
21010, 중구,015005, 14세,2021,166,71,95,74.7,163,69,94,73.4
21010, 중구,020,15~19세,2021,1047,509,538,94.6,958,480,478,100.4
21010, 중구,020001, 15세,2021,159,83,76,109.2,156,82,74,110.8
21010, 중구,020002, 16세,2021,181,91,90,101.1,176,89,87,102.3
21010, 중구,020003, 17세,2021,186,85,101,84.2,184,84,100,84
21010, 중구,020004, 18세,2021,232,117,115,101.7,220,114,106,107.5
21010, 중구,020005, 19세,2021,289,133,156,85.3,222,111,111,100
21010, 중구,025,20~24세,2021,2669,1256,1413,88.9,2322,1078,1244,86.7
21010, 중구,025001, 20세,2021,423,216,207,104.3,321,167,154,108.4
21010, 중구,025002, 21세,2021,473,214,259,82.6,408,178,230,77.4
21010, 중구,025003, 22세,2021,519,240,279,86,457,215,242,88.8
21010, 중구,025004, 23세,2021,594,274,320,85.6,535,238,297,80.1
21010, 중구,025005, 24세,2021,660,312,348,89.7,601,280,321,87.2
21010, 중구,030,25~29세,2021,3633,1894,1739,108.9,3261,1650,1611,102.4
21010, 중구,030001, 25세,2021,685,317,368,86.1,622,283,339,83.5
21010, 중구,030002, 26세,2021,708,381,327,116.5,640,338,302,111.9
21010, 중구,030003, 27세,2021,732,362,370,97.8,656,316,340,92.9
21010, 중구,030004, 28세,2021,740,402,338,118.9,655,339,316,107.3
21010, 중구,030005, 29세,2021,768,432,336,128.6,688,374,314,119.1
21010, 중구,035,30~34세,2021,2645,1514,1131,133.9,2292,1243,1049,118.5
21010, 중구,035001, 30세,2021,630,366,264,138.6,555,306,249,122.9
21010, 중구,035002, 31세,2021,566,315,251,125.5,488,255,233,109.4
21010, 중구,035003, 32세,2021,520,296,224,132.1,451,245,206,118.9
21010, 중구,035004, 33세,2021,479,287,192,149.5,404,232,172,134.9
21010, 중구,035005, 34세,2021,450,250,200,125,394,205,189,108.5
21010, 중구,040,35~39세,2021,2315,1357,958,141.6,1969,1081,888,121.7
21010, 중구,040001, 35세,2021,417,252,165,152.7,342,188,154,122.1
21010, 중구,040002, 36세,2021,463,273,190,143.7,395,218,177,123.2
21010, 중구,040003, 37세,2021,425,233,192,121.4,368,187,181,103.3
21010, 중구,040004, 38세,2021,495,282,213,132.4,418,227,191,118.8
21010, 중구,040005, 39세,2021,515,317,198,160.1,446,261,185,141.1
21010, 중구,045,40~44세,2021,2435,1389,1046,132.8,2214,1211,1003,120.7
21010, 중구,045001, 40세,2021,507,293,214,136.9,456,254,202,125.7
21010, 중구,045002, 41세,2021,534,306,228,134.2,493,272,221,123.1
21010, 중구,045003, 42세,2021,477,269,208,129.3,438,237,201,117.9
21010, 중구,045004, 43세,2021,461,263,198,132.8,414,225,189,119
21010, 중구,045005, 44세,2021,456,258,198,130.3,413,223,190,117.4
21010, 중구,050,45~49세,2021,2846,1597,1249,127.9,2666,1469,1197,122.7
21010, 중구,050001, 45세,2021,449,249,200,124.5,406,218,188,116
21010, 중구,050002, 46세,2021,562,321,241,133.2,533,301,232,129.7
21010, 중구,050003, 47세,2021,574,309,265,116.6,533,278,255,109
21010, 중구,050004, 48세,2021,640,361,279,129.4,603,339,264,128.4
21010, 중구,050005, 49세,2021,621,357,264,135.2,591,333,258,129.1
21010, 중구,055,50~54세,2021,3313,1669,1644,101.5,3208,1618,1590,101.8
21010, 중구,055001, 50세,2021,656,332,324,102.5,631,317,314,101
21010, 중구,055002, 51세,2021,670,322,348,92.5,645,311,334,93.1
21010, 중구,055003, 52세,2021,697,375,322,116.5,677,366,311,117.7
21010, 중구,055004, 53세,2021,669,333,336,99.1,645,322,323,99.7
21010, 중구,055005, 54세,2021,621,307,314,97.8,610,302,308,98.1
21010, 중구,060,55~59세,2021,3354,1676,1678,99.9,3270,1635,1635,100
21010, 중구,060001, 55세,2021,649,345,304,113.5,632,332,300,110.7
21010, 중구,060002, 56세,2021,619,283,336,84.2,606,276,330,83.6
21010, 중구,060003, 57세,2021,584,305,279,109.3,566,297,269,110.4
21010, 중구,060004, 58세,2021,722,361,361,100,701,355,346,102.6
21010, 중구,060005, 59세,2021,780,382,398,96,765,375,390,96.2
21010, 중구,065,60~64세,2021,4187,1957,2230,87.8,4138,1937,2201,88
21010, 중구,065001, 60세,2021,813,351,462,76,808,350,458,76.4
21010, 중구,065002, 61세,2021,858,423,435,97.2,849,419,430,97.4
21010, 중구,065003, 62세,2021,797,379,418,90.7,783,374,409,91.4
21010, 중구,065004, 63세,2021,853,407,446,91.3,843,402,441,91.2
21010, 중구,065005, 64세,2021,866,397,469,84.6,855,392,463,84.7
21010, 중구,070,65~69세,2021,3621,1705,1916,89,3586,1685,1901,88.6
21010, 중구,070001, 65세,2021,742,348,394,88.3,735,345,390,88.5
21010, 중구,070002, 66세,2021,881,415,466,89.1,875,412,463,89
21010, 중구,070003, 67세,2021,696,346,350,98.9,687,342,345,99.1
21010, 중구,070004, 68세,2021,630,277,353,78.5,622,271,351,77.2
21010, 중구,070005, 69세,2021,672,319,353,90.4,667,315,352,89.5
21010, 중구,075,70~74세,2021,2789,1180,1609,73.3,2773,1174,1599,73.4
21010, 중구,075001, 70세,2021,547,238,309,77,543,234,309,75.7
21010, 중구,075002, 71세,2021,587,258,329,78.4,584,257,327,78.6
21010, 중구,075003, 72세,2021,581,244,337,72.4,578,243,335,72.5
21010, 중구,075004, 73세,2021,571,235,336,69.9,568,235,333,70.6
21010, 중구,075005, 74세,2021,503,205,298,68.8,500,205,295,69.5
21010, 중구,080,75~79세,2021,2188,929,1259,73.8,2181,923,1258,73.4
21010, 중구,080001, 75세,2021,434,193,241,80.1,434,193,241,80.1
21010, 중구,080002, 76세,2021,401,172,229,75.1,399,170,229,74.2
21010, 중구,080003, 77세,2021,430,181,249,72.7,427,179,248,72.2
21010, 중구,080004, 78세,2021,438,196,242,81,437,195,242,80.6
21010, 중구,080005, 79세,2021,485,187,298,62.8,484,186,298,62.4
21010, 중구,085,80~84세,2021,1480,549,931,59,1477,548,929,59
21010, 중구,085001, 80세,2021,382,145,237,61.2,381,145,236,61.4
21010, 중구,085002, 81세,2021,315,132,183,72.1,313,131,182,72
21010, 중구,085003, 82세,2021,314,116,198,58.6,314,116,198,58.6
21010, 중구,085004, 83세,2021,253,89,164,54.3,253,89,164,54.3
21010, 중구,085005, 84세,2021,216,67,149,45,216,67,149,45
21010, 중구,090,85~89세,2021,692,211,481,43.9,687,210,477,44
21010, 중구,090001, 85세,2021,190,62,128,48.4,190,62,128,48.4
21010, 중구,090002, 86세,2021,157,46,111,41.4,157,46,111,41.4
21010, 중구,090003, 87세,2021,141,43,98,43.9,140,43,97,44.3
21010, 중구,090004, 88세,2021,105,34,71,47.9,101,33,68,48.5
21010, 중구,090005, 89세,2021,99,26,73,35.6,99,26,73,35.6
21010, 중구,095,90~94세,2021,299,69,230,30,297,67,230,29.1
21010, 중구,095001, 90세,2021,68,18,50,36,68,18,50,36
21010, 중구,095002, 91세,2021,77,21,56,37.5,76,20,56,35.7
21010, 중구,095003, 92세,2021,59,13,46,28.3,59,13,46,28.3
21010, 중구,095004, 93세,2021,60,11,49,22.4,60,11,49,22.4
21010, 중구,095005, 94세,2021,35,6,29,20.7,34,5,29,17.2
21010, 중구,100,95~99세,2021,59,8,51,15.7,57,8,49,16.3
21010, 중구,100001, 95세,2021,23,X,22,4.5,22,X,21,4.8
21010, 중구,100002, 96세,2021,10,X,9,11.1,10,X,9,11.1
21010, 중구,100003, 97세,2021,6,X,X,100,6,X,X,100
21010, 중구,100004, 98세,2021,11,X,10,10,10,X,9,11.1
21010, 중구,100005, 99세,2021,9,X,7,28.6,9,X,7,28.6
21010, 중구,101,100세이상,2021,9,X,8,12.5,9,X,8,12.5
21010, 중구,102,15세미만,2021,1958,1023,935,109.4,1924,998,926,107.8
21010, 중구,103,15~64세,2021,28444,14818,13626,108.7,26298,13402,12896,103.9
21010, 중구,104,65세이상,2021,11137,4652,6485,71.7,11067,4616,6451,71.6
21010, 중구,086,85세이상,2021,1059,289,770,37.5,1050,286,764,37.4
21010, 중구,126,평균연령,2021,49.8,48,51.6,,50.6,48.9,52.2,
21010, 중구,127,중위연령,2021,51.8,49.2,54.6,,53.1,50.9,55.5,
21020, 서구,000,합계,2021,104130,50384,53746,93.7,101828,48966,52862,92.6
21020, 서구,005,0~4세,2021,2117,1085,1032,105.1,2094,1070,1024,104.5
21020, 서구,005001, 0세,2021,358,197,161,122.4,357,196,161,121.7
21020, 서구,005002, 1세,2021,378,191,187,102.1,372,186,186,100
21020, 서구,005003, 2세,2021,418,220,198,111.1,415,219,196,111.7
21020, 서구,005004, 3세,2021,432,207,225,92,428,204,224,91.1
21020, 서구,005005, 4세,2021,531,270,261,103.4,522,265,257,103.1
21020, 서구,010,5~9세,2021,3100,1649,1451,113.6,3089,1642,1447,113.5
21020, 서구,010001, 5세,2021,585,317,268,118.3,581,313,268,116.8
21020, 서구,010002, 6세,2021,621,343,278,123.4,620,343,277,123.8
21020, 서구,010003, 7세,2021,617,316,301,105,613,313,300,104.3
21020, 서구,010004, 8세,2021,585,326,259,125.9,583,326,257,126.8
21020, 서구,010005, 9세,2021,692,347,345,100.6,692,347,345,100.6
21020, 서구,015,10~14세,2021,3287,1683,1604,104.9,3277,1675,1602,104.6
21020, 서구,015001, 10세,2021,694,362,332,109,690,358,332,107.8
21020, 서구,015002, 11세,2021,656,327,329,99.4,654,326,328,99.4
21020, 서구,015003, 12세,2021,617,326,291,112,615,325,290,112.1
21020, 서구,015004, 13세,2021,641,310,331,93.7,640,309,331,93.4
21020, 서구,015005, 14세,2021,679,358,321,111.5,678,357,321,111.2
21020, 서구,020,15~19세,2021,3614,1807,1807,100,3557,1795,1762,101.9
21020, 서구,020001, 15세,2021,631,316,315,100.3,630,316,314,100.6
21020, 서구,020002, 16세,2021,635,317,318,99.7,629,316,313,101
21020, 서구,020003, 17세,2021,728,367,361,101.7,725,365,360,101.4
21020, 서구,020004, 18세,2021,765,389,376,103.5,757,387,370,104.6
21020, 서구,020005, 19세,2021,855,418,437,95.7,816,411,405,101.5
21020, 서구,025,20~24세,2021,6791,3142,3649,86.1,6411,2997,3414,87.8
21020, 서구,025001, 20세,2021,1172,504,668,75.4,1089,478,611,78.2
21020, 서구,025002, 21세,2021,1298,593,705,84.1,1210,565,645,87.6
21020, 서구,025003, 22세,2021,1350,656,694,94.5,1279,624,655,95.3
21020, 서구,025004, 23세,2021,1483,675,808,83.5,1422,652,770,84.7
21020, 서구,025005, 24세,2021,1488,714,774,92.2,1411,678,733,92.5
21020, 서구,030,25~29세,2021,6993,3553,3440,103.3,6623,3313,3310,100.1
21020, 서구,030001, 25세,2021,1508,758,750,101.1,1426,714,712,100.3
21020, 서구,030002, 26세,2021,1413,714,699,102.1,1344,677,667,101.5
21020, 서구,030003, 27세,2021,1361,710,651,109.1,1284,651,633,102.8
21020, 서구,030004, 28세,2021,1343,682,661,103.2,1282,639,643,99.4
21020, 서구,030005, 29세,2021,1368,689,679,101.5,1287,632,655,96.5
21020, 서구,035,30~34세,2021,5276,2823,2453,115.1,4890,2548,2342,108.8
21020, 서구,035001, 30세,2021,1129,614,515,119.2,1044,553,491,112.6
21020, 서구,035002, 31세,2021,1138,610,528,115.5,1052,552,500,110.4
21020, 서구,035003, 32세,2021,1055,558,497,112.3,992,517,475,108.8
21020, 서구,035004, 33세,2021,1027,552,475,116.2,949,489,460,106.3
21020, 서구,035005, 34세,2021,927,489,438,111.6,853,437,416,105
21020, 서구,040,35~39세,2021,5605,2955,2650,111.5,5263,2697,2566,105.1
21020, 서구,040001, 35세,2021,980,554,426,130,895,494,401,123.2
21020, 서구,040002, 36세,2021,1025,532,493,107.9,958,479,479,100
21020, 서구,040003, 37세,2021,1037,527,510,103.3,971,474,497,95.4
21020, 서구,040004, 38세,2021,1241,653,588,111.1,1174,605,569,106.3
21020, 서구,040005, 39세,2021,1322,689,633,108.8,1265,645,620,104
21020, 서구,045,40~44세,2021,6619,3496,3123,111.9,6374,3308,3066,107.9
21020, 서구,045001, 40세,2021,1387,721,666,108.3,1340,687,653,105.2
21020, 서구,045002, 41세,2021,1469,790,679,116.3,1417,752,665,113.1
21020, 서구,045003, 42세,2021,1336,730,606,120.5,1275,680,595,114.3
21020, 서구,045004, 43세,2021,1187,606,581,104.3,1142,569,573,99.3
21020, 서구,045005, 44세,2021,1240,649,591,109.8,1200,620,580,106.9
21020, 서구,050,45~49세,2021,7180,3784,3396,111.4,7010,3666,3344,109.6
21020, 서구,050001, 45세,2021,1217,651,566,115,1182,629,553,113.7
21020, 서구,050002, 46세,2021,1308,703,605,116.2,1264,672,592,113.5
21020, 서구,050003, 47세,2021,1485,766,719,106.5,1454,744,710,104.8
21020, 서구,050004, 48세,2021,1597,827,770,107.4,1567,805,762,105.6
21020, 서구,050005, 49세,2021,1573,837,736,113.7,1543,816,727,112.2
21020, 서구,055,50~54세,2021,8198,4229,3969,106.6,8087,4160,3927,105.9
21020, 서구,055001, 50세,2021,1640,837,803,104.2,1616,818,798,102.5
21020, 서구,055002, 51세,2021,1679,880,799,110.1,1649,860,789,109
21020, 서구,055003, 52세,2021,1654,844,810,104.2,1633,834,799,104.4
21020, 서구,055004, 53세,2021,1641,833,808,103.1,1626,824,802,102.7
21020, 서구,055005, 54세,2021,1584,835,749,111.5,1563,824,739,111.5
21020, 서구,060,55~59세,2021,8320,4160,4160,100,8246,4121,4125,99.9
21020, 서구,060001, 55세,2021,1536,776,760,102.1,1514,767,747,102.7
21020, 서구,060002, 56세,2021,1631,790,841,93.9,1617,780,837,93.2
21020, 서구,060003, 57세,2021,1575,774,801,96.6,1560,769,791,97.2
21020, 서구,060004, 58세,2021,1754,888,866,102.5,1742,880,862,102.1
21020, 서구,060005, 59세,2021,1824,932,892,104.5,1813,925,888,104.2
21020, 서구,065,60~64세,2021,10075,4644,5431,85.5,10016,4624,5392,85.8
21020, 서구,065001, 60세,2021,2094,970,1124,86.3,2084,966,1118,86.4
21020, 서구,065002, 61세,2021,2206,1021,1185,86.2,2190,1018,1172,86.9
21020, 서구,065003, 62세,2021,1969,889,1080,82.3,1961,884,1077,82.1
21020, 서구,065004, 63세,2021,1886,887,999,88.8,1876,883,993,88.9
21020, 서구,065005, 64세,2021,1920,877,1043,84.1,1905,873,1032,84.6
21020, 서구,070,65~69세,2021,8678,3975,4703,84.5,8642,3963,4679,84.7
21020, 서구,070001, 65세,2021,1832,872,960,90.8,1828,871,957,91
21020, 서구,070002, 66세,2021,1971,861,1110,77.6,1961,859,1102,77.9
21020, 서구,070003, 67세,2021,1730,815,915,89.1,1721,811,910,89.1
21020, 서구,070004, 68세,2021,1459,665,794,83.8,1454,662,792,83.6
21020, 서구,070005, 69세,2021,1686,762,924,82.5,1678,760,918,82.8
21020, 서구,075,70~74세,2021,6830,3051,3779,80.7,6814,3045,3769,80.8
21020, 서구,075001, 70세,2021,1361,608,753,80.7,1354,606,748,81
21020, 서구,075002, 71세,2021,1380,628,752,83.5,1377,625,752,83.1
21020, 서구,075003, 72세,2021,1436,632,804,78.6,1434,632,802,78.8
21020, 서구,075004, 73세,2021,1321,590,731,80.7,1320,590,730,80.8
21020, 서구,075005, 74세,2021,1332,593,739,80.2,1329,592,737,80.3
21020, 서구,080,75~79세,2021,5218,2196,3022,72.7,5212,2192,3020,72.6
21020, 서구,080001, 75세,2021,1002,445,557,79.9,1001,444,557,79.7
21020, 서구,080002, 76세,2021,965,404,561,72,964,403,561,71.8
21020, 서구,080003, 77세,2021,1046,455,591,77,1044,454,590,76.9
21020, 서구,080004, 78세,2021,1083,422,661,63.8,1082,422,660,63.9
21020, 서구,080005, 79세,2021,1122,470,652,72.1,1121,469,652,71.9
21020, 서구,085,80~84세,2021,3776,1430,2346,61,3770,1428,2342,61
21020, 서구,085001, 80세,2021,951,369,582,63.4,950,368,582,63.2
21020, 서구,085002, 81세,2021,827,320,507,63.1,825,320,505,63.4
21020, 서구,085003, 82세,2021,807,298,509,58.5,807,298,509,58.5
21020, 서구,085004, 83세,2021,644,239,405,59,641,238,403,59.1
21020, 서구,085005, 84세,2021,547,204,343,59.5,547,204,343,59.5
21020, 서구,090,85~89세,2021,1783,593,1190,49.8,1783,593,1190,49.8
21020, 서구,090001, 85세,2021,486,179,307,58.3,486,179,307,58.3
21020, 서구,090002, 86세,2021,446,147,299,49.2,446,147,299,49.2
21020, 서구,090003, 87세,2021,332,111,221,50.2,332,111,221,50.2
21020, 서구,090004, 88세,2021,280,85,195,43.6,280,85,195,43.6
21020, 서구,090005, 89세,2021,239,71,168,42.3,239,71,168,42.3
21020, 서구,095,90~94세,2021,541,99,442,22.4,541,99,442,22.4
21020, 서구,095001, 90세,2021,155,26,129,20.2,155,26,129,20.2
21020, 서구,095002, 91세,2021,111,26,85,30.6,111,26,85,30.6
21020, 서구,095003, 92세,2021,112,24,88,27.3,112,24,88,27.3
21020, 서구,095004, 93세,2021,85,12,73,16.4,85,12,73,16.4
21020, 서구,095005, 94세,2021,78,11,67,16.4,78,11,67,16.4
21020, 서구,100,95~99세,2021,114,26,88,29.5,114,26,88,29.5
21020, 서구,100001, 95세,2021,23,6,17,35.3,23,6,17,35.3
21020, 서구,100002, 96세,2021,36,8,28,28.6,36,8,28,28.6
21020, 서구,100003, 97세,2021,28,5,23,21.7,28,5,23,21.7
21020, 서구,100004, 98세,2021,21,5,16,31.3,21,5,16,31.3
21020, 서구,100005, 99세,2021,6,X,X,50,6,X,X,50
21020, 서구,101,100세이상,2021,15,X,11,36.4,15,X,11,36.4
21020, 서구,102,15세미만,2021,8504,4417,4087,108.1,8460,4387,4073,107.7
21020, 서구,103,15~64세,2021,68671,34593,34078,101.5,66477,33229,33248,99.9
21020, 서구,104,65세이상,2021,26955,11374,15581,73,26891,11350,15541,73
21020, 서구,086,85세이상,2021,2453,722,1731,41.7,2453,722,1731,41.7
21020, 서구,126,평균연령,2021,48.4,46.8,49.8,,48.6,47.2,50,
21020, 서구,127,중위연령,2021,50.9,49.1,52.8,,51.4,49.7,53.2,
21030, 동구,000,합계,2021,86035,41858,44177,94.8,83865,40836,43029,94.9
21030, 동구,005,0~4세,2021,1812,979,833,117.5,1789,968,821,117.9
21030, 동구,005001, 0세,2021,371,208,163,127.6,367,207,160,129.4
21030, 동구,005002, 1세,2021,323,166,157,105.7,317,162,155,104.5
21030, 동구,005003, 2세,2021,349,173,176,98.3,347,173,174,99.4
21030, 동구,005004, 3세,2021,358,218,140,155.7,352,215,137,156.9
21030, 동구,005005, 4세,2021,411,214,197,108.6,406,211,195,108.2
21030, 동구,010,5~9세,2021,2180,1139,1041,109.4,2131,1116,1015,110
21030, 동구,010001, 5세,2021,426,224,202,110.9,411,219,192,114.1
21030, 동구,010002, 6세,2021,441,233,208,112,436,232,204,113.7
21030, 동구,010003, 7세,2021,400,199,201,99,396,197,199,99
21030, 동구,010004, 8세,2021,432,233,199,117.1,425,229,196,116.8
21030, 동구,010005, 9세,2021,481,250,231,108.2,463,239,224,106.7
21030, 동구,015,10~14세,2021,2192,1111,1081,102.8,2151,1089,1062,102.5
21030, 동구,015001, 10세,2021,436,228,208,109.6,430,226,204,110.8
21030, 동구,015002, 11세,2021,425,211,214,98.6,415,203,212,95.8
21030, 동구,015003, 12세,2021,390,195,195,100,379,187,192,97.4
21030, 동구,015004, 13세,2021,449,233,216,107.9,440,231,209,110.5
21030, 동구,015005, 14세,2021,492,244,248,98.4,487,242,245,98.8
21030, 동구,020,15~19세,2021,2483,1297,1186,109.4,2441,1275,1166,109.3
21030, 동구,020001, 15세,2021,432,211,221,95.5,423,208,215,96.7
21030, 동구,020002, 16세,2021,433,235,198,118.7,422,228,194,117.5
21030, 동구,020003, 17세,2021,530,285,245,116.3,520,278,242,114.9
21030, 동구,020004, 18세,2021,567,301,266,113.2,560,298,262,113.7
21030, 동구,020005, 19세,2021,521,265,256,103.5,516,263,253,104
21030, 동구,025,20~24세,2021,4171,2106,2065,102,4069,2065,2004,103
21030, 동구,025001, 20세,2021,714,387,327,118.3,708,385,323,119.2
21030, 동구,025002, 21세,2021,763,379,384,98.7,749,372,377,98.7
21030, 동구,025003, 22세,2021,786,413,373,110.7,764,403,361,111.6
21030, 동구,025004, 23세,2021,921,472,449,105.1,897,461,436,105.7
21030, 동구,025005, 24세,2021,987,455,532,85.5,951,444,507,87.6
21030, 동구,030,25~29세,2021,5980,3030,2950,102.7,5648,2869,2779,103.2
21030, 동구,030001, 25세,2021,1149,550,599,91.8,1107,534,573,93.2
21030, 동구,030002, 26세,2021,1105,564,541,104.3,1045,537,508,105.7
21030, 동구,030003, 27세,2021,1257,620,637,97.3,1185,587,598,98.2
21030, 동구,030004, 28세,2021,1196,629,567,110.9,1111,585,526,111.2
21030, 동구,030005, 29세,2021,1273,667,606,110.1,1200,626,574,109.1
21030, 동구,035,30~34세,2021,5394,2777,2617,106.1,5050,2612,2438,107.1
21030, 동구,035001, 30세,2021,1211,596,615,96.9,1155,565,590,95.8
21030, 동구,035002, 31세,2021,1115,571,544,105,1044,535,509,105.1
21030, 동구,035003, 32세,2021,1071,558,513,108.8,1000,523,477,109.6
21030, 동구,035004, 33세,2021,1000,516,484,106.6,922,488,434,112.4
21030, 동구,035005, 34세,2021,997,536,461,116.3,929,501,428,117.1
21030, 동구,040,35~39세,2021,5162,2759,2403,114.8,4838,2599,2239,116.1
21030, 동구,040001, 35세,2021,940,516,424,121.7,871,480,391,122.8
21030, 동구,040002, 36세,2021,987,521,466,111.8,934,496,438,113.2
21030, 동구,040003, 37세,2021,1020,532,488,109,936,494,442,111.8
21030, 동구,040004, 38세,2021,1075,595,480,124,1019,566,453,124.9
21030, 동구,040005, 39세,2021,1140,595,545,109.2,1078,563,515,109.3
21030, 동구,045,40~44세,2021,5465,2976,2489,119.6,5226,2865,2361,121.3
21030, 동구,045001, 40세,2021,1151,660,491,134.4,1091,629,462,136.1
21030, 동구,045002, 41세,2021,1123,611,512,119.3,1077,594,483,123
21030, 동구,045003, 42세,2021,1147,631,516,122.3,1097,603,494,122.1
21030, 동구,045004, 43세,2021,1029,546,483,113,994,529,465,113.8
21030, 동구,045005, 44세,2021,1015,528,487,108.4,967,510,457,111.6
21030, 동구,050,45~49세,2021,5860,3109,2751,113,5681,3020,2661,113.5
21030, 동구,050001, 45세,2021,978,522,456,114.5,931,497,434,114.5
21030, 동구,050002, 46세,2021,1111,617,494,124.9,1078,601,477,126
21030, 동구,050003, 47세,2021,1229,618,611,101.1,1192,602,590,102
21030, 동구,050004, 48세,2021,1215,635,580,109.5,1185,619,566,109.4
21030, 동구,050005, 49세,2021,1327,717,610,117.5,1295,701,594,118
21030, 동구,055,50~54세,2021,6981,3584,3397,105.5,6840,3529,3311,106.6
21030, 동구,055001, 50세,2021,1393,717,676,106.1,1367,703,664,105.9
21030, 동구,055002, 51세,2021,1344,717,627,114.4,1307,703,604,116.4
21030, 동구,055003, 52세,2021,1456,739,717,103.1,1433,737,696,105.9
21030, 동구,055004, 53세,2021,1417,732,685,106.9,1389,720,669,107.6
21030, 동구,055005, 54세,2021,1371,679,692,98.1,1344,666,678,98.2
21030, 동구,060,55~59세,2021,6779,3374,3405,99.1,6682,3335,3347,99.6
21030, 동구,060001, 55세,2021,1303,667,636,104.9,1285,656,629,104.3
21030, 동구,060002, 56세,2021,1315,659,656,100.5,1299,654,645,101.4
21030, 동구,060003, 57세,2021,1231,629,602,104.5,1220,625,595,105
21030, 동구,060004, 58세,2021,1404,688,716,96.1,1380,678,702,96.6
21030, 동구,060005, 59세,2021,1526,731,795,91.9,1498,722,776,93
21030, 동구,065,60~64세,2021,8369,3992,4377,91.2,8275,3943,4332,91
21030, 동구,065001, 60세,2021,1714,807,907,89,1692,796,896,88.8
21030, 동구,065002, 61세,2021,1756,822,934,88,1739,815,924,88.2
21030, 동구,065003, 62세,2021,1642,784,858,91.4,1629,775,854,90.7
21030, 동구,065004, 63세,2021,1565,768,797,96.4,1543,755,788,95.8
21030, 동구,065005, 64세,2021,1692,811,881,92.1,1672,802,870,92.2
21030, 동구,070,65~69세,2021,7274,3289,3985,82.5,7182,3249,3933,82.6
21030, 동구,070001, 65세,2021,1550,725,825,87.9,1530,716,814,88
21030, 동구,070002, 66세,2021,1634,714,920,77.6,1616,706,910,77.6
21030, 동구,070003, 67세,2021,1371,630,741,85,1356,622,734,84.7
21030, 동구,070004, 68세,2021,1298,596,702,84.9,1277,589,688,85.6
21030, 동구,070005, 69세,2021,1421,624,797,78.3,1403,616,787,78.3
21030, 동구,075,70~74세,2021,5962,2637,3325,79.3,5920,2613,3307,79
21030, 동구,075001, 70세,2021,1209,553,656,84.3,1200,549,651,84.3
21030, 동구,075002, 71세,2021,1154,523,631,82.9,1144,518,626,82.7
21030, 동구,075003, 72세,2021,1270,552,718,76.9,1258,545,713,76.4
21030, 동구,075004, 73세,2021,1202,549,653,84.1,1197,544,653,83.3
21030, 동구,075005, 74세,2021,1127,460,667,69,1121,457,664,68.8
21030, 동구,080,75~79세,2021,4562,1908,2654,71.9,4550,1902,2648,71.8
21030, 동구,080001, 75세,2021,850,393,457,86,848,392,456,86
21030, 동구,080002, 76세,2021,875,342,533,64.2,874,341,533,64
21030, 동구,080003, 77세,2021,918,380,538,70.6,916,380,536,70.9
21030, 동구,080004, 78세,2021,909,387,522,74.1,905,385,520,74
21030, 동구,080005, 79세,2021,1010,406,604,67.2,1007,404,603,67
21030, 동구,085,80~84세,2021,3287,1197,2090,57.3,3276,1194,2082,57.3
21030, 동구,085001, 80세,2021,826,313,513,61,823,311,512,60.7
21030, 동구,085002, 81세,2021,730,259,471,55,727,259,468,55.3
21030, 동구,085003, 82세,2021,702,250,452,55.3,700,250,450,55.6
21030, 동구,085004, 83세,2021,543,193,350,55.1,542,193,349,55.3
21030, 동구,085005, 84세,2021,486,182,304,59.9,484,181,303,59.7
21030, 동구,090,85~89세,2021,1547,463,1084,42.7,1544,463,1081,42.8
21030, 동구,090001, 85세,2021,461,158,303,52.1,461,158,303,52.1
21030, 동구,090002, 86세,2021,377,113,264,42.8,377,113,264,42.8
21030, 동구,090003, 87세,2021,274,74,200,37,273,74,199,37.2
21030, 동구,090004, 88세,2021,235,73,162,45.1,234,73,161,45.3
21030, 동구,090005, 89세,2021,200,45,155,29,199,45,154,29.2
21030, 동구,095,90~94세,2021,465,105,360,29.2,464,105,359,29.2
21030, 동구,095001, 90세,2021,136,31,105,29.5,136,31,105,29.5
21030, 동구,095002, 91세,2021,98,24,74,32.4,98,24,74,32.4
21030, 동구,095003, 92세,2021,89,22,67,32.8,89,22,67,32.8
21030, 동구,095004, 93세,2021,85,20,65,30.8,84,20,64,31.3
21030, 동구,095005, 94세,2021,57,8,49,16.3,57,8,49,16.3
21030, 동구,100,95~99세,2021,98,23,75,30.7,96,22,74,29.7
21030, 동구,100001, 95세,2021,42,10,32,31.3,41,9,32,28.1
21030, 동구,100002, 96세,2021,19,6,13,46.2,19,6,13,46.2
21030, 동구,100003, 97세,2021,13,X,12,8.3,13,X,12,8.3
21030, 동구,100004, 98세,2021,8,X,7,14.3,7,X,6,16.7
21030, 동구,100005, 99세,2021,16,5,11,45.5,16,5,11,45.5
21030, 동구,101,100세이상,2021,12,X,9,33.3,12,X,9,33.3
21030, 동구,102,15세미만,2021,6184,3229,2955,109.3,6071,3173,2898,109.5
21030, 동구,103,15~64세,2021,56644,29004,27640,104.9,54750,28112,26638,105.5
21030, 동구,104,65세이상,2021,23207,9625,13582,70.9,23044,9551,13493,70.8
21030, 동구,086,85세이상,2021,2122,594,1528,38.9,2116,593,1523,38.9
21030, 동구,126,평균연령,2021,49.4,47.5,51.1,,49.6,47.8,51.4,
21030, 동구,127,중위연령,2021,51.7,49.5,54,,52.2,49.9,54.5,
21040, 영도구,000,합계,2021,112834,56466,56368,100.2,110772,55204,55568,99.3
21040, 영도구,005,0~4세,2021,1904,942,962,97.9,1883,931,952,97.8
21040, 영도구,005001, 0세,2021,291,139,152,91.4,288,137,151,90.7
21040, 영도구,005002, 1세,2021,340,180,160,112.5,336,179,157,114
21040, 영도구,005003, 2세,2021,373,172,201,85.6,368,169,199,84.9
21040, 영도구,005004, 3세,2021,452,235,217,108.3,447,233,214,108.9
21040, 영도구,005005, 4세,2021,448,216,232,93.1,444,213,231,92.2
21040, 영도구,010,5~9세,2021,2901,1494,1407,106.2,2885,1488,1397,106.5
21040, 영도구,010001, 5세,2021,547,269,278,96.8,544,268,276,97.1
21040, 영도구,010002, 6세,2021,560,289,271,106.6,555,287,268,107.1
21040, 영도구,010003, 7세,2021,581,300,281,106.8,579,300,279,107.5
21040, 영도구,010004, 8세,2021,581,290,291,99.7,579,290,289,100.3
21040, 영도구,010005, 9세,2021,632,346,286,121,628,343,285,120.4
21040, 영도구,015,10~14세,2021,3243,1646,1597,103.1,3238,1641,1597,102.8
21040, 영도구,015001, 10세,2021,682,324,358,90.5,680,322,358,89.9
21040, 영도구,015002, 11세,2021,659,342,317,107.9,658,341,317,107.6
21040, 영도구,015003, 12세,2021,599,306,293,104.4,599,306,293,104.4
21040, 영도구,015004, 13세,2021,632,323,309,104.5,631,322,309,104.2
21040, 영도구,015005, 14세,2021,671,351,320,109.7,670,350,320,109.4
21040, 영도구,020,15~19세,2021,4739,2685,2054,130.7,4687,2654,2033,130.5
21040, 영도구,020001, 15세,2021,639,312,327,95.4,639,312,327,95.4
21040, 영도구,020002, 16세,2021,635,329,306,107.5,631,326,305,106.9
21040, 영도구,020003, 17세,2021,842,473,369,128.2,839,472,367,128.6
21040, 영도구,020004, 18세,2021,1000,600,400,150,995,598,397,150.6
21040, 영도구,020005, 19세,2021,1623,971,652,148.9,1583,946,637,148.5
21040, 영도구,025,20~24세,2021,8693,5135,3558,144.3,8429,4997,3432,145.6
21040, 영도구,025001, 20세,2021,1849,1053,796,132.3,1794,1025,769,133.3
21040, 영도구,025002, 21세,2021,1914,1088,826,131.7,1857,1062,795,133.6
21040, 영도구,025003, 22세,2021,1801,1088,713,152.6,1756,1068,688,155.2
21040, 영도구,025004, 23세,2021,1650,1008,642,157,1603,981,622,157.7
21040, 영도구,025005, 24세,2021,1479,898,581,154.6,1419,861,558,154.3
21040, 영도구,030,25~29세,2021,6390,3692,2698,136.8,6054,3484,2570,135.6
21040, 영도구,030001, 25세,2021,1394,821,573,143.3,1325,784,541,144.9
21040, 영도구,030002, 26세,2021,1269,707,562,125.8,1210,672,538,124.9
21040, 영도구,030003, 27세,2021,1279,736,543,135.5,1210,693,517,134
21040, 영도구,030004, 28세,2021,1181,683,498,137.1,1117,636,481,132.2
21040, 영도구,030005, 29세,2021,1267,745,522,142.7,1192,699,493,141.8
21040, 영도구,035,30~34세,2021,5021,2784,2237,124.5,4654,2530,2124,119.1
21040, 영도구,035001, 30세,2021,1091,575,516,111.4,1016,525,491,106.9
21040, 영도구,035002, 31세,2021,1023,577,446,129.4,951,531,420,126.4
21040, 영도구,035003, 32세,2021,986,560,426,131.5,908,502,406,123.6
21040, 영도구,035004, 33세,2021,974,530,444,119.4,900,484,416,116.3
21040, 영도구,035005, 34세,2021,947,542,405,133.8,879,488,391,124.8
21040, 영도구,040,35~39세,2021,5475,2989,2486,120.2,5175,2785,2390,116.5
21040, 영도구,040001, 35세,2021,953,551,402,137.1,893,515,378,136.2
21040, 영도구,040002, 36세,2021,1019,544,475,114.5,949,495,454,109
21040, 영도구,040003, 37세,2021,1047,578,469,123.2,978,530,448,118.3
21040, 영도구,040004, 38세,2021,1172,627,545,115,1117,592,525,112.8
21040, 영도구,040005, 39세,2021,1284,689,595,115.8,1238,653,585,111.6
21040, 영도구,045,40~44세,2021,6621,3483,3138,111,6407,3343,3064,109.1
21040, 영도구,045001, 40세,2021,1367,724,643,112.6,1323,697,626,111.3
21040, 영도구,045002, 41세,2021,1426,744,682,109.1,1384,714,670,106.6
21040, 영도구,045003, 42세,2021,1306,670,636,105.3,1253,637,616,103.4
21040, 영도구,045004, 43세,2021,1288,690,598,115.4,1248,661,587,112.6
21040, 영도구,045005, 44세,2021,1234,655,579,113.1,1199,634,565,112.2
21040, 영도구,050,45~49세,2021,7605,3993,3612,110.5,7455,3897,3558,109.5
21040, 영도구,050001, 45세,2021,1270,670,600,111.7,1234,646,588,109.9
21040, 영도구,050002, 46세,2021,1444,762,682,111.7,1411,741,670,110.6
21040, 영도구,050003, 47세,2021,1581,833,748,111.4,1558,815,743,109.7
21040, 영도구,050004, 48세,2021,1627,836,791,105.7,1600,819,781,104.9
21040, 영도구,050005, 49세,2021,1683,892,791,112.8,1652,876,776,112.9
21040, 영도구,055,50~54세,2021,8779,4558,4221,108,8646,4482,4164,107.6
21040, 영도구,055001, 50세,2021,1752,946,806,117.4,1719,924,795,116.2
21040, 영도구,055002, 51세,2021,1721,905,816,110.9,1693,889,804,110.6
21040, 영도구,055003, 52세,2021,1709,859,850,101.1,1680,842,838,100.5
21040, 영도구,055004, 53세,2021,1827,930,897,103.7,1807,920,887,103.7
21040, 영도구,055005, 54세,2021,1770,918,852,107.7,1747,907,840,108
21040, 영도구,060,55~59세,2021,9195,4570,4625,98.8,9100,4520,4580,98.7
21040, 영도구,060001, 55세,2021,1802,984,818,120.3,1782,972,810,120
21040, 영도구,060002, 56세,2021,1733,806,927,86.9,1713,801,912,87.8
21040, 영도구,060003, 57세,2021,1632,794,838,94.7,1611,782,829,94.3
21040, 영도구,060004, 58세,2021,1906,965,941,102.6,1888,955,933,102.4
21040, 영도구,060005, 59세,2021,2122,1021,1101,92.7,2106,1010,1096,92.2
21040, 영도구,065,60~64세,2021,11475,5461,6014,90.8,11432,5445,5987,90.9
21040, 영도구,065001, 60세,2021,2349,1117,1232,90.7,2342,1114,1228,90.7
21040, 영도구,065002, 61세,2021,2443,1171,1272,92.1,2431,1168,1263,92.5
21040, 영도구,065003, 62세,2021,2239,1039,1200,86.6,2231,1036,1195,86.7
21040, 영도구,065004, 63세,2021,2204,1077,1127,95.6,2196,1075,1121,95.9
21040, 영도구,065005, 64세,2021,2240,1057,1183,89.3,2232,1052,1180,89.2
21040, 영도구,070,65~69세,2021,10134,4685,5449,86,10105,4670,5435,85.9
21040, 영도구,070001, 65세,2021,2187,1027,1160,88.5,2179,1023,1156,88.5
21040, 영도구,070002, 66세,2021,2379,1069,1310,81.6,2373,1065,1308,81.4
21040, 영도구,070003, 67세,2021,1981,957,1024,93.5,1972,952,1020,93.3
21040, 영도구,070004, 68세,2021,1691,761,930,81.8,1688,759,929,81.7
21040, 영도구,070005, 69세,2021,1896,871,1025,85,1893,871,1022,85.2
21040, 영도구,075,70~74세,2021,8046,3566,4480,79.6,8028,3559,4469,79.6
21040, 영도구,075001, 70세,2021,1575,702,873,80.4,1569,699,870,80.3
21040, 영도구,075002, 71세,2021,1590,719,871,82.5,1587,718,869,82.6
21040, 영도구,075003, 72세,2021,1696,754,942,80,1693,752,941,79.9
21040, 영도구,075004, 73세,2021,1566,688,878,78.4,1563,688,875,78.6
21040, 영도구,075005, 74세,2021,1619,703,916,76.7,1616,702,914,76.8
21040, 영도구,080,75~79세,2021,6105,2561,3544,72.3,6097,2559,3538,72.3
21040, 영도구,080001, 75세,2021,1191,520,671,77.5,1189,519,670,77.5
21040, 영도구,080002, 76세,2021,1174,503,671,75,1172,503,669,75.2
21040, 영도구,080003, 77세,2021,1180,482,698,69.1,1179,482,697,69.2
21040, 영도구,080004, 78세,2021,1255,528,727,72.6,1254,528,726,72.7
21040, 영도구,080005, 79세,2021,1305,528,777,68,1303,527,776,67.9
21040, 영도구,085,80~84세,2021,4141,1541,2600,59.3,4133,1540,2593,59.4
21040, 영도구,085001, 80세,2021,1069,432,637,67.8,1068,432,636,67.9
21040, 영도구,085002, 81세,2021,929,330,599,55.1,928,330,598,55.2
21040, 영도구,085003, 82세,2021,864,316,548,57.7,861,316,545,58
21040, 영도구,085004, 83세,2021,669,266,403,66,668,266,402,66.2
21040, 영도구,085005, 84세,2021,610,197,413,47.7,608,196,412,47.6
21040, 영도구,090,85~89세,2021,1754,551,1203,45.8,1752,550,1202,45.8
21040, 영도구,090001, 85세,2021,506,174,332,52.4,505,174,331,52.6
21040, 영도구,090002, 86세,2021,420,134,286,46.9,420,134,286,46.9
21040, 영도구,090003, 87세,2021,352,122,230,53,352,122,230,53
21040, 영도구,090004, 88세,2021,239,64,175,36.6,239,64,175,36.6
21040, 영도구,090005, 89세,2021,237,57,180,31.7,236,56,180,31.1
21040, 영도구,095,90~94세,2021,500,113,387,29.2,499,112,387,28.9
21040, 영도구,095001, 90세,2021,140,50,90,55.6,140,50,90,55.6
21040, 영도구,095002, 91세,2021,115,22,93,23.7,114,21,93,22.6
21040, 영도구,095003, 92세,2021,110,21,89,23.6,110,21,89,23.6
21040, 영도구,095004, 93세,2021,77,10,67,14.9,77,10,67,14.9
21040, 영도구,095005, 94세,2021,58,10,48,20.8,58,10,48,20.8
21040, 영도구,100,95~99세,2021,98,16,82,19.5,98,16,82,19.5
21040, 영도구,100001, 95세,2021,39,6,33,18.2,39,6,33,18.2
21040, 영도구,100002, 96세,2021,24,X,20,20,24,X,20,20
21040, 영도구,100003, 97세,2021,16,X,14,14.3,16,X,14,14.3
21040, 영도구,100004, 98세,2021,15,X,12,25,15,X,12,25
21040, 영도구,100005, 99세,2021,X,X,X,33.3,X,X,X,33.3
21040, 영도구,101,100세이상,2021,15,X,14,7.1,15,X,14,7.1
21040, 영도구,102,15세미만,2021,8048,4082,3966,102.9,8006,4060,3946,102.9
21040, 영도구,103,15~64세,2021,73993,39350,34643,113.6,72039,38137,33902,112.5
21040, 영도구,104,65세이상,2021,30793,13034,17759,73.4,30727,13007,17720,73.4
21040, 영도구,086,85세이상,2021,2367,681,1686,40.4,2364,679,1685,40.3
21040, 영도구,126,평균연령,2021,49,46.8,51.3,,49.3,47,51.5,
21040, 영도구,127,중위연령,2021,52.2,49.3,55.3,,52.7,49.8,55.6,
21050, 부산진구,000,합계,2021,351201,167869,183332,91.6,348159,166720,181439,91.9
21050, 부산진구,005,0~4세,2021,8586,4372,4214,103.7,8566,4361,4205,103.7
21050, 부산진구,005001, 0세,2021,1519,759,760,99.9,1516,757,759,99.7
21050, 부산진구,005002, 1세,2021,1560,807,753,107.2,1553,802,751,106.8
21050, 부산진구,005003, 2세,2021,1643,804,839,95.8,1640,803,837,95.9
21050, 부산진구,005004, 3세,2021,1913,1010,903,111.8,1909,1009,900,112.1
21050, 부산진구,005005, 4세,2021,1951,992,959,103.4,1948,990,958,103.3
21050, 부산진구,010,5~9세,2021,11396,5732,5664,101.2,11379,5721,5658,101.1
21050, 부산진구,010001, 5세,2021,2208,1117,1091,102.4,2203,1115,1088,102.5
21050, 부산진구,010002, 6세,2021,2303,1168,1135,102.9,2301,1166,1135,102.7
21050, 부산진구,010003, 7세,2021,2266,1152,1114,103.4,2260,1148,1112,103.2
21050, 부산진구,010004, 8세,2021,2201,1102,1099,100.3,2199,1100,1099,100.1
21050, 부산진구,010005, 9세,2021,2418,1193,1225,97.4,2416,1192,1224,97.4
21050, 부산진구,015,10~14세,2021,11396,5763,5633,102.3,11384,5760,5624,102.4
21050, 부산진구,015001, 10세,2021,2399,1195,1204,99.3,2397,1194,1203,99.3
21050, 부산진구,015002, 11세,2021,2229,1151,1078,106.8,2229,1151,1078,106.8
21050, 부산진구,015003, 12세,2021,2152,1100,1052,104.6,2148,1100,1048,105
21050, 부산진구,015004, 13세,2021,2274,1136,1138,99.8,2271,1135,1136,99.9
21050, 부산진구,015005, 14세,2021,2342,1181,1161,101.7,2339,1180,1159,101.8
21050, 부산진구,020,15~19세,2021,13635,6787,6848,99.1,13515,6735,6780,99.3
21050, 부산진구,020001, 15세,2021,2199,1117,1082,103.2,2193,1114,1079,103.2
21050, 부산진구,020002, 16세,2021,2176,1075,1101,97.6,2161,1068,1093,97.7
21050, 부산진구,020003, 17세,2021,2622,1385,1237,112,2607,1378,1229,112.1
21050, 부산진구,020004, 18세,2021,2894,1477,1417,104.2,2867,1464,1403,104.3
21050, 부산진구,020005, 19세,2021,3744,1733,2011,86.2,3687,1711,1976,86.6
21050, 부산진구,025,20~24세,2021,24907,11512,13395,85.9,24341,11288,13053,86.5
21050, 부산진구,025001, 20세,2021,4311,1858,2453,75.7,4202,1818,2384,76.3
21050, 부산진구,025002, 21세,2021,4917,2211,2706,81.7,4761,2134,2627,81.2
21050, 부산진구,025003, 22세,2021,4948,2361,2587,91.3,4855,2329,2526,92.2
21050, 부산진구,025004, 23세,2021,5265,2490,2775,89.7,5164,2455,2709,90.6
21050, 부산진구,025005, 24세,2021,5466,2592,2874,90.2,5359,2552,2807,90.9
21050, 부산진구,030,25~29세,2021,28726,14047,14679,95.7,28294,13920,14374,96.8
21050, 부산진구,030001, 25세,2021,5670,2776,2894,95.9,5570,2744,2826,97.1
21050, 부산진구,030002, 26세,2021,5671,2734,2937,93.1,5593,2710,2883,94
21050, 부산진구,030003, 27세,2021,5761,2783,2978,93.5,5680,2760,2920,94.5
21050, 부산진구,030004, 28세,2021,5760,2882,2878,100.1,5678,2858,2820,101.3
21050, 부산진구,030005, 29세,2021,5864,2872,2992,96,5773,2848,2925,97.4
21050, 부산진구,035,30~34세,2021,23897,11961,11936,100.2,23429,11805,11624,101.6
21050, 부산진구,035001, 30세,2021,5336,2643,2693,98.1,5247,2614,2633,99.3
21050, 부산진구,035002, 31세,2021,4933,2486,2447,101.6,4845,2459,2386,103.1
21050, 부산진구,035003, 32세,2021,4843,2381,2462,96.7,4748,2352,2396,98.2
21050, 부산진구,035004, 33세,2021,4428,2263,2165,104.5,4337,2226,2111,105.4
21050, 부산진구,035005, 34세,2021,4357,2188,2169,100.9,4252,2154,2098,102.7
21050, 부산진구,040,35~39세,2021,22542,11583,10959,105.7,22176,11458,10718,106.9
21050, 부산진구,040001, 35세,2021,4144,2130,2014,105.8,4061,2106,1955,107.7
21050, 부산진구,040002, 36세,2021,4277,2222,2055,108.1,4209,2193,2016,108.8
21050, 부산진구,040003, 37세,2021,4296,2232,2064,108.1,4230,2212,2018,109.6
21050, 부산진구,040004, 38세,2021,4783,2401,2382,100.8,4690,2371,2319,102.2
21050, 부산진구,040005, 39세,2021,5042,2598,2444,106.3,4986,2576,2410,106.9
21050, 부산진구,045,40~44세,2021,23839,12193,11646,104.7,23578,12095,11483,105.3
21050, 부산진구,045001, 40세,2021,5033,2565,2468,103.9,4983,2547,2436,104.6
21050, 부산진구,045002, 41세,2021,5190,2672,2518,106.1,5145,2658,2487,106.9
21050, 부산진구,045003, 42세,2021,4907,2481,2426,102.3,4854,2458,2396,102.6
21050, 부산진구,045004, 43세,2021,4333,2259,2074,108.9,4262,2231,2031,109.8
21050, 부산진구,045005, 44세,2021,4376,2216,2160,102.6,4334,2201,2133,103.2
21050, 부산진구,050,45~49세,2021,24832,12414,12418,100,24599,12300,12299,100
21050, 부산진구,050001, 45세,2021,4372,2167,2205,98.3,4319,2150,2169,99.1
21050, 부산진구,050002, 46세,2021,4652,2332,2320,100.5,4610,2312,2298,100.6
21050, 부산진구,050003, 47세,2021,5203,2638,2565,102.8,5149,2609,2540,102.7
21050, 부산진구,050004, 48세,2021,5199,2600,2599,100,5150,2570,2580,99.6
21050, 부산진구,050005, 49세,2021,5406,2677,2729,98.1,5371,2659,2712,98
21050, 부산진구,055,50~54세,2021,27753,13328,14425,92.4,27567,13254,14313,92.6
21050, 부산진구,055001, 50세,2021,5611,2698,2913,92.6,5581,2689,2892,93
21050, 부산진구,055002, 51세,2021,5585,2792,2793,100,5531,2770,2761,100.3
21050, 부산진구,055003, 52세,2021,5555,2682,2873,93.4,5516,2663,2853,93.3
21050, 부산진구,055004, 53세,2021,5707,2710,2997,90.4,5671,2697,2974,90.7
21050, 부산진구,055005, 54세,2021,5295,2446,2849,85.9,5268,2435,2833,86
21050, 부산진구,060,55~59세,2021,27381,13083,14298,91.5,27235,13023,14212,91.6
21050, 부산진구,060001, 55세,2021,5288,2541,2747,92.5,5254,2529,2725,92.8
21050, 부산진구,060002, 56세,2021,5379,2557,2822,90.6,5358,2548,2810,90.7
21050, 부산진구,060003, 57세,2021,5072,2457,2615,94,5052,2446,2606,93.9
21050, 부산진구,060004, 58세,2021,5622,2687,2935,91.6,5589,2672,2917,91.6
21050, 부산진구,060005, 59세,2021,6020,2841,3179,89.4,5982,2828,3154,89.7
21050, 부산진구,065,60~64세,2021,31137,14339,16798,85.4,31044,14301,16743,85.4
21050, 부산진구,065001, 60세,2021,6639,3073,3566,86.2,6619,3065,3554,86.2
21050, 부산진구,065002, 61세,2021,6630,2979,3651,81.6,6614,2975,3639,81.8
21050, 부산진구,065003, 62세,2021,6141,2806,3335,84.1,6128,2800,3328,84.1
21050, 부산진구,065004, 63세,2021,5800,2703,3097,87.3,5778,2694,3084,87.4
21050, 부산진구,065005, 64세,2021,5927,2778,3149,88.2,5905,2767,3138,88.2
21050, 부산진구,070,65~69세,2021,24952,11663,13289,87.8,24877,11629,13248,87.8
21050, 부산진구,070001, 65세,2021,5535,2607,2928,89,5519,2599,2920,89
21050, 부산진구,070002, 66세,2021,5769,2659,3110,85.5,5754,2649,3105,85.3
21050, 부산진구,070003, 67세,2021,4786,2316,2470,93.8,4771,2311,2460,93.9
21050, 부산진구,070004, 68세,2021,4299,1929,2370,81.4,4280,1922,2358,81.5
21050, 부산진구,070005, 69세,2021,4563,2152,2411,89.3,4553,2148,2405,89.3
21050, 부산진구,075,70~74세,2021,18303,8312,9991,83.2,18279,8300,9979,83.2
21050, 부산진구,075001, 70세,2021,3732,1710,2022,84.6,3722,1705,2017,84.5
21050, 부산진구,075002, 71세,2021,3670,1716,1954,87.8,3665,1714,1951,87.9
21050, 부산진구,075003, 72세,2021,3808,1730,2078,83.3,3807,1730,2077,83.3
21050, 부산진구,075004, 73세,2021,3681,1656,2025,81.8,3677,1653,2024,81.7
21050, 부산진구,075005, 74세,2021,3412,1500,1912,78.5,3408,1498,1910,78.4
21050, 부산진구,080,75~79세,2021,13033,5593,7440,75.2,13018,5586,7432,75.2
21050, 부산진구,080001, 75세,2021,2495,1092,1403,77.8,2491,1090,1401,77.8
21050, 부산진구,080002, 76세,2021,2473,1071,1402,76.4,2471,1070,1401,76.4
21050, 부산진구,080003, 77세,2021,2576,1139,1437,79.3,2574,1137,1437,79.1
21050, 부산진구,080004, 78세,2021,2603,1126,1477,76.2,2598,1124,1474,76.3
21050, 부산진구,080005, 79세,2021,2886,1165,1721,67.7,2884,1165,1719,67.8
21050, 부산진구,085,80~84세,2021,9341,3544,5797,61.1,9336,3541,5795,61.1
21050, 부산진구,085001, 80세,2021,2320,955,1365,70,2318,953,1365,69.8
21050, 부산진구,085002, 81세,2021,2100,805,1295,62.2,2099,805,1294,62.2
21050, 부산진구,085003, 82세,2021,1997,736,1261,58.4,1997,736,1261,58.4
21050, 부산진구,085004, 83세,2021,1522,558,964,57.9,1521,557,964,57.8
21050, 부산진구,085005, 84세,2021,1402,490,912,53.7,1401,490,911,53.8
21050, 부산진구,090,85~89세,2021,4129,1350,2779,48.6,4128,1350,2778,48.6
21050, 부산진구,090001, 85세,2021,1103,372,731,50.9,1102,372,730,51
21050, 부산진구,090002, 86세,2021,1037,328,709,46.3,1037,328,709,46.3
21050, 부산진구,090003, 87세,2021,805,274,531,51.6,805,274,531,51.6
21050, 부산진구,090004, 88세,2021,635,198,437,45.3,635,198,437,45.3
21050, 부산진구,090005, 89세,2021,549,178,371,48,549,178,371,48
21050, 부산진구,095,90~94세,2021,1183,257,926,27.8,1183,257,926,27.8
21050, 부산진구,095001, 90세,2021,369,84,285,29.5,369,84,285,29.5
21050, 부산진구,095002, 91세,2021,278,70,208,33.7,278,70,208,33.7
21050, 부산진구,095003, 92세,2021,238,56,182,30.8,238,56,182,30.8
21050, 부산진구,095004, 93세,2021,175,28,147,19,175,28,147,19
21050, 부산진구,095005, 94세,2021,123,19,104,18.3,123,19,104,18.3
21050, 부산진구,100,95~99세,2021,210,32,178,18,208,32,176,18.2
21050, 부산진구,100001, 95세,2021,63,10,53,18.9,62,10,52,19.2
21050, 부산진구,100002, 96세,2021,60,8,52,15.4,60,8,52,15.4
21050, 부산진구,100003, 97세,2021,38,5,33,15.2,38,5,33,15.2
21050, 부산진구,100004, 98세,2021,26,X,22,18.2,25,X,21,19
21050, 부산진구,100005, 99세,2021,23,5,18,27.8,23,5,18,27.8
21050, 부산진구,101,100세이상,2021,23,X,19,21.1,23,X,19,21.1
21050, 부산진구,102,15세미만,2021,31378,15867,15511,102.3,31329,15842,15487,102.3
21050, 부산진구,103,15~64세,2021,248649,121247,127402,95.2,245778,120179,125599,95.7
21050, 부산진구,104,65세이상,2021,71174,30755,40419,76.1,71052,30699,40353,76.1
21050, 부산진구,086,85세이상,2021,5545,1643,3902,42.1,5542,1643,3899,42.1
21050, 부산진구,126,평균연령,2021,45.3,44.3,46.3,,45.4,44.3,46.4,
21050, 부산진구,127,중위연령,2021,46.5,45,47.8,,46.7,45.1,48.1,
21060, 동래구,000,합계,2021,259838,125854,133984,93.9,258566,125423,133143,94.2
21060, 동래구,005,0~4세,2021,7156,3656,3500,104.5,7129,3648,3481,104.8
21060, 동래구,005001, 0세,2021,1202,617,585,105.5,1201,617,584,105.7
21060, 동래구,005002, 1세,2021,1302,703,599,117.4,1298,701,597,117.4
21060, 동래구,005003, 2세,2021,1390,693,697,99.4,1386,692,694,99.7
21060, 동래구,005004, 3세,2021,1490,762,728,104.7,1483,761,722,105.4
21060, 동래구,005005, 4세,2021,1772,881,891,98.9,1761,877,884,99.2
21060, 동래구,010,5~9세,2021,11238,5844,5394,108.3,11215,5835,5380,108.5
21060, 동래구,010001, 5세,2021,2056,1058,998,106,2049,1056,993,106.3
21060, 동래구,010002, 6세,2021,2193,1106,1087,101.7,2186,1105,1081,102.2
21060, 동래구,010003, 7세,2021,2240,1187,1053,112.7,2239,1186,1053,112.6
21060, 동래구,010004, 8세,2021,2263,1181,1082,109.1,2259,1178,1081,109
21060, 동래구,010005, 9세,2021,2486,1312,1174,111.8,2482,1310,1172,111.8
21060, 동래구,015,10~14세,2021,12046,6279,5767,108.9,12037,6271,5766,108.8
21060, 동래구,015001, 10세,2021,2369,1215,1154,105.3,2367,1213,1154,105.1
21060, 동래구,015002, 11세,2021,2465,1313,1152,114,2464,1312,1152,113.9
21060, 동래구,015003, 12세,2021,2226,1153,1073,107.5,2226,1153,1073,107.5
21060, 동래구,015004, 13세,2021,2467,1305,1162,112.3,2464,1303,1161,112.2
21060, 동래구,015005, 14세,2021,2519,1293,1226,105.5,2516,1290,1226,105.2
21060, 동래구,020,15~19세,2021,11268,5890,5378,109.5,11259,5887,5372,109.6
21060, 동래구,020001, 15세,2021,2278,1171,1107,105.8,2277,1170,1107,105.7
21060, 동래구,020002, 16세,2021,2182,1177,1005,117.1,2179,1176,1003,117.2
21060, 동래구,020003, 17세,2021,2343,1213,1130,107.3,2341,1213,1128,107.5
21060, 동래구,020004, 18세,2021,2373,1228,1145,107.2,2372,1228,1144,107.3
21060, 동래구,020005, 19세,2021,2092,1101,991,111.1,2090,1100,990,111.1
21060, 동래구,025,20~24세,2021,13825,7269,6556,110.9,13724,7249,6475,112
21060, 동래구,025001, 20세,2021,2419,1342,1077,124.6,2408,1338,1070,125
21060, 동래구,025002, 21세,2021,2777,1507,1270,118.7,2768,1507,1261,119.5
21060, 동래구,025003, 22세,2021,2743,1463,1280,114.3,2721,1459,1262,115.6
21060, 동래구,025004, 23세,2021,2820,1408,1412,99.7,2799,1405,1394,100.8
21060, 동래구,025005, 24세,2021,3066,1549,1517,102.1,3028,1540,1488,103.5
21060, 동래구,030,25~29세,2021,15828,8201,7627,107.5,15653,8158,7495,108.8
21060, 동래구,030001, 25세,2021,3106,1603,1503,106.7,3079,1597,1482,107.8
21060, 동래구,030002, 26세,2021,3116,1605,1511,106.2,3076,1592,1484,107.3
21060, 동래구,030003, 27세,2021,3164,1653,1511,109.4,3127,1643,1484,110.7
21060, 동래구,030004, 28세,2021,3219,1708,1511,113,3190,1700,1490,114.1
21060, 동래구,030005, 29세,2021,3223,1632,1591,102.6,3181,1626,1555,104.6
21060, 동래구,035,30~34세,2021,14254,7255,6999,103.7,14045,7190,6855,104.9
21060, 동래구,035001, 30세,2021,2950,1520,1430,106.3,2904,1507,1397,107.9
21060, 동래구,035002, 31세,2021,2941,1469,1472,99.8,2887,1450,1437,100.9
21060, 동래구,035003, 32세,2021,2881,1498,1383,108.3,2844,1486,1358,109.4
21060, 동래구,035004, 33세,2021,2746,1391,1355,102.7,2702,1375,1327,103.6
21060, 동래구,035005, 34세,2021,2736,1377,1359,101.3,2708,1372,1336,102.7
21060, 동래구,040,35~39세,2021,16511,8160,8351,97.7,16342,8095,8247,98.2
21060, 동래구,040001, 35세,2021,2848,1448,1400,103.4,2807,1434,1373,104.4
21060, 동래구,040002, 36세,2021,2886,1500,1386,108.2,2854,1487,1367,108.8
21060, 동래구,040003, 37세,2021,3125,1529,1596,95.8,3087,1516,1571,96.5
21060, 동래구,040004, 38세,2021,3591,1740,1851,94,3564,1729,1835,94.2
21060, 동래구,040005, 39세,2021,4061,1943,2118,91.7,4030,1929,2101,91.8
21060, 동래구,045,40~44세,2021,20052,9848,10204,96.5,19905,9791,10114,96.8
21060, 동래구,045001, 40세,2021,4060,2042,2018,101.2,4029,2031,1998,101.7
21060, 동래구,045002, 41세,2021,4389,2173,2216,98.1,4358,2163,2195,98.5
21060, 동래구,045003, 42세,2021,4163,1997,2166,92.2,4139,1987,2152,92.3
21060, 동래구,045004, 43세,2021,3717,1813,1904,95.2,3691,1800,1891,95.2
21060, 동래구,045005, 44세,2021,3723,1823,1900,95.9,3688,1810,1878,96.4
21060, 동래구,050,45~49세,2021,20846,10169,10677,95.2,20737,10133,10604,95.6
21060, 동래구,050001, 45세,2021,3739,1756,1983,88.6,3714,1748,1966,88.9
21060, 동래구,050002, 46세,2021,4059,1954,2105,92.8,4036,1945,2091,93
21060, 동래구,050003, 47세,2021,4292,2126,2166,98.2,4272,2119,2153,98.4
21060, 동래구,050004, 48세,2021,4372,2117,2255,93.9,4349,2111,2238,94.3
21060, 동래구,050005, 49세,2021,4384,2216,2168,102.2,4366,2210,2156,102.5
21060, 동래구,055,50~54세,2021,22179,10699,11480,93.2,22089,10659,11430,93.3
21060, 동래구,055001, 50세,2021,4609,2220,2389,92.9,4589,2214,2375,93.2
21060, 동래구,055002, 51세,2021,4442,2184,2258,96.7,4425,2173,2252,96.5
21060, 동래구,055003, 52세,2021,4488,2182,2306,94.6,4463,2170,2293,94.6
21060, 동래구,055004, 53세,2021,4436,2149,2287,94,4419,2143,2276,94.2
21060, 동래구,055005, 54세,2021,4204,1964,2240,87.7,4193,1959,2234,87.7
21060, 동래구,060,55~59세,2021,20187,9422,10765,87.5,20116,9396,10720,87.6
21060, 동래구,060001, 55세,2021,3912,1887,2025,93.2,3896,1880,2016,93.3
21060, 동래구,060002, 56세,2021,4040,1879,2161,87,4029,1875,2154,87
21060, 동래구,060003, 57세,2021,3731,1714,2017,85,3711,1707,2004,85.2
21060, 동래구,060004, 58세,2021,4089,1902,2187,87,4077,1898,2179,87.1
21060, 동래구,060005, 59세,2021,4415,2040,2375,85.9,4403,2036,2367,86
21060, 동래구,065,60~64세,2021,22741,10565,12176,86.8,22671,10538,12133,86.9
21060, 동래구,065001, 60세,2021,4816,2209,2607,84.7,4801,2203,2598,84.8
21060, 동래구,065002, 61세,2021,4846,2192,2654,82.6,4829,2187,2642,82.8
21060, 동래구,065003, 62세,2021,4506,2099,2407,87.2,4494,2095,2399,87.3
21060, 동래구,065004, 63세,2021,4261,2005,2256,88.9,4247,1999,2248,88.9
21060, 동래구,065005, 64세,2021,4312,2060,2252,91.5,4300,2054,2246,91.5
21060, 동래구,070,65~69세,2021,18549,8484,10065,84.3,18510,8467,10043,84.3
21060, 동래구,070001, 65세,2021,4016,1818,2198,82.7,4007,1811,2196,82.5
21060, 동래구,070002, 66세,2021,4339,1936,2403,80.6,4333,1934,2399,80.6
21060, 동래구,070003, 67세,2021,3561,1684,1877,89.7,3552,1682,1870,89.9
21060, 동래구,070004, 68세,2021,3231,1458,1773,82.2,3222,1456,1766,82.4
21060, 동래구,070005, 69세,2021,3402,1588,1814,87.5,3396,1584,1812,87.4
21060, 동래구,075,70~74세,2021,13487,6241,7246,86.1,13476,6237,7239,86.2
21060, 동래구,075001, 70세,2021,2815,1308,1507,86.8,2811,1307,1504,86.9
21060, 동래구,075002, 71세,2021,2768,1280,1488,86,2763,1279,1484,86.2
21060, 동래구,075003, 72세,2021,2721,1265,1456,86.9,2720,1264,1456,86.8
21060, 동래구,075004, 73세,2021,2698,1247,1451,85.9,2697,1246,1451,85.9
21060, 동래구,075005, 74세,2021,2485,1141,1344,84.9,2485,1141,1344,84.9
21060, 동래구,080,75~79세,2021,9251,4198,5053,83.1,9246,4196,5050,83.1
21060, 동래구,080001, 75세,2021,1854,877,977,89.8,1853,876,977,89.7
21060, 동래구,080002, 76세,2021,1786,862,924,93.3,1785,862,923,93.4
21060, 동래구,080003, 77세,2021,1881,850,1031,82.4,1881,850,1031,82.4
21060, 동래구,080004, 78세,2021,1778,784,994,78.9,1776,783,993,78.9
21060, 동래구,080005, 79세,2021,1952,825,1127,73.2,1951,825,1126,73.3
21060, 동래구,085,80~84세,2021,6160,2500,3660,68.3,6156,2499,3657,68.3
21060, 동래구,085001, 80세,2021,1603,692,911,76,1603,692,911,76
21060, 동래구,085002, 81세,2021,1388,582,806,72.2,1387,582,805,72.3
21060, 동래구,085003, 82세,2021,1237,500,737,67.8,1235,499,736,67.8
21060, 동래구,085004, 83세,2021,1018,381,637,59.8,1017,381,636,59.9
21060, 동래구,085005, 84세,2021,914,345,569,60.6,914,345,569,60.6
21060, 동래구,090,85~89세,2021,2982,922,2060,44.8,2980,922,2058,44.8
21060, 동래구,090001, 85세,2021,835,320,515,62.1,835,320,515,62.1
21060, 동래구,090002, 86세,2021,715,220,495,44.4,714,220,494,44.5
21060, 동래구,090003, 87세,2021,596,167,429,38.9,596,167,429,38.9
21060, 동래구,090004, 88세,2021,456,117,339,34.5,456,117,339,34.5
21060, 동래구,090005, 89세,2021,380,98,282,34.8,379,98,281,34.9
21060, 동래구,095,90~94세,2021,1029,219,810,27,1029,219,810,27
21060, 동래구,095001, 90세,2021,311,75,236,31.8,311,75,236,31.8
21060, 동래구,095002, 91세,2021,258,62,196,31.6,258,62,196,31.6
21060, 동래구,095003, 92세,2021,187,32,155,20.6,187,32,155,20.6
21060, 동래구,095004, 93세,2021,158,29,129,22.5,158,29,129,22.5
21060, 동래구,095005, 94세,2021,115,21,94,22.3,115,21,94,22.3
21060, 동래구,100,95~99세,2021,219,30,189,15.9,218,30,188,16
21060, 동래구,100001, 95세,2021,75,7,68,10.3,75,7,68,10.3
21060, 동래구,100002, 96세,2021,60,11,49,22.4,60,11,49,22.4
21060, 동래구,100003, 97세,2021,32,5,27,18.5,32,5,27,18.5
21060, 동래구,100004, 98세,2021,34,X,30,13.3,34,X,30,13.3
21060, 동래구,100005, 99세,2021,18,X,15,20,17,X,14,21.4
21060, 동래구,101,100세이상,2021,30,X,27,11.1,29,X,26,11.5
21060, 동래구,102,15세미만,2021,30440,15779,14661,107.6,30381,15754,14627,107.7
21060, 동래구,103,15~64세,2021,177691,87478,90213,97,176541,87096,89445,97.4
21060, 동래구,104,65세이상,2021,51707,22597,29110,77.6,51644,22573,29071,77.6
21060, 동래구,086,85세이상,2021,4260,1174,3086,38,4256,1174,3082,38.1
21060, 동래구,126,평균연령,2021,45,43.6,46.4,,45.1,43.6,46.4,
21060, 동래구,127,중위연령,2021,47,45.3,48.4,,47.1,45.3,48.5,
21070, 남구,000,합계,2021,264756,129412,135344,95.6,258156,126145,132011,95.6
21070, 남구,005,0~4세,2021,6227,3180,3047,104.4,6169,3152,3017,104.5
21070, 남구,005001, 0세,2021,962,478,484,98.8,953,473,480,98.5
21070, 남구,005002, 1세,2021,1064,556,508,109.4,1048,550,498,110.4
21070, 남구,005003, 2세,2021,1218,610,608,100.3,1211,605,606,99.8
21070, 남구,005004, 3세,2021,1379,731,648,112.8,1367,727,640,113.6
21070, 남구,005005, 4세,2021,1604,805,799,100.8,1590,797,793,100.5
21070, 남구,010,5~9세,2021,10241,5222,5019,104,10200,5201,4999,104
21070, 남구,010001, 5세,2021,1896,946,950,99.6,1881,938,943,99.5
21070, 남구,010002, 6세,2021,2018,1057,961,110,2010,1052,958,109.8
21070, 남구,010003, 7세,2021,2001,1027,974,105.4,1991,1020,971,105
21070, 남구,010004, 8세,2021,2089,1085,1004,108.1,2084,1084,1000,108.4
21070, 남구,010005, 9세,2021,2237,1107,1130,98,2234,1107,1127,98.2
21070, 남구,015,10~14세,2021,10900,5613,5287,106.2,10883,5604,5279,106.2
21070, 남구,015001, 10세,2021,2229,1095,1134,96.6,2226,1092,1134,96.3
21070, 남구,015002, 11세,2021,2221,1177,1044,112.7,2216,1175,1041,112.9
21070, 남구,015003, 12세,2021,2032,1033,999,103.4,2029,1031,998,103.3
21070, 남구,015004, 13세,2021,2118,1092,1026,106.4,2117,1092,1025,106.5
21070, 남구,015005, 14세,2021,2300,1216,1084,112.2,2295,1214,1081,112.3
21070, 남구,020,15~19세,2021,11445,5852,5593,104.6,11300,5791,5509,105.1
21070, 남구,020001, 15세,2021,2046,1055,991,106.5,2045,1055,990,106.6
21070, 남구,020002, 16세,2021,2068,1078,990,108.9,2064,1076,988,108.9
21070, 남구,020003, 17세,2021,2151,1121,1030,108.8,2143,1118,1025,109.1
21070, 남구,020004, 18세,2021,2344,1192,1152,103.5,2297,1175,1122,104.7
21070, 남구,020005, 19세,2021,2836,1406,1430,98.3,2751,1367,1384,98.8
21070, 남구,025,20~24세,2021,22012,11237,10775,104.3,19684,9999,9685,103.2
21070, 남구,025001, 20세,2021,3403,1571,1832,85.8,3184,1473,1711,86.1
21070, 남구,025002, 21세,2021,4422,1966,2456,80,4019,1787,2232,80.1
21070, 남구,025003, 22세,2021,4821,2429,2392,101.5,4156,2061,2095,98.4
21070, 남구,025004, 23세,2021,4844,2664,2180,122.2,4237,2328,1909,121.9
21070, 남구,025005, 24세,2021,4522,2607,1915,136.1,4088,2350,1738,135.2
21070, 남구,030,25~29세,2021,18006,9828,8178,120.2,16571,9120,7451,122.4
21070, 남구,030001, 25세,2021,4257,2435,1822,133.6,3873,2217,1656,133.9
21070, 남구,030002, 26세,2021,3758,2057,1701,120.9,3431,1892,1539,122.9
21070, 남구,030003, 27세,2021,3476,1879,1597,117.7,3195,1744,1451,120.2
21070, 남구,030004, 28세,2021,3325,1772,1553,114.1,3082,1672,1410,118.6
21070, 남구,030005, 29세,2021,3190,1685,1505,112,2990,1595,1395,114.3
21070, 남구,035,30~34세,2021,13474,7005,6469,108.3,12679,6650,6029,110.3
21070, 남구,035001, 30세,2021,2957,1571,1386,113.3,2767,1497,1270,117.9
21070, 남구,035002, 31세,2021,2751,1417,1334,106.2,2587,1343,1244,108
21070, 남구,035003, 32세,2021,2682,1432,1250,114.6,2541,1361,1180,115.3
21070, 남구,035004, 33세,2021,2440,1272,1168,108.9,2288,1203,1085,110.9
21070, 남구,035005, 34세,2021,2644,1313,1331,98.6,2496,1246,1250,99.7
21070, 남구,040,35~39세,2021,15184,7702,7482,102.9,14648,7456,7192,103.7
21070, 남구,040001, 35세,2021,2632,1372,1260,108.9,2510,1316,1194,110.2
21070, 남구,040002, 36세,2021,2609,1312,1297,101.2,2499,1255,1244,100.9
21070, 남구,040003, 37세,2021,2933,1494,1439,103.8,2810,1442,1368,105.4
21070, 남구,040004, 38세,2021,3285,1648,1637,100.7,3203,1614,1589,101.6
21070, 남구,040005, 39세,2021,3725,1876,1849,101.5,3626,1829,1797,101.8
21070, 남구,045,40~44세,2021,19209,9512,9697,98.1,18818,9317,9501,98.1
21070, 남구,045001, 40세,2021,3889,1945,1944,100.1,3798,1893,1905,99.4
21070, 남구,045002, 41세,2021,4057,2032,2025,100.3,3974,1996,1978,100.9
21070, 남구,045003, 42세,2021,3962,1922,2040,94.2,3890,1881,2009,93.6
21070, 남구,045004, 43세,2021,3604,1800,1804,99.8,3528,1768,1760,100.5
21070, 남구,045005, 44세,2021,3697,1813,1884,96.2,3628,1779,1849,96.2
21070, 남구,050,45~49세,2021,20429,10381,10048,103.3,20134,10238,9896,103.5
21070, 남구,050001, 45세,2021,3524,1730,1794,96.4,3464,1701,1763,96.5
21070, 남구,050002, 46세,2021,3896,2013,1883,106.9,3832,1981,1851,107
21070, 남구,050003, 47세,2021,4313,2192,2121,103.3,4256,2164,2092,103.4
21070, 남구,050004, 48세,2021,4368,2206,2162,102,4308,2184,2124,102.8
21070, 남구,050005, 49세,2021,4328,2240,2088,107.3,4274,2208,2066,106.9
21070, 남구,055,50~54세,2021,21792,10732,11060,97,21560,10617,10943,97
21070, 남구,055001, 50세,2021,4593,2247,2346,95.8,4546,2216,2330,95.1
21070, 남구,055002, 51세,2021,4432,2159,2273,95,4372,2128,2244,94.8
21070, 남구,055003, 52세,2021,4451,2269,2182,104,4408,2248,2160,104.1
21070, 남구,055004, 53세,2021,4351,2124,2227,95.4,4312,2108,2204,95.6
21070, 남구,055005, 54세,2021,3965,1933,2032,95.1,3922,1917,2005,95.6
21070, 남구,060,55~59세,2021,19540,9430,10110,93.3,19396,9354,10042,93.1
21070, 남구,060001, 55세,2021,3895,1880,2015,93.3,3858,1861,1997,93.2
21070, 남구,060002, 56세,2021,3769,1826,1943,94,3735,1806,1929,93.6
21070, 남구,060003, 57세,2021,3729,1861,1868,99.6,3702,1845,1857,99.4
21070, 남구,060004, 58세,2021,4014,1926,2088,92.2,3995,1917,2078,92.3
21070, 남구,060005, 59세,2021,4133,1937,2196,88.2,4106,1925,2181,88.3
21070, 남구,065,60~64세,2021,22346,10303,12043,85.6,22251,10266,11985,85.7
21070, 남구,065001, 60세,2021,4549,2084,2465,84.5,4529,2074,2455,84.5
21070, 남구,065002, 61세,2021,4841,2202,2639,83.4,4820,2195,2625,83.6
21070, 남구,065003, 62세,2021,4317,2011,2306,87.2,4297,2008,2289,87.7
21070, 남구,065004, 63세,2021,4251,1965,2286,86,4228,1954,2274,85.9
21070, 남구,065005, 64세,2021,4388,2041,2347,87,4377,2035,2342,86.9
21070, 남구,070,65~69세,2021,18544,8434,10110,83.4,18503,8416,10087,83.4
21070, 남구,070001, 65세,2021,4041,1795,2246,79.9,4026,1788,2238,79.9
21070, 남구,070002, 66세,2021,4308,1948,2360,82.5,4300,1945,2355,82.6
21070, 남구,070003, 67세,2021,3537,1663,1874,88.7,3531,1661,1870,88.8
21070, 남구,070004, 68세,2021,3161,1448,1713,84.5,3156,1445,1711,84.5
21070, 남구,070005, 69세,2021,3497,1580,1917,82.4,3490,1577,1913,82.4
21070, 남구,075,70~74세,2021,14239,6370,7869,81,14215,6360,7855,81
21070, 남구,075001, 70세,2021,2835,1274,1561,81.6,2831,1271,1560,81.5
21070, 남구,075002, 71세,2021,2945,1315,1630,80.7,2936,1312,1624,80.8
21070, 남구,075003, 72세,2021,2976,1333,1643,81.1,2970,1331,1639,81.2
21070, 남구,075004, 73세,2021,2793,1232,1561,78.9,2790,1231,1559,79
21070, 남구,075005, 74세,2021,2690,1216,1474,82.5,2688,1215,1473,82.5
21070, 남구,080,75~79세,2021,10444,4632,5812,79.7,10437,4630,5807,79.7
21070, 남구,080001, 75세,2021,1995,911,1084,84,1994,911,1083,84.1
21070, 남구,080002, 76세,2021,2006,892,1114,80.1,2004,892,1112,80.2
21070, 남구,080003, 77세,2021,2132,919,1213,75.8,2130,918,1212,75.7
21070, 남구,080004, 78세,2021,2171,930,1241,74.9,2171,930,1241,74.9
21070, 남구,080005, 79세,2021,2140,980,1160,84.5,2138,979,1159,84.5
21070, 남구,085,80~84세,2021,6735,2808,3927,71.5,6724,2804,3920,71.5
21070, 남구,085001, 80세,2021,1659,699,960,72.8,1657,698,959,72.8
21070, 남구,085002, 81세,2021,1556,662,894,74,1553,662,891,74.3
21070, 남구,085003, 82세,2021,1391,580,811,71.5,1388,578,810,71.4
21070, 남구,085004, 83세,2021,1144,473,671,70.5,1142,472,670,70.4
21070, 남구,085005, 84세,2021,985,394,591,66.7,984,394,590,66.8
21070, 남구,090,85~89세,2021,2944,947,1997,47.4,2941,946,1995,47.4
21070, 남구,090001, 85세,2021,853,294,559,52.6,852,294,558,52.7
21070, 남구,090002, 86세,2021,700,230,470,48.9,700,230,470,48.9
21070, 남구,090003, 87세,2021,589,178,411,43.3,589,178,411,43.3
21070, 남구,090004, 88세,2021,427,138,289,47.8,426,138,288,47.9
21070, 남구,090005, 89세,2021,375,107,268,39.9,374,106,268,39.6
21070, 남구,095,90~94세,2021,863,191,672,28.4,862,191,671,28.5
21070, 남구,095001, 90세,2021,255,66,189,34.9,254,66,188,35.1
21070, 남구,095002, 91세,2021,203,52,151,34.4,203,52,151,34.4
21070, 남구,095003, 92세,2021,172,36,136,26.5,172,36,136,26.5
21070, 남구,095004, 93세,2021,134,23,111,20.7,134,23,111,20.7
21070, 남구,095005, 94세,2021,99,14,85,16.5,99,14,85,16.5
21070, 남구,100,95~99세,2021,161,30,131,22.9,160,30,130,23.1
21070, 남구,100001, 95세,2021,57,8,49,16.3,57,8,49,16.3
21070, 남구,100002, 96세,2021,55,6,49,12.2,55,6,49,12.2
21070, 남구,100003, 97세,2021,17,6,11,54.5,17,6,11,54.5
21070, 남구,100004, 98세,2021,16,8,8,100,15,8,7,114.3
21070, 남구,100005, 99세,2021,16,X,14,14.3,16,X,14,14.3
21070, 남구,101,100세이상,2021,21,X,18,16.7,21,X,18,16.7
21070, 남구,102,15세미만,2021,27368,14015,13353,105,27252,13957,13295,105
21070, 남구,103,15~64세,2021,183437,91982,91455,100.6,177041,88808,88233,100.7
21070, 남구,104,65세이상,2021,53951,23415,30536,76.7,53863,23380,30483,76.7
21070, 남구,086,85세이상,2021,3989,1171,2818,41.6,3984,1170,2814,41.6
21070, 남구,126,평균연령,2021,44.9,43.5,46.2,,45.2,43.9,46.5,
21070, 남구,127,중위연령,2021,46.6,44.8,48.2,,47.2,45.5,48.8,
21080, 북구,000,합계,2021,279815,137830,141985,97.1,277083,136652,140431,97.3
21080, 북구,005,0~4세,2021,7661,3930,3731,105.3,7655,3929,3726,105.4
21080, 북구,005001, 0세,2021,1285,674,611,110.3,1285,674,611,110.3
21080, 북구,005002, 1세,2021,1365,675,690,97.8,1363,674,689,97.8
21080, 북구,005003, 2세,2021,1465,755,710,106.3,1463,755,708,106.6
21080, 북구,005004, 3세,2021,1692,862,830,103.9,1692,862,830,103.9
21080, 북구,005005, 4세,2021,1854,964,890,108.3,1852,964,888,108.6
21080, 북구,010,5~9세,2021,10634,5488,5146,106.6,10619,5483,5136,106.8
21080, 북구,010001, 5세,2021,2121,1076,1045,103,2116,1075,1041,103.3
21080, 북구,010002, 6세,2021,2158,1130,1028,109.9,2156,1130,1026,110.1
21080, 북구,010003, 7세,2021,2084,1051,1033,101.7,2080,1049,1031,101.7
21080, 북구,010004, 8세,2021,2054,1057,997,106,2052,1057,995,106.2
21080, 북구,010005, 9세,2021,2217,1174,1043,112.6,2215,1172,1043,112.4
21080, 북구,015,10~14세,2021,10498,5393,5105,105.6,10492,5389,5103,105.6
21080, 북구,015001, 10세,2021,2139,1118,1021,109.5,2138,1118,1020,109.6
21080, 북구,015002, 11세,2021,2029,1068,961,111.1,2027,1067,960,111.1
21080, 북구,015003, 12세,2021,2095,1049,1046,100.3,2094,1048,1046,100.2
21080, 북구,015004, 13세,2021,2111,1072,1039,103.2,2111,1072,1039,103.2
21080, 북구,015005, 14세,2021,2124,1086,1038,104.6,2122,1084,1038,104.4
21080, 북구,020,15~19세,2021,11216,5906,5310,111.2,11196,5899,5297,111.4
21080, 북구,020001, 15세,2021,2119,1149,970,118.5,2118,1148,970,118.4
21080, 북구,020002, 16세,2021,2137,1138,999,113.9,2132,1137,995,114.3
21080, 북구,020003, 17세,2021,2195,1143,1052,108.7,2193,1142,1051,108.7
21080, 북구,020004, 18세,2021,2347,1219,1128,108.1,2345,1218,1127,108.1
21080, 북구,020005, 19세,2021,2418,1257,1161,108.3,2408,1254,1154,108.7
21080, 북구,025,20~24세,2021,16864,9257,7607,121.7,16284,8958,7326,122.3
21080, 북구,025001, 20세,2021,2965,1606,1359,118.2,2950,1599,1351,118.4
21080, 북구,025002, 21세,2021,3383,1882,1501,125.4,3309,1855,1454,127.6
21080, 북구,025003, 22세,2021,3293,1834,1459,125.7,3146,1757,1389,126.5
21080, 북구,025004, 23세,2021,3593,1980,1613,122.8,3416,1884,1532,123
21080, 북구,025005, 24세,2021,3630,1955,1675,116.7,3463,1863,1600,116.4
21080, 북구,030,25~29세,2021,19201,10212,8989,113.6,18576,9883,8693,113.7
21080, 북구,030001, 25세,2021,3853,2053,1800,114.1,3686,1961,1725,113.7
21080, 북구,030002, 26세,2021,3893,2115,1778,119,3756,2037,1719,118.5
21080, 북구,030003, 27세,2021,3802,2037,1765,115.4,3680,1967,1713,114.8
21080, 북구,030004, 28세,2021,3798,2017,1781,113.3,3678,1958,1720,113.8
21080, 북구,030005, 29세,2021,3855,1990,1865,106.7,3776,1960,1816,107.9
21080, 북구,035,30~34세,2021,16522,8570,7952,107.8,16127,8429,7698,109.5
21080, 북구,035001, 30세,2021,3579,1945,1634,119,3504,1918,1586,120.9
21080, 북구,035002, 31세,2021,3408,1773,1635,108.4,3315,1737,1578,110.1
21080, 북구,035003, 32세,2021,3305,1720,1585,108.5,3223,1691,1532,110.4
21080, 북구,035004, 33세,2021,3157,1548,1609,96.2,3066,1518,1548,98.1
21080, 북구,035005, 34세,2021,3073,1584,1489,106.4,3019,1565,1454,107.6
21080, 북구,040,35~39세,2021,16876,8747,8129,107.6,16602,8663,7939,109.1
21080, 북구,040001, 35세,2021,3035,1547,1488,104,2983,1533,1450,105.7
21080, 북구,040002, 36세,2021,3147,1646,1501,109.7,3085,1627,1458,111.6
21080, 북구,040003, 37세,2021,3214,1697,1517,111.9,3172,1682,1490,112.9
21080, 북구,040004, 38세,2021,3554,1837,1717,107,3489,1818,1671,108.8
21080, 북구,040005, 39세,2021,3926,2020,1906,106,3873,2003,1870,107.1
21080, 북구,045,40~44세,2021,18905,9598,9307,103.1,18704,9529,9175,103.9
21080, 북구,045001, 40세,2021,3943,2010,1933,104,3906,1999,1907,104.8
21080, 북구,045002, 41세,2021,4043,2058,1985,103.7,4007,2045,1962,104.2
21080, 북구,045003, 42세,2021,3903,1942,1961,99,3852,1924,1928,99.8
21080, 북구,045004, 43세,2021,3425,1746,1679,104,3387,1732,1655,104.7
21080, 북구,045005, 44세,2021,3591,1842,1749,105.3,3552,1829,1723,106.2
21080, 북구,050,45~49세,2021,20052,9718,10334,94,19870,9657,10213,94.6
21080, 북구,050001, 45세,2021,3393,1724,1669,103.3,3354,1714,1640,104.5
21080, 북구,050002, 46세,2021,3871,1888,1983,95.2,3829,1872,1957,95.7
21080, 북구,050003, 47세,2021,4094,2005,2089,96,4059,1993,2066,96.5
21080, 북구,050004, 48세,2021,4394,2041,2353,86.7,4359,2031,2328,87.2
21080, 북구,050005, 49세,2021,4300,2060,2240,92,4269,2047,2222,92.1
21080, 북구,055,50~54세,2021,25270,11667,13603,85.8,25117,11605,13512,85.9
21080, 북구,055001, 50세,2021,4739,2227,2512,88.7,4700,2210,2490,88.8
21080, 북구,055002, 51세,2021,4930,2288,2642,86.6,4897,2277,2620,86.9
21080, 북구,055003, 52세,2021,5089,2337,2752,84.9,5063,2330,2733,85.3
21080, 북구,055004, 53세,2021,5376,2455,2921,84,5348,2438,2910,83.8
21080, 북구,055005, 54세,2021,5136,2360,2776,85,5109,2350,2759,85.2
21080, 북구,060,55~59세,2021,26403,12600,13803,91.3,26287,12556,13731,91.4
21080, 북구,060001, 55세,2021,5122,2432,2690,90.4,5095,2425,2670,90.8
21080, 북구,060002, 56세,2021,5209,2423,2786,87,5189,2415,2774,87.1
21080, 북구,060003, 57세,2021,4881,2303,2578,89.3,4859,2297,2562,89.7
21080, 북구,060004, 58세,2021,5531,2675,2856,93.7,5506,2660,2846,93.5
21080, 북구,060005, 59세,2021,5660,2767,2893,95.6,5638,2759,2879,95.8
21080, 북구,065,60~64세,2021,27990,13784,14206,97,27907,13740,14167,97
21080, 북구,065001, 60세,2021,6417,3141,3276,95.9,6396,3130,3266,95.8
21080, 북구,065002, 61세,2021,6082,2965,3117,95.1,6065,2957,3108,95.1
21080, 북구,065003, 62세,2021,5427,2679,2748,97.5,5415,2672,2743,97.4
21080, 북구,065004, 63세,2021,5020,2490,2530,98.4,5004,2480,2524,98.3
21080, 북구,065005, 64세,2021,5044,2509,2535,99,5027,2501,2526,99
21080, 북구,070,65~69세,2021,19819,9656,10163,95,19780,9639,10141,95
21080, 북구,070001, 65세,2021,4528,2213,2315,95.6,4515,2205,2310,95.5
21080, 북구,070002, 66세,2021,4728,2260,2468,91.6,4718,2256,2462,91.6
21080, 북구,070003, 67세,2021,3814,1875,1939,96.7,3805,1872,1933,96.8
21080, 북구,070004, 68세,2021,3219,1576,1643,95.9,3215,1575,1640,96
21080, 북구,070005, 69세,2021,3530,1732,1798,96.3,3527,1731,1796,96.4
21080, 북구,075,70~74세,2021,13097,6171,6926,89.1,13078,6166,6912,89.2
21080, 북구,075001, 70세,2021,2671,1292,1379,93.7,2666,1291,1375,93.9
21080, 북구,075002, 71세,2021,2831,1394,1437,97,2827,1394,1433,97.3
21080, 북구,075003, 72세,2021,2660,1222,1438,85,2658,1221,1437,85
21080, 북구,075004, 73세,2021,2537,1158,1379,84,2533,1157,1376,84.1
21080, 북구,075005, 74세,2021,2398,1105,1293,85.5,2394,1103,1291,85.4
21080, 북구,080,75~79세,2021,8831,3944,4887,80.7,8820,3939,4881,80.7
21080, 북구,080001, 75세,2021,1786,850,936,90.8,1784,850,934,91
21080, 북구,080002, 76세,2021,1643,757,886,85.4,1643,757,886,85.4
21080, 북구,080003, 77세,2021,1678,737,941,78.3,1676,736,940,78.3
21080, 북구,080004, 78세,2021,1753,778,975,79.8,1751,776,975,79.6
21080, 북구,080005, 79세,2021,1971,822,1149,71.5,1966,820,1146,71.6
21080, 북구,085,80~84세,2021,5901,2184,3717,58.8,5898,2183,3715,58.8
21080, 북구,085001, 80세,2021,1483,588,895,65.7,1483,588,895,65.7
21080, 북구,085002, 81세,2021,1303,497,806,61.7,1302,497,805,61.7
21080, 북구,085003, 82세,2021,1205,436,769,56.7,1204,435,769,56.6
21080, 북구,085004, 83세,2021,1021,351,670,52.4,1021,351,670,52.4
21080, 북구,085005, 84세,2021,889,312,577,54.1,888,312,576,54.2
21080, 북구,090,85~89세,2021,2914,803,2111,38,2912,803,2109,38.1
21080, 북구,090001, 85세,2021,790,236,554,42.6,789,236,553,42.7
21080, 북구,090002, 86세,2021,723,215,508,42.3,723,215,508,42.3
21080, 북구,090003, 87세,2021,572,157,415,37.8,571,157,414,37.9
21080, 북구,090004, 88세,2021,445,117,328,35.7,445,117,328,35.7
21080, 북구,090005, 89세,2021,384,78,306,25.5,384,78,306,25.5
21080, 북구,095,90~94세,2021,941,170,771,22,940,170,770,22.1
21080, 북구,095001, 90세,2021,289,51,238,21.4,288,51,237,21.5
21080, 북구,095002, 91세,2021,209,37,172,21.5,209,37,172,21.5
21080, 북구,095003, 92세,2021,189,37,152,24.3,189,37,152,24.3
21080, 북구,095004, 93세,2021,154,26,128,20.3,154,26,128,20.3
21080, 북구,095005, 94세,2021,100,19,81,23.5,100,19,81,23.5
21080, 북구,100,95~99세,2021,194,29,165,17.6,193,29,164,17.7
21080, 북구,100001, 95세,2021,65,12,53,22.6,65,12,53,22.6
21080, 북구,100002, 96세,2021,53,X,49,8.2,52,X,48,8.3
21080, 북구,100003, 97세,2021,33,8,25,32,33,8,25,32
21080, 북구,100004, 98세,2021,30,X,26,15.4,30,X,26,15.4
21080, 북구,100005, 99세,2021,13,X,12,8.3,13,X,12,8.3
21080, 북구,101,100세이상,2021,26,X,23,13,26,X,23,13
21080, 북구,102,15세미만,2021,28793,14811,13982,105.9,28766,14801,13965,106
21080, 북구,103,15~64세,2021,199299,100059,99240,100.8,196670,98919,97751,101.2
21080, 북구,104,65세이상,2021,51723,22960,28763,79.8,51647,22932,28715,79.9
21080, 북구,086,85세이상,2021,4075,1005,3070,32.7,4071,1005,3066,32.8
21080, 북구,126,평균연령,2021,45.3,44,46.6,,45.4,44,46.7,
21080, 북구,127,중위연령,2021,48,46,49.7,,48.2,46.2,50,
21090, 해운대구,000,합계,2021,386064,185903,200161,92.9,381351,183670,197681,92.9
21090, 해운대구,005,0~4세,2021,10515,5393,5122,105.3,10372,5320,5052,105.3
21090, 해운대구,005001, 0세,2021,1675,855,820,104.3,1659,845,814,103.8
21090, 해운대구,005002, 1세,2021,1890,972,918,105.9,1873,964,909,106.1
21090, 해운대구,005003, 2세,2021,2063,1057,1006,105.1,2035,1037,998,103.9
21090, 해운대구,005004, 3세,2021,2358,1186,1172,101.2,2325,1168,1157,101
21090, 해운대구,005005, 4세,2021,2529,1323,1206,109.7,2480,1306,1174,111.2
21090, 해운대구,010,5~9세,2021,16419,8454,7965,106.1,16215,8364,7851,106.5
21090, 해운대구,010001, 5세,2021,2977,1511,1466,103.1,2926,1487,1439,103.3
21090, 해운대구,010002, 6세,2021,3293,1665,1628,102.3,3232,1638,1594,102.8
21090, 해운대구,010003, 7세,2021,3199,1648,1551,106.3,3162,1630,1532,106.4
21090, 해운대구,010004, 8세,2021,3366,1777,1589,111.8,3338,1766,1572,112.3
21090, 해운대구,010005, 9세,2021,3584,1853,1731,107,3557,1843,1714,107.5
21090, 해운대구,015,10~14세,2021,17788,9145,8643,105.8,17684,9097,8587,105.9
21090, 해운대구,015001, 10세,2021,3597,1864,1733,107.6,3584,1859,1725,107.8
21090, 해운대구,015002, 11세,2021,3494,1798,1696,106,3469,1790,1679,106.6
21090, 해운대구,015003, 12세,2021,3401,1759,1642,107.1,3383,1747,1636,106.8
21090, 해운대구,015004, 13세,2021,3596,1824,1772,102.9,3572,1812,1760,103
21090, 해운대구,015005, 14세,2021,3700,1900,1800,105.6,3676,1889,1787,105.7
21090, 해운대구,020,15~19세,2021,17700,9375,8325,112.6,17577,9312,8265,112.7
21090, 해운대구,020001, 15세,2021,3434,1762,1672,105.4,3419,1754,1665,105.3
21090, 해운대구,020002, 16세,2021,3418,1763,1655,106.5,3402,1753,1649,106.3
21090, 해운대구,020003, 17세,2021,3684,1936,1748,110.8,3668,1926,1742,110.6
21090, 해운대구,020004, 18세,2021,3749,2041,1708,119.5,3732,2037,1695,120.2
21090, 해운대구,020005, 19세,2021,3415,1873,1542,121.5,3356,1842,1514,121.7
21090, 해운대구,025,20~24세,2021,21165,11320,9845,115,20630,11078,9552,116
21090, 해운대구,025001, 20세,2021,3945,2157,1788,120.6,3866,2126,1740,122.2
21090, 해운대구,025002, 21세,2021,4283,2374,1909,124.4,4198,2340,1858,125.9
21090, 해운대구,025003, 22세,2021,4205,2289,1916,119.5,4086,2233,1853,120.5
21090, 해운대구,025004, 23세,2021,4303,2268,2035,111.4,4164,2196,1968,111.6
21090, 해운대구,025005, 24세,2021,4429,2232,2197,101.6,4316,2183,2133,102.3
21090, 해운대구,030,25~29세,2021,23273,11947,11326,105.5,22723,11721,11002,106.5
21090, 해운대구,030001, 25세,2021,4767,2447,2320,105.5,4657,2412,2245,107.4
21090, 해운대구,030002, 26세,2021,4539,2345,2194,106.9,4431,2306,2125,108.5
21090, 해운대구,030003, 27세,2021,4664,2408,2256,106.7,4553,2361,2192,107.7
21090, 해운대구,030004, 28세,2021,4676,2395,2281,105,4551,2340,2211,105.8
21090, 해운대구,030005, 29세,2021,4627,2352,2275,103.4,4531,2302,2229,103.3
21090, 해운대구,035,30~34세,2021,20361,10074,10287,97.9,19749,9813,9936,98.8
21090, 해운대구,035001, 30세,2021,4312,2156,2156,100,4185,2108,2077,101.5
21090, 해운대구,035002, 31세,2021,4072,2054,2018,101.8,3954,2001,1953,102.5
21090, 해운대구,035003, 32세,2021,4062,2003,2059,97.3,3932,1951,1981,98.5
21090, 해운대구,035004, 33세,2021,3911,1924,1987,96.8,3808,1879,1929,97.4
21090, 해운대구,035005, 34세,2021,4004,1937,2067,93.7,3870,1874,1996,93.9
21090, 해운대구,040,35~39세,2021,23756,11490,12266,93.7,23191,11221,11970,93.7
21090, 해운대구,040001, 35세,2021,4123,1977,2146,92.1,4001,1926,2075,92.8
21090, 해운대구,040002, 36세,2021,4182,2040,2142,95.2,4073,1987,2086,95.3
21090, 해운대구,040003, 37세,2021,4629,2272,2357,96.4,4512,2217,2295,96.6
21090, 해운대구,040004, 38세,2021,5106,2410,2696,89.4,5007,2358,2649,89
21090, 해운대구,040005, 39세,2021,5716,2791,2925,95.4,5598,2733,2865,95.4
21090, 해운대구,045,40~44세,2021,29921,14323,15598,91.8,29479,14101,15378,91.7
21090, 해운대구,045001, 40세,2021,6006,2896,3110,93.1,5925,2860,3065,93.3
21090, 해운대구,045002, 41세,2021,6426,3003,3423,87.7,6323,2958,3365,87.9
21090, 해운대구,045003, 42세,2021,5996,2791,3205,87.1,5904,2743,3161,86.8
21090, 해운대구,045004, 43세,2021,5642,2754,2888,95.4,5557,2710,2847,95.2
21090, 해운대구,045005, 44세,2021,5851,2879,2972,96.9,5770,2830,2940,96.3
21090, 해운대구,050,45~49세,2021,32506,15408,17098,90.1,32130,15213,16917,89.9
21090, 해운대구,050001, 45세,2021,5697,2797,2900,96.4,5606,2754,2852,96.6
21090, 해운대구,050002, 46세,2021,6134,2854,3280,87,6060,2813,3247,86.6
21090, 해운대구,050003, 47세,2021,6783,3158,3625,87.1,6703,3120,3583,87.1
21090, 해운대구,050004, 48세,2021,6742,3207,3535,90.7,6668,3168,3500,90.5
21090, 해운대구,050005, 49세,2021,7150,3392,3758,90.3,7093,3358,3735,89.9
21090, 해운대구,055,50~54세,2021,36043,17063,18980,89.9,35710,16885,18825,89.7
21090, 해운대구,055001, 50세,2021,7568,3564,4004,89,7481,3522,3959,89
21090, 해운대구,055002, 51세,2021,7391,3508,3883,90.3,7322,3473,3849,90.2
21090, 해운대구,055003, 52세,2021,7209,3449,3760,91.7,7141,3410,3731,91.4
21090, 해운대구,055004, 53세,2021,7214,3460,3754,92.2,7157,3432,3725,92.1
21090, 해운대구,055005, 54세,2021,6661,3082,3579,86.1,6609,3048,3561,85.6
21090, 해운대구,060,55~59세,2021,32151,15312,16839,90.9,31860,15171,16689,90.9
21090, 해운대구,060001, 55세,2021,6292,3030,3262,92.9,6243,3010,3233,93.1
21090, 해운대구,060002, 56세,2021,6389,3012,3377,89.2,6317,2979,3338,89.2
21090, 해운대구,060003, 57세,2021,6009,2821,3188,88.5,5956,2793,3163,88.3
21090, 해운대구,060004, 58세,2021,6806,3240,3566,90.9,6736,3206,3530,90.8
21090, 해운대구,060005, 59세,2021,6655,3209,3446,93.1,6608,3183,3425,92.9
21090, 해운대구,065,60~64세,2021,33205,15539,17666,88,32998,15442,17556,88
21090, 해운대구,065001, 60세,2021,7184,3334,3850,86.6,7143,3314,3829,86.6
21090, 해운대구,065002, 61세,2021,7123,3345,3778,88.5,7068,3320,3748,88.6
21090, 해운대구,065003, 62세,2021,6468,3075,3393,90.6,6426,3055,3371,90.6
21090, 해운대구,065004, 63세,2021,6277,2943,3334,88.3,6246,2927,3319,88.2
21090, 해운대구,065005, 64세,2021,6153,2842,3311,85.8,6115,2826,3289,85.9
21090, 해운대구,070,65~69세,2021,25893,12239,13654,89.6,25775,12174,13601,89.5
21090, 해운대구,070001, 65세,2021,5885,2872,3013,95.3,5854,2859,2995,95.5
21090, 해운대구,070002, 66세,2021,5987,2768,3219,86,5964,2756,3208,85.9
21090, 해운대구,070003, 67세,2021,4880,2401,2479,96.9,4852,2385,2467,96.7
21090, 해운대구,070004, 68세,2021,4393,2021,2372,85.2,4378,2012,2366,85
21090, 해운대구,070005, 69세,2021,4748,2177,2571,84.7,4727,2162,2565,84.3
21090, 해운대구,075,70~74세,2021,18053,8224,9829,83.7,17999,8193,9806,83.6
21090, 해운대구,075001, 70세,2021,3538,1644,1894,86.8,3529,1638,1891,86.6
21090, 해운대구,075002, 71세,2021,3677,1684,1993,84.5,3662,1676,1986,84.4
21090, 해운대구,075003, 72세,2021,3804,1680,2124,79.1,3790,1671,2119,78.9
21090, 해운대구,075004, 73세,2021,3626,1664,1962,84.8,3617,1660,1957,84.8
21090, 해운대구,075005, 74세,2021,3408,1552,1856,83.6,3401,1548,1853,83.5
21090, 해운대구,080,75~79세,2021,12633,5473,7160,76.4,12606,5457,7149,76.3
21090, 해운대구,080001, 75세,2021,2396,1080,1316,82.1,2392,1077,1315,81.9
21090, 해운대구,080002, 76세,2021,2524,1145,1379,83,2516,1140,1376,82.8
21090, 해운대구,080003, 77세,2021,2528,1150,1378,83.5,2522,1147,1375,83.4
21090, 해운대구,080004, 78세,2021,2528,1030,1498,68.8,2528,1030,1498,68.8
21090, 해운대구,080005, 79세,2021,2657,1068,1589,67.2,2648,1063,1585,67.1
21090, 해운대구,085,80~84세,2021,8974,3445,5529,62.3,8954,3434,5520,62.2
21090, 해운대구,085001, 80세,2021,2224,863,1361,63.4,2219,861,1358,63.4
21090, 해운대구,085002, 81세,2021,1954,783,1171,66.9,1947,779,1168,66.7
21090, 해운대구,085003, 82세,2021,1849,729,1120,65.1,1846,727,1119,65
21090, 해운대구,085004, 83세,2021,1565,584,981,59.5,1565,584,981,59.5
21090, 해운대구,085005, 84세,2021,1382,486,896,54.2,1377,483,894,54
21090, 해운대구,090,85~89세,2021,4127,1307,2820,46.3,4121,1304,2817,46.3
21090, 해운대구,090001, 85세,2021,1146,380,766,49.6,1144,378,766,49.3
21090, 해운대구,090002, 86세,2021,1006,317,689,46,1004,317,687,46.1
21090, 해운대구,090003, 87세,2021,788,266,522,51,786,265,521,50.9
21090, 해운대구,090004, 88세,2021,650,193,457,42.2,650,193,457,42.2
21090, 해운대구,090005, 89세,2021,537,151,386,39.1,537,151,386,39.1
21090, 해운대구,095,90~94세,2021,1324,320,1004,31.9,1322,319,1003,31.8
21090, 해운대구,095001, 90세,2021,392,103,289,35.6,392,103,289,35.6
21090, 해운대구,095002, 91세,2021,306,65,241,27,306,65,241,27
21090, 해운대구,095003, 92세,2021,275,73,202,36.1,273,72,201,35.8
21090, 해운대구,095004, 93세,2021,200,41,159,25.8,200,41,159,25.8
21090, 해운대구,095005, 94세,2021,151,38,113,33.6,151,38,113,33.6
21090, 해운대구,100,95~99세,2021,230,47,183,25.7,229,46,183,25.1
21090, 해운대구,100001, 95세,2021,71,11,60,18.3,71,11,60,18.3
21090, 해운대구,100002, 96세,2021,55,10,45,22.2,54,9,45,20
21090, 해운대구,100003, 97세,2021,38,9,29,31,38,9,29,31
21090, 해운대구,100004, 98세,2021,34,5,29,17.2,34,5,29,17.2
21090, 해운대구,100005, 99세,2021,32,12,20,60,32,12,20,60
21090, 해운대구,101,100세이상,2021,27,5,22,22.7,27,5,22,22.7
21090, 해운대구,102,15세미만,2021,44722,22992,21730,105.8,44271,22781,21490,106
21090, 해운대구,103,15~64세,2021,270081,131851,138230,95.4,266047,129957,136090,95.5
21090, 해운대구,104,65세이상,2021,71261,31060,40201,77.3,71033,30932,40101,77.1
21090, 해운대구,086,85세이상,2021,5708,1679,4029,41.7,5699,1674,4025,41.6
21090, 해운대구,126,평균연령,2021,44.7,43.4,46,,44.8,43.4,46.1,
21090, 해운대구,127,중위연령,2021,47,45.5,48.3,,47.2,45.7,48.4,
21100, 사하구,000,합계,2021,305790,151916,153874,98.7,300780,148945,151835,98.1
21100, 사하구,005,0~4세,2021,7291,3779,3512,107.6,7241,3753,3488,107.6
21100, 사하구,005001, 0세,2021,1192,631,561,112.5,1183,628,555,113.2
21100, 사하구,005002, 1세,2021,1282,657,625,105.1,1266,648,618,104.9
21100, 사하구,005003, 2세,2021,1379,713,666,107.1,1373,710,663,107.1
21100, 사하구,005004, 3세,2021,1669,832,837,99.4,1657,824,833,98.9
21100, 사하구,005005, 4세,2021,1769,946,823,114.9,1762,943,819,115.1
21100, 사하구,010,5~9세,2021,10958,5630,5328,105.7,10911,5606,5305,105.7
21100, 사하구,010001, 5세,2021,2036,1048,988,106.1,2022,1040,982,105.9
21100, 사하구,010002, 6세,2021,2173,1143,1030,111,2160,1137,1023,111.1
21100, 사하구,010003, 7세,2021,2155,1107,1048,105.6,2148,1104,1044,105.7
21100, 사하구,010004, 8세,2021,2148,1107,1041,106.3,2141,1101,1040,105.9
21100, 사하구,010005, 9세,2021,2446,1225,1221,100.3,2440,1224,1216,100.7
21100, 사하구,015,10~14세,2021,11656,6018,5638,106.7,11633,6009,5624,106.8
21100, 사하구,015001, 10세,2021,2475,1253,1222,102.5,2471,1252,1219,102.7
21100, 사하구,015002, 11세,2021,2210,1127,1083,104.1,2205,1125,1080,104.2
21100, 사하구,015003, 12세,2021,2210,1161,1049,110.7,2205,1159,1046,110.8
21100, 사하구,015004, 13세,2021,2352,1222,1130,108.1,2347,1220,1127,108.3
21100, 사하구,015005, 14세,2021,2409,1255,1154,108.8,2405,1253,1152,108.8
21100, 사하구,020,15~19세,2021,13231,6847,6384,107.3,13193,6836,6357,107.5
21100, 사하구,020001, 15세,2021,2185,1121,1064,105.4,2177,1120,1057,106
21100, 사하구,020002, 16세,2021,2274,1147,1127,101.8,2269,1147,1122,102.2
21100, 사하구,020003, 17세,2021,2710,1369,1341,102.1,2705,1367,1338,102.2
21100, 사하구,020004, 18세,2021,2887,1562,1325,117.9,2880,1558,1322,117.9
21100, 사하구,020005, 19세,2021,3175,1648,1527,107.9,3162,1644,1518,108.3
21100, 사하구,025,20~24세,2021,19220,10088,9132,110.5,18887,9905,8982,110.3
21100, 사하구,025001, 20세,2021,3464,1761,1703,103.4,3433,1747,1686,103.6
21100, 사하구,025002, 21세,2021,3840,1938,1902,101.9,3804,1925,1879,102.4
21100, 사하구,025003, 22세,2021,3762,2002,1760,113.8,3709,1973,1736,113.7
21100, 사하구,025004, 23세,2021,4067,2180,1887,115.5,3976,2130,1846,115.4
21100, 사하구,025005, 24세,2021,4087,2207,1880,117.4,3965,2130,1835,116.1
21100, 사하구,030,25~29세,2021,20087,11023,9064,121.6,19236,10479,8757,119.7
21100, 사하구,030001, 25세,2021,4153,2370,1783,132.9,4004,2274,1730,131.4
21100, 사하구,030002, 26세,2021,4040,2230,1810,123.2,3866,2120,1746,121.4
21100, 사하구,030003, 27세,2021,4000,2198,1802,122,3825,2088,1737,120.2
21100, 사하구,030004, 28세,2021,3961,2154,1807,119.2,3784,2036,1748,116.5
21100, 사하구,030005, 29세,2021,3933,2071,1862,111.2,3757,1961,1796,109.2
21100, 사하구,035,30~34세,2021,16892,9278,7614,121.9,15843,8584,7259,118.3
21100, 사하구,035001, 30세,2021,3642,2003,1639,122.2,3418,1859,1559,119.2
21100, 사하구,035002, 31세,2021,3561,1981,1580,125.4,3340,1834,1506,121.8
21100, 사하구,035003, 32세,2021,3352,1846,1506,122.6,3128,1700,1428,119
21100, 사하구,035004, 33세,2021,3214,1769,1445,122.4,3042,1644,1398,117.6
21100, 사하구,035005, 34세,2021,3123,1679,1444,116.3,2915,1547,1368,113.1
21100, 사하구,040,35~39세,2021,18812,9981,8831,113,18007,9486,8521,111.3
21100, 사하구,040001, 35세,2021,3284,1762,1522,115.8,3104,1659,1445,114.8
21100, 사하구,040002, 36세,2021,3457,1847,1610,114.7,3287,1741,1546,112.6
21100, 사하구,040003, 37세,2021,3614,1914,1700,112.6,3447,1808,1639,110.3
21100, 사하구,040004, 38세,2021,4061,2152,1909,112.7,3919,2063,1856,111.2
21100, 사하구,040005, 39세,2021,4396,2306,2090,110.3,4250,2215,2035,108.8
21100, 사하구,045,40~44세,2021,21644,11372,10272,110.7,21109,11032,10077,109.5
21100, 사하구,045001, 40세,2021,4692,2438,2254,108.2,4562,2352,2210,106.4
21100, 사하구,045002, 41세,2021,4651,2464,2187,112.7,4552,2397,2155,111.2
21100, 사하구,045003, 42세,2021,4285,2269,2016,112.5,4172,2200,1972,111.6
21100, 사하구,045004, 43세,2021,4002,2104,1898,110.9,3913,2056,1857,110.7
21100, 사하구,045005, 44세,2021,4014,2097,1917,109.4,3910,2027,1883,107.6
21100, 사하구,050,45~49세,2021,22443,11258,11185,100.7,22043,11038,11005,100.3
21100, 사하구,050001, 45세,2021,3865,1933,1932,100.1,3781,1892,1889,100.2
21100, 사하구,050002, 46세,2021,4225,2126,2099,101.3,4133,2077,2056,101
21100, 사하구,050003, 47세,2021,4729,2369,2360,100.4,4646,2316,2330,99.4
21100, 사하구,050004, 48세,2021,4835,2437,2398,101.6,4760,2396,2364,101.4
21100, 사하구,050005, 49세,2021,4789,2393,2396,99.9,4723,2357,2366,99.6
21100, 사하구,055,50~54세,2021,26288,12829,13459,95.3,25949,12655,13294,95.2
21100, 사하구,055001, 50세,2021,5239,2631,2608,100.9,5164,2587,2577,100.4
21100, 사하구,055002, 51세,2021,5235,2581,2654,97.2,5167,2542,2625,96.8
21100, 사하구,055003, 52세,2021,5322,2553,2769,92.2,5244,2514,2730,92.1
21100, 사하구,055004, 53세,2021,5441,2674,2767,96.6,5381,2643,2738,96.5
21100, 사하구,055005, 54세,2021,5051,2390,2661,89.8,4993,2369,2624,90.3
21100, 사하구,060,55~59세,2021,25966,12612,13354,94.4,25721,12489,13232,94.4
21100, 사하구,060001, 55세,2021,4970,2447,2523,97,4913,2417,2496,96.8
21100, 사하구,060002, 56세,2021,5089,2424,2665,91,5026,2391,2635,90.7
21100, 사하구,060003, 57세,2021,4759,2326,2433,95.6,4720,2310,2410,95.9
21100, 사하구,060004, 58세,2021,5372,2608,2764,94.4,5323,2578,2745,93.9
21100, 사하구,060005, 59세,2021,5776,2807,2969,94.5,5739,2793,2946,94.8
21100, 사하구,065,60~64세,2021,29432,13938,15494,90,29269,13864,15405,90
21100, 사하구,065001, 60세,2021,6225,2916,3309,88.1,6201,2905,3296,88.1
21100, 사하구,065002, 61세,2021,6452,3040,3412,89.1,6409,3020,3389,89.1
21100, 사하구,065003, 62세,2021,5622,2660,2962,89.8,5589,2647,2942,90
21100, 사하구,065004, 63세,2021,5487,2630,2857,92.1,5455,2618,2837,92.3
21100, 사하구,065005, 64세,2021,5646,2692,2954,91.1,5615,2674,2941,90.9
21100, 사하구,070,65~69세,2021,22931,11013,11918,92.4,22861,10982,11879,92.4
21100, 사하구,070001, 65세,2021,5024,2377,2647,89.8,5010,2372,2638,89.9
21100, 사하구,070002, 66세,2021,5319,2533,2786,90.9,5306,2529,2777,91.1
21100, 사하구,070003, 67세,2021,4490,2197,2293,95.8,4469,2185,2284,95.7
21100, 사하구,070004, 68세,2021,3985,1884,2101,89.7,3976,1880,2096,89.7
21100, 사하구,070005, 69세,2021,4113,2022,2091,96.7,4100,2016,2084,96.7
21100, 사하구,075,70~74세,2021,15869,7378,8491,86.9,15837,7362,8475,86.9
21100, 사하구,075001, 70세,2021,3248,1528,1720,88.8,3239,1523,1716,88.8
21100, 사하구,075002, 71세,2021,3278,1546,1732,89.3,3270,1542,1728,89.2
21100, 사하구,075003, 72세,2021,3277,1565,1712,91.4,3271,1564,1707,91.6
21100, 사하구,075004, 73세,2021,3122,1439,1683,85.5,3119,1436,1683,85.3
21100, 사하구,075005, 74세,2021,2944,1300,1644,79.1,2938,1297,1641,79
21100, 사하구,080,75~79세,2021,10878,4896,5982,81.8,10866,4893,5973,81.9
21100, 사하구,080001, 75세,2021,2250,1047,1203,87,2245,1047,1198,87.4
21100, 사하구,080002, 76세,2021,2194,1024,1170,87.5,2192,1023,1169,87.5
21100, 사하구,080003, 77세,2021,2084,938,1146,81.8,2082,938,1144,82
21100, 사하구,080004, 78세,2021,2064,919,1145,80.3,2063,919,1144,80.3
21100, 사하구,080005, 79세,2021,2286,968,1318,73.4,2284,966,1318,73.3
21100, 사하구,085,80~84세,2021,7296,2740,4556,60.1,7283,2737,4546,60.2
21100, 사하구,085001, 80세,2021,1805,730,1075,67.9,1799,729,1070,68.1
21100, 사하구,085002, 81세,2021,1554,620,934,66.4,1552,620,932,66.5
21100, 사하구,085003, 82세,2021,1505,555,950,58.4,1502,554,948,58.4
21100, 사하구,085004, 83세,2021,1270,447,823,54.3,1269,446,823,54.2
21100, 사하구,085005, 84세,2021,1162,388,774,50.1,1161,388,773,50.2
21100, 사하구,090,85~89세,2021,3367,957,2410,39.7,3363,956,2407,39.7
21100, 사하구,090001, 85세,2021,891,272,619,43.9,891,272,619,43.9
21100, 사하구,090002, 86세,2021,807,233,574,40.6,807,233,574,40.6
21100, 사하구,090003, 87세,2021,711,207,504,41.1,709,207,502,41.2
21100, 사하구,090004, 88세,2021,527,134,393,34.1,526,134,392,34.2
21100, 사하구,090005, 89세,2021,431,111,320,34.7,430,110,320,34.4
21100, 사하구,095,90~94세,2021,1240,234,1006,23.3,1239,234,1005,23.3
21100, 사하구,095001, 90세,2021,307,62,245,25.3,307,62,245,25.3
21100, 사하구,095002, 91세,2021,299,54,245,22,298,54,244,22.1
21100, 사하구,095003, 92세,2021,270,55,215,25.6,270,55,215,25.6
21100, 사하구,095004, 93세,2021,213,39,174,22.4,213,39,174,22.4
21100, 사하구,095005, 94세,2021,151,24,127,18.9,151,24,127,18.9
21100, 사하구,100,95~99세,2021,261,42,219,19.2,261,42,219,19.2
21100, 사하구,100001, 95세,2021,78,18,60,30,78,18,60,30
21100, 사하구,100002, 96세,2021,71,8,63,12.7,71,8,63,12.7
21100, 사하구,100003, 97세,2021,52,9,43,20.9,52,9,43,20.9
21100, 사하구,100004, 98세,2021,40,5,35,14.3,40,5,35,14.3
21100, 사하구,100005, 99세,2021,20,X,18,11.1,20,X,18,11.1
21100, 사하구,101,100세이상,2021,28,X,25,12,28,X,25,12
21100, 사하구,102,15세미만,2021,29905,15427,14478,106.6,29785,15368,14417,106.6
21100, 사하구,103,15~64세,2021,214015,109226,104789,104.2,209257,106368,102889,103.4
21100, 사하구,104,65세이상,2021,61870,27263,34607,78.8,61738,27209,34529,78.8
21100, 사하구,086,85세이상,2021,4896,1236,3660,33.8,4891,1235,3656,33.8
21100, 사하구,126,평균연령,2021,45.8,44.3,47.2,,45.9,44.5,47.3,
21100, 사하구,127,중위연령,2021,48.1,46,50,,48.4,46.4,50.2,
21110, 금정구,000,합계,2021,233596,113576,120020,94.6,228788,111654,117134,95.3
21110, 금정구,005,0~4세,2021,4713,2422,2291,105.7,4636,2388,2248,106.2
21110, 금정구,005001, 0세,2021,773,407,366,111.2,763,401,362,110.8
21110, 금정구,005002, 1세,2021,807,408,399,102.3,787,401,386,103.9
21110, 금정구,005003, 2세,2021,899,461,438,105.3,886,455,431,105.6
21110, 금정구,005004, 3세,2021,1036,539,497,108.5,1013,529,484,109.3
21110, 금정구,005005, 4세,2021,1198,607,591,102.7,1187,602,585,102.9
21110, 금정구,010,5~9세,2021,7316,3739,3577,104.5,7263,3723,3540,105.2
21110, 금정구,010001, 5세,2021,1299,685,614,111.6,1284,680,604,112.6
21110, 금정구,010002, 6세,2021,1483,743,740,100.4,1467,738,729,101.2
21110, 금정구,010003, 7세,2021,1453,746,707,105.5,1447,744,703,105.8
21110, 금정구,010004, 8세,2021,1478,737,741,99.5,1469,735,734,100.1
21110, 금정구,010005, 9세,2021,1603,828,775,106.8,1596,826,770,107.3
21110, 금정구,015,10~14세,2021,7934,4095,3839,106.7,7921,4090,3831,106.8
21110, 금정구,015001, 10세,2021,1626,827,799,103.5,1622,826,796,103.8
21110, 금정구,015002, 11세,2021,1543,797,746,106.8,1540,796,744,107
21110, 금정구,015003, 12세,2021,1518,809,709,114.1,1517,809,708,114.3
21110, 금정구,015004, 13세,2021,1568,810,758,106.9,1563,807,756,106.7
21110, 금정구,015005, 14세,2021,1679,852,827,103,1679,852,827,103
21110, 금정구,020,15~19세,2021,10228,5188,5040,102.9,10023,5122,4901,104.5
21110, 금정구,020001, 15세,2021,1553,830,723,114.8,1548,828,720,115
21110, 금정구,020002, 16세,2021,1584,822,762,107.9,1579,820,759,108
21110, 금정구,020003, 17세,2021,1732,884,848,104.2,1725,879,846,103.9
21110, 금정구,020004, 18세,2021,2155,1105,1050,105.2,2118,1093,1025,106.6
21110, 금정구,020005, 19세,2021,3204,1547,1657,93.4,3053,1502,1551,96.8
21110, 금정구,025,20~24세,2021,20847,10277,10570,97.2,19308,9745,9563,101.9
21110, 금정구,025001, 20세,2021,3617,1585,2032,78,3356,1512,1844,82
21110, 금정구,025002, 21세,2021,4114,1813,2301,78.8,3779,1700,2079,81.8
21110, 금정구,025003, 22세,2021,4273,2067,2206,93.7,3967,1955,2012,97.2
21110, 금정구,025004, 23세,2021,4463,2390,2073,115.3,4139,2260,1879,120.3
21110, 금정구,025005, 24세,2021,4380,2422,1958,123.7,4067,2318,1749,132.5
21110, 금정구,030,25~29세,2021,17481,9920,7561,131.2,16494,9529,6965,136.8
21110, 금정구,030001, 25세,2021,4125,2376,1749,135.8,3858,2278,1580,144.2
21110, 금정구,030002, 26세,2021,3680,2153,1527,141,3455,2069,1386,149.3
21110, 금정구,030003, 27세,2021,3499,1988,1511,131.6,3314,1914,1400,136.7
21110, 금정구,030004, 28세,2021,3124,1706,1418,120.3,2960,1631,1329,122.7
21110, 금정구,030005, 29세,2021,3053,1697,1356,125.1,2907,1637,1270,128.9
21110, 금정구,035,30~34세,2021,12135,6476,5659,114.4,11553,6186,5367,115.3
21110, 금정구,035001, 30세,2021,2718,1509,1209,124.8,2591,1441,1150,125.3
21110, 금정구,035002, 31세,2021,2571,1367,1204,113.5,2441,1304,1137,114.7
21110, 금정구,035003, 32세,2021,2370,1256,1114,112.7,2244,1190,1054,112.9
21110, 금정구,035004, 33세,2021,2257,1211,1046,115.8,2158,1162,996,116.7
21110, 금정구,035005, 34세,2021,2219,1133,1086,104.3,2119,1089,1030,105.7
21110, 금정구,040,35~39세,2021,12201,6309,5892,107.1,11792,6124,5668,108
21110, 금정구,040001, 35세,2021,2201,1205,996,121,2112,1164,948,122.8
21110, 금정구,040002, 36세,2021,2162,1124,1038,108.3,2075,1086,989,109.8
21110, 금정구,040003, 37세,2021,2315,1173,1142,102.7,2238,1146,1092,104.9
21110, 금정구,040004, 38세,2021,2628,1324,1304,101.5,2551,1284,1267,101.3
21110, 금정구,040005, 39세,2021,2895,1483,1412,105,2816,1444,1372,105.2
21110, 금정구,045,40~44세,2021,14699,7367,7332,100.5,14453,7267,7186,101.1
21110, 금정구,045001, 40세,2021,2982,1471,1511,97.4,2937,1456,1481,98.3
21110, 금정구,045002, 41세,2021,3135,1566,1569,99.8,3082,1546,1536,100.7
21110, 금정구,045003, 42세,2021,2995,1498,1497,100.1,2947,1478,1469,100.6
21110, 금정구,045004, 43세,2021,2787,1432,1355,105.7,2733,1409,1324,106.4
21110, 금정구,045005, 44세,2021,2800,1400,1400,100,2754,1378,1376,100.1
21110, 금정구,050,45~49세,2021,15639,7684,7955,96.6,15413,7580,7833,96.8
21110, 금정구,050001, 45세,2021,2667,1357,1310,103.6,2623,1338,1285,104.1
21110, 금정구,050002, 46세,2021,2916,1403,1513,92.7,2863,1376,1487,92.5
21110, 금정구,050003, 47세,2021,3237,1636,1601,102.2,3203,1624,1579,102.8
21110, 금정구,050004, 48세,2021,3380,1609,1771,90.9,3335,1585,1750,90.6
21110, 금정구,050005, 49세,2021,3439,1679,1760,95.4,3389,1657,1732,95.7
21110, 금정구,055,50~54세,2021,18821,8883,9938,89.4,18629,8803,9826,89.6
21110, 금정구,055001, 50세,2021,3712,1792,1920,93.3,3667,1776,1891,93.9
21110, 금정구,055002, 51세,2021,3654,1739,1915,90.8,3612,1721,1891,91
21110, 금정구,055003, 52세,2021,3828,1786,2042,87.5,3791,1766,2025,87.2
21110, 금정구,055004, 53세,2021,3898,1883,2015,93.4,3857,1870,1987,94.1
21110, 금정구,055005, 54세,2021,3729,1683,2046,82.3,3702,1670,2032,82.2
21110, 금정구,060,55~59세,2021,19531,9295,10236,90.8,19398,9238,10160,90.9
21110, 금정구,060001, 55세,2021,3738,1801,1937,93,3714,1794,1920,93.4
21110, 금정구,060002, 56세,2021,3744,1787,1957,91.3,3711,1775,1936,91.7
21110, 금정구,060003, 57세,2021,3698,1739,1959,88.8,3667,1724,1943,88.7
21110, 금정구,060004, 58세,2021,4077,1946,2131,91.3,4048,1933,2115,91.4
21110, 금정구,060005, 59세,2021,4274,2022,2252,89.8,4258,2012,2246,89.6
21110, 금정구,065,60~64세,2021,21673,10133,11540,87.8,21591,10097,11494,87.8
21110, 금정구,065001, 60세,2021,4724,2190,2534,86.4,4709,2183,2526,86.4
21110, 금정구,065002, 61세,2021,4574,2093,2481,84.4,4550,2082,2468,84.4
21110, 금정구,065003, 62세,2021,4260,2001,2259,88.6,4250,1998,2252,88.7
21110, 금정구,065004, 63세,2021,4029,1879,2150,87.4,4014,1874,2140,87.6
21110, 금정구,065005, 64세,2021,4086,1970,2116,93.1,4068,1960,2108,93
21110, 금정구,070,65~69세,2021,17556,8116,9440,86,17518,8100,9418,86
21110, 금정구,070001, 65세,2021,3739,1757,1982,88.6,3730,1753,1977,88.7
21110, 금정구,070002, 66세,2021,4142,1909,2233,85.5,4128,1903,2225,85.5
21110, 금정구,070003, 67세,2021,3279,1533,1746,87.8,3272,1529,1743,87.7
21110, 금정구,070004, 68세,2021,3129,1404,1725,81.4,3125,1403,1722,81.5
21110, 금정구,070005, 69세,2021,3267,1513,1754,86.3,3263,1512,1751,86.4
21110, 금정구,075,70~74세,2021,12762,5884,6878,85.5,12745,5878,6867,85.6
21110, 금정구,075001, 70세,2021,2587,1200,1387,86.5,2584,1199,1385,86.6
21110, 금정구,075002, 71세,2021,2559,1185,1374,86.2,2554,1185,1369,86.6
21110, 금정구,075003, 72세,2021,2696,1230,1466,83.9,2690,1226,1464,83.7
21110, 금정구,075004, 73세,2021,2546,1188,1358,87.5,2544,1187,1357,87.5
21110, 금정구,075005, 74세,2021,2374,1081,1293,83.6,2373,1081,1292,83.7
21110, 금정구,080,75~79세,2021,9039,4041,4998,80.9,9034,4038,4996,80.8
21110, 금정구,080001, 75세,2021,1759,804,955,84.2,1757,803,954,84.2
21110, 금정구,080002, 76세,2021,1713,770,943,81.7,1712,769,943,81.5
21110, 금정구,080003, 77세,2021,1830,801,1029,77.8,1830,801,1029,77.8
21110, 금정구,080004, 78세,2021,1841,859,982,87.5,1840,858,982,87.4
21110, 금정구,080005, 79세,2021,1896,807,1089,74.1,1895,807,1088,74.2
21110, 금정구,085,80~84세,2021,6372,2496,3876,64.4,6369,2496,3873,64.4
21110, 금정구,085001, 80세,2021,1608,681,927,73.5,1607,681,926,73.5
21110, 금정구,085002, 81세,2021,1426,550,876,62.8,1425,550,875,62.9
21110, 금정구,085003, 82세,2021,1297,497,800,62.1,1297,497,800,62.1
21110, 금정구,085004, 83세,2021,1118,433,685,63.2,1118,433,685,63.2
21110, 금정구,085005, 84세,2021,923,335,588,57,922,335,587,57.1
21110, 금정구,090,85~89세,2021,3240,961,2279,42.2,3239,960,2279,42.1
21110, 금정구,090001, 85세,2021,833,273,560,48.8,832,272,560,48.6
21110, 금정구,090002, 86세,2021,836,252,584,43.2,836,252,584,43.2
21110, 금정구,090003, 87세,2021,660,193,467,41.3,660,193,467,41.3
21110, 금정구,090004, 88세,2021,481,142,339,41.9,481,142,339,41.9
21110, 금정구,090005, 89세,2021,430,101,329,30.7,430,101,329,30.7
21110, 금정구,095,90~94세,2021,1161,242,919,26.3,1161,242,919,26.3
21110, 금정구,095001, 90세,2021,334,76,258,29.5,334,76,258,29.5
21110, 금정구,095002, 91세,2021,280,60,220,27.3,280,60,220,27.3
21110, 금정구,095003, 92세,2021,252,51,201,25.4,252,51,201,25.4
21110, 금정구,095004, 93세,2021,169,36,133,27.1,169,36,133,27.1
21110, 금정구,095005, 94세,2021,126,19,107,17.8,126,19,107,17.8
21110, 금정구,100,95~99세,2021,221,45,176,25.6,221,45,176,25.6
21110, 금정구,100001, 95세,2021,75,16,59,27.1,75,16,59,27.1
21110, 금정구,100002, 96세,2021,59,13,46,28.3,59,13,46,28.3
21110, 금정구,100003, 97세,2021,31,6,25,24,31,6,25,24
21110, 금정구,100004, 98세,2021,35,6,29,20.7,35,6,29,20.7
21110, 금정구,100005, 99세,2021,21,X,17,23.5,21,X,17,23.5
21110, 금정구,101,100세이상,2021,27,X,24,12.5,27,X,24,12.5
21110, 금정구,102,15세미만,2021,19963,10256,9707,105.7,19820,10201,9619,106.1
21110, 금정구,103,15~64세,2021,163255,81532,81723,99.8,158654,79691,78963,100.9
21110, 금정구,104,65세이상,2021,50378,21788,28590,76.2,50314,21762,28552,76.2
21110, 금정구,086,85세이상,2021,4649,1251,3398,36.8,4648,1250,3398,36.8
21110, 금정구,126,평균연령,2021,45.9,44.4,47.4,,46.3,44.6,47.8,
21110, 금정구,127,중위연령,2021,48.1,45.7,50.2,,48.7,46.2,50.8,
21120, 강서구,000,합계,2021,142110,74929,67181,111.5,136480,70277,66203,106.2
21120, 강서구,005,0~4세,2021,8662,4558,4104,111.1,8617,4533,4084,111
21120, 강서구,005001, 0세,2021,1324,741,583,127.1,1314,736,578,127.3
21120, 강서구,005002, 1세,2021,1532,846,686,123.3,1515,837,678,123.5
21120, 강서구,005003, 2세,2021,1708,872,836,104.3,1702,869,833,104.3
21120, 강서구,005004, 3세,2021,1939,988,951,103.9,1931,984,947,103.9
21120, 강서구,005005, 4세,2021,2159,1111,1048,106,2155,1107,1048,105.6
21120, 강서구,010,5~9세,2021,11157,5736,5421,105.8,11124,5718,5406,105.8
21120, 강서구,010001, 5세,2021,2382,1219,1163,104.8,2371,1212,1159,104.6
21120, 강서구,010002, 6세,2021,2300,1176,1124,104.6,2295,1175,1120,104.9
21120, 강서구,010003, 7세,2021,2258,1150,1108,103.8,2251,1147,1104,103.9
21120, 강서구,010004, 8세,2021,2044,1050,994,105.6,2040,1049,991,105.9
21120, 강서구,010005, 9세,2021,2173,1141,1032,110.6,2167,1135,1032,110
21120, 강서구,015,10~14세,2021,7825,3945,3880,101.7,7813,3937,3876,101.6
21120, 강서구,015001, 10세,2021,1955,993,962,103.2,1952,990,962,102.9
21120, 강서구,015002, 11세,2021,1714,863,851,101.4,1712,862,850,101.4
21120, 강서구,015003, 12세,2021,1517,779,738,105.6,1516,778,738,105.4
21120, 강서구,015004, 13세,2021,1429,737,692,106.5,1426,736,690,106.7
21120, 강서구,015005, 14세,2021,1210,573,637,90,1207,571,636,89.8
21120, 강서구,020,15~19세,2021,4338,2234,2104,106.2,4321,2224,2097,106.1
21120, 강서구,020001, 15세,2021,1012,512,500,102.4,1010,511,499,102.4
21120, 강서구,020002, 16세,2021,966,504,462,109.1,965,503,462,108.9
21120, 강서구,020003, 17세,2021,888,460,428,107.5,884,458,426,107.5
21120, 강서구,020004, 18세,2021,775,409,366,111.7,772,407,365,111.5
21120, 강서구,020005, 19세,2021,697,349,348,100.3,690,345,345,100
21120, 강서구,025,20~24세,2021,4947,2850,2097,135.9,4586,2557,2029,126
21120, 강서구,025001, 20세,2021,859,479,380,126.1,843,468,375,124.8
21120, 강서구,025002, 21세,2021,947,568,379,149.9,922,551,371,148.5
21120, 강서구,025003, 22세,2021,919,554,365,151.8,863,503,360,139.7
21120, 강서구,025004, 23세,2021,1097,612,485,126.2,987,521,466,111.8
21120, 강서구,025005, 24세,2021,1125,637,488,130.5,971,514,457,112.5
21120, 강서구,030,25~29세,2021,8417,4870,3547,137.3,7259,3884,3375,115.1
21120, 강서구,030001, 25세,2021,1432,830,602,137.9,1236,661,575,115
21120, 강서구,030002, 26세,2021,1470,869,601,144.6,1250,680,570,119.3
21120, 강서구,030003, 27세,2021,1603,957,646,148.1,1383,767,616,124.5
21120, 강서구,030004, 28세,2021,1889,1099,790,139.1,1633,875,758,115.4
21120, 강서구,030005, 29세,2021,2023,1115,908,122.8,1757,901,856,105.3
21120, 강서구,035,30~34세,2021,12222,6603,5619,117.5,10817,5380,5437,99
21120, 강서구,035001, 30세,2021,2114,1132,982,115.3,1863,926,937,98.8
21120, 강서구,035002, 31세,2021,2281,1253,1028,121.9,1991,998,993,100.5
21120, 강서구,035003, 32세,2021,2524,1372,1152,119.1,2225,1108,1117,99.2
21120, 강서구,035004, 33세,2021,2536,1376,1160,118.6,2270,1147,1123,102.1
21120, 강서구,035005, 34세,2021,2767,1470,1297,113.3,2468,1201,1267,94.8
21120, 강서구,040,35~39세,2021,16671,8978,7693,116.7,15525,7993,7532,106.1
21120, 강서구,040001, 35세,2021,2856,1543,1313,117.5,2592,1321,1271,103.9
21120, 강서구,040002, 36세,2021,2962,1571,1391,112.9,2732,1372,1360,100.9
21120, 강서구,040003, 37세,2021,3344,1768,1576,112.2,3100,1554,1546,100.5
21120, 강서구,040004, 38세,2021,3627,1944,1683,115.5,3423,1772,1651,107.3
21120, 강서구,040005, 39세,2021,3882,2152,1730,124.4,3678,1974,1704,115.8
21120, 강서구,045,40~44세,2021,15539,8674,6865,126.4,14894,8134,6760,120.3
21120, 강서구,045001, 40세,2021,3777,2040,1737,117.4,3604,1891,1713,110.4
21120, 강서구,045002, 41세,2021,3525,1948,1577,123.5,3388,1830,1558,117.5
21120, 강서구,045003, 42세,2021,3109,1746,1363,128.1,2974,1634,1340,121.9
21120, 강서구,045004, 43세,2021,2692,1557,1135,137.2,2586,1473,1113,132.3
21120, 강서구,045005, 44세,2021,2436,1383,1053,131.3,2342,1306,1036,126.1
21120, 강서구,050,45~49세,2021,10139,5734,4405,130.2,9805,5480,4325,126.7
21120, 강서구,050001, 45세,2021,2161,1243,918,135.4,2083,1182,901,131.2
21120, 강서구,050002, 46세,2021,2154,1222,932,131.1,2087,1170,917,127.6
21120, 강서구,050003, 47세,2021,2076,1201,875,137.3,2015,1155,860,134.3
21120, 강서구,050004, 48세,2021,1983,1089,894,121.8,1907,1034,873,118.4
21120, 강서구,050005, 49세,2021,1765,979,786,124.6,1713,939,774,121.3
21120, 강서구,055,50~54세,2021,8618,4513,4105,109.9,8381,4339,4042,107.3
21120, 강서구,055001, 50세,2021,1878,1035,843,122.8,1820,988,832,118.8
21120, 강서구,055002, 51세,2021,1764,935,829,112.8,1719,902,817,110.4
21120, 강서구,055003, 52세,2021,1725,925,800,115.6,1677,890,787,113.1
21120, 강서구,055004, 53세,2021,1711,869,842,103.2,1668,840,828,101.4
21120, 강서구,055005, 54세,2021,1540,749,791,94.7,1497,719,778,92.4
21120, 강서구,060,55~59세,2021,8107,4035,4072,99.1,7992,3958,4034,98.1
21120, 강서구,060001, 55세,2021,1539,831,708,117.4,1504,804,700,114.9
21120, 강서구,060002, 56세,2021,1575,771,804,95.9,1556,759,797,95.2
21120, 강서구,060003, 57세,2021,1506,705,801,88,1481,691,790,87.5
21120, 강서구,060004, 58세,2021,1685,859,826,104,1665,845,820,103
21120, 강서구,060005, 59세,2021,1802,869,933,93.1,1786,859,927,92.7
21120, 강서구,065,60~64세,2021,9279,4533,4746,95.5,9219,4500,4719,95.4
21120, 강서구,065001, 60세,2021,2027,967,1060,91.2,2016,960,1056,90.9
21120, 강서구,065002, 61세,2021,1961,954,1007,94.7,1939,940,999,94.1
21120, 강서구,065003, 62세,2021,1798,881,917,96.1,1789,878,911,96.4
21120, 강서구,065004, 63세,2021,1720,861,859,100.2,1710,858,852,100.7
21120, 강서구,065005, 64세,2021,1773,870,903,96.3,1765,864,901,95.9
21120, 강서구,070,65~69세,2021,6781,3416,3365,101.5,6737,3395,3342,101.6
21120, 강서구,070001, 65세,2021,1565,771,794,97.1,1556,764,792,96.5
21120, 강서구,070002, 66세,2021,1617,836,781,107,1609,834,775,107.6
21120, 강서구,070003, 67세,2021,1263,649,614,105.7,1251,642,609,105.4
21120, 강서구,070004, 68세,2021,1170,576,594,97,1162,572,590,96.9
21120, 강서구,070005, 69세,2021,1166,584,582,100.3,1159,583,576,101.2
21120, 강서구,075,70~74세,2021,4153,2101,2052,102.4,4138,2097,2041,102.7
21120, 강서구,075001, 70세,2021,954,493,461,106.9,948,492,456,107.9
21120, 강서구,075002, 71세,2021,845,439,406,108.1,842,439,403,108.9
21120, 강서구,075003, 72세,2021,851,386,465,83,848,384,464,82.8
21120, 강서구,075004, 73세,2021,788,393,395,99.5,786,392,394,99.5
21120, 강서구,075005, 74세,2021,715,390,325,120,714,390,324,120.4
21120, 강서구,080,75~79세,2021,2508,1198,1310,91.5,2506,1197,1309,91.4
21120, 강서구,080001, 75세,2021,528,272,256,106.3,526,271,255,106.3
21120, 강서구,080002, 76세,2021,472,228,244,93.4,472,228,244,93.4
21120, 강서구,080003, 77세,2021,491,247,244,101.2,491,247,244,101.2
21120, 강서구,080004, 78세,2021,469,201,268,75,469,201,268,75
21120, 강서구,080005, 79세,2021,548,250,298,83.9,548,250,298,83.9
21120, 강서구,085,80~84세,2021,1690,670,1020,65.7,1689,670,1019,65.8
21120, 강서구,085001, 80세,2021,407,183,224,81.7,407,183,224,81.7
21120, 강서구,085002, 81세,2021,376,155,221,70.1,376,155,221,70.1
21120, 강서구,085003, 82세,2021,366,136,230,59.1,366,136,230,59.1
21120, 강서구,085004, 83세,2021,283,98,185,53,282,98,184,53.3
21120, 강서구,085005, 84세,2021,258,98,160,61.3,258,98,160,61.3
21120, 강서구,090,85~89세,2021,736,204,532,38.3,736,204,532,38.3
21120, 강서구,090001, 85세,2021,197,58,139,41.7,197,58,139,41.7
21120, 강서구,090002, 86세,2021,177,46,131,35.1,177,46,131,35.1
21120, 강서구,090003, 87세,2021,155,45,110,40.9,155,45,110,40.9
21120, 강서구,090004, 88세,2021,108,33,75,44,108,33,75,44
21120, 강서구,090005, 89세,2021,99,22,77,28.6,99,22,77,28.6
21120, 강서구,095,90~94세,2021,271,68,203,33.5,271,68,203,33.5
21120, 강서구,095001, 90세,2021,81,29,52,55.8,81,29,52,55.8
21120, 강서구,095002, 91세,2021,71,8,63,12.7,71,8,63,12.7
21120, 강서구,095003, 92세,2021,63,15,48,31.3,63,15,48,31.3
21120, 강서구,095004, 93세,2021,32,10,22,45.5,32,10,22,45.5
21120, 강서구,095005, 94세,2021,24,6,18,33.3,24,6,18,33.3
21120, 강서구,100,95~99세,2021,42,7,35,20,42,7,35,20
21120, 강서구,100001, 95세,2021,16,X,15,6.7,16,X,15,6.7
21120, 강서구,100002, 96세,2021,11,X,9,22.2,11,X,9,22.2
21120, 강서구,100003, 97세,2021,5,X,X,66.7,5,X,X,66.7
21120, 강서구,100004, 98세,2021,6,X,5,20,6,X,5,20
21120, 강서구,100005, 99세,2021,X,X,X,33.3,X,X,X,33.3
21120, 강서구,101,100세이상,2021,8,X,6,33.3,8,X,6,33.3
21120, 강서구,102,15세미만,2021,27644,14239,13405,106.2,27554,14188,13366,106.1
21120, 강서구,103,15~64세,2021,98277,53024,45253,117.2,92799,48449,44350,109.2
21120, 강서구,104,65세이상,2021,16189,7666,8523,89.9,16127,7640,8487,90
21120, 강서구,086,85세이상,2021,1057,281,776,36.2,1057,281,776,36.2
21120, 강서구,126,평균연령,2021,38.5,37.9,39.1,,38.6,38.1,39.2,
21120, 강서구,127,중위연령,2021,39.2,38.9,39.5,,39.5,39.4,39.6,
21130, 연제구,000,합계,2021,201217,96290,104927,91.8,200233,95932,104301,92
21130, 연제구,005,0~4세,2021,5640,2836,2804,101.1,5629,2829,2800,101
21130, 연제구,005001, 0세,2021,981,473,508,93.1,980,472,508,92.9
21130, 연제구,005002, 1세,2021,974,505,469,107.7,972,504,468,107.7
21130, 연제구,005003, 2세,2021,1213,609,604,100.8,1210,607,603,100.7
21130, 연제구,005004, 3세,2021,1165,613,552,111.1,1163,611,552,110.7
21130, 연제구,005005, 4세,2021,1307,636,671,94.8,1304,635,669,94.9
21130, 연제구,010,5~9세,2021,7934,3996,3938,101.5,7922,3991,3931,101.5
21130, 연제구,010001, 5세,2021,1582,823,759,108.4,1577,819,758,108
21130, 연제구,010002, 6세,2021,1585,828,757,109.4,1583,827,756,109.4
21130, 연제구,010003, 7세,2021,1593,811,782,103.7,1592,811,781,103.8
21130, 연제구,010004, 8세,2021,1557,731,826,88.5,1554,731,823,88.8
21130, 연제구,010005, 9세,2021,1617,803,814,98.6,1616,803,813,98.8
21130, 연제구,015,10~14세,2021,7774,4028,3746,107.5,7770,4025,3745,107.5
21130, 연제구,015001, 10세,2021,1615,850,765,111.1,1615,850,765,111.1
21130, 연제구,015002, 11세,2021,1538,765,773,99,1537,765,772,99.1
21130, 연제구,015003, 12세,2021,1432,746,686,108.7,1432,746,686,108.7
21130, 연제구,015004, 13세,2021,1538,792,746,106.2,1536,790,746,105.9
21130, 연제구,015005, 14세,2021,1651,875,776,112.8,1650,874,776,112.6
21130, 연제구,020,15~19세,2021,7763,3943,3820,103.2,7753,3936,3817,103.1
21130, 연제구,020001, 15세,2021,1472,752,720,104.4,1471,751,720,104.3
21130, 연제구,020002, 16세,2021,1452,738,714,103.4,1449,736,713,103.2
21130, 연제구,020003, 17세,2021,1519,768,751,102.3,1519,768,751,102.3
21130, 연제구,020004, 18세,2021,1612,799,813,98.3,1608,796,812,98
21130, 연제구,020005, 19세,2021,1708,886,822,107.8,1706,885,821,107.8
21130, 연제구,025,20~24세,2021,11282,5785,5497,105.2,11227,5769,5458,105.7
21130, 연제구,025001, 20세,2021,2004,1049,955,109.8,2001,1048,953,110
21130, 연제구,025002, 21세,2021,2317,1203,1114,108,2310,1202,1108,108.5
21130, 연제구,025003, 22세,2021,2226,1142,1084,105.4,2218,1140,1078,105.8
21130, 연제구,025004, 23세,2021,2373,1205,1168,103.2,2357,1199,1158,103.5
21130, 연제구,025005, 24세,2021,2362,1186,1176,100.9,2341,1180,1161,101.6
21130, 연제구,030,25~29세,2021,13046,6462,6584,98.1,12927,6434,6493,99.1
21130, 연제구,030001, 25세,2021,2582,1306,1276,102.4,2558,1301,1257,103.5
21130, 연제구,030002, 26세,2021,2535,1215,1320,92,2514,1210,1304,92.8
21130, 연제구,030003, 27세,2021,2676,1302,1374,94.8,2654,1298,1356,95.7
21130, 연제구,030004, 28세,2021,2560,1277,1283,99.5,2540,1273,1267,100.5
21130, 연제구,030005, 29세,2021,2693,1362,1331,102.3,2661,1352,1309,103.3
21130, 연제구,035,30~34세,2021,12157,6062,6095,99.5,11969,5998,5971,100.5
21130, 연제구,035001, 30세,2021,2544,1245,1299,95.8,2505,1236,1269,97.4
21130, 연제구,035002, 31세,2021,2490,1230,1260,97.6,2454,1218,1236,98.5
21130, 연제구,035003, 32세,2021,2461,1257,1204,104.4,2431,1243,1188,104.6
21130, 연제구,035004, 33세,2021,2318,1128,1190,94.8,2280,1115,1165,95.7
21130, 연제구,035005, 34세,2021,2344,1202,1142,105.3,2299,1186,1113,106.6
21130, 연제구,040,35~39세,2021,13230,6636,6594,100.6,13078,6583,6495,101.4
21130, 연제구,040001, 35세,2021,2428,1249,1179,105.9,2399,1237,1162,106.5
21130, 연제구,040002, 36세,2021,2385,1170,1215,96.3,2347,1159,1188,97.6
21130, 연제구,040003, 37세,2021,2469,1263,1206,104.7,2445,1255,1190,105.5
21130, 연제구,040004, 38세,2021,2858,1430,1428,100.1,2827,1416,1411,100.4
21130, 연제구,040005, 39세,2021,3090,1524,1566,97.3,3060,1516,1544,98.2
21130, 연제구,045,40~44세,2021,15057,7371,7686,95.9,14947,7329,7618,96.2
21130, 연제구,045001, 40세,2021,3176,1622,1554,104.4,3151,1615,1536,105.1
21130, 연제구,045002, 41세,2021,3232,1580,1652,95.6,3215,1575,1640,96
21130, 연제구,045003, 42세,2021,3068,1518,1550,97.9,3044,1508,1536,98.2
21130, 연제구,045004, 43세,2021,2784,1304,1480,88.1,2760,1295,1465,88.4
21130, 연제구,045005, 44세,2021,2797,1347,1450,92.9,2777,1336,1441,92.7
21130, 연제구,050,45~49세,2021,15119,7407,7712,96,15027,7375,7652,96.4
21130, 연제구,050001, 45세,2021,2685,1323,1362,97.1,2673,1318,1355,97.3
21130, 연제구,050002, 46세,2021,2788,1347,1441,93.5,2767,1342,1425,94.2
21130, 연제구,050003, 47세,2021,3196,1581,1615,97.9,3175,1577,1598,98.7
21130, 연제구,050004, 48세,2021,3175,1543,1632,94.5,3150,1533,1617,94.8
21130, 연제구,050005, 49세,2021,3275,1613,1662,97.1,3262,1605,1657,96.9
21130, 연제구,055,50~54세,2021,16786,7919,8867,89.3,16705,7883,8822,89.4
21130, 연제구,055001, 50세,2021,3378,1625,1753,92.7,3367,1619,1748,92.6
21130, 연제구,055002, 51세,2021,3359,1587,1772,89.6,3334,1579,1755,90
21130, 연제구,055003, 52세,2021,3272,1518,1754,86.5,3257,1509,1748,86.3
21130, 연제구,055004, 53세,2021,3499,1659,1840,90.2,3483,1653,1830,90.3
21130, 연제구,055005, 54세,2021,3278,1530,1748,87.5,3264,1523,1741,87.5
21130, 연제구,060,55~59세,2021,15630,7372,8258,89.3,15567,7352,8215,89.5
21130, 연제구,060001, 55세,2021,3087,1487,1600,92.9,3079,1485,1594,93.2
21130, 연제구,060002, 56세,2021,3117,1452,1665,87.2,3104,1446,1658,87.2
21130, 연제구,060003, 57세,2021,2852,1380,1472,93.8,2837,1377,1460,94.3
21130, 연제구,060004, 58세,2021,3174,1475,1699,86.8,3162,1471,1691,87
21130, 연제구,060005, 59세,2021,3400,1578,1822,86.6,3385,1573,1812,86.8
21130, 연제구,065,60~64세,2021,18022,8159,9863,82.7,17974,8133,9841,82.6
21130, 연제구,065001, 60세,2021,3884,1730,2154,80.3,3874,1725,2149,80.3
21130, 연제구,065002, 61세,2021,3824,1715,2109,81.3,3814,1709,2105,81.2
21130, 연제구,065003, 62세,2021,3458,1562,1896,82.4,3452,1557,1895,82.2
21130, 연제구,065004, 63세,2021,3410,1568,1842,85.1,3396,1561,1835,85.1
21130, 연제구,065005, 64세,2021,3446,1584,1862,85.1,3438,1581,1857,85.1
21130, 연제구,070,65~69세,2021,14960,6903,8057,85.7,14933,6890,8043,85.7
21130, 연제구,070001, 65세,2021,3277,1521,1756,86.6,3270,1518,1752,86.6
21130, 연제구,070002, 66세,2021,3347,1538,1809,85,3345,1538,1807,85.1
21130, 연제구,070003, 67세,2021,2892,1397,1495,93.4,2883,1394,1489,93.6
21130, 연제구,070004, 68세,2021,2662,1221,1441,84.7,2656,1217,1439,84.6
21130, 연제구,070005, 69세,2021,2782,1226,1556,78.8,2779,1223,1556,78.6
21130, 연제구,075,70~74세,2021,10703,4885,5818,84,10700,4883,5817,83.9
21130, 연제구,075001, 70세,2021,2099,951,1148,82.8,2098,950,1148,82.8
21130, 연제구,075002, 71세,2021,2160,1025,1135,90.3,2159,1024,1135,90.2
21130, 연제구,075003, 72세,2021,2212,1018,1194,85.3,2211,1018,1193,85.3
21130, 연제구,075004, 73세,2021,2183,976,1207,80.9,2183,976,1207,80.9
21130, 연제구,075005, 74세,2021,2049,915,1134,80.7,2049,915,1134,80.7
21130, 연제구,080,75~79세,2021,7539,3452,4087,84.5,7533,3449,4084,84.5
21130, 연제구,080001, 75세,2021,1454,697,757,92.1,1453,696,757,91.9
21130, 연제구,080002, 76세,2021,1438,664,774,85.8,1437,664,773,85.9
21130, 연제구,080003, 77세,2021,1466,639,827,77.3,1465,638,827,77.1
21130, 연제구,080004, 78세,2021,1592,734,858,85.5,1591,734,857,85.6
21130, 연제구,080005, 79세,2021,1589,718,871,82.4,1587,717,870,82.4
21130, 연제구,085,80~84세,2021,5213,2136,3077,69.4,5212,2135,3077,69.4
21130, 연제구,085001, 80세,2021,1318,544,774,70.3,1318,544,774,70.3
21130, 연제구,085002, 81세,2021,1191,493,698,70.6,1191,493,698,70.6
21130, 연제구,085003, 82세,2021,1077,452,625,72.3,1077,452,625,72.3
21130, 연제구,085004, 83세,2021,812,340,472,72,812,340,472,72
21130, 연제구,085005, 84세,2021,815,307,508,60.4,814,306,508,60.2
21130, 연제구,090,85~89세,2021,2361,732,1629,44.9,2359,732,1627,45
21130, 연제구,090001, 85세,2021,686,250,436,57.3,685,250,435,57.5
21130, 연제구,090002, 86세,2021,574,188,386,48.7,574,188,386,48.7
21130, 연제구,090003, 87세,2021,481,140,341,41.1,481,140,341,41.1
21130, 연제구,090004, 88세,2021,346,106,240,44.2,345,106,239,44.4
21130, 연제구,090005, 89세,2021,274,48,226,21.2,274,48,226,21.2
21130, 연제구,095,90~94세,2021,830,178,652,27.3,830,178,652,27.3
21130, 연제구,095001, 90세,2021,262,64,198,32.3,262,64,198,32.3
21130, 연제구,095002, 91세,2021,184,32,152,21.1,184,32,152,21.1
21130, 연제구,095003, 92세,2021,169,44,125,35.2,169,44,125,35.2
21130, 연제구,095004, 93세,2021,115,21,94,22.3,115,21,94,22.3
21130, 연제구,095005, 94세,2021,100,17,83,20.5,100,17,83,20.5
21130, 연제구,100,95~99세,2021,147,23,124,18.5,147,23,124,18.5
21130, 연제구,100001, 95세,2021,39,5,34,14.7,39,5,34,14.7
21130, 연제구,100002, 96세,2021,42,6,36,16.7,42,6,36,16.7
21130, 연제구,100003, 97세,2021,24,X,20,20,24,X,20,20
21130, 연제구,100004, 98세,2021,25,X,21,19,25,X,21,19
21130, 연제구,100005, 99세,2021,17,X,13,30.8,17,X,13,30.8
21130, 연제구,101,100세이상,2021,24,5,19,26.3,24,5,19,26.3
21130, 연제구,102,15세미만,2021,21348,10860,10488,103.5,21321,10845,10476,103.5
21130, 연제구,103,15~64세,2021,138092,67116,70976,94.6,137174,66792,70382,94.9
21130, 연제구,104,65세이상,2021,41777,18314,23463,78.1,41738,18295,23443,78
21130, 연제구,086,85세이상,2021,3362,938,2424,38.7,3360,938,2422,38.7
21130, 연제구,126,평균연령,2021,45.6,44.4,46.7,,45.6,44.4,46.8,
21130, 연제구,127,중위연령,2021,47.4,45.8,48.8,,47.5,45.8,48.9,
21140, 수영구,000,합계,2021,170720,80283,90437,88.8,169019,79531,89488,88.9
21140, 수영구,005,0~4세,2021,4297,2128,2169,98.1,4265,2109,2156,97.8
21140, 수영구,005001, 0세,2021,808,383,425,90.1,802,380,422,90
21140, 수영구,005002, 1세,2021,769,394,375,105.1,764,390,374,104.3
21140, 수영구,005003, 2세,2021,859,427,432,98.8,853,424,429,98.8
21140, 수영구,005004, 3세,2021,880,436,444,98.2,874,430,444,96.8
21140, 수영구,005005, 4세,2021,981,488,493,99,972,485,487,99.6
21140, 수영구,010,5~9세,2021,5385,2832,2553,110.9,5350,2816,2534,111.1
21140, 수영구,010001, 5세,2021,1080,559,521,107.3,1073,556,517,107.5
21140, 수영구,010002, 6세,2021,1112,561,551,101.8,1104,558,546,102.2
21140, 수영구,010003, 7세,2021,1025,555,470,118.1,1018,551,467,118
21140, 수영구,010004, 8세,2021,1037,543,494,109.9,1031,540,491,110
21140, 수영구,010005, 9세,2021,1131,614,517,118.8,1124,611,513,119.1
21140, 수영구,015,10~14세,2021,5264,2700,2564,105.3,5236,2690,2546,105.7
21140, 수영구,015001, 10세,2021,1107,562,545,103.1,1098,560,538,104.1
21140, 수영구,015002, 11세,2021,982,535,447,119.7,976,532,444,119.8
21140, 수영구,015003, 12세,2021,1008,506,502,100.8,1001,503,498,101
21140, 수영구,015004, 13세,2021,1064,549,515,106.6,1063,549,514,106.8
21140, 수영구,015005, 14세,2021,1103,548,555,98.7,1098,546,552,98.9
21140, 수영구,020,15~19세,2021,5398,2814,2584,108.9,5385,2806,2579,108.8
21140, 수영구,020001, 15세,2021,988,532,456,116.7,982,529,453,116.8
21140, 수영구,020002, 16세,2021,1072,570,502,113.5,1070,568,502,113.1
21140, 수영구,020003, 17세,2021,1140,590,550,107.3,1140,590,550,107.3
21140, 수영구,020004, 18세,2021,1117,566,551,102.7,1115,565,550,102.7
21140, 수영구,020005, 19세,2021,1081,556,525,105.9,1078,554,524,105.7
21140, 수영구,025,20~24세,2021,8981,4289,4692,91.4,8861,4251,4610,92.2
21140, 수영구,025001, 20세,2021,1360,719,641,112.2,1349,717,632,113.4
21140, 수영구,025002, 21세,2021,1662,840,822,102.2,1645,832,813,102.3
21140, 수영구,025003, 22세,2021,1679,804,875,91.9,1656,798,858,93
21140, 수영구,025004, 23세,2021,2009,952,1057,90.1,1981,944,1037,91
21140, 수영구,025005, 24세,2021,2271,974,1297,75.1,2230,960,1270,75.6
21140, 수영구,030,25~29세,2021,13735,6641,7094,93.6,13436,6531,6905,94.6
21140, 수영구,030001, 25세,2021,2492,1191,1301,91.5,2443,1173,1270,92.4
21140, 수영구,030002, 26세,2021,2666,1245,1421,87.6,2617,1230,1387,88.7
21140, 수영구,030003, 27세,2021,2822,1315,1507,87.3,2756,1291,1465,88.1
21140, 수영구,030004, 28세,2021,2887,1459,1428,102.2,2813,1430,1383,103.4
21140, 수영구,030005, 29세,2021,2868,1431,1437,99.6,2807,1407,1400,100.5
21140, 수영구,035,30~34세,2021,11684,5799,5885,98.5,11419,5701,5718,99.7
21140, 수영구,035001, 30세,2021,2633,1274,1359,93.7,2589,1261,1328,95
21140, 수영구,035002, 31세,2021,2461,1235,1226,100.7,2405,1218,1187,102.6
21140, 수영구,035003, 32세,2021,2344,1208,1136,106.3,2294,1188,1106,107.4
21140, 수영구,035004, 33세,2021,2151,1044,1107,94.3,2106,1028,1078,95.4
21140, 수영구,035005, 34세,2021,2095,1038,1057,98.2,2025,1006,1019,98.7
21140, 수영구,040,35~39세,2021,11265,5609,5656,99.2,11029,5487,5542,99
21140, 수영구,040001, 35세,2021,2105,1056,1049,100.7,2061,1035,1026,100.9
21140, 수영구,040002, 36세,2021,2084,1037,1047,99,2041,1013,1028,98.5
21140, 수영구,040003, 37세,2021,2184,1087,1097,99.1,2130,1059,1071,98.9
21140, 수영구,040004, 38세,2021,2382,1196,1186,100.8,2330,1168,1162,100.5
21140, 수영구,040005, 39세,2021,2510,1233,1277,96.6,2467,1212,1255,96.6
21140, 수영구,045,40~44세,2021,12005,6058,5947,101.9,11817,5955,5862,101.6
21140, 수영구,045001, 40세,2021,2588,1307,1281,102,2549,1284,1265,101.5
21140, 수영구,045002, 41세,2021,2621,1341,1280,104.8,2568,1308,1260,103.8
21140, 수영구,045003, 42세,2021,2453,1212,1241,97.7,2424,1202,1222,98.4
21140, 수영구,045004, 43세,2021,2185,1127,1058,106.5,2150,1110,1040,106.7
21140, 수영구,045005, 44세,2021,2158,1071,1087,98.5,2126,1051,1075,97.8
21140, 수영구,050,45~49세,2021,12019,5806,6213,93.4,11895,5746,6149,93.4
21140, 수영구,050001, 45세,2021,2091,1043,1048,99.5,2062,1031,1031,100
21140, 수영구,050002, 46세,2021,2271,1103,1168,94.4,2249,1093,1156,94.6
21140, 수영구,050003, 47세,2021,2500,1221,1279,95.5,2476,1209,1267,95.4
21140, 수영구,050004, 48세,2021,2512,1170,1342,87.2,2488,1157,1331,86.9
21140, 수영구,050005, 49세,2021,2645,1269,1376,92.2,2620,1256,1364,92.1
21140, 수영구,055,50~54세,2021,13547,6388,7159,89.2,13437,6337,7100,89.3
21140, 수영구,055001, 50세,2021,2787,1334,1453,91.8,2761,1320,1441,91.6
21140, 수영구,055002, 51세,2021,2781,1328,1453,91.4,2761,1319,1442,91.5
21140, 수영구,055003, 52세,2021,2694,1246,1448,86,2665,1234,1431,86.2
21140, 수영구,055004, 53세,2021,2749,1296,1453,89.2,2730,1289,1441,89.5
21140, 수영구,055005, 54세,2021,2536,1184,1352,87.6,2520,1175,1345,87.4
21140, 수영구,060,55~59세,2021,12801,5805,6996,83,12710,5763,6947,83
21140, 수영구,060001, 55세,2021,2410,1132,1278,88.6,2393,1122,1271,88.3
21140, 수영구,060002, 56세,2021,2501,1160,1341,86.5,2484,1153,1331,86.6
21140, 수영구,060003, 57세,2021,2362,1056,1306,80.9,2346,1050,1296,81
21140, 수영구,060004, 58세,2021,2730,1230,1500,82,2702,1216,1486,81.8
21140, 수영구,060005, 59세,2021,2798,1227,1571,78.1,2785,1222,1563,78.2
21140, 수영구,065,60~64세,2021,15337,6740,8597,78.4,15267,6707,8560,78.4
21140, 수영구,065001, 60세,2021,3123,1349,1774,76,3111,1342,1769,75.9
21140, 수영구,065002, 61세,2021,3221,1398,1823,76.7,3206,1390,1816,76.5
21140, 수영구,065003, 62세,2021,3026,1353,1673,80.9,3013,1346,1667,80.7
21140, 수영구,065004, 63세,2021,2929,1281,1648,77.7,2911,1275,1636,77.9
21140, 수영구,065005, 64세,2021,3038,1359,1679,80.9,3026,1354,1672,81
21140, 수영구,070,65~69세,2021,13309,5937,7372,80.5,13262,5916,7346,80.5
21140, 수영구,070001, 65세,2021,2904,1279,1625,78.7,2890,1273,1617,78.7
21140, 수영구,070002, 66세,2021,3022,1312,1710,76.7,3011,1307,1704,76.7
21140, 수영구,070003, 67세,2021,2536,1153,1383,83.4,2530,1150,1380,83.3
21140, 수영구,070004, 68세,2021,2329,1056,1273,83,2319,1052,1267,83
21140, 수영구,070005, 69세,2021,2518,1137,1381,82.3,2512,1134,1378,82.3
21140, 수영구,075,70~74세,2021,10063,4448,5615,79.2,10039,4440,5599,79.3
21140, 수영구,075001, 70세,2021,1894,828,1066,77.7,1888,825,1063,77.6
21140, 수영구,075002, 71세,2021,2004,846,1158,73.1,2000,846,1154,73.3
21140, 수영구,075003, 72세,2021,2086,970,1116,86.9,2075,965,1110,86.9
21140, 수영구,075004, 73세,2021,2058,926,1132,81.8,2057,926,1131,81.9
21140, 수영구,075005, 74세,2021,2021,878,1143,76.8,2019,878,1141,77
21140, 수영구,080,75~79세,2021,7142,3254,3888,83.7,7130,3244,3886,83.5
21140, 수영구,080001, 75세,2021,1502,722,780,92.6,1498,719,779,92.3
21140, 수영구,080002, 76세,2021,1319,589,730,80.7,1315,586,729,80.4
21140, 수영구,080003, 77세,2021,1418,638,780,81.8,1417,637,780,81.7
21140, 수영구,080004, 78세,2021,1376,625,751,83.2,1376,625,751,83.2
21140, 수영구,080005, 79세,2021,1527,680,847,80.3,1524,677,847,79.9
21140, 수영구,085,80~84세,2021,5047,2050,2997,68.4,5041,2048,2993,68.4
21140, 수영구,085001, 80세,2021,1257,517,740,69.9,1255,517,738,70.1
21140, 수영구,085002, 81세,2021,1085,465,620,75,1084,464,620,74.8
21140, 수영구,085003, 82세,2021,1059,457,602,75.9,1058,456,602,75.7
21140, 수영구,085004, 83세,2021,850,324,526,61.6,850,324,526,61.6
21140, 수영구,085005, 84세,2021,796,287,509,56.4,794,287,507,56.6
21140, 수영구,090,85~89세,2021,2391,740,1651,44.8,2390,739,1651,44.8
21140, 수영구,090001, 85세,2021,630,233,397,58.7,629,232,397,58.4
21140, 수영구,090002, 86세,2021,577,181,396,45.7,577,181,396,45.7
21140, 수영구,090003, 87세,2021,452,127,325,39.1,452,127,325,39.1
21140, 수영구,090004, 88세,2021,407,115,292,39.4,407,115,292,39.4
21140, 수영구,090005, 89세,2021,325,84,241,34.9,325,84,241,34.9
21140, 수영구,095,90~94세,2021,868,214,654,32.7,868,214,654,32.7
21140, 수영구,095001, 90세,2021,257,74,183,40.4,257,74,183,40.4
21140, 수영구,095002, 91세,2021,204,48,156,30.8,204,48,156,30.8
21140, 수영구,095003, 92세,2021,175,48,127,37.8,175,48,127,37.8
21140, 수영구,095004, 93세,2021,141,25,116,21.6,141,25,116,21.6
21140, 수영구,095005, 94세,2021,91,19,72,26.4,91,19,72,26.4
21140, 수영구,100,95~99세,2021,159,28,131,21.4,159,28,131,21.4
21140, 수영구,100001, 95세,2021,63,15,48,31.3,63,15,48,31.3
21140, 수영구,100002, 96세,2021,34,X,32,6.3,34,X,32,6.3
21140, 수영구,100003, 97세,2021,30,X,28,7.1,30,X,28,7.1
21140, 수영구,100004, 98세,2021,19,X,16,18.8,19,X,16,18.8
21140, 수영구,100005, 99세,2021,13,6,7,85.7,13,6,7,85.7
21140, 수영구,101,100세이상,2021,23,X,20,15,23,X,20,15
21140, 수영구,102,15세미만,2021,14946,7660,7286,105.1,14851,7615,7236,105.2
21140, 수영구,103,15~64세,2021,116772,55949,60823,92,115256,55284,59972,92.2
21140, 수영구,104,65세이상,2021,39002,16674,22328,74.7,38912,16632,22280,74.6
21140, 수영구,086,85세이상,2021,3441,985,2456,40.1,3440,984,2456,40.1
21140, 수영구,126,평균연령,2021,46.8,45.4,48,,46.9,45.4,48.1,
21140, 수영구,127,중위연령,2021,48.2,46.2,49.9,,48.4,46.4,50.1,
21150, 사상구,000,합계,2021,211788,106222,105566,100.6,206202,103251,102951,100.3
21150, 사상구,005,0~4세,2021,4676,2414,2262,106.7,4623,2390,2233,107
21150, 사상구,005001, 0세,2021,761,407,354,115,750,403,347,116.1
21150, 사상구,005002, 1세,2021,843,418,425,98.4,835,414,421,98.3
21150, 사상구,005003, 2세,2021,878,450,428,105.1,864,441,423,104.3
21150, 사상구,005004, 3세,2021,1039,542,497,109.1,1028,539,489,110.2
21150, 사상구,005005, 4세,2021,1155,597,558,107,1146,593,553,107.2
21150, 사상구,010,5~9세,2021,6714,3392,3322,102.1,6662,3366,3296,102.1
21150, 사상구,010001, 5세,2021,1230,628,602,104.3,1210,615,595,103.4
21150, 사상구,010002, 6세,2021,1325,655,670,97.8,1317,653,664,98.3
21150, 사상구,010003, 7세,2021,1278,652,626,104.2,1269,645,624,103.4
21150, 사상구,010004, 8세,2021,1364,680,684,99.4,1357,677,680,99.6
21150, 사상구,010005, 9세,2021,1517,777,740,105,1509,776,733,105.9
21150, 사상구,015,10~14세,2021,6753,3461,3292,105.1,6720,3443,3277,105.1
21150, 사상구,015001, 10세,2021,1404,697,707,98.6,1401,695,706,98.4
21150, 사상구,015002, 11세,2021,1323,691,632,109.3,1315,686,629,109.1
21150, 사상구,015003, 12세,2021,1268,654,614,106.5,1261,651,610,106.7
21150, 사상구,015004, 13세,2021,1402,705,697,101.1,1394,699,695,100.6
21150, 사상구,015005, 14세,2021,1356,714,642,111.2,1349,712,637,111.8
21150, 사상구,020,15~19세,2021,8012,4115,3897,105.6,7869,4051,3818,106.1
21150, 사상구,020001, 15세,2021,1332,708,624,113.5,1325,706,619,114.1
21150, 사상구,020002, 16세,2021,1286,659,627,105.1,1277,654,623,105
21150, 사상구,020003, 17세,2021,1491,776,715,108.5,1478,768,710,108.2
21150, 사상구,020004, 18세,2021,1658,852,806,105.7,1644,846,798,106
21150, 사상구,020005, 19세,2021,2245,1120,1125,99.6,2145,1077,1068,100.8
21150, 사상구,025,20~24세,2021,15061,7711,7350,104.9,13849,7115,6734,105.7
21150, 사상구,025001, 20세,2021,2635,1279,1356,94.3,2399,1190,1209,98.4
21150, 사상구,025002, 21세,2021,2992,1437,1555,92.4,2732,1309,1423,92
21150, 사상구,025003, 22세,2021,3006,1577,1429,110.4,2788,1454,1334,109
21150, 사상구,025004, 23세,2021,3205,1676,1529,109.6,2940,1539,1401,109.9
21150, 사상구,025005, 24세,2021,3223,1742,1481,117.6,2990,1623,1367,118.7
21150, 사상구,030,25~29세,2021,15961,8735,7226,120.9,15121,8276,6845,120.9
21150, 사상구,030001, 25세,2021,3156,1717,1439,119.3,2969,1615,1354,119.3
21150, 사상구,030002, 26세,2021,3201,1756,1445,121.5,3035,1669,1366,122.2
21150, 사상구,030003, 27세,2021,3273,1766,1507,117.2,3111,1680,1431,117.4
21150, 사상구,030004, 28세,2021,3239,1818,1421,127.9,3069,1717,1352,127
21150, 사상구,030005, 29세,2021,3092,1678,1414,118.7,2937,1595,1342,118.9
21150, 사상구,035,30~34세,2021,12902,7070,5832,121.2,12014,6590,5424,121.5
21150, 사상구,035001, 30세,2021,2891,1605,1286,124.8,2734,1513,1221,123.9
21150, 사상구,035002, 31세,2021,2741,1509,1232,122.5,2557,1410,1147,122.9
21150, 사상구,035003, 32세,2021,2525,1347,1178,114.3,2355,1256,1099,114.3
21150, 사상구,035004, 33세,2021,2380,1318,1062,124.1,2176,1215,961,126.4
21150, 사상구,035005, 34세,2021,2365,1291,1074,120.2,2192,1196,996,120.1
21150, 사상구,040,35~39세,2021,12368,6618,5750,115.1,11625,6185,5440,113.7
21150, 사상구,040001, 35세,2021,2301,1280,1021,125.4,2122,1172,950,123.4
21150, 사상구,040002, 36세,2021,2278,1219,1059,115.1,2117,1132,985,114.9
21150, 사상구,040003, 37세,2021,2316,1228,1088,112.9,2189,1149,1040,110.5
21150, 사상구,040004, 38세,2021,2591,1404,1187,118.3,2459,1320,1139,115.9
21150, 사상구,040005, 39세,2021,2882,1487,1395,106.6,2738,1412,1326,106.5
21150, 사상구,045,40~44세,2021,13870,7424,6446,115.2,13404,7148,6256,114.3
21150, 사상구,045001, 40세,2021,2919,1575,1344,117.2,2815,1514,1301,116.4
21150, 사상구,045002, 41세,2021,3044,1644,1400,117.4,2938,1582,1356,116.7
21150, 사상구,045003, 42세,2021,2794,1486,1308,113.6,2699,1434,1265,113.4
21150, 사상구,045004, 43세,2021,2573,1398,1175,119,2490,1346,1144,117.7
21150, 사상구,045005, 44세,2021,2540,1321,1219,108.4,2462,1272,1190,106.9
21150, 사상구,050,45~49세,2021,14387,7426,6961,106.7,14033,7239,6794,106.5
21150, 사상구,050001, 45세,2021,2483,1323,1160,114.1,2417,1286,1131,113.7
21150, 사상구,050002, 46세,2021,2711,1378,1333,103.4,2637,1341,1296,103.5
21150, 사상구,050003, 47세,2021,2939,1557,1382,112.7,2860,1516,1344,112.8
21150, 사상구,050004, 48세,2021,3096,1573,1523,103.3,3027,1533,1494,102.6
21150, 사상구,050005, 49세,2021,3158,1595,1563,102,3092,1563,1529,102.2
21150, 사상구,055,50~54세,2021,18377,8922,9455,94.4,18070,8762,9308,94.1
21150, 사상구,055001, 50세,2021,3321,1644,1677,98,3250,1607,1643,97.8
21150, 사상구,055002, 51세,2021,3593,1783,1810,98.5,3518,1744,1774,98.3
21150, 사상구,055003, 52세,2021,3706,1809,1897,95.4,3646,1779,1867,95.3
21150, 사상구,055004, 53세,2021,3985,1885,2100,89.8,3926,1859,2067,89.9
21150, 사상구,055005, 54세,2021,3772,1801,1971,91.4,3730,1773,1957,90.6
21150, 사상구,060,55~59세,2021,20051,10004,10047,99.6,19820,9878,9942,99.4
21150, 사상구,060001, 55세,2021,3854,1951,1903,102.5,3788,1913,1875,102
21150, 사상구,060002, 56세,2021,3974,1914,2060,92.9,3929,1889,2040,92.6
21150, 사상구,060003, 57세,2021,3790,1903,1887,100.8,3747,1881,1866,100.8
21150, 사상구,060004, 58세,2021,4064,2055,2009,102.3,4033,2036,1997,102
21150, 사상구,060005, 59세,2021,4369,2181,2188,99.7,4323,2159,2164,99.8
21150, 사상구,065,60~64세,2021,22014,10897,11117,98,21886,10831,11055,98
21150, 사상구,065001, 60세,2021,4944,2425,2519,96.3,4922,2417,2505,96.5
21150, 사상구,065002, 61세,2021,4864,2348,2516,93.3,4835,2330,2505,93
21150, 사상구,065003, 62세,2021,4317,2201,2116,104,4291,2186,2105,103.8
21150, 사상구,065004, 63세,2021,3990,1999,1991,100.4,3960,1987,1973,100.7
21150, 사상구,065005, 64세,2021,3899,1924,1975,97.4,3878,1911,1967,97.2
21150, 사상구,070,65~69세,2021,15774,7646,8128,94.1,15693,7607,8086,94.1
21150, 사상구,070001, 65세,2021,3565,1723,1842,93.5,3547,1714,1833,93.5
21150, 사상구,070002, 66세,2021,3671,1756,1915,91.7,3652,1746,1906,91.6
21150, 사상구,070003, 67세,2021,3106,1535,1571,97.7,3090,1527,1563,97.7
21150, 사상구,070004, 68세,2021,2635,1279,1356,94.3,2617,1269,1348,94.1
21150, 사상구,070005, 69세,2021,2797,1353,1444,93.7,2787,1351,1436,94.1
21150, 사상구,075,70~74세,2021,10797,5086,5711,89.1,10761,5072,5689,89.2
21150, 사상구,075001, 70세,2021,2317,1109,1208,91.8,2306,1104,1202,91.8
21150, 사상구,075002, 71세,2021,2202,1035,1167,88.7,2194,1032,1162,88.8
21150, 사상구,075003, 72세,2021,2224,1049,1175,89.3,2219,1047,1172,89.3
21150, 사상구,075004, 73세,2021,2117,1002,1115,89.9,2110,1001,1109,90.3
21150, 사상구,075005, 74세,2021,1937,891,1046,85.2,1932,888,1044,85.1
21150, 사상구,080,75~79세,2021,6773,3010,3763,80,6763,3008,3755,80.1
21150, 사상구,080001, 75세,2021,1358,633,725,87.3,1356,632,724,87.3
21150, 사상구,080002, 76세,2021,1343,582,761,76.5,1341,581,760,76.4
21150, 사상구,080003, 77세,2021,1357,604,753,80.2,1357,604,753,80.2
21150, 사상구,080004, 78세,2021,1341,576,765,75.3,1337,576,761,75.7
21150, 사상구,080005, 79세,2021,1374,615,759,81,1372,615,757,81.2
21150, 사상구,085,80~84세,2021,4443,1630,2813,57.9,4438,1630,2808,58
21150, 사상구,085001, 80세,2021,1145,473,672,70.4,1144,473,671,70.5
21150, 사상구,085002, 81세,2021,960,366,594,61.6,959,366,593,61.7
21150, 사상구,085003, 82세,2021,879,312,567,55,879,312,567,55
21150, 사상구,085004, 83세,2021,766,258,508,50.8,763,258,505,51.1
21150, 사상구,085005, 84세,2021,693,221,472,46.8,693,221,472,46.8
21150, 사상구,090,85~89세,2021,2084,539,1545,34.9,2081,539,1542,35
21150, 사상구,090001, 85세,2021,570,170,400,42.5,568,170,398,42.7
21150, 사상구,090002, 86세,2021,501,123,378,32.5,500,123,377,32.6
21150, 사상구,090003, 87세,2021,405,94,311,30.2,405,94,311,30.2
21150, 사상구,090004, 88세,2021,348,91,257,35.4,348,91,257,35.4
21150, 사상구,090005, 89세,2021,260,61,199,30.7,260,61,199,30.7
21150, 사상구,095,90~94세,2021,607,100,507,19.7,606,99,507,19.5
21150, 사상구,095001, 90세,2021,160,26,134,19.4,159,25,134,18.7
21150, 사상구,095002, 91세,2021,151,29,122,23.8,151,29,122,23.8
21150, 사상구,095003, 92세,2021,125,20,105,19,125,20,105,19
21150, 사상구,095004, 93세,2021,101,19,82,23.2,101,19,82,23.2
21150, 사상구,095005, 94세,2021,70,6,64,9.4,70,6,64,9.4
21150, 사상구,100,95~99세,2021,147,20,127,15.7,147,20,127,15.7
21150, 사상구,100001, 95세,2021,59,8,51,15.7,59,8,51,15.7
21150, 사상구,100002, 96세,2021,41,8,33,24.2,41,8,33,24.2
21150, 사상구,100003, 97세,2021,24,X,21,14.3,24,X,21,14.3
21150, 사상구,100004, 98세,2021,12,X,12,0,12,X,12,0
21150, 사상구,100005, 99세,2021,11,X,10,10,11,X,10,10
21150, 사상구,101,100세이상,2021,17,X,15,13.3,17,X,15,13.3
21150, 사상구,102,15세미만,2021,18143,9267,8876,104.4,18005,9199,8806,104.5
21150, 사상구,103,15~64세,2021,153003,78922,74081,106.5,147691,76075,71616,106.2
21150, 사상구,104,65세이상,2021,40642,18033,22609,79.8,40506,17977,22529,79.8
21150, 사상구,086,85세이상,2021,2855,661,2194,30.1,2851,660,2191,30.1
21150, 사상구,126,평균연령,2021,45.8,44.6,47,,46.1,44.9,47.3,
21150, 사상구,127,중위연령,2021,48.5,46.6,50.3,,49.1,47.3,50.8,
21310, 기장군,000,합계,2021,172902,85460,87442,97.7,170430,83865,86565,96.9
21310, 기장군,005,0~4세,2021,7322,3730,3592,103.8,7300,3719,3581,103.9
21310, 기장군,005001, 0세,2021,1116,578,538,107.4,1113,577,536,107.6
21310, 기장군,005002, 1세,2021,1297,656,641,102.3,1295,655,640,102.3
21310, 기장군,005003, 2세,2021,1406,735,671,109.5,1399,729,670,108.8
21310, 기장군,005004, 3세,2021,1633,797,836,95.3,1626,794,832,95.4
21310, 기장군,005005, 4세,2021,1870,964,906,106.4,1867,964,903,106.8
21310, 기장군,010,5~9세,2021,10952,5581,5371,103.9,10925,5570,5355,104
21310, 기장군,010001, 5세,2021,2107,1030,1077,95.6,2106,1029,1077,95.5
21310, 기장군,010002, 6세,2021,2203,1113,1090,102.1,2196,1110,1086,102.2
21310, 기장군,010003, 7세,2021,2224,1154,1070,107.9,2217,1152,1065,108.2
21310, 기장군,010004, 8세,2021,2140,1093,1047,104.4,2136,1092,1044,104.6
21310, 기장군,010005, 9세,2021,2278,1191,1087,109.6,2270,1187,1083,109.6
21310, 기장군,015,10~14세,2021,9659,4970,4689,106,9654,4968,4686,106
21310, 기장군,015001, 10세,2021,2234,1125,1109,101.4,2233,1124,1109,101.4
21310, 기장군,015002, 11세,2021,1978,1009,969,104.1,1978,1009,969,104.1
21310, 기장군,015003, 12세,2021,1784,922,862,107,1781,921,860,107.1
21310, 기장군,015004, 13세,2021,1846,982,864,113.7,1845,982,863,113.8
21310, 기장군,015005, 14세,2021,1817,932,885,105.3,1817,932,885,105.3
21310, 기장군,020,15~19세,2021,7634,4003,3631,110.2,7624,3998,3626,110.3
21310, 기장군,020001, 15세,2021,1589,822,767,107.2,1586,819,767,106.8
21310, 기장군,020002, 16세,2021,1531,808,723,111.8,1529,808,721,112.1
21310, 기장군,020003, 17세,2021,1623,852,771,110.5,1623,852,771,110.5
21310, 기장군,020004, 18세,2021,1588,817,771,106,1584,815,769,106
21310, 기장군,020005, 19세,2021,1303,704,599,117.5,1302,704,598,117.7
21310, 기장군,025,20~24세,2021,7394,4027,3367,119.6,7237,3925,3312,118.5
21310, 기장군,025001, 20세,2021,1416,851,565,150.6,1401,843,558,151.1
21310, 기장군,025002, 21세,2021,1476,812,664,122.3,1461,802,659,121.7
21310, 기장군,025003, 22세,2021,1473,773,700,110.4,1442,752,690,109
21310, 기장군,025004, 23세,2021,1451,775,676,114.6,1407,743,664,111.9
21310, 기장군,025005, 24세,2021,1578,816,762,107.1,1526,785,741,105.9
21310, 기장군,030,25~29세,2021,8790,4698,4092,114.8,8350,4403,3947,111.6
21310, 기장군,030001, 25세,2021,1654,877,777,112.9,1580,832,748,111.2
21310, 기장군,030002, 26세,2021,1733,923,810,114,1657,869,788,110.3
21310, 기장군,030003, 27세,2021,1695,914,781,117,1615,861,754,114.2
21310, 기장군,030004, 28세,2021,1837,971,866,112.1,1728,901,827,108.9
21310, 기장군,030005, 29세,2021,1871,1013,858,118.1,1770,940,830,113.3
21310, 기장군,035,30~34세,2021,10260,5253,5007,104.9,9717,4866,4851,100.3
21310, 기장군,035001, 30세,2021,2001,1048,953,110,1890,967,923,104.8
21310, 기장군,035002, 31세,2021,1977,1047,930,112.6,1868,980,888,110.4
21310, 기장군,035003, 32세,2021,1937,1014,923,109.9,1844,941,903,104.2
21310, 기장군,035004, 33세,2021,2147,1071,1076,99.5,2020,975,1045,93.3
21310, 기장군,035005, 34세,2021,2198,1073,1125,95.4,2095,1003,1092,91.8
21310, 기장군,040,35~39세,2021,14143,7024,7119,98.7,13675,6713,6962,96.4
21310, 기장군,040001, 35세,2021,2306,1126,1180,95.4,2205,1057,1148,92.1
21310, 기장군,040002, 36세,2021,2442,1229,1213,101.3,2344,1163,1181,98.5
21310, 기장군,040003, 37세,2021,2785,1383,1402,98.6,2680,1310,1370,95.6
21310, 기장군,040004, 38세,2021,3089,1520,1569,96.9,3003,1466,1537,95.4
21310, 기장군,040005, 39세,2021,3521,1766,1755,100.6,3443,1717,1726,99.5
21310, 기장군,045,40~44세,2021,17275,8707,8568,101.6,17006,8531,8475,100.7
21310, 기장군,045001, 40세,2021,3676,1849,1827,101.2,3591,1790,1801,99.4
21310, 기장군,045002, 41세,2021,3846,1926,1920,100.3,3797,1893,1904,99.4
21310, 기장군,045003, 42세,2021,3521,1781,1740,102.4,3469,1750,1719,101.8
21310, 기장군,045004, 43세,2021,3138,1567,1571,99.7,3095,1539,1556,98.9
21310, 기장군,045005, 44세,2021,3094,1584,1510,104.9,3054,1559,1495,104.3
21310, 기장군,050,45~49세,2021,14978,7697,7281,105.7,14806,7593,7213,105.3
21310, 기장군,050001, 45세,2021,2930,1508,1422,106,2898,1486,1412,105.2
21310, 기장군,050002, 46세,2021,3035,1567,1468,106.7,2999,1549,1450,106.8
21310, 기장군,050003, 47세,2021,3083,1580,1503,105.1,3046,1557,1489,104.6
21310, 기장군,050004, 48세,2021,2964,1500,1464,102.5,2922,1475,1447,101.9
21310, 기장군,050005, 49세,2021,2966,1542,1424,108.3,2941,1526,1415,107.8
21310, 기장군,055,50~54세,2021,13217,6773,6444,105.1,13063,6688,6375,104.9
21310, 기장군,055001, 50세,2021,2955,1584,1371,115.5,2909,1554,1355,114.7
21310, 기장군,055002, 51세,2021,2761,1431,1330,107.6,2729,1417,1312,108
21310, 기장군,055003, 52세,2021,2643,1335,1308,102.1,2609,1319,1290,102.2
21310, 기장군,055004, 53세,2021,2504,1233,1271,97,2476,1216,1260,96.5
21310, 기장군,055005, 54세,2021,2354,1190,1164,102.2,2340,1182,1158,102.1
21310, 기장군,060,55~59세,2021,11036,5470,5566,98.3,10953,5420,5533,98
21310, 기장군,060001, 55세,2021,2243,1172,1071,109.4,2222,1161,1061,109.4
21310, 기장군,060002, 56세,2021,2173,1019,1154,88.3,2159,1010,1149,87.9
21310, 기장군,060003, 57세,2021,2068,1059,1009,105,2049,1046,1003,104.3
21310, 기장군,060004, 58세,2021,2234,1094,1140,96,2218,1086,1132,95.9
21310, 기장군,060005, 59세,2021,2318,1126,1192,94.5,2305,1117,1188,94
21310, 기장군,065,60~64세,2021,11900,5515,6385,86.4,11844,5489,6355,86.4
21310, 기장군,065001, 60세,2021,2401,1138,1263,90.1,2394,1133,1261,89.8
21310, 기장군,065002, 61세,2021,2547,1198,1349,88.8,2532,1191,1341,88.8
21310, 기장군,065003, 62세,2021,2398,1116,1282,87.1,2386,1112,1274,87.3
21310, 기장군,065004, 63세,2021,2204,1021,1183,86.3,2190,1012,1178,85.9
21310, 기장군,065005, 64세,2021,2350,1042,1308,79.7,2342,1041,1301,80
21310, 기장군,070,65~69세,2021,9693,4413,5280,83.6,9665,4403,5262,83.7
21310, 기장군,070001, 65세,2021,2095,948,1147,82.7,2084,944,1140,82.8
21310, 기장군,070002, 66세,2021,2214,1029,1185,86.8,2207,1028,1179,87.2
21310, 기장군,070003, 67세,2021,1884,870,1014,85.8,1880,867,1013,85.6
21310, 기장군,070004, 68세,2021,1678,731,947,77.2,1674,730,944,77.3
21310, 기장군,070005, 69세,2021,1822,835,987,84.6,1820,834,986,84.6
21310, 기장군,075,70~74세,2021,7225,3350,3875,86.5,7201,3338,3863,86.4
21310, 기장군,075001, 70세,2021,1498,724,774,93.5,1493,721,772,93.4
21310, 기장군,075002, 71세,2021,1419,637,782,81.5,1414,635,779,81.5
21310, 기장군,075003, 72세,2021,1469,665,804,82.7,1463,663,800,82.9
21310, 기장군,075004, 73세,2021,1444,672,772,87,1441,670,771,86.9
21310, 기장군,075005, 74세,2021,1395,652,743,87.8,1390,649,741,87.6
21310, 기장군,080,75~79세,2021,5182,2260,2922,77.3,5174,2254,2920,77.2
21310, 기장군,080001, 75세,2021,1051,456,595,76.6,1047,452,595,76
21310, 기장군,080002, 76세,2021,1012,443,569,77.9,1010,442,568,77.8
21310, 기장군,080003, 77세,2021,1042,464,578,80.3,1041,464,577,80.4
21310, 기장군,080004, 78세,2021,1009,451,558,80.8,1008,450,558,80.6
21310, 기장군,080005, 79세,2021,1068,446,622,71.7,1068,446,622,71.7
21310, 기장군,085,80~84세,2021,3600,1320,2280,57.9,3596,1319,2277,57.9
21310, 기장군,085001, 80세,2021,828,336,492,68.3,826,335,491,68.2
21310, 기장군,085002, 81세,2021,808,294,514,57.2,806,294,512,57.4
21310, 기장군,085003, 82세,2021,789,283,506,55.9,789,283,506,55.9
21310, 기장군,085004, 83세,2021,632,229,403,56.8,632,229,403,56.8
21310, 기장군,085005, 84세,2021,543,178,365,48.8,543,178,365,48.8
21310, 기장군,090,85~89세,2021,1823,509,1314,38.7,1823,509,1314,38.7
21310, 기장군,090001, 85세,2021,477,143,334,42.8,477,143,334,42.8
21310, 기장군,090002, 86세,2021,426,129,297,43.4,426,129,297,43.4
21310, 기장군,090003, 87세,2021,356,89,267,33.3,356,89,267,33.3
21310, 기장군,090004, 88세,2021,300,83,217,38.2,300,83,217,38.2
21310, 기장군,090005, 89세,2021,264,65,199,32.7,264,65,199,32.7
21310, 기장군,095,90~94세,2021,634,142,492,28.9,633,142,491,28.9
21310, 기장군,095001, 90세,2021,197,55,142,38.7,197,55,142,38.7
21310, 기장군,095002, 91세,2021,159,34,125,27.2,159,34,125,27.2
21310, 기장군,095003, 92세,2021,106,27,79,34.2,106,27,79,34.2
21310, 기장군,095004, 93세,2021,104,19,85,22.4,103,19,84,22.6
21310, 기장군,095005, 94세,2021,68,7,61,11.5,68,7,61,11.5
21310, 기장군,100,95~99세,2021,153,15,138,10.9,153,15,138,10.9
21310, 기장군,100001, 95세,2021,48,7,41,17.1,48,7,41,17.1
21310, 기장군,100002, 96세,2021,42,X,40,5,42,X,40,5
21310, 기장군,100003, 97세,2021,28,X,27,3.7,28,X,27,3.7
21310, 기장군,100004, 98세,2021,17,X,15,13.3,17,X,15,13.3
21310, 기장군,100005, 99세,2021,18,X,15,20,18,X,15,20
21310, 기장군,101,100세이상,2021,32,X,29,10.3,31,X,29,6.9
21310, 기장군,102,15세미만,2021,27933,14281,13652,104.6,27879,14257,13622,104.7
21310, 기장군,103,15~64세,2021,116627,59167,57460,103,114275,57626,56649,101.7
21310, 기장군,104,65세이상,2021,28342,12012,16330,73.6,28276,11982,16294,73.5
21310, 기장군,086,85세이상,2021,2642,669,1973,33.9,2640,668,1972,33.9
21310, 기장군,126,평균연령,2021,42,40.6,43.3,,42,40.7,43.3,
21310, 기장군,127,중위연령,2021,42.8,41.8,43.9,,43,42,44,
22,대구광역시,000,합계,2021,2387911,1177420,1210491,97.3,2350955,1158350,1192605,97.1
22,대구광역시,005,0~4세,2021,67629,34732,32897,105.6,67018,34437,32581,105.7
22,대구광역시,005001, 0세,2021,10837,5590,5247,106.5,10734,5536,5198,106.5
22,대구광역시,005002, 1세,2021,11905,6122,5783,105.9,11780,6067,5713,106.2
22,대구광역시,005003, 2세,2021,13432,6983,6449,108.3,13308,6927,6381,108.6
22,대구광역시,005004, 3세,2021,14901,7542,7359,102.5,14769,7470,7299,102.3
22,대구광역시,005005, 4세,2021,16554,8495,8059,105.4,16427,8437,7990,105.6
22,대구광역시,010,5~9세,2021,100372,51280,49092,104.5,99865,51048,48817,104.6
22,대구광역시,010001, 5세,2021,19078,9769,9309,104.9,18944,9703,9241,105
22,대구광역시,010002, 6세,2021,19882,10178,9704,104.9,19759,10128,9631,105.2
22,대구광역시,010003, 7세,2021,19775,10044,9731,103.2,19671,10001,9670,103.4
22,대구광역시,010004, 8세,2021,19829,10136,9693,104.6,19757,10100,9657,104.6
22,대구광역시,010005, 9세,2021,21808,11153,10655,104.7,21734,11116,10618,104.7
22,대구광역시,015,10~14세,2021,105005,54244,50761,106.9,104695,54088,50607,106.9
22,대구광역시,015001, 10세,2021,21198,10955,10243,107,21131,10923,10208,107
22,대구광역시,015002, 11세,2021,20576,10598,9978,106.2,20517,10564,9953,106.1
22,대구광역시,015003, 12세,2021,19930,10383,9547,108.8,19867,10354,9513,108.8
22,대구광역시,015004, 13세,2021,21321,11067,10254,107.9,21267,11040,10227,107.9
22,대구광역시,015005, 14세,2021,21980,11241,10739,104.7,21913,11207,10706,104.7
22,대구광역시,020,15~19세,2021,111424,58469,52955,110.4,110624,58097,52527,110.6
22,대구광역시,020001, 15세,2021,20403,10673,9730,109.7,20357,10649,9708,109.7
22,대구광역시,020002, 16세,2021,20437,10646,9791,108.7,20393,10624,9769,108.8
22,대구광역시,020003, 17세,2021,22299,11681,10618,110,22243,11654,10589,110.1
22,대구광역시,020004, 18세,2021,23666,12495,11171,111.9,23513,12422,11091,112
22,대구광역시,020005, 19세,2021,24619,12974,11645,111.4,24118,12748,11370,112.1
22,대구광역시,025,20~24세,2021,158547,83644,74903,111.7,152109,80487,71622,112.4
22,대구광역시,025001, 20세,2021,29472,15230,14242,106.9,28076,14572,13504,107.9
22,대구광역시,025002, 21세,2021,32744,17337,15407,112.5,31269,16595,14674,113.1
22,대구광역시,025003, 22세,2021,31025,16495,14530,113.5,29750,15870,13880,114.3
22,대구광역시,025004, 23세,2021,32140,17174,14966,114.8,30977,16586,14391,115.3
22,대구광역시,025005, 24세,2021,33166,17408,15758,110.5,32037,16864,15173,111.1
22,대구광역시,030,25~29세,2021,162309,87198,75111,116.1,156459,84177,72282,116.5
22,대구광역시,030001, 25세,2021,33435,17965,15470,116.1,32235,17325,14910,116.2
22,대구광역시,030002, 26세,2021,32905,17665,15240,115.9,31692,17056,14636,116.5
22,대구광역시,030003, 27세,2021,32223,17335,14888,116.4,31117,16782,14335,117.1
22,대구광역시,030004, 28세,2021,31710,17050,14660,116.3,30553,16435,14118,116.4
22,대구광역시,030005, 29세,2021,32036,17183,14853,115.7,30862,16579,14283,116.1
22,대구광역시,035,30~34세,2021,138675,74734,63941,116.9,132616,71434,61182,116.8
22,대구광역시,035001, 30세,2021,29703,16019,13684,117.1,28519,15374,13145,117
22,대구광역시,035002, 31세,2021,28666,15507,13159,117.8,27445,14854,12591,118
22,대구광역시,035003, 32세,2021,27764,15063,12701,118.6,26572,14388,12184,118.1
22,대구광역시,035004, 33세,2021,25889,14013,11876,118,24648,13340,11308,118
22,대구광역시,035005, 34세,2021,26653,14132,12521,112.9,25432,13478,11954,112.7
22,대구광역시,040,35~39세,2021,150689,77251,73438,105.2,145701,74484,71217,104.6
22,대구광역시,040001, 35세,2021,27071,14488,12583,115.1,25935,13854,12081,114.7
22,대구광역시,040002, 36세,2021,27099,14201,12898,110.1,26028,13628,12400,109.9
22,대구광역시,040003, 37세,2021,28559,14661,13898,105.5,27611,14108,13503,104.5
22,대구광역시,040004, 38세,2021,32193,16071,16122,99.7,31266,15590,15676,99.5
22,대구광역시,040005, 39세,2021,35767,17830,17937,99.4,34861,17304,17557,98.6
22,대구광역시,045,40~44세,2021,175521,87145,88376,98.6,172142,85319,86823,98.3
22,대구광역시,045001, 40세,2021,36036,17991,18045,99.7,35259,17579,17680,99.4
22,대구광역시,045002, 41세,2021,37210,18453,18757,98.4,36504,18080,18424,98.1
22,대구광역시,045003, 42세,2021,35292,17374,17918,97,34600,17001,17599,96.6
22,대구광역시,045004, 43세,2021,32640,16281,16359,99.5,32002,15932,16070,99.1
22,대구광역시,045005, 44세,2021,34343,17046,17297,98.5,33777,16727,17050,98.1
22,대구광역시,050,45~49세,2021,193349,94993,98356,96.6,190845,93639,97206,96.3
22,대구광역시,050001, 45세,2021,34357,17191,17166,100.1,33838,16910,16928,99.9
22,대구광역시,050002, 46세,2021,36446,17781,18665,95.3,35942,17510,18432,95
22,대구광역시,050003, 47세,2021,40285,19812,20473,96.8,39786,19556,20230,96.7
22,대구광역시,050004, 48세,2021,40769,19859,20910,95,40269,19574,20695,94.6
22,대구광역시,050005, 49세,2021,41492,20350,21142,96.3,41010,20089,20921,96
22,대구광역시,055,50~54세,2021,216592,105452,111140,94.9,214455,104364,110091,94.8
22,대구광역시,055001, 50세,2021,43949,21576,22373,96.4,43455,21323,22132,96.3
22,대구광역시,055002, 51세,2021,43117,20990,22127,94.9,42613,20733,21880,94.8
22,대구광역시,055003, 52세,2021,43446,21081,22365,94.3,43037,20861,22176,94.1
22,대구광역시,055004, 53세,2021,44637,21885,22752,96.2,44250,21682,22568,96.1
22,대구광역시,055005, 54세,2021,41443,19920,21523,92.6,41100,19765,21335,92.6
22,대구광역시,060,55~59세,2021,199334,97690,101644,96.1,197774,96973,100801,96.2
22,대구광역시,060001, 55세,2021,39745,19775,19970,99,39422,19625,19797,99.1
22,대구광역시,060002, 56세,2021,40497,19553,20944,93.4,40169,19381,20788,93.2
22,대구광역시,060003, 57세,2021,37889,18457,19432,95,37594,18330,19264,95.2
22,대구광역시,060004, 58세,2021,40013,19708,20305,97.1,39671,19545,20126,97.1
22,대구광역시,060005, 59세,2021,41190,20197,20993,96.2,40918,20092,20826,96.5
22,대구광역시,065,60~64세,2021,194611,94073,100538,93.6,193771,93682,100089,93.6
22,대구광역시,065001, 60세,2021,44309,21359,22950,93.1,44167,21291,22876,93.1
22,대구광역시,065002, 61세,2021,42794,20479,22315,91.8,42555,20367,22188,91.8
22,대구광역시,065003, 62세,2021,38877,18659,20218,92.3,38713,18584,20129,92.3
22,대구광역시,065004, 63세,2021,33592,16505,17087,96.6,33440,16436,17004,96.7
22,대구광역시,065005, 64세,2021,35039,17071,17968,95,34896,17004,17892,95
22,대구광역시,070,65~69세,2021,144646,67678,76968,87.9,144126,67450,76676,88
22,대구광역시,070001, 65세,2021,32215,15484,16731,92.5,32094,15429,16665,92.6
22,대구광역시,070002, 66세,2021,32566,15129,17437,86.8,32464,15085,17379,86.8
22,대구광역시,070003, 67세,2021,26773,12783,13990,91.4,26651,12734,13917,91.5
22,대구광역시,070004, 68세,2021,25815,11766,14049,83.7,25720,11718,14002,83.7
22,대구광역시,070005, 69세,2021,27277,12516,14761,84.8,27197,12484,14713,84.9
22,대구광역시,075,70~74세,2021,103563,46847,56716,82.6,103331,46756,56575,82.6
22,대구광역시,075001, 70세,2021,20742,9537,11205,85.1,20665,9506,11159,85.2
22,대구광역시,075002, 71세,2021,20790,9646,11144,86.6,20735,9628,11107,86.7
22,대구광역시,075003, 72세,2021,22133,10015,12118,82.6,22090,9994,12096,82.6
22,대구광역시,075004, 73세,2021,20641,9219,11422,80.7,20607,9207,11400,80.8
22,대구광역시,075005, 74세,2021,19257,8430,10827,77.9,19234,8421,10813,77.9
22,대구광역시,080,75~79세,2021,73247,30990,42257,73.3,73139,30947,42192,73.3
22,대구광역시,080001, 75세,2021,12914,5802,7112,81.6,12887,5793,7094,81.7
22,대구광역시,080002, 76세,2021,13202,5601,7601,73.7,13181,5594,7587,73.7
22,대구광역시,080003, 77세,2021,15062,6244,8818,70.8,15029,6227,8802,70.7
22,대구광역시,080004, 78세,2021,15509,6491,9018,72,15493,6486,9007,72
22,대구광역시,080005, 79세,2021,16560,6852,9708,70.6,16549,6847,9702,70.6
22,대구광역시,085,80~84세,2021,54585,20287,34298,59.1,54524,20272,34252,59.2
22,대구광역시,085001, 80세,2021,13260,5185,8075,64.2,13238,5178,8060,64.2
22,대구광역시,085002, 81세,2021,11779,4412,7367,59.9,11773,4412,7361,59.9
22,대구광역시,085003, 82세,2021,11353,4297,7056,60.9,11342,4291,7051,60.9
22,대구광역시,085004, 83세,2021,9590,3390,6200,54.7,9576,3389,6187,54.8
22,대구광역시,085005, 84세,2021,8603,3003,5600,53.6,8595,3002,5593,53.7
22,대구광역시,090,85~89세,2021,27677,8609,19068,45.1,27640,8598,19042,45.2
22,대구광역시,090001, 85세,2021,7556,2513,5043,49.8,7547,2511,5036,49.9
22,대구광역시,090002, 86세,2021,6723,2166,4557,47.5,6715,2165,4550,47.6
22,대구광역시,090003, 87세,2021,5480,1654,3826,43.2,5472,1649,3823,43.1
22,대구광역시,090004, 88세,2021,4282,1252,3030,41.3,4273,1251,3022,41.4
22,대구광역시,090005, 89세,2021,3636,1024,2612,39.2,3633,1022,2611,39.1
22,대구광역시,095,90~94세,2021,8413,1799,6614,27.2,8404,1794,6610,27.1
22,대구광역시,095001, 90세,2021,2611,628,1983,31.7,2609,628,1981,31.7
22,대구광역시,095002, 91세,2021,2023,406,1617,25.1,2020,404,1616,25
22,대구광역시,095003, 92세,2021,1601,332,1269,26.2,1601,332,1269,26.2
22,대구광역시,095004, 93세,2021,1262,259,1003,25.8,1259,257,1002,25.6
22,대구광역시,095005, 94세,2021,916,174,742,23.5,915,173,742,23.3
22,대구광역시,100,95~99세,2021,1509,279,1230,22.7,1507,279,1228,22.7
22,대구광역시,100001, 95세,2021,501,93,408,22.8,500,93,407,22.9
22,대구광역시,100002, 96세,2021,429,88,341,25.8,428,88,340,25.9
22,대구광역시,100003, 97세,2021,242,46,196,23.5,242,46,196,23.5
22,대구광역시,100004, 98세,2021,187,32,155,20.6,187,32,155,20.6
22,대구광역시,100005, 99세,2021,150,20,130,15.4,150,20,130,15.4
22,대구광역시,101,100세이상,2021,214,26,188,13.8,210,25,185,13.5
22,대구광역시,102,15세미만,2021,273006,140256,132750,105.7,271578,139573,132005,105.7
22,대구광역시,103,15~64세,2021,1701051,860649,840402,102.4,1666496,842656,823840,102.3
22,대구광역시,104,65세이상,2021,413854,176515,237339,74.4,412881,176121,236760,74.4
22,대구광역시,086,85세이상,2021,37813,10713,27100,39.5,37761,10696,27065,39.5
22,대구광역시,126,평균연령,2021,43.9,42.5,45.3,,44,42.6,45.4,
22,대구광역시,127,중위연령,2021,45.7,43.8,47.4,,46,44.1,47.7,
22004, 읍부,000,합계,2021,234617,119033,115584,103,228340,115322,113018,102
22004, 읍부,005,0~4세,2021,11539,5893,5646,104.4,11366,5814,5552,104.7
22004, 읍부,005001, 0세,2021,1887,978,909,107.6,1861,961,900,106.8
22004, 읍부,005002, 1세,2021,2138,1105,1033,107,2104,1092,1012,107.9
22004, 읍부,005003, 2세,2021,2380,1217,1163,104.6,2342,1206,1136,106.2
22004, 읍부,005004, 3세,2021,2484,1262,1222,103.3,2444,1242,1202,103.3
22004, 읍부,005005, 4세,2021,2650,1331,1319,100.9,2615,1313,1302,100.8
22004, 읍부,010,5~9세,2021,14312,7288,7024,103.8,14171,7234,6937,104.3
22004, 읍부,010001, 5세,2021,2946,1493,1453,102.8,2910,1478,1432,103.2
22004, 읍부,010002, 6세,2021,2935,1485,1450,102.4,2901,1476,1425,103.6
22004, 읍부,010003, 7세,2021,2812,1417,1395,101.6,2783,1408,1375,102.4
22004, 읍부,010004, 8세,2021,2745,1417,1328,106.7,2721,1404,1317,106.6
22004, 읍부,010005, 9세,2021,2874,1476,1398,105.6,2856,1468,1388,105.8
22004, 읍부,015,10~14세,2021,12210,6244,5966,104.7,12099,6181,5918,104.4
22004, 읍부,015001, 10세,2021,2735,1379,1356,101.7,2708,1366,1342,101.8
22004, 읍부,015002, 11세,2021,2522,1305,1217,107.2,2502,1288,1214,106.1
22004, 읍부,015003, 12세,2021,2292,1172,1120,104.6,2270,1161,1109,104.7
22004, 읍부,015004, 13세,2021,2371,1246,1125,110.8,2354,1236,1118,110.6
22004, 읍부,015005, 14세,2021,2290,1142,1148,99.5,2265,1130,1135,99.6
22004, 읍부,020,15~19세,2021,10073,5300,4773,111,9996,5256,4740,110.9
22004, 읍부,020001, 15세,2021,2039,1091,948,115.1,2020,1082,938,115.4
22004, 읍부,020002, 16세,2021,2066,1045,1021,102.4,2050,1039,1011,102.8
22004, 읍부,020003, 17세,2021,2040,1000,1040,96.2,2030,993,1037,95.8
22004, 읍부,020004, 18세,2021,2116,1110,1006,110.3,2098,1098,1000,109.8
22004, 읍부,020005, 19세,2021,1812,1054,758,139.1,1798,1044,754,138.5
22004, 읍부,025,20~24세,2021,11770,6599,5171,127.6,11414,6417,4997,128.4
22004, 읍부,025001, 20세,2021,2174,1266,908,139.4,2140,1246,894,139.4
22004, 읍부,025002, 21세,2021,2384,1375,1009,136.3,2349,1364,985,138.5
22004, 읍부,025003, 22세,2021,2197,1216,981,124,2129,1181,948,124.6
22004, 읍부,025004, 23세,2021,2384,1312,1072,122.4,2293,1266,1027,123.3
22004, 읍부,025005, 24세,2021,2631,1430,1201,119.1,2503,1360,1143,119
22004, 읍부,030,25~29세,2021,14276,7920,6356,124.6,13379,7348,6031,121.8
22004, 읍부,030001, 25세,2021,2693,1520,1173,129.6,2536,1420,1116,127.2
22004, 읍부,030002, 26세,2021,2745,1571,1174,133.8,2568,1458,1110,131.4
22004, 읍부,030003, 27세,2021,2725,1537,1188,129.4,2575,1438,1137,126.5
22004, 읍부,030004, 28세,2021,2918,1618,1300,124.5,2725,1489,1236,120.5
22004, 읍부,030005, 29세,2021,3195,1674,1521,110.1,2975,1543,1432,107.8
22004, 읍부,035,30~34세,2021,16639,8818,7821,112.7,15455,8036,7419,108.3
22004, 읍부,035001, 30세,2021,3177,1663,1514,109.8,2944,1519,1425,106.6
22004, 읍부,035002, 31세,2021,3159,1701,1458,116.7,2923,1550,1373,112.9
22004, 읍부,035003, 32세,2021,3370,1815,1555,116.7,3127,1643,1484,110.7
22004, 읍부,035004, 33세,2021,3357,1786,1571,113.7,3120,1628,1492,109.1
22004, 읍부,035005, 34세,2021,3576,1853,1723,107.5,3341,1696,1645,103.1
22004, 읍부,040,35~39세,2021,20777,10844,9933,109.2,19709,10162,9547,106.4
22004, 읍부,040001, 35세,2021,3697,1990,1707,116.6,3478,1850,1628,113.6
22004, 읍부,040002, 36세,2021,3778,2004,1774,113,3535,1852,1683,110
22004, 읍부,040003, 37세,2021,3986,2110,1876,112.5,3765,1963,1802,108.9
22004, 읍부,040004, 38세,2021,4467,2235,2232,100.1,4274,2120,2154,98.4
22004, 읍부,040005, 39세,2021,4849,2505,2344,106.9,4657,2377,2280,104.3
22004, 읍부,045,40~44세,2021,21782,11257,10525,107,21066,10843,10223,106.1
22004, 읍부,045001, 40세,2021,4812,2499,2313,108,4640,2403,2237,107.4
22004, 읍부,045002, 41세,2021,4803,2431,2372,102.5,4651,2350,2301,102.1
22004, 읍부,045003, 42세,2021,4367,2250,2117,106.3,4236,2173,2063,105.3
22004, 읍부,045004, 43세,2021,3813,1968,1845,106.7,3670,1884,1786,105.5
22004, 읍부,045005, 44세,2021,3987,2109,1878,112.3,3869,2033,1836,110.7
22004, 읍부,050,45~49세,2021,18901,9883,9018,109.6,18370,9560,8810,108.5
22004, 읍부,050001, 45세,2021,3617,1937,1680,115.3,3509,1877,1632,115
22004, 읍부,050002, 46세,2021,3739,1938,1801,107.6,3637,1876,1761,106.5
22004, 읍부,050003, 47세,2021,3961,2073,1888,109.8,3843,2000,1843,108.5
22004, 읍부,050004, 48세,2021,3775,1967,1808,108.8,3673,1899,1774,107
22004, 읍부,050005, 49세,2021,3809,1968,1841,106.9,3708,1908,1800,106
22004, 읍부,055,50~54세,2021,19051,9316,9735,95.7,18625,9097,9528,95.5
22004, 읍부,055001, 50세,2021,3898,1981,1917,103.3,3809,1935,1874,103.3
22004, 읍부,055002, 51세,2021,3794,1899,1895,100.2,3694,1841,1853,99.4
22004, 읍부,055003, 52세,2021,3815,1803,2012,89.6,3739,1761,1978,89
22004, 읍부,055004, 53세,2021,3927,1903,2024,94,3841,1864,1977,94.3
22004, 읍부,055005, 54세,2021,3617,1730,1887,91.7,3542,1696,1846,91.9
22004, 읍부,060,55~59세,2021,17668,8693,8975,96.9,17368,8532,8836,96.6
22004, 읍부,060001, 55세,2021,3567,1779,1788,99.5,3502,1742,1760,99
22004, 읍부,060002, 56세,2021,3601,1759,1842,95.5,3529,1713,1816,94.3
22004, 읍부,060003, 57세,2021,3338,1634,1704,95.9,3274,1605,1669,96.2
22004, 읍부,060004, 58세,2021,3479,1681,1798,93.5,3420,1650,1770,93.2
22004, 읍부,060005, 59세,2021,3683,1840,1843,99.8,3643,1822,1821,100.1
22004, 읍부,065,60~64세,2021,16548,8219,8329,98.7,16380,8136,8244,98.7
22004, 읍부,065001, 60세,2021,3890,1949,1941,100.4,3861,1936,1925,100.6
22004, 읍부,065002, 61세,2021,3645,1784,1861,95.9,3604,1764,1840,95.9
22004, 읍부,065003, 62세,2021,3308,1622,1686,96.2,3274,1605,1669,96.2
22004, 읍부,065004, 63세,2021,2839,1405,1434,98,2808,1389,1419,97.9
22004, 읍부,065005, 64세,2021,2866,1459,1407,103.7,2833,1442,1391,103.7
22004, 읍부,070,65~69세,2021,11127,5427,5700,95.2,11052,5389,5663,95.2
22004, 읍부,070001, 65세,2021,2604,1305,1299,100.5,2582,1293,1289,100.3
22004, 읍부,070002, 66세,2021,2565,1205,1360,88.6,2553,1199,1354,88.6
22004, 읍부,070003, 67세,2021,1958,987,971,101.6,1942,980,962,101.9
22004, 읍부,070004, 68세,2021,1910,914,996,91.8,1893,905,988,91.6
22004, 읍부,070005, 69세,2021,2090,1016,1074,94.6,2082,1012,1070,94.6
22004, 읍부,075,70~74세,2021,7289,3458,3831,90.3,7257,3449,3808,90.6
22004, 읍부,075001, 70세,2021,1537,736,801,91.9,1527,734,793,92.6
22004, 읍부,075002, 71세,2021,1498,732,766,95.6,1489,729,760,95.9
22004, 읍부,075003, 72세,2021,1572,740,832,88.9,1566,737,829,88.9
22004, 읍부,075004, 73세,2021,1394,663,731,90.7,1393,663,730,90.8
22004, 읍부,075005, 74세,2021,1288,587,701,83.7,1282,586,696,84.2
22004, 읍부,080,75~79세,2021,4734,2056,2678,76.8,4719,2050,2669,76.8
22004, 읍부,080001, 75세,2021,882,426,456,93.4,875,425,450,94.4
22004, 읍부,080002, 76세,2021,873,381,492,77.4,871,380,491,77.4
22004, 읍부,080003, 77세,2021,937,415,522,79.5,933,411,522,78.7
22004, 읍부,080004, 78세,2021,992,413,579,71.3,990,413,577,71.6
22004, 읍부,080005, 79세,2021,1050,421,629,66.9,1050,421,629,66.9
22004, 읍부,085,80~84세,2021,3468,1190,2278,52.2,3463,1190,2273,52.4
22004, 읍부,085001, 80세,2021,848,308,540,57,847,308,539,57.1
22004, 읍부,085002, 81세,2021,738,247,491,50.3,738,247,491,50.3
22004, 읍부,085003, 82세,2021,708,257,451,57,707,257,450,57.1
22004, 읍부,085004, 83세,2021,629,208,421,49.4,626,208,418,49.8
22004, 읍부,085005, 84세,2021,545,170,375,45.3,545,170,375,45.3
22004, 읍부,090,85~89세,2021,1795,495,1300,38.1,1793,495,1298,38.1
22004, 읍부,090001, 85세,2021,492,147,345,42.6,491,147,344,42.7
22004, 읍부,090002, 86세,2021,436,122,314,38.9,436,122,314,38.9
22004, 읍부,090003, 87세,2021,358,93,265,35.1,358,93,265,35.1
22004, 읍부,090004, 88세,2021,271,70,201,34.8,270,70,200,35
22004, 읍부,090005, 89세,2021,238,63,175,36,238,63,175,36
22004, 읍부,095,90~94세,2021,546,111,435,25.5,546,111,435,25.5
22004, 읍부,095001, 90세,2021,170,40,130,30.8,170,40,130,30.8
22004, 읍부,095002, 91세,2021,131,15,116,12.9,131,15,116,12.9
22004, 읍부,095003, 92세,2021,108,27,81,33.3,108,27,81,33.3
22004, 읍부,095004, 93세,2021,76,21,55,38.2,76,21,55,38.2
22004, 읍부,095005, 94세,2021,61,8,53,15.1,61,8,53,15.1
22004, 읍부,100,95~99세,2021,102,22,80,27.5,102,22,80,27.5
22004, 읍부,100001, 95세,2021,37,9,28,32.1,37,9,28,32.1
22004, 읍부,100002, 96세,2021,24,5,19,26.3,24,5,19,26.3
22004, 읍부,100003, 97세,2021,16,X,13,23.1,16,X,13,23.1
22004, 읍부,100004, 98세,2021,17,X,15,13.3,17,X,15,13.3
22004, 읍부,100005, 99세,2021,8,X,5,60,8,X,5,60
22004, 읍부,101,100세이상,2021,10,X,10,0,10,X,10,0
22004, 읍부,102,15세미만,2021,38061,19425,18636,104.2,37636,19229,18407,104.5
22004, 읍부,103,15~64세,2021,167485,86849,80636,107.7,161762,83387,78375,106.4
22004, 읍부,104,65세이상,2021,29071,12759,16312,78.2,28942,12706,16236,78.3
22004, 읍부,086,85세이상,2021,2453,628,1825,34.4,2451,628,1823,34.4
22004, 읍부,126,평균연령,2021,40.3,39.3,41.4,,40.4,39.4,41.5,
22004, 읍부,127,중위연령,2021,41.2,40.2,42.2,,41.4,40.5,42.4,
22005, 면부,000,합계,2021,30237,15776,14461,109.1,28775,14711,14064,104.6
22005, 면부,005,0~4세,2021,1608,815,793,102.8,1572,796,776,102.6
22005, 면부,005001, 0세,2021,287,148,139,106.5,282,146,136,107.4
22005, 면부,005002, 1세,2021,322,169,153,110.5,315,165,150,110
22005, 면부,005003, 2세,2021,306,161,145,111,301,158,143,110.5
22005, 면부,005004, 3세,2021,348,173,175,98.9,340,167,173,96.5
22005, 면부,005005, 4세,2021,345,164,181,90.6,334,160,174,92
22005, 면부,010,5~9세,2021,1543,777,766,101.4,1523,770,753,102.3
22005, 면부,010001, 5세,2021,326,162,164,98.8,323,161,162,99.4
22005, 면부,010002, 6세,2021,316,155,161,96.3,313,154,159,96.9
22005, 면부,010003, 7세,2021,309,148,161,91.9,303,147,156,94.2
22005, 면부,010004, 8세,2021,280,138,142,97.2,275,135,140,96.4
22005, 면부,010005, 9세,2021,312,174,138,126.1,309,173,136,127.2
22005, 면부,015,10~14세,2021,1088,560,528,106.1,1074,554,520,106.5
22005, 면부,015001, 10세,2021,271,142,129,110.1,266,138,128,107.8
22005, 면부,015002, 11세,2021,252,122,130,93.8,250,122,128,95.3
22005, 면부,015003, 12세,2021,180,99,81,122.2,177,99,78,126.9
22005, 면부,015004, 13세,2021,189,99,90,110,187,98,89,110.1
22005, 면부,015005, 14세,2021,196,98,98,100,194,97,97,100
22005, 면부,020,15~19세,2021,798,476,322,147.8,792,473,319,148.3
22005, 면부,020001, 15세,2021,153,73,80,91.3,152,73,79,92.4
22005, 면부,020002, 16세,2021,134,75,59,127.1,133,75,58,129.3
22005, 면부,020003, 17세,2021,194,120,74,162.2,194,120,74,162.2
22005, 면부,020004, 18세,2021,182,116,66,175.8,180,115,65,176.9
22005, 면부,020005, 19세,2021,135,92,43,214,133,90,43,209.3
22005, 면부,025,20~24세,2021,1078,652,426,153.1,994,592,402,147.3
22005, 면부,025001, 20세,2021,174,116,58,200,173,115,58,198.3
22005, 면부,025002, 21세,2021,208,120,88,136.4,199,116,83,139.8
22005, 면부,025003, 22세,2021,214,136,78,174.4,194,121,73,165.8
22005, 면부,025004, 23세,2021,230,135,95,142.1,210,122,88,138.6
22005, 면부,025005, 24세,2021,252,145,107,135.5,218,118,100,118
22005, 면부,030,25~29세,2021,1925,1177,748,157.4,1643,955,688,138.8
22005, 면부,030001, 25세,2021,308,210,98,214.3,260,168,92,182.6
22005, 면부,030002, 26세,2021,353,227,126,180.2,290,178,112,158.9
22005, 면부,030003, 27세,2021,366,216,150,144,308,173,135,128.1
22005, 면부,030004, 28세,2021,440,267,173,154.3,384,223,161,138.5
22005, 면부,030005, 29세,2021,458,257,201,127.9,401,213,188,113.3
22005, 면부,035,30~34세,2021,2618,1539,1079,142.6,2268,1271,997,127.5
22005, 면부,035001, 30세,2021,499,287,212,135.4,426,227,199,114.1
22005, 면부,035002, 31세,2021,528,307,221,138.9,461,262,199,131.7
22005, 면부,035003, 32세,2021,561,345,216,159.7,497,295,202,146
22005, 면부,035004, 33세,2021,493,289,204,141.7,422,232,190,122.1
22005, 면부,035005, 34세,2021,537,311,226,137.6,462,255,207,123.2
22005, 면부,040,35~39세,2021,2854,1631,1223,133.4,2581,1410,1171,120.4
22005, 면부,040001, 35세,2021,561,314,247,127.1,491,258,233,110.7
22005, 면부,040002, 36세,2021,569,351,218,161,508,300,208,144.2
22005, 면부,040003, 37세,2021,548,321,227,141.4,496,278,218,127.5
22005, 면부,040004, 38세,2021,582,322,260,123.8,536,287,249,115.3
22005, 면부,040005, 39세,2021,594,323,271,119.2,550,287,263,109.1
22005, 면부,045,40~44세,2021,2478,1418,1060,133.8,2317,1291,1026,125.8
22005, 면부,045001, 40세,2021,585,347,238,145.8,540,307,233,131.8
22005, 면부,045002, 41세,2021,539,309,230,134.3,498,277,221,125.3
22005, 면부,045003, 42세,2021,507,271,236,114.8,479,251,228,110.1
22005, 면부,045004, 43세,2021,449,264,185,142.7,418,238,180,132.2
22005, 면부,045005, 44세,2021,398,227,171,132.7,382,218,164,132.9
22005, 면부,050,45~49세,2021,1874,1041,833,125,1789,985,804,122.5
22005, 면부,050001, 45세,2021,371,209,162,129,355,199,156,127.6
22005, 면부,050002, 46세,2021,358,215,143,150.3,342,205,137,149.6
22005, 면부,050003, 47세,2021,397,224,173,129.5,377,210,167,125.7
22005, 면부,050004, 48세,2021,375,194,181,107.2,358,181,177,102.3
22005, 면부,050005, 49세,2021,373,199,174,114.4,357,190,167,113.8
22005, 면부,055,50~54세,2021,1947,1013,934,108.5,1893,981,912,107.6
22005, 면부,055001, 50세,2021,392,208,184,113,383,202,181,111.6
22005, 면부,055002, 51세,2021,419,233,186,125.3,402,223,179,124.6
22005, 면부,055003, 52세,2021,386,191,195,97.9,373,183,190,96.3
22005, 면부,055004, 53세,2021,384,201,183,109.8,376,197,179,110.1
22005, 면부,055005, 54세,2021,366,180,186,96.8,359,176,183,96.2
22005, 면부,060,55~59세,2021,2013,1000,1013,98.7,1974,980,994,98.6
22005, 면부,060001, 55세,2021,419,207,212,97.6,409,203,206,98.5
22005, 면부,060002, 56세,2021,364,179,185,96.8,357,176,181,97.2
22005, 면부,060003, 57세,2021,383,200,183,109.3,378,197,181,108.8
22005, 면부,060004, 58세,2021,418,193,225,85.8,407,187,220,85
22005, 면부,060005, 59세,2021,429,221,208,106.3,423,217,206,105.3
22005, 면부,065,60~64세,2021,2266,1093,1173,93.2,2238,1081,1157,93.4
22005, 면부,065001, 60세,2021,502,248,254,97.6,494,246,248,99.2
22005, 면부,065002, 61세,2021,465,223,242,92.1,458,220,238,92.4
22005, 면부,065003, 62세,2021,436,203,233,87.1,433,202,231,87.4
22005, 면부,065004, 63세,2021,423,214,209,102.4,419,211,208,101.4
22005, 면부,065005, 64세,2021,440,205,235,87.2,434,202,232,87.1
22005, 면부,070,65~69세,2021,1824,895,929,96.3,1806,887,919,96.5
22005, 면부,070001, 65세,2021,418,216,202,106.9,412,214,198,108.1
22005, 면부,070002, 66세,2021,409,194,215,90.2,404,192,212,90.6
22005, 면부,070003, 67세,2021,333,176,157,112.1,332,175,157,111.5
22005, 면부,070004, 68세,2021,312,144,168,85.7,311,143,168,85.1
22005, 면부,070005, 69세,2021,352,165,187,88.2,347,163,184,88.6
22005, 면부,075,70~74세,2021,1321,673,648,103.9,1313,669,644,103.9
22005, 면부,075001, 70세,2021,253,129,124,104,251,127,124,102.4
22005, 면부,075002, 71세,2021,281,137,144,95.1,279,137,142,96.5
22005, 면부,075003, 72세,2021,283,163,120,135.8,283,163,120,135.8
22005, 면부,075004, 73세,2021,258,129,129,100,255,127,128,99.2
22005, 면부,075005, 74세,2021,246,115,131,87.8,245,115,130,88.5
22005, 면부,080,75~79세,2021,968,418,550,76,967,418,549,76.1
22005, 면부,080001, 75세,2021,154,70,84,83.3,153,70,83,84.3
22005, 면부,080002, 76세,2021,184,88,96,91.7,184,88,96,91.7
22005, 면부,080003, 77세,2021,221,104,117,88.9,221,104,117,88.9
22005, 면부,080004, 78세,2021,180,68,112,60.7,180,68,112,60.7
22005, 면부,080005, 79세,2021,229,88,141,62.4,229,88,141,62.4
22005, 면부,085,80~84세,2021,997,322,675,47.7,994,322,672,47.9
22005, 면부,085001, 80세,2021,214,73,141,51.8,212,73,139,52.5
22005, 면부,085002, 81세,2021,186,62,124,50,186,62,124,50
22005, 면부,085003, 82세,2021,216,70,146,47.9,216,70,146,47.9
22005, 면부,085004, 83세,2021,185,58,127,45.7,184,58,126,46
22005, 면부,085005, 84세,2021,196,59,137,43.1,196,59,137,43.1
22005, 면부,090,85~89세,2021,698,205,493,41.6,698,205,493,41.6
22005, 면부,090001, 85세,2021,135,45,90,50,135,45,90,50
22005, 면부,090002, 86세,2021,178,53,125,42.4,178,53,125,42.4
22005, 면부,090003, 87세,2021,157,36,121,29.8,157,36,121,29.8
22005, 면부,090004, 88세,2021,111,33,78,42.3,111,33,78,42.3
22005, 면부,090005, 89세,2021,117,38,79,48.1,117,38,79,48.1
22005, 면부,095,90~94세,2021,271,57,214,26.6,271,57,214,26.6
22005, 면부,095001, 90세,2021,85,13,72,18.1,85,13,72,18.1
22005, 면부,095002, 91세,2021,62,18,44,40.9,62,18,44,40.9
22005, 면부,095003, 92세,2021,47,11,36,30.6,47,11,36,30.6
22005, 면부,095004, 93세,2021,46,8,38,21.1,46,8,38,21.1
22005, 면부,095005, 94세,2021,31,7,24,29.2,31,7,24,29.2
22005, 면부,100,95~99세,2021,57,12,45,26.7,57,12,45,26.7
22005, 면부,100001, 95세,2021,17,X,14,21.4,17,X,14,21.4
22005, 면부,100002, 96세,2021,18,5,13,38.5,18,5,13,38.5
22005, 면부,100003, 97세,2021,8,X,5,60,8,X,5,60
22005, 면부,100004, 98세,2021,10,X,10,0,10,X,10,0
22005, 면부,100005, 99세,2021,X,X,X,33.3,X,X,X,33.3
22005, 면부,101,100세이상,2021,11,X,9,22.2,11,X,9,22.2
22005, 면부,102,15세미만,2021,4239,2152,2087,103.1,4169,2120,2049,103.5
22005, 면부,103,15~64세,2021,19851,11040,8811,125.3,18489,10019,8470,118.3
22005, 면부,104,65세이상,2021,6147,2584,3563,72.5,6117,2572,3545,72.6
22005, 면부,086,85세이상,2021,1037,276,761,36.3,1037,276,761,36.3
22005, 면부,126,평균연령,2021,44.1,42,46.5,,44.6,42.5,46.8,
22005, 면부,127,중위연령,2021,43,40.8,46.9,,44,41.8,47.5,
22003, 동부,000,합계,2021,2123057,1042611,1080446,96.5,2093840,1028317,1065523,96.5
22003, 동부,005,0~4세,2021,54482,28024,26458,105.9,54080,27827,26253,106
22003, 동부,005001, 0세,2021,8663,4464,4199,106.3,8591,4429,4162,106.4
22003, 동부,005002, 1세,2021,9445,4848,4597,105.5,9361,4810,4551,105.7
22003, 동부,005003, 2세,2021,10746,5605,5141,109,10665,5563,5102,109
22003, 동부,005004, 3세,2021,12069,6107,5962,102.4,11985,6061,5924,102.3
22003, 동부,005005, 4세,2021,13559,7000,6559,106.7,13478,6964,6514,106.9
22003, 동부,010,5~9세,2021,84517,43215,41302,104.6,84171,43044,41127,104.7
22003, 동부,010001, 5세,2021,15806,8114,7692,105.5,15711,8064,7647,105.5
22003, 동부,010002, 6세,2021,16631,8538,8093,105.5,16545,8498,8047,105.6
22003, 동부,010003, 7세,2021,16654,8479,8175,103.7,16585,8446,8139,103.8
22003, 동부,010004, 8세,2021,16804,8581,8223,104.4,16761,8561,8200,104.4
22003, 동부,010005, 9세,2021,18622,9503,9119,104.2,18569,9475,9094,104.2
22003, 동부,015,10~14세,2021,91707,47440,44267,107.2,91522,47353,44169,107.2
22003, 동부,015001, 10세,2021,18192,9434,8758,107.7,18157,9419,8738,107.8
22003, 동부,015002, 11세,2021,17802,9171,8631,106.3,17765,9154,8611,106.3
22003, 동부,015003, 12세,2021,17458,9112,8346,109.2,17420,9094,8326,109.2
22003, 동부,015004, 13세,2021,18761,9722,9039,107.6,18726,9706,9020,107.6
22003, 동부,015005, 14세,2021,19494,10001,9493,105.4,19454,9980,9474,105.3
22003, 동부,020,15~19세,2021,100553,52693,47860,110.1,99836,52368,47468,110.3
22003, 동부,020001, 15세,2021,18211,9509,8702,109.3,18185,9494,8691,109.2
22003, 동부,020002, 16세,2021,18237,9526,8711,109.4,18210,9510,8700,109.3
22003, 동부,020003, 17세,2021,20065,10561,9504,111.1,20019,10541,9478,111.2
22003, 동부,020004, 18세,2021,21368,11269,10099,111.6,21235,11209,10026,111.8
22003, 동부,020005, 19세,2021,22672,11828,10844,109.1,22187,11614,10573,109.8
22003, 동부,025,20~24세,2021,145699,76393,69306,110.2,139701,73478,66223,111
22003, 동부,025001, 20세,2021,27124,13848,13276,104.3,25763,13211,12552,105.3
22003, 동부,025002, 21세,2021,30152,15842,14310,110.7,28721,15115,13606,111.1
22003, 동부,025003, 22세,2021,28614,15143,13471,112.4,27427,14568,12859,113.3
22003, 동부,025004, 23세,2021,29526,15727,13799,114,28474,15198,13276,114.5
22003, 동부,025005, 24세,2021,30283,15833,14450,109.6,29316,15386,13930,110.5
22003, 동부,030,25~29세,2021,146108,78101,68007,114.8,141437,75874,65563,115.7
22003, 동부,030001, 25세,2021,30434,16235,14199,114.3,29439,15737,13702,114.9
22003, 동부,030002, 26세,2021,29807,15867,13940,113.8,28834,15420,13414,115
22003, 동부,030003, 27세,2021,29132,15582,13550,115,28234,15171,13063,116.1
22003, 동부,030004, 28세,2021,28352,15165,13187,115,27444,14723,12721,115.7
22003, 동부,030005, 29세,2021,28383,15252,13131,116.2,27486,14823,12663,117.1
22003, 동부,035,30~34세,2021,119418,64377,55041,117,114893,62127,52766,117.7
22003, 동부,035001, 30세,2021,26027,14069,11958,117.7,25149,13628,11521,118.3
22003, 동부,035002, 31세,2021,24979,13499,11480,117.6,24061,13042,11019,118.4
22003, 동부,035003, 32세,2021,23833,12903,10930,118.1,22948,12450,10498,118.6
22003, 동부,035004, 33세,2021,22039,11938,10101,118.2,21106,11480,9626,119.3
22003, 동부,035005, 34세,2021,22540,11968,10572,113.2,21629,11527,10102,114.1
22003, 동부,040,35~39세,2021,127058,64776,62282,104,123411,62912,60499,104
22003, 동부,040001, 35세,2021,22813,12184,10629,114.6,21966,11746,10220,114.9
22003, 동부,040002, 36세,2021,22752,11846,10906,108.6,21985,11476,10509,109.2
22003, 동부,040003, 37세,2021,24025,12230,11795,103.7,23350,11867,11483,103.3
22003, 동부,040004, 38세,2021,27144,13514,13630,99.1,26456,13183,13273,99.3
22003, 동부,040005, 39세,2021,30324,15002,15322,97.9,29654,14640,15014,97.5
22003, 동부,045,40~44세,2021,151261,74470,76791,97,148759,73185,75574,96.8
22003, 동부,045001, 40세,2021,30639,15145,15494,97.7,30079,14869,15210,97.8
22003, 동부,045002, 41세,2021,31868,15713,16155,97.3,31355,15453,15902,97.2
22003, 동부,045003, 42세,2021,30418,14853,15565,95.4,29885,14577,15308,95.2
22003, 동부,045004, 43세,2021,28378,14049,14329,98,27914,13810,14104,97.9
22003, 동부,045005, 44세,2021,29958,14710,15248,96.5,29526,14476,15050,96.2
22003, 동부,050,45~49세,2021,172574,84069,88505,95,170686,83094,87592,94.9
22003, 동부,050001, 45세,2021,30369,15045,15324,98.2,29974,14834,15140,98
22003, 동부,050002, 46세,2021,32349,15628,16721,93.5,31963,15429,16534,93.3
22003, 동부,050003, 47세,2021,35927,17515,18412,95.1,35566,17346,18220,95.2
22003, 동부,050004, 48세,2021,36619,17698,18921,93.5,36238,17494,18744,93.3
22003, 동부,050005, 49세,2021,37310,18183,19127,95.1,36945,17991,18954,94.9
22003, 동부,055,50~54세,2021,195594,95123,100471,94.7,193937,94286,99651,94.6
22003, 동부,055001, 50세,2021,39659,19387,20272,95.6,39263,19186,20077,95.6
22003, 동부,055002, 51세,2021,38904,18858,20046,94.1,38517,18669,19848,94.1
22003, 동부,055003, 52세,2021,39245,19087,20158,94.7,38925,18917,20008,94.5
22003, 동부,055004, 53세,2021,40326,19781,20545,96.3,40033,19621,20412,96.1
22003, 동부,055005, 54세,2021,37460,18010,19450,92.6,37199,17893,19306,92.7
22003, 동부,060,55~59세,2021,179653,87997,91656,96,178432,87461,90971,96.1
22003, 동부,060001, 55세,2021,35759,17789,17970,99,35511,17680,17831,99.2
22003, 동부,060002, 56세,2021,36532,17615,18917,93.1,36283,17492,18791,93.1
22003, 동부,060003, 57세,2021,34168,16623,17545,94.7,33942,16528,17414,94.9
22003, 동부,060004, 58세,2021,36116,17834,18282,97.5,35844,17708,18136,97.6
22003, 동부,060005, 59세,2021,37078,18136,18942,95.7,36852,18053,18799,96
22003, 동부,065,60~64세,2021,175797,84761,91036,93.1,175153,84465,90688,93.1
22003, 동부,065001, 60세,2021,39917,19162,20755,92.3,39812,19109,20703,92.3
22003, 동부,065002, 61세,2021,38684,18472,20212,91.4,38493,18383,20110,91.4
22003, 동부,065003, 62세,2021,35133,16834,18299,92,35006,16777,18229,92
22003, 동부,065004, 63세,2021,30330,14886,15444,96.4,30213,14836,15377,96.5
22003, 동부,065005, 64세,2021,31733,15407,16326,94.4,31629,15360,16269,94.4
22003, 동부,070,65~69세,2021,131695,61356,70339,87.2,131268,61174,70094,87.3
22003, 동부,070001, 65세,2021,29193,13963,15230,91.7,29100,13922,15178,91.7
22003, 동부,070002, 66세,2021,29592,13730,15862,86.6,29507,13694,15813,86.6
22003, 동부,070003, 67세,2021,24482,11620,12862,90.3,24377,11579,12798,90.5
22003, 동부,070004, 68세,2021,23593,10708,12885,83.1,23516,10670,12846,83.1
22003, 동부,070005, 69세,2021,24835,11335,13500,84,24768,11309,13459,84
22003, 동부,075,70~74세,2021,94953,42716,52237,81.8,94761,42638,52123,81.8
22003, 동부,075001, 70세,2021,18952,8672,10280,84.4,18887,8645,10242,84.4
22003, 동부,075002, 71세,2021,19011,8777,10234,85.8,18967,8762,10205,85.9
22003, 동부,075003, 72세,2021,20278,9112,11166,81.6,20241,9094,11147,81.6
22003, 동부,075004, 73세,2021,18989,8427,10562,79.8,18959,8417,10542,79.8
22003, 동부,075005, 74세,2021,17723,7728,9995,77.3,17707,7720,9987,77.3
22003, 동부,080,75~79세,2021,67545,28516,39029,73.1,67453,28479,38974,73.1
22003, 동부,080001, 75세,2021,11878,5306,6572,80.7,11859,5298,6561,80.7
22003, 동부,080002, 76세,2021,12145,5132,7013,73.2,12126,5126,7000,73.2
22003, 동부,080003, 77세,2021,13904,5725,8179,70,13875,5712,8163,70
22003, 동부,080004, 78세,2021,14337,6010,8327,72.2,14323,6005,8318,72.2
22003, 동부,080005, 79세,2021,15281,6343,8938,71,15270,6338,8932,71
22003, 동부,085,80~84세,2021,50120,18775,31345,59.9,50067,18760,31307,59.9
22003, 동부,085001, 80세,2021,12198,4804,7394,65,12179,4797,7382,65
22003, 동부,085002, 81세,2021,10855,4103,6752,60.8,10849,4103,6746,60.8
22003, 동부,085003, 82세,2021,10429,3970,6459,61.5,10419,3964,6455,61.4
22003, 동부,085004, 83세,2021,8776,3124,5652,55.3,8766,3123,5643,55.3
22003, 동부,085005, 84세,2021,7862,2774,5088,54.5,7854,2773,5081,54.6
22003, 동부,090,85~89세,2021,25184,7909,17275,45.8,25149,7898,17251,45.8
22003, 동부,090001, 85세,2021,6929,2321,4608,50.4,6921,2319,4602,50.4
22003, 동부,090002, 86세,2021,6109,1991,4118,48.3,6101,1990,4111,48.4
22003, 동부,090003, 87세,2021,4965,1525,3440,44.3,4957,1520,3437,44.2
22003, 동부,090004, 88세,2021,3900,1149,2751,41.8,3892,1148,2744,41.8
22003, 동부,090005, 89세,2021,3281,923,2358,39.1,3278,921,2357,39.1
22003, 동부,095,90~94세,2021,7596,1631,5965,27.3,7587,1626,5961,27.3
22003, 동부,095001, 90세,2021,2356,575,1781,32.3,2354,575,1779,32.3
22003, 동부,095002, 91세,2021,1830,373,1457,25.6,1827,371,1456,25.5
22003, 동부,095003, 92세,2021,1446,294,1152,25.5,1446,294,1152,25.5
22003, 동부,095004, 93세,2021,1140,230,910,25.3,1137,228,909,25.1
22003, 동부,095005, 94세,2021,824,159,665,23.9,823,158,665,23.8
22003, 동부,100,95~99세,2021,1350,245,1105,22.2,1348,245,1103,22.2
22003, 동부,100001, 95세,2021,447,81,366,22.1,446,81,365,22.2
22003, 동부,100002, 96세,2021,387,78,309,25.2,386,78,308,25.3
22003, 동부,100003, 97세,2021,218,40,178,22.5,218,40,178,22.5
22003, 동부,100004, 98세,2021,160,30,130,23.1,160,30,130,23.1
22003, 동부,100005, 99세,2021,138,16,122,13.1,138,16,122,13.1
22003, 동부,101,100세이상,2021,193,24,169,14.2,189,23,166,13.9
22003, 동부,102,15세미만,2021,230706,118679,112027,105.9,229773,118224,111549,106
22003, 동부,103,15~64세,2021,1513715,762760,750955,101.6,1486245,749250,736995,101.7
22003, 동부,104,65세이상,2021,378636,161172,217464,74.1,377822,160843,216979,74.1
22003, 동부,086,85세이상,2021,34323,9809,24514,40,34273,9792,24481,40
22003, 동부,126,평균연령,2021,44.3,42.8,45.7,,44.4,43,45.8,
22003, 동부,127,중위연령,2021,46.3,44.4,47.9,,46.6,44.7,48.2,
22010, 중구,000,합계,2021,72834,34835,37999,91.7,72112,34526,37586,91.9
22010, 중구,005,0~4세,2021,2220,1123,1097,102.4,2210,1116,1094,102
22010, 중구,005001, 0세,2021,394,207,187,110.7,393,206,187,110.2
22010, 중구,005002, 1세,2021,365,183,182,100.5,364,183,181,101.1
22010, 중구,005003, 2세,2021,440,221,219,100.9,436,218,218,100
22010, 중구,005004, 3세,2021,502,250,252,99.2,499,248,251,98.8
22010, 중구,005005, 4세,2021,519,262,257,101.9,518,261,257,101.6
22010, 중구,010,5~9세,2021,2754,1423,1331,106.9,2747,1422,1325,107.3
22010, 중구,010001, 5세,2021,587,304,283,107.4,583,303,280,108.2
22010, 중구,010002, 6세,2021,566,276,290,95.2,565,276,289,95.5
22010, 중구,010003, 7세,2021,523,276,247,111.7,522,276,246,112.2
22010, 중구,010004, 8세,2021,520,259,261,99.2,519,259,260,99.6
22010, 중구,010005, 9세,2021,558,308,250,123.2,558,308,250,123.2
22010, 중구,015,10~14세,2021,2298,1202,1096,109.7,2293,1198,1095,109.4
22010, 중구,015001, 10세,2021,535,266,269,98.9,535,266,269,98.9
22010, 중구,015002, 11세,2021,455,228,227,100.4,455,228,227,100.4
22010, 중구,015003, 12세,2021,421,234,187,125.1,419,232,187,124.1
22010, 중구,015004, 13세,2021,442,224,218,102.8,439,222,217,102.3
22010, 중구,015005, 14세,2021,445,250,195,128.2,445,250,195,128.2
22010, 중구,020,15~19세,2021,2365,1157,1208,95.8,2362,1155,1207,95.7
22010, 중구,020001, 15세,2021,458,203,255,79.6,457,202,255,79.2
22010, 중구,020002, 16세,2021,419,217,202,107.4,419,217,202,107.4
22010, 중구,020003, 17세,2021,470,224,246,91.1,468,223,245,91
22010, 중구,020004, 18세,2021,514,261,253,103.2,514,261,253,103.2
22010, 중구,020005, 19세,2021,504,252,252,100,504,252,252,100
22010, 중구,025,20~24세,2021,4767,2200,2567,85.7,4708,2174,2534,85.8
22010, 중구,025001, 20세,2021,699,346,353,98,692,343,349,98.3
22010, 중구,025002, 21세,2021,871,428,443,96.6,859,424,435,97.5
22010, 중구,025003, 22세,2021,963,438,525,83.4,954,435,519,83.8
22010, 중구,025004, 23세,2021,1031,453,578,78.4,1019,447,572,78.1
22010, 중구,025005, 24세,2021,1203,535,668,80.1,1184,525,659,79.7
22010, 중구,030,25~29세,2021,6742,3298,3444,95.8,6616,3255,3361,96.8
22010, 중구,030001, 25세,2021,1351,648,703,92.2,1328,641,687,93.3
22010, 중구,030002, 26세,2021,1368,641,727,88.2,1344,631,713,88.5
22010, 중구,030003, 27세,2021,1312,645,667,96.7,1285,637,648,98.3
22010, 중구,030004, 28세,2021,1349,676,673,100.4,1322,669,653,102.5
22010, 중구,030005, 29세,2021,1362,688,674,102.1,1337,677,660,102.6
22010, 중구,035,30~34세,2021,5214,2649,2565,103.3,5111,2604,2507,103.9
22010, 중구,035001, 30세,2021,1137,573,564,101.6,1124,570,554,102.9
22010, 중구,035002, 31세,2021,1108,577,531,108.7,1082,564,518,108.9
22010, 중구,035003, 32세,2021,1078,549,529,103.8,1062,540,522,103.4
22010, 중구,035004, 33세,2021,948,489,459,106.5,924,478,446,107.2
22010, 중구,035005, 34세,2021,943,461,482,95.6,919,452,467,96.8
22010, 중구,040,35~39세,2021,5319,2758,2561,107.7,5218,2713,2505,108.3
22010, 중구,040001, 35세,2021,1004,529,475,111.4,983,521,462,112.8
22010, 중구,040002, 36세,2021,1003,540,463,116.6,977,527,450,117.1
22010, 중구,040003, 37세,2021,1014,524,490,106.9,997,515,482,106.8
22010, 중구,040004, 38세,2021,1127,594,533,111.4,1113,589,524,112.4
22010, 중구,040005, 39세,2021,1171,571,600,95.2,1148,561,587,95.6
22010, 중구,045,40~44세,2021,4995,2575,2420,106.4,4938,2553,2385,107
22010, 중구,045001, 40세,2021,1149,607,542,112,1137,602,535,112.5
22010, 중구,045002, 41세,2021,1116,579,537,107.8,1099,569,530,107.4
22010, 중구,045003, 42세,2021,986,496,490,101.2,978,493,485,101.6
22010, 중구,045004, 43세,2021,848,423,425,99.5,838,421,417,101
22010, 중구,045005, 44세,2021,896,470,426,110.3,886,468,418,112
22010, 중구,050,45~49세,2021,5141,2548,2593,98.3,5094,2524,2570,98.2
22010, 중구,050001, 45세,2021,929,473,456,103.7,921,470,451,104.2
22010, 중구,050002, 46세,2021,964,480,484,99.2,951,475,476,99.8
22010, 중구,050003, 47세,2021,1100,533,567,94,1092,529,563,94
22010, 중구,050004, 48세,2021,1040,499,541,92.2,1031,493,538,91.6
22010, 중구,050005, 49세,2021,1108,563,545,103.3,1099,557,542,102.8
22010, 중구,055,50~54세,2021,5541,2694,2847,94.6,5497,2671,2826,94.5
22010, 중구,055001, 50세,2021,1195,582,613,94.9,1185,578,607,95.2
22010, 중구,055002, 51세,2021,1102,547,555,98.6,1090,540,550,98.2
22010, 중구,055003, 52세,2021,1082,528,554,95.3,1074,525,549,95.6
22010, 중구,055004, 53세,2021,1103,553,550,100.5,1094,547,547,100
22010, 중구,055005, 54세,2021,1059,484,575,84.2,1054,481,573,83.9
22010, 중구,060,55~59세,2021,5104,2502,2602,96.2,5047,2479,2568,96.5
22010, 중구,060001, 55세,2021,970,474,496,95.6,955,471,484,97.3
22010, 중구,060002, 56세,2021,1025,504,521,96.7,1013,495,518,95.6
22010, 중구,060003, 57세,2021,1001,490,511,95.9,992,486,506,96
22010, 중구,060004, 58세,2021,1018,510,508,100.4,1011,508,503,101
22010, 중구,060005, 59세,2021,1090,524,566,92.6,1076,519,557,93.2
22010, 중구,065,60~64세,2021,5383,2544,2839,89.6,5344,2525,2819,89.6
22010, 중구,065001, 60세,2021,1108,526,582,90.4,1103,525,578,90.8
22010, 중구,065002, 61세,2021,1172,562,610,92.1,1160,554,606,91.4
22010, 중구,065003, 62세,2021,1072,512,560,91.4,1066,507,559,90.7
22010, 중구,065004, 63세,2021,955,478,477,100.2,949,478,471,101.5
22010, 중구,065005, 64세,2021,1076,466,610,76.4,1066,461,605,76.2
22010, 중구,070,65~69세,2021,4499,1998,2501,79.9,4478,1990,2488,80
22010, 중구,070001, 65세,2021,979,439,540,81.3,973,437,536,81.5
22010, 중구,070002, 66세,2021,1003,448,555,80.7,1001,447,554,80.7
22010, 중구,070003, 67세,2021,813,379,434,87.3,807,377,430,87.7
22010, 중구,070004, 68세,2021,796,346,450,76.9,792,345,447,77.2
22010, 중구,070005, 69세,2021,908,386,522,73.9,905,384,521,73.7
22010, 중구,075,70~74세,2021,3750,1570,2180,72,3733,1562,2171,71.9
22010, 중구,075001, 70세,2021,671,282,389,72.5,665,278,387,71.8
22010, 중구,075002, 71세,2021,752,315,437,72.1,749,315,434,72.6
22010, 중구,075003, 72세,2021,762,311,451,69,760,309,451,68.5
22010, 중구,075004, 73세,2021,822,357,465,76.8,817,355,462,76.8
22010, 중구,075005, 74세,2021,743,305,438,69.6,742,305,437,69.8
22010, 중구,080,75~79세,2021,3074,1294,1780,72.7,3064,1289,1775,72.6
22010, 중구,080001, 75세,2021,565,235,330,71.2,564,234,330,70.9
22010, 중구,080002, 76세,2021,544,224,320,70,542,223,319,69.9
22010, 중구,080003, 77세,2021,663,264,399,66.2,659,261,398,65.6
22010, 중구,080004, 78세,2021,629,273,356,76.7,627,273,354,77.1
22010, 중구,080005, 79세,2021,673,298,375,79.5,672,298,374,79.7
22010, 중구,085,80~84세,2021,2195,840,1355,62,2188,839,1349,62.2
22010, 중구,085001, 80세,2021,505,204,301,67.8,503,203,300,67.7
22010, 중구,085002, 81세,2021,483,197,286,68.9,483,197,286,68.9
22010, 중구,085003, 82세,2021,451,159,292,54.5,451,159,292,54.5
22010, 중구,085004, 83세,2021,410,144,266,54.1,406,144,262,55
22010, 중구,085005, 84세,2021,346,136,210,64.8,345,136,209,65.1
22010, 중구,090,85~89세,2021,1062,363,699,51.9,1055,361,694,52
22010, 중구,090001, 85세,2021,296,111,185,60,293,110,183,60.1
22010, 중구,090002, 86세,2021,245,95,150,63.3,244,95,149,63.8
22010, 중구,090003, 87세,2021,212,66,146,45.2,210,65,145,44.8
22010, 중구,090004, 88세,2021,161,48,113,42.5,160,48,112,42.9
22010, 중구,090005, 89세,2021,148,43,105,41,148,43,105,41
22010, 중구,095,90~94세,2021,332,81,251,32.3,330,80,250,32
22010, 중구,095001, 90세,2021,109,29,80,36.3,108,29,79,36.7
22010, 중구,095002, 91세,2021,72,16,56,28.6,71,15,56,26.8
22010, 중구,095003, 92세,2021,58,15,43,34.9,58,15,43,34.9
22010, 중구,095004, 93세,2021,52,14,38,36.8,52,14,38,36.8
22010, 중구,095005, 94세,2021,41,7,34,20.6,41,7,34,20.6
22010, 중구,100,95~99세,2021,65,13,52,25,65,13,52,25
22010, 중구,100001, 95세,2021,17,X,14,21.4,17,X,14,21.4
22010, 중구,100002, 96세,2021,19,X,16,18.8,19,X,16,18.8
22010, 중구,100003, 97세,2021,11,5,6,83.3,11,5,6,83.3
22010, 중구,100004, 98세,2021,8,X,6,33.3,8,X,6,33.3
22010, 중구,100005, 99세,2021,10,X,10,0,10,X,10,0
22010, 중구,101,100세이상,2021,14,X,11,27.3,14,X,11,27.3
22010, 중구,102,15세미만,2021,7272,3748,3524,106.4,7250,3736,3514,106.3
22010, 중구,103,15~64세,2021,50571,24925,25646,97.2,49935,24653,25282,97.5
22010, 중구,104,65세이상,2021,14991,6162,8829,69.8,14927,6137,8790,69.8
22010, 중구,086,85세이상,2021,1473,460,1013,45.4,1464,457,1007,45.4
22010, 중구,126,평균연령,2021,44.8,43.4,46,,44.8,43.4,46.1,
22010, 중구,127,중위연령,2021,44.7,42.8,46.5,,44.8,42.9,46.7,
22020, 동구,000,합계,2021,332637,162891,169746,96,330408,162181,168227,96.4
22020, 동구,005,0~4세,2021,10057,5181,4876,106.3,10012,5153,4859,106.1
22020, 동구,005001, 0세,2021,1653,851,802,106.1,1647,848,799,106.1
22020, 동구,005002, 1세,2021,1787,916,871,105.2,1782,912,870,104.8
22020, 동구,005003, 2세,2021,2007,1033,974,106.1,2000,1028,972,105.8
22020, 동구,005004, 3세,2021,2203,1095,1108,98.8,2192,1087,1105,98.4
22020, 동구,005005, 4세,2021,2407,1286,1121,114.7,2391,1278,1113,114.8
22020, 동구,010,5~9세,2021,13680,6899,6781,101.7,13624,6871,6753,101.7
22020, 동구,010001, 5세,2021,2649,1285,1364,94.2,2638,1278,1360,94
22020, 동구,010002, 6세,2021,2806,1452,1354,107.2,2789,1444,1345,107.4
22020, 동구,010003, 7세,2021,2713,1360,1353,100.5,2702,1355,1347,100.6
22020, 동구,010004, 8세,2021,2636,1333,1303,102.3,2628,1330,1298,102.5
22020, 동구,010005, 9세,2021,2876,1469,1407,104.4,2867,1464,1403,104.3
22020, 동구,015,10~14세,2021,12788,6614,6174,107.1,12752,6600,6152,107.3
22020, 동구,015001, 10세,2021,2692,1410,1282,110,2684,1409,1275,110.5
22020, 동구,015002, 11세,2021,2595,1366,1229,111.1,2590,1363,1227,111.1
22020, 동구,015003, 12세,2021,2446,1284,1162,110.5,2439,1280,1159,110.4
22020, 동구,015004, 13세,2021,2512,1253,1259,99.5,2501,1248,1253,99.6
22020, 동구,015005, 14세,2021,2543,1301,1242,104.8,2538,1300,1238,105
22020, 동구,020,15~19세,2021,12411,6728,5683,118.4,12372,6710,5662,118.5
22020, 동구,020001, 15세,2021,2297,1232,1065,115.7,2291,1228,1063,115.5
22020, 동구,020002, 16세,2021,2353,1287,1066,120.7,2347,1284,1063,120.8
22020, 동구,020003, 17세,2021,2572,1391,1181,117.8,2565,1390,1175,118.3
22020, 동구,020004, 18세,2021,2684,1431,1253,114.2,2677,1428,1249,114.3
22020, 동구,020005, 19세,2021,2505,1387,1118,124.1,2492,1380,1112,124.1
22020, 동구,025,20~24세,2021,17380,9271,8109,114.3,17196,9223,7973,115.7
22020, 동구,025001, 20세,2021,2911,1582,1329,119,2899,1581,1318,120
22020, 동구,025002, 21세,2021,3488,1942,1546,125.6,3455,1930,1525,126.6
22020, 동구,025003, 22세,2021,3432,1835,1597,114.9,3379,1816,1563,116.2
22020, 동구,025004, 23세,2021,3663,1960,1703,115.1,3625,1952,1673,116.7
22020, 동구,025005, 24세,2021,3886,1952,1934,100.9,3838,1944,1894,102.6
22020, 동구,030,25~29세,2021,21674,11406,10268,111.1,21396,11356,10040,113.1
22020, 동구,030001, 25세,2021,4157,2141,2016,106.2,4095,2129,1966,108.3
22020, 동구,030002, 26세,2021,4280,2247,2033,110.5,4230,2240,1990,112.6
22020, 동구,030003, 27세,2021,4425,2337,2088,111.9,4372,2325,2047,113.6
22020, 동구,030004, 28세,2021,4319,2292,2027,113.1,4262,2282,1980,115.3
22020, 동구,030005, 29세,2021,4493,2389,2104,113.5,4437,2380,2057,115.7
22020, 동구,035,30~34세,2021,20496,10931,9565,114.3,20147,10836,9311,116.4
22020, 동구,035001, 30세,2021,4331,2304,2027,113.7,4265,2288,1977,115.7
22020, 동구,035002, 31세,2021,4236,2302,1934,119,4168,2284,1884,121.2
22020, 동구,035003, 32세,2021,4112,2169,1943,111.6,4040,2144,1896,113.1
22020, 동구,035004, 33세,2021,3834,2047,1787,114.5,3753,2026,1727,117.3
22020, 동구,035005, 34세,2021,3983,2109,1874,112.5,3921,2094,1827,114.6
22020, 동구,040,35~39세,2021,21817,11353,10464,108.5,21526,11272,10254,109.9
22020, 동구,040001, 35세,2021,3957,2131,1826,116.7,3889,2107,1782,118.2
22020, 동구,040002, 36세,2021,3922,2055,1867,110.1,3859,2040,1819,112.1
22020, 동구,040003, 37세,2021,4111,2150,1961,109.6,4063,2142,1921,111.5
22020, 동구,040004, 38세,2021,4676,2383,2293,103.9,4622,2367,2255,105
22020, 동구,040005, 39세,2021,5151,2634,2517,104.6,5093,2616,2477,105.6
22020, 동구,045,40~44세,2021,24430,12459,11971,104.1,24192,12382,11810,104.8
22020, 동구,045001, 40세,2021,5221,2648,2573,102.9,5173,2634,2539,103.7
22020, 동구,045002, 41세,2021,5283,2684,2599,103.3,5239,2669,2570,103.9
22020, 동구,045003, 42세,2021,4838,2446,2392,102.3,4786,2430,2356,103.1
22020, 동구,045004, 43세,2021,4505,2344,2161,108.5,4455,2328,2127,109.4
22020, 동구,045005, 44세,2021,4583,2337,2246,104.1,4539,2321,2218,104.6
22020, 동구,050,45~49세,2021,24777,12619,12158,103.8,24596,12550,12046,104.2
22020, 동구,050001, 45세,2021,4462,2340,2122,110.3,4429,2325,2104,110.5
22020, 동구,050002, 46세,2021,4811,2478,2333,106.2,4770,2464,2306,106.9
22020, 동구,050003, 47세,2021,5091,2564,2527,101.5,5055,2555,2500,102.2
22020, 동구,050004, 48세,2021,5158,2578,2580,99.9,5121,2564,2557,100.3
22020, 동구,050005, 49세,2021,5255,2659,2596,102.4,5221,2642,2579,102.4
22020, 동구,055,50~54세,2021,27705,13506,14199,95.1,27548,13450,14098,95.4
22020, 동구,055001, 50세,2021,5540,2825,2715,104.1,5498,2811,2687,104.6
22020, 동구,055002, 51세,2021,5443,2659,2784,95.5,5410,2648,2762,95.9
22020, 동구,055003, 52세,2021,5548,2659,2889,92,5517,2645,2872,92.1
22020, 동구,055004, 53세,2021,5814,2835,2979,95.2,5783,2825,2958,95.5
22020, 동구,055005, 54세,2021,5360,2528,2832,89.3,5340,2521,2819,89.4
22020, 동구,060,55~59세,2021,27267,13100,14167,92.5,27111,13044,14067,92.7
22020, 동구,060001, 55세,2021,5294,2601,2693,96.6,5261,2586,2675,96.7
22020, 동구,060002, 56세,2021,5504,2633,2871,91.7,5477,2623,2854,91.9
22020, 동구,060003, 57세,2021,5200,2480,2720,91.2,5171,2474,2697,91.7
22020, 동구,060004, 58세,2021,5523,2640,2883,91.6,5480,2623,2857,91.8
22020, 동구,060005, 59세,2021,5746,2746,3000,91.5,5722,2738,2984,91.8
22020, 동구,065,60~64세,2021,29076,13584,15492,87.7,28970,13546,15424,87.8
22020, 동구,065001, 60세,2021,6371,2974,3397,87.5,6354,2966,3388,87.5
22020, 동구,065002, 61세,2021,6317,2887,3430,84.2,6285,2876,3409,84.4
22020, 동구,065003, 62세,2021,5754,2663,3091,86.2,5736,2655,3081,86.2
22020, 동구,065004, 63세,2021,5216,2522,2694,93.6,5193,2513,2680,93.8
22020, 동구,065005, 64세,2021,5418,2538,2880,88.1,5402,2536,2866,88.5
22020, 동구,070,65~69세,2021,23446,10735,12711,84.5,23387,10705,12682,84.4
22020, 동구,070001, 65세,2021,5124,2400,2724,88.1,5110,2395,2715,88.2
22020, 동구,070002, 66세,2021,5288,2378,2910,81.7,5274,2371,2903,81.7
22020, 동구,070003, 67세,2021,4390,2005,2385,84.1,4375,1998,2377,84.1
22020, 동구,070004, 68세,2021,4152,1874,2278,82.3,4143,1867,2276,82
22020, 동구,070005, 69세,2021,4492,2078,2414,86.1,4485,2074,2411,86
22020, 동구,075,70~74세,2021,17599,7889,9710,81.2,17569,7875,9694,81.2
22020, 동구,075001, 70세,2021,3503,1603,1900,84.4,3494,1598,1896,84.3
22020, 동구,075002, 71세,2021,3471,1586,1885,84.1,3463,1583,1880,84.2
22020, 동구,075003, 72세,2021,3857,1723,2134,80.7,3851,1719,2132,80.6
22020, 동구,075004, 73세,2021,3478,1549,1929,80.3,3476,1548,1928,80.3
22020, 동구,075005, 74세,2021,3290,1428,1862,76.7,3285,1427,1858,76.8
22020, 동구,080,75~79세,2021,12643,5349,7294,73.3,12632,5345,7287,73.3
22020, 동구,080001, 75세,2021,2215,1000,1215,82.3,2213,998,1215,82.1
22020, 동구,080002, 76세,2021,2308,973,1335,72.9,2306,972,1334,72.9
22020, 동구,080003, 77세,2021,2611,1093,1518,72,2607,1093,1514,72.2
22020, 동구,080004, 78세,2021,2711,1147,1564,73.3,2708,1146,1562,73.4
22020, 동구,080005, 79세,2021,2798,1136,1662,68.4,2798,1136,1662,68.4
22020, 동구,085,80~84세,2021,9260,3501,5759,60.8,9254,3499,5755,60.8
22020, 동구,085001, 80세,2021,2294,920,1374,67,2292,919,1373,66.9
22020, 동구,085002, 81세,2021,2033,795,1238,64.2,2033,795,1238,64.2
22020, 동구,085003, 82세,2021,1923,736,1187,62,1921,736,1185,62.1
22020, 동구,085004, 83세,2021,1568,534,1034,51.6,1568,534,1034,51.6
22020, 동구,085005, 84세,2021,1442,516,926,55.7,1440,515,925,55.7
22020, 동구,090,85~89세,2021,4544,1437,3107,46.3,4538,1436,3102,46.3
22020, 동구,090001, 85세,2021,1265,433,832,52,1264,433,831,52.1
22020, 동구,090002, 86세,2021,1105,377,728,51.8,1103,377,726,51.9
22020, 동구,090003, 87세,2021,912,267,645,41.4,912,267,645,41.4
22020, 동구,090004, 88세,2021,691,193,498,38.8,689,193,496,38.9
22020, 동구,090005, 89세,2021,571,167,404,41.3,570,166,404,41.1
22020, 동구,095,90~94세,2021,1293,277,1016,27.3,1292,276,1016,27.2
22020, 동구,095001, 90세,2021,401,99,302,32.8,401,99,302,32.8
22020, 동구,095002, 91세,2021,295,57,238,23.9,295,57,238,23.9
22020, 동구,095003, 92세,2021,233,43,190,22.6,233,43,190,22.6
22020, 동구,095004, 93세,2021,223,48,175,27.4,222,47,175,26.9
22020, 동구,095005, 94세,2021,141,30,111,27,141,30,111,27
22020, 동구,100,95~99세,2021,260,46,214,21.5,260,46,214,21.5
22020, 동구,100001, 95세,2021,73,14,59,23.7,73,14,59,23.7
22020, 동구,100002, 96세,2021,88,18,70,25.7,88,18,70,25.7
22020, 동구,100003, 97세,2021,41,9,32,28.1,41,9,32,28.1
22020, 동구,100004, 98세,2021,30,X,28,7.1,30,X,28,7.1
22020, 동구,100005, 99세,2021,28,X,25,12,28,X,25,12
22020, 동구,101,100세이상,2021,34,6,28,21.4,34,6,28,21.4
22020, 동구,102,15세미만,2021,36525,18694,17831,104.8,36388,18624,17764,104.8
22020, 동구,103,15~64세,2021,227033,114957,112076,102.6,225054,114369,110685,103.3
22020, 동구,104,65세이상,2021,69079,29240,39839,73.4,68966,29188,39778,73.4
22020, 동구,086,85세이상,2021,6131,1766,4365,40.5,6124,1764,4360,40.5
22020, 동구,126,평균연령,2021,45.6,44,47.2,,45.7,44,47.3,
22020, 동구,127,중위연령,2021,47.5,45.3,49.5,,47.6,45.3,49.7,
22030, 서구,000,합계,2021,165455,82384,83071,99.2,162512,80882,81630,99.1
22030, 서구,005,0~4세,2021,2638,1373,1265,108.5,2600,1361,1239,109.8
22030, 서구,005001, 0세,2021,390,197,193,102.1,382,195,187,104.3
22030, 서구,005002, 1세,2021,445,248,197,125.9,436,244,192,127.1
22030, 서구,005003, 2세,2021,484,271,213,127.2,477,270,207,130.4
22030, 서구,005004, 3세,2021,611,299,312,95.8,602,295,307,96.1
22030, 서구,005005, 4세,2021,708,358,350,102.3,703,357,346,103.2
22030, 서구,010,5~9세,2021,4234,2155,2079,103.7,4195,2138,2057,103.9
22030, 서구,010001, 5세,2021,811,440,371,118.6,799,434,365,118.9
22030, 서구,010002, 6세,2021,838,432,406,106.4,829,431,398,108.3
22030, 서구,010003, 7세,2021,805,407,398,102.3,797,402,395,101.8
22030, 서구,010004, 8세,2021,846,412,434,94.9,842,409,433,94.5
22030, 서구,010005, 9세,2021,934,464,470,98.7,928,462,466,99.1
22030, 서구,015,10~14세,2021,4502,2273,2229,102,4478,2262,2216,102.1
22030, 서구,015001, 10세,2021,933,484,449,107.8,928,480,448,107.1
22030, 서구,015002, 11세,2021,839,410,429,95.6,834,407,427,95.3
22030, 서구,015003, 12세,2021,862,426,436,97.7,859,425,434,97.9
22030, 서구,015004, 13세,2021,901,467,434,107.6,894,465,429,108.4
22030, 서구,015005, 14세,2021,967,486,481,101,963,485,478,101.5
22030, 서구,020,15~19세,2021,5620,2981,2639,113,5593,2973,2620,113.5
22030, 서구,020001, 15세,2021,941,485,456,106.4,938,484,454,106.6
22030, 서구,020002, 16세,2021,986,513,473,108.5,982,511,471,108.5
22030, 서구,020003, 17세,2021,1159,625,534,117,1155,623,532,117.1
22030, 서구,020004, 18세,2021,1292,674,618,109.1,1288,673,615,109.4
22030, 서구,020005, 19세,2021,1242,684,558,122.6,1230,682,548,124.5
22030, 서구,025,20~24세,2021,9020,4937,4083,120.9,8817,4833,3984,121.3
22030, 서구,025001, 20세,2021,1488,830,658,126.1,1474,825,649,127.1
22030, 서구,025002, 21세,2021,1739,984,755,130.3,1706,969,737,131.5
22030, 서구,025003, 22세,2021,1686,893,793,112.6,1639,871,768,113.4
22030, 서구,025004, 23세,2021,1981,1115,866,128.8,1932,1083,849,127.6
22030, 서구,025005, 24세,2021,2126,1115,1011,110.3,2066,1085,981,110.6
22030, 서구,030,25~29세,2021,11433,6379,5054,126.2,11038,6178,4860,127.1
22030, 서구,030001, 25세,2021,2243,1183,1060,111.6,2170,1146,1024,111.9
22030, 서구,030002, 26세,2021,2300,1277,1023,124.8,2232,1243,989,125.7
22030, 서구,030003, 27세,2021,2257,1274,983,129.6,2180,1236,944,130.9
22030, 서구,030004, 28세,2021,2293,1315,978,134.5,2206,1264,942,134.2
22030, 서구,030005, 29세,2021,2340,1330,1010,131.7,2250,1289,961,134.1
22030, 서구,035,30~34세,2021,8784,5099,3685,138.4,8274,4840,3434,140.9
22030, 서구,035001, 30세,2021,2083,1170,913,128.1,1995,1123,872,128.8
22030, 서구,035002, 31세,2021,1888,1095,793,138.1,1774,1040,734,141.7
22030, 서구,035003, 32세,2021,1711,1014,697,145.5,1624,971,653,148.7
22030, 서구,035004, 33세,2021,1547,923,624,147.9,1450,877,573,153.1
22030, 서구,035005, 34세,2021,1555,897,658,136.3,1431,829,602,137.7
22030, 서구,040,35~39세,2021,8487,4707,3780,124.5,8037,4468,3569,125.2
22030, 서구,040001, 35세,2021,1631,958,673,142.3,1514,894,620,144.2
22030, 서구,040002, 36세,2021,1516,851,665,128,1427,809,618,130.9
22030, 서구,040003, 37세,2021,1610,886,724,122.4,1526,836,690,121.2
22030, 서구,040004, 38세,2021,1799,982,817,120.2,1711,938,773,121.3
22030, 서구,040005, 39세,2021,1931,1030,901,114.3,1859,991,868,114.2
22030, 서구,045,40~44세,2021,9690,5255,4435,118.5,9348,5079,4269,119
22030, 서구,045001, 40세,2021,1965,1109,856,129.6,1896,1078,818,131.8
22030, 서구,045002, 41세,2021,2075,1086,989,109.8,2009,1053,956,110.1
22030, 서구,045003, 42세,2021,1933,1046,887,117.9,1858,1009,849,118.8
22030, 서구,045004, 43세,2021,1799,959,840,114.2,1729,920,809,113.7
22030, 서구,045005, 44세,2021,1918,1055,863,122.2,1856,1019,837,121.7
22030, 서구,050,45~49세,2021,11582,6154,5428,113.4,11314,6003,5311,113
22030, 서구,050001, 45세,2021,1947,1021,926,110.3,1888,984,904,108.8
22030, 서구,050002, 46세,2021,2140,1140,1000,114,2083,1111,972,114.3
22030, 서구,050003, 47세,2021,2384,1330,1054,126.2,2336,1303,1033,126.1
22030, 서구,050004, 48세,2021,2567,1351,1216,111.1,2522,1327,1195,111
22030, 서구,050005, 49세,2021,2544,1312,1232,106.5,2485,1278,1207,105.9
22030, 서구,055,50~54세,2021,15086,7558,7528,100.4,14836,7423,7413,100.1
22030, 서구,055001, 50세,2021,2828,1430,1398,102.3,2766,1403,1363,102.9
22030, 서구,055002, 51세,2021,2852,1466,1386,105.8,2788,1426,1362,104.7
22030, 서구,055003, 52세,2021,3044,1504,1540,97.7,2992,1473,1519,97
22030, 서구,055004, 53세,2021,3283,1653,1630,101.4,3247,1630,1617,100.8
22030, 서구,055005, 54세,2021,3079,1505,1574,95.6,3043,1491,1552,96.1
22030, 서구,060,55~59세,2021,16891,8367,8524,98.2,16702,8269,8433,98.1
22030, 서구,060001, 55세,2021,3258,1621,1637,99,3228,1606,1622,99
22030, 서구,060002, 56세,2021,3363,1663,1700,97.8,3322,1638,1684,97.3
22030, 서구,060003, 57세,2021,3273,1622,1651,98.2,3238,1604,1634,98.2
22030, 서구,060004, 58세,2021,3337,1693,1644,103,3290,1667,1623,102.7
22030, 서구,060005, 59세,2021,3660,1768,1892,93.4,3624,1754,1870,93.8
22030, 서구,065,60~64세,2021,17532,8408,9124,92.2,17451,8372,9079,92.2
22030, 서구,065001, 60세,2021,3954,1923,2031,94.7,3941,1913,2028,94.3
22030, 서구,065002, 61세,2021,3844,1843,2001,92.1,3824,1833,1991,92.1
22030, 서구,065003, 62세,2021,3523,1637,1886,86.8,3506,1634,1872,87.3
22030, 서구,065004, 63세,2021,2977,1427,1550,92.1,2962,1423,1539,92.5
22030, 서구,065005, 64세,2021,3234,1578,1656,95.3,3218,1569,1649,95.1
22030, 서구,070,65~69세,2021,14099,6381,7718,82.7,14021,6341,7680,82.6
22030, 서구,070001, 65세,2021,3047,1412,1635,86.4,3026,1403,1623,86.4
22030, 서구,070002, 66세,2021,3078,1367,1711,79.9,3065,1360,1705,79.8
22030, 서구,070003, 67세,2021,2618,1207,1411,85.5,2601,1197,1404,85.3
22030, 서구,070004, 68세,2021,2541,1161,1380,84.1,2526,1151,1375,83.7
22030, 서구,070005, 69세,2021,2815,1234,1581,78.1,2803,1230,1573,78.2
22030, 서구,075,70~74세,2021,10159,4611,5548,83.1,10135,4602,5533,83.2
22030, 서구,075001, 70세,2021,2031,916,1115,82.2,2021,915,1106,82.7
22030, 서구,075002, 71세,2021,1985,959,1026,93.5,1980,957,1023,93.5
22030, 서구,075003, 72세,2021,2207,1017,1190,85.5,2204,1014,1190,85.2
22030, 서구,075004, 73세,2021,2043,903,1140,79.2,2038,901,1137,79.2
22030, 서구,075005, 74세,2021,1893,816,1077,75.8,1892,815,1077,75.7
22030, 서구,080,75~79세,2021,7171,3008,4163,72.3,7160,3007,4153,72.4
22030, 서구,080001, 75세,2021,1229,515,714,72.1,1225,514,711,72.3
22030, 서구,080002, 76세,2021,1266,562,704,79.8,1262,562,700,80.3
22030, 서구,080003, 77세,2021,1502,599,903,66.3,1500,599,901,66.5
22030, 서구,080004, 78세,2021,1536,660,876,75.3,1535,660,875,75.4
22030, 서구,080005, 79세,2021,1638,672,966,69.6,1638,672,966,69.6
22030, 서구,085,80~84세,2021,5162,1889,3273,57.7,5155,1887,3268,57.7
22030, 서구,085001, 80세,2021,1298,526,772,68.1,1295,524,771,68
22030, 서구,085002, 81세,2021,1055,385,670,57.5,1053,385,668,57.6
22030, 서구,085003, 82세,2021,1122,416,706,58.9,1122,416,706,58.9
22030, 서구,085004, 83세,2021,886,304,582,52.2,885,304,581,52.3
22030, 서구,085005, 84세,2021,801,258,543,47.5,800,258,542,47.6
22030, 서구,090,85~89세,2021,2485,718,1767,40.6,2481,716,1765,40.6
22030, 서구,090001, 85세,2021,695,240,455,52.7,695,240,455,52.7
22030, 서구,090002, 86세,2021,585,159,426,37.3,585,159,426,37.3
22030, 서구,090003, 87세,2021,492,142,350,40.6,492,142,350,40.6
22030, 서구,090004, 88세,2021,372,98,274,35.8,369,97,272,35.7
22030, 서구,090005, 89세,2021,341,79,262,30.2,340,78,262,29.8
22030, 서구,095,90~94세,2021,726,114,612,18.6,725,113,612,18.5
22030, 서구,095001, 90세,2021,222,39,183,21.3,222,39,183,21.3
22030, 서구,095002, 91세,2021,173,27,146,18.5,172,26,146,17.8
22030, 서구,095003, 92세,2021,138,21,117,17.9,138,21,117,17.9
22030, 서구,095004, 93세,2021,106,16,90,17.8,106,16,90,17.8
22030, 서구,095005, 94세,2021,87,11,76,14.5,87,11,76,14.5
22030, 서구,100,95~99세,2021,135,16,119,13.4,135,16,119,13.4
22030, 서구,100001, 95세,2021,52,6,46,13,52,6,46,13
22030, 서구,100002, 96세,2021,27,X,24,12.5,27,X,24,12.5
22030, 서구,100003, 97세,2021,25,X,22,13.6,25,X,22,13.6
22030, 서구,100004, 98세,2021,21,X,17,23.5,21,X,17,23.5
22030, 서구,100005, 99세,2021,10,X,10,0,10,X,10,0
22030, 서구,101,100세이상,2021,19,X,18,5.6,17,X,16,6.3
22030, 서구,102,15세미만,2021,11374,5801,5573,104.1,11273,5761,5512,104.5
22030, 서구,103,15~64세,2021,114125,59845,54280,110.3,111410,58438,52972,110.3
22030, 서구,104,65세이상,2021,39956,16738,23218,72.1,39829,16683,23146,72.1
22030, 서구,086,85세이상,2021,3365,849,2516,33.7,3358,846,2512,33.7
22030, 서구,126,평균연령,2021,49,47.1,50.9,,49.2,47.2,51.1,
22030, 서구,127,중위연령,2021,52.3,49.9,54.6,,52.7,50.2,54.9,
22040, 남구,000,합계,2021,144898,69140,75758,91.3,142958,68352,74606,91.6
22040, 남구,005,0~4세,2021,2683,1407,1276,110.3,2666,1398,1268,110.3
22040, 남구,005001, 0세,2021,463,237,226,104.9,459,235,224,104.9
22040, 남구,005002, 1세,2021,480,250,230,108.7,478,249,229,108.7
22040, 남구,005003, 2세,2021,553,307,246,124.8,551,306,245,124.9
22040, 남구,005004, 3세,2021,594,305,289,105.5,589,303,286,105.9
22040, 남구,005005, 4세,2021,593,308,285,108.1,589,305,284,107.4
22040, 남구,010,5~9세,2021,3649,1859,1790,103.9,3632,1848,1784,103.6
22040, 남구,010001, 5세,2021,709,346,363,95.3,701,341,360,94.7
22040, 남구,010002, 6세,2021,686,356,330,107.9,684,355,329,107.9
22040, 남구,010003, 7세,2021,737,368,369,99.7,735,366,369,99.2
22040, 남구,010004, 8세,2021,744,390,354,110.2,741,388,353,109.9
22040, 남구,010005, 9세,2021,773,399,374,106.7,771,398,373,106.7
22040, 남구,015,10~14세,2021,3873,2046,1827,112,3857,2037,1820,111.9
22040, 남구,015001, 10세,2021,755,401,354,113.3,752,399,353,113
22040, 남구,015002, 11세,2021,748,400,348,114.9,744,399,345,115.7
22040, 남구,015003, 12세,2021,718,362,356,101.7,714,359,355,101.1
22040, 남구,015004, 13세,2021,787,427,360,118.6,785,426,359,118.7
22040, 남구,015005, 14세,2021,865,456,409,111.5,862,454,408,111.3
22040, 남구,020,15~19세,2021,5313,2686,2627,102.2,5206,2629,2577,102
22040, 남구,020001, 15세,2021,852,452,400,113,848,450,398,113.1
22040, 남구,020002, 16세,2021,858,440,418,105.3,856,439,417,105.3
22040, 남구,020003, 17세,2021,1041,498,543,91.7,1032,493,539,91.5
22040, 남구,020004, 18세,2021,1132,578,554,104.3,1107,566,541,104.6
22040, 남구,020005, 19세,2021,1430,718,712,100.8,1363,681,682,99.9
22040, 남구,025,20~24세,2021,10432,5020,5412,92.8,9866,4725,5141,91.9
22040, 남구,025001, 20세,2021,1779,801,978,81.9,1672,748,924,81
22040, 남구,025002, 21세,2021,2047,975,1072,91,1911,900,1011,89
22040, 남구,025003, 22세,2021,2155,1101,1054,104.5,1988,1012,976,103.7
22040, 남구,025004, 23세,2021,2147,1035,1112,93.1,2053,985,1068,92.2
22040, 남구,025005, 24세,2021,2304,1108,1196,92.6,2242,1080,1162,92.9
22040, 남구,030,25~29세,2021,11308,5761,5547,103.9,11063,5689,5374,105.9
22040, 남구,030001, 25세,2021,2277,1122,1155,97.1,2214,1099,1115,98.6
22040, 남구,030002, 26세,2021,2321,1163,1158,100.4,2262,1145,1117,102.5
22040, 남구,030003, 27세,2021,2305,1201,1104,108.8,2273,1192,1081,110.3
22040, 남구,030004, 28세,2021,2203,1155,1048,110.2,2154,1141,1013,112.6
22040, 남구,030005, 29세,2021,2202,1120,1082,103.5,2160,1112,1048,106.1
22040, 남구,035,30~34세,2021,8552,4542,4010,113.3,8357,4492,3865,116.2
22040, 남구,035001, 30세,2021,1930,1012,918,110.2,1895,1005,890,112.9
22040, 남구,035002, 31세,2021,1891,1004,887,113.2,1850,991,859,115.4
22040, 남구,035003, 32세,2021,1689,922,767,120.2,1642,913,729,125.2
22040, 남구,035004, 33세,2021,1505,778,727,107,1468,768,700,109.7
22040, 남구,035005, 34세,2021,1537,826,711,116.2,1502,815,687,118.6
22040, 남구,040,35~39세,2021,8244,4256,3988,106.7,8041,4194,3847,109
22040, 남구,040001, 35세,2021,1565,849,716,118.6,1518,837,681,122.9
22040, 남구,040002, 36세,2021,1541,827,714,115.8,1494,811,683,118.7
22040, 남구,040003, 37세,2021,1570,773,797,97,1526,760,766,99.2
22040, 남구,040004, 38세,2021,1706,885,821,107.8,1671,877,794,110.5
22040, 남구,040005, 39세,2021,1862,922,940,98.1,1832,909,923,98.5
22040, 남구,045,40~44세,2021,8903,4510,4393,102.7,8778,4474,4304,103.9
22040, 남구,045001, 40세,2021,1850,935,915,102.2,1822,930,892,104.3
22040, 남구,045002, 41세,2021,1901,997,904,110.3,1868,988,880,112.3
22040, 남구,045003, 42세,2021,1762,867,895,96.9,1745,860,885,97.2
22040, 남구,045004, 43세,2021,1664,851,813,104.7,1639,844,795,106.2
22040, 남구,045005, 44세,2021,1726,860,866,99.3,1704,852,852,100
22040, 남구,050,45~49세,2021,10089,5044,5045,100,9995,5005,4990,100.3
22040, 남구,050001, 45세,2021,1701,854,847,100.8,1685,848,837,101.3
22040, 남구,050002, 46세,2021,1847,884,963,91.8,1832,877,955,91.8
22040, 남구,050003, 47세,2021,2070,1069,1001,106.8,2044,1057,987,107.1
22040, 남구,050004, 48세,2021,2198,1106,1092,101.3,2183,1099,1084,101.4
22040, 남구,050005, 49세,2021,2273,1131,1142,99,2251,1124,1127,99.7
22040, 남구,055,50~54세,2021,12053,5950,6103,97.5,11953,5904,6049,97.6
22040, 남구,055001, 50세,2021,2413,1202,1211,99.3,2390,1189,1201,99
22040, 남구,055002, 51세,2021,2395,1177,1218,96.6,2374,1167,1207,96.7
22040, 남구,055003, 52세,2021,2321,1175,1146,102.5,2307,1169,1138,102.7
22040, 남구,055004, 53세,2021,2546,1266,1280,98.9,2524,1253,1271,98.6
22040, 남구,055005, 54세,2021,2378,1130,1248,90.5,2358,1126,1232,91.4
22040, 남구,060,55~59세,2021,11679,5605,6074,92.3,11609,5576,6033,92.4
22040, 남구,060001, 55세,2021,2139,1085,1054,102.9,2123,1077,1046,103
22040, 남구,060002, 56세,2021,2357,1114,1243,89.6,2343,1106,1237,89.4
22040, 남구,060003, 57세,2021,2144,960,1184,81.1,2132,957,1175,81.4
22040, 남구,060004, 58세,2021,2465,1197,1268,94.4,2448,1190,1258,94.6
22040, 남구,060005, 59세,2021,2574,1249,1325,94.3,2563,1246,1317,94.6
22040, 남구,065,60~64세,2021,13131,6058,7073,85.6,13056,6028,7028,85.8
22040, 남구,065001, 60세,2021,2823,1309,1514,86.5,2809,1305,1504,86.8
22040, 남구,065002, 61세,2021,2732,1206,1526,79,2712,1198,1514,79.1
22040, 남구,065003, 62세,2021,2688,1229,1459,84.2,2674,1226,1448,84.7
22040, 남구,065004, 63세,2021,2378,1130,1248,90.5,2361,1121,1240,90.4
22040, 남구,065005, 64세,2021,2510,1184,1326,89.3,2500,1178,1322,89.1
22040, 남구,070,65~69세,2021,11131,5041,6090,82.8,11079,5024,6055,83
22040, 남구,070001, 65세,2021,2329,1072,1257,85.3,2316,1066,1250,85.3
22040, 남구,070002, 66세,2021,2555,1163,1392,83.5,2540,1159,1381,83.9
22040, 남구,070003, 67세,2021,2085,975,1110,87.8,2075,973,1102,88.3
22040, 남구,070004, 68세,2021,2018,873,1145,76.2,2009,870,1139,76.4
22040, 남구,070005, 69세,2021,2144,958,1186,80.8,2139,956,1183,80.8
22040, 남구,075,70~74세,2021,8511,3710,4801,77.3,8483,3695,4788,77.2
22040, 남구,075001, 70세,2021,1637,702,935,75.1,1628,697,931,74.9
22040, 남구,075002, 71세,2021,1664,774,890,87,1659,771,888,86.8
22040, 남구,075003, 72세,2021,1813,797,1016,78.4,1806,793,1013,78.3
22040, 남구,075004, 73세,2021,1749,741,1008,73.5,1745,741,1004,73.8
22040, 남구,075005, 74세,2021,1648,696,952,73.1,1645,693,952,72.8
22040, 남구,080,75~79세,2021,6438,2668,3770,70.8,6423,2662,3761,70.8
22040, 남구,080001, 75세,2021,1160,495,665,74.4,1157,494,663,74.5
22040, 남구,080002, 76세,2021,1120,442,678,65.2,1117,441,676,65.2
22040, 남구,080003, 77세,2021,1275,531,744,71.4,1268,529,739,71.6
22040, 남구,080004, 78세,2021,1446,581,865,67.2,1446,581,865,67.2
22040, 남구,080005, 79세,2021,1437,619,818,75.7,1435,617,818,75.4
22040, 남구,085,80~84세,2021,5125,1912,3213,59.5,5118,1910,3208,59.5
22040, 남구,085001, 80세,2021,1258,497,761,65.3,1257,497,760,65.4
22040, 남구,085002, 81세,2021,1080,383,697,54.9,1078,383,695,55.1
22040, 남구,085003, 82세,2021,1054,420,634,66.2,1052,418,634,65.9
22040, 남구,085004, 83세,2021,896,316,580,54.5,894,316,578,54.7
22040, 남구,085005, 84세,2021,837,296,541,54.7,837,296,541,54.7
22040, 남구,090,85~89세,2021,2704,860,1844,46.6,2699,857,1842,46.5
22040, 남구,090001, 85세,2021,704,233,471,49.5,702,232,470,49.4
22040, 남구,090002, 86세,2021,657,217,440,49.3,656,217,439,49.4
22040, 남구,090003, 87세,2021,556,179,377,47.5,554,177,377,46.9
22040, 남구,090004, 88세,2021,434,126,308,40.9,434,126,308,40.9
22040, 남구,090005, 89세,2021,353,105,248,42.3,353,105,248,42.3
22040, 남구,095,90~94세,2021,880,178,702,25.4,879,178,701,25.4
22040, 남구,095001, 90세,2021,266,54,212,25.5,265,54,211,25.6
22040, 남구,095002, 91세,2021,223,42,181,23.2,223,42,181,23.2
22040, 남구,095003, 92세,2021,170,32,138,23.2,170,32,138,23.2
22040, 남구,095004, 93세,2021,120,31,89,34.8,120,31,89,34.8
22040, 남구,095005, 94세,2021,101,19,82,23.2,101,19,82,23.2
22040, 남구,100,95~99세,2021,178,24,154,15.6,176,24,152,15.8
22040, 남구,100001, 95세,2021,59,9,50,18,58,9,49,18.4
22040, 남구,100002, 96세,2021,44,7,37,18.9,43,7,36,19.4
22040, 남구,100003, 97세,2021,33,X,29,13.8,33,X,29,13.8
22040, 남구,100004, 98세,2021,22,X,18,22.2,22,X,18,22.2
22040, 남구,100005, 99세,2021,20,X,20,0,20,X,20,0
22040, 남구,101,100세이상,2021,22,X,19,15.8,22,X,19,15.8
22040, 남구,102,15세미만,2021,10205,5312,4893,108.6,10155,5283,4872,108.4
22040, 남구,103,15~64세,2021,99704,49432,50272,98.3,97924,48716,49208,99
22040, 남구,104,65세이상,2021,34989,14396,20593,69.9,34879,14353,20526,69.9
22040, 남구,086,85세이상,2021,3784,1065,2719,39.2,3776,1062,2714,39.1
22040, 남구,126,평균연령,2021,47.8,46,49.3,,47.9,46.2,49.6,
22040, 남구,127,중위연령,2021,49.7,47.7,51.6,,50,47.9,51.9,
22050, 북구,000,합계,2021,444446,221221,223225,99.1,438182,218301,219881,99.3
22050, 북구,005,0~4세,2021,13127,6699,6428,104.2,13016,6645,6371,104.3
22050, 북구,005001, 0세,2021,2071,1054,1017,103.6,2046,1040,1006,103.4
22050, 북구,005002, 1세,2021,2367,1209,1158,104.4,2343,1202,1141,105.3
22050, 북구,005003, 2세,2021,2585,1363,1222,111.5,2565,1351,1214,111.3
22050, 북구,005004, 3세,2021,2899,1462,1437,101.7,2878,1450,1428,101.5
22050, 북구,005005, 4세,2021,3205,1611,1594,101.1,3184,1602,1582,101.3
22050, 북구,010,5~9세,2021,18807,9647,9160,105.3,18730,9606,9124,105.3
22050, 북구,010001, 5세,2021,3636,1880,1756,107.1,3615,1870,1745,107.2
22050, 북구,010002, 6세,2021,3752,1937,1815,106.7,3733,1925,1808,106.5
22050, 북구,010003, 7세,2021,3696,1856,1840,100.9,3679,1848,1831,100.9
22050, 북구,010004, 8세,2021,3699,1908,1791,106.5,3693,1905,1788,106.5
22050, 북구,010005, 9세,2021,4024,2066,1958,105.5,4010,2058,1952,105.4
22050, 북구,015,10~14세,2021,19638,10150,9488,107,19610,10135,9475,107
22050, 북구,015001, 10세,2021,3962,2065,1897,108.9,3957,2065,1892,109.1
22050, 북구,015002, 11세,2021,3781,1957,1824,107.3,3773,1952,1821,107.2
22050, 북구,015003, 12세,2021,3699,1890,1809,104.5,3694,1888,1806,104.5
22050, 북구,015004, 13세,2021,3975,2066,1909,108.2,3974,2065,1909,108.2
22050, 북구,015005, 14세,2021,4221,2172,2049,106,4212,2165,2047,105.8
22050, 북구,020,15~19세,2021,22815,11729,11086,105.8,22613,11647,10966,106.2
22050, 북구,020001, 15세,2021,3914,2008,1906,105.4,3911,2006,1905,105.3
22050, 북구,020002, 16세,2021,3968,2007,1961,102.3,3963,2004,1959,102.3
22050, 북구,020003, 17세,2021,4228,2224,2004,111,4221,2221,2000,111.1
22050, 북구,020004, 18세,2021,4757,2453,2304,106.5,4705,2431,2274,106.9
22050, 북구,020005, 19세,2021,5948,3037,2911,104.3,5813,2985,2828,105.6
22050, 북구,025,20~24세,2021,36899,19382,17517,110.6,35610,18820,16790,112.1
22050, 북구,025001, 20세,2021,6984,3361,3623,92.8,6723,3254,3469,93.8
22050, 북구,025002, 21세,2021,7705,3782,3923,96.4,7422,3654,3768,97
22050, 북구,025003, 22세,2021,7282,3881,3401,114.1,7003,3759,3244,115.9
22050, 북구,025004, 23세,2021,7469,4182,3287,127.2,7221,4068,3153,129
22050, 북구,025005, 24세,2021,7459,4176,3283,127.2,7241,4085,3156,129.4
22050, 북구,030,25~29세,2021,31567,17445,14122,123.5,30471,16957,13514,125.5
22050, 북구,030001, 25세,2021,6964,3982,2982,133.5,6755,3879,2876,134.9
22050, 북구,030002, 26세,2021,6474,3542,2932,120.8,6239,3444,2795,123.2
22050, 북구,030003, 27세,2021,6267,3439,2828,121.6,6037,3340,2697,123.8
22050, 북구,030004, 28세,2021,6029,3273,2756,118.8,5816,3177,2639,120.4
22050, 북구,030005, 29세,2021,5833,3209,2624,122.3,5624,3117,2507,124.3
22050, 북구,035,30~34세,2021,25842,13943,11899,117.2,24832,13473,11359,118.6
22050, 북구,035001, 30세,2021,5479,2977,2502,119,5277,2890,2387,121.1
22050, 북구,035002, 31세,2021,5299,2821,2478,113.8,5090,2722,2368,114.9
22050, 북구,035003, 32세,2021,5163,2788,2375,117.4,4973,2701,2272,118.9
22050, 북구,035004, 33세,2021,4885,2676,2209,121.1,4681,2580,2101,122.8
22050, 북구,035005, 34세,2021,5016,2681,2335,114.8,4811,2580,2231,115.6
22050, 북구,040,35~39세,2021,27553,14248,13305,107.1,26767,13845,12922,107.1
22050, 북구,040001, 35세,2021,5055,2676,2379,112.5,4854,2572,2282,112.7
22050, 북구,040002, 36세,2021,4979,2657,2322,114.4,4821,2578,2243,114.9
22050, 북구,040003, 37세,2021,5269,2759,2510,109.9,5119,2674,2445,109.4
22050, 북구,040004, 38세,2021,5789,2887,2902,99.5,5644,2823,2821,100.1
22050, 북구,040005, 39세,2021,6461,3269,3192,102.4,6329,3198,3131,102.1
22050, 북구,045,40~44세,2021,32179,15984,16195,98.7,31695,15736,15959,98.6
22050, 북구,045001, 40세,2021,6619,3285,3334,98.5,6493,3219,3274,98.3
22050, 북구,045002, 41세,2021,6755,3386,3369,100.5,6654,3340,3314,100.8
22050, 북구,045003, 42세,2021,6402,3162,3240,97.6,6295,3108,3187,97.5
22050, 북구,045004, 43세,2021,6025,3019,3006,100.4,5947,2975,2972,100.1
22050, 북구,045005, 44세,2021,6378,3132,3246,96.5,6306,3094,3212,96.3
22050, 북구,050,45~49세,2021,37632,18295,19337,94.6,37253,18106,19147,94.6
22050, 북구,050001, 45세,2021,6456,3177,3279,96.9,6380,3138,3242,96.8
22050, 북구,050002, 46세,2021,7169,3493,3676,95,7095,3457,3638,95
22050, 북구,050003, 47세,2021,7886,3794,4092,92.7,7812,3764,4048,93
22050, 북구,050004, 48세,2021,7959,3858,4101,94.1,7877,3813,4064,93.8
22050, 북구,050005, 49세,2021,8162,3973,4189,94.8,8089,3934,4155,94.7
22050, 북구,055,50~54세,2021,41405,20426,20979,97.4,41080,20262,20818,97.3
22050, 북구,055001, 50세,2021,8460,4189,4271,98.1,8388,4144,4244,97.6
22050, 북구,055002, 51세,2021,8387,4062,4325,93.9,8315,4032,4283,94.1
22050, 북구,055003, 52세,2021,8267,4093,4174,98.1,8198,4062,4136,98.2
22050, 북구,055004, 53세,2021,8495,4290,4205,102,8442,4258,4184,101.8
22050, 북구,055005, 54세,2021,7796,3792,4004,94.7,7737,3766,3971,94.8
22050, 북구,060,55~59세,2021,36263,18034,18229,98.9,36022,17933,18089,99.1
22050, 북구,060001, 55세,2021,7486,3806,3680,103.4,7441,3787,3654,103.6
22050, 북구,060002, 56세,2021,7411,3559,3852,92.4,7364,3542,3822,92.7
22050, 북구,060003, 57세,2021,6722,3341,3381,98.8,6681,3323,3358,99
22050, 북구,060004, 58세,2021,7172,3550,3622,98,7110,3523,3587,98.2
22050, 북구,060005, 59세,2021,7472,3778,3694,102.3,7426,3758,3668,102.5
22050, 북구,065,60~64세,2021,33655,16702,16953,98.5,33556,16648,16908,98.5
22050, 북구,065001, 60세,2021,7948,3872,4076,95,7931,3864,4067,95
22050, 북구,065002, 61세,2021,7495,3682,3813,96.6,7469,3666,3803,96.4
22050, 북구,065003, 62세,2021,6635,3298,3337,98.8,6612,3284,3328,98.7
22050, 북구,065004, 63세,2021,5826,2956,2870,103,5812,2949,2863,103
22050, 북구,065005, 64세,2021,5751,2894,2857,101.3,5732,2885,2847,101.3
22050, 북구,070,65~69세,2021,23438,11119,12319,90.3,23359,11086,12273,90.3
22050, 북구,070001, 65세,2021,5327,2559,2768,92.4,5314,2552,2762,92.4
22050, 북구,070002, 66세,2021,5224,2463,2761,89.2,5211,2458,2753,89.3
22050, 북구,070003, 67세,2021,4433,2164,2269,95.4,4407,2154,2253,95.6
22050, 북구,070004, 68세,2021,4150,1894,2256,84,4136,1888,2248,84
22050, 북구,070005, 69세,2021,4304,2039,2265,90,4291,2034,2257,90.1
22050, 북구,075,70~74세,2021,16724,7522,9202,81.7,16698,7514,9184,81.8
22050, 북구,075001, 70세,2021,3375,1573,1802,87.3,3369,1572,1797,87.5
22050, 북구,075002, 71세,2021,3329,1523,1806,84.3,3320,1520,1800,84.4
22050, 북구,075003, 72세,2021,3598,1611,1987,81.1,3592,1609,1983,81.1
22050, 북구,075004, 73세,2021,3395,1472,1923,76.5,3391,1470,1921,76.5
22050, 북구,075005, 74세,2021,3027,1343,1684,79.8,3026,1343,1683,79.8
22050, 북구,080,75~79세,2021,12136,5012,7124,70.4,12119,5006,7113,70.4
22050, 북구,080001, 75세,2021,2102,914,1188,76.9,2096,913,1183,77.2
22050, 북구,080002, 76세,2021,2179,889,1290,68.9,2176,888,1288,68.9
22050, 북구,080003, 77세,2021,2514,976,1538,63.5,2511,974,1537,63.4
22050, 북구,080004, 78세,2021,2535,1033,1502,68.8,2532,1032,1500,68.8
22050, 북구,080005, 79세,2021,2806,1200,1606,74.7,2804,1199,1605,74.7
22050, 북구,085,80~84세,2021,8874,3266,5608,58.2,8864,3264,5600,58.3
22050, 북구,085001, 80세,2021,2143,807,1336,60.4,2140,807,1333,60.5
22050, 북구,085002, 81세,2021,1990,727,1263,57.6,1989,727,1262,57.6
22050, 북구,085003, 82세,2021,1867,700,1167,60,1865,699,1166,59.9
22050, 북구,085004, 83세,2021,1529,562,967,58.1,1527,561,966,58.1
22050, 북구,085005, 84세,2021,1345,470,875,53.7,1343,470,873,53.8
22050, 북구,090,85~89세,2021,4331,1305,3026,43.1,4327,1305,3022,43.2
22050, 북구,090001, 85세,2021,1187,379,808,46.9,1186,379,807,47
22050, 북구,090002, 86세,2021,1069,332,737,45,1069,332,737,45
22050, 북구,090003, 87세,2021,860,252,608,41.4,859,252,607,41.5
22050, 북구,090004, 88세,2021,669,191,478,40,668,191,477,40
22050, 북구,090005, 89세,2021,546,151,395,38.2,545,151,394,38.3
22050, 북구,095,90~94세,2021,1309,274,1035,26.5,1309,274,1035,26.5
22050, 북구,095001, 90세,2021,403,104,299,34.8,403,104,299,34.8
22050, 북구,095002, 91세,2021,321,61,260,23.5,321,61,260,23.5
22050, 북구,095003, 92세,2021,232,41,191,21.5,232,41,191,21.5
22050, 북구,095004, 93세,2021,195,36,159,22.6,195,36,159,22.6
22050, 북구,095005, 94세,2021,158,32,126,25.4,158,32,126,25.4
22050, 북구,100,95~99세,2021,219,38,181,21,219,38,181,21
22050, 북구,100001, 95세,2021,65,13,52,25,65,13,52,25
22050, 북구,100002, 96세,2021,65,12,53,22.6,65,12,53,22.6
22050, 북구,100003, 97세,2021,29,5,24,20.8,29,5,24,20.8
22050, 북구,100004, 98세,2021,34,X,30,13.3,34,X,30,13.3
22050, 북구,100005, 99세,2021,26,X,22,18.2,26,X,22,18.2
22050, 북구,101,100세이상,2021,33,X,32,3.1,32,X,31,3.2
22050, 북구,102,15세미만,2021,51572,26496,25076,105.7,51356,26386,24970,105.7
22050, 북구,103,15~64세,2021,325810,166188,159622,104.1,319899,163427,156472,104.4
22050, 북구,104,65세이상,2021,67064,28537,38527,74.1,66927,28488,38439,74.1
22050, 북구,086,85세이상,2021,5892,1618,4274,37.9,5887,1618,4269,37.9
22050, 북구,126,평균연령,2021,42.5,41.2,43.8,,42.6,41.3,43.9,
22050, 북구,127,중위연령,2021,44,42.2,45.7,,44.3,42.5,46.1,
22060, 수성구,000,합계,2021,408085,197716,210369,94,405938,196873,209065,94.2
22060, 수성구,005,0~4세,2021,9659,4983,4676,106.6,9621,4965,4656,106.6
22060, 수성구,005001, 0세,2021,1430,729,701,104,1427,727,700,103.9
22060, 수성구,005002, 1세,2021,1521,805,716,112.4,1517,802,715,112.2
22060, 수성구,005003, 2세,2021,1885,986,899,109.7,1877,982,895,109.7
22060, 수성구,005004, 3세,2021,2184,1147,1037,110.6,2172,1142,1030,110.9
22060, 수성구,005005, 4세,2021,2639,1316,1323,99.5,2628,1312,1316,99.7
22060, 수성구,010,5~9세,2021,18582,9592,8990,106.7,18539,9569,8970,106.7
22060, 수성구,010001, 5세,2021,3161,1649,1512,109.1,3153,1645,1508,109.1
22060, 수성구,010002, 6세,2021,3426,1766,1660,106.4,3415,1761,1654,106.5
22060, 수성구,010003, 7세,2021,3734,1944,1790,108.6,3723,1937,1786,108.5
22060, 수성구,010004, 8세,2021,3896,2005,1891,106,3888,2000,1888,105.9
22060, 수성구,010005, 9세,2021,4365,2228,2137,104.3,4360,2226,2134,104.3
22060, 수성구,015,10~14세,2021,23591,12253,11338,108.1,23569,12240,11329,108
22060, 수성구,015001, 10세,2021,4372,2263,2109,107.3,4368,2261,2107,107.3
22060, 수성구,015002, 11세,2021,4483,2296,2187,105,4479,2294,2185,105
22060, 수성구,015003, 12세,2021,4562,2410,2152,112,4556,2406,2150,111.9
22060, 수성구,015004, 13세,2021,5058,2643,2415,109.4,5056,2642,2414,109.4
22060, 수성구,015005, 14세,2021,5116,2641,2475,106.7,5110,2637,2473,106.6
22060, 수성구,020,15~19세,2021,23967,12881,11086,116.2,23944,12867,11077,116.2
22060, 수성구,020001, 15세,2021,4808,2566,2242,114.5,4805,2565,2240,114.5
22060, 수성구,020002, 16세,2021,4650,2468,2182,113.1,4647,2465,2182,113
22060, 수성구,020003, 17세,2021,5014,2679,2335,114.7,5007,2675,2332,114.7
22060, 수성구,020004, 18세,2021,5091,2779,2312,120.2,5089,2777,2312,120.1
22060, 수성구,020005, 19세,2021,4404,2389,2015,118.6,4396,2385,2011,118.6
22060, 수성구,025,20~24세,2021,25685,13931,11754,118.5,25355,13798,11557,119.4
22060, 수성구,025001, 20세,2021,5069,2820,2249,125.4,5050,2811,2239,125.5
22060, 수성구,025002, 21세,2021,5531,3102,2429,127.7,5459,3070,2389,128.5
22060, 수성구,025003, 22세,2021,5025,2743,2282,120.2,4958,2717,2241,121.2
22060, 수성구,025004, 23세,2021,5049,2660,2389,111.3,4956,2617,2339,111.9
22060, 수성구,025005, 24세,2021,5011,2606,2405,108.4,4932,2583,2349,110
22060, 수성구,030,25~29세,2021,23734,12535,11199,111.9,23388,12425,10963,113.3
22060, 수성구,030001, 25세,2021,5031,2632,2399,109.7,4956,2607,2349,111
22060, 수성구,030002, 26세,2021,4911,2620,2291,114.4,4844,2598,2246,115.7
22060, 수성구,030003, 27세,2021,4775,2511,2264,110.9,4707,2489,2218,112.2
22060, 수성구,030004, 28세,2021,4513,2389,2124,112.5,4442,2367,2075,114.1
22060, 수성구,030005, 29세,2021,4504,2383,2121,112.4,4439,2364,2075,113.9
22060, 수성구,035,30~34세,2021,18648,9665,8983,107.6,18337,9563,8774,109
22060, 수성구,035001, 30세,2021,4178,2193,1985,110.5,4108,2169,1939,111.9
22060, 수성구,035002, 31세,2021,3906,2006,1900,105.6,3850,1988,1862,106.8
22060, 수성구,035003, 32세,2021,3683,1951,1732,112.6,3606,1926,1680,114.6
22060, 수성구,035004, 33세,2021,3396,1757,1639,107.2,3341,1739,1602,108.6
22060, 수성구,035005, 34세,2021,3485,1758,1727,101.8,3432,1741,1691,103
22060, 수성구,040,35~39세,2021,22106,10319,11787,87.5,21826,10207,11619,87.8
22060, 수성구,040001, 35세,2021,3516,1766,1750,100.9,3456,1740,1716,101.4
22060, 수성구,040002, 36세,2021,3888,1860,2028,91.7,3832,1835,1997,91.9
22060, 수성구,040003, 37세,2021,4164,1975,2189,90.2,4097,1950,2147,90.8
22060, 수성구,040004, 38세,2021,4822,2138,2684,79.7,4772,2120,2652,79.9
22060, 수성구,040005, 39세,2021,5716,2580,3136,82.3,5669,2562,3107,82.5
22060, 수성구,045,40~44세,2021,31179,14120,17059,82.8,30993,14036,16957,82.8
22060, 수성구,045001, 40세,2021,5907,2642,3265,80.9,5875,2629,3246,81
22060, 수성구,045002, 41세,2021,6410,2897,3513,82.5,6381,2883,3498,82.4
22060, 수성구,045003, 42세,2021,6411,2927,3484,84,6362,2899,3463,83.7
22060, 수성구,045004, 43세,2021,5986,2717,3269,83.1,5944,2699,3245,83.2
22060, 수성구,045005, 44세,2021,6465,2937,3528,83.2,6431,2926,3505,83.5
22060, 수성구,050,45~49세,2021,37548,17267,20281,85.1,37400,17198,20202,85.1
22060, 수성구,050001, 45세,2021,6707,3123,3584,87.1,6681,3110,3571,87.1
22060, 수성구,050002, 46세,2021,7037,3170,3867,82,7004,3158,3846,82.1
22060, 수성구,050003, 47세,2021,7793,3516,4277,82.2,7766,3500,4266,82
22060, 수성구,050004, 48세,2021,7939,3656,4283,85.4,7908,3642,4266,85.4
22060, 수성구,050005, 49세,2021,8072,3802,4270,89,8041,3788,4253,89.1
22060, 수성구,055,50~54세,2021,40614,19499,21115,92.3,40470,19445,21025,92.5
22060, 수성구,055001, 50세,2021,8567,4067,4500,90.4,8539,4058,4481,90.6
22060, 수성구,055002, 51세,2021,8325,3910,4415,88.6,8293,3901,4392,88.8
22060, 수성구,055003, 52세,2021,8118,3904,4214,92.6,8091,3891,4200,92.6
22060, 수성구,055004, 53세,2021,8152,3980,4172,95.4,8129,3971,4158,95.5
22060, 수성구,055005, 54세,2021,7452,3638,3814,95.4,7418,3624,3794,95.5
22060, 수성구,060,55~59세,2021,33534,16436,17098,96.1,33416,16397,17019,96.3
22060, 수성구,060001, 55세,2021,6804,3397,3407,99.7,6784,3392,3392,100
22060, 수성구,060002, 56세,2021,6940,3360,3580,93.9,6918,3352,3566,94
22060, 수성구,060003, 57세,2021,6505,3195,3310,96.5,6477,3185,3292,96.7
22060, 수성구,060004, 58세,2021,6775,3327,3448,96.5,6750,3319,3431,96.7
22060, 수성구,060005, 59세,2021,6510,3157,3353,94.2,6487,3149,3338,94.3
22060, 수성구,065,60~64세,2021,30960,14932,16028,93.2,30880,14899,15981,93.2
22060, 수성구,065001, 60세,2021,6861,3316,3545,93.5,6847,3309,3538,93.5
22060, 수성구,065002, 61세,2021,6806,3297,3509,94,6780,3289,3491,94.2
22060, 수성구,065003, 62세,2021,6247,3014,3233,93.2,6229,3006,3223,93.3
22060, 수성구,065004, 63세,2021,5376,2583,2793,92.5,5361,2576,2785,92.5
22060, 수성구,065005, 64세,2021,5670,2722,2948,92.3,5663,2719,2944,92.4
22060, 수성구,070,65~69세,2021,23122,10830,12292,88.1,23082,10811,12271,88.1
22060, 수성구,070001, 65세,2021,5172,2458,2714,90.6,5158,2451,2707,90.5
22060, 수성구,070002, 66세,2021,5173,2464,2709,91,5167,2460,2707,90.9
22060, 수성구,070003, 67세,2021,4269,2029,2240,90.6,4262,2026,2236,90.6
22060, 수성구,070004, 68세,2021,4251,1915,2336,82,4243,1912,2331,82
22060, 수성구,070005, 69세,2021,4257,1964,2293,85.7,4252,1962,2290,85.7
22060, 수성구,075,70~74세,2021,16931,7528,9403,80.1,16913,7520,9393,80.1
22060, 수성구,075001, 70세,2021,3337,1485,1852,80.2,3331,1482,1849,80.2
22060, 수성구,075002, 71세,2021,3424,1569,1855,84.6,3421,1568,1853,84.6
22060, 수성구,075003, 72세,2021,3556,1564,1992,78.5,3552,1562,1990,78.5
22060, 수성구,075004, 73세,2021,3343,1477,1866,79.2,3342,1477,1865,79.2
22060, 수성구,075005, 74세,2021,3271,1433,1838,78,3267,1431,1836,77.9
22060, 수성구,080,75~79세,2021,12110,5196,6914,75.2,12098,5189,6909,75.1
22060, 수성구,080001, 75세,2021,2107,962,1145,84,2107,962,1145,84
22060, 수성구,080002, 76세,2021,2218,952,1266,75.2,2216,951,1265,75.2
22060, 수성구,080003, 77세,2021,2481,1065,1416,75.2,2475,1061,1414,75
22060, 수성구,080004, 78세,2021,2608,1094,1514,72.3,2605,1092,1513,72.2
22060, 수성구,080005, 79세,2021,2696,1123,1573,71.4,2695,1123,1572,71.4
22060, 수성구,085,80~84세,2021,9310,3627,5683,63.8,9307,3625,5682,63.8
22060, 수성구,085001, 80세,2021,2235,895,1340,66.8,2232,893,1339,66.7
22060, 수성구,085002, 81세,2021,1997,784,1213,64.6,1997,784,1213,64.6
22060, 수성구,085003, 82세,2021,1896,768,1128,68.1,1896,768,1128,68.1
22060, 수성구,085004, 83세,2021,1667,617,1050,58.8,1667,617,1050,58.8
22060, 수성구,085005, 84세,2021,1515,563,952,59.1,1515,563,952,59.1
22060, 수성구,090,85~89세,2021,4979,1684,3295,51.1,4976,1683,3293,51.1
22060, 수성구,090001, 85세,2021,1333,473,860,55,1333,473,860,55
22060, 수성구,090002, 86세,2021,1207,409,798,51.3,1207,409,798,51.3
22060, 수성구,090003, 87세,2021,977,330,647,51,975,329,646,50.9
22060, 수성구,090004, 88세,2021,801,270,531,50.8,800,270,530,50.9
22060, 수성구,090005, 89세,2021,661,202,459,44,661,202,459,44
22060, 수성구,095,90~94세,2021,1531,375,1156,32.4,1530,374,1156,32.4
22060, 수성구,095001, 90세,2021,476,131,345,38,476,131,345,38
22060, 수성구,095002, 91세,2021,352,89,263,33.8,352,89,263,33.8
22060, 수성구,095003, 92세,2021,318,79,239,33.1,318,79,239,33.1
22060, 수성구,095004, 93세,2021,217,42,175,24,217,42,175,24
22060, 수성구,095005, 94세,2021,168,34,134,25.4,167,33,134,24.6
22060, 수성구,100,95~99세,2021,258,57,201,28.4,258,57,201,28.4
22060, 수성구,100001, 95세,2021,101,23,78,29.5,101,23,78,29.5
22060, 수성구,100002, 96세,2021,70,16,54,29.6,70,16,54,29.6
22060, 수성구,100003, 97세,2021,37,X,33,12.1,37,X,33,12.1
22060, 수성구,100004, 98세,2021,29,10,19,52.6,29,10,19,52.6
22060, 수성구,100005, 99세,2021,21,X,17,23.5,21,X,17,23.5
22060, 수성구,101,100세이상,2021,37,6,31,19.4,36,5,31,16.1
22060, 수성구,102,15세미만,2021,51832,26828,25004,107.3,51729,26774,24955,107.3
22060, 수성구,103,15~64세,2021,287975,141585,146390,96.7,286009,140835,145174,97
22060, 수성구,104,65세이상,2021,68278,29303,38975,75.2,68200,29264,38936,75.2
22060, 수성구,086,85세이상,2021,6805,2122,4683,45.3,6800,2119,4681,45.3
22060, 수성구,126,평균연령,2021,43.5,42,44.9,,43.5,42.1,44.9,
22060, 수성구,127,중위연령,2021,46,44.5,47.2,,46.1,44.6,47.3,
22070, 달서구,000,합계,2021,554702,274424,280278,97.9,541730,267202,274528,97.3
22070, 달서구,005,0~4세,2021,14098,7258,6840,106.1,13955,7189,6766,106.3
22070, 달서구,005001, 0세,2021,2262,1189,1073,110.8,2237,1178,1059,111.2
22070, 달서구,005002, 1세,2021,2480,1237,1243,99.5,2441,1218,1223,99.6
22070, 달서구,005003, 2세,2021,2792,1424,1368,104.1,2759,1408,1351,104.2
22070, 달서구,005004, 3세,2021,3076,1549,1527,101.4,3053,1536,1517,101.3
22070, 달서구,005005, 4세,2021,3488,1859,1629,114.1,3465,1849,1616,114.4
22070, 달서구,010,5~9세,2021,22811,11640,11171,104.2,22704,11590,11114,104.3
22070, 달서구,010001, 5세,2021,4253,2210,2043,108.2,4222,2193,2029,108.1
22070, 달서구,010002, 6세,2021,4557,2319,2238,103.6,4530,2306,2224,103.7
22070, 달서구,010003, 7세,2021,4446,2268,2178,104.1,4427,2262,2165,104.5
22070, 달서구,010004, 8세,2021,4463,2274,2189,103.9,4450,2270,2180,104.1
22070, 달서구,010005, 9세,2021,5092,2569,2523,101.8,5075,2559,2516,101.7
22070, 달서구,015,10~14세,2021,25017,12902,12115,106.5,24963,12881,12082,106.6
22070, 달서구,015001, 10세,2021,4943,2545,2398,106.1,4933,2539,2394,106.1
22070, 달서구,015002, 11세,2021,4901,2514,2387,105.3,4890,2511,2379,105.5
22070, 달서구,015003, 12세,2021,4750,2506,2244,111.7,4739,2504,2235,112
22070, 달서구,015004, 13세,2021,5086,2642,2444,108.1,5077,2638,2439,108.2
22070, 달서구,015005, 14세,2021,5337,2695,2642,102,5324,2689,2635,102
22070, 달서구,020,15~19세,2021,28062,14531,13531,107.4,27746,14387,13359,107.7
22070, 달서구,020001, 15세,2021,4941,2563,2378,107.8,4935,2559,2376,107.7
22070, 달서구,020002, 16세,2021,5003,2594,2409,107.7,4996,2590,2406,107.6
22070, 달서구,020003, 17세,2021,5581,2920,2661,109.7,5571,2916,2655,109.8
22070, 달서구,020004, 18세,2021,5898,3093,2805,110.3,5855,3073,2782,110.5
22070, 달서구,020005, 19세,2021,6639,3361,3278,102.5,6389,3249,3140,103.5
22070, 달서구,025,20~24세,2021,41516,21652,19864,109,38149,19905,18244,109.1
22070, 달서구,025001, 20세,2021,8194,4108,4086,100.5,7253,3649,3604,101.2
22070, 달서구,025002, 21세,2021,8771,4629,4142,111.8,7909,4168,3741,111.4
22070, 달서구,025003, 22세,2021,8071,4252,3819,111.3,7506,3958,3548,111.6
22070, 달서구,025004, 23세,2021,8186,4322,3864,111.9,7668,4046,3622,111.7
22070, 달서구,025005, 24세,2021,8294,4341,3953,109.8,7813,4084,3729,109.5
22070, 달서구,030,25~29세,2021,39650,21277,18373,115.8,37465,20014,17451,114.7
22070, 달서구,030001, 25세,2021,8411,4527,3884,116.6,7921,4236,3685,115
22070, 달서구,030002, 26세,2021,8153,4377,3776,115.9,7683,4119,3564,115.6
22070, 달서구,030003, 27세,2021,7791,4175,3616,115.5,7380,3952,3428,115.3
22070, 달서구,030004, 28세,2021,7646,4065,3581,113.5,7242,3823,3419,111.8
22070, 달서구,030005, 29세,2021,7649,4133,3516,117.5,7239,3884,3355,115.8
22070, 달서구,035,30~34세,2021,31882,17548,14334,122.4,29835,16319,13516,120.7
22070, 달서구,035001, 30세,2021,6889,3840,3049,125.9,6485,3583,2902,123.5
22070, 달서구,035002, 31세,2021,6651,3694,2957,124.9,6247,3453,2794,123.6
22070, 달서구,035003, 32세,2021,6397,3510,2887,121.6,6001,3255,2746,118.5
22070, 달서구,035004, 33세,2021,5924,3268,2656,123,5489,3012,2477,121.6
22070, 달서구,035005, 34세,2021,6021,3236,2785,116.2,5613,3016,2597,116.1
22070, 달서구,040,35~39세,2021,33532,17135,16397,104.5,31996,16213,15783,102.7
22070, 달서구,040001, 35세,2021,6085,3275,2810,116.5,5752,3075,2677,114.9
22070, 달서구,040002, 36세,2021,5903,3056,2847,107.3,5575,2876,2699,106.6
22070, 달서구,040003, 37세,2021,6287,3163,3124,101.2,6022,2990,3032,98.6
22070, 달서구,040004, 38세,2021,7225,3645,3580,101.8,6923,3469,3454,100.4
22070, 달서구,040005, 39세,2021,8032,3996,4036,99,7724,3803,3921,97
22070, 달서구,045,40~44세,2021,39885,19567,20318,96.3,38815,18925,19890,95.1
22070, 달서구,045001, 40세,2021,7928,3919,4009,97.8,7683,3777,3906,96.7
22070, 달서구,045002, 41세,2021,8328,4084,4244,96.2,8105,3951,4154,95.1
22070, 달서구,045003, 42세,2021,8086,3909,4177,93.6,7861,3778,4083,92.5
22070, 달서구,045004, 43세,2021,7551,3736,3815,97.9,7362,3623,3739,96.9
22070, 달서구,045005, 44세,2021,7992,3919,4073,96.2,7804,3796,4008,94.7
22070, 달서구,050,45~49세,2021,45805,22142,23663,93.6,45034,21708,23326,93.1
22070, 달서구,050001, 45세,2021,8167,4057,4110,98.7,7990,3959,4031,98.2
22070, 달서구,050002, 46세,2021,8381,3983,4398,90.6,8228,3887,4341,89.5
22070, 달서구,050003, 47세,2021,9603,4709,4894,96.2,9461,4638,4823,96.2
22070, 달서구,050004, 48세,2021,9758,4650,5108,91,9596,4556,5040,90.4
22070, 달서구,050005, 49세,2021,9896,4743,5153,92,9759,4668,5091,91.7
22070, 달서구,055,50~54세,2021,53190,25490,27700,92,52553,25131,27422,91.6
22070, 달서구,055001, 50세,2021,10656,5092,5564,91.5,10497,5003,5494,91.1
22070, 달서구,055002, 51세,2021,10400,5037,5363,93.9,10247,4955,5292,93.6
22070, 달서구,055003, 52세,2021,10865,5224,5641,92.6,10746,5152,5594,92.1
22070, 달서구,055004, 53세,2021,10933,5204,5729,90.8,10814,5137,5677,90.5
22070, 달서구,055005, 54세,2021,10336,4933,5403,91.3,10249,4884,5365,91
22070, 달서구,060,55~59세,2021,48915,23953,24962,96,48525,23763,24762,96
22070, 달서구,060001, 55세,2021,9808,4805,5003,96,9719,4761,4958,96
22070, 달서구,060002, 56세,2021,9932,4782,5150,92.9,9846,4736,5110,92.7
22070, 달서구,060003, 57세,2021,9323,4535,4788,94.7,9251,4499,4752,94.7
22070, 달서구,060004, 58세,2021,9826,4917,4909,100.2,9755,4878,4877,100
22070, 달서구,060005, 59세,2021,10026,4914,5112,96.1,9954,4889,5065,96.5
22070, 달서구,065,60~64세,2021,46060,22533,23527,95.8,45896,22447,23449,95.7
22070, 달서구,065001, 60세,2021,10852,5242,5610,93.4,10827,5227,5600,93.3
22070, 달서구,065002, 61세,2021,10318,4995,5323,93.8,10263,4967,5296,93.8
22070, 달서구,065003, 62세,2021,9214,4481,4733,94.7,9183,4465,4718,94.6
22070, 달서구,065004, 63세,2021,7602,3790,3812,99.4,7575,3776,3799,99.4
22070, 달서구,065005, 64세,2021,8074,4025,4049,99.4,8048,4012,4036,99.4
22070, 달서구,070,65~69세,2021,31960,15252,16708,91.3,31862,15217,16645,91.4
22070, 달서구,070001, 65세,2021,7215,3623,3592,100.9,7203,3618,3585,100.9
22070, 달서구,070002, 66세,2021,7271,3447,3824,90.1,7249,3439,3810,90.3
22070, 달서구,070003, 67세,2021,5874,2861,3013,95,5850,2854,2996,95.3
22070, 달서구,070004, 68세,2021,5685,2645,3040,87,5667,2637,3030,87
22070, 달서구,070005, 69세,2021,5915,2676,3239,82.6,5893,2669,3224,82.8
22070, 달서구,075,70~74세,2021,21279,9886,11393,86.8,21230,9870,11360,86.9
22070, 달서구,075001, 70세,2021,4398,2111,2287,92.3,4379,2103,2276,92.4
22070, 달서구,075002, 71세,2021,4386,2051,2335,87.8,4375,2048,2327,88
22070, 달서구,075003, 72세,2021,4485,2089,2396,87.2,4476,2088,2388,87.4
22070, 달서구,075004, 73세,2021,4159,1928,2231,86.4,4150,1925,2225,86.5
22070, 달서구,075005, 74세,2021,3851,1707,2144,79.6,3850,1706,2144,79.6
22070, 달서구,080,75~79세,2021,13973,5989,7984,75,13957,5981,7976,75
22070, 달서구,080001, 75세,2021,2500,1185,1315,90.1,2497,1183,1314,90
22070, 달서구,080002, 76세,2021,2510,1090,1420,76.8,2507,1089,1418,76.8
22070, 달서구,080003, 77세,2021,2858,1197,1661,72.1,2855,1195,1660,72
22070, 달서구,080004, 78세,2021,2872,1222,1650,74.1,2870,1221,1649,74
22070, 달서구,080005, 79세,2021,3233,1295,1938,66.8,3228,1293,1935,66.8
22070, 달서구,085,80~84세,2021,10194,3740,6454,57.9,10181,3736,6445,58
22070, 달서구,085001, 80세,2021,2465,955,1510,63.2,2460,954,1506,63.3
22070, 달서구,085002, 81세,2021,2217,832,1385,60.1,2216,832,1384,60.1
22070, 달서구,085003, 82세,2021,2116,771,1345,57.3,2112,768,1344,57.1
22070, 달서구,085004, 83세,2021,1820,647,1173,55.2,1819,647,1172,55.2
22070, 달서구,085005, 84세,2021,1576,535,1041,51.4,1574,535,1039,51.5
22070, 달서구,090,85~89세,2021,5079,1542,3537,43.6,5073,1540,3533,43.6
22070, 달서구,090001, 85세,2021,1449,452,997,45.3,1448,452,996,45.4
22070, 달서구,090002, 86세,2021,1241,402,839,47.9,1237,401,836,48
22070, 달서구,090003, 87세,2021,956,289,667,43.3,955,288,667,43.2
22070, 달서구,090004, 88세,2021,772,223,549,40.6,772,223,549,40.6
22070, 달서구,090005, 89세,2021,661,176,485,36.3,661,176,485,36.3
22070, 달서구,095,90~94세,2021,1525,332,1193,27.8,1522,331,1191,27.8
22070, 달서구,095001, 90세,2021,479,119,360,33.1,479,119,360,33.1
22070, 달서구,095002, 91세,2021,394,81,313,25.9,393,81,312,26
22070, 달서구,095003, 92세,2021,297,63,234,26.9,297,63,234,26.9
22070, 달서구,095004, 93세,2021,227,43,184,23.4,225,42,183,23
22070, 달서구,095005, 94세,2021,128,26,102,25.5,128,26,102,25.5
22070, 달서구,100,95~99세,2021,235,51,184,27.7,235,51,184,27.7
22070, 달서구,100001, 95세,2021,80,13,67,19.4,80,13,67,19.4
22070, 달서구,100002, 96세,2021,74,19,55,34.5,74,19,55,34.5
22070, 달서구,100003, 97세,2021,42,10,32,31.3,42,10,32,31.3
22070, 달서구,100004, 98세,2021,16,X,12,33.3,16,X,12,33.3
22070, 달서구,100005, 99세,2021,23,5,18,27.8,23,5,18,27.8
22070, 달서구,101,100세이상,2021,34,X,30,13.3,34,X,30,13.3
22070, 달서구,102,15세미만,2021,61926,31800,30126,105.6,61622,31660,29962,105.7
22070, 달서구,103,15~64세,2021,408497,205828,202669,101.6,396014,198812,197202,100.8
22070, 달서구,104,65세이상,2021,84279,36796,47483,77.5,84094,36730,47364,77.5
22070, 달서구,086,85세이상,2021,6873,1929,4944,39,6864,1926,4938,39
22070, 달서구,126,평균연령,2021,43.1,41.9,44.3,,43.4,42.1,44.5,
22070, 달서구,127,중위연령,2021,45.1,43.4,46.7,,45.7,44,47.1,
22310, 달성군,000,합계,2021,264854,134809,130045,103.7,257115,130033,127082,102.3
22310, 달성군,005,0~4세,2021,13147,6708,6439,104.2,12938,6610,6328,104.5
22310, 달성군,005001, 0세,2021,2174,1126,1048,107.4,2143,1107,1036,106.9
22310, 달성군,005002, 1세,2021,2460,1274,1186,107.4,2419,1257,1162,108.2
22310, 달성군,005003, 2세,2021,2686,1378,1308,105.4,2643,1364,1279,106.6
22310, 달성군,005004, 3세,2021,2832,1435,1397,102.7,2784,1409,1375,102.5
22310, 달성군,005005, 4세,2021,2995,1495,1500,99.7,2949,1473,1476,99.8
22310, 달성군,010,5~9세,2021,15855,8065,7790,103.5,15694,8004,7690,104.1
22310, 달성군,010001, 5세,2021,3272,1655,1617,102.4,3233,1639,1594,102.8
22310, 달성군,010002, 6세,2021,3251,1640,1611,101.8,3214,1630,1584,102.9
22310, 달성군,010003, 7세,2021,3121,1565,1556,100.6,3086,1555,1531,101.6
22310, 달성군,010004, 8세,2021,3025,1555,1470,105.8,2996,1539,1457,105.6
22310, 달성군,010005, 9세,2021,3186,1650,1536,107.4,3165,1641,1524,107.7
22310, 달성군,015,10~14세,2021,13298,6804,6494,104.8,13173,6735,6438,104.6
22310, 달성군,015001, 10세,2021,3006,1521,1485,102.4,2974,1504,1470,102.3
22310, 달성군,015002, 11세,2021,2774,1427,1347,105.9,2752,1410,1342,105.1
22310, 달성군,015003, 12세,2021,2472,1271,1201,105.8,2447,1260,1187,106.1
22310, 달성군,015004, 13세,2021,2560,1345,1215,110.7,2541,1334,1207,110.5
22310, 달성군,015005, 14세,2021,2486,1240,1246,99.5,2459,1227,1232,99.6
22310, 달성군,020,15~19세,2021,10871,5776,5095,113.4,10788,5729,5059,113.2
22310, 달성군,020001, 15세,2021,2192,1164,1028,113.2,2172,1155,1017,113.6
22310, 달성군,020002, 16세,2021,2200,1120,1080,103.7,2183,1114,1069,104.2
22310, 달성군,020003, 17세,2021,2234,1120,1114,100.5,2224,1113,1111,100.2
22310, 달성군,020004, 18세,2021,2298,1226,1072,114.4,2278,1213,1065,113.9
22310, 달성군,020005, 19세,2021,1947,1146,801,143.1,1931,1134,797,142.3
22310, 달성군,025,20~24세,2021,12848,7251,5597,129.6,12408,7009,5399,129.8
22310, 달성군,025001, 20세,2021,2348,1382,966,143.1,2313,1361,952,143
22310, 달성군,025002, 21세,2021,2592,1495,1097,136.3,2548,1480,1068,138.6
22310, 달성군,025003, 22세,2021,2411,1352,1059,127.7,2323,1302,1021,127.5
22310, 달성군,025004, 23세,2021,2614,1447,1167,124,2503,1388,1115,124.5
22310, 달성군,025005, 24세,2021,2883,1575,1308,120.4,2721,1478,1243,118.9
22310, 달성군,030,25~29세,2021,16201,9097,7104,128.1,15022,8303,6719,123.6
22310, 달성군,030001, 25세,2021,3001,1730,1271,136.1,2796,1588,1208,131.5
22310, 달성군,030002, 26세,2021,3098,1798,1300,138.3,2858,1636,1222,133.9
22310, 달성군,030003, 27세,2021,3091,1753,1338,131,2883,1611,1272,126.7
22310, 달성군,030004, 28세,2021,3358,1885,1473,128,3109,1712,1397,122.5
22310, 달성군,030005, 29세,2021,3653,1931,1722,112.1,3376,1756,1620,108.4
22310, 달성군,035,30~34세,2021,19257,10357,8900,116.4,17723,9307,8416,110.6
22310, 달성군,035001, 30세,2021,3676,1950,1726,113,3370,1746,1624,107.5
22310, 달성군,035002, 31세,2021,3687,2008,1679,119.6,3384,1812,1572,115.3
22310, 달성군,035003, 32세,2021,3931,2160,1771,122,3624,1938,1686,114.9
22310, 달성군,035004, 33세,2021,3850,2075,1775,116.9,3542,1860,1682,110.6
22310, 달성군,035005, 34세,2021,4113,2164,1949,111,3803,1951,1852,105.3
22310, 달성군,040,35~39세,2021,23631,12475,11156,111.8,22290,11572,10718,108
22310, 달성군,040001, 35세,2021,4258,2304,1954,117.9,3969,2108,1861,113.3
22310, 달성군,040002, 36세,2021,4347,2355,1992,118.2,4043,2152,1891,113.8
22310, 달성군,040003, 37세,2021,4534,2431,2103,115.6,4261,2241,2020,110.9
22310, 달성군,040004, 38세,2021,5049,2557,2492,102.6,4810,2407,2403,100.2
22310, 달성군,040005, 39세,2021,5443,2828,2615,108.1,5207,2664,2543,104.8
22310, 달성군,045,40~44세,2021,24260,12675,11585,109.4,23383,12134,11249,107.9
22310, 달성군,045001, 40세,2021,5397,2846,2551,111.6,5180,2710,2470,109.7
22310, 달성군,045002, 41세,2021,5342,2740,2602,105.3,5149,2627,2522,104.2
22310, 달성군,045003, 42세,2021,4874,2521,2353,107.1,4715,2424,2291,105.8
22310, 달성군,045004, 43세,2021,4262,2232,2030,110,4088,2122,1966,107.9
22310, 달성군,045005, 44세,2021,4385,2336,2049,114,4251,2251,2000,112.6
22310, 달성군,050,45~49세,2021,20775,10924,9851,110.9,20159,10545,9614,109.7
22310, 달성군,050001, 45세,2021,3988,2146,1842,116.5,3864,2076,1788,116.1
22310, 달성군,050002, 46세,2021,4097,2153,1944,110.8,3979,2081,1898,109.6
22310, 달성군,050003, 47세,2021,4358,2297,2061,111.5,4220,2210,2010,110
22310, 달성군,050004, 48세,2021,4150,2161,1989,108.6,4031,2080,1951,106.6
22310, 달성군,050005, 49세,2021,4182,2167,2015,107.5,4065,2098,1967,106.7
22310, 달성군,055,50~54세,2021,20998,10329,10669,96.8,20518,10078,10440,96.5
22310, 달성군,055001, 50세,2021,4290,2189,2101,104.2,4192,2137,2055,104
22310, 달성군,055002, 51세,2021,4213,2132,2081,102.5,4096,2064,2032,101.6
22310, 달성군,055003, 52세,2021,4201,1994,2207,90.3,4112,1944,2168,89.7
22310, 달성군,055004, 53세,2021,4311,2104,2207,95.3,4217,2061,2156,95.6
22310, 달성군,055005, 54세,2021,3983,1910,2073,92.1,3901,1872,2029,92.3
22310, 달성군,060,55~59세,2021,19681,9693,9988,97,19342,9512,9830,96.8
22310, 달성군,060001, 55세,2021,3986,1986,2000,99.3,3911,1945,1966,98.9
22310, 달성군,060002, 56세,2021,3965,1938,2027,95.6,3886,1889,1997,94.6
22310, 달성군,060003, 57세,2021,3721,1834,1887,97.2,3652,1802,1850,97.4
22310, 달성군,060004, 58세,2021,3897,1874,2023,92.6,3827,1837,1990,92.3
22310, 달성군,060005, 59세,2021,4112,2061,2051,100.5,4066,2039,2027,100.6
22310, 달성군,065,60~64세,2021,18814,9312,9502,98,18618,9217,9401,98
22310, 달성군,065001, 60세,2021,4392,2197,2195,100.1,4355,2182,2173,100.4
22310, 달성군,065002, 61세,2021,4110,2007,2103,95.4,4062,1984,2078,95.5
22310, 달성군,065003, 62세,2021,3744,1825,1919,95.1,3707,1807,1900,95.1
22310, 달성군,065004, 63세,2021,3262,1619,1643,98.5,3227,1600,1627,98.3
22310, 달성군,065005, 64세,2021,3306,1664,1642,101.3,3267,1644,1623,101.3
22310, 달성군,070,65~69세,2021,12951,6322,6629,95.4,12858,6276,6582,95.4
22310, 달성군,070001, 65세,2021,3022,1521,1501,101.3,2994,1507,1487,101.3
22310, 달성군,070002, 66세,2021,2974,1399,1575,88.8,2957,1391,1566,88.8
22310, 달성군,070003, 67세,2021,2291,1163,1128,103.1,2274,1155,1119,103.2
22310, 달성군,070004, 68세,2021,2222,1058,1164,90.9,2204,1048,1156,90.7
22310, 달성군,070005, 69세,2021,2442,1181,1261,93.7,2429,1175,1254,93.7
22310, 달성군,075,70~74세,2021,8610,4131,4479,92.2,8570,4118,4452,92.5
22310, 달성군,075001, 70세,2021,1790,865,925,93.5,1778,861,917,93.9
22310, 달성군,075002, 71세,2021,1779,869,910,95.5,1768,866,902,96
22310, 달성군,075003, 72세,2021,1855,903,952,94.9,1849,900,949,94.8
22310, 달성군,075004, 73세,2021,1652,792,860,92.1,1648,790,858,92.1
22310, 달성군,075005, 74세,2021,1534,702,832,84.4,1527,701,826,84.9
22310, 달성군,080,75~79세,2021,5702,2474,3228,76.6,5686,2468,3218,76.7
22310, 달성군,080001, 75세,2021,1036,496,540,91.9,1028,495,533,92.9
22310, 달성군,080002, 76세,2021,1057,469,588,79.8,1055,468,587,79.7
22310, 달성군,080003, 77세,2021,1158,519,639,81.2,1154,515,639,80.6
22310, 달성군,080004, 78세,2021,1172,481,691,69.6,1170,481,689,69.8
22310, 달성군,080005, 79세,2021,1279,509,770,66.1,1279,509,770,66.1
22310, 달성군,085,80~84세,2021,4465,1512,2953,51.2,4457,1512,2945,51.3
22310, 달성군,085001, 80세,2021,1062,381,681,55.9,1059,381,678,56.2
22310, 달성군,085002, 81세,2021,924,309,615,50.2,924,309,615,50.2
22310, 달성군,085003, 82세,2021,924,327,597,54.8,923,327,596,54.9
22310, 달성군,085004, 83세,2021,814,266,548,48.5,810,266,544,48.9
22310, 달성군,085005, 84세,2021,741,229,512,44.7,741,229,512,44.7
22310, 달성군,090,85~89세,2021,2493,700,1793,39,2491,700,1791,39.1
22310, 달성군,090001, 85세,2021,627,192,435,44.1,626,192,434,44.2
22310, 달성군,090002, 86세,2021,614,175,439,39.9,614,175,439,39.9
22310, 달성군,090003, 87세,2021,515,129,386,33.4,515,129,386,33.4
22310, 달성군,090004, 88세,2021,382,103,279,36.9,381,103,278,37.1
22310, 달성군,090005, 89세,2021,355,101,254,39.8,355,101,254,39.8
22310, 달성군,095,90~94세,2021,817,168,649,25.9,817,168,649,25.9
22310, 달성군,095001, 90세,2021,255,53,202,26.2,255,53,202,26.2
22310, 달성군,095002, 91세,2021,193,33,160,20.6,193,33,160,20.6
22310, 달성군,095003, 92세,2021,155,38,117,32.5,155,38,117,32.5
22310, 달성군,095004, 93세,2021,122,29,93,31.2,122,29,93,31.2
22310, 달성군,095005, 94세,2021,92,15,77,19.5,92,15,77,19.5
22310, 달성군,100,95~99세,2021,159,34,125,27.2,159,34,125,27.2
22310, 달성군,100001, 95세,2021,54,12,42,28.6,54,12,42,28.6
22310, 달성군,100002, 96세,2021,42,10,32,31.3,42,10,32,31.3
22310, 달성군,100003, 97세,2021,24,6,18,33.3,24,6,18,33.3
22310, 달성군,100004, 98세,2021,27,X,25,8,27,X,25,8
22310, 달성군,100005, 99세,2021,12,X,8,50,12,X,8,50
22310, 달성군,101,100세이상,2021,21,X,19,10.5,21,X,19,10.5
22310, 달성군,102,15세미만,2021,42300,21577,20723,104.1,41805,21349,20456,104.4
22310, 달성군,103,15~64세,2021,187336,97889,89447,109.4,180251,93406,86845,107.6
22310, 달성군,104,65세이상,2021,35218,15343,19875,77.2,35059,15278,19781,77.2
22310, 달성군,086,85세이상,2021,3490,904,2586,35,3488,904,2584,35
22310, 달성군,126,평균연령,2021,40.8,39.6,42,,40.9,39.7,42.1,
22310, 달성군,127,중위연령,2021,41.4,40.3,42.5,,41.6,40.6,42.8,
23,인천광역시,000,합계,2021,2957044,1482202,1474842,100.5,2856665,1427672,1428993,99.9
23,인천광역시,005,0~4세,2021,92583,47751,44832,106.5,88956,45827,43129,106.3
23,인천광역시,005001, 0세,2021,15615,8019,7596,105.6,15015,7701,7314,105.3
23,인천광역시,005002, 1세,2021,16821,8682,8139,106.7,16088,8300,7788,106.6
23,인천광역시,005003, 2세,2021,18723,9678,9045,107,17982,9315,8667,107.5
23,인천광역시,005004, 3세,2021,19753,10198,9555,106.7,18964,9754,9210,105.9
23,인천광역시,005005, 4세,2021,21671,11174,10497,106.4,20907,10757,10150,106
23,인천광역시,010,5~9세,2021,129296,66166,63130,104.8,126047,64535,61512,104.9
23,인천광역시,010001, 5세,2021,24514,12484,12030,103.8,23687,12070,11617,103.9
23,인천광역시,010002, 6세,2021,25960,13296,12664,105,25235,12933,12302,105.1
23,인천광역시,010003, 7세,2021,25370,13019,12351,105.4,24717,12690,12027,105.5
23,인천광역시,010004, 8세,2021,25648,13078,12570,104,25102,12819,12283,104.4
23,인천광역시,010005, 9세,2021,27804,14289,13515,105.7,27306,14023,13283,105.6
23,인천광역시,015,10~14세,2021,134896,69288,65608,105.6,133098,68336,64762,105.5
23,인천광역시,015001, 10세,2021,27894,14425,13469,107.1,27481,14199,13282,106.9
23,인천광역시,015002, 11세,2021,26413,13599,12814,106.1,26026,13389,12637,106
23,인천광역시,015003, 12세,2021,25793,13193,12600,104.7,25434,13011,12423,104.7
23,인천광역시,015004, 13세,2021,26910,13742,13168,104.4,26590,13562,13028,104.1
23,인천광역시,015005, 14세,2021,27886,14329,13557,105.7,27567,14175,13392,105.8
23,인천광역시,020,15~19세,2021,131154,67406,63748,105.7,129497,66640,62857,106
23,인천광역시,020001, 15세,2021,25149,12987,12162,106.8,24901,12855,12046,106.7
23,인천광역시,020002, 16세,2021,24680,12675,12005,105.6,24420,12547,11873,105.7
23,인천광역시,020003, 17세,2021,26719,13766,12953,106.3,26472,13644,12828,106.4
23,인천광역시,020004, 18세,2021,27480,14127,13353,105.8,27125,13974,13151,106.3
23,인천광역시,020005, 19세,2021,27126,13851,13275,104.3,26579,13620,12959,105.1
23,인천광역시,025,20~24세,2021,175046,91028,84018,108.3,168369,87551,80818,108.3
23,인천광역시,025001, 20세,2021,31044,16272,14772,110.2,30124,15893,14231,111.7
23,인천광역시,025002, 21세,2021,34749,18417,16332,112.8,33295,17709,15586,113.6
23,인천광역시,025003, 22세,2021,34078,17967,16111,111.5,32855,17322,15533,111.5
23,인천광역시,025004, 23세,2021,36297,18597,17700,105.1,34873,17806,17067,104.3
23,인천광역시,025005, 24세,2021,38878,19775,19103,103.5,37222,18821,18401,102.3
23,인천광역시,030,25~29세,2021,217238,114544,102694,111.5,206383,108188,98195,110.2
23,인천광역시,030001, 25세,2021,40973,21303,19670,108.3,39088,20201,18887,107
23,인천광역시,030002, 26세,2021,42509,22386,20123,111.2,40534,21229,19305,110
23,인천광역시,030003, 27세,2021,43768,23326,20442,114.1,41630,22104,19526,113.2
23,인천광역시,030004, 28세,2021,44735,23793,20942,113.6,42406,22398,20008,111.9
23,인천광역시,030005, 29세,2021,45253,23736,21517,110.3,42725,22256,20469,108.7
23,인천광역시,035,30~34세,2021,200102,105470,94632,111.5,184385,96308,88077,109.3
23,인천광역시,035001, 30세,2021,43097,22874,20223,113.1,40279,21271,19008,111.9
23,인천광역시,035002, 31세,2021,40857,21636,19221,112.6,37700,19790,17910,110.5
23,인천광역시,035003, 32세,2021,39397,20807,18590,111.9,36322,19028,17294,110
23,인천광역시,035004, 33세,2021,38350,20152,18198,110.7,35034,18212,16822,108.3
23,인천광역시,035005, 34세,2021,38401,20001,18400,108.7,35050,18007,17043,105.7
23,인천광역시,040,35~39세,2021,216944,113101,103843,108.9,202693,104569,98124,106.6
23,인천광역시,040001, 35세,2021,39454,20714,18740,110.5,36193,18798,17395,108.1
23,인천광역시,040002, 36세,2021,39928,21018,18910,111.1,36956,19231,17725,108.5
23,인천광역시,040003, 37세,2021,41605,21641,19964,108.4,38808,19984,18824,106.2
23,인천광역시,040004, 38세,2021,46103,23829,22274,107,43460,22207,21253,104.5
23,인천광역시,040005, 39세,2021,49854,25899,23955,108.1,47276,24349,22927,106.2
23,인천광역시,045,40~44세,2021,238433,123174,115259,106.9,228872,117553,111319,105.6
23,인천광역시,045001, 40세,2021,50152,26225,23927,109.6,47946,24886,23060,107.9
23,인천광역시,045002, 41세,2021,50916,26218,24698,106.2,48892,25016,23876,104.8
23,인천광역시,045003, 42세,2021,48288,25114,23174,108.4,46259,23927,22332,107.1
23,인천광역시,045004, 43세,2021,44117,22522,21595,104.3,42367,21523,20844,103.3
23,인천광역시,045005, 44세,2021,44960,23095,21865,105.6,43408,22201,21207,104.7
23,인천광역시,050,45~49세,2021,241442,123109,118333,104,234008,118961,115047,103.4
23,인천광역시,050001, 45세,2021,43361,22340,21021,106.3,41851,21473,20378,105.4
23,인천광역시,050002, 46세,2021,46383,23723,22660,104.7,45004,22950,22054,104.1
23,인천광역시,050003, 47세,2021,50019,25730,24289,105.9,48563,24888,23675,105.1
23,인천광역시,050004, 48세,2021,50672,25369,25303,100.3,49134,24546,24588,99.8
23,인천광역시,050005, 49세,2021,51007,25947,25060,103.5,49456,25104,24352,103.1
23,인천광역시,055,50~54세,2021,260690,128983,131707,97.9,253484,125262,128222,97.7
23,인천광역시,055001, 50세,2021,53655,27031,26624,101.5,52114,26227,25887,101.3
23,인천광역시,055002, 51세,2021,52146,26199,25947,101,50552,25331,25221,100.4
23,인천광역시,055003, 52세,2021,53145,26149,26996,96.9,51681,25433,26248,96.9
23,인천광역시,055004, 53세,2021,53275,25899,27376,94.6,51765,25128,26637,94.3
23,인천광역시,055005, 54세,2021,48469,23705,24764,95.7,47372,23143,24229,95.5
23,인천광역시,060,55~59세,2021,248673,123871,124802,99.3,241665,120542,121123,99.5
23,인천광역시,060001, 55세,2021,48198,23989,24209,99.1,46920,23371,23549,99.2
23,인천광역시,060002, 56세,2021,51157,25189,25968,97,49711,24500,25211,97.2
23,인천광역시,060003, 57세,2021,47845,23779,24066,98.8,46359,23076,23283,99.1
23,인천광역시,060004, 58세,2021,50528,25459,25069,101.6,48955,24713,24242,101.9
23,인천광역시,060005, 59세,2021,50945,25455,25490,99.9,49720,24882,24838,100.2
23,인천광역시,065,60~64세,2021,238398,118726,119672,99.2,233044,116221,116823,99.5
23,인천광역시,065001, 60세,2021,53906,26985,26921,100.2,53026,26616,26410,100.8
23,인천광역시,065002, 61세,2021,53147,26423,26724,98.9,51864,25831,26033,99.2
23,인천광역시,065003, 62세,2021,46559,23142,23417,98.8,45506,22624,22882,98.9
23,인천광역시,065004, 63세,2021,43485,21669,21816,99.3,42410,21155,21255,99.5
23,인천광역시,065005, 64세,2021,41301,20507,20794,98.6,40238,19995,20243,98.8
23,인천광역시,070,65~69세,2021,157992,76701,81291,94.4,154620,75221,79399,94.7
23,인천광역시,070001, 65세,2021,36601,17943,18658,96.2,35757,17573,18184,96.6
23,인천광역시,070002, 66세,2021,37134,18000,19134,94.1,36362,17658,18704,94.4
23,인천광역시,070003, 67세,2021,30199,14597,15602,93.6,29514,14292,15222,93.9
23,인천광역시,070004, 68세,2021,25948,12563,13385,93.9,25387,12323,13064,94.3
23,인천광역시,070005, 69세,2021,28110,13598,14512,93.7,27600,13375,14225,94
23,인천광역시,075,70~74세,2021,102795,48735,54060,90.1,101380,48137,53243,90.4
23,인천광역시,075001, 70세,2021,18646,8959,9687,92.5,18235,8764,9471,92.5
23,인천광역시,075002, 71세,2021,21235,10258,10977,93.4,20897,10127,10770,94
23,인천광역시,075003, 72세,2021,21603,10290,11313,91,21313,10171,11142,91.3
23,인천광역시,075004, 73세,2021,20564,9771,10793,90.5,20356,9685,10671,90.8
23,인천광역시,075005, 74세,2021,20747,9457,11290,83.8,20579,9390,11189,83.9
23,인천광역시,080,75~79세,2021,75904,33025,42879,77,75326,32849,42477,77.3
23,인천광역시,080001, 75세,2021,15786,7203,8583,83.9,15646,7154,8492,84.2
23,인천광역시,080002, 76세,2021,14553,6487,8066,80.4,14413,6441,7972,80.8
23,인천광역시,080003, 77세,2021,14406,6336,8070,78.5,14292,6307,7985,79
23,인천광역시,080004, 78세,2021,14709,6252,8457,73.9,14616,6232,8384,74.3
23,인천광역시,080005, 79세,2021,16450,6747,9703,69.5,16359,6715,9644,69.6
23,인천광역시,085,80~84세,2021,53575,20022,33553,59.7,53180,19915,33265,59.9
23,인천광역시,085001, 80세,2021,12916,5154,7762,66.4,12816,5122,7694,66.6
23,인천광역시,085002, 81세,2021,11290,4337,6953,62.4,11201,4313,6888,62.6
23,인천광역시,085003, 82세,2021,11115,4116,6999,58.8,11050,4100,6950,59
23,인천광역시,085004, 83세,2021,9898,3576,6322,56.6,9812,3560,6252,56.9
23,인천광역시,085005, 84세,2021,8356,2839,5517,51.5,8301,2820,5481,51.5
23,인천광역시,090,85~89세,2021,28804,8432,20372,41.4,28638,8398,20240,41.5
23,인천광역시,090001, 85세,2021,7732,2506,5226,48,7673,2492,5181,48.1
23,인천광역시,090002, 86세,2021,6971,2174,4797,45.3,6933,2164,4769,45.4
23,인천광역시,090003, 87세,2021,5498,1557,3941,39.5,5470,1555,3915,39.7
23,인천광역시,090004, 88세,2021,4725,1261,3464,36.4,4703,1258,3445,36.5
23,인천광역시,090005, 89세,2021,3878,934,2944,31.7,3859,929,2930,31.7
23,인천광역시,095,90~94세,2021,10402,2194,8208,26.7,10354,2186,8168,26.8
23,인천광역시,095001, 90세,2021,2933,686,2247,30.5,2919,684,2235,30.6
23,인천광역시,095002, 91세,2021,2597,496,2101,23.6,2579,494,2085,23.7
23,인천광역시,095003, 92세,2021,2086,454,1632,27.8,2077,451,1626,27.7
23,인천광역시,095004, 93세,2021,1596,318,1278,24.9,1593,317,1276,24.8
23,인천광역시,095005, 94세,2021,1190,240,950,25.3,1186,240,946,25.4
23,인천광역시,100,95~99세,2021,2300,407,1893,21.5,2290,405,1885,21.5
23,인천광역시,100001, 95세,2021,753,131,622,21.1,747,130,617,21.1
23,인천광역시,100002, 96세,2021,595,80,515,15.5,594,80,514,15.6
23,인천광역시,100003, 97세,2021,399,75,324,23.1,397,75,322,23.3
23,인천광역시,100004, 98세,2021,345,88,257,34.2,345,88,257,34.2
23,인천광역시,100005, 99세,2021,208,33,175,18.9,207,32,175,18.3
23,인천광역시,101,100세이상,2021,377,69,308,22.4,376,68,308,22.1
23,인천광역시,102,15세미만,2021,356775,183205,173570,105.6,348101,178698,169403,105.5
23,인천광역시,103,15~64세,2021,2168120,1109412,1058708,104.8,2082400,1061795,1020605,104
23,인천광역시,104,65세이상,2021,432149,189585,242564,78.2,426164,187179,238985,78.3
23,인천광역시,086,85세이상,2021,41883,11102,30781,36.1,41658,11057,30601,36.1
23,인천광역시,126,평균연령,2021,42.7,41.7,43.8,,42.9,41.9,43.9,
23,인천광역시,127,중위연령,2021,43.7,42.6,45,,44.1,42.9,45.3,
23004, 읍부,000,합계,2021,21611,10725,10886,98.5,21264,10562,10702,98.7
23004, 읍부,005,0~4세,2021,606,337,269,125.3,606,337,269,125.3
23004, 읍부,005001, 0세,2021,132,66,66,100,132,66,66,100
23004, 읍부,005002, 1세,2021,140,84,56,150,140,84,56,150
23004, 읍부,005003, 2세,2021,109,65,44,147.7,109,65,44,147.7
23004, 읍부,005004, 3세,2021,100,52,48,108.3,100,52,48,108.3
23004, 읍부,005005, 4세,2021,125,70,55,127.3,125,70,55,127.3
23004, 읍부,010,5~9세,2021,792,419,373,112.3,788,417,371,112.4
23004, 읍부,010001, 5세,2021,128,75,53,141.5,126,74,52,142.3
23004, 읍부,010002, 6세,2021,148,78,70,111.4,148,78,70,111.4
23004, 읍부,010003, 7세,2021,167,88,79,111.4,166,87,79,110.1
23004, 읍부,010004, 8세,2021,174,89,85,104.7,174,89,85,104.7
23004, 읍부,010005, 9세,2021,175,89,86,103.5,174,89,85,104.7
23004, 읍부,015,10~14세,2021,987,489,498,98.2,984,488,496,98.4
23004, 읍부,015001, 10세,2021,189,91,98,92.9,189,91,98,92.9
23004, 읍부,015002, 11세,2021,191,100,91,109.9,190,100,90,111.1
23004, 읍부,015003, 12세,2021,190,100,90,111.1,189,100,89,112.4
23004, 읍부,015004, 13세,2021,208,88,120,73.3,207,87,120,72.5
23004, 읍부,015005, 14세,2021,209,110,99,111.1,209,110,99,111.1
23004, 읍부,020,15~19세,2021,1129,559,570,98.1,1124,557,567,98.2
23004, 읍부,020001, 15세,2021,206,97,109,89,206,97,109,89
23004, 읍부,020002, 16세,2021,222,111,111,100,222,111,111,100
23004, 읍부,020003, 17세,2021,280,134,146,91.8,278,133,145,91.7
23004, 읍부,020004, 18세,2021,278,150,128,117.2,278,150,128,117.2
23004, 읍부,020005, 19세,2021,143,67,76,88.2,140,66,74,89.2
23004, 읍부,025,20~24세,2021,980,559,421,132.8,954,545,409,133.3
23004, 읍부,025001, 20세,2021,184,111,73,152.1,183,111,72,154.2
23004, 읍부,025002, 21세,2021,212,122,90,135.6,211,122,89,137.1
23004, 읍부,025003, 22세,2021,196,116,80,145,191,113,78,144.9
23004, 읍부,025004, 23세,2021,185,105,80,131.3,175,97,78,124.4
23004, 읍부,025005, 24세,2021,203,105,98,107.1,194,102,92,110.9
23004, 읍부,030,25~29세,2021,1039,586,453,129.4,975,547,428,127.8
23004, 읍부,030001, 25세,2021,180,99,81,122.2,169,91,78,116.7
23004, 읍부,030002, 26세,2021,227,131,96,136.5,218,126,92,137
23004, 읍부,030003, 27세,2021,227,132,95,138.9,216,126,90,140
23004, 읍부,030004, 28세,2021,182,101,81,124.7,167,91,76,119.7
23004, 읍부,030005, 29세,2021,223,123,100,123,205,113,92,122.8
23004, 읍부,035,30~34세,2021,958,514,444,115.8,907,486,421,115.4
23004, 읍부,035001, 30세,2021,218,110,108,101.9,206,105,101,104
23004, 읍부,035002, 31세,2021,188,109,79,138,174,100,74,135.1
23004, 읍부,035003, 32세,2021,203,109,94,116,194,104,90,115.6
23004, 읍부,035004, 33세,2021,164,83,81,102.5,155,79,76,103.9
23004, 읍부,035005, 34세,2021,185,103,82,125.6,178,98,80,122.5
23004, 읍부,040,35~39세,2021,1106,545,561,97.1,1056,524,532,98.5
23004, 읍부,040001, 35세,2021,166,82,84,97.6,155,77,78,98.7
23004, 읍부,040002, 36세,2021,197,104,93,111.8,187,99,88,112.5
23004, 읍부,040003, 37세,2021,231,111,120,92.5,217,105,112,93.8
23004, 읍부,040004, 38세,2021,252,130,122,106.6,244,127,117,108.5
23004, 읍부,040005, 39세,2021,260,118,142,83.1,253,116,137,84.7
23004, 읍부,045,40~44세,2021,1398,708,690,102.6,1370,692,678,102.1
23004, 읍부,045001, 40세,2021,295,149,146,102.1,289,147,142,103.5
23004, 읍부,045002, 41세,2021,280,142,138,102.9,272,136,136,100
23004, 읍부,045003, 42세,2021,267,131,136,96.3,265,130,135,96.3
23004, 읍부,045004, 43세,2021,251,115,136,84.6,241,109,132,82.6
23004, 읍부,045005, 44세,2021,305,171,134,127.6,303,170,133,127.8
23004, 읍부,050,45~49세,2021,1626,825,801,103,1609,817,792,103.2
23004, 읍부,050001, 45세,2021,263,124,139,89.2,261,122,139,87.8
23004, 읍부,050002, 46세,2021,322,167,155,107.7,319,166,153,108.5
23004, 읍부,050003, 47세,2021,333,182,151,120.5,326,180,146,123.3
23004, 읍부,050004, 48세,2021,366,190,176,108,366,190,176,108
23004, 읍부,050005, 49세,2021,342,162,180,90,337,159,178,89.3
23004, 읍부,055,50~54세,2021,1789,932,857,108.8,1761,924,837,110.4
23004, 읍부,055001, 50세,2021,386,206,180,114.4,380,204,176,115.9
23004, 읍부,055002, 51세,2021,386,215,171,125.7,377,212,165,128.5
23004, 읍부,055003, 52세,2021,347,179,168,106.5,342,179,163,109.8
23004, 읍부,055004, 53세,2021,337,172,165,104.2,334,172,162,106.2
23004, 읍부,055005, 54세,2021,333,160,173,92.5,328,157,171,91.8
23004, 읍부,060,55~59세,2021,1804,887,917,96.7,1775,876,899,97.4
23004, 읍부,060001, 55세,2021,341,178,163,109.2,339,178,161,110.6
23004, 읍부,060002, 56세,2021,355,168,187,89.8,348,164,184,89.1
23004, 읍부,060003, 57세,2021,337,163,174,93.7,329,159,170,93.5
23004, 읍부,060004, 58세,2021,374,178,196,90.8,367,176,191,92.1
23004, 읍부,060005, 59세,2021,397,200,197,101.5,392,199,193,103.1
23004, 읍부,065,60~64세,2021,2053,999,1054,94.8,2029,991,1038,95.5
23004, 읍부,065001, 60세,2021,435,201,234,85.9,433,201,232,86.6
23004, 읍부,065002, 61세,2021,424,218,206,105.8,415,213,202,105.4
23004, 읍부,065003, 62세,2021,410,207,203,102,405,204,201,101.5
23004, 읍부,065004, 63세,2021,405,182,223,81.6,399,182,217,83.9
23004, 읍부,065005, 64세,2021,379,191,188,101.6,377,191,186,102.7
23004, 읍부,070,65~69세,2021,1643,798,845,94.4,1635,795,840,94.6
23004, 읍부,070001, 65세,2021,334,169,165,102.4,333,168,165,101.8
23004, 읍부,070002, 66세,2021,385,182,203,89.7,384,182,202,90.1
23004, 읍부,070003, 67세,2021,301,143,158,90.5,299,142,157,90.4
23004, 읍부,070004, 68세,2021,326,158,168,94,323,157,166,94.6
23004, 읍부,070005, 69세,2021,297,146,151,96.7,296,146,150,97.3
23004, 읍부,075,70~74세,2021,1244,564,680,82.9,1239,563,676,83.3
23004, 읍부,075001, 70세,2021,199,92,107,86,196,92,104,88.5
23004, 읍부,075002, 71세,2021,228,112,116,96.6,228,112,116,96.6
23004, 읍부,075003, 72세,2021,274,121,153,79.1,274,121,153,79.1
23004, 읍부,075004, 73세,2021,256,114,142,80.3,255,114,141,80.9
23004, 읍부,075005, 74세,2021,287,125,162,77.2,286,124,162,76.5
23004, 읍부,080,75~79세,2021,1058,475,583,81.5,1057,475,582,81.6
23004, 읍부,080001, 75세,2021,200,86,114,75.4,200,86,114,75.4
23004, 읍부,080002, 76세,2021,202,86,116,74.1,202,86,116,74.1
23004, 읍부,080003, 77세,2021,209,99,110,90,209,99,110,90
23004, 읍부,080004, 78세,2021,222,106,116,91.4,221,106,115,92.2
23004, 읍부,080005, 79세,2021,225,98,127,77.2,225,98,127,77.2
23004, 읍부,085,80~84세,2021,806,338,468,72.2,804,337,467,72.2
23004, 읍부,085001, 80세,2021,214,89,125,71.2,213,88,125,70.4
23004, 읍부,085002, 81세,2021,157,60,97,61.9,156,60,96,62.5
23004, 읍부,085003, 82세,2021,159,68,91,74.7,159,68,91,74.7
23004, 읍부,085004, 83세,2021,139,56,83,67.5,139,56,83,67.5
23004, 읍부,085005, 84세,2021,137,65,72,90.3,137,65,72,90.3
23004, 읍부,090,85~89세,2021,442,150,292,51.4,442,150,292,51.4
23004, 읍부,090001, 85세,2021,105,37,68,54.4,105,37,68,54.4
23004, 읍부,090002, 86세,2021,122,41,81,50.6,122,41,81,50.6
23004, 읍부,090003, 87세,2021,80,30,50,60,80,30,50,60
23004, 읍부,090004, 88세,2021,74,23,51,45.1,74,23,51,45.1
23004, 읍부,090005, 89세,2021,61,19,42,45.2,61,19,42,45.2
23004, 읍부,095,90~94세,2021,124,36,88,40.9,123,36,87,41.4
23004, 읍부,095001, 90세,2021,37,13,24,54.2,37,13,24,54.2
23004, 읍부,095002, 91세,2021,30,10,20,50,30,10,20,50
23004, 읍부,095003, 92세,2021,25,8,17,47.1,24,8,16,50
23004, 읍부,095004, 93세,2021,20,X,17,17.6,20,X,17,17.6
23004, 읍부,095005, 94세,2021,12,X,10,20,12,X,10,20
23004, 읍부,100,95~99세,2021,26,5,21,23.8,25,5,20,25
23004, 읍부,100001, 95세,2021,6,X,6,0,5,X,5,0
23004, 읍부,100002, 96세,2021,8,X,6,33.3,8,X,6,33.3
23004, 읍부,100003, 97세,2021,5,X,5,0,5,X,5,0
23004, 읍부,100004, 98세,2021,5,X,X,66.7,5,X,X,66.7
23004, 읍부,100005, 99세,2021,X,X,X,100,X,X,X,100
23004, 읍부,101,100세이상,2021,X,X,X,0,X,X,X,0
23004, 읍부,102,15세미만,2021,2385,1245,1140,109.2,2378,1242,1136,109.3
23004, 읍부,103,15~64세,2021,13882,7114,6768,105.1,13560,6959,6601,105.4
23004, 읍부,104,65세이상,2021,5344,2366,2978,79.4,5326,2361,2965,79.6
23004, 읍부,086,85세이상,2021,593,191,402,47.5,591,191,400,47.8
23004, 읍부,126,평균연령,2021,47.6,46,49.1,,47.7,46.2,49.2,
23004, 읍부,127,중위연령,2021,50.5,48.9,52.1,,50.7,49.2,52.3,
23005, 면부,000,합계,2021,63207,33114,30093,110,62198,32438,29760,109
23005, 면부,005,0~4세,2021,1094,546,548,99.6,1092,544,548,99.3
23005, 면부,005001, 0세,2021,216,102,114,89.5,216,102,114,89.5
23005, 면부,005002, 1세,2021,221,105,116,90.5,221,105,116,90.5
23005, 면부,005003, 2세,2021,229,116,113,102.7,229,116,113,102.7
23005, 면부,005004, 3세,2021,230,126,104,121.2,228,124,104,119.2
23005, 면부,005005, 4세,2021,198,97,101,96,198,97,101,96
23005, 면부,010,5~9세,2021,1423,742,681,109,1420,739,681,108.5
23005, 면부,010001, 5세,2021,265,132,133,99.2,265,132,133,99.2
23005, 면부,010002, 6세,2021,282,150,132,113.6,281,149,132,112.9
23005, 면부,010003, 7세,2021,261,136,125,108.8,260,135,125,108
23005, 면부,010004, 8세,2021,288,144,144,100,287,143,144,99.3
23005, 면부,010005, 9세,2021,327,180,147,122.4,327,180,147,122.4
23005, 면부,015,10~14세,2021,1609,862,747,115.4,1606,860,746,115.3
23005, 면부,015001, 10세,2021,319,180,139,129.5,317,179,138,129.7
23005, 면부,015002, 11세,2021,323,163,160,101.9,323,163,160,101.9
23005, 면부,015003, 12세,2021,324,186,138,134.8,323,185,138,134.1
23005, 면부,015004, 13세,2021,334,170,164,103.7,334,170,164,103.7
23005, 면부,015005, 14세,2021,309,163,146,111.6,309,163,146,111.6
23005, 면부,020,15~19세,2021,1543,885,658,134.5,1537,881,656,134.3
23005, 면부,020001, 15세,2021,317,174,143,121.7,315,173,142,121.8
23005, 면부,020002, 16세,2021,317,183,134,136.6,315,182,133,136.8
23005, 면부,020003, 17세,2021,360,212,148,143.2,359,211,148,142.6
23005, 면부,020004, 18세,2021,321,172,149,115.4,321,172,149,115.4
23005, 면부,020005, 19세,2021,228,144,84,171.4,227,143,84,170.2
23005, 면부,025,20~24세,2021,2283,1606,677,237.2,2206,1545,661,233.7
23005, 면부,025001, 20세,2021,333,231,102,226.5,331,230,101,227.7
23005, 면부,025002, 21세,2021,462,354,108,327.8,454,349,105,332.4
23005, 면부,025003, 22세,2021,470,313,157,199.4,458,303,155,195.5
23005, 면부,025004, 23세,2021,477,333,144,231.3,453,314,139,225.9
23005, 면부,025005, 24세,2021,541,375,166,225.9,510,349,161,216.8
23005, 면부,030,25~29세,2021,2709,1795,914,196.4,2489,1627,862,188.7
23005, 면부,030001, 25세,2021,569,383,186,205.9,527,354,173,204.6
23005, 면부,030002, 26세,2021,535,366,169,216.6,497,338,159,212.6
23005, 면부,030003, 27세,2021,560,382,178,214.6,521,352,169,208.3
23005, 면부,030004, 28세,2021,537,353,184,191.8,485,310,175,177.1
23005, 면부,030005, 29세,2021,508,311,197,157.9,459,273,186,146.8
23005, 면부,035,30~34세,2021,2383,1467,916,160.2,2173,1303,870,149.8
23005, 면부,035001, 30세,2021,528,321,207,155.1,491,294,197,149.2
23005, 면부,035002, 31세,2021,498,321,177,181.4,446,279,167,167.1
23005, 면부,035003, 32세,2021,470,299,171,174.9,423,261,162,161.1
23005, 면부,035004, 33세,2021,450,270,180,150,413,240,173,138.7
23005, 면부,035005, 34세,2021,437,256,181,141.4,400,229,171,133.9
23005, 면부,040,35~39세,2021,2416,1333,1083,123.1,2264,1231,1033,119.2
23005, 면부,040001, 35세,2021,440,264,176,150,399,233,166,140.4
23005, 면부,040002, 36세,2021,421,223,198,112.6,392,204,188,108.5
23005, 면부,040003, 37세,2021,467,251,216,116.2,438,236,202,116.8
23005, 면부,040004, 38세,2021,522,285,237,120.3,494,263,231,113.9
23005, 면부,040005, 39세,2021,566,310,256,121.1,541,295,246,119.9
23005, 면부,045,40~44세,2021,2819,1630,1189,137.1,2737,1576,1161,135.7
23005, 면부,045001, 40세,2021,552,314,238,131.9,531,299,232,128.9
23005, 면부,045002, 41세,2021,570,327,243,134.6,553,314,239,131.4
23005, 면부,045003, 42세,2021,565,320,245,130.6,544,308,236,130.5
23005, 면부,045004, 43세,2021,547,326,221,147.5,533,318,215,147.9
23005, 면부,045005, 44세,2021,585,343,242,141.7,576,337,239,141
23005, 면부,050,45~49세,2021,3425,2037,1388,146.8,3356,2001,1355,147.7
23005, 면부,050001, 45세,2021,607,356,251,141.8,594,349,245,142.4
23005, 면부,050002, 46세,2021,660,412,248,166.1,643,402,241,166.8
23005, 면부,050003, 47세,2021,701,413,288,143.4,684,403,281,143.4
23005, 면부,050004, 48세,2021,713,417,296,140.9,704,412,292,141.1
23005, 면부,050005, 49세,2021,744,439,305,143.9,731,435,296,147
23005, 면부,055,50~54세,2021,4578,2459,2119,116,4532,2440,2092,116.6
23005, 면부,055001, 50세,2021,836,465,371,125.3,826,458,368,124.5
23005, 면부,055002, 51세,2021,805,453,352,128.7,795,448,347,129.1
23005, 면부,055003, 52세,2021,934,486,448,108.5,923,485,438,110.7
23005, 면부,055004, 53세,2021,1007,511,496,103,1000,508,492,103.3
23005, 면부,055005, 54세,2021,996,544,452,120.4,988,541,447,121
23005, 면부,060,55~59세,2021,6231,3237,2994,108.1,6187,3221,2966,108.6
23005, 면부,060001, 55세,2021,1073,564,509,110.8,1067,561,506,110.9
23005, 면부,060002, 56세,2021,1214,618,596,103.7,1203,615,588,104.6
23005, 면부,060003, 57세,2021,1149,615,534,115.2,1138,610,528,115.5
23005, 면부,060004, 58세,2021,1277,653,624,104.6,1266,650,616,105.5
23005, 면부,060005, 59세,2021,1518,787,731,107.7,1513,785,728,107.8
23005, 면부,065,60~64세,2021,8113,4106,4007,102.5,8079,4091,3988,102.6
23005, 면부,065001, 60세,2021,1655,844,811,104.1,1652,841,811,103.7
23005, 면부,065002, 61세,2021,1689,845,844,100.1,1682,843,839,100.5
23005, 면부,065003, 62세,2021,1716,847,869,97.5,1702,841,861,97.7
23005, 면부,065004, 63세,2021,1555,795,760,104.6,1548,793,755,105
23005, 면부,065005, 64세,2021,1498,775,723,107.2,1495,773,722,107.1
23005, 면부,070,65~69세,2021,6657,3379,3278,103.1,6626,3366,3260,103.3
23005, 면부,070001, 65세,2021,1485,735,750,98,1481,733,748,98
23005, 면부,070002, 66세,2021,1502,787,715,110.1,1490,783,707,110.7
23005, 면부,070003, 67세,2021,1244,618,626,98.7,1239,616,623,98.9
23005, 면부,070004, 68세,2021,1164,615,549,112,1161,613,548,111.9
23005, 면부,070005, 69세,2021,1262,624,638,97.8,1255,621,634,97.9
23005, 면부,075,70~74세,2021,5077,2610,2467,105.8,5059,2599,2460,105.7
23005, 면부,075001, 70세,2021,805,414,391,105.9,799,410,389,105.4
23005, 면부,075002, 71세,2021,1062,546,516,105.8,1061,546,515,106
23005, 면부,075003, 72세,2021,1059,578,481,120.2,1055,575,480,119.8
23005, 면부,075004, 73세,2021,994,503,491,102.4,988,500,488,102.5
23005, 면부,075005, 74세,2021,1157,569,588,96.8,1156,568,588,96.6
23005, 면부,080,75~79세,2021,4294,1980,2314,85.6,4289,1978,2311,85.6
23005, 면부,080001, 75세,2021,921,441,480,91.9,920,440,480,91.7
23005, 면부,080002, 76세,2021,789,381,408,93.4,786,380,406,93.6
23005, 면부,080003, 77세,2021,785,345,440,78.4,785,345,440,78.4
23005, 면부,080004, 78세,2021,889,420,469,89.6,889,420,469,89.6
23005, 면부,080005, 79세,2021,910,393,517,76,909,393,516,76.2
23005, 면부,085,80~84세,2021,3330,1447,1883,76.8,3326,1444,1882,76.7
23005, 면부,085001, 80세,2021,771,342,429,79.7,771,342,429,79.7
23005, 면부,085002, 81세,2021,695,322,373,86.3,694,321,373,86.1
23005, 면부,085003, 82세,2021,680,284,396,71.7,679,283,396,71.5
23005, 면부,085004, 83세,2021,635,288,347,83,634,287,347,82.7
23005, 면부,085005, 84세,2021,549,211,338,62.4,548,211,337,62.6
23005, 면부,090,85~89세,2021,2240,769,1471,52.3,2238,769,1469,52.3
23005, 면부,090001, 85세,2021,618,233,385,60.5,617,233,384,60.7
23005, 면부,090002, 86세,2021,503,191,312,61.2,502,191,311,61.4
23005, 면부,090003, 87세,2021,432,142,290,49,432,142,290,49
23005, 면부,090004, 88세,2021,366,121,245,49.4,366,121,245,49.4
23005, 면부,090005, 89세,2021,321,82,239,34.3,321,82,239,34.3
23005, 면부,095,90~94세,2021,777,177,600,29.5,776,176,600,29.3
23005, 면부,095001, 90세,2021,240,62,178,34.8,239,61,178,34.3
23005, 면부,095002, 91세,2021,190,37,153,24.2,190,37,153,24.2
23005, 면부,095003, 92세,2021,145,34,111,30.6,145,34,111,30.6
23005, 면부,095004, 93세,2021,117,25,92,27.2,117,25,92,27.2
23005, 면부,095005, 94세,2021,85,19,66,28.8,85,19,66,28.8
23005, 면부,100,95~99세,2021,178,40,138,29,178,40,138,29
23005, 면부,100001, 95세,2021,56,9,47,19.1,56,9,47,19.1
23005, 면부,100002, 96세,2021,41,12,29,41.4,41,12,29,41.4
23005, 면부,100003, 97세,2021,36,9,27,33.3,36,9,27,33.3
23005, 면부,100004, 98세,2021,33,10,23,43.5,33,10,23,43.5
23005, 면부,100005, 99세,2021,12,X,12,0,12,X,12,0
23005, 면부,101,100세이상,2021,28,7,21,33.3,28,7,21,33.3
23005, 면부,102,15세미만,2021,4126,2150,1976,108.8,4118,2143,1975,108.5
23005, 면부,103,15~64세,2021,36500,20555,15945,128.9,35560,19916,15644,127.3
23005, 면부,104,65세이상,2021,22581,10409,12172,85.5,22520,10379,12141,85.5
23005, 면부,086,85세이상,2021,3223,993,2230,44.5,3220,992,2228,44.5
23005, 면부,126,평균연령,2021,54.7,52.3,57.3,,54.9,52.7,57.4,
23005, 면부,127,중위연령,2021,59.4,57,61.4,,59.7,57.5,61.5,
23003, 동부,000,합계,2021,2872226,1438363,1433863,100.3,2773203,1384672,1388531,99.7
23003, 동부,005,0~4세,2021,90883,46868,44015,106.5,87258,44946,42312,106.2
23003, 동부,005001, 0세,2021,15267,7851,7416,105.9,14667,7533,7134,105.6
23003, 동부,005002, 1세,2021,16460,8493,7967,106.6,15727,8111,7616,106.5
23003, 동부,005003, 2세,2021,18385,9497,8888,106.9,17644,9134,8510,107.3
23003, 동부,005004, 3세,2021,19423,10020,9403,106.6,18636,9578,9058,105.7
23003, 동부,005005, 4세,2021,21348,11007,10341,106.4,20584,10590,9994,106
23003, 동부,010,5~9세,2021,127081,65005,62076,104.7,123839,63379,60460,104.8
23003, 동부,010001, 5세,2021,24121,12277,11844,103.7,23296,11864,11432,103.8
23003, 동부,010002, 6세,2021,25530,13068,12462,104.9,24806,12706,12100,105
23003, 동부,010003, 7세,2021,24942,12795,12147,105.3,24291,12468,11823,105.5
23003, 동부,010004, 8세,2021,25186,12845,12341,104.1,24641,12587,12054,104.4
23003, 동부,010005, 9세,2021,27302,14020,13282,105.6,26805,13754,13051,105.4
23003, 동부,015,10~14세,2021,132300,67937,64363,105.6,130508,66988,63520,105.5
23003, 동부,015001, 10세,2021,27386,14154,13232,107,26975,13929,13046,106.8
23003, 동부,015002, 11세,2021,25899,13336,12563,106.2,25513,13126,12387,106
23003, 동부,015003, 12세,2021,25279,12907,12372,104.3,24922,12726,12196,104.3
23003, 동부,015004, 13세,2021,26368,13484,12884,104.7,26049,13305,12744,104.4
23003, 동부,015005, 14세,2021,27368,14056,13312,105.6,27049,13902,13147,105.7
23003, 동부,020,15~19세,2021,128482,65962,62520,105.5,126836,65202,61634,105.8
23003, 동부,020001, 15세,2021,24626,12716,11910,106.8,24380,12585,11795,106.7
23003, 동부,020002, 16세,2021,24141,12381,11760,105.3,23883,12254,11629,105.4
23003, 동부,020003, 17세,2021,26079,13420,12659,106,25835,13300,12535,106.1
23003, 동부,020004, 18세,2021,26881,13805,13076,105.6,26526,13652,12874,106
23003, 동부,020005, 19세,2021,26755,13640,13115,104,26212,13411,12801,104.8
23003, 동부,025,20~24세,2021,171783,88863,82920,107.2,165209,85461,79748,107.2
23003, 동부,025001, 20세,2021,30527,15930,14597,109.1,29610,15552,14058,110.6
23003, 동부,025002, 21세,2021,34075,17941,16134,111.2,32630,17238,15392,112
23003, 동부,025003, 22세,2021,33412,17538,15874,110.5,32206,16906,15300,110.5
23003, 동부,025004, 23세,2021,35635,18159,17476,103.9,34245,17395,16850,103.2
23003, 동부,025005, 24세,2021,38134,19295,18839,102.4,36518,18370,18148,101.2
23003, 동부,030,25~29세,2021,213490,112163,101327,110.7,202919,106014,96905,109.4
23003, 동부,030001, 25세,2021,40224,20821,19403,107.3,38392,19756,18636,106
23003, 동부,030002, 26세,2021,41747,21889,19858,110.2,39819,20765,19054,109
23003, 동부,030003, 27세,2021,42981,22812,20169,113.1,40893,21626,19267,112.2
23003, 동부,030004, 28세,2021,44016,23339,20677,112.9,41754,21997,19757,111.3
23003, 동부,030005, 29세,2021,44522,23302,21220,109.8,42061,21870,20191,108.3
23003, 동부,035,30~34세,2021,196761,103489,93272,111,181305,94519,86786,108.9
23003, 동부,035001, 30세,2021,42351,22443,19908,112.7,39582,20872,18710,111.6
23003, 동부,035002, 31세,2021,40171,21206,18965,111.8,37080,19411,17669,109.9
23003, 동부,035003, 32세,2021,38724,20399,18325,111.3,35705,18663,17042,109.5
23003, 동부,035004, 33세,2021,37736,19799,17937,110.4,34466,17893,16573,108
23003, 동부,035005, 34세,2021,37779,19642,18137,108.3,34472,17680,16792,105.3
23003, 동부,040,35~39세,2021,213422,111223,102199,108.8,199373,102814,96559,106.5
23003, 동부,040001, 35세,2021,38848,20368,18480,110.2,35639,18488,17151,107.8
23003, 동부,040002, 36세,2021,39310,20691,18619,111.1,36377,18928,17449,108.5
23003, 동부,040003, 37세,2021,40907,21279,19628,108.4,38153,19643,18510,106.1
23003, 동부,040004, 38세,2021,45329,23414,21915,106.8,42722,21817,20905,104.4
23003, 동부,040005, 39세,2021,49028,25471,23557,108.1,46482,23938,22544,106.2
23003, 동부,045,40~44세,2021,234216,120836,113380,106.6,224765,115285,109480,105.3
23003, 동부,045001, 40세,2021,49305,25762,23543,109.4,47126,24440,22686,107.7
23003, 동부,045002, 41세,2021,50066,25749,24317,105.9,48067,24566,23501,104.5
23003, 동부,045003, 42세,2021,47456,24663,22793,108.2,45450,23489,21961,107
23003, 동부,045004, 43세,2021,43319,22081,21238,104,41593,21096,20497,102.9
23003, 동부,045005, 44세,2021,44070,22581,21489,105.1,42529,21694,20835,104.1
23003, 동부,050,45~49세,2021,236391,120247,116144,103.5,229043,116143,112900,102.9
23003, 동부,050001, 45세,2021,42491,21860,20631,106,40996,21002,19994,105
23003, 동부,050002, 46세,2021,45401,23144,22257,104,44042,22382,21660,103.3
23003, 동부,050003, 47세,2021,48985,25135,23850,105.4,47553,24305,23248,104.5
23003, 동부,050004, 48세,2021,49593,24762,24831,99.7,48064,23944,24120,99.3
23003, 동부,050005, 49세,2021,49921,25346,24575,103.1,48388,24510,23878,102.6
23003, 동부,055,50~54세,2021,254323,125592,128731,97.6,247191,121898,125293,97.3
23003, 동부,055001, 50세,2021,52433,26360,26073,101.1,50908,25565,25343,100.9
23003, 동부,055002, 51세,2021,50955,25531,25424,100.4,49380,24671,24709,99.8
23003, 동부,055003, 52세,2021,51864,25484,26380,96.6,50416,24769,25647,96.6
23003, 동부,055004, 53세,2021,51931,25216,26715,94.4,50431,24448,25983,94.1
23003, 동부,055005, 54세,2021,47140,23001,24139,95.3,46056,22445,23611,95.1
23003, 동부,060,55~59세,2021,240638,119747,120891,99.1,233703,116445,117258,99.3
23003, 동부,060001, 55세,2021,46784,23247,23537,98.8,45514,22632,22882,98.9
23003, 동부,060002, 56세,2021,49588,24403,25185,96.9,48160,23721,24439,97.1
23003, 동부,060003, 57세,2021,46359,23001,23358,98.5,44892,22307,22585,98.8
23003, 동부,060004, 58세,2021,48877,24628,24249,101.6,47322,23887,23435,101.9
23003, 동부,060005, 59세,2021,49030,24468,24562,99.6,47815,23898,23917,99.9
23003, 동부,065,60~64세,2021,228232,113621,114611,99.1,222936,111139,111797,99.4
23003, 동부,065001, 60세,2021,51816,25940,25876,100.2,50941,25574,25367,100.8
23003, 동부,065002, 61세,2021,51034,25360,25674,98.8,49767,24775,24992,99.1
23003, 동부,065003, 62세,2021,44433,22088,22345,98.8,43399,21579,21820,98.9
23003, 동부,065004, 63세,2021,41525,20692,20833,99.3,40463,20180,20283,99.5
23003, 동부,065005, 64세,2021,39424,19541,19883,98.3,38366,19031,19335,98.4
23003, 동부,070,65~69세,2021,149692,72524,77168,94,146359,71060,75299,94.4
23003, 동부,070001, 65세,2021,34782,17039,17743,96,33943,16672,17271,96.5
23003, 동부,070002, 66세,2021,35247,17031,18216,93.5,34488,16693,17795,93.8
23003, 동부,070003, 67세,2021,28654,13836,14818,93.4,27976,13534,14442,93.7
23003, 동부,070004, 68세,2021,24458,11790,12668,93.1,23903,11553,12350,93.5
23003, 동부,070005, 69세,2021,26551,12828,13723,93.5,26049,12608,13441,93.8
23003, 동부,075,70~74세,2021,96474,45561,50913,89.5,95082,44975,50107,89.8
23003, 동부,075001, 70세,2021,17642,8453,9189,92,17240,8262,8978,92
23003, 동부,075002, 71세,2021,19945,9600,10345,92.8,19608,9469,10139,93.4
23003, 동부,075003, 72세,2021,20270,9591,10679,89.8,19984,9475,10509,90.2
23003, 동부,075004, 73세,2021,19314,9154,10160,90.1,19113,9071,10042,90.3
23003, 동부,075005, 74세,2021,19303,8763,10540,83.1,19137,8698,10439,83.3
23003, 동부,080,75~79세,2021,70552,30570,39982,76.5,69980,30396,39584,76.8
23003, 동부,080001, 75세,2021,14665,6676,7989,83.6,14526,6628,7898,83.9
23003, 동부,080002, 76세,2021,13562,6020,7542,79.8,13425,5975,7450,80.2
23003, 동부,080003, 77세,2021,13412,5892,7520,78.4,13298,5863,7435,78.9
23003, 동부,080004, 78세,2021,13598,5726,7872,72.7,13506,5706,7800,73.2
23003, 동부,080005, 79세,2021,15315,6256,9059,69.1,15225,6224,9001,69.1
23003, 동부,085,80~84세,2021,49439,18237,31202,58.4,49050,18134,30916,58.7
23003, 동부,085001, 80세,2021,11931,4723,7208,65.5,11832,4692,7140,65.7
23003, 동부,085002, 81세,2021,10438,3955,6483,61,10351,3932,6419,61.3
23003, 동부,085003, 82세,2021,10276,3764,6512,57.8,10212,3749,6463,58
23003, 동부,085004, 83세,2021,9124,3232,5892,54.9,9039,3217,5822,55.3
23003, 동부,085005, 84세,2021,7670,2563,5107,50.2,7616,2544,5072,50.2
23003, 동부,090,85~89세,2021,26122,7513,18609,40.4,25958,7479,18479,40.5
23003, 동부,090001, 85세,2021,7009,2236,4773,46.8,6951,2222,4729,47
23003, 동부,090002, 86세,2021,6346,1942,4404,44.1,6309,1932,4377,44.1
23003, 동부,090003, 87세,2021,4986,1385,3601,38.5,4958,1383,3575,38.7
23003, 동부,090004, 88세,2021,4285,1117,3168,35.3,4263,1114,3149,35.4
23003, 동부,090005, 89세,2021,3496,833,2663,31.3,3477,828,2649,31.3
23003, 동부,095,90~94세,2021,9501,1981,7520,26.3,9455,1974,7481,26.4
23003, 동부,095001, 90세,2021,2656,611,2045,29.9,2643,610,2033,30
23003, 동부,095002, 91세,2021,2377,449,1928,23.3,2359,447,1912,23.4
23003, 동부,095003, 92세,2021,1916,412,1504,27.4,1908,409,1499,27.3
23003, 동부,095004, 93세,2021,1459,290,1169,24.8,1456,289,1167,24.8
23003, 동부,095005, 94세,2021,1093,219,874,25.1,1089,219,870,25.2
23003, 동부,100,95~99세,2021,2096,362,1734,20.9,2087,360,1727,20.8
23003, 동부,100001, 95세,2021,691,122,569,21.4,686,121,565,21.4
23003, 동부,100002, 96세,2021,546,66,480,13.8,545,66,479,13.8
23003, 동부,100003, 97세,2021,358,66,292,22.6,356,66,290,22.8
23003, 동부,100004, 98세,2021,307,76,231,32.9,307,76,231,32.9
23003, 동부,100005, 99세,2021,194,32,162,19.8,193,31,162,19.1
23003, 동부,101,100세이상,2021,348,62,286,21.7,347,61,286,21.3
23003, 동부,102,15세미만,2021,350264,179810,170454,105.5,341605,175313,166292,105.4
23003, 동부,103,15~64세,2021,2117738,1081743,1035995,104.4,2033280,1034920,998360,103.7
23003, 동부,104,65세이상,2021,404224,176810,227414,77.7,398318,174439,223879,77.9
23003, 동부,086,85세이상,2021,38067,9918,28149,35.2,37847,9874,27973,35.3
23003, 동부,126,평균연령,2021,42.4,41.4,43.4,,42.6,41.6,43.6,
23003, 동부,127,중위연령,2021,43.3,42.2,44.6,,43.7,42.6,44.8,
23010, 중구,000,합계,2021,141758,73095,68663,106.5,136607,70465,66142,106.5
23010, 중구,005,0~4세,2021,5013,2631,2382,110.5,4912,2579,2333,110.5
23010, 중구,005001, 0세,2021,849,454,395,114.9,829,442,387,114.2
23010, 중구,005002, 1세,2021,832,444,388,114.4,816,434,382,113.6
23010, 중구,005003, 2세,2021,1072,565,507,111.4,1051,557,494,112.8
23010, 중구,005004, 3세,2021,1074,568,506,112.3,1050,557,493,113
23010, 중구,005005, 4세,2021,1186,600,586,102.4,1166,589,577,102.1
23010, 중구,010,5~9세,2021,6689,3381,3308,102.2,6576,3327,3249,102.4
23010, 중구,010001, 5세,2021,1257,637,620,102.7,1224,617,607,101.6
23010, 중구,010002, 6세,2021,1349,696,653,106.6,1325,684,641,106.7
23010, 중구,010003, 7세,2021,1312,645,667,96.7,1291,640,651,98.3
23010, 중구,010004, 8세,2021,1352,698,654,106.7,1328,687,641,107.2
23010, 중구,010005, 9세,2021,1419,705,714,98.7,1408,699,709,98.6
23010, 중구,015,10~14세,2021,6735,3433,3302,104,6666,3404,3262,104.4
23010, 중구,015001, 10세,2021,1405,739,666,111,1393,732,661,110.7
23010, 중구,015002, 11세,2021,1362,707,655,107.9,1349,699,650,107.5
23010, 중구,015003, 12세,2021,1228,611,617,99,1211,606,605,100.2
23010, 중구,015004, 13세,2021,1335,646,689,93.8,1319,641,678,94.5
23010, 중구,015005, 14세,2021,1405,730,675,108.1,1394,726,668,108.7
23010, 중구,020,15~19세,2021,6504,3363,3141,107.1,6424,3326,3098,107.4
23010, 중구,020001, 15세,2021,1212,630,582,108.2,1195,623,572,108.9
23010, 중구,020002, 16세,2021,1180,620,560,110.7,1163,609,554,109.9
23010, 중구,020003, 17세,2021,1578,828,750,110.4,1564,822,742,110.8
23010, 중구,020004, 18세,2021,1440,763,677,112.7,1425,759,666,114
23010, 중구,020005, 19세,2021,1094,522,572,91.3,1077,513,564,91
23010, 중구,025,20~24세,2021,6643,3351,3292,101.8,6426,3250,3176,102.3
23010, 중구,025001, 20세,2021,1108,625,483,129.4,1085,620,465,133.3
23010, 중구,025002, 21세,2021,1232,669,563,118.8,1197,651,546,119.2
23010, 중구,025003, 22세,2021,1252,626,626,100,1206,606,600,101
23010, 중구,025004, 23세,2021,1443,680,763,89.1,1393,658,735,89.5
23010, 중구,025005, 24세,2021,1608,751,857,87.6,1545,715,830,86.1
23010, 중구,030,25~29세,2021,11622,6020,5602,107.5,11150,5780,5370,107.6
23010, 중구,030001, 25세,2021,1863,906,957,94.7,1789,865,924,93.6
23010, 중구,030002, 26세,2021,2231,1071,1160,92.3,2148,1029,1119,92
23010, 중구,030003, 27세,2021,2414,1296,1118,115.9,2310,1244,1066,116.7
23010, 중구,030004, 28세,2021,2538,1341,1197,112,2437,1292,1145,112.8
23010, 중구,030005, 29세,2021,2576,1406,1170,120.2,2466,1350,1116,121
23010, 중구,035,30~34세,2021,10923,6080,4843,125.5,10233,5711,4522,126.3
23010, 중구,035001, 30세,2021,2404,1341,1063,126.2,2274,1274,1000,127.4
23010, 중구,035002, 31세,2021,2222,1291,931,138.7,2094,1225,869,141
23010, 중구,035003, 32세,2021,2133,1192,941,126.7,1993,1113,880,126.5
23010, 중구,035004, 33세,2021,2034,1097,937,117.1,1912,1030,882,116.8
23010, 중구,035005, 34세,2021,2130,1159,971,119.4,1960,1069,891,120
23010, 중구,040,35~39세,2021,11206,5961,5245,113.7,10543,5601,4942,113.3
23010, 중구,040001, 35세,2021,2091,1097,994,110.4,1943,1017,926,109.8
23010, 중구,040002, 36세,2021,2074,1123,951,118.1,1941,1049,892,117.6
23010, 중구,040003, 37세,2021,2031,1099,932,117.9,1909,1032,877,117.7
23010, 중구,040004, 38세,2021,2358,1272,1086,117.1,2228,1201,1027,116.9
23010, 중구,040005, 39세,2021,2652,1370,1282,106.9,2522,1302,1220,106.7
23010, 중구,045,40~44세,2021,12611,6706,5905,113.6,12022,6370,5652,112.7
23010, 중구,045001, 40세,2021,2629,1406,1223,115,2479,1325,1154,114.8
23010, 중구,045002, 41세,2021,2679,1439,1240,116,2562,1372,1190,115.3
23010, 중구,045003, 42세,2021,2522,1355,1167,116.1,2411,1288,1123,114.7
23010, 중구,045004, 43세,2021,2434,1278,1156,110.6,2324,1212,1112,109
23010, 중구,045005, 44세,2021,2347,1228,1119,109.7,2246,1173,1073,109.3
23010, 중구,050,45~49세,2021,12110,6690,5420,123.4,11703,6458,5245,123.1
23010, 중구,050001, 45세,2021,2309,1273,1036,122.9,2237,1230,1007,122.1
23010, 중구,050002, 46세,2021,2365,1304,1061,122.9,2296,1266,1030,122.9
23010, 중구,050003, 47세,2021,2453,1375,1078,127.6,2371,1326,1045,126.9
23010, 중구,050004, 48세,2021,2500,1366,1134,120.5,2412,1317,1095,120.3
23010, 중구,050005, 49세,2021,2483,1372,1111,123.5,2387,1319,1068,123.5
23010, 중구,055,50~54세,2021,11264,6234,5030,123.9,10821,6009,4812,124.9
23010, 중구,055001, 50세,2021,2464,1378,1086,126.9,2364,1327,1037,128
23010, 중구,055002, 51세,2021,2382,1333,1049,127.1,2277,1279,998,128.2
23010, 중구,055003, 52세,2021,2239,1221,1018,119.9,2156,1180,976,120.9
23010, 중구,055004, 53세,2021,2251,1219,1032,118.1,2163,1172,991,118.3
23010, 중구,055005, 54세,2021,1928,1083,845,128.2,1861,1051,810,129.8
23010, 중구,060,55~59세,2021,9567,5077,4490,113.1,9135,4889,4246,115.1
23010, 중구,060001, 55세,2021,1890,1025,865,118.5,1812,987,825,119.6
23010, 중구,060002, 56세,2021,2047,1093,954,114.6,1961,1062,899,118.1
23010, 중구,060003, 57세,2021,1797,952,845,112.7,1718,917,801,114.5
23010, 중구,060004, 58세,2021,1947,1005,942,106.7,1839,959,880,109
23010, 중구,060005, 59세,2021,1886,1002,884,113.3,1805,964,841,114.6
23010, 중구,065,60~64세,2021,9532,4784,4748,100.8,9159,4609,4550,101.3
23010, 중구,065001, 60세,2021,2017,1020,997,102.3,1940,989,951,104
23010, 중구,065002, 61세,2021,2039,1043,996,104.7,1957,1005,952,105.6
23010, 중구,065003, 62세,2021,1889,938,951,98.6,1796,896,900,99.6
23010, 중구,065004, 63세,2021,1823,890,933,95.4,1772,863,909,94.9
23010, 중구,065005, 64세,2021,1764,893,871,102.5,1694,856,838,102.1
23010, 중구,070,65~69세,2021,7394,3556,3838,92.7,7142,3440,3702,92.9
23010, 중구,070001, 65세,2021,1589,767,822,93.3,1533,738,795,92.8
23010, 중구,070002, 66세,2021,1757,826,931,88.7,1702,801,901,88.9
23010, 중구,070003, 67세,2021,1479,706,773,91.3,1425,681,744,91.5
23010, 중구,070004, 68세,2021,1237,610,627,97.3,1192,595,597,99.7
23010, 중구,070005, 69세,2021,1332,647,685,94.5,1290,625,665,94
23010, 중구,075,70~74세,2021,5250,2430,2820,86.2,5118,2362,2756,85.7
23010, 중구,075001, 70세,2021,847,379,468,81,812,357,455,78.5
23010, 중구,075002, 71세,2021,1098,548,550,99.6,1072,535,537,99.6
23010, 중구,075003, 72세,2021,1145,490,655,74.8,1111,477,634,75.2
23010, 중구,075004, 73세,2021,1037,480,557,86.2,1019,469,550,85.3
23010, 중구,075005, 74세,2021,1123,533,590,90.3,1104,524,580,90.3
23010, 중구,080,75~79세,2021,4026,1837,2189,83.9,3956,1807,2149,84.1
23010, 중구,080001, 75세,2021,812,366,446,82.1,799,359,440,81.6
23010, 중구,080002, 76세,2021,785,368,417,88.2,764,360,404,89.1
23010, 중구,080003, 77세,2021,774,377,397,95,761,373,388,96.1
23010, 중구,080004, 78세,2021,756,360,396,90.9,745,355,390,91
23010, 중구,080005, 79세,2021,899,366,533,68.7,887,360,527,68.3
23010, 중구,085,80~84세,2021,2574,1005,1569,64.1,2538,991,1547,64.1
23010, 중구,085001, 80세,2021,639,284,355,80,626,280,346,80.9
23010, 중구,085002, 81세,2021,534,209,325,64.3,526,205,321,63.9
23010, 중구,085003, 82세,2021,563,203,360,56.4,560,202,358,56.4
23010, 중구,085004, 83세,2021,467,177,290,61,462,175,287,61
23010, 중구,085005, 84세,2021,371,132,239,55.2,364,129,235,54.9
23010, 중구,090,85~89세,2021,1401,413,988,41.8,1391,409,982,41.6
23010, 중구,090001, 85세,2021,351,133,218,61,347,131,216,60.6
23010, 중구,090002, 86세,2021,338,100,238,42,336,99,237,41.8
23010, 중구,090003, 87세,2021,279,70,209,33.5,278,70,208,33.7
23010, 중구,090004, 88세,2021,216,57,159,35.8,216,57,159,35.8
23010, 중구,090005, 89세,2021,217,53,164,32.3,214,52,162,32.1
23010, 중구,095,90~94세,2021,532,111,421,26.4,530,111,419,26.5
23010, 중구,095001, 90세,2021,161,36,125,28.8,159,36,123,29.3
23010, 중구,095002, 91세,2021,123,22,101,21.8,123,22,101,21.8
23010, 중구,095003, 92세,2021,99,23,76,30.3,99,23,76,30.3
23010, 중구,095004, 93세,2021,79,14,65,21.5,79,14,65,21.5
23010, 중구,095005, 94세,2021,70,16,54,29.6,70,16,54,29.6
23010, 중구,100,95~99세,2021,142,26,116,22.4,142,26,116,22.4
23010, 중구,100001, 95세,2021,45,10,35,28.6,45,10,35,28.6
23010, 중구,100002, 96세,2021,31,X,28,10.7,31,X,28,10.7
23010, 중구,100003, 97세,2021,32,7,25,28,32,7,25,28
23010, 중구,100004, 98세,2021,19,X,15,26.7,19,X,15,26.7
23010, 중구,100005, 99세,2021,15,X,13,15.4,15,X,13,15.4
23010, 중구,101,100세이상,2021,20,6,14,42.9,20,6,14,42.9
23010, 중구,102,15세미만,2021,18437,9445,8992,105,18154,9310,8844,105.3
23010, 중구,103,15~64세,2021,101982,54266,47716,113.7,97616,52003,45613,114
23010, 중구,104,65세이상,2021,21339,9384,11955,78.5,20837,9152,11685,78.3
23010, 중구,086,85세이상,2021,2095,556,1539,36.1,2083,552,1531,36.1
23010, 중구,126,평균연령,2021,41.9,41.1,42.8,,41.9,41.1,42.8,
23010, 중구,127,중위연령,2021,42.1,41.6,42.6,,42.1,41.7,42.7,
23020, 동구,000,합계,2021,61053,30640,30413,100.7,59863,30009,29854,100.5
23020, 동구,005,0~4세,2021,1373,694,679,102.2,1351,684,667,102.5
23020, 동구,005001, 0세,2021,208,117,91,128.6,204,114,90,126.7
23020, 동구,005002, 1세,2021,242,114,128,89.1,239,113,126,89.7
23020, 동구,005003, 2세,2021,298,140,158,88.6,292,137,155,88.4
23020, 동구,005004, 3세,2021,312,171,141,121.3,308,170,138,123.2
23020, 동구,005005, 4세,2021,313,152,161,94.4,308,150,158,94.9
23020, 동구,010,5~9세,2021,2130,1134,996,113.9,2110,1125,985,114.2
23020, 동구,010001, 5세,2021,390,202,188,107.4,385,200,185,108.1
23020, 동구,010002, 6세,2021,439,250,189,132.3,435,247,188,131.4
23020, 동구,010003, 7세,2021,410,222,188,118.1,405,219,186,117.7
23020, 동구,010004, 8세,2021,419,208,211,98.6,414,207,207,100
23020, 동구,010005, 9세,2021,472,252,220,114.5,471,252,219,115.1
23020, 동구,015,10~14세,2021,2385,1213,1172,103.5,2370,1208,1162,104
23020, 동구,015001, 10세,2021,474,247,227,108.8,472,246,226,108.8
23020, 동구,015002, 11세,2021,475,237,238,99.6,470,236,234,100.9
23020, 동구,015003, 12세,2021,447,213,234,91,444,212,232,91.4
23020, 동구,015004, 13세,2021,455,245,210,116.7,453,244,209,116.7
23020, 동구,015005, 14세,2021,534,271,263,103,531,270,261,103.4
23020, 동구,020,15~19세,2021,2354,1207,1147,105.2,2334,1200,1134,105.8
23020, 동구,020001, 15세,2021,441,233,208,112,436,232,204,113.7
23020, 동구,020002, 16세,2021,468,240,228,105.3,464,238,226,105.3
23020, 동구,020003, 17세,2021,484,252,232,108.6,481,251,230,109.1
23020, 동구,020004, 18세,2021,481,239,242,98.8,480,239,241,99.2
23020, 동구,020005, 19세,2021,480,243,237,102.5,473,240,233,103
23020, 동구,025,20~24세,2021,3063,1618,1445,112,3003,1587,1416,112.1
23020, 동구,025001, 20세,2021,552,294,258,114,543,290,253,114.6
23020, 동구,025002, 21세,2021,644,340,304,111.8,635,337,298,113.1
23020, 동구,025003, 22세,2021,575,317,258,122.9,562,310,252,123
23020, 동구,025004, 23세,2021,636,323,313,103.2,623,316,307,102.9
23020, 동구,025005, 24세,2021,656,344,312,110.3,640,334,306,109.2
23020, 동구,030,25~29세,2021,3306,1832,1474,124.3,3169,1732,1437,120.5
23020, 동구,030001, 25세,2021,646,354,292,121.2,627,340,287,118.5
23020, 동구,030002, 26세,2021,625,343,282,121.6,601,324,277,117
23020, 동구,030003, 27세,2021,680,396,284,139.4,650,370,280,132.1
23020, 동구,030004, 28세,2021,675,372,303,122.8,642,354,288,122.9
23020, 동구,030005, 29세,2021,680,367,313,117.3,649,344,305,112.8
23020, 동구,035,30~34세,2021,3184,1757,1427,123.1,3010,1664,1346,123.6
23020, 동구,035001, 30세,2021,689,379,310,122.3,649,357,292,122.3
23020, 동구,035002, 31세,2021,642,363,279,130.1,608,341,267,127.7
23020, 동구,035003, 32세,2021,567,321,246,130.5,537,306,231,132.5
23020, 동구,035004, 33세,2021,644,344,300,114.7,610,325,285,114
23020, 동구,035005, 34세,2021,642,350,292,119.9,606,335,271,123.6
23020, 동구,040,35~39세,2021,3767,2014,1753,114.9,3596,1916,1680,114
23020, 동구,040001, 35세,2021,651,354,297,119.2,620,336,284,118.3
23020, 동구,040002, 36세,2021,691,374,317,118,655,351,304,115.5
23020, 동구,040003, 37세,2021,724,389,335,116.1,688,370,318,116.4
23020, 동구,040004, 38세,2021,831,437,394,110.9,801,421,380,110.8
23020, 동구,040005, 39세,2021,870,460,410,112.2,832,438,394,111.2
23020, 동구,045,40~44세,2021,4739,2550,2189,116.5,4606,2484,2122,117.1
23020, 동구,045001, 40세,2021,961,513,448,114.5,937,500,437,114.4
23020, 동구,045002, 41세,2021,1020,535,485,110.3,992,517,475,108.8
23020, 동구,045003, 42세,2021,994,539,455,118.5,966,528,438,120.5
23020, 동구,045004, 43세,2021,877,479,398,120.4,857,473,384,123.2
23020, 동구,045005, 44세,2021,887,484,403,120.1,854,466,388,120.1
23020, 동구,050,45~49세,2021,4887,2609,2278,114.5,4802,2563,2239,114.5
23020, 동구,050001, 45세,2021,861,477,384,124.2,839,463,376,123.1
23020, 동구,050002, 46세,2021,960,530,430,123.3,946,522,424,123.1
23020, 동구,050003, 47세,2021,972,491,481,102.1,962,487,475,102.5
23020, 동구,050004, 48세,2021,1019,547,472,115.9,998,535,463,115.6
23020, 동구,050005, 49세,2021,1075,564,511,110.4,1057,556,501,111
23020, 동구,055,50~54세,2021,5022,2666,2356,113.2,4929,2619,2310,113.4
23020, 동구,055001, 50세,2021,1036,556,480,115.8,1018,546,472,115.7
23020, 동구,055002, 51세,2021,1003,566,437,129.5,981,554,427,129.7
23020, 동구,055003, 52세,2021,983,513,470,109.1,967,505,462,109.3
23020, 동구,055004, 53세,2021,1057,555,502,110.6,1030,543,487,111.5
23020, 동구,055005, 54세,2021,943,476,467,101.9,933,471,462,101.9
23020, 동구,060,55~59세,2021,4841,2506,2335,107.3,4736,2455,2281,107.6
23020, 동구,060001, 55세,2021,915,482,433,111.3,896,471,425,110.8
23020, 동구,060002, 56세,2021,989,507,482,105.2,969,498,471,105.7
23020, 동구,060003, 57세,2021,913,477,436,109.4,893,471,422,111.6
23020, 동구,060004, 58세,2021,945,492,453,108.6,922,476,446,106.7
23020, 동구,060005, 59세,2021,1079,548,531,103.2,1056,539,517,104.3
23020, 동구,065,60~64세,2021,5624,2725,2899,94,5559,2695,2864,94.1
23020, 동구,065001, 60세,2021,1142,568,574,99,1130,563,567,99.3
23020, 동구,065002, 61세,2021,1190,573,617,92.9,1174,566,608,93.1
23020, 동구,065003, 62세,2021,1115,531,584,90.9,1105,527,578,91.2
23020, 동구,065004, 63세,2021,1089,537,552,97.3,1074,528,546,96.7
23020, 동구,065005, 64세,2021,1088,516,572,90.2,1076,511,565,90.4
23020, 동구,070,65~69세,2021,4665,2210,2455,90,4616,2190,2426,90.3
23020, 동구,070001, 65세,2021,1032,508,524,96.9,1022,507,515,98.4
23020, 동구,070002, 66세,2021,1075,499,576,86.6,1063,493,570,86.5
23020, 동구,070003, 67세,2021,885,428,457,93.7,872,420,452,92.9
23020, 동구,070004, 68세,2021,772,366,406,90.1,768,365,403,90.6
23020, 동구,070005, 69세,2021,901,409,492,83.1,891,405,486,83.3
23020, 동구,075,70~74세,2021,3536,1553,1983,78.3,3511,1540,1971,78.1
23020, 동구,075001, 70세,2021,613,261,352,74.1,607,257,350,73.4
23020, 동구,075002, 71세,2021,715,327,388,84.3,710,326,384,84.9
23020, 동구,075003, 72세,2021,731,314,417,75.3,725,311,414,75.1
23020, 동구,075004, 73세,2021,728,319,409,78,724,317,407,77.9
23020, 동구,075005, 74세,2021,749,332,417,79.6,745,329,416,79.1
23020, 동구,080,75~79세,2021,2882,1249,1633,76.5,2874,1246,1628,76.5
23020, 동구,080001, 75세,2021,599,267,332,80.4,598,266,332,80.1
23020, 동구,080002, 76세,2021,563,265,298,88.9,559,264,295,89.5
23020, 동구,080003, 77세,2021,531,213,318,67,531,213,318,67
23020, 동구,080004, 78세,2021,547,231,316,73.1,545,230,315,73
23020, 동구,080005, 79세,2021,642,273,369,74,641,273,368,74.2
23020, 동구,085,80~84세,2021,1939,755,1184,63.8,1936,754,1182,63.8
23020, 동구,085001, 80세,2021,499,208,291,71.5,496,207,289,71.6
23020, 동구,085002, 81세,2021,385,163,222,73.4,385,163,222,73.4
23020, 동구,085003, 82세,2021,422,159,263,60.5,422,159,263,60.5
23020, 동구,085004, 83세,2021,338,124,214,57.9,338,124,214,57.9
23020, 동구,085005, 84세,2021,295,101,194,52.1,295,101,194,52.1
23020, 동구,090,85~89세,2021,949,253,696,36.4,946,252,694,36.3
23020, 동구,090001, 85세,2021,258,80,178,44.9,258,80,178,44.9
23020, 동구,090002, 86세,2021,225,61,164,37.2,225,61,164,37.2
23020, 동구,090003, 87세,2021,168,44,124,35.5,167,44,123,35.8
23020, 동구,090004, 88세,2021,155,34,121,28.1,154,34,120,28.3
23020, 동구,090005, 89세,2021,143,34,109,31.2,142,33,109,30.3
23020, 동구,095,90~94세,2021,327,79,248,31.9,325,79,246,32.1
23020, 동구,095001, 90세,2021,88,23,65,35.4,88,23,65,35.4
23020, 동구,095002, 91세,2021,77,19,58,32.8,77,19,58,32.8
23020, 동구,095003, 92세,2021,61,16,45,35.6,61,16,45,35.6
23020, 동구,095004, 93세,2021,59,13,46,28.3,58,13,45,28.9
23020, 동구,095005, 94세,2021,42,8,34,23.5,41,8,33,24.2
23020, 동구,100,95~99세,2021,73,14,59,23.7,73,14,59,23.7
23020, 동구,100001, 95세,2021,21,X,19,10.5,21,X,19,10.5
23020, 동구,100002, 96세,2021,19,X,18,5.6,19,X,18,5.6
23020, 동구,100003, 97세,2021,22,6,16,37.5,22,6,16,37.5
23020, 동구,100004, 98세,2021,8,5,X,166.7,8,5,X,166.7
23020, 동구,100005, 99세,2021,X,X,X,0,X,X,X,0
23020, 동구,101,100세이상,2021,7,X,5,40,7,X,5,40
23020, 동구,102,15세미만,2021,5888,3041,2847,106.8,5831,3017,2814,107.2
23020, 동구,103,15~64세,2021,40787,21484,19303,111.3,39744,20915,18829,111.1
23020, 동구,104,65세이상,2021,14378,6115,8263,74,14288,6077,8211,74
23020, 동구,086,85세이상,2021,1356,348,1008,34.5,1351,347,1004,34.6
23020, 동구,126,평균연령,2021,47.5,45.8,49.1,,47.6,45.9,49.2,
23020, 동구,127,중위연령,2021,49.4,47.6,51.4,,49.6,47.9,51.6,
23040, 연수구,000,합계,2021,399594,198779,200815,99,379697,188497,191200,98.6
23040, 연수구,005,0~4세,2021,16343,8398,7945,105.7,15097,7746,7351,105.4
23040, 연수구,005001, 0세,2021,2709,1412,1297,108.9,2497,1301,1196,108.8
23040, 연수구,005002, 1세,2021,2993,1511,1482,102,2738,1404,1334,105.2
23040, 연수구,005003, 2세,2021,3281,1716,1565,109.6,3070,1601,1469,109
23040, 연수구,005004, 3세,2021,3488,1793,1695,105.8,3206,1628,1578,103.2
23040, 연수구,005005, 4세,2021,3872,1966,1906,103.1,3586,1812,1774,102.1
23040, 연수구,010,5~9세,2021,22871,11651,11220,103.8,21535,10968,10567,103.8
23040, 연수구,010001, 5세,2021,4285,2163,2122,101.9,3978,2004,1974,101.5
23040, 연수구,010002, 6세,2021,4627,2368,2259,104.8,4316,2210,2106,104.9
23040, 연수구,010003, 7세,2021,4628,2383,2245,106.1,4346,2244,2102,106.8
23040, 연수구,010004, 8세,2021,4546,2312,2234,103.5,4322,2199,2123,103.6
23040, 연수구,010005, 9세,2021,4785,2425,2360,102.8,4573,2311,2262,102.2
23040, 연수구,015,10~14세,2021,22825,11740,11085,105.9,22058,11321,10737,105.4
23040, 연수구,015001, 10세,2021,4806,2459,2347,104.8,4624,2368,2256,105
23040, 연수구,015002, 11세,2021,4448,2299,2149,107,4289,2211,2078,106.4
23040, 연수구,015003, 12세,2021,4457,2322,2135,108.8,4295,2231,2064,108.1
23040, 연수구,015004, 13세,2021,4547,2352,2195,107.2,4405,2268,2137,106.1
23040, 연수구,015005, 14세,2021,4567,2308,2259,102.2,4445,2243,2202,101.9
23040, 연수구,020,15~19세,2021,20757,10579,10178,103.9,20120,10299,9821,104.9
23040, 연수구,020001, 15세,2021,3923,1987,1936,102.6,3827,1939,1888,102.7
23040, 연수구,020002, 16세,2021,3856,1969,1887,104.3,3750,1910,1840,103.8
23040, 연수구,020003, 17세,2021,3980,2057,1923,107,3882,2006,1876,106.9
23040, 연수구,020004, 18세,2021,4185,2132,2053,103.8,4024,2064,1960,105.3
23040, 연수구,020005, 19세,2021,4813,2434,2379,102.3,4637,2380,2257,105.4
23040, 연수구,025,20~24세,2021,26092,13462,12630,106.6,23929,12287,11642,105.5
23040, 연수구,025001, 20세,2021,5137,2611,2526,103.4,4801,2471,2330,106.1
23040, 연수구,025002, 21세,2021,5522,2846,2676,106.4,4907,2515,2392,105.1
23040, 연수구,025003, 22세,2021,5014,2594,2420,107.2,4649,2388,2261,105.6
23040, 연수구,025004, 23세,2021,5195,2693,2502,107.6,4785,2446,2339,104.6
23040, 연수구,025005, 24세,2021,5224,2718,2506,108.5,4787,2467,2320,106.3
23040, 연수구,030,25~29세,2021,27510,14392,13118,109.7,25373,13290,12083,110
23040, 연수구,030001, 25세,2021,5340,2801,2539,110.3,4923,2596,2327,111.6
23040, 연수구,030002, 26세,2021,5260,2778,2482,111.9,4872,2567,2305,111.4
23040, 연수구,030003, 27세,2021,5470,2894,2576,112.3,5009,2659,2350,113.1
23040, 연수구,030004, 28세,2021,5654,2978,2676,111.3,5225,2750,2475,111.1
23040, 연수구,030005, 29세,2021,5786,2941,2845,103.4,5344,2718,2626,103.5
23040, 연수구,035,30~34세,2021,27484,13701,13783,99.4,24778,12281,12497,98.3
23040, 연수구,035001, 30세,2021,5565,2807,2758,101.8,5085,2561,2524,101.5
23040, 연수구,035002, 31세,2021,5461,2726,2735,99.7,4904,2425,2479,97.8
23040, 연수구,035003, 32세,2021,5518,2745,2773,99,4995,2487,2508,99.2
23040, 연수구,035004, 33세,2021,5448,2745,2703,101.6,4885,2442,2443,100
23040, 연수구,035005, 34세,2021,5492,2678,2814,95.2,4909,2366,2543,93
23040, 연수구,040,35~39세,2021,32570,16116,16454,97.9,29961,14686,15275,96.1
23040, 연수구,040001, 35세,2021,5915,2923,2992,97.7,5297,2592,2705,95.8
23040, 연수구,040002, 36세,2021,6012,3016,2996,100.7,5494,2729,2765,98.7
23040, 연수구,040003, 37세,2021,6270,3135,3135,100,5777,2862,2915,98.2
23040, 연수구,040004, 38세,2021,6892,3358,3534,95,6402,3084,3318,92.9
23040, 연수구,040005, 39세,2021,7481,3684,3797,97,6991,3419,3572,95.7
23040, 연수구,045,40~44세,2021,35392,17489,17903,97.7,33485,16474,17011,96.8
23040, 연수구,045001, 40세,2021,7602,3726,3876,96.1,7176,3484,3692,94.4
23040, 연수구,045002, 41세,2021,7446,3687,3759,98.1,7043,3479,3564,97.6
23040, 연수구,045003, 42세,2021,7127,3533,3594,98.3,6744,3345,3399,98.4
23040, 연수구,045004, 43세,2021,6582,3244,3338,97.2,6199,3033,3166,95.8
23040, 연수구,045005, 44세,2021,6635,3299,3336,98.9,6323,3133,3190,98.2
23040, 연수구,050,45~49세,2021,34719,17069,17650,96.7,33256,16286,16970,96
23040, 연수구,050001, 45세,2021,6380,3196,3184,100.4,6045,3009,3036,99.1
23040, 연수구,050002, 46세,2021,6801,3342,3459,96.6,6519,3197,3322,96.2
23040, 연수구,050003, 47세,2021,7182,3561,3621,98.3,6917,3407,3510,97.1
23040, 연수구,050004, 48세,2021,7122,3343,3779,88.5,6833,3209,3624,88.5
23040, 연수구,050005, 49세,2021,7234,3627,3607,100.6,6942,3464,3478,99.6
23040, 연수구,055,50~54세,2021,34522,16873,17649,95.6,33459,16336,17123,95.4
23040, 연수구,055001, 50세,2021,7484,3712,3772,98.4,7236,3591,3645,98.5
23040, 연수구,055002, 51세,2021,7122,3522,3600,97.8,6882,3397,3485,97.5
23040, 연수구,055003, 52세,2021,7064,3410,3654,93.3,6857,3296,3561,92.6
23040, 연수구,055004, 53세,2021,6705,3236,3469,93.3,6479,3126,3353,93.2
23040, 연수구,055005, 54세,2021,6147,2993,3154,94.9,6005,2926,3079,95
23040, 연수구,060,55~59세,2021,30843,15194,15649,97.1,30029,14814,15215,97.4
23040, 연수구,060001, 55세,2021,5977,2909,3068,94.8,5814,2825,2989,94.5
23040, 연수구,060002, 56세,2021,6308,3052,3256,93.7,6133,2974,3159,94.1
23040, 연수구,060003, 57세,2021,5967,2932,3035,96.6,5803,2857,2946,97
23040, 연수구,060004, 58세,2021,6391,3189,3202,99.6,6207,3102,3105,99.9
23040, 연수구,060005, 59세,2021,6200,3112,3088,100.8,6072,3056,3016,101.3
23040, 연수구,065,60~64세,2021,27094,13951,13143,106.1,26549,13700,12849,106.6
23040, 연수구,065001, 60세,2021,6399,3274,3125,104.8,6286,3226,3060,105.4
23040, 연수구,065002, 61세,2021,6133,3146,2987,105.3,6006,3074,2932,104.8
23040, 연수구,065003, 62세,2021,5308,2730,2578,105.9,5212,2692,2520,106.8
23040, 연수구,065004, 63세,2021,4812,2542,2270,112,4695,2493,2202,113.2
23040, 연수구,065005, 64세,2021,4442,2259,2183,103.5,4350,2215,2135,103.7
23040, 연수구,070,65~69세,2021,15965,8065,7900,102.1,15673,7976,7697,103.6
23040, 연수구,070001, 65세,2021,3828,1943,1885,103.1,3735,1919,1816,105.7
23040, 연수구,070002, 66세,2021,3822,1903,1919,99.2,3755,1879,1876,100.2
23040, 연수구,070003, 67세,2021,3065,1595,1470,108.5,3021,1580,1441,109.6
23040, 연수구,070004, 68세,2021,2512,1246,1266,98.4,2461,1230,1231,99.9
23040, 연수구,070005, 69세,2021,2738,1378,1360,101.3,2701,1368,1333,102.6
23040, 연수구,075,70~74세,2021,9173,4348,4825,90.1,9055,4308,4747,90.8
23040, 연수구,075001, 70세,2021,1648,815,833,97.8,1612,802,810,99
23040, 연수구,075002, 71세,2021,1898,923,975,94.7,1870,915,955,95.8
23040, 연수구,075003, 72세,2021,1954,950,1004,94.6,1935,943,992,95.1
23040, 연수구,075004, 73세,2021,1841,858,983,87.3,1821,850,971,87.5
23040, 연수구,075005, 74세,2021,1832,802,1030,77.9,1817,798,1019,78.3
23040, 연수구,080,75~79세,2021,6664,2960,3704,79.9,6620,2948,3672,80.3
23040, 연수구,080001, 75세,2021,1415,681,734,92.8,1400,678,722,93.9
23040, 연수구,080002, 76세,2021,1234,572,662,86.4,1226,569,657,86.6
23040, 연수구,080003, 77세,2021,1230,551,679,81.1,1221,547,674,81.2
23040, 연수구,080004, 78세,2021,1359,583,776,75.1,1350,581,769,75.6
23040, 연수구,080005, 79세,2021,1426,573,853,67.2,1423,573,850,67.4
23040, 연수구,085,80~84세,2021,4893,1775,3118,56.9,4860,1764,3096,57
23040, 연수구,085001, 80세,2021,1141,459,682,67.3,1131,453,678,66.8
23040, 연수구,085002, 81세,2021,1004,370,634,58.4,999,370,629,58.8
23040, 연수구,085003, 82세,2021,1008,348,660,52.7,1002,347,655,53
23040, 연수구,085004, 83세,2021,942,333,609,54.7,932,331,601,55.1
23040, 연수구,085005, 84세,2021,798,265,533,49.7,796,263,533,49.3
23040, 연수구,090,85~89세,2021,2613,746,1867,40,2603,744,1859,40
23040, 연수구,090001, 85세,2021,648,203,445,45.6,646,203,443,45.8
23040, 연수구,090002, 86세,2021,625,194,431,45,624,194,430,45.1
23040, 연수구,090003, 87세,2021,519,155,364,42.6,518,155,363,42.7
23040, 연수구,090004, 88세,2021,442,108,334,32.3,440,107,333,32.1
23040, 연수구,090005, 89세,2021,379,86,293,29.4,375,85,290,29.3
23040, 연수구,095,90~94세,2021,1002,230,772,29.8,995,229,766,29.9
23040, 연수구,095001, 90세,2021,293,63,230,27.4,291,63,228,27.6
23040, 연수구,095002, 91세,2021,257,58,199,29.1,255,57,198,28.8
23040, 연수구,095003, 92세,2021,199,46,153,30.1,197,46,151,30.5
23040, 연수구,095004, 93세,2021,148,33,115,28.7,148,33,115,28.7
23040, 연수구,095005, 94세,2021,105,30,75,40,104,30,74,40.5
23040, 연수구,100,95~99세,2021,229,35,194,18,229,35,194,18
23040, 연수구,100001, 95세,2021,79,13,66,19.7,79,13,66,19.7
23040, 연수구,100002, 96세,2021,56,X,55,1.8,56,X,55,1.8
23040, 연수구,100003, 97세,2021,35,9,26,34.6,35,9,26,34.6
23040, 연수구,100004, 98세,2021,37,7,30,23.3,37,7,30,23.3
23040, 연수구,100005, 99세,2021,22,5,17,29.4,22,5,17,29.4
23040, 연수구,101,100세이상,2021,33,5,28,17.9,33,5,28,17.9
23040, 연수구,102,15세미만,2021,62039,31789,30250,105.1,58690,30035,28655,104.8
23040, 연수구,103,15~64세,2021,296983,148826,148157,100.5,280939,140453,140486,100
23040, 연수구,104,65세이상,2021,40572,18164,22408,81.1,40068,18009,22059,81.6
23040, 연수구,086,85세이상,2021,3877,1016,2861,35.5,3860,1013,2847,35.6
23040, 연수구,126,평균연령,2021,39.4,38.7,40.1,,39.8,39.1,40.5,
23040, 연수구,127,중위연령,2021,40.4,39.8,41,,41,40.4,41.5,
23050, 남동구,000,합계,2021,521165,260262,260903,99.8,504770,250105,254665,98.2
23050, 남동구,005,0~4세,2021,15385,7955,7430,107.1,15024,7759,7265,106.8
23050, 남동구,005001, 0세,2021,2481,1288,1193,108,2427,1262,1165,108.3
23050, 남동구,005002, 1세,2021,2720,1417,1303,108.7,2653,1373,1280,107.3
23050, 남동구,005003, 2세,2021,3089,1565,1524,102.7,3009,1523,1486,102.5
23050, 남동구,005004, 3세,2021,3347,1754,1593,110.1,3266,1712,1554,110.2
23050, 남동구,005005, 4세,2021,3748,1931,1817,106.3,3669,1889,1780,106.1
23050, 남동구,010,5~9세,2021,23275,11956,11319,105.6,22914,11770,11144,105.6
23050, 남동구,010001, 5세,2021,4330,2248,2082,108,4223,2197,2026,108.4
23050, 남동구,010002, 6세,2021,4600,2349,2251,104.4,4525,2308,2217,104.1
23050, 남동구,010003, 7세,2021,4577,2374,2203,107.8,4513,2332,2181,106.9
23050, 남동구,010004, 8세,2021,4707,2382,2325,102.5,4649,2360,2289,103.1
23050, 남동구,010005, 9세,2021,5061,2603,2458,105.9,5004,2573,2431,105.8
23050, 남동구,015,10~14세,2021,24501,12546,11955,104.9,24307,12444,11863,104.9
23050, 남동구,015001, 10세,2021,5094,2661,2433,109.4,5061,2639,2422,109
23050, 남동구,015002, 11세,2021,4846,2511,2335,107.5,4802,2485,2317,107.3
23050, 남동구,015003, 12세,2021,4690,2345,2345,100,4651,2329,2322,100.3
23050, 남동구,015004, 13세,2021,4889,2470,2419,102.1,4854,2450,2404,101.9
23050, 남동구,015005, 14세,2021,4982,2559,2423,105.6,4939,2541,2398,106
23050, 남동구,020,15~19세,2021,22792,11551,11241,102.8,22644,11479,11165,102.8
23050, 남동구,020001, 15세,2021,4559,2361,2198,107.4,4534,2345,2189,107.1
23050, 남동구,020002, 16세,2021,4432,2240,2192,102.2,4405,2232,2173,102.7
23050, 남동구,020003, 17세,2021,4703,2341,2362,99.1,4673,2326,2347,99.1
23050, 남동구,020004, 18세,2021,4813,2433,2380,102.2,4790,2421,2369,102.2
23050, 남동구,020005, 19세,2021,4285,2176,2109,103.2,4242,2155,2087,103.3
23050, 남동구,025,20~24세,2021,29793,15303,14490,105.6,28871,14780,14091,104.9
23050, 남동구,025001, 20세,2021,5208,2788,2420,115.2,5128,2756,2372,116.2
23050, 남동구,025002, 21세,2021,5825,3045,2780,109.5,5664,2974,2690,110.6
23050, 남동구,025003, 22세,2021,5745,2993,2752,108.8,5596,2916,2680,108.8
23050, 남동구,025004, 23세,2021,6276,3131,3145,99.6,6049,2996,3053,98.1
23050, 남동구,025005, 24세,2021,6739,3346,3393,98.6,6434,3138,3296,95.2
23050, 남동구,030,25~29세,2021,38453,20392,18061,112.9,36303,18903,17400,108.6
23050, 남동구,030001, 25세,2021,7243,3736,3507,106.5,6890,3489,3401,102.6
23050, 남동구,030002, 26세,2021,7624,4002,3622,110.5,7232,3734,3498,106.7
23050, 남동구,030003, 27세,2021,7685,4076,3609,112.9,7238,3765,3473,108.4
23050, 남동구,030004, 28세,2021,7958,4369,3589,121.7,7475,4037,3438,117.4
23050, 남동구,030005, 29세,2021,7943,4209,3734,112.7,7468,3878,3590,108
23050, 남동구,035,30~34세,2021,34612,18593,16019,116.1,31668,16574,15094,109.8
23050, 남동구,035001, 30세,2021,7469,4063,3406,119.3,6908,3687,3221,114.5
23050, 남동구,035002, 31세,2021,7167,3853,3314,116.3,6552,3411,3141,108.6
23050, 남동구,035003, 32세,2021,6745,3559,3186,111.7,6164,3169,2995,105.8
23050, 남동구,035004, 33세,2021,6686,3627,3059,118.6,6067,3209,2858,112.3
23050, 남동구,035005, 34세,2021,6545,3491,3054,114.3,5977,3098,2879,107.6
23050, 남동구,040,35~39세,2021,38033,19966,18067,110.5,35382,18142,17240,105.2
23050, 남동구,040001, 35세,2021,6679,3542,3137,112.9,6114,3169,2945,107.6
23050, 남동구,040002, 36세,2021,6882,3694,3188,115.9,6319,3289,3030,108.5
23050, 남동구,040003, 37세,2021,7226,3762,3464,108.6,6679,3398,3281,103.6
23050, 남동구,040004, 38세,2021,8203,4266,3937,108.4,7702,3901,3801,102.6
23050, 남동구,040005, 39세,2021,9043,4702,4341,108.3,8568,4385,4183,104.8
23050, 남동구,045,40~44세,2021,43708,22443,21265,105.5,41964,21278,20686,102.9
23050, 남동구,045001, 40세,2021,8945,4691,4254,110.3,8533,4411,4122,107
23050, 남동구,045002, 41세,2021,9380,4772,4608,103.6,9007,4518,4489,100.6
23050, 남동구,045003, 42세,2021,8929,4592,4337,105.9,8524,4319,4205,102.7
23050, 남동구,045004, 43세,2021,8187,4113,4074,101,7895,3929,3966,99.1
23050, 남동구,045005, 44세,2021,8267,4275,3992,107.1,8005,4101,3904,105
23050, 남동구,050,45~49세,2021,43323,22208,21115,105.2,42064,21409,20655,103.7
23050, 남동구,050001, 45세,2021,7933,4203,3730,112.7,7677,4034,3643,110.7
23050, 남동구,050002, 46세,2021,8369,4297,4072,105.5,8135,4141,3994,103.7
23050, 남동구,050003, 47세,2021,8958,4647,4311,107.8,8706,4470,4236,105.5
23050, 남동구,050004, 48세,2021,9057,4517,4540,99.5,8789,4360,4429,98.4
23050, 남동구,050005, 49세,2021,9006,4544,4462,101.8,8757,4404,4353,101.2
23050, 남동구,055,50~54세,2021,46003,22527,23476,96,44827,21863,22964,95.2
23050, 남동구,055001, 50세,2021,9496,4731,4765,99.3,9244,4586,4658,98.5
23050, 남동구,055002, 51세,2021,9221,4610,4611,100,8956,4447,4509,98.6
23050, 남동구,055003, 52세,2021,9342,4534,4808,94.3,9108,4420,4688,94.3
23050, 남동구,055004, 53세,2021,9493,4608,4885,94.3,9260,4468,4792,93.2
23050, 남동구,055005, 54세,2021,8451,4044,4407,91.8,8259,3942,4317,91.3
23050, 남동구,060,55~59세,2021,43128,21333,21795,97.9,42149,20856,21293,97.9
23050, 남동구,060001, 55세,2021,8344,4071,4273,95.3,8156,3971,4185,94.9
23050, 남동구,060002, 56세,2021,9004,4420,4584,96.4,8791,4312,4479,96.3
23050, 남동구,060003, 57세,2021,8220,4082,4138,98.6,8008,3982,4026,98.9
23050, 남동구,060004, 58세,2021,8696,4364,4332,100.7,8487,4266,4221,101.1
23050, 남동구,060005, 59세,2021,8864,4396,4468,98.4,8707,4325,4382,98.7
23050, 남동구,065,60~64세,2021,42223,20566,21657,95,41522,20214,21308,94.9
23050, 남동구,065001, 60세,2021,9612,4722,4890,96.6,9486,4663,4823,96.7
23050, 남동구,065002, 61세,2021,9404,4611,4793,96.2,9240,4529,4711,96.1
23050, 남동구,065003, 62세,2021,8115,3895,4220,92.3,7977,3819,4158,91.8
23050, 남동구,065004, 63세,2021,7793,3750,4043,92.8,7658,3688,3970,92.9
23050, 남동구,065005, 64세,2021,7299,3588,3711,96.7,7161,3515,3646,96.4
23050, 남동구,070,65~69세,2021,28338,13464,14874,90.5,27894,13293,14601,91
23050, 남동구,070001, 65세,2021,6353,3027,3326,91,6248,2989,3259,91.7
23050, 남동구,070002, 66세,2021,6651,3183,3468,91.8,6545,3137,3408,92
23050, 남동구,070003, 67세,2021,5471,2594,2877,90.2,5388,2560,2828,90.5
23050, 남동구,070004, 68세,2021,4729,2225,2504,88.9,4656,2201,2455,89.7
23050, 남동구,070005, 69세,2021,5134,2435,2699,90.2,5057,2406,2651,90.8
23050, 남동구,075,70~74세,2021,18341,8686,9655,90,18152,8612,9540,90.3
23050, 남동구,075001, 70세,2021,3352,1609,1743,92.3,3297,1583,1714,92.4
23050, 남동구,075002, 71세,2021,3815,1817,1998,90.9,3769,1797,1972,91.1
23050, 남동구,075003, 72세,2021,3831,1857,1974,94.1,3793,1845,1948,94.7
23050, 남동구,075004, 73세,2021,3668,1716,1952,87.9,3635,1705,1930,88.3
23050, 남동구,075005, 74세,2021,3675,1687,1988,84.9,3658,1682,1976,85.1
23050, 남동구,080,75~79세,2021,13260,5693,7567,75.2,13167,5669,7498,75.6
23050, 남동구,080001, 75세,2021,2809,1273,1536,82.9,2789,1265,1524,83
23050, 남동구,080002, 76세,2021,2532,1130,1402,80.6,2508,1125,1383,81.3
23050, 남동구,080003, 77세,2021,2603,1158,1445,80.1,2588,1155,1433,80.6
23050, 남동구,080004, 78세,2021,2452,974,1478,65.9,2438,971,1467,66.2
23050, 남동구,080005, 79세,2021,2864,1158,1706,67.9,2844,1153,1691,68.2
23050, 남동구,085,80~84세,2021,8971,3319,5652,58.7,8925,3308,5617,58.9
23050, 남동구,085001, 80세,2021,2169,836,1333,62.7,2159,833,1326,62.8
23050, 남동구,085002, 81세,2021,1926,735,1191,61.7,1915,732,1183,61.9
23050, 남동구,085003, 82세,2021,1843,677,1166,58.1,1840,676,1164,58.1
23050, 남동구,085004, 83세,2021,1617,567,1050,54,1603,564,1039,54.3
23050, 남동구,085005, 84세,2021,1416,504,912,55.3,1408,503,905,55.6
23050, 남동구,090,85~89세,2021,4724,1341,3383,39.6,4695,1333,3362,39.6
23050, 남동구,090001, 85세,2021,1290,395,895,44.1,1274,390,884,44.1
23050, 남동구,090002, 86세,2021,1168,350,818,42.8,1164,348,816,42.6
23050, 남동구,090003, 87세,2021,873,242,631,38.4,870,241,629,38.3
23050, 남동구,090004, 88세,2021,780,211,569,37.1,776,211,565,37.3
23050, 남동구,090005, 89세,2021,613,143,470,30.4,611,143,468,30.6
23050, 남동구,095,90~94세,2021,1815,342,1473,23.2,1811,341,1470,23.2
23050, 남동구,095001, 90세,2021,513,100,413,24.2,512,100,412,24.3
23050, 남동구,095002, 91세,2021,449,73,376,19.4,447,72,375,19.2
23050, 남동구,095003, 92세,2021,366,75,291,25.8,366,75,291,25.8
23050, 남동구,095004, 93세,2021,287,55,232,23.7,286,55,231,23.8
23050, 남동구,095005, 94세,2021,200,39,161,24.2,200,39,161,24.2
23050, 남동구,100,95~99세,2021,411,68,343,19.8,411,68,343,19.8
23050, 남동구,100001, 95세,2021,136,23,113,20.4,136,23,113,20.4
23050, 남동구,100002, 96세,2021,114,13,101,12.9,114,13,101,12.9
23050, 남동구,100003, 97세,2021,73,13,60,21.7,73,13,60,21.7
23050, 남동구,100004, 98세,2021,52,11,41,26.8,52,11,41,26.8
23050, 남동구,100005, 99세,2021,36,8,28,28.6,36,8,28,28.6
23050, 남동구,101,100세이상,2021,76,10,66,15.2,76,10,66,15.2
23050, 남동구,102,15세미만,2021,63161,32457,30704,105.7,62245,31973,30272,105.6
23050, 남동구,103,15~64세,2021,382068,194882,187186,104.1,367394,185498,181896,102
23050, 남동구,104,65세이상,2021,75936,32923,43013,76.5,75131,32634,42497,76.8
23050, 남동구,086,85세이상,2021,7026,1761,5265,33.4,6993,1752,5241,33.4
23050, 남동구,126,평균연령,2021,42.8,41.6,43.9,,42.9,41.8,44,
23050, 남동구,127,중위연령,2021,43.8,42.5,45.2,,44.2,43,45.4,
23060, 부평구,000,합계,2021,494641,244210,250431,97.5,472289,233036,239253,97.4
23060, 부평구,005,0~4세,2021,13511,7019,6492,108.1,12527,6483,6044,107.3
23060, 부평구,005001, 0세,2021,2291,1153,1138,101.3,2124,1061,1063,99.8
23060, 부평구,005002, 1세,2021,2461,1301,1160,112.2,2268,1193,1075,111
23060, 부평구,005003, 2세,2021,2764,1444,1320,109.4,2532,1336,1196,111.7
23060, 부평구,005004, 3세,2021,2908,1494,1414,105.7,2702,1375,1327,103.6
23060, 부평구,005005, 4세,2021,3087,1627,1460,111.4,2901,1518,1383,109.8
23060, 부평구,010,5~9세,2021,18326,9279,9047,102.6,17629,8932,8697,102.7
23060, 부평구,010001, 5세,2021,3589,1804,1785,101.1,3397,1706,1691,100.9
23060, 부평구,010002, 6세,2021,3637,1835,1802,101.8,3486,1760,1726,102
23060, 부평구,010003, 7세,2021,3638,1850,1788,103.5,3500,1784,1716,104
23060, 부평구,010004, 8세,2021,3519,1777,1742,102,3415,1722,1693,101.7
23060, 부평구,010005, 9세,2021,3943,2013,1930,104.3,3831,1960,1871,104.8
23060, 부평구,015,10~14세,2021,19896,10330,9566,108,19557,10161,9396,108.1
23060, 부평구,015001, 10세,2021,4006,2077,1929,107.7,3915,2028,1887,107.5
23060, 부평구,015002, 11세,2021,3763,1978,1785,110.8,3689,1939,1750,110.8
23060, 부평구,015003, 12세,2021,3854,1952,1902,102.6,3787,1922,1865,103.1
23060, 부평구,015004, 13세,2021,3980,2096,1884,111.3,3928,2070,1858,111.4
23060, 부평구,015005, 14세,2021,4293,2227,2066,107.8,4238,2202,2036,108.2
23060, 부평구,020,15~19세,2021,20570,10716,9854,108.7,20362,10610,9752,108.8
23060, 부평구,020001, 15세,2021,3893,2046,1847,110.8,3847,2021,1826,110.7
23060, 부평구,020002, 16세,2021,3870,2003,1867,107.3,3824,1981,1843,107.5
23060, 부평구,020003, 17세,2021,4263,2241,2022,110.8,4224,2221,2003,110.9
23060, 부평구,020004, 18세,2021,4365,2273,2092,108.7,4332,2257,2075,108.8
23060, 부평구,020005, 19세,2021,4179,2153,2026,106.3,4135,2130,2005,106.2
23060, 부평구,025,20~24세,2021,28366,14546,13820,105.3,27777,14295,13482,106
23060, 부평구,025001, 20세,2021,4817,2562,2255,113.6,4753,2536,2217,114.4
23060, 부평구,025002, 21세,2021,5497,2914,2583,112.8,5386,2861,2525,113.3
23060, 부평구,025003, 22세,2021,5539,2891,2648,109.2,5412,2844,2568,110.7
23060, 부평구,025004, 23세,2021,5988,2956,3032,97.5,5860,2900,2960,98
23060, 부평구,025005, 24세,2021,6525,3223,3302,97.6,6366,3154,3212,98.2
23060, 부평구,030,25~29세,2021,38019,19428,18591,104.5,36599,18769,17830,105.3
23060, 부평구,030001, 25세,2021,6885,3483,3402,102.4,6686,3386,3300,102.6
23060, 부평구,030002, 26세,2021,7416,3821,3595,106.3,7166,3706,3460,107.1
23060, 부평구,030003, 27세,2021,7792,4036,3756,107.5,7518,3913,3605,108.5
23060, 부평구,030004, 28세,2021,7961,4046,3915,103.3,7636,3887,3749,103.7
23060, 부평구,030005, 29세,2021,7965,4042,3923,103,7593,3877,3716,104.3
23060, 부평구,035,30~34세,2021,35011,18109,16902,107.1,31752,16502,15250,108.2
23060, 부평구,035001, 30세,2021,7576,3914,3662,106.9,7063,3684,3379,109
23060, 부평구,035002, 31세,2021,7162,3640,3522,103.4,6517,3333,3184,104.7
23060, 부평구,035003, 32세,2021,6923,3625,3298,109.9,6314,3324,2990,111.2
23060, 부평구,035004, 33세,2021,6633,3412,3221,105.9,5898,3026,2872,105.4
23060, 부평구,035005, 34세,2021,6717,3518,3199,110,5960,3135,2825,111
23060, 부평구,040,35~39세,2021,35087,18231,16856,108.2,32076,16603,15473,107.3
23060, 부평구,040001, 35세,2021,6687,3497,3190,109.6,5949,3109,2840,109.5
23060, 부평구,040002, 36세,2021,6490,3402,3088,110.2,5828,3058,2770,110.4
23060, 부평구,040003, 37세,2021,6811,3564,3247,109.8,6239,3251,2988,108.8
23060, 부평구,040004, 38세,2021,7267,3772,3495,107.9,6739,3477,3262,106.6
23060, 부평구,040005, 39세,2021,7832,3996,3836,104.2,7321,3708,3613,102.6
23060, 부평구,045,40~44세,2021,36937,19031,17906,106.3,35184,18025,17159,105
23060, 부평구,045001, 40세,2021,7767,4048,3719,108.8,7382,3837,3545,108.2
23060, 부평구,045002, 41세,2021,7859,4063,3796,107,7505,3850,3655,105.3
23060, 부평구,045003, 42세,2021,7352,3842,3510,109.5,6960,3603,3357,107.3
23060, 부평구,045004, 43세,2021,6820,3470,3350,103.6,6489,3281,3208,102.3
23060, 부평구,045005, 44세,2021,7139,3608,3531,102.2,6848,3454,3394,101.8
23060, 부평구,050,45~49세,2021,38788,19330,19458,99.3,37216,18497,18719,98.8
23060, 부평구,050001, 45세,2021,6689,3397,3292,103.2,6401,3242,3159,102.6
23060, 부평구,050002, 46세,2021,7263,3557,3706,96,6980,3406,3574,95.3
23060, 부평구,050003, 47세,2021,8118,4092,4026,101.6,7818,3925,3893,100.8
23060, 부평구,050004, 48세,2021,8292,4139,4153,99.7,7947,3965,3982,99.6
23060, 부평구,050005, 49세,2021,8426,4145,4281,96.8,8070,3959,4111,96.3
23060, 부평구,055,50~54세,2021,44937,21533,23404,92,42986,20547,22439,91.6
23060, 부평구,055001, 50세,2021,8913,4377,4536,96.5,8522,4179,4343,96.2
23060, 부평구,055002, 51세,2021,8949,4361,4588,95.1,8530,4134,4396,94
23060, 부평구,055003, 52세,2021,9189,4402,4787,92,8781,4212,4569,92.2
23060, 부평구,055004, 53세,2021,9349,4309,5040,85.5,8919,4097,4822,85
23060, 부평구,055005, 54세,2021,8537,4084,4453,91.7,8234,3925,4309,91.1
23060, 부평구,060,55~59세,2021,45112,22142,22970,96.4,42715,20977,21738,96.5
23060, 부평구,060001, 55세,2021,8731,4303,4428,97.2,8325,4111,4214,97.6
23060, 부평구,060002, 56세,2021,9167,4415,4752,92.9,8691,4184,4507,92.8
23060, 부평구,060003, 57세,2021,8901,4384,4517,97.1,8361,4118,4243,97.1
23060, 부평구,060004, 58세,2021,9134,4530,4604,98.4,8601,4270,4331,98.6
23060, 부평구,060005, 59세,2021,9179,4510,4669,96.6,8737,4294,4443,96.6
23060, 부평구,065,60~64세,2021,43315,21236,22079,96.2,41282,20257,21025,96.3
23060, 부평구,065001, 60세,2021,9568,4773,4795,99.5,9280,4653,4627,100.6
23060, 부평구,065002, 61세,2021,9761,4757,5004,95.1,9263,4538,4725,96
23060, 부평구,065003, 62세,2021,8462,4136,4326,95.6,8058,3925,4133,95
23060, 부평구,065004, 63세,2021,7872,3857,4015,96.1,7428,3631,3797,95.6
23060, 부평구,065005, 64세,2021,7652,3713,3939,94.3,7253,3510,3743,93.8
23060, 부평구,070,65~69세,2021,28461,13585,14876,91.3,27178,12966,14212,91.2
23060, 부평구,070001, 65세,2021,6565,3175,3390,93.7,6248,3017,3231,93.4
23060, 부평구,070002, 66세,2021,6712,3197,3515,91,6415,3056,3359,91
23060, 부평구,070003, 67세,2021,5502,2552,2950,86.5,5215,2418,2797,86.4
23060, 부평구,070004, 68세,2021,4687,2262,2425,93.3,4475,2157,2318,93.1
23060, 부평구,070005, 69세,2021,4995,2399,2596,92.4,4825,2318,2507,92.5
23060, 부평구,075,70~74세,2021,18408,8622,9786,88.1,17947,8427,9520,88.5
23060, 부평구,075001, 70세,2021,3576,1713,1863,91.9,3429,1635,1794,91.1
23060, 부평구,075002, 71세,2021,3770,1792,1978,90.6,3658,1751,1907,91.8
23060, 부평구,075003, 72세,2021,3840,1795,2045,87.8,3753,1759,1994,88.2
23060, 부평구,075004, 73세,2021,3675,1751,1924,91,3610,1728,1882,91.8
23060, 부평구,075005, 74세,2021,3547,1571,1976,79.5,3497,1554,1943,80
23060, 부평구,080,75~79세,2021,13307,5721,7586,75.4,13140,5679,7461,76.1
23060, 부평구,080001, 75세,2021,2765,1240,1525,81.3,2728,1230,1498,82.1
23060, 부평구,080002, 76세,2021,2495,1070,1425,75.1,2462,1060,1402,75.6
23060, 부평구,080003, 77세,2021,2557,1120,1437,77.9,2515,1112,1403,79.3
23060, 부평구,080004, 78세,2021,2624,1118,1506,74.2,2600,1114,1486,75
23060, 부평구,080005, 79세,2021,2866,1173,1693,69.3,2835,1163,1672,69.6
23060, 부평구,085,80~84세,2021,9507,3414,6093,56,9357,3378,5979,56.5
23060, 부평구,085001, 80세,2021,2290,885,1405,63,2255,878,1377,63.8
23060, 부평구,085002, 81세,2021,1997,763,1234,61.8,1958,753,1205,62.5
23060, 부평구,085003, 82세,2021,1990,718,1272,56.4,1963,713,1250,57
23060, 부평구,085004, 83세,2021,1723,583,1140,51.1,1692,576,1116,51.6
23060, 부평구,085005, 84세,2021,1507,465,1042,44.6,1489,458,1031,44.4
23060, 부평구,090,85~89세,2021,5006,1513,3493,43.3,4946,1505,3441,43.7
23060, 부평구,090001, 85세,2021,1345,443,902,49.1,1325,439,886,49.5
23060, 부평구,090002, 86세,2021,1231,397,834,47.6,1216,394,822,47.9
23060, 부평구,090003, 87세,2021,930,266,664,40.1,919,266,653,40.7
23060, 부평구,090004, 88세,2021,838,244,594,41.1,827,243,584,41.6
23060, 부평구,090005, 89세,2021,662,163,499,32.7,659,163,496,32.9
23060, 부평구,095,90~94세,2021,1682,362,1320,27.4,1669,360,1309,27.5
23060, 부평구,095001, 90세,2021,475,131,344,38.1,470,130,340,38.2
23060, 부평구,095002, 91세,2021,447,85,362,23.5,441,85,356,23.9
23060, 부평구,095003, 92세,2021,323,68,255,26.7,322,67,255,26.3
23060, 부평구,095004, 93세,2021,245,42,203,20.7,245,42,203,20.7
23060, 부평구,095005, 94세,2021,192,36,156,23.1,191,36,155,23.2
23060, 부평구,100,95~99세,2021,334,56,278,20.1,329,56,273,20.5
23060, 부평구,100001, 95세,2021,107,15,92,16.3,105,15,90,16.7
23060, 부평구,100002, 96세,2021,90,12,78,15.4,89,12,77,15.6
23060, 부평구,100003, 97세,2021,50,6,44,13.6,48,6,42,14.3
23060, 부평구,100004, 98세,2021,47,15,32,46.9,47,15,32,46.9
23060, 부평구,100005, 99세,2021,40,8,32,25,40,8,32,25
23060, 부평구,101,100세이상,2021,61,7,54,13,61,7,54,13
23060, 부평구,102,15세미만,2021,51733,26628,25105,106.1,49713,25576,24137,106
23060, 부평구,103,15~64세,2021,366142,184302,181840,101.4,347949,175082,172867,101.3
23060, 부평구,104,65세이상,2021,76766,33280,43486,76.5,74627,32378,42249,76.6
23060, 부평구,086,85세이상,2021,7083,1938,5145,37.7,7005,1928,5077,38
23060, 부평구,126,평균연령,2021,43.9,42.7,45,,43.9,42.8,45,
23060, 부평구,127,중위연령,2021,45.2,43.7,46.8,,45.4,43.9,46.9,
23070, 계양구,000,합계,2021,290967,143944,147023,97.9,286332,141989,144343,98.4
23070, 계양구,005,0~4세,2021,7076,3633,3443,105.5,6960,3570,3390,105.3
23070, 계양구,005001, 0세,2021,1264,617,647,95.4,1241,607,634,95.7
23070, 계양구,005002, 1세,2021,1296,668,628,106.4,1276,657,619,106.1
23070, 계양구,005003, 2세,2021,1456,774,682,113.5,1426,758,668,113.5
23070, 계양구,005004, 3세,2021,1473,753,720,104.6,1452,736,716,102.8
23070, 계양구,005005, 4세,2021,1587,821,766,107.2,1565,812,753,107.8
23070, 계양구,010,5~9세,2021,10073,5103,4970,102.7,9992,5071,4921,103
23070, 계양구,010001, 5세,2021,1876,935,941,99.4,1856,929,927,100.2
23070, 계양구,010002, 6세,2021,1968,983,985,99.8,1950,977,973,100.4
23070, 계양구,010003, 7세,2021,1978,1015,963,105.4,1958,1005,953,105.5
23070, 계양구,010004, 8세,2021,2026,1055,971,108.7,2014,1051,963,109.1
23070, 계양구,010005, 9세,2021,2225,1115,1110,100.5,2214,1109,1105,100.4
23070, 계양구,015,10~14세,2021,11939,6060,5879,103.1,11907,6047,5860,103.2
23070, 계양구,015001, 10세,2021,2339,1165,1174,99.2,2331,1161,1170,99.2
23070, 계양구,015002, 11세,2021,2268,1135,1133,100.2,2262,1133,1129,100.4
23070, 계양구,015003, 12세,2021,2271,1161,1110,104.6,2266,1158,1108,104.5
23070, 계양구,015004, 13세,2021,2451,1265,1186,106.7,2444,1262,1182,106.8
23070, 계양구,015005, 14세,2021,2610,1334,1276,104.5,2604,1333,1271,104.9
23070, 계양구,020,15~19세,2021,12740,6456,6284,102.7,12670,6430,6240,103
23070, 계양구,020001, 15세,2021,2386,1224,1162,105.3,2379,1218,1161,104.9
23070, 계양구,020002, 16세,2021,2279,1158,1121,103.3,2271,1154,1117,103.3
23070, 계양구,020003, 17세,2021,2605,1332,1273,104.6,2595,1330,1265,105.1
23070, 계양구,020004, 18세,2021,2747,1368,1379,99.2,2734,1366,1368,99.9
23070, 계양구,020005, 19세,2021,2723,1374,1349,101.9,2691,1362,1329,102.5
23070, 계양구,025,20~24세,2021,18436,9511,8925,106.6,18114,9411,8703,108.1
23070, 계양구,025001, 20세,2021,3350,1724,1626,106,3312,1714,1598,107.3
23070, 계양구,025002, 21세,2021,3631,1940,1691,114.7,3573,1921,1652,116.3
23070, 계양구,025003, 22세,2021,3653,1877,1776,105.7,3590,1857,1733,107.2
23070, 계양구,025004, 23세,2021,3709,1901,1808,105.1,3635,1880,1755,107.1
23070, 계양구,025005, 24세,2021,4093,2069,2024,102.2,4004,2039,1965,103.8
23070, 계양구,030,25~29세,2021,22895,11846,11049,107.2,22284,11600,10684,108.6
23070, 계양구,030001, 25세,2021,4376,2237,2139,104.6,4259,2196,2063,106.4
23070, 계양구,030002, 26세,2021,4527,2386,2141,111.4,4418,2346,2072,113.2
23070, 계양구,030003, 27세,2021,4688,2461,2227,110.5,4568,2417,2151,112.4
23070, 계양구,030004, 28세,2021,4654,2407,2247,107.1,4534,2350,2184,107.6
23070, 계양구,030005, 29세,2021,4650,2355,2295,102.6,4505,2291,2214,103.5
23070, 계양구,035,30~34세,2021,18801,9769,9032,108.2,18104,9469,8635,109.7
23070, 계양구,035001, 30세,2021,4298,2236,2062,108.4,4165,2171,1994,108.9
23070, 계양구,035002, 31세,2021,4002,2074,1928,107.6,3865,2027,1838,110.3
23070, 계양구,035003, 32세,2021,3687,1944,1743,111.5,3553,1890,1663,113.7
23070, 계양구,035004, 33세,2021,3472,1805,1667,108.3,3314,1745,1569,111.2
23070, 계양구,035005, 34세,2021,3342,1710,1632,104.8,3207,1636,1571,104.1
23070, 계양구,040,35~39세,2021,18637,9732,8905,109.3,18003,9436,8567,110.1
23070, 계양구,040001, 35세,2021,3553,1917,1636,117.2,3400,1835,1565,117.3
23070, 계양구,040002, 36세,2021,3506,1819,1687,107.8,3371,1764,1607,109.8
23070, 계양구,040003, 37세,2021,3482,1792,1690,106,3364,1744,1620,107.7
23070, 계양구,040004, 38세,2021,3955,2024,1931,104.8,3840,1970,1870,105.3
23070, 계양구,040005, 39세,2021,4141,2180,1961,111.2,4028,2123,1905,111.4
23070, 계양구,045,40~44세,2021,20559,10364,10195,101.7,20159,10192,9967,102.3
23070, 계양구,045001, 40세,2021,4215,2184,2031,107.5,4132,2143,1989,107.7
23070, 계양구,045002, 41세,2021,4388,2160,2228,96.9,4293,2121,2172,97.7
23070, 계양구,045003, 42세,2021,4142,2084,2058,101.3,4059,2052,2007,102.2
23070, 계양구,045004, 43세,2021,3819,1918,1901,100.9,3732,1879,1853,101.4
23070, 계양구,045005, 44세,2021,3995,2018,1977,102.1,3943,1997,1946,102.6
23070, 계양구,050,45~49세,2021,23249,11448,11801,97,22876,11275,11601,97.2
23070, 계양구,050001, 45세,2021,3941,1962,1979,99.1,3875,1931,1944,99.3
23070, 계양구,050002, 46세,2021,4349,2092,2257,92.7,4287,2067,2220,93.1
23070, 계양구,050003, 47세,2021,4849,2470,2379,103.8,4766,2434,2332,104.4
23070, 계양구,050004, 48세,2021,5070,2448,2622,93.4,4981,2402,2579,93.1
23070, 계양구,050005, 49세,2021,5040,2476,2564,96.6,4967,2441,2526,96.6
23070, 계양구,055,50~54세,2021,28866,13682,15184,90.1,28490,13528,14962,90.4
23070, 계양구,055001, 50세,2021,5576,2667,2909,91.7,5482,2629,2853,92.1
23070, 계양구,055002, 51세,2021,5553,2698,2855,94.5,5493,2677,2816,95.1
23070, 계양구,055003, 52세,2021,5936,2811,3125,90,5845,2776,3069,90.5
23070, 계양구,055004, 53세,2021,6080,2831,3249,87.1,6001,2794,3207,87.1
23070, 계양구,055005, 54세,2021,5721,2675,3046,87.8,5669,2652,3017,87.9
23070, 계양구,060,55~59세,2021,29865,14619,15246,95.9,29517,14481,15036,96.3
23070, 계양구,060001, 55세,2021,5734,2781,2953,94.2,5667,2760,2907,94.9
23070, 계양구,060002, 56세,2021,5987,2928,3059,95.7,5923,2906,3017,96.3
23070, 계양구,060003, 57세,2021,5658,2702,2956,91.4,5584,2670,2914,91.6
23070, 계양구,060004, 58세,2021,6185,3106,3079,100.9,6099,3068,3031,101.2
23070, 계양구,060005, 59세,2021,6301,3102,3199,97,6244,3077,3167,97.2
23070, 계양구,065,60~64세,2021,27203,13840,13363,103.6,26937,13730,13207,104
23070, 계양구,065001, 60세,2021,6566,3236,3330,97.2,6518,3217,3301,97.5
23070, 계양구,065002, 61세,2021,6237,3117,3120,99.9,6168,3090,3078,100.4
23070, 계양구,065003, 62세,2021,5218,2667,2551,104.5,5173,2646,2527,104.7
23070, 계양구,065004, 63세,2021,4783,2495,2288,109,4725,2468,2257,109.3
23070, 계양구,065005, 64세,2021,4399,2325,2074,112.1,4353,2309,2044,113
23070, 계양구,070,65~69세,2021,15593,7860,7733,101.6,15435,7783,7652,101.7
23070, 계양구,070001, 65세,2021,3796,1909,1887,101.2,3757,1894,1863,101.7
23070, 계양구,070002, 66세,2021,3735,1854,1881,98.6,3709,1842,1867,98.7
23070, 계양구,070003, 67세,2021,2920,1538,1382,111.3,2888,1517,1371,110.6
23070, 계양구,070004, 68세,2021,2455,1224,1231,99.4,2422,1211,1211,100
23070, 계양구,070005, 69세,2021,2687,1335,1352,98.7,2659,1319,1340,98.4
23070, 계양구,075,70~74세,2021,9134,4472,4662,95.9,9050,4441,4609,96.4
23070, 계양구,075001, 70세,2021,1702,853,849,100.5,1687,849,838,101.3
23070, 계양구,075002, 71세,2021,1871,920,951,96.7,1848,912,936,97.4
23070, 계양구,075003, 72세,2021,1897,931,966,96.4,1875,924,951,97.2
23070, 계양구,075004, 73세,2021,1842,934,908,102.9,1831,928,903,102.8
23070, 계양구,075005, 74세,2021,1822,834,988,84.4,1809,828,981,84.4
23070, 계양구,080,75~79세,2021,6653,2730,3923,69.6,6621,2715,3906,69.5
23070, 계양구,080001, 75세,2021,1333,595,738,80.6,1322,589,733,80.4
23070, 계양구,080002, 76세,2021,1297,537,760,70.7,1291,535,756,70.8
23070, 계양구,080003, 77세,2021,1247,516,731,70.6,1240,511,729,70.1
23070, 계양구,080004, 78세,2021,1293,520,773,67.3,1288,519,769,67.5
23070, 계양구,080005, 79세,2021,1483,562,921,61,1480,561,919,61
23070, 계양구,085,80~84세,2021,5134,1803,3331,54.1,5110,1797,3313,54.2
23070, 계양구,085001, 80세,2021,1232,451,781,57.7,1228,450,778,57.8
23070, 계양구,085002, 81세,2021,1081,382,699,54.6,1078,381,697,54.7
23070, 계양구,085003, 82세,2021,1063,378,685,55.2,1058,377,681,55.4
23070, 계양구,085004, 83세,2021,945,325,620,52.4,941,325,616,52.8
23070, 계양구,085005, 84세,2021,813,267,546,48.9,805,264,541,48.8
23070, 계양구,090,85~89세,2021,2849,762,2087,36.5,2840,760,2080,36.5
23070, 계양구,090001, 85세,2021,787,217,570,38.1,785,217,568,38.2
23070, 계양구,090002, 86세,2021,702,213,489,43.6,701,212,489,43.4
23070, 계양구,090003, 87세,2021,550,138,412,33.5,547,138,409,33.7
23070, 계양구,090004, 88세,2021,461,115,346,33.2,459,115,344,33.4
23070, 계양구,090005, 89세,2021,349,79,270,29.3,348,78,270,28.9
23070, 계양구,095,90~94세,2021,1010,201,809,24.8,1009,201,808,24.9
23070, 계양구,095001, 90세,2021,278,64,214,29.9,278,64,214,29.9
23070, 계양구,095002, 91세,2021,261,45,216,20.8,261,45,216,20.8
23070, 계양구,095003, 92세,2021,199,35,164,21.3,199,35,164,21.3
23070, 계양구,095004, 93세,2021,158,35,123,28.5,158,35,123,28.5
23070, 계양구,095005, 94세,2021,114,22,92,23.9,113,22,91,24.2
23070, 계양구,100,95~99세,2021,221,47,174,27,220,46,174,26.4
23070, 계양구,100001, 95세,2021,71,19,52,36.5,70,18,52,34.6
23070, 계양구,100002, 96세,2021,62,10,52,19.2,62,10,52,19.2
23070, 계양구,100003, 97세,2021,33,6,27,22.2,33,6,27,22.2
23070, 계양구,100004, 98세,2021,37,11,26,42.3,37,11,26,42.3
23070, 계양구,100005, 99세,2021,18,X,17,5.9,18,X,17,5.9
23070, 계양구,101,100세이상,2021,34,6,28,21.4,34,6,28,21.4
23070, 계양구,102,15세미만,2021,29088,14796,14292,103.5,28859,14688,14171,103.6
23070, 계양구,103,15~64세,2021,221251,111267,109984,101.2,217154,109552,107602,101.8
23070, 계양구,104,65세이상,2021,40628,17881,22747,78.6,40319,17749,22570,78.6
23070, 계양구,086,85세이상,2021,4114,1016,3098,32.8,4103,1013,3090,32.8
23070, 계양구,126,평균연령,2021,43.8,42.9,44.7,,43.9,42.9,44.8,
23070, 계양구,127,중위연령,2021,46.1,44.8,47.2,,46.3,44.9,47.4,
23080, 서구,000,합계,2021,551026,279909,271117,103.2,534648,269444,265204,101.6
23080, 서구,005,0~4세,2021,20562,10567,9995,105.7,20233,10402,9831,105.8
23080, 서구,005001, 0세,2021,3518,1812,1706,106.2,3467,1786,1681,106.2
23080, 서구,005002, 1세,2021,3682,1888,1794,105.2,3612,1852,1760,105.2
23080, 서구,005003, 2세,2021,4141,2121,2020,105,4074,2095,1979,105.9
23080, 서구,005004, 3세,2021,4384,2250,2134,105.4,4318,2213,2105,105.1
23080, 서구,005005, 4세,2021,4837,2496,2341,106.6,4762,2456,2306,106.5
23080, 서구,010,5~9세,2021,28685,14839,13846,107.2,28377,14687,13690,107.3
23080, 서구,010001, 5세,2021,5516,2844,2672,106.4,5448,2811,2637,106.6
23080, 서구,010002, 6세,2021,5842,3007,2835,106.1,5764,2968,2796,106.2
23080, 서구,010003, 7세,2021,5520,2870,2650,108.3,5458,2841,2617,108.6
23080, 서구,010004, 8세,2021,5644,2876,2768,103.9,5584,2849,2735,104.2
23080, 서구,010005, 9세,2021,6163,3242,2921,111,6123,3218,2905,110.8
23080, 서구,015,10~14세,2021,28819,14724,14095,104.5,28611,14607,14004,104.3
23080, 서구,015001, 10세,2021,6091,3163,2928,108,6047,3131,2916,107.4
23080, 서구,015002, 11세,2021,5743,2941,2802,105,5699,2918,2781,104.9
23080, 서구,015003, 12세,2021,5449,2796,2653,105.4,5412,2781,2631,105.7
23080, 서구,015004, 13세,2021,5666,2861,2805,102,5627,2836,2791,101.6
23080, 서구,015005, 14세,2021,5870,2963,2907,101.9,5826,2941,2885,101.9
23080, 서구,020,15~19세,2021,25671,13192,12479,105.7,25550,13127,12423,105.7
23080, 서구,020001, 15세,2021,5390,2785,2605,106.9,5368,2776,2592,107.1
23080, 서구,020002, 16세,2021,5146,2660,2486,107,5126,2654,2472,107.4
23080, 서구,020003, 17세,2021,5260,2675,2585,103.5,5241,2664,2577,103.4
23080, 서구,020004, 18세,2021,5216,2652,2564,103.4,5191,2639,2552,103.4
23080, 서구,020005, 19세,2021,4659,2420,2239,108.1,4624,2394,2230,107.4
23080, 서구,025,20~24세,2021,30668,15995,14673,109,29960,15571,14389,108.2
23080, 서구,025001, 20세,2021,5509,3021,2488,121.4,5460,3002,2458,122.1
23080, 서구,025002, 21세,2021,6090,3343,2747,121.7,6018,3318,2700,122.9
23080, 서구,025003, 22세,2021,5819,3060,2759,110.9,5696,2985,2711,110.1
23080, 서구,025004, 23세,2021,6396,3218,3178,101.3,6201,3096,3105,99.7
23080, 서구,025005, 24세,2021,6854,3353,3501,95.8,6585,3170,3415,92.8
23080, 서구,030,25~29세,2021,39364,20842,18522,112.5,37091,19189,17902,107.2
23080, 서구,030001, 25세,2021,7355,3758,3597,104.5,6982,3480,3502,99.4
23080, 서구,030002, 26세,2021,7652,4029,3623,111.2,7239,3742,3497,107
23080, 서구,030003, 27세,2021,7895,4269,3626,117.7,7478,3964,3514,112.8
23080, 서구,030004, 28세,2021,8115,4345,3770,115.3,7628,3988,3640,109.6
23080, 서구,030005, 29세,2021,8347,4441,3906,113.7,7764,4015,3749,107.1
23080, 서구,035,30~34세,2021,38737,20343,18394,110.6,35587,18113,17474,103.7
23080, 서구,035001, 30세,2021,8174,4359,3815,114.3,7586,3943,3643,108.2
23080, 서구,035002, 31세,2021,7668,4071,3597,113.2,7077,3652,3425,106.6
23080, 서구,035003, 32세,2021,7610,4005,3605,111.1,6970,3560,3410,104.4
23080, 서구,035004, 33세,2021,7600,3986,3614,110.3,6932,3521,3411,103.2
23080, 서구,035005, 34세,2021,7685,3922,3763,104.2,7022,3437,3585,95.9
23080, 서구,040,35~39세,2021,45044,23593,21451,110,42337,21648,20689,104.6
23080, 서구,040001, 35세,2021,7998,4194,3804,110.3,7393,3754,3639,103.2
23080, 서구,040002, 36세,2021,8274,4350,3924,110.9,7723,3952,3771,104.8
23080, 서구,040003, 37세,2021,8758,4510,4248,106.2,8180,4104,4076,100.7
23080, 서구,040004, 38세,2021,9686,5063,4623,109.5,9191,4711,4480,105.2
23080, 서구,040005, 39세,2021,10328,5476,4852,112.9,9850,5127,4723,108.6
23080, 서구,045,40~44세,2021,48974,25554,23420,109.1,47165,24352,22813,106.7
23080, 서구,045001, 40세,2021,10457,5553,4904,113.2,10012,5241,4771,109.9
23080, 서구,045002, 41세,2021,10574,5521,5053,109.3,10176,5260,4916,107
23080, 서구,045003, 42세,2021,9965,5222,4743,110.1,9586,4973,4613,107.8
23080, 서구,045004, 43세,2021,8872,4582,4290,106.8,8574,4391,4183,105
23080, 서구,045005, 44세,2021,9106,4676,4430,105.6,8817,4487,4330,103.6
23080, 서구,050,45~49세,2021,47882,24451,23431,104.4,46536,23650,22886,103.3
23080, 서구,050001, 45세,2021,8837,4498,4339,103.7,8554,4322,4232,102.1
23080, 서구,050002, 46세,2021,9296,4807,4489,107.1,9043,4657,4386,106.2
23080, 서구,050003, 47세,2021,10030,5114,4916,104,9756,4957,4799,103.3
23080, 서구,050004, 48세,2021,9821,4941,4880,101.3,9566,4791,4775,100.3
23080, 서구,050005, 49세,2021,9898,5091,4807,105.9,9617,4923,4694,104.9
23080, 서구,055,50~54세,2021,49702,24919,24783,100.5,48572,24276,24296,99.9
23080, 서구,055001, 50세,2021,10402,5325,5077,104.9,10177,5193,4984,104.2
23080, 서구,055002, 51세,2021,9855,4979,4876,102.1,9597,4826,4771,101.2
23080, 서구,055003, 52세,2021,10164,5029,5135,97.9,9932,4895,5037,97.2
23080, 서구,055004, 53세,2021,10120,5042,5078,99.3,9893,4923,4970,99.1
23080, 서구,055005, 54세,2021,9161,4544,4617,98.4,8973,4439,4534,97.9
23080, 서구,060,55~59세,2021,44707,22734,21973,103.5,43772,22240,21532,103.3
23080, 서구,060001, 55세,2021,9009,4582,4427,103.5,8825,4479,4346,103.1
23080, 서구,060002, 56세,2021,9470,4751,4719,100.7,9257,4630,4627,100.1
23080, 서구,060003, 57세,2021,8650,4349,4301,101.1,8463,4255,4208,101.1
23080, 서구,060004, 58세,2021,8846,4555,4291,106.2,8652,4460,4192,106.4
23080, 서구,060005, 59세,2021,8732,4497,4235,106.2,8575,4416,4159,106.2
23080, 서구,065,60~64세,2021,39485,20285,19200,105.7,38853,19998,18855,106.1
23080, 서구,065001, 60세,2021,9261,4876,4385,111.2,9146,4828,4318,111.8
23080, 서구,065002, 61세,2021,9002,4602,4400,104.6,8857,4532,4325,104.8
23080, 서구,065003, 62세,2021,7598,3942,3656,107.8,7480,3883,3597,108
23080, 서구,065004, 63세,2021,7005,3582,3423,104.6,6892,3531,3361,105.1
23080, 서구,065005, 64세,2021,6619,3283,3336,98.4,6478,3224,3254,99.1
23080, 서구,070,65~69세,2021,24420,12125,12295,98.6,24036,11960,12076,99
23080, 서구,070001, 65세,2021,5850,2968,2882,103,5757,2926,2831,103.4
23080, 서구,070002, 66세,2021,5747,2843,2904,97.9,5666,2807,2859,98.2
23080, 서구,070003, 67세,2021,4591,2253,2338,96.4,4513,2225,2288,97.2
23080, 서구,070004, 68세,2021,3975,1930,2045,94.4,3913,1905,2008,94.9
23080, 서구,070005, 69세,2021,4257,2131,2126,100.2,4187,2097,2090,100.3
23080, 서구,075,70~74세,2021,14977,7236,7741,93.5,14783,7156,7627,93.8
23080, 서구,075001, 70세,2021,2835,1380,1455,94.8,2780,1359,1421,95.6
23080, 서구,075002, 71세,2021,3151,1571,1580,99.4,3096,1548,1548,100
23080, 서구,075003, 72세,2021,3113,1520,1593,95.4,3079,1507,1572,95.9
23080, 서구,075004, 73세,2021,2952,1437,1515,94.9,2922,1423,1499,94.9
23080, 서구,075005, 74세,2021,2926,1328,1598,83.1,2906,1319,1587,83.1
23080, 서구,080,75~79세,2021,10268,4486,5782,77.6,10194,4461,5733,77.8
23080, 서구,080001, 75세,2021,2140,976,1164,83.8,2123,970,1153,84.1
23080, 서구,080002, 76세,2021,2017,906,1111,81.5,1993,896,1097,81.7
23080, 서구,080003, 77세,2021,1920,856,1064,80.5,1908,854,1054,81
23080, 서구,080004, 78세,2021,1970,833,1137,73.3,1960,831,1129,73.6
23080, 서구,080005, 79세,2021,2221,915,1306,70.1,2210,910,1300,70
23080, 서구,085,80~84세,2021,7147,2571,4576,56.2,7103,2560,4543,56.4
23080, 서구,085001, 80세,2021,1711,663,1048,63.3,1701,660,1041,63.4
23080, 서구,085002, 81세,2021,1501,557,944,59,1490,552,938,58.8
23080, 서구,085003, 82세,2021,1488,542,946,57.3,1481,539,942,57.2
23080, 서구,085004, 83세,2021,1369,473,896,52.8,1357,473,884,53.5
23080, 서구,085005, 84세,2021,1078,336,742,45.3,1074,336,738,45.5
23080, 서구,090,85~89세,2021,4016,1104,2912,37.9,3999,1101,2898,38
23080, 서구,090001, 85세,2021,1115,331,784,42.2,1107,330,777,42.5
23080, 서구,090002, 86세,2021,937,272,665,40.9,933,272,661,41.1
23080, 서구,090003, 87세,2021,751,210,541,38.8,750,210,540,38.9
23080, 서구,090004, 88세,2021,683,171,512,33.4,682,170,512,33.2
23080, 서구,090005, 89세,2021,530,120,410,29.3,527,119,408,29.2
23080, 서구,095,90~94세,2021,1521,289,1232,23.5,1514,287,1227,23.4
23080, 서구,095001, 90세,2021,410,88,322,27.3,408,88,320,27.5
23080, 서구,095002, 91세,2021,367,63,304,20.7,365,63,302,20.9
23080, 서구,095003, 92세,2021,325,65,260,25,323,64,259,24.7
23080, 서구,095004, 93세,2021,235,43,192,22.4,234,42,192,21.9
23080, 서구,095005, 94세,2021,184,30,154,19.5,184,30,154,19.5
23080, 서구,100,95~99세,2021,318,46,272,16.9,317,46,271,17
23080, 서구,100001, 95세,2021,105,17,88,19.3,104,17,87,19.5
23080, 서구,100002, 96세,2021,81,13,68,19.1,81,13,68,19.1
23080, 서구,100003, 97세,2021,54,5,49,10.2,54,5,49,10.2
23080, 서구,100004, 98세,2021,48,8,40,20,48,8,40,20
23080, 서구,100005, 99세,2021,30,X,27,11.1,30,X,27,11.1
23080, 서구,101,100세이상,2021,59,14,45,31.1,58,13,45,28.9
23080, 서구,102,15세미만,2021,78066,40130,37936,105.8,77221,39696,37525,105.8
23080, 서구,103,15~64세,2021,410234,211908,198326,106.8,395423,202164,193259,104.6
23080, 서구,104,65세이상,2021,62726,27871,34855,80,62004,27584,34420,80.1
23080, 서구,086,85세이상,2021,5914,1453,4461,32.6,5888,1447,4441,32.6
23080, 서구,126,평균연령,2021,40.7,40,41.5,,40.8,40.1,41.5,
23080, 서구,127,중위연령,2021,41.7,41.1,42.5,,41.9,41.4,42.5,
23090, 미추홀구,000,합계,2021,412022,207524,204498,101.5,398997,201127,197870,101.6
23090, 미추홀구,005,0~4세,2021,11620,5971,5649,105.7,11154,5723,5431,105.4
23090, 미추홀구,005001, 0세,2021,1947,998,949,105.2,1878,960,918,104.6
23090, 미추홀구,005002, 1세,2021,2234,1150,1084,106.1,2125,1085,1040,104.3
23090, 미추홀구,005003, 2세,2021,2284,1172,1112,105.4,2190,1127,1063,106
23090, 미추홀구,005004, 3세,2021,2437,1237,1200,103.1,2334,1187,1147,103.5
23090, 미추홀구,005005, 4세,2021,2718,1414,1304,108.4,2627,1364,1263,108
23090, 미추홀구,010,5~9세,2021,15032,7662,7370,104,14706,7499,7207,104.1
23090, 미추홀구,010001, 5세,2021,2878,1444,1434,100.7,2785,1400,1385,101.1
23090, 미추홀구,010002, 6세,2021,3068,1580,1488,106.2,3005,1552,1453,106.8
23090, 미추홀구,010003, 7세,2021,2879,1436,1443,99.5,2820,1403,1417,99
23090, 미추홀구,010004, 8세,2021,2973,1537,1436,107,2915,1512,1403,107.8
23090, 미추홀구,010005, 9세,2021,3234,1665,1569,106.1,3181,1632,1549,105.4
23090, 미추홀구,015,10~14세,2021,15200,7891,7309,108,15032,7796,7236,107.7
23090, 미추홀구,015001, 10세,2021,3171,1643,1528,107.5,3132,1624,1508,107.7
23090, 미추홀구,015002, 11세,2021,2994,1528,1466,104.2,2953,1505,1448,103.9
23090, 미추홀구,015003, 12세,2021,2883,1507,1376,109.5,2856,1487,1369,108.6
23090, 미추홀구,015004, 13세,2021,3045,1549,1496,103.5,3019,1534,1485,103.3
23090, 미추홀구,015005, 14세,2021,3107,1664,1443,115.3,3072,1646,1426,115.4
23090, 미추홀구,020,15~19세,2021,17094,8898,8196,108.6,16732,8731,8001,109.1
23090, 미추홀구,020001, 15세,2021,2822,1450,1372,105.7,2794,1431,1363,105
23090, 미추홀구,020002, 16세,2021,2910,1491,1419,105.1,2880,1476,1404,105.1
23090, 미추홀구,020003, 17세,2021,3206,1694,1512,112,3175,1680,1495,112.4
23090, 미추홀구,020004, 18세,2021,3634,1945,1689,115.2,3550,1907,1643,116.1
23090, 미추홀구,020005, 19세,2021,4522,2318,2204,105.2,4333,2237,2096,106.7
23090, 미추홀구,025,20~24세,2021,28722,15077,13645,110.5,27129,14280,12849,111.1
23090, 미추홀구,025001, 20세,2021,4846,2305,2541,90.7,4528,2163,2365,91.5
23090, 미추홀구,025002, 21세,2021,5634,2844,2790,101.9,5250,2661,2589,102.8
23090, 미추홀구,025003, 22세,2021,5815,3180,2635,120.7,5495,3000,2495,120.2
23090, 미추홀구,025004, 23세,2021,5992,3257,2735,119.1,5699,3103,2596,119.5
23090, 미추홀구,025005, 24세,2021,6435,3491,2944,118.6,6157,3353,2804,119.6
23090, 미추홀구,030,25~29세,2021,32321,17411,14910,116.8,30950,16751,14199,118
23090, 미추홀구,030001, 25세,2021,6516,3546,2970,119.4,6236,3404,2832,120.2
23090, 미추홀구,030002, 26세,2021,6412,3459,2953,117.1,6143,3317,2826,117.4
23090, 미추홀구,030003, 27세,2021,6357,3384,2973,113.8,6122,3294,2828,116.5
23090, 미추홀구,030004, 28세,2021,6461,3481,2980,116.8,6177,3339,2838,117.7
23090, 미추홀구,030005, 29세,2021,6575,3541,3034,116.7,6272,3397,2875,118.2
23090, 미추홀구,035,30~34세,2021,28009,15137,12872,117.6,26173,14205,11968,118.7
23090, 미추홀구,035001, 30세,2021,6176,3344,2832,118.1,5852,3195,2657,120.2
23090, 미추홀구,035002, 31세,2021,5847,3188,2659,119.9,5463,2997,2466,121.5
23090, 미추홀구,035003, 32세,2021,5541,3008,2533,118.8,5179,2814,2365,119
23090, 미추홀구,035004, 33세,2021,5219,2783,2436,114.2,4848,2595,2253,115.2
23090, 미추홀구,035005, 34세,2021,5226,2814,2412,116.7,4831,2604,2227,116.9
23090, 미추홀구,040,35~39세,2021,29078,15610,13468,115.9,27475,14782,12693,116.5
23090, 미추홀구,040001, 35세,2021,5274,2844,2430,117,4923,2676,2247,119.1
23090, 미추홀구,040002, 36세,2021,5381,2913,2468,118,5046,2736,2310,118.4
23090, 미추홀구,040003, 37세,2021,5605,3028,2577,117.5,5317,2882,2435,118.4
23090, 미추홀구,040004, 38세,2021,6137,3222,2915,110.5,5819,3052,2767,110.3
23090, 미추홀구,040005, 39세,2021,6681,3603,3078,117.1,6370,3436,2934,117.1
23090, 미추홀구,045,40~44세,2021,31296,16699,14597,114.4,30180,16110,14070,114.5
23090, 미추홀구,045001, 40세,2021,6729,3641,3088,117.9,6475,3499,2976,117.6
23090, 미추홀구,045002, 41세,2021,6720,3572,3148,113.5,6489,3449,3040,113.5
23090, 미추홀구,045003, 42세,2021,6425,3496,2929,119.4,6200,3381,2819,119.9
23090, 미추홀구,045004, 43세,2021,5728,2997,2731,109.7,5523,2898,2625,110.4
23090, 미추홀구,045005, 44세,2021,5694,2993,2701,110.8,5493,2883,2610,110.5
23090, 미추홀구,050,45~49세,2021,31433,16442,14991,109.7,30590,16005,14585,109.7
23090, 미추홀구,050001, 45세,2021,5541,2854,2687,106.2,5368,2771,2597,106.7
23090, 미추홀구,050002, 46세,2021,5998,3215,2783,115.5,5836,3126,2710,115.4
23090, 미추홀구,050003, 47세,2021,6423,3385,3038,111.4,6257,3299,2958,111.5
23090, 미추홀구,050004, 48세,2021,6712,3461,3251,106.5,6538,3365,3173,106.1
23090, 미추홀구,050005, 49세,2021,6759,3527,3232,109.1,6591,3444,3147,109.4
23090, 미추홀구,055,50~54세,2021,34007,17158,16849,101.8,33107,16720,16387,102
23090, 미추홀구,055001, 50세,2021,7062,3614,3448,104.8,6865,3514,3351,104.9
23090, 미추홀구,055002, 51세,2021,6870,3462,3408,101.6,6664,3357,3307,101.5
23090, 미추홀구,055003, 52세,2021,6947,3564,3383,105.4,6770,3485,3285,106.1
23090, 미추홀구,055004, 53세,2021,6876,3416,3460,98.7,6686,3325,3361,98.9
23090, 미추홀구,055005, 54세,2021,6252,3102,3150,98.5,6122,3039,3083,98.6
23090, 미추홀구,060,55~59세,2021,32575,16142,16433,98.2,31650,15733,15917,98.8
23090, 미추홀구,060001, 55세,2021,6184,3094,3090,100.1,6019,3028,2991,101.2
23090, 미추홀구,060002, 56세,2021,6616,3237,3379,95.8,6435,3155,3280,96.2
23090, 미추홀구,060003, 57세,2021,6253,3123,3130,99.8,6062,3037,3025,100.4
23090, 미추홀구,060004, 58세,2021,6733,3387,3346,101.2,6515,3286,3229,101.8
23090, 미추홀구,060005, 59세,2021,6789,3301,3488,94.6,6619,3227,3392,95.1
23090, 미추홀구,065,60~64세,2021,33756,16234,17522,92.6,33075,15936,17139,93
23090, 미추홀구,065001, 60세,2021,7251,3471,3780,91.8,7155,3435,3720,92.3
23090, 미추홀구,065002, 61세,2021,7268,3511,3757,93.5,7102,3441,3661,94
23090, 미추홀구,065003, 62세,2021,6728,3249,3479,93.4,6598,3191,3407,93.7
23090, 미추홀구,065004, 63세,2021,6348,3039,3309,91.8,6219,2978,3241,91.9
23090, 미추홀구,065005, 64세,2021,6161,2964,3197,92.7,6001,2891,3110,93
23090, 미추홀구,070,65~69세,2021,24856,11659,13197,88.3,24385,11452,12933,88.5
23090, 미추홀구,070001, 65세,2021,5769,2742,3027,90.6,5643,2682,2961,90.6
23090, 미추홀구,070002, 66세,2021,5748,2726,3022,90.2,5633,2678,2955,90.6
23090, 미추홀구,070003, 67세,2021,4741,2170,2571,84.4,4654,2133,2521,84.6
23090, 미추홀구,070004, 68세,2021,4091,1927,2164,89,4016,1889,2127,88.8
23090, 미추홀구,070005, 69세,2021,4507,2094,2413,86.8,4439,2070,2369,87.4
23090, 미추홀구,075,70~74세,2021,17655,8214,9441,87,17466,8129,9337,87.1
23090, 미추홀구,075001, 70세,2021,3069,1443,1626,88.7,3016,1420,1596,89
23090, 미추홀구,075002, 71세,2021,3627,1702,1925,88.4,3585,1685,1900,88.7
23090, 미추홀구,075003, 72세,2021,3759,1734,2025,85.6,3713,1709,2004,85.3
23090, 미추홀구,075004, 73세,2021,3571,1659,1912,86.8,3551,1651,1900,86.9
23090, 미추홀구,075005, 74세,2021,3629,1676,1953,85.8,3601,1664,1937,85.9
23090, 미추홀구,080,75~79세,2021,13492,5894,7598,77.6,13408,5871,7537,77.9
23090, 미추홀구,080001, 75세,2021,2792,1278,1514,84.4,2767,1271,1496,85
23090, 미추홀구,080002, 76세,2021,2639,1172,1467,79.9,2622,1166,1456,80.1
23090, 미추홀구,080003, 77세,2021,2550,1101,1449,76,2534,1098,1436,76.5
23090, 미추홀구,080004, 78세,2021,2597,1107,1490,74.3,2580,1105,1475,74.9
23090, 미추홀구,080005, 79세,2021,2914,1236,1678,73.7,2905,1231,1674,73.5
23090, 미추홀구,085,80~84세,2021,9274,3595,5679,63.3,9221,3582,5639,63.5
23090, 미추홀구,085001, 80세,2021,2250,937,1313,71.4,2236,931,1305,71.3
23090, 미추홀구,085002, 81세,2021,2010,776,1234,62.9,2000,776,1224,63.4
23090, 미추홀구,085003, 82세,2021,1899,739,1160,63.7,1886,736,1150,64
23090, 미추홀구,085004, 83세,2021,1723,650,1073,60.6,1714,649,1065,60.9
23090, 미추홀구,085005, 84세,2021,1392,493,899,54.8,1385,490,895,54.7
23090, 미추홀구,090,85~89세,2021,4564,1381,3183,43.4,4538,1375,3163,43.5
23090, 미추홀구,090001, 85세,2021,1215,434,781,55.6,1209,432,777,55.6
23090, 미추홀구,090002, 86세,2021,1120,355,765,46.4,1110,352,758,46.4
23090, 미추홀구,090003, 87세,2021,916,260,656,39.6,909,259,650,39.8
23090, 미추홀구,090004, 88세,2021,710,177,533,33.2,709,177,532,33.3
23090, 미추홀구,090005, 89세,2021,603,155,448,34.6,601,155,446,34.8
23090, 미추홀구,095,90~94세,2021,1612,367,1245,29.5,1602,366,1236,29.6
23090, 미추홀구,095001, 90세,2021,438,106,332,31.9,437,106,331,32
23090, 미추홀구,095002, 91세,2021,396,84,312,26.9,390,84,306,27.5
23090, 미추홀구,095003, 92세,2021,344,84,260,32.3,341,83,258,32.2
23090, 미추홀구,095004, 93세,2021,248,55,193,28.5,248,55,193,28.5
23090, 미추홀구,095005, 94세,2021,186,38,148,25.7,186,38,148,25.7
23090, 미추홀구,100,95~99세,2021,368,70,298,23.5,366,69,297,23.2
23090, 미추홀구,100001, 95세,2021,127,23,104,22.1,126,23,103,22.3
23090, 미추홀구,100002, 96세,2021,93,13,80,16.3,93,13,80,16.3
23090, 미추홀구,100003, 97세,2021,59,14,45,31.1,59,14,45,31.1
23090, 미추홀구,100004, 98세,2021,59,15,44,34.1,59,15,44,34.1
23090, 미추홀구,100005, 99세,2021,30,5,25,20,29,X,25,16
23090, 미추홀구,101,100세이상,2021,58,12,46,26.1,58,12,46,26.1
23090, 미추홀구,102,15세미만,2021,41852,21524,20328,105.9,40892,21018,19874,105.8
23090, 미추홀구,103,15~64세,2021,298291,154808,143483,107.9,287061,149253,137808,108.3
23090, 미추홀구,104,65세이상,2021,71879,31192,40687,76.7,71044,30856,40188,76.8
23090, 미추홀구,086,85세이상,2021,6602,1830,4772,38.3,6564,1822,4742,38.4
23090, 미추홀구,126,평균연령,2021,44,42.7,45.3,,44.2,42.8,45.5,
23090, 미추홀구,127,중위연령,2021,44.6,42.8,46.6,,45,43.2,47,
23310, 강화군,000,합계,2021,65834,32927,32907,100.1,64759,32279,32480,99.4
23310, 강화군,005,0~4세,2021,1310,690,620,111.3,1308,688,620,111
23310, 강화군,005001, 0세,2021,269,129,140,92.1,269,129,140,92.1
23310, 강화군,005002, 1세,2021,297,169,128,132,297,169,128,132
23310, 강화군,005003, 2세,2021,250,134,116,115.5,250,134,116,115.5
23310, 강화군,005004, 3세,2021,248,128,120,106.7,246,126,120,105
23310, 강화군,005005, 4세,2021,246,130,116,112.1,246,130,116,112.1
23310, 강화군,010,5~9세,2021,1744,920,824,111.7,1737,915,822,111.3
23310, 강화군,010001, 5세,2021,295,159,136,116.9,293,158,135,117
23310, 강화군,010002, 6세,2021,335,179,156,114.7,334,178,156,114.1
23310, 강화군,010003, 7세,2021,353,187,166,112.7,351,185,166,111.4
23310, 강화군,010004, 8세,2021,357,171,186,91.9,356,170,186,91.4
23310, 강화군,010005, 9세,2021,404,224,180,124.4,403,224,179,125.1
23310, 강화군,015,10~14세,2021,2101,1091,1010,108,2096,1088,1008,107.9
23310, 강화군,015001, 10세,2021,402,209,193,108.3,401,208,193,107.8
23310, 강화군,015002, 11세,2021,414,216,198,109.1,413,216,197,109.6
23310, 강화군,015003, 12세,2021,417,231,186,124.2,415,230,185,124.3
23310, 강화군,015004, 13세,2021,457,213,244,87.3,456,212,244,86.9
23310, 강화군,015005, 14세,2021,411,222,189,117.5,411,222,189,117.5
23310, 강화군,020,15~19세,2021,2212,1177,1035,113.7,2202,1171,1031,113.6
23310, 강화군,020001, 15세,2021,425,222,203,109.4,423,221,202,109.4
23310, 강화군,020002, 16세,2021,446,237,209,113.4,445,236,209,112.9
23310, 강화군,020003, 17세,2021,541,296,245,120.8,538,294,244,120.5
23310, 강화군,020004, 18세,2021,505,270,235,114.9,505,270,235,114.9
23310, 강화군,020005, 19세,2021,295,152,143,106.3,291,150,141,106.4
23310, 강화군,025,20~24세,2021,2185,1286,899,143,2114,1242,872,142.4
23310, 강화군,025001, 20세,2021,392,237,155,152.9,389,236,153,154.2
23310, 강화군,025002, 21세,2021,461,287,174,164.9,457,287,170,168.8
23310, 강화군,025003, 22세,2021,432,242,190,127.4,418,232,186,124.7
23310, 강화군,025004, 23세,2021,415,239,176,135.8,393,224,169,132.5
23310, 강화군,025005, 24세,2021,485,281,204,137.7,457,263,194,135.6
23310, 강화군,030,25~29세,2021,2495,1472,1023,143.9,2275,1315,960,137
23310, 강화군,030001, 25세,2021,468,268,200,134,428,240,188,127.7
23310, 강화군,030002, 26세,2021,509,309,200,154.5,473,285,188,151.6
23310, 강화군,030003, 27세,2021,536,326,210,155.2,494,296,198,149.5
23310, 강화군,030004, 28세,2021,471,278,193,144,421,240,181,132.6
23310, 강화군,030005, 29세,2021,511,291,220,132.3,459,254,205,123.9
23310, 강화군,035,30~34세,2021,2407,1364,1043,130.8,2201,1213,988,122.8
23310, 강화군,035001, 30세,2021,534,286,248,115.3,494,260,234,111.1
23310, 강화군,035002, 31세,2021,476,296,180,164.4,426,257,169,152.1
23310, 강화군,035003, 32세,2021,494,276,218,126.6,446,239,207,115.5
23310, 강화군,035004, 33세,2021,454,252,202,124.8,415,223,192,116.1
23310, 강화군,035005, 34세,2021,449,254,195,130.3,420,234,186,125.8
23310, 강화군,040,35~39세,2021,2653,1357,1296,104.7,2495,1260,1235,102
23310, 강화군,040001, 35세,2021,445,242,203,119.2,400,211,189,111.6
23310, 강화군,040002, 36세,2021,465,229,236,97,435,212,223,95.1
23310, 강화군,040003, 37세,2021,533,266,267,99.6,500,248,252,98.4
23310, 강화군,040004, 38세,2021,585,308,277,111.2,558,289,269,107.4
23310, 강화군,040005, 39세,2021,625,312,313,99.7,602,300,302,99.3
23310, 강화군,045,40~44세,2021,3186,1704,1482,115,3099,1649,1450,113.7
23310, 강화군,045001, 40세,2021,654,345,309,111.7,633,332,301,110.3
23310, 강화군,045002, 41세,2021,630,338,292,115.8,609,323,286,112.9
23310, 강화군,045003, 42세,2021,613,319,294,108.5,597,310,287,108
23310, 강화군,045004, 43세,2021,615,327,288,113.5,593,314,279,112.5
23310, 강화군,045005, 44세,2021,674,375,299,125.4,667,370,297,124.6
23310, 강화군,050,45~49세,2021,3886,2105,1781,118.2,3812,2068,1744,118.6
23310, 강화군,050001, 45세,2021,656,341,315,108.3,645,334,311,107.4
23310, 강화군,050002, 46세,2021,739,409,330,123.9,720,399,321,124.3
23310, 강화군,050003, 47세,2021,797,449,348,129,777,440,337,130.6
23310, 강화군,050004, 48세,2021,851,458,393,116.5,845,454,391,116.1
23310, 강화군,050005, 49세,2021,843,448,395,113.4,825,441,384,114.8
23310, 강화군,055,50~54세,2021,4964,2551,2413,105.7,4902,2530,2372,106.7
23310, 강화군,055001, 50세,2021,950,508,442,114.9,937,501,436,114.9
23310, 강화군,055002, 51세,2021,936,506,430,117.7,919,500,419,119.3
23310, 강화군,055003, 52세,2021,1012,505,507,99.6,1000,505,495,102
23310, 강화군,055004, 53세,2021,1063,524,539,97.2,1054,522,532,98.1
23310, 강화군,055005, 54세,2021,1003,508,495,102.6,992,502,490,102.4
23310, 강화군,060,55~59세,2021,6164,3065,3099,98.9,6100,3040,3060,99.3
23310, 강화군,060001, 55세,2021,1089,553,536,103.2,1082,550,532,103.4
23310, 강화군,060002, 56세,2021,1195,583,612,95.3,1180,576,604,95.4
23310, 강화군,060003, 57세,2021,1154,587,567,103.5,1136,579,557,103.9
23310, 강화군,060004, 58세,2021,1258,618,640,96.6,1242,613,629,97.5
23310, 강화군,060005, 59세,2021,1468,724,744,97.3,1460,722,738,97.8
23310, 강화군,065,60~64세,2021,7919,3886,4033,96.4,7870,3867,4003,96.6
23310, 강화군,065001, 60세,2021,1607,787,820,96,1602,784,818,95.8
23310, 강화군,065002, 61세,2021,1653,809,844,95.9,1640,803,837,95.9
23310, 강화군,065003, 62세,2021,1661,810,851,95.2,1646,803,843,95.3
23310, 강화군,065004, 63세,2021,1535,739,796,92.8,1523,737,786,93.8
23310, 강화군,065005, 64세,2021,1463,741,722,102.6,1459,740,719,102.9
23310, 강화군,070,65~69세,2021,6491,3220,3271,98.4,6462,3208,3254,98.6
23310, 강화군,070001, 65세,2021,1418,697,721,96.7,1416,696,720,96.7
23310, 강화군,070002, 66세,2021,1450,732,718,101.9,1439,728,711,102.4
23310, 강화군,070003, 67세,2021,1215,591,624,94.7,1209,588,621,94.7
23310, 강화군,070004, 68세,2021,1198,610,588,103.7,1193,608,585,103.9
23310, 강화군,070005, 69세,2021,1210,590,620,95.2,1205,588,617,95.3
23310, 강화군,075,70~74세,2021,5073,2530,2543,99.5,5058,2522,2536,99.4
23310, 강화군,075001, 70세,2021,813,413,400,103.3,807,410,397,103.3
23310, 강화군,075002, 71세,2021,1005,494,511,96.7,1005,494,511,96.7
23310, 강화군,075003, 72세,2021,1075,558,517,107.9,1071,555,516,107.6
23310, 강화군,075004, 73세,2021,1033,513,520,98.7,1029,512,517,99
23310, 강화군,075005, 74세,2021,1147,552,595,92.8,1146,551,595,92.6
23310, 강화군,080,75~79세,2021,4371,1998,2373,84.2,4365,1996,2369,84.3
23310, 강화군,080001, 75세,2021,890,420,470,89.4,889,419,470,89.1
23310, 강화군,080002, 76세,2021,788,366,422,86.7,785,365,420,86.9
23310, 강화군,080003, 77세,2021,837,370,467,79.2,837,370,467,79.2
23310, 강화군,080004, 78세,2021,922,439,483,90.9,921,439,482,91.1
23310, 강화군,080005, 79세,2021,934,403,531,75.9,933,403,530,76
23310, 강화군,085,80~84세,2021,3487,1511,1976,76.5,3482,1508,1974,76.4
23310, 강화군,085001, 80세,2021,836,365,471,77.5,835,364,471,77.3
23310, 강화군,085002, 81세,2021,725,317,408,77.7,723,316,407,77.6
23310, 강화군,085003, 82세,2021,711,309,402,76.9,711,309,402,76.9
23310, 강화군,085004, 83세,2021,647,289,358,80.7,646,288,358,80.4
23310, 강화군,085005, 84세,2021,568,231,337,68.5,567,231,336,68.8
23310, 강화군,090,85~89세,2021,2274,786,1488,52.8,2272,786,1486,52.9
23310, 강화군,090001, 85세,2021,598,229,369,62.1,597,229,368,62.2
23310, 강화군,090002, 86세,2021,545,207,338,61.2,544,207,337,61.4
23310, 강화군,090003, 87세,2021,430,145,285,50.9,430,145,285,50.9
23310, 강화군,090004, 88세,2021,373,116,257,45.1,373,116,257,45.1
23310, 강화군,090005, 89세,2021,328,89,239,37.2,328,89,239,37.2
23310, 강화군,095,90~94세,2021,730,176,554,31.8,728,175,553,31.6
23310, 강화군,095001, 90세,2021,218,62,156,39.7,217,61,156,39.1
23310, 강화군,095002, 91세,2021,184,40,144,27.8,184,40,144,27.8
23310, 강화군,095003, 92세,2021,142,34,108,31.5,141,34,107,31.8
23310, 강화군,095004, 93세,2021,115,25,90,27.8,115,25,90,27.8
23310, 강화군,095005, 94세,2021,71,15,56,26.8,71,15,56,26.8
23310, 강화군,100,95~99세,2021,161,34,127,26.8,160,34,126,27
23310, 강화군,100001, 95세,2021,49,6,43,14,48,6,42,14.3
23310, 강화군,100002, 96세,2021,39,10,29,34.5,39,10,29,34.5
23310, 강화군,100003, 97세,2021,33,7,26,26.9,33,7,26,26.9
23310, 강화군,100004, 98세,2021,30,10,20,50,30,10,20,50
23310, 강화군,100005, 99세,2021,10,X,9,11.1,10,X,9,11.1
23310, 강화군,101,100세이상,2021,21,X,17,23.5,21,X,17,23.5
23310, 강화군,102,15세미만,2021,5155,2701,2454,110.1,5141,2691,2450,109.8
23310, 강화군,103,15~64세,2021,38071,19967,18104,110.3,37070,19355,17715,109.3
23310, 강화군,104,65세이상,2021,22608,10259,12349,83.1,22548,10233,12315,83.1
23310, 강화군,086,85세이상,2021,3186,1000,2186,45.7,3181,999,2182,45.8
23310, 강화군,126,평균연령,2021,53.5,51.7,55.4,,53.8,52,55.5,
23310, 강화군,127,중위연령,2021,58.3,56.3,59.9,,58.6,56.8,60.1,
23320, 옹진군,000,합계,2021,18984,10912,8072,135.2,18703,10721,7982,134.3
23320, 옹진군,005,0~4세,2021,390,193,197,98,390,193,197,98
23320, 옹진군,005001, 0세,2021,79,39,40,97.5,79,39,40,97.5
23320, 옹진군,005002, 1세,2021,64,20,44,45.5,64,20,44,45.5
23320, 옹진군,005003, 2세,2021,88,47,41,114.6,88,47,41,114.6
23320, 옹진군,005004, 3세,2021,82,50,32,156.3,82,50,32,156.3
23320, 옹진군,005005, 4세,2021,77,37,40,92.5,77,37,40,92.5
23320, 옹진군,010,5~9세,2021,471,241,230,104.8,471,241,230,104.8
23320, 옹진군,010001, 5세,2021,98,48,50,96,98,48,50,96
23320, 옹진군,010002, 6세,2021,95,49,46,106.5,95,49,46,106.5
23320, 옹진군,010003, 7세,2021,75,37,38,97.4,75,37,38,97.4
23320, 옹진군,010004, 8세,2021,105,62,43,144.2,105,62,43,144.2
23320, 옹진군,010005, 9세,2021,98,45,53,84.9,98,45,53,84.9
23320, 옹진군,015,10~14세,2021,495,260,235,110.6,494,260,234,111.1
23320, 옹진군,015001, 10세,2021,106,62,44,140.9,105,62,43,144.2
23320, 옹진군,015002, 11세,2021,100,47,53,88.7,100,47,53,88.7
23320, 옹진군,015003, 12세,2021,97,55,42,131,97,55,42,131
23320, 옹진군,015004, 13세,2021,85,45,40,112.5,85,45,40,112.5
23320, 옹진군,015005, 14세,2021,107,51,56,91.1,107,51,56,91.1
23320, 옹진군,020,15~19세,2021,460,267,193,138.3,459,267,192,139.1
23320, 옹진군,020001, 15세,2021,98,49,49,100,98,49,49,100
23320, 옹진군,020002, 16세,2021,93,57,36,158.3,92,57,35,162.9
23320, 옹진군,020003, 17세,2021,99,50,49,102,99,50,49,102
23320, 옹진군,020004, 18세,2021,94,52,42,123.8,94,52,42,123.8
23320, 옹진군,020005, 19세,2021,76,59,17,347.1,76,59,17,347.1
23320, 옹진군,025,20~24세,2021,1078,879,199,441.7,1046,848,198,428.3
23320, 옹진군,025001, 20세,2021,125,105,20,525,125,105,20,525
23320, 옹진군,025002, 21세,2021,213,189,24,787.5,208,184,24,766.7
23320, 옹진군,025003, 22세,2021,234,187,47,397.9,231,184,47,391.5
23320, 옹진군,025004, 23세,2021,247,199,48,414.6,235,187,48,389.6
23320, 옹진군,025005, 24세,2021,259,199,60,331.7,247,188,59,318.6
23320, 옹진군,030,25~29세,2021,1253,909,344,264.2,1189,859,330,260.3
23320, 옹진군,030001, 25세,2021,281,214,67,319.4,268,205,63,325.4
23320, 옹진군,030002, 26세,2021,253,188,65,289.2,242,179,63,284.1
23320, 옹진군,030003, 27세,2021,251,188,63,298.4,243,182,61,298.4
23320, 옹진군,030004, 28세,2021,248,176,72,244.4,231,161,70,230
23320, 옹진군,030005, 29세,2021,220,143,77,185.7,205,132,73,180.8
23320, 옹진군,035,30~34세,2021,934,617,317,194.6,879,576,303,190.1
23320, 옹진군,035001, 30세,2021,212,145,67,216.4,203,139,64,217.2
23320, 옹진군,035002, 31세,2021,210,134,76,176.3,194,122,72,169.4
23320, 옹진군,035003, 32세,2021,179,132,47,280.9,171,126,45,280
23320, 옹진군,035004, 33세,2021,160,101,59,171.2,153,96,57,168.4
23320, 옹진군,035005, 34세,2021,173,105,68,154.4,158,93,65,143.1
23320, 옹진군,040,35~39세,2021,869,521,348,149.7,825,495,330,150
23320, 옹진군,040001, 35세,2021,161,104,57,182.5,154,99,55,180
23320, 옹진군,040002, 36세,2021,153,98,55,178.2,144,91,53,171.7
23320, 옹진군,040003, 37세,2021,165,96,69,139.1,155,93,62,150
23320, 옹진군,040004, 38세,2021,189,107,82,130.5,180,101,79,127.8
23320, 옹진군,040005, 39세,2021,201,116,85,136.5,192,111,81,137
23320, 옹진군,045,40~44세,2021,1031,634,397,159.7,1008,619,389,159.1
23320, 옹진군,045001, 40세,2021,193,118,75,157.3,187,114,73,156.2
23320, 옹진군,045002, 41세,2021,220,131,89,147.2,216,127,89,142.7
23320, 옹진군,045003, 42세,2021,219,132,87,151.7,212,128,84,152.4
23320, 옹진군,045004, 43세,2021,183,114,69,165.2,181,113,68,166.2
23320, 옹진군,045005, 44세,2021,216,139,77,180.5,212,137,75,182.7
23320, 옹진군,050,45~49세,2021,1165,757,408,185.5,1153,750,403,186.1
23320, 옹진군,050001, 45세,2021,214,139,75,185.3,210,137,73,187.7
23320, 옹진군,050002, 46세,2021,243,170,73,232.9,242,169,73,231.5
23320, 옹진군,050003, 47세,2021,237,146,91,160.4,233,143,90,158.9
23320, 옹진군,050004, 48세,2021,228,149,79,188.6,225,148,77,192.2
23320, 옹진군,050005, 49세,2021,243,153,90,170,243,153,90,170
23320, 옹진군,055,50~54세,2021,1403,840,563,149.2,1391,834,557,149.7
23320, 옹진군,055001, 50세,2021,272,163,109,149.5,269,161,108,149.1
23320, 옹진군,055002, 51세,2021,255,162,93,174.2,253,160,93,172
23320, 옹진군,055003, 52세,2021,269,160,109,146.8,265,159,106,150
23320, 옹진군,055004, 53세,2021,281,159,122,130.3,280,158,122,129.5
23320, 옹진군,055005, 54세,2021,326,196,130,150.8,324,196,128,153.1
23320, 옹진군,060,55~59세,2021,1871,1059,812,130.4,1862,1057,805,131.3
23320, 옹진군,060001, 55세,2021,325,189,136,139,324,189,135,140
23320, 옹진군,060002, 56세,2021,374,203,171,118.7,371,203,168,120.8
23320, 옹진군,060003, 57세,2021,332,191,141,135.5,331,190,141,134.8
23320, 옹진군,060004, 58세,2021,393,213,180,118.3,391,213,178,119.7
23320, 옹진군,060005, 59세,2021,447,263,184,142.9,445,262,183,143.2
23320, 옹진군,065,60~64세,2021,2247,1219,1028,118.6,2238,1215,1023,118.8
23320, 옹진군,065001, 60세,2021,483,258,225,114.7,483,258,225,114.7
23320, 옹진군,065002, 61세,2021,460,254,206,123.3,457,253,204,124
23320, 옹진군,065003, 62세,2021,465,244,221,110.4,461,242,219,110.5
23320, 옹진군,065004, 63세,2021,425,238,187,127.3,424,238,186,128
23320, 옹진군,065005, 64세,2021,414,225,189,119,413,224,189,118.5
23320, 옹진군,070,65~69세,2021,1809,957,852,112.3,1799,953,846,112.6
23320, 옹진군,070001, 65세,2021,401,207,194,106.7,398,205,193,106.2
23320, 옹진군,070002, 66세,2021,437,237,200,118.5,435,237,198,119.7
23320, 옹진군,070003, 67세,2021,330,170,160,106.3,329,170,159,106.9
23320, 옹진군,070004, 68세,2021,292,163,129,126.4,291,162,129,125.6
23320, 옹진군,070005, 69세,2021,349,180,169,106.5,346,179,167,107.2
23320, 옹진군,075,70~74세,2021,1248,644,604,106.6,1240,640,600,106.7
23320, 옹진군,075001, 70세,2021,191,93,98,94.9,188,92,96,95.8
23320, 옹진군,075002, 71세,2021,285,164,121,135.5,284,164,120,136.7
23320, 옹진군,075003, 72세,2021,258,141,117,120.5,258,141,117,120.5
23320, 옹진군,075004, 73세,2021,217,104,113,92,214,102,112,91.1
23320, 옹진군,075005, 74세,2021,297,142,155,91.6,296,141,155,91
23320, 옹진군,080,75~79세,2021,981,457,524,87.2,981,457,524,87.2
23320, 옹진군,080001, 75세,2021,231,107,124,86.3,231,107,124,86.3
23320, 옹진군,080002, 76세,2021,203,101,102,99,203,101,102,99
23320, 옹진군,080003, 77세,2021,157,74,83,89.2,157,74,83,89.2
23320, 옹진군,080004, 78세,2021,189,87,102,85.3,189,87,102,85.3
23320, 옹진군,080005, 79세,2021,201,88,113,77.9,201,88,113,77.9
23320, 옹진군,085,80~84세,2021,649,274,375,73.1,648,273,375,72.8
23320, 옹진군,085001, 80세,2021,149,66,83,79.5,149,66,83,79.5
23320, 옹진군,085002, 81세,2021,127,65,62,104.8,127,65,62,104.8
23320, 옹진군,085003, 82세,2021,128,43,85,50.6,127,42,85,49.4
23320, 옹진군,085004, 83세,2021,127,55,72,76.4,127,55,72,76.4
23320, 옹진군,085005, 84세,2021,118,45,73,61.6,118,45,73,61.6
23320, 옹진군,090,85~89세,2021,408,133,275,48.4,408,133,275,48.4
23320, 옹진군,090001, 85세,2021,125,41,84,48.8,125,41,84,48.8
23320, 옹진군,090002, 86세,2021,80,25,55,45.5,80,25,55,45.5
23320, 옹진군,090003, 87세,2021,82,27,55,49.1,82,27,55,49.1
23320, 옹진군,090004, 88세,2021,67,28,39,71.8,67,28,39,71.8
23320, 옹진군,090005, 89세,2021,54,12,42,28.6,54,12,42,28.6
23320, 옹진군,095,90~94세,2021,171,37,134,27.6,171,37,134,27.6
23320, 옹진군,095001, 90세,2021,59,13,46,28.3,59,13,46,28.3
23320, 옹진군,095002, 91세,2021,36,7,29,24.1,36,7,29,24.1
23320, 옹진군,095003, 92세,2021,28,8,20,40,28,8,20,40
23320, 옹진군,095004, 93세,2021,22,X,19,15.8,22,X,19,15.8
23320, 옹진군,095005, 94세,2021,26,6,20,30,26,6,20,30
23320, 옹진군,100,95~99세,2021,43,11,32,34.4,43,11,32,34.4
23320, 옹진군,100001, 95세,2021,13,X,10,30,13,X,10,30
23320, 옹진군,100002, 96세,2021,10,X,6,66.7,10,X,6,66.7
23320, 옹진군,100003, 97세,2021,8,X,6,33.3,8,X,6,33.3
23320, 옹진군,100004, 98세,2021,8,X,6,33.3,8,X,6,33.3
23320, 옹진군,100005, 99세,2021,X,X,X,0,X,X,X,0
23320, 옹진군,101,100세이상,2021,8,X,5,60,8,X,5,60
23320, 옹진군,102,15세미만,2021,1356,694,662,104.8,1355,694,661,105
23320, 옹진군,103,15~64세,2021,12311,7702,4609,167.1,12050,7520,4530,166
23320, 옹진군,104,65세이상,2021,5317,2516,2801,89.8,5298,2507,2791,89.8
23320, 옹진군,086,85세이상,2021,630,184,446,41.3,630,184,446,41.3
23320, 옹진군,126,평균연령,2021,50.6,48,54,,50.8,48.3,54.1,
23320, 옹진군,127,중위연령,2021,54.8,51.1,58.9,,55.1,51.6,59,
24,광주광역시,000,합계,2021,1475262,732088,743174,98.5,1444765,716048,728717,98.3
24,광주광역시,005,0~4세,2021,46442,23732,22710,104.5,45778,23397,22381,104.5
24,광주광역시,005001, 0세,2021,8162,4112,4050,101.5,8018,4043,3975,101.7
24,광주광역시,005002, 1세,2021,8007,4045,3962,102.1,7882,3980,3902,102
24,광주광역시,005003, 2세,2021,9056,4567,4489,101.7,8943,4509,4434,101.7
24,광주광역시,005004, 3세,2021,10091,5231,4860,107.6,9952,5153,4799,107.4
24,광주광역시,005005, 4세,2021,11126,5777,5349,108,10983,5712,5271,108.4
24,광주광역시,010,5~9세,2021,68675,35314,33361,105.9,68009,34994,33015,106
24,광주광역시,010001, 5세,2021,12747,6443,6304,102.2,12589,6363,6226,102.2
24,광주광역시,010002, 6세,2021,13419,6966,6453,107.9,13268,6889,6379,108
24,광주광역시,010003, 7세,2021,13620,6901,6719,102.7,13471,6828,6643,102.8
24,광주광역시,010004, 8세,2021,13773,7137,6636,107.5,13666,7088,6578,107.8
24,광주광역시,010005, 9세,2021,15116,7867,7249,108.5,15015,7826,7189,108.9
24,광주광역시,015,10~14세,2021,74192,38334,35858,106.9,73837,38152,35685,106.9
24,광주광역시,015001, 10세,2021,14811,7629,7182,106.2,14726,7583,7143,106.2
24,광주광역시,015002, 11세,2021,14555,7480,7075,105.7,14474,7437,7037,105.7
24,광주광역시,015003, 12세,2021,14215,7338,6877,106.7,14149,7304,6845,106.7
24,광주광역시,015004, 13세,2021,14841,7712,7129,108.2,14779,7680,7099,108.2
24,광주광역시,015005, 14세,2021,15770,8175,7595,107.6,15709,8148,7561,107.8
24,광주광역시,020,15~19세,2021,77867,40062,37805,106,77168,39729,37439,106.1
24,광주광역시,020001, 15세,2021,14488,7509,6979,107.6,14402,7470,6932,107.8
24,광주광역시,020002, 16세,2021,14097,7278,6819,106.7,14047,7252,6795,106.7
24,광주광역시,020003, 17세,2021,15192,7913,7279,108.7,15130,7875,7255,108.5
24,광주광역시,020004, 18세,2021,16404,8536,7868,108.5,16262,8468,7794,108.6
24,광주광역시,020005, 19세,2021,17686,8826,8860,99.6,17327,8664,8663,100
24,광주광역시,025,20~24세,2021,111615,57114,54501,104.8,106097,54180,51917,104.4
24,광주광역시,025001, 20세,2021,20544,10183,10361,98.3,19752,9868,9884,99.8
24,광주광역시,025002, 21세,2021,23166,11695,11471,102,21995,11107,10888,102
24,광주광역시,025003, 22세,2021,22423,11447,10976,104.3,21263,10803,10460,103.3
24,광주광역시,025004, 23세,2021,22607,11679,10928,106.9,21438,11018,10420,105.7
24,광주광역시,025005, 24세,2021,22875,12110,10765,112.5,21649,11384,10265,110.9
24,광주광역시,030,25~29세,2021,108975,57475,51500,111.6,103700,54528,49172,110.9
24,광주광역시,030001, 25세,2021,22666,12045,10621,113.4,21532,11404,10128,112.6
24,광주광역시,030002, 26세,2021,22398,11664,10734,108.7,21334,11075,10259,108
24,광주광역시,030003, 27세,2021,21869,11652,10217,114,20815,11058,9757,113.3
24,광주광역시,030004, 28세,2021,21173,11204,9969,112.4,20139,10645,9494,112.1
24,광주광역시,030005, 29세,2021,20869,10910,9959,109.5,19880,10346,9534,108.5
24,광주광역시,035,30~34세,2021,87425,45429,41996,108.2,82747,42844,39903,107.4
24,광주광역시,035001, 30세,2021,18944,9857,9087,108.5,18017,9346,8671,107.8
24,광주광역시,035002, 31세,2021,17848,9388,8460,111,16884,8855,8029,110.3
24,광주광역시,035003, 32세,2021,17116,8932,8184,109.1,16145,8392,7753,108.2
24,광주광역시,035004, 33세,2021,16489,8527,7962,107.1,15596,8038,7558,106.4
24,광주광역시,035005, 34세,2021,17028,8725,8303,105.1,16105,8213,7892,104.1
24,광주광역시,040,35~39세,2021,100313,51200,49113,104.2,96670,49213,47457,103.7
24,광주광역시,040001, 35세,2021,17345,8833,8512,103.8,16552,8406,8146,103.2
24,광주광역시,040002, 36세,2021,17814,9106,8708,104.6,17003,8665,8338,103.9
24,광주광역시,040003, 37세,2021,19420,10009,9411,106.4,18741,9653,9088,106.2
24,광주광역시,040004, 38세,2021,21665,11075,10590,104.6,20997,10702,10295,104
24,광주광역시,040005, 39세,2021,24069,12177,11892,102.4,23377,11787,11590,101.7
24,광주광역시,045,40~44세,2021,115496,57517,57979,99.2,112977,56169,56808,98.9
24,광주광역시,045001, 40세,2021,23150,11664,11486,101.5,22590,11367,11223,101.3
24,광주광역시,045002, 41세,2021,24161,11933,12228,97.6,23629,11656,11973,97.4
24,광주광역시,045003, 42세,2021,23749,11730,12019,97.6,23244,11458,11786,97.2
24,광주광역시,045004, 43세,2021,21719,10882,10837,100.4,21216,10608,10608,100
24,광주광역시,045005, 44세,2021,22717,11308,11409,99.1,22298,11080,11218,98.8
24,광주광역시,050,45~49세,2021,123506,61806,61700,100.2,121442,60772,60670,100.2
24,광주광역시,050001, 45세,2021,22545,11439,11106,103,22127,11210,10917,102.7
24,광주광역시,050002, 46세,2021,23064,11487,11577,99.2,22649,11296,11353,99.5
24,광주광역시,050003, 47세,2021,26078,13139,12939,101.5,25683,12944,12739,101.6
24,광주광역시,050004, 48세,2021,25755,12688,13067,97.1,25363,12488,12875,97
24,광주광역시,050005, 49세,2021,26064,13053,13011,100.3,25620,12834,12786,100.4
24,광주광역시,055,50~54세,2021,128776,64241,64535,99.5,127076,63402,63674,99.6
24,광주광역시,055001, 50세,2021,27368,13649,13719,99.5,26971,13436,13535,99.3
24,광주광역시,055002, 51세,2021,26095,13059,13036,100.2,25737,12901,12836,100.5
24,광주광역시,055003, 52세,2021,25499,12779,12720,100.5,25167,12613,12554,100.5
24,광주광역시,055004, 53세,2021,26225,13026,13199,98.7,25917,12872,13045,98.7
24,광주광역시,055005, 54세,2021,23589,11728,11861,98.9,23284,11580,11704,98.9
24,광주광역시,060,55~59세,2021,111082,55676,55406,100.5,109813,55111,54702,100.7
24,광주광역시,060001, 55세,2021,23478,11895,11583,102.7,23198,11770,11428,103
24,광주광역시,060002, 56세,2021,22933,11310,11623,97.3,22674,11187,11487,97.4
24,광주광역시,060003, 57세,2021,21031,10617,10414,101.9,20767,10509,10258,102.4
24,광주광역시,060004, 58세,2021,22467,11295,11172,101.1,22221,11193,11028,101.5
24,광주광역시,060005, 59세,2021,21173,10559,10614,99.5,20953,10452,10501,99.5
24,광주광역시,065,60~64세,2021,104581,50920,53661,94.9,103831,50563,53268,94.9
24,광주광역시,065001, 60세,2021,22767,11222,11545,97.2,22595,11145,11450,97.3
24,광주광역시,065002, 61세,2021,23749,11530,12219,94.4,23576,11452,12124,94.5
24,광주광역시,065003, 62세,2021,20989,10179,10810,94.2,20846,10110,10736,94.2
24,광주광역시,065004, 63세,2021,18832,9096,9736,93.4,18689,9023,9666,93.3
24,광주광역시,065005, 64세,2021,18244,8893,9351,95.1,18125,8833,9292,95.1
24,광주광역시,070,65~69세,2021,70586,33561,37025,90.6,70186,33390,36796,90.7
24,광주광역시,070001, 65세,2021,15621,7659,7962,96.2,15521,7613,7908,96.3
24,광주광역시,070002, 66세,2021,16623,7891,8732,90.4,16535,7850,8685,90.4
24,광주광역시,070003, 67세,2021,13385,6337,7048,89.9,13299,6304,6995,90.1
24,광주광역시,070004, 68세,2021,11913,5558,6355,87.5,11854,5533,6321,87.5
24,광주광역시,070005, 69세,2021,13044,6116,6928,88.3,12977,6090,6887,88.4
24,광주광역시,075,70~74세,2021,55041,25109,29932,83.9,54880,25056,29824,84
24,광주광역시,075001, 70세,2021,10776,4997,5779,86.5,10733,4981,5752,86.6
24,광주광역시,075002, 71세,2021,11155,5139,6016,85.4,11119,5130,5989,85.7
24,광주광역시,075003, 72세,2021,11555,5281,6274,84.2,11526,5269,6257,84.2
24,광주광역시,075004, 73세,2021,10592,4808,5784,83.1,10567,4800,5767,83.2
24,광주광역시,075005, 74세,2021,10963,4884,6079,80.3,10935,4876,6059,80.5
24,광주광역시,080,75~79세,2021,40725,17838,22887,77.9,40654,17813,22841,78
24,광주광역시,080001, 75세,2021,8332,3800,4532,83.8,8317,3795,4522,83.9
24,광주광역시,080002, 76세,2021,7982,3504,4478,78.2,7959,3495,4464,78.3
24,광주광역시,080003, 77세,2021,7491,3269,4222,77.4,7478,3264,4214,77.5
24,광주광역시,080004, 78세,2021,7400,3186,4214,75.6,7389,3182,4207,75.6
24,광주광역시,080005, 79세,2021,9520,4079,5441,75,9511,4077,5434,75
24,광주광역시,085,80~84세,2021,28908,11017,17891,61.6,28869,11002,17867,61.6
24,광주광역시,085001, 80세,2021,7102,2836,4266,66.5,7090,2831,4259,66.5
24,광주광역시,085002, 81세,2021,6188,2367,3821,61.9,6180,2364,3816,61.9
24,광주광역시,085003, 82세,2021,5830,2257,3573,63.2,5821,2253,3568,63.1
24,광주광역시,085004, 83세,2021,5181,1924,3257,59.1,5176,1922,3254,59.1
24,광주광역시,085005, 84세,2021,4607,1633,2974,54.9,4602,1632,2970,54.9
24,광주광역시,090,85~89세,2021,14613,4394,10219,43,14594,4386,10208,43
24,광주광역시,090001, 85세,2021,3760,1234,2526,48.9,3752,1230,2522,48.8
24,광주광역시,090002, 86세,2021,3530,1098,2432,45.1,3525,1096,2429,45.1
24,광주광역시,090003, 87세,2021,3074,909,2165,42,3072,909,2163,42
24,광주광역시,090004, 88세,2021,2308,644,1664,38.7,2306,643,1663,38.7
24,광주광역시,090005, 89세,2021,1941,509,1432,35.5,1939,508,1431,35.5
24,광주광역시,095,90~94세,2021,5215,1169,4046,28.9,5210,1167,4043,28.9
24,광주광역시,095001, 90세,2021,1475,358,1117,32.1,1474,357,1117,32
24,광주광역시,095002, 91세,2021,1451,291,1160,25.1,1450,291,1159,25.1
24,광주광역시,095003, 92세,2021,1014,264,750,35.2,1012,263,749,35.1
24,광주광역시,095004, 93세,2021,751,151,600,25.2,751,151,600,25.2
24,광주광역시,095005, 94세,2021,524,105,419,25.1,523,105,418,25.1
24,광주광역시,100,95~99세,2021,1064,164,900,18.2,1062,164,898,18.3
24,광주광역시,100001, 95세,2021,376,61,315,19.4,375,61,314,19.4
24,광주광역시,100002, 96세,2021,255,38,217,17.5,255,38,217,17.5
24,광주광역시,100003, 97세,2021,142,32,110,29.1,142,32,110,29.1
24,광주광역시,100004, 98세,2021,188,22,166,13.3,187,22,165,13.3
24,광주광역시,100005, 99세,2021,103,11,92,12,103,11,92,12
24,광주광역시,101,100세이상,2021,165,16,149,10.7,165,16,149,10.7
24,광주광역시,102,15세미만,2021,189309,97380,91929,105.9,187624,96543,91081,106
24,광주광역시,103,15~64세,2021,1069636,541440,528196,102.5,1041521,526511,515010,102.2
24,광주광역시,104,65세이상,2021,216317,93268,123049,75.8,215620,92994,122626,75.8
24,광주광역시,086,85세이상,2021,21057,5743,15314,37.5,21031,5733,15298,37.5
24,광주광역시,126,평균연령,2021,41.8,40.7,42.9,,42,40.8,43.1,
24,광주광역시,127,중위연령,2021,42.6,41.5,43.8,,43,41.8,44.2,
24010, 동구,000,합계,2021,108676,53901,54775,98.4,106508,52792,53716,98.3
24010, 동구,005,0~4세,2021,3370,1731,1639,105.6,3346,1720,1626,105.8
24010, 동구,005001, 0세,2021,659,310,349,88.8,655,307,348,88.2
24010, 동구,005002, 1세,2021,614,312,302,103.3,608,310,298,104
24010, 동구,005003, 2세,2021,670,342,328,104.3,666,340,326,104.3
24010, 동구,005004, 3세,2021,679,353,326,108.3,674,351,323,108.7
24010, 동구,005005, 4세,2021,748,414,334,124,743,412,331,124.5
24010, 동구,010,5~9세,2021,3903,2015,1888,106.7,3873,2005,1868,107.3
24010, 동구,010001, 5세,2021,756,391,365,107.1,749,387,362,106.9
24010, 동구,010002, 6세,2021,866,434,432,100.5,861,433,428,101.2
24010, 동구,010003, 7세,2021,801,422,379,111.3,794,419,375,111.7
24010, 동구,010004, 8세,2021,734,378,356,106.2,728,376,352,106.8
24010, 동구,010005, 9세,2021,746,390,356,109.6,741,390,351,111.1
24010, 동구,015,10~14세,2021,3337,1709,1628,105,3334,1707,1627,104.9
24010, 동구,015001, 10세,2021,729,376,353,106.5,729,376,353,106.5
24010, 동구,015002, 11세,2021,669,345,324,106.5,667,344,323,106.5
24010, 동구,015003, 12세,2021,593,309,284,108.8,593,309,284,108.8
24010, 동구,015004, 13세,2021,654,326,328,99.4,654,326,328,99.4
24010, 동구,015005, 14세,2021,692,353,339,104.1,691,352,339,103.8
24010, 동구,020,15~19세,2021,4448,2337,2111,110.7,4414,2318,2096,110.6
24010, 동구,020001, 15세,2021,658,346,312,110.9,658,346,312,110.9
24010, 동구,020002, 16세,2021,633,323,310,104.2,633,323,310,104.2
24010, 동구,020003, 17세,2021,708,362,346,104.6,706,360,346,104
24010, 동구,020004, 18세,2021,918,488,430,113.5,902,479,423,113.2
24010, 동구,020005, 19세,2021,1531,818,713,114.7,1515,810,705,114.9
24010, 동구,025,20~24세,2021,9799,5130,4669,109.9,9149,4789,4360,109.8
24010, 동구,025001, 20세,2021,1626,770,856,90,1536,738,798,92.5
24010, 동구,025002, 21세,2021,2052,998,1054,94.7,1845,896,949,94.4
24010, 동구,025003, 22세,2021,2090,1106,984,112.4,1957,1027,930,110.4
24010, 동구,025004, 23세,2021,2030,1134,896,126.6,1932,1084,848,127.8
24010, 동구,025005, 24세,2021,2001,1122,879,127.6,1879,1044,835,125
24010, 동구,030,25~29세,2021,8541,4489,4052,110.8,8125,4275,3850,111
24010, 동구,030001, 25세,2021,1840,1040,800,130,1737,981,756,129.8
24010, 동구,030002, 26세,2021,1814,933,881,105.9,1722,891,831,107.2
24010, 동구,030003, 27세,2021,1701,887,814,109,1615,846,769,110
24010, 동구,030004, 28세,2021,1624,820,804,102,1548,779,769,101.3
24010, 동구,030005, 29세,2021,1562,809,753,107.4,1503,778,725,107.3
24010, 동구,035,30~34세,2021,6825,3506,3319,105.6,6547,3365,3182,105.8
24010, 동구,035001, 30세,2021,1430,708,722,98.1,1375,685,690,99.3
24010, 동구,035002, 31세,2021,1373,697,676,103.1,1317,670,647,103.6
24010, 동구,035003, 32세,2021,1409,750,659,113.8,1342,713,629,113.4
24010, 동구,035004, 33세,2021,1274,680,594,114.5,1222,650,572,113.6
24010, 동구,035005, 34세,2021,1339,671,668,100.4,1291,647,644,100.5
24010, 동구,040,35~39세,2021,7112,3716,3396,109.4,6894,3608,3286,109.8
24010, 동구,040001, 35세,2021,1359,690,669,103.1,1312,669,643,104
24010, 동구,040002, 36세,2021,1283,662,621,106.6,1244,647,597,108.4
24010, 동구,040003, 37세,2021,1400,746,654,114.1,1351,724,627,115.5
24010, 동구,040004, 38세,2021,1443,748,695,107.6,1403,722,681,106
24010, 동구,040005, 39세,2021,1627,870,757,114.9,1584,846,738,114.6
24010, 동구,045,40~44세,2021,6971,3708,3263,113.6,6830,3634,3196,113.7
24010, 동구,045001, 40세,2021,1506,801,705,113.6,1475,789,686,115
24010, 동구,045002, 41세,2021,1395,732,663,110.4,1362,715,647,110.5
24010, 동구,045003, 42세,2021,1409,751,658,114.1,1388,740,648,114.2
24010, 동구,045004, 43세,2021,1352,747,605,123.5,1319,729,590,123.6
24010, 동구,045005, 44세,2021,1309,677,632,107.1,1286,661,625,105.8
24010, 동구,050,45~49세,2021,6918,3585,3333,107.6,6796,3518,3278,107.3
24010, 동구,050001, 45세,2021,1251,680,571,119.1,1224,668,556,120.1
24010, 동구,050002, 46세,2021,1277,661,616,107.3,1255,648,607,106.8
24010, 동구,050003, 47세,2021,1388,748,640,116.9,1365,733,632,116
24010, 동구,050004, 48세,2021,1496,733,763,96.1,1472,719,753,95.5
24010, 동구,050005, 49세,2021,1506,763,743,102.7,1480,750,730,102.7
24010, 동구,055,50~54세,2021,7870,3928,3942,99.6,7780,3878,3902,99.4
24010, 동구,055001, 50세,2021,1621,795,826,96.2,1597,782,815,96
24010, 동구,055002, 51세,2021,1610,803,807,99.5,1601,796,805,98.9
24010, 동구,055003, 52세,2021,1590,785,805,97.5,1575,780,795,98.1
24010, 동구,055004, 53세,2021,1605,809,796,101.6,1584,797,787,101.3
24010, 동구,055005, 54세,2021,1444,736,708,104,1423,723,700,103.3
24010, 동구,060,55~59세,2021,7802,3843,3959,97.1,7727,3806,3921,97.1
24010, 동구,060001, 55세,2021,1550,784,766,102.3,1534,777,757,102.6
24010, 동구,060002, 56세,2021,1551,756,795,95.1,1537,751,786,95.5
24010, 동구,060003, 57세,2021,1494,736,758,97.1,1481,729,752,96.9
24010, 동구,060004, 58세,2021,1662,802,860,93.3,1642,793,849,93.4
24010, 동구,060005, 59세,2021,1545,765,780,98.1,1533,756,777,97.3
24010, 동구,065,60~64세,2021,8580,4116,4464,92.2,8537,4101,4436,92.4
24010, 동구,065001, 60세,2021,1760,827,933,88.6,1749,825,924,89.3
24010, 동구,065002, 61세,2021,1853,873,980,89.1,1845,871,974,89.4
24010, 동구,065003, 62세,2021,1680,814,866,94,1668,807,861,93.7
24010, 동구,065004, 63세,2021,1664,799,865,92.4,1655,796,859,92.7
24010, 동구,065005, 64세,2021,1623,803,820,97.9,1620,802,818,98
24010, 동구,070,65~69세,2021,6876,3166,3710,85.3,6854,3157,3697,85.4
24010, 동구,070001, 65세,2021,1460,686,774,88.6,1455,685,770,89
24010, 동구,070002, 66세,2021,1616,729,887,82.2,1610,727,883,82.3
24010, 동구,070003, 67세,2021,1344,633,711,89,1339,630,709,88.9
24010, 동구,070004, 68세,2021,1157,518,639,81.1,1155,517,638,81
24010, 동구,070005, 69세,2021,1299,600,699,85.8,1295,598,697,85.8
24010, 동구,075,70~74세,2021,5750,2590,3160,82,5740,2584,3156,81.9
24010, 동구,075001, 70세,2021,1077,509,568,89.6,1076,508,568,89.4
24010, 동구,075002, 71세,2021,1142,518,624,83,1139,516,623,82.8
24010, 동구,075003, 72세,2021,1230,552,678,81.4,1227,550,677,81.2
24010, 동구,075004, 73세,2021,1099,485,614,79,1098,484,614,78.8
24010, 동구,075005, 74세,2021,1202,526,676,77.8,1200,526,674,78
24010, 동구,080,75~79세,2021,4643,2047,2596,78.9,4635,2044,2591,78.9
24010, 동구,080001, 75세,2021,917,383,534,71.7,914,382,532,71.8
24010, 동구,080002, 76세,2021,908,394,514,76.7,905,392,513,76.4
24010, 동구,080003, 77세,2021,868,429,439,97.7,868,429,439,97.7
24010, 동구,080004, 78세,2021,850,360,490,73.5,849,360,489,73.6
24010, 동구,080005, 79세,2021,1100,481,619,77.7,1099,481,618,77.8
24010, 동구,085,80~84세,2021,3437,1462,1975,74,3436,1461,1975,74
24010, 동구,085001, 80세,2021,857,369,488,75.6,857,369,488,75.6
24010, 동구,085002, 81세,2021,759,324,435,74.5,759,324,435,74.5
24010, 동구,085003, 82세,2021,671,281,390,72.1,670,280,390,71.8
24010, 동구,085004, 83세,2021,593,256,337,76,593,256,337,76
24010, 동구,085005, 84세,2021,557,232,325,71.4,557,232,325,71.4
24010, 동구,090,85~89세,2021,1705,629,1076,58.5,1704,629,1075,58.5
24010, 동구,090001, 85세,2021,474,203,271,74.9,473,203,270,75.2
24010, 동구,090002, 86세,2021,366,133,233,57.1,366,133,233,57.1
24010, 동구,090003, 87세,2021,353,129,224,57.6,353,129,224,57.6
24010, 동구,090004, 88세,2021,270,95,175,54.3,270,95,175,54.3
24010, 동구,090005, 89세,2021,242,69,173,39.9,242,69,173,39.9
24010, 동구,095,90~94세,2021,633,169,464,36.4,631,168,463,36.3
24010, 동구,095001, 90세,2021,190,58,132,43.9,189,57,132,43.2
24010, 동구,095002, 91세,2021,164,40,124,32.3,164,40,124,32.3
24010, 동구,095003, 92세,2021,125,33,92,35.9,124,33,91,36.3
24010, 동구,095004, 93세,2021,93,24,69,34.8,93,24,69,34.8
24010, 동구,095005, 94세,2021,61,14,47,29.8,61,14,47,29.8
24010, 동구,100,95~99세,2021,134,20,114,17.5,134,20,114,17.5
24010, 동구,100001, 95세,2021,50,8,42,19,50,8,42,19
24010, 동구,100002, 96세,2021,33,5,28,17.9,33,5,28,17.9
24010, 동구,100003, 97세,2021,18,X,15,20,18,X,15,20
24010, 동구,100004, 98세,2021,23,X,19,21.1,23,X,19,21.1
24010, 동구,100005, 99세,2021,10,X,10,0,10,X,10,0
24010, 동구,101,100세이상,2021,22,5,17,29.4,22,5,17,29.4
24010, 동구,102,15세미만,2021,10610,5455,5155,105.8,10553,5432,5121,106.1
24010, 동구,103,15~64세,2021,74866,38358,36508,105.1,72799,37292,35507,105
24010, 동구,104,65세이상,2021,23200,10088,13112,76.9,23156,10068,13088,76.9
24010, 동구,086,85세이상,2021,2494,823,1671,49.3,2491,822,1669,49.3
24010, 동구,126,평균연령,2021,44.8,43.4,46.2,,45.1,43.7,46.5,
24010, 동구,127,중위연령,2021,45,43,47.4,,45.6,43.5,48,
24020, 서구,000,합계,2021,290565,143071,147494,97,288316,142091,146225,97.2
24020, 서구,005,0~4세,2021,7995,4120,3875,106.3,7953,4090,3863,105.9
24020, 서구,005001, 0세,2021,1344,670,674,99.4,1334,663,671,98.8
24020, 서구,005002, 1세,2021,1393,701,692,101.3,1384,694,690,100.6
24020, 서구,005003, 2세,2021,1521,785,736,106.7,1515,780,735,106.1
24020, 서구,005004, 3세,2021,1747,893,854,104.6,1738,885,853,103.8
24020, 서구,005005, 4세,2021,1990,1071,919,116.5,1982,1068,914,116.8
24020, 서구,010,5~9세,2021,12266,6387,5879,108.6,12210,6359,5851,108.7
24020, 서구,010001, 5세,2021,2191,1110,1081,102.7,2175,1100,1075,102.3
24020, 서구,010002, 6세,2021,2341,1233,1108,111.3,2329,1227,1102,111.3
24020, 서구,010003, 7세,2021,2444,1236,1208,102.3,2434,1233,1201,102.7
24020, 서구,010004, 8세,2021,2550,1357,1193,113.7,2545,1355,1190,113.9
24020, 서구,010005, 9세,2021,2740,1451,1289,112.6,2727,1444,1283,112.5
24020, 서구,015,10~14세,2021,14098,7371,6727,109.6,14083,7359,6724,109.4
24020, 서구,015001, 10세,2021,2793,1458,1335,109.2,2791,1456,1335,109.1
24020, 서구,015002, 11세,2021,2679,1439,1240,116,2673,1433,1240,115.6
24020, 서구,015003, 12세,2021,2717,1405,1312,107.1,2715,1404,1311,107.1
24020, 서구,015004, 13세,2021,2848,1482,1366,108.5,2844,1479,1365,108.4
24020, 서구,015005, 14세,2021,3061,1587,1474,107.7,3060,1587,1473,107.7
24020, 서구,020,15~19세,2021,14566,7728,6838,113,14539,7718,6821,113.2
24020, 서구,020001, 15세,2021,2884,1570,1314,119.5,2878,1568,1310,119.7
24020, 서구,020002, 16세,2021,2752,1414,1338,105.7,2749,1414,1335,105.9
24020, 서구,020003, 17세,2021,3033,1590,1443,110.2,3031,1589,1442,110.2
24020, 서구,020004, 18세,2021,3050,1628,1422,114.5,3045,1625,1420,114.4
24020, 서구,020005, 19세,2021,2847,1526,1321,115.5,2836,1522,1314,115.8
24020, 서구,025,20~24세,2021,19964,10202,9762,104.5,19706,10098,9608,105.1
24020, 서구,025001, 20세,2021,3440,1847,1593,115.9,3403,1832,1571,116.6
24020, 서구,025002, 21세,2021,3921,2111,1810,116.6,3879,2095,1784,117.4
24020, 서구,025003, 22세,2021,3999,2049,1950,105.1,3954,2033,1921,105.8
24020, 서구,025004, 23세,2021,4118,1986,2132,93.2,4054,1969,2085,94.4
24020, 서구,025005, 24세,2021,4486,2209,2277,97,4416,2169,2247,96.5
24020, 서구,030,25~29세,2021,22596,11452,11144,102.8,22219,11280,10939,103.1
24020, 서구,030001, 25세,2021,4616,2313,2303,100.4,4551,2284,2267,100.7
24020, 서구,030002, 26세,2021,4743,2350,2393,98.2,4663,2310,2353,98.2
24020, 서구,030003, 27세,2021,4503,2310,2193,105.3,4428,2276,2152,105.8
24020, 서구,030004, 28세,2021,4401,2271,2130,106.6,4321,2241,2080,107.7
24020, 서구,030005, 29세,2021,4333,2208,2125,103.9,4256,2169,2087,103.9
24020, 서구,035,30~34세,2021,16669,8627,8042,107.3,16326,8481,7845,108.1
24020, 서구,035001, 30세,2021,3726,1903,1823,104.4,3668,1888,1780,106.1
24020, 서구,035002, 31세,2021,3471,1861,1610,115.6,3399,1822,1577,115.5
24020, 서구,035003, 32세,2021,3391,1770,1621,109.2,3313,1735,1578,109.9
24020, 서구,035004, 33세,2021,3039,1560,1479,105.5,2978,1534,1444,106.2
24020, 서구,035005, 34세,2021,3042,1533,1509,101.6,2968,1502,1466,102.5
24020, 서구,040,35~39세,2021,18678,9389,9289,101.1,18416,9266,9150,101.3
24020, 서구,040001, 35세,2021,3214,1629,1585,102.8,3161,1604,1557,103
24020, 서구,040002, 36세,2021,3295,1637,1658,98.7,3239,1612,1627,99.1
24020, 서구,040003, 37세,2021,3592,1791,1801,99.4,3538,1773,1765,100.5
24020, 서구,040004, 38세,2021,4088,2082,2006,103.8,4038,2052,1986,103.3
24020, 서구,040005, 39세,2021,4489,2250,2239,100.5,4440,2225,2215,100.5
24020, 서구,045,40~44세,2021,22271,10893,11378,95.7,22072,10811,11261,96
24020, 서구,045001, 40세,2021,4352,2206,2146,102.8,4317,2194,2123,103.3
24020, 서구,045002, 41세,2021,4709,2252,2457,91.7,4660,2233,2427,92
24020, 서구,045003, 42세,2021,4538,2179,2359,92.4,4494,2157,2337,92.3
24020, 서구,045004, 43세,2021,4222,2072,2150,96.4,4185,2056,2129,96.6
24020, 서구,045005, 44세,2021,4450,2184,2266,96.4,4416,2171,2245,96.7
24020, 서구,050,45~49세,2021,25121,12169,12952,94,24954,12102,12852,94.2
24020, 서구,050001, 45세,2021,4485,2206,2279,96.8,4462,2197,2265,97
24020, 서구,050002, 46세,2021,4644,2248,2396,93.8,4603,2230,2373,94
24020, 서구,050003, 47세,2021,5355,2627,2728,96.3,5324,2619,2705,96.8
24020, 서구,050004, 48세,2021,5184,2482,2702,91.9,5149,2466,2683,91.9
24020, 서구,050005, 49세,2021,5453,2606,2847,91.5,5416,2590,2826,91.6
24020, 서구,055,50~54세,2021,27329,13508,13821,97.7,27140,13429,13711,97.9
24020, 서구,055001, 50세,2021,5801,2838,2963,95.8,5749,2816,2933,96
24020, 서구,055002, 51세,2021,5452,2715,2737,99.2,5414,2707,2707,100
24020, 서구,055003, 52세,2021,5509,2697,2812,95.9,5479,2683,2796,96
24020, 서구,055004, 53세,2021,5551,2777,2774,100.1,5514,2757,2757,100
24020, 서구,055005, 54세,2021,5016,2481,2535,97.9,4984,2466,2518,97.9
24020, 서구,060,55~59세,2021,23172,11496,11676,98.5,23046,11441,11605,98.6
24020, 서구,060001, 55세,2021,4876,2456,2420,101.5,4851,2448,2403,101.9
24020, 서구,060002, 56세,2021,4753,2368,2385,99.3,4726,2355,2371,99.3
24020, 서구,060003, 57세,2021,4463,2224,2239,99.3,4439,2210,2229,99.1
24020, 서구,060004, 58세,2021,4657,2312,2345,98.6,4628,2300,2328,98.8
24020, 서구,060005, 59세,2021,4423,2136,2287,93.4,4402,2128,2274,93.6
24020, 서구,065,60~64세,2021,21828,10474,11354,92.2,21740,10437,11303,92.3
24020, 서구,065001, 60세,2021,4721,2325,2396,97,4701,2319,2382,97.4
24020, 서구,065002, 61세,2021,4944,2382,2562,93,4921,2372,2549,93.1
24020, 서구,065003, 62세,2021,4363,2043,2320,88.1,4343,2036,2307,88.3
24020, 서구,065004, 63세,2021,3949,1843,2106,87.5,3936,1835,2101,87.3
24020, 서구,065005, 64세,2021,3851,1881,1970,95.5,3839,1875,1964,95.5
24020, 서구,070,65~69세,2021,14824,7047,7777,90.6,14783,7033,7750,90.7
24020, 서구,070001, 65세,2021,3260,1581,1679,94.2,3254,1578,1676,94.2
24020, 서구,070002, 66세,2021,3505,1699,1806,94.1,3495,1695,1800,94.2
24020, 서구,070003, 67세,2021,2774,1301,1473,88.3,2764,1301,1463,88.9
24020, 서구,070004, 68세,2021,2553,1187,1366,86.9,2544,1182,1362,86.8
24020, 서구,070005, 69세,2021,2732,1279,1453,88,2726,1277,1449,88.1
24020, 서구,075,70~74세,2021,11387,5224,6163,84.8,11360,5216,6144,84.9
24020, 서구,075001, 70세,2021,2231,1039,1192,87.2,2222,1037,1185,87.5
24020, 서구,075002, 71세,2021,2321,1062,1259,84.4,2319,1062,1257,84.5
24020, 서구,075003, 72세,2021,2357,1086,1271,85.4,2351,1083,1268,85.4
24020, 서구,075004, 73세,2021,2176,998,1178,84.7,2171,997,1174,84.9
24020, 서구,075005, 74세,2021,2302,1039,1263,82.3,2297,1037,1260,82.3
24020, 서구,080,75~79세,2021,8254,3633,4621,78.6,8242,3627,4615,78.6
24020, 서구,080001, 75세,2021,1701,785,916,85.7,1700,784,916,85.6
24020, 서구,080002, 76세,2021,1682,760,922,82.4,1676,757,919,82.4
24020, 서구,080003, 77세,2021,1508,642,866,74.1,1506,640,866,73.9
24020, 서구,080004, 78세,2021,1516,675,841,80.3,1514,675,839,80.5
24020, 서구,080005, 79세,2021,1847,771,1076,71.7,1846,771,1075,71.7
24020, 서구,085,80~84세,2021,5633,2202,3431,64.2,5620,2198,3422,64.2
24020, 서구,085001, 80세,2021,1401,581,820,70.9,1399,580,819,70.8
24020, 서구,085002, 81세,2021,1193,472,721,65.5,1189,471,718,65.6
24020, 서구,085003, 82세,2021,1159,444,715,62.1,1156,442,714,61.9
24020, 서구,085004, 83세,2021,1043,390,653,59.7,1040,390,650,60
24020, 서구,085005, 84세,2021,837,315,522,60.3,836,315,521,60.5
24020, 서구,090,85~89세,2021,2756,882,1874,47.1,2751,880,1871,47
24020, 서구,090001, 85세,2021,725,248,477,52,723,247,476,51.9
24020, 서구,090002, 86세,2021,670,248,422,58.8,668,247,421,58.7
24020, 서구,090003, 87세,2021,567,164,403,40.7,566,164,402,40.8
24020, 서구,090004, 88세,2021,443,130,313,41.5,443,130,313,41.5
24020, 서구,090005, 89세,2021,351,92,259,35.5,351,92,259,35.5
24020, 서구,095,90~94세,2021,916,237,679,34.9,915,236,679,34.8
24020, 서구,095001, 90세,2021,245,65,180,36.1,245,65,180,36.1
24020, 서구,095002, 91세,2021,247,55,192,28.6,247,55,192,28.6
24020, 서구,095003, 92세,2021,208,68,140,48.6,207,67,140,47.9
24020, 서구,095004, 93세,2021,124,29,95,30.5,124,29,95,30.5
24020, 서구,095005, 94세,2021,92,20,72,27.8,92,20,72,27.8
24020, 서구,100,95~99세,2021,210,29,181,16,209,29,180,16.1
24020, 서구,100001, 95세,2021,76,12,64,18.8,76,12,64,18.8
24020, 서구,100002, 96세,2021,43,7,36,19.4,43,7,36,19.4
24020, 서구,100003, 97세,2021,31,5,26,19.2,31,5,26,19.2
24020, 서구,100004, 98세,2021,32,X,30,6.7,31,X,29,6.9
24020, 서구,100005, 99세,2021,28,X,25,12,28,X,25,12
24020, 서구,101,100세이상,2021,32,X,31,3.2,32,X,31,3.2
24020, 서구,102,15세미만,2021,34359,17878,16481,108.5,34246,17808,16438,108.3
24020, 서구,103,15~64세,2021,212194,105938,106256,99.7,210158,105063,105095,100
24020, 서구,104,65세이상,2021,44012,19255,24757,77.8,43912,19220,24692,77.8
24020, 서구,086,85세이상,2021,3914,1149,2765,41.6,3907,1146,2761,41.5
24020, 서구,126,평균연령,2021,42.7,41.6,43.8,,42.7,41.6,43.8,
24020, 서구,127,중위연령,2021,44.1,42.8,45.4,,44.2,42.9,45.5,
24030, 남구,000,합계,2021,216266,103912,112354,92.5,214319,103150,111169,92.8
24030, 남구,005,0~4세,2021,6331,3242,3089,105,6304,3230,3074,105.1
24030, 남구,005001, 0세,2021,1053,529,524,101,1048,525,523,100.4
24030, 남구,005002, 1세,2021,1020,528,492,107.3,1016,527,489,107.8
24030, 남구,005003, 2세,2021,1279,632,647,97.7,1274,630,644,97.8
24030, 남구,005004, 3세,2021,1383,720,663,108.6,1381,719,662,108.6
24030, 남구,005005, 4세,2021,1596,833,763,109.2,1585,829,756,109.7
24030, 남구,010,5~9세,2021,10497,5313,5184,102.5,10456,5296,5160,102.6
24030, 남구,010001, 5세,2021,1837,908,929,97.7,1826,905,921,98.3
24030, 남구,010002, 6세,2021,2036,1053,983,107.1,2029,1049,980,107
24030, 남구,010003, 7세,2021,2179,1094,1085,100.8,2171,1089,1082,100.6
24030, 남구,010004, 8세,2021,2092,1052,1040,101.2,2084,1048,1036,101.2
24030, 남구,010005, 9세,2021,2353,1206,1147,105.1,2346,1205,1141,105.6
24030, 남구,015,10~14세,2021,11215,5609,5606,100.1,11206,5603,5603,100
24030, 남구,015001, 10세,2021,2230,1114,1116,99.8,2228,1113,1115,99.8
24030, 남구,015002, 11세,2021,2233,1108,1125,98.5,2231,1106,1125,98.3
24030, 남구,015003, 12세,2021,2147,1079,1068,101,2146,1079,1067,101.1
24030, 남구,015004, 13세,2021,2222,1134,1088,104.2,2219,1132,1087,104.1
24030, 남구,015005, 14세,2021,2383,1174,1209,97.1,2382,1173,1209,97
24030, 남구,020,15~19세,2021,11042,5475,5567,98.3,10911,5417,5494,98.6
24030, 남구,020001, 15세,2021,2130,1041,1089,95.6,2124,1040,1084,95.9
24030, 남구,020002, 16세,2021,2050,1013,1037,97.7,2050,1013,1037,97.7
24030, 남구,020003, 17세,2021,2139,1076,1063,101.2,2134,1073,1061,101.1
24030, 남구,020004, 18세,2021,2207,1110,1097,101.2,2182,1098,1084,101.3
24030, 남구,020005, 19세,2021,2516,1235,1281,96.4,2421,1193,1228,97.1
24030, 남구,025,20~24세,2021,14711,7376,7335,100.6,14218,7161,7057,101.5
24030, 남구,025001, 20세,2021,2825,1359,1466,92.7,2701,1306,1395,93.6
24030, 남구,025002, 21세,2021,3069,1534,1535,99.9,2946,1475,1471,100.3
24030, 남구,025003, 22세,2021,2921,1451,1470,98.7,2833,1412,1421,99.4
24030, 남구,025004, 23세,2021,3037,1541,1496,103,2950,1505,1445,104.2
24030, 남구,025005, 24세,2021,2859,1491,1368,109,2788,1463,1325,110.4
24030, 남구,030,25~29세,2021,13687,6972,6715,103.8,13423,6883,6540,105.2
24030, 남구,030001, 25세,2021,2832,1432,1400,102.3,2754,1398,1356,103.1
24030, 남구,030002, 26세,2021,2822,1424,1398,101.9,2769,1406,1363,103.2
24030, 남구,030003, 27세,2021,2799,1485,1314,113,2759,1474,1285,114.7
24030, 남구,030004, 28세,2021,2693,1386,1307,106,2645,1368,1277,107.1
24030, 남구,030005, 29세,2021,2541,1245,1296,96.1,2496,1237,1259,98.3
24030, 남구,035,30~34세,2021,11164,5645,5519,102.3,10951,5569,5382,103.5
24030, 남구,035001, 30세,2021,2401,1208,1193,101.3,2365,1194,1171,102
24030, 남구,035002, 31세,2021,2257,1143,1114,102.6,2200,1121,1079,103.9
24030, 남구,035003, 32세,2021,2154,1102,1052,104.8,2122,1090,1032,105.6
24030, 남구,035004, 33세,2021,2125,1095,1030,106.3,2079,1082,997,108.5
24030, 남구,035005, 34세,2021,2227,1097,1130,97.1,2185,1082,1103,98.1
24030, 남구,040,35~39세,2021,13915,6720,7195,93.4,13734,6674,7060,94.5
24030, 남구,040001, 35세,2021,2269,1099,1170,93.9,2223,1085,1138,95.3
24030, 남구,040002, 36세,2021,2453,1152,1301,88.5,2414,1145,1269,90.2
24030, 남구,040003, 37세,2021,2695,1337,1358,98.5,2656,1326,1330,99.7
24030, 남구,040004, 38세,2021,3081,1515,1566,96.7,3053,1509,1544,97.7
24030, 남구,040005, 39세,2021,3417,1617,1800,89.8,3388,1609,1779,90.4
24030, 남구,045,40~44세,2021,16681,8162,8519,95.8,16548,8111,8437,96.1
24030, 남구,045001, 40세,2021,3422,1650,1772,93.1,3393,1640,1753,93.6
24030, 남구,045002, 41세,2021,3446,1674,1772,94.5,3422,1666,1756,94.9
24030, 남구,045003, 42세,2021,3438,1684,1754,96,3402,1668,1734,96.2
24030, 남구,045004, 43세,2021,3031,1496,1535,97.5,3005,1485,1520,97.7
24030, 남구,045005, 44세,2021,3344,1658,1686,98.3,3326,1652,1674,98.7
24030, 남구,050,45~49세,2021,17119,8543,8576,99.6,16991,8490,8501,99.9
24030, 남구,050001, 45세,2021,3236,1626,1610,101,3214,1615,1599,101
24030, 남구,050002, 46세,2021,3210,1611,1599,100.8,3184,1602,1582,101.3
24030, 남구,050003, 47세,2021,3551,1784,1767,101,3531,1777,1754,101.3
24030, 남구,050004, 48세,2021,3492,1682,1810,92.9,3470,1673,1797,93.1
24030, 남구,050005, 49세,2021,3630,1840,1790,102.8,3592,1823,1769,103.1
24030, 남구,055,50~54세,2021,17525,8448,9077,93.1,17412,8405,9007,93.3
24030, 남구,055001, 50세,2021,3715,1804,1911,94.4,3696,1796,1900,94.5
24030, 남구,055002, 51세,2021,3521,1683,1838,91.6,3497,1677,1820,92.1
24030, 남구,055003, 52세,2021,3440,1709,1731,98.7,3420,1699,1721,98.7
24030, 남구,055004, 53세,2021,3586,1683,1903,88.4,3563,1673,1890,88.5
24030, 남구,055005, 54세,2021,3263,1569,1694,92.6,3236,1560,1676,93.1
24030, 남구,060,55~59세,2021,15954,7588,8366,90.7,15848,7545,8303,90.9
24030, 남구,060001, 55세,2021,3210,1556,1654,94.1,3181,1544,1637,94.3
24030, 남구,060002, 56세,2021,3237,1539,1698,90.6,3218,1529,1689,90.5
24030, 남구,060003, 57세,2021,2992,1450,1542,94,2970,1440,1530,94.1
24030, 남구,060004, 58세,2021,3286,1588,1698,93.5,3263,1585,1678,94.5
24030, 남구,060005, 59세,2021,3229,1455,1774,82,3216,1447,1769,81.8
24030, 남구,065,60~64세,2021,16996,7813,9183,85.1,16948,7790,9158,85.1
24030, 남구,065001, 60세,2021,3518,1601,1917,83.5,3506,1597,1909,83.7
24030, 남구,065002, 61세,2021,3734,1712,2022,84.7,3723,1708,2015,84.8
24030, 남구,065003, 62세,2021,3376,1561,1815,86,3371,1556,1815,85.7
24030, 남구,065004, 63세,2021,3202,1499,1703,88,3194,1494,1700,87.9
24030, 남구,065005, 64세,2021,3166,1440,1726,83.4,3154,1435,1719,83.5
24030, 남구,070,65~69세,2021,12565,5849,6716,87.1,12527,5827,6700,87
24030, 남구,070001, 65세,2021,2768,1343,1425,94.2,2757,1338,1419,94.3
24030, 남구,070002, 66세,2021,2860,1302,1558,83.6,2855,1299,1556,83.5
24030, 남구,070003, 67세,2021,2326,1056,1270,83.1,2320,1051,1269,82.8
24030, 남구,070004, 68세,2021,2208,1024,1184,86.5,2200,1019,1181,86.3
24030, 남구,070005, 69세,2021,2403,1124,1279,87.9,2395,1120,1275,87.8
24030, 남구,075,70~74세,2021,10251,4581,5670,80.8,10240,4577,5663,80.8
24030, 남구,075001, 70세,2021,1945,855,1090,78.4,1941,853,1088,78.4
24030, 남구,075002, 71세,2021,2083,954,1129,84.5,2079,954,1125,84.8
24030, 남구,075003, 72세,2021,2156,965,1191,81,2155,964,1191,80.9
24030, 남구,075004, 73세,2021,1988,884,1104,80.1,1987,883,1104,80
24030, 남구,075005, 74세,2021,2079,923,1156,79.8,2078,923,1155,79.9
24030, 남구,080,75~79세,2021,7515,3394,4121,82.4,7508,3391,4117,82.4
24030, 남구,080001, 75세,2021,1536,700,836,83.7,1533,698,835,83.6
24030, 남구,080002, 76세,2021,1473,674,799,84.4,1470,673,797,84.4
24030, 남구,080003, 77세,2021,1418,625,793,78.8,1418,625,793,78.8
24030, 남구,080004, 78세,2021,1339,597,742,80.5,1339,597,742,80.5
24030, 남구,080005, 79세,2021,1749,798,951,83.9,1748,798,950,84
24030, 남구,085,80~84세,2021,5317,2118,3199,66.2,5313,2117,3196,66.2
24030, 남구,085001, 80세,2021,1314,538,776,69.3,1312,538,774,69.5
24030, 남구,085002, 81세,2021,1128,463,665,69.6,1127,463,664,69.7
24030, 남구,085003, 82세,2021,1070,462,608,76,1070,462,608,76
24030, 남구,085004, 83세,2021,964,363,601,60.4,964,363,601,60.4
24030, 남구,085005, 84세,2021,841,292,549,53.2,840,291,549,53
24030, 남구,090,85~89세,2021,2619,817,1802,45.3,2619,817,1802,45.3
24030, 남구,090001, 85세,2021,685,229,456,50.2,685,229,456,50.2
24030, 남구,090002, 86세,2021,639,201,438,45.9,639,201,438,45.9
24030, 남구,090003, 87세,2021,543,177,366,48.4,543,177,366,48.4
24030, 남구,090004, 88세,2021,421,117,304,38.5,421,117,304,38.5
24030, 남구,090005, 89세,2021,331,93,238,39.1,331,93,238,39.1
24030, 남구,095,90~94세,2021,936,210,726,28.9,936,210,726,28.9
24030, 남구,095001, 90세,2021,252,62,190,32.6,252,62,190,32.6
24030, 남구,095002, 91세,2021,278,62,216,28.7,278,62,216,28.7
24030, 남구,095003, 92세,2021,181,46,135,34.1,181,46,135,34.1
24030, 남구,095004, 93세,2021,127,22,105,21,127,22,105,21
24030, 남구,095005, 94세,2021,98,18,80,22.5,98,18,80,22.5
24030, 남구,100,95~99세,2021,200,35,165,21.2,200,35,165,21.2
24030, 남구,100001, 95세,2021,62,9,53,17,62,9,53,17
24030, 남구,100002, 96세,2021,53,9,44,20.5,53,9,44,20.5
24030, 남구,100003, 97세,2021,33,10,23,43.5,33,10,23,43.5
24030, 남구,100004, 98세,2021,39,6,33,18.2,39,6,33,18.2
24030, 남구,100005, 99세,2021,13,X,12,8.3,13,X,12,8.3
24030, 남구,101,100세이상,2021,26,X,24,8.3,26,X,24,8.3
24030, 남구,102,15세미만,2021,28043,14164,13879,102.1,27966,14129,13837,102.1
24030, 남구,103,15~64세,2021,148794,72742,76052,95.6,146984,72045,74939,96.1
24030, 남구,104,65세이상,2021,39429,17006,22423,75.8,39369,16976,22393,75.8
24030, 남구,086,85세이상,2021,3781,1064,2717,39.2,3781,1064,2717,39.2
24030, 남구,126,평균연령,2021,43.4,42.2,44.5,,43.5,42.3,44.7,
24030, 남구,127,중위연령,2021,44.7,43.4,45.9,,44.8,43.5,46.1,
24040, 북구,000,합계,2021,436997,217227,219770,98.8,431073,214526,216547,99.1
24040, 북구,005,0~4세,2021,13559,6914,6645,104,13444,6861,6583,104.2
24040, 북구,005001, 0세,2021,2509,1290,1219,105.8,2483,1278,1205,106.1
24040, 북구,005002, 1세,2021,2351,1181,1170,100.9,2327,1167,1160,100.6
24040, 북구,005003, 2세,2021,2637,1310,1327,98.7,2621,1303,1318,98.9
24040, 북구,005004, 3세,2021,2974,1546,1428,108.3,2947,1534,1413,108.6
24040, 북구,005005, 4세,2021,3088,1587,1501,105.7,3066,1579,1487,106.2
24040, 북구,010,5~9세,2021,18562,9502,9060,104.9,18471,9465,9006,105.1
24040, 북구,010001, 5세,2021,3573,1789,1784,100.3,3553,1782,1771,100.6
24040, 북구,010002, 6세,2021,3683,1919,1764,108.8,3658,1905,1753,108.7
24040, 북구,010003, 7세,2021,3643,1815,1828,99.3,3619,1806,1813,99.6
24040, 북구,010004, 8세,2021,3663,1923,1740,110.5,3653,1919,1734,110.7
24040, 북구,010005, 9세,2021,4000,2056,1944,105.8,3988,2053,1935,106.1
24040, 북구,015,10~14세,2021,19723,10378,9345,111.1,19692,10364,9328,111.1
24040, 북구,015001, 10세,2021,3939,2010,1929,104.2,3926,2004,1922,104.3
24040, 북구,015002, 11세,2021,3839,1955,1884,103.8,3832,1952,1880,103.8
24040, 북구,015003, 12세,2021,3790,2052,1738,118.1,3783,2048,1735,118
24040, 북구,015004, 13세,2021,3974,2113,1861,113.5,3971,2112,1859,113.6
24040, 북구,015005, 14세,2021,4181,2248,1933,116.3,4180,2248,1932,116.4
24040, 북구,020,15~19세,2021,22045,11511,10534,109.3,21975,11484,10491,109.5
24040, 북구,020001, 15세,2021,3836,2002,1834,109.2,3832,2001,1831,109.3
24040, 북구,020002, 16세,2021,3837,2042,1795,113.8,3833,2040,1793,113.8
24040, 북구,020003, 17세,2021,4244,2253,1991,113.2,4238,2250,1988,113.2
24040, 북구,020004, 18세,2021,4792,2521,2271,111,4777,2514,2263,111.1
24040, 북구,020005, 19세,2021,5336,2693,2643,101.9,5295,2679,2616,102.4
24040, 북구,025,20~24세,2021,33401,17064,16337,104.5,32282,16522,15760,104.8
24040, 북구,025001, 20세,2021,6117,3037,3080,98.6,5980,2987,2993,99.8
24040, 북구,025002, 21세,2021,6814,3409,3405,100.1,6653,3348,3305,101.3
24040, 북구,025003, 22세,2021,6628,3376,3252,103.8,6394,3256,3138,103.8
24040, 북구,025004, 23세,2021,6754,3462,3292,105.2,6483,3313,3170,104.5
24040, 북구,025005, 24세,2021,7088,3780,3308,114.3,6772,3618,3154,114.7
24040, 북구,030,25~29세,2021,33272,17715,15557,113.9,32033,17129,14904,114.9
24040, 북구,030001, 25세,2021,6984,3784,3200,118.3,6690,3640,3050,119.3
24040, 북구,030002, 26세,2021,6863,3605,3258,110.7,6602,3478,3124,111.3
24040, 북구,030003, 27세,2021,6651,3570,3081,115.9,6424,3466,2958,117.2
24040, 북구,030004, 28세,2021,6413,3432,2981,115.1,6168,3320,2848,116.6
24040, 북구,030005, 29세,2021,6361,3324,3037,109.5,6149,3225,2924,110.3
24040, 북구,035,30~34세,2021,26482,13766,12716,108.3,25580,13356,12224,109.3
24040, 북구,035001, 30세,2021,5766,3031,2735,110.8,5579,2944,2635,111.7
24040, 북구,035002, 31세,2021,5407,2855,2552,111.9,5218,2767,2451,112.9
24040, 북구,035003, 32세,2021,5187,2680,2507,106.9,4987,2590,2397,108.1
24040, 북구,035004, 33세,2021,5016,2601,2415,107.7,4864,2523,2341,107.8
24040, 북구,035005, 34세,2021,5106,2599,2507,103.7,4932,2532,2400,105.5
24040, 북구,040,35~39세,2021,29046,15166,13880,109.3,28379,14868,13511,110
24040, 북구,040001, 35세,2021,5159,2679,2480,108,4995,2604,2391,108.9
24040, 북구,040002, 36세,2021,5235,2747,2488,110.4,5080,2674,2406,111.1
24040, 북구,040003, 37세,2021,5675,3006,2669,112.6,5560,2956,2604,113.5
24040, 북구,040004, 38세,2021,6242,3241,3001,108,6123,3196,2927,109.2
24040, 북구,040005, 39세,2021,6735,3493,3242,107.7,6621,3438,3183,108
24040, 북구,045,40~44세,2021,31789,15957,15832,100.8,31392,15778,15614,101.1
24040, 북구,045001, 40세,2021,6402,3229,3173,101.8,6308,3187,3121,102.1
24040, 북구,045002, 41세,2021,6722,3383,3339,101.3,6650,3350,3300,101.5
24040, 북구,045003, 42세,2021,6567,3283,3284,100,6482,3245,3237,100.2
24040, 북구,045004, 43세,2021,6001,3031,2970,102.1,5923,2992,2931,102.1
24040, 북구,045005, 44세,2021,6097,3031,3066,98.9,6029,3004,3025,99.3
24040, 북구,050,45~49세,2021,34200,17231,16969,101.5,33843,17092,16751,102
24040, 북구,050001, 45세,2021,6132,3167,2965,106.8,6066,3143,2923,107.5
24040, 북구,050002, 46세,2021,6372,3221,3151,102.2,6299,3193,3106,102.8
24040, 북구,050003, 47세,2021,7354,3756,3598,104.4,7282,3729,3553,105
24040, 북구,050004, 48세,2021,7122,3517,3605,97.6,7050,3489,3561,98
24040, 북구,050005, 49세,2021,7220,3570,3650,97.8,7146,3538,3608,98.1
24040, 북구,055,50~54세,2021,37498,18471,19027,97.1,37149,18322,18827,97.3
24040, 북구,055001, 50세,2021,7643,3775,3868,97.6,7559,3733,3826,97.6
24040, 북구,055002, 51세,2021,7519,3692,3827,96.5,7453,3670,3783,97
24040, 북구,055003, 52세,2021,7330,3663,3667,99.9,7269,3641,3628,100.4
24040, 북구,055004, 53세,2021,7812,3888,3924,99.1,7738,3854,3884,99.2
24040, 북구,055005, 54세,2021,7194,3453,3741,92.3,7130,3424,3706,92.4
24040, 북구,060,55~59세,2021,34672,17159,17513,98,34396,17045,17351,98.2
24040, 북구,060001, 55세,2021,7176,3634,3542,102.6,7123,3611,3512,102.8
24040, 북구,060002, 56세,2021,7070,3450,3620,95.3,7003,3427,3576,95.8
24040, 북구,060003, 57세,2021,6575,3258,3317,98.2,6520,3237,3283,98.6
24040, 북구,060004, 58세,2021,7104,3461,3643,95,7053,3439,3614,95.2
24040, 북구,060005, 59세,2021,6747,3356,3391,99,6697,3331,3366,99
24040, 북구,065,60~64세,2021,33971,16435,17536,93.7,33812,16354,17458,93.7
24040, 북구,065001, 60세,2021,7398,3622,3776,95.9,7359,3604,3755,96
24040, 북구,065002, 61세,2021,7830,3752,4078,92,7788,3731,4057,92
24040, 북구,065003, 62세,2021,6964,3373,3591,93.9,6939,3360,3579,93.9
24040, 북구,065004, 63세,2021,5973,2859,3114,91.8,5940,2844,3096,91.9
24040, 북구,065005, 64세,2021,5806,2829,2977,95,5786,2815,2971,94.7
24040, 북구,070,65~69세,2021,22892,10967,11925,92,22804,10923,11881,91.9
24040, 북구,070001, 65세,2021,5020,2484,2536,97.9,4999,2474,2525,98
24040, 북구,070002, 66세,2021,5456,2598,2858,90.9,5436,2588,2848,90.9
24040, 북구,070003, 67세,2021,4417,2119,2298,92.2,4398,2108,2290,92.1
24040, 북구,070004, 68세,2021,3764,1769,1995,88.7,3753,1764,1989,88.7
24040, 북구,070005, 69세,2021,4235,1997,2238,89.2,4218,1989,2229,89.2
24040, 북구,075,70~74세,2021,17674,8213,9461,86.8,17642,8199,9443,86.8
24040, 북구,075001, 70세,2021,3526,1669,1857,89.9,3515,1663,1852,89.8
24040, 북구,075002, 71세,2021,3610,1703,1907,89.3,3603,1700,1903,89.3
24040, 북구,075003, 72세,2021,3742,1744,1998,87.3,3736,1742,1994,87.4
24040, 북구,075004, 73세,2021,3414,1566,1848,84.7,3412,1566,1846,84.8
24040, 북구,075005, 74세,2021,3382,1531,1851,82.7,3376,1528,1848,82.7
24040, 북구,080,75~79세,2021,12878,5646,7232,78.1,12867,5642,7225,78.1
24040, 북구,080001, 75세,2021,2598,1186,1412,84,2598,1186,1412,84
24040, 북구,080002, 76세,2021,2539,1098,1441,76.2,2536,1097,1439,76.2
24040, 북구,080003, 77세,2021,2360,1013,1347,75.2,2356,1012,1344,75.3
24040, 북구,080004, 78세,2021,2343,1008,1335,75.5,2341,1007,1334,75.5
24040, 북구,080005, 79세,2021,3038,1341,1697,79,3036,1340,1696,79
24040, 북구,085,80~84세,2021,8846,3400,5446,62.4,8836,3395,5441,62.4
24040, 북구,085001, 80세,2021,2170,873,1297,67.3,2165,871,1294,67.3
24040, 북구,085002, 81세,2021,1887,710,1177,60.3,1885,708,1177,60.2
24040, 북구,085003, 82세,2021,1800,704,1096,64.2,1798,704,1094,64.4
24040, 북구,085004, 83세,2021,1579,591,988,59.8,1578,590,988,59.7
24040, 북구,085005, 84세,2021,1410,522,888,58.8,1410,522,888,58.8
24040, 북구,090,85~89세,2021,4510,1326,3184,41.6,4500,1321,3179,41.6
24040, 북구,090001, 85세,2021,1137,374,763,49,1133,372,761,48.9
24040, 북구,090002, 86세,2021,1087,305,782,39,1084,304,780,39
24040, 북구,090003, 87세,2021,971,280,691,40.5,970,280,690,40.6
24040, 북구,090004, 88세,2021,707,206,501,41.1,706,205,501,40.9
24040, 북구,090005, 89세,2021,608,161,447,36,607,160,447,35.8
24040, 북구,095,90~94세,2021,1629,346,1283,27,1628,346,1282,27
24040, 북구,095001, 90세,2021,497,116,381,30.4,497,116,381,30.4
24040, 북구,095002, 91세,2021,443,81,362,22.4,443,81,362,22.4
24040, 북구,095003, 92세,2021,280,71,209,34,280,71,209,34
24040, 북구,095004, 93세,2021,243,45,198,22.7,243,45,198,22.7
24040, 북구,095005, 94세,2021,166,33,133,24.8,165,33,132,25
24040, 북구,100,95~99세,2021,298,55,243,22.6,298,55,243,22.6
24040, 북구,100001, 95세,2021,115,20,95,21.1,115,20,95,21.1
24040, 북구,100002, 96세,2021,73,14,59,23.7,73,14,59,23.7
24040, 북구,100003, 97세,2021,32,7,25,28,32,7,25,28
24040, 북구,100004, 98세,2021,46,8,38,21.1,46,8,38,21.1
24040, 북구,100005, 99세,2021,32,6,26,23.1,32,6,26,23.1
24040, 북구,101,100세이상,2021,50,5,45,11.1,50,5,45,11.1
24040, 북구,102,15세미만,2021,51844,26794,25050,107,51607,26690,24917,107.1
24040, 북구,103,15~64세,2021,316376,160475,155901,102.9,310841,157950,152891,103.3
24040, 북구,104,65세이상,2021,68777,29958,38819,77.2,68625,29886,38739,77.1
24040, 북구,086,85세이상,2021,6487,1732,4755,36.4,6476,1727,4749,36.4
24040, 북구,126,평균연령,2021,42.6,41.4,43.8,,42.7,41.5,43.9,
24040, 북구,127,중위연령,2021,43.5,42,45,,43.7,42.2,45.3,
24050, 광산구,000,합계,2021,422758,213977,208781,102.5,404549,203489,201060,101.2
24050, 광산구,005,0~4세,2021,15187,7725,7462,103.5,14731,7496,7235,103.6
24050, 광산구,005001, 0세,2021,2597,1313,1284,102.3,2498,1270,1228,103.4
24050, 광산구,005002, 1세,2021,2629,1323,1306,101.3,2547,1282,1265,101.3
24050, 광산구,005003, 2세,2021,2949,1498,1451,103.2,2867,1456,1411,103.2
24050, 광산구,005004, 3세,2021,3308,1719,1589,108.2,3212,1664,1548,107.5
24050, 광산구,005005, 4세,2021,3704,1872,1832,102.2,3607,1824,1783,102.3
24050, 광산구,010,5~9세,2021,23447,12097,11350,106.6,22999,11869,11130,106.6
24050, 광산구,010001, 5세,2021,4390,2245,2145,104.7,4286,2189,2097,104.4
24050, 광산구,010002, 6세,2021,4493,2327,2166,107.4,4391,2275,2116,107.5
24050, 광산구,010003, 7세,2021,4553,2334,2219,105.2,4453,2281,2172,105
24050, 광산구,010004, 8세,2021,4734,2427,2307,105.2,4656,2390,2266,105.5
24050, 광산구,010005, 9세,2021,5277,2764,2513,110,5213,2734,2479,110.3
24050, 광산구,015,10~14세,2021,25819,13267,12552,105.7,25522,13119,12403,105.8
24050, 광산구,015001, 10세,2021,5120,2671,2449,109.1,5052,2634,2418,108.9
24050, 광산구,015002, 11세,2021,5135,2633,2502,105.2,5071,2602,2469,105.4
24050, 광산구,015003, 12세,2021,4968,2493,2475,100.7,4912,2464,2448,100.7
24050, 광산구,015004, 13세,2021,5143,2657,2486,106.9,5091,2631,2460,107
24050, 광산구,015005, 14세,2021,5453,2813,2640,106.6,5396,2788,2608,106.9
24050, 광산구,020,15~19세,2021,25766,13011,12755,102,25329,12792,12537,102
24050, 광산구,020001, 15세,2021,4980,2550,2430,104.9,4910,2515,2395,105
24050, 광산구,020002, 16세,2021,4825,2486,2339,106.3,4782,2462,2320,106.1
24050, 광산구,020003, 17세,2021,5068,2632,2436,108,5021,2603,2418,107.7
24050, 광산구,020004, 18세,2021,5437,2789,2648,105.3,5356,2752,2604,105.7
24050, 광산구,020005, 19세,2021,5456,2554,2902,88,5260,2460,2800,87.9
24050, 광산구,025,20~24세,2021,33740,17342,16398,105.8,30742,15610,15132,103.2
24050, 광산구,025001, 20세,2021,6536,3170,3366,94.2,6132,3005,3127,96.1
24050, 광산구,025002, 21세,2021,7310,3643,3667,99.3,6672,3293,3379,97.5
24050, 광산구,025003, 22세,2021,6785,3465,3320,104.4,6125,3075,3050,100.8
24050, 광산구,025004, 23세,2021,6668,3556,3112,114.3,6019,3147,2872,109.6
24050, 광산구,025005, 24세,2021,6441,3508,2933,119.6,5794,3090,2704,114.3
24050, 광산구,030,25~29세,2021,30879,16847,14032,120.1,27900,14961,12939,115.6
24050, 광산구,030001, 25세,2021,6394,3476,2918,119.1,5800,3101,2699,114.9
24050, 광산구,030002, 26세,2021,6156,3352,2804,119.5,5578,2990,2588,115.5
24050, 광산구,030003, 27세,2021,6215,3400,2815,120.8,5589,2996,2593,115.5
24050, 광산구,030004, 28세,2021,6042,3295,2747,119.9,5457,2937,2520,116.5
24050, 광산구,030005, 29세,2021,6072,3324,2748,121,5476,2937,2539,115.7
24050, 광산구,035,30~34세,2021,26285,13885,12400,112,23343,12073,11270,107.1
24050, 광산구,035001, 30세,2021,5621,3007,2614,115,5030,2635,2395,110
24050, 광산구,035002, 31세,2021,5340,2832,2508,112.9,4750,2475,2275,108.8
24050, 광산구,035003, 32세,2021,4975,2630,2345,112.2,4381,2264,2117,106.9
24050, 광산구,035004, 33세,2021,5035,2591,2444,106,4453,2249,2204,102
24050, 광산구,035005, 34세,2021,5314,2825,2489,113.5,4729,2450,2279,107.5
24050, 광산구,040,35~39세,2021,31562,16209,15353,105.6,29247,14797,14450,102.4
24050, 광산구,040001, 35세,2021,5344,2736,2608,104.9,4861,2444,2417,101.1
24050, 광산구,040002, 36세,2021,5548,2908,2640,110.2,5026,2587,2439,106.1
24050, 광산구,040003, 37세,2021,6058,3129,2929,106.8,5636,2874,2762,104.1
24050, 광산구,040004, 38세,2021,6811,3489,3322,105,6380,3223,3157,102.1
24050, 광산구,040005, 39세,2021,7801,3947,3854,102.4,7344,3669,3675,99.8
24050, 광산구,045,40~44세,2021,37784,18797,18987,99,36135,17835,18300,97.5
24050, 광산구,045001, 40세,2021,7468,3778,3690,102.4,7097,3557,3540,100.5
24050, 광산구,045002, 41세,2021,7889,3892,3997,97.4,7535,3692,3843,96.1
24050, 광산구,045003, 42세,2021,7797,3833,3964,96.7,7478,3648,3830,95.2
24050, 광산구,045004, 43세,2021,7113,3536,3577,98.9,6784,3346,3438,97.3
24050, 광산구,045005, 44세,2021,7517,3758,3759,100,7241,3592,3649,98.4
24050, 광산구,050,45~49세,2021,40148,20278,19870,102.1,38858,19570,19288,101.5
24050, 광산구,050001, 45세,2021,7441,3760,3681,102.1,7161,3587,3574,100.4
24050, 광산구,050002, 46세,2021,7561,3746,3815,98.2,7308,3623,3685,98.3
24050, 광산구,050003, 47세,2021,8430,4224,4206,100.4,8181,4086,4095,99.8
24050, 광산구,050004, 48세,2021,8461,4274,4187,102.1,8222,4141,4081,101.5
24050, 광산구,050005, 49세,2021,8255,4274,3981,107.4,7986,4133,3853,107.3
24050, 광산구,055,50~54세,2021,38554,19886,18668,106.5,37595,19368,18227,106.3
24050, 광산구,055001, 50세,2021,8588,4437,4151,106.9,8370,4309,4061,106.1
24050, 광산구,055002, 51세,2021,7993,4166,3827,108.9,7772,4051,3721,108.9
24050, 광산구,055003, 52세,2021,7630,3925,3705,105.9,7424,3810,3614,105.4
24050, 광산구,055004, 53세,2021,7671,3869,3802,101.8,7518,3791,3727,101.7
24050, 광산구,055005, 54세,2021,6672,3489,3183,109.6,6511,3407,3104,109.8
24050, 광산구,060,55~59세,2021,29482,15590,13892,112.2,28796,15274,13522,113
24050, 광산구,060001, 55세,2021,6666,3465,3201,108.2,6509,3390,3119,108.7
24050, 광산구,060002, 56세,2021,6322,3197,3125,102.3,6190,3125,3065,102
24050, 광산구,060003, 57세,2021,5507,2949,2558,115.3,5357,2893,2464,117.4
24050, 광산구,060004, 58세,2021,5758,3132,2626,119.3,5635,3076,2559,120.2
24050, 광산구,060005, 59세,2021,5229,2847,2382,119.5,5105,2790,2315,120.5
24050, 광산구,065,60~64세,2021,23206,12082,11124,108.6,22794,11881,10913,108.9
24050, 광산구,065001, 60세,2021,5370,2847,2523,112.8,5280,2800,2480,112.9
24050, 광산구,065002, 61세,2021,5388,2811,2577,109.1,5299,2770,2529,109.5
24050, 광산구,065003, 62세,2021,4606,2388,2218,107.7,4525,2351,2174,108.1
24050, 광산구,065004, 63세,2021,4044,2096,1948,107.6,3964,2054,1910,107.5
24050, 광산구,065005, 64세,2021,3798,1940,1858,104.4,3726,1906,1820,104.7
24050, 광산구,070,65~69세,2021,13429,6532,6897,94.7,13218,6450,6768,95.3
24050, 광산구,070001, 65세,2021,3113,1565,1548,101.1,3056,1538,1518,101.3
24050, 광산구,070002, 66세,2021,3186,1563,1623,96.3,3139,1541,1598,96.4
24050, 광산구,070003, 67세,2021,2524,1228,1296,94.8,2478,1214,1264,96
24050, 광산구,070004, 68세,2021,2231,1060,1171,90.5,2202,1051,1151,91.3
24050, 광산구,070005, 69세,2021,2375,1116,1259,88.6,2343,1106,1237,89.4
24050, 광산구,075,70~74세,2021,9979,4501,5478,82.2,9898,4480,5418,82.7
24050, 광산구,075001, 70세,2021,1997,925,1072,86.3,1979,920,1059,86.9
24050, 광산구,075002, 71세,2021,1999,902,1097,82.2,1979,898,1081,83.1
24050, 광산구,075003, 72세,2021,2070,934,1136,82.2,2057,930,1127,82.5
24050, 광산구,075004, 73세,2021,1915,875,1040,84.1,1899,870,1029,84.5
24050, 광산구,075005, 74세,2021,1998,865,1133,76.3,1984,862,1122,76.8
24050, 광산구,080,75~79세,2021,7435,3118,4317,72.2,7402,3109,4293,72.4
24050, 광산구,080001, 75세,2021,1580,746,834,89.4,1572,745,827,90.1
24050, 광산구,080002, 76세,2021,1380,578,802,72.1,1372,576,796,72.4
24050, 광산구,080003, 77세,2021,1337,560,777,72.1,1330,558,772,72.3
24050, 광산구,080004, 78세,2021,1352,546,806,67.7,1346,543,803,67.6
24050, 광산구,080005, 79세,2021,1786,688,1098,62.7,1782,687,1095,62.7
24050, 광산구,085,80~84세,2021,5675,1835,3840,47.8,5664,1831,3833,47.8
24050, 광산구,085001, 80세,2021,1360,475,885,53.7,1357,473,884,53.5
24050, 광산구,085002, 81세,2021,1221,398,823,48.4,1220,398,822,48.4
24050, 광산구,085003, 82세,2021,1130,366,764,47.9,1127,365,762,47.9
24050, 광산구,085004, 83세,2021,1002,324,678,47.8,1001,323,678,47.6
24050, 광산구,085005, 84세,2021,962,272,690,39.4,959,272,687,39.6
24050, 광산구,090,85~89세,2021,3023,740,2283,32.4,3020,739,2281,32.4
24050, 광산구,090001, 85세,2021,739,180,559,32.2,738,179,559,32
24050, 광산구,090002, 86세,2021,768,211,557,37.9,768,211,557,37.9
24050, 광산구,090003, 87세,2021,640,159,481,33.1,640,159,481,33.1
24050, 광산구,090004, 88세,2021,467,96,371,25.9,466,96,370,25.9
24050, 광산구,090005, 89세,2021,409,94,315,29.8,408,94,314,29.9
24050, 광산구,095,90~94세,2021,1101,207,894,23.2,1100,207,893,23.2
24050, 광산구,095001, 90세,2021,291,57,234,24.4,291,57,234,24.4
24050, 광산구,095002, 91세,2021,319,53,266,19.9,318,53,265,20
24050, 광산구,095003, 92세,2021,220,46,174,26.4,220,46,174,26.4
24050, 광산구,095004, 93세,2021,164,31,133,23.3,164,31,133,23.3
24050, 광산구,095005, 94세,2021,107,20,87,23,107,20,87,23
24050, 광산구,100,95~99세,2021,222,25,197,12.7,221,25,196,12.8
24050, 광산구,100001, 95세,2021,73,12,61,19.7,72,12,60,20
24050, 광산구,100002, 96세,2021,53,X,50,6,53,X,50,6
24050, 광산구,100003, 97세,2021,28,7,21,33.3,28,7,21,33.3
24050, 광산구,100004, 98세,2021,48,X,46,4.3,48,X,46,4.3
24050, 광산구,100005, 99세,2021,20,X,19,5.3,20,X,19,5.3
24050, 광산구,101,100세이상,2021,35,X,32,9.4,35,X,32,9.4
24050, 광산구,102,15세미만,2021,64453,33089,31364,105.5,63252,32484,30768,105.6
24050, 광산구,103,15~64세,2021,317406,163927,153479,106.8,300739,154161,146578,105.2
24050, 광산구,104,65세이상,2021,40899,16961,23938,70.9,40558,16844,23714,71
24050, 광산구,086,85세이상,2021,4381,975,3406,28.6,4376,974,3402,28.6
24050, 광산구,126,평균연령,2021,38.7,37.9,39.6,,39,38.2,39.7,
24050, 광산구,127,중위연령,2021,39.8,39.1,40.6,,40.3,39.7,41,
25,대전광역시,000,합계,2021,1479740,740481,739259,100.2,1456477,730007,726470,100.5
25,대전광역시,005,0~4세,2021,44193,22674,21519,105.4,43686,22417,21269,105.4
25,대전광역시,005001, 0세,2021,7616,3976,3640,109.2,7520,3927,3593,109.3
25,대전광역시,005002, 1세,2021,7754,4018,3736,107.5,7655,3971,3684,107.8
25,대전광역시,005003, 2세,2021,8727,4397,4330,101.5,8641,4359,4282,101.8
25,대전광역시,005004, 3세,2021,9403,4809,4594,104.7,9290,4745,4545,104.4
25,대전광역시,005005, 4세,2021,10693,5474,5219,104.9,10580,5415,5165,104.8
25,대전광역시,010,5~9세,2021,63674,32806,30868,106.3,63229,32582,30647,106.3
25,대전광역시,010001, 5세,2021,11969,6229,5740,108.5,11844,6162,5682,108.4
25,대전광역시,010002, 6세,2021,12751,6537,6214,105.2,12636,6475,6161,105.1
25,대전광역시,010003, 7세,2021,12443,6435,6008,107.1,12352,6391,5961,107.2
25,대전광역시,010004, 8세,2021,12963,6584,6379,103.2,12904,6554,6350,103.2
25,대전광역시,010005, 9세,2021,13548,7021,6527,107.6,13493,7000,6493,107.8
25,대전광역시,015,10~14세,2021,68619,35266,33353,105.7,68418,35173,33245,105.8
25,대전광역시,015001, 10세,2021,13854,7128,6726,106,13807,7112,6695,106.2
25,대전광역시,015002, 11세,2021,13268,6786,6482,104.7,13231,6770,6461,104.8
25,대전광역시,015003, 12세,2021,13060,6771,6289,107.7,13017,6752,6265,107.8
25,대전광역시,015004, 13세,2021,13894,7149,6745,106,13853,7125,6728,105.9
25,대전광역시,015005, 14세,2021,14543,7432,7111,104.5,14510,7414,7096,104.5
25,대전광역시,020,15~19세,2021,78502,41386,37116,111.5,77543,40942,36601,111.9
25,대전광역시,020001, 15세,2021,13395,6939,6456,107.5,13360,6924,6436,107.6
25,대전광역시,020002, 16세,2021,13189,6935,6254,110.9,13159,6920,6239,110.9
25,대전광역시,020003, 17세,2021,14859,7862,6997,112.4,14823,7843,6980,112.4
25,대전광역시,020004, 18세,2021,16276,8588,7688,111.7,16055,8485,7570,112.1
25,대전광역시,020005, 19세,2021,20783,11062,9721,113.8,20146,10770,9376,114.9
25,대전광역시,025,20~24세,2021,120355,62073,58282,106.5,115568,59832,55736,107.3
25,대전광역시,025001, 20세,2021,22618,10911,11707,93.2,21633,10473,11160,93.8
25,대전광역시,025002, 21세,2021,24213,11822,12391,95.4,23130,11328,11802,96
25,대전광역시,025003, 22세,2021,24179,12617,11562,109.1,23315,12202,11113,109.8
25,대전광역시,025004, 23세,2021,24784,13407,11377,117.8,23859,12941,10918,118.5
25,대전광역시,025005, 24세,2021,24561,13316,11245,118.4,23631,12888,10743,120
25,대전광역시,030,25~29세,2021,114451,62133,52318,118.8,110698,60457,50241,120.3
25,대전광역시,030001, 25세,2021,23959,13154,10805,121.7,23138,12746,10392,122.7
25,대전광역시,030002, 26세,2021,23432,12857,10575,121.6,22610,12499,10111,123.6
25,대전광역시,030003, 27세,2021,22856,12377,10479,118.1,22131,12061,10070,119.8
25,대전광역시,030004, 28세,2021,22127,11965,10162,117.7,21446,11678,9768,119.6
25,대전광역시,030005, 29세,2021,22077,11780,10297,114.4,21373,11473,9900,115.9
25,대전광역시,035,30~34세,2021,93871,50231,43640,115.1,90640,48766,41874,116.5
25,대전광역시,035001, 30세,2021,20292,10748,9544,112.6,19653,10459,9194,113.8
25,대전광역시,035002, 31세,2021,19234,10408,8826,117.9,18555,10104,8451,119.6
25,대전광역시,035003, 32세,2021,18465,9942,8523,116.6,17795,9650,8145,118.5
25,대전광역시,035004, 33세,2021,18198,9847,8351,117.9,17539,9547,7992,119.5
25,대전광역시,035005, 34세,2021,17682,9286,8396,110.6,17098,9006,8092,111.3
25,대전광역시,040,35~39세,2021,97511,50060,47451,105.5,95114,49027,46087,106.4
25,대전광역시,040001, 35세,2021,17967,9393,8574,109.6,17415,9158,8257,110.9
25,대전광역시,040002, 36세,2021,18176,9434,8742,107.9,17686,9223,8463,109
25,대전광역시,040003, 37세,2021,18495,9452,9043,104.5,18034,9248,8786,105.3
25,대전광역시,040004, 38세,2021,20559,10550,10009,105.4,20110,10352,9758,106.1
25,대전광역시,040005, 39세,2021,22314,11231,11083,101.3,21869,11046,10823,102.1
25,대전광역시,045,40~44세,2021,110452,55051,55401,99.4,108709,54282,54427,99.7
25,대전광역시,045001, 40세,2021,22737,11451,11286,101.5,22325,11265,11060,101.9
25,대전광역시,045002, 41세,2021,23054,11532,11522,100.1,22689,11375,11314,100.5
25,대전광역시,045003, 42세,2021,22012,10949,11063,99,21640,10791,10849,99.5
25,대전광역시,045004, 43세,2021,20950,10385,10565,98.3,20622,10230,10392,98.4
25,대전광역시,045005, 44세,2021,21699,10734,10965,97.9,21433,10621,10812,98.2
25,대전광역시,050,45~49세,2021,118451,58917,59534,99,117052,58301,58751,99.2
25,대전광역시,050001, 45세,2021,21342,10543,10799,97.6,21049,10427,10622,98.2
25,대전광역시,050002, 46세,2021,22395,11141,11254,99,22115,11019,11096,99.3
25,대전광역시,050003, 47세,2021,24913,12410,12503,99.3,24647,12304,12343,99.7
25,대전광역시,050004, 48세,2021,25195,12428,12767,97.3,24920,12287,12633,97.3
25,대전광역시,050005, 49세,2021,24606,12395,12211,101.5,24321,12264,12057,101.7
25,대전광역시,055,50~54세,2021,128354,63875,64479,99.1,127049,63294,63755,99.3
25,대전광역시,055001, 50세,2021,26856,13472,13384,100.7,26568,13345,13223,100.9
25,대전광역시,055002, 51세,2021,25410,12784,12626,101.3,25115,12652,12463,101.5
25,대전광역시,055003, 52세,2021,26562,13237,13325,99.3,26305,13117,13188,99.5
25,대전광역시,055004, 53세,2021,26355,12910,13445,96,26104,12795,13309,96.1
25,대전광역시,055005, 54세,2021,23171,11472,11699,98.1,22957,11385,11572,98.4
25,대전광역시,060,55~59세,2021,109814,54891,54923,99.9,108750,54442,54308,100.2
25,대전광역시,060001, 55세,2021,21692,11001,10691,102.9,21459,10905,10554,103.3
25,대전광역시,060002, 56세,2021,22822,11299,11523,98.1,22618,11210,11408,98.3
25,대전광역시,060003, 57세,2021,20774,10291,10483,98.2,20565,10205,10360,98.5
25,대전광역시,060004, 58세,2021,21467,10790,10677,101.1,21241,10689,10552,101.3
25,대전광역시,060005, 59세,2021,23059,11510,11549,99.7,22867,11433,11434,100
25,대전광역시,065,60~64세,2021,110624,53963,56661,95.2,109919,53662,56257,95.4
25,대전광역시,065001, 60세,2021,25465,12425,13040,95.3,25328,12377,12951,95.6
25,대전광역시,065002, 61세,2021,24406,11733,12673,92.6,24244,11665,12579,92.7
25,대전광역시,065003, 62세,2021,21389,10383,11006,94.3,21251,10322,10929,94.4
25,대전광역시,065004, 63세,2021,19652,9647,10005,96.4,19511,9579,9932,96.4
25,대전광역시,065005, 64세,2021,19712,9775,9937,98.4,19585,9719,9866,98.5
25,대전광역시,070,65~69세,2021,78382,37797,40585,93.1,77964,37606,40358,93.2
25,대전광역시,070001, 65세,2021,18135,8858,9277,95.5,18030,8809,9221,95.5
25,대전광역시,070002, 66세,2021,18235,8793,9442,93.1,18137,8745,9392,93.1
25,대전광역시,070003, 67세,2021,15303,7264,8039,90.4,15204,7221,7983,90.5
25,대전광역시,070004, 68세,2021,12822,6193,6629,93.4,12758,6163,6595,93.4
25,대전광역시,070005, 69세,2021,13887,6689,7198,92.9,13835,6668,7167,93
25,대전광역시,075,70~74세,2021,53165,24976,28189,88.6,52965,24898,28067,88.7
25,대전광역시,075001, 70세,2021,10239,4880,5359,91.1,10186,4862,5324,91.3
25,대전광역시,075002, 71세,2021,11542,5461,6081,89.8,11498,5444,6054,89.9
25,대전광역시,075003, 72세,2021,11078,5226,5852,89.3,11032,5210,5822,89.5
25,대전광역시,075004, 73세,2021,10463,4906,5557,88.3,10443,4896,5547,88.3
25,대전광역시,075005, 74세,2021,9843,4503,5340,84.3,9806,4486,5320,84.3
25,대전광역시,080,75~79세,2021,39281,17255,22026,78.3,39211,17227,21984,78.4
25,대전광역시,080001, 75세,2021,7564,3528,4036,87.4,7538,3523,4015,87.7
25,대전광역시,080002, 76세,2021,7480,3361,4119,81.6,7465,3354,4111,81.6
25,대전광역시,080003, 77세,2021,7650,3297,4353,75.7,7639,3291,4348,75.7
25,대전광역시,080004, 78세,2021,7511,3192,4319,73.9,7501,3186,4315,73.8
25,대전광역시,080005, 79세,2021,9076,3877,5199,74.6,9068,3873,5195,74.6
25,대전광역시,085,80~84세,2021,28204,10902,17302,63,28145,10885,17260,63.1
25,대전광역시,085001, 80세,2021,6661,2711,3950,68.6,6648,2708,3940,68.7
25,대전광역시,085002, 81세,2021,5734,2263,3471,65.2,5717,2258,3459,65.3
25,대전광역시,085003, 82세,2021,5947,2274,3673,61.9,5932,2270,3662,62
25,대전광역시,085004, 83세,2021,5309,2004,3305,60.6,5302,2002,3300,60.7
25,대전광역시,085005, 84세,2021,4553,1650,2903,56.8,4546,1647,2899,56.8
25,대전광역시,090,85~89세,2021,15320,4792,10528,45.5,15308,4786,10522,45.5
25,대전광역시,090001, 85세,2021,4092,1346,2746,49,4091,1346,2745,49
25,대전광역시,090002, 86세,2021,3664,1161,2503,46.4,3659,1158,2501,46.3
25,대전광역시,090003, 87세,2021,3052,970,2082,46.6,3047,968,2079,46.6
25,대전광역시,090004, 88세,2021,2432,730,1702,42.9,2432,730,1702,42.9
25,대전광역시,090005, 89세,2021,2080,585,1495,39.1,2079,584,1495,39.1
25,대전광역시,095,90~94세,2021,5257,1204,4053,29.7,5250,1200,4050,29.6
25,대전광역시,095001, 90세,2021,1496,362,1134,31.9,1496,362,1134,31.9
25,대전광역시,095002, 91세,2021,1287,301,986,30.5,1287,301,986,30.5
25,대전광역시,095003, 92세,2021,1036,229,807,28.4,1034,227,807,28.1
25,대전광역시,095004, 93세,2021,837,178,659,27,834,177,657,26.9
25,대전광역시,095005, 94세,2021,601,134,467,28.7,599,133,466,28.5
25,대전광역시,100,95~99세,2021,1094,202,892,22.6,1094,202,892,22.6
25,대전광역시,100001, 95세,2021,352,82,270,30.4,352,82,270,30.4
25,대전광역시,100002, 96세,2021,284,45,239,18.8,284,45,239,18.8
25,대전광역시,100003, 97세,2021,188,31,157,19.7,188,31,157,19.7
25,대전광역시,100004, 98세,2021,163,23,140,16.4,163,23,140,16.4
25,대전광역시,100005, 99세,2021,107,21,86,24.4,107,21,86,24.4
25,대전광역시,101,100세이상,2021,166,27,139,19.4,165,26,139,18.7
25,대전광역시,102,15세미만,2021,176486,90746,85740,105.8,175333,90172,85161,105.9
25,대전광역시,103,15~64세,2021,1082385,552580,529805,104.3,1061042,543005,518037,104.8
25,대전광역시,104,65세이상,2021,220869,97155,123714,78.5,220102,96830,123272,78.5
25,대전광역시,086,85세이상,2021,21837,6225,15612,39.9,21817,6214,15603,39.8
25,대전광역시,126,평균연령,2021,42,40.9,43.1,,42.1,41,43.3,
25,대전광역시,127,중위연령,2021,42.6,41.2,44.1,,42.8,41.4,44.4,
25010, 동구,000,합계,2021,233721,117546,116175,101.2,228148,115008,113140,101.7
25010, 동구,005,0~4세,2021,5917,3084,2833,108.9,5857,3052,2805,108.8
25010, 동구,005001, 0세,2021,971,515,456,112.9,962,511,451,113.3
25010, 동구,005002, 1세,2021,1029,524,505,103.8,1019,519,500,103.8
25010, 동구,005003, 2세,2021,1198,615,583,105.5,1186,611,575,106.3
25010, 동구,005004, 3세,2021,1269,687,582,118,1256,678,578,117.3
25010, 동구,005005, 4세,2021,1450,743,707,105.1,1434,733,701,104.6
25010, 동구,010,5~9세,2021,8423,4363,4060,107.5,8361,4331,4030,107.5
25010, 동구,010001, 5세,2021,1556,819,737,111.1,1533,810,723,112
25010, 동구,010002, 6세,2021,1681,874,807,108.3,1669,864,805,107.3
25010, 동구,010003, 7세,2021,1688,897,791,113.4,1677,892,785,113.6
25010, 동구,010004, 8세,2021,1686,833,853,97.7,1679,829,850,97.5
25010, 동구,010005, 9세,2021,1812,940,872,107.8,1803,936,867,108
25010, 동구,015,10~14세,2021,9237,4778,4459,107.2,9209,4763,4446,107.1
25010, 동구,015001, 10세,2021,1854,941,913,103.1,1849,940,909,103.4
25010, 동구,015002, 11세,2021,1767,920,847,108.6,1766,919,847,108.5
25010, 동구,015003, 12세,2021,1743,936,807,116,1735,932,803,116.1
25010, 동구,015004, 13세,2021,1935,986,949,103.9,1927,980,947,103.5
25010, 동구,015005, 14세,2021,1938,995,943,105.5,1932,992,940,105.5
25010, 동구,020,15~19세,2021,12955,6861,6094,112.6,12603,6692,5911,113.2
25010, 동구,020001, 15세,2021,1825,946,879,107.6,1823,944,879,107.4
25010, 동구,020002, 16세,2021,1838,1010,828,122,1830,1007,823,122.4
25010, 동구,020003, 17세,2021,2198,1186,1012,117.2,2186,1181,1005,117.5
25010, 동구,020004, 18세,2021,2599,1400,1199,116.8,2514,1357,1157,117.3
25010, 동구,020005, 19세,2021,4495,2319,2176,106.6,4250,2203,2047,107.6
25010, 동구,025,20~24세,2021,23198,11775,11423,103.1,21263,10834,10429,103.9
25010, 동구,025001, 20세,2021,4678,1904,2774,68.6,4242,1725,2517,68.5
25010, 동구,025002, 21세,2021,5125,2227,2898,76.8,4592,1981,2611,75.9
25010, 동구,025003, 22세,2021,4735,2484,2251,110.4,4367,2292,2075,110.5
25010, 동구,025004, 23세,2021,4493,2616,1877,139.4,4194,2451,1743,140.6
25010, 동구,025005, 24세,2021,4167,2544,1623,156.7,3868,2385,1483,160.8
25010, 동구,030,25~29세,2021,15628,8754,6874,127.3,14878,8392,6486,129.4
25010, 동구,030001, 25세,2021,3484,2043,1441,141.8,3286,1933,1353,142.9
25010, 동구,030002, 26세,2021,3263,1871,1392,134.4,3090,1786,1304,137
25010, 동구,030003, 27세,2021,3063,1664,1399,118.9,2916,1589,1327,119.7
25010, 동구,030004, 28세,2021,2910,1603,1307,122.6,2784,1555,1229,126.5
25010, 동구,030005, 29세,2021,2908,1573,1335,117.8,2802,1529,1273,120.1
25010, 동구,035,30~34세,2021,12361,6807,5554,122.6,11831,6593,5238,125.9
25010, 동구,035001, 30세,2021,2707,1475,1232,119.7,2588,1427,1161,122.9
25010, 동구,035002, 31세,2021,2598,1470,1128,130.3,2479,1418,1061,133.6
25010, 동구,035003, 32세,2021,2426,1335,1091,122.4,2320,1291,1029,125.5
25010, 동구,035004, 33세,2021,2358,1292,1066,121.2,2275,1266,1009,125.5
25010, 동구,035005, 34세,2021,2272,1235,1037,119.1,2169,1191,978,121.8
25010, 동구,040,35~39세,2021,13532,7083,6449,109.8,13069,6921,6148,112.6
25010, 동구,040001, 35세,2021,2390,1247,1143,109.1,2292,1217,1075,113.2
25010, 동구,040002, 36세,2021,2456,1331,1125,118.3,2358,1293,1065,121.4
25010, 동구,040003, 37세,2021,2574,1337,1237,108.1,2497,1313,1184,110.9
25010, 동구,040004, 38세,2021,2916,1519,1397,108.7,2819,1482,1337,110.8
25010, 동구,040005, 39세,2021,3196,1649,1547,106.6,3103,1616,1487,108.7
25010, 동구,045,40~44세,2021,15944,8254,7690,107.3,15592,8114,7478,108.5
25010, 동구,045001, 40세,2021,3332,1769,1563,113.2,3247,1737,1510,115
25010, 동구,045002, 41세,2021,3386,1759,1627,108.1,3321,1737,1584,109.7
25010, 동구,045003, 42세,2021,3132,1568,1564,100.3,3060,1539,1521,101.2
25010, 동구,045004, 43세,2021,3051,1607,1444,111.3,2982,1575,1407,111.9
25010, 동구,045005, 44세,2021,3043,1551,1492,104,2982,1526,1456,104.8
25010, 동구,050,45~49세,2021,17328,9097,8231,110.5,17028,8958,8070,111
25010, 동구,050001, 45세,2021,3065,1578,1487,106.1,2999,1548,1451,106.7
25010, 동구,050002, 46세,2021,3300,1736,1564,111,3246,1714,1532,111.9
25010, 동구,050003, 47세,2021,3698,1993,1705,116.9,3638,1966,1672,117.6
25010, 동구,050004, 48세,2021,3727,1967,1760,111.8,3666,1935,1731,111.8
25010, 동구,050005, 49세,2021,3538,1823,1715,106.3,3479,1795,1684,106.6
25010, 동구,055,50~54세,2021,18635,9580,9055,105.8,18374,9473,8901,106.4
25010, 동구,055001, 50세,2021,3832,2023,1809,111.8,3772,1997,1775,112.5
25010, 동구,055002, 51세,2021,3625,1875,1750,107.1,3562,1853,1709,108.4
25010, 동구,055003, 52세,2021,3897,2019,1878,107.5,3844,1997,1847,108.1
25010, 동구,055004, 53세,2021,3831,1927,1904,101.2,3788,1905,1883,101.2
25010, 동구,055005, 54세,2021,3450,1736,1714,101.3,3408,1721,1687,102
25010, 동구,060,55~59세,2021,17144,8724,8420,103.6,16935,8630,8305,103.9
25010, 동구,060001, 55세,2021,3356,1753,1603,109.4,3302,1721,1581,108.9
25010, 동구,060002, 56세,2021,3553,1756,1797,97.7,3515,1740,1775,98
25010, 동구,060003, 57세,2021,3168,1603,1565,102.4,3128,1587,1541,103
25010, 동구,060004, 58세,2021,3343,1723,1620,106.4,3312,1709,1603,106.6
25010, 동구,060005, 59세,2021,3724,1889,1835,102.9,3678,1873,1805,103.8
25010, 동구,065,60~64세,2021,19096,9229,9867,93.5,18957,9161,9796,93.5
25010, 동구,065001, 60세,2021,4244,2048,2196,93.3,4214,2035,2179,93.4
25010, 동구,065002, 61세,2021,4294,2064,2230,92.6,4262,2050,2212,92.7
25010, 동구,065003, 62세,2021,3692,1754,1938,90.5,3664,1743,1921,90.7
25010, 동구,065004, 63세,2021,3373,1630,1743,93.5,3345,1614,1731,93.2
25010, 동구,065005, 64세,2021,3493,1733,1760,98.5,3472,1719,1753,98.1
25010, 동구,070,65~69세,2021,14614,7014,7600,92.3,14546,6982,7564,92.3
25010, 동구,070001, 65세,2021,3334,1629,1705,95.5,3321,1624,1697,95.7
25010, 동구,070002, 66세,2021,3302,1579,1723,91.6,3278,1567,1711,91.6
25010, 동구,070003, 67세,2021,2891,1387,1504,92.2,2881,1381,1500,92.1
25010, 동구,070004, 68세,2021,2376,1127,1249,90.2,2364,1122,1242,90.3
25010, 동구,070005, 69세,2021,2711,1292,1419,91.1,2702,1288,1414,91.1
25010, 동구,075,70~74세,2021,10745,4892,5853,83.6,10705,4873,5832,83.6
25010, 동구,075001, 70세,2021,2069,979,1090,89.8,2056,973,1083,89.8
25010, 동구,075002, 71세,2021,2340,1046,1294,80.8,2335,1044,1291,80.9
25010, 동구,075003, 72세,2021,2180,972,1208,80.5,2174,968,1206,80.3
25010, 동구,075004, 73세,2021,2096,991,1105,89.7,2091,988,1103,89.6
25010, 동구,075005, 74세,2021,2060,904,1156,78.2,2049,900,1149,78.3
25010, 동구,080,75~79세,2021,8371,3682,4689,78.5,8358,3676,4682,78.5
25010, 동구,080001, 75세,2021,1539,716,823,87,1537,716,821,87.2
25010, 동구,080002, 76세,2021,1606,734,872,84.2,1603,733,870,84.3
25010, 동구,080003, 77세,2021,1666,735,931,78.9,1663,732,931,78.6
25010, 동구,080004, 78세,2021,1652,700,952,73.5,1648,698,950,73.5
25010, 동구,080005, 79세,2021,1908,797,1111,71.7,1907,797,1110,71.8
25010, 동구,085,80~84세,2021,6045,2276,3769,60.4,6039,2275,3764,60.4
25010, 동구,085001, 80세,2021,1445,586,859,68.2,1443,585,858,68.2
25010, 동구,085002, 81세,2021,1247,463,784,59.1,1246,463,783,59.1
25010, 동구,085003, 82세,2021,1284,488,796,61.3,1283,488,795,61.4
25010, 동구,085004, 83세,2021,1107,398,709,56.1,1106,398,708,56.2
25010, 동구,085005, 84세,2021,962,341,621,54.9,961,341,620,55
25010, 동구,090,85~89세,2021,3158,979,2179,44.9,3157,978,2179,44.9
25010, 동구,090001, 85세,2021,837,286,551,51.9,837,286,551,51.9
25010, 동구,090002, 86세,2021,783,249,534,46.6,782,248,534,46.4
25010, 동구,090003, 87세,2021,627,202,425,47.5,627,202,425,47.5
25010, 동구,090004, 88세,2021,486,127,359,35.4,486,127,359,35.4
25010, 동구,090005, 89세,2021,425,115,310,37.1,425,115,310,37.1
25010, 동구,095,90~94세,2021,1122,262,860,30.5,1119,259,860,30.1
25010, 동구,095001, 90세,2021,314,84,230,36.5,314,84,230,36.5
25010, 동구,095002, 91세,2021,265,62,203,30.5,265,62,203,30.5
25010, 동구,095003, 92세,2021,234,47,187,25.1,232,45,187,24.1
25010, 동구,095004, 93세,2021,178,40,138,29,178,40,138,29
25010, 동구,095005, 94세,2021,131,29,102,28.4,130,28,102,27.5
25010, 동구,100,95~99세,2021,238,46,192,24,238,46,192,24
25010, 동구,100001, 95세,2021,63,15,48,31.3,63,15,48,31.3
25010, 동구,100002, 96세,2021,62,10,52,19.2,62,10,52,19.2
25010, 동구,100003, 97세,2021,48,10,38,26.3,48,10,38,26.3
25010, 동구,100004, 98세,2021,43,6,37,16.2,43,6,37,16.2
25010, 동구,100005, 99세,2021,22,5,17,29.4,22,5,17,29.4
25010, 동구,101,100세이상,2021,30,6,24,25,29,5,24,20.8
25010, 동구,102,15세미만,2021,23577,12225,11352,107.7,23427,12146,11281,107.7
25010, 동구,103,15~64세,2021,165821,86164,79657,108.2,160530,83768,76762,109.1
25010, 동구,104,65세이상,2021,44323,19157,25166,76.1,44191,19094,25097,76.1
25010, 동구,086,85세이상,2021,4548,1293,3255,39.7,4543,1288,3255,39.6
25010, 동구,126,평균연령,2021,43.9,42.5,45.3,,44.2,42.7,45.7,
25010, 동구,127,중위연령,2021,44.9,43.1,46.7,,45.5,43.6,47.4,
25020, 중구,000,합계,2021,227326,111459,115867,96.2,225339,110766,114573,96.7
25020, 중구,005,0~4세,2021,5478,2777,2701,102.8,5460,2767,2693,102.7
25020, 중구,005001, 0세,2021,947,493,454,108.6,943,490,453,108.2
25020, 중구,005002, 1세,2021,949,500,449,111.4,944,495,449,110.2
25020, 중구,005003, 2세,2021,1097,542,555,97.7,1094,542,552,98.2
25020, 중구,005004, 3세,2021,1146,560,586,95.6,1143,560,583,96.1
25020, 중구,005005, 4세,2021,1339,682,657,103.8,1336,680,656,103.7
25020, 중구,010,5~9세,2021,8491,4358,4133,105.4,8467,4342,4125,105.3
25020, 중구,010001, 5세,2021,1520,776,744,104.3,1511,770,741,103.9
25020, 중구,010002, 6세,2021,1645,877,768,114.2,1640,873,767,113.8
25020, 중구,010003, 7세,2021,1596,794,802,99,1593,792,801,98.9
25020, 중구,010004, 8세,2021,1803,937,866,108.2,1797,933,864,108
25020, 중구,010005, 9세,2021,1927,974,953,102.2,1926,974,952,102.3
25020, 중구,015,10~14세,2021,9887,5079,4808,105.6,9878,5076,4802,105.7
25020, 중구,015001, 10세,2021,1967,1013,954,106.2,1964,1012,952,106.3
25020, 중구,015002, 11세,2021,1897,957,940,101.8,1894,956,938,101.9
25020, 중구,015003, 12세,2021,1814,930,884,105.2,1813,929,884,105.1
25020, 중구,015004, 13세,2021,2075,1079,996,108.3,2074,1079,995,108.4
25020, 중구,015005, 14세,2021,2134,1100,1034,106.4,2133,1100,1033,106.5
25020, 중구,020,15~19세,2021,10510,5597,4913,113.9,10500,5592,4908,113.9
25020, 중구,020001, 15세,2021,1949,980,969,101.1,1948,980,968,101.2
25020, 중구,020002, 16세,2021,1996,1012,984,102.8,1995,1011,984,102.7
25020, 중구,020003, 17세,2021,2208,1206,1002,120.4,2208,1206,1002,120.4
25020, 중구,020004, 18세,2021,2349,1290,1059,121.8,2347,1288,1059,121.6
25020, 중구,020005, 19세,2021,2008,1109,899,123.4,2002,1107,895,123.7
25020, 중구,025,20~24세,2021,13558,6921,6637,104.3,13416,6884,6532,105.4
25020, 중구,025001, 20세,2021,2383,1276,1107,115.3,2360,1269,1091,116.3
25020, 중구,025002, 21세,2021,2673,1436,1237,116.1,2640,1426,1214,117.5
25020, 중구,025003, 22세,2021,2651,1361,1290,105.5,2632,1354,1278,105.9
25020, 중구,025004, 23세,2021,2881,1445,1436,100.6,2851,1435,1416,101.3
25020, 중구,025005, 24세,2021,2970,1403,1567,89.5,2933,1400,1533,91.3
25020, 중구,030,25~29세,2021,15473,7707,7766,99.2,15227,7649,7578,100.9
25020, 중구,030001, 25세,2021,3286,1594,1692,94.2,3252,1584,1668,95
25020, 중구,030002, 26세,2021,3179,1534,1645,93.3,3122,1523,1599,95.2
25020, 중구,030003, 27세,2021,3160,1620,1540,105.2,3112,1611,1501,107.3
25020, 중구,030004, 28세,2021,2916,1480,1436,103.1,2868,1463,1405,104.1
25020, 중구,030005, 29세,2021,2932,1479,1453,101.8,2873,1468,1405,104.5
25020, 중구,035,30~34세,2021,12162,6311,5851,107.9,11849,6212,5637,110.2
25020, 중구,035001, 30세,2021,2793,1423,1370,103.9,2732,1402,1330,105.4
25020, 중구,035002, 31세,2021,2548,1349,1199,112.5,2483,1330,1153,115.4
25020, 중구,035003, 32세,2021,2290,1207,1083,111.4,2228,1189,1039,114.4
25020, 중구,035004, 33세,2021,2298,1228,1070,114.8,2235,1208,1027,117.6
25020, 중구,035005, 34세,2021,2233,1104,1129,97.8,2171,1083,1088,99.5
25020, 중구,040,35~39세,2021,12758,6459,6299,102.5,12519,6389,6130,104.2
25020, 중구,040001, 35세,2021,2302,1191,1111,107.2,2243,1172,1071,109.4
25020, 중구,040002, 36세,2021,2315,1162,1153,100.8,2263,1148,1115,103
25020, 중구,040003, 37세,2021,2377,1190,1187,100.3,2338,1180,1158,101.9
25020, 중구,040004, 38세,2021,2710,1400,1310,106.9,2668,1390,1278,108.8
25020, 중구,040005, 39세,2021,3054,1516,1538,98.6,3007,1499,1508,99.4
25020, 중구,045,40~44세,2021,16270,8153,8117,100.4,16085,8087,7998,101.1
25020, 중구,045001, 40세,2021,3205,1606,1599,100.4,3158,1588,1570,101.1
25020, 중구,045002, 41세,2021,3366,1678,1688,99.4,3322,1667,1655,100.7
25020, 중구,045003, 42세,2021,3350,1674,1676,99.9,3321,1661,1660,100.1
25020, 중구,045004, 43세,2021,3041,1545,1496,103.3,3010,1534,1476,103.9
25020, 중구,045005, 44세,2021,3308,1650,1658,99.5,3274,1637,1637,100
25020, 중구,050,45~49세,2021,18234,9198,9036,101.8,18045,9123,8922,102.3
25020, 중구,050001, 45세,2021,3220,1614,1606,100.5,3185,1599,1586,100.8
25020, 중구,050002, 46세,2021,3426,1711,1715,99.8,3381,1691,1690,100.1
25020, 중구,050003, 47세,2021,3845,1955,1890,103.4,3801,1941,1860,104.4
25020, 중구,050004, 48세,2021,3892,1932,1960,98.6,3856,1915,1941,98.7
25020, 중구,050005, 49세,2021,3851,1986,1865,106.5,3822,1977,1845,107.2
25020, 중구,055,50~54세,2021,20140,10145,9995,101.5,19973,10075,9898,101.8
25020, 중구,055001, 50세,2021,4144,2142,2002,107,4109,2130,1979,107.6
25020, 중구,055002, 51세,2021,3892,1978,1914,103.3,3860,1963,1897,103.5
25020, 중구,055003, 52세,2021,4216,2138,2078,102.9,4177,2121,2056,103.2
25020, 중구,055004, 53세,2021,4125,2039,2086,97.7,4096,2029,2067,98.2
25020, 중구,055005, 54세,2021,3763,1848,1915,96.5,3731,1832,1899,96.5
25020, 중구,060,55~59세,2021,18056,9047,9009,100.4,17889,8985,8904,100.9
25020, 중구,060001, 55세,2021,3535,1807,1728,104.6,3506,1797,1709,105.1
25020, 중구,060002, 56세,2021,3687,1829,1858,98.4,3658,1818,1840,98.8
25020, 중구,060003, 57세,2021,3441,1739,1702,102.2,3408,1726,1682,102.6
25020, 중구,060004, 58세,2021,3482,1720,1762,97.6,3439,1703,1736,98.1
25020, 중구,060005, 59세,2021,3911,1952,1959,99.6,3878,1941,1937,100.2
25020, 중구,065,60~64세,2021,19127,9244,9883,93.5,18996,9189,9807,93.7
25020, 중구,065001, 60세,2021,4163,2045,2118,96.6,4137,2038,2099,97.1
25020, 중구,065002, 61세,2021,4156,1950,2206,88.4,4127,1937,2190,88.4
25020, 중구,065003, 62세,2021,3720,1792,1928,92.9,3691,1778,1913,92.9
25020, 중구,065004, 63세,2021,3539,1733,1806,96,3512,1723,1789,96.3
25020, 중구,065005, 64세,2021,3549,1724,1825,94.5,3529,1713,1816,94.3
25020, 중구,070,65~69세,2021,15345,7111,8234,86.4,15256,7069,8187,86.3
25020, 중구,070001, 65세,2021,3394,1585,1809,87.6,3370,1570,1800,87.2
25020, 중구,070002, 66세,2021,3468,1621,1847,87.8,3450,1614,1836,87.9
25020, 중구,070003, 67세,2021,3089,1373,1716,80,3067,1365,1702,80.2
25020, 중구,070004, 68세,2021,2565,1224,1341,91.3,2552,1217,1335,91.2
25020, 중구,070005, 69세,2021,2829,1308,1521,86,2817,1303,1514,86.1
25020, 중구,075,70~74세,2021,11603,5303,6300,84.2,11574,5290,6284,84.2
25020, 중구,075001, 70세,2021,2065,950,1115,85.2,2061,949,1112,85.3
25020, 중구,075002, 71세,2021,2435,1084,1351,80.2,2429,1081,1348,80.2
25020, 중구,075003, 72세,2021,2538,1176,1362,86.3,2529,1173,1356,86.5
25020, 중구,075004, 73세,2021,2366,1101,1265,87,2364,1100,1264,87
25020, 중구,075005, 74세,2021,2199,992,1207,82.2,2191,987,1204,82
25020, 중구,080,75~79세,2021,9077,3973,5104,77.8,9066,3968,5098,77.8
25020, 중구,080001, 75세,2021,1815,821,994,82.6,1811,821,990,82.9
25020, 중구,080002, 76세,2021,1724,759,965,78.7,1722,757,965,78.4
25020, 중구,080003, 77세,2021,1726,763,963,79.2,1726,763,963,79.2
25020, 중구,080004, 78세,2021,1683,717,966,74.2,1682,716,966,74.1
25020, 중구,080005, 79세,2021,2129,913,1216,75.1,2125,911,1214,75
25020, 중구,085,80~84세,2021,6458,2598,3860,67.3,6445,2595,3850,67.4
25020, 중구,085001, 80세,2021,1481,624,857,72.8,1480,624,856,72.9
25020, 중구,085002, 81세,2021,1347,543,804,67.5,1344,543,801,67.8
25020, 중구,085003, 82세,2021,1346,548,798,68.7,1342,547,795,68.8
25020, 중구,085004, 83세,2021,1279,504,775,65,1278,504,774,65.1
25020, 중구,085005, 84세,2021,1005,379,626,60.5,1001,377,624,60.4
25020, 중구,090,85~89세,2021,3352,1152,2200,52.4,3348,1149,2199,52.3
25020, 중구,090001, 85세,2021,950,334,616,54.2,950,334,616,54.2
25020, 중구,090002, 86세,2021,797,280,517,54.2,796,279,517,54
25020, 중구,090003, 87세,2021,651,221,430,51.4,649,220,429,51.3
25020, 중구,090004, 88세,2021,516,174,342,50.9,516,174,342,50.9
25020, 중구,090005, 89세,2021,438,143,295,48.5,437,142,295,48.1
25020, 중구,095,90~94세,2021,1082,273,809,33.7,1081,272,809,33.6
25020, 중구,095001, 90세,2021,318,95,223,42.6,318,95,223,42.6
25020, 중구,095002, 91세,2021,283,72,211,34.1,283,72,211,34.1
25020, 중구,095003, 92세,2021,202,49,153,32,202,49,153,32
25020, 중구,095004, 93세,2021,156,30,126,23.8,155,29,126,23
25020, 중구,095005, 94세,2021,123,27,96,28.1,123,27,96,28.1
25020, 중구,100,95~99세,2021,231,45,186,24.2,231,45,186,24.2
25020, 중구,100001, 95세,2021,68,13,55,23.6,68,13,55,23.6
25020, 중구,100002, 96세,2021,69,14,55,25.5,69,14,55,25.5
25020, 중구,100003, 97세,2021,52,10,42,23.8,52,10,42,23.8
25020, 중구,100004, 98세,2021,24,X,20,20,24,X,20,20
25020, 중구,100005, 99세,2021,18,X,14,28.6,18,X,14,28.6
25020, 중구,101,100세이상,2021,34,8,26,30.8,34,8,26,30.8
25020, 중구,102,15세미만,2021,23856,12214,11642,104.9,23805,12185,11620,104.9
25020, 중구,103,15~64세,2021,156288,78782,77506,101.6,154499,78185,76314,102.5
25020, 중구,104,65세이상,2021,47182,20463,26719,76.6,47035,20396,26639,76.6
25020, 중구,086,85세이상,2021,4699,1478,3221,45.9,4694,1474,3220,45.8
25020, 중구,126,평균연령,2021,45.6,44.4,46.8,,45.6,44.4,46.9,
25020, 중구,127,중위연령,2021,47.6,46.4,48.8,,47.7,46.5,48.9,
25030, 서구,000,합계,2021,475671,233608,242063,96.5,471170,231859,239311,96.9
25030, 서구,005,0~4세,2021,14370,7366,7004,105.2,14310,7338,6972,105.2
25030, 서구,005001, 0세,2021,2489,1300,1189,109.3,2475,1295,1180,109.7
25030, 서구,005002, 1세,2021,2550,1307,1243,105.1,2536,1299,1237,105
25030, 서구,005003, 2세,2021,2771,1396,1375,101.5,2761,1389,1372,101.2
25030, 서구,005004, 3세,2021,3097,1573,1524,103.2,3083,1567,1516,103.4
25030, 서구,005005, 4세,2021,3463,1790,1673,107,3455,1788,1667,107.3
25030, 서구,010,5~9세,2021,21215,11028,10187,108.3,21165,11001,10164,108.2
25030, 서구,010001, 5세,2021,3987,2124,1863,114,3978,2117,1861,113.8
25030, 서구,010002, 6세,2021,4234,2171,2063,105.2,4219,2165,2054,105.4
25030, 서구,010003, 7세,2021,4086,2127,1959,108.6,4074,2119,1955,108.4
25030, 서구,010004, 8세,2021,4391,2249,2142,105,4385,2246,2139,105
25030, 서구,010005, 9세,2021,4517,2357,2160,109.1,4509,2354,2155,109.2
25030, 서구,015,10~14세,2021,23306,11927,11379,104.8,23278,11913,11365,104.8
25030, 서구,015001, 10세,2021,4673,2385,2288,104.2,4669,2383,2286,104.2
25030, 서구,015002, 11세,2021,4504,2262,2242,100.9,4498,2258,2240,100.8
25030, 서구,015003, 12세,2021,4469,2330,2139,108.9,4458,2325,2133,109
25030, 서구,015004, 13세,2021,4685,2404,2281,105.4,4681,2403,2278,105.5
25030, 서구,015005, 14세,2021,4975,2546,2429,104.8,4972,2544,2428,104.8
25030, 서구,020,15~19세,2021,25584,13072,12512,104.5,25414,13003,12411,104.8
25030, 서구,020001, 15세,2021,4551,2334,2217,105.3,4546,2334,2212,105.5
25030, 서구,020002, 16세,2021,4490,2345,2145,109.3,4485,2342,2143,109.3
25030, 서구,020003, 17세,2021,5042,2589,2453,105.5,5035,2585,2450,105.5
25030, 서구,020004, 18세,2021,5279,2633,2646,99.5,5240,2619,2621,99.9
25030, 서구,020005, 19세,2021,6222,3171,3051,103.9,6108,3123,2985,104.6
25030, 서구,025,20~24세,2021,37768,18840,18928,99.5,36998,18525,18473,100.3
25030, 서구,025001, 20세,2021,6917,3308,3609,91.7,6755,3241,3514,92.2
25030, 서구,025002, 21세,2021,7623,3685,3938,93.6,7442,3602,3840,93.8
25030, 서구,025003, 22세,2021,7559,3825,3734,102.4,7440,3775,3665,103
25030, 서구,025004, 23세,2021,7736,3947,3789,104.2,7568,3873,3695,104.8
25030, 서구,025005, 24세,2021,7933,4075,3858,105.6,7793,4034,3759,107.3
25030, 서구,030,25~29세,2021,39203,20297,18906,107.4,38467,20045,18422,108.8
25030, 서구,030001, 25세,2021,7923,4112,3811,107.9,7765,4055,3710,109.3
25030, 서구,030002, 26세,2021,7990,4220,3770,111.9,7845,4168,3677,113.4
25030, 서구,030003, 27세,2021,7904,4085,3819,107,7749,4035,3714,108.6
25030, 서구,030004, 28세,2021,7659,3943,3716,106.1,7515,3898,3617,107.8
25030, 서구,030005, 29세,2021,7727,3937,3790,103.9,7593,3889,3704,105
25030, 서구,035,30~34세,2021,31651,16355,15296,106.9,31014,16108,14906,108.1
25030, 서구,035001, 30세,2021,6944,3524,3420,103,6834,3486,3348,104.1
25030, 서구,035002, 31세,2021,6483,3315,3168,104.6,6347,3269,3078,106.2
25030, 서구,035003, 32세,2021,6219,3263,2956,110.4,6076,3206,2870,111.7
25030, 서구,035004, 33세,2021,6068,3198,2870,111.4,5937,3145,2792,112.6
25030, 서구,035005, 34세,2021,5937,3055,2882,106,5820,3002,2818,106.5
25030, 서구,040,35~39세,2021,32563,16436,16127,101.9,32087,16270,15817,102.9
25030, 서구,040001, 35세,2021,5933,3084,2849,108.2,5824,3053,2771,110.2
25030, 서구,040002, 36세,2021,6113,3121,2992,104.3,6010,3078,2932,105
25030, 서구,040003, 37세,2021,6210,3084,3126,98.7,6116,3049,3067,99.4
25030, 서구,040004, 38세,2021,6874,3436,3438,99.9,6793,3408,3385,100.7
25030, 서구,040005, 39세,2021,7433,3711,3722,99.7,7344,3682,3662,100.5
25030, 서구,045,40~44세,2021,36310,17663,18647,94.7,35942,17526,18416,95.2
25030, 서구,045001, 40세,2021,7332,3602,3730,96.6,7248,3570,3678,97.1
25030, 서구,045002, 41세,2021,7678,3750,3928,95.5,7600,3721,3879,95.9
25030, 서구,045003, 42세,2021,7245,3573,3672,97.3,7173,3553,3620,98.1
25030, 서구,045004, 43세,2021,6792,3262,3530,92.4,6723,3230,3493,92.5
25030, 서구,045005, 44세,2021,7263,3476,3787,91.8,7198,3452,3746,92.2
25030, 서구,050,45~49세,2021,38923,18657,20266,92.1,38621,18542,20079,92.3
25030, 서구,050001, 45세,2021,7003,3315,3688,89.9,6932,3292,3640,90.4
25030, 서구,050002, 46세,2021,7398,3581,3817,93.8,7339,3560,3779,94.2
25030, 서구,050003, 47세,2021,8189,3835,4354,88.1,8136,3822,4314,88.6
25030, 서구,050004, 48세,2021,8228,3970,4258,93.2,8173,3938,4235,93
25030, 서구,050005, 49세,2021,8105,3956,4149,95.3,8041,3930,4111,95.6
25030, 서구,055,50~54세,2021,41876,20277,21599,93.9,41575,20138,21437,93.9
25030, 서구,055001, 50세,2021,8948,4347,4601,94.5,8884,4318,4566,94.6
25030, 서구,055002, 51세,2021,8331,4114,4217,97.6,8258,4079,4179,97.6
25030, 서구,055003, 52세,2021,8642,4193,4449,94.2,8592,4170,4422,94.3
25030, 서구,055004, 53세,2021,8558,4085,4473,91.3,8489,4051,4438,91.3
25030, 서구,055005, 54세,2021,7397,3538,3859,91.7,7352,3520,3832,91.9
25030, 서구,060,55~59세,2021,34539,16841,17698,95.2,34295,16742,17553,95.4
25030, 서구,060001, 55세,2021,6744,3303,3441,96,6686,3283,3403,96.5
25030, 서구,060002, 56세,2021,7251,3527,3724,94.7,7198,3506,3692,95
25030, 서구,060003, 57세,2021,6553,3112,3441,90.4,6504,3090,3414,90.5
25030, 서구,060004, 58세,2021,6826,3368,3458,97.4,6774,3347,3427,97.7
25030, 서구,060005, 59세,2021,7165,3531,3634,97.2,7133,3516,3617,97.2
25030, 서구,065,60~64세,2021,34386,16482,17904,92.1,34224,16415,17809,92.2
25030, 서구,065001, 60세,2021,7990,3790,4200,90.2,7957,3778,4179,90.4
25030, 서구,065002, 61세,2021,7510,3560,3950,90.1,7472,3546,3926,90.3
25030, 서구,065003, 62세,2021,6652,3192,3460,92.3,6627,3182,3445,92.4
25030, 서구,065004, 63세,2021,6120,2982,3138,95,6089,2963,3126,94.8
25030, 서구,065005, 64세,2021,6114,2958,3156,93.7,6079,2946,3133,94
25030, 서구,070,65~69세,2021,23752,11464,12288,93.3,23647,11418,12229,93.4
25030, 서구,070001, 65세,2021,5521,2689,2832,95,5492,2678,2814,95.2
25030, 서구,070002, 66세,2021,5571,2664,2907,91.6,5542,2651,2891,91.7
25030, 서구,070003, 67세,2021,4599,2193,2406,91.1,4575,2179,2396,90.9
25030, 서구,070004, 68세,2021,3945,1900,2045,92.9,3934,1896,2038,93
25030, 서구,070005, 69세,2021,4116,2018,2098,96.2,4104,2014,2090,96.4
25030, 서구,075,70~74세,2021,15596,7380,8216,89.8,15541,7361,8180,90
25030, 서구,075001, 70세,2021,3042,1409,1633,86.3,3026,1402,1624,86.3
25030, 서구,075002, 71세,2021,3444,1670,1774,94.1,3432,1666,1766,94.3
25030, 서구,075003, 72세,2021,3212,1559,1653,94.3,3197,1555,1642,94.7
25030, 서구,075004, 73세,2021,3044,1391,1653,84.2,3039,1389,1650,84.2
25030, 서구,075005, 74세,2021,2854,1351,1503,89.9,2847,1349,1498,90.1
25030, 서구,080,75~79세,2021,10889,4802,6087,78.9,10872,4797,6075,79
25030, 서구,080001, 75세,2021,2164,1000,1164,85.9,2154,999,1155,86.5
25030, 서구,080002, 76세,2021,2057,926,1131,81.9,2055,925,1130,81.9
25030, 서구,080003, 77세,2021,2125,892,1233,72.3,2123,892,1231,72.5
25030, 서구,080004, 78세,2021,2055,895,1160,77.2,2053,893,1160,77
25030, 서구,080005, 79세,2021,2488,1089,1399,77.8,2487,1088,1399,77.8
25030, 서구,085,80~84세,2021,7705,3034,4671,65,7689,3031,4658,65.1
25030, 서구,085001, 80세,2021,1836,769,1067,72.1,1831,769,1062,72.4
25030, 서구,085002, 81세,2021,1546,645,901,71.6,1543,645,898,71.8
25030, 서구,085003, 82세,2021,1662,630,1032,61,1660,629,1031,61
25030, 서구,085004, 83세,2021,1426,536,890,60.2,1422,535,887,60.3
25030, 서구,085005, 84세,2021,1235,454,781,58.1,1233,453,780,58.1
25030, 서구,090,85~89세,2021,4236,1317,2919,45.1,4233,1316,2917,45.1
25030, 서구,090001, 85세,2021,1103,358,745,48.1,1103,358,745,48.1
25030, 서구,090002, 86세,2021,1024,335,689,48.6,1023,335,688,48.7
25030, 서구,090003, 87세,2021,870,275,595,46.2,868,274,594,46.1
25030, 서구,090004, 88세,2021,663,205,458,44.8,663,205,458,44.8
25030, 서구,090005, 89세,2021,576,144,432,33.3,576,144,432,33.3
25030, 서구,095,90~94세,2021,1448,312,1136,27.5,1447,312,1135,27.5
25030, 서구,095001, 90세,2021,400,82,318,25.8,400,82,318,25.8
25030, 서구,095002, 91세,2021,355,73,282,25.9,355,73,282,25.9
25030, 서구,095003, 92세,2021,266,64,202,31.7,266,64,202,31.7
25030, 서구,095004, 93세,2021,255,55,200,27.5,255,55,200,27.5
25030, 서구,095005, 94세,2021,172,38,134,28.4,171,38,133,28.6
25030, 서구,100,95~99세,2021,303,50,253,19.8,303,50,253,19.8
25030, 서구,100001, 95세,2021,103,24,79,30.4,103,24,79,30.4
25030, 서구,100002, 96세,2021,80,8,72,11.1,80,8,72,11.1
25030, 서구,100003, 97세,2021,43,6,37,16.2,43,6,37,16.2
25030, 서구,100004, 98세,2021,48,7,41,17.1,48,7,41,17.1
25030, 서구,100005, 99세,2021,29,5,24,20.8,29,5,24,20.8
25030, 서구,101,100세이상,2021,48,8,40,20,48,8,40,20
25030, 서구,102,15세미만,2021,58891,30321,28570,106.1,58753,30252,28501,106.1
25030, 서구,103,15~64세,2021,352803,174920,177883,98.3,348637,173314,175323,98.9
25030, 서구,104,65세이상,2021,63977,28367,35610,79.7,63780,28293,35487,79.7
25030, 서구,086,85세이상,2021,6035,1687,4348,38.8,6031,1686,4345,38.8
25030, 서구,126,평균연령,2021,41.2,40.2,42.1,,41.2,40.2,42.2,
25030, 서구,127,중위연령,2021,41.6,40.4,42.8,,41.7,40.5,43,
25040, 유성구,000,합계,2021,367288,188649,178639,105.6,359052,184564,174488,105.8
25040, 유성구,005,0~4세,2021,14116,7277,6839,106.4,13779,7109,6670,106.6
25040, 유성구,005001, 0세,2021,2445,1266,1179,107.4,2381,1232,1149,107.2
25040, 유성구,005002, 1세,2021,2472,1303,1169,111.5,2409,1279,1130,113.2
25040, 유성구,005003, 2세,2021,2785,1416,1369,103.4,2727,1391,1336,104.1
25040, 유성구,005004, 3세,2021,2983,1558,1425,109.3,2909,1514,1395,108.5
25040, 유성구,005005, 4세,2021,3431,1734,1697,102.2,3353,1693,1660,102
25040, 유성구,010,5~9세,2021,19394,9936,9458,105.1,19107,9795,9312,105.2
25040, 유성구,010001, 5세,2021,3789,1966,1823,107.8,3709,1922,1787,107.6
25040, 유성구,010002, 6세,2021,4002,2021,1981,102,3927,1982,1945,101.9
25040, 유성구,010003, 7세,2021,3858,1973,1885,104.7,3797,1945,1852,105
25040, 유성구,010004, 8세,2021,3812,1928,1884,102.3,3775,1911,1864,102.5
25040, 유성구,010005, 9세,2021,3933,2048,1885,108.6,3899,2035,1864,109.2
25040, 유성구,015,10~14세,2021,18890,9678,9212,105.1,18767,9627,9140,105.3
25040, 유성구,015001, 10세,2021,3920,2056,1864,110.3,3888,2045,1843,111
25040, 유성구,015002, 11세,2021,3721,1911,1810,105.6,3695,1902,1793,106.1
25040, 유성구,015003, 12세,2021,3614,1826,1788,102.1,3593,1819,1774,102.5
25040, 유성구,015004, 13세,2021,3730,1935,1795,107.8,3706,1922,1784,107.7
25040, 유성구,015005, 14세,2021,3905,1950,1955,99.7,3885,1939,1946,99.6
25040, 유성구,020,15~19세,2021,20730,11340,9390,120.8,20386,11173,9213,121.3
25040, 유성구,020001, 15세,2021,3585,1891,1694,111.6,3561,1880,1681,111.8
25040, 유성구,020002, 16세,2021,3404,1818,1586,114.6,3390,1810,1580,114.6
25040, 유성구,020003, 17세,2021,3730,1972,1758,112.2,3716,1963,1753,112
25040, 유성구,020004, 18세,2021,4213,2347,1866,125.8,4137,2309,1828,126.3
25040, 유성구,020005, 19세,2021,5798,3312,2486,133.2,5582,3211,2371,135.4
25040, 유성구,025,20~24세,2021,32653,17468,15185,115,31173,16739,14434,116
25040, 유성구,025001, 20세,2021,6123,3151,2972,106,5876,3016,2860,105.5
25040, 유성구,025002, 21세,2021,6273,3181,3092,102.9,6029,3062,2967,103.2
25040, 유성구,025003, 22세,2021,6563,3478,3085,112.7,6276,3343,2933,114
25040, 유성구,025004, 23세,2021,6901,3856,3045,126.6,6555,3684,2871,128.3
25040, 유성구,025005, 24세,2021,6793,3802,2991,127.1,6437,3634,2803,129.6
25040, 유성구,030,25~29세,2021,31665,18288,13377,136.7,30093,17526,12567,139.5
25040, 유성구,030001, 25세,2021,6651,3895,2756,141.3,6309,3717,2592,143.4
25040, 유성구,030002, 26세,2021,6430,3806,2624,145,6078,3647,2431,150
25040, 유성구,030003, 27세,2021,6274,3640,2634,138.2,5979,3497,2482,140.9
25040, 유성구,030004, 28세,2021,6241,3545,2696,131.5,5962,3412,2550,133.8
25040, 유성구,030005, 29세,2021,6069,3402,2667,127.6,5765,3253,2512,129.5
25040, 유성구,035,30~34세,2021,27735,15153,12582,120.4,26465,14486,11979,120.9
25040, 유성구,035001, 30세,2021,5661,3086,2575,119.8,5403,2948,2455,120.1
25040, 유성구,035002, 31세,2021,5559,3088,2471,125,5290,2950,2340,126.1
25040, 유성구,035003, 32세,2021,5601,3073,2528,121.6,5354,2948,2406,122.5
25040, 유성구,035004, 33세,2021,5527,3046,2481,122.8,5242,2896,2346,123.4
25040, 유성구,035005, 34세,2021,5387,2860,2527,113.2,5176,2744,2432,112.8
25040, 유성구,040,35~39세,2021,28595,14686,13909,105.6,27764,14245,13519,105.4
25040, 유성구,040001, 35세,2021,5469,2871,2598,110.5,5264,2756,2508,109.9
25040, 유성구,040002, 36세,2021,5411,2806,2605,107.7,5249,2722,2527,107.7
25040, 유성구,040003, 37세,2021,5405,2818,2587,108.9,5234,2724,2510,108.5
25040, 유성구,040004, 38세,2021,5950,3039,2911,104.4,5805,2961,2844,104.1
25040, 유성구,040005, 39세,2021,6360,3152,3208,98.3,6212,3082,3130,98.5
25040, 유성구,045,40~44세,2021,30021,14793,15228,97.1,29440,14480,14960,96.8
25040, 유성구,045001, 40세,2021,6397,3159,3238,97.6,6262,3083,3179,97
25040, 유성구,045002, 41세,2021,6257,3146,3111,101.1,6130,3076,3054,100.7
25040, 유성구,045003, 42세,2021,5839,2829,3010,94,5700,2756,2944,93.6
25040, 유성구,045004, 43세,2021,5812,2819,2993,94.2,5704,2760,2944,93.8
25040, 유성구,045005, 44세,2021,5716,2840,2876,98.7,5644,2805,2839,98.8
25040, 유성구,050,45~49세,2021,29886,14851,15035,98.8,29487,14660,14827,98.9
25040, 유성구,050001, 45세,2021,5638,2823,2815,100.3,5562,2795,2767,101
25040, 유성구,050002, 46세,2021,5684,2840,2844,99.9,5599,2797,2802,99.8
25040, 유성구,050003, 47세,2021,6202,3066,3136,97.8,6126,3032,3094,98
25040, 유성구,050004, 48세,2021,6277,3030,3247,93.3,6201,2991,3210,93.2
25040, 유성구,050005, 49세,2021,6085,3092,2993,103.3,5999,3045,2954,103.1
25040, 유성구,055,50~54세,2021,30246,15098,15148,99.7,29861,14918,14943,99.8
25040, 유성구,055001, 50세,2021,6486,3274,3212,101.9,6397,3231,3166,102.1
25040, 유성구,055002, 51세,2021,6144,3060,3084,99.2,6055,3019,3036,99.4
25040, 유성구,055003, 52세,2021,6131,3020,3111,97.1,6066,2988,3078,97.1
25040, 유성구,055004, 53세,2021,6156,3041,3115,97.6,6084,3006,3078,97.7
25040, 유성구,055005, 54세,2021,5329,2703,2626,102.9,5259,2674,2585,103.4
25040, 유성구,060,55~59세,2021,24550,12498,12052,103.7,24268,12370,11898,104
25040, 유성구,060001, 55세,2021,5025,2613,2412,108.3,4966,2588,2378,108.8
25040, 유성구,060002, 56세,2021,5040,2523,2517,100.2,4992,2500,2492,100.3
25040, 유성구,060003, 57세,2021,4652,2328,2324,100.2,4597,2306,2291,100.7
25040, 유성구,060004, 58세,2021,4864,2504,2360,106.1,4800,2470,2330,106
25040, 유성구,060005, 59세,2021,4969,2530,2439,103.7,4913,2506,2407,104.1
25040, 유성구,065,60~64세,2021,22462,11231,11231,100,22297,11170,11127,100.4
25040, 유성구,065001, 60세,2021,5406,2704,2702,100.1,5382,2694,2688,100.2
25040, 유성구,065002, 61세,2021,4985,2444,2541,96.2,4949,2430,2519,96.5
25040, 유성구,065003, 62세,2021,4402,2221,2181,101.8,4362,2206,2156,102.3
25040, 유성구,065004, 63세,2021,3875,1908,1967,97,3839,1895,1944,97.5
25040, 유성구,065005, 64세,2021,3794,1954,1840,106.2,3765,1945,1820,106.9
25040, 유성구,070,65~69세,2021,14167,7123,7044,101.1,14064,7072,6992,101.1
25040, 유성구,070001, 65세,2021,3394,1713,1681,101.9,3367,1700,1667,102
25040, 유성구,070002, 66세,2021,3428,1722,1706,100.9,3407,1709,1698,100.6
25040, 유성구,070003, 67세,2021,2714,1349,1365,98.8,2685,1338,1347,99.3
25040, 유성구,070004, 68세,2021,2267,1163,1104,105.3,2254,1155,1099,105.1
25040, 유성구,070005, 69세,2021,2364,1176,1188,99,2351,1170,1181,99.1
25040, 유성구,075,70~74세,2021,8188,4076,4112,99.1,8144,4056,4088,99.2
25040, 유성구,075001, 70세,2021,1654,823,831,99,1640,819,821,99.8
25040, 유성구,075002, 71세,2021,1839,933,906,103,1826,927,899,103.1
25040, 유성구,075003, 72세,2021,1684,860,824,104.4,1676,856,820,104.4
25040, 유성구,075004, 73세,2021,1594,790,804,98.3,1589,787,802,98.1
25040, 유성구,075005, 74세,2021,1417,670,747,89.7,1413,667,746,89.4
25040, 유성구,080,75~79세,2021,5745,2525,3220,78.4,5728,2517,3211,78.4
25040, 유성구,080001, 75세,2021,1098,522,576,90.6,1093,520,573,90.8
25040, 유성구,080002, 76세,2021,1117,502,615,81.6,1113,500,613,81.6
25040, 유성구,080003, 77세,2021,1150,491,659,74.5,1146,489,657,74.4
25040, 유성구,080004, 78세,2021,1066,441,625,70.6,1063,440,623,70.6
25040, 유성구,080005, 79세,2021,1314,569,745,76.4,1313,568,745,76.2
25040, 유성구,085,80~84세,2021,4308,1606,2702,59.4,4296,1600,2696,59.3
25040, 유성구,085001, 80세,2021,1018,380,638,59.6,1016,379,637,59.5
25040, 유성구,085002, 81세,2021,867,348,519,67.1,861,345,516,66.9
25040, 유성구,085003, 82세,2021,881,332,549,60.5,878,331,547,60.5
25040, 유성구,085004, 83세,2021,806,281,525,53.5,805,280,525,53.3
25040, 유성구,085005, 84세,2021,736,265,471,56.3,736,265,471,56.3
25040, 유성구,090,85~89세,2021,2698,750,1948,38.5,2695,749,1946,38.5
25040, 유성구,090001, 85세,2021,684,195,489,39.9,683,195,488,40
25040, 유성구,090002, 86세,2021,610,151,459,32.9,608,150,458,32.8
25040, 유성구,090003, 87세,2021,530,148,382,38.7,530,148,382,38.7
25040, 유성구,090004, 88세,2021,464,134,330,40.6,464,134,330,40.6
25040, 유성구,090005, 89세,2021,410,122,288,42.4,410,122,288,42.4
25040, 유성구,095,90~94세,2021,1003,224,779,28.8,1002,224,778,28.8
25040, 유성구,095001, 90세,2021,274,61,213,28.6,274,61,213,28.6
25040, 유성구,095002, 91세,2021,240,55,185,29.7,240,55,185,29.7
25040, 유성구,095003, 92세,2021,216,47,169,27.8,216,47,169,27.8
25040, 유성구,095004, 93세,2021,161,33,128,25.8,160,33,127,26
25040, 유성구,095005, 94세,2021,112,28,84,33.3,112,28,84,33.3
25040, 유성구,100,95~99세,2021,205,44,161,27.3,205,44,161,27.3
25040, 유성구,100001, 95세,2021,77,22,55,40,77,22,55,40
25040, 유성구,100002, 96세,2021,49,11,38,28.9,49,11,38,28.9
25040, 유성구,100003, 97세,2021,28,X,24,16.7,28,X,24,16.7
25040, 유성구,100004, 98세,2021,27,X,23,17.4,27,X,23,17.4
25040, 유성구,100005, 99세,2021,24,X,21,14.3,24,X,21,14.3
25040, 유성구,101,100세이상,2021,31,X,27,14.8,31,X,27,14.8
25040, 유성구,102,15세미만,2021,52400,26891,25509,105.4,51653,26531,25122,105.6
25040, 유성구,103,15~64세,2021,278543,145406,133137,109.2,271234,141767,129467,109.5
25040, 유성구,104,65세이상,2021,36345,16352,19993,81.8,36165,16266,19899,81.7
25040, 유성구,086,85세이상,2021,3937,1022,2915,35.1,3933,1021,2912,35.1
25040, 유성구,126,평균연령,2021,38.5,37.6,39.5,,38.7,37.7,39.7,
25040, 유성구,127,중위연령,2021,38.4,36.8,39.8,,38.7,37.1,40.1,
25050, 대덕구,000,합계,2021,175734,89219,86515,103.1,172768,87810,84958,103.4
25050, 대덕구,005,0~4세,2021,4312,2170,2142,101.3,4280,2151,2129,101
25050, 대덕구,005001, 0세,2021,764,402,362,111,759,399,360,110.8
25050, 대덕구,005002, 1세,2021,754,384,370,103.8,747,379,368,103
25050, 대덕구,005003, 2세,2021,876,428,448,95.5,873,426,447,95.3
25050, 대덕구,005004, 3세,2021,908,431,477,90.4,899,426,473,90.1
25050, 대덕구,005005, 4세,2021,1010,525,485,108.2,1002,521,481,108.3
25050, 대덕구,010,5~9세,2021,6151,3121,3030,103,6129,3113,3016,103.2
25050, 대덕구,010001, 5세,2021,1117,544,573,94.9,1113,543,570,95.3
25050, 대덕구,010002, 6세,2021,1189,594,595,99.8,1181,591,590,100.2
25050, 대덕구,010003, 7세,2021,1215,644,571,112.8,1211,643,568,113.2
25050, 대덕구,010004, 8세,2021,1271,637,634,100.5,1268,635,633,100.3
25050, 대덕구,010005, 9세,2021,1359,702,657,106.8,1356,701,655,107
25050, 대덕구,015,10~14세,2021,7299,3804,3495,108.8,7286,3794,3492,108.6
25050, 대덕구,015001, 10세,2021,1440,733,707,103.7,1437,732,705,103.8
25050, 대덕구,015002, 11세,2021,1379,736,643,114.5,1378,735,643,114.3
25050, 대덕구,015003, 12세,2021,1420,749,671,111.6,1418,747,671,111.3
25050, 대덕구,015004, 13세,2021,1469,745,724,102.9,1465,741,724,102.3
25050, 대덕구,015005, 14세,2021,1591,841,750,112.1,1588,839,749,112
25050, 대덕구,020,15~19세,2021,8723,4516,4207,107.3,8640,4482,4158,107.8
25050, 대덕구,020001, 15세,2021,1485,788,697,113.1,1482,786,696,112.9
25050, 대덕구,020002, 16세,2021,1461,750,711,105.5,1459,750,709,105.8
25050, 대덕구,020003, 17세,2021,1681,909,772,117.7,1678,908,770,117.9
25050, 대덕구,020004, 18세,2021,1836,918,918,100,1817,912,905,100.8
25050, 대덕구,020005, 19세,2021,2260,1151,1109,103.8,2204,1126,1078,104.5
25050, 대덕구,025,20~24세,2021,13178,7069,6109,115.7,12718,6850,5868,116.7
25050, 대덕구,025001, 20세,2021,2517,1272,1245,102.2,2400,1222,1178,103.7
25050, 대덕구,025002, 21세,2021,2519,1293,1226,105.5,2427,1257,1170,107.4
25050, 대덕구,025003, 22세,2021,2671,1469,1202,122.2,2600,1438,1162,123.8
25050, 대덕구,025004, 23세,2021,2773,1543,1230,125.4,2691,1498,1193,125.6
25050, 대덕구,025005, 24세,2021,2698,1492,1206,123.7,2600,1435,1165,123.2
25050, 대덕구,030,25~29세,2021,12482,7087,5395,131.4,12033,6845,5188,131.9
25050, 대덕구,030001, 25세,2021,2615,1510,1105,136.7,2526,1457,1069,136.3
25050, 대덕구,030002, 26세,2021,2570,1426,1144,124.7,2475,1375,1100,125
25050, 대덕구,030003, 27세,2021,2455,1368,1087,125.9,2375,1329,1046,127.1
25050, 대덕구,030004, 28세,2021,2401,1394,1007,138.4,2317,1350,967,139.6
25050, 대덕구,030005, 29세,2021,2441,1389,1052,132,2340,1334,1006,132.6
25050, 대덕구,035,30~34세,2021,9962,5605,4357,128.6,9481,5367,4114,130.5
25050, 대덕구,035001, 30세,2021,2187,1240,947,130.9,2096,1196,900,132.9
25050, 대덕구,035002, 31세,2021,2046,1186,860,137.9,1956,1137,819,138.8
25050, 대덕구,035003, 32세,2021,1929,1064,865,123,1817,1016,801,126.8
25050, 대덕구,035004, 33세,2021,1947,1083,864,125.3,1850,1032,818,126.2
25050, 대덕구,035005, 34세,2021,1853,1032,821,125.7,1762,986,776,127.1
25050, 대덕구,040,35~39세,2021,10063,5396,4667,115.6,9675,5202,4473,116.3
25050, 대덕구,040001, 35세,2021,1873,1000,873,114.5,1792,960,832,115.4
25050, 대덕구,040002, 36세,2021,1881,1014,867,117,1806,982,824,119.2
25050, 대덕구,040003, 37세,2021,1929,1023,906,112.9,1849,982,867,113.3
25050, 대덕구,040004, 38세,2021,2109,1156,953,121.3,2025,1111,914,121.6
25050, 대덕구,040005, 39세,2021,2271,1203,1068,112.6,2203,1167,1036,112.6
25050, 대덕구,045,40~44세,2021,11907,6188,5719,108.2,11650,6075,5575,109
25050, 대덕구,045001, 40세,2021,2471,1315,1156,113.8,2410,1287,1123,114.6
25050, 대덕구,045002, 41세,2021,2367,1199,1168,102.7,2316,1174,1142,102.8
25050, 대덕구,045003, 42세,2021,2446,1305,1141,114.4,2386,1282,1104,116.1
25050, 대덕구,045004, 43세,2021,2254,1152,1102,104.5,2203,1131,1072,105.5
25050, 대덕구,045005, 44세,2021,2369,1217,1152,105.6,2335,1201,1134,105.9
25050, 대덕구,050,45~49세,2021,14080,7114,6966,102.1,13871,7018,6853,102.4
25050, 대덕구,050001, 45세,2021,2416,1213,1203,100.8,2371,1193,1178,101.3
25050, 대덕구,050002, 46세,2021,2587,1273,1314,96.9,2550,1257,1293,97.2
25050, 대덕구,050003, 47세,2021,2979,1561,1418,110.1,2946,1543,1403,110
25050, 대덕구,050004, 48세,2021,3071,1529,1542,99.2,3024,1508,1516,99.5
25050, 대덕구,050005, 49세,2021,3027,1538,1489,103.3,2980,1517,1463,103.7
25050, 대덕구,055,50~54세,2021,17457,8775,8682,101.1,17266,8690,8576,101.3
25050, 대덕구,055001, 50세,2021,3446,1686,1760,95.8,3406,1669,1737,96.1
25050, 대덕구,055002, 51세,2021,3418,1757,1661,105.8,3380,1738,1642,105.8
25050, 대덕구,055003, 52세,2021,3676,1867,1809,103.2,3626,1841,1785,103.1
25050, 대덕구,055004, 53세,2021,3685,1818,1867,97.4,3647,1804,1843,97.9
25050, 대덕구,055005, 54세,2021,3232,1647,1585,103.9,3207,1638,1569,104.4
25050, 대덕구,060,55~59세,2021,15525,7781,7744,100.5,15363,7715,7648,100.9
25050, 대덕구,060001, 55세,2021,3032,1525,1507,101.2,2999,1516,1483,102.2
25050, 대덕구,060002, 56세,2021,3291,1664,1627,102.3,3255,1646,1609,102.3
25050, 대덕구,060003, 57세,2021,2960,1509,1451,104,2928,1496,1432,104.5
25050, 대덕구,060004, 58세,2021,2952,1475,1477,99.9,2916,1460,1456,100.3
25050, 대덕구,060005, 59세,2021,3290,1608,1682,95.6,3265,1597,1668,95.7
25050, 대덕구,065,60~64세,2021,15553,7777,7776,100,15445,7727,7718,100.1
25050, 대덕구,065001, 60세,2021,3662,1838,1824,100.8,3638,1832,1806,101.4
25050, 대덕구,065002, 61세,2021,3461,1715,1746,98.2,3434,1702,1732,98.3
25050, 대덕구,065003, 62세,2021,2923,1424,1499,95,2907,1413,1494,94.6
25050, 대덕구,065004, 63세,2021,2745,1394,1351,103.2,2726,1384,1342,103.1
25050, 대덕구,065005, 64세,2021,2762,1406,1356,103.7,2740,1396,1344,103.9
25050, 대덕구,070,65~69세,2021,10504,5085,5419,93.8,10451,5065,5386,94
25050, 대덕구,070001, 65세,2021,2492,1242,1250,99.4,2480,1237,1243,99.5
25050, 대덕구,070002, 66세,2021,2466,1207,1259,95.9,2460,1204,1256,95.9
25050, 대덕구,070003, 67세,2021,2010,962,1048,91.8,1996,958,1038,92.3
25050, 대덕구,070004, 68세,2021,1669,779,890,87.5,1654,773,881,87.7
25050, 대덕구,070005, 69세,2021,1867,895,972,92.1,1861,893,968,92.3
25050, 대덕구,075,70~74세,2021,7033,3325,3708,89.7,7001,3318,3683,90.1
25050, 대덕구,075001, 70세,2021,1409,719,690,104.2,1403,719,684,105.1
25050, 대덕구,075002, 71세,2021,1484,728,756,96.3,1476,726,750,96.8
25050, 대덕구,075003, 72세,2021,1464,659,805,81.9,1456,658,798,82.5
25050, 대덕구,075004, 73세,2021,1363,633,730,86.7,1360,632,728,86.8
25050, 대덕구,075005, 74세,2021,1313,586,727,80.6,1306,583,723,80.6
25050, 대덕구,080,75~79세,2021,5199,2273,2926,77.7,5187,2269,2918,77.8
25050, 대덕구,080001, 75세,2021,948,469,479,97.9,943,467,476,98.1
25050, 대덕구,080002, 76세,2021,976,440,536,82.1,972,439,533,82.4
25050, 대덕구,080003, 77세,2021,983,416,567,73.4,981,415,566,73.3
25050, 대덕구,080004, 78세,2021,1055,439,616,71.3,1055,439,616,71.3
25050, 대덕구,080005, 79세,2021,1237,509,728,69.9,1236,509,727,70
25050, 대덕구,085,80~84세,2021,3688,1388,2300,60.3,3676,1384,2292,60.4
25050, 대덕구,085001, 80세,2021,881,352,529,66.5,878,351,527,66.6
25050, 대덕구,085002, 81세,2021,727,264,463,57,723,262,461,56.8
25050, 대덕구,085003, 82세,2021,774,276,498,55.4,769,275,494,55.7
25050, 대덕구,085004, 83세,2021,691,285,406,70.2,691,285,406,70.2
25050, 대덕구,085005, 84세,2021,615,211,404,52.2,615,211,404,52.2
25050, 대덕구,090,85~89세,2021,1876,594,1282,46.3,1875,594,1281,46.4
25050, 대덕구,090001, 85세,2021,518,173,345,50.1,518,173,345,50.1
25050, 대덕구,090002, 86세,2021,450,146,304,48,450,146,304,48
25050, 대덕구,090003, 87세,2021,374,124,250,49.6,373,124,249,49.8
25050, 대덕구,090004, 88세,2021,303,90,213,42.3,303,90,213,42.3
25050, 대덕구,090005, 89세,2021,231,61,170,35.9,231,61,170,35.9
25050, 대덕구,095,90~94세,2021,602,133,469,28.4,601,133,468,28.4
25050, 대덕구,095001, 90세,2021,190,40,150,26.7,190,40,150,26.7
25050, 대덕구,095002, 91세,2021,144,39,105,37.1,144,39,105,37.1
25050, 대덕구,095003, 92세,2021,118,22,96,22.9,118,22,96,22.9
25050, 대덕구,095004, 93세,2021,87,20,67,29.9,86,20,66,30.3
25050, 대덕구,095005, 94세,2021,63,12,51,23.5,63,12,51,23.5
25050, 대덕구,100,95~99세,2021,117,17,100,17,117,17,100,17
25050, 대덕구,100001, 95세,2021,41,8,33,24.2,41,8,33,24.2
25050, 대덕구,100002, 96세,2021,24,X,22,9.1,24,X,22,9.1
25050, 대덕구,100003, 97세,2021,17,X,16,6.3,17,X,16,6.3
25050, 대덕구,100004, 98세,2021,21,X,19,10.5,21,X,19,10.5
25050, 대덕구,100005, 99세,2021,14,X,10,40,14,X,10,40
25050, 대덕구,101,100세이상,2021,23,X,22,4.5,23,X,22,4.5
25050, 대덕구,102,15세미만,2021,17762,9095,8667,104.9,17695,9058,8637,104.9
25050, 대덕구,103,15~64세,2021,128930,67308,61622,109.2,126142,65971,60171,109.6
25050, 대덕구,104,65세이상,2021,29042,12816,16226,79,28931,12781,16150,79.1
25050, 대덕구,086,85세이상,2021,2618,745,1873,39.8,2616,745,1871,39.8
25050, 대덕구,126,평균연령,2021,44.1,42.9,45.4,,44.3,43,45.5,
25050, 대덕구,127,중위연령,2021,46.5,44.7,48.1,,46.8,45,48.4,
26,울산광역시,000,합계,2021,1120753,578207,542546,106.6,1095365,563428,531937,105.9
26,울산광역시,005,0~4세,2021,37456,19235,18221,105.6,37024,19009,18015,105.5
26,울산광역시,005001, 0세,2021,6178,3218,2960,108.7,6113,3185,2928,108.8
26,울산광역시,005002, 1세,2021,6638,3284,3354,97.9,6564,3243,3321,97.7
26,울산광역시,005003, 2세,2021,7387,3803,3584,106.1,7296,3753,3543,105.9
26,울산광역시,005004, 3세,2021,8081,4135,3946,104.8,7991,4095,3896,105.1
26,울산광역시,005005, 4세,2021,9172,4795,4377,109.5,9060,4733,4327,109.4
26,울산광역시,010,5~9세,2021,55219,28432,26787,106.1,54807,28227,26580,106.2
26,울산광역시,010001, 5세,2021,10473,5407,5066,106.7,10376,5369,5007,107.2
26,울산광역시,010002, 6세,2021,11028,5734,5294,108.3,10932,5685,5247,108.3
26,울산광역시,010003, 7세,2021,10975,5621,5354,105,10883,5571,5312,104.9
26,울산광역시,010004, 8세,2021,10976,5593,5383,103.9,10912,5558,5354,103.8
26,울산광역시,010005, 9세,2021,11767,6077,5690,106.8,11704,6044,5660,106.8
26,울산광역시,015,10~14세,2021,55972,29159,26813,108.7,55716,29013,26703,108.7
26,울산광역시,015001, 10세,2021,11471,5934,5537,107.2,11422,5906,5516,107.1
26,울산광역시,015002, 11세,2021,11091,5847,5244,111.5,11040,5823,5217,111.6
26,울산광역시,015003, 12세,2021,10696,5572,5124,108.7,10647,5540,5107,108.5
26,울산광역시,015004, 13세,2021,11241,5784,5457,106,11188,5751,5437,105.8
26,울산광역시,015005, 14세,2021,11473,6022,5451,110.5,11419,5993,5426,110.4
26,울산광역시,020,15~19세,2021,50920,27400,23520,116.5,50698,27298,23400,116.7
26,울산광역시,020001, 15세,2021,10208,5300,4908,108,10182,5289,4893,108.1
26,울산광역시,020002, 16세,2021,10030,5285,4745,111.4,9991,5271,4720,111.7
26,울산광역시,020003, 17세,2021,10856,5731,5125,111.8,10820,5715,5105,111.9
26,울산광역시,020004, 18세,2021,10747,5813,4934,117.8,10704,5795,4909,118
26,울산광역시,020005, 19세,2021,9079,5271,3808,138.4,9001,5228,3773,138.6
26,울산광역시,025,20~24세,2021,62607,36277,26330,137.8,60707,35140,25567,137.4
26,울산광역시,025001, 20세,2021,10928,6691,4237,157.9,10697,6561,4136,158.6
26,울산광역시,025002, 21세,2021,12670,7488,5182,144.5,12347,7318,5029,145.5
26,울산광역시,025003, 22세,2021,12001,6909,5092,135.7,11642,6682,4960,134.7
26,울산광역시,025004, 23세,2021,13004,7316,5688,128.6,12563,7040,5523,127.5
26,울산광역시,025005, 24세,2021,14004,7873,6131,128.4,13458,7539,5919,127.4
26,울산광역시,030,25~29세,2021,74109,42469,31640,134.2,70754,40407,30347,133.1
26,울산광역시,030001, 25세,2021,14524,8434,6090,138.5,13936,8085,5851,138.2
26,울산광역시,030002, 26세,2021,14714,8407,6307,133.3,14052,8008,6044,132.5
26,울산광역시,030003, 27세,2021,14809,8520,6289,135.5,14102,8082,6020,134.3
26,울산광역시,030004, 28세,2021,14978,8586,6392,134.3,14304,8167,6137,133.1
26,울산광역시,030005, 29세,2021,15084,8522,6562,129.9,14360,8065,6295,128.1
26,울산광역시,035,30~34세,2021,69957,38538,31419,122.7,65838,36054,29784,121.1
26,울산광역시,035001, 30세,2021,14540,7942,6598,120.4,13733,7461,6272,119
26,울산광역시,035002, 31세,2021,14082,7859,6223,126.3,13211,7306,5905,123.7
26,울산광역시,035003, 32세,2021,14017,7807,6210,125.7,13230,7348,5882,124.9
26,울산광역시,035004, 33세,2021,13520,7474,6046,123.6,12642,6950,5692,122.1
26,울산광역시,035005, 34세,2021,13798,7456,6342,117.6,13022,6989,6033,115.8
26,울산광역시,040,35~39세,2021,80244,42084,38160,110.3,76733,39946,36787,108.6
26,울산광역시,040001, 35세,2021,14165,7587,6578,115.3,13340,7074,6266,112.9
26,울산광역시,040002, 36세,2021,14343,7632,6711,113.7,13598,7183,6415,112
26,울산광역시,040003, 37세,2021,15558,8181,7377,110.9,14889,7770,7119,109.1
26,울산광역시,040004, 38세,2021,17284,8951,8333,107.4,16642,8557,8085,105.8
26,울산광역시,040005, 39세,2021,18894,9733,9161,106.2,18264,9362,8902,105.2
26,울산광역시,045,40~44세,2021,91723,47870,43853,109.2,89219,46369,42850,108.2
26,울산광역시,045001, 40세,2021,19106,10076,9030,111.6,18585,9735,8850,110
26,울산광역시,045002, 41세,2021,19928,10320,9608,107.4,19397,10007,9390,106.6
26,울산광역시,045003, 42세,2021,18323,9545,8778,108.7,17818,9225,8593,107.4
26,울산광역시,045004, 43세,2021,16925,8880,8045,110.4,16428,8622,7806,110.5
26,울산광역시,045005, 44세,2021,17441,9049,8392,107.8,16991,8780,8211,106.9
26,울산광역시,050,45~49세,2021,92115,46281,45834,101,89944,45023,44921,100.2
26,울산광역시,050001, 45세,2021,16418,8504,7914,107.5,16007,8248,7759,106.3
26,울산광역시,050002, 46세,2021,17559,8877,8682,102.2,17134,8641,8493,101.7
26,울산광역시,050003, 47세,2021,19007,9461,9546,99.1,18582,9210,9372,98.3
26,울산광역시,050004, 48세,2021,19499,9664,9835,98.3,19061,9419,9642,97.7
26,울산광역시,050005, 49세,2021,19632,9775,9857,99.2,19160,9505,9655,98.4
26,울산광역시,055,50~54세,2021,106836,52747,54089,97.5,104462,51408,53054,96.9
26,울산광역시,055001, 50세,2021,21390,10626,10764,98.7,20836,10309,10527,97.9
26,울산광역시,055002, 51세,2021,20994,10349,10645,97.2,20487,10061,10426,96.5
26,울산광역시,055003, 52세,2021,21585,10669,10916,97.7,21111,10408,10703,97.2
26,울산광역시,055004, 53세,2021,22125,10917,11208,97.4,21646,10641,11005,96.7
26,울산광역시,055005, 54세,2021,20742,10186,10556,96.5,20382,9989,10393,96.1
26,울산광역시,060,55~59세,2021,100277,52104,48173,108.2,98271,50964,47307,107.7
26,울산광역시,060001, 55세,2021,20724,10852,9872,109.9,20303,10605,9698,109.4
26,울산광역시,060002, 56세,2021,21001,10827,10174,106.4,20556,10570,9986,105.8
26,울산광역시,060003, 57세,2021,18863,9712,9151,106.1,18440,9472,8968,105.6
26,울산광역시,060004, 58세,2021,19797,10325,9472,109,19357,10086,9271,108.8
26,울산광역시,060005, 59세,2021,19892,10388,9504,109.3,19615,10231,9384,109
26,울산광역시,065,60~64세,2021,92550,46838,45712,102.5,91485,46260,45225,102.3
26,울산광역시,065001, 60세,2021,21703,11057,10646,103.9,21492,10943,10549,103.7
26,울산광역시,065002, 61세,2021,20257,10174,10083,100.9,19982,10021,9961,100.6
26,울산광역시,065003, 62세,2021,18124,9187,8937,102.8,17916,9072,8844,102.6
26,울산광역시,065004, 63세,2021,16556,8406,8150,103.1,16360,8301,8059,103
26,울산광역시,065005, 64세,2021,15910,8014,7896,101.5,15735,7923,7812,101.4
26,울산광역시,070,65~69세,2021,61337,30531,30806,99.1,60758,30231,30527,99
26,울산광역시,070001, 65세,2021,14249,7106,7143,99.5,14098,7022,7076,99.2
26,울산광역시,070002, 66세,2021,14353,7100,7253,97.9,14212,7025,7187,97.7
26,울산광역시,070003, 67세,2021,11668,5876,5792,101.5,11558,5814,5744,101.2
26,울산광역시,070004, 68세,2021,10518,5201,5317,97.8,10425,5158,5267,97.9
26,울산광역시,070005, 69세,2021,10549,5248,5301,99,10465,5212,5253,99.2
26,울산광역시,075,70~74세,2021,38229,18903,19326,97.8,37975,18806,19169,98.1
26,울산광역시,075001, 70세,2021,8144,4076,4068,100.2,8068,4049,4019,100.7
26,울산광역시,075002, 71세,2021,7990,3950,4040,97.8,7940,3930,4010,98
26,울산광역시,075003, 72세,2021,7812,3887,3925,99,7760,3868,3892,99.4
26,울산광역시,075004, 73세,2021,7552,3712,3840,96.7,7506,3690,3816,96.7
26,울산광역시,075005, 74세,2021,6731,3278,3453,94.9,6701,3269,3432,95.3
26,울산광역시,080,75~79세,2021,24052,10775,13277,81.2,23928,10736,13192,81.4
26,울산광역시,080001, 75세,2021,4619,2229,2390,93.3,4590,2222,2368,93.8
26,울산광역시,080002, 76세,2021,4581,2154,2427,88.8,4562,2147,2415,88.9
26,울산광역시,080003, 77세,2021,4673,2032,2641,76.9,4655,2027,2628,77.1
26,울산광역시,080004, 78세,2021,4937,2144,2793,76.8,4910,2133,2777,76.8
26,울산광역시,080005, 79세,2021,5242,2216,3026,73.2,5211,2207,3004,73.5
26,울산광역시,085,80~84세,2021,15923,5852,10071,58.1,15850,5831,10019,58.2
26,울산광역시,085001, 80세,2021,3792,1540,2252,68.4,3775,1531,2244,68.2
26,울산광역시,085002, 81세,2021,3585,1356,2229,60.8,3571,1352,2219,60.9
26,울산광역시,085003, 82세,2021,3278,1234,2044,60.4,3261,1231,2030,60.6
26,울산광역시,085004, 83세,2021,2825,943,1882,50.1,2811,940,1871,50.2
26,울산광역시,085005, 84세,2021,2443,779,1664,46.8,2432,777,1655,46.9
26,울산광역시,090,85~89세,2021,8006,2166,5840,37.1,7986,2162,5824,37.1
26,울산광역시,090001, 85세,2021,2117,603,1514,39.8,2109,601,1508,39.9
26,울산광역시,090002, 86세,2021,1913,526,1387,37.9,1910,526,1384,38
26,울산광역시,090003, 87세,2021,1631,467,1164,40.1,1627,466,1161,40.1
26,울산광역시,090004, 88세,2021,1304,334,970,34.4,1302,334,968,34.5
26,울산광역시,090005, 89세,2021,1041,236,805,29.3,1038,235,803,29.3
26,울산광역시,095,90~94세,2021,2591,470,2121,22.2,2582,469,2113,22.2
26,울산광역시,095001, 90세,2021,802,157,645,24.3,800,156,644,24.2
26,울산광역시,095002, 91세,2021,598,105,493,21.3,592,105,487,21.6
26,울산광역시,095003, 92세,2021,512,110,402,27.4,511,110,401,27.4
26,울산광역시,095004, 93세,2021,384,54,330,16.4,384,54,330,16.4
26,울산광역시,095005, 94세,2021,295,44,251,17.5,295,44,251,17.5
26,울산광역시,100,95~99세,2021,566,71,495,14.3,564,70,494,14.2
26,울산광역시,100001, 95세,2021,195,26,169,15.4,194,26,168,15.5
26,울산광역시,100002, 96세,2021,153,15,138,10.9,152,14,138,10.1
26,울산광역시,100003, 97세,2021,95,11,84,13.1,95,11,84,13.1
26,울산광역시,100004, 98세,2021,88,16,72,22.2,88,16,72,22.2
26,울산광역시,100005, 99세,2021,35,X,32,9.4,35,X,32,9.4
26,울산광역시,101,100세이상,2021,64,5,59,8.5,64,5,59,8.5
26,울산광역시,102,15세미만,2021,148647,76826,71821,107,147547,76249,71298,106.9
26,울산광역시,103,15~64세,2021,821338,432608,388730,111.3,798111,418869,379242,110.4
26,울산광역시,104,65세이상,2021,150768,68773,81995,83.9,149707,68310,81397,83.9
26,울산광역시,086,85세이상,2021,11227,2712,8515,31.8,11196,2706,8490,31.9
26,울산광역시,126,평균연령,2021,42.2,41.2,43.3,,42.3,41.3,43.4,
26,울산광역시,127,중위연령,2021,44,42.5,45.6,,44.2,42.7,45.8,
26004, 읍부,000,합계,2021,191057,99753,91304,109.3,183736,95255,88481,107.7
26004, 읍부,005,0~4세,2021,6386,3328,3058,108.8,6212,3237,2975,108.8
26004, 읍부,005001, 0세,2021,1100,601,499,120.4,1076,588,488,120.5
26004, 읍부,005002, 1세,2021,1161,567,594,95.5,1130,554,576,96.2
26004, 읍부,005003, 2세,2021,1224,635,589,107.8,1186,613,573,107
26004, 읍부,005004, 3세,2021,1420,721,699,103.1,1392,710,682,104.1
26004, 읍부,005005, 4세,2021,1481,804,677,118.8,1428,772,656,117.7
26004, 읍부,010,5~9세,2021,9148,4645,4503,103.2,9015,4579,4436,103.2
26004, 읍부,010001, 5세,2021,1613,801,812,98.6,1582,787,795,99
26004, 읍부,010002, 6세,2021,1799,952,847,112.4,1767,937,830,112.9
26004, 읍부,010003, 7세,2021,1811,952,859,110.8,1778,935,843,110.9
26004, 읍부,010004, 8세,2021,1857,922,935,98.6,1838,912,926,98.5
26004, 읍부,010005, 9세,2021,2068,1018,1050,97,2050,1008,1042,96.7
26004, 읍부,015,10~14세,2021,10077,5197,4880,106.5,9997,5147,4850,106.1
26004, 읍부,015001, 10세,2021,2046,1061,985,107.7,2029,1052,977,107.7
26004, 읍부,015002, 11세,2021,1970,1019,951,107.2,1958,1011,947,106.8
26004, 읍부,015003, 12세,2021,1889,954,935,102,1870,939,931,100.9
26004, 읍부,015004, 13세,2021,2058,1048,1010,103.8,2040,1038,1002,103.6
26004, 읍부,015005, 14세,2021,2114,1115,999,111.6,2100,1107,993,111.5
26004, 읍부,020,15~19세,2021,9536,5138,4398,116.8,9451,5098,4353,117.1
26004, 읍부,020001, 15세,2021,1900,1010,890,113.5,1893,1008,885,113.9
26004, 읍부,020002, 16세,2021,1927,995,932,106.8,1915,993,922,107.7
26004, 읍부,020003, 17세,2021,1983,1009,974,103.6,1970,1002,968,103.5
26004, 읍부,020004, 18세,2021,1962,1046,916,114.2,1937,1034,903,114.5
26004, 읍부,020005, 19세,2021,1764,1078,686,157.1,1736,1061,675,157.2
26004, 읍부,025,20~24세,2021,11297,6715,4582,146.6,10968,6515,4453,146.3
26004, 읍부,025001, 20세,2021,2082,1309,773,169.3,2041,1285,756,170
26004, 읍부,025002, 21세,2021,2360,1448,912,158.8,2313,1423,890,159.9
26004, 읍부,025003, 22세,2021,2183,1271,912,139.4,2126,1236,890,138.9
26004, 읍부,025004, 23세,2021,2244,1291,953,135.5,2165,1246,919,135.6
26004, 읍부,025005, 24세,2021,2428,1396,1032,135.3,2323,1325,998,132.8
26004, 읍부,030,25~29세,2021,12436,7383,5053,146.1,11596,6832,4764,143.4
26004, 읍부,030001, 25세,2021,2491,1532,959,159.7,2358,1447,911,158.8
26004, 읍부,030002, 26세,2021,2596,1524,1072,142.2,2445,1421,1024,138.8
26004, 읍부,030003, 27세,2021,2513,1510,1003,150.5,2343,1395,948,147.2
26004, 읍부,030004, 28세,2021,2419,1468,951,154.4,2239,1346,893,150.7
26004, 읍부,030005, 29세,2021,2417,1349,1068,126.3,2211,1223,988,123.8
26004, 읍부,035,30~34세,2021,11037,6135,4902,125.2,9917,5413,4504,120.2
26004, 읍부,035001, 30세,2021,2325,1275,1050,121.4,2110,1142,968,118
26004, 읍부,035002, 31세,2021,2238,1278,960,133.1,2006,1125,881,127.7
26004, 읍부,035003, 32세,2021,2192,1224,968,126.4,1956,1078,878,122.8
26004, 읍부,035004, 33세,2021,2094,1147,947,121.1,1858,1000,858,116.6
26004, 읍부,035005, 34세,2021,2188,1211,977,124,1987,1068,919,116.2
26004, 읍부,040,35~39세,2021,12671,6758,5913,114.3,11731,6137,5594,109.7
26004, 읍부,040001, 35세,2021,2236,1219,1017,119.9,2000,1063,937,113.4
26004, 읍부,040002, 36세,2021,2270,1217,1053,115.6,2056,1083,973,111.3
26004, 읍부,040003, 37세,2021,2472,1336,1136,117.6,2317,1224,1093,112
26004, 읍부,040004, 38세,2021,2678,1414,1264,111.9,2508,1304,1204,108.3
26004, 읍부,040005, 39세,2021,3015,1572,1443,108.9,2850,1463,1387,105.5
26004, 읍부,045,40~44세,2021,15461,8020,7441,107.8,14758,7561,7197,105.1
26004, 읍부,045001, 40세,2021,3142,1701,1441,118,2994,1601,1393,114.9
26004, 읍부,045002, 41세,2021,3217,1620,1597,101.4,3070,1526,1544,98.8
26004, 읍부,045003, 42세,2021,3067,1577,1490,105.8,2925,1478,1447,102.1
26004, 읍부,045004, 43세,2021,2873,1501,1372,109.4,2713,1406,1307,107.6
26004, 읍부,045005, 44세,2021,3162,1621,1541,105.2,3056,1550,1506,102.9
26004, 읍부,050,45~49세,2021,17648,8871,8777,101.1,16910,8405,8505,98.8
26004, 읍부,050001, 45세,2021,3130,1603,1527,105,2988,1507,1481,101.8
26004, 읍부,050002, 46세,2021,3292,1625,1667,97.5,3146,1538,1608,95.6
26004, 읍부,050003, 47세,2021,3645,1844,1801,102.4,3508,1752,1756,99.8
26004, 읍부,050004, 48세,2021,3739,1837,1902,96.6,3585,1741,1844,94.4
26004, 읍부,050005, 49세,2021,3842,1962,1880,104.4,3683,1867,1816,102.8
26004, 읍부,055,50~54세,2021,19627,10100,9527,106,18803,9628,9175,104.9
26004, 읍부,055001, 50세,2021,4167,2144,2023,106,3974,2028,1946,104.2
26004, 읍부,055002, 51세,2021,3949,2005,1944,103.1,3774,1911,1863,102.6
26004, 읍부,055003, 52세,2021,3919,2041,1878,108.7,3763,1956,1807,108.2
26004, 읍부,055004, 53세,2021,3966,2051,1915,107.1,3806,1953,1853,105.4
26004, 읍부,055005, 54세,2021,3626,1859,1767,105.2,3486,1780,1706,104.3
26004, 읍부,060,55~59세,2021,16668,8955,7713,116.1,15942,8518,7424,114.7
26004, 읍부,060001, 55세,2021,3525,1870,1655,113,3372,1777,1595,111.4
26004, 읍부,060002, 56세,2021,3587,1931,1656,116.6,3433,1830,1603,114.2
26004, 읍부,060003, 57세,2021,3151,1690,1461,115.7,2995,1596,1399,114.1
26004, 읍부,060004, 58세,2021,3268,1786,1482,120.5,3104,1696,1408,120.5
26004, 읍부,060005, 59세,2021,3137,1678,1459,115,3038,1619,1419,114.1
26004, 읍부,065,60~64세,2021,14442,7554,6888,109.7,14102,7359,6743,109.1
26004, 읍부,065001, 60세,2021,3421,1811,1610,112.5,3354,1768,1586,111.5
26004, 읍부,065002, 61세,2021,3114,1630,1484,109.8,3023,1581,1442,109.6
26004, 읍부,065003, 62세,2021,2812,1485,1327,111.9,2738,1445,1293,111.8
26004, 읍부,065004, 63세,2021,2576,1321,1255,105.3,2520,1284,1236,103.9
26004, 읍부,065005, 64세,2021,2519,1307,1212,107.8,2467,1281,1186,108
26004, 읍부,070,65~69세,2021,9361,4732,4629,102.2,9200,4642,4558,101.8
26004, 읍부,070001, 65세,2021,2208,1127,1081,104.3,2155,1096,1059,103.5
26004, 읍부,070002, 66세,2021,2256,1127,1129,99.8,2219,1109,1110,99.9
26004, 읍부,070003, 67세,2021,1760,899,861,104.4,1729,879,850,103.4
26004, 읍부,070004, 68세,2021,1557,786,771,101.9,1537,775,762,101.7
26004, 읍부,070005, 69세,2021,1580,793,787,100.8,1560,783,777,100.8
26004, 읍부,075,70~74세,2021,5945,2943,3002,98,5887,2923,2964,98.6
26004, 읍부,075001, 70세,2021,1244,624,620,100.6,1232,620,612,101.3
26004, 읍부,075002, 71세,2021,1238,620,618,100.3,1223,613,610,100.5
26004, 읍부,075003, 72세,2021,1209,590,619,95.3,1198,586,612,95.8
26004, 읍부,075004, 73세,2021,1157,560,597,93.8,1145,556,589,94.4
26004, 읍부,075005, 74세,2021,1097,549,548,100.2,1089,548,541,101.3
26004, 읍부,080,75~79세,2021,3987,1694,2293,73.9,3951,1685,2266,74.4
26004, 읍부,080001, 75세,2021,690,319,371,86,686,319,367,86.9
26004, 읍부,080002, 76세,2021,700,313,387,80.9,695,311,384,81
26004, 읍부,080003, 77세,2021,797,307,490,62.7,793,306,487,62.8
26004, 읍부,080004, 78세,2021,861,372,489,76.1,850,369,481,76.7
26004, 읍부,080005, 79세,2021,939,383,556,68.9,927,380,547,69.5
26004, 읍부,085,80~84세,2021,2995,1024,1971,52,2969,1019,1950,52.3
26004, 읍부,085001, 80세,2021,678,249,429,58,674,247,427,57.8
26004, 읍부,085002, 81세,2021,658,227,431,52.7,651,225,426,52.8
26004, 읍부,085003, 82세,2021,631,216,415,52,626,215,411,52.3
26004, 읍부,085004, 83세,2021,573,203,370,54.9,566,203,363,55.9
26004, 읍부,085005, 84세,2021,455,129,326,39.6,452,129,323,39.9
26004, 읍부,090,85~89세,2021,1615,427,1188,35.9,1610,425,1185,35.9
26004, 읍부,090001, 85세,2021,394,123,271,45.4,392,122,270,45.2
26004, 읍부,090002, 86세,2021,417,110,307,35.8,416,110,306,35.9
26004, 읍부,090003, 87세,2021,342,86,256,33.6,341,85,256,33.2
26004, 읍부,090004, 88세,2021,247,65,182,35.7,247,65,182,35.7
26004, 읍부,090005, 89세,2021,215,43,172,25,214,43,171,25.1
26004, 읍부,095,90~94세,2021,583,115,468,24.6,581,114,467,24.4
26004, 읍부,095001, 90세,2021,187,42,145,29,186,41,145,28.3
26004, 읍부,095002, 91세,2021,141,24,117,20.5,140,24,116,20.7
26004, 읍부,095003, 92세,2021,112,27,85,31.8,112,27,85,31.8
26004, 읍부,095004, 93세,2021,80,18,62,29,80,18,62,29
26004, 읍부,095005, 94세,2021,63,X,59,6.8,63,X,59,6.8
26004, 읍부,100,95~99세,2021,125,18,107,16.8,124,17,107,15.9
26004, 읍부,100001, 95세,2021,50,8,42,19,50,8,42,19
26004, 읍부,100002, 96세,2021,30,5,25,20,29,X,25,16
26004, 읍부,100003, 97세,2021,18,X,17,5.9,18,X,17,5.9
26004, 읍부,100004, 98세,2021,23,X,20,15,23,X,20,15
26004, 읍부,100005, 99세,2021,X,X,X,33.3,X,X,X,33.3
26004, 읍부,101,100세이상,2021,12,X,11,9.1,12,X,11,9.1
26004, 읍부,102,15세미만,2021,25611,13170,12441,105.9,25224,12963,12261,105.7
26004, 읍부,103,15~64세,2021,140823,75629,65194,116,134178,71466,62712,114
26004, 읍부,104,65세이상,2021,24623,10954,13669,80.1,24334,10826,13508,80.1
26004, 읍부,086,85세이상,2021,2335,561,1774,31.6,2327,557,1770,31.5
26004, 읍부,126,평균연령,2021,42,40.9,43.1,,42,40.9,43.2,
26004, 읍부,127,중위연령,2021,44.2,42.8,45.6,,44.4,43,45.8,
26005, 면부,000,합계,2021,33107,17526,15581,112.5,31209,15921,15288,104.1
26005, 면부,005,0~4세,2021,480,248,232,106.9,476,248,228,108.8
26005, 면부,005001, 0세,2021,89,44,45,97.8,88,44,44,100
26005, 면부,005002, 1세,2021,68,38,30,126.7,68,38,30,126.7
26005, 면부,005003, 2세,2021,94,49,45,108.9,93,49,44,111.4
26005, 면부,005004, 3세,2021,120,61,59,103.4,120,61,59,103.4
26005, 면부,005005, 4세,2021,109,56,53,105.7,107,56,51,109.8
26005, 면부,010,5~9세,2021,650,349,301,115.9,647,347,300,115.7
26005, 면부,010001, 5세,2021,123,65,58,112.1,123,65,58,112.1
26005, 면부,010002, 6세,2021,119,65,54,120.4,118,64,54,118.5
26005, 면부,010003, 7세,2021,152,82,70,117.1,152,82,70,117.1
26005, 면부,010004, 8세,2021,120,61,59,103.4,120,61,59,103.4
26005, 면부,010005, 9세,2021,136,76,60,126.7,134,75,59,127.1
26005, 면부,015,10~14세,2021,702,358,344,104.1,697,355,342,103.8
26005, 면부,015001, 10세,2021,126,57,69,82.6,125,56,69,81.2
26005, 면부,015002, 11세,2021,125,67,58,115.5,123,66,57,115.8
26005, 면부,015003, 12세,2021,143,77,66,116.7,142,77,65,118.5
26005, 면부,015004, 13세,2021,147,72,75,96,146,71,75,94.7
26005, 면부,015005, 14세,2021,161,85,76,111.8,161,85,76,111.8
26005, 면부,020,15~19세,2021,944,540,404,133.7,940,537,403,133.3
26005, 면부,020001, 15세,2021,140,74,66,112.1,139,74,65,113.8
26005, 면부,020002, 16세,2021,175,99,76,130.3,173,97,76,127.6
26005, 면부,020003, 17세,2021,212,138,74,186.5,212,138,74,186.5
26005, 면부,020004, 18세,2021,189,109,80,136.3,188,108,80,135
26005, 면부,020005, 19세,2021,228,120,108,111.1,228,120,108,111.1
26005, 면부,025,20~24세,2021,1674,963,711,135.4,1521,821,700,117.3
26005, 면부,025001, 20세,2021,304,155,149,104,295,149,146,102.1
26005, 면부,025002, 21세,2021,336,166,170,97.6,322,153,169,90.5
26005, 면부,025003, 22세,2021,352,201,151,133.1,320,170,150,113.3
26005, 면부,025004, 23세,2021,339,214,125,171.2,296,171,125,136.8
26005, 면부,025005, 24세,2021,343,227,116,195.7,288,178,110,161.8
26005, 면부,030,25~29세,2021,1827,1254,573,218.8,1411,880,531,165.7
26005, 면부,030001, 25세,2021,366,253,113,223.9,292,187,105,178.1
26005, 면부,030002, 26세,2021,359,241,118,204.2,284,174,110,158.2
26005, 면부,030003, 27세,2021,373,259,114,227.2,285,182,103,176.7
26005, 면부,030004, 28세,2021,385,271,114,237.7,299,196,103,190.3
26005, 면부,030005, 29세,2021,344,230,114,201.8,251,141,110,128.2
26005, 면부,035,30~34세,2021,1594,1077,517,208.3,1129,663,466,142.3
26005, 면부,035001, 30세,2021,340,227,113,200.9,244,145,99,146.5
26005, 면부,035002, 31세,2021,319,227,92,246.7,207,123,84,146.4
26005, 면부,035003, 32세,2021,309,211,98,215.3,223,136,87,156.3
26005, 면부,035004, 33세,2021,329,229,100,229,237,146,91,160.4
26005, 면부,035005, 34세,2021,297,183,114,160.5,218,113,105,107.6
26005, 면부,040,35~39세,2021,1602,996,606,164.4,1250,688,562,122.4
26005, 면부,040001, 35세,2021,324,207,117,176.9,242,134,108,124.1
26005, 면부,040002, 36세,2021,299,197,102,193.1,230,136,94,144.7
26005, 면부,040003, 37세,2021,296,193,103,187.4,212,118,94,125.5
26005, 면부,040004, 38세,2021,330,196,134,146.3,265,139,126,110.3
26005, 면부,040005, 39세,2021,353,203,150,135.3,301,161,140,115
26005, 면부,045,40~44세,2021,1643,1018,625,162.9,1440,853,587,145.3
26005, 면부,045001, 40세,2021,331,203,128,158.6,270,151,119,126.9
26005, 면부,045002, 41세,2021,354,218,136,160.3,315,189,126,150
26005, 면부,045003, 42세,2021,311,187,124,150.8,279,159,120,132.5
26005, 면부,045004, 43세,2021,313,191,122,156.6,276,165,111,148.6
26005, 면부,045005, 44세,2021,334,219,115,190.4,300,189,111,170.3
26005, 면부,050,45~49세,2021,1841,1020,821,124.2,1748,952,796,119.6
26005, 면부,050001, 45세,2021,292,176,116,151.7,268,159,109,145.9
26005, 면부,050002, 46세,2021,363,195,168,116.1,339,178,161,110.6
26005, 면부,050003, 47세,2021,350,194,156,124.4,338,186,152,122.4
26005, 면부,050004, 48세,2021,413,222,191,116.2,399,211,188,112.2
26005, 면부,050005, 49세,2021,423,233,190,122.6,404,218,186,117.2
26005, 면부,055,50~54세,2021,2827,1459,1368,106.7,2745,1403,1342,104.5
26005, 면부,055001, 50세,2021,506,260,246,105.7,481,240,241,99.6
26005, 면부,055002, 51세,2021,502,272,230,118.3,488,264,224,117.9
26005, 면부,055003, 52세,2021,558,277,281,98.6,543,268,275,97.5
26005, 면부,055004, 53세,2021,632,335,297,112.8,617,325,292,111.3
26005, 면부,055005, 54세,2021,629,315,314,100.3,616,306,310,98.7
26005, 면부,060,55~59세,2021,3410,1798,1612,111.5,3351,1760,1591,110.6
26005, 면부,060001, 55세,2021,629,339,290,116.9,615,331,284,116.5
26005, 면부,060002, 56세,2021,648,365,283,129,635,357,278,128.4
26005, 면부,060003, 57세,2021,669,321,348,92.2,657,312,345,90.4
26005, 면부,060004, 58세,2021,686,358,328,109.1,677,353,324,109
26005, 면부,060005, 59세,2021,778,415,363,114.3,767,407,360,113.1
26005, 면부,065,60~64세,2021,4146,2101,2045,102.7,4118,2085,2033,102.6
26005, 면부,065001, 60세,2021,885,456,429,106.3,881,453,428,105.8
26005, 면부,065002, 61세,2021,872,443,429,103.3,867,440,427,103
26005, 면부,065003, 62세,2021,819,413,406,101.7,812,409,403,101.5
26005, 면부,065004, 63세,2021,766,378,388,97.4,758,373,385,96.9
26005, 면부,065005, 64세,2021,804,411,393,104.6,800,410,390,105.1
26005, 면부,070,65~69세,2021,3291,1648,1643,100.3,3273,1636,1637,99.9
26005, 면부,070001, 65세,2021,720,390,330,118.2,716,388,328,118.3
26005, 면부,070002, 66세,2021,742,381,361,105.5,739,379,360,105.3
26005, 면부,070003, 67세,2021,621,324,297,109.1,617,322,295,109.2
26005, 면부,070004, 68세,2021,603,282,321,87.9,601,280,321,87.2
26005, 면부,070005, 69세,2021,605,271,334,81.1,600,267,333,80.2
26005, 면부,075,70~74세,2021,2285,1184,1101,107.5,2279,1182,1097,107.7
26005, 면부,075001, 70세,2021,443,226,217,104.1,440,224,216,103.7
26005, 면부,075002, 71세,2021,491,265,226,117.3,491,265,226,117.3
26005, 면부,075003, 72세,2021,459,231,228,101.3,456,231,225,102.7
26005, 면부,075004, 73세,2021,456,242,214,113.1,456,242,214,113.1
26005, 면부,075005, 74세,2021,436,220,216,101.9,436,220,216,101.9
26005, 면부,080,75~79세,2021,1704,716,988,72.5,1700,715,985,72.6
26005, 면부,080001, 75세,2021,302,141,161,87.6,301,141,160,88.1
26005, 면부,080002, 76세,2021,345,153,192,79.7,344,152,192,79.2
26005, 면부,080003, 77세,2021,316,124,192,64.6,315,124,191,64.9
26005, 면부,080004, 78세,2021,356,144,212,67.9,356,144,212,67.9
26005, 면부,080005, 79세,2021,385,154,231,66.7,384,154,230,67
26005, 면부,085,80~84세,2021,1385,516,869,59.4,1382,515,867,59.4
26005, 면부,085001, 80세,2021,321,136,185,73.5,320,136,184,73.9
26005, 면부,085002, 81세,2021,308,121,187,64.7,308,121,187,64.7
26005, 면부,085003, 82세,2021,273,96,177,54.2,272,96,176,54.5
26005, 면부,085004, 83세,2021,251,80,171,46.8,250,79,171,46.2
26005, 면부,085005, 84세,2021,232,83,149,55.7,232,83,149,55.7
26005, 면부,090,85~89세,2021,777,210,567,37,777,210,567,37
26005, 면부,090001, 85세,2021,183,54,129,41.9,183,54,129,41.9
26005, 면부,090002, 86세,2021,180,51,129,39.5,180,51,129,39.5
26005, 면부,090003, 87세,2021,161,50,111,45,161,50,111,45
26005, 면부,090004, 88세,2021,138,30,108,27.8,138,30,108,27.8
26005, 면부,090005, 89세,2021,115,25,90,27.8,115,25,90,27.8
26005, 면부,095,90~94세,2021,259,56,203,27.6,259,56,203,27.6
26005, 면부,095001, 90세,2021,71,14,57,24.6,71,14,57,24.6
26005, 면부,095002, 91세,2021,51,8,43,18.6,51,8,43,18.6
26005, 면부,095003, 92세,2021,55,13,42,31,55,13,42,31
26005, 면부,095004, 93세,2021,51,10,41,24.4,51,10,41,24.4
26005, 면부,095005, 94세,2021,31,11,20,55,31,11,20,55
26005, 면부,100,95~99세,2021,61,14,47,29.8,61,14,47,29.8
26005, 면부,100001, 95세,2021,20,6,14,42.9,20,6,14,42.9
26005, 면부,100002, 96세,2021,16,X,14,14.3,16,X,14,14.3
26005, 면부,100003, 97세,2021,11,X,11,0,11,X,11,0
26005, 면부,100004, 98세,2021,11,5,6,83.3,11,5,6,83.3
26005, 면부,100005, 99세,2021,X,X,X,50,X,X,X,50
26005, 면부,101,100세이상,2021,5,X,X,25,5,X,X,25
26005, 면부,102,15세미만,2021,1832,955,877,108.9,1820,950,870,109.2
26005, 면부,103,15~64세,2021,21508,12226,9282,131.7,19653,10642,9011,118.1
26005, 면부,104,65세이상,2021,9767,4345,5422,80.1,9736,4329,5407,80.1
26005, 면부,086,85세이상,2021,1102,281,821,34.2,1102,281,821,34.2
26005, 면부,126,평균연령,2021,52.1,49.6,54.9,,53.1,51,55.2,
26005, 면부,127,중위연령,2021,56.2,53.4,59.1,,57.5,55.6,59.4,
26003, 동부,000,합계,2021,896589,460928,435661,105.8,880420,452252,428168,105.6
26003, 동부,005,0~4세,2021,30590,15659,14931,104.9,30336,15524,14812,104.8
26003, 동부,005001, 0세,2021,4989,2573,2416,106.5,4949,2553,2396,106.6
26003, 동부,005002, 1세,2021,5409,2679,2730,98.1,5366,2651,2715,97.6
26003, 동부,005003, 2세,2021,6069,3119,2950,105.7,6017,3091,2926,105.6
26003, 동부,005004, 3세,2021,6541,3353,3188,105.2,6479,3324,3155,105.4
26003, 동부,005005, 4세,2021,7582,3935,3647,107.9,7525,3905,3620,107.9
26003, 동부,010,5~9세,2021,45421,23438,21983,106.6,45145,23301,21844,106.7
26003, 동부,010001, 5세,2021,8737,4541,4196,108.2,8671,4517,4154,108.7
26003, 동부,010002, 6세,2021,9110,4717,4393,107.4,9047,4684,4363,107.4
26003, 동부,010003, 7세,2021,9012,4587,4425,103.7,8953,4554,4399,103.5
26003, 동부,010004, 8세,2021,8999,4610,4389,105,8954,4585,4369,104.9
26003, 동부,010005, 9세,2021,9563,4983,4580,108.8,9520,4961,4559,108.8
26003, 동부,015,10~14세,2021,45193,23604,21589,109.3,45022,23511,21511,109.3
26003, 동부,015001, 10세,2021,9299,4816,4483,107.4,9268,4798,4470,107.3
26003, 동부,015002, 11세,2021,8996,4761,4235,112.4,8959,4746,4213,112.7
26003, 동부,015003, 12세,2021,8664,4541,4123,110.1,8635,4524,4111,110
26003, 동부,015004, 13세,2021,9036,4664,4372,106.7,9002,4642,4360,106.5
26003, 동부,015005, 14세,2021,9198,4822,4376,110.2,9158,4801,4357,110.2
26003, 동부,020,15~19세,2021,40440,21722,18718,116,40307,21663,18644,116.2
26003, 동부,020001, 15세,2021,8168,4216,3952,106.7,8150,4207,3943,106.7
26003, 동부,020002, 16세,2021,7928,4191,3737,112.1,7903,4181,3722,112.3
26003, 동부,020003, 17세,2021,8661,4584,4077,112.4,8638,4575,4063,112.6
26003, 동부,020004, 18세,2021,8596,4658,3938,118.3,8579,4653,3926,118.5
26003, 동부,020005, 19세,2021,7087,4073,3014,135.1,7037,4047,2990,135.4
26003, 동부,025,20~24세,2021,49636,28599,21037,135.9,48218,27804,20414,136.2
26003, 동부,025001, 20세,2021,8542,5227,3315,157.7,8361,5127,3234,158.5
26003, 동부,025002, 21세,2021,9974,5874,4100,143.3,9712,5742,3970,144.6
26003, 동부,025003, 22세,2021,9466,5437,4029,134.9,9196,5276,3920,134.6
26003, 동부,025004, 23세,2021,10421,5811,4610,126.1,10102,5623,4479,125.5
26003, 동부,025005, 24세,2021,11233,6250,4983,125.4,10847,6036,4811,125.5
26003, 동부,030,25~29세,2021,59846,33832,26014,130.1,57747,32695,25052,130.5
26003, 동부,030001, 25세,2021,11667,6649,5018,132.5,11286,6451,4835,133.4
26003, 동부,030002, 26세,2021,11759,6642,5117,129.8,11323,6413,4910,130.6
26003, 동부,030003, 27세,2021,11923,6751,5172,130.5,11474,6505,4969,130.9
26003, 동부,030004, 28세,2021,12174,6847,5327,128.5,11766,6625,5141,128.9
26003, 동부,030005, 29세,2021,12323,6943,5380,129.1,11898,6701,5197,128.9
26003, 동부,035,30~34세,2021,57326,31326,26000,120.5,54792,29978,24814,120.8
26003, 동부,035001, 30세,2021,11875,6440,5435,118.5,11379,6174,5205,118.6
26003, 동부,035002, 31세,2021,11525,6354,5171,122.9,10998,6058,4940,122.6
26003, 동부,035003, 32세,2021,11516,6372,5144,123.9,11051,6134,4917,124.8
26003, 동부,035004, 33세,2021,11097,6098,4999,122,10547,5804,4743,122.4
26003, 동부,035005, 34세,2021,11313,6062,5251,115.4,10817,5808,5009,116
26003, 동부,040,35~39세,2021,65971,34330,31641,108.5,63752,33121,30631,108.1
26003, 동부,040001, 35세,2021,11605,6161,5444,113.2,11098,5877,5221,112.6
26003, 동부,040002, 36세,2021,11774,6218,5556,111.9,11312,5964,5348,111.5
26003, 동부,040003, 37세,2021,12790,6652,6138,108.4,12360,6428,5932,108.4
26003, 동부,040004, 38세,2021,14276,7341,6935,105.9,13869,7114,6755,105.3
26003, 동부,040005, 39세,2021,15526,7958,7568,105.2,15113,7738,7375,104.9
26003, 동부,045,40~44세,2021,74619,38832,35787,108.5,73021,37955,35066,108.2
26003, 동부,045001, 40세,2021,15633,8172,7461,109.5,15321,7983,7338,108.8
26003, 동부,045002, 41세,2021,16357,8482,7875,107.7,16012,8292,7720,107.4
26003, 동부,045003, 42세,2021,14945,7781,7164,108.6,14614,7588,7026,108
26003, 동부,045004, 43세,2021,13739,7188,6551,109.7,13439,7051,6388,110.4
26003, 동부,045005, 44세,2021,13945,7209,6736,107,13635,7041,6594,106.8
26003, 동부,050,45~49세,2021,72626,36390,36236,100.4,71286,35666,35620,100.1
26003, 동부,050001, 45세,2021,12996,6725,6271,107.2,12751,6582,6169,106.7
26003, 동부,050002, 46세,2021,13904,7057,6847,103.1,13649,6925,6724,103
26003, 동부,050003, 47세,2021,15012,7423,7589,97.8,14736,7272,7464,97.4
26003, 동부,050004, 48세,2021,15347,7605,7742,98.2,15077,7467,7610,98.1
26003, 동부,050005, 49세,2021,15367,7580,7787,97.3,15073,7420,7653,97
26003, 동부,055,50~54세,2021,84382,41188,43194,95.4,82914,40377,42537,94.9
26003, 동부,055001, 50세,2021,16717,8222,8495,96.8,16381,8041,8340,96.4
26003, 동부,055002, 51세,2021,16543,8072,8471,95.3,16225,7886,8339,94.6
26003, 동부,055003, 52세,2021,17108,8351,8757,95.4,16805,8184,8621,94.9
26003, 동부,055004, 53세,2021,17527,8531,8996,94.8,17223,8363,8860,94.4
26003, 동부,055005, 54세,2021,16487,8012,8475,94.5,16280,7903,8377,94.3
26003, 동부,060,55~59세,2021,80199,41351,38848,106.4,78978,40686,38292,106.3
26003, 동부,060001, 55세,2021,16570,8643,7927,109,16316,8497,7819,108.7
26003, 동부,060002, 56세,2021,16766,8531,8235,103.6,16488,8383,8105,103.4
26003, 동부,060003, 57세,2021,15043,7701,7342,104.9,14788,7564,7224,104.7
26003, 동부,060004, 58세,2021,15843,8181,7662,106.8,15576,8037,7539,106.6
26003, 동부,060005, 59세,2021,15977,8295,7682,108,15810,8205,7605,107.9
26003, 동부,065,60~64세,2021,73962,37183,36779,101.1,73265,36816,36449,101
26003, 동부,065001, 60세,2021,17397,8790,8607,102.1,17257,8722,8535,102.2
26003, 동부,065002, 61세,2021,16271,8101,8170,99.2,16092,8000,8092,98.9
26003, 동부,065003, 62세,2021,14493,7289,7204,101.2,14366,7218,7148,101
26003, 동부,065004, 63세,2021,13214,6707,6507,103.1,13082,6644,6438,103.2
26003, 동부,065005, 64세,2021,12587,6296,6291,100.1,12468,6232,6236,99.9
26003, 동부,070,65~69세,2021,48685,24151,24534,98.4,48285,23953,24332,98.4
26003, 동부,070001, 65세,2021,11321,5589,5732,97.5,11227,5538,5689,97.3
26003, 동부,070002, 66세,2021,11355,5592,5763,97,11254,5537,5717,96.9
26003, 동부,070003, 67세,2021,9287,4653,4634,100.4,9212,4613,4599,100.3
26003, 동부,070004, 68세,2021,8358,4133,4225,97.8,8287,4103,4184,98.1
26003, 동부,070005, 69세,2021,8364,4184,4180,100.1,8305,4162,4143,100.5
26003, 동부,075,70~74세,2021,29999,14776,15223,97.1,29809,14701,15108,97.3
26003, 동부,075001, 70세,2021,6457,3226,3231,99.8,6396,3205,3191,100.4
26003, 동부,075002, 71세,2021,6261,3065,3196,95.9,6226,3052,3174,96.2
26003, 동부,075003, 72세,2021,6144,3066,3078,99.6,6106,3051,3055,99.9
26003, 동부,075004, 73세,2021,5939,2910,3029,96.1,5905,2892,3013,96
26003, 동부,075005, 74세,2021,5198,2509,2689,93.3,5176,2501,2675,93.5
26003, 동부,080,75~79세,2021,18361,8365,9996,83.7,18277,8336,9941,83.9
26003, 동부,080001, 75세,2021,3627,1769,1858,95.2,3603,1762,1841,95.7
26003, 동부,080002, 76세,2021,3536,1688,1848,91.3,3523,1684,1839,91.6
26003, 동부,080003, 77세,2021,3560,1601,1959,81.7,3547,1597,1950,81.9
26003, 동부,080004, 78세,2021,3720,1628,2092,77.8,3704,1620,2084,77.7
26003, 동부,080005, 79세,2021,3918,1679,2239,75,3900,1673,2227,75.1
26003, 동부,085,80~84세,2021,11543,4312,7231,59.6,11499,4297,7202,59.7
26003, 동부,085001, 80세,2021,2793,1155,1638,70.5,2781,1148,1633,70.3
26003, 동부,085002, 81세,2021,2619,1008,1611,62.6,2612,1006,1606,62.6
26003, 동부,085003, 82세,2021,2374,922,1452,63.5,2363,920,1443,63.8
26003, 동부,085004, 83세,2021,2001,660,1341,49.2,1995,658,1337,49.2
26003, 동부,085005, 84세,2021,1756,567,1189,47.7,1748,565,1183,47.8
26003, 동부,090,85~89세,2021,5614,1529,4085,37.4,5599,1527,4072,37.5
26003, 동부,090001, 85세,2021,1540,426,1114,38.2,1534,425,1109,38.3
26003, 동부,090002, 86세,2021,1316,365,951,38.4,1314,365,949,38.5
26003, 동부,090003, 87세,2021,1128,331,797,41.5,1125,331,794,41.7
26003, 동부,090004, 88세,2021,919,239,680,35.1,917,239,678,35.3
26003, 동부,090005, 89세,2021,711,168,543,30.9,709,167,542,30.8
26003, 동부,095,90~94세,2021,1749,299,1450,20.6,1742,299,1443,20.7
26003, 동부,095001, 90세,2021,544,101,443,22.8,543,101,442,22.9
26003, 동부,095002, 91세,2021,406,73,333,21.9,401,73,328,22.3
26003, 동부,095003, 92세,2021,345,70,275,25.5,344,70,274,25.5
26003, 동부,095004, 93세,2021,253,26,227,11.5,253,26,227,11.5
26003, 동부,095005, 94세,2021,201,29,172,16.9,201,29,172,16.9
26003, 동부,100,95~99세,2021,380,39,341,11.4,379,39,340,11.5
26003, 동부,100001, 95세,2021,125,12,113,10.6,124,12,112,10.7
26003, 동부,100002, 96세,2021,107,8,99,8.1,107,8,99,8.1
26003, 동부,100003, 97세,2021,66,10,56,17.9,66,10,56,17.9
26003, 동부,100004, 98세,2021,54,8,46,17.4,54,8,46,17.4
26003, 동부,100005, 99세,2021,28,X,27,3.7,28,X,27,3.7
26003, 동부,101,100세이상,2021,47,X,44,6.8,47,X,44,6.8
26003, 동부,102,15세미만,2021,121204,62701,58503,107.2,120503,62336,58167,107.2
26003, 동부,103,15~64세,2021,659007,344753,314254,109.7,644280,336761,307519,109.5
26003, 동부,104,65세이상,2021,116378,53474,62904,85,115637,53155,62482,85.1
26003, 동부,086,85세이상,2021,7790,1870,5920,31.6,7767,1868,5899,31.7
26003, 동부,126,평균연령,2021,41.9,41,43,,42,41,43,
26003, 동부,127,중위연령,2021,43.5,42.2,45,,43.7,42.3,45.2,
26010, 중구,000,합계,2021,209555,105796,103759,102,206875,104710,102165,102.5
26010, 중구,005,0~4세,2021,5972,3060,2912,105.1,5935,3040,2895,105
26010, 중구,005001, 0세,2021,964,494,470,105.1,958,490,468,104.7
26010, 중구,005002, 1세,2021,997,484,513,94.3,993,481,512,93.9
26010, 중구,005003, 2세,2021,1185,612,573,106.8,1177,607,570,106.5
26010, 중구,005004, 3세,2021,1294,659,635,103.8,1284,655,629,104.1
26010, 중구,005005, 4세,2021,1532,811,721,112.5,1523,807,716,112.7
26010, 중구,010,5~9세,2021,9397,4859,4538,107.1,9347,4830,4517,106.9
26010, 중구,010001, 5세,2021,1738,912,826,110.4,1725,906,819,110.6
26010, 중구,010002, 6세,2021,1821,933,888,105.1,1812,928,884,105
26010, 중구,010003, 7세,2021,1886,948,938,101.1,1874,940,934,100.6
26010, 중구,010004, 8세,2021,1913,975,938,103.9,1904,970,934,103.9
26010, 중구,010005, 9세,2021,2039,1091,948,115.1,2032,1086,946,114.8
26010, 중구,015,10~14세,2021,9835,5187,4648,111.6,9811,5175,4636,111.6
26010, 중구,015001, 10세,2021,2078,1058,1020,103.7,2074,1055,1019,103.5
26010, 중구,015002, 11세,2021,1951,1045,906,115.3,1946,1044,902,115.7
26010, 중구,015003, 12세,2021,1837,987,850,116.1,1831,985,846,116.4
26010, 중구,015004, 13세,2021,1949,1020,929,109.8,1945,1018,927,109.8
26010, 중구,015005, 14세,2021,2020,1077,943,114.2,2015,1073,942,113.9
26010, 중구,020,15~19세,2021,8710,4669,4041,115.5,8690,4662,4028,115.7
26010, 중구,020001, 15세,2021,1769,926,843,109.8,1768,926,842,110
26010, 중구,020002, 16세,2021,1752,935,817,114.4,1749,935,814,114.9
26010, 중구,020003, 17세,2021,1848,963,885,108.8,1842,960,882,108.8
26010, 중구,020004, 18세,2021,1923,1016,907,112,1921,1016,905,112.3
26010, 중구,020005, 19세,2021,1418,829,589,140.7,1410,825,585,141
26010, 중구,025,20~24세,2021,10758,6231,4527,137.6,10623,6200,4423,140.2
26010, 중구,025001, 20세,2021,1871,1185,686,172.7,1854,1182,672,175.9
26010, 중구,025002, 21세,2021,2151,1302,849,153.4,2132,1298,834,155.6
26010, 중구,025003, 22세,2021,1979,1139,840,135.6,1958,1134,824,137.6
26010, 중구,025004, 23세,2021,2270,1250,1020,122.5,2241,1243,998,124.5
26010, 중구,025005, 24세,2021,2487,1355,1132,119.7,2438,1343,1095,122.6
26010, 중구,030,25~29세,2021,13142,7263,5879,123.5,12901,7205,5696,126.5
26010, 중구,030001, 25세,2021,2532,1425,1107,128.7,2496,1414,1082,130.7
26010, 중구,030002, 26세,2021,2594,1408,1186,118.7,2544,1400,1144,122.4
26010, 중구,030003, 27세,2021,2697,1487,1210,122.9,2641,1476,1165,126.7
26010, 중구,030004, 28세,2021,2685,1488,1197,124.3,2632,1472,1160,126.9
26010, 중구,030005, 29세,2021,2634,1455,1179,123.4,2588,1443,1145,126
26010, 중구,035,30~34세,2021,11796,6258,5538,113,11423,6138,5285,116.1
26010, 중구,035001, 30세,2021,2496,1337,1159,115.4,2428,1316,1112,118.3
26010, 중구,035002, 31세,2021,2456,1344,1112,120.9,2386,1321,1065,124
26010, 중구,035003, 32세,2021,2372,1274,1098,116,2293,1254,1039,120.7
26010, 중구,035004, 33세,2021,2271,1176,1095,107.4,2197,1148,1049,109.4
26010, 중구,035005, 34세,2021,2201,1127,1074,104.9,2119,1099,1020,107.7
26010, 중구,040,35~39세,2021,13576,6964,6612,105.3,13252,6841,6411,106.7
26010, 중구,040001, 35세,2021,2379,1279,1100,116.3,2307,1246,1061,117.4
26010, 중구,040002, 36세,2021,2367,1198,1169,102.5,2300,1177,1123,104.8
26010, 중구,040003, 37세,2021,2655,1368,1287,106.3,2588,1346,1242,108.4
26010, 중구,040004, 38세,2021,2921,1481,1440,102.8,2869,1459,1410,103.5
26010, 중구,040005, 39세,2021,3254,1638,1616,101.4,3188,1613,1575,102.4
26010, 중구,045,40~44세,2021,16127,8331,7796,106.9,15855,8217,7638,107.6
26010, 중구,045001, 40세,2021,3260,1673,1587,105.4,3211,1650,1561,105.7
26010, 중구,045002, 41세,2021,3474,1781,1693,105.2,3421,1759,1662,105.8
26010, 중구,045003, 42세,2021,3299,1711,1588,107.7,3237,1678,1559,107.6
26010, 중구,045004, 43세,2021,2998,1551,1447,107.2,2938,1535,1403,109.4
26010, 중구,045005, 44세,2021,3096,1615,1481,109,3048,1595,1453,109.8
26010, 중구,050,45~49세,2021,16570,8254,8316,99.3,16340,8156,8184,99.7
26010, 중구,050001, 45세,2021,2818,1425,1393,102.3,2777,1404,1373,102.3
26010, 중구,050002, 46세,2021,3097,1574,1523,103.3,3050,1556,1494,104.1
26010, 중구,050003, 47세,2021,3384,1684,1700,99.1,3337,1664,1673,99.5
26010, 중구,050004, 48세,2021,3618,1798,1820,98.8,3582,1783,1799,99.1
26010, 중구,050005, 49세,2021,3653,1773,1880,94.3,3594,1749,1845,94.8
26010, 중구,055,50~54세,2021,20041,9694,10347,93.7,19756,9554,10202,93.6
26010, 중구,055001, 50세,2021,3922,1921,2001,96,3854,1888,1966,96
26010, 중구,055002, 51세,2021,3890,1870,2020,92.6,3830,1838,1992,92.3
26010, 중구,055003, 52세,2021,4033,1932,2101,92,3979,1908,2071,92.1
26010, 중구,055004, 53세,2021,4235,2038,2197,92.8,4173,2008,2165,92.7
26010, 중구,055005, 54세,2021,3961,1933,2028,95.3,3920,1912,2008,95.2
26010, 중구,060,55~59세,2021,19897,10073,9824,102.5,19598,9921,9677,102.5
26010, 중구,060001, 55세,2021,3953,1997,1956,102.1,3895,1968,1927,102.1
26010, 중구,060002, 56세,2021,4201,2111,2090,101,4132,2073,2059,100.7
26010, 중구,060003, 57세,2021,3812,1935,1877,103.1,3745,1905,1840,103.5
26010, 중구,060004, 58세,2021,3876,1933,1943,99.5,3812,1905,1907,99.9
26010, 중구,060005, 59세,2021,4055,2097,1958,107.1,4014,2070,1944,106.5
26010, 중구,065,60~64세,2021,19381,9562,9819,97.4,19194,9473,9721,97.4
26010, 중구,065001, 60세,2021,4517,2268,2249,100.8,4477,2249,2228,100.9
26010, 중구,065002, 61세,2021,4113,1997,2116,94.4,4064,1971,2093,94.2
26010, 중구,065003, 62세,2021,3813,1867,1946,95.9,3780,1847,1933,95.6
26010, 중구,065004, 63세,2021,3486,1711,1775,96.4,3450,1698,1752,96.9
26010, 중구,065005, 64세,2021,3452,1719,1733,99.2,3423,1708,1715,99.6
26010, 중구,070,65~69세,2021,13886,6623,7263,91.2,13768,6558,7210,91
26010, 중구,070001, 65세,2021,3219,1526,1693,90.1,3187,1505,1682,89.5
26010, 중구,070002, 66세,2021,3131,1439,1692,85,3106,1424,1682,84.7
26010, 중구,070003, 67세,2021,2634,1298,1336,97.2,2617,1290,1327,97.2
26010, 중구,070004, 68세,2021,2454,1181,1273,92.8,2432,1168,1264,92.4
26010, 중구,070005, 69세,2021,2448,1179,1269,92.9,2426,1171,1255,93.3
26010, 중구,075,70~74세,2021,8943,4259,4684,90.9,8891,4242,4649,91.2
26010, 중구,075001, 70세,2021,1925,939,986,95.2,1907,935,972,96.2
26010, 중구,075002, 71세,2021,1823,876,947,92.5,1817,873,944,92.5
26010, 중구,075003, 72세,2021,1889,927,962,96.4,1874,923,951,97.1
26010, 중구,075004, 73세,2021,1710,781,929,84.1,1704,778,926,84
26010, 중구,075005, 74세,2021,1596,736,860,85.6,1589,733,856,85.6
26010, 중구,080,75~79세,2021,5714,2543,3171,80.2,5697,2537,3160,80.3
26010, 중구,080001, 75세,2021,1048,501,547,91.6,1043,498,545,91.4
26010, 중구,080002, 76세,2021,1125,531,594,89.4,1122,531,591,89.8
26010, 중구,080003, 77세,2021,1158,474,684,69.3,1155,473,682,69.4
26010, 중구,080004, 78세,2021,1161,517,644,80.3,1157,516,641,80.5
26010, 중구,080005, 79세,2021,1222,520,702,74.1,1220,519,701,74
26010, 중구,085,80~84세,2021,3579,1369,2210,61.9,3572,1366,2206,61.9
26010, 중구,085001, 80세,2021,902,358,544,65.8,899,355,544,65.3
26010, 중구,085002, 81세,2021,826,324,502,64.5,826,324,502,64.5
26010, 중구,085003, 82세,2021,738,293,445,65.8,736,293,443,66.1
26010, 중구,085004, 83세,2021,602,217,385,56.4,600,217,383,56.7
26010, 중구,085005, 84세,2021,511,177,334,53,511,177,334,53
26010, 중구,090,85~89세,2021,1653,501,1152,43.5,1646,499,1147,43.5
26010, 중구,090001, 85세,2021,497,164,333,49.2,495,163,332,49.1
26010, 중구,090002, 86세,2021,365,120,245,49,364,120,244,49.2
26010, 중구,090003, 87세,2021,302,94,208,45.2,301,94,207,45.4
26010, 중구,090004, 88세,2021,271,73,198,36.9,270,73,197,37.1
26010, 중구,090005, 89세,2021,218,50,168,29.8,216,49,167,29.3
26010, 중구,095,90~94세,2021,482,86,396,21.7,481,86,395,21.8
26010, 중구,095001, 90세,2021,157,34,123,27.6,156,34,122,27.9
26010, 중구,095002, 91세,2021,102,20,82,24.4,102,20,82,24.4
26010, 중구,095003, 92세,2021,92,20,72,27.8,92,20,72,27.8
26010, 중구,095004, 93세,2021,86,9,77,11.7,86,9,77,11.7
26010, 중구,095005, 94세,2021,45,X,42,7.1,45,X,42,7.1
26010, 중구,100,95~99세,2021,84,9,75,12,83,9,74,12.2
26010, 중구,100001, 95세,2021,30,X,26,15.4,29,X,25,16
26010, 중구,100002, 96세,2021,22,X,20,10,22,X,20,10
26010, 중구,100003, 97세,2021,14,X,13,7.7,14,X,13,7.7
26010, 중구,100004, 98세,2021,12,X,10,20,12,X,10,20
26010, 중구,100005, 99세,2021,6,X,6,0,6,X,6,0
26010, 중구,101,100세이상,2021,12,X,11,9.1,12,X,11,9.1
26010, 중구,102,15세미만,2021,25204,13106,12098,108.3,25093,13045,12048,108.3
26010, 중구,103,15~64세,2021,149998,77299,72699,106.3,147632,76367,71265,107.2
26010, 중구,104,65세이상,2021,34353,15391,18962,81.2,34150,15298,18852,81.1
26010, 중구,086,85세이상,2021,2231,597,1634,36.5,2222,595,1627,36.6
26010, 중구,126,평균연령,2021,44.2,43,45.4,,44.2,42.9,45.5,
26010, 중구,127,중위연령,2021,46.9,45.1,48.4,,46.9,45,48.6,
26020, 남구,000,합계,2021,315307,160993,154314,104.3,309061,157767,151294,104.3
26020, 남구,005,0~4세,2021,9174,4677,4497,104,9081,4626,4455,103.8
26020, 남구,005001, 0세,2021,1631,849,782,108.6,1612,842,770,109.4
26020, 남구,005002, 1세,2021,1670,833,837,99.5,1654,823,831,99
26020, 남구,005003, 2세,2021,1806,919,887,103.6,1789,908,881,103.1
26020, 남구,005004, 3세,2021,1852,939,913,102.8,1831,928,903,102.8
26020, 남구,005005, 4세,2021,2215,1137,1078,105.5,2195,1125,1070,105.1
26020, 남구,010,5~9세,2021,13411,6942,6469,107.3,13320,6902,6418,107.5
26020, 남구,010001, 5세,2021,2518,1335,1183,112.8,2491,1327,1164,114
26020, 남구,010002, 6세,2021,2738,1420,1318,107.7,2722,1414,1308,108.1
26020, 남구,010003, 7세,2021,2636,1362,1274,106.9,2617,1349,1268,106.4
26020, 남구,010004, 8세,2021,2677,1344,1333,100.8,2662,1336,1326,100.8
26020, 남구,010005, 9세,2021,2842,1481,1361,108.8,2828,1476,1352,109.2
26020, 남구,015,10~14세,2021,14126,7445,6681,111.4,14053,7401,6652,111.3
26020, 남구,015001, 10세,2021,2802,1488,1314,113.2,2789,1479,1310,112.9
26020, 남구,015002, 11세,2021,2692,1432,1260,113.7,2677,1424,1253,113.6
26020, 남구,015003, 12세,2021,2781,1449,1332,108.8,2766,1438,1328,108.3
26020, 남구,015004, 13세,2021,2905,1490,1415,105.3,2894,1482,1412,105
26020, 남구,015005, 14세,2021,2946,1586,1360,116.6,2927,1578,1349,117
26020, 남구,020,15~19세,2021,14124,7580,6544,115.8,14058,7548,6510,115.9
26020, 남구,020001, 15세,2021,2730,1387,1343,103.3,2724,1385,1339,103.4
26020, 남구,020002, 16세,2021,2690,1438,1252,114.9,2675,1432,1243,115.2
26020, 남구,020003, 17세,2021,2865,1531,1334,114.8,2862,1530,1332,114.9
26020, 남구,020004, 18세,2021,2919,1579,1340,117.8,2910,1576,1334,118.1
26020, 남구,020005, 19세,2021,2920,1645,1275,129,2887,1625,1262,128.8
26020, 남구,025,20~24세,2021,20655,11748,8907,131.9,19829,11245,8584,131
26020, 남구,025001, 20세,2021,3575,2072,1503,137.9,3441,1990,1451,137.1
26020, 남구,025002, 21세,2021,4148,2365,1783,132.6,3976,2265,1711,132.4
26020, 남구,025003, 22세,2021,4016,2269,1747,129.9,3855,2165,1690,128.1
26020, 남구,025004, 23세,2021,4323,2422,1901,127.4,4153,2322,1831,126.8
26020, 남구,025005, 24세,2021,4593,2620,1973,132.8,4404,2503,1901,131.7
26020, 남구,030,25~29세,2021,23540,13212,10328,127.9,22714,12816,9898,129.5
26020, 남구,030001, 25세,2021,4673,2640,2033,129.9,4497,2551,1946,131.1
26020, 남구,030002, 26세,2021,4631,2610,2021,129.1,4452,2528,1924,131.4
26020, 남구,030003, 27세,2021,4639,2595,2044,127,4463,2504,1959,127.8
26020, 남구,030004, 28세,2021,4834,2692,2142,125.7,4686,2624,2062,127.3
26020, 남구,030005, 29세,2021,4763,2675,2088,128.1,4616,2609,2007,130
26020, 남구,035,30~34세,2021,20773,11343,9430,120.3,19923,10942,8981,121.8
26020, 남구,035001, 30세,2021,4513,2451,2062,118.9,4360,2382,1978,120.4
26020, 남구,035002, 31세,2021,4192,2288,1904,120.2,4017,2205,1812,121.7
26020, 남구,035003, 32세,2021,4244,2320,1924,120.6,4081,2245,1836,122.3
26020, 남구,035004, 33세,2021,3894,2149,1745,123.2,3692,2058,1634,125.9
26020, 남구,035005, 34세,2021,3930,2135,1795,118.9,3773,2052,1721,119.2
26020, 남구,040,35~39세,2021,20981,10875,10106,107.6,20277,10535,9742,108.1
26020, 남구,040001, 35세,2021,3867,2039,1828,111.5,3709,1961,1748,112.2
26020, 남구,040002, 36세,2021,3909,2097,1812,115.7,3765,2033,1732,117.4
26020, 남구,040003, 37세,2021,3999,2040,1959,104.1,3865,1972,1893,104.2
26020, 남구,040004, 38세,2021,4359,2257,2102,107.4,4220,2190,2030,107.9
26020, 남구,040005, 39세,2021,4847,2442,2405,101.5,4718,2379,2339,101.7
26020, 남구,045,40~44세,2021,23557,11936,11621,102.7,23035,11673,11362,102.7
26020, 남구,045001, 40세,2021,4942,2584,2358,109.6,4846,2536,2310,109.8
26020, 남구,045002, 41세,2021,5064,2565,2499,102.6,4953,2505,2448,102.3
26020, 남구,045003, 42세,2021,4684,2314,2370,97.6,4567,2251,2316,97.2
26020, 남구,045004, 43세,2021,4395,2272,2123,107,4300,2232,2068,107.9
26020, 남구,045005, 44세,2021,4472,2201,2271,96.9,4369,2149,2220,96.8
26020, 남구,050,45~49세,2021,25883,12349,13534,91.2,25410,12107,13303,91
26020, 남구,050001, 45세,2021,4388,2145,2243,95.6,4309,2101,2208,95.2
26020, 남구,050002, 46세,2021,4789,2288,2501,91.5,4701,2246,2455,91.5
26020, 남구,050003, 47세,2021,5379,2492,2887,86.3,5275,2439,2836,86
26020, 남구,050004, 48세,2021,5650,2689,2961,90.8,5544,2638,2906,90.8
26020, 남구,050005, 49세,2021,5677,2735,2942,93,5581,2683,2898,92.6
26020, 남구,055,50~54세,2021,31840,15458,16382,94.4,31256,15140,16116,93.9
26020, 남구,055001, 50세,2021,6381,3056,3325,91.9,6253,2991,3262,91.7
26020, 남구,055002, 51세,2021,6344,3095,3249,95.3,6213,3019,3194,94.5
26020, 남구,055003, 52세,2021,6458,3139,3319,94.6,6325,3064,3261,94
26020, 남구,055004, 53세,2021,6543,3215,3328,96.6,6425,3151,3274,96.2
26020, 남구,055005, 54세,2021,6114,2953,3161,93.4,6040,2915,3125,93.3
26020, 남구,060,55~59세,2021,29132,15009,14123,106.3,28610,14725,13885,106
26020, 남구,060001, 55세,2021,6078,3214,2864,112.2,5966,3148,2818,111.7
26020, 남구,060002, 56세,2021,6112,3141,2971,105.7,5992,3080,2912,105.8
26020, 남구,060003, 57세,2021,5426,2763,2663,103.8,5322,2706,2616,103.4
26020, 남구,060004, 58세,2021,5798,2981,2817,105.8,5682,2918,2764,105.6
26020, 남구,060005, 59세,2021,5718,2910,2808,103.6,5648,2873,2775,103.5
26020, 남구,065,60~64세,2021,26292,13170,13122,100.4,25983,12995,12988,100.1
26020, 남구,065001, 60세,2021,6129,3132,2997,104.5,6075,3106,2969,104.6
26020, 남구,065002, 61세,2021,5785,2904,2881,100.8,5708,2858,2850,100.3
26020, 남구,065003, 62세,2021,5164,2529,2635,96,5102,2489,2613,95.3
26020, 남구,065004, 63세,2021,4704,2346,2358,99.5,4645,2319,2326,99.7
26020, 남구,065005, 64세,2021,4510,2259,2251,100.4,4453,2223,2230,99.7
26020, 남구,070,65~69세,2021,17553,8757,8796,99.6,17382,8669,8713,99.5
26020, 남구,070001, 65세,2021,4032,1995,2037,97.9,3994,1976,2018,97.9
26020, 남구,070002, 66세,2021,4147,2102,2045,102.8,4105,2074,2031,102.1
26020, 남구,070003, 67세,2021,3403,1710,1693,101,3366,1688,1678,100.6
26020, 남구,070004, 68세,2021,3023,1489,1534,97.1,2991,1479,1512,97.8
26020, 남구,070005, 69세,2021,2948,1461,1487,98.3,2926,1452,1474,98.5
26020, 남구,075,70~74세,2021,10757,5322,5435,97.9,10688,5291,5397,98
26020, 남구,075001, 70세,2021,2305,1132,1173,96.5,2278,1120,1158,96.7
26020, 남구,075002, 71세,2021,2290,1124,1166,96.4,2281,1121,1160,96.6
26020, 남구,075003, 72세,2021,2148,1074,1074,100,2135,1067,1068,99.9
26020, 남구,075004, 73세,2021,2202,1107,1095,101.1,2190,1101,1089,101.1
26020, 남구,075005, 74세,2021,1812,885,927,95.5,1804,882,922,95.7
26020, 남구,080,75~79세,2021,6498,2918,3580,81.5,6462,2907,3555,81.8
26020, 남구,080001, 75세,2021,1304,607,697,87.1,1294,604,690,87.5
26020, 남구,080002, 76세,2021,1240,583,657,88.7,1234,583,651,89.6
26020, 남구,080003, 77세,2021,1274,582,692,84.1,1269,582,687,84.7
26020, 남구,080004, 78세,2021,1294,556,738,75.3,1288,553,735,75.2
26020, 남구,080005, 79세,2021,1386,590,796,74.1,1377,585,792,73.9
26020, 남구,085,80~84세,2021,4156,1561,2595,60.2,4133,1554,2579,60.3
26020, 남구,085001, 80세,2021,1002,431,571,75.5,997,428,569,75.2
26020, 남구,085002, 81세,2021,954,366,588,62.2,950,365,585,62.4
26020, 남구,085003, 82세,2021,858,330,528,62.5,853,330,523,63.1
26020, 남구,085004, 83세,2021,684,216,468,46.2,682,215,467,46
26020, 남구,085005, 84세,2021,658,218,440,49.5,651,216,435,49.7
26020, 남구,090,85~89세,2021,2054,570,1484,38.4,2051,570,1481,38.5
26020, 남구,090001, 85세,2021,526,143,383,37.3,525,143,382,37.4
26020, 남구,090002, 86세,2021,512,142,370,38.4,511,142,369,38.5
26020, 남구,090003, 87세,2021,436,133,303,43.9,435,133,302,44
26020, 남구,090004, 88세,2021,340,80,260,30.8,340,80,260,30.8
26020, 남구,090005, 89세,2021,240,72,168,42.9,240,72,168,42.9
26020, 남구,095,90~94세,2021,638,108,530,20.4,633,108,525,20.6
26020, 남구,095001, 90세,2021,199,34,165,20.6,199,34,165,20.6
26020, 남구,095002, 91세,2021,152,29,123,23.6,148,29,119,24.4
26020, 남구,095003, 92세,2021,128,26,102,25.5,127,26,101,25.7
26020, 남구,095004, 93세,2021,84,6,78,7.7,84,6,78,7.7
26020, 남구,095005, 94세,2021,75,13,62,21,75,13,62,21
26020, 남구,100,95~99세,2021,150,13,137,9.5,150,13,137,9.5
26020, 남구,100001, 95세,2021,48,X,44,9.1,48,X,44,9.1
26020, 남구,100002, 96세,2021,48,X,48,0,48,X,48,0
26020, 남구,100003, 97세,2021,26,5,21,23.8,26,5,21,23.8
26020, 남구,100004, 98세,2021,20,X,17,17.6,20,X,17,17.6
26020, 남구,100005, 99세,2021,8,X,7,14.3,8,X,7,14.3
26020, 남구,101,100세이상,2021,13,X,13,0,13,X,13,0
26020, 남구,102,15세미만,2021,36711,19064,17647,108,36454,18929,17525,108
26020, 남구,103,15~64세,2021,236777,122680,114097,107.5,231095,119726,111369,107.5
26020, 남구,104,65세이상,2021,41819,19249,22570,85.3,41512,19112,22400,85.3
26020, 남구,086,85세이상,2021,2855,691,2164,31.9,2847,691,2156,32.1
26020, 남구,126,평균연령,2021,42.5,41.5,43.6,,42.6,41.5,43.7,
26020, 남구,127,중위연령,2021,44.4,42.7,46.1,,44.6,42.8,46.3,
26030, 동구,000,합계,2021,155578,81916,73662,111.2,151407,79274,72133,109.9
26030, 동구,005,0~4세,2021,5335,2714,2621,103.5,5255,2677,2578,103.8
26030, 동구,005001, 0세,2021,795,407,388,104.9,785,401,384,104.4
26030, 동구,005002, 1세,2021,874,430,444,96.8,860,422,438,96.3
26030, 동구,005003, 2세,2021,1049,524,525,99.8,1029,515,514,100.2
26030, 동구,005004, 3세,2021,1184,596,588,101.4,1166,591,575,102.8
26030, 동구,005005, 4세,2021,1433,757,676,112,1415,748,667,112.1
26030, 동구,010,5~9세,2021,8650,4415,4235,104.3,8537,4356,4181,104.2
26030, 동구,010001, 5세,2021,1688,846,842,100.5,1665,838,827,101.3
26030, 동구,010002, 6세,2021,1675,871,804,108.3,1641,850,791,107.5
26030, 동구,010003, 7세,2021,1778,882,896,98.4,1758,873,885,98.6
26030, 동구,010004, 8세,2021,1664,863,801,107.7,1646,853,793,107.6
26030, 동구,010005, 9세,2021,1845,953,892,106.8,1827,942,885,106.4
26030, 동구,015,10~14세,2021,8325,4368,3957,110.4,8281,4343,3938,110.3
26030, 동구,015001, 10세,2021,1735,926,809,114.5,1726,921,805,114.4
26030, 동구,015002, 11세,2021,1753,938,815,115.1,1743,936,807,116
26030, 동구,015003, 12세,2021,1590,814,776,104.9,1586,811,775,104.6
26030, 동구,015004, 13세,2021,1584,849,735,115.5,1572,840,732,114.8
26030, 동구,015005, 14세,2021,1663,841,822,102.3,1654,835,819,102
26030, 동구,020,15~19세,2021,7102,3794,3308,114.7,7076,3781,3295,114.7
26030, 동구,020001, 15세,2021,1477,806,671,120.1,1470,801,669,119.7
26030, 동구,020002, 16세,2021,1353,714,639,111.7,1347,711,636,111.8
26030, 동구,020003, 17세,2021,1548,811,737,110,1539,807,732,110.2
26030, 동구,020004, 18세,2021,1532,820,712,115.2,1532,820,712,115.2
26030, 동구,020005, 19세,2021,1192,643,549,117.1,1188,642,546,117.6
26030, 동구,025,20~24세,2021,7457,4201,3256,129,7185,4038,3147,128.3
26030, 동구,025001, 20세,2021,1259,750,509,147.3,1239,742,497,149.3
26030, 동구,025002, 21세,2021,1566,892,674,132.3,1523,876,647,135.4
26030, 동구,025003, 22세,2021,1394,801,593,135.1,1331,761,570,133.5
26030, 동구,025004, 23세,2021,1562,862,700,123.1,1490,806,684,117.8
26030, 동구,025005, 24세,2021,1676,896,780,114.9,1602,853,749,113.9
26030, 동구,030,25~29세,2021,9301,5401,3900,138.5,8721,4995,3726,134.1
26030, 동구,030001, 25세,2021,1845,1052,793,132.7,1744,990,754,131.3
26030, 동구,030002, 26세,2021,1914,1124,790,142.3,1794,1036,758,136.7
26030, 동구,030003, 27세,2021,1794,1056,738,143.1,1681,977,704,138.8
26030, 동구,030004, 28세,2021,1852,1066,786,135.6,1737,987,750,131.6
26030, 동구,030005, 29세,2021,1896,1103,793,139.1,1765,1005,760,132.2
26030, 동구,035,30~34세,2021,9586,5553,4033,137.7,8916,5106,3810,134
26030, 동구,035001, 30세,2021,1835,1054,781,135,1703,960,743,129.2
26030, 동구,035002, 31세,2021,1853,1072,781,137.3,1712,972,740,131.4
26030, 동구,035003, 32세,2021,1874,1096,778,140.9,1749,1013,736,137.6
26030, 동구,035004, 33세,2021,1947,1153,794,145.2,1810,1064,746,142.6
26030, 동구,035005, 34세,2021,2077,1178,899,131,1942,1097,845,129.8
26030, 동구,040,35~39세,2021,13072,7147,5925,120.6,12385,6694,5691,117.6
26030, 동구,040001, 35세,2021,2256,1220,1036,117.8,2097,1112,985,112.9
26030, 동구,040002, 36세,2021,2284,1268,1016,124.8,2145,1169,976,119.8
26030, 동구,040003, 37세,2021,2535,1391,1144,121.6,2400,1307,1093,119.6
26030, 동구,040004, 38세,2021,2922,1578,1344,117.4,2803,1503,1300,115.6
26030, 동구,040005, 39세,2021,3075,1690,1385,122,2940,1603,1337,119.9
26030, 동구,045,40~44세,2021,14209,7814,6395,122.2,13742,7503,6239,120.3
26030, 동구,045001, 40세,2021,3025,1686,1339,125.9,2924,1611,1313,122.7
26030, 동구,045002, 41세,2021,3201,1772,1429,124,3101,1706,1395,122.3
26030, 동구,045003, 42세,2021,2787,1565,1222,128.1,2700,1504,1196,125.8
26030, 동구,045004, 43세,2021,2654,1412,1242,113.7,2567,1365,1202,113.6
26030, 동구,045005, 44세,2021,2542,1379,1163,118.6,2450,1317,1133,116.2
26030, 동구,050,45~49세,2021,12282,6756,5526,122.3,11888,6507,5381,120.9
26030, 동구,050001, 45세,2021,2353,1307,1046,125,2281,1261,1020,123.6
26030, 동구,050002, 46세,2021,2473,1346,1127,119.4,2400,1300,1100,118.2
26030, 동구,050003, 47세,2021,2569,1423,1146,124.2,2481,1369,1112,123.1
26030, 동구,050004, 48세,2021,2533,1361,1172,116.1,2456,1313,1143,114.9
26030, 동구,050005, 49세,2021,2354,1319,1035,127.4,2270,1264,1006,125.6
26030, 동구,055,50~54세,2021,12518,6402,6116,104.7,12171,6192,5979,103.6
26030, 동구,055001, 50세,2021,2577,1379,1198,115.1,2491,1325,1166,113.6
26030, 동구,055002, 51세,2021,2497,1291,1206,107,2416,1239,1177,105.3
26030, 동구,055003, 52세,2021,2517,1326,1191,111.3,2460,1294,1166,111
26030, 동구,055004, 53세,2021,2520,1243,1277,97.3,2450,1199,1251,95.8
26030, 동구,055005, 54세,2021,2407,1163,1244,93.5,2354,1135,1219,93.1
26030, 동구,060,55~59세,2021,12530,6248,6282,99.5,12280,6099,6181,98.7
26030, 동구,060001, 55세,2021,2453,1284,1169,109.8,2402,1252,1150,108.9
26030, 동구,060002, 56세,2021,2526,1233,1293,95.4,2470,1200,1270,94.5
26030, 동구,060003, 57세,2021,2265,1124,1141,98.5,2211,1092,1119,97.6
26030, 동구,060004, 58세,2021,2609,1277,1332,95.9,2552,1240,1312,94.5
26030, 동구,060005, 59세,2021,2677,1330,1347,98.7,2645,1315,1330,98.9
26030, 동구,065,60~64세,2021,14282,6996,7286,96,14171,6931,7240,95.7
26030, 동구,065001, 60세,2021,3103,1434,1669,85.9,3072,1418,1654,85.7
26030, 동구,065002, 61세,2021,3168,1501,1667,90,3143,1480,1663,89
26030, 동구,065003, 62세,2021,2858,1462,1396,104.7,2840,1457,1383,105.4
26030, 동구,065004, 63세,2021,2689,1406,1283,109.6,2668,1393,1275,109.3
26030, 동구,065005, 64세,2021,2464,1193,1271,93.9,2448,1183,1265,93.5
26030, 동구,070,65~69세,2021,9359,4745,4614,102.8,9302,4719,4583,103
26030, 동구,070001, 65세,2021,2172,1098,1074,102.2,2158,1091,1067,102.2
26030, 동구,070002, 66세,2021,2164,1078,1086,99.3,2150,1071,1079,99.3
26030, 동구,070003, 67세,2021,1751,887,864,102.7,1741,882,859,102.7
26030, 동구,070004, 68세,2021,1616,803,813,98.8,1606,799,807,99
26030, 동구,070005, 69세,2021,1656,879,777,113.1,1647,876,771,113.6
26030, 동구,075,70~74세,2021,5608,2923,2685,108.9,5564,2904,2660,109.2
26030, 동구,075001, 70세,2021,1251,653,598,109.2,1243,650,593,109.6
26030, 동구,075002, 71세,2021,1180,601,579,103.8,1166,595,571,104.2
26030, 동구,075003, 72세,2021,1145,589,556,105.9,1138,586,552,106.2
26030, 동구,075004, 73세,2021,1096,582,514,113.2,1086,577,509,113.4
26030, 동구,075005, 74세,2021,936,498,438,113.7,931,496,435,114
26030, 동구,080,75~79세,2021,3100,1512,1588,95.2,3081,1505,1576,95.5
26030, 동구,080001, 75세,2021,699,376,323,116.4,691,375,316,118.7
26030, 동구,080002, 76세,2021,604,301,303,99.3,601,298,303,98.3
26030, 동구,080003, 77세,2021,532,262,270,97,531,261,270,96.7
26030, 동구,080004, 78세,2021,632,303,329,92.1,629,301,328,91.8
26030, 동구,080005, 79세,2021,633,270,363,74.4,629,270,359,75.2
26030, 동구,085,80~84세,2021,1734,673,1061,63.4,1727,670,1057,63.4
26030, 동구,085001, 80세,2021,434,188,246,76.4,432,187,245,76.3
26030, 동구,085002, 81세,2021,401,165,236,69.9,400,164,236,69.5
26030, 동구,085003, 82세,2021,353,147,206,71.4,351,146,205,71.2
26030, 동구,085004, 83세,2021,315,102,213,47.9,314,102,212,48.1
26030, 동구,085005, 84세,2021,231,71,160,44.4,230,71,159,44.7
26030, 동구,090,85~89세,2021,801,204,597,34.2,798,204,594,34.3
26030, 동구,090001, 85세,2021,225,55,170,32.4,223,55,168,32.7
26030, 동구,090002, 86세,2021,191,49,142,34.5,191,49,142,34.5
26030, 동구,090003, 87세,2021,163,42,121,34.7,163,42,121,34.7
26030, 동구,090004, 88세,2021,125,38,87,43.7,124,38,86,44.2
26030, 동구,090005, 89세,2021,97,20,77,26,97,20,77,26
26030, 동구,095,90~94세,2021,248,41,207,19.8,248,41,207,19.8
26030, 동구,095001, 90세,2021,87,13,74,17.6,87,13,74,17.6
26030, 동구,095002, 91세,2021,48,6,42,14.3,48,6,42,14.3
26030, 동구,095003, 92세,2021,48,14,34,41.2,48,14,34,41.2
26030, 동구,095004, 93세,2021,35,X,31,12.9,35,X,31,12.9
26030, 동구,095005, 94세,2021,30,X,26,15.4,30,X,26,15.4
26030, 동구,100,95~99세,2021,73,8,65,12.3,73,8,65,12.3
26030, 동구,100001, 95세,2021,15,X,13,15.4,15,X,13,15.4
26030, 동구,100002, 96세,2021,26,X,24,8.3,26,X,24,8.3
26030, 동구,100003, 97세,2021,10,X,9,11.1,10,X,9,11.1
26030, 동구,100004, 98세,2021,12,X,9,33.3,12,X,9,33.3
26030, 동구,100005, 99세,2021,10,X,10,0,10,X,10,0
26030, 동구,101,100세이상,2021,6,X,5,20,6,X,5,20
26030, 동구,102,15세미만,2021,22310,11497,10813,106.3,22073,11376,10697,106.3
26030, 동구,103,15~64세,2021,112339,60312,52027,115.9,108535,57846,50689,114.1
26030, 동구,104,65세이상,2021,20929,10107,10822,93.4,20799,10052,10747,93.5
26030, 동구,086,85세이상,2021,1128,254,874,29.1,1125,254,871,29.2
26030, 동구,126,평균연령,2021,41.8,41.1,42.7,,41.9,41.2,42.8,
26030, 동구,127,중위연령,2021,43,41.9,44.3,,43.2,42.2,44.5,
26040, 북구,000,합계,2021,216149,112223,103926,108,213077,110501,102576,107.7
26040, 북구,005,0~4세,2021,10109,5208,4901,106.3,10065,5181,4884,106.1
26040, 북구,005001, 0세,2021,1599,823,776,106.1,1594,820,774,105.9
26040, 북구,005002, 1세,2021,1868,932,936,99.6,1859,925,934,99
26040, 북구,005003, 2세,2021,2029,1064,965,110.3,2022,1061,961,110.4
26040, 북구,005004, 3세,2021,2211,1159,1052,110.2,2198,1150,1048,109.7
26040, 북구,005005, 4세,2021,2402,1230,1172,104.9,2392,1225,1167,105
26040, 북구,010,5~9세,2021,13963,7222,6741,107.1,13941,7213,6728,107.2
26040, 북구,010001, 5세,2021,2793,1448,1345,107.7,2790,1446,1344,107.6
26040, 북구,010002, 6세,2021,2876,1493,1383,108,2872,1492,1380,108.1
26040, 북구,010003, 7세,2021,2712,1395,1317,105.9,2704,1392,1312,106.1
26040, 북구,010004, 8세,2021,2745,1428,1317,108.4,2742,1426,1316,108.4
26040, 북구,010005, 9세,2021,2837,1458,1379,105.7,2833,1457,1376,105.9
26040, 북구,015,10~14세,2021,12907,6604,6303,104.8,12877,6592,6285,104.9
26040, 북구,015001, 10세,2021,2684,1344,1340,100.3,2679,1343,1336,100.5
26040, 북구,015002, 11세,2021,2600,1346,1254,107.3,2593,1342,1251,107.3
26040, 북구,015003, 12세,2021,2456,1291,1165,110.8,2452,1290,1162,111
26040, 북구,015004, 13세,2021,2598,1305,1293,100.9,2591,1302,1289,101
26040, 북구,015005, 14세,2021,2569,1318,1251,105.4,2562,1315,1247,105.5
26040, 북구,020,15~19세,2021,10504,5679,4825,117.7,10483,5672,4811,117.9
26040, 북구,020001, 15세,2021,2192,1097,1095,100.2,2188,1095,1093,100.2
26040, 북구,020002, 16세,2021,2133,1104,1029,107.3,2132,1103,1029,107.2
26040, 북구,020003, 17세,2021,2400,1279,1121,114.1,2395,1278,1117,114.4
26040, 북구,020004, 18세,2021,2222,1243,979,127,2216,1241,975,127.3
26040, 북구,020005, 19세,2021,1557,956,601,159.1,1552,955,597,160
26040, 북구,025,20~24세,2021,10766,6419,4347,147.7,10581,6321,4260,148.4
26040, 북구,025001, 20세,2021,1837,1220,617,197.7,1827,1213,614,197.6
26040, 북구,025002, 21세,2021,2109,1315,794,165.6,2081,1303,778,167.5
26040, 북구,025003, 22세,2021,2077,1228,849,144.6,2052,1216,836,145.5
26040, 북구,025004, 23세,2021,2266,1277,989,129.1,2218,1252,966,129.6
26040, 북구,025005, 24세,2021,2477,1379,1098,125.6,2403,1337,1066,125.4
26040, 북구,030,25~29세,2021,13863,7956,5907,134.7,13411,7679,5732,134
26040, 북구,030001, 25세,2021,2617,1532,1085,141.2,2549,1496,1053,142.1
26040, 북구,030002, 26세,2021,2620,1500,1120,133.9,2533,1449,1084,133.7
26040, 북구,030003, 27세,2021,2793,1613,1180,136.7,2689,1548,1141,135.7
26040, 북구,030004, 28세,2021,2803,1601,1202,133.2,2711,1542,1169,131.9
26040, 북구,030005, 29세,2021,3030,1710,1320,129.5,2929,1644,1285,127.9
26040, 북구,035,30~34세,2021,15171,8172,6999,116.8,14530,7792,6738,115.6
26040, 북구,035001, 30세,2021,3031,1598,1433,111.5,2888,1516,1372,110.5
26040, 북구,035002, 31세,2021,3024,1650,1374,120.1,2883,1560,1323,117.9
26040, 북구,035003, 32세,2021,3026,1682,1344,125.1,2928,1622,1306,124.2
26040, 북구,035004, 33세,2021,2985,1620,1365,118.7,2848,1534,1314,116.7
26040, 북구,035005, 34세,2021,3105,1622,1483,109.4,2983,1560,1423,109.6
26040, 북구,040,35~39세,2021,18342,9344,8998,103.8,17838,9051,8787,103
26040, 북구,040001, 35세,2021,3103,1623,1480,109.7,2985,1558,1427,109.2
26040, 북구,040002, 36세,2021,3214,1655,1559,106.2,3102,1585,1517,104.5
26040, 북구,040003, 37세,2021,3601,1853,1748,106,3507,1803,1704,105.8
26040, 북구,040004, 38세,2021,4074,2025,2049,98.8,3977,1962,2015,97.4
26040, 북구,040005, 39세,2021,4350,2188,2162,101.2,4267,2143,2124,100.9
26040, 북구,045,40~44세,2021,20726,10751,9975,107.8,20389,10562,9827,107.5
26040, 북구,045001, 40세,2021,4406,2229,2177,102.4,4340,2186,2154,101.5
26040, 북구,045002, 41세,2021,4618,2364,2254,104.9,4537,2322,2215,104.8
26040, 북구,045003, 42세,2021,4175,2191,1984,110.4,4110,2155,1955,110.2
26040, 북구,045004, 43세,2021,3692,1953,1739,112.3,3634,1919,1715,111.9
26040, 북구,045005, 44세,2021,3835,2014,1821,110.6,3768,1980,1788,110.7
26040, 북구,050,45~49세,2021,17891,9031,8860,101.9,17648,8896,8752,101.6
26040, 북구,050001, 45세,2021,3437,1848,1589,116.3,3384,1816,1568,115.8
26040, 북구,050002, 46세,2021,3545,1849,1696,109,3498,1823,1675,108.8
26040, 북구,050003, 47세,2021,3680,1824,1856,98.3,3643,1800,1843,97.7
26040, 북구,050004, 48세,2021,3546,1757,1789,98.2,3495,1733,1762,98.4
26040, 북구,050005, 49세,2021,3683,1753,1930,90.8,3628,1724,1904,90.5
26040, 북구,055,50~54세,2021,19983,9634,10349,93.1,19731,9491,10240,92.7
26040, 북구,055001, 50세,2021,3837,1866,1971,94.7,3783,1837,1946,94.4
26040, 북구,055002, 51세,2021,3812,1816,1996,91,3766,1790,1976,90.6
26040, 북구,055003, 52세,2021,4100,1954,2146,91.1,4041,1918,2123,90.3
26040, 북구,055004, 53세,2021,4229,2035,2194,92.8,4175,2005,2170,92.4
26040, 북구,055005, 54세,2021,4005,1963,2042,96.1,3966,1941,2025,95.9
26040, 북구,060,55~59세,2021,18640,10021,8619,116.3,18490,9941,8549,116.3
26040, 북구,060001, 55세,2021,4086,2148,1938,110.8,4053,2129,1924,110.7
26040, 북구,060002, 56세,2021,3927,2046,1881,108.8,3894,2030,1864,108.9
26040, 북구,060003, 57세,2021,3540,1879,1661,113.1,3510,1861,1649,112.9
26040, 북구,060004, 58세,2021,3560,1990,1570,126.8,3530,1974,1556,126.9
26040, 북구,060005, 59세,2021,3527,1958,1569,124.8,3503,1947,1556,125.1
26040, 북구,065,60~64세,2021,14007,7455,6552,113.8,13917,7417,6500,114.1
26040, 북구,065001, 60세,2021,3648,1956,1692,115.6,3633,1949,1684,115.7
26040, 북구,065002, 61세,2021,3205,1699,1506,112.8,3177,1691,1486,113.8
26040, 북구,065003, 62세,2021,2658,1431,1227,116.6,2644,1425,1219,116.9
26040, 북구,065004, 63세,2021,2335,1244,1091,114,2319,1234,1085,113.7
26040, 북구,065005, 64세,2021,2161,1125,1036,108.6,2144,1118,1026,109
26040, 북구,070,65~69세,2021,7887,4026,3861,104.3,7833,4007,3826,104.7
26040, 북구,070001, 65세,2021,1898,970,928,104.5,1888,966,922,104.8
26040, 북구,070002, 66세,2021,1913,973,940,103.5,1893,968,925,104.6
26040, 북구,070003, 67세,2021,1499,758,741,102.3,1488,753,735,102.4
26040, 북구,070004, 68세,2021,1265,660,605,109.1,1258,657,601,109.3
26040, 북구,070005, 69세,2021,1312,665,647,102.8,1306,663,643,103.1
26040, 북구,075,70~74세,2021,4691,2272,2419,93.9,4666,2264,2402,94.3
26040, 북구,075001, 70세,2021,976,502,474,105.9,968,500,468,106.8
26040, 북구,075002, 71세,2021,968,464,504,92.1,962,463,499,92.8
26040, 북구,075003, 72세,2021,962,476,486,97.9,959,475,484,98.1
26040, 북구,075004, 73세,2021,931,440,491,89.6,925,436,489,89.2
26040, 북구,075005, 74세,2021,854,390,464,84.1,852,390,462,84.4
26040, 북구,080,75~79세,2021,3049,1392,1657,84,3037,1387,1650,84.1
26040, 북구,080001, 75세,2021,576,285,291,97.9,575,285,290,98.3
26040, 북구,080002, 76세,2021,567,273,294,92.9,566,272,294,92.5
26040, 북구,080003, 77세,2021,596,283,313,90.4,592,281,311,90.4
26040, 북구,080004, 78세,2021,633,252,381,66.1,630,250,380,65.8
26040, 북구,080005, 79세,2021,677,299,378,79.1,674,299,375,79.7
26040, 북구,085,80~84세,2021,2074,709,1365,51.9,2067,707,1360,52
26040, 북구,085001, 80세,2021,455,178,277,64.3,453,178,275,64.7
26040, 북구,085002, 81세,2021,438,153,285,53.7,436,153,283,54.1
26040, 북구,085003, 82세,2021,425,152,273,55.7,423,151,272,55.5
26040, 북구,085004, 83세,2021,400,125,275,45.5,399,124,275,45.1
26040, 북구,085005, 84세,2021,356,101,255,39.6,356,101,255,39.6
26040, 북구,090,85~89세,2021,1106,254,852,29.8,1104,254,850,29.9
26040, 북구,090001, 85세,2021,292,64,228,28.1,291,64,227,28.2
26040, 북구,090002, 86세,2021,248,54,194,27.8,248,54,194,27.8
26040, 북구,090003, 87세,2021,227,62,165,37.6,226,62,164,37.8
26040, 북구,090004, 88세,2021,183,48,135,35.6,183,48,135,35.6
26040, 북구,090005, 89세,2021,156,26,130,20,156,26,130,20
26040, 북구,095,90~94세,2021,381,64,317,20.2,380,64,316,20.3
26040, 북구,095001, 90세,2021,101,20,81,24.7,101,20,81,24.7
26040, 북구,095002, 91세,2021,104,18,86,20.9,103,18,85,21.2
26040, 북구,095003, 92세,2021,77,10,67,14.9,77,10,67,14.9
26040, 북구,095004, 93세,2021,48,7,41,17.1,48,7,41,17.1
26040, 북구,095005, 94세,2021,51,9,42,21.4,51,9,42,21.4
26040, 북구,100,95~99세,2021,73,9,64,14.1,73,9,64,14.1
26040, 북구,100001, 95세,2021,32,X,30,6.7,32,X,30,6.7
26040, 북구,100002, 96세,2021,11,X,7,57.1,11,X,7,57.1
26040, 북구,100003, 97세,2021,16,X,13,23.1,16,X,13,23.1
26040, 북구,100004, 98세,2021,10,X,10,0,10,X,10,0
26040, 북구,100005, 99세,2021,X,X,X,0,X,X,X,0
26040, 북구,101,100세이상,2021,16,X,15,6.7,16,X,15,6.7
26040, 북구,102,15세미만,2021,36979,19034,17945,106.1,36883,18986,17897,106.1
26040, 북구,103,15~64세,2021,159893,84462,75431,112,157018,82822,74196,111.6
26040, 북구,104,65세이상,2021,19277,8727,10550,82.7,19176,8693,10483,82.9
26040, 북구,086,85세이상,2021,1576,328,1248,26.3,1573,328,1245,26.3
26040, 북구,126,평균연령,2021,39,38.2,39.8,,39,38.3,39.8,
26040, 북구,127,중위연령,2021,40.6,39.8,41.3,,40.6,39.9,41.4,
26310, 울주군,000,합계,2021,224164,117279,106885,109.7,214945,111176,103769,107.1
26310, 울주군,005,0~4세,2021,6866,3576,3290,108.7,6688,3485,3203,108.8
26310, 울주군,005001, 0세,2021,1189,645,544,118.6,1164,632,532,118.8
26310, 울주군,005002, 1세,2021,1229,605,624,97,1198,592,606,97.7
26310, 울주군,005003, 2세,2021,1318,684,634,107.9,1279,662,617,107.3
26310, 울주군,005004, 3세,2021,1540,782,758,103.2,1512,771,741,104
26310, 울주군,005005, 4세,2021,1590,860,730,117.8,1535,828,707,117.1
26310, 울주군,010,5~9세,2021,9798,4994,4804,104,9662,4926,4736,104
26310, 울주군,010001, 5세,2021,1736,866,870,99.5,1705,852,853,99.9
26310, 울주군,010002, 6세,2021,1918,1017,901,112.9,1885,1001,884,113.2
26310, 울주군,010003, 7세,2021,1963,1034,929,111.3,1930,1017,913,111.4
26310, 울주군,010004, 8세,2021,1977,983,994,98.9,1958,973,985,98.8
26310, 울주군,010005, 9세,2021,2204,1094,1110,98.6,2184,1083,1101,98.4
26310, 울주군,015,10~14세,2021,10779,5555,5224,106.3,10694,5502,5192,106
26310, 울주군,015001, 10세,2021,2172,1118,1054,106.1,2154,1108,1046,105.9
26310, 울주군,015002, 11세,2021,2095,1086,1009,107.6,2081,1077,1004,107.3
26310, 울주군,015003, 12세,2021,2032,1031,1001,103,2012,1016,996,102
26310, 울주군,015004, 13세,2021,2205,1120,1085,103.2,2186,1109,1077,103
26310, 울주군,015005, 14세,2021,2275,1200,1075,111.6,2261,1192,1069,111.5
26310, 울주군,020,15~19세,2021,10480,5678,4802,118.2,10391,5635,4756,118.5
26310, 울주군,020001, 15세,2021,2040,1084,956,113.4,2032,1082,950,113.9
26310, 울주군,020002, 16세,2021,2102,1094,1008,108.5,2088,1090,998,109.2
26310, 울주군,020003, 17세,2021,2195,1147,1048,109.4,2182,1140,1042,109.4
26310, 울주군,020004, 18세,2021,2151,1155,996,116,2125,1142,983,116.2
26310, 울주군,020005, 19세,2021,1992,1198,794,150.9,1964,1181,783,150.8
26310, 울주군,025,20~24세,2021,12971,7678,5293,145.1,12489,7336,5153,142.4
26310, 울주군,025001, 20세,2021,2386,1464,922,158.8,2336,1434,902,159
26310, 울주군,025002, 21세,2021,2696,1614,1082,149.2,2635,1576,1059,148.8
26310, 울주군,025003, 22세,2021,2535,1472,1063,138.5,2446,1406,1040,135.2
26310, 울주군,025004, 23세,2021,2583,1505,1078,139.6,2461,1417,1044,135.7
26310, 울주군,025005, 24세,2021,2771,1623,1148,141.4,2611,1503,1108,135.6
26310, 울주군,030,25~29세,2021,14263,8637,5626,153.5,13007,7712,5295,145.6
26310, 울주군,030001, 25세,2021,2857,1785,1072,166.5,2650,1634,1016,160.8
26310, 울주군,030002, 26세,2021,2955,1765,1190,148.3,2729,1595,1134,140.7
26310, 울주군,030003, 27세,2021,2886,1769,1117,158.4,2628,1577,1051,150
26310, 울주군,030004, 28세,2021,2804,1739,1065,163.3,2538,1542,996,154.8
26310, 울주군,030005, 29세,2021,2761,1579,1182,133.6,2462,1364,1098,124.2
26310, 울주군,035,30~34세,2021,12631,7212,5419,133.1,11046,6076,4970,122.3
26310, 울주군,035001, 30세,2021,2665,1502,1163,129.1,2354,1287,1067,120.6
26310, 울주군,035002, 31세,2021,2557,1505,1052,143.1,2213,1248,965,129.3
26310, 울주군,035003, 32세,2021,2501,1435,1066,134.6,2179,1214,965,125.8
26310, 울주군,035004, 33세,2021,2423,1376,1047,131.4,2095,1146,949,120.8
26310, 울주군,035005, 34세,2021,2485,1394,1091,127.8,2205,1181,1024,115.3
26310, 울주군,040,35~39세,2021,14273,7754,6519,118.9,12981,6825,6156,110.9
26310, 울주군,040001, 35세,2021,2560,1426,1134,125.7,2242,1197,1045,114.5
26310, 울주군,040002, 36세,2021,2569,1414,1155,122.4,2286,1219,1067,114.2
26310, 울주군,040003, 37세,2021,2768,1529,1239,123.4,2529,1342,1187,113.1
26310, 울주군,040004, 38세,2021,3008,1610,1398,115.2,2773,1443,1330,108.5
26310, 울주군,040005, 39세,2021,3368,1775,1593,111.4,3151,1624,1527,106.4
26310, 울주군,045,40~44세,2021,17104,9038,8066,112.1,16198,8414,7784,108.1
26310, 울주군,045001, 40세,2021,3473,1904,1569,121.4,3264,1752,1512,115.9
26310, 울주군,045002, 41세,2021,3571,1838,1733,106.1,3385,1715,1670,102.7
26310, 울주군,045003, 42세,2021,3378,1764,1614,109.3,3204,1637,1567,104.5
26310, 울주군,045004, 43세,2021,3186,1692,1494,113.3,2989,1571,1418,110.8
26310, 울주군,045005, 44세,2021,3496,1840,1656,111.1,3356,1739,1617,107.5
26310, 울주군,050,45~49세,2021,19489,9891,9598,103.1,18658,9357,9301,100.6
26310, 울주군,050001, 45세,2021,3422,1779,1643,108.3,3256,1666,1590,104.8
26310, 울주군,050002, 46세,2021,3655,1820,1835,99.2,3485,1716,1769,97
26310, 울주군,050003, 47세,2021,3995,2038,1957,104.1,3846,1938,1908,101.6
26310, 울주군,050004, 48세,2021,4152,2059,2093,98.4,3984,1952,2032,96.1
26310, 울주군,050005, 49세,2021,4265,2195,2070,106,4087,2085,2002,104.1
26310, 울주군,055,50~54세,2021,22454,11559,10895,106.1,21548,11031,10517,104.9
26310, 울주군,055001, 50세,2021,4673,2404,2269,105.9,4455,2268,2187,103.7
26310, 울주군,055002, 51세,2021,4451,2277,2174,104.7,4262,2175,2087,104.2
26310, 울주군,055003, 52세,2021,4477,2318,2159,107.4,4306,2224,2082,106.8
26310, 울주군,055004, 53세,2021,4598,2386,2212,107.9,4423,2278,2145,106.2
26310, 울주군,055005, 54세,2021,4255,2174,2081,104.5,4102,2086,2016,103.5
26310, 울주군,060,55~59세,2021,20078,10753,9325,115.3,19293,10278,9015,114
26310, 울주군,060001, 55세,2021,4154,2209,1945,113.6,3987,2108,1879,112.2
26310, 울주군,060002, 56세,2021,4235,2296,1939,118.4,4068,2187,1881,116.3
26310, 울주군,060003, 57세,2021,3820,2011,1809,111.2,3652,1908,1744,109.4
26310, 울주군,060004, 58세,2021,3954,2144,1810,118.5,3781,2049,1732,118.3
26310, 울주군,060005, 59세,2021,3915,2093,1822,114.9,3805,2026,1779,113.9
26310, 울주군,065,60~64세,2021,18588,9655,8933,108.1,18220,9444,8776,107.6
26310, 울주군,065001, 60세,2021,4306,2267,2039,111.2,4235,2221,2014,110.3
26310, 울주군,065002, 61세,2021,3986,2073,1913,108.4,3890,2021,1869,108.1
26310, 울주군,065003, 62세,2021,3631,1898,1733,109.5,3550,1854,1696,109.3
26310, 울주군,065004, 63세,2021,3342,1699,1643,103.4,3278,1657,1621,102.2
26310, 울주군,065005, 64세,2021,3323,1718,1605,107,3267,1691,1576,107.3
26310, 울주군,070,65~69세,2021,12652,6380,6272,101.7,12473,6278,6195,101.3
26310, 울주군,070001, 65세,2021,2928,1517,1411,107.5,2871,1484,1387,107
26310, 울주군,070002, 66세,2021,2998,1508,1490,101.2,2958,1488,1470,101.2
26310, 울주군,070003, 67세,2021,2381,1223,1158,105.6,2346,1201,1145,104.9
26310, 울주군,070004, 68세,2021,2160,1068,1092,97.8,2138,1055,1083,97.4
26310, 울주군,070005, 69세,2021,2185,1064,1121,94.9,2160,1050,1110,94.6
26310, 울주군,075,70~74세,2021,8230,4127,4103,100.6,8166,4105,4061,101.1
26310, 울주군,075001, 70세,2021,1687,850,837,101.6,1672,844,828,101.9
26310, 울주군,075002, 71세,2021,1729,885,844,104.9,1714,878,836,105
26310, 울주군,075003, 72세,2021,1668,821,847,96.9,1654,817,837,97.6
26310, 울주군,075004, 73세,2021,1613,802,811,98.9,1601,798,803,99.4
26310, 울주군,075005, 74세,2021,1533,769,764,100.7,1525,768,757,101.5
26310, 울주군,080,75~79세,2021,5691,2410,3281,73.5,5651,2400,3251,73.8
26310, 울주군,080001, 75세,2021,992,460,532,86.5,987,460,527,87.3
26310, 울주군,080002, 76세,2021,1045,466,579,80.5,1039,463,576,80.4
26310, 울주군,080003, 77세,2021,1113,431,682,63.2,1108,430,678,63.4
26310, 울주군,080004, 78세,2021,1217,516,701,73.6,1206,513,693,74
26310, 울주군,080005, 79세,2021,1324,537,787,68.2,1311,534,777,68.7
26310, 울주군,085,80~84세,2021,4380,1540,2840,54.2,4351,1534,2817,54.5
26310, 울주군,085001, 80세,2021,999,385,614,62.7,994,383,611,62.7
26310, 울주군,085002, 81세,2021,966,348,618,56.3,959,346,613,56.4
26310, 울주군,085003, 82세,2021,904,312,592,52.7,898,311,587,53
26310, 울주군,085004, 83세,2021,824,283,541,52.3,816,282,534,52.8
26310, 울주군,085005, 84세,2021,687,212,475,44.6,684,212,472,44.9
26310, 울주군,090,85~89세,2021,2392,637,1755,36.3,2387,635,1752,36.2
26310, 울주군,090001, 85세,2021,577,177,400,44.3,575,176,399,44.1
26310, 울주군,090002, 86세,2021,597,161,436,36.9,596,161,435,37
26310, 울주군,090003, 87세,2021,503,136,367,37.1,502,135,367,36.8
26310, 울주군,090004, 88세,2021,385,95,290,32.8,385,95,290,32.8
26310, 울주군,090005, 89세,2021,330,68,262,26,329,68,261,26.1
26310, 울주군,095,90~94세,2021,842,171,671,25.5,840,170,670,25.4
26310, 울주군,095001, 90세,2021,258,56,202,27.7,257,55,202,27.2
26310, 울주군,095002, 91세,2021,192,32,160,20,191,32,159,20.1
26310, 울주군,095003, 92세,2021,167,40,127,31.5,167,40,127,31.5
26310, 울주군,095004, 93세,2021,131,28,103,27.2,131,28,103,27.2
26310, 울주군,095005, 94세,2021,94,15,79,19,94,15,79,19
26310, 울주군,100,95~99세,2021,186,32,154,20.8,185,31,154,20.1
26310, 울주군,100001, 95세,2021,70,14,56,25,70,14,56,25
26310, 울주군,100002, 96세,2021,46,7,39,17.9,45,6,39,15.4
26310, 울주군,100003, 97세,2021,29,X,28,3.6,29,X,28,3.6
26310, 울주군,100004, 98세,2021,34,8,26,30.8,34,8,26,30.8
26310, 울주군,100005, 99세,2021,7,X,5,40,7,X,5,40
26310, 울주군,101,100세이상,2021,17,X,15,13.3,17,X,15,13.3
26310, 울주군,102,15세미만,2021,27443,14125,13318,106.1,27044,13913,13131,106
26310, 울주군,103,15~64세,2021,162331,87855,74476,118,153831,82108,71723,114.5
26310, 울주군,104,65세이상,2021,34390,15299,19091,80.1,34070,15155,18915,80.1
26310, 울주군,086,85세이상,2021,3437,842,2595,32.4,3429,838,2591,32.3
26310, 울주군,126,평균연령,2021,43.5,42.2,44.9,,43.6,42.4,45,
26310, 울주군,127,중위연령,2021,45.9,44.2,47.5,,46.3,44.8,47.7,
29,세종특별자치시,000,합계,2021,366227,183616,182611,100.6,359236,179460,179776,99.8
29,세종특별자치시,005,0~4세,2021,20047,10169,9878,102.9,19953,10124,9829,103
29,세종특별자치시,005001, 0세,2021,3603,1802,1801,100.1,3585,1795,1790,100.3
29,세종특별자치시,005002, 1세,2021,3523,1789,1734,103.2,3509,1782,1727,103.2
29,세종특별자치시,005003, 2세,2021,3984,2034,1950,104.3,3965,2024,1941,104.3
29,세종특별자치시,005004, 3세,2021,4266,2173,2093,103.8,4244,2163,2081,103.9
29,세종특별자치시,005005, 4세,2021,4671,2371,2300,103.1,4650,2360,2290,103.1
29,세종특별자치시,010,5~9세,2021,26421,13545,12876,105.2,26337,13504,12833,105.2
29,세종특별자치시,010001, 5세,2021,5132,2623,2509,104.5,5109,2613,2496,104.7
29,세종특별자치시,010002, 6세,2021,5343,2704,2639,102.5,5330,2699,2631,102.6
29,세종특별자치시,010003, 7세,2021,5171,2690,2481,108.4,5154,2679,2475,108.2
29,세종특별자치시,010004, 8세,2021,5258,2663,2595,102.6,5239,2656,2583,102.8
29,세종특별자치시,010005, 9세,2021,5517,2865,2652,108,5505,2857,2648,107.9
29,세종특별자치시,015,10~14세,2021,25139,12714,12425,102.3,25102,12700,12402,102.4
29,세종특별자치시,015001, 10세,2021,5363,2778,2585,107.5,5353,2773,2580,107.5
29,세종특별자치시,015002, 11세,2021,5070,2602,2468,105.4,5061,2600,2461,105.6
29,세종특별자치시,015003, 12세,2021,4908,2487,2421,102.7,4901,2484,2417,102.8
29,세종특별자치시,015004, 13세,2021,5039,2489,2550,97.6,5034,2488,2546,97.7
29,세종특별자치시,015005, 14세,2021,4759,2358,2401,98.2,4753,2355,2398,98.2
29,세종특별자치시,020,15~19세,2021,19452,9719,9733,99.9,19274,9638,9636,100
29,세종특별자치시,020001, 15세,2021,4304,2170,2134,101.7,4292,2168,2124,102.1
29,세종특별자치시,020002, 16세,2021,3814,1881,1933,97.3,3811,1880,1931,97.4
29,세종특별자치시,020003, 17세,2021,3899,1911,1988,96.1,3888,1906,1982,96.2
29,세종특별자치시,020004, 18세,2021,3770,1868,1902,98.2,3684,1831,1853,98.8
29,세종특별자치시,020005, 19세,2021,3665,1889,1776,106.4,3599,1853,1746,106.1
29,세종특별자치시,025,20~24세,2021,19793,10415,9378,111.1,18836,9842,8994,109.4
29,세종특별자치시,025001, 20세,2021,4019,2043,1976,103.4,3925,1986,1939,102.4
29,세종특별자치시,025002, 21세,2021,4229,2188,2041,107.2,4019,2062,1957,105.4
29,세종특별자치시,025003, 22세,2021,3800,1954,1846,105.9,3600,1827,1773,103
29,세종특별자치시,025004, 23세,2021,3836,2077,1759,118.1,3625,1958,1667,117.5
29,세종특별자치시,025005, 24세,2021,3909,2153,1756,122.6,3667,2009,1658,121.2
29,세종특별자치시,030,25~29세,2021,21559,11192,10367,108,20285,10349,9936,104.2
29,세종특별자치시,030001, 25세,2021,3992,2175,1817,119.7,3745,2006,1739,115.4
29,세종특별자치시,030002, 26세,2021,4035,2187,1848,118.3,3778,2016,1762,114.4
29,세종특별자치시,030003, 27세,2021,4211,2190,2021,108.4,3927,2014,1913,105.3
29,세종특별자치시,030004, 28세,2021,4442,2227,2215,100.5,4214,2073,2141,96.8
29,세종특별자치시,030005, 29세,2021,4879,2413,2466,97.9,4621,2240,2381,94.1
29,세종특별자치시,035,30~34세,2021,26697,13158,13539,97.2,25605,12444,13161,94.6
29,세종특별자치시,035001, 30세,2021,4976,2383,2593,91.9,4769,2236,2533,88.3
29,세종특별자치시,035002, 31세,2021,5117,2540,2577,98.6,4891,2389,2502,95.5
29,세종특별자치시,035003, 32세,2021,5250,2608,2642,98.7,5023,2470,2553,96.7
29,세종특별자치시,035004, 33세,2021,5518,2754,2764,99.6,5298,2617,2681,97.6
29,세종특별자치시,035005, 34세,2021,5836,2873,2963,97,5624,2732,2892,94.5
29,세종특별자치시,040,35~39세,2021,34311,16848,17463,96.5,33387,16273,17114,95.1
29,세종특별자치시,040001, 35세,2021,6042,2993,3049,98.2,5819,2846,2973,95.7
29,세종특별자치시,040002, 36세,2021,6124,3109,3015,103.1,5923,2975,2948,100.9
29,세종특별자치시,040003, 37세,2021,6598,3232,3366,96,6434,3132,3302,94.9
29,세종특별자치시,040004, 38세,2021,7242,3429,3813,89.9,7076,3334,3742,89.1
29,세종특별자치시,040005, 39세,2021,8305,4085,4220,96.8,8135,3986,4149,96.1
29,세종특별자치시,045,40~44세,2021,37893,18750,19143,97.9,37293,18411,18882,97.5
29,세종특별자치시,045001, 40세,2021,8047,3924,4123,95.2,7914,3842,4072,94.4
29,세종특별자치시,045002, 41세,2021,8095,4019,4076,98.6,7978,3954,4024,98.3
29,세종특별자치시,045003, 42세,2021,7858,3887,3971,97.9,7715,3797,3918,96.9
29,세종특별자치시,045004, 43세,2021,6877,3395,3482,97.5,6775,3344,3431,97.5
29,세종특별자치시,045005, 44세,2021,7016,3525,3491,101,6911,3474,3437,101.1
29,세종특별자치시,050,45~49세,2021,32533,16889,15644,108,32075,16630,15445,107.7
29,세종특별자치시,050001, 45세,2021,6495,3231,3264,99,6404,3184,3220,98.9
29,세종특별자치시,050002, 46세,2021,6648,3428,3220,106.5,6560,3378,3182,106.2
29,세종특별자치시,050003, 47세,2021,6852,3537,3315,106.7,6755,3476,3279,106
29,세종특별자치시,050004, 48세,2021,6500,3379,3121,108.3,6417,3338,3079,108.4
29,세종특별자치시,050005, 49세,2021,6038,3314,2724,121.7,5939,3254,2685,121.2
29,세종특별자치시,055,50~54세,2021,27097,14247,12850,110.9,26657,14007,12650,110.7
29,세종특별자치시,055001, 50세,2021,6325,3366,2959,113.8,6224,3313,2911,113.8
29,세종특별자치시,055002, 51세,2021,5604,3005,2599,115.6,5505,2952,2553,115.6
29,세종특별자치시,055003, 52세,2021,5488,2901,2587,112.1,5399,2849,2550,111.7
29,세종특별자치시,055004, 53세,2021,5177,2681,2496,107.4,5096,2638,2458,107.3
29,세종특별자치시,055005, 54세,2021,4503,2294,2209,103.8,4433,2255,2178,103.5
29,세종특별자치시,060,55~59세,2021,20287,10434,9853,105.9,19914,10240,9674,105.9
29,세종특별자치시,060001, 55세,2021,4140,2133,2007,106.3,4065,2090,1975,105.8
29,세종특별자치시,060002, 56세,2021,4289,2209,2080,106.2,4224,2164,2060,105
29,세종특별자치시,060003, 57세,2021,3859,1999,1860,107.5,3775,1958,1817,107.8
29,세종특별자치시,060004, 58세,2021,3952,2043,1909,107,3866,2004,1862,107.6
29,세종특별자치시,060005, 59세,2021,4047,2050,1997,102.7,3984,2024,1960,103.3
29,세종특별자치시,065,60~64세,2021,19271,9589,9682,99,19015,9460,9555,99
29,세종특별자치시,065001, 60세,2021,4479,2255,2224,101.4,4432,2233,2199,101.5
29,세종특별자치시,065002, 61세,2021,4170,2049,2121,96.6,4109,2017,2092,96.4
29,세종특별자치시,065003, 62세,2021,3780,1887,1893,99.7,3725,1859,1866,99.6
29,세종특별자치시,065004, 63세,2021,3459,1705,1754,97.2,3412,1681,1731,97.1
29,세종특별자치시,065005, 64세,2021,3383,1693,1690,100.2,3337,1670,1667,100.2
29,세종특별자치시,070,65~69세,2021,13331,6572,6759,97.2,13199,6501,6698,97.1
29,세종특별자치시,070001, 65세,2021,3122,1560,1562,99.9,3091,1543,1548,99.7
29,세종특별자치시,070002, 66세,2021,3205,1587,1618,98.1,3164,1567,1597,98.1
29,세종특별자치시,070003, 67세,2021,2591,1248,1343,92.9,2569,1238,1331,93
29,세종특별자치시,070004, 68세,2021,2080,1052,1028,102.3,2057,1036,1021,101.5
29,세종특별자치시,070005, 69세,2021,2333,1125,1208,93.1,2318,1117,1201,93
29,세종특별자치시,075,70~74세,2021,8462,4089,4373,93.5,8406,4063,4343,93.6
29,세종특별자치시,075001, 70세,2021,1647,787,860,91.5,1636,783,853,91.8
29,세종특별자치시,075002, 71세,2021,1851,934,917,101.9,1835,925,910,101.6
29,세종특별자치시,075003, 72세,2021,1866,892,974,91.6,1853,885,968,91.4
29,세종특별자치시,075004, 73세,2021,1595,789,806,97.9,1585,786,799,98.4
29,세종특별자치시,075005, 74세,2021,1503,687,816,84.2,1497,684,813,84.1
29,세종특별자치시,080,75~79세,2021,5869,2612,3257,80.2,5851,2605,3246,80.3
29,세종특별자치시,080001, 75세,2021,1173,556,617,90.1,1165,553,612,90.4
29,세종특별자치시,080002, 76세,2021,1095,500,595,84,1095,500,595,84
29,세종특별자치시,080003, 77세,2021,1145,487,658,74,1143,486,657,74
29,세종특별자치시,080004, 78세,2021,1104,484,620,78.1,1097,482,615,78.4
29,세종특별자치시,080005, 79세,2021,1352,585,767,76.3,1351,584,767,76.1
29,세종특별자치시,085,80~84세,2021,4387,1646,2741,60.1,4379,1644,2735,60.1
29,세종특별자치시,085001, 80세,2021,1066,428,638,67.1,1064,427,637,67
29,세종특별자치시,085002, 81세,2021,889,336,553,60.8,887,336,551,61
29,세종특별자치시,085003, 82세,2021,920,336,584,57.5,920,336,584,57.5
29,세종특별자치시,085004, 83세,2021,820,303,517,58.6,816,302,514,58.8
29,세종특별자치시,085005, 84세,2021,692,243,449,54.1,692,243,449,54.1
29,세종특별자치시,090,85~89세,2021,2587,793,1794,44.2,2579,790,1789,44.2
29,세종특별자치시,090001, 85세,2021,680,239,441,54.2,678,237,441,53.7
29,세종특별자치시,090002, 86세,2021,620,194,426,45.5,618,194,424,45.8
29,세종특별자치시,090003, 87세,2021,522,176,346,50.9,519,176,343,51.3
29,세종특별자치시,090004, 88세,2021,414,109,305,35.7,413,108,305,35.4
29,세종특별자치시,090005, 89세,2021,351,75,276,27.2,351,75,276,27.2
29,세종특별자치시,095,90~94세,2021,897,202,695,29.1,895,202,693,29.1
29,세종특별자치시,095001, 90세,2021,260,73,187,39,260,73,187,39
29,세종특별자치시,095002, 91세,2021,222,48,174,27.6,221,48,173,27.7
29,세종특별자치시,095003, 92세,2021,184,37,147,25.2,184,37,147,25.2
29,세종특별자치시,095004, 93세,2021,135,25,110,22.7,134,25,109,22.9
29,세종특별자치시,095005, 94세,2021,96,19,77,24.7,96,19,77,24.7
29,세종특별자치시,100,95~99세,2021,174,29,145,20,174,29,145,20
29,세종특별자치시,100001, 95세,2021,54,11,43,25.6,54,11,43,25.6
29,세종특별자치시,100002, 96세,2021,49,7,42,16.7,49,7,42,16.7
29,세종특별자치시,100003, 97세,2021,29,X,25,16,29,X,25,16
29,세종특별자치시,100004, 98세,2021,23,X,20,15,23,X,20,15
29,세종특별자치시,100005, 99세,2021,19,X,15,26.7,19,X,15,26.7
29,세종특별자치시,101,100세이상,2021,20,X,16,25,20,X,16,25
29,세종특별자치시,102,15세미만,2021,71607,36428,35179,103.6,71392,36328,35064,103.6
29,세종특별자치시,103,15~64세,2021,258893,131241,127652,102.8,252341,127294,125047,101.8
29,세종특별자치시,104,65세이상,2021,35727,15947,19780,80.6,35503,15838,19665,80.5
29,세종특별자치시,086,85세이상,2021,3678,1028,2650,38.8,3668,1025,2643,38.8
29,세종특별자치시,126,평균연령,2021,37.4,36.9,37.9,,37.4,36.9,37.9,
29,세종특별자치시,127,중위연령,2021,38.7,38.5,39,,38.9,38.7,39,
29004, 읍부,000,합계,2021,47774,24972,22802,109.5,45681,23893,21788,109.7
29004, 읍부,005,0~4세,2021,1232,626,606,103.3,1185,604,581,104
29004, 읍부,005001, 0세,2021,216,110,106,103.8,206,106,100,106
29004, 읍부,005002, 1세,2021,233,110,123,89.4,227,106,121,87.6
29004, 읍부,005003, 2세,2021,268,146,122,119.7,256,142,114,124.6
29004, 읍부,005004, 3세,2021,237,121,116,104.3,226,116,110,105.5
29004, 읍부,005005, 4세,2021,278,139,139,100,270,134,136,98.5
29004, 읍부,010,5~9세,2021,1857,954,903,105.6,1817,940,877,107.2
29004, 읍부,010001, 5세,2021,316,160,156,102.6,306,156,150,104
29004, 읍부,010002, 6세,2021,358,194,164,118.3,352,193,159,121.4
29004, 읍부,010003, 7세,2021,363,182,181,100.6,356,179,177,101.1
29004, 읍부,010004, 8세,2021,384,184,200,92,373,182,191,95.3
29004, 읍부,010005, 9세,2021,436,234,202,115.8,430,230,200,115
29004, 읍부,015,10~14세,2021,2124,1108,1016,109.1,2113,1105,1008,109.6
29004, 읍부,015001, 10세,2021,416,236,180,131.1,414,235,179,131.3
29004, 읍부,015002, 11세,2021,446,225,221,101.8,443,223,220,101.4
29004, 읍부,015003, 12세,2021,394,207,187,110.7,391,207,184,112.5
29004, 읍부,015004, 13세,2021,475,241,234,103,473,241,232,103.9
29004, 읍부,015005, 14세,2021,393,199,194,102.6,392,199,193,103.1
29004, 읍부,020,15~19세,2021,2688,1416,1272,111.3,2535,1345,1190,113
29004, 읍부,020001, 15세,2021,357,181,176,102.8,355,180,175,102.9
29004, 읍부,020002, 16세,2021,402,215,187,115,401,214,187,114.4
29004, 읍부,020003, 17세,2021,457,251,206,121.8,450,249,201,123.9
29004, 읍부,020004, 18세,2021,581,312,269,116,498,277,221,125.3
29004, 읍부,020005, 19세,2021,891,457,434,105.3,831,425,406,104.7
29004, 읍부,025,20~24세,2021,5673,2895,2778,104.2,5317,2719,2598,104.7
29004, 읍부,025001, 20세,2021,1149,527,622,84.7,1082,487,595,81.8
29004, 읍부,025002, 21세,2021,1209,528,681,77.5,1110,480,630,76.2
29004, 읍부,025003, 22세,2021,1113,534,579,92.2,1048,507,541,93.7
29004, 읍부,025004, 23세,2021,1155,640,515,124.3,1083,605,478,126.6
29004, 읍부,025005, 24세,2021,1047,666,381,174.8,994,640,354,180.8
29004, 읍부,030,25~29세,2021,3939,2476,1463,169.2,3727,2385,1342,177.7
29004, 읍부,030001, 25세,2021,975,661,314,210.5,938,646,292,221.2
29004, 읍부,030002, 26세,2021,866,543,323,168.1,828,529,299,176.9
29004, 읍부,030003, 27세,2021,713,437,276,158.3,658,420,238,176.5
29004, 읍부,030004, 28세,2021,727,453,274,165.3,694,436,258,169
29004, 읍부,030005, 29세,2021,658,382,276,138.4,609,354,255,138.8
29004, 읍부,035,30~34세,2021,2817,1614,1203,134.2,2563,1471,1092,134.7
29004, 읍부,035001, 30세,2021,616,353,263,134.2,574,330,244,135.2
29004, 읍부,035002, 31세,2021,578,334,244,136.9,525,303,222,136.5
29004, 읍부,035003, 32세,2021,500,283,217,130.4,452,256,196,130.6
29004, 읍부,035004, 33세,2021,565,334,231,144.6,506,299,207,144.4
29004, 읍부,035005, 34세,2021,558,310,248,125,506,283,223,126.9
29004, 읍부,040,35~39세,2021,2902,1570,1332,117.9,2704,1454,1250,116.3
29004, 읍부,040001, 35세,2021,557,305,252,121,499,267,232,115.1
29004, 읍부,040002, 36세,2021,521,297,224,132.6,482,273,209,130.6
29004, 읍부,040003, 37세,2021,553,304,249,122.1,518,288,230,125.2
29004, 읍부,040004, 38세,2021,583,294,289,101.7,544,271,273,99.3
29004, 읍부,040005, 39세,2021,688,370,318,116.4,661,355,306,116
29004, 읍부,045,40~44세,2021,3348,1795,1553,115.6,3202,1717,1485,115.6
29004, 읍부,045001, 40세,2021,661,355,306,116,628,334,294,113.6
29004, 읍부,045002, 41세,2021,693,370,323,114.6,671,357,314,113.7
29004, 읍부,045003, 42세,2021,666,357,309,115.5,633,337,296,113.9
29004, 읍부,045004, 43세,2021,635,339,296,114.5,607,329,278,118.3
29004, 읍부,045005, 44세,2021,693,374,319,117.2,663,360,303,118.8
29004, 읍부,050,45~49세,2021,3566,1918,1648,116.4,3425,1837,1588,115.7
29004, 읍부,050001, 45세,2021,652,340,312,109,625,325,300,108.3
29004, 읍부,050002, 46세,2021,668,363,305,119,646,346,300,115.3
29004, 읍부,050003, 47세,2021,736,406,330,123,713,394,319,123.5
29004, 읍부,050004, 48세,2021,769,398,371,107.3,741,387,354,109.3
29004, 읍부,050005, 49세,2021,741,411,330,124.5,700,385,315,122.2
29004, 읍부,055,50~54세,2021,3643,1966,1677,117.2,3471,1875,1596,117.5
29004, 읍부,055001, 50세,2021,791,433,358,120.9,756,411,345,119.1
29004, 읍부,055002, 51세,2021,720,397,323,122.9,683,382,301,126.9
29004, 읍부,055003, 52세,2021,771,419,352,119,736,399,337,118.4
29004, 읍부,055004, 53세,2021,700,385,315,122.2,665,365,300,121.7
29004, 읍부,055005, 54세,2021,661,332,329,100.9,631,318,313,101.6
29004, 읍부,060,55~59세,2021,3234,1682,1552,108.4,3066,1586,1480,107.2
29004, 읍부,060001, 55세,2021,639,330,309,106.8,602,309,293,105.5
29004, 읍부,060002, 56세,2021,699,347,352,98.6,668,323,345,93.6
29004, 읍부,060003, 57세,2021,613,344,269,127.9,578,324,254,127.6
29004, 읍부,060004, 58세,2021,650,337,313,107.7,614,319,295,108.1
29004, 읍부,060005, 59세,2021,633,324,309,104.9,604,311,293,106.1
29004, 읍부,065,60~64세,2021,3295,1652,1643,100.5,3194,1603,1591,100.8
29004, 읍부,065001, 60세,2021,778,409,369,110.8,761,403,358,112.6
29004, 읍부,065002, 61세,2021,716,364,352,103.4,690,351,339,103.5
29004, 읍부,065003, 62세,2021,612,297,315,94.3,595,287,308,93.2
29004, 읍부,065004, 63세,2021,565,276,289,95.5,544,267,277,96.4
29004, 읍부,065005, 64세,2021,624,306,318,96.2,604,295,309,95.5
29004, 읍부,070,65~69세,2021,2523,1277,1246,102.5,2464,1244,1220,102
29004, 읍부,070001, 65세,2021,537,292,245,119.2,526,285,241,118.3
29004, 읍부,070002, 66세,2021,633,319,314,101.6,616,312,304,102.6
29004, 읍부,070003, 67세,2021,484,229,255,89.8,474,225,249,90.4
29004, 읍부,070004, 68세,2021,415,203,212,95.8,403,194,209,92.8
29004, 읍부,070005, 69세,2021,454,234,220,106.4,445,228,217,105.1
29004, 읍부,075,70~74세,2021,1713,797,916,87,1686,784,902,86.9
29004, 읍부,075001, 70세,2021,328,144,184,78.3,322,140,182,76.9
29004, 읍부,075002, 71세,2021,364,179,185,96.8,358,176,182,96.7
29004, 읍부,075003, 72세,2021,383,181,202,89.6,376,178,198,89.9
29004, 읍부,075004, 73세,2021,325,160,165,97,320,158,162,97.5
29004, 읍부,075005, 74세,2021,313,133,180,73.9,310,132,178,74.2
29004, 읍부,080,75~79세,2021,1366,543,823,66,1362,541,821,65.9
29004, 읍부,080001, 75세,2021,264,101,163,62,263,100,163,61.3
29004, 읍부,080002, 76세,2021,257,107,150,71.3,257,107,150,71.3
29004, 읍부,080003, 77세,2021,257,90,167,53.9,256,89,167,53.3
29004, 읍부,080004, 78세,2021,268,110,158,69.6,266,110,156,70.5
29004, 읍부,080005, 79세,2021,320,135,185,73,320,135,185,73
29004, 읍부,085,80~84세,2021,1049,437,612,71.4,1048,437,611,71.5
29004, 읍부,085001, 80세,2021,276,120,156,76.9,275,120,155,77.4
29004, 읍부,085002, 81세,2021,199,86,113,76.1,199,86,113,76.1
29004, 읍부,085003, 82세,2021,224,85,139,61.2,224,85,139,61.2
29004, 읍부,085004, 83세,2021,195,86,109,78.9,195,86,109,78.9
29004, 읍부,085005, 84세,2021,155,60,95,63.2,155,60,95,63.2
29004, 읍부,090,85~89세,2021,543,188,355,53,540,188,352,53.4
29004, 읍부,090001, 85세,2021,149,54,95,56.8,149,54,95,56.8
29004, 읍부,090002, 86세,2021,137,47,90,52.2,135,47,88,53.4
29004, 읍부,090003, 87세,2021,99,43,56,76.8,98,43,55,78.2
29004, 읍부,090004, 88세,2021,80,24,56,42.9,80,24,56,42.9
29004, 읍부,090005, 89세,2021,78,20,58,34.5,78,20,58,34.5
29004, 읍부,095,90~94세,2021,210,53,157,33.8,210,53,157,33.8
29004, 읍부,095001, 90세,2021,52,15,37,40.5,52,15,37,40.5
29004, 읍부,095002, 91세,2021,61,15,46,32.6,61,15,46,32.6
29004, 읍부,095003, 92세,2021,42,8,34,23.5,42,8,34,23.5
29004, 읍부,095004, 93세,2021,23,X,19,21.1,23,X,19,21.1
29004, 읍부,095005, 94세,2021,32,11,21,52.4,32,11,21,52.4
29004, 읍부,100,95~99세,2021,45,X,41,9.8,45,X,41,9.8
29004, 읍부,100001, 95세,2021,14,X,12,16.7,14,X,12,16.7
29004, 읍부,100002, 96세,2021,15,X,15,0,15,X,15,0
29004, 읍부,100003, 97세,2021,9,X,9,0,9,X,9,0
29004, 읍부,100004, 98세,2021,X,X,X,50,X,X,X,50
29004, 읍부,100005, 99세,2021,X,X,X,33.3,X,X,X,33.3
29004, 읍부,101,100세이상,2021,7,X,6,16.7,7,X,6,16.7
29004, 읍부,102,15세미만,2021,5213,2688,2525,106.5,5115,2649,2466,107.4
29004, 읍부,103,15~64세,2021,35105,18984,16121,117.8,33204,17992,15212,118.3
29004, 읍부,104,65세이상,2021,7456,3300,4156,79.4,7362,3252,4110,79.1
29004, 읍부,086,85세이상,2021,805,246,559,44,802,246,556,44.2
29004, 읍부,126,평균연령,2021,41.4,40.3,42.7,,41.7,40.4,43,
29004, 읍부,127,중위연령,2021,41,39.5,42.6,,41.4,39.8,43.2,
29005, 면부,000,합계,2021,50376,27688,22688,122,47204,25361,21843,116.1
29005, 면부,005,0~4세,2021,776,373,403,92.6,754,359,395,90.9
29005, 면부,005001, 0세,2021,154,70,84,83.3,148,67,81,82.7
29005, 면부,005002, 1세,2021,132,59,73,80.8,128,57,71,80.3
29005, 면부,005003, 2세,2021,163,77,86,89.5,160,74,86,86
29005, 면부,005004, 3세,2021,171,86,85,101.2,167,83,84,98.8
29005, 면부,005005, 4세,2021,156,81,75,108,151,78,73,106.8
29005, 면부,010,5~9세,2021,965,499,466,107.1,949,491,458,107.2
29005, 면부,010001, 5세,2021,171,97,74,131.1,167,96,71,135.2
29005, 면부,010002, 6세,2021,179,93,86,108.1,179,93,86,108.1
29005, 면부,010003, 7세,2021,182,88,94,93.6,177,85,92,92.4
29005, 면부,010004, 8세,2021,204,110,94,117,200,108,92,117.4
29005, 면부,010005, 9세,2021,229,111,118,94.1,226,109,117,93.2
29005, 면부,015,10~14세,2021,1005,500,505,99,992,495,497,99.6
29005, 면부,015001, 10세,2021,186,86,100,86,183,84,99,84.8
29005, 면부,015002, 11세,2021,205,110,95,115.8,201,110,91,120.9
29005, 면부,015003, 12세,2021,185,96,89,107.9,183,94,89,105.6
29005, 면부,015004, 13세,2021,229,106,123,86.2,228,106,122,86.9
29005, 면부,015005, 14세,2021,200,102,98,104.1,197,101,96,105.2
29005, 면부,020,15~19세,2021,1909,947,962,98.4,1897,940,957,98.2
29005, 면부,020001, 15세,2021,221,111,110,100.9,218,111,107,103.7
29005, 면부,020002, 16세,2021,190,94,96,97.9,190,94,96,97.9
29005, 면부,020003, 17세,2021,234,127,107,118.7,231,124,107,115.9
29005, 면부,020004, 18세,2021,367,203,164,123.8,366,202,164,123.2
29005, 면부,020005, 19세,2021,897,412,485,84.9,892,409,483,84.7
29005, 면부,025,20~24세,2021,4356,2326,2030,114.6,3916,1995,1921,103.9
29005, 면부,025001, 20세,2021,881,376,505,74.5,865,363,502,72.3
29005, 면부,025002, 21세,2021,866,375,491,76.4,780,310,470,66
29005, 면부,025003, 22세,2021,855,468,387,120.9,750,381,369,103.3
29005, 면부,025004, 23세,2021,878,544,334,162.9,779,474,305,155.4
29005, 면부,025005, 24세,2021,876,563,313,179.9,742,467,275,169.8
29005, 면부,030,25~29세,2021,3977,2756,1221,225.7,3225,2149,1076,199.7
29005, 면부,030001, 25세,2021,802,566,236,239.8,652,433,219,197.7
29005, 면부,030002, 26세,2021,835,594,241,246.5,674,462,212,217.9
29005, 면부,030003, 27세,2021,838,597,241,247.7,676,470,206,228.2
29005, 면부,030004, 28세,2021,773,501,272,184.2,632,392,240,163.3
29005, 면부,030005, 29세,2021,729,498,231,215.6,591,392,199,197
29005, 면부,035,30~34세,2021,3031,2053,978,209.9,2484,1622,862,188.2
29005, 면부,035001, 30세,2021,692,487,205,237.6,566,383,183,209.3
29005, 면부,035002, 31세,2021,689,470,219,214.6,569,372,197,188.8
29005, 면부,035003, 32세,2021,574,374,200,187,465,293,172,170.3
29005, 면부,035004, 33세,2021,574,397,177,224.3,474,321,153,209.8
29005, 면부,035005, 34세,2021,502,325,177,183.6,410,253,157,161.1
29005, 면부,040,35~39세,2021,2573,1672,901,185.6,2162,1350,812,166.3
29005, 면부,040001, 35세,2021,488,324,164,197.6,393,250,143,174.8
29005, 면부,040002, 36세,2021,496,337,159,211.9,406,262,144,181.9
29005, 면부,040003, 37세,2021,505,330,175,188.6,428,269,159,169.2
29005, 면부,040004, 38세,2021,494,308,186,165.6,422,256,166,154.2
29005, 면부,040005, 39세,2021,590,373,217,171.9,513,313,200,156.5
29005, 면부,045,40~44세,2021,2687,1734,953,182,2388,1529,859,178
29005, 면부,045001, 40세,2021,522,322,200,161,454,272,182,149.5
29005, 면부,045002, 41세,2021,583,356,227,156.8,503,307,196,156.6
29005, 면부,045003, 42세,2021,547,372,175,212.6,488,327,161,203.1
29005, 면부,045004, 43세,2021,500,348,152,228.9,454,315,139,226.6
29005, 면부,045005, 44세,2021,535,336,199,168.8,489,308,181,170.2
29005, 면부,050,45~49세,2021,2961,1832,1129,162.3,2752,1697,1055,160.9
29005, 면부,050001, 45세,2021,486,296,190,155.8,453,274,179,153.1
29005, 면부,050002, 46세,2021,583,365,218,167.4,537,339,198,171.2
29005, 면부,050003, 47세,2021,656,415,241,172.2,607,377,230,163.9
29005, 면부,050004, 48세,2021,648,382,266,143.6,608,359,249,144.2
29005, 면부,050005, 49세,2021,588,374,214,174.8,547,348,199,174.9
29005, 면부,055,50~54세,2021,3914,2245,1669,134.5,3736,2137,1599,133.6
29005, 면부,055001, 50세,2021,762,467,295,158.3,719,444,275,161.5
29005, 면부,055002, 51세,2021,751,445,306,145.4,707,419,288,145.5
29005, 면부,055003, 52세,2021,831,487,344,141.6,796,463,333,139
29005, 면부,055004, 53세,2021,800,436,364,119.8,770,419,351,119.4
29005, 면부,055005, 54세,2021,770,410,360,113.9,744,392,352,111.4
29005, 면부,060,55~59세,2021,4284,2379,1905,124.9,4156,2304,1852,124.4
29005, 면부,060001, 55세,2021,748,418,330,126.7,722,402,320,125.6
29005, 면부,060002, 56세,2021,894,538,356,151.1,874,522,352,148.3
29005, 면부,060003, 57세,2021,808,431,377,114.3,781,417,364,114.6
29005, 면부,060004, 58세,2021,862,467,395,118.2,828,448,380,117.9
29005, 면부,060005, 59세,2021,972,525,447,117.4,951,515,436,118.1
29005, 면부,065,60~64세,2021,4922,2638,2284,115.5,4841,2593,2248,115.3
29005, 면부,065001, 60세,2021,1085,587,498,117.9,1070,578,492,117.5
29005, 면부,065002, 61세,2021,1069,582,487,119.5,1050,570,480,118.8
29005, 면부,065003, 62세,2021,980,522,458,114,957,510,447,114.1
29005, 면부,065004, 63세,2021,902,480,422,113.7,892,474,418,113.4
29005, 면부,065005, 64세,2021,886,467,419,111.5,872,461,411,112.2
29005, 면부,070,65~69세,2021,3941,2018,1923,104.9,3901,1992,1909,104.3
29005, 면부,070001, 65세,2021,890,456,434,105.1,878,448,430,104.2
29005, 면부,070002, 66세,2021,925,488,437,111.7,912,478,434,110.1
29005, 면부,070003, 67세,2021,774,403,371,108.6,766,399,367,108.7
29005, 면부,070004, 68세,2021,613,318,295,107.8,609,315,294,107.1
29005, 면부,070005, 69세,2021,739,353,386,91.5,736,352,384,91.7
29005, 면부,075,70~74세,2021,2835,1409,1426,98.8,2821,1404,1417,99.1
29005, 면부,075001, 70세,2021,543,281,262,107.3,542,281,261,107.7
29005, 면부,075002, 71세,2021,616,331,285,116.1,610,328,282,116.3
29005, 면부,075003, 72세,2021,639,312,327,95.4,638,311,327,95.1
29005, 면부,075004, 73세,2021,539,248,291,85.2,535,248,287,86.4
29005, 면부,075005, 74세,2021,498,237,261,90.8,496,236,260,90.8
29005, 면부,080,75~79세,2021,2309,1012,1297,78,2303,1010,1293,78.1
29005, 면부,080001, 75세,2021,422,202,220,91.8,419,202,217,93.1
29005, 면부,080002, 76세,2021,387,174,213,81.7,387,174,213,81.7
29005, 면부,080003, 77세,2021,458,192,266,72.2,458,192,266,72.2
29005, 면부,080004, 78세,2021,441,186,255,72.9,439,185,254,72.8
29005, 면부,080005, 79세,2021,601,258,343,75.2,600,257,343,74.9
29005, 면부,085,80~84세,2021,2085,769,1316,58.4,2082,768,1314,58.4
29005, 면부,085001, 80세,2021,458,168,290,57.9,458,168,290,57.9
29005, 면부,085002, 81세,2021,432,155,277,56,431,155,276,56.2
29005, 면부,085003, 82세,2021,444,167,277,60.3,444,167,277,60.3
29005, 면부,085004, 83세,2021,394,149,245,60.8,392,148,244,60.7
29005, 면부,085005, 84세,2021,357,130,227,57.3,357,130,227,57.3
29005, 면부,090,85~89세,2021,1335,416,919,45.3,1335,416,919,45.3
29005, 면부,090001, 85세,2021,352,125,227,55.1,352,125,227,55.1
29005, 면부,090002, 86세,2021,309,107,202,53,309,107,202,53
29005, 면부,090003, 87세,2021,279,88,191,46.1,279,88,191,46.1
29005, 면부,090004, 88세,2021,225,57,168,33.9,225,57,168,33.9
29005, 면부,090005, 89세,2021,170,39,131,29.8,170,39,131,29.8
29005, 면부,095,90~94세,2021,420,93,327,28.4,419,93,326,28.5
29005, 면부,095001, 90세,2021,134,35,99,35.4,134,35,99,35.4
29005, 면부,095002, 91세,2021,99,26,73,35.6,99,26,73,35.6
29005, 면부,095003, 92세,2021,84,12,72,16.7,84,12,72,16.7
29005, 면부,095004, 93세,2021,62,13,49,26.5,61,13,48,27.1
29005, 면부,095005, 94세,2021,41,7,34,20.6,41,7,34,20.6
29005, 면부,100,95~99세,2021,83,15,68,22.1,83,15,68,22.1
29005, 면부,100001, 95세,2021,25,6,19,31.6,25,6,19,31.6
29005, 면부,100002, 96세,2021,23,5,18,27.8,23,5,18,27.8
29005, 면부,100003, 97세,2021,12,X,10,20,12,X,10,20
29005, 면부,100004, 98세,2021,14,X,12,16.7,14,X,12,16.7
29005, 면부,100005, 99세,2021,9,X,9,0,9,X,9,0
29005, 면부,101,100세이상,2021,8,X,6,33.3,8,X,6,33.3
29005, 면부,102,15세미만,2021,2746,1372,1374,99.9,2695,1345,1350,99.6
29005, 면부,103,15~64세,2021,34614,20582,14032,146.7,31557,18316,13241,138.3
29005, 면부,104,65세이상,2021,13016,5734,7282,78.7,12952,5700,7252,78.6
29005, 면부,086,85세이상,2021,1846,526,1320,39.8,1845,526,1319,39.9
29005, 면부,126,평균연령,2021,48.8,46.7,51.4,,49.7,47.8,51.9,
29005, 면부,127,중위연령,2021,51.2,47.8,55.4,,52.8,50.1,56.3,
29003, 동부,000,합계,2021,268077,130956,137121,95.5,266351,130206,136145,95.6
29003, 동부,005,0~4세,2021,18039,9170,8869,103.4,18014,9161,8853,103.5
29003, 동부,005001, 0세,2021,3233,1622,1611,100.7,3231,1622,1609,100.8
29003, 동부,005002, 1세,2021,3158,1620,1538,105.3,3154,1619,1535,105.5
29003, 동부,005003, 2세,2021,3553,1811,1742,104,3549,1808,1741,103.8
29003, 동부,005004, 3세,2021,3858,1966,1892,103.9,3851,1964,1887,104.1
29003, 동부,005005, 4세,2021,4237,2151,2086,103.1,4229,2148,2081,103.2
29003, 동부,010,5~9세,2021,23599,12092,11507,105.1,23571,12073,11498,105
29003, 동부,010001, 5세,2021,4645,2366,2279,103.8,4636,2361,2275,103.8
29003, 동부,010002, 6세,2021,4806,2417,2389,101.2,4799,2413,2386,101.1
29003, 동부,010003, 7세,2021,4626,2420,2206,109.7,4621,2415,2206,109.5
29003, 동부,010004, 8세,2021,4670,2369,2301,103,4666,2366,2300,102.9
29003, 동부,010005, 9세,2021,4852,2520,2332,108.1,4849,2518,2331,108
29003, 동부,015,10~14세,2021,22010,11106,10904,101.9,21997,11100,10897,101.9
29003, 동부,015001, 10세,2021,4761,2456,2305,106.6,4756,2454,2302,106.6
29003, 동부,015002, 11세,2021,4419,2267,2152,105.3,4417,2267,2150,105.4
29003, 동부,015003, 12세,2021,4329,2184,2145,101.8,4327,2183,2144,101.8
29003, 동부,015004, 13세,2021,4335,2142,2193,97.7,4333,2141,2192,97.7
29003, 동부,015005, 14세,2021,4166,2057,2109,97.5,4164,2055,2109,97.4
29003, 동부,020,15~19세,2021,14855,7356,7499,98.1,14842,7353,7489,98.2
29003, 동부,020001, 15세,2021,3726,1878,1848,101.6,3719,1877,1842,101.9
29003, 동부,020002, 16세,2021,3222,1572,1650,95.3,3220,1572,1648,95.4
29003, 동부,020003, 17세,2021,3208,1533,1675,91.5,3207,1533,1674,91.6
29003, 동부,020004, 18세,2021,2822,1353,1469,92.1,2820,1352,1468,92.1
29003, 동부,020005, 19세,2021,1877,1020,857,119,1876,1019,857,118.9
29003, 동부,025,20~24세,2021,9764,5194,4570,113.7,9603,5128,4475,114.6
29003, 동부,025001, 20세,2021,1989,1140,849,134.3,1978,1136,842,134.9
29003, 동부,025002, 21세,2021,2154,1285,869,147.9,2129,1272,857,148.4
29003, 동부,025003, 22세,2021,1832,952,880,108.2,1802,939,863,108.8
29003, 동부,025004, 23세,2021,1803,893,910,98.1,1763,879,884,99.4
29003, 동부,025005, 24세,2021,1986,924,1062,87,1931,902,1029,87.7
29003, 동부,030,25~29세,2021,13643,5960,7683,77.6,13333,5815,7518,77.3
29003, 동부,030001, 25세,2021,2215,948,1267,74.8,2155,927,1228,75.5
29003, 동부,030002, 26세,2021,2334,1050,1284,81.8,2276,1025,1251,81.9
29003, 동부,030003, 27세,2021,2660,1156,1504,76.9,2593,1124,1469,76.5
29003, 동부,030004, 28세,2021,2942,1273,1669,76.3,2888,1245,1643,75.8
29003, 동부,030005, 29세,2021,3492,1533,1959,78.3,3421,1494,1927,77.5
29003, 동부,035,30~34세,2021,20849,9491,11358,83.6,20558,9351,11207,83.4
29003, 동부,035001, 30세,2021,3668,1543,2125,72.6,3629,1523,2106,72.3
29003, 동부,035002, 31세,2021,3850,1736,2114,82.1,3797,1714,2083,82.3
29003, 동부,035003, 32세,2021,4176,1951,2225,87.7,4106,1921,2185,87.9
29003, 동부,035004, 33세,2021,4379,2023,2356,85.9,4318,1997,2321,86
29003, 동부,035005, 34세,2021,4776,2238,2538,88.2,4708,2196,2512,87.4
29003, 동부,040,35~39세,2021,28836,13606,15230,89.3,28521,13469,15052,89.5
29003, 동부,040001, 35세,2021,4997,2364,2633,89.8,4927,2329,2598,89.6
29003, 동부,040002, 36세,2021,5107,2475,2632,94,5035,2440,2595,94
29003, 동부,040003, 37세,2021,5540,2598,2942,88.3,5488,2575,2913,88.4
29003, 동부,040004, 38세,2021,6165,2827,3338,84.7,6110,2807,3303,85
29003, 동부,040005, 39세,2021,7027,3342,3685,90.7,6961,3318,3643,91.1
29003, 동부,045,40~44세,2021,31858,15221,16637,91.5,31703,15165,16538,91.7
29003, 동부,045001, 40세,2021,6864,3247,3617,89.8,6832,3236,3596,90
29003, 동부,045002, 41세,2021,6819,3293,3526,93.4,6804,3290,3514,93.6
29003, 동부,045003, 42세,2021,6645,3158,3487,90.6,6594,3133,3461,90.5
29003, 동부,045004, 43세,2021,5742,2708,3034,89.3,5714,2700,3014,89.6
29003, 동부,045005, 44세,2021,5788,2815,2973,94.7,5759,2806,2953,95
29003, 동부,050,45~49세,2021,26006,13139,12867,102.1,25898,13096,12802,102.3
29003, 동부,050001, 45세,2021,5357,2595,2762,94,5326,2585,2741,94.3
29003, 동부,050002, 46세,2021,5397,2700,2697,100.1,5377,2693,2684,100.3
29003, 동부,050003, 47세,2021,5460,2716,2744,99,5435,2705,2730,99.1
29003, 동부,050004, 48세,2021,5083,2599,2484,104.6,5068,2592,2476,104.7
29003, 동부,050005, 49세,2021,4709,2529,2180,116,4692,2521,2171,116.1
29003, 동부,055,50~54세,2021,19540,10036,9504,105.6,19450,9995,9455,105.7
29003, 동부,055001, 50세,2021,4772,2466,2306,106.9,4749,2458,2291,107.3
29003, 동부,055002, 51세,2021,4133,2163,1970,109.8,4115,2151,1964,109.5
29003, 동부,055003, 52세,2021,3886,1995,1891,105.5,3867,1987,1880,105.7
29003, 동부,055004, 53세,2021,3677,1860,1817,102.4,3661,1854,1807,102.6
29003, 동부,055005, 54세,2021,3072,1552,1520,102.1,3058,1545,1513,102.1
29003, 동부,060,55~59세,2021,12769,6373,6396,99.6,12692,6350,6342,100.1
29003, 동부,060001, 55세,2021,2753,1385,1368,101.2,2741,1379,1362,101.2
29003, 동부,060002, 56세,2021,2696,1324,1372,96.5,2682,1319,1363,96.8
29003, 동부,060003, 57세,2021,2438,1224,1214,100.8,2416,1217,1199,101.5
29003, 동부,060004, 58세,2021,2440,1239,1201,103.2,2424,1237,1187,104.2
29003, 동부,060005, 59세,2021,2442,1201,1241,96.8,2429,1198,1231,97.3
29003, 동부,065,60~64세,2021,11054,5299,5755,92.1,10980,5264,5716,92.1
29003, 동부,065001, 60세,2021,2616,1259,1357,92.8,2601,1252,1349,92.8
29003, 동부,065002, 61세,2021,2385,1103,1282,86,2369,1096,1273,86.1
29003, 동부,065003, 62세,2021,2188,1068,1120,95.4,2173,1062,1111,95.6
29003, 동부,065004, 63세,2021,1992,949,1043,91,1976,940,1036,90.7
29003, 동부,065005, 64세,2021,1873,920,953,96.5,1861,914,947,96.5
29003, 동부,070,65~69세,2021,6867,3277,3590,91.3,6834,3265,3569,91.5
29003, 동부,070001, 65세,2021,1695,812,883,92,1687,810,877,92.4
29003, 동부,070002, 66세,2021,1647,780,867,90,1636,777,859,90.5
29003, 동부,070003, 67세,2021,1333,616,717,85.9,1329,614,715,85.9
29003, 동부,070004, 68세,2021,1052,531,521,101.9,1045,527,518,101.7
29003, 동부,070005, 69세,2021,1140,538,602,89.4,1137,537,600,89.5
29003, 동부,075,70~74세,2021,3914,1883,2031,92.7,3899,1875,2024,92.6
29003, 동부,075001, 70세,2021,776,362,414,87.4,772,362,410,88.3
29003, 동부,075002, 71세,2021,871,424,447,94.9,867,421,446,94.4
29003, 동부,075003, 72세,2021,844,399,445,89.7,839,396,443,89.4
29003, 동부,075004, 73세,2021,731,381,350,108.9,730,380,350,108.6
29003, 동부,075005, 74세,2021,692,317,375,84.5,691,316,375,84.3
29003, 동부,080,75~79세,2021,2194,1057,1137,93,2186,1054,1132,93.1
29003, 동부,080001, 75세,2021,487,253,234,108.1,483,251,232,108.2
29003, 동부,080002, 76세,2021,451,219,232,94.4,451,219,232,94.4
29003, 동부,080003, 77세,2021,430,205,225,91.1,429,205,224,91.5
29003, 동부,080004, 78세,2021,395,188,207,90.8,392,187,205,91.2
29003, 동부,080005, 79세,2021,431,192,239,80.3,431,192,239,80.3
29003, 동부,085,80~84세,2021,1253,440,813,54.1,1249,439,810,54.2
29003, 동부,085001, 80세,2021,332,140,192,72.9,331,139,192,72.4
29003, 동부,085002, 81세,2021,258,95,163,58.3,257,95,162,58.6
29003, 동부,085003, 82세,2021,252,84,168,50,252,84,168,50
29003, 동부,085004, 83세,2021,231,68,163,41.7,229,68,161,42.2
29003, 동부,085005, 84세,2021,180,53,127,41.7,180,53,127,41.7
29003, 동부,090,85~89세,2021,709,189,520,36.3,704,186,518,35.9
29003, 동부,090001, 85세,2021,179,60,119,50.4,177,58,119,48.7
29003, 동부,090002, 86세,2021,174,40,134,29.9,174,40,134,29.9
29003, 동부,090003, 87세,2021,144,45,99,45.5,142,45,97,46.4
29003, 동부,090004, 88세,2021,109,28,81,34.6,108,27,81,33.3
29003, 동부,090005, 89세,2021,103,16,87,18.4,103,16,87,18.4
29003, 동부,095,90~94세,2021,267,56,211,26.5,266,56,210,26.7
29003, 동부,095001, 90세,2021,74,23,51,45.1,74,23,51,45.1
29003, 동부,095002, 91세,2021,62,7,55,12.7,61,7,54,13
29003, 동부,095003, 92세,2021,58,17,41,41.5,58,17,41,41.5
29003, 동부,095004, 93세,2021,50,8,42,19,50,8,42,19
29003, 동부,095005, 94세,2021,23,X,22,4.5,23,X,22,4.5
29003, 동부,100,95~99세,2021,46,10,36,27.8,46,10,36,27.8
29003, 동부,100001, 95세,2021,15,X,12,25,15,X,12,25
29003, 동부,100002, 96세,2021,11,X,9,22.2,11,X,9,22.2
29003, 동부,100003, 97세,2021,8,X,6,33.3,8,X,6,33.3
29003, 동부,100004, 98세,2021,6,X,6,0,6,X,6,0
29003, 동부,100005, 99세,2021,6,X,X,100,6,X,X,100
29003, 동부,101,100세이상,2021,5,X,X,25,5,X,X,25
29003, 동부,102,15세미만,2021,63648,32368,31280,103.5,63582,32334,31248,103.5
29003, 동부,103,15~64세,2021,189174,91675,97499,94,187580,90986,96594,94.2
29003, 동부,104,65세이상,2021,15255,6913,8342,82.9,15189,6886,8303,82.9
29003, 동부,086,85세이상,2021,1027,256,771,33.2,1021,253,768,32.9
29003, 동부,126,평균연령,2021,34.5,34.1,34.9,,34.5,34.1,34.9,
29003, 동부,127,중위연령,2021,37.2,37.1,37.3,,37.2,37.1,37.3,
29010, 세종시,000,합계,2021,366227,183616,182611,100.6,359236,179460,179776,99.8
29010, 세종시,005,0~4세,2021,20047,10169,9878,102.9,19953,10124,9829,103
29010, 세종시,005001, 0세,2021,3603,1802,1801,100.1,3585,1795,1790,100.3
29010, 세종시,005002, 1세,2021,3523,1789,1734,103.2,3509,1782,1727,103.2
29010, 세종시,005003, 2세,2021,3984,2034,1950,104.3,3965,2024,1941,104.3
29010, 세종시,005004, 3세,2021,4266,2173,2093,103.8,4244,2163,2081,103.9
29010, 세종시,005005, 4세,2021,4671,2371,2300,103.1,4650,2360,2290,103.1
29010, 세종시,010,5~9세,2021,26421,13545,12876,105.2,26337,13504,12833,105.2
29010, 세종시,010001, 5세,2021,5132,2623,2509,104.5,5109,2613,2496,104.7
29010, 세종시,010002, 6세,2021,5343,2704,2639,102.5,5330,2699,2631,102.6
29010, 세종시,010003, 7세,2021,5171,2690,2481,108.4,5154,2679,2475,108.2
29010, 세종시,010004, 8세,2021,5258,2663,2595,102.6,5239,2656,2583,102.8
29010, 세종시,010005, 9세,2021,5517,2865,2652,108,5505,2857,2648,107.9
29010, 세종시,015,10~14세,2021,25139,12714,12425,102.3,25102,12700,12402,102.4
29010, 세종시,015001, 10세,2021,5363,2778,2585,107.5,5353,2773,2580,107.5
29010, 세종시,015002, 11세,2021,5070,2602,2468,105.4,5061,2600,2461,105.6
29010, 세종시,015003, 12세,2021,4908,2487,2421,102.7,4901,2484,2417,102.8
29010, 세종시,015004, 13세,2021,5039,2489,2550,97.6,5034,2488,2546,97.7
29010, 세종시,015005, 14세,2021,4759,2358,2401,98.2,4753,2355,2398,98.2
29010, 세종시,020,15~19세,2021,19452,9719,9733,99.9,19274,9638,9636,100
29010, 세종시,020001, 15세,2021,4304,2170,2134,101.7,4292,2168,2124,102.1
29010, 세종시,020002, 16세,2021,3814,1881,1933,97.3,3811,1880,1931,97.4
29010, 세종시,020003, 17세,2021,3899,1911,1988,96.1,3888,1906,1982,96.2
29010, 세종시,020004, 18세,2021,3770,1868,1902,98.2,3684,1831,1853,98.8
29010, 세종시,020005, 19세,2021,3665,1889,1776,106.4,3599,1853,1746,106.1
29010, 세종시,025,20~24세,2021,19793,10415,9378,111.1,18836,9842,8994,109.4
29010, 세종시,025001, 20세,2021,4019,2043,1976,103.4,3925,1986,1939,102.4
29010, 세종시,025002, 21세,2021,4229,2188,2041,107.2,4019,2062,1957,105.4
29010, 세종시,025003, 22세,2021,3800,1954,1846,105.9,3600,1827,1773,103
29010, 세종시,025004, 23세,2021,3836,2077,1759,118.1,3625,1958,1667,117.5
29010, 세종시,025005, 24세,2021,3909,2153,1756,122.6,3667,2009,1658,121.2
29010, 세종시,030,25~29세,2021,21559,11192,10367,108,20285,10349,9936,104.2
29010, 세종시,030001, 25세,2021,3992,2175,1817,119.7,3745,2006,1739,115.4
29010, 세종시,030002, 26세,2021,4035,2187,1848,118.3,3778,2016,1762,114.4
29010, 세종시,030003, 27세,2021,4211,2190,2021,108.4,3927,2014,1913,105.3
29010, 세종시,030004, 28세,2021,4442,2227,2215,100.5,4214,2073,2141,96.8
29010, 세종시,030005, 29세,2021,4879,2413,2466,97.9,4621,2240,2381,94.1
29010, 세종시,035,30~34세,2021,26697,13158,13539,97.2,25605,12444,13161,94.6
29010, 세종시,035001, 30세,2021,4976,2383,2593,91.9,4769,2236,2533,88.3
29010, 세종시,035002, 31세,2021,5117,2540,2577,98.6,4891,2389,2502,95.5
29010, 세종시,035003, 32세,2021,5250,2608,2642,98.7,5023,2470,2553,96.7
29010, 세종시,035004, 33세,2021,5518,2754,2764,99.6,5298,2617,2681,97.6
29010, 세종시,035005, 34세,2021,5836,2873,2963,97,5624,2732,2892,94.5
29010, 세종시,040,35~39세,2021,34311,16848,17463,96.5,33387,16273,17114,95.1
29010, 세종시,040001, 35세,2021,6042,2993,3049,98.2,5819,2846,2973,95.7
29010, 세종시,040002, 36세,2021,6124,3109,3015,103.1,5923,2975,2948,100.9
29010, 세종시,040003, 37세,2021,6598,3232,3366,96,6434,3132,3302,94.9
29010, 세종시,040004, 38세,2021,7242,3429,3813,89.9,7076,3334,3742,89.1
29010, 세종시,040005, 39세,2021,8305,4085,4220,96.8,8135,3986,4149,96.1
29010, 세종시,045,40~44세,2021,37893,18750,19143,97.9,37293,18411,18882,97.5
29010, 세종시,045001, 40세,2021,8047,3924,4123,95.2,7914,3842,4072,94.4
29010, 세종시,045002, 41세,2021,8095,4019,4076,98.6,7978,3954,4024,98.3
29010, 세종시,045003, 42세,2021,7858,3887,3971,97.9,7715,3797,3918,96.9
29010, 세종시,045004, 43세,2021,6877,3395,3482,97.5,6775,3344,3431,97.5
29010, 세종시,045005, 44세,2021,7016,3525,3491,101,6911,3474,3437,101.1
29010, 세종시,050,45~49세,2021,32533,16889,15644,108,32075,16630,15445,107.7
29010, 세종시,050001, 45세,2021,6495,3231,3264,99,6404,3184,3220,98.9
29010, 세종시,050002, 46세,2021,6648,3428,3220,106.5,6560,3378,3182,106.2
29010, 세종시,050003, 47세,2021,6852,3537,3315,106.7,6755,3476,3279,106
29010, 세종시,050004, 48세,2021,6500,3379,3121,108.3,6417,3338,3079,108.4
29010, 세종시,050005, 49세,2021,6038,3314,2724,121.7,5939,3254,2685,121.2
29010, 세종시,055,50~54세,2021,27097,14247,12850,110.9,26657,14007,12650,110.7
29010, 세종시,055001, 50세,2021,6325,3366,2959,113.8,6224,3313,2911,113.8
29010, 세종시,055002, 51세,2021,5604,3005,2599,115.6,5505,2952,2553,115.6
29010, 세종시,055003, 52세,2021,5488,2901,2587,112.1,5399,2849,2550,111.7
29010, 세종시,055004, 53세,2021,5177,2681,2496,107.4,5096,2638,2458,107.3
29010, 세종시,055005, 54세,2021,4503,2294,2209,103.8,4433,2255,2178,103.5
29010, 세종시,060,55~59세,2021,20287,10434,9853,105.9,19914,10240,9674,105.9
29010, 세종시,060001, 55세,2021,4140,2133,2007,106.3,4065,2090,1975,105.8
29010, 세종시,060002, 56세,2021,4289,2209,2080,106.2,4224,2164,2060,105
29010, 세종시,060003, 57세,2021,3859,1999,1860,107.5,3775,1958,1817,107.8
29010, 세종시,060004, 58세,2021,3952,2043,1909,107,3866,2004,1862,107.6
29010, 세종시,060005, 59세,2021,4047,2050,1997,102.7,3984,2024,1960,103.3
29010, 세종시,065,60~64세,2021,19271,9589,9682,99,19015,9460,9555,99
29010, 세종시,065001, 60세,2021,4479,2255,2224,101.4,4432,2233,2199,101.5
29010, 세종시,065002, 61세,2021,4170,2049,2121,96.6,4109,2017,2092,96.4
29010, 세종시,065003, 62세,2021,3780,1887,1893,99.7,3725,1859,1866,99.6
29010, 세종시,065004, 63세,2021,3459,1705,1754,97.2,3412,1681,1731,97.1
29010, 세종시,065005, 64세,2021,3383,1693,1690,100.2,3337,1670,1667,100.2
29010, 세종시,070,65~69세,2021,13331,6572,6759,97.2,13199,6501,6698,97.1
29010, 세종시,070001, 65세,2021,3122,1560,1562,99.9,3091,1543,1548,99.7
29010, 세종시,070002, 66세,2021,3205,1587,1618,98.1,3164,1567,1597,98.1
29010, 세종시,070003, 67세,2021,2591,1248,1343,92.9,2569,1238,1331,93
29010, 세종시,070004, 68세,2021,2080,1052,1028,102.3,2057,1036,1021,101.5
29010, 세종시,070005, 69세,2021,2333,1125,1208,93.1,2318,1117,1201,93
29010, 세종시,075,70~74세,2021,8462,4089,4373,93.5,8406,4063,4343,93.6
29010, 세종시,075001, 70세,2021,1647,787,860,91.5,1636,783,853,91.8
29010, 세종시,075002, 71세,2021,1851,934,917,101.9,1835,925,910,101.6
29010, 세종시,075003, 72세,2021,1866,892,974,91.6,1853,885,968,91.4
29010, 세종시,075004, 73세,2021,1595,789,806,97.9,1585,786,799,98.4
29010, 세종시,075005, 74세,2021,1503,687,816,84.2,1497,684,813,84.1
29010, 세종시,080,75~79세,2021,5869,2612,3257,80.2,5851,2605,3246,80.3
29010, 세종시,080001, 75세,2021,1173,556,617,90.1,1165,553,612,90.4
29010, 세종시,080002, 76세,2021,1095,500,595,84,1095,500,595,84
29010, 세종시,080003, 77세,2021,1145,487,658,74,1143,486,657,74
29010, 세종시,080004, 78세,2021,1104,484,620,78.1,1097,482,615,78.4
29010, 세종시,080005, 79세,2021,1352,585,767,76.3,1351,584,767,76.1
29010, 세종시,085,80~84세,2021,4387,1646,2741,60.1,4379,1644,2735,60.1
29010, 세종시,085001, 80세,2021,1066,428,638,67.1,1064,427,637,67
29010, 세종시,085002, 81세,2021,889,336,553,60.8,887,336,551,61
29010, 세종시,085003, 82세,2021,920,336,584,57.5,920,336,584,57.5
29010, 세종시,085004, 83세,2021,820,303,517,58.6,816,302,514,58.8
29010, 세종시,085005, 84세,2021,692,243,449,54.1,692,243,449,54.1
29010, 세종시,090,85~89세,2021,2587,793,1794,44.2,2579,790,1789,44.2
29010, 세종시,090001, 85세,2021,680,239,441,54.2,678,237,441,53.7
29010, 세종시,090002, 86세,2021,620,194,426,45.5,618,194,424,45.8
29010, 세종시,090003, 87세,2021,522,176,346,50.9,519,176,343,51.3
29010, 세종시,090004, 88세,2021,414,109,305,35.7,413,108,305,35.4
29010, 세종시,090005, 89세,2021,351,75,276,27.2,351,75,276,27.2
29010, 세종시,095,90~94세,2021,897,202,695,29.1,895,202,693,29.1
29010, 세종시,095001, 90세,2021,260,73,187,39,260,73,187,39
29010, 세종시,095002, 91세,2021,222,48,174,27.6,221,48,173,27.7
29010, 세종시,095003, 92세,2021,184,37,147,25.2,184,37,147,25.2
29010, 세종시,095004, 93세,2021,135,25,110,22.7,134,25,109,22.9
29010, 세종시,095005, 94세,2021,96,19,77,24.7,96,19,77,24.7
29010, 세종시,100,95~99세,2021,174,29,145,20,174,29,145,20
29010, 세종시,100001, 95세,2021,54,11,43,25.6,54,11,43,25.6
29010, 세종시,100002, 96세,2021,49,7,42,16.7,49,7,42,16.7
29010, 세종시,100003, 97세,2021,29,X,25,16,29,X,25,16
29010, 세종시,100004, 98세,2021,23,X,20,15,23,X,20,15
29010, 세종시,100005, 99세,2021,19,X,15,26.7,19,X,15,26.7
29010, 세종시,101,100세이상,2021,20,X,16,25,20,X,16,25
29010, 세종시,102,15세미만,2021,71607,36428,35179,103.6,71392,36328,35064,103.6
29010, 세종시,103,15~64세,2021,258893,131241,127652,102.8,252341,127294,125047,101.8
29010, 세종시,104,65세이상,2021,35727,15947,19780,80.6,35503,15838,19665,80.5
29010, 세종시,086,85세이상,2021,3678,1028,2650,38.8,3668,1025,2643,38.8
29010, 세종시,126,평균연령,2021,37.4,36.9,37.9,,37.4,36.9,37.9,
29010, 세종시,127,중위연령,2021,38.7,38.5,39,,38.9,38.7,39,
31,경기도,000,합계,2021,13652529,6898723,6753806,102.1,13081325,6571118,6510207,100.9
31,경기도,005,0~4세,2021,466012,238704,227308,105,451883,231551,220332,105.1
31,경기도,005001, 0세,2021,79470,40599,38871,104.4,77242,39484,37758,104.6
31,경기도,005002, 1세,2021,84256,42752,41504,103,81653,41441,40212,103.1
31,경기도,005003, 2세,2021,92817,47722,45095,105.8,89716,46133,43583,105.9
31,경기도,005004, 3세,2021,100473,51530,48943,105.3,97352,49921,47431,105.2
31,경기도,005005, 4세,2021,108996,56101,52895,106.1,105920,54572,51348,106.3
31,경기도,010,5~9세,2021,644943,329755,315188,104.6,632772,323665,309107,104.7
31,경기도,010001, 5세,2021,123473,63098,60375,104.5,120182,61423,58759,104.5
31,경기도,010002, 6세,2021,129292,66296,62996,105.2,126644,64939,61705,105.2
31,경기도,010003, 7세,2021,126817,64672,62145,104.1,124491,63541,60950,104.3
31,경기도,010004, 8세,2021,127102,64806,62296,104,125056,63805,61251,104.2
31,경기도,010005, 9세,2021,138259,70883,67376,105.2,136399,69957,66442,105.3
31,경기도,015,10~14세,2021,656852,336690,320162,105.2,650140,333248,316892,105.2
31,경기도,015001, 10세,2021,135061,69203,65858,105.1,133497,68361,65136,105
31,경기도,015002, 11세,2021,129951,66836,63115,105.9,128542,66126,62416,105.9
31,경기도,015003, 12세,2021,125512,64389,61123,105.3,124180,63726,60454,105.4
31,경기도,015004, 13세,2021,132193,67635,64558,104.8,130930,66988,63942,104.8
31,경기도,015005, 14세,2021,134135,68627,65508,104.8,132991,68047,64944,104.8
31,경기도,020,15~19세,2021,624696,320223,304473,105.2,618523,317276,301247,105.3
31,경기도,020001, 15세,2021,121954,62619,59335,105.5,120967,62126,58841,105.6
31,경기도,020002, 16세,2021,118218,60336,57882,104.2,117364,59935,57429,104.4
31,경기도,020003, 17세,2021,127587,65264,62323,104.7,126686,64817,61869,104.8
31,경기도,020004, 18세,2021,128238,65760,62478,105.3,127120,65229,61891,105.4
31,경기도,020005, 19세,2021,128699,66244,62455,106.1,126386,65169,61217,106.5
31,경기도,025,20~24세,2021,820998,430376,390622,110.2,787648,411359,376289,109.3
31,경기도,025001, 20세,2021,148127,77700,70427,110.3,144465,76033,68432,111.1
31,경기도,025002, 21세,2021,163535,86845,76690,113.2,158499,84328,74171,113.7
31,경기도,025003, 22세,2021,159813,84287,75526,111.6,153576,80805,72771,111
31,경기도,025004, 23세,2021,169786,88110,81676,107.9,161392,83103,78289,106.1
31,경기도,025005, 24세,2021,179737,93434,86303,108.3,169716,87090,82626,105.4
31,경기도,030,25~29세,2021,988655,535522,453133,118.2,920787,491219,429568,114.4
31,경기도,030001, 25세,2021,187878,100012,87866,113.8,176486,92673,83813,110.6
31,경기도,030002, 26세,2021,194735,105332,89403,117.8,181910,96928,84982,114.1
31,경기도,030003, 27세,2021,198184,108140,90044,120.1,184824,99334,85490,116.2
31,경기도,030004, 28세,2021,201477,109810,91667,119.8,186863,100298,86565,115.9
31,경기도,030005, 29세,2021,206381,112228,94153,119.2,190704,101986,88718,115
31,경기도,035,30~34세,2021,944395,503662,440733,114.3,856307,448179,408128,109.8
31,경기도,035001, 30세,2021,196878,106008,90870,116.7,180804,95681,85123,112.4
31,경기도,035002, 31세,2021,189042,101321,87721,115.5,171257,90032,81225,110.8
31,경기도,035003, 32세,2021,186683,100028,86655,115.4,168852,88761,80091,110.8
31,경기도,035004, 33세,2021,185073,98006,87067,112.6,167000,86869,80131,108.4
31,경기도,035005, 34세,2021,186719,98299,88420,111.2,168394,86836,81558,106.5
31,경기도,040,35~39세,2021,1048051,547566,500485,109.4,969980,499139,470841,106
31,경기도,040001, 35세,2021,189895,99991,89904,111.2,172348,89197,83151,107.3
31,경기도,040002, 36세,2021,194240,101864,92376,110.3,177813,91640,86173,106.3
31,경기도,040003, 37세,2021,201495,105460,96035,109.8,186000,95760,90240,106.1
31,경기도,040004, 38세,2021,221603,115342,106261,108.5,207346,106467,100879,105.5
31,경기도,040005, 39세,2021,240818,124909,115909,107.8,226473,116075,110398,105.1
31,경기도,045,40~44세,2021,1144257,588866,555391,106,1089476,555272,534204,103.9
31,경기도,045001, 40세,2021,240525,124839,115686,107.9,228400,117304,111096,105.6
31,경기도,045002, 41세,2021,243871,125453,118418,105.9,232313,118282,114031,103.7
31,경기도,045003, 42세,2021,231215,118732,112483,105.6,219572,111629,107943,103.4
31,경기도,045004, 43세,2021,211159,108703,102456,106.1,200905,102449,98456,104.1
31,경기도,045005, 44세,2021,217487,111139,106348,104.5,208286,105608,102678,102.9
31,경기도,050,45~49세,2021,1158611,590700,567911,104,1112873,564307,548566,102.9
31,경기도,050001, 45세,2021,212332,109249,103083,106,203183,103747,99436,104.3
31,경기도,050002, 46세,2021,221268,112530,108738,103.5,212782,107631,105151,102.4
31,경기도,050003, 47세,2021,239880,122307,117573,104,231235,117352,113883,103
31,경기도,050004, 48세,2021,241249,121786,119463,101.9,231803,116493,115310,101
31,경기도,050005, 49세,2021,243882,124828,119054,104.8,233870,119084,114786,103.7
31,경기도,055,50~54세,2021,1214132,608361,605771,100.4,1165738,582387,583351,99.8
31,경기도,055001, 50세,2021,256688,130232,126456,103,246282,124496,121786,102.2
31,경기도,055002, 51세,2021,246319,124734,121585,102.6,235757,118972,116785,101.9
31,경기도,055003, 52세,2021,248334,124117,124217,99.9,238597,118996,119601,99.5
31,경기도,055004, 53세,2021,243103,120462,122641,98.2,233399,115275,118124,97.6
31,경기도,055005, 54세,2021,219688,108816,110872,98.1,211703,104648,107055,97.8
31,경기도,060,55~59세,2021,1071438,544215,527223,103.2,1023745,520151,503594,103.3
31,경기도,060001, 55세,2021,215182,109844,105338,104.3,206235,105284,100951,104.3
31,경기도,060002, 56세,2021,222367,112136,110231,101.7,212585,107143,105442,101.6
31,경기도,060003, 57세,2021,205488,104165,101323,102.8,196131,99394,96737,102.7
31,경기도,060004, 58세,2021,215921,110276,105645,104.4,204701,104671,100030,104.6
31,경기도,060005, 59세,2021,212480,107794,104686,103,204093,103659,100434,103.2
31,경기도,065,60~64세,2021,994733,497454,497279,100,961570,481524,480046,100.3
31,경기도,065001, 60세,2021,225379,112675,112704,100,220017,110178,109839,100.3
31,경기도,065002, 61세,2021,220195,109886,110309,99.6,212179,105977,106202,99.8
31,경기도,065003, 62세,2021,195013,97734,97279,100.5,188509,94621,93888,100.8
31,경기도,065004, 63세,2021,181486,91253,90233,101.1,174772,87997,86775,101.4
31,경기도,065005, 64세,2021,172660,85906,86754,99,166093,82751,83342,99.3
31,경기도,070,65~69세,2021,670633,326755,343878,95,649907,317073,332834,95.3
31,경기도,070001, 65세,2021,154516,76229,78287,97.4,149075,73634,75441,97.6
31,경기도,070002, 66세,2021,156280,76037,80243,94.8,151398,73712,77686,94.9
31,경기도,070003, 67세,2021,128429,62567,65862,95,124233,60623,63610,95.3
31,경기도,070004, 68세,2021,111362,53828,57534,93.6,108005,52315,55690,93.9
31,경기도,070005, 69세,2021,120046,58094,61952,93.8,117196,56789,60407,94
31,경기도,075,70~74세,2021,437113,204609,232504,88,428985,201174,227811,88.3
31,경기도,075001, 70세,2021,80791,38345,42446,90.3,78435,37308,41127,90.7
31,경기도,075002, 71세,2021,89706,42143,47563,88.6,87789,41322,46467,88.9
31,경기도,075003, 72세,2021,90033,42366,47667,88.9,88351,41667,46684,89.3
31,경기도,075004, 73세,2021,87830,41104,46726,88,86716,40641,46075,88.2
31,경기도,075005, 74세,2021,88753,40651,48102,84.5,87694,40236,47458,84.8
31,경기도,080,75~79세,2021,335499,146234,189265,77.3,332463,145286,187177,77.6
31,경기도,080001, 75세,2021,68545,31155,37390,83.3,67742,30887,36855,83.8
31,경기도,080002, 76세,2021,65539,29273,36266,80.7,64932,29058,35874,81
31,경기도,080003, 77세,2021,64334,27796,36538,76.1,63755,27612,36143,76.4
31,경기도,080004, 78세,2021,64054,27197,36857,73.8,63510,27062,36448,74.2
31,경기도,080005, 79세,2021,73027,30813,42214,73,72524,30667,41857,73.3
31,경기도,085,80~84세,2021,244882,95085,149797,63.5,242920,94574,148346,63.8
31,경기도,085001, 80세,2021,58683,24138,34545,69.9,58168,23994,34174,70.2
31,경기도,085002, 81세,2021,51938,20681,31257,66.2,51502,20561,30941,66.5
31,경기도,085003, 82세,2021,50200,19334,30866,62.6,49816,19249,30567,63
31,경기도,085004, 83세,2021,44541,16682,27859,59.9,44188,16600,27588,60.2
31,경기도,085005, 84세,2021,39520,14250,25270,56.4,39246,14170,25076,56.5
31,경기도,090,85~89세,2021,129493,40906,88587,46.2,128722,40731,87991,46.3
31,경기도,090001, 85세,2021,34787,11955,22832,52.4,34537,11896,22641,52.5
31,경기도,090002, 86세,2021,31440,10166,21274,47.8,31257,10127,21130,47.9
31,경기도,090003, 87세,2021,25385,7959,17426,45.7,25235,7926,17309,45.8
31,경기도,090004, 88세,2021,20572,5987,14585,41,20459,5959,14500,41.1
31,경기도,090005, 89세,2021,17309,4839,12470,38.8,17234,4823,12411,38.9
31,경기도,095,90~94세,2021,45383,10738,34645,31,45182,10710,34472,31.1
31,경기도,095001, 90세,2021,12807,3327,9480,35.1,12740,3320,9420,35.2
31,경기도,095002, 91세,2021,11457,2746,8711,31.5,11409,2741,8668,31.6
31,경기도,095003, 92세,2021,9149,2184,6965,31.4,9104,2176,6928,31.4
31,경기도,095004, 93세,2021,6975,1500,5475,27.4,6948,1493,5455,27.4
31,경기도,095005, 94세,2021,4995,981,4014,24.4,4981,980,4001,24.5
31,경기도,100,95~99세,2021,10191,2013,8178,24.6,10148,2006,8142,24.6
31,경기도,100001, 95세,2021,3380,639,2741,23.3,3368,636,2732,23.3
31,경기도,100002, 96세,2021,2594,452,2142,21.1,2587,451,2136,21.1
31,경기도,100003, 97세,2021,1676,362,1314,27.5,1665,360,1305,27.6
31,경기도,100004, 98세,2021,1539,350,1189,29.4,1531,349,1182,29.5
31,경기도,100005, 99세,2021,1002,210,792,26.5,997,210,787,26.7
31,경기도,101,100세이상,2021,1562,289,1273,22.7,1556,287,1269,22.6
31,경기도,102,15세미만,2021,1767807,905149,862658,104.9,1734795,888464,846331,105
31,경기도,103,15~64세,2021,10009966,5166945,4843021,106.7,9506647,4870813,4635834,105.1
31,경기도,104,65세이상,2021,1874756,826629,1048127,78.9,1839883,811841,1028042,79
31,경기도,086,85세이상,2021,186629,53946,132683,40.7,185608,53734,131874,40.7
31,경기도,126,평균연령,2021,41.9,40.9,42.8,,41.9,41,42.9,
31,경기도,127,중위연령,2021,42.6,41.7,43.8,,42.9,42,43.9,
31004, 읍부,000,합계,2021,1535737,797737,738000,108.1,1452906,745126,707780,105.3
31004, 읍부,005,0~4세,2021,50998,26181,24817,105.5,49391,25381,24010,105.7
31004, 읍부,005001, 0세,2021,8178,4196,3982,105.4,7908,4061,3847,105.6
31004, 읍부,005002, 1세,2021,9337,4769,4568,104.4,9027,4609,4418,104.3
31004, 읍부,005003, 2세,2021,10088,5300,4788,110.7,9752,5123,4629,110.7
31004, 읍부,005004, 3세,2021,11240,5749,5491,104.7,10874,5569,5305,105
31004, 읍부,005005, 4세,2021,12155,6167,5988,103,11830,6019,5811,103.6
31004, 읍부,010,5~9세,2021,73482,37577,35905,104.7,72037,36872,35165,104.9
31004, 읍부,010001, 5세,2021,13877,7149,6728,106.3,13510,6976,6534,106.8
31004, 읍부,010002, 6세,2021,14426,7500,6926,108.3,14113,7335,6778,108.2
31004, 읍부,010003, 7세,2021,14419,7292,7127,102.3,14141,7162,6979,102.6
31004, 읍부,010004, 8세,2021,14580,7453,7127,104.6,14334,7337,6997,104.9
31004, 읍부,010005, 9세,2021,16180,8183,7997,102.3,15939,8062,7877,102.3
31004, 읍부,015,10~14세,2021,77919,39981,37938,105.4,77063,39539,37524,105.4
31004, 읍부,015001, 10세,2021,16053,8254,7799,105.8,15861,8152,7709,105.7
31004, 읍부,015002, 11세,2021,15375,7894,7481,105.5,15208,7814,7394,105.7
31004, 읍부,015003, 12세,2021,14809,7556,7253,104.2,14639,7464,7175,104
31004, 읍부,015004, 13세,2021,15845,8161,7684,106.2,15673,8074,7599,106.3
31004, 읍부,015005, 14세,2021,15837,8116,7721,105.1,15682,8035,7647,105.1
31004, 읍부,020,15~19세,2021,72242,37014,35228,105.1,71509,36673,34836,105.3
31004, 읍부,020001, 15세,2021,14451,7443,7008,106.2,14314,7370,6944,106.1
31004, 읍부,020002, 16세,2021,14086,7342,6744,108.9,13968,7296,6672,109.4
31004, 읍부,020003, 17세,2021,14813,7609,7204,105.6,14693,7545,7148,105.6
31004, 읍부,020004, 18세,2021,14445,7271,7174,101.4,14285,7202,7083,101.7
31004, 읍부,020005, 19세,2021,14447,7349,7098,103.5,14249,7260,6989,103.9
31004, 읍부,025,20~24세,2021,87012,47178,39834,118.4,81784,43886,37898,115.8
31004, 읍부,025001, 20세,2021,16132,8394,7738,108.5,15805,8253,7552,109.3
31004, 읍부,025002, 21세,2021,17214,9466,7748,122.2,16639,9188,7451,123.3
31004, 읍부,025003, 22세,2021,16867,9087,7780,116.8,15904,8498,7406,114.7
31004, 읍부,025004, 23세,2021,17842,9718,8124,119.6,16359,8742,7617,114.8
31004, 읍부,025005, 24세,2021,18957,10513,8444,124.5,17077,9205,7872,116.9
31004, 읍부,030,25~29세,2021,103579,60579,43000,140.9,90186,50768,39418,128.8
31004, 읍부,030001, 25세,2021,19872,11338,8534,132.9,17618,9685,7933,122.1
31004, 읍부,030002, 26세,2021,20477,11993,8484,141.4,17908,10117,7791,129.9
31004, 읍부,030003, 27세,2021,20665,12228,8437,144.9,17965,10206,7759,131.5
31004, 읍부,030004, 28세,2021,20931,12300,8631,142.5,18066,10243,7823,130.9
31004, 읍부,030005, 29세,2021,21634,12720,8914,142.7,18629,10517,8112,129.6
31004, 읍부,035,30~34세,2021,99587,56691,42896,132.2,84246,45911,38335,119.8
31004, 읍부,035001, 30세,2021,20409,11823,8586,137.7,17514,9750,7764,125.6
31004, 읍부,035002, 31세,2021,20007,11525,8482,135.9,16807,9239,7568,122.1
31004, 읍부,035003, 32세,2021,19606,11219,8387,133.8,16477,9036,7441,121.4
31004, 읍부,035004, 33세,2021,19556,11014,8542,128.9,16489,8894,7595,117.1
31004, 읍부,035005, 34세,2021,20009,11110,8899,124.8,16959,8992,7967,112.9
31004, 읍부,040,35~39세,2021,115910,62781,53129,118.2,103050,54098,48952,110.5
31004, 읍부,040001, 35세,2021,20402,11132,9270,120.1,17546,9207,8339,110.4
31004, 읍부,040002, 36세,2021,21255,11692,9563,122.3,18510,9810,8700,112.8
31004, 읍부,040003, 37세,2021,22292,12136,10156,119.5,19742,10388,9354,111.1
31004, 읍부,040004, 38세,2021,24707,13319,11388,117,22311,11685,10626,110
31004, 읍부,040005, 39세,2021,27254,14502,12752,113.7,24941,13008,11933,109
31004, 읍부,045,40~44세,2021,132605,70243,62362,112.6,123929,64569,59360,108.8
31004, 읍부,045001, 40세,2021,27545,14977,12568,119.2,25516,13601,11915,114.2
31004, 읍부,045002, 41세,2021,28043,14795,13248,111.7,26200,13589,12611,107.8
31004, 읍부,045003, 42세,2021,26795,14089,12706,110.9,24968,12919,12049,107.2
31004, 읍부,045004, 43세,2021,24811,13069,11742,111.3,23227,12006,11221,107
31004, 읍부,045005, 44세,2021,25411,13313,12098,110,24018,12454,11564,107.7
31004, 읍부,050,45~49세,2021,133269,70889,62380,113.6,127023,67214,59809,112.4
31004, 읍부,050001, 45세,2021,24612,13020,11592,112.3,23278,12202,11076,110.2
31004, 읍부,050002, 46세,2021,25802,13680,12122,112.9,24597,12941,11656,111
31004, 읍부,050003, 47세,2021,27528,14700,12828,114.6,26326,13976,12350,113.2
31004, 읍부,050004, 48세,2021,27624,14568,13056,111.6,26408,13898,12510,111.1
31004, 읍부,050005, 49세,2021,27703,14921,12782,116.7,26414,14197,12217,116.2
31004, 읍부,055,50~54세,2021,133107,69936,63171,110.7,127437,66774,60663,110.1
31004, 읍부,055001, 50세,2021,28373,15164,13209,114.8,27110,14430,12680,113.8
31004, 읍부,055002, 51세,2021,27006,14406,12600,114.3,25729,13670,12059,113.4
31004, 읍부,055003, 52세,2021,27267,14195,13072,108.6,26127,13570,12557,108.1
31004, 읍부,055004, 53세,2021,26517,13758,12759,107.8,25424,13194,12230,107.9
31004, 읍부,055005, 54세,2021,23944,12413,11531,107.6,23047,11910,11137,106.9
31004, 읍부,060,55~59세,2021,118186,62012,56174,110.4,113419,59536,53883,110.5
31004, 읍부,060001, 55세,2021,24143,12871,11272,114.2,23179,12369,10810,114.4
31004, 읍부,060002, 56세,2021,24325,12678,11647,108.9,23298,12146,11152,108.9
31004, 읍부,060003, 57세,2021,22556,11760,10796,108.9,21612,11251,10361,108.6
31004, 읍부,060004, 58세,2021,23545,12393,11152,111.1,22495,11846,10649,111.2
31004, 읍부,060005, 59세,2021,23617,12310,11307,108.9,22835,11924,10911,109.3
31004, 읍부,065,60~64세,2021,112095,56558,55537,101.8,109158,55128,54030,102
31004, 읍부,065001, 60세,2021,25344,12826,12518,102.5,24782,12573,12209,103
31004, 읍부,065002, 61세,2021,24241,12274,11967,102.6,23562,11946,11616,102.8
31004, 읍부,065003, 62세,2021,22102,11152,10950,101.8,21536,10867,10669,101.9
31004, 읍부,065004, 63세,2021,20782,10503,10279,102.2,20188,10200,9988,102.1
31004, 읍부,065005, 64세,2021,19626,9803,9823,99.8,19090,9542,9548,99.9
31004, 읍부,070,65~69세,2021,78870,38622,40248,96,77167,37823,39344,96.1
31004, 읍부,070001, 65세,2021,18050,8961,9089,98.6,17618,8760,8858,98.9
31004, 읍부,070002, 66세,2021,18123,8783,9340,94,17723,8596,9127,94.2
31004, 읍부,070003, 67세,2021,15133,7332,7801,94,14798,7181,7617,94.3
31004, 읍부,070004, 68세,2021,13138,6500,6638,97.9,12826,6352,6474,98.1
31004, 읍부,070005, 69세,2021,14426,7046,7380,95.5,14202,6934,7268,95.4
31004, 읍부,075,70~74세,2021,52839,24971,27868,89.6,52058,24626,27432,89.8
31004, 읍부,075001, 70세,2021,9604,4528,5076,89.2,9397,4430,4967,89.2
31004, 읍부,075002, 71세,2021,10681,5094,5587,91.2,10512,5009,5503,91
31004, 읍부,075003, 72세,2021,10930,5115,5815,88,10778,5053,5725,88.3
31004, 읍부,075004, 73세,2021,10818,5129,5689,90.2,10684,5076,5608,90.5
31004, 읍부,075005, 74세,2021,10806,5105,5701,89.5,10687,5058,5629,89.9
31004, 읍부,080,75~79세,2021,41205,18238,22967,79.4,40907,18133,22774,79.6
31004, 읍부,080001, 75세,2021,8405,3909,4496,86.9,8334,3882,4452,87.2
31004, 읍부,080002, 76세,2021,8066,3664,4402,83.2,8005,3641,4364,83.4
31004, 읍부,080003, 77세,2021,7806,3461,4345,79.7,7755,3442,4313,79.8
31004, 읍부,080004, 78세,2021,7861,3356,4505,74.5,7798,3336,4462,74.8
31004, 읍부,080005, 79세,2021,9067,3848,5219,73.7,9015,3832,5183,73.9
31004, 읍부,085,80~84세,2021,30077,11700,18377,63.7,29880,11638,18242,63.8
31004, 읍부,085001, 80세,2021,7215,2992,4223,70.9,7163,2974,4189,71
31004, 읍부,085002, 81세,2021,6422,2532,3890,65.1,6383,2521,3862,65.3
31004, 읍부,085003, 82세,2021,6105,2337,3768,62,6061,2324,3737,62.2
31004, 읍부,085004, 83세,2021,5496,2033,3463,58.7,5468,2028,3440,59
31004, 읍부,085005, 84세,2021,4839,1806,3033,59.5,4805,1791,3014,59.4
31004, 읍부,090,85~89세,2021,15932,5075,10857,46.7,15863,5050,10813,46.7
31004, 읍부,090001, 85세,2021,4281,1457,2824,51.6,4263,1451,2812,51.6
31004, 읍부,090002, 86세,2021,3901,1287,2614,49.2,3876,1278,2598,49.2
31004, 읍부,090003, 87세,2021,3180,1045,2135,48.9,3170,1041,2129,48.9
31004, 읍부,090004, 88세,2021,2510,736,1774,41.5,2500,731,1769,41.3
31004, 읍부,090005, 89세,2021,2060,550,1510,36.4,2054,549,1505,36.5
31004, 읍부,095,90~94세,2021,5374,1223,4151,29.5,5355,1221,4134,29.5
31004, 읍부,095001, 90세,2021,1467,351,1116,31.5,1461,351,1110,31.6
31004, 읍부,095002, 91세,2021,1360,323,1037,31.1,1357,322,1035,31.1
31004, 읍부,095003, 92세,2021,1116,255,861,29.6,1109,255,854,29.9
31004, 읍부,095004, 93세,2021,836,181,655,27.6,834,180,654,27.5
31004, 읍부,095005, 94세,2021,595,113,482,23.4,594,113,481,23.5
31004, 읍부,100,95~99세,2021,1264,254,1010,25.1,1260,253,1007,25.1
31004, 읍부,100001, 95세,2021,429,84,345,24.3,427,83,344,24.1
31004, 읍부,100002, 96세,2021,315,48,267,18,313,48,265,18.1
31004, 읍부,100003, 97세,2021,198,44,154,28.6,198,44,154,28.6
31004, 읍부,100004, 98세,2021,200,49,151,32.5,200,49,151,32.5
31004, 읍부,100005, 99세,2021,122,29,93,31.2,122,29,93,31.2
31004, 읍부,101,100세이상,2021,185,34,151,22.5,184,33,151,21.9
31004, 읍부,102,15세미만,2021,202399,103739,98660,105.1,198491,101792,96699,105.3
31004, 읍부,103,15~64세,2021,1107592,593881,513711,115.6,1031741,544557,487184,111.8
31004, 읍부,104,65세이상,2021,225746,100117,125629,79.7,222674,98777,123897,79.7
31004, 읍부,086,85세이상,2021,22755,6586,16169,40.7,22662,6557,16105,40.7
31004, 읍부,126,평균연령,2021,42.3,41.3,43.4,,42.5,41.6,43.5,
31004, 읍부,127,중위연령,2021,43.2,42.1,44.5,,43.9,42.9,44.9,
31005, 면부,000,합계,2021,787819,434470,353349,123,704947,371778,333169,111.6
31005, 면부,005,0~4세,2021,15816,8023,7793,103,15214,7736,7478,103.5
31005, 면부,005001, 0세,2021,2802,1428,1374,103.9,2687,1376,1311,105
31005, 면부,005002, 1세,2021,2858,1448,1410,102.7,2736,1380,1356,101.8
31005, 면부,005003, 2세,2021,3111,1584,1527,103.7,3000,1531,1469,104.2
31005, 면부,005004, 3세,2021,3366,1688,1678,100.6,3241,1635,1606,101.8
31005, 면부,005005, 4세,2021,3679,1875,1804,103.9,3550,1814,1736,104.5
31005, 면부,010,5~9세,2021,21050,10956,10094,108.5,20528,10700,9828,108.9
31005, 면부,010001, 5세,2021,3956,2076,1880,110.4,3805,1999,1806,110.7
31005, 면부,010002, 6세,2021,4104,2122,1982,107.1,3988,2067,1921,107.6
31005, 면부,010003, 7세,2021,4080,2151,1929,111.5,3989,2104,1885,111.6
31005, 면부,010004, 8세,2021,4237,2213,2024,109.3,4151,2170,1981,109.5
31005, 면부,010005, 9세,2021,4673,2394,2279,105,4595,2360,2235,105.6
31005, 면부,015,10~14세,2021,22415,11706,10709,109.3,22103,11529,10574,109
31005, 면부,015001, 10세,2021,4735,2493,2242,111.2,4657,2452,2205,111.2
31005, 면부,015002, 11세,2021,4452,2310,2142,107.8,4397,2281,2116,107.8
31005, 면부,015003, 12세,2021,4237,2214,2023,109.4,4178,2178,2000,108.9
31005, 면부,015004, 13세,2021,4446,2359,2087,113,4380,2322,2058,112.8
31005, 면부,015005, 14세,2021,4545,2330,2215,105.2,4491,2296,2195,104.6
31005, 면부,020,15~19세,2021,27960,14812,13148,112.7,27489,14568,12921,112.7
31005, 면부,020001, 15세,2021,4342,2289,2053,111.5,4296,2266,2030,111.6
31005, 면부,020002, 16세,2021,4336,2297,2039,112.7,4285,2266,2019,112.2
31005, 면부,020003, 17세,2021,5491,2859,2632,108.6,5445,2837,2608,108.8
31005, 면부,020004, 18세,2021,5930,3096,2834,109.2,5831,3046,2785,109.4
31005, 면부,020005, 19세,2021,7861,4271,3590,119,7632,4153,3479,119.4
31005, 면부,025,20~24세,2021,41501,24646,16855,146.2,35229,19899,15330,129.8
31005, 면부,025001, 20세,2021,7130,3830,3300,116.1,6764,3625,3139,115.5
31005, 면부,025002, 21세,2021,7412,4069,3343,121.7,6771,3615,3156,114.5
31005, 면부,025003, 22세,2021,7874,4707,3167,148.6,6850,3922,2928,133.9
31005, 면부,025004, 23세,2021,8913,5540,3373,164.2,7146,4182,2964,141.1
31005, 면부,025005, 24세,2021,10172,6500,3672,177,7698,4555,3143,144.9
31005, 면부,030,25~29세,2021,59623,40017,19606,204.1,41566,25451,16115,157.9
31005, 면부,030001, 25세,2021,10917,7223,3694,195.5,7830,4752,3078,154.4
31005, 면부,030002, 26세,2021,11494,7718,3776,204.4,8063,4924,3139,156.9
31005, 면부,030003, 27세,2021,12037,8033,4004,200.6,8488,5173,3315,156
31005, 면부,030004, 28세,2021,12391,8417,3974,211.8,8502,5295,3207,165.1
31005, 면부,030005, 29세,2021,12784,8626,4158,207.5,8683,5307,3376,157.2
31005, 면부,035,30~34세,2021,54845,36882,17963,205.3,35853,21546,14307,150.6
31005, 면부,035001, 30세,2021,11857,7985,3872,206.2,7904,4800,3104,154.6
31005, 면부,035002, 31세,2021,11598,7862,3736,210.4,7479,4586,2893,158.5
31005, 면부,035003, 32세,2021,10913,7440,3473,214.2,7077,4287,2790,153.7
31005, 면부,035004, 33세,2021,10406,6958,3448,201.8,6740,4011,2729,147
31005, 면부,035005, 34세,2021,10071,6637,3434,193.3,6653,3862,2791,138.4
31005, 면부,040,35~39세,2021,49673,31622,18051,175.2,36002,20676,15326,134.9
31005, 면부,040001, 35세,2021,9808,6454,3354,192.4,6687,3944,2743,143.8
31005, 면부,040002, 36세,2021,9631,6201,3430,180.8,6621,3793,2828,134.1
31005, 면부,040003, 37세,2021,9603,6129,3474,176.4,6860,3936,2924,134.6
31005, 면부,040004, 38세,2021,9969,6273,3696,169.7,7518,4296,3222,133.3
31005, 면부,040005, 39세,2021,10662,6565,4097,160.2,8316,4707,3609,130.4
31005, 면부,045,40~44세,2021,48606,29507,19099,154.5,40228,23128,17100,135.3
31005, 면부,045001, 40세,2021,10265,6272,3993,157.1,8264,4715,3549,132.9
31005, 면부,045002, 41세,2021,10447,6406,4041,158.5,8536,4943,3593,137.6
31005, 면부,045003, 42세,2021,9630,5878,3752,156.7,7921,4570,3351,136.4
31005, 면부,045004, 43세,2021,9093,5476,3617,151.4,7626,4395,3231,136
31005, 면부,045005, 44세,2021,9171,5475,3696,148.1,7881,4505,3376,133.4
31005, 면부,050,45~49세,2021,50865,29630,21235,139.5,45658,25953,19705,131.7
31005, 면부,050001, 45세,2021,9091,5386,3705,145.4,7880,4458,3422,130.3
31005, 면부,050002, 46세,2021,9479,5557,3922,141.7,8412,4821,3591,134.3
31005, 면부,050003, 47세,2021,10432,6088,4344,140.1,9391,5369,4022,133.5
31005, 면부,050004, 48세,2021,10768,6192,4576,135.3,9849,5551,4298,129.2
31005, 면부,050005, 49세,2021,11095,6407,4688,136.7,10126,5754,4372,131.6
31005, 면부,055,50~54세,2021,61758,33931,27827,121.9,57808,31446,26362,119.3
31005, 면부,055001, 50세,2021,11830,6686,5144,130,10920,6111,4809,127.1
31005, 면부,055002, 51세,2021,11845,6657,5188,128.3,10979,6108,4871,125.4
31005, 면부,055003, 52세,2021,12658,6987,5671,123.2,11893,6515,5378,121.1
31005, 면부,055004, 53세,2021,12964,7027,5937,118.4,12177,6523,5654,115.4
31005, 면부,055005, 54세,2021,12461,6574,5887,111.7,11839,6189,5650,109.5
31005, 면부,060,55~59세,2021,69615,37531,32084,117,66501,35700,30801,115.9
31005, 면부,060001, 55세,2021,12940,7129,5811,122.7,12284,6740,5544,121.6
31005, 면부,060002, 56세,2021,14203,7658,6545,117,13537,7253,6284,115.4
31005, 면부,060003, 57세,2021,13301,7211,6090,118.4,12711,6873,5838,117.7
31005, 면부,060004, 58세,2021,14533,7710,6823,113,13835,7308,6527,112
31005, 면부,060005, 59세,2021,14638,7823,6815,114.8,14134,7526,6608,113.9
31005, 면부,065,60~64세,2021,78420,41048,37372,109.8,76580,40010,36570,109.4
31005, 면부,065001, 60세,2021,16868,8802,8066,109.1,16522,8610,7912,108.8
31005, 면부,065002, 61세,2021,16775,8687,8088,107.4,16337,8434,7903,106.7
31005, 면부,065003, 62세,2021,15566,8184,7382,110.9,15199,7981,7218,110.6
31005, 면부,065004, 63세,2021,15007,7948,7059,112.6,14651,7750,6901,112.3
31005, 면부,065005, 64세,2021,14204,7427,6777,109.6,13871,7235,6636,109
31005, 면부,070,65~69세,2021,60149,30964,29185,106.1,59259,30505,28754,106.1
31005, 면부,070001, 65세,2021,13332,6960,6372,109.2,13093,6828,6265,109
31005, 면부,070002, 66세,2021,13758,7062,6696,105.5,13559,6957,6602,105.4
31005, 면부,070003, 67세,2021,11593,5959,5634,105.8,11421,5874,5547,105.9
31005, 면부,070004, 68세,2021,10143,5117,5026,101.8,9983,5042,4941,102
31005, 면부,070005, 69세,2021,11323,5866,5457,107.5,11203,5804,5399,107.5
31005, 면부,075,70~74세,2021,39800,19865,19935,99.6,39474,19701,19773,99.6
31005, 면부,075001, 70세,2021,7095,3528,3567,98.9,7010,3481,3529,98.6
31005, 면부,075002, 71세,2021,8013,3968,4045,98.1,7938,3932,4006,98.2
31005, 면부,075003, 72세,2021,8100,4067,4033,100.8,8039,4036,4003,100.8
31005, 면부,075004, 73세,2021,8093,4161,3932,105.8,8031,4131,3900,105.9
31005, 면부,075005, 74세,2021,8499,4141,4358,95,8456,4121,4335,95.1
31005, 면부,080,75~79세,2021,33747,15351,18396,83.4,33615,15298,18317,83.5
31005, 면부,080001, 75세,2021,6611,3248,3363,96.6,6577,3234,3343,96.7
31005, 면부,080002, 76세,2021,6560,3109,3451,90.1,6542,3099,3443,90
31005, 면부,080003, 77세,2021,6415,2899,3516,82.5,6384,2883,3501,82.3
31005, 면부,080004, 78세,2021,6535,2828,3707,76.3,6508,2822,3686,76.6
31005, 면부,080005, 79세,2021,7626,3267,4359,74.9,7604,3260,4344,75
31005, 면부,085,80~84세,2021,27726,11042,16684,66.2,27640,11011,16629,66.2
31005, 면부,085001, 80세,2021,6350,2691,3659,73.5,6333,2684,3649,73.6
31005, 면부,085002, 81세,2021,5606,2327,3279,71,5584,2319,3265,71
31005, 면부,085003, 82세,2021,5771,2285,3486,65.5,5756,2280,3476,65.6
31005, 면부,085004, 83세,2021,5170,1960,3210,61.1,5150,1956,3194,61.2
31005, 면부,085005, 84세,2021,4829,1779,3050,58.3,4817,1772,3045,58.2
31005, 면부,090,85~89세,2021,16418,5236,11182,46.8,16388,5223,11165,46.8
31005, 면부,090001, 85세,2021,4286,1576,2710,58.2,4281,1573,2708,58.1
31005, 면부,090002, 86세,2021,3878,1255,2623,47.8,3871,1252,2619,47.8
31005, 면부,090003, 87세,2021,3326,1019,2307,44.2,3317,1015,2302,44.1
31005, 면부,090004, 88세,2021,2667,759,1908,39.8,2660,757,1903,39.8
31005, 면부,090005, 89세,2021,2261,627,1634,38.4,2259,626,1633,38.3
31005, 면부,095,90~94세,2021,6053,1338,4715,28.4,6037,1335,4702,28.4
31005, 면부,095001, 90세,2021,1706,453,1253,36.2,1702,452,1250,36.2
31005, 면부,095002, 91세,2021,1527,332,1195,27.8,1522,331,1191,27.8
31005, 면부,095003, 92세,2021,1241,265,976,27.2,1236,264,972,27.2
31005, 면부,095004, 93세,2021,915,168,747,22.5,914,168,746,22.5
31005, 면부,095005, 94세,2021,664,120,544,22.1,663,120,543,22.1
31005, 면부,100,95~99세,2021,1549,314,1235,25.4,1546,314,1232,25.5
31005, 면부,100001, 95세,2021,521,90,431,20.9,521,90,431,20.9
31005, 면부,100002, 96세,2021,410,92,318,28.9,410,92,318,28.9
31005, 면부,100003, 97세,2021,255,52,203,25.6,255,52,203,25.6
31005, 면부,100004, 98세,2021,231,56,175,32,229,56,173,32.4
31005, 면부,100005, 99세,2021,132,24,108,22.2,131,24,107,22.4
31005, 면부,101,100세이상,2021,230,49,181,27.1,229,49,180,27.2
31005, 면부,102,15세미만,2021,59281,30685,28596,107.3,57845,29965,27880,107.5
31005, 면부,103,15~64세,2021,542866,319626,223240,143.2,462914,258377,204537,126.3
31005, 면부,104,65세이상,2021,185672,84159,101513,82.9,184188,83436,100752,82.8
31005, 면부,086,85세이상,2021,24250,6937,17313,40.1,24200,6921,17279,40.1
31005, 면부,126,평균연령,2021,48,46,50.6,,49.4,47.7,51.3,
31005, 면부,127,중위연령,2021,50.1,46.7,54,,52.9,50.8,55.3,
31003, 동부,000,합계,2021,11328973,5666516,5662457,100.1,10923472,5454214,5469258,99.7
31003, 동부,005,0~4세,2021,399198,204500,194698,105,387278,198434,188844,105.1
31003, 동부,005001, 0세,2021,68490,34975,33515,104.4,66647,34047,32600,104.4
31003, 동부,005002, 1세,2021,72061,36535,35526,102.8,69890,35452,34438,102.9
31003, 동부,005003, 2세,2021,79618,40838,38780,105.3,76964,39479,37485,105.3
31003, 동부,005004, 3세,2021,85867,44093,41774,105.6,83237,42717,40520,105.4
31003, 동부,005005, 4세,2021,93162,48059,45103,106.6,90540,46739,43801,106.7
31003, 동부,010,5~9세,2021,550411,281222,269189,104.5,540207,276093,264114,104.5
31003, 동부,010001, 5세,2021,105640,53873,51767,104.1,102867,52448,50419,104
31003, 동부,010002, 6세,2021,110762,56674,54088,104.8,108543,55537,53006,104.8
31003, 동부,010003, 7세,2021,108318,55229,53089,104,106361,54275,52086,104.2
31003, 동부,010004, 8세,2021,108285,55140,53145,103.8,106571,54298,52273,103.9
31003, 동부,010005, 9세,2021,117406,60306,57100,105.6,115865,59535,56330,105.7
31003, 동부,015,10~14세,2021,556518,285003,271515,105,550974,282180,268794,105
31003, 동부,015001, 10세,2021,114273,58456,55817,104.7,112979,57757,55222,104.6
31003, 동부,015002, 11세,2021,110124,56632,53492,105.9,108937,56031,52906,105.9
31003, 동부,015003, 12세,2021,106466,54619,51847,105.3,105363,54084,51279,105.5
31003, 동부,015004, 13세,2021,111902,57115,54787,104.2,110877,56592,54285,104.2
31003, 동부,015005, 14세,2021,113753,58181,55572,104.7,112818,57716,55102,104.7
31003, 동부,020,15~19세,2021,524494,268397,256097,104.8,519525,266035,253490,104.9
31003, 동부,020001, 15세,2021,103161,52887,50274,105.2,102357,52490,49867,105.3
31003, 동부,020002, 16세,2021,99796,50697,49099,103.3,99111,50373,48738,103.4
31003, 동부,020003, 17세,2021,107283,54796,52487,104.4,106548,54435,52113,104.5
31003, 동부,020004, 18세,2021,107863,55393,52470,105.6,107004,54981,52023,105.7
31003, 동부,020005, 19세,2021,106391,54624,51767,105.5,104505,53756,50749,105.9
31003, 동부,025,20~24세,2021,692485,358552,333933,107.4,670635,347574,323061,107.6
31003, 동부,025001, 20세,2021,124865,65476,59389,110.2,121896,64155,57741,111.1
31003, 동부,025002, 21세,2021,138909,73310,65599,111.8,135089,71525,63564,112.5
31003, 동부,025003, 22세,2021,135072,70493,64579,109.2,130822,68385,62437,109.5
31003, 동부,025004, 23세,2021,143031,72852,70179,103.8,137887,70179,67708,103.6
31003, 동부,025005, 24세,2021,150608,76421,74187,103,144941,73330,71611,102.4
31003, 동부,030,25~29세,2021,825453,434926,390527,111.4,789035,415000,374035,111
31003, 동부,030001, 25세,2021,157089,81451,75638,107.7,151038,78236,72802,107.5
31003, 동부,030002, 26세,2021,162764,85621,77143,111,155939,81887,74052,110.6
31003, 동부,030003, 27세,2021,165482,87879,77603,113.2,158371,83955,74416,112.8
31003, 동부,030004, 28세,2021,168155,89093,79062,112.7,160295,84760,75535,112.2
31003, 동부,030005, 29세,2021,171963,90882,81081,112.1,163392,86162,77230,111.6
31003, 동부,035,30~34세,2021,789963,410089,379874,108,736208,380722,355486,107.1
31003, 동부,035001, 30세,2021,164612,86200,78412,109.9,155386,81131,74255,109.3
31003, 동부,035002, 31세,2021,157437,81934,75503,108.5,146971,76207,70764,107.7
31003, 동부,035003, 32세,2021,156164,81369,74795,108.8,145298,75438,69860,108
31003, 동부,035004, 33세,2021,155111,80034,75077,106.6,143771,73964,69807,106
31003, 동부,035005, 34세,2021,156639,80552,76087,105.9,144782,73982,70800,104.5
31003, 동부,040,35~39세,2021,882468,453163,429305,105.6,830928,424365,406563,104.4
31003, 동부,040001, 35세,2021,159685,82405,77280,106.6,148115,76046,72069,105.5
31003, 동부,040002, 36세,2021,163354,83971,79383,105.8,152682,78037,74645,104.5
31003, 동부,040003, 37세,2021,169600,87195,82405,105.8,159398,81436,77962,104.5
31003, 동부,040004, 38세,2021,186927,95750,91177,105,177517,90486,87031,104
31003, 동부,040005, 39세,2021,202902,103842,99060,104.8,193216,98360,94856,103.7
31003, 동부,045,40~44세,2021,963046,489116,473930,103.2,925319,467575,457744,102.1
31003, 동부,045001, 40세,2021,202715,103590,99125,104.5,194620,98988,95632,103.5
31003, 동부,045002, 41세,2021,205381,104252,101129,103.1,197577,99750,97827,102
31003, 동부,045003, 42세,2021,194790,98765,96025,102.9,186683,94140,92543,101.7
31003, 동부,045004, 43세,2021,177255,90158,87097,103.5,170052,86048,84004,102.4
31003, 동부,045005, 44세,2021,182905,92351,90554,102,176387,88649,87738,101
31003, 동부,050,45~49세,2021,974477,490181,484296,101.2,940192,471140,469052,100.4
31003, 동부,050001, 45세,2021,178629,90843,87786,103.5,172025,87087,84938,102.5
31003, 동부,050002, 46세,2021,185987,93293,92694,100.6,179773,89869,89904,100
31003, 동부,050003, 47세,2021,201920,101519,100401,101.1,195518,98007,97511,100.5
31003, 동부,050004, 48세,2021,202857,101026,101831,99.2,195546,97044,98502,98.5
31003, 동부,050005, 49세,2021,205084,103500,101584,101.9,197330,99133,98197,101
31003, 동부,055,50~54세,2021,1019267,504494,514773,98,980493,484167,496326,97.6
31003, 동부,055001, 50세,2021,216485,108382,108103,100.3,208252,103955,104297,99.7
31003, 동부,055002, 51세,2021,207468,103671,103797,99.9,199049,99194,99855,99.3
31003, 동부,055003, 52세,2021,208409,102935,105474,97.6,200577,98911,101666,97.3
31003, 동부,055004, 53세,2021,203622,99677,103945,95.9,195798,95558,100240,95.3
31003, 동부,055005, 54세,2021,183283,89829,93454,96.1,176817,86549,90268,95.9
31003, 동부,060,55~59세,2021,883637,444672,438965,101.3,843825,424915,418910,101.4
31003, 동부,060001, 55세,2021,178099,89844,88255,101.8,170772,86175,84597,101.9
31003, 동부,060002, 56세,2021,183839,91800,92039,99.7,175750,87744,88006,99.7
31003, 동부,060003, 57세,2021,169631,85194,84437,100.9,161808,81270,80538,100.9
31003, 동부,060004, 58세,2021,177843,90173,87670,102.9,168371,85517,82854,103.2
31003, 동부,060005, 59세,2021,174225,87661,86564,101.3,167124,84209,82915,101.6
31003, 동부,065,60~64세,2021,804218,399848,404370,98.9,775832,386386,389446,99.2
31003, 동부,065001, 60세,2021,183167,91047,92120,98.8,178713,88995,89718,99.2
31003, 동부,065002, 61세,2021,179179,88925,90254,98.5,172280,85597,86683,98.7
31003, 동부,065003, 62세,2021,157345,78398,78947,99.3,151774,75773,76001,99.7
31003, 동부,065004, 63세,2021,145697,72802,72895,99.9,139933,70047,69886,100.2
31003, 동부,065005, 64세,2021,138830,68676,70154,97.9,133132,65974,67158,98.2
31003, 동부,070,65~69세,2021,531614,257169,274445,93.7,513481,248745,264736,94
31003, 동부,070001, 65세,2021,123134,60308,62826,96,118364,58046,60318,96.2
31003, 동부,070002, 66세,2021,124399,60192,64207,93.7,120116,58159,61957,93.9
31003, 동부,070003, 67세,2021,101703,49276,52427,94,98014,47568,50446,94.3
31003, 동부,070004, 68세,2021,88081,42211,45870,92,85196,40921,44275,92.4
31003, 동부,070005, 69세,2021,94297,45182,49115,92,91791,44051,47740,92.3
31003, 동부,075,70~74세,2021,344474,159773,184701,86.5,337453,156847,180606,86.8
31003, 동부,075001, 70세,2021,64092,30289,33803,89.6,62028,29397,32631,90.1
31003, 동부,075002, 71세,2021,71012,33081,37931,87.2,69339,32381,36958,87.6
31003, 동부,075003, 72세,2021,71003,33184,37819,87.7,69534,32578,36956,88.2
31003, 동부,075004, 73세,2021,68919,31814,37105,85.7,68001,31434,36567,86
31003, 동부,075005, 74세,2021,69448,31405,38043,82.6,68551,31057,37494,82.8
31003, 동부,080,75~79세,2021,260547,112645,147902,76.2,257941,111855,146086,76.6
31003, 동부,080001, 75세,2021,53529,23998,29531,81.3,52831,23771,29060,81.8
31003, 동부,080002, 76세,2021,50913,22500,28413,79.2,50385,22318,28067,79.5
31003, 동부,080003, 77세,2021,50113,21436,28677,74.7,49616,21287,28329,75.1
31003, 동부,080004, 78세,2021,49658,21013,28645,73.4,49204,20904,28300,73.9
31003, 동부,080005, 79세,2021,56334,23698,32636,72.6,55905,23575,32330,72.9
31003, 동부,085,80~84세,2021,187079,72343,114736,63.1,185400,71925,113475,63.4
31003, 동부,085001, 80세,2021,45118,18455,26663,69.2,44672,18336,26336,69.6
31003, 동부,085002, 81세,2021,39910,15822,24088,65.7,39535,15721,23814,66
31003, 동부,085003, 82세,2021,38324,14712,23612,62.3,37999,14645,23354,62.7
31003, 동부,085004, 83세,2021,33875,12689,21186,59.9,33570,12616,20954,60.2
31003, 동부,085005, 84세,2021,29852,10665,19187,55.6,29624,10607,19017,55.8
31003, 동부,090,85~89세,2021,97143,30595,66548,46,96471,30458,66013,46.1
31003, 동부,090001, 85세,2021,26220,8922,17298,51.6,25993,8872,17121,51.8
31003, 동부,090002, 86세,2021,23661,7624,16037,47.5,23510,7597,15913,47.7
31003, 동부,090003, 87세,2021,18879,5895,12984,45.4,18748,5870,12878,45.6
31003, 동부,090004, 88세,2021,15395,4492,10903,41.2,15299,4471,10828,41.3
31003, 동부,090005, 89세,2021,12988,3662,9326,39.3,12921,3648,9273,39.3
31003, 동부,095,90~94세,2021,33956,8177,25779,31.7,33790,8154,25636,31.8
31003, 동부,095001, 90세,2021,9634,2523,7111,35.5,9577,2517,7060,35.7
31003, 동부,095002, 91세,2021,8570,2091,6479,32.3,8530,2088,6442,32.4
31003, 동부,095003, 92세,2021,6792,1664,5128,32.4,6759,1657,5102,32.5
31003, 동부,095004, 93세,2021,5224,1151,4073,28.3,5200,1145,4055,28.2
31003, 동부,095005, 94세,2021,3736,748,2988,25,3724,747,2977,25.1
31003, 동부,100,95~99세,2021,7378,1445,5933,24.4,7342,1439,5903,24.4
31003, 동부,100001, 95세,2021,2430,465,1965,23.7,2420,463,1957,23.7
31003, 동부,100002, 96세,2021,1869,312,1557,20,1864,311,1553,20
31003, 동부,100003, 97세,2021,1223,266,957,27.8,1212,264,948,27.8
31003, 동부,100004, 98세,2021,1108,245,863,28.4,1102,244,858,28.4
31003, 동부,100005, 99세,2021,748,157,591,26.6,744,157,587,26.7
31003, 동부,101,100세이상,2021,1147,206,941,21.9,1143,205,938,21.9
31003, 동부,102,15세미만,2021,1506127,770725,735402,104.8,1478459,756707,721752,104.8
31003, 동부,103,15~64세,2021,8359508,4253438,4106070,103.6,8011992,4067879,3944113,103.1
31003, 동부,104,65세이상,2021,1463338,642353,820985,78.2,1433021,629628,803393,78.4
31003, 동부,086,85세이상,2021,139624,40423,99201,40.7,138746,40256,98490,40.9
31003, 동부,126,평균연령,2021,41.4,40.5,42.3,,41.4,40.5,42.3,
31003, 동부,127,중위연령,2021,42.2,41.3,43.1,,42.2,41.4,43.2,
31010, 수원시,000,합계,2021,1208337,609383,598954,101.7,1154352,581519,572833,101.5
31010, 수원시,005,0~4세,2021,39271,20197,19074,105.9,37676,19411,18265,106.3
31010, 수원시,005001, 0세,2021,6889,3565,3324,107.3,6614,3427,3187,107.5
31010, 수원시,005002, 1세,2021,7178,3706,3472,106.7,6857,3550,3307,107.3
31010, 수원시,005003, 2세,2021,7846,3980,3866,102.9,7509,3813,3696,103.2
31010, 수원시,005004, 3세,2021,8412,4321,4091,105.6,8068,4145,3923,105.7
31010, 수원시,005005, 4세,2021,8946,4625,4321,107,8628,4476,4152,107.8
31010, 수원시,010,5~9세,2021,54127,27849,26278,106,52790,27171,25619,106.1
31010, 수원시,010001, 5세,2021,10298,5306,4992,106.3,9936,5116,4820,106.1
31010, 수원시,010002, 6세,2021,10961,5640,5321,106,10660,5482,5178,105.9
31010, 수원시,010003, 7세,2021,10568,5415,5153,105.1,10307,5284,5023,105.2
31010, 수원시,010004, 8세,2021,10695,5529,5166,107,10464,5424,5040,107.6
31010, 수원시,010005, 9세,2021,11605,5959,5646,105.5,11423,5865,5558,105.5
31010, 수원시,015,10~14세,2021,56343,29120,27223,107,55632,28757,26875,107
31010, 수원시,015001, 10세,2021,11349,5891,5458,107.9,11144,5774,5370,107.5
31010, 수원시,015002, 11세,2021,10875,5633,5242,107.5,10748,5567,5181,107.5
31010, 수원시,015003, 12세,2021,10690,5524,5166,106.9,10550,5459,5091,107.2
31010, 수원시,015004, 13세,2021,11620,5974,5646,105.8,11488,5904,5584,105.7
31010, 수원시,015005, 14세,2021,11809,6098,5711,106.8,11702,6053,5649,107.2
31010, 수원시,020,15~19세,2021,57477,29786,27691,107.6,56742,29494,27248,108.2
31010, 수원시,020001, 15세,2021,10711,5548,5163,107.5,10615,5508,5107,107.9
31010, 수원시,020002, 16세,2021,10473,5309,5164,102.8,10394,5281,5113,103.3
31010, 수원시,020003, 17세,2021,11731,6198,5533,112,11656,6160,5496,112.1
31010, 수원시,020004, 18세,2021,12058,6275,5783,108.5,11947,6222,5725,108.7
31010, 수원시,020005, 19세,2021,12504,6456,6048,106.7,12130,6323,5807,108.9
31010, 수원시,025,20~24세,2021,84162,43489,40673,106.9,80906,42064,38842,108.3
31010, 수원시,025001, 20세,2021,14651,7638,7013,108.9,14112,7437,6675,111.4
31010, 수원시,025002, 21세,2021,16443,8387,8056,104.1,15826,8141,7685,105.9
31010, 수원시,025003, 22세,2021,16289,8451,7838,107.8,15648,8172,7476,109.3
31010, 수원시,025004, 23세,2021,17916,9269,8647,107.2,17190,8933,8257,108.2
31010, 수원시,025005, 24세,2021,18863,9744,9119,106.9,18130,9381,8749,107.2
31010, 수원시,030,25~29세,2021,102761,54699,48062,113.8,98318,52470,45848,114.4
31010, 수원시,030001, 25세,2021,19741,10368,9373,110.6,18960,9993,8967,111.4
31010, 수원시,030002, 26세,2021,20370,10735,9635,111.4,19587,10351,9236,112.1
31010, 수원시,030003, 27세,2021,20599,10986,9613,114.3,19761,10538,9223,114.3
31010, 수원시,030004, 28세,2021,20978,11256,9722,115.8,20008,10790,9218,117.1
31010, 수원시,030005, 29세,2021,21073,11354,9719,116.8,20002,10798,9204,117.3
31010, 수원시,035,30~34세,2021,91691,48818,42873,113.9,85435,45504,39931,114
31010, 수원시,035001, 30세,2021,19850,10701,9149,117,18817,10157,8660,117.3
31010, 수원시,035002, 31세,2021,18703,9935,8768,113.3,17424,9262,8162,113.5
31010, 수원시,035003, 32세,2021,18120,9648,8472,113.9,16858,9009,7849,114.8
31010, 수원시,035004, 33세,2021,17559,9319,8240,113.1,16230,8632,7598,113.6
31010, 수원시,035005, 34세,2021,17459,9215,8244,111.8,16106,8444,7662,110.2
31010, 수원시,040,35~39세,2021,92666,48039,44627,107.6,86626,44730,41896,106.8
31010, 수원시,040001, 35세,2021,17281,9110,8171,111.5,15887,8346,7541,110.7
31010, 수원시,040002, 36세,2021,17600,9096,8504,107,16298,8422,7876,106.9
31010, 수원시,040003, 37세,2021,17749,9285,8464,109.7,16575,8612,7963,108.2
31010, 수원시,040004, 38세,2021,19104,9925,9179,108.1,18076,9387,8689,108
31010, 수원시,040005, 39세,2021,20932,10623,10309,103,19790,9963,9827,101.4
31010, 수원시,045,40~44세,2021,100063,50922,49141,103.6,95611,48361,47250,102.4
31010, 수원시,045001, 40세,2021,20884,10614,10270,103.3,20002,10112,9890,102.2
31010, 수원시,045002, 41세,2021,21118,10803,10315,104.7,20209,10263,9946,103.2
31010, 수원시,045003, 42세,2021,20276,10268,10008,102.6,19313,9703,9610,101
31010, 수원시,045004, 43세,2021,18578,9550,9028,105.8,17709,9066,8643,104.9
31010, 수원시,045005, 44세,2021,19207,9687,9520,101.8,18378,9217,9161,100.6
31010, 수원시,050,45~49세,2021,101855,51178,50677,101,97377,48685,48692,100
31010, 수원시,050001, 45세,2021,18857,9599,9258,103.7,18037,9128,8909,102.5
31010, 수원시,050002, 46세,2021,19409,9789,9620,101.8,18655,9361,9294,100.7
31010, 수원시,050003, 47세,2021,20889,10370,10519,98.6,20073,9908,10165,97.5
31010, 수원시,050004, 48세,2021,21437,10592,10845,97.7,20445,10061,10384,96.9
31010, 수원시,050005, 49세,2021,21263,10828,10435,103.8,20167,10227,9940,102.9
31010, 수원시,055,50~54세,2021,108685,53580,55105,97.2,103118,50596,52522,96.3
31010, 수원시,055001, 50세,2021,22693,11445,11248,101.8,21538,10795,10743,100.5
31010, 수원시,055002, 51세,2021,21803,11017,10786,102.1,20594,10349,10245,101
31010, 수원시,055003, 52세,2021,22383,10886,11497,94.7,21236,10302,10934,94.2
31010, 수원시,055004, 53세,2021,21939,10521,11418,92.1,20824,9937,10887,91.3
31010, 수원시,055005, 54세,2021,19867,9711,10156,95.6,18926,9213,9713,94.9
31010, 수원시,060,55~59세,2021,95419,48211,47208,102.1,88963,44886,44077,101.8
31010, 수원시,060001, 55세,2021,19281,9671,9610,100.6,18125,9077,9048,100.3
31010, 수원시,060002, 56세,2021,19927,10031,9896,101.4,18584,9327,9257,100.8
31010, 수원시,060003, 57세,2021,18326,9256,9070,102.1,17069,8587,8482,101.2
31010, 수원시,060004, 58세,2021,19469,9952,9517,104.6,17899,9138,8761,104.3
31010, 수원시,060005, 59세,2021,18416,9301,9115,102,17286,8757,8529,102.7
31010, 수원시,065,60~64세,2021,82877,41805,41072,101.8,78635,39629,39006,101.6
31010, 수원시,065001, 60세,2021,19614,9875,9739,101.4,18947,9535,9412,101.3
31010, 수원시,065002, 61세,2021,18690,9470,9220,102.7,17643,8927,8716,102.4
31010, 수원시,065003, 62세,2021,16331,8259,8072,102.3,15487,7822,7665,102
31010, 수원시,065004, 63세,2021,14718,7385,7333,100.7,13885,6955,6930,100.4
31010, 수원시,065005, 64세,2021,13524,6816,6708,101.6,12673,6390,6283,101.7
31010, 수원시,070,65~69세,2021,52715,25396,27319,93,50051,24101,25950,92.9
31010, 수원시,070001, 65세,2021,12315,6077,6238,97.4,11587,5699,5888,96.8
31010, 수원시,070002, 66세,2021,12336,5889,6447,91.3,11694,5579,6115,91.2
31010, 수원시,070003, 67세,2021,9918,4784,5134,93.2,9395,4532,4863,93.2
31010, 수원시,070004, 68세,2021,8731,4075,4656,87.5,8316,3888,4428,87.8
31010, 수원시,070005, 69세,2021,9415,4571,4844,94.4,9059,4403,4656,94.6
31010, 수원시,075,70~74세,2021,33403,15514,17889,86.7,32392,15066,17326,87
31010, 수원시,075001, 70세,2021,6252,2939,3313,88.7,5951,2803,3148,89
31010, 수원시,075002, 71세,2021,6969,3273,3696,88.6,6733,3155,3578,88.2
31010, 수원시,075003, 72세,2021,6819,3206,3613,88.7,6618,3123,3495,89.4
31010, 수원시,075004, 73세,2021,6631,3083,3548,86.9,6506,3025,3481,86.9
31010, 수원시,075005, 74세,2021,6732,3013,3719,81,6584,2960,3624,81.7
31010, 수원시,080,75~79세,2021,24666,10553,14113,74.8,24296,10451,13845,75.5
31010, 수원시,080001, 75세,2021,5037,2278,2759,82.6,4952,2251,2701,83.3
31010, 수원시,080002, 76세,2021,4886,2128,2758,77.2,4809,2101,2708,77.6
31010, 수원시,080003, 77세,2021,4823,2017,2806,71.9,4737,1999,2738,73
31010, 수원시,080004, 78세,2021,4689,1938,2751,70.4,4627,1923,2704,71.1
31010, 수원시,080005, 79세,2021,5231,2192,3039,72.1,5171,2177,2994,72.7
31010, 수원시,085,80~84세,2021,17376,6588,10788,61.1,17117,6526,10591,61.6
31010, 수원시,085001, 80세,2021,4271,1686,2585,65.2,4201,1671,2530,66
31010, 수원시,085002, 81세,2021,3623,1428,2195,65.1,3572,1411,2161,65.3
31010, 수원시,085003, 82세,2021,3557,1322,2235,59.1,3501,1312,2189,59.9
31010, 수원시,085004, 83세,2021,3126,1181,1945,60.7,3088,1170,1918,61
31010, 수원시,085005, 84세,2021,2799,971,1828,53.1,2755,962,1793,53.7
31010, 수원시,090,85~89세,2021,8987,2772,6215,44.6,8892,2752,6140,44.8
31010, 수원시,090001, 85세,2021,2455,777,1678,46.3,2422,768,1654,46.4
31010, 수원시,090002, 86세,2021,2175,695,1480,47,2155,692,1463,47.3
31010, 수원시,090003, 87세,2021,1749,569,1180,48.2,1730,564,1166,48.4
31010, 수원시,090004, 88세,2021,1399,397,1002,39.6,1384,396,988,40.1
31010, 수원시,090005, 89세,2021,1209,334,875,38.2,1201,332,869,38.2
31010, 수원시,095,90~94세,2021,3028,720,2308,31.2,3013,719,2294,31.3
31010, 수원시,095001, 90세,2021,841,218,623,35,834,218,616,35.4
31010, 수원시,095002, 91세,2021,750,174,576,30.2,745,174,571,30.5
31010, 수원시,095003, 92세,2021,653,154,499,30.9,651,153,498,30.7
31010, 수원시,095004, 93세,2021,462,106,356,29.8,461,106,355,29.9
31010, 수원시,095005, 94세,2021,322,68,254,26.8,322,68,254,26.8
31010, 수원시,100,95~99세,2021,663,131,532,24.6,660,130,530,24.5
31010, 수원시,100001, 95세,2021,218,40,178,22.5,217,40,177,22.6
31010, 수원시,100002, 96세,2021,181,30,151,19.9,181,30,151,19.9
31010, 수원시,100003, 97세,2021,113,23,90,25.6,112,23,89,25.8
31010, 수원시,100004, 98세,2021,79,26,53,49.1,78,25,53,47.2
31010, 수원시,100005, 99세,2021,72,12,60,20,72,12,60,20
31010, 수원시,101,100세이상,2021,102,16,86,18.6,102,16,86,18.6
31010, 수원시,102,15세미만,2021,149741,77166,72575,106.3,146098,75339,70759,106.5
31010, 수원시,103,15~64세,2021,917656,470527,447129,105.2,871731,446419,425312,105
31010, 수원시,104,65세이상,2021,140940,61690,79250,77.8,136523,59761,76762,77.9
31010, 수원시,086,85세이상,2021,12780,3639,9141,39.8,12667,3617,9050,40
31010, 수원시,126,평균연령,2021,40.8,39.9,41.7,,40.7,39.8,41.7,
31010, 수원시,127,중위연령,2021,41.2,40.3,42.2,,41.2,40.1,42.2,
31011, 장안구,000,합계,2021,277786,140352,137434,102.1,267967,135350,132617,102.1
31011, 장안구,005,0~4세,2021,6914,3522,3392,103.8,6661,3397,3264,104.1
31011, 장안구,005001, 0세,2021,1098,532,566,94,1054,512,542,94.5
31011, 장안구,005002, 1세,2021,1293,681,612,111.3,1242,652,590,110.5
31011, 장안구,005003, 2세,2021,1401,692,709,97.6,1347,664,683,97.2
31011, 장안구,005004, 3세,2021,1472,754,718,105,1422,733,689,106.4
31011, 장안구,005005, 4세,2021,1650,863,787,109.7,1596,836,760,110
31011, 장안구,010,5~9세,2021,10815,5574,5241,106.4,10620,5463,5157,105.9
31011, 장안구,010001, 5세,2021,1932,957,975,98.2,1877,921,956,96.3
31011, 장안구,010002, 6세,2021,2138,1119,1019,109.8,2099,1095,1004,109.1
31011, 장안구,010003, 7세,2021,2147,1113,1034,107.6,2108,1088,1020,106.7
31011, 장안구,010004, 8세,2021,2212,1174,1038,113.1,2176,1156,1020,113.3
31011, 장안구,010005, 9세,2021,2386,1211,1175,103.1,2360,1203,1157,104
31011, 장안구,015,10~14세,2021,12989,6699,6290,106.5,12882,6649,6233,106.7
31011, 장안구,015001, 10세,2021,2461,1284,1177,109.1,2432,1270,1162,109.3
31011, 장안구,015002, 11세,2021,2428,1267,1161,109.1,2407,1255,1152,108.9
31011, 장안구,015003, 12세,2021,2458,1260,1198,105.2,2437,1250,1187,105.3
31011, 장안구,015004, 13세,2021,2796,1425,1371,103.9,2778,1418,1360,104.3
31011, 장안구,015005, 14세,2021,2846,1463,1383,105.8,2828,1456,1372,106.1
31011, 장안구,020,15~19세,2021,14802,7891,6911,114.2,14611,7815,6796,115
31011, 장안구,020001, 15세,2021,2618,1338,1280,104.5,2606,1332,1274,104.6
31011, 장안구,020002, 16세,2021,2634,1357,1277,106.3,2624,1354,1270,106.6
31011, 장안구,020003, 17세,2021,3006,1653,1353,122.2,2994,1649,1345,122.6
31011, 장안구,020004, 18세,2021,3144,1676,1468,114.2,3112,1661,1451,114.5
31011, 장안구,020005, 19세,2021,3400,1867,1533,121.8,3275,1819,1456,124.9
31011, 장안구,025,20~24세,2021,22684,12429,10255,121.2,21643,11958,9685,123.5
31011, 장안구,025001, 20세,2021,3906,2170,1736,125,3788,2117,1671,126.7
31011, 장안구,025002, 21세,2021,4442,2305,2137,107.9,4205,2218,1987,111.6
31011, 장안구,025003, 22세,2021,4352,2376,1976,120.2,4132,2283,1849,123.5
31011, 장안구,025004, 23세,2021,4918,2704,2214,122.1,4701,2596,2105,123.3
31011, 장안구,025005, 24세,2021,5066,2874,2192,131.1,4817,2744,2073,132.4
31011, 장안구,030,25~29세,2021,22541,12591,9950,126.5,21360,11921,9439,126.3
31011, 장안구,030001, 25세,2021,4781,2715,2066,131.4,4543,2575,1968,130.8
31011, 장안구,030002, 26세,2021,4601,2583,2018,128,4379,2456,1923,127.7
31011, 장안구,030003, 27세,2021,4512,2524,1988,127,4270,2394,1876,127.6
31011, 장안구,030004, 28세,2021,4404,2419,1985,121.9,4183,2296,1887,121.7
31011, 장안구,030005, 29세,2021,4243,2350,1893,124.1,3985,2200,1785,123.2
31011, 장안구,035,30~34세,2021,16888,9133,7755,117.8,15696,8531,7165,119.1
31011, 장안구,035001, 30세,2021,3926,2159,1767,122.2,3690,2033,1657,122.7
31011, 장안구,035002, 31세,2021,3570,1935,1635,118.3,3294,1792,1502,119.3
31011, 장안구,035003, 32세,2021,3289,1780,1509,118,3065,1677,1388,120.8
31011, 장안구,035004, 33세,2021,3056,1649,1407,117.2,2825,1538,1287,119.5
31011, 장안구,035005, 34세,2021,3047,1610,1437,112,2822,1491,1331,112
31011, 장안구,040,35~39세,2021,17061,8746,8315,105.2,16068,8236,7832,105.2
31011, 장안구,040001, 35세,2021,3085,1626,1459,111.4,2864,1509,1355,111.4
31011, 장안구,040002, 36세,2021,3218,1679,1539,109.1,3009,1580,1429,110.6
31011, 장안구,040003, 37세,2021,3228,1627,1601,101.6,3039,1521,1518,100.2
31011, 장안구,040004, 38세,2021,3535,1821,1714,106.2,3357,1739,1618,107.5
31011, 장안구,040005, 39세,2021,3995,1993,2002,99.6,3799,1887,1912,98.7
31011, 장안구,045,40~44세,2021,20566,10239,10327,99.1,19866,9833,10033,98
31011, 장안구,045001, 40세,2021,4071,2035,2036,100,3918,1943,1975,98.4
31011, 장안구,045002, 41세,2021,4220,2117,2103,100.7,4078,2032,2046,99.3
31011, 장안구,045003, 42세,2021,4251,2077,2174,95.5,4095,1984,2111,94
31011, 장안구,045004, 43세,2021,3876,1984,1892,104.9,3739,1909,1830,104.3
31011, 장안구,045005, 44세,2021,4148,2026,2122,95.5,4036,1965,2071,94.9
31011, 장안구,050,45~49세,2021,23687,11723,11964,98,22961,11326,11635,97.3
31011, 장안구,050001, 45세,2021,4196,2095,2101,99.7,4081,2033,2048,99.3
31011, 장안구,050002, 46세,2021,4377,2155,2222,97,4278,2104,2174,96.8
31011, 장안구,050003, 47세,2021,4956,2439,2517,96.9,4827,2367,2460,96.2
31011, 장안구,050004, 48세,2021,5123,2483,2640,94.1,4928,2384,2544,93.7
31011, 장안구,050005, 49세,2021,5035,2551,2484,102.7,4847,2438,2409,101.2
31011, 장안구,055,50~54세,2021,26634,12989,13645,95.2,25722,12539,13183,95.1
31011, 장안구,055001, 50세,2021,5387,2678,2709,98.9,5205,2589,2616,99
31011, 장안구,055002, 51세,2021,5286,2668,2618,101.9,5087,2557,2530,101.1
31011, 장안구,055003, 52세,2021,5536,2652,2884,92,5348,2563,2785,92
31011, 장안구,055004, 53세,2021,5475,2606,2869,90.8,5291,2525,2766,91.3
31011, 장안구,055005, 54세,2021,4950,2385,2565,93,4791,2305,2486,92.7
31011, 장안구,060,55~59세,2021,23131,11788,11343,103.9,22185,11308,10877,104
31011, 장안구,060001, 55세,2021,4784,2424,2360,102.7,4627,2343,2284,102.6
31011, 장안구,060002, 56세,2021,4752,2430,2322,104.7,4554,2326,2228,104.4
31011, 장안구,060003, 57세,2021,4391,2240,2151,104.1,4191,2135,2056,103.8
31011, 장안구,060004, 58세,2021,4711,2432,2279,106.7,4489,2319,2170,106.9
31011, 장안구,060005, 59세,2021,4493,2262,2231,101.4,4324,2185,2139,102.2
31011, 장안구,065,60~64세,2021,20456,10278,10178,101,19811,9949,9862,100.9
31011, 장안구,065001, 60세,2021,4825,2409,2416,99.7,4731,2359,2372,99.5
31011, 장안구,065002, 61세,2021,4595,2340,2255,103.8,4416,2252,2164,104.1
31011, 장안구,065003, 62세,2021,4043,2022,2021,100,3909,1956,1953,100.2
31011, 장안구,065004, 63세,2021,3648,1833,1815,101,3528,1765,1763,100.1
31011, 장안구,065005, 64세,2021,3345,1674,1671,100.2,3227,1617,1610,100.4
31011, 장안구,070,65~69세,2021,13360,6443,6917,93.1,12910,6224,6686,93.1
31011, 장안구,070001, 65세,2021,3086,1548,1538,100.7,2968,1482,1486,99.7
31011, 장안구,070002, 66세,2021,3121,1463,1658,88.2,3007,1407,1600,87.9
31011, 장안구,070003, 67세,2021,2519,1232,1287,95.7,2431,1196,1235,96.8
31011, 장안구,070004, 68세,2021,2245,1054,1191,88.5,2172,1021,1151,88.7
31011, 장안구,070005, 69세,2021,2389,1146,1243,92.2,2332,1118,1214,92.1
31011, 장안구,075,70~74세,2021,8937,4093,4844,84.5,8788,4024,4764,84.5
31011, 장안구,075001, 70세,2021,1633,751,882,85.1,1587,729,858,85
31011, 장안구,075002, 71세,2021,1871,840,1031,81.5,1831,821,1010,81.3
31011, 장안구,075003, 72세,2021,1843,865,978,88.4,1817,855,962,88.9
31011, 장안구,075004, 73세,2021,1774,832,942,88.3,1757,822,935,87.9
31011, 장안구,075005, 74세,2021,1816,805,1011,79.6,1796,797,999,79.8
31011, 장안구,080,75~79세,2021,7102,2997,4105,73,7031,2976,4055,73.4
31011, 장안구,080001, 75세,2021,1389,624,765,81.6,1372,616,756,81.5
31011, 장안구,080002, 76세,2021,1399,578,821,70.4,1382,571,811,70.4
31011, 장안구,080003, 77세,2021,1387,578,809,71.4,1370,577,793,72.8
31011, 장안구,080004, 78세,2021,1385,587,798,73.6,1377,585,792,73.9
31011, 장안구,080005, 79세,2021,1542,630,912,69.1,1530,627,903,69.4
31011, 장안구,085,80~84세,2021,5125,2025,3100,65.3,5081,2016,3065,65.8
31011, 장안구,085001, 80세,2021,1250,516,734,70.3,1239,515,724,71.1
31011, 장안구,085002, 81세,2021,1072,436,636,68.6,1064,434,630,68.9
31011, 장안구,085003, 82세,2021,1026,397,629,63.1,1017,396,621,63.8
31011, 장안구,085004, 83세,2021,929,378,551,68.6,923,375,548,68.4
31011, 장안구,085005, 84세,2021,848,298,550,54.2,838,296,542,54.6
31011, 장안구,090,85~89세,2021,2820,876,1944,45.1,2798,869,1929,45
31011, 장안구,090001, 85세,2021,773,248,525,47.2,767,245,522,46.9
31011, 장안구,090002, 86세,2021,685,221,464,47.6,679,220,459,47.9
31011, 장안구,090003, 87세,2021,536,179,357,50.1,531,177,354,50
31011, 장안구,090004, 88세,2021,416,115,301,38.2,414,115,299,38.5
31011, 장안구,090005, 89세,2021,410,113,297,38,407,112,295,38
31011, 장안구,095,90~94세,2021,1036,268,768,34.9,1035,268,767,34.9
31011, 장안구,095001, 90세,2021,284,81,203,39.9,283,81,202,40.1
31011, 장안구,095002, 91세,2021,244,56,188,29.8,244,56,188,29.8
31011, 장안구,095003, 92세,2021,231,61,170,35.9,231,61,170,35.9
31011, 장안구,095004, 93세,2021,155,44,111,39.6,155,44,111,39.6
31011, 장안구,095005, 94세,2021,122,26,96,27.1,122,26,96,27.1
31011, 장안구,100,95~99세,2021,208,43,165,26.1,208,43,165,26.1
31011, 장안구,100001, 95세,2021,60,12,48,25,60,12,48,25
31011, 장안구,100002, 96세,2021,62,12,50,24,62,12,50,24
31011, 장안구,100003, 97세,2021,36,8,28,28.6,36,8,28,28.6
31011, 장안구,100004, 98세,2021,25,8,17,47.1,25,8,17,47.1
31011, 장안구,100005, 99세,2021,25,X,22,13.6,25,X,22,13.6
31011, 장안구,101,100세이상,2021,30,5,25,20,30,5,25,20
31011, 장안구,102,15세미만,2021,30718,15795,14923,105.8,30163,15509,14654,105.8
31011, 장안구,103,15~64세,2021,208450,107807,100643,107.1,199923,103416,96507,107.2
31011, 장안구,104,65세이상,2021,38618,16750,21868,76.6,37881,16425,21456,76.6
31011, 장안구,086,85세이상,2021,4094,1192,2902,41.1,4071,1185,2886,41.1
31011, 장안구,126,평균연령,2021,42.2,41,43.5,,42.3,41,43.6,
31011, 장안구,127,중위연령,2021,43.4,41.7,45.1,,43.6,41.9,45.3,
31012, 권선구,000,합계,2021,368924,186179,182745,101.9,354006,178643,175363,101.9
31012, 권선구,005,0~4세,2021,13084,6741,6343,106.3,12598,6501,6097,106.6
31012, 권선구,005001, 0세,2021,2220,1161,1059,109.6,2136,1118,1018,109.8
31012, 권선구,005002, 1세,2021,2400,1222,1178,103.7,2307,1175,1132,103.8
31012, 권선구,005003, 2세,2021,2588,1331,1257,105.9,2480,1279,1201,106.5
31012, 권선구,005004, 3세,2021,2808,1434,1374,104.4,2698,1378,1320,104.4
31012, 권선구,005005, 4세,2021,3068,1593,1475,108,2977,1551,1426,108.8
31012, 권선구,010,5~9세,2021,17519,8976,8543,105.1,17185,8808,8377,105.1
31012, 권선구,010001, 5세,2021,3475,1829,1646,111.1,3382,1779,1603,111
31012, 권선구,010002, 6세,2021,3535,1826,1709,106.8,3469,1788,1681,106.4
31012, 권선구,010003, 7세,2021,3472,1743,1729,100.8,3390,1706,1684,101.3
31012, 권선구,010004, 8세,2021,3371,1698,1673,101.5,3326,1683,1643,102.4
31012, 권선구,010005, 9세,2021,3666,1880,1786,105.3,3618,1852,1766,104.9
31012, 권선구,015,10~14세,2021,16306,8388,7918,105.9,16109,8287,7822,105.9
31012, 권선구,015001, 10세,2021,3481,1787,1694,105.5,3423,1754,1669,105.1
31012, 권선구,015002, 11세,2021,3170,1596,1574,101.4,3139,1578,1561,101.1
31012, 권선구,015003, 12세,2021,3159,1626,1533,106.1,3120,1609,1511,106.5
31012, 권선구,015004, 13세,2021,3187,1672,1515,110.4,3151,1654,1497,110.5
31012, 권선구,015005, 14세,2021,3309,1707,1602,106.6,3276,1692,1584,106.8
31012, 권선구,020,15~19세,2021,15367,7996,7371,108.5,15235,7942,7293,108.9
31012, 권선구,020001, 15세,2021,3005,1568,1437,109.1,2979,1557,1422,109.5
31012, 권선구,020002, 16세,2021,2848,1446,1402,103.1,2822,1437,1385,103.8
31012, 권선구,020003, 17세,2021,3118,1668,1450,115,3092,1653,1439,114.9
31012, 권선구,020004, 18세,2021,3247,1708,1539,111,3227,1699,1528,111.2
31012, 권선구,020005, 19세,2021,3149,1606,1543,104.1,3115,1596,1519,105.1
31012, 권선구,025,20~24세,2021,22080,11361,10719,106,21739,11219,10520,106.6
31012, 권선구,025001, 20세,2021,3785,2013,1772,113.6,3754,2000,1754,114
31012, 권선구,025002, 21세,2021,4277,2230,2047,108.9,4227,2212,2015,109.8
31012, 권선구,025003, 22세,2021,4262,2183,2079,105,4192,2156,2036,105.9
31012, 권선구,025004, 23세,2021,4630,2430,2200,110.5,4540,2389,2151,111.1
31012, 권선구,025005, 24세,2021,5126,2505,2621,95.6,5026,2462,2564,96
31012, 권선구,030,25~29세,2021,29731,15619,14112,110.7,28790,15184,13606,111.6
31012, 권선구,030001, 25세,2021,5451,2790,2661,104.8,5323,2742,2581,106.2
31012, 권선구,030002, 26세,2021,5834,3041,2793,108.9,5676,2958,2718,108.8
31012, 권선구,030003, 27세,2021,5943,3135,2808,111.6,5774,3050,2724,112
31012, 권선구,030004, 28세,2021,6188,3301,2887,114.3,5959,3206,2753,116.5
31012, 권선구,030005, 29세,2021,6315,3352,2963,113.1,6058,3228,2830,114.1
31012, 권선구,035,30~34세,2021,28307,14968,13339,112.2,26513,14042,12471,112.6
31012, 권선구,035001, 30세,2021,6042,3263,2779,117.4,5775,3135,2640,118.8
31012, 권선구,035002, 31세,2021,5707,3015,2692,112,5373,2854,2519,113.3
31012, 권선구,035003, 32세,2021,5557,2934,2623,111.9,5193,2744,2449,112
31012, 권선구,035004, 33세,2021,5456,2835,2621,108.2,5043,2628,2415,108.8
31012, 권선구,035005, 34세,2021,5545,2921,2624,111.3,5129,2681,2448,109.5
31012, 권선구,040,35~39세,2021,30231,15824,14407,109.8,28430,14867,13563,109.6
31012, 권선구,040001, 35세,2021,5486,2889,2597,111.2,5072,2673,2399,111.4
31012, 권선구,040002, 36세,2021,5709,2950,2759,106.9,5292,2736,2556,107
31012, 권선구,040003, 37세,2021,5907,3160,2747,115,5558,2964,2594,114.3
31012, 권선구,040004, 38세,2021,6330,3296,3034,108.6,6038,3147,2891,108.9
31012, 권선구,040005, 39세,2021,6799,3529,3270,107.9,6470,3347,3123,107.2
31012, 권선구,045,40~44세,2021,31445,16425,15020,109.4,30112,15683,14429,108.7
31012, 권선구,045001, 40세,2021,6876,3553,3323,106.9,6599,3408,3191,106.8
31012, 권선구,045002, 41세,2021,6742,3561,3181,111.9,6492,3415,3077,111
31012, 권선구,045003, 42세,2021,6373,3306,3067,107.8,6086,3148,2938,107.1
31012, 권선구,045004, 43세,2021,5720,2982,2738,108.9,5466,2840,2626,108.1
31012, 권선구,045005, 44세,2021,5734,3023,2711,111.5,5469,2872,2597,110.6
31012, 권선구,050,45~49세,2021,29923,15338,14585,105.2,28612,14621,13991,104.5
31012, 권선구,050001, 45세,2021,5586,2928,2658,110.2,5319,2781,2538,109.6
31012, 권선구,050002, 46세,2021,5728,2919,2809,103.9,5500,2796,2704,103.4
31012, 권선구,050003, 47세,2021,6060,3097,2963,104.5,5836,2958,2878,102.8
31012, 권선구,050004, 48세,2021,6246,3163,3083,102.6,5967,3018,2949,102.3
31012, 권선구,050005, 49세,2021,6303,3231,3072,105.2,5990,3068,2922,105
31012, 권선구,055,50~54세,2021,32827,15960,16867,94.6,31194,15118,16076,94
31012, 권선구,055001, 50세,2021,6732,3421,3311,103.3,6384,3235,3149,102.7
31012, 권선구,055002, 51세,2021,6326,3097,3229,95.9,5985,2931,3054,96
31012, 권선구,055003, 52세,2021,6721,3188,3533,90.2,6378,3019,3359,89.9
31012, 권선구,055004, 53세,2021,6743,3185,3558,89.5,6408,3013,3395,88.7
31012, 권선구,055005, 54세,2021,6305,3069,3236,94.8,6039,2920,3119,93.6
31012, 권선구,060,55~59세,2021,30761,15353,15408,99.6,28836,14403,14433,99.8
31012, 권선구,060001, 55세,2021,6105,3017,3088,97.7,5778,2850,2928,97.3
31012, 권선구,060002, 56세,2021,6556,3218,3338,96.4,6144,3012,3132,96.2
31012, 권선구,060003, 57세,2021,5867,2916,2951,98.8,5492,2723,2769,98.3
31012, 권선구,060004, 58세,2021,6246,3194,3052,104.7,5765,2961,2804,105.6
31012, 권선구,060005, 59세,2021,5987,3008,2979,101,5657,2857,2800,102
31012, 권선구,065,60~64세,2021,27429,13701,13728,99.8,26117,13039,13078,99.7
31012, 권선구,065001, 60세,2021,6540,3262,3278,99.5,6349,3161,3188,99.2
31012, 권선구,065002, 61세,2021,6203,3121,3082,101.3,5878,2956,2922,101.2
31012, 권선구,065003, 62세,2021,5462,2704,2758,98,5206,2577,2629,98
31012, 권선구,065004, 63세,2021,4771,2362,2409,98,4507,2233,2274,98.2
31012, 권선구,065005, 64세,2021,4453,2252,2201,102.3,4177,2112,2065,102.3
31012, 권선구,070,65~69세,2021,17276,8415,8861,95,16439,8011,8428,95.1
31012, 권선구,070001, 65세,2021,4050,1999,2051,97.5,3826,1886,1940,97.2
31012, 권선구,070002, 66세,2021,4068,1999,2069,96.6,3870,1903,1967,96.7
31012, 권선구,070003, 67세,2021,3232,1541,1691,91.1,3067,1462,1605,91.1
31012, 권선구,070004, 68세,2021,2865,1353,1512,89.5,2726,1289,1437,89.7
31012, 권선구,070005, 69세,2021,3061,1523,1538,99,2950,1471,1479,99.5
31012, 권선구,075,70~74세,2021,10512,4964,5548,89.5,10211,4836,5375,90
31012, 권선구,075001, 70세,2021,2008,939,1069,87.8,1917,896,1021,87.8
31012, 권선구,075002, 71세,2021,2131,1039,1092,95.1,2062,1003,1059,94.7
31012, 권선구,075003, 72세,2021,2169,1041,1128,92.3,2107,1015,1092,92.9
31012, 권선구,075004, 73세,2021,2061,953,1108,86,2029,945,1084,87.2
31012, 권선구,075005, 74세,2021,2143,992,1151,86.2,2096,977,1119,87.3
31012, 권선구,080,75~79세,2021,7325,3234,4091,79.1,7203,3194,4009,79.7
31012, 권선구,080001, 75세,2021,1551,689,862,79.9,1518,681,837,81.4
31012, 권선구,080002, 76세,2021,1481,687,794,86.5,1456,676,780,86.7
31012, 권선구,080003, 77세,2021,1471,659,812,81.2,1445,649,796,81.5
31012, 권선구,080004, 78세,2021,1331,555,776,71.5,1310,549,761,72.1
31012, 권선구,080005, 79세,2021,1491,644,847,76,1474,639,835,76.5
31012, 권선구,085,80~84세,2021,5151,1884,3267,57.7,5066,1864,3202,58.2
31012, 권선구,085001, 80세,2021,1260,482,778,62,1233,476,757,62.9
31012, 권선구,085002, 81세,2021,1064,404,660,61.2,1050,399,651,61.3
31012, 권선구,085003, 82세,2021,1099,400,699,57.2,1079,398,681,58.4
31012, 권선구,085004, 83세,2021,909,324,585,55.4,897,321,576,55.7
31012, 권선구,085005, 84세,2021,819,274,545,50.3,807,270,537,50.3
31012, 권선구,090,85~89세,2021,2589,793,1796,44.2,2562,785,1777,44.2
31012, 권선구,090001, 85세,2021,668,223,445,50.1,658,218,440,49.5
31012, 권선구,090002, 86세,2021,636,188,448,42,630,187,443,42.2
31012, 권선구,090003, 87세,2021,508,159,349,45.6,504,158,346,45.7
31012, 권선구,090004, 88세,2021,432,124,308,40.3,426,123,303,40.6
31012, 권선구,090005, 89세,2021,345,99,246,40.2,344,99,245,40.4
31012, 권선구,095,90~94세,2021,843,197,646,30.5,838,197,641,30.7
31012, 권선구,095001, 90세,2021,221,60,161,37.3,217,60,157,38.2
31012, 권선구,095002, 91세,2021,225,53,172,30.8,225,53,172,30.8
31012, 권선구,095003, 92세,2021,180,40,140,28.6,180,40,140,28.6
31012, 권선구,095004, 93세,2021,126,27,99,27.3,125,27,98,27.6
31012, 권선구,095005, 94세,2021,91,17,74,23,91,17,74,23
31012, 권선구,100,95~99세,2021,186,37,149,24.8,185,37,148,25
31012, 권선구,100001, 95세,2021,61,10,51,19.6,61,10,51,19.6
31012, 권선구,100002, 96세,2021,52,9,43,20.9,52,9,43,20.9
31012, 권선구,100003, 97세,2021,31,9,22,40.9,30,9,21,42.9
31012, 권선구,100004, 98세,2021,22,6,16,37.5,22,6,16,37.5
31012, 권선구,100005, 99세,2021,20,X,17,17.6,20,X,17,17.6
31012, 권선구,101,100세이상,2021,32,5,27,18.5,32,5,27,18.5
31012, 권선구,102,15세미만,2021,46909,24105,22804,105.7,45892,23596,22296,105.8
31012, 권선구,103,15~64세,2021,278101,142545,135556,105.2,265578,136118,129460,105.1
31012, 권선구,104,65세이상,2021,43914,19529,24385,80.1,42536,18929,23607,80.2
31012, 권선구,086,85세이상,2021,3650,1032,2618,39.4,3617,1024,2593,39.5
31012, 권선구,126,평균연령,2021,41.2,40.4,42.1,,41.1,40.2,42,
31012, 권선구,127,중위연령,2021,41.7,40.9,42.7,,41.6,40.7,42.6,
31013, 팔달구,000,합계,2021,195418,99258,96160,103.2,175662,88559,87103,101.7
31013, 팔달구,005,0~4세,2021,5045,2545,2500,101.8,4508,2292,2216,103.4
31013, 팔달구,005001, 0세,2021,936,495,441,112.2,844,450,394,114.2
31013, 팔달구,005002, 1세,2021,953,477,476,100.2,831,422,409,103.2
31013, 팔달구,005003, 2세,2021,1016,507,509,99.6,905,454,451,100.7
31013, 팔달구,005004, 3세,2021,1039,525,514,102.1,931,476,455,104.6
31013, 팔달구,005005, 4세,2021,1101,541,560,96.6,997,490,507,96.6
31013, 팔달구,010,5~9세,2021,5741,2910,2831,102.8,5321,2701,2620,103.1
31013, 팔달구,010001, 5세,2021,1191,587,604,97.2,1084,531,553,96
31013, 팔달구,010002, 6세,2021,1118,552,566,97.5,1018,504,514,98.1
31013, 팔달구,010003, 7세,2021,1073,554,519,106.7,990,516,474,108.9
31013, 팔달구,010004, 8세,2021,1144,576,568,101.4,1074,544,530,102.6
31013, 팔달구,010005, 9세,2021,1215,641,574,111.7,1155,606,549,110.4
31013, 팔달구,015,10~14세,2021,6272,3266,3006,108.6,6047,3156,2891,109.2
31013, 팔달구,015001, 10세,2021,1200,630,570,110.5,1137,598,539,110.9
31013, 팔달구,015002, 11세,2021,1208,611,597,102.3,1165,590,575,102.6
31013, 팔달구,015003, 12세,2021,1172,634,538,117.8,1132,613,519,118.1
31013, 팔달구,015004, 13세,2021,1320,691,629,109.9,1276,669,607,110.2
31013, 팔달구,015005, 14세,2021,1372,700,672,104.2,1337,686,651,105.4
31013, 팔달구,020,15~19세,2021,7145,3648,3497,104.3,6977,3570,3407,104.8
31013, 팔달구,020001, 15세,2021,1239,629,610,103.1,1199,610,589,103.6
31013, 팔달구,020002, 16세,2021,1298,633,665,95.2,1271,625,646,96.7
31013, 팔달구,020003, 17세,2021,1483,776,707,109.8,1458,762,696,109.5
31013, 팔달구,020004, 18세,2021,1539,817,722,113.2,1505,798,707,112.9
31013, 팔달구,020005, 19세,2021,1586,793,793,100,1544,775,769,100.8
31013, 팔달구,025,20~24세,2021,12154,6018,6136,98.1,11702,5803,5899,98.4
31013, 팔달구,025001, 20세,2021,1891,952,939,101.4,1833,927,906,102.3
31013, 팔달구,025002, 21세,2021,2272,1167,1105,105.6,2198,1130,1068,105.8
31013, 팔달구,025003, 22세,2021,2398,1201,1197,100.3,2315,1160,1155,100.4
31013, 팔달구,025004, 23세,2021,2658,1274,1384,92.1,2537,1220,1317,92.6
31013, 팔달구,025005, 24세,2021,2935,1424,1511,94.2,2819,1366,1453,94
31013, 팔달구,030,25~29세,2021,18144,9546,8598,111,17107,9032,8075,111.9
31013, 팔달구,030001, 25세,2021,3363,1682,1681,100.1,3214,1612,1602,100.6
31013, 팔달구,030002, 26세,2021,3643,1846,1797,102.7,3487,1773,1714,103.4
31013, 팔달구,030003, 27세,2021,3627,1936,1691,114.5,3439,1830,1609,113.7
31013, 팔달구,030004, 28세,2021,3771,2052,1719,119.4,3525,1940,1585,122.4
31013, 팔달구,030005, 29세,2021,3740,2030,1710,118.7,3442,1877,1565,119.9
31013, 팔달구,035,30~34세,2021,15846,8716,7130,122.2,13801,7565,6236,121.3
31013, 팔달구,035001, 30세,2021,3423,1863,1560,119.4,3123,1693,1430,118.4
31013, 팔달구,035002, 31세,2021,3272,1778,1494,119,2858,1555,1303,119.3
31013, 팔달구,035003, 32세,2021,3181,1761,1420,124,2744,1523,1221,124.7
31013, 팔달구,035004, 33세,2021,3035,1674,1361,123,2603,1436,1167,123.1
31013, 팔달구,035005, 34세,2021,2935,1640,1295,126.6,2473,1358,1115,121.8
31013, 팔달구,040,35~39세,2021,14238,7857,6381,123.1,12120,6594,5526,119.3
31013, 팔달구,040001, 35세,2021,2846,1603,1243,129,2339,1303,1036,125.8
31013, 팔달구,040002, 36세,2021,2724,1489,1235,120.6,2296,1241,1055,117.6
31013, 팔달구,040003, 37세,2021,2743,1536,1207,127.3,2339,1294,1045,123.8
31013, 팔달구,040004, 38세,2021,2879,1584,1295,122.3,2511,1373,1138,120.7
31013, 팔달구,040005, 39세,2021,3046,1645,1401,117.4,2635,1383,1252,110.5
31013, 팔달구,045,40~44세,2021,14332,7655,6677,114.6,12651,6656,5995,111
31013, 팔달구,045001, 40세,2021,2889,1532,1357,112.9,2597,1351,1246,108.4
31013, 팔달구,045002, 41세,2021,3069,1680,1389,121,2721,1471,1250,117.7
31013, 팔달구,045003, 42세,2021,2870,1559,1311,118.9,2505,1329,1176,113
31013, 팔달구,045004, 43세,2021,2670,1426,1244,114.6,2315,1230,1085,113.4
31013, 팔달구,045005, 44세,2021,2834,1458,1376,106,2513,1275,1238,103
31013, 팔달구,050,45~49세,2021,15623,8114,7509,108.1,13778,7046,6732,104.7
31013, 팔달구,050001, 45세,2021,2723,1414,1309,108,2406,1214,1192,101.8
31013, 팔달구,050002, 46세,2021,2964,1552,1412,109.9,2644,1351,1293,104.5
31013, 팔달구,050003, 47세,2021,3245,1675,1570,106.7,2900,1491,1409,105.8
31013, 팔달구,050004, 48세,2021,3354,1731,1623,106.7,2955,1506,1449,103.9
31013, 팔달구,050005, 49세,2021,3337,1742,1595,109.2,2873,1484,1389,106.8
31013, 팔달구,055,50~54세,2021,18077,9210,8867,103.9,15637,7823,7814,100.1
31013, 팔달구,055001, 50세,2021,3679,1918,1761,108.9,3170,1604,1566,102.4
31013, 팔달구,055002, 51세,2021,3721,1969,1752,112.4,3175,1650,1525,108.2
31013, 팔달구,055003, 52세,2021,3704,1872,1832,102.2,3221,1606,1615,99.4
31013, 팔달구,055004, 53세,2021,3697,1794,1903,94.3,3207,1522,1685,90.3
31013, 팔달구,055005, 54세,2021,3276,1657,1619,102.3,2864,1441,1423,101.3
31013, 팔달구,060,55~59세,2021,17367,8918,8449,105.6,14381,7307,7074,103.3
31013, 팔달구,060001, 55세,2021,3366,1758,1608,109.3,2809,1469,1340,109.6
31013, 팔달구,060002, 56세,2021,3476,1818,1658,109.7,2875,1489,1386,107.4
31013, 팔달구,060003, 57세,2021,3416,1777,1639,108.4,2838,1455,1383,105.2
31013, 팔달구,060004, 58세,2021,3681,1849,1832,100.9,2958,1445,1513,95.5
31013, 팔달구,060005, 59세,2021,3428,1716,1712,100.2,2901,1449,1452,99.8
31013, 팔달구,065,60~64세,2021,15893,8017,7876,101.8,13998,7016,6982,100.5
31013, 팔달구,065001, 60세,2021,3562,1811,1751,103.4,3254,1659,1595,104
31013, 팔달구,065002, 61세,2021,3507,1758,1749,100.5,3046,1510,1536,98.3
31013, 팔달구,065003, 62세,2021,3119,1602,1517,105.6,2737,1386,1351,102.6
31013, 팔달구,065004, 63세,2021,2909,1457,1452,100.3,2547,1266,1281,98.8
31013, 팔달구,065005, 64세,2021,2796,1389,1407,98.7,2414,1195,1219,98
31013, 팔달구,070,65~69세,2021,11063,5206,5857,88.9,9913,4640,5273,88
31013, 팔달구,070001, 65세,2021,2517,1190,1327,89.7,2204,1031,1173,87.9
31013, 팔달구,070002, 66세,2021,2546,1190,1356,87.8,2267,1055,1212,87
31013, 팔달구,070003, 67세,2021,2161,1020,1141,89.4,1928,902,1026,87.9
31013, 팔달구,070004, 68세,2021,1786,827,959,86.2,1625,749,876,85.5
31013, 팔달구,070005, 69세,2021,2053,979,1074,91.2,1889,903,986,91.6
31013, 팔달구,075,70~74세,2021,7187,3283,3904,84.1,6728,3074,3654,84.1
31013, 팔달구,075001, 70세,2021,1349,640,709,90.3,1219,580,639,90.8
31013, 팔달구,075002, 71세,2021,1522,710,812,87.4,1413,656,757,86.7
31013, 팔달구,075003, 72세,2021,1429,661,768,86.1,1335,621,714,87
31013, 팔달구,075004, 73세,2021,1445,667,778,85.7,1382,633,749,84.5
31013, 팔달구,075005, 74세,2021,1442,605,837,72.3,1379,584,795,73.5
31013, 팔달구,080,75~79세,2021,5304,2277,3027,75.2,5159,2246,2913,77.1
31013, 팔달구,080001, 75세,2021,1064,490,574,85.4,1038,482,556,86.7
31013, 팔달구,080002, 76세,2021,1038,472,566,83.4,1007,464,543,85.5
31013, 팔달구,080003, 77세,2021,1050,427,623,68.5,1015,423,592,71.5
31013, 팔달구,080004, 78세,2021,1011,403,608,66.3,986,398,588,67.7
31013, 팔달구,080005, 79세,2021,1141,485,656,73.9,1113,479,634,75.6
31013, 팔달구,085,80~84세,2021,3600,1388,2212,62.7,3492,1359,2133,63.7
31013, 팔달구,085001, 80세,2021,910,371,539,68.8,887,365,522,69.9
31013, 팔달구,085002, 81세,2021,764,300,464,64.7,737,290,447,64.9
31013, 팔달구,085003, 82세,2021,722,275,447,61.5,699,269,430,62.6
31013, 팔달구,085004, 83세,2021,659,255,404,63.1,641,251,390,64.4
31013, 팔달구,085005, 84세,2021,545,187,358,52.2,528,184,344,53.5
31013, 팔달구,090,85~89세,2021,1731,537,1194,45,1695,533,1162,45.9
31013, 팔달구,090001, 85세,2021,523,154,369,41.7,507,153,354,43.2
31013, 팔달구,090002, 86세,2021,395,141,254,55.5,388,140,248,56.5
31013, 팔달구,090003, 87세,2021,338,109,229,47.6,328,107,221,48.4
31013, 팔달구,090004, 88세,2021,263,76,187,40.6,260,76,184,41.3
31013, 팔달구,090005, 89세,2021,212,57,155,36.8,212,57,155,36.8
31013, 팔달구,095,90~94세,2021,517,121,396,30.6,509,120,389,30.8
31013, 팔달구,095001, 90세,2021,154,43,111,38.7,152,43,109,39.4
31013, 팔달구,095002, 91세,2021,122,30,92,32.6,118,30,88,34.1
31013, 팔달구,095003, 92세,2021,108,24,84,28.6,106,23,83,27.7
31013, 팔달구,095004, 93세,2021,80,13,67,19.4,80,13,67,19.4
31013, 팔달구,095005, 94세,2021,53,11,42,26.2,53,11,42,26.2
31013, 팔달구,100,95~99세,2021,120,24,96,25,119,24,95,25.3
31013, 팔달구,100001, 95세,2021,46,11,35,31.4,45,11,34,32.4
31013, 팔달구,100002, 96세,2021,28,X,26,7.7,28,X,26,7.7
31013, 팔달구,100003, 97세,2021,18,X,15,20,18,X,15,20
31013, 팔달구,100004, 98세,2021,14,X,10,40,14,X,10,40
31013, 팔달구,100005, 99세,2021,14,X,10,40,14,X,10,40
31013, 팔달구,101,100세이상,2021,19,X,17,11.8,19,X,17,11.8
31013, 팔달구,102,15세미만,2021,17058,8721,8337,104.6,15876,8149,7727,105.5
31013, 팔달구,103,15~64세,2021,148819,77699,71120,109.3,132152,68412,63740,107.3
31013, 팔달구,104,65세이상,2021,29541,12838,16703,76.9,27634,11998,15636,76.7
31013, 팔달구,086,85세이상,2021,2387,684,1703,40.2,2342,679,1663,40.8
31013, 팔달구,126,평균연령,2021,43.8,42.9,44.8,,43.6,42.6,44.6,
31013, 팔달구,127,중위연령,2021,44.6,43.2,46,,44,42.6,45.6,
31014, 영통구,000,합계,2021,366209,183594,182615,100.5,356717,178967,177750,100.7
31014, 영통구,005,0~4세,2021,14228,7389,6839,108,13909,7221,6688,108
31014, 영통구,005001, 0세,2021,2635,1377,1258,109.5,2580,1347,1233,109.2
31014, 영통구,005002, 1세,2021,2532,1326,1206,110,2477,1301,1176,110.6
31014, 영통구,005003, 2세,2021,2841,1450,1391,104.2,2777,1416,1361,104
31014, 영통구,005004, 3세,2021,3093,1608,1485,108.3,3017,1558,1459,106.8
31014, 영통구,005005, 4세,2021,3127,1628,1499,108.6,3058,1599,1459,109.6
31014, 영통구,010,5~9세,2021,20052,10389,9663,107.5,19664,10199,9465,107.8
31014, 영통구,010001, 5세,2021,3700,1933,1767,109.4,3593,1885,1708,110.4
31014, 영통구,010002, 6세,2021,4170,2143,2027,105.7,4074,2095,1979,105.9
31014, 영통구,010003, 7세,2021,3876,2005,1871,107.2,3819,1974,1845,107
31014, 영통구,010004, 8세,2021,3968,2081,1887,110.3,3888,2041,1847,110.5
31014, 영통구,010005, 9세,2021,4338,2227,2111,105.5,4290,2204,2086,105.7
31014, 영통구,015,10~14세,2021,20776,10767,10009,107.6,20594,10665,9929,107.4
31014, 영통구,015001, 10세,2021,4207,2190,2017,108.6,4152,2152,2000,107.6
31014, 영통구,015002, 11세,2021,4069,2159,1910,113,4037,2144,1893,113.3
31014, 영통구,015003, 12세,2021,3901,2004,1897,105.6,3861,1987,1874,106
31014, 영통구,015004, 13세,2021,4317,2186,2131,102.6,4283,2163,2120,102
31014, 영통구,015005, 14세,2021,4282,2228,2054,108.5,4261,2219,2042,108.7
31014, 영통구,020,15~19세,2021,20163,10251,9912,103.4,19919,10167,9752,104.3
31014, 영통구,020001, 15세,2021,3849,2013,1836,109.6,3831,2009,1822,110.3
31014, 영통구,020002, 16세,2021,3693,1873,1820,102.9,3677,1865,1812,102.9
31014, 영통구,020003, 17세,2021,4124,2101,2023,103.9,4112,2096,2016,104
31014, 영통구,020004, 18세,2021,4128,2074,2054,101,4103,2064,2039,101.2
31014, 영통구,020005, 19세,2021,4369,2190,2179,100.5,4196,2133,2063,103.4
31014, 영통구,025,20~24세,2021,27244,13681,13563,100.9,25822,13084,12738,102.7
31014, 영통구,025001, 20세,2021,5069,2503,2566,97.5,4737,2393,2344,102.1
31014, 영통구,025002, 21세,2021,5452,2685,2767,97,5196,2581,2615,98.7
31014, 영통구,025003, 22세,2021,5277,2691,2586,104.1,5009,2573,2436,105.6
31014, 영통구,025004, 23세,2021,5710,2861,2849,100.4,5412,2728,2684,101.6
31014, 영통구,025005, 24세,2021,5736,2941,2795,105.2,5468,2809,2659,105.6
31014, 영통구,030,25~29세,2021,32345,16943,15402,110,31061,16333,14728,110.9
31014, 영통구,030001, 25세,2021,6146,3181,2965,107.3,5880,3064,2816,108.8
31014, 영통구,030002, 26세,2021,6292,3265,3027,107.9,6045,3164,2881,109.8
31014, 영통구,030003, 27세,2021,6517,3391,3126,108.5,6278,3264,3014,108.3
31014, 영통구,030004, 28세,2021,6615,3484,3131,111.3,6341,3348,2993,111.9
31014, 영통구,030005, 29세,2021,6775,3622,3153,114.9,6517,3493,3024,115.5
31014, 영통구,035,30~34세,2021,30650,16001,14649,109.2,29425,15366,14059,109.3
31014, 영통구,035001, 30세,2021,6459,3416,3043,112.3,6229,3296,2933,112.4
31014, 영통구,035002, 31세,2021,6154,3207,2947,108.8,5899,3061,2838,107.9
31014, 영통구,035003, 32세,2021,6093,3173,2920,108.7,5856,3065,2791,109.8
31014, 영통구,035004, 33세,2021,6012,3161,2851,110.9,5759,3030,2729,111
31014, 영통구,035005, 34세,2021,5932,3044,2888,105.4,5682,2914,2768,105.3
31014, 영통구,040,35~39세,2021,31136,15612,15524,100.6,30008,15033,14975,100.4
31014, 영통구,040001, 35세,2021,5864,2992,2872,104.2,5612,2861,2751,104
31014, 영통구,040002, 36세,2021,5949,2978,2971,100.2,5701,2865,2836,101
31014, 영통구,040003, 37세,2021,5871,2962,2909,101.8,5639,2833,2806,101
31014, 영통구,040004, 38세,2021,6360,3224,3136,102.8,6170,3128,3042,102.8
31014, 영통구,040005, 39세,2021,7092,3456,3636,95,6886,3346,3540,94.5
31014, 영통구,045,40~44세,2021,33720,16603,17117,97,32982,16189,16793,96.4
31014, 영통구,045001, 40세,2021,7048,3494,3554,98.3,6888,3410,3478,98
31014, 영통구,045002, 41세,2021,7087,3445,3642,94.6,6918,3345,3573,93.6
31014, 영통구,045003, 42세,2021,6782,3326,3456,96.2,6627,3242,3385,95.8
31014, 영통구,045004, 43세,2021,6312,3158,3154,100.1,6189,3087,3102,99.5
31014, 영통구,045005, 44세,2021,6491,3180,3311,96,6360,3105,3255,95.4
31014, 영통구,050,45~49세,2021,32622,16003,16619,96.3,32026,15692,16334,96.1
31014, 영통구,050001, 45세,2021,6352,3162,3190,99.1,6231,3100,3131,99
31014, 영통구,050002, 46세,2021,6340,3163,3177,99.6,6233,3110,3123,99.6
31014, 영통구,050003, 47세,2021,6628,3159,3469,91.1,6510,3092,3418,90.5
31014, 영통구,050004, 48세,2021,6714,3215,3499,91.9,6595,3153,3442,91.6
31014, 영통구,050005, 49세,2021,6588,3304,3284,100.6,6457,3237,3220,100.5
31014, 영통구,055,50~54세,2021,31147,15421,15726,98.1,30565,15116,15449,97.8
31014, 영통구,055001, 50세,2021,6895,3428,3467,98.9,6779,3367,3412,98.7
31014, 영통구,055002, 51세,2021,6470,3283,3187,103,6347,3211,3136,102.4
31014, 영통구,055003, 52세,2021,6422,3174,3248,97.7,6289,3114,3175,98.1
31014, 영통구,055004, 53세,2021,6024,2936,3088,95.1,5918,2877,3041,94.6
31014, 영통구,055005, 54세,2021,5336,2600,2736,95,5232,2547,2685,94.9
31014, 영통구,060,55~59세,2021,24160,12152,12008,101.2,23561,11868,11693,101.5
31014, 영통구,060001, 55세,2021,5026,2472,2554,96.8,4911,2415,2496,96.8
31014, 영통구,060002, 56세,2021,5143,2565,2578,99.5,5011,2500,2511,99.6
31014, 영통구,060003, 57세,2021,4652,2323,2329,99.7,4548,2274,2274,100
31014, 영통구,060004, 58세,2021,4831,2477,2354,105.2,4687,2413,2274,106.1
31014, 영통구,060005, 59세,2021,4508,2315,2193,105.6,4404,2266,2138,106
31014, 영통구,065,60~64세,2021,19099,9809,9290,105.6,18709,9625,9084,106
31014, 영통구,065001, 60세,2021,4687,2393,2294,104.3,4613,2356,2257,104.4
31014, 영통구,065002, 61세,2021,4385,2251,2134,105.5,4303,2209,2094,105.5
31014, 영통구,065003, 62세,2021,3707,1931,1776,108.7,3635,1903,1732,109.9
31014, 영통구,065004, 63세,2021,3390,1733,1657,104.6,3303,1691,1612,104.9
31014, 영통구,065005, 64세,2021,2930,1501,1429,105,2855,1466,1389,105.5
31014, 영통구,070,65~69세,2021,11016,5332,5684,93.8,10789,5226,5563,93.9
31014, 영통구,070001, 65세,2021,2662,1340,1322,101.4,2589,1300,1289,100.9
31014, 영통구,070002, 66세,2021,2601,1237,1364,90.7,2550,1214,1336,90.9
31014, 영통구,070003, 67세,2021,2006,991,1015,97.6,1969,972,997,97.5
31014, 영통구,070004, 68세,2021,1835,841,994,84.6,1793,829,964,86
31014, 영통구,070005, 69세,2021,1912,923,989,93.3,1888,911,977,93.2
31014, 영통구,075,70~74세,2021,6767,3174,3593,88.3,6665,3132,3533,88.6
31014, 영통구,075001, 70세,2021,1262,609,653,93.3,1228,598,630,94.9
31014, 영통구,075002, 71세,2021,1445,684,761,89.9,1427,675,752,89.8
31014, 영통구,075003, 72세,2021,1378,639,739,86.5,1359,632,727,86.9
31014, 영통구,075004, 73세,2021,1351,631,720,87.6,1338,625,713,87.7
31014, 영통구,075005, 74세,2021,1331,611,720,84.9,1313,602,711,84.7
31014, 영통구,080,75~79세,2021,4935,2045,2890,70.8,4903,2035,2868,71
31014, 영통구,080001, 75세,2021,1033,475,558,85.1,1024,472,552,85.5
31014, 영통구,080002, 76세,2021,968,391,577,67.8,964,390,574,67.9
31014, 영통구,080003, 77세,2021,915,353,562,62.8,907,350,557,62.8
31014, 영통구,080004, 78세,2021,962,393,569,69.1,954,391,563,69.4
31014, 영통구,080005, 79세,2021,1057,433,624,69.4,1054,432,622,69.5
31014, 영통구,085,80~84세,2021,3500,1291,2209,58.4,3478,1287,2191,58.7
31014, 영통구,085001, 80세,2021,851,317,534,59.4,842,315,527,59.8
31014, 영통구,085002, 81세,2021,723,288,435,66.2,721,288,433,66.5
31014, 영통구,085003, 82세,2021,710,250,460,54.3,706,249,457,54.5
31014, 영통구,085004, 83세,2021,629,224,405,55.3,627,223,404,55.2
31014, 영통구,085005, 84세,2021,587,212,375,56.5,582,212,370,57.3
31014, 영통구,090,85~89세,2021,1847,566,1281,44.2,1837,565,1272,44.4
31014, 영통구,090001, 85세,2021,491,152,339,44.8,490,152,338,45
31014, 영통구,090002, 86세,2021,459,145,314,46.2,458,145,313,46.3
31014, 영통구,090003, 87세,2021,367,122,245,49.8,367,122,245,49.8
31014, 영통구,090004, 88세,2021,288,82,206,39.8,284,82,202,40.6
31014, 영통구,090005, 89세,2021,242,65,177,36.7,238,64,174,36.8
31014, 영통구,095,90~94세,2021,632,134,498,26.9,631,134,497,27
31014, 영통구,095001, 90세,2021,182,34,148,23,182,34,148,23
31014, 영통구,095002, 91세,2021,159,35,124,28.2,158,35,123,28.5
31014, 영통구,095003, 92세,2021,134,29,105,27.6,134,29,105,27.6
31014, 영통구,095004, 93세,2021,101,22,79,27.8,101,22,79,27.8
31014, 영통구,095005, 94세,2021,56,14,42,33.3,56,14,42,33.3
31014, 영통구,100,95~99세,2021,149,27,122,22.1,148,26,122,21.3
31014, 영통구,100001, 95세,2021,51,7,44,15.9,51,7,44,15.9
31014, 영통구,100002, 96세,2021,39,7,32,21.9,39,7,32,21.9
31014, 영통구,100003, 97세,2021,28,X,25,12,28,X,25,12
31014, 영통구,100004, 98세,2021,18,8,10,80,17,7,10,70
31014, 영통구,100005, 99세,2021,13,X,11,18.2,13,X,11,18.2
31014, 영통구,101,100세이상,2021,21,X,17,23.5,21,X,17,23.5
31014, 영통구,102,15세미만,2021,55056,28545,26511,107.7,54167,28085,26082,107.7
31014, 영통구,103,15~64세,2021,282286,142476,139810,101.9,274078,138473,135605,102.1
31014, 영통구,104,65세이상,2021,28867,12573,16294,77.2,28472,12409,16063,77.3
31014, 영통구,086,85세이상,2021,2649,731,1918,38.1,2637,729,1908,38.2
31014, 영통구,126,평균연령,2021,37.7,37,38.4,,37.7,37,38.5,
31014, 영통구,127,중위연령,2021,38,37.1,38.8,,38.2,37.3,39,
31020, 성남시,000,합계,2021,913482,451948,461534,97.9,889568,440440,449128,98.1
31020, 성남시,005,0~4세,2021,27207,13811,13396,103.1,26736,13597,13139,103.5
31020, 성남시,005001, 0세,2021,4959,2525,2434,103.7,4901,2500,2401,104.1
31020, 성남시,005002, 1세,2021,4990,2501,2489,100.5,4931,2473,2458,100.6
31020, 성남시,005003, 2세,2021,5428,2723,2705,100.7,5323,2675,2648,101
31020, 성남시,005004, 3세,2021,5663,2893,2770,104.4,5543,2833,2710,104.5
31020, 성남시,005005, 4세,2021,6167,3169,2998,105.7,6038,3116,2922,106.6
31020, 성남시,010,5~9세,2021,37326,19214,18112,106.1,36783,18933,17850,106.1
31020, 성남시,010001, 5세,2021,6934,3536,3398,104.1,6795,3462,3333,103.9
31020, 성남시,010002, 6세,2021,7455,3827,3628,105.5,7320,3758,3562,105.5
31020, 성남시,010003, 7세,2021,7419,3793,3626,104.6,7302,3730,3572,104.4
31020, 성남시,010004, 8세,2021,7490,3834,3656,104.9,7406,3797,3609,105.2
31020, 성남시,010005, 9세,2021,8028,4224,3804,111,7960,4186,3774,110.9
31020, 성남시,015,10~14세,2021,40424,20716,19708,105.1,40125,20565,19560,105.1
31020, 성남시,015001, 10세,2021,8104,4173,3931,106.2,8039,4140,3899,106.2
31020, 성남시,015002, 11세,2021,7908,4058,3850,105.4,7843,4022,3821,105.3
31020, 성남시,015003, 12세,2021,7740,3952,3788,104.3,7688,3922,3766,104.1
31020, 성남시,015004, 13세,2021,8163,4148,4015,103.3,8109,4119,3990,103.2
31020, 성남시,015005, 14세,2021,8509,4385,4124,106.3,8446,4362,4084,106.8
31020, 성남시,020,15~19세,2021,40477,20625,19852,103.9,40165,20464,19701,103.9
31020, 성남시,020001, 15세,2021,7653,3891,3762,103.4,7598,3859,3739,103.2
31020, 성남시,020002, 16세,2021,7608,3860,3748,103,7560,3836,3724,103
31020, 성남시,020003, 17세,2021,8349,4292,4057,105.8,8294,4263,4031,105.8
31020, 성남시,020004, 18세,2021,8462,4333,4129,104.9,8413,4308,4105,104.9
31020, 성남시,020005, 19세,2021,8405,4249,4156,102.2,8300,4198,4102,102.3
31020, 성남시,025,20~24세,2021,54776,27556,27220,101.2,53016,26692,26324,101.4
31020, 성남시,025001, 20세,2021,9805,4948,4857,101.9,9530,4811,4719,101.9
31020, 성남시,025002, 21세,2021,10909,5464,5445,100.3,10541,5291,5250,100.8
31020, 성남시,025003, 22세,2021,10650,5453,5197,104.9,10292,5266,5026,104.8
31020, 성남시,025004, 23세,2021,11332,5753,5579,103.1,10942,5558,5384,103.2
31020, 성남시,025005, 24세,2021,12080,5938,6142,96.7,11711,5766,5945,97
31020, 성남시,030,25~29세,2021,68857,35653,33204,107.4,66800,34766,32034,108.5
31020, 성남시,030001, 25세,2021,12778,6398,6380,100.3,12396,6238,6158,101.3
31020, 성남시,030002, 26세,2021,13364,6842,6522,104.9,12957,6664,6293,105.9
31020, 성남시,030003, 27세,2021,13909,7236,6673,108.4,13483,7050,6433,109.6
31020, 성남시,030004, 28세,2021,14219,7586,6633,114.4,13787,7398,6389,115.8
31020, 성남시,030005, 29세,2021,14587,7591,6996,108.5,14177,7416,6761,109.7
31020, 성남시,035,30~34세,2021,65633,33984,31649,107.4,63179,32810,30369,108
31020, 성남시,035001, 30세,2021,13993,7306,6687,109.3,13562,7097,6465,109.8
31020, 성남시,035002, 31세,2021,13081,6827,6254,109.2,12604,6605,5999,110.1
31020, 성남시,035003, 32세,2021,13090,6767,6323,107,12592,6535,6057,107.9
31020, 성남시,035004, 33세,2021,12725,6549,6176,106,12198,6310,5888,107.2
31020, 성남시,035005, 34세,2021,12744,6535,6209,105.3,12223,6263,5960,105.1
31020, 성남시,040,35~39세,2021,67304,34242,33062,103.6,65041,33100,31941,103.6
31020, 성남시,040001, 35세,2021,12520,6410,6110,104.9,12080,6194,5886,105.2
31020, 성남시,040002, 36세,2021,12745,6501,6244,104.1,12268,6260,6008,104.2
31020, 성남시,040003, 37세,2021,13147,6687,6460,103.5,12671,6450,6221,103.7
31020, 성남시,040004, 38세,2021,13962,7067,6895,102.5,13530,6843,6687,102.3
31020, 성남시,040005, 39세,2021,14930,7577,7353,103,14492,7353,7139,103
31020, 성남시,045,40~44세,2021,72549,35900,36649,98,70739,34960,35779,97.7
31020, 성남시,045001, 40세,2021,14975,7493,7482,100.1,14630,7319,7311,100.1
31020, 성남시,045002, 41세,2021,15346,7574,7772,97.5,14993,7378,7615,96.9
31020, 성남시,045003, 42세,2021,14783,7295,7488,97.4,14394,7099,7295,97.3
31020, 성남시,045004, 43세,2021,13390,6547,6843,95.7,13002,6345,6657,95.3
31020, 성남시,045005, 44세,2021,14055,6991,7064,99,13720,6819,6901,98.8
31020, 성남시,050,45~49세,2021,76860,37988,38872,97.7,74791,36896,37895,97.4
31020, 성남시,050001, 45세,2021,13846,6962,6884,101.1,13486,6763,6723,100.6
31020, 성남시,050002, 46세,2021,14553,7185,7368,97.5,14174,6986,7188,97.2
31020, 성남시,050003, 47세,2021,15699,7702,7997,96.3,15303,7499,7804,96.1
31020, 성남시,050004, 48세,2021,16103,7864,8239,95.4,15679,7648,8031,95.2
31020, 성남시,050005, 49세,2021,16659,8275,8384,98.7,16149,8000,8149,98.2
31020, 성남시,055,50~54세,2021,82722,41239,41483,99.4,79970,39877,40093,99.5
31020, 성남시,055001, 50세,2021,17736,8966,8770,102.2,17165,8671,8494,102.1
31020, 성남시,055002, 51세,2021,17012,8648,8364,103.4,16440,8357,8083,103.4
31020, 성남시,055003, 52세,2021,16877,8289,8588,96.5,16323,8033,8290,96.9
31020, 성남시,055004, 53세,2021,16127,7907,8220,96.2,15571,7639,7932,96.3
31020, 성남시,055005, 54세,2021,14970,7429,7541,98.5,14471,7177,7294,98.4
31020, 성남시,060,55~59세,2021,72390,35885,36505,98.3,69398,34488,34910,98.8
31020, 성남시,060001, 55세,2021,14308,7196,7112,101.2,13773,6962,6811,102.2
31020, 성남시,060002, 56세,2021,14745,7260,7485,97,14149,6976,7173,97.3
31020, 성남시,060003, 57세,2021,14038,6938,7100,97.7,13449,6661,6788,98.1
31020, 성남시,060004, 58세,2021,14890,7402,7488,98.9,14161,7060,7101,99.4
31020, 성남시,060005, 59세,2021,14409,7089,7320,96.8,13866,6829,7037,97
31020, 성남시,065,60~64세,2021,70852,34730,36122,96.1,68802,33788,35014,96.5
31020, 성남시,065001, 60세,2021,15792,7604,8188,92.9,15452,7453,7999,93.2
31020, 성남시,065002, 61세,2021,15483,7460,8023,93,14990,7250,7740,93.7
31020, 성남시,065003, 62세,2021,13822,6728,7094,94.8,13432,6547,6885,95.1
31020, 성남시,065004, 63세,2021,13031,6625,6406,103.4,12621,6419,6202,103.5
31020, 성남시,065005, 64세,2021,12724,6313,6411,98.5,12307,6119,6188,98.9
31020, 성남시,070,65~69세,2021,49413,23767,25646,92.7,48206,23185,25021,92.7
31020, 성남시,070001, 65세,2021,11302,5487,5815,94.4,10941,5308,5633,94.2
31020, 성남시,070002, 66세,2021,11497,5561,5936,93.7,11218,5416,5802,93.3
31020, 성남시,070003, 67세,2021,9486,4528,4958,91.3,9260,4422,4838,91.4
31020, 성남시,070004, 68세,2021,8307,3964,4343,91.3,8139,3886,4253,91.4
31020, 성남시,070005, 69세,2021,8821,4227,4594,92,8648,4153,4495,92.4
31020, 성남시,075,70~74세,2021,33034,15292,17742,86.2,32542,15081,17461,86.4
31020, 성남시,075001, 70세,2021,6061,2819,3242,87,5916,2763,3153,87.6
31020, 성남시,075002, 71세,2021,6714,3181,3533,90,6596,3132,3464,90.4
31020, 성남시,075003, 72세,2021,6935,3191,3744,85.2,6825,3141,3684,85.3
31020, 성남시,075004, 73세,2021,6579,3028,3551,85.3,6507,2995,3512,85.3
31020, 성남시,075005, 74세,2021,6745,3073,3672,83.7,6698,3050,3648,83.6
31020, 성남시,080,75~79세,2021,24385,10776,13609,79.2,24188,10710,13478,79.5
31020, 성남시,080001, 75세,2021,5071,2255,2816,80.1,5012,2233,2779,80.4
31020, 성남시,080002, 76세,2021,4829,2153,2676,80.5,4789,2138,2651,80.6
31020, 성남시,080003, 77세,2021,4691,2062,2629,78.4,4649,2050,2599,78.9
31020, 성남시,080004, 78세,2021,4634,2016,2618,77,4598,2010,2588,77.7
31020, 성남시,080005, 79세,2021,5160,2290,2870,79.8,5140,2279,2861,79.7
31020, 성남시,085,80~84세,2021,16664,6701,9963,67.3,16551,6672,9879,67.5
31020, 성남시,085001, 80세,2021,4030,1735,2295,75.6,4002,1727,2275,75.9
31020, 성남시,085002, 81세,2021,3587,1469,2118,69.4,3559,1461,2098,69.6
31020, 성남시,085003, 82세,2021,3410,1372,2038,67.3,3388,1369,2019,67.8
31020, 성남시,085004, 83세,2021,2992,1144,1848,61.9,2972,1139,1833,62.1
31020, 성남시,085005, 84세,2021,2645,981,1664,59,2630,976,1654,59
31020, 성남시,090,85~89세,2021,8648,2860,5788,49.4,8603,2850,5753,49.5
31020, 성남시,090001, 85세,2021,2320,871,1449,60.1,2307,866,1441,60.1
31020, 성남시,090002, 86세,2021,2103,717,1386,51.7,2092,716,1376,52
31020, 성남시,090003, 87세,2021,1724,555,1169,47.5,1715,555,1160,47.8
31020, 성남시,090004, 88세,2021,1347,394,953,41.3,1340,391,949,41.2
31020, 성남시,090005, 89세,2021,1154,323,831,38.9,1149,322,827,38.9
31020, 성남시,095,90~94세,2021,3210,853,2357,36.2,3189,851,2338,36.4
31020, 성남시,095001, 90세,2021,891,252,639,39.4,884,252,632,39.9
31020, 성남시,095002, 91세,2021,820,220,600,36.7,818,220,598,36.8
31020, 성남시,095003, 92세,2021,655,173,482,35.9,649,172,477,36.1
31020, 성남시,095004, 93세,2021,486,131,355,36.9,483,130,353,36.8
31020, 성남시,095005, 94세,2021,358,77,281,27.4,355,77,278,27.7
31020, 성남시,100,95~99세,2021,640,131,509,25.7,636,130,506,25.7
31020, 성남시,100001, 95세,2021,192,41,151,27.2,191,40,151,26.5
31020, 성남시,100002, 96세,2021,169,25,144,17.4,168,25,143,17.5
31020, 성남시,100003, 97세,2021,107,28,79,35.4,106,28,78,35.9
31020, 성남시,100004, 98세,2021,95,21,74,28.4,94,21,73,28.8
31020, 성남시,100005, 99세,2021,77,16,61,26.2,77,16,61,26.2
31020, 성남시,101,100세이상,2021,111,25,86,29.1,108,25,83,30.1
31020, 성남시,102,15세미만,2021,104957,53741,51216,104.9,103644,53095,50549,105
31020, 성남시,103,15~64세,2021,672420,337802,334618,101,651901,327841,324060,101.2
31020, 성남시,104,65세이상,2021,136105,60405,75700,79.8,134023,59504,74519,79.9
31020, 성남시,086,85세이상,2021,12609,3869,8740,44.3,12536,3856,8680,44.4
31020, 성남시,126,평균연령,2021,42.8,42,43.7,,42.8,41.9,43.7,
31020, 성남시,127,중위연령,2021,43.7,42.7,44.7,,43.7,42.6,44.7,
31021, 수정구,000,합계,2021,244058,123147,120911,101.8,229653,115890,113763,101.9
31021, 수정구,005,0~4세,2021,6991,3513,3478,101,6714,3399,3315,102.5
31021, 수정구,005001, 0세,2021,1236,643,593,108.4,1195,629,566,111.1
31021, 수정구,005002, 1세,2021,1330,674,656,102.7,1294,655,639,102.5
31021, 수정구,005003, 2세,2021,1430,707,723,97.8,1367,682,685,99.6
31021, 수정구,005004, 3세,2021,1479,735,744,98.8,1408,702,706,99.4
31021, 수정구,005005, 4세,2021,1516,754,762,99,1450,731,719,101.7
31021, 수정구,010,5~9세,2021,8086,4095,3991,102.6,7814,3963,3851,102.9
31021, 수정구,010001, 5세,2021,1618,826,792,104.3,1557,794,763,104.1
31021, 수정구,010002, 6세,2021,1682,830,852,97.4,1620,799,821,97.3
31021, 수정구,010003, 7세,2021,1631,842,789,106.7,1568,812,756,107.4
31021, 수정구,010004, 8세,2021,1544,763,781,97.7,1491,743,748,99.3
31021, 수정구,010005, 9세,2021,1611,834,777,107.3,1578,815,763,106.8
31021, 수정구,015,10~14세,2021,7976,4048,3928,103.1,7826,3984,3842,103.7
31021, 수정구,015001, 10세,2021,1657,848,809,104.8,1624,832,792,105.1
31021, 수정구,015002, 11세,2021,1661,836,825,101.3,1631,822,809,101.6
31021, 수정구,015003, 12세,2021,1425,733,692,105.9,1394,717,677,105.9
31021, 수정구,015004, 13세,2021,1568,797,771,103.4,1543,786,757,103.8
31021, 수정구,015005, 14세,2021,1665,834,831,100.4,1634,827,807,102.5
31021, 수정구,020,15~19세,2021,9034,4598,4436,103.7,8843,4506,4337,103.9
31021, 수정구,020001, 15세,2021,1480,740,740,100,1454,729,725,100.6
31021, 수정구,020002, 16세,2021,1504,777,727,106.9,1478,767,711,107.9
31021, 수정구,020003, 17세,2021,1715,939,776,121,1683,925,758,122
31021, 수정구,020004, 18세,2021,1897,958,939,102,1871,944,927,101.8
31021, 수정구,020005, 19세,2021,2438,1184,1254,94.4,2357,1141,1216,93.8
31021, 수정구,025,20~24세,2021,16572,8269,8303,99.6,15225,7549,7676,98.3
31021, 수정구,025001, 20세,2021,2857,1341,1516,88.5,2613,1217,1396,87.2
31021, 수정구,025002, 21세,2021,3205,1530,1675,91.3,2882,1369,1513,90.5
31021, 수정구,025003, 22세,2021,3381,1719,1662,103.4,3092,1553,1539,100.9
31021, 수정구,025004, 23세,2021,3448,1790,1658,108,3185,1638,1547,105.9
31021, 수정구,025005, 24세,2021,3681,1889,1792,105.4,3453,1772,1681,105.4
31021, 수정구,030,25~29세,2021,19578,10589,8989,117.8,18571,10098,8473,119.2
31021, 수정구,030001, 25세,2021,3760,2009,1751,114.7,3534,1896,1638,115.8
31021, 수정구,030002, 26세,2021,3831,2094,1737,120.6,3636,1991,1645,121
31021, 수정구,030003, 27세,2021,3963,2181,1782,122.4,3759,2077,1682,123.5
31021, 수정구,030004, 28세,2021,4039,2194,1845,118.9,3841,2106,1735,121.4
31021, 수정구,030005, 29세,2021,3985,2111,1874,112.6,3801,2028,1773,114.4
31021, 수정구,035,30~34세,2021,17893,9660,8233,117.3,16672,9033,7639,118.2
31021, 수정구,035001, 30세,2021,3904,2117,1787,118.5,3686,2005,1681,119.3
31021, 수정구,035002, 31세,2021,3557,1932,1625,118.9,3329,1819,1510,120.5
31021, 수정구,035003, 32세,2021,3582,1917,1665,115.1,3345,1801,1544,116.6
31021, 수정구,035004, 33세,2021,3386,1821,1565,116.4,3124,1687,1437,117.4
31021, 수정구,035005, 34세,2021,3464,1873,1591,117.7,3188,1721,1467,117.3
31021, 수정구,040,35~39세,2021,18073,9679,8394,115.3,16928,9055,7873,115
31021, 수정구,040001, 35세,2021,3422,1819,1603,113.5,3201,1701,1500,113.4
31021, 수정구,040002, 36세,2021,3479,1871,1608,116.4,3230,1735,1495,116.1
31021, 수정구,040003, 37세,2021,3539,1922,1617,118.9,3301,1793,1508,118.9
31021, 수정구,040004, 38세,2021,3687,1981,1706,116.1,3473,1851,1622,114.1
31021, 수정구,040005, 39세,2021,3946,2086,1860,112.2,3723,1975,1748,113
31021, 수정구,045,40~44세,2021,18293,9744,8549,114,17320,9199,8121,113.3
31021, 수정구,045001, 40세,2021,3906,2082,1824,114.1,3735,1993,1742,114.4
31021, 수정구,045002, 41세,2021,3865,2041,1824,111.9,3675,1928,1747,110.4
31021, 수정구,045003, 42세,2021,3689,1979,1710,115.7,3488,1859,1629,114.1
31021, 수정구,045004, 43세,2021,3340,1751,1589,110.2,3122,1635,1487,110
31021, 수정구,045005, 44세,2021,3493,1891,1602,118,3300,1784,1516,117.7
31021, 수정구,050,45~49세,2021,18503,9755,8748,111.5,17329,9107,8222,110.8
31021, 수정구,050001, 45세,2021,3293,1794,1499,119.7,3103,1675,1428,117.3
31021, 수정구,050002, 46세,2021,3538,1852,1686,109.8,3319,1731,1588,109
31021, 수정구,050003, 47세,2021,3678,1962,1716,114.3,3465,1840,1625,113.2
31021, 수정구,050004, 48세,2021,3921,1985,1936,102.5,3684,1862,1822,102.2
31021, 수정구,050005, 49세,2021,4073,2162,1911,113.1,3758,1999,1759,113.6
31021, 수정구,055,50~54세,2021,21436,10877,10559,103,19648,9964,9684,102.9
31021, 수정구,055001, 50세,2021,4408,2304,2104,109.5,4024,2099,1925,109
31021, 수정구,055002, 51세,2021,4365,2226,2139,104.1,4000,2043,1957,104.4
31021, 수정구,055003, 52세,2021,4322,2157,2165,99.6,3956,1977,1979,99.9
31021, 수정구,055004, 53세,2021,4275,2139,2136,100.1,3921,1966,1955,100.6
31021, 수정구,055005, 54세,2021,4066,2051,2015,101.8,3747,1879,1868,100.6
31021, 수정구,060,55~59세,2021,20991,10638,10353,102.8,18927,9645,9282,103.9
31021, 수정구,060001, 55세,2021,4112,2089,2023,103.3,3742,1927,1815,106.2
31021, 수정구,060002, 56세,2021,4179,2074,2105,98.5,3775,1876,1899,98.8
31021, 수정구,060003, 57세,2021,4079,2066,2013,102.6,3671,1864,1807,103.2
31021, 수정구,060004, 58세,2021,4408,2255,2153,104.7,3887,2000,1887,106
31021, 수정구,060005, 59세,2021,4213,2154,2059,104.6,3852,1978,1874,105.5
31021, 수정구,065,60~64세,2021,20883,10178,10705,95.1,19508,9519,9989,95.3
31021, 수정구,065001, 60세,2021,4574,2249,2325,96.7,4367,2151,2216,97.1
31021, 수정구,065002, 61세,2021,4619,2207,2412,91.5,4278,2055,2223,92.4
31021, 수정구,065003, 62세,2021,4055,1985,2070,95.9,3802,1872,1930,97
31021, 수정구,065004, 63세,2021,3843,1930,1913,100.9,3569,1784,1785,99.9
31021, 수정구,065005, 64세,2021,3792,1807,1985,91,3492,1657,1835,90.3
31021, 수정구,070,65~69세,2021,15152,7224,7928,91.1,14301,6803,7498,90.7
31021, 수정구,070001, 65세,2021,3462,1682,1780,94.5,3197,1548,1649,93.9
31021, 수정구,070002, 66세,2021,3454,1678,1776,94.5,3263,1576,1687,93.4
31021, 수정구,070003, 67세,2021,2962,1375,1587,86.6,2800,1301,1499,86.8
31021, 수정구,070004, 68세,2021,2556,1219,1337,91.2,2443,1163,1280,90.9
31021, 수정구,070005, 69세,2021,2718,1270,1448,87.7,2598,1215,1383,87.9
31021, 수정구,075,70~74세,2021,10054,4656,5398,86.3,9716,4499,5217,86.2
31021, 수정구,075001, 70세,2021,1942,899,1043,86.2,1830,849,981,86.5
31021, 수정구,075002, 71세,2021,2038,953,1085,87.8,1959,920,1039,88.5
31021, 수정구,075003, 72세,2021,2143,993,1150,86.3,2073,962,1111,86.6
31021, 수정구,075004, 73세,2021,1976,916,1060,86.4,1933,891,1042,85.5
31021, 수정구,075005, 74세,2021,1955,895,1060,84.4,1921,877,1044,84
31021, 수정구,080,75~79세,2021,7069,3085,3984,77.4,6950,3046,3904,78
31021, 수정구,080001, 75세,2021,1521,678,843,80.4,1485,666,819,81.3
31021, 수정구,080002, 76세,2021,1366,596,770,77.4,1341,585,756,77.4
31021, 수정구,080003, 77세,2021,1326,575,751,76.6,1302,567,735,77.1
31021, 수정구,080004, 78세,2021,1367,592,775,76.4,1345,589,756,77.9
31021, 수정구,080005, 79세,2021,1489,644,845,76.2,1477,639,838,76.3
31021, 수정구,085,80~84세,2021,4414,1704,2710,62.9,4347,1692,2655,63.7
31021, 수정구,085001, 80세,2021,1110,459,651,70.5,1093,456,637,71.6
31021, 수정구,085002, 81세,2021,980,389,591,65.8,965,387,578,67
31021, 수정구,085003, 82세,2021,943,353,590,59.8,931,353,578,61.1
31021, 수정구,085004, 83세,2021,761,283,478,59.2,747,279,468,59.6
31021, 수정구,085005, 84세,2021,620,220,400,55,611,217,394,55.1
31021, 수정구,090,85~89세,2021,2147,637,1510,42.2,2112,631,1481,42.6
31021, 수정구,090001, 85세,2021,589,209,380,55,578,205,373,55
31021, 수정구,090002, 86세,2021,536,162,374,43.3,526,161,365,44.1
31021, 수정구,090003, 87세,2021,428,119,309,38.5,420,119,301,39.5
31021, 수정구,090004, 88세,2021,344,88,256,34.4,341,87,254,34.3
31021, 수정구,090005, 89세,2021,250,59,191,30.9,247,59,188,31.4
31021, 수정구,095,90~94세,2021,727,166,561,29.6,717,166,551,30.1
31021, 수정구,095001, 90세,2021,180,43,137,31.4,176,43,133,32.3
31021, 수정구,095002, 91세,2021,190,45,145,31,189,45,144,31.3
31021, 수정구,095003, 92세,2021,167,32,135,23.7,163,32,131,24.4
31021, 수정구,095004, 93세,2021,99,21,78,26.9,99,21,78,26.9
31021, 수정구,095005, 94세,2021,91,25,66,37.9,90,25,65,38.5
31021, 수정구,100,95~99세,2021,151,25,126,19.8,151,25,126,19.8
31021, 수정구,100001, 95세,2021,43,10,33,30.3,43,10,33,30.3
31021, 수정구,100002, 96세,2021,42,8,34,23.5,42,8,34,23.5
31021, 수정구,100003, 97세,2021,25,X,21,19,25,X,21,19
31021, 수정구,100004, 98세,2021,25,X,23,8.7,25,X,23,8.7
31021, 수정구,100005, 99세,2021,16,X,15,6.7,16,X,15,6.7
31021, 수정구,101,100세이상,2021,35,7,28,25,34,7,27,25.9
31021, 수정구,102,15세미만,2021,23053,11656,11397,102.3,22354,11346,11008,103.1
31021, 수정구,103,15~64세,2021,181256,93987,87269,107.7,168971,87675,81296,107.8
31021, 수정구,104,65세이상,2021,39749,17504,22245,78.7,38328,16869,21459,78.6
31021, 수정구,086,85세이상,2021,3060,835,2225,37.5,3014,829,2185,37.9
31021, 수정구,126,평균연령,2021,44,43,45,,43.9,43,44.9,
31021, 수정구,127,중위연령,2021,44.9,43.6,46.4,,44.7,43.4,46.2,
31022, 중원구,000,합계,2021,209170,105374,103796,101.5,205019,103528,101491,102
31022, 중원구,005,0~4세,2021,5493,2765,2728,101.4,5445,2744,2701,101.6
31022, 중원구,005001, 0세,2021,1042,509,533,95.5,1035,506,529,95.7
31022, 중원구,005002, 1세,2021,1052,503,549,91.6,1042,501,541,92.6
31022, 중원구,005003, 2세,2021,1068,531,537,98.9,1058,526,532,98.9
31022, 중원구,005004, 3세,2021,1121,568,553,102.7,1110,562,548,102.6
31022, 중원구,005005, 4세,2021,1210,654,556,117.6,1200,649,551,117.8
31022, 중원구,010,5~9세,2021,6735,3495,3240,107.9,6687,3466,3221,107.6
31022, 중원구,010001, 5세,2021,1324,678,646,105,1316,674,642,105
31022, 중원구,010002, 6세,2021,1361,697,664,105,1350,691,659,104.9
31022, 중원구,010003, 7세,2021,1277,656,621,105.6,1267,646,621,104
31022, 중원구,010004, 8세,2021,1326,695,631,110.1,1317,691,626,110.4
31022, 중원구,010005, 9세,2021,1447,769,678,113.4,1437,764,673,113.5
31022, 중원구,015,10~14세,2021,7324,3761,3563,105.6,7295,3747,3548,105.6
31022, 중원구,015001, 10세,2021,1455,756,699,108.2,1451,753,698,107.9
31022, 중원구,015002, 11세,2021,1388,718,670,107.2,1382,716,666,107.5
31022, 중원구,015003, 12세,2021,1372,677,695,97.4,1369,675,694,97.3
31022, 중원구,015004, 13세,2021,1484,801,683,117.3,1480,798,682,117
31022, 중원구,015005, 14세,2021,1625,809,816,99.1,1613,805,808,99.6
31022, 중원구,020,15~19세,2021,7803,4005,3798,105.5,7761,3985,3776,105.5
31022, 중원구,020001, 15세,2021,1388,724,664,109,1380,718,662,108.5
31022, 중원구,020002, 16세,2021,1463,713,750,95.1,1457,710,747,95
31022, 중원구,020003, 17세,2021,1562,804,758,106.1,1554,801,753,106.4
31022, 중원구,020004, 18세,2021,1663,886,777,114,1655,883,772,114.4
31022, 중원구,020005, 19세,2021,1727,878,849,103.4,1715,873,842,103.7
31022, 중원구,025,20~24세,2021,12295,6131,6164,99.5,12125,6066,6059,100.1
31022, 중원구,025001, 20세,2021,2135,1098,1037,105.9,2115,1092,1023,106.7
31022, 중원구,025002, 21세,2021,2414,1161,1253,92.7,2392,1155,1237,93.4
31022, 중원구,025003, 22세,2021,2381,1199,1182,101.4,2350,1192,1158,102.9
31022, 중원구,025004, 23세,2021,2533,1291,1242,103.9,2482,1270,1212,104.8
31022, 중원구,025005, 24세,2021,2832,1382,1450,95.3,2786,1357,1429,95
31022, 중원구,030,25~29세,2021,17360,9155,8205,111.6,16963,9004,7959,113.1
31022, 중원구,030001, 25세,2021,3138,1586,1552,102.2,3077,1565,1512,103.5
31022, 중원구,030002, 26세,2021,3429,1769,1660,106.6,3353,1745,1608,108.5
31022, 중원구,030003, 27세,2021,3498,1811,1687,107.4,3418,1784,1634,109.2
31022, 중원구,030004, 28세,2021,3619,1978,1641,120.5,3532,1941,1591,122
31022, 중원구,030005, 29세,2021,3676,2011,1665,120.8,3583,1969,1614,122
31022, 중원구,035,30~34세,2021,15636,8501,7135,119.1,15140,8276,6864,120.6
31022, 중원구,035001, 30세,2021,3416,1846,1570,117.6,3342,1810,1532,118.1
31022, 중원구,035002, 31세,2021,3163,1743,1420,122.7,3044,1691,1353,125
31022, 중원구,035003, 32세,2021,3127,1702,1425,119.4,3028,1662,1366,121.7
31022, 중원구,035004, 33세,2021,2952,1620,1332,121.6,2851,1579,1272,124.1
31022, 중원구,035005, 34세,2021,2978,1590,1388,114.6,2875,1534,1341,114.4
31022, 중원구,040,35~39세,2021,15004,8076,6928,116.6,14545,7867,6678,117.8
31022, 중원구,040001, 35세,2021,2788,1523,1265,120.4,2702,1486,1216,122.2
31022, 중원구,040002, 36세,2021,2828,1510,1318,114.6,2736,1470,1266,116.1
31022, 중원구,040003, 37세,2021,2958,1557,1401,111.1,2860,1515,1345,112.6
31022, 중원구,040004, 38세,2021,3203,1730,1473,117.4,3111,1692,1419,119.2
31022, 중원구,040005, 39세,2021,3227,1756,1471,119.4,3136,1704,1432,119
31022, 중원구,045,40~44세,2021,15165,7986,7179,111.2,14828,7852,6976,112.6
31022, 중원구,045001, 40세,2021,3154,1666,1488,112,3089,1641,1448,113.3
31022, 중원구,045002, 41세,2021,3213,1702,1511,112.6,3156,1681,1475,114
31022, 중원구,045003, 42세,2021,3159,1636,1523,107.4,3083,1610,1473,109.3
31022, 중원구,045004, 43세,2021,2792,1477,1315,112.3,2715,1439,1276,112.8
31022, 중원구,045005, 44세,2021,2847,1505,1342,112.1,2785,1481,1304,113.6
31022, 중원구,050,45~49세,2021,16057,8390,7667,109.4,15669,8208,7461,110
31022, 중원구,050001, 45세,2021,2807,1498,1309,114.4,2737,1462,1275,114.7
31022, 중원구,050002, 46세,2021,2977,1547,1430,108.2,2903,1514,1389,109
31022, 중원구,050003, 47세,2021,3314,1707,1607,106.2,3238,1675,1563,107.2
31022, 중원구,050004, 48세,2021,3405,1758,1647,106.7,3318,1718,1600,107.4
31022, 중원구,050005, 49세,2021,3554,1880,1674,112.3,3473,1839,1634,112.5
31022, 중원구,055,50~54세,2021,18600,9428,9172,102.8,18118,9203,8915,103.2
31022, 중원구,055001, 50세,2021,3726,1952,1774,110,3635,1909,1726,110.6
31022, 중원구,055002, 51세,2021,3660,1900,1760,108,3558,1848,1710,108.1
31022, 중원구,055003, 52세,2021,3790,1854,1936,95.8,3687,1812,1875,96.6
31022, 중원구,055004, 53세,2021,3795,1913,1882,101.6,3695,1869,1826,102.4
31022, 중원구,055005, 54세,2021,3629,1809,1820,99.4,3543,1765,1778,99.3
31022, 중원구,060,55~59세,2021,18112,8962,9150,97.9,17591,8724,8867,98.4
31022, 중원구,060001, 55세,2021,3553,1767,1786,98.9,3458,1723,1735,99.3
31022, 중원구,060002, 56세,2021,3689,1820,1869,97.4,3581,1767,1814,97.4
31022, 중원구,060003, 57세,2021,3422,1655,1767,93.7,3318,1612,1706,94.5
31022, 중원구,060004, 58세,2021,3695,1876,1819,103.1,3572,1824,1748,104.3
31022, 중원구,060005, 59세,2021,3753,1844,1909,96.6,3662,1798,1864,96.5
31022, 중원구,065,60~64세,2021,18920,9355,9565,97.8,18553,9180,9373,97.9
31022, 중원구,065001, 60세,2021,4187,1972,2215,89,4132,1943,2189,88.8
31022, 중원구,065002, 61세,2021,4238,2086,2152,96.9,4144,2047,2097,97.6
31022, 중원구,065003, 62세,2021,3654,1793,1861,96.3,3574,1754,1820,96.4
31022, 중원구,065004, 63세,2021,3480,1786,1694,105.4,3403,1748,1655,105.6
31022, 중원구,065005, 64세,2021,3361,1718,1643,104.6,3300,1688,1612,104.7
31022, 중원구,070,65~69세,2021,13000,6230,6770,92,12790,6129,6661,92
31022, 중원구,070001, 65세,2021,2945,1425,1520,93.8,2894,1396,1498,93.2
31022, 중원구,070002, 66세,2021,3043,1433,1610,89,2996,1410,1586,88.9
31022, 중원구,070003, 67세,2021,2503,1216,1287,94.5,2462,1196,1266,94.5
31022, 중원구,070004, 68세,2021,2137,1013,1124,90.1,2101,995,1106,90
31022, 중원구,070005, 69세,2021,2372,1143,1229,93,2337,1132,1205,93.9
31022, 중원구,075,70~74세,2021,8836,4136,4700,88,8755,4101,4654,88.1
31022, 중원구,075001, 70세,2021,1654,766,888,86.3,1633,762,871,87.5
31022, 중원구,075002, 71세,2021,1827,866,961,90.1,1808,855,953,89.7
31022, 중원구,075003, 72세,2021,1867,881,986,89.4,1841,868,973,89.2
31022, 중원구,075004, 73세,2021,1721,804,917,87.7,1709,800,909,88
31022, 중원구,075005, 74세,2021,1767,819,948,86.4,1764,816,948,86.1
31022, 중원구,080,75~79세,2021,6222,2738,3484,78.6,6179,2725,3454,78.9
31022, 중원구,080001, 75세,2021,1238,567,671,84.5,1223,562,661,85
31022, 중원구,080002, 76세,2021,1245,579,666,86.9,1238,577,661,87.3
31022, 중원구,080003, 77세,2021,1201,498,703,70.8,1193,497,696,71.4
31022, 중원구,080004, 78세,2021,1177,512,665,77,1170,511,659,77.5
31022, 중원구,080005, 79세,2021,1361,582,779,74.7,1355,578,777,74.4
31022, 중원구,085,80~84세,2021,3983,1537,2446,62.8,3956,1530,2426,63.1
31022, 중원구,085001, 80세,2021,992,428,564,75.9,986,426,560,76.1
31022, 중원구,085002, 81세,2021,849,340,509,66.8,842,337,505,66.7
31022, 중원구,085003, 82세,2021,791,311,480,64.8,784,310,474,65.4
31022, 중원구,085004, 83세,2021,734,257,477,53.9,731,257,474,54.2
31022, 중원구,085005, 84세,2021,617,201,416,48.3,613,200,413,48.4
31022, 중원구,090,85~89세,2021,1820,575,1245,46.2,1818,574,1244,46.1
31022, 중원구,090001, 85세,2021,530,208,322,64.6,530,208,322,64.6
31022, 중원구,090002, 86세,2021,432,144,288,50,431,144,287,50.2
31022, 중원구,090003, 87세,2021,373,112,261,42.9,373,112,261,42.9
31022, 중원구,090004, 88세,2021,254,58,196,29.6,253,57,196,29.1
31022, 중원구,090005, 89세,2021,231,53,178,29.8,231,53,178,29.8
31022, 중원구,095,90~94세,2021,648,124,524,23.7,646,124,522,23.8
31022, 중원구,095001, 90세,2021,184,42,142,29.6,184,42,142,29.6
31022, 중원구,095002, 91세,2021,162,29,133,21.8,162,29,133,21.8
31022, 중원구,095003, 92세,2021,134,25,109,22.9,133,25,108,23.1
31022, 중원구,095004, 93세,2021,91,19,72,26.4,91,19,72,26.4
31022, 중원구,095005, 94세,2021,77,9,68,13.2,76,9,67,13.4
31022, 중원구,100,95~99세,2021,136,22,114,19.3,134,21,113,18.6
31022, 중원구,100001, 95세,2021,43,7,36,19.4,42,6,36,16.7
31022, 중원구,100002, 96세,2021,34,X,32,6.3,34,X,32,6.3
31022, 중원구,100003, 97세,2021,22,5,17,29.4,21,5,16,31.3
31022, 중원구,100004, 98세,2021,20,5,15,33.3,20,5,15,33.3
31022, 중원구,100005, 99세,2021,17,X,14,21.4,17,X,14,21.4
31022, 중원구,101,100세이상,2021,21,X,19,10.5,21,X,19,10.5
31022, 중원구,102,15세미만,2021,19552,10021,9531,105.1,19427,9957,9470,105.1
31022, 중원구,103,15~64세,2021,154952,79989,74963,106.7,151293,78365,72928,107.5
31022, 중원구,104,65세이상,2021,34666,15364,19302,79.6,34299,15206,19093,79.6
31022, 중원구,086,85세이상,2021,2625,723,1902,38,2619,721,1898,38
31022, 중원구,126,평균연령,2021,44.4,43.4,45.4,,44.4,43.4,45.4,
31022, 중원구,127,중위연령,2021,45.6,44.2,47.1,,45.6,44.2,47.2,
31023, 분당구,000,합계,2021,460254,223427,236827,94.3,454896,221022,233874,94.5
31023, 분당구,005,0~4세,2021,14723,7533,7190,104.8,14577,7454,7123,104.6
31023, 분당구,005001, 0세,2021,2681,1373,1308,105,2671,1365,1306,104.5
31023, 분당구,005002, 1세,2021,2608,1324,1284,103.1,2595,1317,1278,103.1
31023, 분당구,005003, 2세,2021,2930,1485,1445,102.8,2898,1467,1431,102.5
31023, 분당구,005004, 3세,2021,3063,1590,1473,107.9,3025,1569,1456,107.8
31023, 분당구,005005, 4세,2021,3441,1761,1680,104.8,3388,1736,1652,105.1
31023, 분당구,010,5~9세,2021,22505,11624,10881,106.8,22282,11504,10778,106.7
31023, 분당구,010001, 5세,2021,3992,2032,1960,103.7,3922,1994,1928,103.4
31023, 분당구,010002, 6세,2021,4412,2300,2112,108.9,4350,2268,2082,108.9
31023, 분당구,010003, 7세,2021,4511,2295,2216,103.6,4467,2272,2195,103.5
31023, 분당구,010004, 8세,2021,4620,2376,2244,105.9,4598,2363,2235,105.7
31023, 분당구,010005, 9세,2021,4970,2621,2349,111.6,4945,2607,2338,111.5
31023, 분당구,015,10~14세,2021,25124,12907,12217,105.6,25004,12834,12170,105.5
31023, 분당구,015001, 10세,2021,4992,2569,2423,106,4964,2555,2409,106.1
31023, 분당구,015002, 11세,2021,4859,2504,2355,106.3,4830,2484,2346,105.9
31023, 분당구,015003, 12세,2021,4943,2542,2401,105.9,4925,2530,2395,105.6
31023, 분당구,015004, 13세,2021,5111,2550,2561,99.6,5086,2535,2551,99.4
31023, 분당구,015005, 14세,2021,5219,2742,2477,110.7,5199,2730,2469,110.6
31023, 분당구,020,15~19세,2021,23640,12022,11618,103.5,23561,11973,11588,103.3
31023, 분당구,020001, 15세,2021,4785,2427,2358,102.9,4764,2412,2352,102.6
31023, 분당구,020002, 16세,2021,4641,2370,2271,104.4,4625,2359,2266,104.1
31023, 분당구,020003, 17세,2021,5072,2549,2523,101,5057,2537,2520,100.7
31023, 분당구,020004, 18세,2021,4902,2489,2413,103.1,4887,2481,2406,103.1
31023, 분당구,020005, 19세,2021,4240,2187,2053,106.5,4228,2184,2044,106.8
31023, 분당구,025,20~24세,2021,25909,13156,12753,103.2,25666,13077,12589,103.9
31023, 분당구,025001, 20세,2021,4813,2509,2304,108.9,4802,2502,2300,108.8
31023, 분당구,025002, 21세,2021,5290,2773,2517,110.2,5267,2767,2500,110.7
31023, 분당구,025003, 22세,2021,4888,2535,2353,107.7,4850,2521,2329,108.2
31023, 분당구,025004, 23세,2021,5351,2672,2679,99.7,5275,2650,2625,101
31023, 분당구,025005, 24세,2021,5567,2667,2900,92,5472,2637,2835,93
31023, 분당구,030,25~29세,2021,31919,15909,16010,99.4,31266,15664,15602,100.4
31023, 분당구,030001, 25세,2021,5880,2803,3077,91.1,5785,2777,3008,92.3
31023, 분당구,030002, 26세,2021,6104,2979,3125,95.3,5968,2928,3040,96.3
31023, 분당구,030003, 27세,2021,6448,3244,3204,101.2,6306,3189,3117,102.3
31023, 분당구,030004, 28세,2021,6561,3414,3147,108.5,6414,3351,3063,109.4
31023, 분당구,030005, 29세,2021,6926,3469,3457,100.3,6793,3419,3374,101.3
31023, 분당구,035,30~34세,2021,32104,15823,16281,97.2,31367,15501,15866,97.7
31023, 분당구,035001, 30세,2021,6673,3343,3330,100.4,6534,3282,3252,100.9
31023, 분당구,035002, 31세,2021,6361,3152,3209,98.2,6231,3095,3136,98.7
31023, 분당구,035003, 32세,2021,6381,3148,3233,97.4,6219,3072,3147,97.6
31023, 분당구,035004, 33세,2021,6387,3108,3279,94.8,6223,3044,3179,95.8
31023, 분당구,035005, 34세,2021,6302,3072,3230,95.1,6160,3008,3152,95.4
31023, 분당구,040,35~39세,2021,34227,16487,17740,92.9,33568,16178,17390,93
31023, 분당구,040001, 35세,2021,6310,3068,3242,94.6,6177,3007,3170,94.9
31023, 분당구,040002, 36세,2021,6438,3120,3318,94,6302,3055,3247,94.1
31023, 분당구,040003, 37세,2021,6650,3208,3442,93.2,6510,3142,3368,93.3
31023, 분당구,040004, 38세,2021,7072,3356,3716,90.3,6946,3300,3646,90.5
31023, 분당구,040005, 39세,2021,7757,3735,4022,92.9,7633,3674,3959,92.8
31023, 분당구,045,40~44세,2021,39091,18170,20921,86.9,38591,17909,20682,86.6
31023, 분당구,045001, 40세,2021,7915,3745,4170,89.8,7806,3685,4121,89.4
31023, 분당구,045002, 41세,2021,8268,3831,4437,86.3,8162,3769,4393,85.8
31023, 분당구,045003, 42세,2021,7935,3680,4255,86.5,7823,3630,4193,86.6
31023, 분당구,045004, 43세,2021,7258,3319,3939,84.3,7165,3271,3894,84
31023, 분당구,045005, 44세,2021,7715,3595,4120,87.3,7635,3554,4081,87.1
31023, 분당구,050,45~49세,2021,42300,19843,22457,88.4,41793,19581,22212,88.2
31023, 분당구,050001, 45세,2021,7746,3670,4076,90,7646,3626,4020,90.2
31023, 분당구,050002, 46세,2021,8038,3786,4252,89,7952,3741,4211,88.8
31023, 분당구,050003, 47세,2021,8707,4033,4674,86.3,8600,3984,4616,86.3
31023, 분당구,050004, 48세,2021,8777,4121,4656,88.5,8677,4068,4609,88.3
31023, 분당구,050005, 49세,2021,9032,4233,4799,88.2,8918,4162,4756,87.5
31023, 분당구,055,50~54세,2021,42686,20934,21752,96.2,42204,20710,21494,96.4
31023, 분당구,055001, 50세,2021,9602,4710,4892,96.3,9506,4663,4843,96.3
31023, 분당구,055002, 51세,2021,8987,4522,4465,101.3,8882,4466,4416,101.1
31023, 분당구,055003, 52세,2021,8765,4278,4487,95.3,8680,4244,4436,95.7
31023, 분당구,055004, 53세,2021,8057,3855,4202,91.7,7955,3804,4151,91.6
31023, 분당구,055005, 54세,2021,7275,3569,3706,96.3,7181,3533,3648,96.8
31023, 분당구,060,55~59세,2021,33287,16285,17002,95.8,32880,16119,16761,96.2
31023, 분당구,060001, 55세,2021,6643,3340,3303,101.1,6573,3312,3261,101.6
31023, 분당구,060002, 56세,2021,6877,3366,3511,95.9,6793,3333,3460,96.3
31023, 분당구,060003, 57세,2021,6537,3217,3320,96.9,6460,3185,3275,97.3
31023, 분당구,060004, 58세,2021,6787,3271,3516,93,6702,3236,3466,93.4
31023, 분당구,060005, 59세,2021,6443,3091,3352,92.2,6352,3053,3299,92.5
31023, 분당구,065,60~64세,2021,31049,15197,15852,95.9,30741,15089,15652,96.4
31023, 분당구,065001, 60세,2021,7031,3383,3648,92.7,6953,3359,3594,93.5
31023, 분당구,065002, 61세,2021,6626,3167,3459,91.6,6568,3148,3420,92
31023, 분당구,065003, 62세,2021,6113,2950,3163,93.3,6056,2921,3135,93.2
31023, 분당구,065004, 63세,2021,5708,2909,2799,103.9,5649,2887,2762,104.5
31023, 분당구,065005, 64세,2021,5571,2788,2783,100.2,5515,2774,2741,101.2
31023, 분당구,070,65~69세,2021,21261,10313,10948,94.2,21115,10253,10862,94.4
31023, 분당구,070001, 65세,2021,4895,2380,2515,94.6,4850,2364,2486,95.1
31023, 분당구,070002, 66세,2021,5000,2450,2550,96.1,4959,2430,2529,96.1
31023, 분당구,070003, 67세,2021,4021,1937,2084,92.9,3998,1925,2073,92.9
31023, 분당구,070004, 68세,2021,3614,1732,1882,92,3595,1728,1867,92.6
31023, 분당구,070005, 69세,2021,3731,1814,1917,94.6,3713,1806,1907,94.7
31023, 분당구,075,70~74세,2021,14144,6500,7644,85,14071,6481,7590,85.4
31023, 분당구,075001, 70세,2021,2465,1154,1311,88,2453,1152,1301,88.5
31023, 분당구,075002, 71세,2021,2849,1362,1487,91.6,2829,1357,1472,92.2
31023, 분당구,075003, 72세,2021,2925,1317,1608,81.9,2911,1311,1600,81.9
31023, 분당구,075004, 73세,2021,2882,1308,1574,83.1,2865,1304,1561,83.5
31023, 분당구,075005, 74세,2021,3023,1359,1664,81.7,3013,1357,1656,81.9
31023, 분당구,080,75~79세,2021,11094,4953,6141,80.7,11059,4939,6120,80.7
31023, 분당구,080001, 75세,2021,2312,1010,1302,77.6,2304,1005,1299,77.4
31023, 분당구,080002, 76세,2021,2218,978,1240,78.9,2210,976,1234,79.1
31023, 분당구,080003, 77세,2021,2164,989,1175,84.2,2154,986,1168,84.4
31023, 분당구,080004, 78세,2021,2090,912,1178,77.4,2083,910,1173,77.6
31023, 분당구,080005, 79세,2021,2310,1064,1246,85.4,2308,1062,1246,85.2
31023, 분당구,085,80~84세,2021,8267,3460,4807,72,8248,3450,4798,71.9
31023, 분당구,085001, 80세,2021,1928,848,1080,78.5,1923,845,1078,78.4
31023, 분당구,085002, 81세,2021,1758,740,1018,72.7,1752,737,1015,72.6
31023, 분당구,085003, 82세,2021,1676,708,968,73.1,1673,706,967,73
31023, 분당구,085004, 83세,2021,1497,604,893,67.6,1494,603,891,67.7
31023, 분당구,085005, 84세,2021,1408,560,848,66,1406,559,847,66
31023, 분당구,090,85~89세,2021,4681,1648,3033,54.3,4673,1645,3028,54.3
31023, 분당구,090001, 85세,2021,1201,454,747,60.8,1199,453,746,60.7
31023, 분당구,090002, 86세,2021,1135,411,724,56.8,1135,411,724,56.8
31023, 분당구,090003, 87세,2021,923,324,599,54.1,922,324,598,54.2
31023, 분당구,090004, 88세,2021,749,248,501,49.5,746,247,499,49.5
31023, 분당구,090005, 89세,2021,673,211,462,45.7,671,210,461,45.6
31023, 분당구,095,90~94세,2021,1835,563,1272,44.3,1826,561,1265,44.3
31023, 분당구,095001, 90세,2021,527,167,360,46.4,524,167,357,46.8
31023, 분당구,095002, 91세,2021,468,146,322,45.3,467,146,321,45.5
31023, 분당구,095003, 92세,2021,354,116,238,48.7,353,115,238,48.3
31023, 분당구,095004, 93세,2021,296,91,205,44.4,293,90,203,44.3
31023, 분당구,095005, 94세,2021,190,43,147,29.3,189,43,146,29.5
31023, 분당구,100,95~99세,2021,353,84,269,31.2,351,84,267,31.5
31023, 분당구,100001, 95세,2021,106,24,82,29.3,106,24,82,29.3
31023, 분당구,100002, 96세,2021,93,15,78,19.2,92,15,77,19.5
31023, 분당구,100003, 97세,2021,60,19,41,46.3,60,19,41,46.3
31023, 분당구,100004, 98세,2021,50,14,36,38.9,49,14,35,40
31023, 분당구,100005, 99세,2021,44,12,32,37.5,44,12,32,37.5
31023, 분당구,101,100세이상,2021,55,16,39,41,53,16,37,43.2
31023, 분당구,102,15세미만,2021,62352,32064,30288,105.9,61863,31792,30071,105.7
31023, 분당구,103,15~64세,2021,336212,163826,172386,95,331637,161801,169836,95.3
31023, 분당구,104,65세이상,2021,61690,27537,34153,80.6,61396,27429,33967,80.8
31023, 분당구,086,85세이상,2021,6924,2311,4613,50.1,6903,2306,4597,50.2
31023, 분당구,126,평균연령,2021,41.5,40.7,42.3,,41.5,40.7,42.3,
31023, 분당구,127,중위연령,2021,42.5,41.7,43.2,,42.5,41.7,43.3,
31030, 의정부시,000,합계,2021,455454,223988,231466,96.8,448866,221045,227821,97
31030, 의정부시,005,0~4세,2021,13844,7276,6568,110.8,13720,7211,6509,110.8
31030, 의정부시,005001, 0세,2021,2410,1277,1133,112.7,2389,1269,1120,113.3
31030, 의정부시,005002, 1세,2021,2484,1266,1218,103.9,2456,1255,1201,104.5
31030, 의정부시,005003, 2세,2021,2758,1451,1307,111,2740,1440,1300,110.8
31030, 의정부시,005004, 3세,2021,2977,1575,1402,112.3,2946,1552,1394,111.3
31030, 의정부시,005005, 4세,2021,3215,1707,1508,113.2,3189,1695,1494,113.5
31030, 의정부시,010,5~9세,2021,19106,9756,9350,104.3,18985,9697,9288,104.4
31030, 의정부시,010001, 5세,2021,3588,1797,1791,100.3,3552,1780,1772,100.5
31030, 의정부시,010002, 6세,2021,3897,2040,1857,109.9,3859,2020,1839,109.8
31030, 의정부시,010003, 7세,2021,3740,1909,1831,104.3,3724,1902,1822,104.4
31030, 의정부시,010004, 8세,2021,3754,1927,1827,105.5,3740,1921,1819,105.6
31030, 의정부시,010005, 9세,2021,4127,2083,2044,101.9,4110,2074,2036,101.9
31030, 의정부시,015,10~14세,2021,19835,10313,9522,108.3,19774,10281,9493,108.3
31030, 의정부시,015001, 10세,2021,3985,2067,1918,107.8,3972,2062,1910,108
31030, 의정부시,015002, 11세,2021,3954,2052,1902,107.9,3938,2047,1891,108.2
31030, 의정부시,015003, 12세,2021,3730,1881,1849,101.7,3712,1871,1841,101.6
31030, 의정부시,015004, 13세,2021,3913,2050,1863,110,3907,2045,1862,109.8
31030, 의정부시,015005, 14세,2021,4253,2263,1990,113.7,4245,2256,1989,113.4
31030, 의정부시,020,15~19세,2021,20242,10385,9857,105.4,20134,10338,9796,105.5
31030, 의정부시,020001, 15세,2021,3761,1894,1867,101.4,3750,1887,1863,101.3
31030, 의정부시,020002, 16세,2021,3826,1948,1878,103.7,3820,1945,1875,103.7
31030, 의정부시,020003, 17세,2021,4138,2150,1988,108.1,4127,2147,1980,108.4
31030, 의정부시,020004, 18세,2021,4214,2199,2015,109.1,4194,2190,2004,109.3
31030, 의정부시,020005, 19세,2021,4303,2194,2109,104,4243,2169,2074,104.6
31030, 의정부시,025,20~24세,2021,29218,14536,14682,99,28519,14202,14317,99.2
31030, 의정부시,025001, 20세,2021,5148,2604,2544,102.4,5053,2571,2482,103.6
31030, 의정부시,025002, 21세,2021,5874,3003,2871,104.6,5745,2946,2799,105.3
31030, 의정부시,025003, 22세,2021,5717,2875,2842,101.2,5584,2815,2769,101.7
31030, 의정부시,025004, 23세,2021,5968,2928,3040,96.3,5782,2828,2954,95.7
31030, 의정부시,025005, 24세,2021,6511,3126,3385,92.3,6355,3042,3313,91.8
31030, 의정부시,030,25~29세,2021,33292,16933,16359,103.5,32409,16554,15855,104.4
31030, 의정부시,030001, 25세,2021,6567,3287,3280,100.2,6393,3211,3182,100.9
31030, 의정부시,030002, 26세,2021,6706,3332,3374,98.8,6512,3252,3260,99.8
31030, 의정부시,030003, 27세,2021,6674,3431,3243,105.8,6496,3358,3138,107
31030, 의정부시,030004, 28세,2021,6657,3418,3239,105.5,6501,3346,3155,106.1
31030, 의정부시,030005, 29세,2021,6688,3465,3223,107.5,6507,3387,3120,108.6
31030, 의정부시,035,30~34세,2021,28246,14338,13908,103.1,27342,13977,13365,104.6
31030, 의정부시,035001, 30세,2021,6255,3181,3074,103.5,6080,3109,2971,104.6
31030, 의정부시,035002, 31세,2021,5735,2900,2835,102.3,5556,2832,2724,104
31030, 의정부시,035003, 32세,2021,5527,2833,2694,105.2,5343,2757,2586,106.6
31030, 의정부시,035004, 33세,2021,5400,2722,2678,101.6,5213,2657,2556,104
31030, 의정부시,035005, 34세,2021,5329,2702,2627,102.9,5150,2622,2528,103.7
31030, 의정부시,040,35~39세,2021,31391,16019,15372,104.2,30608,15680,14928,105
31030, 의정부시,040001, 35세,2021,5695,2931,2764,106,5532,2857,2675,106.8
31030, 의정부시,040002, 36세,2021,5647,2851,2796,102,5494,2786,2708,102.9
31030, 의정부시,040003, 37세,2021,6084,3096,2988,103.6,5927,3031,2896,104.7
31030, 의정부시,040004, 38세,2021,6790,3454,3336,103.5,6648,3395,3253,104.4
31030, 의정부시,040005, 39세,2021,7175,3687,3488,105.7,7007,3611,3396,106.3
31030, 의정부시,045,40~44세,2021,34659,17751,16908,105,34061,17450,16611,105.1
31030, 의정부시,045001, 40세,2021,7339,3785,3554,106.5,7211,3720,3491,106.6
31030, 의정부시,045002, 41세,2021,7371,3827,3544,108,7248,3766,3482,108.2
31030, 의정부시,045003, 42세,2021,6970,3564,3406,104.6,6856,3513,3343,105.1
31030, 의정부시,045004, 43세,2021,6396,3282,3114,105.4,6275,3213,3062,104.9
31030, 의정부시,045005, 44세,2021,6583,3293,3290,100.1,6471,3238,3233,100.2
31030, 의정부시,050,45~49세,2021,37435,18501,18934,97.7,36951,18272,18679,97.8
31030, 의정부시,050001, 45세,2021,6328,3189,3139,101.6,6224,3134,3090,101.4
31030, 의정부시,050002, 46세,2021,6923,3410,3513,97.1,6849,3380,3469,97.4
31030, 의정부시,050003, 47세,2021,7929,3959,3970,99.7,7834,3912,3922,99.7
31030, 의정부시,050004, 48세,2021,7912,3831,4081,93.9,7820,3789,4031,94
31030, 의정부시,050005, 49세,2021,8343,4112,4231,97.2,8224,4057,4167,97.4
31030, 의정부시,055,50~54세,2021,41603,20331,21272,95.6,41066,20079,20987,95.7
31030, 의정부시,055001, 50세,2021,8672,4283,4389,97.6,8560,4229,4331,97.6
31030, 의정부시,055002, 51세,2021,8430,4147,4283,96.8,8312,4090,4222,96.9
31030, 의정부시,055003, 52세,2021,8541,4202,4339,96.8,8440,4157,4283,97.1
31030, 의정부시,055004, 53세,2021,8426,4047,4379,92.4,8301,3984,4317,92.3
31030, 의정부시,055005, 54세,2021,7534,3652,3882,94.1,7453,3619,3834,94.4
31030, 의정부시,060,55~59세,2021,37699,18617,19082,97.6,37207,18399,18808,97.8
31030, 의정부시,060001, 55세,2021,7626,3702,3924,94.3,7531,3667,3864,94.9
31030, 의정부시,060002, 56세,2021,7750,3835,3915,98,7641,3787,3854,98.3
31030, 의정부시,060003, 57세,2021,7147,3563,3584,99.4,7036,3512,3524,99.7
31030, 의정부시,060004, 58세,2021,7653,3815,3838,99.4,7565,3770,3795,99.3
31030, 의정부시,060005, 59세,2021,7523,3702,3821,96.9,7434,3663,3771,97.1
31030, 의정부시,065,60~64세,2021,35785,17694,18091,97.8,35436,17555,17881,98.2
31030, 의정부시,065001, 60세,2021,7819,3820,3999,95.5,7754,3798,3956,96
31030, 의정부시,065002, 61세,2021,8052,4022,4030,99.8,7964,3985,3979,100.2
31030, 의정부시,065003, 62세,2021,6844,3364,3480,96.7,6776,3337,3439,97
31030, 의정부시,065004, 63세,2021,6617,3306,3311,99.8,6551,3280,3271,100.3
31030, 의정부시,065005, 64세,2021,6453,3182,3271,97.3,6391,3155,3236,97.5
31030, 의정부시,070,65~69세,2021,24667,11716,12951,90.5,24441,11602,12839,90.4
31030, 의정부시,070001, 65세,2021,5555,2689,2866,93.8,5504,2656,2848,93.3
31030, 의정부시,070002, 66세,2021,5695,2638,3057,86.3,5644,2608,3036,85.9
31030, 의정부시,070003, 67세,2021,4855,2332,2523,92.4,4812,2314,2498,92.6
31030, 의정부시,070004, 68세,2021,4094,1985,2109,94.1,4056,1971,2085,94.5
31030, 의정부시,070005, 69세,2021,4468,2072,2396,86.5,4425,2053,2372,86.6
31030, 의정부시,075,70~74세,2021,17238,7807,9431,82.8,17117,7761,9356,83
31030, 의정부시,075001, 70세,2021,3015,1401,1614,86.8,2981,1391,1590,87.5
31030, 의정부시,075002, 71세,2021,3500,1574,1926,81.7,3482,1569,1913,82
31030, 의정부시,075003, 72세,2021,3580,1645,1935,85,3546,1633,1913,85.4
31030, 의정부시,075004, 73세,2021,3480,1557,1923,81,3464,1548,1916,80.8
31030, 의정부시,075005, 74세,2021,3663,1630,2033,80.2,3644,1620,2024,80
31030, 의정부시,080,75~79세,2021,13962,5934,8028,73.9,13916,5919,7997,74
31030, 의정부시,080001, 75세,2021,2818,1212,1606,75.5,2807,1207,1600,75.4
31030, 의정부시,080002, 76세,2021,2729,1192,1537,77.6,2721,1189,1532,77.6
31030, 의정부시,080003, 77세,2021,2689,1152,1537,75,2678,1149,1529,75.1
31030, 의정부시,080004, 78세,2021,2650,1100,1550,71,2642,1099,1543,71.2
31030, 의정부시,080005, 79세,2021,3076,1278,1798,71.1,3068,1275,1793,71.1
31030, 의정부시,085,80~84세,2021,10130,3989,6141,65,10105,3983,6122,65.1
31030, 의정부시,085001, 80세,2021,2429,1002,1427,70.2,2426,1001,1425,70.2
31030, 의정부시,085002, 81세,2021,2195,872,1323,65.9,2187,871,1316,66.2
31030, 의정부시,085003, 82세,2021,2088,818,1270,64.4,2083,817,1266,64.5
31030, 의정부시,085004, 83세,2021,1851,714,1137,62.8,1845,712,1133,62.8
31030, 의정부시,085005, 84세,2021,1567,583,984,59.2,1564,582,982,59.3
31030, 의정부시,090,85~89세,2021,5029,1630,3399,48,5008,1624,3384,48
31030, 의정부시,090001, 85세,2021,1416,481,935,51.4,1409,480,929,51.7
31030, 의정부시,090002, 86세,2021,1197,406,791,51.3,1190,404,786,51.4
31030, 의정부시,090003, 87세,2021,992,301,691,43.6,991,301,690,43.6
31030, 의정부시,090004, 88세,2021,782,256,526,48.7,778,255,523,48.8
31030, 의정부시,090005, 89세,2021,642,186,456,40.8,640,184,456,40.4
31030, 의정부시,095,90~94세,2021,1676,394,1282,30.7,1670,393,1277,30.8
31030, 의정부시,095001, 90세,2021,463,119,344,34.6,460,118,342,34.5
31030, 의정부시,095002, 91세,2021,435,95,340,27.9,434,95,339,28
31030, 의정부시,095003, 92세,2021,326,81,245,33.1,325,81,244,33.2
31030, 의정부시,095004, 93세,2021,273,61,212,28.8,272,61,211,28.9
31030, 의정부시,095005, 94세,2021,179,38,141,27,179,38,141,27
31030, 의정부시,100,95~99세,2021,339,57,282,20.2,339,57,282,20.2
31030, 의정부시,100001, 95세,2021,99,20,79,25.3,99,20,79,25.3
31030, 의정부시,100002, 96세,2021,94,14,80,17.5,94,14,80,17.5
31030, 의정부시,100003, 97세,2021,63,10,53,18.9,63,10,53,18.9
31030, 의정부시,100004, 98세,2021,49,7,42,16.7,49,7,42,16.7
31030, 의정부시,100005, 99세,2021,34,6,28,21.4,34,6,28,21.4
31030, 의정부시,101,100세이상,2021,58,11,47,23.4,58,11,47,23.4
31030, 의정부시,102,15세미만,2021,52785,27345,25440,107.5,52479,27189,25290,107.5
31030, 의정부시,103,15~64세,2021,329570,165105,164465,100.4,323733,162506,161227,100.8
31030, 의정부시,104,65세이상,2021,73099,31538,41561,75.9,72654,31350,41304,75.9
31030, 의정부시,086,85세이상,2021,7102,2092,5010,41.8,7075,2085,4990,41.8
31030, 의정부시,126,평균연령,2021,43.4,42.3,44.4,,43.4,42.3,44.5,
31030, 의정부시,127,중위연령,2021,44.7,43.4,46,,44.8,43.5,46.2,
31040, 안양시,000,합계,2021,538929,265951,272978,97.4,528599,260994,267605,97.5
31040, 안양시,005,0~4세,2021,16221,8215,8006,102.6,15991,8100,7891,102.6
31040, 안양시,005001, 0세,2021,3100,1559,1541,101.2,3065,1541,1524,101.1
31040, 안양시,005002, 1세,2021,3019,1514,1505,100.6,2961,1487,1474,100.9
31040, 안양시,005003, 2세,2021,3146,1566,1580,99.1,3096,1541,1555,99.1
31040, 안양시,005004, 3세,2021,3481,1797,1684,106.7,3430,1770,1660,106.6
31040, 안양시,005005, 4세,2021,3475,1779,1696,104.9,3439,1761,1678,104.9
31040, 안양시,010,5~9세,2021,21256,10879,10377,104.8,21019,10751,10268,104.7
31040, 안양시,010001, 5세,2021,4139,2127,2012,105.7,4075,2091,1984,105.4
31040, 안양시,010002, 6세,2021,4240,2121,2119,100.1,4191,2091,2100,99.6
31040, 안양시,010003, 7세,2021,4148,2110,2038,103.5,4100,2085,2015,103.5
31040, 안양시,010004, 8세,2021,4130,2116,2014,105.1,4091,2097,1994,105.2
31040, 안양시,010005, 9세,2021,4599,2405,2194,109.6,4562,2387,2175,109.7
31040, 안양시,015,10~14세,2021,23793,12358,11435,108.1,23677,12299,11378,108.1
31040, 안양시,015001, 10세,2021,4709,2384,2325,102.5,4685,2371,2314,102.5
31040, 안양시,015002, 11세,2021,4596,2426,2170,111.8,4564,2411,2153,112
31040, 안양시,015003, 12세,2021,4504,2357,2147,109.8,4486,2347,2139,109.7
31040, 안양시,015004, 13세,2021,4929,2565,2364,108.5,4908,2555,2353,108.6
31040, 안양시,015005, 14세,2021,5055,2626,2429,108.1,5034,2615,2419,108.1
31040, 안양시,020,15~19세,2021,24998,12897,12101,106.6,24893,12845,12048,106.6
31040, 안양시,020001, 15세,2021,4915,2558,2357,108.5,4899,2551,2348,108.6
31040, 안양시,020002, 16세,2021,4729,2424,2305,105.2,4708,2414,2294,105.2
31040, 안양시,020003, 17세,2021,4950,2583,2367,109.1,4935,2576,2359,109.2
31040, 안양시,020004, 18세,2021,5288,2726,2562,106.4,5281,2722,2559,106.4
31040, 안양시,020005, 19세,2021,5116,2606,2510,103.8,5070,2582,2488,103.8
31040, 안양시,025,20~24세,2021,33795,17265,16530,104.4,33300,17074,16226,105.2
31040, 안양시,025001, 20세,2021,6028,3079,2949,104.4,5973,3055,2918,104.7
31040, 안양시,025002, 21세,2021,6801,3507,3294,106.5,6718,3478,3240,107.3
31040, 안양시,025003, 22세,2021,6679,3480,3199,108.8,6590,3441,3149,109.3
31040, 안양시,025004, 23세,2021,6935,3490,3445,101.3,6779,3428,3351,102.3
31040, 안양시,025005, 24세,2021,7352,3709,3643,101.8,7240,3672,3568,102.9
31040, 안양시,030,25~29세,2021,39222,20344,18878,107.8,38436,20021,18415,108.7
31040, 안양시,030001, 25세,2021,7405,3849,3556,108.2,7288,3800,3488,108.9
31040, 안양시,030002, 26세,2021,7656,3990,3666,108.8,7519,3933,3586,109.7
31040, 안양시,030003, 27세,2021,7984,4165,3819,109.1,7815,4096,3719,110.1
31040, 안양시,030004, 28세,2021,7998,4159,3839,108.3,7831,4090,3741,109.3
31040, 안양시,030005, 29세,2021,8179,4181,3998,104.6,7983,4102,3881,105.7
31040, 안양시,035,30~34세,2021,37980,19569,18411,106.3,36744,19002,17742,107.1
31040, 안양시,035001, 30세,2021,7948,4115,3833,107.4,7715,4015,3700,108.5
31040, 안양시,035002, 31세,2021,7609,3934,3675,107,7373,3830,3543,108.1
31040, 안양시,035003, 32세,2021,7561,3853,3708,103.9,7310,3744,3566,105
31040, 안양시,035004, 33세,2021,7482,3881,3601,107.8,7226,3757,3469,108.3
31040, 안양시,035005, 34세,2021,7380,3786,3594,105.3,7120,3656,3464,105.5
31040, 안양시,040,35~39세,2021,38275,19754,18521,106.7,37104,19156,17948,106.7
31040, 안양시,040001, 35세,2021,7337,3824,3513,108.9,7077,3687,3390,108.8
31040, 안양시,040002, 36세,2021,7151,3701,3450,107.3,6905,3577,3328,107.5
31040, 안양시,040003, 37세,2021,7369,3774,3595,105,7127,3655,3472,105.3
31040, 안양시,040004, 38세,2021,7917,4041,3876,104.3,7722,3943,3779,104.3
31040, 안양시,040005, 39세,2021,8501,4414,4087,108,8273,4294,3979,107.9
31040, 안양시,045,40~44세,2021,39924,19878,20046,99.2,39090,19445,19645,99
31040, 안양시,045001, 40세,2021,8339,4313,4026,107.1,8175,4237,3938,107.6
31040, 안양시,045002, 41세,2021,8356,4125,4231,97.5,8196,4031,4165,96.8
31040, 안양시,045003, 42세,2021,7999,3994,4005,99.7,7817,3905,3912,99.8
31040, 안양시,045004, 43세,2021,7424,3639,3785,96.1,7243,3546,3697,95.9
31040, 안양시,045005, 44세,2021,7806,3807,3999,95.2,7659,3726,3933,94.7
31040, 안양시,050,45~49세,2021,44229,21524,22705,94.8,43347,21067,22280,94.6
31040, 안양시,050001, 45세,2021,7803,3829,3974,96.4,7650,3747,3903,96
31040, 안양시,050002, 46세,2021,8354,4056,4298,94.4,8204,3968,4236,93.7
31040, 안양시,050003, 47세,2021,9220,4526,4694,96.4,9037,4440,4597,96.6
31040, 안양시,050004, 48세,2021,9262,4403,4859,90.6,9083,4305,4778,90.1
31040, 안양시,050005, 49세,2021,9590,4710,4880,96.5,9373,4607,4766,96.7
31040, 안양시,055,50~54세,2021,49804,23961,25843,92.7,48734,23410,25324,92.4
31040, 안양시,055001, 50세,2021,10308,5008,5300,94.5,10108,4911,5197,94.5
31040, 안양시,055002, 51세,2021,10017,4837,5180,93.4,9787,4711,5076,92.8
31040, 안양시,055003, 52세,2021,10175,4924,5251,93.8,9945,4818,5127,94
31040, 안양시,055004, 53세,2021,10081,4849,5232,92.7,9873,4731,5142,92
31040, 안양시,055005, 54세,2021,9223,4343,4880,89,9021,4239,4782,88.6
31040, 안양시,060,55~59세,2021,45787,22381,23406,95.6,44610,21785,22825,95.4
31040, 안양시,060001, 55세,2021,9000,4485,4515,99.3,8786,4373,4413,99.1
31040, 안양시,060002, 56세,2021,9312,4459,4853,91.9,9088,4351,4737,91.9
31040, 안양시,060003, 57세,2021,8793,4368,4425,98.7,8555,4243,4312,98.4
31040, 안양시,060004, 58세,2021,9235,4518,4717,95.8,8942,4373,4569,95.7
31040, 안양시,060005, 59세,2021,9447,4551,4896,93,9239,4445,4794,92.7
31040, 안양시,065,60~64세,2021,45216,21998,23218,94.7,44240,21534,22706,94.8
31040, 안양시,065001, 60세,2021,10068,4820,5248,91.8,9929,4764,5165,92.2
31040, 안양시,065002, 61세,2021,10243,4919,5324,92.4,10022,4809,5213,92.3
31040, 안양시,065003, 62세,2021,8860,4332,4528,95.7,8683,4250,4433,95.9
31040, 안양시,065004, 63세,2021,8253,4122,4131,99.8,8016,4004,4012,99.8
31040, 안양시,065005, 64세,2021,7792,3805,3987,95.4,7590,3707,3883,95.5
31040, 안양시,070,65~69세,2021,29971,14816,15155,97.8,29350,14520,14830,97.9
31040, 안양시,070001, 65세,2021,6918,3376,3542,95.3,6759,3296,3463,95.2
31040, 안양시,070002, 66세,2021,7132,3508,3624,96.8,6985,3441,3544,97.1
31040, 안양시,070003, 67세,2021,5750,2891,2859,101.1,5626,2822,2804,100.6
31040, 안양시,070004, 68세,2021,4973,2507,2466,101.7,4854,2459,2395,102.7
31040, 안양시,070005, 69세,2021,5198,2534,2664,95.1,5126,2502,2624,95.4
31040, 안양시,075,70~74세,2021,18391,8801,9590,91.8,18181,8719,9462,92.1
31040, 안양시,075001, 70세,2021,3532,1710,1822,93.9,3466,1680,1786,94.1
31040, 안양시,075002, 71세,2021,3996,1990,2006,99.2,3951,1977,1974,100.2
31040, 안양시,075003, 72세,2021,3717,1810,1907,94.9,3666,1788,1878,95.2
31040, 안양시,075004, 73세,2021,3614,1680,1934,86.9,3587,1672,1915,87.3
31040, 안양시,075005, 74세,2021,3532,1611,1921,83.9,3511,1602,1909,83.9
31040, 안양시,080,75~79세,2021,13356,5790,7566,76.5,13270,5774,7496,77
31040, 안양시,080001, 75세,2021,2740,1247,1493,83.5,2716,1244,1472,84.5
31040, 안양시,080002, 76세,2021,2635,1156,1479,78.2,2623,1153,1470,78.4
31040, 안양시,080003, 77세,2021,2588,1097,1491,73.6,2575,1095,1480,74
31040, 안양시,080004, 78세,2021,2519,1097,1422,77.1,2497,1092,1405,77.7
31040, 안양시,080005, 79세,2021,2874,1193,1681,71,2859,1190,1669,71.3
31040, 안양시,085,80~84세,2021,9412,3564,5848,60.9,9350,3543,5807,61
31040, 안양시,085001, 80세,2021,2221,908,1313,69.2,2201,902,1299,69.4
31040, 안양시,085002, 81세,2021,1947,752,1195,62.9,1938,750,1188,63.1
31040, 안양시,085003, 82세,2021,1966,762,1204,63.3,1951,756,1195,63.3
31040, 안양시,085004, 83세,2021,1741,624,1117,55.9,1735,622,1113,55.9
31040, 안양시,085005, 84세,2021,1537,518,1019,50.8,1525,513,1012,50.7
31040, 안양시,090,85~89세,2021,5084,1470,3614,40.7,5056,1464,3592,40.8
31040, 안양시,090001, 85세,2021,1328,408,920,44.3,1317,407,910,44.7
31040, 안양시,090002, 86세,2021,1252,373,879,42.4,1247,372,875,42.5
31040, 안양시,090003, 87세,2021,965,282,683,41.3,963,281,682,41.2
31040, 안양시,090004, 88세,2021,836,225,611,36.8,830,223,607,36.7
31040, 안양시,090005, 89세,2021,703,182,521,34.9,699,181,518,34.9
31040, 안양시,095,90~94세,2021,1804,403,1401,28.8,1799,402,1397,28.8
31040, 안양시,095001, 90세,2021,549,122,427,28.6,549,122,427,28.6
31040, 안양시,095002, 91세,2021,465,115,350,32.9,463,115,348,33
31040, 안양시,095003, 92세,2021,321,75,246,30.5,319,74,245,30.2
31040, 안양시,095004, 93세,2021,266,53,213,24.9,265,53,212,25
31040, 안양시,095005, 94세,2021,203,38,165,23,203,38,165,23
31040, 안양시,100,95~99세,2021,378,80,298,26.8,375,79,296,26.7
31040, 안양시,100001, 95세,2021,122,29,93,31.2,120,29,91,31.9
31040, 안양시,100002, 96세,2021,102,15,87,17.2,102,15,87,17.2
31040, 안양시,100003, 97세,2021,55,16,39,41,54,15,39,38.5
31040, 안양시,100004, 98세,2021,67,14,53,26.4,67,14,53,26.4
31040, 안양시,100005, 99세,2021,32,6,26,23.1,32,6,26,23.1
31040, 안양시,101,100세이상,2021,33,X,29,13.8,33,X,29,13.8
31040, 안양시,102,15세미만,2021,61270,31452,29818,105.5,60687,31150,29537,105.5
31040, 안양시,103,15~64세,2021,399230,199571,199659,100,390498,195339,195159,100.1
31040, 안양시,104,65세이상,2021,78429,34928,43501,80.3,77414,34505,42909,80.4
31040, 안양시,086,85세이상,2021,7299,1957,5342,36.6,7263,1949,5314,36.7
31040, 안양시,126,평균연령,2021,42.9,41.9,43.9,,42.9,41.9,43.9,
31040, 안양시,127,중위연령,2021,44.2,42.8,45.5,,44.2,42.8,45.6,
31041, 만안구,000,합계,2021,240501,119862,120639,99.4,232576,115922,116654,99.4
31041, 만안구,005,0~4세,2021,6923,3467,3456,100.3,6746,3376,3370,100.2
31041, 만안구,005001, 0세,2021,1333,653,680,96,1305,639,666,95.9
31041, 만안구,005002, 1세,2021,1351,660,691,95.5,1309,639,670,95.4
31041, 만안구,005003, 2세,2021,1329,671,658,102,1287,649,638,101.7
31041, 만안구,005004, 3세,2021,1457,745,712,104.6,1417,725,692,104.8
31041, 만안구,005005, 4세,2021,1453,738,715,103.2,1428,724,704,102.8
31041, 만안구,010,5~9세,2021,8078,4125,3953,104.4,7892,4030,3862,104.4
31041, 만안구,010001, 5세,2021,1712,872,840,103.8,1658,841,817,102.9
31041, 만안구,010002, 6세,2021,1624,820,804,102,1588,800,788,101.5
31041, 만안구,010003, 7세,2021,1544,758,786,96.4,1508,741,767,96.6
31041, 만안구,010004, 8세,2021,1543,796,747,106.6,1513,782,731,107
31041, 만안구,010005, 9세,2021,1655,879,776,113.3,1625,866,759,114.1
31041, 만안구,015,10~14세,2021,8151,4273,3878,110.2,8071,4230,3841,110.1
31041, 만안구,015001, 10세,2021,1628,828,800,103.5,1613,818,795,102.9
31041, 만안구,015002, 11세,2021,1573,813,760,107,1552,804,748,107.5
31041, 만안구,015003, 12세,2021,1540,825,715,115.4,1525,817,708,115.4
31041, 만안구,015004, 13세,2021,1675,885,790,112,1661,877,784,111.9
31041, 만안구,015005, 14세,2021,1735,922,813,113.4,1720,914,806,113.4
31041, 만안구,020,15~19세,2021,9504,4932,4572,107.9,9414,4889,4525,108
31041, 만안구,020001, 15세,2021,1731,903,828,109.1,1721,898,823,109.1
31041, 만안구,020002, 16세,2021,1703,881,822,107.2,1687,874,813,107.5
31041, 만안구,020003, 17세,2021,1839,969,870,111.4,1826,964,862,111.8
31041, 만안구,020004, 18세,2021,2089,1098,991,110.8,2083,1095,988,110.8
31041, 만안구,020005, 19세,2021,2142,1081,1061,101.9,2097,1058,1039,101.8
31041, 만안구,025,20~24세,2021,15376,7732,7644,101.2,14990,7565,7425,101.9
31041, 만안구,025001, 20세,2021,2526,1261,1265,99.7,2480,1240,1240,100
31041, 만안구,025002, 21세,2021,3157,1519,1638,92.7,3091,1495,1596,93.7
31041, 만안구,025003, 22세,2021,3124,1573,1551,101.4,3049,1536,1513,101.5
31041, 만안구,025004, 23세,2021,3191,1647,1544,106.7,3072,1594,1478,107.8
31041, 만안구,025005, 24세,2021,3378,1732,1646,105.2,3298,1700,1598,106.4
31041, 만안구,030,25~29세,2021,18504,9753,8751,111.5,17979,9519,8460,112.5
31041, 만안구,030001, 25세,2021,3422,1838,1584,116,3349,1805,1544,116.9
31041, 만안구,030002, 26세,2021,3637,1915,1722,111.2,3542,1874,1668,112.4
31041, 만안구,030003, 27세,2021,3829,2017,1812,111.3,3717,1966,1751,112.3
31041, 만안구,030004, 28세,2021,3809,2022,1787,113.2,3698,1969,1729,113.9
31041, 만안구,030005, 29세,2021,3807,1961,1846,106.2,3673,1905,1768,107.7
31041, 만안구,035,30~34세,2021,17084,9006,8078,111.5,16208,8576,7632,112.4
31041, 만안구,035001, 30세,2021,3637,1942,1695,114.6,3475,1870,1605,116.5
31041, 만안구,035002, 31세,2021,3408,1833,1575,116.4,3242,1758,1484,118.5
31041, 만안구,035003, 32세,2021,3417,1757,1660,105.8,3234,1665,1569,106.1
31041, 만안구,035004, 33세,2021,3396,1804,1592,113.3,3221,1714,1507,113.7
31041, 만안구,035005, 34세,2021,3226,1670,1556,107.3,3036,1569,1467,107
31041, 만안구,040,35~39세,2021,16698,8900,7798,114.1,15858,8450,7408,114.1
31041, 만안구,040001, 35세,2021,3209,1714,1495,114.6,3023,1610,1413,113.9
31041, 만안구,040002, 36세,2021,3160,1669,1491,111.9,2981,1577,1404,112.3
31041, 만안구,040003, 37세,2021,3165,1677,1488,112.7,2999,1590,1409,112.8
31041, 만안구,040004, 38세,2021,3483,1842,1641,112.2,3344,1770,1574,112.5
31041, 만안구,040005, 39세,2021,3681,1998,1683,118.7,3511,1903,1608,118.3
31041, 만안구,045,40~44세,2021,16544,8701,7843,110.9,15937,8360,7577,110.3
31041, 만안구,045001, 40세,2021,3585,1950,1635,119.3,3465,1888,1577,119.7
31041, 만안구,045002, 41세,2021,3506,1818,1688,107.7,3394,1746,1648,105.9
31041, 만안구,045003, 42세,2021,3315,1739,1576,110.3,3170,1665,1505,110.6
31041, 만안구,045004, 43세,2021,2981,1568,1413,111,2853,1496,1357,110.2
31041, 만안구,045005, 44세,2021,3157,1626,1531,106.2,3055,1565,1490,105
31041, 만안구,050,45~49세,2021,17696,8941,8755,102.1,17050,8601,8449,101.8
31041, 만안구,050001, 45세,2021,3097,1616,1481,109.1,2979,1553,1426,108.9
31041, 만안구,050002, 46세,2021,3268,1686,1582,106.6,3159,1618,1541,105
31041, 만안구,050003, 47세,2021,3651,1856,1795,103.4,3516,1794,1722,104.2
31041, 만안구,050004, 48세,2021,3738,1837,1901,96.6,3608,1762,1846,95.4
31041, 만안구,050005, 49세,2021,3942,1946,1996,97.5,3788,1874,1914,97.9
31041, 만안구,055,50~54세,2021,21686,10408,11278,92.3,20841,9966,10875,91.6
31041, 만안구,055001, 50세,2021,4265,2097,2168,96.7,4100,2017,2083,96.8
31041, 만안구,055002, 51세,2021,4283,2050,2233,91.8,4093,1948,2145,90.8
31041, 만안구,055003, 52세,2021,4414,2117,2297,92.2,4242,2036,2206,92.3
31041, 만안구,055004, 53세,2021,4472,2156,2316,93.1,4313,2066,2247,91.9
31041, 만안구,055005, 54세,2021,4252,1988,2264,87.8,4093,1899,2194,86.6
31041, 만안구,060,55~59세,2021,21748,10784,10964,98.4,20761,10280,10481,98.1
31041, 만안구,060001, 55세,2021,4234,2130,2104,101.2,4060,2036,2024,100.6
31041, 만안구,060002, 56세,2021,4398,2104,2294,91.7,4217,2018,2199,91.8
31041, 만안구,060003, 57세,2021,4162,2111,2051,102.9,3954,2003,1951,102.7
31041, 만안구,060004, 58세,2021,4443,2206,2237,98.6,4197,2081,2116,98.3
31041, 만안구,060005, 59세,2021,4511,2233,2278,98,4333,2142,2191,97.8
31041, 만안구,065,60~64세,2021,22059,10765,11294,95.3,21218,10358,10860,95.4
31041, 만안구,065001, 60세,2021,4815,2351,2464,95.4,4701,2303,2398,96
31041, 만안구,065002, 61세,2021,4974,2393,2581,92.7,4782,2299,2483,92.6
31041, 만안구,065003, 62세,2021,4318,2093,2225,94.1,4170,2025,2145,94.4
31041, 만안구,065004, 63세,2021,4074,2047,2027,101,3865,1940,1925,100.8
31041, 만안구,065005, 64세,2021,3878,1881,1997,94.2,3700,1791,1909,93.8
31041, 만안구,070,65~69세,2021,15095,7417,7678,96.6,14558,7159,7399,96.8
31041, 만안구,070001, 65세,2021,3417,1661,1756,94.6,3279,1589,1690,94
31041, 만안구,070002, 66세,2021,3494,1696,1798,94.3,3365,1636,1729,94.6
31041, 만안구,070003, 67세,2021,2970,1495,1475,101.4,2866,1438,1428,100.7
31041, 만안구,070004, 68세,2021,2524,1261,1263,99.8,2421,1220,1201,101.6
31041, 만안구,070005, 69세,2021,2690,1304,1386,94.1,2627,1276,1351,94.4
31041, 만안구,075,70~74세,2021,9580,4639,4941,93.9,9417,4578,4839,94.6
31041, 만안구,075001, 70세,2021,1817,875,942,92.9,1763,851,912,93.3
31041, 만안구,075002, 71세,2021,2067,1046,1021,102.4,2032,1037,995,104.2
31041, 만안구,075003, 72세,2021,1972,978,994,98.4,1935,961,974,98.7
31041, 만안구,075004, 73세,2021,1887,907,980,92.6,1865,901,964,93.5
31041, 만안구,075005, 74세,2021,1837,833,1004,83,1822,828,994,83.3
31041, 만안구,080,75~79세,2021,7135,3134,4001,78.3,7068,3119,3949,79
31041, 만안구,080001, 75세,2021,1458,657,801,82,1438,654,784,83.4
31041, 만안구,080002, 76세,2021,1394,598,796,75.1,1388,596,792,75.3
31041, 만안구,080003, 77세,2021,1371,602,769,78.3,1359,600,759,79.1
31041, 만안구,080004, 78세,2021,1366,605,761,79.5,1346,600,746,80.4
31041, 만안구,080005, 79세,2021,1546,672,874,76.9,1537,669,868,77.1
31041, 만안구,085,80~84세,2021,4900,1891,3009,62.8,4858,1878,2980,63
31041, 만안구,085001, 80세,2021,1153,486,667,72.9,1137,482,655,73.6
31041, 만안구,085002, 81세,2021,1001,390,611,63.8,994,388,606,64
31041, 만안구,085003, 82세,2021,1024,405,619,65.4,1014,402,612,65.7
31041, 만안구,085004, 83세,2021,916,329,587,56,913,328,585,56.1
31041, 만안구,085005, 84세,2021,806,281,525,53.5,800,278,522,53.3
31041, 만안구,090,85~89세,2021,2606,768,1838,41.8,2581,763,1818,42
31041, 만안구,090001, 85세,2021,673,213,460,46.3,662,212,450,47.1
31041, 만안구,090002, 86세,2021,635,188,447,42.1,631,187,444,42.1
31041, 만안구,090003, 87세,2021,495,152,343,44.3,493,151,342,44.2
31041, 만안구,090004, 88세,2021,430,121,309,39.2,425,120,305,39.3
31041, 만안구,090005, 89세,2021,373,94,279,33.7,370,93,277,33.6
31041, 만안구,095,90~94세,2021,909,178,731,24.4,906,177,729,24.3
31041, 만안구,095001, 90세,2021,287,65,222,29.3,287,65,222,29.3
31041, 만안구,095002, 91세,2021,227,44,183,24,226,44,182,24.2
31041, 만안구,095003, 92세,2021,161,35,126,27.8,159,34,125,27.2
31041, 만안구,095004, 93세,2021,132,22,110,20,132,22,110,20
31041, 만안구,095005, 94세,2021,102,12,90,13.3,102,12,90,13.3
31041, 만안구,100,95~99세,2021,204,45,159,28.3,202,45,157,28.7
31041, 만안구,100001, 95세,2021,61,15,46,32.6,59,15,44,34.1
31041, 만안구,100002, 96세,2021,52,9,43,20.9,52,9,43,20.9
31041, 만안구,100003, 97세,2021,34,10,24,41.7,34,10,24,41.7
31041, 만안구,100004, 98세,2021,37,8,29,27.6,37,8,29,27.6
31041, 만안구,100005, 99세,2021,20,X,17,17.6,20,X,17,17.6
31041, 만안구,101,100세이상,2021,21,X,18,16.7,21,X,18,16.7
31041, 만안구,102,15세미만,2021,23152,11865,11287,105.1,22709,11636,11073,105.1
31041, 만안구,103,15~64세,2021,176899,89922,86977,103.4,170256,86564,83692,103.4
31041, 만안구,104,65세이상,2021,40450,18075,22375,80.8,39611,17722,21889,81
31041, 만안구,086,85세이상,2021,3740,994,2746,36.2,3710,988,2722,36.3
31041, 만안구,126,평균연령,2021,44.5,43.4,45.5,,44.5,43.4,45.5,
31041, 만안구,127,중위연령,2021,46.1,44.4,47.7,,46.1,44.3,47.7,
31042, 동안구,000,합계,2021,298428,146089,152339,95.9,296023,145072,150951,96.1
31042, 동안구,005,0~4세,2021,9298,4748,4550,104.4,9245,4724,4521,104.5
31042, 동안구,005001, 0세,2021,1767,906,861,105.2,1760,902,858,105.1
31042, 동안구,005002, 1세,2021,1668,854,814,104.9,1652,848,804,105.5
31042, 동안구,005003, 2세,2021,1817,895,922,97.1,1809,892,917,97.3
31042, 동안구,005004, 3세,2021,2024,1052,972,108.2,2013,1045,968,108
31042, 동안구,005005, 4세,2021,2022,1041,981,106.1,2011,1037,974,106.5
31042, 동안구,010,5~9세,2021,13178,6754,6424,105.1,13127,6721,6406,104.9
31042, 동안구,010001, 5세,2021,2427,1255,1172,107.1,2417,1250,1167,107.1
31042, 동안구,010002, 6세,2021,2616,1301,1315,98.9,2603,1291,1312,98.4
31042, 동안구,010003, 7세,2021,2604,1352,1252,108,2592,1344,1248,107.7
31042, 동안구,010004, 8세,2021,2587,1320,1267,104.2,2578,1315,1263,104.1
31042, 동안구,010005, 9세,2021,2944,1526,1418,107.6,2937,1521,1416,107.4
31042, 동안구,015,10~14세,2021,15642,8085,7557,107,15606,8069,7537,107.1
31042, 동안구,015001, 10세,2021,3081,1556,1525,102,3072,1553,1519,102.2
31042, 동안구,015002, 11세,2021,3023,1613,1410,114.4,3012,1607,1405,114.4
31042, 동안구,015003, 12세,2021,2964,1532,1432,107,2961,1530,1431,106.9
31042, 동안구,015004, 13세,2021,3254,1680,1574,106.7,3247,1678,1569,106.9
31042, 동안구,015005, 14세,2021,3320,1704,1616,105.4,3314,1701,1613,105.5
31042, 동안구,020,15~19세,2021,15494,7965,7529,105.8,15479,7956,7523,105.8
31042, 동안구,020001, 15세,2021,3184,1655,1529,108.2,3178,1653,1525,108.4
31042, 동안구,020002, 16세,2021,3026,1543,1483,104,3021,1540,1481,104
31042, 동안구,020003, 17세,2021,3111,1614,1497,107.8,3109,1612,1497,107.7
31042, 동안구,020004, 18세,2021,3199,1628,1571,103.6,3198,1627,1571,103.6
31042, 동안구,020005, 19세,2021,2974,1525,1449,105.2,2973,1524,1449,105.2
31042, 동안구,025,20~24세,2021,18419,9533,8886,107.3,18310,9509,8801,108
31042, 동안구,025001, 20세,2021,3502,1818,1684,108,3493,1815,1678,108.2
31042, 동안구,025002, 21세,2021,3644,1988,1656,120,3627,1983,1644,120.6
31042, 동안구,025003, 22세,2021,3555,1907,1648,115.7,3541,1905,1636,116.4
31042, 동안구,025004, 23세,2021,3744,1843,1901,96.9,3707,1834,1873,97.9
31042, 동안구,025005, 24세,2021,3974,1977,1997,99,3942,1972,1970,100.1
31042, 동안구,030,25~29세,2021,20718,10591,10127,104.6,20457,10502,9955,105.5
31042, 동안구,030001, 25세,2021,3983,2011,1972,102,3939,1995,1944,102.6
31042, 동안구,030002, 26세,2021,4019,2075,1944,106.7,3977,2059,1918,107.4
31042, 동안구,030003, 27세,2021,4155,2148,2007,107,4098,2130,1968,108.2
31042, 동안구,030004, 28세,2021,4189,2137,2052,104.1,4133,2121,2012,105.4
31042, 동안구,030005, 29세,2021,4372,2220,2152,103.2,4310,2197,2113,104
31042, 동안구,035,30~34세,2021,20896,10563,10333,102.2,20536,10426,10110,103.1
31042, 동안구,035001, 30세,2021,4311,2173,2138,101.6,4240,2145,2095,102.4
31042, 동안구,035002, 31세,2021,4201,2101,2100,100,4131,2072,2059,100.6
31042, 동안구,035003, 32세,2021,4144,2096,2048,102.3,4076,2079,1997,104.1
31042, 동안구,035004, 33세,2021,4086,2077,2009,103.4,4005,2043,1962,104.1
31042, 동안구,035005, 34세,2021,4154,2116,2038,103.8,4084,2087,1997,104.5
31042, 동안구,040,35~39세,2021,21577,10854,10723,101.2,21246,10706,10540,101.6
31042, 동안구,040001, 35세,2021,4128,2110,2018,104.6,4054,2077,1977,105.1
31042, 동안구,040002, 36세,2021,3991,2032,1959,103.7,3924,2000,1924,104
31042, 동안구,040003, 37세,2021,4204,2097,2107,99.5,4128,2065,2063,100.1
31042, 동안구,040004, 38세,2021,4434,2199,2235,98.4,4378,2173,2205,98.5
31042, 동안구,040005, 39세,2021,4820,2416,2404,100.5,4762,2391,2371,100.8
31042, 동안구,045,40~44세,2021,23380,11177,12203,91.6,23153,11085,12068,91.9
31042, 동안구,045001, 40세,2021,4754,2363,2391,98.8,4710,2349,2361,99.5
31042, 동안구,045002, 41세,2021,4850,2307,2543,90.7,4802,2285,2517,90.8
31042, 동안구,045003, 42세,2021,4684,2255,2429,92.8,4647,2240,2407,93.1
31042, 동안구,045004, 43세,2021,4443,2071,2372,87.3,4390,2050,2340,87.6
31042, 동안구,045005, 44세,2021,4649,2181,2468,88.4,4604,2161,2443,88.5
31042, 동안구,050,45~49세,2021,26533,12583,13950,90.2,26297,12466,13831,90.1
31042, 동안구,050001, 45세,2021,4706,2213,2493,88.8,4671,2194,2477,88.6
31042, 동안구,050002, 46세,2021,5086,2370,2716,87.3,5045,2350,2695,87.2
31042, 동안구,050003, 47세,2021,5569,2670,2899,92.1,5521,2646,2875,92
31042, 동안구,050004, 48세,2021,5524,2566,2958,86.7,5475,2543,2932,86.7
31042, 동안구,050005, 49세,2021,5648,2764,2884,95.8,5585,2733,2852,95.8
31042, 동안구,055,50~54세,2021,28118,13553,14565,93.1,27893,13444,14449,93
31042, 동안구,055001, 50세,2021,6043,2911,3132,92.9,6008,2894,3114,92.9
31042, 동안구,055002, 51세,2021,5734,2787,2947,94.6,5694,2763,2931,94.3
31042, 동안구,055003, 52세,2021,5761,2807,2954,95,5703,2782,2921,95.2
31042, 동안구,055004, 53세,2021,5609,2693,2916,92.4,5560,2665,2895,92.1
31042, 동안구,055005, 54세,2021,4971,2355,2616,90,4928,2340,2588,90.4
31042, 동안구,060,55~59세,2021,24039,11597,12442,93.2,23849,11505,12344,93.2
31042, 동안구,060001, 55세,2021,4766,2355,2411,97.7,4726,2337,2389,97.8
31042, 동안구,060002, 56세,2021,4914,2355,2559,92,4871,2333,2538,91.9
31042, 동안구,060003, 57세,2021,4631,2257,2374,95.1,4601,2240,2361,94.9
31042, 동안구,060004, 58세,2021,4792,2312,2480,93.2,4745,2292,2453,93.4
31042, 동안구,060005, 59세,2021,4936,2318,2618,88.5,4906,2303,2603,88.5
31042, 동안구,065,60~64세,2021,23157,11233,11924,94.2,23022,11176,11846,94.3
31042, 동안구,065001, 60세,2021,5253,2469,2784,88.7,5228,2461,2767,88.9
31042, 동안구,065002, 61세,2021,5269,2526,2743,92.1,5240,2510,2730,91.9
31042, 동안구,065003, 62세,2021,4542,2239,2303,97.2,4513,2225,2288,97.2
31042, 동안구,065004, 63세,2021,4179,2075,2104,98.6,4151,2064,2087,98.9
31042, 동안구,065005, 64세,2021,3914,1924,1990,96.7,3890,1916,1974,97.1
31042, 동안구,070,65~69세,2021,14876,7399,7477,99,14792,7361,7431,99.1
31042, 동안구,070001, 65세,2021,3501,1715,1786,96,3480,1707,1773,96.3
31042, 동안구,070002, 66세,2021,3638,1812,1826,99.2,3620,1805,1815,99.4
31042, 동안구,070003, 67세,2021,2780,1396,1384,100.9,2760,1384,1376,100.6
31042, 동안구,070004, 68세,2021,2449,1246,1203,103.6,2433,1239,1194,103.8
31042, 동안구,070005, 69세,2021,2508,1230,1278,96.2,2499,1226,1273,96.3
31042, 동안구,075,70~74세,2021,8811,4162,4649,89.5,8764,4141,4623,89.6
31042, 동안구,075001, 70세,2021,1715,835,880,94.9,1703,829,874,94.9
31042, 동안구,075002, 71세,2021,1929,944,985,95.8,1919,940,979,96
31042, 동안구,075003, 72세,2021,1745,832,913,91.1,1731,827,904,91.5
31042, 동안구,075004, 73세,2021,1727,773,954,81,1722,771,951,81.1
31042, 동안구,075005, 74세,2021,1695,778,917,84.8,1689,774,915,84.6
31042, 동안구,080,75~79세,2021,6221,2656,3565,74.5,6202,2655,3547,74.9
31042, 동안구,080001, 75세,2021,1282,590,692,85.3,1278,590,688,85.8
31042, 동안구,080002, 76세,2021,1241,558,683,81.7,1235,557,678,82.2
31042, 동안구,080003, 77세,2021,1217,495,722,68.6,1216,495,721,68.7
31042, 동안구,080004, 78세,2021,1153,492,661,74.4,1151,492,659,74.7
31042, 동안구,080005, 79세,2021,1328,521,807,64.6,1322,521,801,65
31042, 동안구,085,80~84세,2021,4512,1673,2839,58.9,4492,1665,2827,58.9
31042, 동안구,085001, 80세,2021,1068,422,646,65.3,1064,420,644,65.2
31042, 동안구,085002, 81세,2021,946,362,584,62,944,362,582,62.2
31042, 동안구,085003, 82세,2021,942,357,585,61,937,354,583,60.7
31042, 동안구,085004, 83세,2021,825,295,530,55.7,822,294,528,55.7
31042, 동안구,085005, 84세,2021,731,237,494,48,725,235,490,48
31042, 동안구,090,85~89세,2021,2478,702,1776,39.5,2475,701,1774,39.5
31042, 동안구,090001, 85세,2021,655,195,460,42.4,655,195,460,42.4
31042, 동안구,090002, 86세,2021,617,185,432,42.8,616,185,431,42.9
31042, 동안구,090003, 87세,2021,470,130,340,38.2,470,130,340,38.2
31042, 동안구,090004, 88세,2021,406,104,302,34.4,405,103,302,34.1
31042, 동안구,090005, 89세,2021,330,88,242,36.4,329,88,241,36.5
31042, 동안구,095,90~94세,2021,895,225,670,33.6,893,225,668,33.7
31042, 동안구,095001, 90세,2021,262,57,205,27.8,262,57,205,27.8
31042, 동안구,095002, 91세,2021,238,71,167,42.5,237,71,166,42.8
31042, 동안구,095003, 92세,2021,160,40,120,33.3,160,40,120,33.3
31042, 동안구,095004, 93세,2021,134,31,103,30.1,133,31,102,30.4
31042, 동안구,095005, 94세,2021,101,26,75,34.7,101,26,75,34.7
31042, 동안구,100,95~99세,2021,174,35,139,25.2,173,34,139,24.5
31042, 동안구,100001, 95세,2021,61,14,47,29.8,61,14,47,29.8
31042, 동안구,100002, 96세,2021,50,6,44,13.6,50,6,44,13.6
31042, 동안구,100003, 97세,2021,21,6,15,40,20,5,15,33.3
31042, 동안구,100004, 98세,2021,30,6,24,25,30,6,24,25
31042, 동안구,100005, 99세,2021,12,X,9,33.3,12,X,9,33.3
31042, 동안구,101,100세이상,2021,12,X,11,9.1,12,X,11,9.1
31042, 동안구,102,15세미만,2021,38118,19587,18531,105.7,37978,19514,18464,105.7
31042, 동안구,103,15~64세,2021,222331,109649,112682,97.3,220242,108775,111467,97.6
31042, 동안구,104,65세이상,2021,37979,16853,21126,79.8,37803,16783,21020,79.8
31042, 동안구,086,85세이상,2021,3559,963,2596,37.1,3553,961,2592,37.1
31042, 동안구,126,평균연령,2021,41.7,40.7,42.6,,41.7,40.7,42.6,
31042, 동안구,127,중위연령,2021,42.9,41.7,44.1,,43,41.7,44.2,
31050, 부천시,000,합계,2021,822635,406604,416031,97.7,782913,386819,396094,97.7
31050, 부천시,005,0~4세,2021,23795,12322,11473,107.4,22332,11544,10788,107
31050, 부천시,005001, 0세,2021,4153,2128,2025,105.1,3937,2014,1923,104.7
31050, 부천시,005002, 1세,2021,4478,2333,2145,108.8,4186,2184,2002,109.1
31050, 부천시,005003, 2세,2021,4738,2447,2291,106.8,4405,2274,2131,106.7
31050, 부천시,005004, 3세,2021,5039,2603,2436,106.9,4722,2429,2293,105.9
31050, 부천시,005005, 4세,2021,5387,2811,2576,109.1,5082,2643,2439,108.4
31050, 부천시,010,5~9세,2021,31156,15943,15213,104.8,30115,15424,14691,105
31050, 부천시,010001, 5세,2021,6025,3094,2931,105.6,5713,2933,2780,105.5
31050, 부천시,010002, 6세,2021,6096,3143,2953,106.4,5882,3037,2845,106.7
31050, 부천시,010003, 7세,2021,6243,3131,3112,100.6,6054,3048,3006,101.4
31050, 부천시,010004, 8세,2021,6118,3131,2987,104.8,5943,3038,2905,104.6
31050, 부천시,010005, 9세,2021,6674,3444,3230,106.6,6523,3368,3155,106.8
31050, 부천시,015,10~14세,2021,32713,16719,15994,104.5,32172,16454,15718,104.7
31050, 부천시,015001, 10세,2021,6553,3316,3237,102.4,6416,3244,3172,102.3
31050, 부천시,015002, 11세,2021,6434,3280,3154,104,6323,3226,3097,104.2
31050, 부천시,015003, 12세,2021,6173,3175,2998,105.9,6072,3129,2943,106.3
31050, 부천시,015004, 13세,2021,6550,3358,3192,105.2,6449,3309,3140,105.4
31050, 부천시,015005, 14세,2021,7003,3590,3413,105.2,6912,3546,3366,105.3
31050, 부천시,020,15~19세,2021,33918,17242,16676,103.4,33498,17039,16459,103.5
31050, 부천시,020001, 15세,2021,6422,3295,3127,105.4,6335,3251,3084,105.4
31050, 부천시,020002, 16세,2021,6231,3157,3074,102.7,6164,3118,3046,102.4
31050, 부천시,020003, 17세,2021,6796,3399,3397,100.1,6728,3364,3364,100
31050, 부천시,020004, 18세,2021,7124,3667,3457,106.1,7060,3640,3420,106.4
31050, 부천시,020005, 19세,2021,7345,3724,3621,102.8,7211,3666,3545,103.4
31050, 부천시,025,20~24세,2021,49648,25307,24341,104,48355,24712,23643,104.5
31050, 부천시,025001, 20세,2021,8696,4516,4180,108,8477,4410,4067,108.4
31050, 부천시,025002, 21세,2021,9548,4974,4574,108.7,9325,4873,4452,109.5
31050, 부천시,025003, 22세,2021,9627,4980,4647,107.2,9371,4873,4498,108.3
31050, 부천시,025004, 23세,2021,10480,5223,5257,99.4,10208,5095,5113,99.6
31050, 부천시,025005, 24세,2021,11297,5614,5683,98.8,10974,5461,5513,99.1
31050, 부천시,030,25~29세,2021,62487,32359,30128,107.4,59966,31175,28791,108.3
31050, 부천시,030001, 25세,2021,11952,6133,5819,105.4,11584,5969,5615,106.3
31050, 부천시,030002, 26세,2021,12176,6318,5858,107.9,11736,6124,5612,109.1
31050, 부천시,030003, 27세,2021,12582,6571,6011,109.3,12102,6339,5763,110
31050, 부천시,030004, 28세,2021,12717,6585,6132,107.4,12169,6327,5842,108.3
31050, 부천시,030005, 29세,2021,13060,6752,6308,107,12375,6416,5959,107.7
31050, 부천시,035,30~34세,2021,58193,29902,28291,105.7,53086,27338,25748,106.2
31050, 부천시,035001, 30세,2021,12270,6248,6022,103.8,11480,5868,5612,104.6
31050, 부천시,035002, 31세,2021,11575,5926,5649,104.9,10610,5441,5169,105.3
31050, 부천시,035003, 32세,2021,11555,5978,5577,107.2,10533,5443,5090,106.9
31050, 부천시,035004, 33세,2021,11558,5993,5565,107.7,10436,5448,4988,109.2
31050, 부천시,035005, 34세,2021,11235,5757,5478,105.1,10027,5138,4889,105.1
31050, 부천시,040,35~39세,2021,60157,31264,28893,108.2,55340,28690,26650,107.7
31050, 부천시,040001, 35세,2021,11144,5773,5371,107.5,10083,5206,4877,106.7
31050, 부천시,040002, 36세,2021,11493,5948,5545,107.3,10465,5424,5041,107.6
31050, 부천시,040003, 37세,2021,11444,5946,5498,108.1,10528,5443,5085,107
31050, 부천시,040004, 38세,2021,12598,6590,6008,109.7,11643,6084,5559,109.4
31050, 부천시,040005, 39세,2021,13478,7007,6471,108.3,12621,6533,6088,107.3
31050, 부천시,045,40~44세,2021,62011,31653,30358,104.3,58938,29901,29037,103
31050, 부천시,045001, 40세,2021,13155,6779,6376,106.3,12471,6409,6062,105.7
31050, 부천시,045002, 41세,2021,13316,6720,6596,101.9,12705,6381,6324,100.9
31050, 부천시,045003, 42세,2021,12520,6416,6104,105.1,11882,6050,5832,103.7
31050, 부천시,045004, 43세,2021,11353,5840,5513,105.9,10739,5481,5258,104.2
31050, 부천시,045005, 44세,2021,11667,5898,5769,102.2,11141,5580,5561,100.3
31050, 부천시,050,45~49세,2021,64608,32374,32234,100.4,61676,30814,30862,99.8
31050, 부천시,050001, 45세,2021,11455,5792,5663,102.3,10905,5493,5412,101.5
31050, 부천시,050002, 46세,2021,11999,5905,6094,96.9,11513,5651,5862,96.4
31050, 부천시,050003, 47세,2021,13460,6791,6669,101.8,12904,6495,6409,101.3
31050, 부천시,050004, 48세,2021,13764,6909,6855,100.8,13116,6571,6545,100.4
31050, 부천시,050005, 49세,2021,13930,6977,6953,100.3,13238,6604,6634,99.5
31050, 부천시,055,50~54세,2021,74456,35780,38676,92.5,70767,33937,36830,92.1
31050, 부천시,055001, 50세,2021,15287,7501,7786,96.3,14588,7154,7434,96.2
31050, 부천시,055002, 51세,2021,14741,7095,7646,92.8,13975,6716,7259,92.5
31050, 부천시,055003, 52세,2021,15134,7320,7814,93.7,14370,6905,7465,92.5
31050, 부천시,055004, 53세,2021,15352,7293,8059,90.5,14546,6902,7644,90.3
31050, 부천시,055005, 54세,2021,13942,6571,7371,89.1,13288,6260,7028,89.1
31050, 부천시,060,55~59세,2021,74480,36047,38433,93.8,69721,33753,35968,93.8
31050, 부천시,060001, 55세,2021,14072,6757,7315,92.4,13300,6386,6914,92.4
31050, 부천시,060002, 56세,2021,15311,7293,8018,91,14375,6851,7524,91.1
31050, 부천시,060003, 57세,2021,14344,6910,7434,93,13428,6452,6976,92.5
31050, 부천시,060004, 58세,2021,15195,7461,7734,96.5,14011,6889,7122,96.7
31050, 부천시,060005, 59세,2021,15558,7626,7932,96.1,14607,7175,7432,96.5
31050, 부천시,065,60~64세,2021,73841,36150,37691,95.9,69997,34257,35740,95.9
31050, 부천시,065001, 60세,2021,16350,7939,8411,94.4,15785,7658,8127,94.2
31050, 부천시,065002, 61세,2021,16613,8074,8539,94.6,15679,7605,8074,94.2
31050, 부천시,065003, 62세,2021,14572,7142,7430,96.1,13807,6779,7028,96.5
31050, 부천시,065004, 63세,2021,13349,6599,6750,97.8,12559,6214,6345,97.9
31050, 부천시,065005, 64세,2021,12957,6396,6561,97.5,12167,6001,6166,97.3
31050, 부천시,070,65~69세,2021,47803,23278,24525,94.9,45199,22069,23130,95.4
31050, 부천시,070001, 65세,2021,11384,5533,5851,94.6,10722,5236,5486,95.4
31050, 부천시,070002, 66세,2021,11357,5554,5803,95.7,10729,5260,5469,96.2
31050, 부천시,070003, 67세,2021,9125,4406,4719,93.4,8589,4159,4430,93.9
31050, 부천시,070004, 68세,2021,7747,3783,3964,95.4,7355,3602,3753,96
31050, 부천시,070005, 69세,2021,8190,4002,4188,95.6,7804,3812,3992,95.5
31050, 부천시,075,70~74세,2021,28596,13748,14848,92.6,27667,13362,14305,93.4
31050, 부천시,075001, 70세,2021,5649,2837,2812,100.9,5375,2703,2672,101.2
31050, 부천시,075002, 71세,2021,6124,2935,3189,92,5855,2827,3028,93.4
31050, 부천시,075003, 72세,2021,5835,2808,3027,92.8,5648,2740,2908,94.2
31050, 부천시,075004, 73세,2021,5601,2691,2910,92.5,5491,2647,2844,93.1
31050, 부천시,075005, 74세,2021,5387,2477,2910,85.1,5298,2445,2853,85.7
31050, 부천시,080,75~79세,2021,19606,8559,11047,77.5,19262,8459,10803,78.3
31050, 부천시,080001, 75세,2021,4005,1893,2112,89.6,3910,1869,2041,91.6
31050, 부천시,080002, 76세,2021,3736,1704,2032,83.9,3669,1672,1997,83.7
31050, 부천시,080003, 77세,2021,3808,1628,2180,74.7,3747,1612,2135,75.5
31050, 부천시,080004, 78세,2021,3705,1550,2155,71.9,3646,1534,2112,72.6
31050, 부천시,080005, 79세,2021,4352,1784,2568,69.5,4290,1772,2518,70.4
31050, 부천시,085,80~84세,2021,13887,5002,8885,56.3,13658,4952,8706,56.9
31050, 부천시,085001, 80세,2021,3271,1254,2017,62.2,3213,1241,1972,62.9
31050, 부천시,085002, 81세,2021,2971,1135,1836,61.8,2921,1125,1796,62.6
31050, 부천시,085003, 82세,2021,2926,1043,1883,55.4,2884,1036,1848,56.1
31050, 부천시,085004, 83세,2021,2512,852,1660,51.3,2461,842,1619,52
31050, 부천시,085005, 84세,2021,2207,718,1489,48.2,2179,708,1471,48.1
31050, 부천시,090,85~89세,2021,7688,2175,5513,39.5,7597,2160,5437,39.7
31050, 부천시,090001, 85세,2021,2010,616,1394,44.2,1981,609,1372,44.4
31050, 부천시,090002, 86세,2021,1941,543,1398,38.8,1912,541,1371,39.5
31050, 부천시,090003, 87세,2021,1439,430,1009,42.6,1423,427,996,42.9
31050, 부천시,090004, 88세,2021,1274,338,936,36.1,1263,335,928,36.1
31050, 부천시,090005, 89세,2021,1024,248,776,32,1018,248,770,32.2
31050, 부천시,095,90~94세,2021,2880,667,2213,30.1,2858,666,2192,30.4
31050, 부천시,095001, 90세,2021,798,201,597,33.7,792,201,591,34
31050, 부천시,095002, 91세,2021,721,175,546,32.1,712,174,538,32.3
31050, 부천시,095003, 92세,2021,603,132,471,28,601,132,469,28.1
31050, 부천시,095004, 93세,2021,439,90,349,25.8,438,90,348,25.9
31050, 부천시,095005, 94세,2021,319,69,250,27.6,315,69,246,28
31050, 부천시,100,95~99세,2021,608,97,511,19,605,97,508,19.1
31050, 부천시,100001, 95세,2021,187,29,158,18.4,186,29,157,18.5
31050, 부천시,100002, 96세,2021,145,19,126,15.1,145,19,126,15.1
31050, 부천시,100003, 97세,2021,96,14,82,17.1,94,14,80,17.5
31050, 부천시,100004, 98세,2021,116,20,96,20.8,116,20,96,20.8
31050, 부천시,100005, 99세,2021,64,15,49,30.6,64,15,49,30.6
31050, 부천시,101,100세이상,2021,104,16,88,18.2,104,16,88,18.2
31050, 부천시,102,15세미만,2021,87664,44984,42680,105.4,84619,43422,41197,105.4
31050, 부천시,103,15~64세,2021,613799,308078,305721,100.8,581344,291616,289728,100.7
31050, 부천시,104,65세이상,2021,121172,53542,67630,79.2,116950,51781,65169,79.5
31050, 부천시,086,85세이상,2021,11280,2955,8325,35.5,11164,2939,8225,35.7
31050, 부천시,126,평균연령,2021,43.5,42.5,44.5,,43.4,42.4,44.4,
31050, 부천시,127,중위연령,2021,44.8,43.4,46.2,,44.8,43.4,46.2,
31060, 광명시,000,합계,2021,290345,142943,147402,97,283852,139817,144035,97.1
31060, 광명시,005,0~4세,2021,9026,4587,4439,103.3,8906,4531,4375,103.6
31060, 광명시,005001, 0세,2021,1675,827,848,97.5,1662,823,839,98.1
31060, 광명시,005002, 1세,2021,1610,817,793,103,1603,812,791,102.7
31060, 광명시,005003, 2세,2021,1720,891,829,107.5,1687,874,813,107.5
31060, 광명시,005004, 3세,2021,1988,1020,968,105.4,1956,1006,950,105.9
31060, 광명시,005005, 4세,2021,2033,1032,1001,103.1,1998,1016,982,103.5
31060, 광명시,010,5~9세,2021,12929,6582,6347,103.7,12803,6520,6283,103.8
31060, 광명시,010001, 5세,2021,2423,1225,1198,102.3,2393,1210,1183,102.3
31060, 광명시,010002, 6세,2021,2499,1284,1215,105.7,2476,1271,1205,105.5
31060, 광명시,010003, 7세,2021,2560,1306,1254,104.1,2537,1298,1239,104.8
31060, 광명시,010004, 8세,2021,2590,1316,1274,103.3,2564,1302,1262,103.2
31060, 광명시,010005, 9세,2021,2857,1451,1406,103.2,2833,1439,1394,103.2
31060, 광명시,015,10~14세,2021,14267,7242,7025,103.1,14195,7208,6987,103.2
31060, 광명시,015001, 10세,2021,2820,1438,1382,104.1,2807,1430,1377,103.8
31060, 광명시,015002, 11세,2021,2762,1445,1317,109.7,2742,1436,1306,110
31060, 광명시,015003, 12세,2021,2695,1382,1313,105.3,2683,1376,1307,105.3
31060, 광명시,015004, 13세,2021,2961,1472,1489,98.9,2948,1464,1484,98.7
31060, 광명시,015005, 14세,2021,3029,1505,1524,98.8,3015,1502,1513,99.3
31060, 광명시,020,15~19세,2021,14261,7423,6838,108.6,14221,7403,6818,108.6
31060, 광명시,020001, 15세,2021,2863,1477,1386,106.6,2852,1472,1380,106.7
31060, 광명시,020002, 16세,2021,2770,1442,1328,108.6,2763,1440,1323,108.8
31060, 광명시,020003, 17세,2021,2957,1514,1443,104.9,2951,1510,1441,104.8
31060, 광명시,020004, 18세,2021,2926,1549,1377,112.5,2919,1546,1373,112.6
31060, 광명시,020005, 19세,2021,2745,1441,1304,110.5,2736,1435,1301,110.3
31060, 광명시,025,20~24세,2021,16756,8695,8061,107.9,16590,8627,7963,108.3
31060, 광명시,025001, 20세,2021,3144,1655,1489,111.1,3130,1650,1480,111.5
31060, 광명시,025002, 21세,2021,3473,1889,1584,119.3,3454,1885,1569,120.1
31060, 광명시,025003, 22세,2021,3262,1689,1573,107.4,3222,1671,1551,107.7
31060, 광명시,025004, 23세,2021,3349,1715,1634,105,3306,1696,1610,105.3
31060, 광명시,025005, 24세,2021,3528,1747,1781,98.1,3478,1725,1753,98.4
31060, 광명시,030,25~29세,2021,18399,9641,8758,110.1,18038,9469,8569,110.5
31060, 광명시,030001, 25세,2021,3503,1818,1685,107.9,3457,1800,1657,108.6
31060, 광명시,030002, 26세,2021,3571,1885,1686,111.8,3503,1852,1651,112.2
31060, 광명시,030003, 27세,2021,3764,1996,1768,112.9,3684,1956,1728,113.2
31060, 광명시,030004, 28세,2021,3606,1865,1741,107.1,3522,1825,1697,107.5
31060, 광명시,030005, 29세,2021,3955,2077,1878,110.6,3872,2036,1836,110.9
31060, 광명시,035,30~34세,2021,18873,9708,9165,105.9,18148,9376,8772,106.9
31060, 광명시,035001, 30세,2021,3925,2067,1858,111.2,3814,2023,1791,113
31060, 광명시,035002, 31세,2021,3775,1942,1833,105.9,3629,1867,1762,106
31060, 광명시,035003, 32세,2021,3723,1919,1804,106.4,3563,1851,1712,108.1
31060, 광명시,035004, 33세,2021,3704,1895,1809,104.8,3557,1826,1731,105.5
31060, 광명시,035005, 34세,2021,3746,1885,1861,101.3,3585,1809,1776,101.9
31060, 광명시,040,35~39세,2021,21178,10679,10499,101.7,20525,10354,10171,101.8
31060, 광명시,040001, 35세,2021,3940,2018,1922,105,3786,1946,1840,105.8
31060, 광명시,040002, 36세,2021,3768,1890,1878,100.6,3650,1830,1820,100.5
31060, 광명시,040003, 37세,2021,4042,2073,1969,105.3,3912,1996,1916,104.2
31060, 광명시,040004, 38세,2021,4384,2224,2160,103,4275,2168,2107,102.9
31060, 광명시,040005, 39세,2021,5044,2474,2570,96.3,4902,2414,2488,97
31060, 광명시,045,40~44세,2021,23789,11684,12105,96.5,23258,11415,11843,96.4
31060, 광명시,045001, 40세,2021,4905,2381,2524,94.3,4810,2332,2478,94.1
31060, 광명시,045002, 41세,2021,5016,2480,2536,97.8,4907,2425,2482,97.7
31060, 광명시,045003, 42세,2021,4800,2384,2416,98.7,4678,2327,2351,99
31060, 광명시,045004, 43세,2021,4415,2189,2226,98.3,4307,2128,2179,97.7
31060, 광명시,045005, 44세,2021,4653,2250,2403,93.6,4556,2203,2353,93.6
31060, 광명시,050,45~49세,2021,25633,12719,12914,98.5,25105,12439,12666,98.2
31060, 광명시,050001, 45세,2021,4605,2296,2309,99.4,4520,2249,2271,99
31060, 광명시,050002, 46세,2021,4941,2401,2540,94.5,4844,2352,2492,94.4
31060, 광명시,050003, 47세,2021,5296,2663,2633,101.1,5208,2620,2588,101.2
31060, 광명시,050004, 48세,2021,5473,2743,2730,100.5,5350,2676,2674,100.1
31060, 광명시,050005, 49세,2021,5318,2616,2702,96.8,5183,2542,2641,96.3
31060, 광명시,055,50~54세,2021,26242,12882,13360,96.4,25476,12517,12959,96.6
31060, 광명시,055001, 50세,2021,5594,2763,2831,97.6,5441,2689,2752,97.7
31060, 광명시,055002, 51세,2021,5203,2555,2648,96.5,5048,2479,2569,96.5
31060, 광명시,055003, 52세,2021,5406,2716,2690,101,5266,2648,2618,101.1
31060, 광명시,055004, 53세,2021,5293,2576,2717,94.8,5107,2483,2624,94.6
31060, 광명시,055005, 54세,2021,4746,2272,2474,91.8,4614,2218,2396,92.6
31060, 광명시,060,55~59세,2021,23043,11536,11507,100.3,22154,11082,11072,100.1
31060, 광명시,060001, 55세,2021,4576,2339,2237,104.6,4431,2269,2162,104.9
31060, 광명시,060002, 56세,2021,4865,2431,2434,99.9,4695,2337,2358,99.1
31060, 광명시,060003, 57세,2021,4390,2212,2178,101.6,4214,2128,2086,102
31060, 광명시,060004, 58세,2021,4638,2286,2352,97.2,4401,2166,2235,96.9
31060, 광명시,060005, 59세,2021,4574,2268,2306,98.4,4413,2182,2231,97.8
31060, 광명시,065,60~64세,2021,23207,10998,12209,90.1,22474,10646,11828,90
31060, 광명시,065001, 60세,2021,5145,2484,2661,93.3,5044,2434,2610,93.3
31060, 광명시,065002, 61세,2021,4954,2328,2626,88.7,4779,2245,2534,88.6
31060, 광명시,065003, 62세,2021,4631,2143,2488,86.1,4466,2071,2395,86.5
31060, 광명시,065004, 63세,2021,4290,2075,2215,93.7,4148,2004,2144,93.5
31060, 광명시,065005, 64세,2021,4187,1968,2219,88.7,4037,1892,2145,88.2
31060, 광명시,070,65~69세,2021,16423,7849,8574,91.5,15932,7622,8310,91.7
31060, 광명시,070001, 65세,2021,3831,1814,2017,89.9,3711,1752,1959,89.4
31060, 광명시,070002, 66세,2021,3800,1857,1943,95.6,3670,1800,1870,96.3
31060, 광명시,070003, 67세,2021,3228,1545,1683,91.8,3139,1506,1633,92.2
31060, 광명시,070004, 68세,2021,2687,1262,1425,88.6,2612,1226,1386,88.5
31060, 광명시,070005, 69세,2021,2877,1371,1506,91,2800,1338,1462,91.5
31060, 광명시,075,70~74세,2021,10331,4875,5456,89.4,10152,4794,5358,89.5
31060, 광명시,075001, 70세,2021,1995,942,1053,89.5,1936,914,1022,89.4
31060, 광명시,075002, 71세,2021,2172,1026,1146,89.5,2136,1012,1124,90
31060, 광명시,075003, 72세,2021,2101,982,1119,87.8,2057,961,1096,87.7
31060, 광명시,075004, 73세,2021,1985,954,1031,92.5,1966,946,1020,92.7
31060, 광명시,075005, 74세,2021,2078,971,1107,87.7,2057,961,1096,87.7
31060, 광명시,080,75~79세,2021,7276,3075,4201,73.2,7217,3057,4160,73.5
31060, 광명시,080001, 75세,2021,1434,624,810,77,1413,617,796,77.5
31060, 광명시,080002, 76세,2021,1435,631,804,78.5,1420,627,793,79.1
31060, 광명시,080003, 77세,2021,1368,583,785,74.3,1358,579,779,74.3
31060, 광명시,080004, 78세,2021,1414,597,817,73.1,1405,595,810,73.5
31060, 광명시,080005, 79세,2021,1625,640,985,65,1621,639,982,65.1
31060, 광명시,085,80~84세,2021,5005,1826,3179,57.4,4971,1818,3153,57.7
31060, 광명시,085001, 80세,2021,1242,466,776,60.1,1233,463,770,60.1
31060, 광명시,085002, 81세,2021,1074,411,663,62,1061,409,652,62.7
31060, 광명시,085003, 82세,2021,1062,396,666,59.5,1059,396,663,59.7
31060, 광명시,085004, 83세,2021,878,303,575,52.7,872,301,571,52.7
31060, 광명시,085005, 84세,2021,749,250,499,50.1,746,249,497,50.1
31060, 광명시,090,85~89세,2021,2639,728,1911,38.1,2622,725,1897,38.2
31060, 광명시,090001, 85세,2021,717,223,494,45.1,707,220,487,45.2
31060, 광명시,090002, 86세,2021,634,175,459,38.1,633,175,458,38.2
31060, 광명시,090003, 87세,2021,517,134,383,35,512,134,378,35.4
31060, 광명시,090004, 88세,2021,410,99,311,31.8,409,99,310,31.9
31060, 광명시,090005, 89세,2021,361,97,264,36.7,361,97,264,36.7
31060, 광명시,095,90~94세,2021,852,170,682,24.9,851,170,681,25
31060, 광명시,095001, 90세,2021,241,49,192,25.5,240,49,191,25.7
31060, 광명시,095002, 91세,2021,232,41,191,21.5,232,41,191,21.5
31060, 광명시,095003, 92세,2021,167,37,130,28.5,167,37,130,28.5
31060, 광명시,095004, 93세,2021,123,22,101,21.8,123,22,101,21.8
31060, 광명시,095005, 94세,2021,89,21,68,30.9,89,21,68,30.9
31060, 광명시,100,95~99세,2021,185,37,148,25,183,37,146,25.3
31060, 광명시,100001, 95세,2021,74,13,61,21.3,74,13,61,21.3
31060, 광명시,100002, 96세,2021,47,10,37,27,47,10,37,27
31060, 광명시,100003, 97세,2021,26,X,23,13,25,X,22,13.6
31060, 광명시,100004, 98세,2021,26,8,18,44.4,26,8,18,44.4
31060, 광명시,100005, 99세,2021,12,X,9,33.3,11,X,8,37.5
31060, 광명시,101,100세이상,2021,31,7,24,29.2,31,7,24,29.2
31060, 광명시,102,15세미만,2021,36222,18411,17811,103.4,35904,18259,17645,103.5
31060, 광명시,103,15~64세,2021,211381,105965,105416,100.5,205989,103328,102661,100.6
31060, 광명시,104,65세이상,2021,42742,18567,24175,76.8,41959,18230,23729,76.8
31060, 광명시,086,85세이상,2021,3707,942,2765,34.1,3687,939,2748,34.2
31060, 광명시,126,평균연령,2021,42.6,41.6,43.7,,42.5,41.4,43.6,
31060, 광명시,127,중위연령,2021,44.1,42.9,45.2,,44,42.7,45.1,
31070, 평택시,000,합계,2021,571838,299252,272586,109.8,538412,280448,257964,108.7
31070, 평택시,005,0~4세,2021,22589,11383,11206,101.6,21517,10838,10679,101.5
31070, 평택시,005001, 0세,2021,4066,2034,2032,100.1,3864,1930,1934,99.8
31070, 평택시,005002, 1세,2021,4233,2081,2152,96.7,4045,1980,2065,95.9
31070, 평택시,005003, 2세,2021,4473,2267,2206,102.8,4257,2161,2096,103.1
31070, 평택시,005004, 3세,2021,4723,2448,2275,107.6,4499,2327,2172,107.1
31070, 평택시,005005, 4세,2021,5094,2553,2541,100.5,4852,2440,2412,101.2
31070, 평택시,010,5~9세,2021,28415,14509,13906,104.3,27488,14071,13417,104.9
31070, 평택시,010001, 5세,2021,5586,2830,2756,102.7,5341,2718,2623,103.6
31070, 평택시,010002, 6세,2021,5829,3059,2770,110.4,5603,2937,2666,110.2
31070, 평택시,010003, 7세,2021,5534,2799,2735,102.3,5366,2725,2641,103.2
31070, 평택시,010004, 8세,2021,5514,2750,2764,99.5,5360,2679,2681,99.9
31070, 평택시,010005, 9세,2021,5952,3071,2881,106.6,5818,3012,2806,107.3
31070, 평택시,015,10~14세,2021,27807,14276,13531,105.5,27336,14015,13321,105.2
31070, 평택시,015001, 10세,2021,5774,2920,2854,102.3,5670,2862,2808,101.9
31070, 평택시,015002, 11세,2021,5612,2935,2677,109.6,5509,2881,2628,109.6
31070, 평택시,015003, 12세,2021,5418,2780,2638,105.4,5315,2720,2595,104.8
31070, 평택시,015004, 13세,2021,5513,2817,2696,104.5,5426,2769,2657,104.2
31070, 평택시,015005, 14세,2021,5490,2824,2666,105.9,5416,2783,2633,105.7
31070, 평택시,020,15~19세,2021,25162,13093,12069,108.5,24819,12911,11908,108.4
31070, 평택시,020001, 15세,2021,5051,2571,2480,103.7,4988,2531,2457,103
31070, 평택시,020002, 16세,2021,4797,2461,2336,105.4,4744,2440,2304,105.9
31070, 평택시,020003, 17세,2021,5047,2625,2422,108.4,4987,2595,2392,108.5
31070, 평택시,020004, 18세,2021,5202,2712,2490,108.9,5134,2673,2461,108.6
31070, 평택시,020005, 19세,2021,5065,2724,2341,116.4,4966,2672,2294,116.5
31070, 평택시,025,20~24세,2021,34367,18662,15705,118.8,32118,17396,14722,118.2
31070, 평택시,025001, 20세,2021,5948,3235,2713,119.2,5736,3129,2607,120
31070, 평택시,025002, 21세,2021,6858,3756,3102,121.1,6471,3589,2882,124.5
31070, 평택시,025003, 22세,2021,6671,3604,3067,117.5,6167,3328,2839,117.2
31070, 평택시,025004, 23세,2021,7216,3865,3351,115.3,6658,3537,3121,113.3
31070, 평택시,025005, 24세,2021,7674,4202,3472,121,7086,3813,3273,116.5
31070, 평택시,030,25~29세,2021,45159,25754,19405,132.7,41365,23414,17951,130.4
31070, 평택시,030001, 25세,2021,8225,4514,3711,121.6,7571,4111,3460,118.8
31070, 평택시,030002, 26세,2021,8841,5015,3826,131.1,8124,4561,3563,128
31070, 평택시,030003, 27세,2021,8930,5147,3783,136.1,8213,4714,3499,134.7
31070, 평택시,030004, 28세,2021,9487,5461,4026,135.6,8677,4967,3710,133.9
31070, 평택시,030005, 29세,2021,9676,5617,4059,138.4,8780,5061,3719,136.1
31070, 평택시,035,30~34세,2021,44839,25427,19412,131,39565,22298,17267,129.1
31070, 평택시,035001, 30세,2021,9442,5387,4055,132.8,8497,4832,3665,131.8
31070, 평택시,035002, 31세,2021,9073,5223,3850,135.7,8038,4597,3441,133.6
31070, 평택시,035003, 32세,2021,8786,5012,3774,132.8,7698,4373,3325,131.5
31070, 평택시,035004, 33세,2021,8584,4823,3761,128.2,7509,4184,3325,125.8
31070, 평택시,035005, 34세,2021,8954,4982,3972,125.4,7823,4312,3511,122.8
31070, 평택시,040,35~39세,2021,47779,26196,21583,121.4,42921,23254,19667,118.2
31070, 평택시,040001, 35세,2021,8859,4981,3878,128.4,7794,4326,3468,124.7
31070, 평택시,040002, 36세,2021,9102,4999,4103,121.8,8084,4380,3704,118.3
31070, 평택시,040003, 37세,2021,9056,4964,4092,121.3,8125,4378,3747,116.8
31070, 평택시,040004, 38세,2021,9945,5368,4577,117.3,9033,4825,4208,114.7
31070, 평택시,040005, 39세,2021,10817,5884,4933,119.3,9885,5345,4540,117.7
31070, 평택시,045,40~44세,2021,50149,27403,22746,120.5,46737,25305,21432,118.1
31070, 평택시,045001, 40세,2021,10702,5935,4767,124.5,9903,5432,4471,121.5
31070, 평택시,045002, 41세,2021,10779,5879,4900,120,10058,5433,4625,117.5
31070, 평택시,045003, 42세,2021,10132,5477,4655,117.7,9380,5027,4353,115.5
31070, 평택시,045004, 43세,2021,9355,5129,4226,121.4,8744,4742,4002,118.5
31070, 평택시,045005, 44세,2021,9181,4983,4198,118.7,8652,4671,3981,117.3
31070, 평택시,050,45~49세,2021,48747,25926,22821,113.6,46139,24434,21705,112.6
31070, 평택시,050001, 45세,2021,9009,4813,4196,114.7,8481,4504,3977,113.3
31070, 평택시,050002, 46세,2021,9478,5005,4473,111.9,8988,4711,4277,110.1
31070, 평택시,050003, 47세,2021,10049,5424,4625,117.3,9555,5127,4428,115.8
31070, 평택시,050004, 48세,2021,10093,5196,4897,106.1,9544,4899,4645,105.5
31070, 평택시,050005, 49세,2021,10118,5488,4630,118.5,9571,5193,4378,118.6
31070, 평택시,055,50~54세,2021,49769,25985,23784,109.3,47232,24639,22593,109.1
31070, 평택시,055001, 50세,2021,10582,5630,4952,113.7,10013,5323,4690,113.5
31070, 평택시,055002, 51세,2021,10162,5379,4783,112.5,9580,5050,4530,111.5
31070, 평택시,055003, 52세,2021,10286,5277,5009,105.4,9787,5030,4757,105.7
31070, 평택시,055004, 53세,2021,9907,5142,4765,107.9,9395,4886,4509,108.4
31070, 평택시,055005, 54세,2021,8832,4557,4275,106.6,8457,4350,4107,105.9
31070, 평택시,060,55~59세,2021,41945,22173,19772,112.1,39531,20958,18573,112.8
31070, 평택시,060001, 55세,2021,8616,4610,4006,115.1,8150,4373,3777,115.8
31070, 평택시,060002, 56세,2021,8972,4667,4305,108.4,8445,4390,4055,108.3
31070, 평택시,060003, 57세,2021,8060,4245,3815,111.3,7579,4010,3569,112.4
31070, 평택시,060004, 58세,2021,8338,4457,3881,114.8,7789,4191,3598,116.5
31070, 평택시,060005, 59세,2021,7959,4194,3765,111.4,7568,3994,3574,111.8
31070, 평택시,065,60~64세,2021,36494,18646,17848,104.5,34831,17899,16932,105.7
31070, 평택시,065001, 60세,2021,8654,4510,4144,108.8,8387,4398,3989,110.3
31070, 평택시,065002, 61세,2021,8120,4114,4006,102.7,7735,3924,3811,103
31070, 평택시,065003, 62세,2021,7225,3680,3545,103.8,6884,3540,3344,105.9
31070, 평택시,065004, 63세,2021,6566,3300,3266,101,6219,3143,3076,102.2
31070, 평택시,065005, 64세,2021,5929,3042,2887,105.4,5606,2894,2712,106.7
31070, 평택시,070,65~69세,2021,23903,11678,12225,95.5,22877,11195,11682,95.8
31070, 평택시,070001, 65세,2021,5630,2837,2793,101.6,5354,2708,2646,102.3
31070, 평택시,070002, 66세,2021,5513,2696,2817,95.7,5264,2583,2681,96.3
31070, 평택시,070003, 67세,2021,4553,2184,2369,92.2,4350,2094,2256,92.8
31070, 평택시,070004, 68세,2021,3917,1890,2027,93.2,3750,1804,1946,92.7
31070, 평택시,070005, 69세,2021,4290,2071,2219,93.3,4159,2006,2153,93.2
31070, 평택시,075,70~74세,2021,15868,7284,8584,84.9,15440,7103,8337,85.2
31070, 평택시,075001, 70세,2021,2950,1354,1596,84.8,2838,1305,1533,85.1
31070, 평택시,075002, 71세,2021,3274,1513,1761,85.9,3194,1479,1715,86.2
31070, 평택시,075003, 72세,2021,3218,1484,1734,85.6,3133,1443,1690,85.4
31070, 평택시,075004, 73세,2021,3189,1431,1758,81.4,3112,1402,1710,82
31070, 평택시,075005, 74세,2021,3237,1502,1735,86.6,3163,1474,1689,87.3
31070, 평택시,080,75~79세,2021,12428,5236,7192,72.8,12268,5159,7109,72.6
31070, 평택시,080001, 75세,2021,2428,1111,1317,84.4,2382,1087,1295,83.9
31070, 평택시,080002, 76세,2021,2383,1017,1366,74.5,2350,1001,1349,74.2
31070, 평택시,080003, 77세,2021,2406,977,1429,68.4,2377,962,1415,68
31070, 평택시,080004, 78세,2021,2399,983,1416,69.4,2368,969,1399,69.3
31070, 평택시,080005, 79세,2021,2812,1148,1664,69,2791,1140,1651,69
31070, 평택시,085,80~84세,2021,9573,3624,5949,60.9,9455,3584,5871,61
31070, 평택시,085001, 80세,2021,2262,919,1343,68.4,2226,907,1319,68.8
31070, 평택시,085002, 81세,2021,1980,801,1179,67.9,1958,794,1164,68.2
31070, 평택시,085003, 82세,2021,1942,707,1235,57.2,1920,698,1222,57.1
31070, 평택시,085004, 83세,2021,1790,626,1164,53.8,1767,618,1149,53.8
31070, 평택시,085005, 84세,2021,1599,571,1028,55.5,1584,567,1017,55.8
31070, 평택시,090,85~89세,2021,4918,1545,3373,45.8,4867,1528,3339,45.8
31070, 평택시,090001, 85세,2021,1386,482,904,53.3,1371,477,894,53.4
31070, 평택시,090002, 86세,2021,1195,373,822,45.4,1180,370,810,45.7
31070, 평택시,090003, 87세,2021,981,309,672,46,971,308,663,46.5
31070, 평택시,090004, 88세,2021,751,223,528,42.2,742,216,526,41.1
31070, 평택시,090005, 89세,2021,605,158,447,35.3,603,157,446,35.2
31070, 평택시,095,90~94세,2021,1546,364,1182,30.8,1528,359,1169,30.7
31070, 평택시,095001, 90세,2021,435,99,336,29.5,430,97,333,29.1
31070, 평택시,095002, 91세,2021,395,95,300,31.7,391,95,296,32.1
31070, 평택시,095003, 92세,2021,317,74,243,30.5,310,73,237,30.8
31070, 평택시,095004, 93세,2021,237,54,183,29.5,235,52,183,28.4
31070, 평택시,095005, 94세,2021,162,42,120,35,162,42,120,35
31070, 평택시,100,95~99세,2021,335,79,256,30.9,332,79,253,31.2
31070, 평택시,100001, 95세,2021,106,26,80,32.5,105,26,79,32.9
31070, 평택시,100002, 96세,2021,87,12,75,16,87,12,75,16
31070, 평택시,100003, 97세,2021,59,16,43,37.2,59,16,43,37.2
31070, 평택시,100004, 98세,2021,56,18,38,47.4,55,18,37,48.6
31070, 평택시,100005, 99세,2021,27,7,20,35,26,7,19,36.8
31070, 평택시,101,100세이상,2021,46,9,37,24.3,46,9,37,24.3
31070, 평택시,102,15세미만,2021,78811,40168,38643,103.9,76341,38924,37417,104
31070, 평택시,103,15~64세,2021,424410,229265,195145,117.5,395258,212508,182750,116.3
31070, 평택시,104,65세이상,2021,68617,29819,38798,76.9,66813,29016,37797,76.8
31070, 평택시,086,85세이상,2021,6845,1997,4848,41.2,6773,1975,4798,41.2
31070, 평택시,126,평균연령,2021,40.6,39.7,41.5,,40.7,39.8,41.6,
31070, 평택시,127,중위연령,2021,40.9,40.1,42,,41.2,40.4,42.2,
31080, 동두천시,000,합계,2021,94912,47428,47484,99.9,90717,45103,45614,98.9
31080, 동두천시,005,0~4세,2021,2325,1171,1154,101.5,2211,1106,1105,100.1
31080, 동두천시,005001, 0세,2021,364,167,197,84.8,354,159,195,81.5
31080, 동두천시,005002, 1세,2021,429,213,216,98.6,408,200,208,96.2
31080, 동두천시,005003, 2세,2021,481,260,221,117.6,458,246,212,116
31080, 동두천시,005004, 3세,2021,465,235,230,102.2,439,226,213,106.1
31080, 동두천시,005005, 4세,2021,586,296,290,102.1,552,275,277,99.3
31080, 동두천시,010,5~9세,2021,3659,1902,1757,108.3,3538,1833,1705,107.5
31080, 동두천시,010001, 5세,2021,671,340,331,102.7,641,324,317,102.2
31080, 동두천시,010002, 6세,2021,711,386,325,118.8,677,362,315,114.9
31080, 동두천시,010003, 7세,2021,732,400,332,120.5,704,385,319,120.7
31080, 동두천시,010004, 8세,2021,742,371,371,100,721,362,359,100.8
31080, 동두천시,010005, 9세,2021,803,405,398,101.8,795,400,395,101.3
31080, 동두천시,015,10~14세,2021,4121,2040,2081,98,4065,2016,2049,98.4
31080, 동두천시,015001, 10세,2021,825,423,402,105.2,816,419,397,105.5
31080, 동두천시,015002, 11세,2021,802,408,394,103.6,790,405,385,105.2
31080, 동두천시,015003, 12세,2021,833,400,433,92.4,827,396,431,91.9
31080, 동두천시,015004, 13세,2021,802,373,429,86.9,787,368,419,87.8
31080, 동두천시,015005, 14세,2021,859,436,423,103.1,845,428,417,102.6
31080, 동두천시,020,15~19세,2021,4082,2048,2034,100.7,4037,2018,2019,100
31080, 동두천시,020001, 15세,2021,777,398,379,105,765,391,374,104.5
31080, 동두천시,020002, 16세,2021,752,380,372,102.2,744,375,369,101.6
31080, 동두천시,020003, 17세,2021,835,431,404,106.7,824,424,400,106
31080, 동두천시,020004, 18세,2021,902,442,460,96.1,896,439,457,96.1
31080, 동두천시,020005, 19세,2021,816,397,419,94.7,808,389,419,92.8
31080, 동두천시,025,20~24세,2021,5373,2866,2507,114.3,5139,2726,2413,113
31080, 동두천시,025001, 20세,2021,967,516,451,114.4,947,504,443,113.8
31080, 동두천시,025002, 21세,2021,1128,599,529,113.2,1096,581,515,112.8
31080, 동두천시,025003, 22세,2021,1051,575,476,120.8,1009,554,455,121.8
31080, 동두천시,025004, 23세,2021,1100,601,499,120.4,1042,563,479,117.5
31080, 동두천시,025005, 24세,2021,1127,575,552,104.2,1045,524,521,100.6
31080, 동두천시,030,25~29세,2021,5935,3294,2641,124.7,5394,2987,2407,124.1
31080, 동두천시,030001, 25세,2021,1118,594,524,113.4,1041,552,489,112.9
31080, 동두천시,030002, 26세,2021,1250,684,566,120.8,1157,629,528,119.1
31080, 동두천시,030003, 27세,2021,1220,709,511,138.7,1100,637,463,137.6
31080, 동두천시,030004, 28세,2021,1197,674,523,128.9,1079,606,473,128.1
31080, 동두천시,030005, 29세,2021,1150,633,517,122.4,1017,563,454,124
31080, 동두천시,035,30~34세,2021,5155,2766,2389,115.8,4475,2409,2066,116.6
31080, 동두천시,035001, 30세,2021,1162,639,523,122.2,1023,563,460,122.4
31080, 동두천시,035002, 31세,2021,1050,578,472,122.5,920,516,404,127.7
31080, 동두천시,035003, 32세,2021,993,527,466,113.1,849,448,401,111.7
31080, 동두천시,035004, 33세,2021,969,522,447,116.8,835,456,379,120.3
31080, 동두천시,035005, 34세,2021,981,500,481,104,848,426,422,100.9
31080, 동두천시,040,35~39세,2021,5712,2976,2736,108.8,5028,2605,2423,107.5
31080, 동두천시,040001, 35세,2021,995,529,466,113.5,866,467,399,117
31080, 동두천시,040002, 36세,2021,1077,584,493,118.5,909,494,415,119
31080, 동두천시,040003, 37세,2021,1118,553,565,97.9,967,460,507,90.7
31080, 동두천시,040004, 38세,2021,1184,624,560,111.4,1061,560,501,111.8
31080, 동두천시,040005, 39세,2021,1338,686,652,105.2,1225,624,601,103.8
31080, 동두천시,045,40~44세,2021,6487,3377,3110,108.6,5990,3089,2901,106.5
31080, 동두천시,045001, 40세,2021,1317,662,655,101.1,1219,608,611,99.5
31080, 동두천시,045002, 41세,2021,1341,690,651,106,1245,634,611,103.8
31080, 동두천시,045003, 42세,2021,1314,684,630,108.6,1208,624,584,106.8
31080, 동두천시,045004, 43세,2021,1199,626,573,109.2,1109,574,535,107.3
31080, 동두천시,045005, 44세,2021,1316,715,601,119,1209,649,560,115.9
31080, 동두천시,050,45~49세,2021,7487,3898,3589,108.6,7129,3692,3437,107.4
31080, 동두천시,050001, 45세,2021,1297,698,599,116.5,1218,652,566,115.2
31080, 동두천시,050002, 46세,2021,1425,741,684,108.3,1340,691,649,106.5
31080, 동두천시,050003, 47세,2021,1528,800,728,109.9,1464,768,696,110.3
31080, 동두천시,050004, 48세,2021,1557,789,768,102.7,1494,749,745,100.5
31080, 동두천시,050005, 49세,2021,1680,870,810,107.4,1613,832,781,106.5
31080, 동두천시,055,50~54세,2021,8361,4470,3891,114.9,8053,4270,3783,112.9
31080, 동두천시,055001, 50세,2021,1709,893,816,109.4,1642,849,793,107.1
31080, 동두천시,055002, 51세,2021,1678,890,788,112.9,1595,838,757,110.7
31080, 동두천시,055003, 52세,2021,1746,927,819,113.2,1693,892,801,111.4
31080, 동두천시,055004, 53세,2021,1737,951,786,121,1675,908,767,118.4
31080, 동두천시,055005, 54세,2021,1491,809,682,118.6,1448,783,665,117.7
31080, 동두천시,060,55~59세,2021,7914,4168,3746,111.3,7662,4034,3628,111.2
31080, 동두천시,060001, 55세,2021,1612,903,709,127.4,1555,870,685,127
31080, 동두천시,060002, 56세,2021,1626,850,776,109.5,1559,815,744,109.5
31080, 동두천시,060003, 57세,2021,1481,769,712,108,1437,742,695,106.8
31080, 동두천시,060004, 58세,2021,1594,837,757,110.6,1543,814,729,111.7
31080, 동두천시,060005, 59세,2021,1601,809,792,102.1,1568,793,775,102.3
31080, 동두천시,065,60~64세,2021,8045,4039,4006,100.8,7893,3973,3920,101.4
31080, 동두천시,065001, 60세,2021,1736,874,862,101.4,1706,859,847,101.4
31080, 동두천시,065002, 61세,2021,1718,869,849,102.4,1689,852,837,101.8
31080, 동두천시,065003, 62세,2021,1603,821,782,105,1573,806,767,105.1
31080, 동두천시,065004, 63세,2021,1543,761,782,97.3,1508,753,755,99.7
31080, 동두천시,065005, 64세,2021,1445,714,731,97.7,1417,703,714,98.5
31080, 동두천시,070,65~69세,2021,5835,2794,3041,91.9,5761,2762,2999,92.1
31080, 동두천시,070001, 65세,2021,1285,619,666,92.9,1265,610,655,93.1
31080, 동두천시,070002, 66세,2021,1350,668,682,97.9,1331,655,676,96.9
31080, 동두천시,070003, 67세,2021,1162,572,590,96.9,1145,564,581,97.1
31080, 동두천시,070004, 68세,2021,1003,450,553,81.4,988,448,540,83
31080, 동두천시,070005, 69세,2021,1035,485,550,88.2,1032,485,547,88.7
31080, 동두천시,075,70~74세,2021,4606,2022,2584,78.3,4562,1999,2563,78
31080, 동두천시,075001, 70세,2021,809,360,449,80.2,799,355,444,80
31080, 동두천시,075002, 71세,2021,849,394,455,86.6,843,391,452,86.5
31080, 동두천시,075003, 72세,2021,942,405,537,75.4,929,400,529,75.6
31080, 동두천시,075004, 73세,2021,961,393,568,69.2,955,390,565,69
31080, 동두천시,075005, 74세,2021,1045,470,575,81.7,1036,463,573,80.8
31080, 동두천시,080,75~79세,2021,4039,1648,2391,68.9,4016,1642,2374,69.2
31080, 동두천시,080001, 75세,2021,783,345,438,78.8,776,344,432,79.6
31080, 동두천시,080002, 76세,2021,734,323,411,78.6,728,322,406,79.3
31080, 동두천시,080003, 77세,2021,756,280,476,58.8,754,278,476,58.4
31080, 동두천시,080004, 78세,2021,796,338,458,73.8,790,337,453,74.4
31080, 동두천시,080005, 79세,2021,970,362,608,59.5,968,361,607,59.5
31080, 동두천시,085,80~84세,2021,3392,1279,2113,60.5,3381,1273,2108,60.4
31080, 동두천시,085001, 80세,2021,851,336,515,65.2,847,333,514,64.8
31080, 동두천시,085002, 81세,2021,734,284,450,63.1,731,282,449,62.8
31080, 동두천시,085003, 82세,2021,678,251,427,58.8,676,250,426,58.7
31080, 동두천시,085004, 83세,2021,588,223,365,61.1,587,223,364,61.3
31080, 동두천시,085005, 84세,2021,541,185,356,52,540,185,355,52.1
31080, 동두천시,090,85~89세,2021,1640,506,1134,44.6,1639,505,1134,44.5
31080, 동두천시,090001, 85세,2021,458,160,298,53.7,457,159,298,53.4
31080, 동두천시,090002, 86세,2021,400,128,272,47.1,400,128,272,47.1
31080, 동두천시,090003, 87세,2021,307,89,218,40.8,307,89,218,40.8
31080, 동두천시,090004, 88세,2021,257,64,193,33.2,257,64,193,33.2
31080, 동두천시,090005, 89세,2021,218,65,153,42.5,218,65,153,42.5
31080, 동두천시,095,90~94세,2021,573,137,436,31.4,573,137,436,31.4
31080, 동두천시,095001, 90세,2021,145,36,109,33,145,36,109,33
31080, 동두천시,095002, 91세,2021,142,30,112,26.8,142,30,112,26.8
31080, 동두천시,095003, 92세,2021,105,31,74,41.9,105,31,74,41.9
31080, 동두천시,095004, 93세,2021,113,23,90,25.6,113,23,90,25.6
31080, 동두천시,095005, 94세,2021,68,17,51,33.3,68,17,51,33.3
31080, 동두천시,100,95~99세,2021,148,22,126,17.5,148,22,126,17.5
31080, 동두천시,100001, 95세,2021,51,7,44,15.9,51,7,44,15.9
31080, 동두천시,100002, 96세,2021,34,5,29,17.2,34,5,29,17.2
31080, 동두천시,100003, 97세,2021,27,X,24,12.5,27,X,24,12.5
31080, 동두천시,100004, 98세,2021,24,X,21,14.3,24,X,21,14.3
31080, 동두천시,100005, 99세,2021,12,X,8,50,12,X,8,50
31080, 동두천시,101,100세이상,2021,23,5,18,27.8,23,5,18,27.8
31080, 동두천시,102,15세미만,2021,10105,5113,4992,102.4,9814,4955,4859,102
31080, 동두천시,103,15~64세,2021,64551,33902,30649,110.6,60800,31803,28997,109.7
31080, 동두천시,104,65세이상,2021,20256,8413,11843,71,20103,8345,11758,71
31080, 동두천시,086,85세이상,2021,2384,670,1714,39.1,2383,669,1714,39
31080, 동두천시,126,평균연령,2021,46.2,44.7,47.7,,46.6,45,48.1,
31080, 동두천시,127,중위연령,2021,48.2,46.8,49.7,,49,47.5,50.4,
31090, 안산시,000,합계,2021,718384,371177,347207,106.9,638456,326593,311863,104.7
31090, 안산시,005,0~4세,2021,20503,10471,10032,104.4,17503,8948,8555,104.6
31090, 안산시,005001, 0세,2021,3666,1953,1713,114,3222,1716,1506,113.9
31090, 안산시,005002, 1세,2021,3756,1871,1885,99.3,3248,1610,1638,98.3
31090, 안산시,005003, 2세,2021,4139,2089,2050,101.9,3457,1742,1715,101.6
31090, 안산시,005004, 3세,2021,4377,2227,2150,103.6,3673,1879,1794,104.7
31090, 안산시,005005, 4세,2021,4565,2331,2234,104.3,3903,2001,1902,105.2
31090, 안산시,010,5~9세,2021,26448,13446,13002,103.4,23962,12239,11723,104.4
31090, 안산시,010001, 5세,2021,5110,2629,2481,106,4459,2294,2165,106
31090, 안산시,010002, 6세,2021,5328,2671,2657,100.5,4801,2420,2381,101.6
31090, 안산시,010003, 7세,2021,5219,2659,2560,103.9,4754,2427,2327,104.3
31090, 안산시,010004, 8세,2021,5156,2639,2517,104.8,4719,2435,2284,106.6
31090, 안산시,010005, 9세,2021,5635,2848,2787,102.2,5229,2663,2566,103.8
31090, 안산시,015,10~14세,2021,29454,15171,14283,106.2,27908,14404,13504,106.7
31090, 안산시,015001, 10세,2021,5777,2945,2832,104,5449,2774,2675,103.7
31090, 안산시,015002, 11세,2021,5615,2920,2695,108.3,5287,2751,2536,108.5
31090, 안산시,015003, 12세,2021,5618,2914,2704,107.8,5295,2758,2537,108.7
31090, 안산시,015004, 13세,2021,6016,3133,2883,108.7,5720,2989,2731,109.4
31090, 안산시,015005, 14세,2021,6428,3259,3169,102.8,6157,3132,3025,103.5
31090, 안산시,020,15~19세,2021,33607,17239,16368,105.3,32268,16589,15679,105.8
31090, 안산시,020001, 15세,2021,5682,2952,2730,108.1,5467,2844,2623,108.4
31090, 안산시,020002, 16세,2021,6020,3059,2961,103.3,5833,2978,2855,104.3
31090, 안산시,020003, 17세,2021,6886,3538,3348,105.7,6664,3427,3237,105.9
31090, 안산시,020004, 18세,2021,7097,3673,3424,107.3,6828,3535,3293,107.3
31090, 안산시,020005, 19세,2021,7922,4017,3905,102.9,7476,3805,3671,103.7
31090, 안산시,025,20~24세,2021,52183,27415,24768,110.7,48596,25380,23216,109.3
31090, 안산시,025001, 20세,2021,9361,4822,4539,106.2,8866,4593,4273,107.5
31090, 안산시,025002, 21세,2021,10303,5467,4836,113,9665,5107,4558,112
31090, 안산시,025003, 22세,2021,10322,5450,4872,111.9,9667,5074,4593,110.5
31090, 안산시,025004, 23세,2021,10720,5541,5179,107,9911,5068,4843,104.6
31090, 안산시,025005, 24세,2021,11477,6135,5342,114.8,10487,5538,4949,111.9
31090, 안산시,030,25~29세,2021,60716,33332,27384,121.7,54377,29390,24987,117.6
31090, 안산시,030001, 25세,2021,11982,6411,5571,115.1,10936,5767,5169,111.6
31090, 안산시,030002, 26세,2021,12265,6646,5619,118.3,11083,5923,5160,114.8
31090, 안산시,030003, 27세,2021,12118,6718,5400,124.4,10929,5985,4944,121.1
31090, 안산시,030004, 28세,2021,11995,6629,5366,123.5,10610,5775,4835,119.4
31090, 안산시,030005, 29세,2021,12356,6928,5428,127.6,10819,5940,4879,121.7
31090, 안산시,035,30~34세,2021,52286,29551,22735,130,41961,23341,18620,125.4
31090, 안산시,035001, 30세,2021,11222,6400,4822,132.7,9526,5313,4213,126.1
31090, 안산시,035002, 31세,2021,10835,6106,4729,129.1,8820,4881,3939,123.9
31090, 안산시,035003, 32세,2021,10454,5917,4537,130.4,8356,4666,3690,126.4
31090, 안산시,035004, 33세,2021,9987,5636,4351,129.5,7755,4316,3439,125.5
31090, 안산시,035005, 34세,2021,9788,5492,4296,127.8,7504,4165,3339,124.7
31090, 안산시,040,35~39세,2021,51069,28328,22741,124.6,40632,22032,18600,118.5
31090, 안산시,040001, 35세,2021,9841,5483,4358,125.8,7541,4149,3392,122.3
31090, 안산시,040002, 36세,2021,9587,5323,4264,124.8,7434,4019,3415,117.7
31090, 안산시,040003, 37세,2021,9880,5457,4423,123.4,7819,4228,3591,117.7
31090, 안산시,040004, 38세,2021,10426,5793,4633,125,8534,4607,3927,117.3
31090, 안산시,040005, 39세,2021,11335,6272,5063,123.9,9304,5029,4275,117.6
31090, 안산시,045,40~44세,2021,54390,29009,25381,114.3,46266,24194,22072,109.6
31090, 안산시,045001, 40세,2021,10897,5951,4946,120.3,9170,4928,4242,116.2
31090, 안산시,045002, 41세,2021,11500,6099,5401,112.9,9815,5105,4710,108.4
31090, 안산시,045003, 42세,2021,11029,5888,5141,114.5,9258,4826,4432,108.9
31090, 안산시,045004, 43세,2021,10328,5480,4848,113,8797,4575,4222,108.4
31090, 안산시,045005, 44세,2021,10636,5591,5045,110.8,9226,4760,4466,106.6
31090, 안산시,050,45~49세,2021,62288,31966,30322,105.4,54918,27622,27296,101.2
31090, 안산시,050001, 45세,2021,10701,5555,5146,107.9,9300,4738,4562,103.9
31090, 안산시,050002, 46세,2021,11718,6055,5663,106.9,10319,5247,5072,103.5
31090, 안산시,050003, 47세,2021,12889,6678,6211,107.5,11493,5858,5635,104
31090, 안산시,050004, 48세,2021,13309,6729,6580,102.3,11751,5827,5924,98.4
31090, 안산시,050005, 49세,2021,13671,6949,6722,103.4,12055,5952,6103,97.5
31090, 안산시,055,50~54세,2021,73635,36797,36838,99.9,65627,32338,33289,97.1
31090, 안산시,055001, 50세,2021,14842,7427,7415,100.2,13073,6442,6631,97.1
31090, 안산시,055002, 51세,2021,14758,7390,7368,100.3,12993,6400,6593,97.1
31090, 안산시,055003, 52세,2021,15196,7500,7696,97.5,13582,6612,6970,94.9
31090, 안산시,055004, 53세,2021,15118,7555,7563,99.9,13523,6657,6866,97
31090, 안산시,055005, 54세,2021,13721,6925,6796,101.9,12456,6227,6229,100
31090, 안산시,060,55~59세,2021,66532,34663,31869,108.8,59157,30790,28367,108.5
31090, 안산시,060001, 55세,2021,13697,7004,6693,104.6,12280,6266,6014,104.2
31090, 안산시,060002, 56세,2021,14067,7216,6851,105.3,12553,6406,6147,104.2
31090, 안산시,060003, 57세,2021,12712,6629,6083,109,11240,5857,5383,108.8
31090, 안산시,060004, 58세,2021,13205,7048,6157,114.5,11499,6149,5350,114.9
31090, 안산시,060005, 59세,2021,12851,6766,6085,111.2,11585,6112,5473,111.7
31090, 안산시,065,60~64세,2021,54426,28630,25796,111,49550,26246,23304,112.6
31090, 안산시,065001, 60세,2021,12982,6776,6206,109.2,12184,6380,5804,109.9
31090, 안산시,065002, 61세,2021,12488,6576,5912,111.2,11238,5948,5290,112.4
31090, 안산시,065003, 62세,2021,10637,5680,4957,114.6,9689,5217,4472,116.7
31090, 안산시,065004, 63세,2021,9522,5045,4477,112.7,8586,4595,3991,115.1
31090, 안산시,065005, 64세,2021,8797,4553,4244,107.3,7853,4106,3747,109.6
31090, 안산시,070,65~69세,2021,30665,15396,15269,100.8,27572,13988,13584,103
31090, 안산시,070001, 65세,2021,7556,3870,3686,105,6743,3511,3232,108.6
31090, 안산시,070002, 66세,2021,7310,3695,3615,102.2,6583,3352,3231,103.7
31090, 안산시,070003, 67세,2021,5902,2943,2959,99.5,5244,2627,2617,100.4
31090, 안산시,070004, 68세,2021,4825,2427,2398,101.2,4319,2194,2125,103.2
31090, 안산시,070005, 69세,2021,5072,2461,2611,94.3,4683,2304,2379,96.8
31090, 안산시,075,70~74세,2021,18223,8572,9651,88.8,17056,8121,8935,90.9
31090, 안산시,075001, 70세,2021,3679,1791,1888,94.9,3318,1649,1669,98.8
31090, 안산시,075002, 71세,2021,3876,1845,2031,90.8,3613,1734,1879,92.3
31090, 안산시,075003, 72세,2021,3747,1795,1952,92,3480,1693,1787,94.7
31090, 안산시,075004, 73세,2021,3445,1569,1876,83.6,3309,1521,1788,85.1
31090, 안산시,075005, 74세,2021,3476,1572,1904,82.6,3336,1524,1812,84.1
31090, 안산시,080,75~79세,2021,13458,5556,7902,70.3,13021,5433,7588,71.6
31090, 안산시,080001, 75세,2021,2711,1190,1521,78.2,2586,1157,1429,81
31090, 안산시,080002, 76세,2021,2580,1084,1496,72.5,2498,1059,1439,73.6
31090, 안산시,080003, 77세,2021,2588,1086,1502,72.3,2504,1061,1443,73.5
31090, 안산시,080004, 78세,2021,2685,1050,1635,64.2,2613,1032,1581,65.3
31090, 안산시,080005, 79세,2021,2894,1146,1748,65.6,2820,1124,1696,66.3
31090, 안산시,085,80~84세,2021,10279,3545,6734,52.6,9972,3467,6505,53.3
31090, 안산시,085001, 80세,2021,2408,876,1532,57.2,2324,852,1472,57.9
31090, 안산시,085002, 81세,2021,2164,793,1371,57.8,2099,775,1324,58.5
31090, 안산시,085003, 82세,2021,2108,741,1367,54.2,2051,727,1324,54.9
31090, 안산시,085004, 83세,2021,1901,620,1281,48.4,1838,607,1231,49.3
31090, 안산시,085005, 84세,2021,1698,515,1183,43.5,1660,506,1154,43.8
31090, 안산시,090,85~89세,2021,5763,1595,4168,38.3,5676,1579,4097,38.5
31090, 안산시,090001, 85세,2021,1528,453,1075,42.1,1493,449,1044,43
31090, 안산시,090002, 86세,2021,1447,403,1044,38.6,1426,398,1028,38.7
31090, 안산시,090003, 87세,2021,1088,302,786,38.4,1072,297,775,38.3
31090, 안산시,090004, 88세,2021,926,239,687,34.8,916,238,678,35.1
31090, 안산시,090005, 89세,2021,774,198,576,34.4,769,197,572,34.4
31090, 안산시,095,90~94세,2021,1927,402,1525,26.4,1903,399,1504,26.5
31090, 안산시,095001, 90세,2021,565,143,422,33.9,556,143,413,34.6
31090, 안산시,095002, 91세,2021,495,107,388,27.6,488,106,382,27.7
31090, 안산시,095003, 92세,2021,347,72,275,26.2,344,71,273,26
31090, 안산시,095004, 93세,2021,305,56,249,22.5,302,55,247,22.3
31090, 안산시,095005, 94세,2021,215,24,191,12.6,213,24,189,12.7
31090, 안산시,100,95~99세,2021,465,83,382,21.7,464,83,381,21.8
31090, 안산시,100001, 95세,2021,174,37,137,27,174,37,137,27
31090, 안산시,100002, 96세,2021,123,18,105,17.1,123,18,105,17.1
31090, 안산시,100003, 97세,2021,71,16,55,29.1,70,16,54,29.6
31090, 안산시,100004, 98세,2021,55,7,48,14.6,55,7,48,14.6
31090, 안산시,100005, 99세,2021,42,5,37,13.5,42,5,37,13.5
31090, 안산시,101,100세이상,2021,67,10,57,17.5,67,10,57,17.5
31090, 안산시,102,15세미만,2021,76405,39088,37317,104.7,69373,35591,33782,105.4
31090, 안산시,103,15~64세,2021,561132,296930,264202,112.4,493352,257922,235430,109.6
31090, 안산시,104,65세이상,2021,80847,35159,45688,77,75731,33080,42651,77.6
31090, 안산시,086,85세이상,2021,8222,2090,6132,34.1,8110,2071,6039,34.3
31090, 안산시,126,평균연령,2021,41.8,41,42.7,,41.9,41.1,42.8,
31090, 안산시,127,중위연령,2021,43,41.8,44.4,,43.4,42.2,44.8,
31091, 상록구,000,합계,2021,364309,185647,178662,103.9,343066,174858,168208,104
31091, 상록구,005,0~4세,2021,9822,5011,4811,104.2,8754,4460,4294,103.9
31091, 상록구,005001, 0세,2021,1720,911,809,112.6,1575,834,741,112.6
31091, 상록구,005002, 1세,2021,1793,872,921,94.7,1606,771,835,92.3
31091, 상록구,005003, 2세,2021,1927,957,970,98.7,1693,836,857,97.5
31091, 상록구,005004, 3세,2021,2171,1112,1059,105,1892,977,915,106.8
31091, 상록구,005005, 4세,2021,2211,1159,1052,110.2,1988,1042,946,110.1
31091, 상록구,010,5~9세,2021,13785,7034,6751,104.2,13037,6668,6369,104.7
31091, 상록구,010001, 5세,2021,2636,1347,1289,104.5,2435,1244,1191,104.5
31091, 상록구,010002, 6세,2021,2801,1416,1385,102.2,2613,1328,1285,103.3
31091, 상록구,010003, 7세,2021,2734,1407,1327,106,2602,1339,1263,106
31091, 상록구,010004, 8세,2021,2670,1338,1332,100.5,2544,1279,1265,101.1
31091, 상록구,010005, 9세,2021,2944,1526,1418,107.6,2843,1478,1365,108.3
31091, 상록구,015,10~14세,2021,15383,7878,7505,105,14971,7657,7314,104.7
31091, 상록구,015001, 10세,2021,3020,1519,1501,101.2,2932,1475,1457,101.2
31091, 상록구,015002, 11세,2021,2976,1526,1450,105.2,2889,1477,1412,104.6
31091, 상록구,015003, 12세,2021,2955,1556,1399,111.2,2863,1506,1357,111
31091, 상록구,015004, 13세,2021,3051,1583,1468,107.8,2975,1540,1435,107.3
31091, 상록구,015005, 14세,2021,3381,1694,1687,100.4,3312,1659,1653,100.4
31091, 상록구,020,15~19세,2021,18029,9227,8802,104.8,17499,8967,8532,105.1
31091, 상록구,020001, 15세,2021,2982,1545,1437,107.5,2933,1520,1413,107.6
31091, 상록구,020002, 16세,2021,3219,1611,1608,100.2,3176,1592,1584,100.5
31091, 상록구,020003, 17세,2021,3554,1823,1731,105.3,3499,1798,1701,105.7
31091, 상록구,020004, 18세,2021,3792,1958,1834,106.8,3665,1888,1777,106.2
31091, 상록구,020005, 19세,2021,4482,2290,2192,104.5,4226,2169,2057,105.4
31091, 상록구,025,20~24세,2021,28956,15091,13865,108.8,27382,14299,13083,109.3
31091, 상록구,025001, 20세,2021,5347,2669,2678,99.7,5042,2533,2509,101
31091, 상록구,025002, 21세,2021,5776,3012,2764,109,5408,2815,2593,108.6
31091, 상록구,025003, 22세,2021,5685,2963,2722,108.9,5412,2819,2593,108.7
31091, 상록구,025004, 23세,2021,5923,3100,2823,109.8,5605,2943,2662,110.6
31091, 상록구,025005, 24세,2021,6225,3347,2878,116.3,5915,3189,2726,117
31091, 상록구,030,25~29세,2021,31158,16894,14264,118.4,29445,16035,13410,119.6
31091, 상록구,030001, 25세,2021,6346,3394,2952,115,6021,3227,2794,115.5
31091, 상록구,030002, 26세,2021,6447,3432,3015,113.8,6124,3276,2848,115
31091, 상록구,030003, 27세,2021,6181,3362,2819,119.3,5895,3228,2667,121
31091, 상록구,030004, 28세,2021,6043,3282,2761,118.9,5674,3098,2576,120.3
31091, 상록구,030005, 29세,2021,6141,3424,2717,126,5731,3206,2525,127
31091, 상록구,035,30~34세,2021,24021,13224,10797,122.5,21363,11861,9502,124.8
31091, 상록구,035001, 30세,2021,5410,3004,2406,124.9,4994,2777,2217,125.3
31091, 상록구,035002, 31세,2021,5043,2787,2256,123.5,4510,2510,2000,125.5
31091, 상록구,035003, 32세,2021,4711,2584,2127,121.5,4155,2310,1845,125.2
31091, 상록구,035004, 33세,2021,4489,2474,2015,122.8,3912,2182,1730,126.1
31091, 상록구,035005, 34세,2021,4368,2375,1993,119.2,3792,2082,1710,121.8
31091, 상록구,040,35~39세,2021,23852,12814,11038,116.1,21087,11331,9756,116.1
31091, 상록구,040001, 35세,2021,4521,2413,2108,114.5,3866,2076,1790,116
31091, 상록구,040002, 36세,2021,4371,2386,1985,120.2,3796,2077,1719,120.8
31091, 상록구,040003, 37세,2021,4595,2458,2137,115,4043,2160,1883,114.7
31091, 상록구,040004, 38세,2021,4989,2665,2324,114.7,4497,2389,2108,113.3
31091, 상록구,040005, 39세,2021,5376,2892,2484,116.4,4885,2629,2256,116.5
31091, 상록구,045,40~44세,2021,26435,13810,12625,109.4,24447,12727,11720,108.6
31091, 상록구,045001, 40세,2021,5147,2726,2421,112.6,4715,2486,2229,111.5
31091, 상록구,045002, 41세,2021,5588,2890,2698,107.1,5141,2652,2489,106.5
31091, 상록구,045003, 42세,2021,5369,2775,2594,107,4929,2520,2409,104.6
31091, 상록구,045004, 43세,2021,5030,2674,2356,113.5,4675,2480,2195,113
31091, 상록구,045005, 44세,2021,5301,2745,2556,107.4,4987,2589,2398,108
31091, 상록구,050,45~49세,2021,31327,15796,15531,101.7,29590,14821,14769,100.4
31091, 상록구,050001, 45세,2021,5362,2770,2592,106.9,5016,2565,2451,104.7
31091, 상록구,050002, 46세,2021,5851,2924,2927,99.9,5486,2722,2764,98.5
31091, 상록구,050003, 47세,2021,6418,3232,3186,101.4,6109,3074,3035,101.3
31091, 상록구,050004, 48세,2021,6709,3349,3360,99.7,6361,3162,3199,98.8
31091, 상록구,050005, 49세,2021,6987,3521,3466,101.6,6618,3298,3320,99.3
31091, 상록구,055,50~54세,2021,37368,18433,18935,97.3,35704,17556,18148,96.7
31091, 상록구,055001, 50세,2021,7411,3619,3792,95.4,7046,3426,3620,94.6
31091, 상록구,055002, 51세,2021,7521,3752,3769,99.5,7151,3555,3596,98.9
31091, 상록구,055003, 52세,2021,7779,3781,3998,94.6,7450,3615,3835,94.3
31091, 상록구,055004, 53세,2021,7567,3707,3860,96,7254,3540,3714,95.3
31091, 상록구,055005, 54세,2021,7090,3574,3516,101.6,6803,3420,3383,101.1
31091, 상록구,060,55~59세,2021,33527,17402,16125,107.9,31827,16568,15259,108.6
31091, 상록구,060001, 55세,2021,7065,3573,3492,102.3,6744,3412,3332,102.4
31091, 상록구,060002, 56세,2021,7078,3636,3442,105.6,6750,3454,3296,104.8
31091, 상록구,060003, 57세,2021,6335,3274,3061,107,6002,3116,2886,108
31091, 상록구,060004, 58세,2021,6573,3492,3081,113.3,6169,3305,2864,115.4
31091, 상록구,060005, 59세,2021,6476,3427,3049,112.4,6162,3281,2881,113.9
31091, 상록구,065,60~64세,2021,27617,14483,13134,110.3,26374,13908,12466,111.6
31091, 상록구,065001, 60세,2021,6715,3515,3200,109.8,6518,3423,3095,110.6
31091, 상록구,065002, 61세,2021,6317,3312,3005,110.2,6003,3167,2836,111.7
31091, 상록구,065003, 62세,2021,5389,2858,2531,112.9,5167,2754,2413,114.1
31091, 상록구,065004, 63세,2021,4747,2514,2233,112.6,4490,2393,2097,114.1
31091, 상록구,065005, 64세,2021,4449,2284,2165,105.5,4196,2171,2025,107.2
31091, 상록구,070,65~69세,2021,15531,7757,7774,99.8,14676,7401,7275,101.7
31091, 상록구,070001, 65세,2021,3778,1940,1838,105.5,3569,1864,1705,109.3
31091, 상록구,070002, 66세,2021,3694,1858,1836,101.2,3493,1770,1723,102.7
31091, 상록구,070003, 67세,2021,3042,1503,1539,97.7,2848,1409,1439,97.9
31091, 상록구,070004, 68세,2021,2421,1206,1215,99.3,2283,1147,1136,101
31091, 상록구,070005, 69세,2021,2596,1250,1346,92.9,2483,1211,1272,95.2
31091, 상록구,075,70~74세,2021,9625,4484,5141,87.2,9293,4363,4930,88.5
31091, 상록구,075001, 70세,2021,1867,889,978,90.9,1766,845,921,91.7
31091, 상록구,075002, 71세,2021,1996,964,1032,93.4,1923,938,985,95.2
31091, 상록구,075003, 72세,2021,1945,925,1020,90.7,1870,899,971,92.6
31091, 상록구,075004, 73세,2021,1904,855,1049,81.5,1865,845,1020,82.8
31091, 상록구,075005, 74세,2021,1913,851,1062,80.1,1869,836,1033,80.9
31091, 상록구,080,75~79세,2021,7656,3113,4543,68.5,7530,3070,4460,68.8
31091, 상록구,080001, 75세,2021,1517,653,864,75.6,1486,643,843,76.3
31091, 상록구,080002, 76세,2021,1488,627,861,72.8,1464,621,843,73.7
31091, 상록구,080003, 77세,2021,1422,593,829,71.5,1397,581,816,71.2
31091, 상록구,080004, 78세,2021,1550,584,966,60.5,1528,579,949,61
31091, 상록구,080005, 79세,2021,1679,656,1023,64.1,1655,646,1009,64
31091, 상록구,085,80~84세,2021,5746,2000,3746,53.4,5658,1977,3681,53.7
31091, 상록구,085001, 80세,2021,1350,502,848,59.2,1328,496,832,59.6
31091, 상록구,085002, 81세,2021,1198,430,768,56,1182,423,759,55.7
31091, 상록구,085003, 82세,2021,1173,405,768,52.7,1160,403,757,53.2
31091, 상록구,085004, 83세,2021,1069,362,707,51.2,1045,359,686,52.3
31091, 상록구,085005, 84세,2021,956,301,655,46,943,296,647,45.7
31091, 상록구,090,85~89세,2021,3134,912,2222,41,3102,906,2196,41.3
31091, 상록구,090001, 85세,2021,862,268,594,45.1,848,266,582,45.7
31091, 상록구,090002, 86세,2021,763,220,543,40.5,758,219,539,40.6
31091, 상록구,090003, 87세,2021,598,173,425,40.7,592,171,421,40.6
31091, 상록구,090004, 88세,2021,483,130,353,36.8,479,130,349,37.2
31091, 상록구,090005, 89세,2021,428,121,307,39.4,425,120,305,39.3
31091, 상록구,095,90~94세,2021,1035,235,800,29.4,1025,234,791,29.6
31091, 상록구,095001, 90세,2021,296,80,216,37,294,80,214,37.4
31091, 상록구,095002, 91세,2021,261,69,192,35.9,256,69,187,36.9
31091, 상록구,095003, 92세,2021,195,42,153,27.5,194,41,153,26.8
31091, 상록구,095004, 93세,2021,174,36,138,26.1,172,36,136,26.5
31091, 상록구,095005, 94세,2021,109,8,101,7.9,109,8,101,7.9
31091, 상록구,100,95~99세,2021,268,46,222,20.7,268,46,222,20.7
31091, 상록구,100001, 95세,2021,92,23,69,33.3,92,23,69,33.3
31091, 상록구,100002, 96세,2021,69,11,58,19,69,11,58,19
31091, 상록구,100003, 97세,2021,42,7,35,20,42,7,35,20
31091, 상록구,100004, 98세,2021,37,X,35,5.7,37,X,35,5.7
31091, 상록구,100005, 99세,2021,28,X,25,12,28,X,25,12
31091, 상록구,101,100세이상,2021,34,X,31,9.7,34,X,31,9.7
31091, 상록구,102,15세미만,2021,38990,19923,19067,104.5,36762,18785,17977,104.5
31091, 상록구,103,15~64세,2021,282290,147174,135116,108.9,264718,138073,126645,109
31091, 상록구,104,65세이상,2021,43029,18550,24479,75.8,41586,18000,23586,76.3
31091, 상록구,086,85세이상,2021,4471,1196,3275,36.5,4429,1189,3240,36.7
31091, 상록구,126,평균연령,2021,41.9,41,42.8,,42.1,41.2,43,
31091, 상록구,127,중위연령,2021,43.2,42,44.6,,43.7,42.4,45.1,
31092, 단원구,000,합계,2021,354075,185530,168545,110.1,295390,151735,143655,105.6
31092, 단원구,005,0~4세,2021,10681,5460,5221,104.6,8749,4488,4261,105.3
31092, 단원구,005001, 0세,2021,1946,1042,904,115.3,1647,882,765,115.3
31092, 단원구,005002, 1세,2021,1963,999,964,103.6,1642,839,803,104.5
31092, 단원구,005003, 2세,2021,2212,1132,1080,104.8,1764,906,858,105.6
31092, 단원구,005004, 3세,2021,2206,1115,1091,102.2,1781,902,879,102.6
31092, 단원구,005005, 4세,2021,2354,1172,1182,99.2,1915,959,956,100.3
31092, 단원구,010,5~9세,2021,12663,6412,6251,102.6,10925,5571,5354,104.1
31092, 단원구,010001, 5세,2021,2474,1282,1192,107.6,2024,1050,974,107.8
31092, 단원구,010002, 6세,2021,2527,1255,1272,98.7,2188,1092,1096,99.6
31092, 단원구,010003, 7세,2021,2485,1252,1233,101.5,2152,1088,1064,102.3
31092, 단원구,010004, 8세,2021,2486,1301,1185,109.8,2175,1156,1019,113.4
31092, 단원구,010005, 9세,2021,2691,1322,1369,96.6,2386,1185,1201,98.7
31092, 단원구,015,10~14세,2021,14071,7293,6778,107.6,12937,6747,6190,109
31092, 단원구,015001, 10세,2021,2757,1426,1331,107.1,2517,1299,1218,106.7
31092, 단원구,015002, 11세,2021,2639,1394,1245,112,2398,1274,1124,113.3
31092, 단원구,015003, 12세,2021,2663,1358,1305,104.1,2432,1252,1180,106.1
31092, 단원구,015004, 13세,2021,2965,1550,1415,109.5,2745,1449,1296,111.8
31092, 단원구,015005, 14세,2021,3047,1565,1482,105.6,2845,1473,1372,107.4
31092, 단원구,020,15~19세,2021,15578,8012,7566,105.9,14769,7622,7147,106.6
31092, 단원구,020001, 15세,2021,2700,1407,1293,108.8,2534,1324,1210,109.4
31092, 단원구,020002, 16세,2021,2801,1448,1353,107,2657,1386,1271,109
31092, 단원구,020003, 17세,2021,3332,1715,1617,106.1,3165,1629,1536,106.1
31092, 단원구,020004, 18세,2021,3305,1715,1590,107.9,3163,1647,1516,108.6
31092, 단원구,020005, 19세,2021,3440,1727,1713,100.8,3250,1636,1614,101.4
31092, 단원구,025,20~24세,2021,23227,12324,10903,113,21214,11081,10133,109.4
31092, 단원구,025001, 20세,2021,4014,2153,1861,115.7,3824,2060,1764,116.8
31092, 단원구,025002, 21세,2021,4527,2455,2072,118.5,4257,2292,1965,116.6
31092, 단원구,025003, 22세,2021,4637,2487,2150,115.7,4255,2255,2000,112.8
31092, 단원구,025004, 23세,2021,4797,2441,2356,103.6,4306,2125,2181,97.4
31092, 단원구,025005, 24세,2021,5252,2788,2464,113.1,4572,2349,2223,105.7
31092, 단원구,030,25~29세,2021,29558,16438,13120,125.3,24932,13355,11577,115.4
31092, 단원구,030001, 25세,2021,5636,3017,2619,115.2,4915,2540,2375,106.9
31092, 단원구,030002, 26세,2021,5818,3214,2604,123.4,4959,2647,2312,114.5
31092, 단원구,030003, 27세,2021,5937,3356,2581,130,5034,2757,2277,121.1
31092, 단원구,030004, 28세,2021,5952,3347,2605,128.5,4936,2677,2259,118.5
31092, 단원구,030005, 29세,2021,6215,3504,2711,129.3,5088,2734,2354,116.1
31092, 단원구,035,30~34세,2021,28265,16327,11938,136.8,20598,11480,9118,125.9
31092, 단원구,035001, 30세,2021,5812,3396,2416,140.6,4532,2536,1996,127.1
31092, 단원구,035002, 31세,2021,5792,3319,2473,134.2,4310,2371,1939,122.3
31092, 단원구,035003, 32세,2021,5743,3333,2410,138.3,4201,2356,1845,127.7
31092, 단원구,035004, 33세,2021,5498,3162,2336,135.4,3843,2134,1709,124.9
31092, 단원구,035005, 34세,2021,5420,3117,2303,135.3,3712,2083,1629,127.9
31092, 단원구,040,35~39세,2021,27217,15514,11703,132.6,19545,10701,8844,121
31092, 단원구,040001, 35세,2021,5320,3070,2250,136.4,3675,2073,1602,129.4
31092, 단원구,040002, 36세,2021,5216,2937,2279,128.9,3638,1942,1696,114.5
31092, 단원구,040003, 37세,2021,5285,2999,2286,131.2,3776,2068,1708,121.1
31092, 단원구,040004, 38세,2021,5437,3128,2309,135.5,4037,2218,1819,121.9
31092, 단원구,040005, 39세,2021,5959,3380,2579,131.1,4419,2400,2019,118.9
31092, 단원구,045,40~44세,2021,27955,15199,12756,119.2,21819,11467,10352,110.8
31092, 단원구,045001, 40세,2021,5750,3225,2525,127.7,4455,2442,2013,121.3
31092, 단원구,045002, 41세,2021,5912,3209,2703,118.7,4674,2453,2221,110.4
31092, 단원구,045003, 42세,2021,5660,3113,2547,122.2,4329,2306,2023,114
31092, 단원구,045004, 43세,2021,5298,2806,2492,112.6,4122,2095,2027,103.4
31092, 단원구,045005, 44세,2021,5335,2846,2489,114.3,4239,2171,2068,105
31092, 단원구,050,45~49세,2021,30961,16170,14791,109.3,25328,12801,12527,102.2
31092, 단원구,050001, 45세,2021,5339,2785,2554,109,4284,2173,2111,102.9
31092, 단원구,050002, 46세,2021,5867,3131,2736,114.4,4833,2525,2308,109.4
31092, 단원구,050003, 47세,2021,6471,3446,3025,113.9,5384,2784,2600,107.1
31092, 단원구,050004, 48세,2021,6600,3380,3220,105,5390,2665,2725,97.8
31092, 단원구,050005, 49세,2021,6684,3428,3256,105.3,5437,2654,2783,95.4
31092, 단원구,055,50~54세,2021,36267,18364,17903,102.6,29923,14782,15141,97.6
31092, 단원구,055001, 50세,2021,7431,3808,3623,105.1,6027,3016,3011,100.2
31092, 단원구,055002, 51세,2021,7237,3638,3599,101.1,5842,2845,2997,94.9
31092, 단원구,055003, 52세,2021,7417,3719,3698,100.6,6132,2997,3135,95.6
31092, 단원구,055004, 53세,2021,7551,3848,3703,103.9,6269,3117,3152,98.9
31092, 단원구,055005, 54세,2021,6631,3351,3280,102.2,5653,2807,2846,98.6
31092, 단원구,060,55~59세,2021,33005,17261,15744,109.6,27330,14222,13108,108.5
31092, 단원구,060001, 55세,2021,6632,3431,3201,107.2,5536,2854,2682,106.4
31092, 단원구,060002, 56세,2021,6989,3580,3409,105,5803,2952,2851,103.5
31092, 단원구,060003, 57세,2021,6377,3355,3022,111,5238,2741,2497,109.8
31092, 단원구,060004, 58세,2021,6632,3556,3076,115.6,5330,2844,2486,114.4
31092, 단원구,060005, 59세,2021,6375,3339,3036,110,5423,2831,2592,109.2
31092, 단원구,065,60~64세,2021,26809,14147,12662,111.7,23176,12338,10838,113.8
31092, 단원구,065001, 60세,2021,6267,3261,3006,108.5,5666,2957,2709,109.2
31092, 단원구,065002, 61세,2021,6171,3264,2907,112.3,5235,2781,2454,113.3
31092, 단원구,065003, 62세,2021,5248,2822,2426,116.3,4522,2463,2059,119.6
31092, 단원구,065004, 63세,2021,4775,2531,2244,112.8,4096,2202,1894,116.3
31092, 단원구,065005, 64세,2021,4348,2269,2079,109.1,3657,1935,1722,112.4
31092, 단원구,070,65~69세,2021,15134,7639,7495,101.9,12896,6587,6309,104.4
31092, 단원구,070001, 65세,2021,3778,1930,1848,104.4,3174,1647,1527,107.9
31092, 단원구,070002, 66세,2021,3616,1837,1779,103.3,3090,1582,1508,104.9
31092, 단원구,070003, 67세,2021,2860,1440,1420,101.4,2396,1218,1178,103.4
31092, 단원구,070004, 68세,2021,2404,1221,1183,103.2,2036,1047,989,105.9
31092, 단원구,070005, 69세,2021,2476,1211,1265,95.7,2200,1093,1107,98.7
31092, 단원구,075,70~74세,2021,8598,4088,4510,90.6,7763,3758,4005,93.8
31092, 단원구,075001, 70세,2021,1812,902,910,99.1,1552,804,748,107.5
31092, 단원구,075002, 71세,2021,1880,881,999,88.2,1690,796,894,89
31092, 단원구,075003, 72세,2021,1802,870,932,93.3,1610,794,816,97.3
31092, 단원구,075004, 73세,2021,1541,714,827,86.3,1444,676,768,88
31092, 단원구,075005, 74세,2021,1563,721,842,85.6,1467,688,779,88.3
31092, 단원구,080,75~79세,2021,5802,2443,3359,72.7,5491,2363,3128,75.5
31092, 단원구,080001, 75세,2021,1194,537,657,81.7,1100,514,586,87.7
31092, 단원구,080002, 76세,2021,1092,457,635,72,1034,438,596,73.5
31092, 단원구,080003, 77세,2021,1166,493,673,73.3,1107,480,627,76.6
31092, 단원구,080004, 78세,2021,1135,466,669,69.7,1085,453,632,71.7
31092, 단원구,080005, 79세,2021,1215,490,725,67.6,1165,478,687,69.6
31092, 단원구,085,80~84세,2021,4533,1545,2988,51.7,4314,1490,2824,52.8
31092, 단원구,085001, 80세,2021,1058,374,684,54.7,996,356,640,55.6
31092, 단원구,085002, 81세,2021,966,363,603,60.2,917,352,565,62.3
31092, 단원구,085003, 82세,2021,935,336,599,56.1,891,324,567,57.1
31092, 단원구,085004, 83세,2021,832,258,574,44.9,793,248,545,45.5
31092, 단원구,085005, 84세,2021,742,214,528,40.5,717,210,507,41.4
31092, 단원구,090,85~89세,2021,2629,683,1946,35.1,2574,673,1901,35.4
31092, 단원구,090001, 85세,2021,666,185,481,38.5,645,183,462,39.6
31092, 단원구,090002, 86세,2021,684,183,501,36.5,668,179,489,36.6
31092, 단원구,090003, 87세,2021,490,129,361,35.7,480,126,354,35.6
31092, 단원구,090004, 88세,2021,443,109,334,32.6,437,108,329,32.8
31092, 단원구,090005, 89세,2021,346,77,269,28.6,344,77,267,28.8
31092, 단원구,095,90~94세,2021,892,167,725,23,878,165,713,23.1
31092, 단원구,095001, 90세,2021,269,63,206,30.6,262,63,199,31.7
31092, 단원구,095002, 91세,2021,234,38,196,19.4,232,37,195,19
31092, 단원구,095003, 92세,2021,152,30,122,24.6,150,30,120,25
31092, 단원구,095004, 93세,2021,131,20,111,18,130,19,111,17.1
31092, 단원구,095005, 94세,2021,106,16,90,17.8,104,16,88,18.2
31092, 단원구,100,95~99세,2021,197,37,160,23.1,196,37,159,23.3
31092, 단원구,100001, 95세,2021,82,14,68,20.6,82,14,68,20.6
31092, 단원구,100002, 96세,2021,54,7,47,14.9,54,7,47,14.9
31092, 단원구,100003, 97세,2021,29,9,20,45,28,9,19,47.4
31092, 단원구,100004, 98세,2021,18,5,13,38.5,18,5,13,38.5
31092, 단원구,100005, 99세,2021,14,X,12,16.7,14,X,12,16.7
31092, 단원구,101,100세이상,2021,33,7,26,26.9,33,7,26,26.9
31092, 단원구,102,15세미만,2021,37415,19165,18250,105,32611,16806,15805,106.3
31092, 단원구,103,15~64세,2021,278842,149756,129086,116,228634,119849,108785,110.2
31092, 단원구,104,65세이상,2021,37818,16609,21209,78.3,34145,15080,19065,79.1
31092, 단원구,086,85세이상,2021,3751,894,2857,31.3,3681,882,2799,31.5
31092, 단원구,126,평균연령,2021,41.7,40.9,42.6,,41.8,41,42.7,
31092, 단원구,127,중위연령,2021,42.7,41.5,44.2,,43.1,42,44.4,
31100, 고양시,000,합계,2021,1049513,512695,536818,95.5,1031893,504082,527811,95.5
31100, 고양시,005,0~4세,2021,32083,16287,15796,103.1,31752,16133,15619,103.3
31100, 고양시,005001, 0세,2021,5552,2803,2749,102,5514,2788,2726,102.3
31100, 고양시,005002, 1세,2021,5738,2865,2873,99.7,5673,2842,2831,100.4
31100, 고양시,005003, 2세,2021,6344,3198,3146,101.7,6279,3163,3116,101.5
31100, 고양시,005004, 3세,2021,6946,3546,3400,104.3,6866,3505,3361,104.3
31100, 고양시,005005, 4세,2021,7503,3875,3628,106.8,7420,3835,3585,107
31100, 고양시,010,5~9세,2021,45320,23178,22142,104.7,44969,23011,21958,104.8
31100, 고양시,010001, 5세,2021,8615,4369,4246,102.9,8512,4323,4189,103.2
31100, 고양시,010002, 6세,2021,9048,4670,4378,106.7,8976,4631,4345,106.6
31100, 고양시,010003, 7세,2021,8768,4512,4256,106,8711,4486,4225,106.2
31100, 고양시,010004, 8세,2021,8999,4543,4456,102,8944,4515,4429,101.9
31100, 고양시,010005, 9세,2021,9890,5084,4806,105.8,9826,5056,4770,106
31100, 고양시,015,10~14세,2021,48432,24859,23573,105.5,48245,24759,23486,105.4
31100, 고양시,015001, 10세,2021,9761,4967,4794,103.6,9722,4951,4771,103.8
31100, 고양시,015002, 11세,2021,9529,4908,4621,106.2,9489,4888,4601,106.2
31100, 고양시,015003, 12세,2021,9266,4825,4441,108.6,9224,4804,4420,108.7
31100, 고양시,015004, 13세,2021,9960,5035,4925,102.2,9929,5015,4914,102.1
31100, 고양시,015005, 14세,2021,9916,5124,4792,106.9,9881,5101,4780,106.7
31100, 고양시,020,15~19세,2021,48292,24461,23831,102.6,48108,24374,23734,102.7
31100, 고양시,020001, 15세,2021,9354,4720,4634,101.9,9330,4710,4620,101.9
31100, 고양시,020002, 16세,2021,9218,4631,4587,101,9187,4616,4571,101
31100, 고양시,020003, 17세,2021,10346,5189,5157,100.6,10311,5177,5134,100.8
31100, 고양시,020004, 18세,2021,10154,5227,4927,106.1,10127,5214,4913,106.1
31100, 고양시,020005, 19세,2021,9220,4694,4526,103.7,9153,4657,4496,103.6
31100, 고양시,025,20~24세,2021,61894,32084,29810,107.6,61064,31688,29376,107.9
31100, 고양시,025001, 20세,2021,10970,5893,5077,116.1,10872,5851,5021,116.5
31100, 고양시,025002, 21세,2021,12409,6762,5647,119.7,12308,6713,5595,120
31100, 고양시,025003, 22세,2021,12098,6380,5718,111.6,11939,6312,5627,112.2
31100, 고양시,025004, 23세,2021,12798,6373,6425,99.2,12590,6274,6316,99.3
31100, 고양시,025005, 24세,2021,13619,6676,6943,96.2,13355,6538,6817,95.9
31100, 고양시,030,25~29세,2021,74496,37878,36618,103.4,72483,36832,35651,103.3
31100, 고양시,030001, 25세,2021,14557,7446,7111,104.7,14263,7301,6962,104.9
31100, 고양시,030002, 26세,2021,14928,7579,7349,103.1,14517,7346,7171,102.4
31100, 고양시,030003, 27세,2021,14878,7683,7195,106.8,14487,7474,7013,106.6
31100, 고양시,030004, 28세,2021,14937,7596,7341,103.5,14467,7365,7102,103.7
31100, 고양시,030005, 29세,2021,15196,7574,7622,99.4,14749,7346,7403,99.2
31100, 고양시,035,30~34세,2021,67343,33694,33649,100.1,64766,32370,32396,99.9
31100, 고양시,035001, 30세,2021,14462,7253,7209,100.6,13970,7015,6955,100.9
31100, 고양시,035002, 31세,2021,13672,6822,6850,99.6,13111,6511,6600,98.7
31100, 고양시,035003, 32세,2021,13151,6615,6536,101.2,12661,6355,6306,100.8
31100, 고양시,035004, 33세,2021,13126,6563,6563,100,12595,6315,6280,100.6
31100, 고양시,035005, 34세,2021,12932,6441,6491,99.2,12429,6174,6255,98.7
31100, 고양시,040,35~39세,2021,72748,36409,36339,100.2,70448,35199,35249,99.9
31100, 고양시,040001, 35세,2021,13127,6536,6591,99.2,12629,6274,6355,98.7
31100, 고양시,040002, 36세,2021,13606,6840,6766,101.1,13141,6599,6542,100.9
31100, 고양시,040003, 37세,2021,13964,6985,6979,100.1,13507,6754,6753,100
31100, 고양시,040004, 38세,2021,15609,7807,7802,100.1,15179,7574,7605,99.6
31100, 고양시,040005, 39세,2021,16442,8241,8201,100.5,15992,7998,7994,100.1
31100, 고양시,045,40~44세,2021,81795,39752,42043,94.6,80024,38826,41198,94.2
31100, 고양시,045001, 40세,2021,16891,8222,8669,94.8,16499,8019,8480,94.6
31100, 고양시,045002, 41세,2021,16873,8232,8641,95.3,16491,8035,8456,95
31100, 고양시,045003, 42세,2021,16676,8077,8599,93.9,16308,7889,8419,93.7
31100, 고양시,045004, 43세,2021,15227,7478,7749,96.5,14910,7308,7602,96.1
31100, 고양시,045005, 44세,2021,16128,7743,8385,92.3,15816,7575,8241,91.9
31100, 고양시,050,45~49세,2021,91914,44393,47521,93.4,90435,43641,46794,93.3
31100, 고양시,050001, 45세,2021,15897,7794,8103,96.2,15590,7640,7950,96.1
31100, 고양시,050002, 46세,2021,17020,8222,8798,93.5,16719,8077,8642,93.5
31100, 고양시,050003, 47세,2021,18889,9099,9790,92.9,18617,8970,9647,93
31100, 고양시,050004, 48세,2021,19473,9308,10165,91.6,19165,9146,10019,91.3
31100, 고양시,050005, 49세,2021,20635,9970,10665,93.5,20344,9808,10536,93.1
31100, 고양시,055,50~54세,2021,102312,49340,52972,93.1,100866,48687,52179,93.3
31100, 고양시,055001, 50세,2021,21620,10512,11108,94.6,21329,10375,10954,94.7
31100, 고양시,055002, 51세,2021,20912,10104,10808,93.5,20597,9957,10640,93.6
31100, 고양시,055003, 52세,2021,20897,10196,10701,95.3,20594,10077,10517,95.8
31100, 고양시,055004, 53세,2021,20345,9710,10635,91.3,20054,9556,10498,91
31100, 고양시,055005, 54세,2021,18538,8818,9720,90.7,18292,8722,9570,91.1
31100, 고양시,060,55~59세,2021,90272,44529,45743,97.3,88730,43845,44885,97.7
31100, 고양시,060001, 55세,2021,18044,8925,9119,97.9,17738,8772,8966,97.8
31100, 고양시,060002, 56세,2021,18609,9007,9602,93.8,18311,8881,9430,94.2
31100, 고양시,060003, 57세,2021,17581,8606,8975,95.9,17271,8468,8803,96.2
31100, 고양시,060004, 58세,2021,18359,9198,9161,100.4,17998,9041,8957,100.9
31100, 고양시,060005, 59세,2021,17679,8793,8886,99,17412,8683,8729,99.5
31100, 고양시,065,60~64세,2021,79821,40325,39496,102.1,78543,39762,38781,102.5
31100, 고양시,065001, 60세,2021,18356,9327,9029,103.3,18142,9230,8912,103.6
31100, 고양시,065002, 61세,2021,17843,8858,8985,98.6,17531,8726,8805,99.1
31100, 고양시,065003, 62세,2021,15629,7889,7740,101.9,15385,7783,7602,102.4
31100, 고양시,065004, 63세,2021,14246,7228,7018,103,13987,7117,6870,103.6
31100, 고양시,065005, 64세,2021,13747,7023,6724,104.4,13498,6906,6592,104.8
31100, 고양시,070,65~69세,2021,50599,24979,25620,97.5,49840,24638,25202,97.8
31100, 고양시,070001, 65세,2021,12098,6144,5954,103.2,11901,6047,5854,103.3
31100, 고양시,070002, 66세,2021,12019,5863,6156,95.2,11843,5777,6066,95.2
31100, 고양시,070003, 67세,2021,9565,4795,4770,100.5,9426,4732,4694,100.8
31100, 고양시,070004, 68세,2021,8282,4001,4281,93.5,8147,3953,4194,94.3
31100, 고양시,070005, 69세,2021,8635,4176,4459,93.7,8523,4129,4394,94
31100, 고양시,075,70~74세,2021,32974,14685,18289,80.3,32665,14552,18113,80.3
31100, 고양시,075001, 70세,2021,5695,2659,3036,87.6,5613,2624,2989,87.8
31100, 고양시,075002, 71세,2021,6660,2958,3702,79.9,6583,2918,3665,79.6
31100, 고양시,075003, 72세,2021,6786,3060,3726,82.1,6724,3039,3685,82.5
31100, 고양시,075004, 73세,2021,6849,3014,3835,78.6,6806,2997,3809,78.7
31100, 고양시,075005, 74세,2021,6984,2994,3990,75,6939,2974,3965,75
31100, 고양시,080,75~79세,2021,28298,11656,16642,70,28155,11603,16552,70.1
31100, 고양시,080001, 75세,2021,5647,2408,3239,74.3,5609,2393,3216,74.4
31100, 고양시,080002, 76세,2021,5344,2245,3099,72.4,5314,2232,3082,72.4
31100, 고양시,080003, 77세,2021,5391,2151,3240,66.4,5367,2145,3222,66.6
31100, 고양시,080004, 78세,2021,5569,2263,3306,68.5,5548,2255,3293,68.5
31100, 고양시,080005, 79세,2021,6347,2589,3758,68.9,6317,2578,3739,68.9
31100, 고양시,085,80~84세,2021,23013,8669,14344,60.4,22951,8656,14295,60.6
31100, 고양시,085001, 80세,2021,5326,2111,3215,65.7,5311,2109,3202,65.9
31100, 고양시,085002, 81세,2021,4884,1877,3007,62.4,4871,1874,2997,62.5
31100, 고양시,085003, 82세,2021,4735,1761,2974,59.2,4726,1760,2966,59.3
31100, 고양시,085004, 83세,2021,4249,1576,2673,59,4233,1572,2661,59.1
31100, 고양시,085005, 84세,2021,3819,1344,2475,54.3,3810,1341,2469,54.3
31100, 고양시,090,85~89세,2021,12566,4159,8407,49.5,12522,4151,8371,49.6
31100, 고양시,090001, 85세,2021,3476,1247,2229,55.9,3462,1243,2219,56
31100, 고양시,090002, 86세,2021,3045,1031,2014,51.2,3033,1030,2003,51.4
31100, 고양시,090003, 87세,2021,2431,768,1663,46.2,2424,767,1657,46.3
31100, 고양시,090004, 88세,2021,1946,601,1345,44.7,1944,600,1344,44.6
31100, 고양시,090005, 89세,2021,1668,512,1156,44.3,1659,511,1148,44.5
31100, 고양시,095,90~94세,2021,4312,1135,3177,35.7,4303,1133,3170,35.7
31100, 고양시,095001, 90세,2021,1253,368,885,41.6,1249,367,882,41.6
31100, 고양시,095002, 91세,2021,1101,285,816,34.9,1100,285,815,35
31100, 고양시,095003, 92세,2021,883,229,654,35,881,229,652,35.1
31100, 고양시,095004, 93세,2021,626,144,482,29.9,624,143,481,29.7
31100, 고양시,095005, 94세,2021,449,109,340,32.1,449,109,340,32.1
31100, 고양시,100,95~99세,2021,895,196,699,28,890,195,695,28.1
31100, 고양시,100001, 95세,2021,293,54,239,22.6,292,53,239,22.2
31100, 고양시,100002, 96세,2021,238,40,198,20.2,238,40,198,20.2
31100, 고양시,100003, 97세,2021,148,36,112,32.1,148,36,112,32.1
31100, 고양시,100004, 98세,2021,131,43,88,48.9,129,43,86,50
31100, 고양시,100005, 99세,2021,85,23,62,37.1,83,23,60,38.3
31100, 고양시,101,100세이상,2021,134,27,107,25.2,134,27,107,25.2
31100, 고양시,102,15세미만,2021,125835,64324,61511,104.6,124966,63903,61063,104.7
31100, 고양시,103,15~64세,2021,770887,382865,388022,98.7,755467,375224,380243,98.7
31100, 고양시,104,65세이상,2021,152791,65506,87285,75,151460,64955,86505,75.1
31100, 고양시,086,85세이상,2021,17907,5517,12390,44.5,17849,5506,12343,44.6
31100, 고양시,126,평균연령,2021,43,41.9,44,,43,42,44,
31100, 고양시,127,중위연령,2021,44.5,43.4,45.6,,44.6,43.5,45.7,
31101, 덕양구,000,합계,2021,468756,231078,237678,97.2,461976,227967,234009,97.4
31101, 덕양구,005,0~4세,2021,15956,8132,7824,103.9,15846,8077,7769,104
31101, 덕양구,005001, 0세,2021,2818,1436,1382,103.9,2804,1430,1374,104.1
31101, 덕양구,005002, 1세,2021,2993,1506,1487,101.3,2972,1499,1473,101.8
31101, 덕양구,005003, 2세,2021,3087,1534,1553,98.8,3069,1523,1546,98.5
31101, 덕양구,005004, 3세,2021,3407,1727,1680,102.8,3378,1712,1666,102.8
31101, 덕양구,005005, 4세,2021,3651,1929,1722,112,3623,1913,1710,111.9
31101, 덕양구,010,5~9세,2021,20914,10668,10246,104.1,20813,10618,10195,104.1
31101, 덕양구,010001, 5세,2021,4197,2110,2087,101.1,4165,2094,2071,101.1
31101, 덕양구,010002, 6세,2021,4184,2112,2072,101.9,4172,2106,2066,101.9
31101, 덕양구,010003, 7세,2021,4135,2139,1996,107.2,4118,2131,1987,107.2
31101, 덕양구,010004, 8세,2021,4023,2052,1971,104.1,4008,2042,1966,103.9
31101, 덕양구,010005, 9세,2021,4375,2255,2120,106.4,4350,2245,2105,106.7
31101, 덕양구,015,10~14세,2021,20009,10283,9726,105.7,19950,10253,9697,105.7
31101, 덕양구,015001, 10세,2021,4334,2227,2107,105.7,4320,2219,2101,105.6
31101, 덕양구,015002, 11세,2021,3959,2040,1919,106.3,3949,2037,1912,106.5
31101, 덕양구,015003, 12세,2021,3873,2008,1865,107.7,3859,2001,1858,107.7
31101, 덕양구,015004, 13세,2021,3979,2002,1977,101.3,3968,1997,1971,101.3
31101, 덕양구,015005, 14세,2021,3864,2006,1858,108,3854,1999,1855,107.8
31101, 덕양구,020,15~19세,2021,18995,9623,9372,102.7,18913,9586,9327,102.8
31101, 덕양구,020001, 15세,2021,3621,1828,1793,102,3614,1827,1787,102.2
31101, 덕양구,020002, 16세,2021,3553,1736,1817,95.5,3546,1733,1813,95.6
31101, 덕양구,020003, 17세,2021,3929,2012,1917,105,3921,2008,1913,105
31101, 덕양구,020004, 18세,2021,4079,2094,1985,105.5,4063,2089,1974,105.8
31101, 덕양구,020005, 19세,2021,3813,1953,1860,105,3769,1929,1840,104.8
31101, 덕양구,025,20~24세,2021,26040,13698,12342,111,25655,13524,12131,111.5
31101, 덕양구,025001, 20세,2021,4602,2448,2154,113.6,4535,2416,2119,114
31101, 덕양구,025002, 21세,2021,5103,2771,2332,118.8,5051,2741,2310,118.7
31101, 덕양구,025003, 22세,2021,5193,2811,2382,118,5109,2776,2333,119
31101, 덕양구,025004, 23세,2021,5381,2726,2655,102.7,5299,2690,2609,103.1
31101, 덕양구,025005, 24세,2021,5761,2942,2819,104.4,5661,2901,2760,105.1
31101, 덕양구,030,25~29세,2021,32658,16786,15872,105.8,31890,16436,15454,106.4
31101, 덕양구,030001, 25세,2021,6248,3247,3001,108.2,6127,3195,2932,109
31101, 덕양구,030002, 26세,2021,6431,3292,3139,104.9,6284,3223,3061,105.3
31101, 덕양구,030003, 27세,2021,6440,3377,3063,110.3,6289,3309,2980,111
31101, 덕양구,030004, 28세,2021,6669,3446,3223,106.9,6481,3359,3122,107.6
31101, 덕양구,030005, 29세,2021,6870,3424,3446,99.4,6709,3350,3359,99.7
31101, 덕양구,035,30~34세,2021,32151,16082,16069,100.1,31162,15634,15528,100.7
31101, 덕양구,035001, 30세,2021,6640,3278,3362,97.5,6460,3204,3256,98.4
31101, 덕양구,035002, 31세,2021,6569,3267,3302,98.9,6342,3153,3189,98.9
31101, 덕양구,035003, 32세,2021,6243,3124,3119,100.2,6064,3036,3028,100.3
31101, 덕양구,035004, 33세,2021,6343,3192,3151,101.3,6136,3109,3027,102.7
31101, 덕양구,035005, 34세,2021,6356,3221,3135,102.7,6160,3132,3028,103.4
31101, 덕양구,040,35~39세,2021,35524,18069,17455,103.5,34652,17653,16999,103.8
31101, 덕양구,040001, 35세,2021,6405,3256,3149,103.4,6211,3153,3058,103.1
31101, 덕양구,040002, 36세,2021,6735,3411,3324,102.6,6561,3331,3230,103.1
31101, 덕양구,040003, 37세,2021,6757,3385,3372,100.4,6584,3314,3270,101.3
31101, 덕양구,040004, 38세,2021,7694,3905,3789,103.1,7527,3824,3703,103.3
31101, 덕양구,040005, 39세,2021,7933,4112,3821,107.6,7769,4031,3738,107.8
31101, 덕양구,045,40~44세,2021,37573,18848,18725,100.7,36912,18525,18387,100.8
31101, 덕양구,045001, 40세,2021,8032,4057,3975,102.1,7893,3989,3904,102.2
31101, 덕양구,045002, 41세,2021,7903,3983,3920,101.6,7748,3910,3838,101.9
31101, 덕양구,045003, 42세,2021,7584,3753,3831,98,7455,3692,3763,98.1
31101, 덕양구,045004, 43세,2021,6839,3461,3378,102.5,6719,3399,3320,102.4
31101, 덕양구,045005, 44세,2021,7215,3594,3621,99.3,7097,3535,3562,99.2
31101, 덕양구,050,45~49세,2021,38701,19311,19390,99.6,38123,19034,19089,99.7
31101, 덕양구,050001, 45세,2021,6887,3542,3345,105.9,6763,3480,3283,106
31101, 덕양구,050002, 46세,2021,7334,3625,3709,97.7,7211,3571,3640,98.1
31101, 덕양구,050003, 47세,2021,7962,3936,4026,97.8,7848,3889,3959,98.2
31101, 덕양구,050004, 48세,2021,8046,3985,4061,98.1,7936,3928,4008,98
31101, 덕양구,050005, 49세,2021,8472,4223,4249,99.4,8365,4166,4199,99.2
31101, 덕양구,055,50~54세,2021,42517,20794,21723,95.7,41947,20554,21393,96.1
31101, 덕양구,055001, 50세,2021,8932,4449,4483,99.2,8820,4401,4419,99.6
31101, 덕양구,055002, 51세,2021,8543,4220,4323,97.6,8411,4163,4248,98
31101, 덕양구,055003, 52세,2021,8662,4272,4390,97.3,8538,4232,4306,98.3
31101, 덕양구,055004, 53세,2021,8526,4092,4434,92.3,8427,4036,4391,91.9
31101, 덕양구,055005, 54세,2021,7854,3761,4093,91.9,7751,3722,4029,92.4
31101, 덕양구,060,55~59세,2021,39303,19540,19763,98.9,38703,19265,19438,99.1
31101, 덕양구,060001, 55세,2021,7826,3922,3904,100.5,7722,3857,3865,99.8
31101, 덕양구,060002, 56세,2021,8088,3961,4127,96,7956,3906,4050,96.4
31101, 덕양구,060003, 57세,2021,7587,3746,3841,97.5,7467,3702,3765,98.3
31101, 덕양구,060004, 58세,2021,8084,4071,4013,101.4,7948,4009,3939,101.8
31101, 덕양구,060005, 59세,2021,7718,3840,3878,99,7610,3791,3819,99.3
31101, 덕양구,065,60~64세,2021,36247,18166,18081,100.5,35774,17958,17816,100.8
31101, 덕양구,065001, 60세,2021,8231,4160,4071,102.2,8153,4124,4029,102.4
31101, 덕양구,065002, 61세,2021,8086,4014,4072,98.6,7973,3959,4014,98.6
31101, 덕양구,065003, 62세,2021,7061,3561,3500,101.7,6969,3524,3445,102.3
31101, 덕양구,065004, 63세,2021,6559,3280,3279,100,6462,3241,3221,100.6
31101, 덕양구,065005, 64세,2021,6310,3151,3159,99.7,6217,3110,3107,100.1
31101, 덕양구,070,65~69세,2021,24366,11822,12544,94.2,24068,11685,12383,94.4
31101, 덕양구,070001, 65세,2021,5634,2796,2838,98.5,5569,2765,2804,98.6
31101, 덕양구,070002, 66세,2021,5767,2728,3039,89.8,5689,2683,3006,89.3
31101, 덕양구,070003, 67세,2021,4638,2307,2331,99,4590,2287,2303,99.3
31101, 덕양구,070004, 68세,2021,4036,1915,2121,90.3,3982,1895,2087,90.8
31101, 덕양구,070005, 69세,2021,4291,2076,2215,93.7,4238,2055,2183,94.1
31101, 덕양구,075,70~74세,2021,16195,7280,8915,81.7,16063,7222,8841,81.7
31101, 덕양구,075001, 70세,2021,2832,1299,1533,84.7,2794,1283,1511,84.9
31101, 덕양구,075002, 71세,2021,3246,1450,1796,80.7,3215,1436,1779,80.7
31101, 덕양구,075003, 72세,2021,3370,1540,1830,84.2,3343,1529,1814,84.3
31101, 덕양구,075004, 73세,2021,3381,1531,1850,82.8,3363,1521,1842,82.6
31101, 덕양구,075005, 74세,2021,3366,1460,1906,76.6,3348,1453,1895,76.7
31101, 덕양구,080,75~79세,2021,13621,5655,7966,71,13562,5631,7931,71
31101, 덕양구,080001, 75세,2021,2781,1214,1567,77.5,2768,1209,1559,77.5
31101, 덕양구,080002, 76세,2021,2608,1100,1508,72.9,2593,1092,1501,72.8
31101, 덕양구,080003, 77세,2021,2552,1014,1538,65.9,2545,1012,1533,66
31101, 덕양구,080004, 78세,2021,2652,1082,1570,68.9,2640,1079,1561,69.1
31101, 덕양구,080005, 79세,2021,3028,1245,1783,69.8,3016,1239,1777,69.7
31101, 덕양구,085,80~84세,2021,10466,4033,6433,62.7,10440,4029,6411,62.8
31101, 덕양구,085001, 80세,2021,2465,1012,1453,69.6,2458,1011,1447,69.9
31101, 덕양구,085002, 81세,2021,2255,901,1354,66.5,2249,901,1348,66.8
31101, 덕양구,085003, 82세,2021,2183,827,1356,61,2180,827,1353,61.1
31101, 덕양구,085004, 83세,2021,1880,709,1171,60.5,1873,707,1166,60.6
31101, 덕양구,085005, 84세,2021,1683,584,1099,53.1,1680,583,1097,53.1
31101, 덕양구,090,85~89세,2021,5340,1726,3614,47.8,5328,1724,3604,47.8
31101, 덕양구,090001, 85세,2021,1513,530,983,53.9,1509,529,980,54
31101, 덕양구,090002, 86세,2021,1292,446,846,52.7,1287,446,841,53
31101, 덕양구,090003, 87세,2021,1018,308,710,43.4,1015,307,708,43.4
31101, 덕양구,090004, 88세,2021,825,243,582,41.8,825,243,582,41.8
31101, 덕양구,090005, 89세,2021,692,199,493,40.4,692,199,493,40.4
31101, 덕양구,095,90~94세,2021,1753,466,1287,36.2,1749,464,1285,36.1
31101, 덕양구,095001, 90세,2021,506,159,347,45.8,504,158,346,45.7
31101, 덕양구,095002, 91세,2021,445,110,335,32.8,445,110,335,32.8
31101, 덕양구,095003, 92세,2021,364,87,277,31.4,363,87,276,31.5
31101, 덕양구,095004, 93세,2021,238,62,176,35.2,237,61,176,34.7
31101, 덕양구,095005, 94세,2021,200,48,152,31.6,200,48,152,31.6
31101, 덕양구,100,95~99세,2021,368,84,284,29.6,367,83,284,29.2
31101, 덕양구,100001, 95세,2021,132,24,108,22.2,131,23,108,21.3
31101, 덕양구,100002, 96세,2021,93,19,74,25.7,93,19,74,25.7
31101, 덕양구,100003, 97세,2021,64,18,46,39.1,64,18,46,39.1
31101, 덕양구,100004, 98세,2021,47,14,33,42.4,47,14,33,42.4
31101, 덕양구,100005, 99세,2021,32,9,23,39.1,32,9,23,39.1
31101, 덕양구,101,100세이상,2021,59,12,47,25.5,59,12,47,25.5
31101, 덕양구,102,15세미만,2021,56879,29083,27796,104.6,56609,28948,27661,104.7
31101, 덕양구,103,15~64세,2021,339709,170917,168792,101.3,333731,168169,165562,101.6
31101, 덕양구,104,65세이상,2021,72168,31078,41090,75.6,71636,30850,40786,75.6
31101, 덕양구,086,85세이상,2021,7520,2288,5232,43.7,7503,2283,5220,43.7
31101, 덕양구,126,평균연령,2021,43.2,42.1,44.2,,43.2,42.1,44.2,
31101, 덕양구,127,중위연령,2021,44.2,43.1,45.4,,44.3,43.2,45.5,
31103, 일산동구,000,합계,2021,293014,142127,150887,94.2,287045,138950,148095,93.8
31103, 일산동구,005,0~4세,2021,7903,4004,3899,102.7,7789,3950,3839,102.9
31103, 일산동구,005001, 0세,2021,1311,665,646,102.9,1301,661,640,103.3
31103, 일산동구,005002, 1세,2021,1324,653,671,97.3,1302,645,657,98.2
31103, 일산동구,005003, 2세,2021,1620,819,801,102.2,1592,803,789,101.8
31103, 일산동구,005004, 3세,2021,1756,911,845,107.8,1731,897,834,107.6
31103, 일산동구,005005, 4세,2021,1892,956,936,102.1,1863,944,919,102.7
31103, 일산동구,010,5~9세,2021,11762,6101,5661,107.8,11634,6037,5597,107.9
31103, 일산동구,010001, 5세,2021,2109,1100,1009,109,2072,1082,990,109.3
31103, 일산동구,010002, 6세,2021,2385,1280,1105,115.8,2351,1261,1090,115.7
31103, 일산동구,010003, 7세,2021,2270,1131,1139,99.3,2253,1120,1133,98.9
31103, 일산동구,010004, 8세,2021,2386,1213,1173,103.4,2363,1204,1159,103.9
31103, 일산동구,010005, 9세,2021,2612,1377,1235,111.5,2595,1370,1225,111.8
31103, 일산동구,015,10~14세,2021,13241,6843,6398,107,13178,6810,6368,106.9
31103, 일산동구,015001, 10세,2021,2554,1257,1297,96.9,2541,1253,1288,97.3
31103, 일산동구,015002, 11세,2021,2585,1351,1234,109.5,2570,1341,1229,109.1
31103, 일산동구,015003, 12세,2021,2535,1347,1188,113.4,2521,1340,1181,113.5
31103, 일산동구,015004, 13세,2021,2759,1441,1318,109.3,2752,1438,1314,109.4
31103, 일산동구,015005, 14세,2021,2808,1447,1361,106.3,2794,1438,1356,106
31103, 일산동구,020,15~19세,2021,13858,6971,6887,101.2,13799,6947,6852,101.4
31103, 일산동구,020001, 15세,2021,2715,1359,1356,100.2,2704,1354,1350,100.3
31103, 일산동구,020002, 16세,2021,2621,1357,1264,107.4,2608,1351,1257,107.5
31103, 일산동구,020003, 17세,2021,3051,1476,1575,93.7,3035,1472,1563,94.2
31103, 일산동구,020004, 18세,2021,2945,1504,1441,104.4,2939,1500,1439,104.2
31103, 일산동구,020005, 19세,2021,2526,1275,1251,101.9,2513,1270,1243,102.2
31103, 일산동구,025,20~24세,2021,18026,9112,8914,102.2,17748,8958,8790,101.9
31103, 일산동구,025001, 20세,2021,3112,1707,1405,121.5,3091,1700,1391,122.2
31103, 일산동구,025002, 21세,2021,3508,1875,1633,114.8,3481,1860,1621,114.7
31103, 일산동구,025003, 22세,2021,3468,1795,1673,107.3,3427,1774,1653,107.3
31103, 일산동구,025004, 23세,2021,3821,1819,2002,90.9,3735,1770,1965,90.1
31103, 일산동구,025005, 24세,2021,4117,1916,2201,87.1,4014,1854,2160,85.8
31103, 일산동구,030,25~29세,2021,22576,11320,11256,100.6,21751,10837,10914,99.3
31103, 일산동구,030001, 25세,2021,4417,2181,2236,97.5,4296,2110,2186,96.5
31103, 일산동구,030002, 26세,2021,4581,2315,2266,102.2,4408,2204,2204,100
31103, 일산동구,030003, 27세,2021,4511,2283,2228,102.5,4353,2189,2164,101.2
31103, 일산동구,030004, 28세,2021,4504,2236,2268,98.6,4316,2135,2181,97.9
31103, 일산동구,030005, 29세,2021,4563,2305,2258,102.1,4378,2199,2179,100.9
31103, 일산동구,035,30~34세,2021,18640,9319,9321,100,17676,8752,8924,98.1
31103, 일산동구,035001, 30세,2021,4197,2143,2054,104.3,4007,2038,1969,103.5
31103, 일산동구,035002, 31세,2021,3758,1864,1894,98.4,3548,1728,1820,94.9
31103, 일산동구,035003, 32세,2021,3667,1881,1786,105.3,3474,1772,1702,104.1
31103, 일산동구,035004, 33세,2021,3594,1785,1809,98.7,3404,1681,1723,97.6
31103, 일산동구,035005, 34세,2021,3424,1646,1778,92.6,3243,1533,1710,89.6
31103, 일산동구,040,35~39세,2021,19148,9553,9595,99.6,18311,9052,9259,97.8
31103, 일산동구,040001, 35세,2021,3558,1751,1807,96.9,3385,1652,1733,95.3
31103, 일산동구,040002, 36세,2021,3530,1798,1732,103.8,3370,1700,1670,101.8
31103, 일산동구,040003, 37세,2021,3695,1869,1826,102.4,3513,1761,1752,100.5
31103, 일산동구,040004, 38세,2021,4022,2008,2014,99.7,3866,1917,1949,98.4
31103, 일산동구,040005, 39세,2021,4343,2127,2216,96,4177,2022,2155,93.8
31103, 일산동구,045,40~44세,2021,22364,10625,11739,90.5,21753,10276,11477,89.5
31103, 일산동구,045001, 40세,2021,4524,2134,2390,89.3,4380,2048,2332,87.8
31103, 일산동구,045002, 41세,2021,4528,2163,2365,91.5,4409,2092,2317,90.3
31103, 일산동구,045003, 42세,2021,4641,2237,2404,93.1,4500,2160,2340,92.3
31103, 일산동구,045004, 43세,2021,4265,2058,2207,93.2,4150,1995,2155,92.6
31103, 일산동구,045005, 44세,2021,4406,2033,2373,85.7,4314,1981,2333,84.9
31103, 일산동구,050,45~49세,2021,26479,12552,13927,90.1,25982,12289,13693,89.7
31103, 일산동구,050001, 45세,2021,4576,2192,2384,91.9,4474,2139,2335,91.6
31103, 일산동구,050002, 46세,2021,4793,2304,2489,92.6,4683,2248,2435,92.3
31103, 일산동구,050003, 47세,2021,5429,2535,2894,87.6,5344,2491,2853,87.3
31103, 일산동구,050004, 48세,2021,5656,2612,3044,85.8,5556,2560,2996,85.4
31103, 일산동구,050005, 49세,2021,6025,2909,3116,93.4,5925,2851,3074,92.7
31103, 일산동구,055,50~54세,2021,29830,14243,15587,91.4,29397,14050,15347,91.5
31103, 일산동구,055001, 50세,2021,6327,3047,3280,92.9,6230,3001,3229,92.9
31103, 일산동구,055002, 51세,2021,6161,2939,3222,91.2,6071,2900,3171,91.5
31103, 일산동구,055003, 52세,2021,6137,2966,3171,93.5,6047,2929,3118,93.9
31103, 일산동구,055004, 53세,2021,5883,2798,3085,90.7,5794,2755,3039,90.7
31103, 일산동구,055005, 54세,2021,5322,2493,2829,88.1,5255,2465,2790,88.4
31103, 일산동구,060,55~59세,2021,25758,12632,13126,96.2,25325,12440,12885,96.5
31103, 일산동구,060001, 55세,2021,5145,2503,2642,94.7,5044,2455,2589,94.8
31103, 일산동구,060002, 56세,2021,5221,2519,2702,93.2,5143,2488,2655,93.7
31103, 일산동구,060003, 57세,2021,5116,2505,2611,95.9,5024,2458,2566,95.8
31103, 일산동구,060004, 58세,2021,5240,2595,2645,98.1,5144,2557,2587,98.8
31103, 일산동구,060005, 59세,2021,5036,2510,2526,99.4,4970,2482,2488,99.8
31103, 일산동구,065,60~64세,2021,22226,11259,10967,102.7,21873,11109,10764,103.2
31103, 일산동구,065001, 60세,2021,5166,2672,2494,107.1,5104,2645,2459,107.6
31103, 일산동구,065002, 61세,2021,4986,2432,2554,95.2,4888,2389,2499,95.6
31103, 일산동구,065003, 62세,2021,4351,2185,2166,100.9,4279,2155,2124,101.5
31103, 일산동구,065004, 63세,2021,3968,2035,1933,105.3,3907,2011,1896,106.1
31103, 일산동구,065005, 64세,2021,3755,1935,1820,106.3,3695,1909,1786,106.9
31103, 일산동구,070,65~69세,2021,13477,6798,6679,101.8,13266,6710,6556,102.3
31103, 일산동구,070001, 65세,2021,3314,1726,1588,108.7,3258,1696,1562,108.6
31103, 일산동구,070002, 66세,2021,3165,1565,1600,97.8,3119,1548,1571,98.5
31103, 일산동구,070003, 67세,2021,2570,1312,1258,104.3,2524,1288,1236,104.2
31103, 일산동구,070004, 68세,2021,2206,1131,1075,105.2,2172,1122,1050,106.9
31103, 일산동구,070005, 69세,2021,2222,1064,1158,91.9,2193,1056,1137,92.9
31103, 일산동구,075,70~74세,2021,8550,3803,4747,80.1,8465,3763,4702,80
31103, 일산동구,075001, 70세,2021,1466,706,760,92.9,1442,693,749,92.5
31103, 일산동구,075002, 71세,2021,1809,834,975,85.5,1788,821,967,84.9
31103, 일산동구,075003, 72세,2021,1726,758,968,78.3,1707,750,957,78.4
31103, 일산동구,075004, 73세,2021,1733,734,999,73.5,1723,732,991,73.9
31103, 일산동구,075005, 74세,2021,1816,771,1045,73.8,1805,767,1038,73.9
31103, 일산동구,080,75~79세,2021,7302,3007,4295,70,7263,2992,4271,70.1
31103, 일산동구,080001, 75세,2021,1411,595,816,72.9,1396,588,808,72.8
31103, 일산동구,080002, 76세,2021,1306,555,751,73.9,1301,554,747,74.2
31103, 일산동구,080003, 77세,2021,1481,593,888,66.8,1473,590,883,66.8
31103, 일산동구,080004, 78세,2021,1451,602,849,70.9,1446,599,847,70.7
31103, 일산동구,080005, 79세,2021,1653,662,991,66.8,1647,661,986,67
31103, 일산동구,085,80~84세,2021,6281,2337,3944,59.3,6266,2333,3933,59.3
31103, 일산동구,085001, 80세,2021,1399,545,854,63.8,1397,545,852,64
31103, 일산동구,085002, 81세,2021,1360,517,843,61.3,1356,515,841,61.2
31103, 일산동구,085003, 82세,2021,1257,444,813,54.6,1255,444,811,54.7
31103, 일산동구,085004, 83세,2021,1173,434,739,58.7,1168,433,735,58.9
31103, 일산동구,085005, 84세,2021,1092,397,695,57.1,1090,396,694,57.1
31103, 일산동구,090,85~89세,2021,3847,1230,2617,47,3829,1227,2602,47.2
31103, 일산동구,090001, 85세,2021,997,357,640,55.8,991,356,635,56.1
31103, 일산동구,090002, 86세,2021,923,290,633,45.8,920,290,630,46
31103, 일산동구,090003, 87세,2021,787,240,547,43.9,784,240,544,44.1
31103, 일산동구,090004, 88세,2021,614,185,429,43.1,612,184,428,43
31103, 일산동구,090005, 89세,2021,526,158,368,42.9,522,157,365,43
31103, 일산동구,095,90~94세,2021,1386,338,1048,32.3,1383,338,1045,32.3
31103, 일산동구,095001, 90세,2021,383,101,282,35.8,382,101,281,35.9
31103, 일산동구,095002, 91세,2021,355,85,270,31.5,354,85,269,31.6
31103, 일산동구,095003, 92세,2021,291,78,213,36.6,291,78,213,36.6
31103, 일산동구,095004, 93세,2021,222,44,178,24.7,221,44,177,24.9
31103, 일산동구,095005, 94세,2021,135,30,105,28.6,135,30,105,28.6
31103, 일산동구,100,95~99세,2021,321,71,250,28.4,318,71,247,28.7
31103, 일산동구,100001, 95세,2021,98,19,79,24.1,98,19,79,24.1
31103, 일산동구,100002, 96세,2021,92,14,78,17.9,92,14,78,17.9
31103, 일산동구,100003, 97세,2021,47,12,35,34.3,47,12,35,34.3
31103, 일산동구,100004, 98세,2021,53,18,35,51.4,52,18,34,52.9
31103, 일산동구,100005, 99세,2021,31,8,23,34.8,29,8,21,38.1
31103, 일산동구,101,100세이상,2021,39,9,30,30,39,9,30,30
31103, 일산동구,102,15세미만,2021,32906,16948,15958,106.2,32601,16797,15804,106.3
31103, 일산동구,103,15~64세,2021,218905,107586,111319,96.6,213615,104710,108905,96.1
31103, 일산동구,104,65세이상,2021,41203,17593,23610,74.5,40829,17443,23386,74.6
31103, 일산동구,086,85세이상,2021,5593,1648,3945,41.8,5569,1645,3924,41.9
31103, 일산동구,126,평균연령,2021,43.1,42,44.1,,43.1,42.1,44.1,
31103, 일산동구,127,중위연령,2021,44.8,43.6,45.7,,45,43.9,45.9,
31104, 일산서구,000,합계,2021,287743,139490,148253,94.1,282872,137165,145707,94.1
31104, 일산서구,005,0~4세,2021,8224,4151,4073,101.9,8117,4106,4011,102.4
31104, 일산서구,005001, 0세,2021,1423,702,721,97.4,1409,697,712,97.9
31104, 일산서구,005002, 1세,2021,1421,706,715,98.7,1399,698,701,99.6
31104, 일산서구,005003, 2세,2021,1637,845,792,106.7,1618,837,781,107.2
31104, 일산서구,005004, 3세,2021,1783,908,875,103.8,1757,896,861,104.1
31104, 일산서구,005005, 4세,2021,1960,990,970,102.1,1934,978,956,102.3
31104, 일산서구,010,5~9세,2021,12644,6409,6235,102.8,12522,6356,6166,103.1
31104, 일산서구,010001, 5세,2021,2309,1159,1150,100.8,2275,1147,1128,101.7
31104, 일산서구,010002, 6세,2021,2479,1278,1201,106.4,2453,1264,1189,106.3
31104, 일산서구,010003, 7세,2021,2363,1242,1121,110.8,2340,1235,1105,111.8
31104, 일산서구,010004, 8세,2021,2590,1278,1312,97.4,2573,1269,1304,97.3
31104, 일산서구,010005, 9세,2021,2903,1452,1451,100.1,2881,1441,1440,100.1
31104, 일산서구,015,10~14세,2021,15182,7733,7449,103.8,15117,7696,7421,103.7
31104, 일산서구,015001, 10세,2021,2873,1483,1390,106.7,2861,1479,1382,107
31104, 일산서구,015002, 11세,2021,2985,1517,1468,103.3,2970,1510,1460,103.4
31104, 일산서구,015003, 12세,2021,2858,1470,1388,105.9,2844,1463,1381,105.9
31104, 일산서구,015004, 13세,2021,3222,1592,1630,97.7,3209,1580,1629,97
31104, 일산서구,015005, 14세,2021,3244,1671,1573,106.2,3233,1664,1569,106.1
31104, 일산서구,020,15~19세,2021,15439,7867,7572,103.9,15396,7841,7555,103.8
31104, 일산서구,020001, 15세,2021,3018,1533,1485,103.2,3012,1529,1483,103.1
31104, 일산서구,020002, 16세,2021,3044,1538,1506,102.1,3033,1532,1501,102.1
31104, 일산서구,020003, 17세,2021,3366,1701,1665,102.2,3355,1697,1658,102.4
31104, 일산서구,020004, 18세,2021,3130,1629,1501,108.5,3125,1625,1500,108.3
31104, 일산서구,020005, 19세,2021,2881,1466,1415,103.6,2871,1458,1413,103.2
31104, 일산서구,025,20~24세,2021,17828,9274,8554,108.4,17661,9206,8455,108.9
31104, 일산서구,025001, 20세,2021,3256,1738,1518,114.5,3246,1735,1511,114.8
31104, 일산서구,025002, 21세,2021,3798,2116,1682,125.8,3776,2112,1664,126.9
31104, 일산서구,025003, 22세,2021,3437,1774,1663,106.7,3403,1762,1641,107.4
31104, 일산서구,025004, 23세,2021,3596,1828,1768,103.4,3556,1814,1742,104.1
31104, 일산서구,025005, 24세,2021,3741,1818,1923,94.5,3680,1783,1897,94
31104, 일산서구,030,25~29세,2021,19262,9772,9490,103,18842,9559,9283,103
31104, 일산서구,030001, 25세,2021,3892,2018,1874,107.7,3840,1996,1844,108.2
31104, 일산서구,030002, 26세,2021,3916,1972,1944,101.4,3825,1919,1906,100.7
31104, 일산서구,030003, 27세,2021,3927,2023,1904,106.3,3845,1976,1869,105.7
31104, 일산서구,030004, 28세,2021,3764,1914,1850,103.5,3670,1871,1799,104
31104, 일산서구,030005, 29세,2021,3763,1845,1918,96.2,3662,1797,1865,96.4
31104, 일산서구,035,30~34세,2021,16552,8293,8259,100.4,15928,7984,7944,100.5
31104, 일산서구,035001, 30세,2021,3625,1832,1793,102.2,3503,1773,1730,102.5
31104, 일산서구,035002, 31세,2021,3345,1691,1654,102.2,3221,1630,1591,102.5
31104, 일산서구,035003, 32세,2021,3241,1610,1631,98.7,3123,1547,1576,98.2
31104, 일산서구,035004, 33세,2021,3189,1586,1603,98.9,3055,1525,1530,99.7
31104, 일산서구,035005, 34세,2021,3152,1574,1578,99.7,3026,1509,1517,99.5
31104, 일산서구,040,35~39세,2021,18076,8787,9289,94.6,17485,8494,8991,94.5
31104, 일산서구,040001, 35세,2021,3164,1529,1635,93.5,3033,1469,1564,93.9
31104, 일산서구,040002, 36세,2021,3341,1631,1710,95.4,3210,1568,1642,95.5
31104, 일산서구,040003, 37세,2021,3512,1731,1781,97.2,3410,1679,1731,97
31104, 일산서구,040004, 38세,2021,3893,1894,1999,94.7,3786,1833,1953,93.9
31104, 일산서구,040005, 39세,2021,4166,2002,2164,92.5,4046,1945,2101,92.6
31104, 일산서구,045,40~44세,2021,21858,10279,11579,88.8,21359,10025,11334,88.5
31104, 일산서구,045001, 40세,2021,4335,2031,2304,88.2,4226,1982,2244,88.3
31104, 일산서구,045002, 41세,2021,4442,2086,2356,88.5,4334,2033,2301,88.4
31104, 일산서구,045003, 42세,2021,4451,2087,2364,88.3,4353,2037,2316,88
31104, 일산서구,045004, 43세,2021,4123,1959,2164,90.5,4041,1914,2127,90
31104, 일산서구,045005, 44세,2021,4507,2116,2391,88.5,4405,2059,2346,87.8
31104, 일산서구,050,45~49세,2021,26734,12530,14204,88.2,26330,12318,14012,87.9
31104, 일산서구,050001, 45세,2021,4434,2060,2374,86.8,4353,2021,2332,86.7
31104, 일산서구,050002, 46세,2021,4893,2293,2600,88.2,4825,2258,2567,88
31104, 일산서구,050003, 47세,2021,5498,2628,2870,91.6,5425,2590,2835,91.4
31104, 일산서구,050004, 48세,2021,5771,2711,3060,88.6,5673,2658,3015,88.2
31104, 일산서구,050005, 49세,2021,6138,2838,3300,86,6054,2791,3263,85.5
31104, 일산서구,055,50~54세,2021,29965,14303,15662,91.3,29522,14083,15439,91.2
31104, 일산서구,055001, 50세,2021,6361,3016,3345,90.2,6279,2973,3306,89.9
31104, 일산서구,055002, 51세,2021,6208,2945,3263,90.3,6115,2894,3221,89.8
31104, 일산서구,055003, 52세,2021,6098,2958,3140,94.2,6009,2916,3093,94.3
31104, 일산서구,055004, 53세,2021,5936,2820,3116,90.5,5833,2765,3068,90.1
31104, 일산서구,055005, 54세,2021,5362,2564,2798,91.6,5286,2535,2751,92.1
31104, 일산서구,060,55~59세,2021,25211,12357,12854,96.1,24702,12140,12562,96.6
31104, 일산서구,060001, 55세,2021,5073,2500,2573,97.2,4972,2460,2512,97.9
31104, 일산서구,060002, 56세,2021,5300,2527,2773,91.1,5212,2487,2725,91.3
31104, 일산서구,060003, 57세,2021,4878,2355,2523,93.3,4780,2308,2472,93.4
31104, 일산서구,060004, 58세,2021,5035,2532,2503,101.2,4906,2475,2431,101.8
31104, 일산서구,060005, 59세,2021,4925,2443,2482,98.4,4832,2410,2422,99.5
31104, 일산서구,065,60~64세,2021,21348,10900,10448,104.3,20896,10695,10201,104.8
31104, 일산서구,065001, 60세,2021,4959,2495,2464,101.3,4885,2461,2424,101.5
31104, 일산서구,065002, 61세,2021,4771,2412,2359,102.2,4670,2378,2292,103.8
31104, 일산서구,065003, 62세,2021,4217,2143,2074,103.3,4137,2104,2033,103.5
31104, 일산서구,065004, 63세,2021,3719,1913,1806,105.9,3618,1865,1753,106.4
31104, 일산서구,065005, 64세,2021,3682,1937,1745,111,3586,1887,1699,111.1
31104, 일산서구,070,65~69세,2021,12756,6359,6397,99.4,12506,6243,6263,99.7
31104, 일산서구,070001, 65세,2021,3150,1622,1528,106.2,3074,1586,1488,106.6
31104, 일산서구,070002, 66세,2021,3087,1570,1517,103.5,3035,1546,1489,103.8
31104, 일산서구,070003, 67세,2021,2357,1176,1181,99.6,2312,1157,1155,100.2
31104, 일산서구,070004, 68세,2021,2040,955,1085,88,1993,936,1057,88.6
31104, 일산서구,070005, 69세,2021,2122,1036,1086,95.4,2092,1018,1074,94.8
31104, 일산서구,075,70~74세,2021,8229,3602,4627,77.8,8137,3567,4570,78.1
31104, 일산서구,075001, 70세,2021,1397,654,743,88,1377,648,729,88.9
31104, 일산서구,075002, 71세,2021,1605,674,931,72.4,1580,661,919,71.9
31104, 일산서구,075003, 72세,2021,1690,762,928,82.1,1674,760,914,83.2
31104, 일산서구,075004, 73세,2021,1735,749,986,76,1720,744,976,76.2
31104, 일산서구,075005, 74세,2021,1802,763,1039,73.4,1786,754,1032,73.1
31104, 일산서구,080,75~79세,2021,7375,2994,4381,68.3,7330,2980,4350,68.5
31104, 일산서구,080001, 75세,2021,1455,599,856,70,1445,596,849,70.2
31104, 일산서구,080002, 76세,2021,1430,590,840,70.2,1420,586,834,70.3
31104, 일산서구,080003, 77세,2021,1358,544,814,66.8,1349,543,806,67.4
31104, 일산서구,080004, 78세,2021,1466,579,887,65.3,1462,577,885,65.2
31104, 일산서구,080005, 79세,2021,1666,682,984,69.3,1654,678,976,69.5
31104, 일산서구,085,80~84세,2021,6266,2299,3967,58,6245,2294,3951,58.1
31104, 일산서구,085001, 80세,2021,1462,554,908,61,1456,553,903,61.2
31104, 일산서구,085002, 81세,2021,1269,459,810,56.7,1266,458,808,56.7
31104, 일산서구,085003, 82세,2021,1295,490,805,60.9,1291,489,802,61
31104, 일산서구,085004, 83세,2021,1196,433,763,56.7,1192,432,760,56.8
31104, 일산서구,085005, 84세,2021,1044,363,681,53.3,1040,362,678,53.4
31104, 일산서구,090,85~89세,2021,3379,1203,2176,55.3,3365,1200,2165,55.4
31104, 일산서구,090001, 85세,2021,966,360,606,59.4,962,358,604,59.3
31104, 일산서구,090002, 86세,2021,830,295,535,55.1,826,294,532,55.3
31104, 일산서구,090003, 87세,2021,626,220,406,54.2,625,220,405,54.3
31104, 일산서구,090004, 88세,2021,507,173,334,51.8,507,173,334,51.8
31104, 일산서구,090005, 89세,2021,450,155,295,52.5,445,155,290,53.4
31104, 일산서구,095,90~94세,2021,1173,331,842,39.3,1171,331,840,39.4
31104, 일산서구,095001, 90세,2021,364,108,256,42.2,363,108,255,42.4
31104, 일산서구,095002, 91세,2021,301,90,211,42.7,301,90,211,42.7
31104, 일산서구,095003, 92세,2021,228,64,164,39,227,64,163,39.3
31104, 일산서구,095004, 93세,2021,166,38,128,29.7,166,38,128,29.7
31104, 일산서구,095005, 94세,2021,114,31,83,37.3,114,31,83,37.3
31104, 일산서구,100,95~99세,2021,206,41,165,24.8,205,41,164,25
31104, 일산서구,100001, 95세,2021,63,11,52,21.2,63,11,52,21.2
31104, 일산서구,100002, 96세,2021,53,7,46,15.2,53,7,46,15.2
31104, 일산서구,100003, 97세,2021,37,6,31,19.4,37,6,31,19.4
31104, 일산서구,100004, 98세,2021,31,11,20,55,30,11,19,57.9
31104, 일산서구,100005, 99세,2021,22,6,16,37.5,22,6,16,37.5
31104, 일산서구,101,100세이상,2021,36,6,30,20,36,6,30,20
31104, 일산서구,102,15세미만,2021,36050,18293,17757,103,35756,18158,17598,103.2
31104, 일산서구,103,15~64세,2021,212273,104362,107911,96.7,208121,102345,105776,96.8
31104, 일산서구,104,65세이상,2021,39420,16835,22585,74.5,38995,16662,22333,74.6
31104, 일산서구,086,85세이상,2021,4794,1581,3213,49.2,4777,1578,3199,49.3
31104, 일산서구,126,평균연령,2021,42.6,41.5,43.5,,42.6,41.5,43.5,
31104, 일산서구,127,중위연령,2021,44.7,43.6,45.7,,44.8,43.7,45.7,
31110, 과천시,000,합계,2021,65880,32483,33397,97.3,65497,32286,33211,97.2
31110, 과천시,005,0~4세,2021,2535,1345,1190,113,2527,1339,1188,112.7
31110, 과천시,005001, 0세,2021,495,271,224,121,494,271,223,121.5
31110, 과천시,005002, 1세,2021,468,225,243,92.6,468,225,243,92.6
31110, 과천시,005003, 2세,2021,462,244,218,111.9,460,242,218,111
31110, 과천시,005004, 3세,2021,542,290,252,115.1,541,289,252,114.7
31110, 과천시,005005, 4세,2021,568,315,253,124.5,564,312,252,123.8
31110, 과천시,010,5~9세,2021,3260,1693,1567,108,3254,1688,1566,107.8
31110, 과천시,010001, 5세,2021,635,329,306,107.5,633,328,305,107.5
31110, 과천시,010002, 6세,2021,648,335,313,107,646,333,313,106.4
31110, 과천시,010003, 7세,2021,690,362,328,110.4,690,362,328,110.4
31110, 과천시,010004, 8세,2021,599,311,288,108,598,310,288,107.6
31110, 과천시,010005, 9세,2021,688,356,332,107.2,687,355,332,106.9
31110, 과천시,015,10~14세,2021,3192,1635,1557,105,3189,1632,1557,104.8
31110, 과천시,015001, 10세,2021,669,342,327,104.6,669,342,327,104.6
31110, 과천시,015002, 11세,2021,611,325,286,113.6,610,324,286,113.3
31110, 과천시,015003, 12세,2021,636,320,316,101.3,635,319,316,100.9
31110, 과천시,015004, 13세,2021,636,319,317,100.6,636,319,317,100.6
31110, 과천시,015005, 14세,2021,640,329,311,105.8,639,328,311,105.5
31110, 과천시,020,15~19세,2021,2998,1531,1467,104.4,2996,1529,1467,104.2
31110, 과천시,020001, 15세,2021,595,291,304,95.7,594,290,304,95.4
31110, 과천시,020002, 16세,2021,566,299,267,112,566,299,267,112
31110, 과천시,020003, 17세,2021,602,335,267,125.5,601,334,267,125.1
31110, 과천시,020004, 18세,2021,612,310,302,102.6,612,310,302,102.6
31110, 과천시,020005, 19세,2021,623,296,327,90.5,623,296,327,90.5
31110, 과천시,025,20~24세,2021,3976,2155,1821,118.3,3958,2148,1810,118.7
31110, 과천시,025001, 20세,2021,715,394,321,122.7,713,394,319,123.5
31110, 과천시,025002, 21세,2021,795,421,374,112.6,794,421,373,112.9
31110, 과천시,025003, 22세,2021,758,420,338,124.3,756,419,337,124.3
31110, 과천시,025004, 23세,2021,835,432,403,107.2,829,430,399,107.8
31110, 과천시,025005, 24세,2021,873,488,385,126.8,866,484,382,126.7
31110, 과천시,030,25~29세,2021,4405,2269,2136,106.2,4360,2243,2117,106
31110, 과천시,030001, 25세,2021,890,454,436,104.1,885,450,435,103.4
31110, 과천시,030002, 26세,2021,856,449,407,110.3,849,445,404,110.1
31110, 과천시,030003, 27세,2021,840,433,407,106.4,832,426,406,104.9
31110, 과천시,030004, 28세,2021,920,475,445,106.7,907,468,439,106.6
31110, 과천시,030005, 29세,2021,899,458,441,103.9,887,454,433,104.8
31110, 과천시,035,30~34세,2021,4511,2274,2237,101.7,4453,2243,2210,101.5
31110, 과천시,035001, 30세,2021,957,474,483,98.1,946,470,476,98.7
31110, 과천시,035002, 31세,2021,885,470,415,113.3,875,465,410,113.4
31110, 과천시,035003, 32세,2021,868,443,425,104.2,859,439,420,104.5
31110, 과천시,035004, 33세,2021,889,457,432,105.8,878,451,427,105.6
31110, 과천시,035005, 34세,2021,912,430,482,89.2,895,418,477,87.6
31110, 과천시,040,35~39세,2021,4863,2448,2415,101.4,4819,2420,2399,100.9
31110, 과천시,040001, 35세,2021,905,483,422,114.5,895,476,419,113.6
31110, 과천시,040002, 36세,2021,897,444,453,98,887,436,451,96.7
31110, 과천시,040003, 37세,2021,996,515,481,107.1,984,507,477,106.3
31110, 과천시,040004, 38세,2021,1031,505,526,96,1024,501,523,95.8
31110, 과천시,040005, 39세,2021,1034,501,533,94,1029,500,529,94.5
31110, 과천시,045,40~44세,2021,4787,2389,2398,99.6,4759,2372,2387,99.4
31110, 과천시,045001, 40세,2021,1032,533,499,106.8,1028,532,496,107.3
31110, 과천시,045002, 41세,2021,1019,505,514,98.2,1015,501,514,97.5
31110, 과천시,045003, 42세,2021,958,491,467,105.1,954,488,466,104.7
31110, 과천시,045004, 43세,2021,883,426,457,93.2,875,422,453,93.2
31110, 과천시,045005, 44세,2021,895,434,461,94.1,887,429,458,93.7
31110, 과천시,050,45~49세,2021,5055,2453,2602,94.3,5022,2436,2586,94.2
31110, 과천시,050001, 45세,2021,923,437,486,89.9,918,435,483,90.1
31110, 과천시,050002, 46세,2021,908,424,484,87.6,900,420,480,87.5
31110, 과천시,050003, 47세,2021,1017,512,505,101.4,1013,510,503,101.4
31110, 과천시,050004, 48세,2021,1065,526,539,97.6,1054,519,535,97
31110, 과천시,050005, 49세,2021,1142,554,588,94.2,1137,552,585,94.4
31110, 과천시,055,50~54세,2021,6114,2835,3279,86.5,6078,2820,3258,86.6
31110, 과천시,055001, 50세,2021,1277,610,667,91.5,1270,605,665,91
31110, 과천시,055002, 51세,2021,1218,556,662,84,1213,553,660,83.8
31110, 과천시,055003, 52세,2021,1247,580,667,87,1239,578,661,87.4
31110, 과천시,055004, 53세,2021,1241,565,676,83.6,1234,563,671,83.9
31110, 과천시,055005, 54세,2021,1131,524,607,86.3,1122,521,601,86.7
31110, 과천시,060,55~59세,2021,5638,2781,2857,97.3,5607,2769,2838,97.6
31110, 과천시,060001, 55세,2021,1136,548,588,93.2,1130,544,586,92.8
31110, 과천시,060002, 56세,2021,1167,564,603,93.5,1159,560,599,93.5
31110, 과천시,060003, 57세,2021,1064,530,534,99.3,1056,528,528,100
31110, 과천시,060004, 58세,2021,1176,590,586,100.7,1169,589,580,101.6
31110, 과천시,060005, 59세,2021,1095,549,546,100.5,1093,548,545,100.6
31110, 과천시,065,60~64세,2021,5118,2494,2624,95,5081,2481,2600,95.4
31110, 과천시,065001, 60세,2021,1164,574,590,97.3,1156,572,584,97.9
31110, 과천시,065002, 61세,2021,1121,506,615,82.3,1109,501,608,82.4
31110, 과천시,065003, 62세,2021,976,467,509,91.7,970,467,503,92.8
31110, 과천시,065004, 63세,2021,964,497,467,106.4,958,492,466,105.6
31110, 과천시,065005, 64세,2021,893,450,443,101.6,888,449,439,102.3
31110, 과천시,070,65~69세,2021,3387,1667,1720,96.9,3370,1661,1709,97.2
31110, 과천시,070001, 65세,2021,823,397,426,93.2,814,394,420,93.8
31110, 과천시,070002, 66세,2021,789,394,395,99.7,786,394,392,100.5
31110, 과천시,070003, 67세,2021,644,309,335,92.2,641,308,333,92.5
31110, 과천시,070004, 68세,2021,584,303,281,107.8,583,302,281,107.5
31110, 과천시,070005, 69세,2021,547,264,283,93.3,546,263,283,92.9
31110, 과천시,075,70~74세,2021,2150,986,1164,84.7,2142,982,1160,84.7
31110, 과천시,075001, 70세,2021,403,180,223,80.7,402,180,222,81.1
31110, 과천시,075002, 71세,2021,468,223,245,91,466,222,244,91
31110, 과천시,075003, 72세,2021,442,205,237,86.5,440,204,236,86.4
31110, 과천시,075004, 73세,2021,421,198,223,88.8,419,196,223,87.9
31110, 과천시,075005, 74세,2021,416,180,236,76.3,415,180,235,76.6
31110, 과천시,080,75~79세,2021,1649,716,933,76.7,1645,714,931,76.7
31110, 과천시,080001, 75세,2021,346,155,191,81.2,345,155,190,81.6
31110, 과천시,080002, 76세,2021,308,145,163,89,307,144,163,88.3
31110, 과천시,080003, 77세,2021,314,119,195,61,313,118,195,60.5
31110, 과천시,080004, 78세,2021,337,154,183,84.2,337,154,183,84.2
31110, 과천시,080005, 79세,2021,344,143,201,71.1,343,143,200,71.5
31110, 과천시,085,80~84세,2021,1215,490,725,67.6,1213,489,724,67.5
31110, 과천시,085001, 80세,2021,267,108,159,67.9,266,108,158,68.4
31110, 과천시,085002, 81세,2021,262,112,150,74.7,262,112,150,74.7
31110, 과천시,085003, 82세,2021,253,102,151,67.5,253,102,151,67.5
31110, 과천시,085004, 83세,2021,226,94,132,71.2,225,93,132,70.5
31110, 과천시,085005, 84세,2021,207,74,133,55.6,207,74,133,55.6
31110, 과천시,090,85~89세,2021,700,241,459,52.5,699,240,459,52.3
31110, 과천시,090001, 85세,2021,176,62,114,54.4,176,62,114,54.4
31110, 과천시,090002, 86세,2021,180,71,109,65.1,180,71,109,65.1
31110, 과천시,090003, 87세,2021,133,41,92,44.6,133,41,92,44.6
31110, 과천시,090004, 88세,2021,110,31,79,39.2,110,31,79,39.2
31110, 과천시,090005, 89세,2021,101,36,65,55.4,100,35,65,53.8
31110, 과천시,095,90~94세,2021,258,66,192,34.4,257,66,191,34.6
31110, 과천시,095001, 90세,2021,63,14,49,28.6,63,14,49,28.6
31110, 과천시,095002, 91세,2021,70,24,46,52.2,69,24,45,53.3
31110, 과천시,095003, 92세,2021,52,15,37,40.5,52,15,37,40.5
31110, 과천시,095004, 93세,2021,47,10,37,27,47,10,37,27
31110, 과천시,095005, 94세,2021,26,X,23,13,26,X,23,13
31110, 과천시,100,95~99세,2021,63,12,51,23.5,62,11,51,21.6
31110, 과천시,100001, 95세,2021,19,X,15,26.7,19,X,15,26.7
31110, 과천시,100002, 96세,2021,18,X,17,5.9,18,X,17,5.9
31110, 과천시,100003, 97세,2021,10,X,7,42.9,9,X,7,28.6
31110, 과천시,100004, 98세,2021,13,X,10,30,13,X,10,30
31110, 과천시,100005, 99세,2021,X,X,X,50,X,X,X,50
31110, 과천시,101,100세이상,2021,6,X,X,100,6,X,X,100
31110, 과천시,102,15세미만,2021,8987,4673,4314,108.3,8970,4659,4311,108.1
31110, 과천시,103,15~64세,2021,47465,23629,23836,99.1,47133,23461,23672,99.1
31110, 과천시,104,65세이상,2021,9428,4181,5247,79.7,9394,4166,5228,79.7
31110, 과천시,086,85세이상,2021,1027,322,705,45.7,1024,320,704,45.5
31110, 과천시,126,평균연령,2021,42.1,41,43.2,,42.1,41,43.2,
31110, 과천시,127,중위연령,2021,43.2,41.7,44.8,,43.2,41.7,44.8,
31120, 구리시,000,합계,2021,187798,92886,94912,97.9,185784,91939,93845,98
31120, 구리시,005,0~4세,2021,5778,2971,2807,105.8,5742,2953,2789,105.9
31120, 구리시,005001, 0세,2021,976,495,481,102.9,973,493,480,102.7
31120, 구리시,005002, 1세,2021,1046,545,501,108.8,1040,541,499,108.4
31120, 구리시,005003, 2세,2021,1141,574,567,101.2,1134,573,561,102.1
31120, 구리시,005004, 3세,2021,1258,653,605,107.9,1246,645,601,107.3
31120, 구리시,005005, 4세,2021,1357,704,653,107.8,1349,701,648,108.2
31120, 구리시,010,5~9세,2021,8200,4245,3955,107.3,8173,4232,3941,107.4
31120, 구리시,010001, 5세,2021,1550,796,754,105.6,1541,791,750,105.5
31120, 구리시,010002, 6세,2021,1613,821,792,103.7,1607,817,790,103.4
31120, 구리시,010003, 7세,2021,1656,884,772,114.5,1652,883,769,114.8
31120, 구리시,010004, 8세,2021,1655,868,787,110.3,1652,866,786,110.2
31120, 구리시,010005, 9세,2021,1726,876,850,103.1,1721,875,846,103.4
31120, 구리시,015,10~14세,2021,8290,4243,4047,104.8,8273,4236,4037,104.9
31120, 구리시,015001, 10세,2021,1697,861,836,103,1695,861,834,103.2
31120, 구리시,015002, 11세,2021,1643,836,807,103.6,1637,834,803,103.9
31120, 구리시,015003, 12세,2021,1575,812,763,106.4,1572,810,762,106.3
31120, 구리시,015004, 13세,2021,1609,829,780,106.3,1607,828,779,106.3
31120, 구리시,015005, 14세,2021,1766,905,861,105.1,1762,903,859,105.1
31120, 구리시,020,15~19세,2021,8271,4270,4001,106.7,8251,4261,3990,106.8
31120, 구리시,020001, 15세,2021,1662,908,754,120.4,1657,907,750,120.9
31120, 구리시,020002, 16세,2021,1563,838,725,115.6,1561,838,723,115.9
31120, 구리시,020003, 17세,2021,1708,859,849,101.2,1706,857,849,100.9
31120, 구리시,020004, 18세,2021,1707,849,858,99,1705,847,858,98.7
31120, 구리시,020005, 19세,2021,1631,816,815,100.1,1622,812,810,100.2
31120, 구리시,025,20~24세,2021,11324,5764,5560,103.7,11206,5711,5495,103.9
31120, 구리시,025001, 20세,2021,1960,1003,957,104.8,1949,1001,948,105.6
31120, 구리시,025002, 21세,2021,2297,1231,1066,115.5,2287,1229,1058,116.2
31120, 구리시,025003, 22세,2021,2181,1100,1081,101.8,2158,1089,1069,101.9
31120, 구리시,025004, 23세,2021,2375,1176,1199,98.1,2340,1159,1181,98.1
31120, 구리시,025005, 24세,2021,2511,1254,1257,99.8,2472,1233,1239,99.5
31120, 구리시,030,25~29세,2021,13514,6977,6537,106.7,13211,6807,6404,106.3
31120, 구리시,030001, 25세,2021,2673,1332,1341,99.3,2621,1307,1314,99.5
31120, 구리시,030002, 26세,2021,2716,1428,1288,110.9,2660,1392,1268,109.8
31120, 구리시,030003, 27세,2021,2761,1452,1309,110.9,2703,1422,1281,111
31120, 구리시,030004, 28세,2021,2687,1371,1316,104.2,2617,1332,1285,103.7
31120, 구리시,030005, 29세,2021,2677,1394,1283,108.7,2610,1354,1256,107.8
31120, 구리시,035,30~34세,2021,11603,5861,5742,102.1,11297,5695,5602,101.7
31120, 구리시,035001, 30세,2021,2476,1236,1240,99.7,2403,1197,1206,99.3
31120, 구리시,035002, 31세,2021,2423,1200,1223,98.1,2366,1170,1196,97.8
31120, 구리시,035003, 32세,2021,2248,1125,1123,100.2,2193,1097,1096,100.1
31120, 구리시,035004, 33세,2021,2190,1136,1054,107.8,2122,1103,1019,108.2
31120, 구리시,035005, 34세,2021,2266,1164,1102,105.6,2213,1128,1085,104
31120, 구리시,040,35~39세,2021,13258,6712,6546,102.5,13021,6586,6435,102.3
31120, 구리시,040001, 35세,2021,2337,1186,1151,103,2285,1159,1126,102.9
31120, 구리시,040002, 36세,2021,2405,1183,1222,96.8,2365,1162,1203,96.6
31120, 구리시,040003, 37세,2021,2575,1316,1259,104.5,2527,1289,1238,104.1
31120, 구리시,040004, 38세,2021,2820,1440,1380,104.3,2760,1409,1351,104.3
31120, 구리시,040005, 39세,2021,3121,1587,1534,103.5,3084,1567,1517,103.3
31120, 구리시,045,40~44세,2021,15017,7614,7403,102.9,14847,7540,7307,103.2
31120, 구리시,045001, 40세,2021,3166,1629,1537,106,3133,1610,1523,105.7
31120, 구리시,045002, 41세,2021,3235,1655,1580,104.7,3206,1639,1567,104.6
31120, 구리시,045003, 42세,2021,3041,1534,1507,101.8,3006,1524,1482,102.8
31120, 구리시,045004, 43세,2021,2705,1351,1354,99.8,2672,1337,1335,100.1
31120, 구리시,045005, 44세,2021,2870,1445,1425,101.4,2830,1430,1400,102.1
31120, 구리시,050,45~49세,2021,15780,7784,7996,97.3,15601,7696,7905,97.4
31120, 구리시,050001, 45세,2021,2842,1442,1400,103,2808,1425,1383,103
31120, 구리시,050002, 46세,2021,2993,1460,1533,95.2,2959,1445,1514,95.4
31120, 구리시,050003, 47세,2021,3189,1564,1625,96.2,3161,1548,1613,96
31120, 구리시,050004, 48세,2021,3335,1620,1715,94.5,3287,1599,1688,94.7
31120, 구리시,050005, 49세,2021,3421,1698,1723,98.5,3386,1679,1707,98.4
31120, 구리시,055,50~54세,2021,17701,8448,9253,91.3,17526,8377,9149,91.6
31120, 구리시,055001, 50세,2021,3569,1697,1872,90.7,3535,1684,1851,91
31120, 구리시,055002, 51세,2021,3587,1767,1820,97.1,3543,1741,1802,96.6
31120, 구리시,055003, 52세,2021,3630,1714,1916,89.5,3598,1702,1896,89.8
31120, 구리시,055004, 53세,2021,3722,1726,1996,86.5,3680,1711,1969,86.9
31120, 구리시,055005, 54세,2021,3193,1544,1649,93.6,3170,1539,1631,94.4
31120, 구리시,060,55~59세,2021,16365,8201,8164,100.5,16190,8141,8049,101.1
31120, 구리시,060001, 55세,2021,3362,1632,1730,94.3,3328,1617,1711,94.5
31120, 구리시,060002, 56세,2021,3318,1661,1657,100.2,3288,1650,1638,100.7
31120, 구리시,060003, 57세,2021,3116,1555,1561,99.6,3086,1546,1540,100.4
31120, 구리시,060004, 58세,2021,3241,1629,1612,101.1,3204,1620,1584,102.3
31120, 구리시,060005, 59세,2021,3328,1724,1604,107.5,3284,1708,1576,108.4
31120, 구리시,065,60~64세,2021,15294,7577,7717,98.2,15166,7533,7633,98.7
31120, 구리시,065001, 60세,2021,3570,1703,1867,91.2,3549,1699,1850,91.8
31120, 구리시,065002, 61세,2021,3406,1674,1732,96.7,3373,1660,1713,96.9
31120, 구리시,065003, 62세,2021,2951,1546,1405,110,2925,1541,1384,111.3
31120, 구리시,065004, 63세,2021,2758,1353,1405,96.3,2729,1344,1385,97
31120, 구리시,065005, 64세,2021,2609,1301,1308,99.5,2590,1289,1301,99.1
31120, 구리시,070,65~69세,2021,10121,4994,5127,97.4,10054,4969,5085,97.7
31120, 구리시,070001, 65세,2021,2320,1158,1162,99.7,2309,1153,1156,99.7
31120, 구리시,070002, 66세,2021,2359,1172,1187,98.7,2345,1168,1177,99.2
31120, 구리시,070003, 67세,2021,1898,937,961,97.5,1887,935,952,98.2
31120, 구리시,070004, 68세,2021,1671,824,847,97.3,1657,816,841,97
31120, 구리시,070005, 69세,2021,1873,903,970,93.1,1856,897,959,93.5
31120, 구리시,075,70~74세,2021,6423,2978,3445,86.4,6386,2961,3425,86.5
31120, 구리시,075001, 70세,2021,1206,584,622,93.9,1198,579,619,93.5
31120, 구리시,075002, 71세,2021,1301,614,687,89.4,1292,609,683,89.2
31120, 구리시,075003, 72세,2021,1265,594,671,88.5,1257,591,666,88.7
31120, 구리시,075004, 73세,2021,1342,621,721,86.1,1340,620,720,86.1
31120, 구리시,075005, 74세,2021,1309,565,744,75.9,1299,562,737,76.3
31120, 구리시,080,75~79세,2021,5002,2162,2840,76.1,4992,2157,2835,76.1
31120, 구리시,080001, 75세,2021,1024,445,579,76.9,1021,444,577,76.9
31120, 구리시,080002, 76세,2021,971,436,535,81.5,970,436,534,81.6
31120, 구리시,080003, 77세,2021,975,408,567,72,974,407,567,71.8
31120, 구리시,080004, 78세,2021,949,404,545,74.1,948,403,545,73.9
31120, 구리시,080005, 79세,2021,1083,469,614,76.4,1079,467,612,76.3
31120, 구리시,085,80~84세,2021,3509,1392,2117,65.8,3504,1392,2112,65.9
31120, 구리시,085001, 80세,2021,836,338,498,67.9,835,338,497,68
31120, 구리시,085002, 81세,2021,764,303,461,65.7,763,303,460,65.9
31120, 구리시,085003, 82세,2021,732,299,433,69.1,731,299,432,69.2
31120, 구리시,085004, 83세,2021,625,244,381,64,623,244,379,64.4
31120, 구리시,085005, 84세,2021,552,208,344,60.5,552,208,344,60.5
31120, 구리시,090,85~89세,2021,1665,524,1141,45.9,1662,523,1139,45.9
31120, 구리시,090001, 85세,2021,431,145,286,50.7,431,145,286,50.7
31120, 구리시,090002, 86세,2021,410,130,280,46.4,410,130,280,46.4
31120, 구리시,090003, 87세,2021,350,114,236,48.3,349,114,235,48.5
31120, 구리시,090004, 88세,2021,265,80,185,43.2,263,79,184,42.9
31120, 구리시,090005, 89세,2021,209,55,154,35.7,209,55,154,35.7
31120, 구리시,095,90~94세,2021,542,139,403,34.5,541,139,402,34.6
31120, 구리시,095001, 90세,2021,157,43,114,37.7,157,43,114,37.7
31120, 구리시,095002, 91세,2021,148,43,105,41,147,43,104,41.3
31120, 구리시,095003, 92세,2021,100,32,68,47.1,100,32,68,47.1
31120, 구리시,095004, 93세,2021,78,13,65,20,78,13,65,20
31120, 구리시,095005, 94세,2021,59,8,51,15.7,59,8,51,15.7
31120, 구리시,100,95~99세,2021,125,26,99,26.3,125,26,99,26.3
31120, 구리시,100001, 95세,2021,52,9,43,20.9,52,9,43,20.9
31120, 구리시,100002, 96세,2021,29,X,25,16,29,X,25,16
31120, 구리시,100003, 97세,2021,21,7,14,50,21,7,14,50
31120, 구리시,100004, 98세,2021,15,X,12,25,15,X,12,25
31120, 구리시,100005, 99세,2021,8,X,5,60,8,X,5,60
31120, 구리시,101,100세이상,2021,16,X,12,33.3,16,X,12,33.3
31120, 구리시,102,15세미만,2021,22268,11459,10809,106,22188,11421,10767,106.1
31120, 구리시,103,15~64세,2021,138127,69208,68919,100.4,136316,68347,67969,100.6
31120, 구리시,104,65세이상,2021,27403,12219,15184,80.5,27280,12171,15109,80.6
31120, 구리시,086,85세이상,2021,2348,693,1655,41.9,2344,692,1652,41.9
31120, 구리시,126,평균연령,2021,43,42.1,43.9,,43,42.1,43.9,
31120, 구리시,127,중위연령,2021,44.5,43.4,45.6,,44.6,43.5,45.7,
31130, 남양주시,000,합계,2021,713549,354670,358879,98.8,703281,348943,354338,98.5
31130, 남양주시,005,0~4세,2021,24525,12708,11817,107.5,24434,12657,11777,107.5
31130, 남양주시,005001, 0세,2021,3793,1947,1846,105.5,3780,1938,1842,105.2
31130, 남양주시,005002, 1세,2021,4333,2273,2060,110.3,4316,2262,2054,110.1
31130, 남양주시,005003, 2세,2021,4848,2536,2312,109.7,4830,2523,2307,109.4
31130, 남양주시,005004, 3세,2021,5489,2862,2627,108.9,5472,2853,2619,108.9
31130, 남양주시,005005, 4세,2021,6062,3090,2972,104,6036,3081,2955,104.3
31130, 남양주시,010,5~9세,2021,37919,19435,18484,105.1,37837,19394,18443,105.2
31130, 남양주시,010001, 5세,2021,7016,3643,3373,108,6997,3632,3365,107.9
31130, 남양주시,010002, 6세,2021,7421,3734,3687,101.3,7400,3726,3674,101.4
31130, 남양주시,010003, 7세,2021,7408,3797,3611,105.2,7390,3788,3602,105.2
31130, 남양주시,010004, 8세,2021,7698,3932,3766,104.4,7687,3926,3761,104.4
31130, 남양주시,010005, 9세,2021,8376,4329,4047,107,8363,4322,4041,107
31130, 남양주시,015,10~14세,2021,39655,20406,19249,106,39606,20385,19221,106.1
31130, 남양주시,015001, 10세,2021,8208,4209,3999,105.3,8202,4207,3995,105.3
31130, 남양주시,015002, 11세,2021,7821,4086,3735,109.4,7813,4083,3730,109.5
31130, 남양주시,015003, 12세,2021,7640,3879,3761,103.1,7631,3873,3758,103.1
31130, 남양주시,015004, 13세,2021,7934,4090,3844,106.4,7920,4085,3835,106.5
31130, 남양주시,015005, 14세,2021,8052,4142,3910,105.9,8040,4137,3903,106
31130, 남양주시,020,15~19세,2021,35116,17954,17162,104.6,34977,17915,17062,105
31130, 남양주시,020001, 15세,2021,7143,3675,3468,106,7131,3668,3463,105.9
31130, 남양주시,020002, 16세,2021,6863,3497,3366,103.9,6852,3493,3359,104
31130, 남양주시,020003, 17세,2021,7337,3787,3550,106.7,7320,3779,3541,106.7
31130, 남양주시,020004, 18세,2021,7051,3573,3478,102.7,6999,3560,3439,103.5
31130, 남양주시,020005, 19세,2021,6722,3422,3300,103.7,6675,3415,3260,104.8
31130, 남양주시,025,20~24세,2021,40255,20982,19273,108.9,39397,20536,18861,108.9
31130, 남양주시,025001, 20세,2021,7687,3995,3692,108.2,7602,3970,3632,109.3
31130, 남양주시,025002, 21세,2021,8189,4474,3715,120.4,8107,4443,3664,121.3
31130, 남양주시,025003, 22세,2021,7814,4056,3758,107.9,7655,3969,3686,107.7
31130, 남양주시,025004, 23세,2021,8076,4145,3931,105.4,7844,4020,3824,105.1
31130, 남양주시,025005, 24세,2021,8489,4312,4177,103.2,8189,4134,4055,101.9
31130, 남양주시,030,25~29세,2021,42448,22334,20114,111,40703,21188,19515,108.6
31130, 남양주시,030001, 25세,2021,8572,4471,4101,109,8285,4275,4010,106.6
31130, 남양주시,030002, 26세,2021,8741,4647,4094,113.5,8367,4405,3962,111.2
31130, 남양주시,030003, 27세,2021,8407,4425,3982,111.1,8028,4185,3843,108.9
31130, 남양주시,030004, 28세,2021,8262,4354,3908,111.4,7898,4116,3782,108.8
31130, 남양주시,030005, 29세,2021,8466,4437,4029,110.1,8125,4207,3918,107.4
31130, 남양주시,035,30~34세,2021,38401,19600,18801,104.2,36596,18446,18150,101.6
31130, 남양주시,035001, 30세,2021,7905,4072,3833,106.2,7532,3838,3694,103.9
31130, 남양주시,035002, 31세,2021,7593,3923,3670,106.9,7233,3687,3546,104
31130, 남양주시,035003, 32세,2021,7402,3763,3639,103.4,7031,3537,3494,101.2
31130, 남양주시,035004, 33세,2021,7807,3992,3815,104.6,7413,3740,3673,101.8
31130, 남양주시,035005, 34세,2021,7694,3850,3844,100.2,7387,3644,3743,97.4
31130, 남양주시,040,35~39세,2021,50769,24853,25916,95.9,49180,23941,25239,94.9
31130, 남양주시,040001, 35세,2021,8352,4077,4275,95.4,8000,3872,4128,93.8
31130, 남양주시,040002, 36세,2021,8981,4384,4597,95.4,8625,4168,4457,93.5
31130, 남양주시,040003, 37세,2021,9706,4785,4921,97.2,9404,4610,4794,96.2
31130, 남양주시,040004, 38세,2021,11200,5523,5677,97.3,10911,5357,5554,96.5
31130, 남양주시,040005, 39세,2021,12530,6084,6446,94.4,12240,5934,6306,94.1
31130, 남양주시,045,40~44세,2021,63730,31631,32099,98.5,62676,31039,31637,98.1
31130, 남양주시,045001, 40세,2021,13105,6513,6592,98.8,12869,6371,6498,98
31130, 남양주시,045002, 41세,2021,13541,6662,6879,96.8,13310,6525,6785,96.2
31130, 남양주시,045003, 42세,2021,12873,6360,6513,97.7,12626,6219,6407,97.1
31130, 남양주시,045004, 43세,2021,11997,5968,6029,99,11824,5875,5949,98.8
31130, 남양주시,045005, 44세,2021,12214,6128,6086,100.7,12047,6049,5998,100.9
31130, 남양주시,050,45~49세,2021,64490,32659,31831,102.6,63768,32263,31505,102.4
31130, 남양주시,050001, 45세,2021,11918,5984,5934,100.8,11747,5892,5855,100.6
31130, 남양주시,050002, 46세,2021,12482,6253,6229,100.4,12355,6187,6168,100.3
31130, 남양주시,050003, 47세,2021,13417,6822,6595,103.4,13277,6748,6529,103.4
31130, 남양주시,050004, 48세,2021,13311,6782,6529,103.9,13167,6698,6469,103.5
31130, 남양주시,050005, 49세,2021,13362,6818,6544,104.2,13222,6738,6484,103.9
31130, 남양주시,055,50~54세,2021,64074,32253,31821,101.4,63386,31927,31459,101.5
31130, 남양주시,055001, 50세,2021,14050,7136,6914,103.2,13903,7064,6839,103.3
31130, 남양주시,055002, 51세,2021,13046,6711,6335,105.9,12889,6634,6255,106.1
31130, 남양주시,055003, 52세,2021,12969,6502,6467,100.5,12837,6432,6405,100.4
31130, 남양주시,055004, 53세,2021,12621,6236,6385,97.7,12485,6181,6304,98
31130, 남양주시,055005, 54세,2021,11388,5668,5720,99.1,11272,5616,5656,99.3
31130, 남양주시,060,55~59세,2021,54420,27799,26621,104.4,53828,27549,26279,104.8
31130, 남양주시,060001, 55세,2021,11181,5776,5405,106.9,11060,5719,5341,107.1
31130, 남양주시,060002, 56세,2021,11182,5639,5543,101.7,11050,5590,5460,102.4
31130, 남양주시,060003, 57세,2021,10588,5380,5208,103.3,10478,5329,5149,103.5
31130, 남양주시,060004, 58세,2021,10767,5552,5215,106.5,10644,5496,5148,106.8
31130, 남양주시,060005, 59세,2021,10702,5452,5250,103.8,10596,5415,5181,104.5
31130, 남양주시,065,60~64세,2021,50871,24974,25897,96.4,50490,24827,25663,96.7
31130, 남양주시,065001, 60세,2021,11095,5505,5590,98.5,11017,5477,5540,98.9
31130, 남양주시,065002, 61세,2021,11164,5504,5660,97.2,11098,5473,5625,97.3
31130, 남양주시,065003, 62세,2021,9872,4835,5037,96,9803,4813,4990,96.5
31130, 남양주시,065004, 63세,2021,9496,4700,4796,98,9404,4666,4738,98.5
31130, 남양주시,065005, 64세,2021,9244,4430,4814,92,9168,4398,4770,92.2
31130, 남양주시,070,65~69세,2021,37280,17720,19560,90.6,37041,17614,19427,90.7
31130, 남양주시,070001, 65세,2021,8412,4096,4316,94.9,8344,4068,4276,95.1
31130, 남양주시,070002, 66세,2021,8520,3948,4572,86.4,8476,3929,4547,86.4
31130, 남양주시,070003, 67세,2021,7228,3466,3762,92.1,7177,3442,3735,92.2
31130, 남양주시,070004, 68세,2021,6158,2924,3234,90.4,6117,2905,3212,90.4
31130, 남양주시,070005, 69세,2021,6962,3286,3676,89.4,6927,3270,3657,89.4
31130, 남양주시,075,70~74세,2021,25714,12033,13681,88,25584,11977,13607,88
31130, 남양주시,075001, 70세,2021,4693,2238,2455,91.2,4653,2224,2429,91.6
31130, 남양주시,075002, 71세,2021,5209,2399,2810,85.4,5173,2381,2792,85.3
31130, 남양주시,075003, 72세,2021,5274,2458,2816,87.3,5252,2445,2807,87.1
31130, 남양주시,075004, 73세,2021,5325,2477,2848,87,5307,2471,2836,87.1
31130, 남양주시,075005, 74세,2021,5213,2461,2752,89.4,5199,2456,2743,89.5
31130, 남양주시,080,75~79세,2021,19900,8845,11055,80,19849,8820,11029,80
31130, 남양주시,080001, 75세,2021,4061,1795,2266,79.2,4044,1786,2258,79.1
31130, 남양주시,080002, 76세,2021,3916,1789,2127,84.1,3912,1787,2125,84.1
31130, 남양주시,080003, 77세,2021,3836,1703,2133,79.8,3825,1699,2126,79.9
31130, 남양주시,080004, 78세,2021,3793,1665,2128,78.2,3782,1661,2121,78.3
31130, 남양주시,080005, 79세,2021,4294,1893,2401,78.8,4286,1887,2399,78.7
31130, 남양주시,085,80~84세,2021,13778,5571,8207,67.9,13743,5557,8186,67.9
31130, 남양주시,085001, 80세,2021,3324,1432,1892,75.7,3316,1427,1889,75.5
31130, 남양주시,085002, 81세,2021,3060,1270,1790,70.9,3051,1266,1785,70.9
31130, 남양주시,085003, 82세,2021,2858,1157,1701,68,2851,1153,1698,67.9
31130, 남양주시,085004, 83세,2021,2378,916,1462,62.7,2372,916,1456,62.9
31130, 남양주시,085005, 84세,2021,2158,796,1362,58.4,2153,795,1358,58.5
31130, 남양주시,090,85~89세,2021,6923,2197,4726,46.5,6910,2193,4717,46.5
31130, 남양주시,090001, 85세,2021,1860,627,1233,50.9,1858,626,1232,50.8
31130, 남양주시,090002, 86세,2021,1689,578,1111,52,1687,577,1110,52
31130, 남양주시,090003, 87세,2021,1306,420,886,47.4,1303,419,884,47.4
31130, 남양주시,090004, 88세,2021,1129,312,817,38.2,1125,311,814,38.2
31130, 남양주시,090005, 89세,2021,939,260,679,38.3,937,260,677,38.4
31130, 남양주시,095,90~94세,2021,2565,591,1974,29.9,2560,590,1970,29.9
31130, 남양주시,095001, 90세,2021,713,186,527,35.3,712,186,526,35.4
31130, 남양주시,095002, 91세,2021,640,129,511,25.2,639,129,510,25.3
31130, 남양주시,095003, 92세,2021,539,136,403,33.7,539,136,403,33.7
31130, 남양주시,095004, 93세,2021,394,93,301,30.9,392,92,300,30.7
31130, 남양주시,095005, 94세,2021,279,47,232,20.3,278,47,231,20.3
31130, 남양주시,100,95~99세,2021,613,106,507,20.9,613,106,507,20.9
31130, 남양주시,100001, 95세,2021,209,33,176,18.8,209,33,176,18.8
31130, 남양주시,100002, 96세,2021,136,20,116,17.2,136,20,116,17.2
31130, 남양주시,100003, 97세,2021,91,21,70,30,91,21,70,30
31130, 남양주시,100004, 98세,2021,97,20,77,26,97,20,77,26
31130, 남양주시,100005, 99세,2021,80,12,68,17.6,80,12,68,17.6
31130, 남양주시,101,100세이상,2021,103,19,84,22.6,103,19,84,22.6
31130, 남양주시,102,15세미만,2021,102099,52549,49550,106.1,101877,52436,49441,106.1
31130, 남양주시,103,15~64세,2021,504574,255039,249535,102.2,495001,249631,245370,101.7
31130, 남양주시,104,65세이상,2021,106876,47082,59794,78.7,106403,46876,59527,78.7
31130, 남양주시,086,85세이상,2021,10204,2913,7291,40,10186,2908,7278,40
31130, 남양주시,126,평균연령,2021,42.2,41.2,43.1,,42.2,41.3,43.2,
31130, 남양주시,127,중위연령,2021,43.7,42.9,44.4,,43.9,43.2,44.5,
31140, 오산시,000,합계,2021,242297,125462,116835,107.4,226244,117164,109080,107.4
31140, 오산시,005,0~4세,2021,9314,4808,4506,106.7,8712,4492,4220,106.4
31140, 오산시,005001, 0세,2021,1481,777,704,110.4,1397,733,664,110.4
31140, 오산시,005002, 1세,2021,1676,821,855,96,1560,763,797,95.7
31140, 오산시,005003, 2세,2021,1844,976,868,112.4,1684,895,789,113.4
31140, 오산시,005004, 3세,2021,2050,1067,983,108.5,1934,1000,934,107.1
31140, 오산시,005005, 4세,2021,2263,1167,1096,106.5,2137,1101,1036,106.3
31140, 오산시,010,5~9세,2021,13647,6944,6703,103.6,13224,6715,6509,103.2
31140, 오산시,010001, 5세,2021,2576,1279,1297,98.6,2461,1220,1241,98.3
31140, 오산시,010002, 6세,2021,2701,1395,1306,106.8,2614,1347,1267,106.3
31140, 오산시,010003, 7세,2021,2667,1327,1340,99,2566,1278,1288,99.2
31140, 오산시,010004, 8세,2021,2707,1416,1291,109.7,2657,1383,1274,108.6
31140, 오산시,010005, 9세,2021,2996,1527,1469,103.9,2926,1487,1439,103.3
31140, 오산시,015,10~14세,2021,13240,6831,6409,106.6,13053,6728,6325,106.4
31140, 오산시,015001, 10세,2021,2799,1449,1350,107.3,2756,1425,1331,107.1
31140, 오산시,015002, 11세,2021,2697,1362,1335,102,2651,1338,1313,101.9
31140, 오산시,015003, 12세,2021,2546,1309,1237,105.8,2510,1292,1218,106.1
31140, 오산시,015004, 13세,2021,2597,1375,1222,112.5,2563,1353,1210,111.8
31140, 오산시,015005, 14세,2021,2601,1336,1265,105.6,2573,1320,1253,105.3
31140, 오산시,020,15~19세,2021,11391,5749,5642,101.9,11273,5689,5584,101.9
31140, 오산시,020001, 15세,2021,2323,1192,1131,105.4,2295,1177,1118,105.3
31140, 오산시,020002, 16세,2021,2206,1111,1095,101.5,2188,1100,1088,101.1
31140, 오산시,020003, 17세,2021,2335,1171,1164,100.6,2314,1160,1154,100.5
31140, 오산시,020004, 18세,2021,2308,1166,1142,102.1,2292,1162,1130,102.8
31140, 오산시,020005, 19세,2021,2219,1109,1110,99.9,2184,1090,1094,99.6
31140, 오산시,025,20~24세,2021,13821,7266,6555,110.8,13327,7029,6298,111.6
31140, 오산시,025001, 20세,2021,2582,1380,1202,114.8,2499,1337,1162,115.1
31140, 오산시,025002, 21세,2021,2757,1462,1295,112.9,2670,1423,1247,114.1
31140, 오산시,025003, 22세,2021,2643,1415,1228,115.2,2571,1379,1192,115.7
31140, 오산시,025004, 23세,2021,2849,1480,1369,108.1,2724,1418,1306,108.6
31140, 오산시,025005, 24세,2021,2990,1529,1461,104.7,2863,1472,1391,105.8
31140, 오산시,030,25~29세,2021,17793,9832,7961,123.5,16786,9350,7436,125.7
31140, 오산시,030001, 25세,2021,3167,1688,1479,114.1,3014,1613,1401,115.1
31140, 오산시,030002, 26세,2021,3378,1802,1576,114.3,3199,1716,1483,115.7
31140, 오산시,030003, 27세,2021,3598,2045,1553,131.7,3403,1953,1450,134.7
31140, 오산시,030004, 28세,2021,3697,2065,1632,126.5,3460,1948,1512,128.8
31140, 오산시,030005, 29세,2021,3953,2232,1721,129.7,3710,2120,1590,133.3
31140, 오산시,035,30~34세,2021,18749,10256,8493,120.8,16520,9102,7418,122.7
31140, 오산시,035001, 30세,2021,3769,2105,1664,126.5,3432,1919,1513,126.8
31140, 오산시,035002, 31세,2021,3698,2056,1642,125.2,3311,1856,1455,127.6
31140, 오산시,035003, 32세,2021,3675,2057,1618,127.1,3214,1831,1383,132.4
31140, 오산시,035004, 33세,2021,3743,2025,1718,117.9,3255,1761,1494,117.9
31140, 오산시,035005, 34세,2021,3864,2013,1851,108.8,3308,1735,1573,110.3
31140, 오산시,040,35~39세,2021,22737,12267,10470,117.2,20386,10953,9433,116.1
31140, 오산시,040001, 35세,2021,4061,2175,1886,115.3,3506,1877,1629,115.2
31140, 오산시,040002, 36세,2021,4193,2277,1916,118.8,3728,2012,1716,117.2
31140, 오산시,040003, 37세,2021,4310,2316,1994,116.1,3839,2059,1780,115.7
31140, 오산시,040004, 38세,2021,4750,2536,2214,114.5,4336,2314,2022,114.4
31140, 오산시,040005, 39세,2021,5423,2963,2460,120.4,4977,2691,2286,117.7
31140, 오산시,045,40~44세,2021,24112,12917,11195,115.4,22461,11990,10471,114.5
31140, 오산시,045001, 40세,2021,5147,2820,2327,121.2,4809,2634,2175,121.1
31140, 오산시,045002, 41세,2021,5286,2789,2497,111.7,4923,2593,2330,111.3
31140, 오산시,045003, 42세,2021,4844,2572,2272,113.2,4477,2361,2116,111.6
31140, 오산시,045004, 43세,2021,4408,2386,2022,118,4101,2205,1896,116.3
31140, 오산시,045005, 44세,2021,4427,2350,2077,113.1,4151,2197,1954,112.4
31140, 오산시,050,45~49세,2021,21782,11548,10234,112.8,20335,10755,9580,112.3
31140, 오산시,050001, 45세,2021,4198,2255,1943,116.1,3927,2100,1827,114.9
31140, 오산시,050002, 46세,2021,4345,2337,2008,116.4,4096,2208,1888,116.9
31140, 오산시,050003, 47세,2021,4571,2416,2155,112.1,4300,2265,2035,111.3
31140, 오산시,050004, 48세,2021,4394,2261,2133,106,4072,2104,1968,106.9
31140, 오산시,050005, 49세,2021,4274,2279,1995,114.2,3940,2078,1862,111.6
31140, 오산시,055,50~54세,2021,20264,10594,9670,109.6,18582,9683,8899,108.8
31140, 오산시,055001, 50세,2021,4408,2312,2096,110.3,4045,2109,1936,108.9
31140, 오산시,055002, 51세,2021,4095,2185,1910,114.4,3739,2003,1736,115.4
31140, 오산시,055003, 52세,2021,4170,2226,1944,114.5,3806,2022,1784,113.3
31140, 오산시,055004, 53세,2021,4071,2086,1985,105.1,3739,1910,1829,104.4
31140, 오산시,055005, 54세,2021,3520,1785,1735,102.9,3253,1639,1614,101.5
31140, 오산시,060,55~59세,2021,16267,8484,7783,109,14697,7712,6985,110.4
31140, 오산시,060001, 55세,2021,3330,1766,1564,112.9,3042,1625,1417,114.7
31140, 오산시,060002, 56세,2021,3485,1808,1677,107.8,3167,1648,1519,108.5
31140, 오산시,060003, 57세,2021,3076,1634,1442,113.3,2765,1454,1311,110.9
31140, 오산시,060004, 58세,2021,3163,1606,1557,103.1,2803,1453,1350,107.6
31140, 오산시,060005, 59세,2021,3213,1670,1543,108.2,2920,1532,1388,110.4
31140, 오산시,065,60~64세,2021,14337,7128,7209,98.9,13145,6585,6560,100.4
31140, 오산시,065001, 60세,2021,3289,1621,1668,97.2,3114,1550,1564,99.1
31140, 오산시,065002, 61세,2021,3272,1675,1597,104.9,2989,1534,1455,105.4
31140, 오산시,065003, 62세,2021,2789,1389,1400,99.2,2549,1276,1273,100.2
31140, 오산시,065004, 63세,2021,2597,1279,1318,97,2339,1162,1177,98.7
31140, 오산시,065005, 64세,2021,2390,1164,1226,94.9,2154,1063,1091,97.4
31140, 오산시,070,65~69세,2021,9226,4469,4757,93.9,8522,4144,4378,94.7
31140, 오산시,070001, 65세,2021,2146,1043,1103,94.6,1954,946,1008,93.8
31140, 오산시,070002, 66세,2021,2169,1076,1093,98.4,2021,1003,1018,98.5
31140, 오산시,070003, 67세,2021,1788,869,919,94.6,1637,812,825,98.4
31140, 오산시,070004, 68세,2021,1470,688,782,88,1359,633,726,87.2
31140, 오산시,070005, 69세,2021,1653,793,860,92.2,1551,750,801,93.6
31140, 오산시,075,70~74세,2021,5889,2711,3178,85.3,5641,2611,3030,86.2
31140, 오산시,075001, 70세,2021,1155,537,618,86.9,1085,502,583,86.1
31140, 오산시,075002, 71세,2021,1199,555,644,86.2,1132,531,601,88.4
31140, 오산시,075003, 72세,2021,1217,551,666,82.7,1169,529,640,82.7
31140, 오산시,075004, 73세,2021,1184,562,622,90.4,1152,554,598,92.6
31140, 오산시,075005, 74세,2021,1134,506,628,80.6,1103,495,608,81.4
31140, 오산시,080,75~79세,2021,4489,1865,2624,71.1,4407,1844,2563,71.9
31140, 오산시,080001, 75세,2021,861,386,475,81.3,847,380,467,81.4
31140, 오산시,080002, 76세,2021,879,380,499,76.2,865,378,487,77.6
31140, 오산시,080003, 77세,2021,905,355,550,64.5,884,346,538,64.3
31140, 오산시,080004, 78세,2021,849,331,518,63.9,834,330,504,65.5
31140, 오산시,080005, 79세,2021,995,413,582,71,977,410,567,72.3
31140, 오산시,085,80~84세,2021,3091,1169,1922,60.8,3045,1158,1887,61.4
31140, 오산시,085001, 80세,2021,754,302,452,66.8,743,299,444,67.3
31140, 오산시,085002, 81세,2021,655,264,391,67.5,648,263,385,68.3
31140, 오산시,085003, 82세,2021,634,236,398,59.3,618,231,387,59.7
31140, 오산시,085004, 83세,2021,600,220,380,57.9,595,220,375,58.7
31140, 오산시,085005, 84세,2021,448,147,301,48.8,441,145,296,49
31140, 오산시,090,85~89세,2021,1526,500,1026,48.7,1511,500,1011,49.5
31140, 오산시,090001, 85세,2021,445,154,291,52.9,440,154,286,53.8
31140, 오산시,090002, 86세,2021,369,121,248,48.8,363,121,242,50
31140, 오산시,090003, 87세,2021,300,105,195,53.8,297,105,192,54.7
31140, 오산시,090004, 88세,2021,221,64,157,40.8,220,64,156,41
31140, 오산시,090005, 89세,2021,191,56,135,41.5,191,56,135,41.5
31140, 오산시,095,90~94세,2021,501,97,404,24,497,97,400,24.3
31140, 오산시,095001, 90세,2021,143,28,115,24.3,141,28,113,24.8
31140, 오산시,095002, 91세,2021,132,26,106,24.5,130,26,104,25
31140, 오산시,095003, 92세,2021,90,22,68,32.4,90,22,68,32.4
31140, 오산시,095004, 93세,2021,79,15,64,23.4,79,15,64,23.4
31140, 오산시,095005, 94세,2021,57,6,51,11.8,57,6,51,11.8
31140, 오산시,100,95~99세,2021,109,24,85,28.2,108,24,84,28.6
31140, 오산시,100001, 95세,2021,42,6,36,16.7,41,6,35,17.1
31140, 오산시,100002, 96세,2021,36,13,23,56.5,36,13,23,56.5
31140, 오산시,100003, 97세,2021,15,X,12,25,15,X,12,25
31140, 오산시,100004, 98세,2021,8,X,8,0,8,X,8,0
31140, 오산시,100005, 99세,2021,8,X,6,33.3,8,X,6,33.3
31140, 오산시,101,100세이상,2021,12,X,9,33.3,12,X,9,33.3
31140, 오산시,102,15세미만,2021,36201,18583,17618,105.5,34989,17935,17054,105.2
31140, 오산시,103,15~64세,2021,181253,96041,85212,112.7,167512,88848,78664,112.9
31140, 오산시,104,65세이상,2021,24843,10838,14005,77.4,23743,10381,13362,77.7
31140, 오산시,086,85세이상,2021,2148,624,1524,40.9,2128,624,1504,41.5
31140, 오산시,126,평균연령,2021,39.4,38.7,40.2,,39.2,38.5,40,
31140, 오산시,127,중위연령,2021,40.1,39.6,40.7,,40,39.5,40.6,
31150, 시흥시,000,합계,2021,554074,292143,261931,111.5,500680,261074,239606,109
31150, 시흥시,005,0~4세,2021,22161,11225,10936,102.6,20523,10371,10152,102.2
31150, 시흥시,005001, 0세,2021,3710,1867,1843,101.3,3422,1721,1701,101.2
31150, 시흥시,005002, 1세,2021,3993,2020,1973,102.4,3671,1863,1808,103
31150, 시흥시,005003, 2세,2021,4549,2331,2218,105.1,4190,2138,2052,104.2
31150, 시흥시,005004, 3세,2021,4737,2391,2346,101.9,4392,2199,2193,100.3
31150, 시흥시,005005, 4세,2021,5172,2616,2556,102.3,4848,2450,2398,102.2
31150, 시흥시,010,5~9세,2021,28232,14402,13830,104.1,26941,13733,13208,104
31150, 시흥시,010001, 5세,2021,5661,2829,2832,99.9,5310,2650,2660,99.6
31150, 시흥시,010002, 6세,2021,5898,3022,2876,105.1,5653,2900,2753,105.3
31150, 시흥시,010003, 7세,2021,5439,2775,2664,104.2,5182,2642,2540,104
31150, 시흥시,010004, 8세,2021,5412,2752,2660,103.5,5185,2635,2550,103.3
31150, 시흥시,010005, 9세,2021,5822,3024,2798,108.1,5611,2906,2705,107.4
31150, 시흥시,015,10~14세,2021,26173,13343,12830,104,25484,12981,12503,103.8
31150, 시흥시,015001, 10세,2021,5474,2811,2663,105.6,5308,2715,2593,104.7
31150, 시흥시,015002, 11세,2021,5169,2596,2573,100.9,5017,2523,2494,101.2
31150, 시흥시,015003, 12세,2021,5097,2647,2450,108,4972,2583,2389,108.1
31150, 시흥시,015004, 13세,2021,5271,2702,2569,105.2,5145,2638,2507,105.2
31150, 시흥시,015005, 14세,2021,5162,2587,2575,100.5,5042,2522,2520,100.1
31150, 시흥시,020,15~19세,2021,24209,12618,11591,108.9,23779,12403,11376,109
31150, 시흥시,020001, 15세,2021,4711,2384,2327,102.4,4620,2340,2280,102.6
31150, 시흥시,020002, 16세,2021,4605,2322,2283,101.7,4528,2282,2246,101.6
31150, 시흥시,020003, 17세,2021,4888,2589,2299,112.6,4829,2556,2273,112.5
31150, 시흥시,020004, 18세,2021,4998,2567,2431,105.6,4928,2539,2389,106.3
31150, 시흥시,020005, 19세,2021,5007,2756,2251,122.4,4874,2686,2188,122.8
31150, 시흥시,025,20~24세,2021,33270,18203,15067,120.8,31387,17080,14307,119.4
31150, 시흥시,025001, 20세,2021,5846,3234,2612,123.8,5663,3137,2526,124.2
31150, 시흥시,025002, 21세,2021,6643,3710,2933,126.5,6389,3581,2808,127.5
31150, 시흥시,025003, 22세,2021,6424,3533,2891,122.2,6086,3340,2746,121.6
31150, 시흥시,025004, 23세,2021,7084,3818,3266,116.9,6591,3513,3078,114.1
31150, 시흥시,025005, 24세,2021,7273,3908,3365,116.1,6658,3509,3149,111.4
31150, 시흥시,030,25~29세,2021,40687,23022,17665,130.3,35798,19790,16008,123.6
31150, 시흥시,030001, 25세,2021,7676,4229,3447,122.7,6977,3775,3202,117.9
31150, 시흥시,030002, 26세,2021,8029,4627,3402,136,7180,4038,3142,128.5
31150, 시흥시,030003, 27세,2021,8028,4481,3547,126.3,7039,3822,3217,118.8
31150, 시흥시,030004, 28세,2021,8338,4786,3552,134.7,7246,4047,3199,126.5
31150, 시흥시,030005, 29세,2021,8616,4899,3717,131.8,7356,4108,3248,126.5
31150, 시흥시,035,30~34세,2021,42706,23687,19019,124.5,34403,18523,15880,116.6
31150, 시흥시,035001, 30세,2021,8444,4745,3699,128.3,7092,3896,3196,121.9
31150, 시흥시,035002, 31세,2021,8442,4736,3706,127.8,6877,3739,3138,119.2
31150, 시흥시,035003, 32세,2021,8468,4782,3686,129.7,6768,3702,3066,120.7
31150, 시흥시,035004, 33세,2021,8493,4603,3890,118.3,6696,3537,3159,112
31150, 시흥시,035005, 34세,2021,8859,4821,4038,119.4,6970,3649,3321,109.9
31150, 시흥시,040,35~39세,2021,49729,27203,22526,120.8,41674,22229,19445,114.3
31150, 시흥시,040001, 35세,2021,9164,4996,4168,119.9,7239,3835,3404,112.7
31150, 시흥시,040002, 36세,2021,9048,5006,4042,123.8,7447,4002,3445,116.2
31150, 시흥시,040003, 37세,2021,9686,5323,4363,122,8119,4351,3768,115.5
31150, 시흥시,040004, 38세,2021,10400,5626,4774,117.8,8942,4713,4229,111.4
31150, 시흥시,040005, 39세,2021,11431,6252,5179,120.7,9927,5328,4599,115.9
31150, 시흥시,045,40~44세,2021,51380,28425,22955,123.8,45737,24756,20981,118
31150, 시흥시,045001, 40세,2021,11098,6133,4965,123.5,9806,5300,4506,117.6
31150, 시흥시,045002, 41세,2021,11165,6115,5050,121.1,10013,5380,4633,116.1
31150, 시흥시,045003, 42세,2021,10304,5753,4551,126.4,9086,4949,4137,119.6
31150, 시흥시,045004, 43세,2021,9444,5206,4238,122.8,8373,4501,3872,116.2
31150, 시흥시,045005, 44세,2021,9369,5218,4151,125.7,8459,4626,3833,120.7
31150, 시흥시,050,45~49세,2021,49029,26631,22398,118.9,44168,23679,20489,115.6
31150, 시흥시,050001, 45세,2021,9222,5127,4095,125.2,8240,4509,3731,120.9
31150, 시흥시,050002, 46세,2021,9515,5221,4294,121.6,8629,4673,3956,118.1
31150, 시흥시,050003, 47세,2021,10131,5587,4544,123,9260,5056,4204,120.3
31150, 시흥시,050004, 48세,2021,10025,5342,4683,114.1,9043,4755,4288,110.9
31150, 시흥시,050005, 49세,2021,10136,5354,4782,112,8996,4686,4310,108.7
31150, 시흥시,055,50~54세,2021,52044,26867,25177,106.7,47112,24048,23064,104.3
31150, 시흥시,055001, 50세,2021,10728,5579,5149,108.4,9579,4882,4697,103.9
31150, 시흥시,055002, 51세,2021,10393,5412,4981,108.7,9283,4789,4494,106.6
31150, 시흥시,055003, 52세,2021,10655,5546,5109,108.6,9703,5012,4691,106.8
31150, 시흥시,055004, 53세,2021,10555,5371,5184,103.6,9611,4835,4776,101.2
31150, 시흥시,055005, 54세,2021,9713,4959,4754,104.3,8936,4530,4406,102.8
31150, 시흥시,060,55~59세,2021,44873,23921,20952,114.2,40492,21643,18849,114.8
31150, 시흥시,060001, 55세,2021,9164,4890,4274,114.4,8312,4432,3880,114.2
31150, 시흥시,060002, 56세,2021,9487,4973,4514,110.2,8597,4496,4101,109.6
31150, 시흥시,060003, 57세,2021,8635,4604,4031,114.2,7760,4139,3621,114.3
31150, 시흥시,060004, 58세,2021,8914,4797,4117,116.5,7883,4280,3603,118.8
31150, 시흥시,060005, 59세,2021,8673,4657,4016,116,7940,4296,3644,117.9
31150, 시흥시,065,60~64세,2021,35883,19037,16846,113,32953,17676,15277,115.7
31150, 시흥시,065001, 60세,2021,8376,4477,3899,114.8,7975,4294,3681,116.7
31150, 시흥시,065002, 61세,2021,8157,4370,3787,115.4,7442,4034,3408,118.4
31150, 시흥시,065003, 62세,2021,7057,3796,3261,116.4,6483,3521,2962,118.9
31150, 시흥시,065004, 63세,2021,6364,3330,3034,109.8,5754,3046,2708,112.5
31150, 시흥시,065005, 64세,2021,5929,3064,2865,106.9,5299,2781,2518,110.4
31150, 시흥시,070,65~69세,2021,20864,10513,10351,101.6,18726,9567,9159,104.5
31150, 시흥시,070001, 65세,2021,4957,2467,2490,99.1,4445,2242,2203,101.8
31150, 시흥시,070002, 66세,2021,4983,2512,2471,101.7,4476,2285,2191,104.3
31150, 시흥시,070003, 67세,2021,3980,2037,1943,104.8,3521,1845,1676,110.1
31150, 시흥시,070004, 68세,2021,3368,1693,1675,101.1,3007,1530,1477,103.6
31150, 시흥시,070005, 69세,2021,3576,1804,1772,101.8,3277,1665,1612,103.3
31150, 시흥시,075,70~74세,2021,12194,5770,6424,89.8,11381,5456,5925,92.1
31150, 시흥시,075001, 70세,2021,2437,1157,1280,90.4,2186,1059,1127,94
31150, 시흥시,075002, 71세,2021,2568,1233,1335,92.4,2369,1157,1212,95.5
31150, 시흥시,075003, 72세,2021,2521,1202,1319,91.1,2367,1141,1226,93.1
31150, 시흥시,075004, 73세,2021,2354,1143,1211,94.4,2253,1098,1155,95.1
31150, 시흥시,075005, 74세,2021,2314,1035,1279,80.9,2206,1001,1205,83.1
31150, 시흥시,080,75~79세,2021,8793,3724,5069,73.5,8527,3640,4887,74.5
31150, 시흥시,080001, 75세,2021,1778,763,1015,75.2,1705,733,972,75.4
31150, 시흥시,080002, 76세,2021,1729,745,984,75.7,1671,728,943,77.2
31150, 시흥시,080003, 77세,2021,1687,732,955,76.6,1640,715,925,77.3
31150, 시흥시,080004, 78세,2021,1666,695,971,71.6,1612,685,927,73.9
31150, 시흥시,080005, 79세,2021,1933,789,1144,69,1899,779,1120,69.6
31150, 시흥시,085,80~84세,2021,6732,2324,4408,52.7,6555,2283,4272,53.4
31150, 시흥시,085001, 80세,2021,1577,588,989,59.5,1526,576,950,60.6
31150, 시흥시,085002, 81세,2021,1412,490,922,53.1,1369,476,893,53.3
31150, 시흥시,085003, 82세,2021,1396,467,929,50.3,1362,463,899,51.5
31150, 시흥시,085004, 83세,2021,1292,440,852,51.6,1268,436,832,52.4
31150, 시흥시,085005, 84세,2021,1055,339,716,47.3,1030,332,698,47.6
31150, 시흥시,090,85~89세,2021,3464,926,2538,36.5,3400,915,2485,36.8
31150, 시흥시,090001, 85세,2021,952,276,676,40.8,934,272,662,41.1
31150, 시흥시,090002, 86세,2021,793,222,571,38.9,784,218,566,38.5
31150, 시흥시,090003, 87세,2021,715,191,524,36.5,699,188,511,36.8
31150, 시흥시,090004, 88세,2021,530,130,400,32.5,515,130,385,33.8
31150, 시흥시,090005, 89세,2021,474,107,367,29.2,468,107,361,29.6
31150, 시흥시,095,90~94세,2021,1326,245,1081,22.7,1316,244,1072,22.8
31150, 시흥시,095001, 90세,2021,335,78,257,30.4,332,78,254,30.7
31150, 시흥시,095002, 91세,2021,322,59,263,22.4,318,58,260,22.3
31150, 시흥시,095003, 92세,2021,279,45,234,19.2,277,45,232,19.4
31150, 시흥시,095004, 93세,2021,221,36,185,19.5,220,36,184,19.6
31150, 시흥시,095005, 94세,2021,169,27,142,19,169,27,142,19
31150, 시흥시,100,95~99세,2021,273,52,221,23.5,272,52,220,23.6
31150, 시흥시,100001, 95세,2021,86,16,70,22.9,86,16,70,22.9
31150, 시흥시,100002, 96세,2021,68,15,53,28.3,67,15,52,28.8
31150, 시흥시,100003, 97세,2021,42,8,34,23.5,42,8,34,23.5
31150, 시흥시,100004, 98세,2021,41,5,36,13.9,41,5,36,13.9
31150, 시흥시,100005, 99세,2021,36,8,28,28.6,36,8,28,28.6
31150, 시흥시,101,100세이상,2021,52,5,47,10.6,52,5,47,10.6
31150, 시흥시,102,15세미만,2021,76566,38970,37596,103.7,72948,37085,35863,103.4
31150, 시흥시,103,15~64세,2021,423810,229614,194196,118.2,377503,201827,175676,114.9
31150, 시흥시,104,65세이상,2021,53698,23559,30139,78.2,50229,22162,28067,79
31150, 시흥시,086,85세이상,2021,5115,1228,3887,31.6,5040,1216,3824,31.8
31150, 시흥시,126,평균연령,2021,40,39.4,40.7,,39.9,39.4,40.6,
31150, 시흥시,127,중위연령,2021,40.9,40.4,41.5,,41.1,40.6,41.5,
31160, 군포시,000,합계,2021,270443,133978,136465,98.2,260553,129035,131518,98.1
31160, 군포시,005,0~4세,2021,7968,4059,3909,103.8,7729,3946,3783,104.3
31160, 군포시,005001, 0세,2021,1436,728,708,102.8,1398,715,683,104.7
31160, 군포시,005002, 1세,2021,1461,744,717,103.8,1418,722,696,103.7
31160, 군포시,005003, 2세,2021,1627,824,803,102.6,1573,800,773,103.5
31160, 군포시,005004, 3세,2021,1615,837,778,107.6,1568,812,756,107.4
31160, 군포시,005005, 4세,2021,1829,926,903,102.5,1772,897,875,102.5
31160, 군포시,010,5~9세,2021,10956,5586,5370,104,10770,5491,5279,104
31160, 군포시,010001, 5세,2021,2087,1059,1028,103,2040,1033,1007,102.6
31160, 군포시,010002, 6세,2021,2076,1071,1005,106.6,2037,1052,985,106.8
31160, 군포시,010003, 7세,2021,2179,1121,1058,106,2141,1100,1041,105.7
31160, 군포시,010004, 8세,2021,2248,1147,1101,104.2,2221,1133,1088,104.1
31160, 군포시,010005, 9세,2021,2366,1188,1178,100.8,2331,1173,1158,101.3
31160, 군포시,015,10~14세,2021,12108,6308,5800,108.8,11997,6250,5747,108.8
31160, 군포시,015001, 10세,2021,2456,1297,1159,111.9,2423,1279,1144,111.8
31160, 군포시,015002, 11세,2021,2345,1252,1093,114.5,2321,1237,1084,114.1
31160, 군포시,015003, 12세,2021,2277,1150,1127,102,2255,1144,1111,103
31160, 군포시,015004, 13세,2021,2512,1291,1221,105.7,2489,1276,1213,105.2
31160, 군포시,015005, 14세,2021,2518,1318,1200,109.8,2509,1314,1195,110
31160, 군포시,020,15~19세,2021,12498,6467,6031,107.2,12414,6431,5983,107.5
31160, 군포시,020001, 15세,2021,2409,1238,1171,105.7,2396,1233,1163,106
31160, 군포시,020002, 16세,2021,2366,1227,1139,107.7,2353,1218,1135,107.3
31160, 군포시,020003, 17세,2021,2541,1327,1214,109.3,2526,1323,1203,110
31160, 군포시,020004, 18세,2021,2595,1349,1246,108.3,2579,1342,1237,108.5
31160, 군포시,020005, 19세,2021,2587,1326,1261,105.2,2560,1315,1245,105.6
31160, 군포시,025,20~24세,2021,16268,8397,7871,106.7,15977,8259,7718,107
31160, 군포시,025001, 20세,2021,2881,1476,1405,105.1,2858,1464,1394,105
31160, 군포시,025002, 21세,2021,3346,1817,1529,118.8,3303,1799,1504,119.6
31160, 군포시,025003, 22세,2021,3207,1664,1543,107.8,3156,1640,1516,108.2
31160, 군포시,025004, 23세,2021,3361,1715,1646,104.2,3281,1675,1606,104.3
31160, 군포시,025005, 24세,2021,3473,1725,1748,98.7,3379,1681,1698,99
31160, 군포시,030,25~29세,2021,19679,10301,9378,109.8,18954,9969,8985,111
31160, 군포시,030001, 25세,2021,3672,1926,1746,110.3,3563,1882,1681,112
31160, 군포시,030002, 26세,2021,3860,2013,1847,109,3733,1954,1779,109.8
31160, 군포시,030003, 27세,2021,3960,2091,1869,111.9,3813,2028,1785,113.6
31160, 군포시,030004, 28세,2021,4008,2070,1938,106.8,3859,1995,1864,107
31160, 군포시,030005, 29세,2021,4179,2201,1978,111.3,3986,2110,1876,112.5
31160, 군포시,035,30~34세,2021,19006,10029,8977,111.7,17817,9412,8405,112
31160, 군포시,035001, 30세,2021,4127,2176,1951,111.5,3920,2074,1846,112.4
31160, 군포시,035002, 31세,2021,3841,2000,1841,108.6,3613,1885,1728,109.1
31160, 군포시,035003, 32세,2021,3734,1989,1745,114,3496,1858,1638,113.4
31160, 군포시,035004, 33세,2021,3662,1910,1752,109,3425,1788,1637,109.2
31160, 군포시,035005, 34세,2021,3642,1954,1688,115.8,3363,1807,1556,116.1
31160, 군포시,040,35~39세,2021,19216,9982,9234,108.1,18035,9347,8688,107.6
31160, 군포시,040001, 35세,2021,3706,1921,1785,107.6,3440,1779,1661,107.1
31160, 군포시,040002, 36세,2021,3620,1914,1706,112.2,3359,1782,1577,113
31160, 군포시,040003, 37세,2021,3723,1959,1764,111.1,3501,1839,1662,110.6
31160, 군포시,040004, 38세,2021,3991,2086,1905,109.5,3755,1956,1799,108.7
31160, 군포시,040005, 39세,2021,4176,2102,2074,101.4,3980,1991,1989,100.1
31160, 군포시,045,40~44세,2021,20394,10201,10193,100.1,19516,9734,9782,99.5
31160, 군포시,045001, 40세,2021,4205,2126,2079,102.3,4035,2039,1996,102.2
31160, 군포시,045002, 41세,2021,4214,2138,2076,103,4045,2047,1998,102.5
31160, 군포시,045003, 42세,2021,4145,2081,2064,100.8,3930,1967,1963,100.2
31160, 군포시,045004, 43세,2021,3782,1893,1889,100.2,3621,1805,1816,99.4
31160, 군포시,045005, 44세,2021,4048,1963,2085,94.1,3885,1876,2009,93.4
31160, 군포시,050,45~49세,2021,22517,11065,11452,96.6,21675,10616,11059,96
31160, 군포시,050001, 45세,2021,3979,1988,1991,99.8,3830,1905,1925,99
31160, 군포시,050002, 46세,2021,4138,2011,2127,94.5,3978,1929,2049,94.1
31160, 군포시,050003, 47세,2021,4671,2220,2451,90.6,4514,2143,2371,90.4
31160, 군포시,050004, 48세,2021,4922,2460,2462,99.9,4729,2350,2379,98.8
31160, 군포시,050005, 49세,2021,4807,2386,2421,98.6,4624,2289,2335,98
31160, 군포시,055,50~54세,2021,25084,12048,13036,92.4,23959,11477,12482,91.9
31160, 군포시,055001, 50세,2021,5189,2478,2711,91.4,4936,2351,2585,90.9
31160, 군포시,055002, 51세,2021,5110,2522,2588,97.4,4874,2402,2472,97.2
31160, 군포시,055003, 52세,2021,5126,2512,2614,96.1,4890,2401,2489,96.5
31160, 군포시,055004, 53세,2021,5136,2410,2726,88.4,4930,2293,2637,87
31160, 군포시,055005, 54세,2021,4523,2126,2397,88.7,4329,2030,2299,88.3
31160, 군포시,060,55~59세,2021,23411,11483,11928,96.3,22123,10853,11270,96.3
31160, 군포시,060001, 55세,2021,4621,2346,2275,103.1,4387,2234,2153,103.8
31160, 군포시,060002, 56세,2021,4744,2288,2456,93.2,4485,2164,2321,93.2
31160, 군포시,060003, 57세,2021,4443,2150,2293,93.8,4196,2030,2166,93.7
31160, 군포시,060004, 58세,2021,4761,2353,2408,97.7,4441,2194,2247,97.6
31160, 군포시,060005, 59세,2021,4842,2346,2496,94,4614,2231,2383,93.6
31160, 군포시,065,60~64세,2021,22604,11027,11577,95.2,21726,10612,11114,95.5
31160, 군포시,065001, 60세,2021,5106,2428,2678,90.7,4979,2377,2602,91.4
31160, 군포시,065002, 61세,2021,5098,2505,2593,96.6,4882,2391,2491,96
31160, 군포시,065003, 62세,2021,4435,2180,2255,96.7,4259,2102,2157,97.5
31160, 군포시,065004, 63세,2021,4155,2026,2129,95.2,3965,1927,2038,94.6
31160, 군포시,065005, 64세,2021,3810,1888,1922,98.2,3641,1815,1826,99.4
31160, 군포시,070,65~69세,2021,13986,6912,7074,97.7,13448,6635,6813,97.4
31160, 군포시,070001, 65세,2021,3332,1656,1676,98.8,3187,1576,1611,97.8
31160, 군포시,070002, 66세,2021,3314,1593,1721,92.6,3168,1512,1656,91.3
31160, 군포시,070003, 67세,2021,2687,1352,1335,101.3,2583,1302,1281,101.6
31160, 군포시,070004, 68세,2021,2266,1134,1132,100.2,2189,1100,1089,101
31160, 군포시,070005, 69세,2021,2387,1177,1210,97.3,2321,1145,1176,97.4
31160, 군포시,075,70~74세,2021,8660,4139,4521,91.6,8470,4065,4405,92.3
31160, 군포시,075001, 70세,2021,1662,820,842,97.4,1604,792,812,97.5
31160, 군포시,075002, 71세,2021,1786,861,925,93.1,1750,847,903,93.8
31160, 군포시,075003, 72세,2021,1734,853,881,96.8,1697,843,854,98.7
31160, 군포시,075004, 73세,2021,1670,817,853,95.8,1641,805,836,96.3
31160, 군포시,075005, 74세,2021,1808,788,1020,77.3,1778,778,1000,77.8
31160, 군포시,080,75~79세,2021,6623,2770,3853,71.9,6556,2755,3801,72.5
31160, 군포시,080001, 75세,2021,1372,576,796,72.4,1357,573,784,73.1
31160, 군포시,080002, 76세,2021,1258,551,707,77.9,1242,544,698,77.9
31160, 군포시,080003, 77세,2021,1260,520,740,70.3,1248,519,729,71.2
31160, 군포시,080004, 78세,2021,1235,519,716,72.5,1225,518,707,73.3
31160, 군포시,080005, 79세,2021,1498,604,894,67.6,1484,601,883,68.1
31160, 군포시,085,80~84세,2021,5119,1912,3207,59.6,5072,1900,3172,59.9
31160, 군포시,085001, 80세,2021,1193,493,700,70.4,1181,488,693,70.4
31160, 군포시,085002, 81세,2021,1044,387,657,58.9,1030,385,645,59.7
31160, 군포시,085003, 82세,2021,994,375,619,60.6,987,375,612,61.3
31160, 군포시,085004, 83세,2021,1002,346,656,52.7,993,342,651,52.5
31160, 군포시,085005, 84세,2021,886,311,575,54.1,881,310,571,54.3
31160, 군포시,090,85~89세,2021,2999,952,2047,46.5,2975,946,2029,46.6
31160, 군포시,090001, 85세,2021,758,244,514,47.5,748,242,506,47.8
31160, 군포시,090002, 86세,2021,698,227,471,48.2,695,226,469,48.2
31160, 군포시,090003, 87세,2021,648,207,441,46.9,641,206,435,47.4
31160, 군포시,090004, 88세,2021,490,161,329,48.9,489,161,328,49.1
31160, 군포시,090005, 89세,2021,405,113,292,38.7,402,111,291,38.1
31160, 군포시,095,90~94세,2021,1055,275,780,35.3,1050,273,777,35.1
31160, 군포시,095001, 90세,2021,277,80,197,40.6,276,80,196,40.8
31160, 군포시,095002, 91세,2021,270,71,199,35.7,270,71,199,35.7
31160, 군포시,095003, 92세,2021,203,58,145,40,200,56,144,38.9
31160, 군포시,095004, 93세,2021,189,42,147,28.6,188,42,146,28.8
31160, 군포시,095005, 94세,2021,116,24,92,26.1,116,24,92,26.1
31160, 군포시,100,95~99세,2021,245,56,189,29.6,243,55,188,29.3
31160, 군포시,100001, 95세,2021,85,20,65,30.8,85,20,65,30.8
31160, 군포시,100002, 96세,2021,53,9,44,20.5,51,8,43,18.6
31160, 군포시,100003, 97세,2021,45,13,32,40.6,45,13,32,40.6
31160, 군포시,100004, 98세,2021,39,9,30,30,39,9,30,30
31160, 군포시,100005, 99세,2021,23,5,18,27.8,23,5,18,27.8
31160, 군포시,101,100세이상,2021,47,9,38,23.7,47,9,38,23.7
31160, 군포시,102,15세미만,2021,31032,15953,15079,105.8,30496,15687,14809,105.9
31160, 군포시,103,15~64세,2021,200677,101000,99677,101.3,192196,96710,95486,101.3
31160, 군포시,104,65세이상,2021,38734,17025,21709,78.4,37861,16638,21223,78.4
31160, 군포시,086,85세이상,2021,4346,1292,3054,42.3,4315,1283,3032,42.3
31160, 군포시,126,평균연령,2021,43,41.9,44.1,,42.9,41.8,44,
31160, 군포시,127,중위연령,2021,44.3,42.8,45.7,,44.2,42.7,45.7,
31170, 의왕시,000,합계,2021,160115,79433,80682,98.5,158566,78703,79863,98.5
31170, 의왕시,005,0~4세,2021,5407,2863,2544,112.5,5392,2855,2537,112.5
31170, 의왕시,005001, 0세,2021,974,494,480,102.9,971,493,478,103.1
31170, 의왕시,005002, 1세,2021,964,513,451,113.7,963,512,451,113.5
31170, 의왕시,005003, 2세,2021,1044,573,471,121.7,1042,572,470,121.7
31170, 의왕시,005004, 3세,2021,1147,594,553,107.4,1143,593,550,107.8
31170, 의왕시,005005, 4세,2021,1278,689,589,117,1273,685,588,116.5
31170, 의왕시,010,5~9세,2021,7014,3554,3460,102.7,6991,3544,3447,102.8
31170, 의왕시,010001, 5세,2021,1414,696,718,96.9,1406,691,715,96.6
31170, 의왕시,010002, 6세,2021,1434,745,689,108.1,1430,743,687,108.2
31170, 의왕시,010003, 7세,2021,1363,707,656,107.8,1358,705,653,108
31170, 의왕시,010004, 8세,2021,1414,673,741,90.8,1412,673,739,91.1
31170, 의왕시,010005, 9세,2021,1389,733,656,111.7,1385,732,653,112.1
31170, 의왕시,015,10~14세,2021,6684,3428,3256,105.3,6669,3421,3248,105.3
31170, 의왕시,015001, 10세,2021,1342,702,640,109.7,1338,699,639,109.4
31170, 의왕시,015002, 11세,2021,1301,658,643,102.3,1297,657,640,102.7
31170, 의왕시,015003, 12세,2021,1307,664,643,103.3,1304,663,641,103.4
31170, 의왕시,015004, 13세,2021,1369,701,668,104.9,1367,700,667,104.9
31170, 의왕시,015005, 14세,2021,1365,703,662,106.2,1363,702,661,106.2
31170, 의왕시,020,15~19세,2021,7186,3586,3600,99.6,7179,3584,3595,99.7
31170, 의왕시,020001, 15세,2021,1258,665,593,112.1,1257,665,592,112.3
31170, 의왕시,020002, 16세,2021,1244,620,624,99.4,1244,620,624,99.4
31170, 의왕시,020003, 17세,2021,1527,700,827,84.6,1524,698,826,84.5
31170, 의왕시,020004, 18세,2021,1583,815,768,106.1,1582,815,767,106.3
31170, 의왕시,020005, 19세,2021,1574,786,788,99.7,1572,786,786,100
31170, 의왕시,025,20~24세,2021,10330,5330,5000,106.6,10232,5287,4945,106.9
31170, 의왕시,025001, 20세,2021,1922,1005,917,109.6,1913,1003,910,110.2
31170, 의왕시,025002, 21세,2021,2049,1041,1008,103.3,2040,1038,1002,103.6
31170, 의왕시,025003, 22세,2021,1999,1057,942,112.2,1986,1049,937,112
31170, 의왕시,025004, 23세,2021,2157,1091,1066,102.3,2119,1076,1043,103.2
31170, 의왕시,025005, 24세,2021,2203,1136,1067,106.5,2174,1121,1053,106.5
31170, 의왕시,030,25~29세,2021,11687,6264,5423,115.5,11459,6154,5305,116
31170, 의왕시,030001, 25세,2021,2268,1204,1064,113.2,2229,1183,1046,113.1
31170, 의왕시,030002, 26세,2021,2300,1248,1052,118.6,2254,1225,1029,119
31170, 의왕시,030003, 27세,2021,2384,1275,1109,115,2343,1261,1082,116.5
31170, 의왕시,030004, 28세,2021,2356,1267,1089,116.3,2304,1239,1065,116.3
31170, 의왕시,030005, 29세,2021,2379,1270,1109,114.5,2329,1246,1083,115.1
31170, 의왕시,035,30~34세,2021,11027,5651,5376,105.1,10798,5551,5247,105.8
31170, 의왕시,035001, 30세,2021,2371,1209,1162,104,2333,1192,1141,104.5
31170, 의왕시,035002, 31세,2021,2214,1144,1070,106.9,2165,1125,1040,108.2
31170, 의왕시,035003, 32세,2021,2195,1129,1066,105.9,2154,1115,1039,107.3
31170, 의왕시,035004, 33세,2021,2076,1053,1023,102.9,2035,1033,1002,103.1
31170, 의왕시,035005, 34세,2021,2171,1116,1055,105.8,2111,1086,1025,106
31170, 의왕시,040,35~39세,2021,11156,5793,5363,108,10950,5693,5257,108.3
31170, 의왕시,040001, 35세,2021,2094,1062,1032,102.9,2055,1047,1008,103.9
31170, 의왕시,040002, 36세,2021,2171,1170,1001,116.9,2128,1148,980,117.1
31170, 의왕시,040003, 37세,2021,2145,1102,1043,105.7,2102,1079,1023,105.5
31170, 의왕시,040004, 38세,2021,2300,1175,1125,104.4,2267,1158,1109,104.4
31170, 의왕시,040005, 39세,2021,2446,1284,1162,110.5,2398,1261,1137,110.9
31170, 의왕시,045,40~44세,2021,11300,5745,5555,103.4,11133,5662,5471,103.5
31170, 의왕시,045001, 40세,2021,2524,1288,1236,104.2,2492,1271,1221,104.1
31170, 의왕시,045002, 41세,2021,2416,1235,1181,104.6,2375,1214,1161,104.6
31170, 의왕시,045003, 42세,2021,2259,1166,1093,106.7,2220,1147,1073,106.9
31170, 의왕시,045004, 43세,2021,1915,967,948,102,1888,956,932,102.6
31170, 의왕시,045005, 44세,2021,2186,1089,1097,99.3,2158,1074,1084,99.1
31170, 의왕시,050,45~49세,2021,12145,5932,6213,95.5,12022,5872,6150,95.5
31170, 의왕시,050001, 45세,2021,2180,1107,1073,103.2,2165,1100,1065,103.3
31170, 의왕시,050002, 46세,2021,2160,1069,1091,98,2137,1059,1078,98.2
31170, 의왕시,050003, 47세,2021,2462,1206,1256,96,2440,1190,1250,95.2
31170, 의왕시,050004, 48세,2021,2662,1283,1379,93,2629,1270,1359,93.5
31170, 의왕시,050005, 49세,2021,2681,1267,1414,89.6,2651,1253,1398,89.6
31170, 의왕시,055,50~54세,2021,14700,6876,7824,87.9,14566,6806,7760,87.7
31170, 의왕시,055001, 50세,2021,2901,1331,1570,84.8,2881,1319,1562,84.4
31170, 의왕시,055002, 51세,2021,2871,1318,1553,84.9,2844,1302,1542,84.4
31170, 의왕시,055003, 52세,2021,3027,1437,1590,90.4,2992,1418,1574,90.1
31170, 의왕시,055004, 53세,2021,3084,1471,1613,91.2,3052,1458,1594,91.5
31170, 의왕시,055005, 54세,2021,2817,1319,1498,88.1,2797,1309,1488,88
31170, 의왕시,060,55~59세,2021,14190,6919,7271,95.2,14082,6873,7209,95.3
31170, 의왕시,060001, 55세,2021,2712,1357,1355,100.1,2687,1345,1342,100.2
31170, 의왕시,060002, 56세,2021,2961,1479,1482,99.8,2940,1469,1471,99.9
31170, 의왕시,060003, 57세,2021,2766,1333,1433,93,2745,1325,1420,93.3
31170, 의왕시,060004, 58세,2021,2910,1434,1476,97.2,2889,1425,1464,97.3
31170, 의왕시,060005, 59세,2021,2841,1316,1525,86.3,2821,1309,1512,86.6
31170, 의왕시,065,60~64세,2021,13937,6897,7040,98,13843,6855,6988,98.1
31170, 의왕시,065001, 60세,2021,3146,1536,1610,95.4,3125,1528,1597,95.7
31170, 의왕시,065002, 61세,2021,3056,1506,1550,97.2,3041,1500,1541,97.3
31170, 의왕시,065003, 62세,2021,2720,1338,1382,96.8,2705,1333,1372,97.2
31170, 의왕시,065004, 63세,2021,2577,1280,1297,98.7,2559,1270,1289,98.5
31170, 의왕시,065005, 64세,2021,2438,1237,1201,103,2413,1224,1189,102.9
31170, 의왕시,070,65~69세,2021,8967,4543,4424,102.7,8915,4515,4400,102.6
31170, 의왕시,070001, 65세,2021,2066,1027,1039,98.8,2049,1017,1032,98.5
31170, 의왕시,070002, 66세,2021,2192,1095,1097,99.8,2182,1089,1093,99.6
31170, 의왕시,070003, 67세,2021,1736,884,852,103.8,1727,880,847,103.9
31170, 의왕시,070004, 68세,2021,1469,734,735,99.9,1462,730,732,99.7
31170, 의왕시,070005, 69세,2021,1504,803,701,114.6,1495,799,696,114.8
31170, 의왕시,075,70~74세,2021,5284,2575,2709,95.1,5257,2563,2694,95.1
31170, 의왕시,075001, 70세,2021,1020,531,489,108.6,1013,526,487,108
31170, 의왕시,075002, 71세,2021,1022,500,522,95.8,1019,500,519,96.3
31170, 의왕시,075003, 72세,2021,1173,559,614,91,1167,554,613,90.4
31170, 의왕시,075004, 73세,2021,1083,510,573,89,1078,508,570,89.1
31170, 의왕시,075005, 74세,2021,986,475,511,93,980,475,505,94.1
31170, 의왕시,080,75~79세,2021,3868,1736,2132,81.4,3856,1731,2125,81.5
31170, 의왕시,080001, 75세,2021,803,382,421,90.7,800,380,420,90.5
31170, 의왕시,080002, 76세,2021,720,331,389,85.1,718,330,388,85.1
31170, 의왕시,080003, 77세,2021,754,343,411,83.5,752,342,410,83.4
31170, 의왕시,080004, 78세,2021,715,294,421,69.8,712,293,419,69.9
31170, 의왕시,080005, 79세,2021,876,386,490,78.8,874,386,488,79.1
31170, 의왕시,085,80~84세,2021,2837,1103,1734,63.6,2828,1099,1729,63.6
31170, 의왕시,085001, 80세,2021,666,276,390,70.8,664,276,388,71.1
31170, 의왕시,085002, 81세,2021,563,215,348,61.8,559,213,346,61.6
31170, 의왕시,085003, 82세,2021,588,239,349,68.5,586,237,349,67.9
31170, 의왕시,085004, 83세,2021,540,211,329,64.1,539,211,328,64.3
31170, 의왕시,085005, 84세,2021,480,162,318,50.9,480,162,318,50.9
31170, 의왕시,090,85~89세,2021,1642,465,1177,39.5,1641,465,1176,39.5
31170, 의왕시,090001, 85세,2021,397,124,273,45.4,396,124,272,45.6
31170, 의왕시,090002, 86세,2021,399,116,283,41,399,116,283,41
31170, 의왕시,090003, 87세,2021,328,86,242,35.5,328,86,242,35.5
31170, 의왕시,090004, 88세,2021,282,78,204,38.2,282,78,204,38.2
31170, 의왕시,090005, 89세,2021,236,61,175,34.9,236,61,175,34.9
31170, 의왕시,095,90~94세,2021,605,145,460,31.5,605,145,460,31.5
31170, 의왕시,095001, 90세,2021,193,50,143,35,193,50,143,35
31170, 의왕시,095002, 91세,2021,152,38,114,33.3,152,38,114,33.3
31170, 의왕시,095003, 92세,2021,109,25,84,29.8,109,25,84,29.8
31170, 의왕시,095004, 93세,2021,92,20,72,27.8,92,20,72,27.8
31170, 의왕시,095005, 94세,2021,59,12,47,25.5,59,12,47,25.5
31170, 의왕시,100,95~99세,2021,133,26,107,24.3,132,26,106,24.5
31170, 의왕시,100001, 95세,2021,47,10,37,27,46,10,36,27.8
31170, 의왕시,100002, 96세,2021,34,5,29,17.2,34,5,29,17.2
31170, 의왕시,100003, 97세,2021,22,X,18,22.2,22,X,18,22.2
31170, 의왕시,100004, 98세,2021,20,5,15,33.3,20,5,15,33.3
31170, 의왕시,100005, 99세,2021,10,X,8,25,10,X,8,25
31170, 의왕시,101,100세이상,2021,16,X,14,14.3,16,X,14,14.3
31170, 의왕시,102,15세미만,2021,19105,9845,9260,106.3,19052,9820,9232,106.4
31170, 의왕시,103,15~64세,2021,117658,58993,58665,100.6,116264,58337,57927,100.7
31170, 의왕시,104,65세이상,2021,23352,10595,12757,83.1,23250,10546,12704,83
31170, 의왕시,086,85세이상,2021,2396,638,1758,36.3,2394,638,1756,36.3
31170, 의왕시,126,평균연령,2021,42.8,41.8,43.8,,42.8,41.8,43.8,
31170, 의왕시,127,중위연령,2021,44.2,42.6,45.7,,44.3,42.7,45.8,
31180, 하남시,000,합계,2021,305470,152495,152975,99.7,302001,150739,151262,99.7
31180, 하남시,005,0~4세,2021,13455,6965,6490,107.3,13425,6950,6475,107.3
31180, 하남시,005001, 0세,2021,2291,1162,1129,102.9,2285,1161,1124,103.3
31180, 하남시,005002, 1세,2021,2316,1213,1103,110,2308,1209,1099,110
31180, 하남시,005003, 2세,2021,2624,1361,1263,107.8,2618,1358,1260,107.8
31180, 하남시,005004, 3세,2021,3021,1553,1468,105.8,3018,1550,1468,105.6
31180, 하남시,005005, 4세,2021,3203,1676,1527,109.8,3196,1672,1524,109.7
31180, 하남시,010,5~9세,2021,18031,9222,8809,104.7,18000,9207,8793,104.7
31180, 하남시,010001, 5세,2021,3664,1889,1775,106.4,3659,1885,1774,106.3
31180, 하남시,010002, 6세,2021,3759,1899,1860,102.1,3751,1896,1855,102.2
31180, 하남시,010003, 7세,2021,3579,1806,1773,101.9,3573,1802,1771,101.8
31180, 하남시,010004, 8세,2021,3494,1765,1729,102.1,3486,1763,1723,102.3
31180, 하남시,010005, 9세,2021,3535,1863,1672,111.4,3531,1861,1670,111.4
31180, 하남시,015,10~14세,2021,14980,7521,7459,100.8,14954,7509,7445,100.9
31180, 하남시,015001, 10세,2021,3317,1615,1702,94.9,3306,1608,1698,94.7
31180, 하남시,015002, 11세,2021,3164,1618,1546,104.7,3161,1617,1544,104.7
31180, 하남시,015003, 12세,2021,2808,1401,1407,99.6,2802,1400,1402,99.9
31180, 하남시,015004, 13세,2021,2892,1445,1447,99.9,2889,1444,1445,99.9
31180, 하남시,015005, 14세,2021,2799,1442,1357,106.3,2796,1440,1356,106.2
31180, 하남시,020,15~19세,2021,11247,5687,5560,102.3,11225,5671,5554,102.1
31180, 하남시,020001, 15세,2021,2354,1200,1154,104,2349,1195,1154,103.6
31180, 하남시,020002, 16세,2021,2249,1177,1072,109.8,2246,1175,1071,109.7
31180, 하남시,020003, 17세,2021,2300,1137,1163,97.8,2293,1131,1162,97.3
31180, 하남시,020004, 18세,2021,2220,1129,1091,103.5,2216,1128,1088,103.7
31180, 하남시,020005, 19세,2021,2124,1044,1080,96.7,2121,1042,1079,96.6
31180, 하남시,025,20~24세,2021,14536,7371,7165,102.9,14350,7292,7058,103.3
31180, 하남시,025001, 20세,2021,2526,1349,1177,114.6,2515,1346,1169,115.1
31180, 하남시,025002, 21세,2021,2742,1486,1256,118.3,2727,1483,1244,119.2
31180, 하남시,025003, 22세,2021,2822,1400,1422,98.5,2790,1388,1402,99
31180, 하남시,025004, 23세,2021,3009,1447,1562,92.6,2959,1424,1535,92.8
31180, 하남시,025005, 24세,2021,3437,1689,1748,96.6,3359,1651,1708,96.7
31180, 하남시,030,25~29세,2021,21226,10516,10710,98.2,20714,10248,10466,97.9
31180, 하남시,030001, 25세,2021,3703,1764,1939,91,3607,1722,1885,91.4
31180, 하남시,030002, 26세,2021,4044,1975,2069,95.5,3949,1927,2022,95.3
31180, 하남시,030003, 27세,2021,4250,2120,2130,99.5,4138,2063,2075,99.4
31180, 하남시,030004, 28세,2021,4429,2250,2179,103.3,4334,2198,2136,102.9
31180, 하남시,030005, 29세,2021,4800,2407,2393,100.6,4686,2338,2348,99.6
31180, 하남시,035,30~34세,2021,23253,11719,11534,101.6,22665,11385,11280,100.9
31180, 하남시,035001, 30세,2021,4801,2436,2365,103,4680,2371,2309,102.7
31180, 하남시,035002, 31세,2021,4550,2306,2244,102.8,4437,2243,2194,102.2
31180, 하남시,035003, 32세,2021,4559,2323,2236,103.9,4431,2251,2180,103.3
31180, 하남시,035004, 33세,2021,4541,2237,2304,97.1,4442,2179,2263,96.3
31180, 하남시,035005, 34세,2021,4802,2417,2385,101.3,4675,2341,2334,100.3
31180, 하남시,040,35~39세,2021,28300,14390,13910,103.5,27758,14071,13687,102.8
31180, 하남시,040001, 35세,2021,5007,2555,2452,104.2,4891,2493,2398,104
31180, 하남시,040002, 36세,2021,5134,2578,2556,100.9,5028,2519,2509,100.4
31180, 하남시,040003, 37세,2021,5377,2754,2623,105,5252,2667,2585,103.2
31180, 하남시,040004, 38세,2021,6188,3159,3029,104.3,6078,3095,2983,103.8
31180, 하남시,040005, 39세,2021,6594,3344,3250,102.9,6509,3297,3212,102.6
31180, 하남시,045,40~44세,2021,29849,15361,14488,106,29467,15148,14319,105.8
31180, 하남시,045001, 40세,2021,6666,3334,3332,100.1,6580,3283,3297,99.6
31180, 하남시,045002, 41세,2021,6559,3366,3193,105.4,6480,3320,3160,105.1
31180, 하남시,045003, 42세,2021,6128,3150,2978,105.8,6039,3106,2933,105.9
31180, 하남시,045004, 43세,2021,5202,2712,2490,108.9,5130,2671,2459,108.6
31180, 하남시,045005, 44세,2021,5294,2799,2495,112.2,5238,2768,2470,112.1
31180, 하남시,050,45~49세,2021,24523,12871,11652,110.5,24255,12743,11512,110.7
31180, 하남시,050001, 45세,2021,4904,2609,2295,113.7,4845,2577,2268,113.6
31180, 하남시,050002, 46세,2021,4777,2479,2298,107.9,4723,2463,2260,109
31180, 하남시,050003, 47세,2021,5119,2709,2410,112.4,5062,2683,2379,112.8
31180, 하남시,050004, 48세,2021,4803,2488,2315,107.5,4759,2463,2296,107.3
31180, 하남시,050005, 49세,2021,4920,2586,2334,110.8,4866,2557,2309,110.7
31180, 하남시,055,50~54세,2021,23195,11600,11595,100,22953,11498,11455,100.4
31180, 하남시,055001, 50세,2021,5071,2628,2443,107.6,5025,2606,2419,107.7
31180, 하남시,055002, 51세,2021,4718,2385,2333,102.2,4669,2365,2304,102.6
31180, 하남시,055003, 52세,2021,4624,2303,2321,99.2,4571,2277,2294,99.3
31180, 하남시,055004, 53세,2021,4564,2210,2354,93.9,4510,2193,2317,94.6
31180, 하남시,055005, 54세,2021,4218,2074,2144,96.7,4178,2057,2121,97
31180, 하남시,060,55~59세,2021,20822,10244,10578,96.8,20571,10145,10426,97.3
31180, 하남시,060001, 55세,2021,4110,2029,2081,97.5,4051,2008,2043,98.3
31180, 하남시,060002, 56세,2021,4212,2118,2094,101.1,4162,2096,2066,101.5
31180, 하남시,060003, 57세,2021,3990,1987,2003,99.2,3940,1967,1973,99.7
31180, 하남시,060004, 58세,2021,4209,2006,2203,91.1,4158,1986,2172,91.4
31180, 하남시,060005, 59세,2021,4301,2104,2197,95.8,4260,2088,2172,96.1
31180, 하남시,065,60~64세,2021,21725,10435,11290,92.4,21555,10368,11187,92.7
31180, 하남시,065001, 60세,2021,4723,2270,2453,92.5,4689,2257,2432,92.8
31180, 하남시,065002, 61세,2021,4791,2285,2506,91.2,4754,2273,2481,91.6
31180, 하남시,065003, 62세,2021,4210,2001,2209,90.6,4180,1990,2190,90.9
31180, 하남시,065004, 63세,2021,4017,1955,2062,94.8,3977,1941,2036,95.3
31180, 하남시,065005, 64세,2021,3984,1924,2060,93.4,3955,1907,2048,93.1
31180, 하남시,070,65~69세,2021,15983,7706,8277,93.1,15842,7648,8194,93.3
31180, 하남시,070001, 65세,2021,3564,1705,1859,91.7,3526,1690,1836,92
31180, 하남시,070002, 66세,2021,3678,1757,1921,91.5,3641,1747,1894,92.2
31180, 하남시,070003, 67세,2021,3103,1496,1607,93.1,3077,1483,1594,93
31180, 하남시,070004, 68세,2021,2696,1288,1408,91.5,2672,1276,1396,91.4
31180, 하남시,070005, 69세,2021,2942,1460,1482,98.5,2926,1452,1474,98.5
31180, 하남시,075,70~74세,2021,10372,5247,5125,102.4,10330,5228,5102,102.5
31180, 하남시,075001, 70세,2021,1996,972,1024,94.9,1985,969,1016,95.4
31180, 하남시,075002, 71세,2021,2091,1026,1065,96.3,2080,1020,1060,96.2
31180, 하남시,075003, 72세,2021,2189,1128,1061,106.3,2181,1123,1058,106.1
31180, 하남시,075004, 73세,2021,2103,1092,1011,108,2097,1089,1008,108
31180, 하남시,075005, 74세,2021,1993,1029,964,106.7,1987,1027,960,107
31180, 하남시,080,75~79세,2021,6545,3143,3402,92.4,6521,3132,3389,92.4
31180, 하남시,080001, 75세,2021,1452,733,719,101.9,1447,732,715,102.4
31180, 하남시,080002, 76세,2021,1327,668,659,101.4,1322,666,656,101.5
31180, 하남시,080003, 77세,2021,1290,634,656,96.6,1288,632,656,96.3
31180, 하남시,080004, 78세,2021,1170,550,620,88.7,1165,547,618,88.5
31180, 하남시,080005, 79세,2021,1306,558,748,74.6,1299,555,744,74.6
31180, 하남시,085,80~84세,2021,4149,1639,2510,65.3,4140,1639,2501,65.5
31180, 하남시,085001, 80세,2021,1003,433,570,76,1001,433,568,76.2
31180, 하남시,085002, 81세,2021,900,375,525,71.4,899,375,524,71.6
31180, 하남시,085003, 82세,2021,872,321,551,58.3,872,321,551,58.3
31180, 하남시,085004, 83세,2021,765,294,471,62.4,761,294,467,63
31180, 하남시,085005, 84세,2021,609,216,393,55,607,216,391,55.2
31180, 하남시,090,85~89세,2021,2195,627,1568,40,2193,626,1567,39.9
31180, 하남시,090001, 85세,2021,617,209,408,51.2,616,208,408,51
31180, 하남시,090002, 86세,2021,503,147,356,41.3,502,147,355,41.4
31180, 하남시,090003, 87세,2021,439,116,323,35.9,439,116,323,35.9
31180, 하남시,090004, 88세,2021,345,93,252,36.9,345,93,252,36.9
31180, 하남시,090005, 89세,2021,291,62,229,27.1,291,62,229,27.1
31180, 하남시,095,90~94세,2021,846,184,662,27.8,845,184,661,27.8
31180, 하남시,095001, 90세,2021,251,60,191,31.4,251,60,191,31.4
31180, 하남시,095002, 91세,2021,217,43,174,24.7,217,43,174,24.7
31180, 하남시,095003, 92세,2021,166,37,129,28.7,166,37,129,28.7
31180, 하남시,095004, 93세,2021,126,29,97,29.9,125,29,96,30.2
31180, 하남시,095005, 94세,2021,86,15,71,21.1,86,15,71,21.1
31180, 하남시,100,95~99세,2021,205,43,162,26.5,205,43,162,26.5
31180, 하남시,100001, 95세,2021,60,12,48,25,60,12,48,25
31180, 하남시,100002, 96세,2021,53,12,41,29.3,53,12,41,29.3
31180, 하남시,100003, 97세,2021,30,8,22,36.4,30,8,22,36.4
31180, 하남시,100004, 98세,2021,39,8,31,25.8,39,8,31,25.8
31180, 하남시,100005, 99세,2021,23,X,20,15,23,X,20,15
31180, 하남시,101,100세이상,2021,33,X,29,13.8,33,X,29,13.8
31180, 하남시,102,15세미만,2021,46466,23708,22758,104.2,46379,23666,22713,104.2
31180, 하남시,103,15~64세,2021,218676,110194,108482,101.6,215513,108569,106944,101.5
31180, 하남시,104,65세이상,2021,40328,18593,21735,85.5,40109,18504,21605,85.6
31180, 하남시,086,85세이상,2021,3279,858,2421,35.4,3276,857,2419,35.4
31180, 하남시,126,평균연령,2021,40.8,40.2,41.4,,40.8,40.2,41.4,
31180, 하남시,127,중위연령,2021,41.2,40.9,41.5,,41.2,40.9,41.5,
31190, 용인시,000,합계,2021,1067347,530349,536998,98.8,1042523,516763,525760,98.3
31190, 용인시,005,0~4세,2021,37476,19194,18282,105,37014,18950,18064,104.9
31190, 용인시,005001, 0세,2021,6193,3171,3022,104.9,6136,3140,2996,104.8
31190, 용인시,005002, 1세,2021,6568,3299,3269,100.9,6495,3258,3237,100.6
31190, 용인시,005003, 2세,2021,7422,3820,3602,106.1,7329,3772,3557,106
31190, 용인시,005004, 3세,2021,8127,4124,4003,103,8040,4081,3959,103.1
31190, 용인시,005005, 4세,2021,9166,4780,4386,109,9014,4699,4315,108.9
31190, 용인시,010,5~9세,2021,56635,28922,27713,104.4,56063,28654,27409,104.5
31190, 용인시,010001, 5세,2021,10426,5364,5062,106,10251,5275,4976,106
31190, 용인시,010002, 6세,2021,11265,5793,5472,105.9,11132,5729,5403,106
31190, 용인시,010003, 7세,2021,11217,5686,5531,102.8,11112,5646,5466,103.3
31190, 용인시,010004, 8세,2021,11341,5762,5579,103.3,11264,5728,5536,103.5
31190, 용인시,010005, 9세,2021,12386,6317,6069,104.1,12304,6276,6028,104.1
31190, 용인시,015,10~14세,2021,59741,30520,29221,104.4,59494,30399,29095,104.5
31190, 용인시,015001, 10세,2021,12038,6175,5863,105.3,11994,6151,5843,105.3
31190, 용인시,015002, 11세,2021,11771,6012,5759,104.4,11718,5986,5732,104.4
31190, 용인시,015003, 12세,2021,11452,5879,5573,105.5,11394,5856,5538,105.7
31190, 용인시,015004, 13세,2021,12133,6167,5966,103.4,12082,6143,5939,103.4
31190, 용인시,015005, 14세,2021,12347,6287,6060,103.7,12306,6263,6043,103.6
31190, 용인시,020,15~19세,2021,56201,28737,27464,104.6,55742,28531,27211,104.9
31190, 용인시,020001, 15세,2021,11069,5724,5345,107.1,11035,5705,5330,107
31190, 용인시,020002, 16세,2021,10614,5491,5123,107.2,10582,5475,5107,107.2
31190, 용인시,020003, 17세,2021,10941,5570,5371,103.7,10901,5549,5352,103.7
31190, 용인시,020004, 18세,2021,11073,5627,5446,103.3,10980,5589,5391,103.7
31190, 용인시,020005, 19세,2021,12504,6325,6179,102.4,12244,6213,6031,103
31190, 용인시,025,20~24세,2021,71070,36592,34478,106.1,68253,35163,33090,106.3
31190, 용인시,025001, 20세,2021,13810,6973,6837,102,13389,6801,6588,103.2
31190, 용인시,025002, 21세,2021,14796,7615,7181,106,14278,7365,6913,106.5
31190, 용인시,025003, 22세,2021,14032,7195,6837,105.2,13462,6926,6536,106
31190, 용인시,025004, 23세,2021,14208,7339,6869,106.8,13587,7009,6578,106.6
31190, 용인시,025005, 24세,2021,14224,7470,6754,110.6,13537,7062,6475,109.1
31190, 용인시,030,25~29세,2021,69499,37312,32187,115.9,65996,35128,30868,113.8
31190, 용인시,030001, 25세,2021,14188,7491,6697,111.9,13467,7056,6411,110.1
31190, 용인시,030002, 26세,2021,13972,7599,6373,119.2,13276,7178,6098,117.7
31190, 용인시,030003, 27세,2021,13926,7572,6354,119.2,13262,7127,6135,116.2
31190, 용인시,030004, 28세,2021,13778,7353,6425,114.4,13038,6886,6152,111.9
31190, 용인시,030005, 29세,2021,13635,7297,6338,115.1,12953,6881,6072,113.3
31190, 용인시,035,30~34세,2021,63214,32232,30982,104,59668,30016,29652,101.2
31190, 용인시,035001, 30세,2021,12889,6685,6204,107.8,12201,6237,5964,104.6
31190, 용인시,035002, 31세,2021,12423,6389,6034,105.9,11686,5942,5744,103.4
31190, 용인시,035003, 32세,2021,12573,6456,6117,105.5,11859,5986,5873,101.9
31190, 용인시,035004, 33세,2021,12581,6363,6218,102.3,11862,5922,5940,99.7
31190, 용인시,035005, 34세,2021,12748,6339,6409,98.9,12060,5929,6131,96.7
31190, 용인시,040,35~39세,2021,78246,38960,39286,99.2,75290,37221,38069,97.8
31190, 용인시,040001, 35세,2021,13442,6783,6659,101.9,12801,6414,6387,100.4
31190, 용인시,040002, 36세,2021,14046,7032,7014,100.3,13428,6655,6773,98.3
31190, 용인시,040003, 37세,2021,15019,7431,7588,97.9,14435,7080,7355,96.3
31190, 용인시,040004, 38세,2021,17054,8461,8593,98.5,16506,8144,8362,97.4
31190, 용인시,040005, 39세,2021,18685,9253,9432,98.1,18120,8928,9192,97.1
31190, 용인시,045,40~44세,2021,94270,46269,48001,96.4,92223,45110,47113,95.7
31190, 용인시,045001, 40세,2021,19250,9566,9684,98.8,18779,9279,9500,97.7
31190, 용인시,045002, 41세,2021,19710,9666,10044,96.2,19284,9423,9861,95.6
31190, 용인시,045003, 42세,2021,19306,9394,9912,94.8,18879,9165,9714,94.3
31190, 용인시,045004, 43세,2021,17350,8493,8857,95.9,16991,8297,8694,95.4
31190, 용인시,045005, 44세,2021,18654,9150,9504,96.3,18290,8946,9344,95.7
31190, 용인시,050,45~49세,2021,97819,48712,49107,99.2,96037,47748,48289,98.9
31190, 용인시,050001, 45세,2021,18106,9029,9077,99.5,17741,8825,8916,99
31190, 용인시,050002, 46세,2021,18847,9321,9526,97.8,18541,9159,9382,97.6
31190, 용인시,050003, 47세,2021,20600,10232,10368,98.7,20286,10079,10207,98.7
31190, 용인시,050004, 48세,2021,20069,9977,10092,98.9,19663,9753,9910,98.4
31190, 용인시,050005, 49세,2021,20197,10153,10044,101.1,19806,9932,9874,100.6
31190, 용인시,055,50~54세,2021,94941,47500,47441,100.1,93083,46545,46538,100
31190, 용인시,055001, 50세,2021,21101,10678,10423,102.4,20677,10455,10222,102.3
31190, 용인시,055002, 51세,2021,19892,9933,9959,99.7,19490,9719,9771,99.5
31190, 용인시,055003, 52세,2021,19237,9575,9662,99.1,18887,9392,9495,98.9
31190, 용인시,055004, 53세,2021,18393,9161,9232,99.2,18025,8959,9066,98.8
31190, 용인시,055005, 54세,2021,16318,8153,8165,99.9,16004,8020,7984,100.5
31190, 용인시,060,55~59세,2021,73211,37387,35824,104.4,71442,36554,34888,104.8
31190, 용인시,060001, 55세,2021,15103,7693,7410,103.8,14776,7537,7239,104.1
31190, 용인시,060002, 56세,2021,15515,7975,7540,105.8,15165,7805,7360,106
31190, 용인시,060003, 57세,2021,14180,7231,6949,104.1,13834,7079,6755,104.8
31190, 용인시,060004, 58세,2021,14598,7469,7129,104.8,14177,7276,6901,105.4
31190, 용인시,060005, 59세,2021,13815,7019,6796,103.3,13490,6857,6633,103.4
31190, 용인시,065,60~64세,2021,64691,31786,32905,96.6,63294,31133,32161,96.8
31190, 용인시,065001, 60세,2021,14731,7341,7390,99.3,14482,7237,7245,99.9
31190, 용인시,065002, 61세,2021,14042,6979,7063,98.8,13722,6838,6884,99.3
31190, 용인시,065003, 62세,2021,12714,6331,6383,99.2,12454,6208,6246,99.4
31190, 용인시,065004, 63세,2021,11838,5782,6056,95.5,11550,5630,5920,95.1
31190, 용인시,065005, 64세,2021,11366,5353,6013,89,11086,5220,5866,89
31190, 용인시,070,65~69세,2021,48859,22548,26311,85.7,48029,22154,25875,85.6
31190, 용인시,070001, 65세,2021,10588,5019,5569,90.1,10352,4898,5454,89.8
31190, 용인시,070002, 66세,2021,11083,5177,5906,87.7,10898,5091,5807,87.7
31190, 용인시,070003, 67세,2021,9292,4238,5054,83.9,9118,4156,4962,83.8
31190, 용인시,070004, 68세,2021,8622,3876,4746,81.7,8493,3821,4672,81.8
31190, 용인시,070005, 69세,2021,9274,4238,5036,84.2,9168,4188,4980,84.1
31190, 용인시,075,70~74세,2021,36497,16362,20135,81.3,36157,16202,19955,81.2
31190, 용인시,075001, 70세,2021,6369,2845,3524,80.7,6275,2794,3481,80.3
31190, 용인시,075002, 71세,2021,7380,3335,4045,82.4,7305,3303,4002,82.5
31190, 용인시,075003, 72세,2021,7405,3359,4046,83,7340,3330,4010,83
31190, 용인시,075004, 73세,2021,7531,3396,4135,82.1,7472,3374,4098,82.3
31190, 용인시,075005, 74세,2021,7812,3427,4385,78.2,7765,3401,4364,77.9
31190, 용인시,080,75~79세,2021,29466,13341,16125,82.7,29332,13302,16030,83
31190, 용인시,080001, 75세,2021,6306,2802,3504,80,6275,2792,3483,80.2
31190, 용인시,080002, 76세,2021,5808,2630,3178,82.8,5780,2624,3156,83.1
31190, 용인시,080003, 77세,2021,5568,2528,3040,83.2,5540,2517,3023,83.3
31190, 용인시,080004, 78세,2021,5549,2525,3024,83.5,5532,2521,3011,83.7
31190, 용인시,080005, 79세,2021,6235,2856,3379,84.5,6205,2848,3357,84.8
31190, 용인시,085,80~84세,2021,20396,9001,11395,79,20340,8985,11355,79.1
31190, 용인시,085001, 80세,2021,5167,2394,2773,86.3,5150,2389,2761,86.5
31190, 용인시,085002, 81세,2021,4314,1920,2394,80.2,4304,1917,2387,80.3
31190, 용인시,085003, 82세,2021,4118,1785,2333,76.5,4107,1782,2325,76.6
31190, 용인시,085004, 83세,2021,3570,1539,2031,75.8,3560,1536,2024,75.9
31190, 용인시,085005, 84세,2021,3227,1363,1864,73.1,3219,1361,1858,73.3
31190, 용인시,090,85~89세,2021,10333,3789,6544,57.9,10302,3785,6517,58.1
31190, 용인시,090001, 85세,2021,2720,1040,1680,61.9,2714,1040,1674,62.1
31190, 용인시,090002, 86세,2021,2474,967,1507,64.2,2466,966,1500,64.4
31190, 용인시,090003, 87세,2021,2029,717,1312,54.6,2023,715,1308,54.7
31190, 용인시,090004, 88세,2021,1696,589,1107,53.2,1689,588,1101,53.4
31190, 용인시,090005, 89세,2021,1414,476,938,50.7,1410,476,934,51
31190, 용인시,095,90~94세,2021,3757,982,2775,35.4,3743,981,2762,35.5
31190, 용인시,095001, 90세,2021,1036,292,744,39.2,1031,291,740,39.3
31190, 용인시,095002, 91세,2021,936,274,662,41.4,935,274,661,41.5
31190, 용인시,095003, 92세,2021,773,193,580,33.3,771,193,578,33.4
31190, 용인시,095004, 93세,2021,592,134,458,29.3,587,134,453,29.6
31190, 용인시,095005, 94세,2021,420,89,331,26.9,419,89,330,27
31190, 용인시,100,95~99세,2021,885,181,704,25.7,882,181,701,25.8
31190, 용인시,100001, 95세,2021,286,54,232,23.3,285,54,231,23.4
31190, 용인시,100002, 96세,2021,222,41,181,22.7,222,41,181,22.7
31190, 용인시,100003, 97세,2021,152,39,113,34.5,151,39,112,34.8
31190, 용인시,100004, 98세,2021,137,31,106,29.2,136,31,105,29.5
31190, 용인시,100005, 99세,2021,88,16,72,22.2,88,16,72,22.2
31190, 용인시,101,100세이상,2021,140,22,118,18.6,139,21,118,17.8
31190, 용인시,102,15세미만,2021,153852,78636,75216,104.5,152571,78003,74568,104.6
31190, 용인시,103,15~64세,2021,763162,385487,377675,102.1,741028,373149,367879,101.4
31190, 용인시,104,65세이상,2021,150333,66226,84107,78.7,148924,65611,83313,78.8
31190, 용인시,086,85세이상,2021,15115,4974,10141,49,15066,4968,10098,49.2
31190, 용인시,126,평균연령,2021,41.1,40.2,42,,41.2,40.3,42,
31190, 용인시,127,중위연령,2021,42.1,41.3,42.9,,42.3,41.5,43,
31191, 처인구,000,합계,2021,268115,138408,129707,106.7,255071,130246,124825,104.3
31191, 처인구,005,0~4세,2021,8267,4257,4010,106.2,8102,4168,3934,105.9
31191, 처인구,005001, 0세,2021,1389,728,661,110.1,1362,712,650,109.5
31191, 처인구,005002, 1세,2021,1465,744,721,103.2,1438,730,708,103.1
31191, 처인구,005003, 2세,2021,1623,827,796,103.9,1592,812,780,104.1
31191, 처인구,005004, 3세,2021,1777,915,862,106.1,1748,899,849,105.9
31191, 처인구,005005, 4세,2021,2013,1043,970,107.5,1962,1015,947,107.2
31191, 처인구,010,5~9세,2021,11797,6007,5790,103.7,11666,5947,5719,104
31191, 처인구,010001, 5세,2021,2206,1129,1077,104.8,2174,1115,1059,105.3
31191, 처인구,010002, 6세,2021,2329,1224,1105,110.8,2297,1210,1087,111.3
31191, 처인구,010003, 7세,2021,2324,1180,1144,103.1,2298,1170,1128,103.7
31191, 처인구,010004, 8세,2021,2335,1176,1159,101.5,2316,1168,1148,101.7
31191, 처인구,010005, 9세,2021,2603,1298,1305,99.5,2581,1284,1297,99
31191, 처인구,015,10~14세,2021,12270,6273,5997,104.6,12188,6235,5953,104.7
31191, 처인구,015001, 10세,2021,2528,1315,1213,108.4,2521,1311,1210,108.3
31191, 처인구,015002, 11세,2021,2400,1209,1191,101.5,2381,1198,1183,101.3
31191, 처인구,015003, 12세,2021,2361,1227,1134,108.2,2340,1219,1121,108.7
31191, 처인구,015004, 13세,2021,2461,1250,1211,103.2,2438,1241,1197,103.7
31191, 처인구,015005, 14세,2021,2520,1272,1248,101.9,2508,1266,1242,101.9
31191, 처인구,020,15~19세,2021,13729,7078,6651,106.4,13564,7004,6560,106.8
31191, 처인구,020001, 15세,2021,2222,1207,1015,118.9,2213,1201,1012,118.7
31191, 처인구,020002, 16세,2021,2243,1174,1069,109.8,2235,1173,1062,110.5
31191, 처인구,020003, 17세,2021,2524,1299,1225,106,2510,1292,1218,106.1
31191, 처인구,020004, 18세,2021,2816,1391,1425,97.6,2776,1373,1403,97.9
31191, 처인구,020005, 19세,2021,3924,2007,1917,104.7,3830,1965,1865,105.4
31191, 처인구,025,20~24세,2021,19878,10584,9294,113.9,18500,9730,8770,110.9
31191, 처인구,025001, 20세,2021,3833,1927,1906,101.1,3650,1828,1822,100.3
31191, 처인구,025002, 21세,2021,4096,2129,1967,108.2,3838,1988,1850,107.5
31191, 처인구,025003, 22세,2021,3885,2028,1857,109.2,3621,1872,1749,107
31191, 처인구,025004, 23세,2021,3978,2166,1812,119.5,3682,1978,1704,116.1
31191, 처인구,025005, 24세,2021,4086,2334,1752,133.2,3709,2064,1645,125.5
31191, 처인구,030,25~29세,2021,19559,11353,8206,138.3,17403,9789,7614,128.6
31191, 처인구,030001, 25세,2021,4074,2329,1745,133.5,3648,2026,1622,124.9
31191, 처인구,030002, 26세,2021,3837,2306,1531,150.6,3426,2004,1422,140.9
31191, 처인구,030003, 27세,2021,3897,2240,1657,135.2,3472,1916,1556,123.1
31191, 처인구,030004, 28세,2021,3884,2222,1662,133.7,3422,1892,1530,123.7
31191, 처인구,030005, 29세,2021,3867,2256,1611,140,3435,1951,1484,131.5
31191, 처인구,035,30~34세,2021,16838,9566,7272,131.5,14601,7977,6624,120.4
31191, 처인구,035001, 30세,2021,3575,2084,1491,139.8,3128,1758,1370,128.3
31191, 처인구,035002, 31세,2021,3390,1950,1440,135.4,2907,1611,1296,124.3
31191, 처인구,035003, 32세,2021,3371,1946,1425,136.6,2911,1607,1304,123.2
31191, 처인구,035004, 33세,2021,3235,1801,1434,125.6,2790,1485,1305,113.8
31191, 처인구,035005, 34세,2021,3267,1785,1482,120.4,2865,1516,1349,112.4
31191, 처인구,040,35~39세,2021,19310,10427,8883,117.4,17600,9283,8317,111.6
31191, 처인구,040001, 35세,2021,3377,1854,1523,121.7,3010,1619,1391,116.4
31191, 처인구,040002, 36세,2021,3514,1953,1561,125.1,3144,1702,1442,118
31191, 처인구,040003, 37세,2021,3730,1998,1732,115.4,3386,1759,1627,108.1
31191, 처인구,040004, 38세,2021,4211,2259,1952,115.7,3907,2054,1853,110.8
31191, 처인구,040005, 39세,2021,4478,2363,2115,111.7,4153,2149,2004,107.2
31191, 처인구,045,40~44세,2021,21502,11354,10148,111.9,20395,10647,9748,109.2
31191, 처인구,045001, 40세,2021,4442,2367,2075,114.1,4174,2182,1992,109.5
31191, 처인구,045002, 41세,2021,4526,2372,2154,110.1,4307,2230,2077,107.4
31191, 처인구,045003, 42세,2021,4505,2398,2107,113.8,4266,2253,2013,111.9
31191, 처인구,045004, 43세,2021,3916,2051,1865,110,3731,1936,1795,107.9
31191, 처인구,045005, 44세,2021,4113,2166,1947,111.2,3917,2046,1871,109.4
31191, 처인구,050,45~49세,2021,22159,11747,10412,112.8,21245,11223,10022,112
31191, 처인구,050001, 45세,2021,4084,2191,1893,115.7,3893,2084,1809,115.2
31191, 처인구,050002, 46세,2021,4233,2255,1978,114,4087,2174,1913,113.6
31191, 처인구,050003, 47세,2021,4580,2457,2123,115.7,4418,2363,2055,115
31191, 처인구,050004, 48세,2021,4624,2401,2223,108,4422,2284,2138,106.8
31191, 처인구,050005, 49세,2021,4638,2443,2195,111.3,4425,2318,2107,110
31191, 처인구,055,50~54세,2021,22910,11658,11252,103.6,22026,11168,10858,102.9
31191, 처인구,055001, 50세,2021,4768,2473,2295,107.8,4573,2357,2216,106.4
31191, 처인구,055002, 51세,2021,4597,2351,2246,104.7,4400,2245,2155,104.2
31191, 처인구,055003, 52세,2021,4711,2369,2342,101.2,4539,2266,2273,99.7
31191, 처인구,055004, 53세,2021,4676,2388,2288,104.4,4500,2285,2215,103.2
31191, 처인구,055005, 54세,2021,4158,2077,2081,99.8,4014,2015,1999,100.8
31191, 처인구,060,55~59세,2021,20855,10702,10153,105.4,20005,10285,9720,105.8
31191, 처인구,060001, 55세,2021,4254,2175,2079,104.6,4092,2100,1992,105.4
31191, 처인구,060002, 56세,2021,4410,2240,2170,103.2,4227,2143,2084,102.8
31191, 처인구,060003, 57세,2021,3891,2038,1853,110,3739,1965,1774,110.8
31191, 처인구,060004, 58세,2021,4155,2150,2005,107.2,3950,2044,1906,107.2
31191, 처인구,060005, 59세,2021,4145,2099,2046,102.6,3997,2033,1964,103.5
31191, 처인구,065,60~64세,2021,19757,10038,9719,103.3,19171,9735,9436,103.2
31191, 처인구,065001, 60세,2021,4611,2332,2279,102.3,4507,2283,2224,102.7
31191, 처인구,065002, 61세,2021,4320,2233,2087,107,4185,2166,2019,107.3
31191, 처인구,065003, 62세,2021,3901,2025,1876,107.9,3791,1972,1819,108.4
31191, 처인구,065004, 63세,2021,3591,1848,1743,106,3462,1766,1696,104.1
31191, 처인구,065005, 64세,2021,3334,1600,1734,92.3,3226,1548,1678,92.3
31191, 처인구,070,65~69세,2021,14042,6877,7165,96,13634,6670,6964,95.8
31191, 처인구,070001, 65세,2021,3201,1600,1601,99.9,3085,1537,1548,99.3
31191, 처인구,070002, 66세,2021,3187,1573,1614,97.5,3101,1526,1575,96.9
31191, 처인구,070003, 67세,2021,2642,1248,1394,89.5,2560,1212,1348,89.9
31191, 처인구,070004, 68세,2021,2360,1142,1218,93.8,2296,1115,1181,94.4
31191, 처인구,070005, 69세,2021,2652,1314,1338,98.2,2592,1280,1312,97.6
31191, 처인구,075,70~74세,2021,9053,4320,4733,91.3,8890,4241,4649,91.2
31191, 처인구,075001, 70세,2021,1727,807,920,87.7,1673,778,895,86.9
31191, 처인구,075002, 71세,2021,1890,914,976,93.6,1850,895,955,93.7
31191, 처인구,075003, 72세,2021,1790,886,904,98,1763,872,891,97.9
31191, 처인구,075004, 73세,2021,1814,858,956,89.7,1789,850,939,90.5
31191, 처인구,075005, 74세,2021,1832,855,977,87.5,1815,846,969,87.3
31191, 처인구,080,75~79세,2021,6947,3029,3918,77.3,6884,3014,3870,77.9
31191, 처인구,080001, 75세,2021,1432,677,755,89.7,1418,674,744,90.6
31191, 처인구,080002, 76세,2021,1361,610,751,81.2,1347,607,740,82
31191, 처인구,080003, 77세,2021,1340,588,752,78.2,1327,583,744,78.4
31191, 처인구,080004, 78세,2021,1342,555,787,70.5,1335,554,781,70.9
31191, 처인구,080005, 79세,2021,1472,599,873,68.6,1457,596,861,69.2
31191, 처인구,085,80~84세,2021,5042,1944,3098,62.8,5016,1939,3077,63
31191, 처인구,085001, 80세,2021,1246,517,729,70.9,1238,516,722,71.5
31191, 처인구,085002, 81세,2021,1029,407,622,65.4,1024,407,617,66
31191, 처인구,085003, 82세,2021,1038,386,652,59.2,1032,384,648,59.3
31191, 처인구,085004, 83세,2021,887,306,581,52.7,884,305,579,52.7
31191, 처인구,085005, 84세,2021,842,328,514,63.8,838,327,511,64
31191, 처인구,090,85~89세,2021,2895,934,1961,47.6,2882,932,1950,47.8
31191, 처인구,090001, 85세,2021,730,249,481,51.8,727,249,478,52.1
31191, 처인구,090002, 86세,2021,719,244,475,51.4,716,244,472,51.7
31191, 처인구,090003, 87세,2021,594,191,403,47.4,590,189,401,47.1
31191, 처인구,090004, 88세,2021,470,146,324,45.1,468,146,322,45.3
31191, 처인구,090005, 89세,2021,382,104,278,37.4,381,104,277,37.5
31191, 처인구,095,90~94세,2021,1037,216,821,26.3,1031,215,816,26.3
31191, 처인구,095001, 90세,2021,295,68,227,30,292,67,225,29.8
31191, 처인구,095002, 91세,2021,255,62,193,32.1,254,62,192,32.3
31191, 처인구,095003, 92세,2021,207,41,166,24.7,206,41,165,24.8
31191, 처인구,095004, 93세,2021,157,18,139,12.9,156,18,138,13
31191, 처인구,095005, 94세,2021,123,27,96,28.1,123,27,96,28.1
31191, 처인구,100,95~99세,2021,231,40,191,20.9,231,40,191,20.9
31191, 처인구,100001, 95세,2021,83,13,70,18.6,83,13,70,18.6
31191, 처인구,100002, 96세,2021,64,11,53,20.8,64,11,53,20.8
31191, 처인구,100003, 97세,2021,32,9,23,39.1,32,9,23,39.1
31191, 처인구,100004, 98세,2021,37,6,31,19.4,37,6,31,19.4
31191, 처인구,100005, 99세,2021,15,X,14,7.1,15,X,14,7.1
31191, 처인구,101,100세이상,2021,37,X,33,12.1,37,X,33,12.1
31191, 처인구,102,15세미만,2021,32334,16537,15797,104.7,31956,16350,15606,104.8
31191, 처인구,103,15~64세,2021,196497,104507,91990,113.6,184510,96841,87669,110.5
31191, 처인구,104,65세이상,2021,39284,17364,21920,79.2,38605,17055,21550,79.1
31191, 처인구,086,85세이상,2021,4200,1194,3006,39.7,4181,1191,2990,39.8
31191, 처인구,126,평균연령,2021,42.1,41.1,43.3,,42.3,41.3,43.4,
31191, 처인구,127,중위연령,2021,42.8,41.5,44.3,,43.3,42.3,44.6,
31192, 기흥구,000,합계,2021,435708,214973,220735,97.4,428758,211601,217157,97.4
31192, 기흥구,005,0~4세,2021,15712,8089,7623,106.1,15565,8020,7545,106.3
31192, 기흥구,005001, 0세,2021,2555,1320,1235,106.9,2537,1315,1222,107.6
31192, 기흥구,005002, 1세,2021,2755,1390,1365,101.8,2731,1376,1355,101.5
31192, 기흥구,005003, 2세,2021,3147,1628,1519,107.2,3112,1608,1504,106.9
31192, 기흥구,005004, 3세,2021,3453,1761,1692,104.1,3425,1750,1675,104.5
31192, 기흥구,005005, 4세,2021,3802,1990,1812,109.8,3760,1971,1789,110.2
31192, 기흥구,010,5~9세,2021,23911,12233,11678,104.8,23744,12159,11585,105
31192, 기흥구,010001, 5세,2021,4425,2287,2138,107,4371,2257,2114,106.8
31192, 기흥구,010002, 6세,2021,4752,2452,2300,106.6,4720,2436,2284,106.7
31192, 기흥구,010003, 7세,2021,4673,2352,2321,101.3,4640,2342,2298,101.9
31192, 기흥구,010004, 8세,2021,4736,2417,2319,104.2,4716,2412,2304,104.7
31192, 기흥구,010005, 9세,2021,5325,2725,2600,104.8,5297,2712,2585,104.9
31192, 기흥구,015,10~14세,2021,25202,12898,12304,104.8,25127,12860,12267,104.8
31192, 기흥구,015001, 10세,2021,5056,2573,2483,103.6,5038,2562,2476,103.5
31192, 기흥구,015002, 11세,2021,5029,2590,2439,106.2,5014,2584,2430,106.3
31192, 기흥구,015003, 12세,2021,4748,2437,2311,105.5,4728,2428,2300,105.6
31192, 기흥구,015004, 13세,2021,5084,2594,2490,104.2,5075,2590,2485,104.2
31192, 기흥구,015005, 14세,2021,5285,2704,2581,104.8,5272,2696,2576,104.7
31192, 기흥구,020,15~19세,2021,22344,11475,10869,105.6,22212,11412,10800,105.7
31192, 기흥구,020001, 15세,2021,4639,2418,2221,108.9,4626,2412,2214,108.9
31192, 기흥구,020002, 16세,2021,4404,2265,2139,105.9,4392,2257,2135,105.7
31192, 기흥구,020003, 17세,2021,4378,2237,2141,104.5,4367,2230,2137,104.4
31192, 기흥구,020004, 18세,2021,4337,2230,2107,105.8,4317,2223,2094,106.2
31192, 기흥구,020005, 19세,2021,4586,2325,2261,102.8,4510,2290,2220,103.2
31192, 기흥구,025,20~24세,2021,28706,14748,13958,105.7,27991,14409,13582,106.1
31192, 기흥구,025001, 20세,2021,5542,2864,2678,106.9,5428,2824,2604,108.4
31192, 기흥구,025002, 21세,2021,6002,3121,2881,108.3,5875,3060,2815,108.7
31192, 기흥구,025003, 22세,2021,5760,2954,2806,105.3,5606,2881,2725,105.7
31192, 기흥구,025004, 23세,2021,5745,2934,2811,104.4,5580,2845,2735,104
31192, 기흥구,025005, 24세,2021,5657,2875,2782,103.3,5502,2799,2703,103.6
31192, 기흥구,030,25~29세,2021,28108,15050,13058,115.3,27306,14641,12665,115.6
31192, 기흥구,030001, 25세,2021,5724,2998,2726,110,5556,2908,2648,109.8
31192, 기흥구,030002, 26세,2021,5729,3082,2647,116.4,5577,3011,2566,117.3
31192, 기흥구,030003, 27세,2021,5688,3109,2579,120.6,5536,3026,2510,120.6
31192, 기흥구,030004, 28세,2021,5548,2971,2577,115.3,5380,2882,2498,115.4
31192, 기흥구,030005, 29세,2021,5419,2890,2529,114.3,5257,2814,2443,115.2
31192, 기흥구,035,30~34세,2021,24987,12459,12528,99.4,24139,12040,12099,99.5
31192, 기흥구,035001, 30세,2021,5121,2603,2518,103.4,4957,2511,2446,102.7
31192, 기흥구,035002, 31세,2021,4951,2480,2471,100.4,4786,2407,2379,101.2
31192, 기흥구,035003, 32세,2021,4960,2483,2477,100.2,4803,2402,2401,100
31192, 기흥구,035004, 33세,2021,4964,2460,2504,98.2,4791,2383,2408,99
31192, 기흥구,035005, 34세,2021,4991,2433,2558,95.1,4802,2337,2465,94.8
31192, 기흥구,040,35~39세,2021,31777,15564,16213,96,31008,15189,15819,96
31192, 기흥구,040001, 35세,2021,5402,2731,2671,102.2,5232,2644,2588,102.2
31192, 기흥구,040002, 36세,2021,5623,2763,2860,96.6,5463,2681,2782,96.4
31192, 기흥구,040003, 37세,2021,6108,2965,3143,94.3,5951,2896,3055,94.8
31192, 기흥구,040004, 38세,2021,6889,3365,3524,95.5,6749,3297,3452,95.5
31192, 기흥구,040005, 39세,2021,7755,3740,4015,93.2,7613,3671,3942,93.1
31192, 기흥구,045,40~44세,2021,39234,19084,20150,94.7,38679,18814,19865,94.7
31192, 기흥구,045001, 40세,2021,8011,3927,4084,96.2,7892,3866,4026,96
31192, 기흥구,045002, 41세,2021,8296,4050,4246,95.4,8177,3992,4185,95.4
31192, 기흥구,045003, 42세,2021,7919,3843,4076,94.3,7812,3797,4015,94.6
31192, 기흥구,045004, 43세,2021,7237,3507,3730,94,7131,3455,3676,94
31192, 기흥구,045005, 44세,2021,7771,3757,4014,93.6,7667,3704,3963,93.5
31192, 기흥구,050,45~49세,2021,40774,20024,20750,96.5,40241,19746,20495,96.3
31192, 기흥구,050001, 45세,2021,7428,3658,3770,97,7322,3598,3724,96.6
31192, 기흥구,050002, 46세,2021,7847,3817,4030,94.7,7745,3768,3977,94.7
31192, 기흥구,050003, 47세,2021,8625,4220,4405,95.8,8538,4186,4352,96.2
31192, 기흥구,050004, 48세,2021,8481,4176,4305,97,8355,4102,4253,96.4
31192, 기흥구,050005, 49세,2021,8393,4153,4240,97.9,8281,4092,4189,97.7
31192, 기흥구,055,50~54세,2021,39510,19658,19852,99,38898,19356,19542,99
31192, 기흥구,055001, 50세,2021,8822,4426,4396,100.7,8676,4358,4318,100.9
31192, 기흥구,055002, 51세,2021,8434,4200,4234,99.2,8304,4128,4176,98.9
31192, 기흥구,055003, 52세,2021,7830,3890,3940,98.7,7730,3841,3889,98.8
31192, 기흥구,055004, 53세,2021,7611,3735,3876,96.4,7483,3670,3813,96.2
31192, 기흥구,055005, 54세,2021,6813,3407,3406,100,6705,3359,3346,100.4
31192, 기흥구,060,55~59세,2021,29160,14824,14336,103.4,28569,14544,14025,103.7
31192, 기흥구,060001, 55세,2021,6012,3064,2948,103.9,5903,3006,2897,103.8
31192, 기흥구,060002, 56세,2021,6194,3203,2991,107.1,6085,3147,2938,107.1
31192, 기흥구,060003, 57세,2021,5626,2863,2763,103.6,5503,2818,2685,105
31192, 기흥구,060004, 58세,2021,5848,2956,2892,102.2,5715,2896,2819,102.7
31192, 기흥구,060005, 59세,2021,5480,2738,2742,99.9,5363,2677,2686,99.7
31192, 기흥구,065,60~64세,2021,25276,12190,13086,93.2,24765,11954,12811,93.3
31192, 기흥구,065001, 60세,2021,5752,2850,2902,98.2,5670,2816,2854,98.7
31192, 기흥구,065002, 61세,2021,5394,2617,2777,94.2,5277,2569,2708,94.9
31192, 기흥구,065003, 62세,2021,5047,2463,2584,95.3,4947,2414,2533,95.3
31192, 기흥구,065004, 63세,2021,4595,2154,2441,88.2,4494,2108,2386,88.3
31192, 기흥구,065005, 64세,2021,4488,2106,2382,88.4,4377,2047,2330,87.9
31192, 기흥구,070,65~69세,2021,19253,8782,10471,83.9,18975,8645,10330,83.7
31192, 기흥구,070001, 65세,2021,4170,2010,2160,93.1,4084,1963,2121,92.6
31192, 기흥구,070002, 66세,2021,4328,1963,2365,83,4266,1936,2330,83.1
31192, 기흥구,070003, 67세,2021,3636,1658,1978,83.8,3574,1624,1950,83.3
31192, 기흥구,070004, 68세,2021,3413,1516,1897,79.9,3370,1496,1874,79.8
31192, 기흥구,070005, 69세,2021,3706,1635,2071,78.9,3681,1626,2055,79.1
31192, 기흥구,075,70~74세,2021,14722,6474,8248,78.5,14595,6418,8177,78.5
31192, 기흥구,075001, 70세,2021,2538,1108,1430,77.5,2508,1093,1415,77.2
31192, 기흥구,075002, 71세,2021,2909,1310,1599,81.9,2886,1303,1583,82.3
31192, 기흥구,075003, 72세,2021,2970,1279,1691,75.6,2947,1271,1676,75.8
31192, 기흥구,075004, 73세,2021,3062,1355,1707,79.4,3034,1344,1690,79.5
31192, 기흥구,075005, 74세,2021,3243,1422,1821,78.1,3220,1407,1813,77.6
31192, 기흥구,080,75~79세,2021,12064,5465,6599,82.8,12014,5448,6566,83
31192, 기흥구,080001, 75세,2021,2642,1160,1482,78.3,2630,1156,1474,78.4
31192, 기흥구,080002, 76세,2021,2345,1064,1281,83.1,2336,1061,1275,83.2
31192, 기흥구,080003, 77세,2021,2269,1033,1236,83.6,2260,1031,1229,83.9
31192, 기흥구,080004, 78세,2021,2244,1012,1232,82.1,2237,1009,1228,82.2
31192, 기흥구,080005, 79세,2021,2564,1196,1368,87.4,2551,1191,1360,87.6
31192, 기흥구,085,80~84세,2021,8470,3742,4728,79.1,8449,3733,4716,79.2
31192, 기흥구,085001, 80세,2021,2143,1005,1138,88.3,2137,1002,1135,88.3
31192, 기흥구,085002, 81세,2021,1797,800,997,80.2,1792,797,995,80.1
31192, 기흥구,085003, 82세,2021,1719,725,994,72.9,1715,724,991,73.1
31192, 기흥구,085004, 83세,2021,1505,658,847,77.7,1501,657,844,77.8
31192, 기흥구,085005, 84세,2021,1306,554,752,73.7,1304,553,751,73.6
31192, 기흥구,090,85~89세,2021,4373,1659,2714,61.1,4362,1659,2703,61.4
31192, 기흥구,090001, 85세,2021,1179,474,705,67.2,1176,474,702,67.5
31192, 기흥구,090002, 86세,2021,995,390,605,64.5,994,390,604,64.6
31192, 기흥구,090003, 87세,2021,858,311,547,56.9,857,311,546,57
31192, 기흥구,090004, 88세,2021,736,264,472,55.9,733,264,469,56.3
31192, 기흥구,090005, 89세,2021,605,220,385,57.1,602,220,382,57.6
31192, 기흥구,095,90~94세,2021,1658,463,1195,38.7,1654,463,1191,38.9
31192, 기흥구,095001, 90세,2021,440,134,306,43.8,439,134,305,43.9
31192, 기흥구,095002, 91세,2021,418,127,291,43.6,418,127,291,43.6
31192, 기흥구,095003, 92세,2021,361,103,258,39.9,361,103,258,39.9
31192, 기흥구,095004, 93세,2021,247,60,187,32.1,244,60,184,32.6
31192, 기흥구,095005, 94세,2021,192,39,153,25.5,192,39,153,25.5
31192, 기흥구,100,95~99세,2021,406,78,328,23.8,405,78,327,23.9
31192, 기흥구,100001, 95세,2021,133,25,108,23.1,133,25,108,23.1
31192, 기흥구,100002, 96세,2021,91,14,77,18.2,91,14,77,18.2
31192, 기흥구,100003, 97세,2021,73,16,57,28.1,73,16,57,28.1
31192, 기흥구,100004, 98세,2021,66,15,51,29.4,65,15,50,30
31192, 기흥구,100005, 99세,2021,43,8,35,22.9,43,8,35,22.9
31192, 기흥구,101,100세이상,2021,61,14,47,29.8,60,13,47,27.7
31192, 기흥구,102,15세미만,2021,64825,33220,31605,105.1,64436,33039,31397,105.2
31192, 기흥구,103,15~64세,2021,309876,155076,154800,100.2,303808,152105,151703,100.3
31192, 기흥구,104,65세이상,2021,61007,26677,34330,77.7,60514,26457,34057,77.7
31192, 기흥구,086,85세이상,2021,6498,2214,4284,51.7,6481,2213,4268,51.9
31192, 기흥구,126,평균연령,2021,41,40,41.9,,41,40,42,
31192, 기흥구,127,중위연령,2021,42.1,41.3,42.9,,42.2,41.3,43,
31193, 수지구,000,합계,2021,363524,176968,186556,94.9,358694,174916,183778,95.2
31193, 수지구,005,0~4세,2021,13497,6848,6649,103,13347,6762,6585,102.7
31193, 수지구,005001, 0세,2021,2249,1123,1126,99.7,2237,1113,1124,99
31193, 수지구,005002, 1세,2021,2348,1165,1183,98.5,2326,1152,1174,98.1
31193, 수지구,005003, 2세,2021,2652,1365,1287,106.1,2625,1352,1273,106.2
31193, 수지구,005004, 3세,2021,2897,1448,1449,99.9,2867,1432,1435,99.8
31193, 수지구,005005, 4세,2021,3351,1747,1604,108.9,3292,1713,1579,108.5
31193, 수지구,010,5~9세,2021,20927,10682,10245,104.3,20653,10548,10105,104.4
31193, 수지구,010001, 5세,2021,3795,1948,1847,105.5,3706,1903,1803,105.5
31193, 수지구,010002, 6세,2021,4184,2117,2067,102.4,4115,2083,2032,102.5
31193, 수지구,010003, 7세,2021,4220,2154,2066,104.3,4174,2134,2040,104.6
31193, 수지구,010004, 8세,2021,4270,2169,2101,103.2,4232,2148,2084,103.1
31193, 수지구,010005, 9세,2021,4458,2294,2164,106,4426,2280,2146,106.2
31193, 수지구,015,10~14세,2021,22269,11349,10920,103.9,22179,11304,10875,103.9
31193, 수지구,015001, 10세,2021,4454,2287,2167,105.5,4435,2278,2157,105.6
31193, 수지구,015002, 11세,2021,4342,2213,2129,103.9,4323,2204,2119,104
31193, 수지구,015003, 12세,2021,4343,2215,2128,104.1,4326,2209,2117,104.3
31193, 수지구,015004, 13세,2021,4588,2323,2265,102.6,4569,2312,2257,102.4
31193, 수지구,015005, 14세,2021,4542,2311,2231,103.6,4526,2301,2225,103.4
31193, 수지구,020,15~19세,2021,20128,10184,9944,102.4,19966,10115,9851,102.7
31193, 수지구,020001, 15세,2021,4208,2099,2109,99.5,4196,2092,2104,99.4
31193, 수지구,020002, 16세,2021,3967,2052,1915,107.2,3955,2045,1910,107.1
31193, 수지구,020003, 17세,2021,4039,2034,2005,101.4,4024,2027,1997,101.5
31193, 수지구,020004, 18세,2021,3920,2006,1914,104.8,3887,1993,1894,105.2
31193, 수지구,020005, 19세,2021,3994,1993,2001,99.6,3904,1958,1946,100.6
31193, 수지구,025,20~24세,2021,22486,11260,11226,100.3,21762,11024,10738,102.7
31193, 수지구,025001, 20세,2021,4435,2182,2253,96.8,4311,2149,2162,99.4
31193, 수지구,025002, 21세,2021,4698,2365,2333,101.4,4565,2317,2248,103.1
31193, 수지구,025003, 22세,2021,4387,2213,2174,101.8,4235,2173,2062,105.4
31193, 수지구,025004, 23세,2021,4485,2239,2246,99.7,4325,2186,2139,102.2
31193, 수지구,025005, 24세,2021,4481,2261,2220,101.8,4326,2199,2127,103.4
31193, 수지구,030,25~29세,2021,21832,10909,10923,99.9,21287,10698,10589,101
31193, 수지구,030001, 25세,2021,4390,2164,2226,97.2,4263,2122,2141,99.1
31193, 수지구,030002, 26세,2021,4406,2211,2195,100.7,4273,2163,2110,102.5
31193, 수지구,030003, 27세,2021,4341,2223,2118,105,4254,2185,2069,105.6
31193, 수지구,030004, 28세,2021,4346,2160,2186,98.8,4236,2112,2124,99.4
31193, 수지구,030005, 29세,2021,4349,2151,2198,97.9,4261,2116,2145,98.6
31193, 수지구,035,30~34세,2021,21389,10207,11182,91.3,20928,9999,10929,91.5
31193, 수지구,035001, 30세,2021,4193,1998,2195,91,4116,1968,2148,91.6
31193, 수지구,035002, 31세,2021,4082,1959,2123,92.3,3993,1924,2069,93
31193, 수지구,035003, 32세,2021,4242,2027,2215,91.5,4145,1977,2168,91.2
31193, 수지구,035004, 33세,2021,4382,2102,2280,92.2,4281,2054,2227,92.2
31193, 수지구,035005, 34세,2021,4490,2121,2369,89.5,4393,2076,2317,89.6
31193, 수지구,040,35~39세,2021,27159,12969,14190,91.4,26682,12749,13933,91.5
31193, 수지구,040001, 35세,2021,4663,2198,2465,89.2,4559,2151,2408,89.3
31193, 수지구,040002, 36세,2021,4909,2316,2593,89.3,4821,2272,2549,89.1
31193, 수지구,040003, 37세,2021,5181,2468,2713,91,5098,2425,2673,90.7
31193, 수지구,040004, 38세,2021,5954,2837,3117,91,5850,2793,3057,91.4
31193, 수지구,040005, 39세,2021,6452,3150,3302,95.4,6354,3108,3246,95.7
31193, 수지구,045,40~44세,2021,33534,15831,17703,89.4,33149,15649,17500,89.4
31193, 수지구,045001, 40세,2021,6797,3272,3525,92.8,6713,3231,3482,92.8
31193, 수지구,045002, 41세,2021,6888,3244,3644,89,6800,3201,3599,88.9
31193, 수지구,045003, 42세,2021,6882,3153,3729,84.6,6801,3115,3686,84.5
31193, 수지구,045004, 43세,2021,6197,2935,3262,90,6129,2906,3223,90.2
31193, 수지구,045005, 44세,2021,6770,3227,3543,91.1,6706,3196,3510,91.1
31193, 수지구,050,45~49세,2021,34886,16941,17945,94.4,34551,16779,17772,94.4
31193, 수지구,050001, 45세,2021,6594,3180,3414,93.1,6526,3143,3383,92.9
31193, 수지구,050002, 46세,2021,6767,3249,3518,92.4,6709,3217,3492,92.1
31193, 수지구,050003, 47세,2021,7395,3555,3840,92.6,7330,3530,3800,92.9
31193, 수지구,050004, 48세,2021,6964,3400,3564,95.4,6886,3367,3519,95.7
31193, 수지구,050005, 49세,2021,7166,3557,3609,98.6,7100,3522,3578,98.4
31193, 수지구,055,50~54세,2021,32521,16184,16337,99.1,32159,16021,16138,99.3
31193, 수지구,055001, 50세,2021,7511,3779,3732,101.3,7428,3740,3688,101.4
31193, 수지구,055002, 51세,2021,6861,3382,3479,97.2,6786,3346,3440,97.3
31193, 수지구,055003, 52세,2021,6696,3316,3380,98.1,6618,3285,3333,98.6
31193, 수지구,055004, 53세,2021,6106,3038,3068,99,6042,3004,3038,98.9
31193, 수지구,055005, 54세,2021,5347,2669,2678,99.7,5285,2646,2639,100.3
31193, 수지구,060,55~59세,2021,23196,11861,11335,104.6,22868,11725,11143,105.2
31193, 수지구,060001, 55세,2021,4837,2454,2383,103,4781,2431,2350,103.4
31193, 수지구,060002, 56세,2021,4911,2532,2379,106.4,4853,2515,2338,107.6
31193, 수지구,060003, 57세,2021,4663,2330,2333,99.9,4592,2296,2296,100
31193, 수지구,060004, 58세,2021,4595,2363,2232,105.9,4512,2336,2176,107.4
31193, 수지구,060005, 59세,2021,4190,2182,2008,108.7,4130,2147,1983,108.3
31193, 수지구,065,60~64세,2021,19658,9558,10100,94.6,19358,9444,9914,95.3
31193, 수지구,065001, 60세,2021,4368,2159,2209,97.7,4305,2138,2167,98.7
31193, 수지구,065002, 61세,2021,4328,2129,2199,96.8,4260,2103,2157,97.5
31193, 수지구,065003, 62세,2021,3766,1843,1923,95.8,3716,1822,1894,96.2
31193, 수지구,065004, 63세,2021,3652,1780,1872,95.1,3594,1756,1838,95.5
31193, 수지구,065005, 64세,2021,3544,1647,1897,86.8,3483,1625,1858,87.5
31193, 수지구,070,65~69세,2021,15564,6889,8675,79.4,15420,6839,8581,79.7
31193, 수지구,070001, 65세,2021,3217,1409,1808,77.9,3183,1398,1785,78.3
31193, 수지구,070002, 66세,2021,3568,1641,1927,85.2,3531,1629,1902,85.6
31193, 수지구,070003, 67세,2021,3014,1332,1682,79.2,2984,1320,1664,79.3
31193, 수지구,070004, 68세,2021,2849,1218,1631,74.7,2827,1210,1617,74.8
31193, 수지구,070005, 69세,2021,2916,1289,1627,79.2,2895,1282,1613,79.5
31193, 수지구,075,70~74세,2021,12722,5568,7154,77.8,12672,5543,7129,77.8
31193, 수지구,075001, 70세,2021,2104,930,1174,79.2,2094,923,1171,78.8
31193, 수지구,075002, 71세,2021,2581,1111,1470,75.6,2569,1105,1464,75.5
31193, 수지구,075003, 72세,2021,2645,1194,1451,82.3,2630,1187,1443,82.3
31193, 수지구,075004, 73세,2021,2655,1183,1472,80.4,2649,1180,1469,80.3
31193, 수지구,075005, 74세,2021,2737,1150,1587,72.5,2730,1148,1582,72.6
31193, 수지구,080,75~79세,2021,10455,4847,5608,86.4,10434,4840,5594,86.5
31193, 수지구,080001, 75세,2021,2232,965,1267,76.2,2227,962,1265,76
31193, 수지구,080002, 76세,2021,2102,956,1146,83.4,2097,956,1141,83.8
31193, 수지구,080003, 77세,2021,1959,907,1052,86.2,1953,903,1050,86
31193, 수지구,080004, 78세,2021,1963,958,1005,95.3,1960,958,1002,95.6
31193, 수지구,080005, 79세,2021,2199,1061,1138,93.2,2197,1061,1136,93.4
31193, 수지구,085,80~84세,2021,6884,3315,3569,92.9,6875,3313,3562,93
31193, 수지구,085001, 80세,2021,1778,872,906,96.2,1775,871,904,96.3
31193, 수지구,085002, 81세,2021,1488,713,775,92,1488,713,775,92
31193, 수지구,085003, 82세,2021,1361,674,687,98.1,1360,674,686,98.3
31193, 수지구,085004, 83세,2021,1178,575,603,95.4,1175,574,601,95.5
31193, 수지구,085005, 84세,2021,1079,481,598,80.4,1077,481,596,80.7
31193, 수지구,090,85~89세,2021,3065,1196,1869,64,3058,1194,1864,64.1
31193, 수지구,090001, 85세,2021,811,317,494,64.2,811,317,494,64.2
31193, 수지구,090002, 86세,2021,760,333,427,78,756,332,424,78.3
31193, 수지구,090003, 87세,2021,577,215,362,59.4,576,215,361,59.6
31193, 수지구,090004, 88세,2021,490,179,311,57.6,488,178,310,57.4
31193, 수지구,090005, 89세,2021,427,152,275,55.3,427,152,275,55.3
31193, 수지구,095,90~94세,2021,1062,303,759,39.9,1058,303,755,40.1
31193, 수지구,095001, 90세,2021,301,90,211,42.7,300,90,210,42.9
31193, 수지구,095002, 91세,2021,263,85,178,47.8,263,85,178,47.8
31193, 수지구,095003, 92세,2021,205,49,156,31.4,204,49,155,31.6
31193, 수지구,095004, 93세,2021,188,56,132,42.4,187,56,131,42.7
31193, 수지구,095005, 94세,2021,105,23,82,28,104,23,81,28.4
31193, 수지구,100,95~99세,2021,248,63,185,34.1,246,63,183,34.4
31193, 수지구,100001, 95세,2021,70,16,54,29.6,69,16,53,30.2
31193, 수지구,100002, 96세,2021,67,16,51,31.4,67,16,51,31.4
31193, 수지구,100003, 97세,2021,47,14,33,42.4,46,14,32,43.8
31193, 수지구,100004, 98세,2021,34,10,24,41.7,34,10,24,41.7
31193, 수지구,100005, 99세,2021,30,7,23,30.4,30,7,23,30.4
31193, 수지구,101,100세이상,2021,42,X,38,10.5,42,X,38,10.5
31193, 수지구,102,15세미만,2021,56693,28879,27814,103.8,56179,28614,27565,103.8
31193, 수지구,103,15~64세,2021,256789,125904,130885,96.2,252710,124203,128507,96.7
31193, 수지구,104,65세이상,2021,50042,22185,27857,79.6,49805,22099,27706,79.8
31193, 수지구,086,85세이상,2021,4417,1566,2851,54.9,4404,1564,2840,55.1
31193, 수지구,126,평균연령,2021,40.5,39.8,41.2,,40.6,39.9,41.3,
31193, 수지구,127,중위연령,2021,41.8,41.2,42.2,,41.9,41.3,42.3,
31200, 파주시,000,합계,2021,475212,242580,232632,104.3,460533,232705,227828,102.1
31200, 파주시,005,0~4세,2021,17628,9012,8616,104.6,17433,8912,8521,104.6
31200, 파주시,005001, 0세,2021,2748,1402,1346,104.2,2717,1387,1330,104.3
31200, 파주시,005002, 1세,2021,3171,1600,1571,101.8,3127,1578,1549,101.9
31200, 파주시,005003, 2세,2021,3626,1870,1756,106.5,3580,1848,1732,106.7
31200, 파주시,005004, 3세,2021,3824,1978,1846,107.2,3789,1960,1829,107.2
31200, 파주시,005005, 4세,2021,4259,2162,2097,103.1,4220,2139,2081,102.8
31200, 파주시,010,5~9세,2021,25406,12979,12427,104.4,25264,12896,12368,104.3
31200, 파주시,010001, 5세,2021,4805,2496,2309,108.1,4762,2474,2288,108.1
31200, 파주시,010002, 6세,2021,5087,2561,2526,101.4,5049,2536,2513,100.9
31200, 파주시,010003, 7세,2021,5084,2584,2500,103.4,5058,2569,2489,103.2
31200, 파주시,010004, 8세,2021,4947,2504,2443,102.5,4929,2492,2437,102.3
31200, 파주시,010005, 9세,2021,5483,2834,2649,107,5466,2825,2641,107
31200, 파주시,015,10~14세,2021,25600,13033,12567,103.7,25518,12985,12533,103.6
31200, 파주시,015001, 10세,2021,5311,2701,2610,103.5,5293,2689,2604,103.3
31200, 파주시,015002, 11세,2021,5150,2560,2590,98.8,5134,2551,2583,98.8
31200, 파주시,015003, 12세,2021,4835,2511,2324,108,4816,2502,2314,108.1
31200, 파주시,015004, 13세,2021,5154,2646,2508,105.5,5136,2635,2501,105.4
31200, 파주시,015005, 14세,2021,5150,2615,2535,103.2,5139,2608,2531,103
31200, 파주시,020,15~19세,2021,22689,11661,11028,105.7,22604,11613,10991,105.7
31200, 파주시,020001, 15세,2021,4553,2310,2243,103,4537,2301,2236,102.9
31200, 파주시,020002, 16세,2021,4485,2286,2199,104,4471,2277,2194,103.8
31200, 파주시,020003, 17세,2021,4913,2504,2409,103.9,4900,2500,2400,104.2
31200, 파주시,020004, 18세,2021,4776,2464,2312,106.6,4755,2453,2302,106.6
31200, 파주시,020005, 19세,2021,3962,2097,1865,112.4,3941,2082,1859,112
31200, 파주시,025,20~24세,2021,25389,13925,11464,121.5,24564,13331,11233,118.7
31200, 파주시,025001, 20세,2021,4514,2444,2070,118.1,4480,2429,2051,118.4
31200, 파주시,025002, 21세,2021,5086,2866,2220,129.1,5009,2815,2194,128.3
31200, 파주시,025003, 22세,2021,4933,2683,2250,119.2,4779,2582,2197,117.5
31200, 파주시,025004, 23세,2021,5265,2897,2368,122.3,5026,2712,2314,117.2
31200, 파주시,025005, 24세,2021,5591,3035,2556,118.7,5270,2793,2477,112.8
31200, 파주시,030,25~29세,2021,32587,18112,14475,125.1,29876,15979,13897,115
31200, 파주시,030001, 25세,2021,5840,3333,2507,132.9,5400,2969,2431,122.1
31200, 파주시,030002, 26세,2021,6313,3598,2715,132.5,5779,3175,2604,121.9
31200, 파주시,030003, 27세,2021,6595,3706,2889,128.3,6042,3263,2779,117.4
31200, 파주시,030004, 28세,2021,6886,3719,3167,117.4,6267,3253,3014,107.9
31200, 파주시,030005, 29세,2021,6953,3756,3197,117.5,6388,3319,3069,108.1
31200, 파주시,035,30~34세,2021,32914,17853,15061,118.5,30048,15782,14266,110.6
31200, 파주시,035001, 30세,2021,6743,3584,3159,113.5,6151,3137,3014,104.1
31200, 파주시,035002, 31세,2021,6317,3339,2978,112.1,5731,2934,2797,104.9
31200, 파주시,035003, 32세,2021,6461,3583,2878,124.5,5886,3155,2731,115.5
31200, 파주시,035004, 33세,2021,6568,3595,2973,120.9,6016,3198,2818,113.5
31200, 파주시,035005, 34세,2021,6825,3752,3073,122.1,6264,3358,2906,115.6
31200, 파주시,040,35~39세,2021,37855,20391,17464,116.8,35505,18758,16747,112
31200, 파주시,040001, 35세,2021,6934,3842,3092,124.3,6409,3488,2921,119.4
31200, 파주시,040002, 36세,2021,7134,3931,3203,122.7,6656,3591,3065,117.2
31200, 파주시,040003, 37세,2021,7215,3813,3402,112.1,6723,3477,3246,107.1
31200, 파주시,040004, 38세,2021,7955,4211,3744,112.5,7543,3923,3620,108.4
31200, 파주시,040005, 39세,2021,8617,4594,4023,114.2,8174,4279,3895,109.9
31200, 파주시,045,40~44세,2021,40635,21185,19450,108.9,39000,20069,18931,106
31200, 파주시,045001, 40세,2021,8670,4642,4028,115.2,8253,4333,3920,110.5
31200, 파주시,045002, 41세,2021,8796,4683,4113,113.9,8456,4462,3994,111.7
31200, 파주시,045003, 42세,2021,8135,4173,3962,105.3,7816,3963,3853,102.9
31200, 파주시,045004, 43세,2021,7360,3751,3609,103.9,7062,3547,3515,100.9
31200, 파주시,045005, 44세,2021,7674,3936,3738,105.3,7413,3764,3649,103.2
31200, 파주시,050,45~49세,2021,40590,20811,19779,105.2,39552,20149,19403,103.8
31200, 파주시,050001, 45세,2021,7505,3863,3642,106.1,7280,3710,3570,103.9
31200, 파주시,050002, 46세,2021,7571,3795,3776,100.5,7366,3666,3700,99.1
31200, 파주시,050003, 47세,2021,8405,4268,4137,103.2,8191,4136,4055,102
31200, 파주시,050004, 48세,2021,8490,4370,4120,106.1,8292,4237,4055,104.5
31200, 파주시,050005, 49세,2021,8619,4515,4104,110,8423,4400,4023,109.4
31200, 파주시,055,50~54세,2021,40701,21118,19583,107.8,39714,20570,19144,107.4
31200, 파주시,055001, 50세,2021,9011,4687,4324,108.4,8806,4575,4231,108.1
31200, 파주시,055002, 51세,2021,8474,4444,4030,110.3,8244,4311,3933,109.6
31200, 파주시,055003, 52세,2021,8071,4149,3922,105.8,7870,4043,3827,105.6
31200, 파주시,055004, 53세,2021,8028,4191,3837,109.2,7835,4083,3752,108.8
31200, 파주시,055005, 54세,2021,7117,3647,3470,105.1,6959,3558,3401,104.6
31200, 파주시,060,55~59세,2021,34149,17720,16429,107.9,33363,17314,16049,107.9
31200, 파주시,060001, 55세,2021,7007,3717,3290,113,6846,3630,3216,112.9
31200, 파주시,060002, 56세,2021,7000,3600,3400,105.9,6832,3505,3327,105.4
31200, 파주시,060003, 57세,2021,6446,3281,3165,103.7,6294,3201,3093,103.5
31200, 파주시,060004, 58세,2021,6854,3557,3297,107.9,6685,3471,3214,108
31200, 파주시,060005, 59세,2021,6842,3565,3277,108.8,6706,3507,3199,109.6
31200, 파주시,065,60~64세,2021,31384,15782,15602,101.2,30930,15561,15369,101.2
31200, 파주시,065001, 60세,2021,7103,3560,3543,100.5,7023,3525,3498,100.8
31200, 파주시,065002, 61세,2021,6718,3398,3320,102.3,6614,3352,3262,102.8
31200, 파주시,065003, 62세,2021,6182,3073,3109,98.8,6094,3027,3067,98.7
31200, 파주시,065004, 63세,2021,5808,2954,2854,103.5,5704,2906,2798,103.9
31200, 파주시,065005, 64세,2021,5573,2797,2776,100.8,5495,2751,2744,100.3
31200, 파주시,070,65~69세,2021,21481,10378,11103,93.5,21206,10251,10955,93.6
31200, 파주시,070001, 65세,2021,4847,2354,2493,94.4,4782,2323,2459,94.5
31200, 파주시,070002, 66세,2021,5036,2452,2584,94.9,4978,2429,2549,95.3
31200, 파주시,070003, 67세,2021,4080,2001,2079,96.2,4022,1970,2052,96
31200, 파주시,070004, 68세,2021,3633,1765,1868,94.5,3586,1745,1841,94.8
31200, 파주시,070005, 69세,2021,3885,1806,2079,86.9,3838,1784,2054,86.9
31200, 파주시,075,70~74세,2021,15272,6917,8355,82.8,15140,6864,8276,82.9
31200, 파주시,075001, 70세,2021,2599,1167,1432,81.5,2568,1152,1416,81.4
31200, 파주시,075002, 71세,2021,2995,1358,1637,83,2957,1345,1612,83.4
31200, 파주시,075003, 72세,2021,3266,1482,1784,83.1,3243,1475,1768,83.4
31200, 파주시,075004, 73세,2021,3157,1425,1732,82.3,3134,1412,1722,82
31200, 파주시,075005, 74세,2021,3255,1485,1770,83.9,3238,1480,1758,84.2
31200, 파주시,080,75~79세,2021,13137,5574,7563,73.7,13078,5557,7521,73.9
31200, 파주시,080001, 75세,2021,2562,1149,1413,81.3,2546,1143,1403,81.5
31200, 파주시,080002, 76세,2021,2549,1095,1454,75.3,2538,1092,1446,75.5
31200, 파주시,080003, 77세,2021,2460,1011,1449,69.8,2449,1006,1443,69.7
31200, 파주시,080004, 78세,2021,2654,1072,1582,67.8,2641,1071,1570,68.2
31200, 파주시,080005, 79세,2021,2912,1247,1665,74.9,2904,1245,1659,75
31200, 파주시,085,80~84세,2021,10129,3862,6267,61.6,10096,3853,6243,61.7
31200, 파주시,085001, 80세,2021,2412,965,1447,66.7,2402,961,1441,66.7
31200, 파주시,085002, 81세,2021,2224,852,1372,62.1,2218,849,1369,62
31200, 파주시,085003, 82세,2021,2024,775,1249,62,2016,774,1242,62.3
31200, 파주시,085004, 83세,2021,1888,663,1225,54.1,1882,662,1220,54.3
31200, 파주시,085005, 84세,2021,1581,607,974,62.3,1578,607,971,62.5
31200, 파주시,090,85~89세,2021,5298,1714,3584,47.8,5282,1708,3574,47.8
31200, 파주시,090001, 85세,2021,1409,500,909,55,1401,499,902,55.3
31200, 파주시,090002, 86세,2021,1322,447,875,51.1,1319,445,874,50.9
31200, 파주시,090003, 87세,2021,994,317,677,46.8,990,315,675,46.7
31200, 파주시,090004, 88세,2021,853,245,608,40.3,852,244,608,40.1
31200, 파주시,090005, 89세,2021,720,205,515,39.8,720,205,515,39.8
31200, 파주시,095,90~94세,2021,1888,459,1429,32.1,1884,459,1425,32.2
31200, 파주시,095001, 90세,2021,538,141,397,35.5,536,141,395,35.7
31200, 파주시,095002, 91세,2021,443,121,322,37.6,443,121,322,37.6
31200, 파주시,095003, 92세,2021,382,93,289,32.2,381,93,288,32.3
31200, 파주시,095004, 93세,2021,294,68,226,30.1,293,68,225,30.2
31200, 파주시,095005, 94세,2021,231,36,195,18.5,231,36,195,18.5
31200, 파주시,100,95~99세,2021,426,80,346,23.1,422,80,342,23.4
31200, 파주시,100001, 95세,2021,152,27,125,21.6,152,27,125,21.6
31200, 파주시,100002, 96세,2021,105,16,89,18,103,16,87,18.4
31200, 파주시,100003, 97세,2021,74,13,61,21.3,73,13,60,21.7
31200, 파주시,100004, 98세,2021,60,16,44,36.4,59,16,43,37.2
31200, 파주시,100005, 99세,2021,35,8,27,29.6,35,8,27,29.6
31200, 파주시,101,100세이상,2021,54,14,40,35,54,14,40,35
31200, 파주시,102,15세미만,2021,68634,35024,33610,104.2,68215,34793,33422,104.1
31200, 파주시,103,15~64세,2021,338893,178558,160335,111.4,325156,169126,156030,108.4
31200, 파주시,104,65세이상,2021,67685,28998,38687,75,67162,28786,38376,75
31200, 파주시,086,85세이상,2021,7666,2267,5399,42,7642,2261,5381,42
31200, 파주시,126,평균연령,2021,41.5,40.4,42.6,,41.6,40.6,42.7,
31200, 파주시,127,중위연령,2021,42,40.9,43.3,,42.4,41.4,43.5,
31210, 이천시,000,합계,2021,229321,119255,110066,108.3,219387,113519,105868,107.2
31210, 이천시,005,0~4세,2021,7464,3858,3606,107,7375,3818,3557,107.3
31210, 이천시,005001, 0세,2021,1268,657,611,107.5,1248,649,599,108.3
31210, 이천시,005002, 1세,2021,1339,676,663,102,1324,669,655,102.1
31210, 이천시,005003, 2세,2021,1454,776,678,114.5,1440,769,671,114.6
31210, 이천시,005004, 3세,2021,1600,812,788,103,1584,806,778,103.6
31210, 이천시,005005, 4세,2021,1803,937,866,108.2,1779,925,854,108.3
31210, 이천시,010,5~9세,2021,10605,5465,5140,106.3,10508,5421,5087,106.6
31210, 이천시,010001, 5세,2021,2012,1038,974,106.6,1988,1029,959,107.3
31210, 이천시,010002, 6세,2021,2153,1106,1047,105.6,2131,1095,1036,105.7
31210, 이천시,010003, 7세,2021,2058,1075,983,109.4,2040,1067,973,109.7
31210, 이천시,010004, 8세,2021,2116,1089,1027,106,2099,1080,1019,106
31210, 이천시,010005, 9세,2021,2266,1157,1109,104.3,2250,1150,1100,104.5
31210, 이천시,015,10~14세,2021,10863,5584,5279,105.8,10824,5563,5261,105.7
31210, 이천시,015001, 10세,2021,2263,1175,1088,108,2253,1169,1084,107.8
31210, 이천시,015002, 11세,2021,2162,1124,1038,108.3,2151,1117,1034,108
31210, 이천시,015003, 12세,2021,2008,1024,984,104.1,2000,1021,979,104.3
31210, 이천시,015004, 13세,2021,2213,1135,1078,105.3,2207,1132,1075,105.3
31210, 이천시,015005, 14세,2021,2217,1126,1091,103.2,2213,1124,1089,103.2
31210, 이천시,020,15~19세,2021,12145,6287,5858,107.3,12100,6261,5839,107.2
31210, 이천시,020001, 15세,2021,2090,1106,984,112.4,2081,1102,979,112.6
31210, 이천시,020002, 16세,2021,1985,1031,954,108.1,1982,1030,952,108.2
31210, 이천시,020003, 17세,2021,2161,1102,1059,104.1,2153,1099,1054,104.3
31210, 이천시,020004, 18세,2021,2377,1214,1163,104.4,2368,1207,1161,104
31210, 이천시,020005, 19세,2021,3532,1834,1698,108,3516,1823,1693,107.7
31210, 이천시,025,20~24세,2021,14441,7788,6653,117.1,13687,7327,6360,115.2
31210, 이천시,025001, 20세,2021,2802,1430,1372,104.2,2747,1396,1351,103.3
31210, 이천시,025002, 21세,2021,2841,1518,1323,114.7,2752,1457,1295,112.5
31210, 이천시,025003, 22세,2021,2769,1567,1202,130.4,2635,1474,1161,127
31210, 이천시,025004, 23세,2021,2879,1564,1315,118.9,2685,1452,1233,117.8
31210, 이천시,025005, 24세,2021,3150,1709,1441,118.6,2868,1548,1320,117.3
31210, 이천시,030,25~29세,2021,19741,11729,8012,146.4,17665,10437,7228,144.4
31210, 이천시,030001, 25세,2021,3507,1971,1536,128.3,3132,1740,1392,125
31210, 이천시,030002, 26세,2021,3687,2178,1509,144.3,3295,1920,1375,139.6
31210, 이천시,030003, 27세,2021,4053,2448,1605,152.5,3663,2208,1455,151.8
31210, 이천시,030004, 28세,2021,4264,2570,1694,151.7,3798,2286,1512,151.2
31210, 이천시,030005, 29세,2021,4230,2562,1668,153.6,3777,2283,1494,152.8
31210, 이천시,035,30~34세,2021,16955,9489,7466,127.1,14910,8249,6661,123.8
31210, 이천시,035001, 30세,2021,3529,2084,1445,144.2,3108,1843,1265,145.7
31210, 이천시,035002, 31세,2021,3509,2035,1474,138.1,3072,1759,1313,134
31210, 이천시,035003, 32세,2021,3454,1935,1519,127.4,3051,1691,1360,124.3
31210, 이천시,035004, 33세,2021,3211,1702,1509,112.8,2801,1456,1345,108.3
31210, 이천시,035005, 34세,2021,3252,1733,1519,114.1,2878,1500,1378,108.9
31210, 이천시,040,35~39세,2021,17018,9129,7889,115.7,15632,8303,7329,113.3
31210, 이천시,040001, 35세,2021,3164,1672,1492,112.1,2819,1456,1363,106.8
31210, 이천시,040002, 36세,2021,3275,1682,1593,105.6,2968,1497,1471,101.8
31210, 이천시,040003, 37세,2021,3272,1778,1494,119,3008,1618,1390,116.4
31210, 이천시,040004, 38세,2021,3449,1861,1588,117.2,3196,1719,1477,116.4
31210, 이천시,040005, 39세,2021,3858,2136,1722,124,3641,2013,1628,123.6
31210, 이천시,045,40~44세,2021,17675,9264,8411,110.1,16752,8740,8012,109.1
31210, 이천시,045001, 40세,2021,3590,1984,1606,123.5,3373,1870,1503,124.4
31210, 이천시,045002, 41세,2021,3692,1994,1698,117.4,3463,1866,1597,116.8
31210, 이천시,045003, 42세,2021,3479,1783,1696,105.1,3307,1682,1625,103.5
31210, 이천시,045004, 43세,2021,3485,1790,1695,105.6,3320,1696,1624,104.4
31210, 이천시,045005, 44세,2021,3429,1713,1716,99.8,3289,1626,1663,97.8
31210, 이천시,050,45~49세,2021,17695,9158,8537,107.3,17049,8809,8240,106.9
31210, 이천시,050001, 45세,2021,3420,1713,1707,100.4,3271,1617,1654,97.8
31210, 이천시,050002, 46세,2021,3309,1696,1613,105.1,3189,1631,1558,104.7
31210, 이천시,050003, 47세,2021,3744,1955,1789,109.3,3607,1885,1722,109.5
31210, 이천시,050004, 48세,2021,3585,1849,1736,106.5,3464,1794,1670,107.4
31210, 이천시,050005, 49세,2021,3637,1945,1692,115,3518,1882,1636,115
31210, 이천시,055,50~54세,2021,18644,9575,9069,105.6,18007,9259,8748,105.8
31210, 이천시,055001, 50세,2021,3783,2002,1781,112.4,3655,1944,1711,113.6
31210, 이천시,055002, 51세,2021,3842,2057,1785,115.2,3707,1992,1715,116.2
31210, 이천시,055003, 52세,2021,3874,1956,1918,102,3728,1879,1849,101.6
31210, 이천시,055004, 53세,2021,3732,1852,1880,98.5,3619,1794,1825,98.3
31210, 이천시,055005, 54세,2021,3413,1708,1705,100.2,3298,1650,1648,100.1
31210, 이천시,060,55~59세,2021,16993,8845,8148,108.6,16428,8560,7868,108.8
31210, 이천시,060001, 55세,2021,3427,1785,1642,108.7,3315,1724,1591,108.4
31210, 이천시,060002, 56세,2021,3555,1843,1712,107.7,3443,1785,1658,107.7
31210, 이천시,060003, 57세,2021,3227,1658,1569,105.7,3122,1610,1512,106.5
31210, 이천시,060004, 58세,2021,3340,1757,1583,111,3190,1676,1514,110.7
31210, 이천시,060005, 59세,2021,3444,1802,1642,109.7,3358,1765,1593,110.8
31210, 이천시,065,60~64세,2021,16707,8552,8155,104.9,16356,8368,7988,104.8
31210, 이천시,065001, 60세,2021,3949,2058,1891,108.8,3884,2022,1862,108.6
31210, 이천시,065002, 61세,2021,3602,1794,1808,99.2,3506,1743,1763,98.9
31210, 이천시,065003, 62세,2021,3248,1655,1593,103.9,3192,1627,1565,104
31210, 이천시,065004, 63세,2021,3095,1614,1481,109,3030,1583,1447,109.4
31210, 이천시,065005, 64세,2021,2813,1431,1382,103.5,2744,1393,1351,103.1
31210, 이천시,070,65~69세,2021,11320,5763,5557,103.7,11153,5683,5470,103.9
31210, 이천시,070001, 65세,2021,2559,1359,1200,113.3,2513,1341,1172,114.4
31210, 이천시,070002, 66세,2021,2577,1292,1285,100.5,2535,1268,1267,100.1
31210, 이천시,070003, 67세,2021,2109,1072,1037,103.4,2079,1054,1025,102.8
31210, 이천시,070004, 68세,2021,1839,922,917,100.5,1814,914,900,101.6
31210, 이천시,070005, 69세,2021,2236,1118,1118,100,2212,1106,1106,100
31210, 이천시,075,70~74세,2021,7186,3398,3788,89.7,7120,3367,3753,89.7
31210, 이천시,075001, 70세,2021,1363,624,739,84.4,1337,612,725,84.4
31210, 이천시,075002, 71세,2021,1453,680,773,88,1439,672,767,87.6
31210, 이천시,075003, 72세,2021,1477,723,754,95.9,1465,718,747,96.1
31210, 이천시,075004, 73세,2021,1443,690,753,91.6,1434,685,749,91.5
31210, 이천시,075005, 74세,2021,1450,681,769,88.6,1445,680,765,88.9
31210, 이천시,080,75~79세,2021,5815,2583,3232,79.9,5791,2575,3216,80.1
31210, 이천시,080001, 75세,2021,1194,597,597,100,1185,593,592,100.2
31210, 이천시,080002, 76세,2021,1108,502,606,82.8,1102,500,602,83.1
31210, 이천시,080003, 77세,2021,1068,475,593,80.1,1066,474,592,80.1
31210, 이천시,080004, 78세,2021,1142,481,661,72.8,1139,481,658,73.1
31210, 이천시,080005, 79세,2021,1303,528,775,68.1,1299,527,772,68.3
31210, 이천시,085,80~84세,2021,4548,1767,2781,63.5,4533,1762,2771,63.6
31210, 이천시,085001, 80세,2021,1099,448,651,68.8,1094,446,648,68.8
31210, 이천시,085002, 81세,2021,934,381,553,68.9,931,381,550,69.3
31210, 이천시,085003, 82세,2021,896,342,554,61.7,891,340,551,61.7
31210, 이천시,085004, 83세,2021,866,333,533,62.5,865,333,532,62.6
31210, 이천시,085005, 84세,2021,753,263,490,53.7,752,262,490,53.5
31210, 이천시,090,85~89세,2021,2495,798,1697,47,2488,794,1694,46.9
31210, 이천시,090001, 85세,2021,624,217,407,53.3,623,216,407,53.1
31210, 이천시,090002, 86세,2021,644,197,447,44.1,643,196,447,43.8
31210, 이천시,090003, 87세,2021,535,174,361,48.2,535,174,361,48.2
31210, 이천시,090004, 88세,2021,391,121,270,44.8,388,119,269,44.2
31210, 이천시,090005, 89세,2021,301,89,212,42,299,89,210,42.4
31210, 이천시,095,90~94세,2021,785,180,605,29.8,784,180,604,29.8
31210, 이천시,095001, 90세,2021,226,58,168,34.5,226,58,168,34.5
31210, 이천시,095002, 91세,2021,184,48,136,35.3,183,48,135,35.6
31210, 이천시,095003, 92세,2021,180,35,145,24.1,180,35,145,24.1
31210, 이천시,095004, 93세,2021,109,20,89,22.5,109,20,89,22.5
31210, 이천시,095005, 94세,2021,86,19,67,28.4,86,19,67,28.4
31210, 이천시,100,95~99세,2021,205,39,166,23.5,204,39,165,23.6
31210, 이천시,100001, 95세,2021,58,11,47,23.4,58,11,47,23.4
31210, 이천시,100002, 96세,2021,67,15,52,28.8,67,15,52,28.8
31210, 이천시,100003, 97세,2021,28,7,21,33.3,28,7,21,33.3
31210, 이천시,100004, 98세,2021,31,X,27,14.8,30,X,26,15.4
31210, 이천시,100005, 99세,2021,21,X,19,10.5,21,X,19,10.5
31210, 이천시,101,100세이상,2021,21,X,17,23.5,21,X,17,23.5
31210, 이천시,102,15세미만,2021,28932,14907,14025,106.3,28707,14802,13905,106.5
31210, 이천시,103,15~64세,2021,168014,89816,78198,114.9,158586,84313,74273,113.5
31210, 이천시,104,65세이상,2021,32375,14532,17843,81.4,32094,14404,17690,81.4
31210, 이천시,086,85세이상,2021,3506,1021,2485,41.1,3497,1017,2480,41
31210, 이천시,126,평균연령,2021,41.5,40.5,42.7,,41.7,40.7,42.8,
31210, 이천시,127,중위연령,2021,41.5,40.2,43.1,,42,40.7,43.5,
31220, 안성시,000,합계,2021,203897,106850,97047,110.1,185978,95782,90196,106.2
31220, 안성시,005,0~4세,2021,5617,2900,2717,106.7,5193,2702,2491,108.5
31220, 안성시,005001, 0세,2021,941,492,449,109.6,869,462,407,113.5
31220, 안성시,005002, 1세,2021,967,501,466,107.5,884,456,428,106.5
31220, 안성시,005003, 2세,2021,1143,603,540,111.7,1053,558,495,112.7
31220, 안성시,005004, 3세,2021,1227,626,601,104.2,1133,579,554,104.5
31220, 안성시,005005, 4세,2021,1339,678,661,102.6,1254,647,607,106.6
31220, 안성시,010,5~9세,2021,8238,4228,4010,105.4,7826,4015,3811,105.4
31220, 안성시,010001, 5세,2021,1533,789,744,106,1428,735,693,106.1
31220, 안성시,010002, 6세,2021,1590,839,751,111.7,1508,787,721,109.2
31220, 안성시,010003, 7세,2021,1569,785,784,100.1,1486,745,741,100.5
31220, 안성시,010004, 8세,2021,1730,914,816,112,1655,882,773,114.1
31220, 안성시,010005, 9세,2021,1816,901,915,98.5,1749,866,883,98.1
31220, 안성시,015,10~14세,2021,9045,4637,4408,105.2,8799,4503,4296,104.8
31220, 안성시,015001, 10세,2021,1886,962,924,104.1,1833,933,900,103.7
31220, 안성시,015002, 11세,2021,1722,869,853,101.9,1678,844,834,101.2
31220, 안성시,015003, 12세,2021,1764,912,852,107,1715,883,832,106.1
31220, 안성시,015004, 13세,2021,1847,942,905,104.1,1803,923,880,104.9
31220, 안성시,015005, 14세,2021,1826,952,874,108.9,1770,920,850,108.2
31220, 안성시,020,15~19세,2021,9206,4788,4418,108.4,8909,4666,4243,110
31220, 안성시,020001, 15세,2021,1639,854,785,108.8,1602,836,766,109.1
31220, 안성시,020002, 16세,2021,1659,870,789,110.3,1623,854,769,111.1
31220, 안성시,020003, 17세,2021,1816,923,893,103.4,1785,909,876,103.8
31220, 안성시,020004, 18세,2021,1854,980,874,112.1,1804,958,846,113.2
31220, 안성시,020005, 19세,2021,2238,1161,1077,107.8,2095,1109,986,112.5
31220, 안성시,025,20~24세,2021,13540,7313,6227,117.4,12078,6393,5685,112.5
31220, 안성시,025001, 20세,2021,2592,1335,1257,106.2,2419,1259,1160,108.5
31220, 안성시,025002, 21세,2021,2646,1336,1310,102,2438,1217,1221,99.7
31220, 안성시,025003, 22세,2021,2665,1444,1221,118.3,2405,1285,1120,114.7
31220, 안성시,025004, 23세,2021,2802,1574,1228,128.2,2423,1329,1094,121.5
31220, 안성시,025005, 24세,2021,2835,1624,1211,134.1,2393,1303,1090,119.5
31220, 안성시,030,25~29세,2021,14252,8628,5624,153.4,11553,6755,4798,140.8
31220, 안성시,030001, 25세,2021,2857,1712,1145,149.5,2394,1390,1004,138.4
31220, 안성시,030002, 26세,2021,2869,1700,1169,145.4,2337,1332,1005,132.5
31220, 안성시,030003, 27세,2021,2847,1753,1094,160.2,2310,1370,940,145.7
31220, 안성시,030004, 28세,2021,2839,1752,1087,161.2,2258,1342,916,146.5
31220, 안성시,030005, 29세,2021,2840,1711,1129,151.6,2254,1321,933,141.6
31220, 안성시,035,30~34세,2021,13246,7816,5430,143.9,10207,5709,4498,126.9
31220, 안성시,035001, 30세,2021,2673,1555,1118,139.1,2098,1153,945,122
31220, 안성시,035002, 31세,2021,2693,1655,1038,159.4,2033,1222,811,150.7
31220, 안성시,035003, 32세,2021,2616,1551,1065,145.6,2014,1110,904,122.8
31220, 안성시,035004, 33세,2021,2625,1501,1124,133.5,2031,1101,930,118.4
31220, 안성시,035005, 34세,2021,2639,1554,1085,143.2,2031,1123,908,123.7
31220, 안성시,040,35~39세,2021,14539,8230,6309,130.4,11989,6549,5440,120.4
31220, 안성시,040001, 35세,2021,2594,1486,1108,134.1,2043,1117,926,120.6
31220, 안성시,040002, 36세,2021,2706,1584,1122,141.2,2159,1212,947,128
31220, 안성시,040003, 37세,2021,2799,1625,1174,138.4,2270,1278,992,128.8
31220, 안성시,040004, 38세,2021,3123,1709,1414,120.9,2655,1409,1246,113.1
31220, 안성시,040005, 39세,2021,3317,1826,1491,122.5,2862,1533,1329,115.3
31220, 안성시,045,40~44세,2021,16356,9041,7315,123.6,14410,7762,6648,116.8
31220, 안성시,045001, 40세,2021,3371,1897,1474,128.7,2900,1578,1322,119.4
31220, 안성시,045002, 41세,2021,3530,1943,1587,122.4,3131,1683,1448,116.2
31220, 안성시,045003, 42세,2021,3292,1831,1461,125.3,2891,1551,1340,115.7
31220, 안성시,045004, 43세,2021,3075,1702,1373,124,2707,1476,1231,119.9
31220, 안성시,045005, 44세,2021,3088,1668,1420,117.5,2781,1474,1307,112.8
31220, 안성시,050,45~49세,2021,16151,8663,7488,115.7,14742,7845,6897,113.7
31220, 안성시,050001, 45세,2021,2964,1600,1364,117.3,2635,1398,1237,113
31220, 안성시,050002, 46세,2021,3046,1628,1418,114.8,2766,1468,1298,113.1
31220, 안성시,050003, 47세,2021,3360,1810,1550,116.8,3081,1643,1438,114.3
31220, 안성시,050004, 48세,2021,3444,1828,1616,113.1,3193,1696,1497,113.3
31220, 안성시,050005, 49세,2021,3337,1797,1540,116.7,3067,1640,1427,114.9
31220, 안성시,055,50~54세,2021,17174,9089,8085,112.4,15996,8443,7553,111.8
31220, 안성시,055001, 50세,2021,3582,1888,1694,111.5,3311,1739,1572,110.6
31220, 안성시,055002, 51세,2021,3417,1846,1571,117.5,3175,1709,1466,116.6
31220, 안성시,055003, 52세,2021,3646,1969,1677,117.4,3393,1827,1566,116.7
31220, 안성시,055004, 53세,2021,3453,1818,1635,111.2,3211,1693,1518,111.5
31220, 안성시,055005, 54세,2021,3076,1568,1508,104,2906,1475,1431,103.1
31220, 안성시,060,55~59세,2021,15672,8234,7438,110.7,14691,7739,6952,111.3
31220, 안성시,060001, 55세,2021,3134,1697,1437,118.1,2941,1601,1340,119.5
31220, 안성시,060002, 56세,2021,3231,1703,1528,111.5,3029,1597,1432,111.5
31220, 안성시,060003, 57세,2021,2993,1529,1464,104.4,2816,1443,1373,105.1
31220, 안성시,060004, 58세,2021,3276,1695,1581,107.2,3041,1575,1466,107.4
31220, 안성시,060005, 59세,2021,3038,1610,1428,112.7,2864,1523,1341,113.6
31220, 안성시,065,60~64세,2021,16144,8190,7954,103,15473,7855,7618,103.1
31220, 안성시,065001, 60세,2021,3673,1887,1786,105.7,3552,1828,1724,106
31220, 안성시,065002, 61세,2021,3502,1771,1731,102.3,3360,1702,1658,102.7
31220, 안성시,065003, 62세,2021,3215,1637,1578,103.7,3067,1554,1513,102.7
31220, 안성시,065004, 63세,2021,2992,1500,1492,100.5,2865,1448,1417,102.2
31220, 안성시,065005, 64세,2021,2762,1395,1367,102,2629,1323,1306,101.3
31220, 안성시,070,65~69세,2021,11581,5719,5862,97.6,11210,5565,5645,98.6
31220, 안성시,070001, 65세,2021,2544,1227,1317,93.2,2443,1180,1263,93.4
31220, 안성시,070002, 66세,2021,2565,1265,1300,97.3,2493,1232,1261,97.7
31220, 안성시,070003, 67세,2021,2249,1124,1125,99.9,2175,1095,1080,101.4
31220, 안성시,070004, 68세,2021,1986,970,1016,95.5,1910,944,966,97.7
31220, 안성시,070005, 69세,2021,2237,1133,1104,102.6,2189,1114,1075,103.6
31220, 안성시,075,70~74세,2021,7707,3684,4023,91.6,7565,3620,3945,91.8
31220, 안성시,075001, 70세,2021,1470,713,757,94.2,1431,694,737,94.2
31220, 안성시,075002, 71세,2021,1594,781,813,96.1,1553,767,786,97.6
31220, 안성시,075003, 72세,2021,1474,719,755,95.2,1447,706,741,95.3
31220, 안성시,075004, 73세,2021,1533,723,810,89.3,1515,714,801,89.1
31220, 안성시,075005, 74세,2021,1636,748,888,84.2,1619,739,880,84
31220, 안성시,080,75~79세,2021,6077,2627,3450,76.1,6033,2611,3422,76.3
31220, 안성시,080001, 75세,2021,1200,583,617,94.5,1190,577,613,94.1
31220, 안성시,080002, 76세,2021,1194,526,668,78.7,1187,523,664,78.8
31220, 안성시,080003, 77세,2021,1181,530,651,81.4,1169,528,641,82.4
31220, 안성시,080004, 78세,2021,1141,466,675,69,1134,463,671,69
31220, 안성시,080005, 79세,2021,1361,522,839,62.2,1353,520,833,62.4
31220, 안성시,085,80~84세,2021,5083,1913,3170,60.3,5045,1901,3144,60.5
31220, 안성시,085001, 80세,2021,1112,471,641,73.5,1106,469,637,73.6
31220, 안성시,085002, 81세,2021,1060,397,663,59.9,1050,394,656,60.1
31220, 안성시,085003, 82세,2021,1067,405,662,61.2,1059,404,655,61.7
31220, 안성시,085004, 83세,2021,901,305,596,51.2,893,302,591,51.1
31220, 안성시,085005, 84세,2021,943,335,608,55.1,937,332,605,54.9
31220, 안성시,090,85~89세,2021,2977,897,2080,43.1,2970,896,2074,43.2
31220, 안성시,090001, 85세,2021,775,267,508,52.6,774,266,508,52.4
31220, 안성시,090002, 86세,2021,678,198,480,41.3,675,198,477,41.5
31220, 안성시,090003, 87세,2021,610,191,419,45.6,609,191,418,45.7
31220, 안성시,090004, 88세,2021,497,130,367,35.4,495,130,365,35.6
31220, 안성시,090005, 89세,2021,417,111,306,36.3,417,111,306,36.3
31220, 안성시,095,90~94세,2021,998,208,790,26.3,995,208,787,26.4
31220, 안성시,095001, 90세,2021,313,84,229,36.7,312,84,228,36.8
31220, 안성시,095002, 91세,2021,252,53,199,26.6,251,53,198,26.8
31220, 안성시,095003, 92세,2021,196,38,158,24.1,195,38,157,24.2
31220, 안성시,095004, 93세,2021,140,20,120,16.7,140,20,120,16.7
31220, 안성시,095005, 94세,2021,97,13,84,15.5,97,13,84,15.5
31220, 안성시,100,95~99세,2021,260,41,219,18.7,260,41,219,18.7
31220, 안성시,100001, 95세,2021,97,12,85,14.1,97,12,85,14.1
31220, 안성시,100002, 96세,2021,53,8,45,17.8,53,8,45,17.8
31220, 안성시,100003, 97세,2021,49,10,39,25.6,49,10,39,25.6
31220, 안성시,100004, 98세,2021,35,7,28,25,35,7,28,25
31220, 안성시,100005, 99세,2021,26,X,22,18.2,26,X,22,18.2
31220, 안성시,101,100세이상,2021,34,X,30,13.3,34,X,30,13.3
31220, 안성시,102,15세미만,2021,22900,11765,11135,105.7,21818,11220,10598,105.9
31220, 안성시,103,15~64세,2021,146280,79992,66288,120.7,130048,69716,60332,115.6
31220, 안성시,104,65세이상,2021,34717,15093,19624,76.9,34112,14846,19266,77.1
31220, 안성시,086,85세이상,2021,4269,1150,3119,36.9,4259,1149,3110,36.9
31220, 안성시,126,평균연령,2021,43.7,42.3,45.2,,44.3,43,45.7,
31220, 안성시,127,중위연령,2021,44.3,42.6,46.5,,45.8,44.2,47.5,
31230, 김포시,000,합계,2021,491572,251381,240191,104.7,465485,232370,233115,99.7
31230, 김포시,005,0~4세,2021,22360,11564,10796,107.1,21979,11370,10609,107.2
31230, 김포시,005001, 0세,2021,3576,1892,1684,112.4,3509,1857,1652,112.4
31230, 김포시,005002, 1세,2021,3940,2049,1891,108.4,3860,2010,1850,108.6
31230, 김포시,005003, 2세,2021,4545,2377,2168,109.6,4458,2332,2126,109.7
31230, 김포시,005004, 3세,2021,4896,2442,2454,99.5,4815,2405,2410,99.8
31230, 김포시,005005, 4세,2021,5403,2804,2599,107.9,5337,2766,2571,107.6
31230, 김포시,010,5~9세,2021,31590,15913,15677,101.5,31280,15755,15525,101.5
31230, 김포시,010001, 5세,2021,6239,3173,3066,103.5,6140,3122,3018,103.4
31230, 김포시,010002, 6세,2021,6515,3299,3216,102.6,6450,3269,3181,102.8
31230, 김포시,010003, 7세,2021,6251,3167,3084,102.7,6199,3137,3062,102.4
31230, 김포시,010004, 8세,2021,5976,3006,2970,101.2,5921,2979,2942,101.3
31230, 김포시,010005, 9세,2021,6609,3268,3341,97.8,6570,3248,3322,97.8
31230, 김포시,015,10~14세,2021,27293,13967,13326,104.8,27100,13859,13241,104.7
31230, 김포시,015001, 10세,2021,6133,3165,2968,106.6,6074,3135,2939,106.7
31230, 김포시,015002, 11세,2021,5675,2939,2736,107.4,5642,2921,2721,107.4
31230, 김포시,015003, 12세,2021,5235,2686,2549,105.4,5204,2668,2536,105.2
31230, 김포시,015004, 13세,2021,5254,2675,2579,103.7,5216,2652,2564,103.4
31230, 김포시,015005, 14세,2021,4996,2502,2494,100.3,4964,2483,2481,100.1
31230, 김포시,020,15~19세,2021,20039,10126,9913,102.1,19876,10035,9841,102
31230, 김포시,020001, 15세,2021,4483,2320,2163,107.3,4450,2301,2149,107.1
31230, 김포시,020002, 16세,2021,4128,2053,2075,98.9,4100,2043,2057,99.3
31230, 김포시,020003, 17세,2021,4120,2054,2066,99.4,4094,2039,2055,99.2
31230, 김포시,020004, 18세,2021,3953,1989,1964,101.3,3928,1973,1955,100.9
31230, 김포시,020005, 19세,2021,3355,1710,1645,104,3304,1679,1625,103.3
31230, 김포시,025,20~24세,2021,22308,12081,10227,118.1,21008,11098,9910,112
31230, 김포시,025001, 20세,2021,3908,2176,1732,125.6,3846,2143,1703,125.8
31230, 김포시,025002, 21세,2021,4332,2459,1873,131.3,4220,2388,1832,130.3
31230, 김포시,025003, 22세,2021,4201,2244,1957,114.7,3986,2079,1907,109
31230, 김포시,025004, 23세,2021,4741,2484,2257,110.1,4345,2182,2163,100.9
31230, 김포시,025005, 24세,2021,5126,2718,2408,112.9,4611,2306,2305,100
31230, 김포시,030,25~29세,2021,31280,17330,13950,124.2,26665,13434,13231,101.5
31230, 김포시,030001, 25세,2021,5636,2978,2658,112,4955,2412,2543,94.8
31230, 김포시,030002, 26세,2021,5992,3254,2738,118.8,5166,2573,2593,99.2
31230, 김포시,030003, 27세,2021,6224,3529,2695,130.9,5304,2741,2563,106.9
31230, 김포시,030004, 28세,2021,6467,3656,2811,130.1,5448,2799,2649,105.7
31230, 김포시,030005, 29세,2021,6961,3913,3048,128.4,5792,2909,2883,100.9
31230, 김포시,035,30~34세,2021,35536,19002,16534,114.9,30068,14596,15472,94.3
31230, 김포시,035001, 30세,2021,6893,3721,3172,117.3,5820,2832,2988,94.8
31230, 김포시,035002, 31세,2021,6878,3789,3089,122.7,5693,2832,2861,99
31230, 김포시,035003, 32세,2021,7081,3801,3280,115.9,5931,2879,3052,94.3
31230, 김포시,035004, 33세,2021,7072,3768,3304,114,6058,2940,3118,94.3
31230, 김포시,035005, 34세,2021,7612,3923,3689,106.3,6566,3113,3453,90.2
31230, 김포시,040,35~39세,2021,47092,24571,22521,109.1,42762,21193,21569,98.3
31230, 김포시,040001, 35세,2021,7940,4196,3744,112.1,6909,3394,3515,96.6
31230, 김포시,040002, 36세,2021,8497,4455,4042,110.2,7547,3706,3841,96.5
31230, 김포시,040003, 37세,2021,9105,4709,4396,107.1,8264,4050,4214,96.1
31230, 김포시,040004, 38세,2021,10339,5382,4957,108.6,9564,4774,4790,99.7
31230, 김포시,040005, 39세,2021,11211,5829,5382,108.3,10478,5269,5209,101.2
31230, 김포시,045,40~44세,2021,50691,26528,24163,109.8,48069,24569,23500,104.5
31230, 김포시,045001, 40세,2021,11057,5770,5287,109.1,10425,5292,5133,103.1
31230, 김포시,045002, 41세,2021,11140,5817,5323,109.3,10525,5345,5180,103.2
31230, 김포시,045003, 42세,2021,10258,5308,4950,107.2,9741,4928,4813,102.4
31230, 김포시,045004, 43세,2021,9188,4890,4298,113.8,8734,4555,4179,109
31230, 김포시,045005, 44세,2021,9048,4743,4305,110.2,8644,4449,4195,106.1
31230, 김포시,050,45~49세,2021,42000,22432,19568,114.6,40285,21278,19007,111.9
31230, 김포시,050001, 45세,2021,8420,4522,3898,116,8058,4253,3805,111.8
31230, 김포시,050002, 46세,2021,8376,4468,3908,114.3,8047,4238,3809,111.3
31230, 김포시,050003, 47세,2021,8717,4685,4032,116.2,8380,4465,3915,114
31230, 김포시,050004, 48세,2021,8220,4387,3833,114.5,7891,4177,3714,112.5
31230, 김포시,050005, 49세,2021,8267,4370,3897,112.1,7909,4145,3764,110.1
31230, 김포시,055,50~54세,2021,37084,18917,18167,104.1,35497,17998,17499,102.9
31230, 김포시,055001, 50세,2021,8041,4164,3877,107.4,7708,3966,3742,106
31230, 김포시,055002, 51세,2021,7616,3897,3719,104.8,7272,3686,3586,102.8
31230, 김포시,055003, 52세,2021,7507,3771,3736,100.9,7199,3611,3588,100.6
31230, 김포시,055004, 53세,2021,7284,3746,3538,105.9,6948,3541,3407,103.9
31230, 김포시,055005, 54세,2021,6636,3339,3297,101.3,6370,3194,3176,100.6
31230, 김포시,060,55~59세,2021,32319,16442,15877,103.6,30858,15610,15248,102.4
31230, 김포시,060001, 55세,2021,6536,3316,3220,103,6256,3142,3114,100.9
31230, 김포시,060002, 56세,2021,6538,3192,3346,95.4,6246,3026,3220,94
31230, 김포시,060003, 57세,2021,6151,3165,2986,106,5861,3016,2845,106
31230, 김포시,060004, 58세,2021,6517,3352,3165,105.9,6177,3162,3015,104.9
31230, 김포시,060005, 59세,2021,6577,3417,3160,108.1,6318,3264,3054,106.9
31230, 김포시,065,60~64세,2021,30834,15169,15665,96.8,29871,14681,15190,96.6
31230, 김포시,065001, 60세,2021,6621,3276,3345,97.9,6460,3197,3263,98
31230, 김포시,065002, 61세,2021,6714,3350,3364,99.6,6465,3230,3235,99.8
31230, 김포시,065003, 62세,2021,6048,2981,3067,97.2,5838,2876,2962,97.1
31230, 김포시,065004, 63세,2021,5763,2802,2961,94.6,5600,2716,2884,94.2
31230, 김포시,065005, 64세,2021,5688,2760,2928,94.3,5508,2662,2846,93.5
31230, 김포시,070,65~69세,2021,22357,10572,11785,89.7,21797,10287,11510,89.4
31230, 김포시,070001, 65세,2021,4960,2344,2616,89.6,4817,2273,2544,89.3
31230, 김포시,070002, 66세,2021,5177,2432,2745,88.6,5048,2368,2680,88.4
31230, 김포시,070003, 67세,2021,4318,2062,2256,91.4,4194,1994,2200,90.6
31230, 김포시,070004, 68세,2021,3866,1802,2064,87.3,3771,1755,2016,87.1
31230, 김포시,070005, 69세,2021,4036,1932,2104,91.8,3967,1897,2070,91.6
31230, 김포시,075,70~74세,2021,15110,7187,7923,90.7,14881,7083,7798,90.8
31230, 김포시,075001, 70세,2021,2723,1273,1450,87.8,2673,1252,1421,88.1
31230, 김포시,075002, 71세,2021,3109,1455,1654,88,3051,1430,1621,88.2
31230, 김포시,075003, 72세,2021,3242,1556,1686,92.3,3193,1534,1659,92.5
31230, 김포시,075004, 73세,2021,3080,1489,1591,93.6,3044,1472,1572,93.6
31230, 김포시,075005, 74세,2021,2956,1414,1542,91.7,2920,1395,1525,91.5
31230, 김포시,080,75~79세,2021,11031,4974,6057,82.1,10939,4951,5988,82.7
31230, 김포시,080001, 75세,2021,2377,1166,1211,96.3,2352,1157,1195,96.8
31230, 김포시,080002, 76세,2021,2206,1026,1180,86.9,2186,1023,1163,88
31230, 김포시,080003, 77세,2021,2026,900,1126,79.9,2015,895,1120,79.9
31230, 김포시,080004, 78세,2021,2113,932,1181,78.9,2097,929,1168,79.5
31230, 김포시,080005, 79세,2021,2309,950,1359,69.9,2289,947,1342,70.6
31230, 김포시,085,80~84세,2021,7352,2991,4361,68.6,7287,2972,4315,68.9
31230, 김포시,085001, 80세,2021,1852,772,1080,71.5,1836,768,1068,71.9
31230, 김포시,085002, 81세,2021,1576,669,907,73.8,1557,662,895,74
31230, 김포시,085003, 82세,2021,1460,599,861,69.6,1452,598,854,70
31230, 김포시,085004, 83세,2021,1309,524,785,66.8,1297,520,777,66.9
31230, 김포시,085005, 84세,2021,1155,427,728,58.7,1145,424,721,58.8
31230, 김포시,090,85~89세,2021,3695,1229,2466,49.8,3670,1220,2450,49.8
31230, 김포시,090001, 85세,2021,1003,382,621,61.5,993,379,614,61.7
31230, 김포시,090002, 86세,2021,906,314,592,53,900,310,590,52.5
31230, 김포시,090003, 87세,2021,722,218,504,43.3,719,217,502,43.2
31230, 김포시,090004, 88세,2021,584,173,411,42.1,581,173,408,42.4
31230, 김포시,090005, 89세,2021,480,142,338,42,477,141,336,42
31230, 김포시,095,90~94세,2021,1297,319,978,32.6,1290,315,975,32.3
31230, 김포시,095001, 90세,2021,398,112,286,39.2,396,110,286,38.5
31230, 김포시,095002, 91세,2021,298,66,232,28.4,298,66,232,28.4
31230, 김포시,095003, 92세,2021,252,65,187,34.8,249,65,184,35.3
31230, 김포시,095004, 93세,2021,189,38,151,25.2,188,37,151,24.5
31230, 김포시,095005, 94세,2021,160,38,122,31.1,159,37,122,30.3
31230, 김포시,100,95~99세,2021,265,57,208,27.4,264,56,208,26.9
31230, 김포시,100001, 95세,2021,91,17,74,23,90,16,74,21.6
31230, 김포시,100002, 96세,2021,70,16,54,29.6,70,16,54,29.6
31230, 김포시,100003, 97세,2021,36,X,33,9.1,36,X,33,9.1
31230, 김포시,100004, 98세,2021,43,13,30,43.3,43,13,30,43.3
31230, 김포시,100005, 99세,2021,25,8,17,47.1,25,8,17,47.1
31230, 김포시,101,100세이상,2021,39,10,29,34.5,39,10,29,34.5
31230, 김포시,102,15세미만,2021,81243,41444,39799,104.1,80359,40984,39375,104.1
31230, 김포시,103,15~64세,2021,349183,182598,166585,109.6,324959,164492,160467,102.5
31230, 김포시,104,65세이상,2021,61146,27339,33807,80.9,60167,26894,33273,80.8
31230, 김포시,086,85세이상,2021,5296,1615,3681,43.9,5263,1601,3662,43.7
31230, 김포시,126,평균연령,2021,40,39.3,40.8,,40.2,39.5,40.8,
31230, 김포시,127,중위연령,2021,40.7,40.2,41.4,,41.2,40.9,41.4,
31240, 화성시,000,합계,2021,906381,477463,428918,111.3,853419,441545,411874,107.2
31240, 화성시,005,0~4세,2021,43431,22223,21208,104.8,42512,21758,20754,104.8
31240, 화성시,005001, 0세,2021,7168,3588,3580,100.2,7018,3515,3503,100.3
31240, 화성시,005002, 1세,2021,7883,3978,3905,101.9,7722,3895,3827,101.8
31240, 화성시,005003, 2세,2021,8663,4503,4160,108.2,8462,4397,4065,108.2
31240, 화성시,005004, 3세,2021,9431,4871,4560,106.8,9214,4762,4452,107
31240, 화성시,005005, 4세,2021,10286,5283,5003,105.6,10096,5189,4907,105.7
31240, 화성시,010,5~9세,2021,58901,29974,28927,103.6,58095,29581,28514,103.7
31240, 화성시,010001, 5세,2021,11379,5798,5581,103.9,11176,5701,5475,104.1
31240, 화성시,010002, 6세,2021,11908,6096,5812,104.9,11729,6008,5721,105
31240, 화성시,010003, 7세,2021,11627,5869,5758,101.9,11478,5805,5673,102.3
31240, 화성시,010004, 8세,2021,11528,5908,5620,105.1,11378,5828,5550,105
31240, 화성시,010005, 9세,2021,12459,6303,6156,102.4,12334,6239,6095,102.4
31240, 화성시,015,10~14세,2021,55286,28174,27112,103.9,54832,27951,26881,104
31240, 화성시,015001, 10세,2021,11925,6124,5801,105.6,11820,6068,5752,105.5
31240, 화성시,015002, 11세,2021,11255,5777,5478,105.5,11169,5741,5428,105.8
31240, 화성시,015003, 12세,2021,10675,5410,5265,102.8,10583,5364,5219,102.8
31240, 화성시,015004, 13세,2021,10930,5569,5361,103.9,10838,5527,5311,104.1
31240, 화성시,015005, 14세,2021,10501,5294,5207,101.7,10422,5251,5171,101.5
31240, 화성시,020,15~19세,2021,42389,21487,20902,102.8,42064,21326,20738,102.8
31240, 화성시,020001, 15세,2021,9280,4704,4576,102.8,9214,4674,4540,103
31240, 화성시,020002, 16세,2021,8408,4269,4139,103.1,8354,4246,4108,103.4
31240, 화성시,020003, 17세,2021,8731,4352,4379,99.4,8675,4332,4343,99.7
31240, 화성시,020004, 18세,2021,8271,4203,4068,103.3,8217,4170,4047,103
31240, 화성시,020005, 19세,2021,7699,3959,3740,105.9,7604,3904,3700,105.5
31240, 화성시,025,20~24세,2021,47850,25663,22187,115.7,44456,23356,21100,110.7
31240, 화성시,025001, 20세,2021,8775,4637,4138,112.1,8577,4537,4040,112.3
31240, 화성시,025002, 21세,2021,9478,5042,4436,113.7,9091,4841,4250,113.9
31240, 화성시,025003, 22세,2021,9148,4934,4214,117.1,8557,4541,4016,113.1
31240, 화성시,025004, 23세,2021,9723,5185,4538,114.3,8782,4512,4270,105.7
31240, 화성시,025005, 24세,2021,10726,5865,4861,120.7,9449,4925,4524,108.9
31240, 화성시,030,25~29세,2021,67303,39471,27832,141.8,58207,32499,25708,126.4
31240, 화성시,030001, 25세,2021,11536,6604,4932,133.9,10037,5448,4589,118.7
31240, 화성시,030002, 26세,2021,12737,7503,5234,143.4,10993,6183,4810,128.5
31240, 화성시,030003, 27세,2021,13479,7901,5578,141.6,11652,6505,5147,126.4
31240, 화성시,030004, 28세,2021,14472,8535,5937,143.8,12573,7081,5492,128.9
31240, 화성시,030005, 29세,2021,15079,8928,6151,145.1,12952,7282,5670,128.4
31240, 화성시,035,30~34세,2021,76341,42700,33641,126.9,65705,34819,30886,112.7
31240, 화성시,035001, 30세,2021,14724,8494,6230,136.3,12724,6990,5734,121.9
31240, 화성시,035002, 31세,2021,14933,8370,6563,127.5,12692,6701,5991,111.9
31240, 화성시,035003, 32세,2021,15375,8645,6730,128.5,13202,7031,6171,113.9
31240, 화성시,035004, 33세,2021,15476,8494,6982,121.7,13370,6918,6452,107.2
31240, 화성시,035005, 34세,2021,15833,8697,7136,121.9,13717,7179,6538,109.8
31240, 화성시,040,35~39세,2021,89699,48176,41523,116,81042,41907,39135,107.1
31240, 화성시,040001, 35세,2021,16126,8688,7438,116.8,14124,7237,6887,105.1
31240, 화성시,040002, 36세,2021,16522,8998,7524,119.6,14677,7665,7012,109.3
31240, 화성시,040003, 37세,2021,17222,9374,7848,119.4,15465,8114,7351,110.4
31240, 화성시,040004, 38세,2021,19033,10087,8946,112.8,17460,8911,8549,104.2
31240, 화성시,040005, 39세,2021,20796,11029,9767,112.9,19316,9980,9336,106.9
31240, 화성시,045,40~44세,2021,94280,50520,43760,115.4,88828,46749,42079,111.1
31240, 화성시,045001, 40세,2021,20512,10973,9539,115,19256,10087,9169,110
31240, 화성시,045002, 41세,2021,20302,10807,9495,113.8,19106,9963,9143,109
31240, 화성시,045003, 42세,2021,18996,10199,8797,115.9,17886,9438,8448,111.7
31240, 화성시,045004, 43세,2021,17189,9319,7870,118.4,16162,8619,7543,114.3
31240, 화성시,045005, 44세,2021,17281,9222,8059,114.4,16418,8642,7776,111.1
31240, 화성시,050,45~49세,2021,79814,42933,36881,116.4,75948,40458,35490,114
31240, 화성시,050001, 45세,2021,16018,8675,7343,118.1,15190,8124,7066,115
31240, 화성시,050002, 46세,2021,16173,8723,7450,117.1,15392,8212,7180,114.4
31240, 화성시,050003, 47세,2021,16436,8733,7703,113.4,15697,8260,7437,111.1
31240, 화성시,050004, 48세,2021,15993,8570,7423,115.5,15254,8114,7140,113.6
31240, 화성시,050005, 49세,2021,15194,8232,6962,118.2,14415,7748,6667,116.2
31240, 화성시,055,50~54세,2021,69674,37174,32500,114.4,66284,35208,31076,113.3
31240, 화성시,055001, 50세,2021,15426,8354,7072,118.1,14646,7885,6761,116.6
31240, 화성시,055002, 51세,2021,14651,7929,6722,118,13898,7499,6399,117.2
31240, 화성시,055003, 52세,2021,14336,7552,6784,111.3,13674,7165,6509,110.1
31240, 화성시,055004, 53세,2021,13497,7158,6339,112.9,12853,6800,6053,112.3
31240, 화성시,055005, 54세,2021,11764,6181,5583,110.7,11213,5859,5354,109.4
31240, 화성시,060,55~59세,2021,54019,28845,25174,114.6,51223,27310,23913,114.2
31240, 화성시,060001, 55세,2021,11208,6091,5117,119,10631,5776,4855,119
31240, 화성시,060002, 56세,2021,11591,6279,5312,118.2,11000,5954,5046,118
31240, 화성시,060003, 57세,2021,10245,5414,4831,112.1,9694,5106,4588,111.3
31240, 화성시,060004, 58세,2021,10546,5582,4964,112.4,9965,5268,4697,112.2
31240, 화성시,060005, 59세,2021,10429,5479,4950,110.7,9933,5206,4727,110.1
31240, 화성시,065,60~64세,2021,46624,23850,22774,104.7,44986,23012,21974,104.7
31240, 화성시,065001, 60세,2021,11120,5772,5348,107.9,10801,5619,5182,108.4
31240, 화성시,065002, 61세,2021,10368,5360,5008,107,9967,5161,4806,107.4
31240, 화성시,065003, 62세,2021,9187,4759,4428,107.5,8882,4586,4296,106.8
31240, 화성시,065004, 63세,2021,8274,4204,4070,103.3,7967,4038,3929,102.8
31240, 화성시,065005, 64세,2021,7675,3755,3920,95.8,7369,3608,3761,95.9
31240, 화성시,070,65~69세,2021,30695,15139,15556,97.3,29812,14725,15087,97.6
31240, 화성시,070001, 65세,2021,7144,3582,3562,100.6,6925,3476,3449,100.8
31240, 화성시,070002, 66세,2021,6997,3481,3516,99,6774,3372,3402,99.1
31240, 화성시,070003, 67세,2021,5851,2823,3028,93.2,5673,2744,2929,93.7
31240, 화성시,070004, 68세,2021,5110,2573,2537,101.4,4963,2503,2460,101.7
31240, 화성시,070005, 69세,2021,5593,2680,2913,92,5477,2630,2847,92.4
31240, 화성시,075,70~74세,2021,19061,9163,9898,92.6,18676,8983,9693,92.7
31240, 화성시,075001, 70세,2021,3565,1741,1824,95.4,3446,1676,1770,94.7
31240, 화성시,075002, 71세,2021,4031,1901,2130,89.2,3949,1864,2085,89.4
31240, 화성시,075003, 72세,2021,3981,1917,2064,92.9,3910,1886,2024,93.2
31240, 화성시,075004, 73세,2021,3774,1819,1955,93,3715,1793,1922,93.3
31240, 화성시,075005, 74세,2021,3710,1785,1925,92.7,3656,1764,1892,93.2
31240, 화성시,080,75~79세,2021,13563,6030,7533,80,13443,5998,7445,80.6
31240, 화성시,080001, 75세,2021,2877,1377,1500,91.8,2859,1372,1487,92.3
31240, 화성시,080002, 76세,2021,2666,1253,1413,88.7,2631,1238,1393,88.9
31240, 화성시,080003, 77세,2021,2613,1143,1470,77.8,2591,1138,1453,78.3
31240, 화성시,080004, 78세,2021,2542,1052,1490,70.6,2515,1048,1467,71.4
31240, 화성시,080005, 79세,2021,2865,1205,1660,72.6,2847,1202,1645,73.1
31240, 화성시,085,80~84세,2021,9862,3829,6033,63.5,9765,3803,5962,63.8
31240, 화성시,085001, 80세,2021,2318,970,1348,72,2300,962,1338,71.9
31240, 화성시,085002, 81세,2021,2023,793,1230,64.5,2000,788,1212,65
31240, 화성시,085003, 82세,2021,2029,773,1256,61.5,2009,770,1239,62.1
31240, 화성시,085004, 83세,2021,1823,691,1132,61,1809,689,1120,61.5
31240, 화성시,085005, 84세,2021,1669,602,1067,56.4,1647,594,1053,56.4
31240, 화성시,090,85~89세,2021,5390,1661,3729,44.5,5357,1652,3705,44.6
31240, 화성시,090001, 85세,2021,1452,520,932,55.8,1441,518,923,56.1
31240, 화성시,090002, 86세,2021,1222,366,856,42.8,1214,362,852,42.5
31240, 화성시,090003, 87세,2021,1072,332,740,44.9,1066,330,736,44.8
31240, 화성시,090004, 88세,2021,868,243,625,38.9,866,242,624,38.8
31240, 화성시,090005, 89세,2021,776,200,576,34.7,770,200,570,35.1
31240, 화성시,095,90~94세,2021,1768,364,1404,25.9,1758,364,1394,26.1
31240, 화성시,095001, 90세,2021,509,116,393,29.5,505,116,389,29.8
31240, 화성시,095002, 91세,2021,453,83,370,22.4,452,83,369,22.5
31240, 화성시,095003, 92세,2021,335,78,257,30.4,331,78,253,30.8
31240, 화성시,095004, 93세,2021,269,56,213,26.3,268,56,212,26.4
31240, 화성시,095005, 94세,2021,202,31,171,18.1,202,31,171,18.1
31240, 화성시,100,95~99세,2021,376,78,298,26.2,373,78,295,26.4
31240, 화성시,100001, 95세,2021,111,25,86,29.1,111,25,86,29.1
31240, 화성시,100002, 96세,2021,96,20,76,26.3,95,20,75,26.7
31240, 화성시,100003, 97세,2021,69,14,55,25.5,68,14,54,25.9
31240, 화성시,100004, 98세,2021,63,11,52,21.2,63,11,52,21.2
31240, 화성시,100005, 99세,2021,37,8,29,27.6,36,8,28,28.6
31240, 화성시,101,100세이상,2021,55,9,46,19.6,53,8,45,17.8
31240, 화성시,102,15세미만,2021,157618,80371,77247,104,155439,79290,76149,104.1
31240, 화성시,103,15~64세,2021,667993,360819,307174,117.5,618743,326644,292099,111.8
31240, 화성시,104,65세이상,2021,80770,36273,44497,81.5,79237,35611,43626,81.6
31240, 화성시,086,85세이상,2021,7589,2112,5477,38.6,7541,2102,5439,38.6
31240, 화성시,126,평균연령,2021,37.8,37.3,38.3,,37.8,37.3,38.2,
31240, 화성시,127,중위연령,2021,38.6,38.2,39.1,,38.9,38.7,39.2,
31250, 광주시,000,합계,2021,387700,199287,188413,105.8,371619,188941,182678,103.4
31250, 광주시,005,0~4세,2021,14520,7335,7185,102.1,14318,7246,7072,102.5
31250, 광주시,005001, 0세,2021,2363,1185,1178,100.6,2332,1171,1161,100.9
31250, 광주시,005002, 1세,2021,2659,1357,1302,104.2,2620,1339,1281,104.5
31250, 광주시,005003, 2세,2021,2888,1498,1390,107.8,2846,1475,1371,107.6
31250, 광주시,005004, 3세,2021,3235,1615,1620,99.7,3186,1601,1585,101
31250, 광주시,005005, 4세,2021,3375,1680,1695,99.1,3334,1660,1674,99.2
31250, 광주시,010,5~9세,2021,18871,9721,9150,106.2,18645,9611,9034,106.4
31250, 광주시,010001, 5세,2021,3888,2000,1888,105.9,3838,1973,1865,105.8
31250, 광주시,010002, 6세,2021,3763,1952,1811,107.8,3724,1939,1785,108.6
31250, 광주시,010003, 7세,2021,3788,1959,1829,107.1,3743,1938,1805,107.4
31250, 광주시,010004, 8세,2021,3536,1773,1763,100.6,3486,1748,1738,100.6
31250, 광주시,010005, 9세,2021,3896,2037,1859,109.6,3854,2013,1841,109.3
31250, 광주시,015,10~14세,2021,17076,8680,8396,103.4,16942,8609,8333,103.3
31250, 광주시,015001, 10세,2021,3746,1949,1797,108.5,3707,1931,1776,108.7
31250, 광주시,015002, 11세,2021,3383,1731,1652,104.8,3356,1715,1641,104.5
31250, 광주시,015003, 12세,2021,3165,1608,1557,103.3,3136,1593,1543,103.2
31250, 광주시,015004, 13세,2021,3365,1675,1690,99.1,3346,1666,1680,99.2
31250, 광주시,015005, 14세,2021,3417,1717,1700,101,3397,1704,1693,100.6
31250, 광주시,020,15~19세,2021,15704,7937,7767,102.2,15614,7887,7727,102.1
31250, 광주시,020001, 15세,2021,3148,1623,1525,106.4,3134,1619,1515,106.9
31250, 광주시,020002, 16세,2021,2956,1477,1479,99.9,2937,1466,1471,99.7
31250, 광주시,020003, 17세,2021,3246,1621,1625,99.8,3227,1608,1619,99.3
31250, 광주시,020004, 18세,2021,3076,1497,1579,94.8,3062,1490,1572,94.8
31250, 광주시,020005, 19세,2021,3278,1719,1559,110.3,3254,1704,1550,109.9
31250, 광주시,025,20~24세,2021,20494,11139,9355,119.1,19408,10396,9012,115.4
31250, 광주시,025001, 20세,2021,3586,1947,1639,118.8,3544,1933,1611,120
31250, 광주시,025002, 21세,2021,4000,2211,1789,123.6,3894,2145,1749,122.6
31250, 광주시,025003, 22세,2021,4004,2170,1834,118.3,3793,2030,1763,115.1
31250, 광주시,025004, 23세,2021,4411,2376,2035,116.8,4091,2152,1939,111
31250, 광주시,025005, 24세,2021,4493,2435,2058,118.3,4086,2136,1950,109.5
31250, 광주시,030,25~29세,2021,25794,14356,11438,125.5,23024,12302,10722,114.7
31250, 광주시,030001, 25세,2021,4874,2692,2182,123.4,4394,2346,2048,114.6
31250, 광주시,030002, 26세,2021,5032,2794,2238,124.8,4488,2385,2103,113.4
31250, 광주시,030003, 27세,2021,5145,2855,2290,124.7,4598,2440,2158,113.1
31250, 광주시,030004, 28세,2021,5171,2938,2233,131.6,4584,2494,2090,119.3
31250, 광주시,030005, 29세,2021,5572,3077,2495,123.3,4960,2637,2323,113.5
31250, 광주시,035,30~34세,2021,26233,14210,12023,118.2,23335,12125,11210,108.2
31250, 광주시,035001, 30세,2021,5236,2884,2352,122.6,4677,2482,2195,113.1
31250, 광주시,035002, 31세,2021,5135,2788,2347,118.8,4542,2348,2194,107
31250, 광주시,035003, 32세,2021,5215,2835,2380,119.1,4628,2409,2219,108.6
31250, 광주시,035004, 33세,2021,5212,2781,2431,114.4,4624,2380,2244,106.1
31250, 광주시,035005, 34세,2021,5435,2922,2513,116.3,4864,2506,2358,106.3
31250, 광주시,040,35~39세,2021,32652,17357,15295,113.5,30223,15680,14543,107.8
31250, 광주시,040001, 35세,2021,5599,2976,2623,113.5,5091,2625,2466,106.4
31250, 광주시,040002, 36세,2021,6000,3197,2803,114.1,5484,2839,2645,107.3
31250, 광주시,040003, 37세,2021,6262,3332,2930,113.7,5774,2989,2785,107.3
31250, 광주시,040004, 38세,2021,7083,3799,3284,115.7,6613,3472,3141,110.5
31250, 광주시,040005, 39세,2021,7708,4053,3655,110.9,7261,3755,3506,107.1
31250, 광주시,045,40~44세,2021,34746,18636,16110,115.7,33086,17535,15551,112.8
31250, 광주시,045001, 40세,2021,7647,4150,3497,118.7,7249,3872,3377,114.7
31250, 광주시,045002, 41세,2021,7752,4109,3643,112.8,7369,3850,3519,109.4
31250, 광주시,045003, 42세,2021,6936,3765,3171,118.7,6588,3532,3056,115.6
31250, 광주시,045004, 43세,2021,6164,3222,2942,109.5,5894,3056,2838,107.7
31250, 광주시,045005, 44세,2021,6247,3390,2857,118.7,5986,3225,2761,116.8
31250, 광주시,050,45~49세,2021,32641,17194,15447,111.3,31474,16524,14950,110.5
31250, 광주시,050001, 45세,2021,6160,3304,2856,115.7,5900,3131,2769,113.1
31250, 광주시,050002, 46세,2021,6310,3317,2993,110.8,6094,3189,2905,109.8
31250, 광주시,050003, 47세,2021,6639,3478,3161,110,6415,3346,3069,109
31250, 광주시,050004, 48세,2021,6718,3473,3245,107,6482,3353,3129,107.2
31250, 광주시,050005, 49세,2021,6814,3622,3192,113.5,6583,3505,3078,113.9
31250, 광주시,055,50~54세,2021,33757,17147,16610,103.2,32719,16574,16145,102.7
31250, 광주시,055001, 50세,2021,7066,3660,3406,107.5,6840,3531,3309,106.7
31250, 광주시,055002, 51세,2021,6738,3487,3251,107.3,6505,3353,3152,106.4
31250, 광주시,055003, 52세,2021,6937,3538,3399,104.1,6732,3425,3307,103.6
31250, 광주시,055004, 53세,2021,6851,3420,3431,99.7,6650,3308,3342,99
31250, 광주시,055005, 54세,2021,6165,3042,3123,97.4,5992,2957,3035,97.4
31250, 광주시,060,55~59세,2021,30561,15436,15125,102.1,29589,14953,14636,102.2
31250, 광주시,060001, 55세,2021,6038,3080,2958,104.1,5849,2986,2863,104.3
31250, 광주시,060002, 56세,2021,6382,3195,3187,100.3,6165,3088,3077,100.4
31250, 광주시,060003, 57세,2021,5755,2871,2884,99.5,5569,2787,2782,100.2
31250, 광주시,060004, 58세,2021,6109,3132,2977,105.2,5880,3013,2867,105.1
31250, 광주시,060005, 59세,2021,6277,3158,3119,101.3,6126,3079,3047,101.1
31250, 광주시,065,60~64세,2021,30256,14946,15310,97.6,29586,14617,14969,97.6
31250, 광주시,065001, 60세,2021,6696,3250,3446,94.3,6583,3206,3377,94.9
31250, 광주시,065002, 61세,2021,6524,3239,3285,98.6,6365,3151,3214,98
31250, 광주시,065003, 62세,2021,5935,2898,3037,95.4,5810,2836,2974,95.4
31250, 광주시,065004, 63세,2021,5666,2839,2827,100.4,5519,2768,2751,100.6
31250, 광주시,065005, 64세,2021,5435,2720,2715,100.2,5309,2656,2653,100.1
31250, 광주시,070,65~69세,2021,21237,10561,10676,98.9,20831,10379,10452,99.3
31250, 광주시,070001, 65세,2021,4859,2421,2438,99.3,4757,2382,2375,100.3
31250, 광주시,070002, 66세,2021,4974,2462,2512,98,4886,2415,2471,97.7
31250, 광주시,070003, 67세,2021,4070,2010,2060,97.6,3994,1971,2023,97.4
31250, 광주시,070004, 68세,2021,3521,1746,1775,98.4,3450,1719,1731,99.3
31250, 광주시,070005, 69세,2021,3813,1922,1891,101.6,3744,1892,1852,102.2
31250, 광주시,075,70~74세,2021,13376,6520,6856,95.1,13188,6431,6757,95.2
31250, 광주시,075001, 70세,2021,2581,1236,1345,91.9,2533,1218,1315,92.6
31250, 광주시,075002, 71세,2021,2786,1357,1429,95,2739,1328,1411,94.1
31250, 광주시,075003, 72세,2021,2728,1303,1425,91.4,2694,1283,1411,90.9
31250, 광주시,075004, 73세,2021,2642,1325,1317,100.6,2610,1314,1296,101.4
31250, 광주시,075005, 74세,2021,2639,1299,1340,96.9,2612,1288,1324,97.3
31250, 광주시,080,75~79세,2021,9309,4383,4926,89,9240,4360,4880,89.3
31250, 광주시,080001, 75세,2021,1980,935,1045,89.5,1959,929,1030,90.2
31250, 광주시,080002, 76세,2021,1822,877,945,92.8,1810,872,938,93
31250, 광주시,080003, 77세,2021,1791,855,936,91.3,1778,852,926,92
31250, 광주시,080004, 78세,2021,1744,819,925,88.5,1732,815,917,88.9
31250, 광주시,080005, 79세,2021,1972,897,1075,83.4,1961,892,1069,83.4
31250, 광주시,085,80~84세,2021,6068,2469,3599,68.6,6024,2460,3564,69
31250, 광주시,085001, 80세,2021,1509,652,857,76.1,1497,650,847,76.7
31250, 광주시,085002, 81세,2021,1356,535,821,65.2,1347,531,816,65.1
31250, 광주시,085003, 82세,2021,1225,503,722,69.7,1215,502,713,70.4
31250, 광주시,085004, 83세,2021,1068,412,656,62.8,1058,411,647,63.5
31250, 광주시,085005, 84세,2021,910,367,543,67.6,907,366,541,67.7
31250, 광주시,090,85~89세,2021,3060,988,2072,47.7,3035,980,2055,47.7
31250, 광주시,090001, 85세,2021,818,290,528,54.9,814,289,525,55
31250, 광주시,090002, 86세,2021,772,245,527,46.5,768,245,523,46.8
31250, 광주시,090003, 87세,2021,600,207,393,52.7,593,204,389,52.4
31250, 광주시,090004, 88세,2021,482,143,339,42.2,477,142,335,42.4
31250, 광주시,090005, 89세,2021,388,103,285,36.1,383,100,283,35.3
31250, 광주시,095,90~94세,2021,1066,223,843,26.5,1060,223,837,26.6
31250, 광주시,095001, 90세,2021,278,57,221,25.8,276,57,219,26
31250, 광주시,095002, 91세,2021,282,67,215,31.2,282,67,215,31.2
31250, 광주시,095003, 92세,2021,236,57,179,31.8,233,57,176,32.4
31250, 광주시,095004, 93세,2021,149,26,123,21.1,149,26,123,21.1
31250, 광주시,095005, 94세,2021,121,16,105,15.2,120,16,104,15.4
31250, 광주시,100,95~99세,2021,238,42,196,21.4,237,42,195,21.5
31250, 광주시,100001, 95세,2021,81,15,66,22.7,80,15,65,23.1
31250, 광주시,100002, 96세,2021,57,11,46,23.9,57,11,46,23.9
31250, 광주시,100003, 97세,2021,42,5,37,13.5,42,5,37,13.5
31250, 광주시,100004, 98세,2021,34,10,24,41.7,34,10,24,41.7
31250, 광주시,100005, 99세,2021,24,X,23,4.3,24,X,23,4.3
31250, 광주시,101,100세이상,2021,41,7,34,20.6,41,7,34,20.6
31250, 광주시,102,15세미만,2021,50467,25736,24731,104.1,49905,25466,24439,104.2
31250, 광주시,103,15~64세,2021,282838,148358,134480,110.3,268058,138593,129465,107.1
31250, 광주시,104,65세이상,2021,54395,25193,29202,86.3,53656,24882,28774,86.5
31250, 광주시,086,85세이상,2021,4405,1260,3145,40.1,4373,1252,3121,40.1
31250, 광주시,126,평균연령,2021,42.2,41.5,43,,42.4,41.7,43.1,
31250, 광주시,127,중위연령,2021,43,42.2,44.1,,43.5,42.8,44.3,
31260, 양주시,000,합계,2021,239800,122616,117184,104.6,230172,115830,114342,101.3
31260, 양주시,005,0~4세,2021,8078,4141,3937,105.2,7979,4090,3889,105.2
31260, 양주시,005001, 0세,2021,1254,665,589,112.9,1242,658,584,112.7
31260, 양주시,005002, 1세,2021,1445,718,727,98.8,1430,710,720,98.6
31260, 양주시,005003, 2세,2021,1620,846,774,109.3,1594,831,763,108.9
31260, 양주시,005004, 3세,2021,1773,903,870,103.8,1749,890,859,103.6
31260, 양주시,005005, 4세,2021,1986,1009,977,103.3,1964,1001,963,103.9
31260, 양주시,010,5~9세,2021,11626,5949,5677,104.8,11529,5891,5638,104.5
31260, 양주시,010001, 5세,2021,2195,1117,1078,103.6,2170,1105,1065,103.8
31260, 양주시,010002, 6세,2021,2307,1185,1122,105.6,2282,1168,1114,104.8
31260, 양주시,010003, 7세,2021,2213,1139,1074,106.1,2193,1128,1065,105.9
31260, 양주시,010004, 8세,2021,2290,1158,1132,102.3,2278,1151,1127,102.1
31260, 양주시,010005, 9세,2021,2621,1350,1271,106.2,2606,1339,1267,105.7
31260, 양주시,015,10~14세,2021,12142,6113,6029,101.4,12084,6080,6004,101.3
31260, 양주시,015001, 10세,2021,2487,1258,1229,102.4,2475,1252,1223,102.4
31260, 양주시,015002, 11세,2021,2405,1196,1209,98.9,2394,1189,1205,98.7
31260, 양주시,015003, 12세,2021,2320,1173,1147,102.3,2311,1170,1141,102.5
31260, 양주시,015004, 13세,2021,2429,1232,1197,102.9,2415,1221,1194,102.3
31260, 양주시,015005, 14세,2021,2501,1254,1247,100.6,2489,1248,1241,100.6
31260, 양주시,020,15~19세,2021,11356,5848,5508,106.2,11274,5796,5478,105.8
31260, 양주시,020001, 15세,2021,2313,1175,1138,103.3,2304,1170,1134,103.2
31260, 양주시,020002, 16세,2021,2241,1186,1055,112.4,2232,1180,1052,112.2
31260, 양주시,020003, 17세,2021,2360,1220,1140,107,2355,1218,1137,107.1
31260, 양주시,020004, 18세,2021,2273,1116,1157,96.5,2251,1104,1147,96.3
31260, 양주시,020005, 19세,2021,2169,1151,1018,113.1,2132,1124,1008,111.5
31260, 양주시,025,20~24세,2021,13788,7530,6258,120.3,12905,6899,6006,114.9
31260, 양주시,025001, 20세,2021,2604,1362,1242,109.7,2520,1314,1206,109
31260, 양주시,025002, 21세,2021,2732,1517,1215,124.9,2591,1423,1168,121.8
31260, 양주시,025003, 22세,2021,2754,1547,1207,128.2,2593,1432,1161,123.3
31260, 양주시,025004, 23세,2021,2780,1513,1267,119.4,2564,1350,1214,111.2
31260, 양주시,025005, 24세,2021,2918,1591,1327,119.9,2637,1380,1257,109.8
31260, 양주시,030,25~29세,2021,14955,8535,6420,132.9,13178,7146,6032,118.5
31260, 양주시,030001, 25세,2021,2976,1714,1262,135.8,2642,1446,1196,120.9
31260, 양주시,030002, 26세,2021,2935,1683,1252,134.4,2597,1424,1173,121.4
31260, 양주시,030003, 27세,2021,2957,1686,1271,132.7,2612,1420,1192,119.1
31260, 양주시,030004, 28세,2021,3027,1712,1315,130.2,2676,1432,1244,115.1
31260, 양주시,030005, 29세,2021,3060,1740,1320,131.8,2651,1424,1227,116.1
31260, 양주시,035,30~34세,2021,14355,8014,6341,126.4,12332,6448,5884,109.6
31260, 양주시,035001, 30세,2021,3000,1700,1300,130.8,2576,1375,1201,114.5
31260, 양주시,035002, 31세,2021,3023,1699,1324,128.3,2609,1370,1239,110.6
31260, 양주시,035003, 32세,2021,2765,1528,1237,123.5,2376,1233,1143,107.9
31260, 양주시,035004, 33세,2021,2763,1535,1228,125,2355,1232,1123,109.7
31260, 양주시,035005, 34세,2021,2804,1552,1252,124,2416,1238,1178,105.1
31260, 양주시,040,35~39세,2021,16285,8601,7684,111.9,14889,7594,7295,104.1
31260, 양주시,040001, 35세,2021,2849,1507,1342,112.3,2564,1309,1255,104.3
31260, 양주시,040002, 36세,2021,2891,1526,1365,111.8,2603,1313,1290,101.8
31260, 양주시,040003, 37세,2021,3188,1676,1512,110.8,2878,1446,1432,101
31260, 양주시,040004, 38세,2021,3551,1956,1595,122.6,3294,1773,1521,116.6
31260, 양주시,040005, 39세,2021,3806,1936,1870,103.5,3550,1753,1797,97.6
31260, 양주시,045,40~44세,2021,19237,9915,9322,106.4,18238,9224,9014,102.3
31260, 양주시,045001, 40세,2021,3976,2041,1935,105.5,3763,1897,1866,101.7
31260, 양주시,045002, 41세,2021,4152,2171,1981,109.6,3943,2009,1934,103.9
31260, 양주시,045003, 42세,2021,3864,2009,1855,108.3,3636,1853,1783,103.9
31260, 양주시,045004, 43세,2021,3627,1869,1758,106.3,3438,1738,1700,102.2
31260, 양주시,045005, 44세,2021,3618,1825,1793,101.8,3458,1727,1731,99.8
31260, 양주시,050,45~49세,2021,20953,10978,9975,110.1,20262,10536,9726,108.3
31260, 양주시,050001, 45세,2021,3774,1934,1840,105.1,3628,1839,1789,102.8
31260, 양주시,050002, 46세,2021,4026,2134,1892,112.8,3886,2041,1845,110.6
31260, 양주시,050003, 47세,2021,4344,2241,2103,106.6,4203,2148,2055,104.5
31260, 양주시,050004, 48세,2021,4475,2326,2149,108.2,4340,2247,2093,107.4
31260, 양주시,050005, 49세,2021,4334,2343,1991,117.7,4205,2261,1944,116.3
31260, 양주시,055,50~54세,2021,20680,10670,10010,106.6,20096,10285,9811,104.8
31260, 양주시,055001, 50세,2021,4407,2312,2095,110.4,4295,2234,2061,108.4
31260, 양주시,055002, 51세,2021,4172,2149,2023,106.2,4046,2063,1983,104
31260, 양주시,055003, 52세,2021,4272,2151,2121,101.4,4140,2065,2075,99.5
31260, 양주시,055004, 53세,2021,4111,2116,1995,106.1,3999,2046,1953,104.8
31260, 양주시,055005, 54세,2021,3718,1942,1776,109.3,3616,1877,1739,107.9
31260, 양주시,060,55~59세,2021,18316,9667,8649,111.8,17924,9436,8488,111.2
31260, 양주시,060001, 55세,2021,3750,1975,1775,111.3,3668,1927,1741,110.7
31260, 양주시,060002, 56세,2021,3786,1996,1790,111.5,3702,1950,1752,111.3
31260, 양주시,060003, 57세,2021,3423,1851,1572,117.7,3345,1802,1543,116.8
31260, 양주시,060004, 58세,2021,3704,1922,1782,107.9,3610,1862,1748,106.5
31260, 양주시,060005, 59세,2021,3653,1923,1730,111.2,3599,1895,1704,111.2
31260, 양주시,065,60~64세,2021,17803,8947,8856,101,17541,8816,8725,101
31260, 양주시,065001, 60세,2021,3820,1919,1901,100.9,3771,1892,1879,100.7
31260, 양주시,065002, 61세,2021,3921,1961,1960,100.1,3859,1930,1929,100.1
31260, 양주시,065003, 62세,2021,3442,1737,1705,101.9,3389,1711,1678,102
31260, 양주시,065004, 63세,2021,3291,1677,1614,103.9,3237,1648,1589,103.7
31260, 양주시,065005, 64세,2021,3329,1653,1676,98.6,3285,1635,1650,99.1
31260, 양주시,070,65~69세,2021,13031,6351,6680,95.1,12879,6281,6598,95.2
31260, 양주시,070001, 65세,2021,2962,1499,1463,102.5,2918,1480,1438,102.9
31260, 양주시,070002, 66세,2021,3066,1476,1590,92.8,3034,1463,1571,93.1
31260, 양주시,070003, 67세,2021,2529,1243,1286,96.7,2500,1233,1267,97.3
31260, 양주시,070004, 68세,2021,2166,1029,1137,90.5,2143,1018,1125,90.5
31260, 양주시,070005, 69세,2021,2308,1104,1204,91.7,2284,1087,1197,90.8
31260, 양주시,075,70~74세,2021,9112,4301,4811,89.4,9033,4270,4763,89.6
31260, 양주시,075001, 70세,2021,1569,734,835,87.9,1553,729,824,88.5
31260, 양주시,075002, 71세,2021,1827,865,962,89.9,1809,858,951,90.2
31260, 양주시,075003, 72세,2021,1882,871,1011,86.2,1859,858,1001,85.7
31260, 양주시,075004, 73세,2021,1874,883,991,89.1,1865,881,984,89.5
31260, 양주시,075005, 74세,2021,1960,948,1012,93.7,1947,944,1003,94.1
31260, 양주시,080,75~79세,2021,7671,3454,4217,81.9,7644,3443,4201,82
31260, 양주시,080001, 75세,2021,1526,722,804,89.8,1517,721,796,90.6
31260, 양주시,080002, 76세,2021,1519,720,799,90.1,1511,716,795,90.1
31260, 양주시,080003, 77세,2021,1480,664,816,81.4,1478,662,816,81.1
31260, 양주시,080004, 78세,2021,1431,630,801,78.7,1427,628,799,78.6
31260, 양주시,080005, 79세,2021,1715,718,997,72,1711,716,995,72
31260, 양주시,085,80~84세,2021,5656,2248,3408,66,5642,2244,3398,66
31260, 양주시,085001, 80세,2021,1343,542,801,67.7,1340,541,799,67.7
31260, 양주시,085002, 81세,2021,1157,485,672,72.2,1155,485,670,72.4
31260, 양주시,085003, 82세,2021,1145,444,701,63.3,1140,441,699,63.1
31260, 양주시,085004, 83세,2021,1045,410,635,64.6,1044,410,634,64.7
31260, 양주시,085005, 84세,2021,966,367,599,61.3,963,367,596,61.6
31260, 양주시,090,85~89세,2021,3171,1021,2150,47.5,3160,1018,2142,47.5
31260, 양주시,090001, 85세,2021,827,289,538,53.7,824,288,536,53.7
31260, 양주시,090002, 86세,2021,784,255,529,48.2,782,255,527,48.4
31260, 양주시,090003, 87세,2021,619,202,417,48.4,615,201,414,48.6
31260, 양주시,090004, 88세,2021,489,144,345,41.7,487,143,344,41.6
31260, 양주시,090005, 89세,2021,452,131,321,40.8,452,131,321,40.8
31260, 양주시,095,90~94세,2021,1197,252,945,26.7,1195,252,943,26.7
31260, 양주시,095001, 90세,2021,325,73,252,29,325,73,252,29
31260, 양주시,095002, 91세,2021,287,66,221,29.9,286,66,220,30
31260, 양주시,095003, 92세,2021,249,49,200,24.5,249,49,200,24.5
31260, 양주시,095004, 93세,2021,197,45,152,29.6,197,45,152,29.6
31260, 양주시,095005, 94세,2021,139,19,120,15.8,138,19,119,16
31260, 양주시,100,95~99세,2021,335,69,266,25.9,335,69,266,25.9
31260, 양주시,100001, 95세,2021,114,20,94,21.3,114,20,94,21.3
31260, 양주시,100002, 96세,2021,74,15,59,25.4,74,15,59,25.4
31260, 양주시,100003, 97세,2021,62,12,50,24,62,12,50,24
31260, 양주시,100004, 98세,2021,52,14,38,36.8,52,14,38,36.8
31260, 양주시,100005, 99세,2021,33,8,25,32,33,8,25,32
31260, 양주시,101,100세이상,2021,53,12,41,29.3,53,12,41,29.3
31260, 양주시,102,15세미만,2021,31846,16203,15643,103.6,31592,16061,15531,103.4
31260, 양주시,103,15~64세,2021,167728,88705,79023,112.3,158639,82180,76459,107.5
31260, 양주시,104,65세이상,2021,40226,17708,22518,78.6,39941,17589,22352,78.7
31260, 양주시,086,85세이상,2021,4756,1354,3402,39.8,4743,1351,3392,39.8
31260, 양주시,126,평균연령,2021,43.1,42,44.3,,43.4,42.4,44.5,
31260, 양주시,127,중위연령,2021,44.5,43.2,45.8,,45.2,44.3,46.1,
31270, 포천시,000,합계,2021,157602,85864,71738,119.7,141422,74004,67418,109.8
31270, 포천시,005,0~4세,2021,3472,1786,1686,105.9,3363,1729,1634,105.8
31270, 포천시,005001, 0세,2021,571,278,293,94.9,543,266,277,96
31270, 포천시,005002, 1세,2021,623,313,310,101,608,304,304,100
31270, 포천시,005003, 2세,2021,675,363,312,116.3,655,350,305,114.8
31270, 포천시,005004, 3세,2021,765,384,381,100.8,737,368,369,99.7
31270, 포천시,005005, 4세,2021,838,448,390,114.9,820,441,379,116.4
31270, 포천시,010,5~9세,2021,4716,2407,2309,104.2,4639,2370,2269,104.5
31270, 포천시,010001, 5세,2021,887,474,413,114.8,869,464,405,114.6
31270, 포천시,010002, 6세,2021,910,463,447,103.6,894,457,437,104.6
31270, 포천시,010003, 7세,2021,894,447,447,100,883,441,442,99.8
31270, 포천시,010004, 8세,2021,943,489,454,107.7,925,478,447,106.9
31270, 포천시,010005, 9세,2021,1082,534,548,97.4,1068,530,538,98.5
31270, 포천시,015,10~14세,2021,5429,2873,2556,112.4,5375,2847,2528,112.6
31270, 포천시,015001, 10세,2021,1065,579,486,119.1,1053,573,480,119.4
31270, 포천시,015002, 11세,2021,1065,549,516,106.4,1048,542,506,107.1
31270, 포천시,015003, 12세,2021,1041,527,514,102.5,1032,522,510,102.4
31270, 포천시,015004, 13세,2021,1093,579,514,112.6,1083,575,508,113.2
31270, 포천시,015005, 14세,2021,1165,639,526,121.5,1159,635,524,121.2
31270, 포천시,020,15~19세,2021,6068,3171,2897,109.5,5967,3117,2850,109.4
31270, 포천시,020001, 15세,2021,1133,578,555,104.1,1120,573,547,104.8
31270, 포천시,020002, 16세,2021,1098,579,519,111.6,1087,574,513,111.9
31270, 포천시,020003, 17세,2021,1119,593,526,112.7,1108,586,522,112.3
31270, 포천시,020004, 18세,2021,1347,691,656,105.3,1326,682,644,105.9
31270, 포천시,020005, 19세,2021,1371,730,641,113.9,1326,702,624,112.5
31270, 포천시,025,20~24세,2021,10130,5851,4279,136.7,8600,4794,3806,126
31270, 포천시,025001, 20세,2021,1675,903,772,117,1544,826,718,115
31270, 포천시,025002, 21세,2021,1909,1053,856,123,1687,916,771,118.8
31270, 포천시,025003, 22세,2021,1998,1150,848,135.6,1747,976,771,126.6
31270, 포천시,025004, 23세,2021,2180,1312,868,151.2,1805,1053,752,140
31270, 포천시,025005, 24세,2021,2368,1433,935,153.3,1817,1023,794,128.8
31270, 포천시,030,25~29세,2021,12365,8057,4308,187,8819,5256,3563,147.5
31270, 포천시,030001, 25세,2021,2449,1572,877,179.2,1802,1067,735,145.2
31270, 포천시,030002, 26세,2021,2464,1598,866,184.5,1791,1063,728,146
31270, 포천시,030003, 27세,2021,2490,1617,873,185.2,1797,1070,727,147.2
31270, 포천시,030004, 28세,2021,2523,1647,876,188,1755,1046,709,147.5
31270, 포천시,030005, 29세,2021,2439,1623,816,198.9,1674,1010,664,152.1
31270, 포천시,035,30~34세,2021,10625,6829,3796,179.9,7044,3995,3049,131
31270, 포천시,035001, 30세,2021,2364,1554,810,191.9,1586,932,654,142.5
31270, 포천시,035002, 31세,2021,2267,1453,814,178.5,1505,858,647,132.6
31270, 포천시,035003, 32세,2021,2002,1282,720,178.1,1312,735,577,127.4
31270, 포천시,035004, 33세,2021,2081,1324,757,174.9,1392,782,610,128.2
31270, 포천시,035005, 34세,2021,1911,1216,695,175,1249,688,561,122.6
31270, 포천시,040,35~39세,2021,9367,5741,3626,158.3,6878,3801,3077,123.5
31270, 포천시,040001, 35세,2021,1860,1164,696,167.2,1279,722,557,129.6
31270, 포천시,040002, 36세,2021,1834,1137,697,163.1,1276,685,591,115.9
31270, 포천시,040003, 37세,2021,1780,1099,681,161.4,1297,723,574,126
31270, 포천시,040004, 38세,2021,1930,1151,779,147.8,1480,794,686,115.7
31270, 포천시,040005, 39세,2021,1963,1190,773,153.9,1546,877,669,131.1
31270, 포천시,045,40~44세,2021,9821,5564,4257,130.7,8258,4414,3844,114.8
31270, 포천시,045001, 40세,2021,2018,1183,835,141.7,1664,909,755,120.4
31270, 포천시,045002, 41세,2021,2056,1191,865,137.7,1706,932,774,120.4
31270, 포천시,045003, 42세,2021,1898,1074,824,130.3,1573,840,733,114.6
31270, 포천시,045004, 43세,2021,1898,1043,855,122,1608,830,778,106.7
31270, 포천시,045005, 44세,2021,1951,1073,878,122.2,1707,903,804,112.3
31270, 포천시,050,45~49세,2021,11509,6277,5232,120,10410,5521,4889,112.9
31270, 포천시,050001, 45세,2021,1984,1092,892,122.4,1710,891,819,108.8
31270, 포천시,050002, 46세,2021,2161,1170,991,118.1,1932,1016,916,110.9
31270, 포천시,050003, 47세,2021,2390,1316,1074,122.5,2179,1174,1005,116.8
31270, 포천시,050004, 48세,2021,2425,1294,1131,114.4,2250,1181,1069,110.5
31270, 포천시,050005, 49세,2021,2549,1405,1144,122.8,2339,1259,1080,116.6
31270, 포천시,055,50~54세,2021,13867,7441,6426,115.8,13085,6967,6118,113.9
31270, 포천시,055001, 50세,2021,2774,1527,1247,122.5,2595,1411,1184,119.2
31270, 포천시,055002, 51세,2021,2602,1421,1181,120.3,2424,1311,1113,117.8
31270, 포천시,055003, 52세,2021,2771,1469,1302,112.8,2636,1395,1241,112.4
31270, 포천시,055004, 53세,2021,2978,1578,1400,112.7,2821,1485,1336,111.2
31270, 포천시,055005, 54세,2021,2742,1446,1296,111.6,2609,1365,1244,109.7
31270, 포천시,060,55~59세,2021,14745,8075,6670,121.1,14131,7719,6412,120.4
31270, 포천시,060001, 55세,2021,2934,1620,1314,123.3,2809,1542,1267,121.7
31270, 포천시,060002, 56세,2021,3037,1662,1375,120.9,2903,1589,1314,120.9
31270, 포천시,060003, 57세,2021,2786,1531,1255,122,2666,1454,1212,120
31270, 포천시,060004, 58세,2021,3066,1679,1387,121.1,2921,1601,1320,121.3
31270, 포천시,060005, 59세,2021,2922,1583,1339,118.2,2832,1533,1299,118
31270, 포천시,065,60~64세,2021,15365,8176,7189,113.7,15017,7991,7026,113.7
31270, 포천시,065001, 60세,2021,3305,1747,1558,112.1,3233,1704,1529,111.4
31270, 포천시,065002, 61세,2021,3309,1760,1549,113.6,3228,1718,1510,113.8
31270, 포천시,065003, 62세,2021,3045,1601,1444,110.9,2969,1560,1409,110.7
31270, 포천시,065004, 63세,2021,2991,1597,1394,114.6,2926,1564,1362,114.8
31270, 포천시,065005, 64세,2021,2715,1471,1244,118.2,2661,1445,1216,118.8
31270, 포천시,070,65~69세,2021,10092,5352,4740,112.9,9928,5269,4659,113.1
31270, 포천시,070001, 65세,2021,2436,1324,1112,119.1,2393,1302,1091,119.3
31270, 포천시,070002, 66세,2021,2351,1298,1053,123.3,2321,1283,1038,123.6
31270, 포천시,070003, 67세,2021,1967,1003,964,104,1931,988,943,104.8
31270, 포천시,070004, 68세,2021,1649,850,799,106.4,1614,832,782,106.4
31270, 포천시,070005, 69세,2021,1689,877,812,108,1669,864,805,107.3
31270, 포천시,075,70~74세,2021,6442,3134,3308,94.7,6380,3104,3276,94.7
31270, 포천시,075001, 70세,2021,1050,542,508,106.7,1035,536,499,107.4
31270, 포천시,075002, 71세,2021,1265,612,653,93.7,1252,603,649,92.9
31270, 포천시,075003, 72세,2021,1415,703,712,98.7,1401,699,702,99.6
31270, 포천시,075004, 73세,2021,1290,645,645,100,1276,638,638,100
31270, 포천시,075005, 74세,2021,1422,632,790,80,1416,628,788,79.7
31270, 포천시,080,75~79세,2021,5466,2357,3109,75.8,5432,2345,3087,76
31270, 포천시,080001, 75세,2021,1100,511,589,86.8,1092,508,584,87
31270, 포천시,080002, 76세,2021,1120,505,615,82.1,1116,504,612,82.4
31270, 포천시,080003, 77세,2021,999,431,568,75.9,992,428,564,75.9
31270, 포천시,080004, 78세,2021,1040,423,617,68.6,1031,419,612,68.5
31270, 포천시,080005, 79세,2021,1207,487,720,67.6,1201,486,715,68
31270, 포천시,085,80~84세,2021,4547,1739,2808,61.9,4527,1733,2794,62
31270, 포천시,085001, 80세,2021,1039,415,624,66.5,1031,413,618,66.8
31270, 포천시,085002, 81세,2021,997,402,595,67.6,996,402,594,67.7
31270, 포천시,085003, 82세,2021,951,357,594,60.1,946,356,590,60.3
31270, 포천시,085004, 83세,2021,809,289,520,55.6,806,288,518,55.6
31270, 포천시,085005, 84세,2021,751,276,475,58.1,748,274,474,57.8
31270, 포천시,090,85~89세,2021,2436,773,1663,46.5,2432,771,1661,46.4
31270, 포천시,090001, 85세,2021,640,227,413,55,639,226,413,54.7
31270, 포천시,090002, 86세,2021,619,202,417,48.4,617,201,416,48.3
31270, 포천시,090003, 87세,2021,492,154,338,45.6,491,154,337,45.7
31270, 포천시,090004, 88세,2021,380,110,270,40.7,380,110,270,40.7
31270, 포천시,090005, 89세,2021,305,80,225,35.6,305,80,225,35.6
31270, 포천시,095,90~94세,2021,856,193,663,29.1,853,193,660,29.2
31270, 포천시,095001, 90세,2021,235,70,165,42.4,233,70,163,42.9
31270, 포천시,095002, 91세,2021,228,44,184,23.9,227,44,183,24
31270, 포천시,095003, 92세,2021,182,45,137,32.8,182,45,137,32.8
31270, 포천시,095004, 93세,2021,120,17,103,16.5,120,17,103,16.5
31270, 포천시,095005, 94세,2021,91,17,74,23,91,17,74,23
31270, 포천시,100,95~99세,2021,249,61,188,32.4,249,61,188,32.4
31270, 포천시,100001, 95세,2021,84,12,72,16.7,84,12,72,16.7
31270, 포천시,100002, 96세,2021,68,18,50,36,68,18,50,36
31270, 포천시,100003, 97세,2021,38,12,26,46.2,38,12,26,46.2
31270, 포천시,100004, 98세,2021,41,9,32,28.1,41,9,32,28.1
31270, 포천시,100005, 99세,2021,18,10,8,125,18,10,8,125
31270, 포천시,101,100세이상,2021,35,7,28,25,35,7,28,25
31270, 포천시,102,15세미만,2021,13617,7066,6551,107.9,13377,6946,6431,108
31270, 포천시,103,15~64세,2021,113862,65182,48680,133.9,98209,53575,44634,120
31270, 포천시,104,65세이상,2021,30123,13616,16507,82.5,29836,13483,16353,82.4
31270, 포천시,086,85세이상,2021,3576,1034,2542,40.7,3569,1032,2537,40.7
31270, 포천시,126,평균연령,2021,46,44.4,47.9,,47.1,45.8,48.6,
31270, 포천시,127,중위연령,2021,48.1,45.6,50.7,,50.5,49.3,51.9,
31280, 여주시,000,합계,2021,113270,57924,55346,104.7,108422,55044,53378,103.1
31280, 여주시,005,0~4세,2021,2768,1383,1385,99.9,2746,1375,1371,100.3
31280, 여주시,005001, 0세,2021,449,226,223,101.3,443,226,217,104.1
31280, 여주시,005002, 1세,2021,519,245,274,89.4,513,241,272,88.6
31280, 여주시,005003, 2세,2021,564,273,291,93.8,561,273,288,94.8
31280, 여주시,005004, 3세,2021,600,319,281,113.5,594,316,278,113.7
31280, 여주시,005005, 4세,2021,636,320,316,101.3,635,319,316,100.9
31280, 여주시,010,5~9세,2021,4052,2149,1903,112.9,4027,2137,1890,113.1
31280, 여주시,010001, 5세,2021,741,380,361,105.3,732,375,357,105
31280, 여주시,010002, 6세,2021,789,427,362,118,784,425,359,118.4
31280, 여주시,010003, 7세,2021,777,402,375,107.2,773,399,374,106.7
31280, 여주시,010004, 8세,2021,838,454,384,118.2,833,453,380,119.2
31280, 여주시,010005, 9세,2021,907,486,421,115.4,905,485,420,115.5
31280, 여주시,015,10~14세,2021,4566,2372,2194,108.1,4552,2365,2187,108.1
31280, 여주시,015001, 10세,2021,952,476,476,100,947,471,476,98.9
31280, 여주시,015002, 11세,2021,888,443,445,99.6,885,443,442,100.2
31280, 여주시,015003, 12세,2021,891,485,406,119.5,889,484,405,119.5
31280, 여주시,015004, 13세,2021,863,475,388,122.4,861,474,387,122.5
31280, 여주시,015005, 14세,2021,972,493,479,102.9,970,493,477,103.4
31280, 여주시,020,15~19세,2021,4819,2508,2311,108.5,4799,2500,2299,108.7
31280, 여주시,020001, 15세,2021,864,434,430,100.9,859,433,426,101.6
31280, 여주시,020002, 16세,2021,896,459,437,105,891,457,434,105.3
31280, 여주시,020003, 17세,2021,1005,529,476,111.1,1004,528,476,110.9
31280, 여주시,020004, 18세,2021,990,497,493,100.8,987,497,490,101.4
31280, 여주시,020005, 19세,2021,1064,589,475,124,1058,585,473,123.7
31280, 여주시,025,20~24세,2021,6513,3539,2974,119,6057,3260,2797,116.6
31280, 여주시,025001, 20세,2021,1265,697,568,122.7,1247,684,563,121.5
31280, 여주시,025002, 21세,2021,1362,723,639,113.1,1321,703,618,113.8
31280, 여주시,025003, 22세,2021,1256,694,562,123.5,1189,652,537,121.4
31280, 여주시,025004, 23세,2021,1334,714,620,115.2,1173,618,555,111.4
31280, 여주시,025005, 24세,2021,1296,711,585,121.5,1127,603,524,115.1
31280, 여주시,030,25~29세,2021,6784,3891,2893,134.5,5718,3213,2505,128.3
31280, 여주시,030001, 25세,2021,1286,709,577,122.9,1090,586,504,116.3
31280, 여주시,030002, 26세,2021,1413,831,582,142.8,1204,694,510,136.1
31280, 여주시,030003, 27세,2021,1356,798,558,143,1139,657,482,136.3
31280, 여주시,030004, 28세,2021,1337,761,576,132.1,1117,625,492,127
31280, 여주시,030005, 29세,2021,1392,792,600,132,1168,651,517,125.9
31280, 여주시,035,30~34세,2021,5928,3380,2548,132.7,4957,2758,2199,125.4
31280, 여주시,035001, 30세,2021,1326,775,551,140.7,1111,632,479,131.9
31280, 여주시,035002, 31세,2021,1174,669,505,132.5,969,539,430,125.3
31280, 여주시,035003, 32세,2021,1169,683,486,140.5,965,549,416,132
31280, 여주시,035004, 33세,2021,1172,642,530,121.1,985,531,454,117
31280, 여주시,035005, 34세,2021,1087,611,476,128.4,927,507,420,120.7
31280, 여주시,040,35~39세,2021,6439,3404,3035,112.2,5713,2928,2785,105.1
31280, 여주시,040001, 35세,2021,1169,644,525,122.7,1001,531,470,113
31280, 여주시,040002, 36세,2021,1188,647,541,119.6,1010,534,476,112.2
31280, 여주시,040003, 37세,2021,1249,688,561,122.6,1091,575,516,111.4
31280, 여주시,040004, 38세,2021,1297,644,653,98.6,1175,571,604,94.5
31280, 여주시,040005, 39세,2021,1536,781,755,103.4,1436,717,719,99.7
31280, 여주시,045,40~44세,2021,7545,3919,3626,108.1,7127,3702,3425,108.1
31280, 여주시,045001, 40세,2021,1550,810,740,109.5,1457,762,695,109.6
31280, 여주시,045002, 41세,2021,1609,855,754,113.4,1509,794,715,111
31280, 여주시,045003, 42세,2021,1522,780,742,105.1,1439,739,700,105.6
31280, 여주시,045004, 43세,2021,1394,714,680,105,1332,685,647,105.9
31280, 여주시,045005, 44세,2021,1470,760,710,107,1390,722,668,108.1
31280, 여주시,050,45~49세,2021,8224,4269,3955,107.9,7903,4096,3807,107.6
31280, 여주시,050001, 45세,2021,1462,734,728,100.8,1398,696,702,99.1
31280, 여주시,050002, 46세,2021,1557,797,760,104.9,1498,765,733,104.4
31280, 여주시,050003, 47세,2021,1722,898,824,109,1646,860,786,109.4
31280, 여주시,050004, 48세,2021,1816,931,885,105.2,1739,887,852,104.1
31280, 여주시,050005, 49세,2021,1667,909,758,119.9,1622,888,734,121
31280, 여주시,055,50~54세,2021,9619,4983,4636,107.5,9337,4842,4495,107.7
31280, 여주시,055001, 50세,2021,1905,1005,900,111.7,1835,971,864,112.4
31280, 여주시,055002, 51세,2021,1841,979,862,113.6,1783,946,837,113
31280, 여주시,055003, 52세,2021,2007,1023,984,104,1956,997,959,104
31280, 여주시,055004, 53세,2021,1958,1006,952,105.7,1911,986,925,106.6
31280, 여주시,055005, 54세,2021,1908,970,938,103.4,1852,942,910,103.5
31280, 여주시,060,55~59세,2021,10011,5242,4769,109.9,9786,5124,4662,109.9
31280, 여주시,060001, 55세,2021,1914,1036,878,118,1873,1016,857,118.6
31280, 여주시,060002, 56세,2021,2057,1076,981,109.7,2000,1048,952,110.1
31280, 여주시,060003, 57세,2021,1936,993,943,105.3,1901,974,927,105.1
31280, 여주시,060004, 58세,2021,1987,1032,955,108.1,1938,1005,933,107.7
31280, 여주시,060005, 59세,2021,2117,1105,1012,109.2,2074,1081,993,108.9
31280, 여주시,065,60~64세,2021,10780,5467,5313,102.9,10630,5394,5236,103
31280, 여주시,065001, 60세,2021,2381,1208,1173,103,2350,1193,1157,103.1
31280, 여주시,065002, 61세,2021,2297,1167,1130,103.3,2264,1151,1113,103.4
31280, 여주시,065003, 62세,2021,2091,1075,1016,105.8,2061,1062,999,106.3
31280, 여주시,065004, 63세,2021,2046,1039,1007,103.2,2020,1026,994,103.2
31280, 여주시,065005, 64세,2021,1965,978,987,99.1,1935,962,973,98.9
31280, 여주시,070,65~69세,2021,8611,4370,4241,103,8532,4325,4207,102.8
31280, 여주시,070001, 65세,2021,1890,977,913,107,1869,965,904,106.7
31280, 여주시,070002, 66세,2021,1933,979,954,102.6,1909,963,946,101.8
31280, 여주시,070003, 67세,2021,1590,776,814,95.3,1570,766,804,95.3
31280, 여주시,070004, 68세,2021,1433,730,703,103.8,1424,724,700,103.4
31280, 여주시,070005, 69세,2021,1765,908,857,106,1760,907,853,106.3
31280, 여주시,075,70~74세,2021,5343,2693,2650,101.6,5300,2677,2623,102.1
31280, 여주시,075001, 70세,2021,1060,554,506,109.5,1049,551,498,110.6
31280, 여주시,075002, 71세,2021,995,481,514,93.6,989,479,510,93.9
31280, 여주시,075003, 72세,2021,1074,537,537,100,1066,534,532,100.4
31280, 여주시,075004, 73세,2021,1085,558,527,105.9,1076,554,522,106.1
31280, 여주시,075005, 74세,2021,1129,563,566,99.5,1120,559,561,99.6
31280, 여주시,080,75~79세,2021,4580,2032,2548,79.7,4560,2026,2534,80
31280, 여주시,080001, 75세,2021,876,421,455,92.5,870,420,450,93.3
31280, 여주시,080002, 76세,2021,908,403,505,79.8,906,402,504,79.8
31280, 여주시,080003, 77세,2021,882,376,506,74.3,876,373,503,74.2
31280, 여주시,080004, 78세,2021,857,379,478,79.3,852,378,474,79.7
31280, 여주시,080005, 79세,2021,1057,453,604,75,1056,453,603,75.1
31280, 여주시,085,80~84세,2021,3746,1488,2258,65.9,3738,1487,2251,66.1
31280, 여주시,085001, 80세,2021,955,411,544,75.6,954,410,544,75.4
31280, 여주시,085002, 81세,2021,749,279,470,59.4,744,279,465,60
31280, 여주시,085003, 82세,2021,758,297,461,64.4,758,297,461,64.4
31280, 여주시,085004, 83세,2021,672,270,402,67.2,670,270,400,67.5
31280, 여주시,085005, 84세,2021,612,231,381,60.6,612,231,381,60.6
31280, 여주시,090,85~89세,2021,1971,613,1358,45.1,1969,613,1356,45.2
31280, 여주시,090001, 85세,2021,540,180,360,50,540,180,360,50
31280, 여주시,090002, 86세,2021,467,146,321,45.5,467,146,321,45.5
31280, 여주시,090003, 87세,2021,400,138,262,52.7,399,138,261,52.9
31280, 여주시,090004, 88세,2021,316,77,239,32.2,316,77,239,32.2
31280, 여주시,090005, 89세,2021,248,72,176,40.9,247,72,175,41.1
31280, 여주시,095,90~94세,2021,763,185,578,32,763,185,578,32
31280, 여주시,095001, 90세,2021,237,64,173,37,237,64,173,37
31280, 여주시,095002, 91세,2021,198,47,151,31.1,198,47,151,31.1
31280, 여주시,095003, 92세,2021,138,29,109,26.6,138,29,109,26.6
31280, 여주시,095004, 93세,2021,123,30,93,32.3,123,30,93,32.3
31280, 여주시,095005, 94세,2021,67,15,52,28.8,67,15,52,28.8
31280, 여주시,100,95~99세,2021,181,33,148,22.3,181,33,148,22.3
31280, 여주시,100001, 95세,2021,68,13,55,23.6,68,13,55,23.6
31280, 여주시,100002, 96세,2021,40,6,34,17.6,40,6,34,17.6
31280, 여주시,100003, 97세,2021,28,X,24,16.7,28,X,24,16.7
31280, 여주시,100004, 98세,2021,26,6,20,30,26,6,20,30
31280, 여주시,100005, 99세,2021,19,X,15,26.7,19,X,15,26.7
31280, 여주시,101,100세이상,2021,27,X,23,17.4,27,X,23,17.4
31280, 여주시,102,15세미만,2021,11386,5904,5482,107.7,11325,5877,5448,107.9
31280, 여주시,103,15~64세,2021,76662,40602,36060,112.6,72027,37817,34210,110.5
31280, 여주시,104,65세이상,2021,25222,11418,13804,82.7,25070,11350,13720,82.7
31280, 여주시,086,85세이상,2021,2942,835,2107,39.6,2940,835,2105,39.7
31280, 여주시,126,평균연령,2021,46.9,45.5,48.3,,47.3,46,48.6,
31280, 여주시,127,중위연령,2021,49.4,48,50.9,,50.3,49.1,51.7,
31350, 연천군,000,합계,2021,41642,21947,19695,111.4,40483,21164,19319,109.6
31350, 연천군,005,0~4세,2021,1130,578,552,104.7,1125,578,547,105.7
31350, 연천군,005001, 0세,2021,208,97,111,87.4,206,97,109,89
31350, 연천군,005002, 1세,2021,232,108,124,87.1,231,108,123,87.8
31350, 연천군,005003, 2세,2021,226,113,113,100,226,113,113,100
31350, 연천군,005004, 3세,2021,242,129,113,114.2,240,129,111,116.2
31350, 연천군,005005, 4세,2021,222,131,91,144,222,131,91,144
31350, 연천군,010,5~9세,2021,1396,699,697,100.3,1393,698,695,100.4
31350, 연천군,010001, 5세,2021,275,138,137,100.7,274,138,136,101.5
31350, 연천군,010002, 6세,2021,273,138,135,102.2,271,137,134,102.2
31350, 연천군,010003, 7세,2021,269,125,144,86.8,269,125,144,86.8
31350, 연천군,010004, 8세,2021,306,160,146,109.6,306,160,146,109.6
31350, 연천군,010005, 9세,2021,273,138,135,102.2,273,138,135,102.2
31350, 연천군,015,10~14세,2021,1435,731,704,103.8,1431,729,702,103.8
31350, 연천군,015001, 10세,2021,294,149,145,102.8,292,148,144,102.8
31350, 연천군,015002, 11세,2021,303,151,152,99.3,303,151,152,99.3
31350, 연천군,015003, 12세,2021,269,132,137,96.4,269,132,137,96.4
31350, 연천군,015004, 13세,2021,285,154,131,117.6,285,154,131,117.6
31350, 연천군,015005, 14세,2021,284,145,139,104.3,282,144,138,104.3
31350, 연천군,020,15~19세,2021,1399,767,632,121.4,1392,762,630,121
31350, 연천군,020001, 15세,2021,284,164,120,136.7,282,163,119,137
31350, 연천군,020002, 16세,2021,300,155,145,106.9,300,155,145,106.9
31350, 연천군,020003, 17세,2021,297,157,140,112.1,295,155,140,110.7
31350, 연천군,020004, 18세,2021,277,152,125,121.6,275,151,124,121.8
31350, 연천군,020005, 19세,2021,241,139,102,136.3,240,138,102,135.3
31350, 연천군,025,20~24세,2021,2149,1395,754,185,2061,1328,733,181.2
31350, 연천군,025001, 20세,2021,360,215,145,148.3,353,211,142,148.6
31350, 연천군,025002, 21세,2021,367,231,136,169.9,354,222,132,168.2
31350, 연천군,025003, 22세,2021,403,252,151,166.9,392,244,148,164.9
31350, 연천군,025004, 23세,2021,432,287,145,197.9,404,265,139,190.6
31350, 연천군,025005, 24세,2021,587,410,177,231.6,558,386,172,224.4
31350, 연천군,030,25~29세,2021,2875,1901,974,195.2,2633,1711,922,185.6
31350, 연천군,030001, 25세,2021,559,369,190,194.2,515,337,178,189.3
31350, 연천군,030002, 26세,2021,608,416,192,216.7,539,358,181,197.8
31350, 연천군,030003, 27세,2021,554,370,184,201.1,514,340,174,195.4
31350, 연천군,030004, 28세,2021,568,364,204,178.4,525,334,191,174.9
31350, 연천군,030005, 29세,2021,586,382,204,187.3,540,342,198,172.7
31350, 연천군,035,30~34세,2021,2291,1399,892,156.8,2052,1225,827,148.1
31350, 연천군,035001, 30세,2021,562,345,217,159,492,293,199,147.2
31350, 연천군,035002, 31세,2021,464,305,159,191.8,419,268,151,177.5
31350, 연천군,035003, 32세,2021,446,281,165,170.3,401,251,150,167.3
31350, 연천군,035004, 33세,2021,415,252,163,154.6,378,226,152,148.7
31350, 연천군,035005, 34세,2021,404,216,188,114.9,362,187,175,106.9
31350, 연천군,040,35~39세,2021,2024,1143,881,129.7,1864,1032,832,124
31350, 연천군,040001, 35세,2021,373,222,151,147,338,194,144,134.7
31350, 연천군,040002, 36세,2021,360,201,159,126.4,326,180,146,123.3
31350, 연천군,040003, 37세,2021,386,232,154,150.6,363,216,147,146.9
31350, 연천군,040004, 38세,2021,418,225,193,116.6,391,208,183,113.7
31350, 연천군,040005, 39세,2021,487,263,224,117.4,446,234,212,110.4
31350, 연천군,045,40~44세,2021,2195,1177,1018,115.6,2079,1102,977,112.8
31350, 연천군,045001, 40세,2021,472,266,206,129.1,451,253,198,127.8
31350, 연천군,045002, 41세,2021,444,225,219,102.7,421,211,210,100.5
31350, 연천군,045003, 42세,2021,428,224,204,109.8,394,201,193,104.1
31350, 연천군,045004, 43세,2021,429,232,197,117.8,400,213,187,113.9
31350, 연천군,045005, 44세,2021,422,230,192,119.8,413,224,189,118.5
31350, 연천군,050,45~49세,2021,2498,1393,1105,126.1,2427,1351,1076,125.6
31350, 연천군,050001, 45세,2021,383,207,176,117.6,364,194,170,114.1
31350, 연천군,050002, 46세,2021,459,257,202,127.2,447,251,196,128.1
31350, 연천군,050003, 47세,2021,576,313,263,119,557,302,255,118.4
31350, 연천군,050004, 48세,2021,507,289,218,132.6,493,282,211,133.6
31350, 연천군,050005, 49세,2021,573,327,246,132.9,566,322,244,132
31350, 연천군,055,50~54세,2021,3043,1626,1417,114.7,2965,1583,1382,114.5
31350, 연천군,055001, 50세,2021,600,350,250,140,584,341,243,140.3
31350, 연천군,055002, 51세,2021,532,259,273,94.9,515,248,267,92.9
31350, 연천군,055003, 52세,2021,662,367,295,124.4,648,362,286,126.6
31350, 연천군,055004, 53세,2021,613,309,304,101.6,596,300,296,101.4
31350, 연천군,055005, 54세,2021,636,341,295,115.6,622,332,290,114.5
31350, 연천군,060,55~59세,2021,3648,1962,1686,116.4,3584,1929,1655,116.6
31350, 연천군,060001, 55세,2021,643,348,295,118,630,343,287,119.5
31350, 연천군,060002, 56세,2021,733,399,334,119.5,719,390,329,118.5
31350, 연천군,060003, 57세,2021,703,386,317,121.8,690,377,313,120.4
31350, 연천군,060004, 58세,2021,803,408,395,103.3,787,402,385,104.4
31350, 연천군,060005, 59세,2021,766,421,345,122,758,417,341,122.3
31350, 연천군,065,60~64세,2021,4245,2186,2059,106.2,4206,2167,2039,106.3
31350, 연천군,065001, 60세,2021,846,432,414,104.3,840,428,412,103.9
31350, 연천군,065002, 61세,2021,872,434,438,99.1,862,427,435,98.2
31350, 연천군,065003, 62세,2021,825,427,398,107.3,820,427,393,108.7
31350, 연천군,065004, 63세,2021,823,423,400,105.8,812,417,395,105.6
31350, 연천군,065005, 64세,2021,879,470,409,114.9,872,468,404,115.8
31350, 연천군,070,65~69세,2021,3384,1733,1651,105,3358,1720,1638,105
31350, 연천군,070001, 65세,2021,763,378,385,98.2,760,378,382,99
31350, 연천군,070002, 66세,2021,820,427,393,108.7,807,423,384,110.2
31350, 연천군,070003, 67세,2021,680,366,314,116.6,679,366,313,116.9
31350, 연천군,070004, 68세,2021,525,266,259,102.7,520,261,259,100.8
31350, 연천군,070005, 69세,2021,596,296,300,98.7,592,292,300,97.3
31350, 연천군,075,70~74세,2021,2502,1178,1324,89,2492,1172,1320,88.8
31350, 연천군,075001, 70세,2021,394,187,207,90.3,391,185,206,89.8
31350, 연천군,075002, 71세,2021,461,223,238,93.7,458,221,237,93.2
31350, 연천군,075003, 72세,2021,515,243,272,89.3,511,241,270,89.3
31350, 연천군,075004, 73세,2021,550,266,284,93.7,550,266,284,93.7
31350, 연천군,075005, 74세,2021,582,259,323,80.2,582,259,323,80.2
31350, 연천군,080,75~79세,2021,2236,954,1282,74.4,2231,952,1279,74.4
31350, 연천군,080001, 75세,2021,443,201,242,83.1,442,201,241,83.4
31350, 연천군,080002, 76세,2021,431,194,237,81.9,431,194,237,81.9
31350, 연천군,080003, 77세,2021,426,197,229,86,426,197,229,86
31350, 연천군,080004, 78세,2021,414,160,254,63,414,160,254,63
31350, 연천군,080005, 79세,2021,522,202,320,63.1,518,200,318,62.9
31350, 연천군,085,80~84세,2021,1879,693,1186,58.4,1877,693,1184,58.5
31350, 연천군,085001, 80세,2021,444,189,255,74.1,444,189,255,74.1
31350, 연천군,085002, 81세,2021,397,139,258,53.9,396,139,257,54.1
31350, 연천군,085003, 82세,2021,352,120,232,51.7,351,120,231,51.9
31350, 연천군,085004, 83세,2021,359,147,212,69.3,359,147,212,69.3
31350, 연천군,085005, 84세,2021,327,98,229,42.8,327,98,229,42.8
31350, 연천군,090,85~89세,2021,930,324,606,53.5,930,324,606,53.5
31350, 연천군,090001, 85세,2021,235,87,148,58.8,235,87,148,58.8
31350, 연천군,090002, 86세,2021,252,89,163,54.6,252,89,163,54.6
31350, 연천군,090003, 87세,2021,176,56,120,46.7,176,56,120,46.7
31350, 연천군,090004, 88세,2021,140,50,90,55.6,140,50,90,55.6
31350, 연천군,090005, 89세,2021,127,42,85,49.4,127,42,85,49.4
31350, 연천군,095,90~94세,2021,296,83,213,39,296,83,213,39
31350, 연천군,095001, 90세,2021,75,25,50,50,75,25,50,50
31350, 연천군,095002, 91세,2021,76,25,51,49,76,25,51,49
31350, 연천군,095003, 92세,2021,64,15,49,30.6,64,15,49,30.6
31350, 연천군,095004, 93세,2021,40,8,32,25,40,8,32,25
31350, 연천군,095005, 94세,2021,41,10,31,32.3,41,10,31,32.3
31350, 연천군,100,95~99세,2021,74,21,53,39.6,74,21,53,39.6
31350, 연천군,100001, 95세,2021,24,6,18,33.3,24,6,18,33.3
31350, 연천군,100002, 96세,2021,20,X,17,17.6,20,X,17,17.6
31350, 연천군,100003, 97세,2021,12,X,8,50,12,X,8,50
31350, 연천군,100004, 98세,2021,13,5,8,62.5,13,5,8,62.5
31350, 연천군,100005, 99세,2021,5,X,X,150,5,X,X,150
31350, 연천군,101,100세이상,2021,13,X,9,44.4,13,X,9,44.4
31350, 연천군,102,15세미만,2021,3961,2008,1953,102.8,3949,2005,1944,103.1
31350, 연천군,103,15~64세,2021,26367,14949,11418,130.9,25263,14190,11073,128.1
31350, 연천군,104,65세이상,2021,11314,4990,6324,78.9,11271,4969,6302,78.8
31350, 연천군,086,85세이상,2021,1313,432,881,49,1313,432,881,49
31350, 연천군,126,평균연령,2021,48.9,46.7,51.4,,49.2,47,51.6,
31350, 연천군,127,중위연령,2021,52.4,49.4,55.7,,53.1,50.2,56.1,
31370, 가평군,000,합계,2021,59714,30575,29139,104.9,58249,29949,28300,105.8
31370, 가평군,005,0~4세,2021,1336,668,668,100,1307,652,655,99.5
31370, 가평군,005001, 0세,2021,249,129,120,107.5,245,126,119,105.9
31370, 가평군,005002, 1세,2021,254,129,125,103.2,247,126,121,104.1
31370, 가평군,005003, 2세,2021,263,128,135,94.8,258,126,132,95.5
31370, 가평군,005004, 3세,2021,264,122,142,85.9,259,121,138,87.7
31370, 가평군,005005, 4세,2021,306,160,146,109.6,298,153,145,105.5
31370, 가평군,010,5~9세,2021,1793,916,877,104.4,1757,892,865,103.1
31370, 가평군,010001, 5세,2021,342,180,162,111.1,332,173,159,108.8
31370, 가평군,010002, 6세,2021,347,185,162,114.2,339,179,160,111.9
31370, 가평군,010003, 7세,2021,329,176,153,115,321,168,153,109.8
31370, 가평군,010004, 8세,2021,339,178,161,110.6,335,176,159,110.7
31370, 가평군,010005, 9세,2021,436,197,239,82.4,430,196,234,83.8
31370, 가평군,015,10~14세,2021,2165,1070,1095,97.7,2141,1055,1086,97.1
31370, 가평군,015001, 10세,2021,397,187,210,89,395,186,209,89
31370, 가평군,015002, 11세,2021,410,208,202,103,403,202,201,100.5
31370, 가평군,015003, 12세,2021,393,198,195,101.5,388,194,194,100
31370, 가평군,015004, 13세,2021,450,235,215,109.3,442,232,210,110.5
31370, 가평군,015005, 14세,2021,515,242,273,88.6,513,241,272,88.6
31370, 가평군,020,15~19세,2021,2476,1290,1186,108.8,2446,1274,1172,108.7
31370, 가평군,020001, 15세,2021,514,260,254,102.4,511,260,251,103.6
31370, 가평군,020002, 16세,2021,520,260,260,100,511,253,258,98.1
31370, 가평군,020003, 17세,2021,520,270,250,108,516,268,248,108.1
31370, 가평군,020004, 18세,2021,486,256,230,111.3,477,252,225,112
31370, 가평군,020005, 19세,2021,436,244,192,127.1,431,241,190,126.8
31370, 가평군,025,20~24세,2021,2666,1542,1124,137.2,2581,1503,1078,139.4
31370, 가평군,025001, 20세,2021,501,299,202,148,495,297,198,150
31370, 가평군,025002, 21세,2021,518,293,225,130.2,509,289,220,131.4
31370, 가평군,025003, 22세,2021,496,292,204,143.1,481,285,196,145.4
31370, 가평군,025004, 23세,2021,524,293,231,126.8,509,290,219,132.4
31370, 가평군,025005, 24세,2021,627,365,262,139.3,587,342,245,139.6
31370, 가평군,030,25~29세,2021,3102,1840,1262,145.8,2920,1757,1163,151.1
31370, 가평군,030001, 25세,2021,678,401,277,144.8,626,382,244,156.6
31370, 가평군,030002, 26세,2021,603,359,244,147.1,573,343,230,149.1
31370, 가평군,030003, 27세,2021,606,370,236,156.8,571,350,221,158.4
31370, 가평군,030004, 28세,2021,619,358,261,137.2,591,347,244,142.2
31370, 가평군,030005, 29세,2021,596,352,244,144.3,559,335,224,149.6
31370, 가평군,035,30~34세,2021,2628,1489,1139,130.7,2463,1420,1043,136.1
31370, 가평군,035001, 30세,2021,554,343,211,162.6,518,326,192,169.8
31370, 가평군,035002, 31세,2021,533,297,236,125.8,493,281,212,132.5
31370, 가평군,035003, 32세,2021,533,302,231,130.7,496,289,207,139.6
31370, 가평군,035004, 33세,2021,497,270,227,118.9,469,257,212,121.2
31370, 가평군,035005, 34세,2021,511,277,234,118.4,487,267,220,121.4
31370, 가평군,040,35~39세,2021,2779,1457,1322,110.2,2633,1409,1224,115.1
31370, 가평군,040001, 35세,2021,513,268,245,109.4,475,255,220,115.9
31370, 가평군,040002, 36세,2021,532,282,250,112.8,495,270,225,120
31370, 가평군,040003, 37세,2021,515,271,244,111.1,489,265,224,118.3
31370, 가평군,040004, 38세,2021,571,307,264,116.3,547,297,250,118.8
31370, 가평군,040005, 39세,2021,648,329,319,103.1,627,322,305,105.6
31370, 가평군,045,40~44세,2021,3372,1774,1598,111,3260,1731,1529,113.2
31370, 가평군,045001, 40세,2021,700,365,335,109,674,355,319,111.3
31370, 가평군,045002, 41세,2021,698,361,337,107.1,676,355,321,110.6
31370, 가평군,045003, 42세,2021,648,348,300,116,626,337,289,116.6
31370, 가평군,045004, 43세,2021,655,341,314,108.6,632,335,297,112.8
31370, 가평군,045005, 44세,2021,671,359,312,115.1,652,349,303,115.2
31370, 가평군,050,45~49세,2021,4041,2162,1879,115.1,3925,2122,1803,117.7
31370, 가평군,050001, 45세,2021,702,355,347,102.3,679,347,332,104.5
31370, 가평군,050002, 46세,2021,735,391,344,113.7,713,388,325,119.4
31370, 가평군,050003, 47세,2021,867,464,403,115.1,844,455,389,117
31370, 가평군,050004, 48세,2021,814,451,363,124.2,799,445,354,125.7
31370, 가평군,050005, 49세,2021,923,501,422,118.7,890,487,403,120.8
31370, 가평군,055,50~54세,2021,4916,2526,2390,105.7,4772,2472,2300,107.5
31370, 가평군,055001, 50세,2021,894,463,431,107.4,866,454,412,110.2
31370, 가평군,055002, 51세,2021,955,492,463,106.3,932,484,448,108
31370, 가평군,055003, 52세,2021,1054,566,488,116,1021,554,467,118.6
31370, 가평군,055004, 53세,2021,1010,514,496,103.6,975,498,477,104.4
31370, 가평군,055005, 54세,2021,1003,491,512,95.9,978,482,496,97.2
31370, 가평군,060,55~59세,2021,5749,3024,2725,111,5588,2960,2628,112.6
31370, 가평군,060001, 55세,2021,1061,557,504,110.5,1031,545,486,112.1
31370, 가평군,060002, 56세,2021,1124,597,527,113.3,1087,582,505,115.2
31370, 가평군,060003, 57세,2021,1110,589,521,113.1,1081,579,502,115.3
31370, 가평군,060004, 58세,2021,1191,636,555,114.6,1153,621,532,116.7
31370, 가평군,060005, 59세,2021,1263,645,618,104.4,1236,633,603,105
31370, 가평군,065,60~64세,2021,6765,3441,3324,103.5,6649,3383,3266,103.6
31370, 가평군,065001, 60세,2021,1402,708,694,102,1382,700,682,102.6
31370, 가평군,065002, 61세,2021,1418,674,744,90.6,1394,663,731,90.7
31370, 가평군,065003, 62세,2021,1367,706,661,106.8,1350,697,653,106.7
31370, 가평군,065004, 63세,2021,1298,673,625,107.7,1269,653,616,106
31370, 가평군,065005, 64세,2021,1280,680,600,113.3,1254,670,584,114.7
31370, 가평군,070,65~69세,2021,5541,2843,2698,105.4,5480,2816,2664,105.7
31370, 가평군,070001, 65세,2021,1229,636,593,107.3,1213,627,586,107
31370, 가평군,070002, 66세,2021,1272,647,625,103.5,1261,644,617,104.4
31370, 가평군,070003, 67세,2021,1052,522,530,98.5,1041,517,524,98.7
31370, 가평군,070004, 68세,2021,960,500,460,108.7,945,495,450,110
31370, 가평군,070005, 69세,2021,1028,538,490,109.8,1020,533,487,109.4
31370, 가평군,075,70~74세,2021,3309,1596,1713,93.2,3282,1581,1701,92.9
31370, 가평군,075001, 70세,2021,593,286,307,93.2,586,283,303,93.4
31370, 가평군,075002, 71세,2021,678,318,360,88.3,672,315,357,88.2
31370, 가평군,075003, 72세,2021,666,322,344,93.6,659,318,341,93.3
31370, 가평군,075004, 73세,2021,679,336,343,98,676,333,343,97.1
31370, 가평군,075005, 74세,2021,693,334,359,93,689,332,357,93
31370, 가평군,080,75~79세,2021,3030,1411,1619,87.2,3015,1404,1611,87.2
31370, 가평군,080001, 75세,2021,588,292,296,98.6,584,291,293,99.3
31370, 가평군,080002, 76세,2021,663,308,355,86.8,661,307,354,86.7
31370, 가평군,080003, 77세,2021,561,274,287,95.5,558,272,286,95.1
31370, 가평군,080004, 78세,2021,563,245,318,77,559,244,315,77.5
31370, 가평군,080005, 79세,2021,655,292,363,80.4,653,290,363,79.9
31370, 가평군,085,80~84세,2021,2297,951,1346,70.7,2287,947,1340,70.7
31370, 가평군,085001, 80세,2021,513,208,305,68.2,513,208,305,68.2
31370, 가평군,085002, 81세,2021,489,205,284,72.2,487,205,282,72.7
31370, 가평군,085003, 82세,2021,513,212,301,70.4,512,211,301,70.1
31370, 가평군,085004, 83세,2021,410,157,253,62.1,406,156,250,62.4
31370, 가평군,085005, 84세,2021,372,169,203,83.3,369,167,202,82.7
31370, 가평군,090,85~89세,2021,1253,443,810,54.7,1248,440,808,54.5
31370, 가평군,090001, 85세,2021,354,139,215,64.7,354,139,215,64.7
31370, 가평군,090002, 86세,2021,305,108,197,54.8,302,106,196,54.1
31370, 가평군,090003, 87세,2021,220,76,144,52.8,218,75,143,52.4
31370, 가평군,090004, 88세,2021,194,61,133,45.9,194,61,133,45.9
31370, 가평군,090005, 89세,2021,180,59,121,48.8,180,59,121,48.8
31370, 가평군,095,90~94세,2021,371,103,268,38.4,370,102,268,38.1
31370, 가평군,095001, 90세,2021,102,31,71,43.7,102,31,71,43.7
31370, 가평군,095002, 91세,2021,96,29,67,43.3,95,28,67,41.8
31370, 가평군,095003, 92세,2021,76,19,57,33.3,76,19,57,33.3
31370, 가평군,095004, 93세,2021,60,13,47,27.7,60,13,47,27.7
31370, 가평군,095005, 94세,2021,37,11,26,42.3,37,11,26,42.3
31370, 가평군,100,95~99세,2021,104,22,82,26.8,104,22,82,26.8
31370, 가평군,100001, 95세,2021,35,10,25,40,35,10,25,40
31370, 가평군,100002, 96세,2021,31,6,25,24,31,6,25,24
31370, 가평군,100003, 97세,2021,17,X,15,13.3,17,X,15,13.3
31370, 가평군,100004, 98세,2021,12,X,10,20,12,X,10,20
31370, 가평군,100005, 99세,2021,9,X,7,28.6,9,X,7,28.6
31370, 가평군,101,100세이상,2021,21,7,14,50,21,7,14,50
31370, 가평군,102,15세미만,2021,5294,2654,2640,100.5,5205,2599,2606,99.7
31370, 가평군,103,15~64세,2021,38494,20545,17949,114.5,37237,20031,17206,116.4
31370, 가평군,104,65세이상,2021,15926,7376,8550,86.3,15807,7319,8488,86.2
31370, 가평군,086,85세이상,2021,1749,575,1174,49,1743,571,1172,48.7
31370, 가평군,126,평균연령,2021,49.6,48.4,50.9,,49.8,48.5,51.2,
31370, 가평군,127,중위연령,2021,53.6,52.2,55.1,,53.9,52.4,55.5,
31380, 양평군,000,합계,2021,115616,57713,57903,99.7,113399,56759,56640,100.2
31380, 양평군,005,0~4세,2021,2725,1398,1327,105.4,2711,1389,1322,105.1
31380, 양평군,005001, 0세,2021,492,238,254,93.7,492,238,254,93.7
31380, 양평군,005002, 1세,2021,484,258,226,114.2,480,257,223,115.2
31380, 양평군,005003, 2세,2021,516,261,255,102.4,512,259,253,102.4
31380, 양평군,005004, 3세,2021,559,293,266,110.2,556,290,266,109
31380, 양평군,005005, 4세,2021,674,348,326,106.7,671,345,326,105.8
31380, 양평군,010,5~9세,2021,4113,2094,2019,103.7,4104,2090,2014,103.8
31380, 양평군,010001, 5세,2021,759,378,381,99.2,758,378,380,99.5
31380, 양평군,010002, 6세,2021,771,389,382,101.8,768,387,381,101.6
31380, 양평군,010003, 7세,2021,829,445,384,115.9,825,443,382,116
31380, 양평군,010004, 8세,2021,797,391,406,96.3,797,391,406,96.3
31380, 양평군,010005, 9세,2021,957,491,466,105.4,956,491,465,105.6
31380, 양평군,015,10~14세,2021,4700,2407,2293,105,4694,2403,2291,104.9
31380, 양평군,015001, 10세,2021,945,493,452,109.1,944,492,452,108.8
31380, 양평군,015002, 11세,2021,924,479,445,107.6,921,477,444,107.4
31380, 양평군,015003, 12세,2021,911,472,439,107.5,910,471,439,107.3
31380, 양평군,015004, 13세,2021,930,474,456,103.9,929,474,455,104.2
31380, 양평군,015005, 14세,2021,990,489,501,97.6,990,489,501,97.6
31380, 양평군,020,15~19세,2021,4773,2555,2218,115.2,4757,2550,2207,115.5
31380, 양평군,020001, 15세,2021,940,510,430,118.6,940,510,430,118.6
31380, 양평군,020002, 16세,2021,842,458,384,119.3,839,457,382,119.6
31380, 양평군,020003, 17세,2021,1085,545,540,100.9,1083,545,538,101.3
31380, 양평군,020004, 18세,2021,984,513,471,108.9,978,511,467,109.4
31380, 양평군,020005, 19세,2021,922,529,393,134.6,917,527,390,135.1
31380, 양평군,025,20~24세,2021,4708,2675,2033,131.6,4553,2608,1945,134.1
31380, 양평군,025001, 20세,2021,898,540,358,150.8,896,540,356,151.7
31380, 양평군,025002, 21세,2021,904,531,373,142.4,889,526,363,144.9
31380, 양평군,025003, 22세,2021,940,533,407,131,910,520,390,133.3
31380, 양평군,025004, 23세,2021,947,510,437,116.7,903,484,419,115.5
31380, 양평군,025005, 24세,2021,1019,561,458,122.5,955,538,417,129
31380, 양평군,030,25~29세,2021,5355,2958,2397,123.4,4962,2775,2187,126.9
31380, 양평군,030001, 25세,2021,1043,580,463,125.3,962,545,417,130.7
31380, 양평군,030002, 26세,2021,1059,604,455,132.7,986,563,423,133.1
31380, 양평군,030003, 27세,2021,1066,571,495,115.4,991,536,455,117.8
31380, 양평군,030004, 28세,2021,1038,578,460,125.7,957,541,416,130
31380, 양평군,030005, 29세,2021,1149,625,524,119.3,1066,590,476,123.9
31380, 양평군,035,30~34세,2021,4634,2415,2219,108.8,4268,2255,2013,112
31380, 양평군,035001, 30세,2021,1006,534,472,113.1,920,500,420,119
31380, 양평군,035002, 31세,2021,939,505,434,116.4,851,466,385,121
31380, 양평군,035003, 32세,2021,884,466,418,111.5,822,432,390,110.8
31380, 양평군,035004, 33세,2021,905,463,442,104.8,839,433,406,106.7
31380, 양평군,035005, 34세,2021,900,447,453,98.7,836,424,412,102.9
31380, 양평군,040,35~39세,2021,5749,2852,2897,98.4,5464,2724,2740,99.4
31380, 양평군,040001, 35세,2021,967,493,474,104,909,465,444,104.7
31380, 양평군,040002, 36세,2021,1030,503,527,95.4,969,473,496,95.4
31380, 양평군,040003, 37세,2021,1112,542,570,95.1,1057,521,536,97.2
31380, 양평군,040004, 38세,2021,1201,606,595,101.8,1148,583,565,103.2
31380, 양평군,040005, 39세,2021,1439,708,731,96.9,1381,682,699,97.6
31380, 양평군,045,40~44세,2021,7049,3462,3587,96.5,6836,3378,3458,97.7
31380, 양평군,045001, 40세,2021,1365,681,684,99.6,1314,661,653,101.2
31380, 양평군,045002, 41세,2021,1539,737,802,91.9,1490,719,771,93.3
31380, 양평군,045003, 42세,2021,1402,690,712,96.9,1364,676,688,98.3
31380, 양평군,045004, 43세,2021,1344,668,676,98.8,1306,652,654,99.7
31380, 양평군,045005, 44세,2021,1399,686,713,96.2,1362,670,692,96.8
31380, 양평군,050,45~49세,2021,8299,4308,3991,107.9,8145,4248,3897,109
31380, 양평군,050001, 45세,2021,1470,745,725,102.8,1438,731,707,103.4
31380, 양평군,050002, 46세,2021,1560,810,750,108,1529,799,730,109.5
31380, 양평군,050003, 47세,2021,1655,866,789,109.8,1634,859,775,110.8
31380, 양평군,050004, 48세,2021,1793,915,878,104.2,1756,898,858,104.7
31380, 양평군,050005, 49세,2021,1821,972,849,114.5,1788,961,827,116.2
31380, 양평군,055,50~54세,2021,9267,4709,4558,103.3,9112,4655,4457,104.4
31380, 양평군,055001, 50세,2021,1862,943,919,102.6,1833,932,901,103.4
31380, 양평군,055002, 51세,2021,1833,923,910,101.4,1791,915,876,104.5
31380, 양평군,055003, 52세,2021,1871,974,897,108.6,1841,965,876,110.2
31380, 양평군,055004, 53세,2021,1876,967,909,106.4,1846,955,891,107.2
31380, 양평군,055005, 54세,2021,1825,902,923,97.7,1801,888,913,97.3
31380, 양평군,060,55~59세,2021,10578,5294,5284,100.2,10415,5238,5177,101.2
31380, 양평군,060001, 55세,2021,1979,993,986,100.7,1944,976,968,100.8
31380, 양평군,060002, 56세,2021,2078,1040,1038,100.2,2046,1030,1016,101.4
31380, 양평군,060003, 57세,2021,1983,997,986,101.1,1954,988,966,102.3
31380, 양평군,060004, 58세,2021,2213,1114,1099,101.4,2178,1105,1073,103
31380, 양평군,060005, 59세,2021,2325,1150,1175,97.9,2293,1139,1154,98.7
31380, 양평군,065,60~64세,2021,12802,6378,6424,99.3,12671,6320,6351,99.5
31380, 양평군,065001, 60세,2021,2747,1374,1373,100.1,2722,1364,1358,100.4
31380, 양평군,065002, 61세,2021,2639,1284,1355,94.8,2615,1274,1341,95
31380, 양평군,065003, 62세,2021,2550,1264,1286,98.3,2527,1255,1272,98.7
31380, 양평군,065004, 63세,2021,2538,1283,1255,102.2,2508,1268,1240,102.3
31380, 양평군,065005, 64세,2021,2328,1173,1155,101.6,2299,1159,1140,101.7
31380, 양평군,070,65~69세,2021,10636,5233,5403,96.9,10545,5183,5362,96.7
31380, 양평군,070001, 65세,2021,2241,1114,1127,98.8,2218,1100,1118,98.4
31380, 양평군,070002, 66세,2021,2416,1173,1243,94.4,2398,1163,1235,94.2
31380, 양평군,070003, 67세,2021,2034,997,1037,96.1,2021,990,1031,96
31380, 양평군,070004, 68세,2021,1804,867,937,92.5,1790,861,929,92.7
31380, 양평군,070005, 69세,2021,2141,1082,1059,102.2,2118,1069,1049,101.9
31380, 양평군,075,70~74세,2021,6846,3437,3409,100.8,6806,3419,3387,100.9
31380, 양평군,075001, 70세,2021,1246,612,634,96.5,1239,608,631,96.4
31380, 양평군,075002, 71세,2021,1354,677,677,100,1349,676,673,100.4
31380, 양평군,075003, 72세,2021,1413,695,718,96.8,1407,694,713,97.3
31380, 양평군,075004, 73세,2021,1376,729,647,112.7,1359,721,638,113
31380, 양평군,075005, 74세,2021,1457,724,733,98.8,1452,720,732,98.4
31380, 양평군,080,75~79세,2021,5775,2770,3005,92.2,5763,2762,3001,92
31380, 양평군,080001, 75세,2021,1145,601,544,110.5,1142,598,544,109.9
31380, 양평군,080002, 76세,2021,1146,556,590,94.2,1145,556,589,94.4
31380, 양평군,080003, 77세,2021,1150,565,585,96.6,1147,562,585,96.1
31380, 양평군,080004, 78세,2021,1090,469,621,75.5,1088,468,620,75.5
31380, 양평군,080005, 79세,2021,1244,579,665,87.1,1241,578,663,87.2
31380, 양평군,085,80~84세,2021,4158,1747,2411,72.5,4148,1743,2405,72.5
31380, 양평군,085001, 80세,2021,989,438,551,79.5,985,437,548,79.7
31380, 양평군,085002, 81세,2021,843,386,457,84.5,839,384,455,84.4
31380, 양평군,085003, 82세,2021,863,353,510,69.2,861,352,509,69.2
31380, 양평군,085004, 83세,2021,765,314,451,69.6,765,314,451,69.6
31380, 양평군,085005, 84세,2021,698,256,442,57.9,698,256,442,57.9
31380, 양평군,090,85~89세,2021,2408,784,1624,48.3,2406,784,1622,48.3
31380, 양평군,090001, 85세,2021,660,258,402,64.2,660,258,402,64.2
31380, 양평군,090002, 86세,2021,565,176,389,45.2,564,176,388,45.4
31380, 양평군,090003, 87세,2021,504,158,346,45.7,504,158,346,45.7
31380, 양평군,090004, 88세,2021,382,116,266,43.6,382,116,266,43.6
31380, 양평군,090005, 89세,2021,297,76,221,34.4,296,76,220,34.5
31380, 양평군,095,90~94세,2021,835,200,635,31.5,833,198,635,31.2
31380, 양평군,095001, 90세,2021,222,58,164,35.4,222,58,164,35.4
31380, 양평군,095002, 91세,2021,217,53,164,32.3,216,52,164,31.7
31380, 양평군,095003, 92세,2021,171,40,131,30.5,170,39,131,29.8
31380, 양평군,095004, 93세,2021,137,27,110,24.5,137,27,110,24.5
31380, 양평군,095005, 94세,2021,88,22,66,33.3,88,22,66,33.3
31380, 양평군,100,95~99세,2021,171,31,140,22.1,171,31,140,22.1
31380, 양평군,100001, 95세,2021,63,11,52,21.2,63,11,52,21.2
31380, 양평군,100002, 96세,2021,44,10,34,29.4,44,10,34,29.4
31380, 양평군,100003, 97세,2021,28,5,23,21.7,28,5,23,21.7
31380, 양평군,100004, 98세,2021,22,X,20,10,22,X,20,10
31380, 양평군,100005, 99세,2021,14,X,11,27.3,14,X,11,27.3
31380, 양평군,101,100세이상,2021,35,6,29,20.7,35,6,29,20.7
31380, 양평군,102,15세미만,2021,11538,5899,5639,104.6,11509,5882,5627,104.5
31380, 양평군,103,15~64세,2021,73214,37606,35608,105.6,71183,36751,34432,106.7
31380, 양평군,104,65세이상,2021,30864,14208,16656,85.3,30707,14126,16581,85.2
31380, 양평군,086,85세이상,2021,3449,1021,2428,42.1,3445,1019,2426,42
31380, 양평군,126,평균연령,2021,49.3,48.1,50.5,,49.5,48.2,50.8,
31380, 양평군,127,중위연령,2021,53.1,51.9,54.4,,53.4,52.1,54.8,
32,강원도,000,합계,2021,1521890,767067,754823,101.6,1497308,754354,742954,101.5
32,강원도,005,0~4세,2021,42754,21836,20918,104.4,42558,21732,20826,104.4
32,강원도,005001, 0세,2021,7536,3853,3683,104.6,7508,3839,3669,104.6
32,강원도,005002, 1세,2021,8156,4148,4008,103.5,8119,4127,3992,103.4
32,강원도,005003, 2세,2021,8611,4374,4237,103.2,8567,4355,4212,103.4
32,강원도,005004, 3세,2021,8871,4523,4348,104,8826,4500,4326,104
32,강원도,005005, 4세,2021,9580,4938,4642,106.4,9538,4911,4627,106.1
32,강원도,010,5~9세,2021,57870,29586,28284,104.6,57686,29494,28192,104.6
32,강원도,010001, 5세,2021,10775,5569,5206,107,10718,5544,5174,107.2
32,강원도,010002, 6세,2021,11261,5672,5589,101.5,11221,5651,5570,101.5
32,강원도,010003, 7세,2021,11249,5786,5463,105.9,11207,5766,5441,106
32,강원도,010004, 8세,2021,11579,5925,5654,104.8,11556,5913,5643,104.8
32,강원도,010005, 9세,2021,13006,6634,6372,104.1,12984,6620,6364,104
32,강원도,015,10~14세,2021,63908,33071,30837,107.2,63792,33010,30782,107.2
32,강원도,015001, 10세,2021,12917,6686,6231,107.3,12884,6667,6217,107.2
32,강원도,015002, 11세,2021,12577,6474,6103,106.1,12561,6468,6093,106.2
32,강원도,015003, 12세,2021,12257,6329,5928,106.8,12238,6318,5920,106.7
32,강원도,015004, 13세,2021,12799,6588,6211,106.1,12775,6574,6201,106
32,강원도,015005, 14세,2021,13358,6994,6364,109.9,13334,6983,6351,110
32,강원도,020,15~19세,2021,68221,35983,32238,111.6,67808,35747,32061,111.5
32,강원도,020001, 15세,2021,12348,6423,5925,108.4,12319,6406,5913,108.3
32,강원도,020002, 16세,2021,12754,6696,6058,110.5,12732,6681,6051,110.4
32,강원도,020003, 17세,2021,13782,7183,6599,108.8,13751,7170,6581,109
32,강원도,020004, 18세,2021,13952,7327,6625,110.6,13876,7285,6591,110.5
32,강원도,020005, 19세,2021,15385,8354,7031,118.8,15130,8205,6925,118.5
32,강원도,025,20~24세,2021,94687,53523,41164,130,91223,51620,39603,130.3
32,강원도,025001, 20세,2021,17385,9460,7925,119.4,16994,9267,7727,119.9
32,강원도,025002, 21세,2021,19171,10407,8764,118.7,18627,10143,8484,119.6
32,강원도,025003, 22세,2021,19205,10646,8559,124.4,18484,10214,8270,123.5
32,강원도,025004, 23세,2021,19384,11399,7985,142.8,18470,10872,7598,143.1
32,강원도,025005, 24세,2021,19542,11611,7931,146.4,18648,11124,7524,147.8
32,강원도,030,25~29세,2021,89340,51264,38076,134.6,84751,48619,36132,134.6
32,강원도,030001, 25세,2021,18775,11042,7733,142.8,17795,10455,7340,142.4
32,강원도,030002, 26세,2021,18015,10489,7526,139.4,17094,9951,7143,139.3
32,강원도,030003, 27세,2021,17709,10238,7471,137,16786,9707,7079,137.1
32,강원도,030004, 28세,2021,17305,9777,7528,129.9,16425,9275,7150,129.7
32,강원도,030005, 29세,2021,17536,9718,7818,124.3,16651,9231,7420,124.4
32,강원도,035,30~34세,2021,77596,41847,35749,117.1,73709,39782,33927,117.3
32,강원도,035001, 30세,2021,16470,8965,7505,119.5,15610,8529,7081,120.4
32,강원도,035002, 31세,2021,15842,8765,7077,123.9,15033,8336,6697,124.5
32,강원도,035003, 32세,2021,15248,8301,6947,119.5,14474,7865,6609,119
32,강원도,035004, 33세,2021,15027,7966,7061,112.8,14280,7590,6690,113.5
32,강원도,035005, 34세,2021,15009,7850,7159,109.7,14312,7462,6850,108.9
32,강원도,040,35~39세,2021,86696,45071,41625,108.3,83438,43308,40130,107.9
32,강원도,040001, 35세,2021,15388,8141,7247,112.3,14677,7767,6910,112.4
32,강원도,040002, 36세,2021,15894,8436,7458,113.1,15192,8050,7142,112.7
32,강원도,040003, 37세,2021,16281,8495,7786,109.1,15655,8169,7486,109.1
32,강원도,040004, 38세,2021,18607,9590,9017,106.4,17997,9251,8746,105.8
32,강원도,040005, 39세,2021,20526,10409,10117,102.9,19917,10071,9846,102.3
32,강원도,045,40~44세,2021,101110,51349,49761,103.2,98881,50189,48692,103.1
32,강원도,045001, 40세,2021,20368,10547,9821,107.4,19865,10266,9599,106.9
32,강원도,045002, 41세,2021,21137,10565,10572,99.9,20606,10289,10317,99.7
32,강원도,045003, 42세,2021,20195,10167,10028,101.4,19745,9940,9805,101.4
32,강원도,045004, 43세,2021,19441,9887,9554,103.5,19061,9690,9371,103.4
32,강원도,045005, 44세,2021,19969,10183,9786,104.1,19604,10004,9600,104.2
32,강원도,050,45~49세,2021,113419,58337,55082,105.9,111785,57564,54221,106.2
32,강원도,050001, 45세,2021,19885,10162,9723,104.5,19538,9976,9562,104.3
32,강원도,050002, 46세,2021,21299,10832,10467,103.5,20962,10675,10287,103.8
32,강원도,050003, 47세,2021,24039,12316,11723,105.1,23719,12170,11549,105.4
32,강원도,050004, 48세,2021,24314,12553,11761,106.7,23996,12394,11602,106.8
32,강원도,050005, 49세,2021,23882,12474,11408,109.3,23570,12349,11221,110.1
32,강원도,055,50~54세,2021,130156,66998,63158,106.1,128585,66342,62243,106.6
32,강원도,055001, 50세,2021,26072,13420,12652,106.1,25734,13272,12462,106.5
32,강원도,055002, 51세,2021,25667,13340,12327,108.2,25341,13196,12145,108.7
32,강원도,055003, 52세,2021,26633,13717,12916,106.2,26304,13580,12724,106.7
32,강원도,055004, 53세,2021,27048,13981,13067,107,26733,13854,12879,107.6
32,강원도,055005, 54세,2021,24736,12540,12196,102.8,24473,12440,12033,103.4
32,강원도,060,55~59세,2021,127653,65062,62591,103.9,126424,64578,61846,104.4
32,강원도,060001, 55세,2021,25223,13151,12072,108.9,24957,13041,11916,109.4
32,강원도,060002, 56세,2021,24361,12065,12296,98.1,24113,11972,12141,98.6
32,강원도,060003, 57세,2021,24167,12420,11747,105.7,23913,12324,11589,106.3
32,강원도,060004, 58세,2021,26427,13495,12932,104.4,26165,13387,12778,104.8
32,강원도,060005, 59세,2021,27475,13931,13544,102.9,27276,13854,13422,103.2
32,강원도,065,60~64세,2021,144351,71862,72489,99.1,143464,71476,71988,99.3
32,강원도,065001, 60세,2021,31252,15455,15797,97.8,31079,15383,15696,98
32,강원도,065002, 61세,2021,30758,15036,15722,95.6,30550,14943,15607,95.7
32,강원도,065003, 62세,2021,28124,13950,14174,98.4,27929,13864,14065,98.6
32,강원도,065004, 63세,2021,27089,13555,13534,100.2,26942,13501,13441,100.4
32,강원도,065005, 64세,2021,27128,13866,13262,104.6,26964,13785,13179,104.6
32,강원도,070,65~69세,2021,107667,53490,54177,98.7,107175,53264,53911,98.8
32,강원도,070001, 65세,2021,23873,11981,11892,100.7,23734,11918,11816,100.9
32,강원도,070002, 66세,2021,24304,12175,12129,100.4,24196,12130,12066,100.5
32,강원도,070003, 67세,2021,20959,10464,10495,99.7,20864,10416,10448,99.7
32,강원도,070004, 68세,2021,17492,8615,8877,97,17411,8574,8837,97
32,강원도,070005, 69세,2021,21039,10255,10784,95.1,20970,10226,10744,95.2
32,강원도,075,70~74세,2021,67455,31430,36025,87.2,67234,31342,35892,87.3
32,강원도,075001, 70세,2021,12085,5630,6455,87.2,12027,5608,6419,87.4
32,강원도,075002, 71세,2021,12930,5929,7001,84.7,12882,5910,6972,84.8
32,강원도,075003, 72세,2021,13654,6467,7187,90,13609,6447,7162,90
32,강원도,075004, 73세,2021,14371,6687,7684,87,14329,6667,7662,87
32,강원도,075005, 74세,2021,14415,6717,7698,87.3,14387,6710,7677,87.4
32,강원도,080,75~79세,2021,63132,27270,35862,76,63016,27224,35792,76.1
32,강원도,080001, 75세,2021,11880,5428,6452,84.1,11853,5414,6439,84.1
32,강원도,080002, 76세,2021,12788,5741,7047,81.5,12763,5732,7031,81.5
32,강원도,080003, 77세,2021,12473,5321,7152,74.4,12453,5310,7143,74.3
32,강원도,080004, 78세,2021,12407,5223,7184,72.7,12388,5216,7172,72.7
32,강원도,080005, 79세,2021,13584,5557,8027,69.2,13559,5552,8007,69.3
32,강원도,085,80~84세,2021,49981,19196,30785,62.4,49922,19178,30744,62.4
32,강원도,085001, 80세,2021,11785,4760,7025,67.8,11770,4757,7013,67.8
32,강원도,085002, 81세,2021,10978,4284,6694,64,10966,4280,6686,64
32,강원도,085003, 82세,2021,10224,3894,6330,61.5,10213,3891,6322,61.5
32,강원도,085004, 83세,2021,9261,3463,5798,59.7,9248,3459,5789,59.8
32,강원도,085005, 84세,2021,7733,2795,4938,56.6,7725,2791,4934,56.6
32,강원도,090,85~89세,2021,24424,7402,17022,43.5,24396,7397,16999,43.5
32,강원도,090001, 85세,2021,6746,2364,4382,53.9,6742,2363,4379,54
32,강원도,090002, 86세,2021,5902,1812,4090,44.3,5895,1811,4084,44.3
32,강원도,090003, 87세,2021,4782,1348,3434,39.3,4773,1346,3427,39.3
32,강원도,090004, 88세,2021,3882,1102,2780,39.6,3876,1101,2775,39.7
32,강원도,090005, 89세,2021,3112,776,2336,33.2,3110,776,2334,33.2
32,강원도,095,90~94세,2021,9001,1956,7045,27.8,8995,1954,7041,27.8
32,강원도,095001, 90세,2021,2460,601,1859,32.3,2460,601,1859,32.3
32,강원도,095002, 91세,2021,2255,514,1741,29.5,2251,513,1738,29.5
32,강원도,095003, 92세,2021,1853,396,1457,27.2,1852,396,1456,27.2
32,강원도,095004, 93세,2021,1352,251,1101,22.8,1351,250,1101,22.7
32,강원도,095005, 94세,2021,1081,194,887,21.9,1081,194,887,21.9
32,강원도,100,95~99세,2021,2139,469,1670,28.1,2136,469,1667,28.1
32,강원도,100001, 95세,2021,698,118,580,20.3,697,118,579,20.4
32,강원도,100002, 96세,2021,559,129,430,30,559,129,430,30
32,강원도,100003, 97세,2021,396,94,302,31.1,396,94,302,31.1
32,강원도,100004, 98세,2021,317,92,225,40.9,317,92,225,40.9
32,강원도,100005, 99세,2021,169,36,133,27.1,167,36,131,27.5
32,강원도,101,100세이상,2021,330,65,265,24.5,330,65,265,24.5
32,강원도,102,15세미만,2021,164532,84493,80039,105.6,164036,84236,79800,105.6
32,강원도,103,15~64세,2021,1033229,541296,491933,110,1010068,529225,480843,110.1
32,강원도,104,65세이상,2021,324129,141278,182851,77.3,323204,140893,182311,77.3
32,강원도,086,85세이상,2021,35894,9892,26002,38,35857,9885,25972,38.1
32,강원도,126,평균연령,2021,46.1,44.5,47.7,,46.3,44.7,47.8,
32,강원도,127,중위연령,2021,48.6,46.9,50.3,,48.9,47.2,50.6,
32004, 읍부,000,합계,2021,252103,128483,123620,103.9,247712,126135,121577,103.7
32004, 읍부,005,0~4세,2021,7231,3632,3599,100.9,7212,3620,3592,100.8
32004, 읍부,005001, 0세,2021,1261,652,609,107.1,1258,649,609,106.6
32004, 읍부,005002, 1세,2021,1399,678,721,94,1395,675,720,93.8
32004, 읍부,005003, 2세,2021,1522,760,762,99.7,1517,759,758,100.1
32004, 읍부,005004, 3세,2021,1453,724,729,99.3,1450,722,728,99.2
32004, 읍부,005005, 4세,2021,1596,818,778,105.1,1592,815,777,104.9
32004, 읍부,010,5~9세,2021,9147,4680,4467,104.8,9126,4671,4455,104.8
32004, 읍부,010001, 5세,2021,1687,873,814,107.2,1683,871,812,107.3
32004, 읍부,010002, 6세,2021,1792,918,874,105,1788,916,872,105
32004, 읍부,010003, 7세,2021,1749,906,843,107.5,1741,904,837,108
32004, 읍부,010004, 8세,2021,1826,911,915,99.6,1823,909,914,99.5
32004, 읍부,010005, 9세,2021,2093,1072,1021,105,2091,1071,1020,105
32004, 읍부,015,10~14세,2021,10135,5269,4866,108.3,10120,5262,4858,108.3
32004, 읍부,015001, 10세,2021,2011,1029,982,104.8,2011,1029,982,104.8
32004, 읍부,015002, 11세,2021,2009,1031,978,105.4,2008,1031,977,105.5
32004, 읍부,015003, 12세,2021,1955,1040,915,113.7,1950,1038,912,113.8
32004, 읍부,015004, 13세,2021,2066,1071,995,107.6,2062,1069,993,107.7
32004, 읍부,015005, 14세,2021,2094,1098,996,110.2,2089,1095,994,110.2
32004, 읍부,020,15~19세,2021,11489,5946,5543,107.3,11476,5937,5539,107.2
32004, 읍부,020001, 15세,2021,2063,1080,983,109.9,2061,1078,983,109.7
32004, 읍부,020002, 16세,2021,2189,1168,1021,114.4,2187,1166,1021,114.2
32004, 읍부,020003, 17세,2021,2464,1281,1183,108.3,2459,1278,1181,108.2
32004, 읍부,020004, 18세,2021,2395,1216,1179,103.1,2394,1216,1178,103.2
32004, 읍부,020005, 19세,2021,2378,1201,1177,102,2375,1199,1176,102
32004, 읍부,025,20~24세,2021,14227,8123,6104,133.1,13925,7963,5962,133.6
32004, 읍부,025001, 20세,2021,2672,1455,1217,119.6,2657,1448,1209,119.8
32004, 읍부,025002, 21세,2021,2920,1595,1325,120.4,2896,1589,1307,121.6
32004, 읍부,025003, 22세,2021,2991,1624,1367,118.8,2931,1589,1342,118.4
32004, 읍부,025004, 23세,2021,2788,1695,1093,155.1,2701,1643,1058,155.3
32004, 읍부,025005, 24세,2021,2856,1754,1102,159.2,2740,1694,1046,162
32004, 읍부,030,25~29세,2021,13443,8193,5250,156.1,12628,7675,4953,155
32004, 읍부,030001, 25세,2021,2619,1605,1014,158.3,2495,1531,964,158.8
32004, 읍부,030002, 26세,2021,2701,1664,1037,160.5,2562,1577,985,160.1
32004, 읍부,030003, 27세,2021,2757,1704,1053,161.8,2580,1595,985,161.9
32004, 읍부,030004, 28세,2021,2598,1576,1022,154.2,2428,1465,963,152.1
32004, 읍부,030005, 29세,2021,2768,1644,1124,146.3,2563,1507,1056,142.7
32004, 읍부,035,30~34세,2021,12262,6838,5424,126.1,11469,6373,5096,125.1
32004, 읍부,035001, 30세,2021,2696,1537,1159,132.6,2510,1433,1077,133.1
32004, 읍부,035002, 31세,2021,2468,1412,1056,133.7,2305,1322,983,134.5
32004, 읍부,035003, 32세,2021,2390,1361,1029,132.3,2228,1256,972,129.2
32004, 읍부,035004, 33세,2021,2280,1217,1063,114.5,2134,1134,1000,113.4
32004, 읍부,035005, 34세,2021,2428,1311,1117,117.4,2292,1228,1064,115.4
32004, 읍부,040,35~39세,2021,13298,7052,6246,112.9,12609,6652,5957,111.7
32004, 읍부,040001, 35세,2021,2385,1271,1114,114.1,2237,1189,1048,113.5
32004, 읍부,040002, 36세,2021,2456,1387,1069,129.7,2307,1302,1005,129.6
32004, 읍부,040003, 37세,2021,2538,1332,1206,110.4,2395,1248,1147,108.8
32004, 읍부,040004, 38세,2021,2746,1434,1312,109.3,2629,1359,1270,107
32004, 읍부,040005, 39세,2021,3173,1628,1545,105.4,3041,1554,1487,104.5
32004, 읍부,045,40~44세,2021,15877,8243,7634,108,15396,7978,7418,107.5
32004, 읍부,045001, 40세,2021,3178,1657,1521,108.9,3071,1593,1478,107.8
32004, 읍부,045002, 41세,2021,3365,1742,1623,107.3,3241,1677,1564,107.2
32004, 읍부,045003, 42세,2021,3091,1611,1480,108.9,2991,1557,1434,108.6
32004, 읍부,045004, 43세,2021,3055,1598,1457,109.7,2981,1558,1423,109.5
32004, 읍부,045005, 44세,2021,3188,1635,1553,105.3,3112,1593,1519,104.9
32004, 읍부,050,45~49세,2021,18148,9677,8471,114.2,17841,9547,8294,115.1
32004, 읍부,050001, 45세,2021,3161,1655,1506,109.9,3088,1620,1468,110.4
32004, 읍부,050002, 46세,2021,3401,1782,1619,110.1,3339,1759,1580,111.3
32004, 읍부,050003, 47세,2021,3868,2074,1794,115.6,3815,2056,1759,116.9
32004, 읍부,050004, 48세,2021,3882,2108,1774,118.8,3817,2076,1741,119.2
32004, 읍부,050005, 49세,2021,3836,2058,1778,115.7,3782,2036,1746,116.6
32004, 읍부,055,50~54세,2021,21144,11317,9827,115.2,20789,11176,9613,116.3
32004, 읍부,055001, 50세,2021,4152,2228,1924,115.8,4077,2192,1885,116.3
32004, 읍부,055002, 51세,2021,4157,2260,1897,119.1,4087,2229,1858,120
32004, 읍부,055003, 52세,2021,4356,2313,2043,113.2,4274,2285,1989,114.9
32004, 읍부,055004, 53세,2021,4502,2452,2050,119.6,4433,2426,2007,120.9
32004, 읍부,055005, 54세,2021,3977,2064,1913,107.9,3918,2044,1874,109.1
32004, 읍부,060,55~59세,2021,21662,11370,10292,110.5,21432,11279,10153,111.1
32004, 읍부,060001, 55세,2021,4255,2281,1974,115.6,4199,2261,1938,116.7
32004, 읍부,060002, 56세,2021,4049,2014,2035,99,3998,1990,2008,99.1
32004, 읍부,060003, 57세,2021,4105,2196,1909,115,4065,2185,1880,116.2
32004, 읍부,060004, 58세,2021,4576,2444,2132,114.6,4539,2427,2112,114.9
32004, 읍부,060005, 59세,2021,4677,2435,2242,108.6,4631,2416,2215,109.1
32004, 읍부,065,60~64세,2021,24638,12649,11989,105.5,24448,12572,11876,105.9
32004, 읍부,065001, 60세,2021,5286,2703,2583,104.6,5244,2687,2557,105.1
32004, 읍부,065002, 61세,2021,5299,2664,2635,101.1,5262,2647,2615,101.2
32004, 읍부,065003, 62세,2021,4777,2447,2330,105,4734,2431,2303,105.6
32004, 읍부,065004, 63세,2021,4671,2422,2249,107.7,4639,2412,2227,108.3
32004, 읍부,065005, 64세,2021,4605,2413,2192,110.1,4569,2395,2174,110.2
32004, 읍부,070,65~69세,2021,18891,9297,9594,96.9,18801,9255,9546,97
32004, 읍부,070001, 65세,2021,4207,2085,2122,98.3,4176,2070,2106,98.3
32004, 읍부,070002, 66세,2021,4278,2139,2139,100,4260,2131,2129,100.1
32004, 읍부,070003, 67세,2021,3717,1822,1895,96.1,3702,1813,1889,96
32004, 읍부,070004, 68세,2021,3024,1472,1552,94.8,3015,1468,1547,94.9
32004, 읍부,070005, 69세,2021,3665,1779,1886,94.3,3648,1773,1875,94.6
32004, 읍부,075,70~74세,2021,12519,5714,6805,84,12485,5702,6783,84.1
32004, 읍부,075001, 70세,2021,2230,1036,1194,86.8,2222,1034,1188,87
32004, 읍부,075002, 71세,2021,2370,1082,1288,84,2360,1078,1282,84.1
32004, 읍부,075003, 72세,2021,2586,1193,1393,85.6,2583,1192,1391,85.7
32004, 읍부,075004, 73세,2021,2590,1162,1428,81.4,2581,1159,1422,81.5
32004, 읍부,075005, 74세,2021,2743,1241,1502,82.6,2739,1239,1500,82.6
32004, 읍부,080,75~79세,2021,12147,5154,6993,73.7,12128,5148,6980,73.8
32004, 읍부,080001, 75세,2021,2266,1013,1253,80.8,2262,1011,1251,80.8
32004, 읍부,080002, 76세,2021,2446,1099,1347,81.6,2439,1096,1343,81.6
32004, 읍부,080003, 77세,2021,2363,1008,1355,74.4,2363,1008,1355,74.4
32004, 읍부,080004, 78세,2021,2388,970,1418,68.4,2385,969,1416,68.4
32004, 읍부,080005, 79세,2021,2684,1064,1620,65.7,2679,1064,1615,65.9
32004, 읍부,085,80~84세,2021,9456,3560,5896,60.4,9445,3557,5888,60.4
32004, 읍부,085001, 80세,2021,2260,905,1355,66.8,2258,905,1353,66.9
32004, 읍부,085002, 81세,2021,2124,809,1315,61.5,2122,808,1314,61.5
32004, 읍부,085003, 82세,2021,1962,739,1223,60.4,1959,738,1221,60.4
32004, 읍부,085004, 83세,2021,1655,601,1054,57,1652,601,1051,57.2
32004, 읍부,085005, 84세,2021,1455,506,949,53.3,1454,505,949,53.2
32004, 읍부,090,85~89세,2021,4331,1297,3034,42.7,4324,1296,3028,42.8
32004, 읍부,090001, 85세,2021,1199,418,781,53.5,1197,417,780,53.5
32004, 읍부,090002, 86세,2021,1011,292,719,40.6,1007,292,715,40.8
32004, 읍부,090003, 87세,2021,828,212,616,34.4,827,212,615,34.5
32004, 읍부,090004, 88세,2021,721,221,500,44.2,721,221,500,44.2
32004, 읍부,090005, 89세,2021,572,154,418,36.8,572,154,418,36.8
32004, 읍부,095,90~94세,2021,1594,373,1221,30.5,1594,373,1221,30.5
32004, 읍부,095001, 90세,2021,417,113,304,37.2,417,113,304,37.2
32004, 읍부,095002, 91세,2021,399,95,304,31.3,399,95,304,31.3
32004, 읍부,095003, 92세,2021,353,84,269,31.2,353,84,269,31.2
32004, 읍부,095004, 93세,2021,234,46,188,24.5,234,46,188,24.5
32004, 읍부,095005, 94세,2021,191,35,156,22.4,191,35,156,22.4
32004, 읍부,100,95~99세,2021,402,81,321,25.2,402,81,321,25.2
32004, 읍부,100001, 95세,2021,137,24,113,21.2,137,24,113,21.2
32004, 읍부,100002, 96세,2021,98,19,79,24.1,98,19,79,24.1
32004, 읍부,100003, 97세,2021,79,18,61,29.5,79,18,61,29.5
32004, 읍부,100004, 98세,2021,58,13,45,28.9,58,13,45,28.9
32004, 읍부,100005, 99세,2021,30,7,23,30.4,30,7,23,30.4
32004, 읍부,101,100세이상,2021,62,18,44,40.9,62,18,44,40.9
32004, 읍부,102,15세미만,2021,26513,13581,12932,105,26458,13553,12905,105
32004, 읍부,103,15~64세,2021,166188,89408,76780,116.4,162013,87152,74861,116.4
32004, 읍부,104,65세이상,2021,59402,25494,33908,75.2,59241,25430,33811,75.2
32004, 읍부,086,85세이상,2021,6389,1769,4620,38.3,6382,1768,4614,38.3
32004, 읍부,126,평균연령,2021,47.2,45.5,49,,47.4,45.7,49.2,
32004, 읍부,127,중위연령,2021,50.2,48.4,52.2,,50.5,48.7,52.5,
32005, 면부,000,합계,2021,351575,181716,169859,107,343971,177459,166512,106.6
32005, 면부,005,0~4세,2021,8327,4229,4098,103.2,8301,4212,4089,103
32005, 면부,005001, 0세,2021,1499,753,746,100.9,1495,750,745,100.7
32005, 면부,005002, 1세,2021,1606,823,783,105.1,1601,820,781,105
32005, 면부,005003, 2세,2021,1690,870,820,106.1,1685,866,819,105.7
32005, 면부,005004, 3세,2021,1752,868,884,98.2,1743,864,879,98.3
32005, 면부,005005, 4세,2021,1780,915,865,105.8,1777,912,865,105.4
32005, 면부,010,5~9세,2021,10783,5504,5279,104.3,10754,5489,5265,104.3
32005, 면부,010001, 5세,2021,2075,1073,1002,107.1,2065,1067,998,106.9
32005, 면부,010002, 6세,2021,2119,1062,1057,100.5,2112,1058,1054,100.4
32005, 면부,010003, 7세,2021,2103,1049,1054,99.5,2101,1048,1053,99.5
32005, 면부,010004, 8세,2021,2202,1161,1041,111.5,2195,1159,1036,111.9
32005, 면부,010005, 9세,2021,2284,1159,1125,103,2281,1157,1124,102.9
32005, 면부,015,10~14세,2021,10916,5599,5317,105.3,10895,5585,5310,105.2
32005, 면부,015001, 10세,2021,2285,1227,1058,116,2280,1223,1057,115.7
32005, 면부,015002, 11세,2021,2216,1141,1075,106.1,2213,1139,1074,106.1
32005, 면부,015003, 12세,2021,2037,1013,1024,98.9,2034,1010,1024,98.6
32005, 면부,015004, 13세,2021,2236,1133,1103,102.7,2232,1131,1101,102.7
32005, 면부,015005, 14세,2021,2142,1085,1057,102.6,2136,1082,1054,102.7
32005, 면부,020,15~19세,2021,11526,6057,5469,110.8,11316,5936,5380,110.3
32005, 면부,020001, 15세,2021,1959,1040,919,113.2,1953,1038,915,113.4
32005, 면부,020002, 16세,2021,2085,1072,1013,105.8,2081,1070,1011,105.8
32005, 면부,020003, 17세,2021,2366,1221,1145,106.6,2360,1219,1141,106.8
32005, 면부,020004, 18세,2021,2389,1241,1148,108.1,2338,1214,1124,108
32005, 면부,020005, 19세,2021,2727,1483,1244,119.2,2584,1395,1189,117.3
32005, 면부,025,20~24세,2021,17585,10938,6647,164.6,16400,10197,6203,164.4
32005, 면부,025001, 20세,2021,3024,1772,1252,141.5,2833,1651,1182,139.7
32005, 면부,025002, 21세,2021,3402,1994,1408,141.6,3188,1869,1319,141.7
32005, 면부,025003, 22세,2021,3524,2170,1354,160.3,3295,2025,1270,159.4
32005, 면부,025004, 23세,2021,3782,2480,1302,190.5,3512,2315,1197,193.4
32005, 면부,025005, 24세,2021,3853,2522,1331,189.5,3572,2337,1235,189.2
32005, 면부,030,25~29세,2021,17528,10976,6552,167.5,16150,10111,6039,167.4
32005, 면부,030001, 25세,2021,3711,2435,1276,190.8,3386,2206,1180,186.9
32005, 면부,030002, 26세,2021,3447,2221,1226,181.2,3162,2046,1116,183.3
32005, 면부,030003, 27세,2021,3568,2266,1302,174,3309,2105,1204,174.8
32005, 면부,030004, 28세,2021,3399,2062,1337,154.2,3139,1903,1236,154
32005, 면부,030005, 29세,2021,3403,1992,1411,141.2,3154,1851,1303,142.1
32005, 면부,035,30~34세,2021,15880,8972,6908,129.9,14667,8271,6396,129.3
32005, 면부,035001, 30세,2021,3256,1898,1358,139.8,2997,1746,1251,139.6
32005, 면부,035002, 31세,2021,3282,1904,1378,138.2,3036,1748,1288,135.7
32005, 면부,035003, 32세,2021,3071,1750,1321,132.5,2827,1610,1217,132.3
32005, 면부,035004, 33세,2021,3141,1725,1416,121.8,2906,1610,1296,124.2
32005, 면부,035005, 34세,2021,3130,1695,1435,118.1,2901,1557,1344,115.8
32005, 면부,040,35~39세,2021,17471,9520,7951,119.7,16396,8887,7509,118.4
32005, 면부,040001, 35세,2021,3166,1746,1420,123,2942,1609,1333,120.7
32005, 면부,040002, 36세,2021,3293,1832,1461,125.4,3053,1689,1364,123.8
32005, 면부,040003, 37세,2021,3355,1799,1556,115.6,3145,1692,1453,116.4
32005, 면부,040004, 38세,2021,3647,1987,1660,119.7,3447,1856,1591,116.7
32005, 면부,040005, 39세,2021,4010,2156,1854,116.3,3809,2041,1768,115.4
32005, 면부,045,40~44세,2021,18751,10237,8514,120.2,18029,9842,8187,120.2
32005, 면부,045001, 40세,2021,3828,2144,1684,127.3,3655,2036,1619,125.8
32005, 면부,045002, 41세,2021,3945,2096,1849,113.4,3772,2009,1763,114
32005, 면부,045003, 42세,2021,3811,2005,1806,111,3667,1928,1739,110.9
32005, 면부,045004, 43세,2021,3576,2006,1570,127.8,3466,1944,1522,127.7
32005, 면부,045005, 44세,2021,3591,1986,1605,123.7,3469,1925,1544,124.7
32005, 면부,050,45~49세,2021,20751,11560,9191,125.8,20317,11334,8983,126.2
32005, 면부,050001, 45세,2021,3604,2068,1536,134.6,3513,2009,1504,133.6
32005, 면부,050002, 46세,2021,3843,2121,1722,123.2,3765,2084,1681,124
32005, 면부,050003, 47세,2021,4410,2437,1973,123.5,4317,2392,1925,124.3
32005, 면부,050004, 48세,2021,4419,2446,1973,124,4347,2407,1940,124.1
32005, 면부,050005, 49세,2021,4475,2488,1987,125.2,4375,2442,1933,126.3
32005, 면부,055,50~54세,2021,26971,14415,12556,114.8,26551,14252,12299,115.9
32005, 면부,055001, 50세,2021,5058,2776,2282,121.6,4964,2734,2230,122.6
32005, 면부,055002, 51세,2021,4908,2614,2294,113.9,4827,2579,2248,114.7
32005, 면부,055003, 52세,2021,5536,2969,2567,115.7,5448,2933,2515,116.6
32005, 면부,055004, 53세,2021,5852,3087,2765,111.6,5758,3058,2700,113.3
32005, 면부,055005, 54세,2021,5617,2969,2648,112.1,5554,2948,2606,113.1
32005, 면부,060,55~59세,2021,32394,16768,15626,107.3,31997,16609,15388,107.9
32005, 면부,060001, 55세,2021,5925,3164,2761,114.6,5847,3129,2718,115.1
32005, 면부,060002, 56세,2021,6040,3097,2943,105.2,5959,3067,2892,106.1
32005, 면부,060003, 57세,2021,6084,3078,3006,102.4,5984,3042,2942,103.4
32005, 면부,060004, 58세,2021,6874,3543,3331,106.4,6799,3511,3288,106.8
32005, 면부,060005, 59세,2021,7471,3886,3585,108.4,7408,3860,3548,108.8
32005, 면부,065,60~64세,2021,42282,21690,20592,105.3,42025,21580,20445,105.6
32005, 면부,065001, 60세,2021,9021,4548,4473,101.7,8973,4527,4446,101.8
32005, 면부,065002, 61세,2021,8878,4460,4418,101,8827,4438,4389,101.1
32005, 면부,065003, 62세,2021,8120,4152,3968,104.6,8067,4129,3938,104.9
32005, 면부,065004, 63세,2021,8178,4221,3957,106.7,8125,4205,3920,107.3
32005, 면부,065005, 64세,2021,8085,4309,3776,114.1,8033,4281,3752,114.1
32005, 면부,070,65~69세,2021,32727,17208,15519,110.9,32593,17142,15451,110.9
32005, 면부,070001, 65세,2021,7150,3739,3411,109.6,7114,3722,3392,109.7
32005, 면부,070002, 66세,2021,7348,3869,3479,111.2,7315,3857,3458,111.5
32005, 면부,070003, 67세,2021,6394,3398,2996,113.4,6367,3382,2985,113.3
32005, 면부,070004, 68세,2021,5320,2783,2537,109.7,5293,2766,2527,109.5
32005, 면부,070005, 69세,2021,6515,3419,3096,110.4,6504,3415,3089,110.6
32005, 면부,075,70~74세,2021,19876,9804,10072,97.3,19829,9791,10038,97.5
32005, 면부,075001, 70세,2021,3583,1731,1852,93.5,3577,1730,1847,93.7
32005, 면부,075002, 71세,2021,3732,1793,1939,92.5,3721,1791,1930,92.8
32005, 면부,075003, 72세,2021,4028,2016,2012,100.2,4019,2014,2005,100.4
32005, 면부,075004, 73세,2021,4266,2119,2147,98.7,4255,2113,2142,98.6
32005, 면부,075005, 74세,2021,4267,2145,2122,101.1,4257,2143,2114,101.4
32005, 면부,080,75~79세,2021,19131,8532,10599,80.5,19101,8517,10584,80.5
32005, 면부,080001, 75세,2021,3578,1747,1831,95.4,3569,1741,1828,95.2
32005, 면부,080002, 76세,2021,3803,1761,2042,86.2,3797,1761,2036,86.5
32005, 면부,080003, 77세,2021,3742,1609,2133,75.4,3737,1605,2132,75.3
32005, 면부,080004, 78세,2021,3782,1623,2159,75.2,3777,1619,2158,75
32005, 면부,080005, 79세,2021,4226,1792,2434,73.6,4221,1791,2430,73.7
32005, 면부,085,80~84세,2021,16375,6378,9997,63.8,16359,6377,9982,63.9
32005, 면부,085001, 80세,2021,3760,1530,2230,68.6,3754,1529,2225,68.7
32005, 면부,085002, 81세,2021,3531,1455,2076,70.1,3528,1455,2073,70.2
32005, 면부,085003, 82세,2021,3373,1294,2079,62.2,3370,1294,2076,62.3
32005, 면부,085004, 83세,2021,3104,1157,1947,59.4,3101,1157,1944,59.5
32005, 면부,085005, 84세,2021,2607,942,1665,56.6,2606,942,1664,56.6
32005, 면부,090,85~89세,2021,8293,2465,5828,42.3,8289,2465,5824,42.3
32005, 면부,090001, 85세,2021,2289,821,1468,55.9,2289,821,1468,55.9
32005, 면부,090002, 86세,2021,2022,606,1416,42.8,2022,606,1416,42.8
32005, 면부,090003, 87세,2021,1644,440,1204,36.5,1642,440,1202,36.6
32005, 면부,090004, 88세,2021,1276,355,921,38.5,1275,355,920,38.6
32005, 면부,090005, 89세,2021,1062,243,819,29.7,1061,243,818,29.7
32005, 면부,095,90~94세,2021,3086,638,2448,26.1,3082,636,2446,26
32005, 면부,095001, 90세,2021,881,211,670,31.5,881,211,670,31.5
32005, 면부,095002, 91세,2021,739,154,585,26.3,737,153,584,26.2
32005, 면부,095003, 92세,2021,597,115,482,23.9,596,115,481,23.9
32005, 면부,095004, 93세,2021,482,95,387,24.5,481,94,387,24.3
32005, 면부,095005, 94세,2021,387,63,324,19.4,387,63,324,19.4
32005, 면부,100,95~99세,2021,784,202,582,34.7,782,202,580,34.8
32005, 면부,100001, 95세,2021,243,48,195,24.6,242,48,194,24.7
32005, 면부,100002, 96세,2021,211,55,156,35.3,211,55,156,35.3
32005, 면부,100003, 97세,2021,152,48,104,46.2,152,48,104,46.2
32005, 면부,100004, 98세,2021,115,37,78,47.4,115,37,78,47.4
32005, 면부,100005, 99세,2021,63,14,49,28.6,62,14,48,29.2
32005, 면부,101,100세이상,2021,138,24,114,21.1,138,24,114,21.1
32005, 면부,102,15세미만,2021,30026,15332,14694,104.3,29950,15286,14664,104.2
32005, 면부,103,15~64세,2021,221139,121133,100006,121.1,213848,117019,96829,120.9
32005, 면부,104,65세이상,2021,100410,45251,55159,82,100173,45154,55019,82.1
32005, 면부,086,85세이상,2021,12301,3329,8972,37.1,12291,3327,8964,37.1
32005, 면부,126,평균연령,2021,50.6,48.7,52.6,,50.9,49,52.9,
32005, 면부,127,중위연령,2021,54.9,52.6,57.2,,55.4,53.2,57.7,
32003, 동부,000,합계,2021,918212,456868,461344,99,905625,450760,454865,99.1
32003, 동부,005,0~4세,2021,27196,13975,13221,105.7,27045,13900,13145,105.7
32003, 동부,005001, 0세,2021,4776,2448,2328,105.2,4755,2440,2315,105.4
32003, 동부,005002, 1세,2021,5151,2647,2504,105.7,5123,2632,2491,105.7
32003, 동부,005003, 2세,2021,5399,2744,2655,103.4,5365,2730,2635,103.6
32003, 동부,005004, 3세,2021,5666,2931,2735,107.2,5633,2914,2719,107.2
32003, 동부,005005, 4세,2021,6204,3205,2999,106.9,6169,3184,2985,106.7
32003, 동부,010,5~9세,2021,37940,19402,18538,104.7,37806,19334,18472,104.7
32003, 동부,010001, 5세,2021,7013,3623,3390,106.9,6970,3606,3364,107.2
32003, 동부,010002, 6세,2021,7350,3692,3658,100.9,7321,3677,3644,100.9
32003, 동부,010003, 7세,2021,7397,3831,3566,107.4,7365,3814,3551,107.4
32003, 동부,010004, 8세,2021,7551,3853,3698,104.2,7538,3845,3693,104.1
32003, 동부,010005, 9세,2021,8629,4403,4226,104.2,8612,4392,4220,104.1
32003, 동부,015,10~14세,2021,42857,22203,20654,107.5,42777,22163,20614,107.5
32003, 동부,015001, 10세,2021,8621,4430,4191,105.7,8593,4415,4178,105.7
32003, 동부,015002, 11세,2021,8352,4302,4050,106.2,8340,4298,4042,106.3
32003, 동부,015003, 12세,2021,8265,4276,3989,107.2,8254,4270,3984,107.2
32003, 동부,015004, 13세,2021,8497,4384,4113,106.6,8481,4374,4107,106.5
32003, 동부,015005, 14세,2021,9122,4811,4311,111.6,9109,4806,4303,111.7
32003, 동부,020,15~19세,2021,45206,23980,21226,113,45016,23874,21142,112.9
32003, 동부,020001, 15세,2021,8326,4303,4023,107,8305,4290,4015,106.8
32003, 동부,020002, 16세,2021,8480,4456,4024,110.7,8464,4445,4019,110.6
32003, 동부,020003, 17세,2021,8952,4681,4271,109.6,8932,4673,4259,109.7
32003, 동부,020004, 18세,2021,9168,4870,4298,113.3,9144,4855,4289,113.2
32003, 동부,020005, 19세,2021,10280,5670,4610,123,10171,5611,4560,123
32003, 동부,025,20~24세,2021,62875,34462,28413,121.3,60898,33460,27438,121.9
32003, 동부,025001, 20세,2021,11689,6233,5456,114.2,11504,6168,5336,115.6
32003, 동부,025002, 21세,2021,12849,6818,6031,113,12543,6685,5858,114.1
32003, 동부,025003, 22세,2021,12690,6852,5838,117.4,12258,6600,5658,116.6
32003, 동부,025004, 23세,2021,12814,7224,5590,129.2,12257,6914,5343,129.4
32003, 동부,025005, 24세,2021,12833,7335,5498,133.4,12336,7093,5243,135.3
32003, 동부,030,25~29세,2021,58369,32095,26274,122.2,55973,30833,25140,122.6
32003, 동부,030001, 25세,2021,12445,7002,5443,128.6,11914,6718,5196,129.3
32003, 동부,030002, 26세,2021,11867,6604,5263,125.5,11370,6328,5042,125.5
32003, 동부,030003, 27세,2021,11384,6268,5116,122.5,10897,6007,4890,122.8
32003, 동부,030004, 28세,2021,11308,6139,5169,118.8,10858,5907,4951,119.3
32003, 동부,030005, 29세,2021,11365,6082,5283,115.1,10934,5873,5061,116
32003, 동부,035,30~34세,2021,49454,26037,23417,111.2,47573,25138,22435,112
32003, 동부,035001, 30세,2021,10518,5530,4988,110.9,10103,5350,4753,112.6
32003, 동부,035002, 31세,2021,10092,5449,4643,117.4,9692,5266,4426,119
32003, 동부,035003, 32세,2021,9787,5190,4597,112.9,9419,4999,4420,113.1
32003, 동부,035004, 33세,2021,9606,5024,4582,109.6,9240,4846,4394,110.3
32003, 동부,035005, 34세,2021,9451,4844,4607,105.1,9119,4677,4442,105.3
32003, 동부,040,35~39세,2021,55927,28499,27428,103.9,54433,27769,26664,104.1
32003, 동부,040001, 35세,2021,9837,5124,4713,108.7,9498,4969,4529,109.7
32003, 동부,040002, 36세,2021,10145,5217,4928,105.9,9832,5059,4773,106
32003, 동부,040003, 37세,2021,10388,5364,5024,106.8,10115,5229,4886,107
32003, 동부,040004, 38세,2021,12214,6169,6045,102.1,11921,6036,5885,102.6
32003, 동부,040005, 39세,2021,13343,6625,6718,98.6,13067,6476,6591,98.3
32003, 동부,045,40~44세,2021,66482,32869,33613,97.8,65456,32369,33087,97.8
32003, 동부,045001, 40세,2021,13362,6746,6616,102,13139,6637,6502,102.1
32003, 동부,045002, 41세,2021,13827,6727,7100,94.7,13593,6603,6990,94.5
32003, 동부,045003, 42세,2021,13293,6551,6742,97.2,13087,6455,6632,97.3
32003, 동부,045004, 43세,2021,12810,6283,6527,96.3,12614,6188,6426,96.3
32003, 동부,045005, 44세,2021,13190,6562,6628,99,13023,6486,6537,99.2
32003, 동부,050,45~49세,2021,74520,37100,37420,99.1,73627,36683,36944,99.3
32003, 동부,050001, 45세,2021,13120,6439,6681,96.4,12937,6347,6590,96.3
32003, 동부,050002, 46세,2021,14055,6929,7126,97.2,13858,6832,7026,97.2
32003, 동부,050003, 47세,2021,15761,7805,7956,98.1,15587,7722,7865,98.2
32003, 동부,050004, 48세,2021,16013,7999,8014,99.8,15832,7911,7921,99.9
32003, 동부,050005, 49세,2021,15571,7928,7643,103.7,15413,7871,7542,104.4
32003, 동부,055,50~54세,2021,82041,41266,40775,101.2,81245,40914,40331,101.4
32003, 동부,055001, 50세,2021,16862,8416,8446,99.6,16693,8346,8347,100
32003, 동부,055002, 51세,2021,16602,8466,8136,104.1,16427,8388,8039,104.3
32003, 동부,055003, 52세,2021,16741,8435,8306,101.6,16582,8362,8220,101.7
32003, 동부,055004, 53세,2021,16694,8442,8252,102.3,16542,8370,8172,102.4
32003, 동부,055005, 54세,2021,15142,7507,7635,98.3,15001,7448,7553,98.6
32003, 동부,060,55~59세,2021,73597,36924,36673,100.7,72995,36690,36305,101.1
32003, 동부,060001, 55세,2021,15043,7706,7337,105,14911,7651,7260,105.4
32003, 동부,060002, 56세,2021,14272,6954,7318,95,14156,6915,7241,95.5
32003, 동부,060003, 57세,2021,13978,7146,6832,104.6,13864,7097,6767,104.9
32003, 동부,060004, 58세,2021,14977,7508,7469,100.5,14827,7449,7378,101
32003, 동부,060005, 59세,2021,15327,7610,7717,98.6,15237,7578,7659,98.9
32003, 동부,065,60~64세,2021,77431,37523,39908,94,76991,37324,39667,94.1
32003, 동부,065001, 60세,2021,16945,8204,8741,93.9,16862,8169,8693,94
32003, 동부,065002, 61세,2021,16581,7912,8669,91.3,16461,7858,8603,91.3
32003, 동부,065003, 62세,2021,15227,7351,7876,93.3,15128,7304,7824,93.4
32003, 동부,065004, 63세,2021,14240,6912,7328,94.3,14178,6884,7294,94.4
32003, 동부,065005, 64세,2021,14438,7144,7294,97.9,14362,7109,7253,98
32003, 동부,070,65~69세,2021,56049,26985,29064,92.8,55781,26867,28914,92.9
32003, 동부,070001, 65세,2021,12516,6157,6359,96.8,12444,6126,6318,97
32003, 동부,070002, 66세,2021,12678,6167,6511,94.7,12621,6142,6479,94.8
32003, 동부,070003, 67세,2021,10848,5244,5604,93.6,10795,5221,5574,93.7
32003, 동부,070004, 68세,2021,9148,4360,4788,91.1,9103,4340,4763,91.1
32003, 동부,070005, 69세,2021,10859,5057,5802,87.2,10818,5038,5780,87.2
32003, 동부,075,70~74세,2021,35060,15912,19148,83.1,34920,15849,19071,83.1
32003, 동부,075001, 70세,2021,6272,2863,3409,84,6228,2844,3384,84
32003, 동부,075002, 71세,2021,6828,3054,3774,80.9,6801,3041,3760,80.9
32003, 동부,075003, 72세,2021,7040,3258,3782,86.1,7007,3241,3766,86.1
32003, 동부,075004, 73세,2021,7515,3406,4109,82.9,7493,3395,4098,82.8
32003, 동부,075005, 74세,2021,7405,3331,4074,81.8,7391,3328,4063,81.9
32003, 동부,080,75~79세,2021,31854,13584,18270,74.4,31787,13559,18228,74.4
32003, 동부,080001, 75세,2021,6036,2668,3368,79.2,6022,2662,3360,79.2
32003, 동부,080002, 76세,2021,6539,2881,3658,78.8,6527,2875,3652,78.7
32003, 동부,080003, 77세,2021,6368,2704,3664,73.8,6353,2697,3656,73.8
32003, 동부,080004, 78세,2021,6237,2630,3607,72.9,6226,2628,3598,73
32003, 동부,080005, 79세,2021,6674,2701,3973,68,6659,2697,3962,68.1
32003, 동부,085,80~84세,2021,24150,9258,14892,62.2,24118,9244,14874,62.1
32003, 동부,085001, 80세,2021,5765,2325,3440,67.6,5758,2323,3435,67.6
32003, 동부,085002, 81세,2021,5323,2020,3303,61.2,5316,2017,3299,61.1
32003, 동부,085003, 82세,2021,4889,1861,3028,61.5,4884,1859,3025,61.5
32003, 동부,085004, 83세,2021,4502,1705,2797,61,4495,1701,2794,60.9
32003, 동부,085005, 84세,2021,3671,1347,2324,58,3665,1344,2321,57.9
32003, 동부,090,85~89세,2021,11800,3640,8160,44.6,11783,3636,8147,44.6
32003, 동부,090001, 85세,2021,3258,1125,2133,52.7,3256,1125,2131,52.8
32003, 동부,090002, 86세,2021,2869,914,1955,46.8,2866,913,1953,46.7
32003, 동부,090003, 87세,2021,2310,696,1614,43.1,2304,694,1610,43.1
32003, 동부,090004, 88세,2021,1885,526,1359,38.7,1880,525,1355,38.7
32003, 동부,090005, 89세,2021,1478,379,1099,34.5,1477,379,1098,34.5
32003, 동부,095,90~94세,2021,4321,945,3376,28,4319,945,3374,28
32003, 동부,095001, 90세,2021,1162,277,885,31.3,1162,277,885,31.3
32003, 동부,095002, 91세,2021,1117,265,852,31.1,1115,265,850,31.2
32003, 동부,095003, 92세,2021,903,197,706,27.9,903,197,706,27.9
32003, 동부,095004, 93세,2021,636,110,526,20.9,636,110,526,20.9
32003, 동부,095005, 94세,2021,503,96,407,23.6,503,96,407,23.6
32003, 동부,100,95~99세,2021,953,186,767,24.3,952,186,766,24.3
32003, 동부,100001, 95세,2021,318,46,272,16.9,318,46,272,16.9
32003, 동부,100002, 96세,2021,250,55,195,28.2,250,55,195,28.2
32003, 동부,100003, 97세,2021,165,28,137,20.4,165,28,137,20.4
32003, 동부,100004, 98세,2021,144,42,102,41.2,144,42,102,41.2
32003, 동부,100005, 99세,2021,76,15,61,24.6,75,15,60,25
32003, 동부,101,100세이상,2021,130,23,107,21.5,130,23,107,21.5
32003, 동부,102,15세미만,2021,107993,55580,52413,106,107628,55397,52231,106.1
32003, 동부,103,15~64세,2021,645902,330755,315147,105,634207,325054,309153,105.1
32003, 동부,104,65세이상,2021,164317,70533,93784,75.2,163790,70309,93481,75.2
32003, 동부,086,85세이상,2021,17204,4794,12410,38.6,17184,4790,12394,38.6
32003, 동부,126,평균연령,2021,44.1,42.6,45.5,,44.2,42.7,45.7,
32003, 동부,127,중위연령,2021,46,44.2,47.5,,46.2,44.5,47.7,
32010, 춘천시,000,합계,2021,287104,141556,145548,97.3,281838,138878,142960,97.1
32010, 춘천시,005,0~4세,2021,8729,4448,4281,103.9,8644,4404,4240,103.9
32010, 춘천시,005001, 0세,2021,1520,776,744,104.3,1505,772,733,105.3
32010, 춘천시,005002, 1세,2021,1714,865,849,101.9,1697,854,843,101.3
32010, 춘천시,005003, 2세,2021,1731,877,854,102.7,1714,870,844,103.1
32010, 춘천시,005004, 3세,2021,1878,946,932,101.5,1858,935,923,101.3
32010, 춘천시,005005, 4세,2021,1886,984,902,109.1,1870,973,897,108.5
32010, 춘천시,010,5~9세,2021,12001,6194,5807,106.7,11940,6162,5778,106.6
32010, 춘천시,010001, 5세,2021,2252,1162,1090,106.6,2231,1154,1077,107.1
32010, 춘천시,010002, 6세,2021,2269,1154,1115,103.5,2255,1146,1109,103.3
32010, 춘천시,010003, 7세,2021,2410,1255,1155,108.7,2396,1247,1149,108.5
32010, 춘천시,010004, 8세,2021,2445,1254,1191,105.3,2440,1250,1190,105
32010, 춘천시,010005, 9세,2021,2625,1369,1256,109,2618,1365,1253,108.9
32010, 춘천시,015,10~14세,2021,12839,6660,6179,107.8,12815,6644,6171,107.7
32010, 춘천시,015001, 10세,2021,2704,1419,1285,110.4,2691,1410,1281,110.1
32010, 춘천시,015002, 11세,2021,2520,1302,1218,106.9,2516,1301,1215,107.1
32010, 춘천시,015003, 12세,2021,2426,1271,1155,110,2423,1268,1155,109.8
32010, 춘천시,015004, 13세,2021,2593,1331,1262,105.5,2590,1328,1262,105.2
32010, 춘천시,015005, 14세,2021,2596,1337,1259,106.2,2595,1337,1258,106.3
32010, 춘천시,020,15~19세,2021,14252,7427,6825,108.8,14177,7385,6792,108.7
32010, 춘천시,020001, 15세,2021,2438,1251,1187,105.4,2431,1247,1184,105.3
32010, 춘천시,020002, 16세,2021,2483,1334,1149,116.1,2479,1331,1148,115.9
32010, 춘천시,020003, 17세,2021,2657,1396,1261,110.7,2649,1393,1256,110.9
32010, 춘천시,020004, 18세,2021,2919,1507,1412,106.7,2908,1500,1408,106.5
32010, 춘천시,020005, 19세,2021,3755,1939,1816,106.8,3710,1914,1796,106.6
32010, 춘천시,025,20~24세,2021,22112,11482,10630,108,21064,10914,10150,107.5
32010, 춘천시,025001, 20세,2021,4122,1995,2127,93.8,4009,1942,2067,94
32010, 춘천시,025002, 21세,2021,4466,2148,2318,92.7,4313,2085,2228,93.6
32010, 춘천시,025003, 22세,2021,4607,2373,2234,106.2,4374,2226,2148,103.6
32010, 춘천시,025004, 23세,2021,4570,2521,2049,123,4268,2340,1928,121.4
32010, 춘천시,025005, 24세,2021,4347,2445,1902,128.5,4100,2321,1779,130.5
32010, 춘천시,030,25~29세,2021,19795,10826,8969,120.7,18557,10107,8450,119.6
32010, 춘천시,030001, 25세,2021,4262,2351,1911,123,3967,2173,1794,121.1
32010, 춘천시,030002, 26세,2021,4089,2239,1850,121,3837,2087,1750,119.3
32010, 춘천시,030003, 27세,2021,3806,2098,1708,122.8,3553,1953,1600,122.1
32010, 춘천시,030004, 28세,2021,3794,2045,1749,116.9,3567,1923,1644,117
32010, 춘천시,030005, 29세,2021,3844,2093,1751,119.5,3633,1971,1662,118.6
32010, 춘천시,035,30~34세,2021,16603,8617,7986,107.9,15838,8255,7583,108.9
32010, 춘천시,035001, 30세,2021,3532,1830,1702,107.5,3340,1747,1593,109.7
32010, 춘천시,035002, 31세,2021,3448,1832,1616,113.4,3286,1760,1526,115.3
32010, 춘천시,035003, 32세,2021,3231,1691,1540,109.8,3095,1621,1474,110
32010, 춘천시,035004, 33세,2021,3309,1709,1600,106.8,3159,1635,1524,107.3
32010, 춘천시,035005, 34세,2021,3083,1555,1528,101.8,2958,1492,1466,101.8
32010, 춘천시,040,35~39세,2021,18023,9143,8880,103,17440,8865,8575,103.4
32010, 춘천시,040001, 35세,2021,3304,1711,1593,107.4,3164,1653,1511,109.4
32010, 춘천시,040002, 36세,2021,3354,1725,1629,105.9,3223,1653,1570,105.3
32010, 춘천시,040003, 37세,2021,3320,1685,1635,103.1,3208,1631,1577,103.4
32010, 춘천시,040004, 38세,2021,3883,1955,1928,101.4,3783,1911,1872,102.1
32010, 춘천시,040005, 39세,2021,4162,2067,2095,98.7,4062,2017,2045,98.6
32010, 춘천시,045,40~44세,2021,19853,9821,10032,97.9,19505,9657,9848,98.1
32010, 춘천시,045001, 40세,2021,4063,1987,2076,95.7,3997,1954,2043,95.6
32010, 춘천시,045002, 41세,2021,4244,2094,2150,97.4,4166,2058,2108,97.6
32010, 춘천시,045003, 42세,2021,3981,1963,2018,97.3,3912,1927,1985,97.1
32010, 춘천시,045004, 43세,2021,3826,1917,1909,100.4,3751,1886,1865,101.1
32010, 춘천시,045005, 44세,2021,3739,1860,1879,99,3679,1832,1847,99.2
32010, 춘천시,050,45~49세,2021,21234,10431,10803,96.6,20951,10291,10660,96.5
32010, 춘천시,050001, 45세,2021,3734,1820,1914,95.1,3667,1787,1880,95.1
32010, 춘천시,050002, 46세,2021,3991,1876,2115,88.7,3932,1847,2085,88.6
32010, 춘천시,050003, 47세,2021,4427,2204,2223,99.1,4375,2173,2202,98.7
32010, 춘천시,050004, 48세,2021,4481,2214,2267,97.7,4426,2187,2239,97.7
32010, 춘천시,050005, 49세,2021,4601,2317,2284,101.4,4551,2297,2254,101.9
32010, 춘천시,055,50~54세,2021,24001,12040,11961,100.7,23729,11920,11809,100.9
32010, 춘천시,055001, 50세,2021,4942,2469,2473,99.8,4887,2448,2439,100.4
32010, 춘천시,055002, 51세,2021,4677,2383,2294,103.9,4614,2357,2257,104.4
32010, 춘천시,055003, 52세,2021,4891,2424,2467,98.3,4834,2401,2433,98.7
32010, 춘천시,055004, 53세,2021,4931,2433,2498,97.4,4885,2409,2476,97.3
32010, 춘천시,055005, 54세,2021,4560,2331,2229,104.6,4509,2305,2204,104.6
32010, 춘천시,060,55~59세,2021,22023,10940,11083,98.7,21822,10870,10952,99.3
32010, 춘천시,060001, 55세,2021,4354,2178,2176,100.1,4313,2161,2152,100.4
32010, 춘천시,060002, 56세,2021,4117,2032,2085,97.5,4070,2022,2048,98.7
32010, 춘천시,060003, 57세,2021,4392,2221,2171,102.3,4350,2205,2145,102.8
32010, 춘천시,060004, 58세,2021,4532,2268,2264,100.2,4487,2247,2240,100.3
32010, 춘천시,060005, 59세,2021,4628,2241,2387,93.9,4602,2235,2367,94.4
32010, 춘천시,065,60~64세,2021,23328,11206,12122,92.4,23204,11157,12047,92.6
32010, 춘천시,065001, 60세,2021,5360,2607,2753,94.7,5339,2597,2742,94.7
32010, 춘천시,065002, 61세,2021,4740,2218,2522,87.9,4707,2204,2503,88.1
32010, 춘천시,065003, 62세,2021,4427,2121,2306,92,4396,2109,2287,92.2
32010, 춘천시,065004, 63세,2021,4429,2135,2294,93.1,4413,2128,2285,93.1
32010, 춘천시,065005, 64세,2021,4372,2125,2247,94.6,4349,2119,2230,95
32010, 춘천시,070,65~69세,2021,17437,8464,8973,94.3,17340,8417,8923,94.3
32010, 춘천시,070001, 65세,2021,3951,1922,2029,94.7,3927,1910,2017,94.7
32010, 춘천시,070002, 66세,2021,3995,1961,2034,96.4,3972,1952,2020,96.6
32010, 춘천시,070003, 67세,2021,3329,1671,1658,100.8,3308,1661,1647,100.9
32010, 춘천시,070004, 68세,2021,2843,1338,1505,88.9,2831,1329,1502,88.5
32010, 춘천시,070005, 69세,2021,3319,1572,1747,90,3302,1565,1737,90.1
32010, 춘천시,075,70~74세,2021,10107,4533,5574,81.3,10075,4519,5556,81.3
32010, 춘천시,075001, 70세,2021,1766,821,945,86.9,1760,819,941,87
32010, 춘천시,075002, 71세,2021,1819,797,1022,78,1811,793,1018,77.9
32010, 춘천시,075003, 72세,2021,1983,895,1088,82.3,1975,890,1085,82
32010, 춘천시,075004, 73세,2021,2205,956,1249,76.5,2200,953,1247,76.4
32010, 춘천시,075005, 74세,2021,2334,1064,1270,83.8,2329,1064,1265,84.1
32010, 춘천시,080,75~79세,2021,10209,4352,5857,74.3,10193,4342,5851,74.2
32010, 춘천시,080001, 75세,2021,2006,876,1130,77.5,2003,873,1130,77.3
32010, 춘천시,080002, 76세,2021,2046,921,1125,81.9,2042,919,1123,81.8
32010, 춘천시,080003, 77세,2021,1931,814,1117,72.9,1929,813,1116,72.8
32010, 춘천시,080004, 78세,2021,1970,811,1159,70,1964,808,1156,69.9
32010, 춘천시,080005, 79세,2021,2256,930,1326,70.1,2255,929,1326,70.1
32010, 춘천시,085,80~84세,2021,8299,3187,5112,62.3,8290,3186,5104,62.4
32010, 춘천시,085001, 80세,2021,1966,781,1185,65.9,1963,781,1182,66.1
32010, 춘천시,085002, 81세,2021,1784,704,1080,65.2,1784,704,1080,65.2
32010, 춘천시,085003, 82세,2021,1669,633,1036,61.1,1666,632,1034,61.1
32010, 춘천시,085004, 83세,2021,1567,590,977,60.4,1565,590,975,60.5
32010, 춘천시,085005, 84세,2021,1313,479,834,57.4,1312,479,833,57.5
32010, 춘천시,090,85~89세,2021,4210,1300,2910,44.7,4207,1299,2908,44.7
32010, 춘천시,090001, 85세,2021,1175,408,767,53.2,1175,408,767,53.2
32010, 춘천시,090002, 86세,2021,1031,327,704,46.4,1030,327,703,46.5
32010, 춘천시,090003, 87세,2021,800,233,567,41.1,800,233,567,41.1
32010, 춘천시,090004, 88세,2021,667,191,476,40.1,665,190,475,40
32010, 춘천시,090005, 89세,2021,537,141,396,35.6,537,141,396,35.6
32010, 춘천시,095,90~94세,2021,1619,369,1250,29.5,1617,368,1249,29.5
32010, 춘천시,095001, 90세,2021,422,101,321,31.5,422,101,321,31.5
32010, 춘천시,095002, 91세,2021,392,108,284,38,390,107,283,37.8
32010, 춘천시,095003, 92세,2021,338,82,256,32,338,82,256,32
32010, 춘천시,095004, 93세,2021,257,42,215,19.5,257,42,215,19.5
32010, 춘천시,095005, 94세,2021,210,36,174,20.7,210,36,174,20.7
32010, 춘천시,100,95~99세,2021,365,100,265,37.7,365,100,265,37.7
32010, 춘천시,100001, 95세,2021,113,19,94,20.2,113,19,94,20.2
32010, 춘천시,100002, 96세,2021,104,27,77,35.1,104,27,77,35.1
32010, 춘천시,100003, 97세,2021,68,20,48,41.7,68,20,48,41.7
32010, 춘천시,100004, 98세,2021,56,27,29,93.1,56,27,29,93.1
32010, 춘천시,100005, 99세,2021,24,7,17,41.2,24,7,17,41.2
32010, 춘천시,101,100세이상,2021,65,16,49,32.7,65,16,49,32.7
32010, 춘천시,102,15세미만,2021,33569,17302,16267,106.4,33399,17210,16189,106.3
32010, 춘천시,103,15~64세,2021,201224,101933,99291,102.7,196287,99421,96866,102.6
32010, 춘천시,104,65세이상,2021,52311,22321,29990,74.4,52152,22247,29905,74.4
32010, 춘천시,086,85세이상,2021,6259,1785,4474,39.9,6254,1783,4471,39.9
32010, 춘천시,126,평균연령,2021,43.8,42.3,45.2,,43.9,42.5,45.4,
32010, 춘천시,127,중위연령,2021,44.8,43,46.6,,45.3,43.4,47,
32020, 원주시,000,합계,2021,357224,177182,180042,98.4,352622,174887,177735,98.4
32020, 원주시,005,0~4세,2021,11690,5968,5722,104.3,11655,5952,5703,104.4
32020, 원주시,005001, 0세,2021,2121,1100,1021,107.7,2117,1096,1021,107.3
32020, 원주시,005002, 1세,2021,2189,1093,1096,99.7,2183,1092,1091,100.1
32020, 원주시,005003, 2세,2021,2348,1203,1145,105.1,2337,1197,1140,105
32020, 원주시,005004, 3세,2021,2345,1197,1148,104.3,2339,1195,1144,104.5
32020, 원주시,005005, 4세,2021,2687,1375,1312,104.8,2679,1372,1307,105
32020, 원주시,010,5~9세,2021,15609,7919,7690,103,15576,7901,7675,102.9
32020, 원주시,010001, 5세,2021,2925,1521,1404,108.3,2912,1514,1398,108.3
32020, 원주시,010002, 6세,2021,3073,1552,1521,102,3064,1548,1516,102.1
32020, 원주시,010003, 7세,2021,3001,1530,1471,104,2998,1529,1469,104.1
32020, 원주시,010004, 8세,2021,3093,1563,1530,102.2,3088,1559,1529,102
32020, 원주시,010005, 9세,2021,3517,1753,1764,99.4,3514,1751,1763,99.3
32020, 원주시,015,10~14세,2021,17552,9039,8513,106.2,17527,9031,8496,106.3
32020, 원주시,015001, 10세,2021,3470,1773,1697,104.5,3462,1769,1693,104.5
32020, 원주시,015002, 11세,2021,3461,1767,1694,104.3,3458,1766,1692,104.4
32020, 원주시,015003, 12세,2021,3411,1791,1620,110.6,3406,1789,1617,110.6
32020, 원주시,015004, 13세,2021,3470,1780,1690,105.3,3467,1780,1687,105.5
32020, 원주시,015005, 14세,2021,3740,1928,1812,106.4,3734,1927,1807,106.6
32020, 원주시,020,15~19세,2021,17771,9222,8549,107.9,17573,9104,8469,107.5
32020, 원주시,020001, 15세,2021,3234,1662,1572,105.7,3228,1659,1569,105.7
32020, 원주시,020002, 16세,2021,3270,1684,1586,106.2,3263,1680,1583,106.1
32020, 원주시,020003, 17세,2021,3544,1882,1662,113.2,3535,1879,1656,113.5
32020, 원주시,020004, 18세,2021,3584,1886,1698,111.1,3544,1864,1680,111
32020, 원주시,020005, 19세,2021,4139,2108,2031,103.8,4003,2022,1981,102.1
32020, 원주시,025,20~24세,2021,24093,12717,11376,111.8,23502,12427,11075,112.2
32020, 원주시,025001, 20세,2021,4563,2408,2155,111.7,4434,2346,2088,112.4
32020, 원주시,025002, 21세,2021,4965,2575,2390,107.7,4867,2528,2339,108.1
32020, 원주시,025003, 22세,2021,4885,2498,2387,104.7,4778,2447,2331,105
32020, 원주시,025004, 23세,2021,4778,2557,2221,115.1,4639,2488,2151,115.7
32020, 원주시,025005, 24세,2021,4902,2679,2223,120.5,4784,2618,2166,120.9
32020, 원주시,030,25~29세,2021,23432,12532,10900,115,22759,12180,10579,115.1
32020, 원주시,030001, 25세,2021,4778,2581,2197,117.5,4656,2524,2132,118.4
32020, 원주시,030002, 26세,2021,4550,2451,2099,116.8,4412,2382,2030,117.3
32020, 원주시,030003, 27세,2021,4596,2503,2093,119.6,4470,2431,2039,119.2
32020, 원주시,030004, 28세,2021,4760,2565,2195,116.9,4628,2488,2140,116.3
32020, 원주시,030005, 29세,2021,4748,2432,2316,105,4593,2355,2238,105.2
32020, 원주시,035,30~34세,2021,21441,11003,10438,105.4,20744,10626,10118,105
32020, 원주시,035001, 30세,2021,4548,2301,2247,102.4,4409,2232,2177,102.5
32020, 원주시,035002, 31세,2021,4347,2258,2089,108.1,4213,2187,2026,107.9
32020, 원주시,035003, 32세,2021,4233,2205,2028,108.7,4097,2129,1968,108.2
32020, 원주시,035004, 33세,2021,4142,2129,2013,105.8,3989,2048,1941,105.5
32020, 원주시,035005, 34세,2021,4171,2110,2061,102.4,4036,2030,2006,101.2
32020, 원주시,040,35~39세,2021,23889,12131,11758,103.2,23289,11823,11466,103.1
32020, 원주시,040001, 35세,2021,4338,2228,2110,105.6,4202,2156,2046,105.4
32020, 원주시,040002, 36세,2021,4383,2278,2105,108.2,4257,2207,2050,107.7
32020, 원주시,040003, 37세,2021,4418,2243,2175,103.1,4304,2192,2112,103.8
32020, 원주시,040004, 38세,2021,5158,2596,2562,101.3,5051,2541,2510,101.2
32020, 원주시,040005, 39세,2021,5592,2786,2806,99.3,5475,2727,2748,99.2
32020, 원주시,045,40~44세,2021,26967,13290,13677,97.2,26527,13071,13456,97.1
32020, 원주시,045001, 40세,2021,5512,2781,2731,101.8,5415,2733,2682,101.9
32020, 원주시,045002, 41세,2021,5658,2734,2924,93.5,5562,2682,2880,93.1
32020, 원주시,045003, 42세,2021,5347,2620,2727,96.1,5258,2583,2675,96.6
32020, 원주시,045004, 43세,2021,5106,2523,2583,97.7,5027,2481,2546,97.4
32020, 원주시,045005, 44세,2021,5344,2632,2712,97.1,5265,2592,2673,97
32020, 원주시,050,45~49세,2021,28958,14220,14738,96.5,28628,14063,14565,96.6
32020, 원주시,050001, 45세,2021,5219,2560,2659,96.3,5156,2521,2635,95.7
32020, 원주시,050002, 46세,2021,5452,2696,2756,97.8,5382,2667,2715,98.2
32020, 원주시,050003, 47세,2021,6127,2937,3190,92.1,6060,2912,3148,92.5
32020, 원주시,050004, 48세,2021,6167,3038,3129,97.1,6102,2998,3104,96.6
32020, 원주시,050005, 49세,2021,5993,2989,3004,99.5,5928,2965,2963,100.1
32020, 원주시,055,50~54세,2021,31484,15671,15813,99.1,31147,15539,15608,99.6
32020, 원주시,055001, 50세,2021,6513,3263,3250,100.4,6440,3225,3215,100.3
32020, 원주시,055002, 51세,2021,6363,3145,3218,97.7,6280,3111,3169,98.2
32020, 원주시,055003, 52세,2021,6466,3242,3224,100.6,6397,3213,3184,100.9
32020, 원주시,055004, 53세,2021,6404,3249,3155,103,6341,3230,3111,103.8
32020, 원주시,055005, 54세,2021,5738,2772,2966,93.5,5689,2760,2929,94.2
32020, 원주시,060,55~59세,2021,28791,14461,14330,100.9,28550,14342,14208,100.9
32020, 원주시,060001, 55세,2021,5924,3032,2892,104.8,5870,3006,2864,105
32020, 원주시,060002, 56세,2021,5901,2893,3008,96.2,5857,2868,2989,96
32020, 원주시,060003, 57세,2021,5270,2650,2620,101.1,5213,2623,2590,101.3
32020, 원주시,060004, 58세,2021,5737,2917,2820,103.4,5688,2894,2794,103.6
32020, 원주시,060005, 59세,2021,5959,2969,2990,99.3,5922,2951,2971,99.3
32020, 원주시,065,60~64세,2021,29306,14578,14728,99,29128,14495,14633,99.1
32020, 원주시,065001, 60세,2021,6488,3253,3235,100.6,6450,3237,3213,100.7
32020, 원주시,065002, 61세,2021,6441,3159,3282,96.3,6403,3141,3262,96.3
32020, 원주시,065003, 62세,2021,5729,2805,2924,95.9,5695,2787,2908,95.8
32020, 원주시,065004, 63세,2021,5328,2637,2691,98,5301,2626,2675,98.2
32020, 원주시,065005, 64세,2021,5320,2724,2596,104.9,5279,2704,2575,105
32020, 원주시,070,65~69세,2021,19760,9841,9919,99.2,19648,9785,9863,99.2
32020, 원주시,070001, 65세,2021,4597,2322,2275,102.1,4565,2306,2259,102.1
32020, 원주시,070002, 66세,2021,4327,2154,2173,99.1,4304,2141,2163,99
32020, 원주시,070003, 67세,2021,3759,1902,1857,102.4,3736,1891,1845,102.5
32020, 원주시,070004, 68세,2021,2957,1462,1495,97.8,2937,1453,1484,97.9
32020, 원주시,070005, 69세,2021,4120,2001,2119,94.4,4106,1994,2112,94.4
32020, 원주시,075,70~74세,2021,11174,5167,6007,86,11111,5138,5973,86
32020, 원주시,075001, 70세,2021,2098,956,1142,83.7,2077,948,1129,84
32020, 원주시,075002, 71세,2021,2127,981,1146,85.6,2116,977,1139,85.8
32020, 원주시,075003, 72세,2021,2174,1006,1168,86.1,2161,999,1162,86
32020, 원주시,075004, 73세,2021,2317,1097,1220,89.9,2304,1090,1214,89.8
32020, 원주시,075005, 74세,2021,2458,1127,1331,84.7,2453,1124,1329,84.6
32020, 원주시,080,75~79세,2021,10258,4394,5864,74.9,10233,4385,5848,75
32020, 원주시,080001, 75세,2021,1943,856,1087,78.7,1935,852,1083,78.7
32020, 원주시,080002, 76세,2021,2023,930,1093,85.1,2019,928,1091,85.1
32020, 원주시,080003, 77세,2021,2003,873,1130,77.3,2000,871,1129,77.1
32020, 원주시,080004, 78세,2021,2030,833,1197,69.6,2026,832,1194,69.7
32020, 원주시,080005, 79세,2021,2259,902,1357,66.5,2253,902,1351,66.8
32020, 원주시,085,80~84세,2021,8595,3242,5353,60.6,8581,3240,5341,60.7
32020, 원주시,085001, 80세,2021,2014,814,1200,67.8,2013,814,1199,67.9
32020, 원주시,085002, 81세,2021,1848,665,1183,56.2,1843,665,1178,56.5
32020, 원주시,085003, 82세,2021,1790,682,1108,61.6,1788,682,1106,61.7
32020, 원주시,085004, 83세,2021,1604,603,1001,60.2,1600,602,998,60.3
32020, 원주시,085005, 84세,2021,1339,478,861,55.5,1337,477,860,55.5
32020, 원주시,090,85~89세,2021,4403,1316,3087,42.6,4397,1314,3083,42.6
32020, 원주시,090001, 85세,2021,1173,417,756,55.2,1173,417,756,55.2
32020, 원주시,090002, 86세,2021,1048,294,754,39,1046,293,753,38.9
32020, 원주시,090003, 87세,2021,862,228,634,36,860,227,633,35.9
32020, 원주시,090004, 88세,2021,736,230,506,45.5,735,230,505,45.5
32020, 원주시,090005, 89세,2021,584,147,437,33.6,583,147,436,33.7
32020, 원주시,095,90~94세,2021,1631,369,1262,29.2,1629,369,1260,29.3
32020, 원주시,095001, 90세,2021,481,123,358,34.4,481,123,358,34.4
32020, 원주시,095002, 91세,2021,392,90,302,29.8,391,90,301,29.9
32020, 원주시,095003, 92세,2021,333,74,259,28.6,332,74,258,28.7
32020, 원주시,095004, 93세,2021,245,50,195,25.6,245,50,195,25.6
32020, 원주시,095005, 94세,2021,180,32,148,21.6,180,32,148,21.6
32020, 원주시,100,95~99세,2021,372,95,277,34.3,370,95,275,34.5
32020, 원주시,100001, 95세,2021,130,30,100,30,130,30,100,30
32020, 원주시,100002, 96세,2021,104,34,70,48.6,104,34,70,48.6
32020, 원주시,100003, 97세,2021,58,9,49,18.4,58,9,49,18.4
32020, 원주시,100004, 98세,2021,47,16,31,51.6,47,16,31,51.6
32020, 원주시,100005, 99세,2021,33,6,27,22.2,31,6,25,24
32020, 원주시,101,100세이상,2021,48,7,41,17.1,48,7,41,17.1
32020, 원주시,102,15세미만,2021,44851,22926,21925,104.6,44758,22884,21874,104.6
32020, 원주시,103,15~64세,2021,256132,129825,126307,102.8,251847,127670,124177,102.8
32020, 원주시,104,65세이상,2021,56241,24431,31810,76.8,56017,24333,31684,76.8
32020, 원주시,086,85세이상,2021,6454,1787,4667,38.3,6444,1785,4659,38.3
32020, 원주시,126,평균연령,2021,42.9,41.8,44.1,,43,41.8,44.2,
32020, 원주시,127,중위연령,2021,44.3,43,45.5,,44.5,43.2,45.7,
32030, 강릉시,000,합계,2021,216560,108324,108236,100.1,213304,106691,106613,100.1
32030, 강릉시,005,0~4세,2021,5313,2762,2551,108.3,5284,2747,2537,108.3
32030, 강릉시,005001, 0세,2021,902,458,444,103.2,900,456,444,102.7
32030, 강릉시,005002, 1세,2021,996,519,477,108.8,988,515,473,108.9
32030, 강릉시,005003, 2세,2021,1065,538,527,102.1,1059,536,523,102.5
32030, 강릉시,005004, 3세,2021,1156,626,530,118.1,1149,624,525,118.9
32030, 강릉시,005005, 4세,2021,1194,621,573,108.4,1188,616,572,107.7
32030, 강릉시,010,5~9세,2021,7476,3825,3651,104.8,7439,3805,3634,104.7
32030, 강릉시,010001, 5세,2021,1395,715,680,105.1,1385,713,672,106.1
32030, 강릉시,010002, 6세,2021,1460,710,750,94.7,1452,705,747,94.4
32030, 강릉시,010003, 7세,2021,1440,742,698,106.3,1429,735,694,105.9
32030, 강릉시,010004, 8세,2021,1488,793,695,114.1,1485,791,694,114
32030, 강릉시,010005, 9세,2021,1693,865,828,104.5,1688,861,827,104.1
32030, 강릉시,015,10~14세,2021,8649,4527,4122,109.8,8626,4514,4112,109.8
32030, 강릉시,015001, 10세,2021,1748,913,835,109.3,1742,910,832,109.4
32030, 강릉시,015002, 11세,2021,1648,862,786,109.7,1644,860,784,109.7
32030, 강릉시,015003, 12세,2021,1687,841,846,99.4,1684,839,845,99.3
32030, 강릉시,015004, 13세,2021,1721,889,832,106.9,1714,885,829,106.8
32030, 강릉시,015005, 14세,2021,1845,1022,823,124.2,1842,1020,822,124.1
32030, 강릉시,020,15~19세,2021,10731,5738,4993,114.9,10676,5715,4961,115.2
32030, 강릉시,020001, 15세,2021,1750,970,780,124.4,1745,968,777,124.6
32030, 강릉시,020002, 16세,2021,1763,928,835,111.1,1758,924,834,110.8
32030, 강릉시,020003, 17세,2021,1941,981,960,102.2,1934,978,956,102.3
32030, 강릉시,020004, 18세,2021,2136,1125,1011,111.3,2129,1122,1007,111.4
32030, 강릉시,020005, 19세,2021,3141,1734,1407,123.2,3110,1723,1387,124.2
32030, 강릉시,025,20~24세,2021,17051,9532,7519,126.8,16526,9261,7265,127.5
32030, 강릉시,025001, 20세,2021,3244,1594,1650,96.6,3212,1586,1626,97.5
32030, 강릉시,025002, 21세,2021,3534,1740,1794,97,3434,1694,1740,97.4
32030, 강릉시,025003, 22세,2021,3494,1925,1569,122.7,3369,1848,1521,121.5
32030, 강릉시,025004, 23세,2021,3453,2144,1309,163.8,3319,2073,1246,166.4
32030, 강릉시,025005, 24세,2021,3326,2129,1197,177.9,3192,2060,1132,182
32030, 강릉시,030,25~29세,2021,12830,7381,5449,135.5,12266,7085,5181,136.7
32030, 강릉시,030001, 25세,2021,2919,1789,1130,158.3,2805,1724,1081,159.5
32030, 강릉시,030002, 26세,2021,2683,1555,1128,137.9,2565,1492,1073,139
32030, 강릉시,030003, 27세,2021,2546,1424,1122,126.9,2419,1361,1058,128.6
32030, 강릉시,030004, 28세,2021,2340,1301,1039,125.2,2240,1251,989,126.5
32030, 강릉시,030005, 29세,2021,2342,1312,1030,127.4,2237,1257,980,128.3
32030, 강릉시,035,30~34세,2021,9955,5452,4503,121.1,9446,5195,4251,122.2
32030, 강릉시,035001, 30세,2021,2160,1181,979,120.6,2053,1127,926,121.7
32030, 강릉시,035002, 31세,2021,2021,1119,902,124.1,1919,1072,847,126.6
32030, 강릉시,035003, 32세,2021,1944,1085,859,126.3,1843,1031,812,127
32030, 강릉시,035004, 33세,2021,1886,1012,874,115.8,1789,969,820,118.2
32030, 강릉시,035005, 34세,2021,1944,1055,889,118.7,1842,996,846,117.7
32030, 강릉시,040,35~39세,2021,11499,5914,5585,105.9,11081,5684,5397,105.3
32030, 강릉시,040001, 35세,2021,1984,1073,911,117.8,1883,1016,867,117.2
32030, 강릉시,040002, 36세,2021,2074,1074,1000,107.4,1985,1028,957,107.4
32030, 강릉시,040003, 37세,2021,2214,1149,1065,107.9,2144,1111,1033,107.6
32030, 강릉시,040004, 38세,2021,2484,1256,1228,102.3,2406,1215,1191,102
32030, 강릉시,040005, 39세,2021,2743,1362,1381,98.6,2663,1314,1349,97.4
32030, 강릉시,045,40~44세,2021,14271,7228,7043,102.6,13976,7081,6895,102.7
32030, 강릉시,045001, 40세,2021,2819,1464,1355,108,2757,1431,1326,107.9
32030, 강릉시,045002, 41세,2021,2979,1452,1527,95.1,2910,1421,1489,95.4
32030, 강릉시,045003, 42세,2021,2907,1467,1440,101.9,2842,1435,1407,102
32030, 강릉시,045004, 43세,2021,2717,1360,1357,100.2,2657,1330,1327,100.2
32030, 강릉시,045005, 44세,2021,2849,1485,1364,108.9,2810,1464,1346,108.8
32030, 강릉시,050,45~49세,2021,16762,8583,8179,104.9,16551,8484,8067,105.2
32030, 강릉시,050001, 45세,2021,2932,1456,1476,98.6,2896,1440,1456,98.9
32030, 강릉시,050002, 46세,2021,3195,1620,1575,102.9,3148,1596,1552,102.8
32030, 강릉시,050003, 47세,2021,3589,1835,1754,104.6,3546,1809,1737,104.1
32030, 강릉시,050004, 48세,2021,3680,1886,1794,105.1,3635,1867,1768,105.6
32030, 강릉시,050005, 49세,2021,3366,1786,1580,113,3326,1772,1554,114
32030, 강릉시,055,50~54세,2021,18329,9303,9026,103.1,18137,9214,8923,103.3
32030, 강릉시,055001, 50세,2021,3702,1874,1828,102.5,3663,1858,1805,102.9
32030, 강릉시,055002, 51세,2021,3735,1912,1823,104.9,3695,1890,1805,104.7
32030, 강릉시,055003, 52세,2021,3644,1847,1797,102.8,3605,1831,1774,103.2
32030, 강릉시,055004, 53세,2021,3802,1926,1876,102.7,3761,1907,1854,102.9
32030, 강릉시,055005, 54세,2021,3446,1744,1702,102.5,3413,1728,1685,102.6
32030, 강릉시,060,55~59세,2021,17480,8711,8769,99.3,17343,8663,8680,99.8
32030, 강릉시,060001, 55세,2021,3531,1817,1714,106,3502,1809,1693,106.9
32030, 강릉시,060002, 56세,2021,3210,1529,1681,91,3189,1521,1668,91.2
32030, 강릉시,060003, 57세,2021,3312,1686,1626,103.7,3283,1676,1607,104.3
32030, 강릉시,060004, 58세,2021,3709,1821,1888,96.5,3676,1808,1868,96.8
32030, 강릉시,060005, 59세,2021,3718,1858,1860,99.9,3693,1849,1844,100.3
32030, 강릉시,065,60~64세,2021,19896,9560,10336,92.5,19771,9497,10274,92.4
32030, 강릉시,065001, 60세,2021,4150,1921,2229,86.2,4122,1906,2216,86
32030, 강릉시,065002, 61세,2021,4201,2017,2184,92.4,4174,2006,2168,92.5
32030, 강릉시,065003, 62세,2021,4029,1918,2111,90.9,3996,1899,2097,90.6
32030, 강릉시,065004, 63세,2021,3728,1827,1901,96.1,3707,1817,1890,96.1
32030, 강릉시,065005, 64세,2021,3788,1877,1911,98.2,3772,1869,1903,98.2
32030, 강릉시,070,65~69세,2021,15056,7108,7948,89.4,14981,7072,7909,89.4
32030, 강릉시,070001, 65세,2021,3247,1554,1693,91.8,3222,1544,1678,92
32030, 강릉시,070002, 66세,2021,3335,1593,1742,91.4,3322,1587,1735,91.5
32030, 강릉시,070003, 67세,2021,2911,1350,1561,86.5,2902,1345,1557,86.4
32030, 강릉시,070004, 68세,2021,2591,1208,1383,87.3,2577,1199,1378,87
32030, 강릉시,070005, 69세,2021,2972,1403,1569,89.4,2958,1397,1561,89.5
32030, 강릉시,075,70~74세,2021,10205,4698,5507,85.3,10178,4688,5490,85.4
32030, 강릉시,075001, 70세,2021,1877,866,1011,85.7,1871,865,1006,86
32030, 강릉시,075002, 71세,2021,1950,889,1061,83.8,1940,884,1056,83.7
32030, 강릉시,075003, 72세,2021,2111,972,1139,85.3,2106,970,1136,85.4
32030, 강릉시,075004, 73세,2021,2182,1026,1156,88.8,2179,1025,1154,88.8
32030, 강릉시,075005, 74세,2021,2085,945,1140,82.9,2082,944,1138,83
32030, 강릉시,080,75~79세,2021,9083,3967,5116,77.5,9063,3959,5104,77.6
32030, 강릉시,080001, 75세,2021,1693,797,896,89,1690,795,895,88.8
32030, 강릉시,080002, 76세,2021,1949,865,1084,79.8,1946,864,1082,79.9
32030, 강릉시,080003, 77세,2021,1846,797,1049,76,1841,794,1047,75.8
32030, 강릉시,080004, 78세,2021,1732,727,1005,72.3,1729,726,1003,72.4
32030, 강릉시,080005, 79세,2021,1863,781,1082,72.2,1857,780,1077,72.4
32030, 강릉시,085,80~84세,2021,6862,2634,4228,62.3,6850,2626,4224,62.2
32030, 강릉시,085001, 80세,2021,1566,616,950,64.8,1562,614,948,64.8
32030, 강릉시,085002, 81세,2021,1567,631,936,67.4,1565,629,936,67.2
32030, 강릉시,085003, 82세,2021,1389,529,860,61.5,1388,528,860,61.4
32030, 강릉시,085004, 83세,2021,1287,480,807,59.5,1286,479,807,59.4
32030, 강릉시,085005, 84세,2021,1053,378,675,56,1049,376,673,55.9
32030, 강릉시,090,85~89세,2021,3388,1067,2321,46,3386,1067,2319,46
32030, 강릉시,090001, 85세,2021,927,335,592,56.6,926,335,591,56.7
32030, 강릉시,090002, 86세,2021,815,249,566,44,814,249,565,44.1
32030, 강릉시,090003, 87세,2021,671,205,466,44,671,205,466,44
32030, 강릉시,090004, 88세,2021,544,159,385,41.3,544,159,385,41.3
32030, 강릉시,090005, 89세,2021,431,119,312,38.1,431,119,312,38.1
32030, 강릉시,095,90~94세,2021,1360,277,1083,25.6,1360,277,1083,25.6
32030, 강릉시,095001, 90세,2021,368,91,277,32.9,368,91,277,32.9
32030, 강릉시,095002, 91세,2021,349,74,275,26.9,349,74,275,26.9
32030, 강릉시,095003, 92세,2021,285,54,231,23.4,285,54,231,23.4
32030, 강릉시,095004, 93세,2021,185,28,157,17.8,185,28,157,17.8
32030, 강릉시,095005, 94세,2021,173,30,143,21,173,30,143,21
32030, 강릉시,100,95~99세,2021,312,47,265,17.7,312,47,265,17.7
32030, 강릉시,100001, 95세,2021,103,13,90,14.4,103,13,90,14.4
32030, 강릉시,100002, 96세,2021,80,17,63,27,80,17,63,27
32030, 강릉시,100003, 97세,2021,56,7,49,14.3,56,7,49,14.3
32030, 강릉시,100004, 98세,2021,47,7,40,17.5,47,7,40,17.5
32030, 강릉시,100005, 99세,2021,26,X,23,13,26,X,23,13
32030, 강릉시,101,100세이상,2021,52,10,42,23.8,52,10,42,23.8
32030, 강릉시,102,15세미만,2021,21438,11114,10324,107.7,21349,11066,10283,107.6
32030, 강릉시,103,15~64세,2021,148804,77402,71402,108.4,145773,75879,69894,108.6
32030, 강릉시,104,65세이상,2021,46318,19808,26510,74.7,46182,19746,26436,74.7
32030, 강릉시,086,85세이상,2021,5112,1401,3711,37.8,5110,1401,3709,37.8
32030, 강릉시,126,평균연령,2021,46,44.2,47.8,,46.1,44.3,48,
32030, 강릉시,127,중위연령,2021,48.2,46.2,50.3,,48.5,46.5,50.6,
32040, 동해시,000,합계,2021,87264,44384,42880,103.5,86258,43838,42420,103.3
32040, 동해시,005,0~4세,2021,2482,1267,1215,104.3,2469,1258,1211,103.9
32040, 동해시,005001, 0세,2021,440,224,216,103.7,438,223,215,103.7
32040, 동해시,005002, 1세,2021,455,234,221,105.9,454,233,221,105.4
32040, 동해시,005003, 2세,2021,477,245,232,105.6,476,245,231,106.1
32040, 동해시,005004, 3세,2021,510,262,248,105.6,504,257,247,104
32040, 동해시,005005, 4세,2021,600,302,298,101.3,597,300,297,101
32040, 동해시,010,5~9세,2021,3830,1980,1850,107,3820,1974,1846,106.9
32040, 동해시,010001, 5세,2021,719,360,359,100.3,715,356,359,99.2
32040, 동해시,010002, 6세,2021,704,369,335,110.1,704,369,335,110.1
32040, 동해시,010003, 7세,2021,732,383,349,109.7,730,383,347,110.4
32040, 동해시,010004, 8세,2021,794,402,392,102.6,792,402,390,103.1
32040, 동해시,010005, 9세,2021,881,466,415,112.3,879,464,415,111.8
32040, 동해시,015,10~14세,2021,4169,2163,2006,107.8,4161,2160,2001,107.9
32040, 동해시,015001, 10세,2021,863,445,418,106.5,863,445,418,106.5
32040, 동해시,015002, 11세,2021,774,414,360,115,774,414,360,115
32040, 동해시,015003, 12세,2021,825,415,410,101.2,822,415,407,102
32040, 동해시,015004, 13세,2021,838,432,406,106.4,836,430,406,105.9
32040, 동해시,015005, 14세,2021,869,457,412,110.9,866,456,410,111.2
32040, 동해시,020,15~19세,2021,3737,1996,1741,114.6,3731,1990,1741,114.3
32040, 동해시,020001, 15세,2021,792,403,389,103.6,790,401,389,103.1
32040, 동해시,020002, 16세,2021,813,424,389,109,812,423,389,108.7
32040, 동해시,020003, 17세,2021,868,459,409,112.2,868,459,409,112.2
32040, 동해시,020004, 18세,2021,779,415,364,114,777,413,364,113.5
32040, 동해시,020005, 19세,2021,485,295,190,155.3,484,294,190,154.7
32040, 동해시,025,20~24세,2021,3725,2333,1392,167.6,3661,2305,1356,170
32040, 동해시,025001, 20세,2021,697,465,232,200.4,690,465,225,206.7
32040, 동해시,025002, 21세,2021,749,533,216,246.8,747,533,214,249.1
32040, 동해시,025003, 22세,2021,686,427,259,164.9,673,420,253,166
32040, 동해시,025004, 23세,2021,754,426,328,129.9,732,415,317,130.9
32040, 동해시,025005, 24세,2021,839,482,357,135,819,472,347,136
32040, 동해시,030,25~29세,2021,4327,2516,1811,138.9,4179,2432,1747,139.2
32040, 동해시,030001, 25세,2021,864,500,364,137.4,840,490,350,140
32040, 동해시,030002, 26세,2021,863,498,365,136.4,839,484,355,136.3
32040, 동해시,030003, 27세,2021,868,518,350,148,836,500,336,148.8
32040, 동해시,030004, 28세,2021,901,515,386,133.4,864,491,373,131.6
32040, 동해시,030005, 29세,2021,831,485,346,140.2,800,467,333,140.2
32040, 동해시,035,30~34세,2021,3849,2144,1705,125.7,3652,2015,1637,123.1
32040, 동해시,035001, 30세,2021,740,437,303,144.2,697,404,293,137.9
32040, 동해시,035002, 31세,2021,804,470,334,140.7,758,442,316,139.9
32040, 동해시,035003, 32세,2021,742,404,338,119.5,711,384,327,117.4
32040, 동해시,035004, 33세,2021,784,428,356,120.2,745,402,343,117.2
32040, 동해시,035005, 34세,2021,779,405,374,108.3,741,383,358,107
32040, 동해시,040,35~39세,2021,5006,2650,2356,112.5,4847,2560,2287,111.9
32040, 동해시,040001, 35세,2021,807,437,370,118.1,774,421,353,119.3
32040, 동해시,040002, 36세,2021,920,495,425,116.5,890,479,411,116.5
32040, 동해시,040003, 37세,2021,953,502,451,111.3,928,488,440,110.9
32040, 동해시,040004, 38세,2021,1075,559,516,108.3,1039,534,505,105.7
32040, 동해시,040005, 39세,2021,1251,657,594,110.6,1216,638,578,110.4
32040, 동해시,045,40~44세,2021,6520,3294,3226,102.1,6406,3226,3180,101.4
32040, 동해시,045001, 40세,2021,1298,682,616,110.7,1272,664,608,109.2
32040, 동해시,045002, 41세,2021,1314,648,666,97.3,1284,629,655,96
32040, 동해시,045003, 42세,2021,1309,657,652,100.8,1283,639,644,99.2
32040, 동해시,045004, 43세,2021,1289,627,662,94.7,1271,616,655,94
32040, 동해시,045005, 44세,2021,1310,680,630,107.9,1296,678,618,109.7
32040, 동해시,050,45~49세,2021,7471,3997,3474,115.1,7375,3953,3422,115.5
32040, 동해시,050001, 45세,2021,1293,677,616,109.9,1276,667,609,109.5
32040, 동해시,050002, 46세,2021,1408,746,662,112.7,1388,731,657,111.3
32040, 동해시,050003, 47세,2021,1613,851,762,111.7,1590,845,745,113.4
32040, 동해시,050004, 48세,2021,1644,891,753,118.3,1623,881,742,118.7
32040, 동해시,050005, 49세,2021,1513,832,681,122.2,1498,829,669,123.9
32040, 동해시,055,50~54세,2021,8064,4197,3867,108.5,7991,4156,3835,108.4
32040, 동해시,055001, 50세,2021,1683,842,841,100.1,1664,833,831,100.2
32040, 동해시,055002, 51세,2021,1606,867,739,117.3,1596,861,735,117.1
32040, 동해시,055003, 52세,2021,1667,858,809,106.1,1648,845,803,105.2
32040, 동해시,055004, 53세,2021,1582,858,724,118.5,1569,851,718,118.5
32040, 동해시,055005, 54세,2021,1526,772,754,102.4,1514,766,748,102.4
32040, 동해시,060,55~59세,2021,7252,3743,3509,106.7,7208,3732,3476,107.4
32040, 동해시,060001, 55세,2021,1457,745,712,104.6,1443,743,700,106.1
32040, 동해시,060002, 56세,2021,1403,731,672,108.8,1394,730,664,109.9
32040, 동해시,060003, 57세,2021,1362,715,647,110.5,1358,713,645,110.5
32040, 동해시,060004, 58세,2021,1466,749,717,104.5,1457,746,711,104.9
32040, 동해시,060005, 59세,2021,1564,803,761,105.5,1556,800,756,105.8
32040, 동해시,065,60~64세,2021,8101,3941,4160,94.7,8067,3927,4140,94.9
32040, 동해시,065001, 60세,2021,1631,814,817,99.6,1627,813,814,99.9
32040, 동해시,065002, 61세,2021,1804,877,927,94.6,1795,873,922,94.7
32040, 동해시,065003, 62세,2021,1618,777,841,92.4,1610,773,837,92.4
32040, 동해시,065004, 63세,2021,1505,703,802,87.7,1498,701,797,88
32040, 동해시,065005, 64세,2021,1543,770,773,99.6,1537,767,770,99.6
32040, 동해시,070,65~69세,2021,6307,3045,3262,93.3,6283,3038,3245,93.6
32040, 동해시,070001, 65세,2021,1297,650,647,100.5,1293,648,645,100.5
32040, 동해시,070002, 66세,2021,1463,699,764,91.5,1455,697,758,92
32040, 동해시,070003, 67세,2021,1246,586,660,88.8,1243,586,657,89.2
32040, 동해시,070004, 68세,2021,1143,572,571,100.2,1136,569,567,100.4
32040, 동해시,070005, 69세,2021,1158,538,620,86.8,1156,538,618,87.1
32040, 동해시,075,70~74세,2021,4192,1987,2205,90.1,4182,1983,2199,90.2
32040, 동해시,075001, 70세,2021,712,336,376,89.4,710,334,376,88.8
32040, 동해시,075002, 71세,2021,859,401,458,87.6,858,400,458,87.3
32040, 동해시,075003, 72세,2021,849,409,440,93,844,408,436,93.6
32040, 동해시,075004, 73세,2021,961,460,501,91.8,960,460,500,92
32040, 동해시,075005, 74세,2021,811,381,430,88.6,810,381,429,88.8
32040, 동해시,080,75~79세,2021,3678,1578,2100,75.1,3674,1577,2097,75.2
32040, 동해시,080001, 75세,2021,628,279,349,79.9,627,279,348,80.2
32040, 동해시,080002, 76세,2021,739,325,414,78.5,739,325,414,78.5
32040, 동해시,080003, 77세,2021,780,341,439,77.7,778,341,437,78
32040, 동해시,080004, 78세,2021,756,314,442,71,756,314,442,71
32040, 동해시,080005, 79세,2021,775,319,456,70,774,318,456,69.7
32040, 동해시,085,80~84세,2021,2647,1053,1594,66.1,2646,1052,1594,66
32040, 동해시,085001, 80세,2021,658,286,372,76.9,658,286,372,76.9
32040, 동해시,085002, 81세,2021,561,194,367,52.9,561,194,367,52.9
32040, 동해시,085003, 82세,2021,538,227,311,73,538,227,311,73
32040, 동해시,085004, 83세,2021,514,208,306,68,513,207,306,67.6
32040, 동해시,085005, 84세,2021,376,138,238,58,376,138,238,58
32040, 동해시,090,85~89세,2021,1328,397,931,42.6,1327,397,930,42.7
32040, 동해시,090001, 85세,2021,345,117,228,51.3,345,117,228,51.3
32040, 동해시,090002, 86세,2021,330,111,219,50.7,330,111,219,50.7
32040, 동해시,090003, 87세,2021,276,86,190,45.3,275,86,189,45.5
32040, 동해시,090004, 88세,2021,207,50,157,31.8,207,50,157,31.8
32040, 동해시,090005, 89세,2021,170,33,137,24.1,170,33,137,24.1
32040, 동해시,095,90~94세,2021,455,92,363,25.3,455,92,363,25.3
32040, 동해시,095001, 90세,2021,142,31,111,27.9,142,31,111,27.9
32040, 동해시,095002, 91세,2021,121,27,94,28.7,121,27,94,28.7
32040, 동해시,095003, 92세,2021,84,16,68,23.5,84,16,68,23.5
32040, 동해시,095004, 93세,2021,64,10,54,18.5,64,10,54,18.5
32040, 동해시,095005, 94세,2021,44,8,36,22.2,44,8,36,22.2
32040, 동해시,100,95~99세,2021,112,10,102,9.8,112,10,102,9.8
32040, 동해시,100001, 95세,2021,29,X,27,7.4,29,X,27,7.4
32040, 동해시,100002, 96세,2021,29,X,25,16,29,X,25,16
32040, 동해시,100003, 97세,2021,21,X,20,5,21,X,20,5
32040, 동해시,100004, 98세,2021,21,X,21,0,21,X,21,0
32040, 동해시,100005, 99세,2021,12,X,9,33.3,12,X,9,33.3
32040, 동해시,101,100세이상,2021,12,X,11,9.1,12,X,11,9.1
32040, 동해시,102,15세미만,2021,10481,5410,5071,106.7,10450,5392,5058,106.6
32040, 동해시,103,15~64세,2021,58052,30811,27241,113.1,57117,30296,26821,113
32040, 동해시,104,65세이상,2021,18731,8163,10568,77.2,18691,8150,10541,77.3
32040, 동해시,086,85세이상,2021,1907,500,1407,35.5,1906,500,1406,35.6
32040, 동해시,126,평균연령,2021,46.4,44.7,48.2,,46.5,44.8,48.2,
32040, 동해시,127,중위연령,2021,49,47.5,50.8,,49.2,47.7,50.9,
32050, 태백시,000,합계,2021,40395,20405,19990,102.1,40032,20307,19725,103
32050, 태백시,005,0~4세,2021,865,468,397,117.9,863,468,395,118.5
32050, 태백시,005001, 0세,2021,138,72,66,109.1,138,72,66,109.1
32050, 태백시,005002, 1세,2021,150,88,62,141.9,150,88,62,141.9
32050, 태백시,005003, 2세,2021,168,97,71,136.6,167,97,70,138.6
32050, 태백시,005004, 3세,2021,198,98,100,98,198,98,100,98
32050, 태백시,005005, 4세,2021,211,113,98,115.3,210,113,97,116.5
32050, 태백시,010,5~9세,2021,1453,758,695,109.1,1448,756,692,109.2
32050, 태백시,010001, 5세,2021,239,127,112,113.4,238,127,111,114.4
32050, 태백시,010002, 6세,2021,268,133,135,98.5,266,132,134,98.5
32050, 태백시,010003, 7세,2021,288,155,133,116.5,287,155,132,117.4
32050, 태백시,010004, 8세,2021,295,154,141,109.2,294,153,141,108.5
32050, 태백시,010005, 9세,2021,363,189,174,108.6,363,189,174,108.6
32050, 태백시,015,10~14세,2021,1805,905,900,100.6,1799,902,897,100.6
32050, 태백시,015001, 10세,2021,363,173,190,91.1,362,172,190,90.5
32050, 태백시,015002, 11세,2021,365,188,177,106.2,364,188,176,106.8
32050, 태백시,015003, 12세,2021,347,165,182,90.7,345,163,182,89.6
32050, 태백시,015004, 13세,2021,339,169,170,99.4,338,169,169,100
32050, 태백시,015005, 14세,2021,391,210,181,116,390,210,180,116.7
32050, 태백시,020,15~19세,2021,1631,902,729,123.7,1627,900,727,123.8
32050, 태백시,020001, 15세,2021,336,169,167,101.2,334,168,166,101.2
32050, 태백시,020002, 16세,2021,375,213,162,131.5,375,213,162,131.5
32050, 태백시,020003, 17세,2021,353,193,160,120.6,352,193,159,121.4
32050, 태백시,020004, 18세,2021,340,195,145,134.5,339,194,145,133.8
32050, 태백시,020005, 19세,2021,227,132,95,138.9,227,132,95,138.9
32050, 태백시,025,20~24세,2021,1580,966,614,157.3,1563,962,601,160.1
32050, 태백시,025001, 20세,2021,337,220,117,188,334,220,114,193
32050, 태백시,025002, 21세,2021,362,238,124,191.9,359,237,122,194.3
32050, 태백시,025003, 22세,2021,323,191,132,144.7,320,190,130,146.2
32050, 태백시,025004, 23세,2021,280,152,128,118.8,276,151,125,120.8
32050, 태백시,025005, 24세,2021,278,165,113,146,274,164,110,149.1
32050, 태백시,030,25~29세,2021,1515,827,688,120.2,1469,822,647,127
32050, 태백시,030001, 25세,2021,322,171,151,113.2,315,171,144,118.8
32050, 태백시,030002, 26세,2021,332,187,145,129,321,184,137,134.3
32050, 태백시,030003, 27세,2021,290,160,130,123.1,278,159,119,133.6
32050, 태백시,030004, 28세,2021,298,164,134,122.4,287,164,123,133.3
32050, 태백시,030005, 29세,2021,273,145,128,113.3,268,144,124,116.1
32050, 태백시,035,30~34세,2021,1429,757,672,112.6,1363,742,621,119.5
32050, 태백시,035001, 30세,2021,243,125,118,105.9,232,124,108,114.8
32050, 태백시,035002, 31세,2021,285,156,129,120.9,270,154,116,132.8
32050, 태백시,035003, 32세,2021,309,164,145,113.1,296,159,137,116.1
32050, 태백시,035004, 33세,2021,279,151,128,118,264,148,116,127.6
32050, 태백시,035005, 34세,2021,313,161,152,105.9,301,157,144,109
32050, 태백시,040,35~39세,2021,1981,1025,956,107.2,1927,1010,917,110.1
32050, 태백시,040001, 35세,2021,296,163,133,122.6,287,160,127,126
32050, 태백시,040002, 36세,2021,305,164,141,116.3,295,161,134,120.1
32050, 태백시,040003, 37세,2021,362,179,183,97.8,352,175,177,98.9
32050, 태백시,040004, 38세,2021,474,242,232,104.3,456,240,216,111.1
32050, 태백시,040005, 39세,2021,544,277,267,103.7,537,274,263,104.2
32050, 태백시,045,40~44세,2021,2895,1468,1427,102.9,2863,1463,1400,104.5
32050, 태백시,045001, 40세,2021,512,255,257,99.2,506,255,251,101.6
32050, 태백시,045002, 41세,2021,585,299,286,104.5,581,299,282,106
32050, 태백시,045003, 42세,2021,589,291,298,97.7,578,289,289,100
32050, 태백시,045004, 43세,2021,616,307,309,99.4,611,304,307,99
32050, 태백시,045005, 44세,2021,593,316,277,114.1,587,316,271,116.6
32050, 태백시,050,45~49세,2021,3248,1781,1467,121.4,3208,1770,1438,123.1
32050, 태백시,050001, 45세,2021,583,318,265,120,574,315,259,121.6
32050, 태백시,050002, 46세,2021,632,355,277,128.2,629,355,274,129.6
32050, 태백시,050003, 47세,2021,679,383,296,129.4,670,379,291,130.2
32050, 태백시,050004, 48세,2021,670,361,309,116.8,665,361,304,118.8
32050, 태백시,050005, 49세,2021,684,364,320,113.8,670,360,310,116.1
32050, 태백시,055,50~54세,2021,3628,1983,1645,120.5,3591,1968,1623,121.3
32050, 태백시,055001, 50세,2021,688,359,329,109.1,678,355,323,109.9
32050, 태백시,055002, 51세,2021,742,405,337,120.2,735,402,333,120.7
32050, 태백시,055003, 52세,2021,737,419,318,131.8,731,415,316,131.3
32050, 태백시,055004, 53세,2021,757,425,332,128,750,423,327,129.4
32050, 태백시,055005, 54세,2021,704,375,329,114,697,373,324,115.1
32050, 태백시,060,55~59세,2021,3499,1850,1649,112.2,3464,1837,1627,112.9
32050, 태백시,060001, 55세,2021,721,375,346,108.4,714,371,343,108.2
32050, 태백시,060002, 56세,2021,684,344,340,101.2,679,344,335,102.7
32050, 태백시,060003, 57세,2021,636,341,295,115.6,631,340,291,116.8
32050, 태백시,060004, 58세,2021,725,412,313,131.6,710,404,306,132
32050, 태백시,060005, 59세,2021,733,378,355,106.5,730,378,352,107.4
32050, 태백시,065,60~64세,2021,4300,2156,2144,100.6,4293,2154,2139,100.7
32050, 태백시,065001, 60세,2021,903,442,461,95.9,901,441,460,95.9
32050, 태백시,065002, 61세,2021,920,463,457,101.3,917,462,455,101.5
32050, 태백시,065003, 62세,2021,875,436,439,99.3,873,436,437,99.8
32050, 태백시,065004, 63세,2021,756,374,382,97.9,756,374,382,97.9
32050, 태백시,065005, 64세,2021,846,441,405,108.9,846,441,405,108.9
32050, 태백시,070,65~69세,2021,3516,1711,1805,94.8,3512,1711,1801,95
32050, 태백시,070001, 65세,2021,750,391,359,108.9,749,391,358,109.2
32050, 태백시,070002, 66세,2021,800,378,422,89.6,798,378,420,90
32050, 태백시,070003, 67세,2021,672,328,344,95.3,671,328,343,95.6
32050, 태백시,070004, 68세,2021,626,307,319,96.2,626,307,319,96.2
32050, 태백시,070005, 69세,2021,668,307,361,85,668,307,361,85
32050, 태백시,075,70~74세,2021,2611,1149,1462,78.6,2607,1146,1461,78.4
32050, 태백시,075001, 70세,2021,485,222,263,84.4,484,221,263,84
32050, 태백시,075002, 71세,2021,542,225,317,71,541,224,317,70.7
32050, 태백시,075003, 72세,2021,545,254,291,87.3,544,253,291,86.9
32050, 태백시,075004, 73세,2021,525,231,294,78.6,524,231,293,78.8
32050, 태백시,075005, 74세,2021,514,217,297,73.1,514,217,297,73.1
32050, 태백시,080,75~79세,2021,2153,941,1212,77.6,2151,939,1212,77.5
32050, 태백시,080001, 75세,2021,405,169,236,71.6,405,169,236,71.6
32050, 태백시,080002, 76세,2021,441,196,245,80,440,195,245,79.6
32050, 태백시,080003, 77세,2021,438,182,256,71.1,437,181,256,70.7
32050, 태백시,080004, 78세,2021,422,202,220,91.8,422,202,220,91.8
32050, 태백시,080005, 79세,2021,447,192,255,75.3,447,192,255,75.3
32050, 태백시,085,80~84세,2021,1467,556,911,61,1466,555,911,60.9
32050, 태백시,085001, 80세,2021,345,152,193,78.8,345,152,193,78.8
32050, 태백시,085002, 81세,2021,340,114,226,50.4,339,113,226,50
32050, 태백시,085003, 82세,2021,319,117,202,57.9,319,117,202,57.9
32050, 태백시,085004, 83세,2021,241,85,156,54.5,241,85,156,54.5
32050, 태백시,085005, 84세,2021,222,88,134,65.7,222,88,134,65.7
32050, 태백시,090,85~89세,2021,612,170,442,38.5,611,170,441,38.5
32050, 태백시,090001, 85세,2021,180,54,126,42.9,180,54,126,42.9
32050, 태백시,090002, 86세,2021,174,51,123,41.5,174,51,123,41.5
32050, 태백시,090003, 87세,2021,114,29,85,34.1,114,29,85,34.1
32050, 태백시,090004, 88세,2021,96,25,71,35.2,95,25,70,35.7
32050, 태백시,090005, 89세,2021,48,11,37,29.7,48,11,37,29.7
32050, 태백시,095,90~94세,2021,162,27,135,20,162,27,135,20
32050, 태백시,095001, 90세,2021,41,X,37,10.8,41,X,37,10.8
32050, 태백시,095002, 91세,2021,49,9,40,22.5,49,9,40,22.5
32050, 태백시,095003, 92세,2021,28,5,23,21.7,28,5,23,21.7
32050, 태백시,095004, 93세,2021,26,7,19,36.8,26,7,19,36.8
32050, 태백시,095005, 94세,2021,18,X,16,12.5,18,X,16,12.5
32050, 태백시,100,95~99세,2021,44,5,39,12.8,44,5,39,12.8
32050, 태백시,100001, 95세,2021,17,X,16,6.3,17,X,16,6.3
32050, 태백시,100002, 96세,2021,9,X,7,28.6,9,X,7,28.6
32050, 태백시,100003, 97세,2021,9,X,9,0,9,X,9,0
32050, 태백시,100004, 98세,2021,X,X,X,50,X,X,X,50
32050, 태백시,100005, 99세,2021,6,X,5,20,6,X,5,20
32050, 태백시,101,100세이상,2021,X,X,X,0,X,X,X,0
32050, 태백시,102,15세미만,2021,4123,2131,1992,107,4110,2126,1984,107.2
32050, 태백시,103,15~64세,2021,25706,13715,11991,114.4,25368,13628,11740,116.1
32050, 태백시,104,65세이상,2021,10566,4559,6007,75.9,10554,4553,6001,75.9
32050, 태백시,086,85세이상,2021,819,202,617,32.7,818,202,616,32.8
32050, 태백시,126,평균연령,2021,49.2,47.5,50.9,,49.3,47.5,51.1,
32050, 태백시,127,중위연령,2021,52.5,51,54.4,,52.6,51,54.7,
32060, 속초시,000,합계,2021,80362,40149,40213,99.8,78898,39307,39591,99.3
32060, 속초시,005,0~4세,2021,2305,1208,1097,110.1,2296,1201,1095,109.7
32060, 속초시,005001, 0세,2021,392,208,184,113,390,207,183,113.1
32060, 속초시,005002, 1세,2021,457,237,220,107.7,455,235,220,106.8
32060, 속초시,005003, 2세,2021,462,232,230,100.9,461,231,230,100.4
32060, 속초시,005004, 3세,2021,475,237,238,99.6,474,236,238,99.2
32060, 속초시,005005, 4세,2021,519,294,225,130.7,516,292,224,130.4
32060, 속초시,010,5~9세,2021,3323,1644,1679,97.9,3315,1641,1674,98
32060, 속초시,010001, 5세,2021,638,332,306,108.5,636,331,305,108.5
32060, 속초시,010002, 6세,2021,708,331,377,87.8,707,330,377,87.5
32060, 속초시,010003, 7세,2021,634,324,310,104.5,631,323,308,104.9
32060, 속초시,010004, 8세,2021,623,301,322,93.5,623,301,322,93.5
32060, 속초시,010005, 9세,2021,720,356,364,97.8,718,356,362,98.3
32060, 속초시,015,10~14세,2021,3444,1773,1671,106.1,3439,1771,1668,106.2
32060, 속초시,015001, 10세,2021,694,361,333,108.4,692,361,331,109.1
32060, 속초시,015002, 11세,2021,704,351,353,99.4,703,351,352,99.7
32060, 속초시,015003, 12세,2021,648,323,325,99.4,648,323,325,99.4
32060, 속초시,015004, 13세,2021,686,351,335,104.8,685,350,335,104.5
32060, 속초시,015005, 14세,2021,712,387,325,119.1,711,386,325,118.8
32060, 속초시,020,15~19세,2021,3102,1631,1471,110.9,3093,1626,1467,110.8
32060, 속초시,020001, 15세,2021,646,318,328,97,644,316,328,96.3
32060, 속초시,020002, 16세,2021,645,321,324,99.1,644,320,324,98.8
32060, 속초시,020003, 17세,2021,742,386,356,108.4,740,385,355,108.5
32060, 속초시,020004, 18세,2021,634,349,285,122.5,633,349,284,122.9
32060, 속초시,020005, 19세,2021,435,257,178,144.4,432,256,176,145.5
32060, 속초시,025,20~24세,2021,3463,2047,1416,144.6,3320,1971,1349,146.1
32060, 속초시,025001, 20세,2021,604,393,211,186.3,602,392,210,186.7
32060, 속초시,025002, 21세,2021,724,473,251,188.4,703,463,240,192.9
32060, 속초시,025003, 22세,2021,653,375,278,134.9,628,362,266,136.1
32060, 속초시,025004, 23세,2021,714,411,303,135.6,676,391,285,137.2
32060, 속초시,025005, 24세,2021,768,395,373,105.9,711,363,348,104.3
32060, 속초시,030,25~29세,2021,4471,2557,1914,133.6,4170,2371,1799,131.8
32060, 속초시,030001, 25세,2021,871,494,377,131,807,457,350,130.6
32060, 속초시,030002, 26세,2021,890,530,360,147.2,824,489,335,146
32060, 속초시,030003, 27세,2021,888,495,393,126,827,453,374,121.1
32060, 속초시,030004, 28세,2021,849,493,356,138.5,804,461,343,134.4
32060, 속초시,030005, 29세,2021,973,545,428,127.3,908,511,397,128.7
32060, 속초시,035,30~34세,2021,4305,2440,1865,130.8,4056,2295,1761,130.3
32060, 속초시,035001, 30세,2021,903,514,389,132.1,850,487,363,134.2
32060, 속초시,035002, 31세,2021,839,506,333,152,786,473,313,151.1
32060, 속초시,035003, 32세,2021,857,487,370,131.6,798,452,346,130.6
32060, 속초시,035004, 33세,2021,862,482,380,126.8,819,456,363,125.6
32060, 속초시,035005, 34세,2021,844,451,393,114.8,803,427,376,113.6
32060, 속초시,040,35~39세,2021,4845,2559,2286,111.9,4655,2430,2225,109.2
32060, 속초시,040001, 35세,2021,822,433,389,111.3,784,404,380,106.3
32060, 속초시,040002, 36세,2021,858,450,408,110.3,819,424,395,107.3
32060, 속초시,040003, 37세,2021,945,546,399,136.8,908,520,388,134
32060, 속초시,040004, 38세,2021,1045,543,502,108.2,1011,524,487,107.6
32060, 속초시,040005, 39세,2021,1175,587,588,99.8,1133,558,575,97
32060, 속초시,045,40~44세,2021,5725,2914,2811,103.7,5586,2827,2759,102.5
32060, 속초시,045001, 40세,2021,1190,636,554,114.8,1150,613,537,114.2
32060, 속초시,045002, 41세,2021,1174,578,596,97,1139,557,582,95.7
32060, 속초시,045003, 42세,2021,1138,568,570,99.6,1120,555,565,98.2
32060, 속초시,045004, 43세,2021,1098,558,540,103.3,1074,543,531,102.3
32060, 속초시,045005, 44세,2021,1125,574,551,104.2,1103,559,544,102.8
32060, 속초시,050,45~49세,2021,6325,3167,3158,100.3,6209,3086,3123,98.8
32060, 속초시,050001, 45세,2021,1082,551,531,103.8,1054,533,521,102.3
32060, 속초시,050002, 46세,2021,1170,567,603,94,1139,546,593,92.1
32060, 속초시,050003, 47세,2021,1345,698,647,107.9,1322,678,644,105.3
32060, 속초시,050004, 48세,2021,1327,649,678,95.7,1305,633,672,94.2
32060, 속초시,050005, 49세,2021,1401,702,699,100.4,1389,696,693,100.4
32060, 속초시,055,50~54세,2021,7621,3756,3865,97.2,7543,3718,3825,97.2
32060, 속초시,055001, 50세,2021,1496,735,761,96.6,1483,728,755,96.4
32060, 속초시,055002, 51세,2021,1551,795,756,105.2,1534,786,748,105.1
32060, 속초시,055003, 52세,2021,1566,790,776,101.8,1552,783,769,101.8
32060, 속초시,055004, 53세,2021,1600,757,843,89.8,1586,750,836,89.7
32060, 속초시,055005, 54세,2021,1408,679,729,93.1,1388,671,717,93.6
32060, 속초시,060,55~59세,2021,7177,3614,3563,101.4,7096,3585,3511,102.1
32060, 속초시,060001, 55세,2021,1370,733,637,115.1,1356,729,627,116.3
32060, 속초시,060002, 56세,2021,1384,673,711,94.7,1365,664,701,94.7
32060, 속초시,060003, 57세,2021,1411,713,698,102.1,1393,706,687,102.8
32060, 속초시,060004, 58세,2021,1566,762,804,94.8,1543,755,788,95.8
32060, 속초시,060005, 59세,2021,1446,733,713,102.8,1439,731,708,103.2
32060, 속초시,065,60~64세,2021,7850,3792,4058,93.4,7780,3765,4015,93.8
32060, 속초시,065001, 60세,2021,1720,796,924,86.1,1712,796,916,86.9
32060, 속초시,065002, 61세,2021,1713,807,906,89.1,1688,797,891,89.5
32060, 속초시,065003, 62세,2021,1524,732,792,92.4,1509,727,782,93
32060, 속초시,065004, 63세,2021,1473,738,735,100.4,1463,734,729,100.7
32060, 속초시,065005, 64세,2021,1420,719,701,102.6,1408,711,697,102
32060, 속초시,070,65~69세,2021,5710,2829,2881,98.2,5685,2818,2867,98.3
32060, 속초시,070001, 65세,2021,1269,657,612,107.4,1262,653,609,107.2
32060, 속초시,070002, 66세,2021,1367,693,674,102.8,1362,691,671,103
32060, 속초시,070003, 67세,2021,1195,572,623,91.8,1188,569,619,91.9
32060, 속초시,070004, 68세,2021,908,449,459,97.8,904,448,456,98.2
32060, 속초시,070005, 69세,2021,971,458,513,89.3,969,457,512,89.3
32060, 속초시,075,70~74세,2021,3579,1609,1970,81.7,3559,1597,1962,81.4
32060, 속초시,075001, 70세,2021,627,257,370,69.5,617,252,365,69
32060, 속초시,075002, 71세,2021,701,322,379,85,699,321,378,84.9
32060, 속초시,075003, 72세,2021,748,359,389,92.3,745,357,388,92
32060, 속초시,075004, 73세,2021,745,336,409,82.2,741,332,409,81.2
32060, 속초시,075005, 74세,2021,758,335,423,79.2,757,335,422,79.4
32060, 속초시,080,75~79세,2021,3160,1329,1831,72.6,3150,1328,1822,72.9
32060, 속초시,080001, 75세,2021,639,286,353,81,637,286,351,81.5
32060, 속초시,080002, 76세,2021,668,276,392,70.4,667,276,391,70.6
32060, 속초시,080003, 77세,2021,614,237,377,62.9,612,237,375,63.2
32060, 속초시,080004, 78세,2021,608,273,335,81.5,606,273,333,82
32060, 속초시,080005, 79세,2021,631,257,374,68.7,628,256,372,68.8
32060, 속초시,085,80~84세,2021,2278,849,1429,59.4,2273,847,1426,59.4
32060, 속초시,085001, 80세,2021,550,214,336,63.7,549,214,335,63.9
32060, 속초시,085002, 81세,2021,523,210,313,67.1,523,210,313,67.1
32060, 속초시,085003, 82세,2021,431,150,281,53.4,430,150,280,53.6
32060, 속초시,085004, 83세,2021,420,155,265,58.5,418,154,264,58.3
32060, 속초시,085005, 84세,2021,354,120,234,51.3,353,119,234,50.9
32060, 속초시,090,85~89세,2021,1078,328,750,43.7,1072,327,745,43.9
32060, 속초시,090001, 85세,2021,317,114,203,56.2,316,114,202,56.4
32060, 속초시,090002, 86세,2021,251,78,173,45.1,250,78,172,45.3
32060, 속초시,090003, 87세,2021,220,70,150,46.7,217,69,148,46.6
32060, 속초시,090004, 88세,2021,159,40,119,33.6,158,40,118,33.9
32060, 속초시,090005, 89세,2021,131,26,105,24.8,131,26,105,24.8
32060, 속초시,095,90~94세,2021,479,82,397,20.7,479,82,397,20.7
32060, 속초시,095001, 90세,2021,102,17,85,20,102,17,85,20
32060, 속초시,095002, 91세,2021,125,25,100,25,125,25,100,25
32060, 속초시,095003, 92세,2021,117,19,98,19.4,117,19,98,19.4
32060, 속초시,095004, 93세,2021,73,15,58,25.9,73,15,58,25.9
32060, 속초시,095005, 94세,2021,62,6,56,10.7,62,6,56,10.7
32060, 속초시,100,95~99세,2021,111,20,91,22,111,20,91,22
32060, 속초시,100001, 95세,2021,38,5,33,15.2,38,5,33,15.2
32060, 속초시,100002, 96세,2021,29,X,26,11.5,29,X,26,11.5
32060, 속초시,100003, 97세,2021,21,X,19,10.5,21,X,19,10.5
32060, 속초시,100004, 98세,2021,16,8,8,100,16,8,8,100
32060, 속초시,100005, 99세,2021,7,X,5,40,7,X,5,40
32060, 속초시,101,100세이상,2021,11,X,10,10,11,X,10,10
32060, 속초시,102,15세미만,2021,9072,4625,4447,104,9050,4613,4437,104
32060, 속초시,103,15~64세,2021,54884,28477,26407,107.8,53508,27674,25834,107.1
32060, 속초시,104,65세이상,2021,16406,7047,9359,75.3,16340,7020,9320,75.3
32060, 속초시,086,85세이상,2021,1679,431,1248,34.5,1673,430,1243,34.6
32060, 속초시,126,평균연령,2021,46.4,44.6,48.1,,46.5,44.8,48.2,
32060, 속초시,127,중위연령,2021,49.2,47.3,51,,49.5,47.7,51.2,
32070, 삼척시,000,합계,2021,64464,33293,31171,106.8,63588,32793,30795,106.5
32070, 삼척시,005,0~4세,2021,1548,772,776,99.5,1548,772,776,99.5
32070, 삼척시,005001, 0세,2021,294,143,151,94.7,294,143,151,94.7
32070, 삼척시,005002, 1세,2021,300,157,143,109.8,300,157,143,109.8
32070, 삼척시,005003, 2세,2021,318,135,183,73.8,318,135,183,73.8
32070, 삼척시,005004, 3세,2021,311,168,143,117.5,311,168,143,117.5
32070, 삼척시,005005, 4세,2021,325,169,156,108.3,325,169,156,108.3
32070, 삼척시,010,5~9세,2021,1978,1018,960,106,1977,1018,959,106.2
32070, 삼척시,010001, 5세,2021,345,174,171,101.8,345,174,171,101.8
32070, 삼척시,010002, 6세,2021,371,195,176,110.8,371,195,176,110.8
32070, 삼척시,010003, 7세,2021,393,206,187,110.2,393,206,187,110.2
32070, 삼척시,010004, 8세,2021,396,200,196,102,395,200,195,102.6
32070, 삼척시,010005, 9세,2021,473,243,230,105.7,473,243,230,105.7
32070, 삼척시,015,10~14세,2021,2248,1156,1092,105.9,2248,1156,1092,105.9
32070, 삼척시,015001, 10세,2021,448,238,210,113.3,448,238,210,113.3
32070, 삼척시,015002, 11세,2021,435,214,221,96.8,435,214,221,96.8
32070, 삼척시,015003, 12세,2021,446,234,212,110.4,446,234,212,110.4
32070, 삼척시,015004, 13세,2021,452,237,215,110.2,452,237,215,110.2
32070, 삼척시,015005, 14세,2021,467,233,234,99.6,467,233,234,99.6
32070, 삼척시,020,15~19세,2021,3128,1749,1379,126.8,3121,1745,1376,126.8
32070, 삼척시,020001, 15세,2021,434,239,195,122.6,434,239,195,122.6
32070, 삼척시,020002, 16세,2021,461,247,214,115.4,460,247,213,116
32070, 삼척시,020003, 17세,2021,488,243,245,99.2,488,243,245,99.2
32070, 삼척시,020004, 18세,2021,618,339,279,121.5,618,339,279,121.5
32070, 삼척시,020005, 19세,2021,1127,681,446,152.7,1121,677,444,152.5
32070, 삼척시,025,20~24세,2021,5604,3349,2255,148.5,5489,3272,2217,147.6
32070, 삼척시,025001, 20세,2021,1053,531,522,101.7,1041,520,521,99.8
32070, 삼척시,025002, 21세,2021,1114,556,558,99.6,1102,547,555,98.6
32070, 삼척시,025003, 22세,2021,1261,728,533,136.6,1240,720,520,138.5
32070, 삼척시,025004, 23세,2021,1143,801,342,234.2,1108,777,331,234.7
32070, 삼척시,025005, 24세,2021,1033,733,300,244.3,998,708,290,244.1
32070, 삼척시,030,25~29세,2021,3061,1909,1152,165.7,2885,1794,1091,164.4
32070, 삼척시,030001, 25세,2021,800,567,233,243.3,771,545,226,241.2
32070, 삼척시,030002, 26세,2021,637,415,222,186.9,605,395,210,188.1
32070, 삼척시,030003, 27세,2021,575,360,215,167.4,545,341,204,167.2
32070, 삼척시,030004, 28세,2021,520,286,234,122.2,477,259,218,118.8
32070, 삼척시,030005, 29세,2021,529,281,248,113.3,487,254,233,109
32070, 삼척시,035,30~34세,2021,2444,1365,1079,126.5,2283,1262,1021,123.6
32070, 삼척시,035001, 30세,2021,504,276,228,121.1,475,261,214,122
32070, 삼척시,035002, 31세,2021,493,297,196,151.5,455,276,179,154.2
32070, 삼척시,035003, 32세,2021,468,267,201,132.8,435,243,192,126.6
32070, 삼척시,035004, 33세,2021,478,249,229,108.7,448,231,217,106.5
32070, 삼척시,035005, 34세,2021,501,276,225,122.7,470,251,219,114.6
32070, 삼척시,040,35~39세,2021,2939,1583,1356,116.7,2828,1523,1305,116.7
32070, 삼척시,040001, 35세,2021,472,253,219,115.5,449,242,207,116.9
32070, 삼척시,040002, 36세,2021,552,298,254,117.3,531,287,244,117.6
32070, 삼척시,040003, 37세,2021,554,308,246,125.2,535,295,240,122.9
32070, 삼척시,040004, 38세,2021,648,343,305,112.5,619,331,288,114.9
32070, 삼척시,040005, 39세,2021,713,381,332,114.8,694,368,326,112.9
32070, 삼척시,045,40~44세,2021,3717,1988,1729,115,3623,1932,1691,114.3
32070, 삼척시,045001, 40세,2021,704,388,316,122.8,682,375,307,122.1
32070, 삼척시,045002, 41세,2021,763,385,378,101.9,736,369,367,100.5
32070, 삼척시,045003, 42세,2021,743,404,339,119.2,723,391,332,117.8
32070, 삼척시,045004, 43세,2021,735,382,353,108.2,720,375,345,108.7
32070, 삼척시,045005, 44세,2021,772,429,343,125.1,762,422,340,124.1
32070, 삼척시,050,45~49세,2021,4512,2512,2000,125.6,4438,2481,1957,126.8
32070, 삼척시,050001, 45세,2021,782,409,373,109.7,759,398,361,110.2
32070, 삼척시,050002, 46세,2021,894,484,410,118,880,481,399,120.6
32070, 삼척시,050003, 47세,2021,974,553,421,131.4,961,548,413,132.7
32070, 삼척시,050004, 48세,2021,964,559,405,138,956,556,400,139
32070, 삼척시,050005, 49세,2021,898,507,391,129.7,882,498,384,129.7
32070, 삼척시,055,50~54세,2021,5265,2918,2347,124.3,5211,2893,2318,124.8
32070, 삼척시,055001, 50세,2021,1057,596,461,129.3,1043,591,452,130.8
32070, 삼척시,055002, 51세,2021,1029,575,454,126.7,1021,570,451,126.4
32070, 삼척시,055003, 52세,2021,1079,600,479,125.3,1069,597,472,126.5
32070, 삼척시,055004, 53세,2021,1099,613,486,126.1,1088,606,482,125.7
32070, 삼척시,055005, 54세,2021,1001,534,467,114.3,990,529,461,114.8
32070, 삼척시,060,55~59세,2021,5324,2815,2509,112.2,5281,2800,2481,112.9
32070, 삼척시,060001, 55세,2021,1058,575,483,119,1047,572,475,120.4
32070, 삼척시,060002, 56세,2021,978,490,488,100.4,971,489,482,101.5
32070, 삼척시,060003, 57세,2021,1033,554,479,115.7,1025,552,473,116.7
32070, 삼척시,060004, 58세,2021,1061,564,497,113.5,1050,560,490,114.3
32070, 삼척시,060005, 59세,2021,1194,632,562,112.5,1188,627,561,111.8
32070, 삼척시,065,60~64세,2021,6428,3242,3186,101.8,6407,3233,3174,101.9
32070, 삼척시,065001, 60세,2021,1438,724,714,101.4,1436,724,712,101.7
32070, 삼척시,065002, 61세,2021,1380,702,678,103.5,1376,699,677,103.2
32070, 삼척시,065003, 62세,2021,1306,661,645,102.5,1300,658,642,102.5
32070, 삼척시,065004, 63세,2021,1120,575,545,105.5,1115,574,541,106.1
32070, 삼척시,065005, 64세,2021,1184,580,604,96,1180,578,602,96
32070, 삼척시,070,65~69세,2021,4977,2472,2505,98.7,4966,2468,2498,98.8
32070, 삼척시,070001, 65세,2021,1086,529,557,95,1079,527,552,95.5
32070, 삼척시,070002, 66세,2021,1105,546,559,97.7,1105,546,559,97.7
32070, 삼척시,070003, 67세,2021,941,471,470,100.2,938,470,468,100.4
32070, 삼척시,070004, 68세,2021,887,442,445,99.3,887,442,445,99.3
32070, 삼척시,070005, 69세,2021,958,484,474,102.1,957,483,474,101.9
32070, 삼척시,075,70~74세,2021,3598,1694,1904,89,3593,1694,1899,89.2
32070, 삼척시,075001, 70세,2021,616,278,338,82.2,615,278,337,82.5
32070, 삼척시,075002, 71세,2021,744,346,398,86.9,744,346,398,86.9
32070, 삼척시,075003, 72세,2021,780,389,391,99.5,778,389,389,100
32070, 삼척시,075004, 73세,2021,791,356,435,81.8,790,356,434,82
32070, 삼척시,075005, 74세,2021,667,325,342,95,666,325,341,95.3
32070, 삼척시,080,75~79세,2021,3218,1321,1897,69.6,3217,1321,1896,69.7
32070, 삼척시,080001, 75세,2021,554,257,297,86.5,554,257,297,86.5
32070, 삼척시,080002, 76세,2021,631,278,353,78.8,631,278,353,78.8
32070, 삼척시,080003, 77세,2021,656,265,391,67.8,656,265,391,67.8
32070, 삼척시,080004, 78세,2021,694,279,415,67.2,693,279,414,67.4
32070, 삼척시,080005, 79세,2021,683,242,441,54.9,683,242,441,54.9
32070, 삼척시,085,80~84세,2021,2509,893,1616,55.3,2507,892,1615,55.2
32070, 삼척시,085001, 80세,2021,598,214,384,55.7,597,213,384,55.5
32070, 삼척시,085002, 81세,2021,560,220,340,64.7,559,220,339,64.9
32070, 삼척시,085003, 82세,2021,512,185,327,56.6,512,185,327,56.6
32070, 삼척시,085004, 83세,2021,459,157,302,52,459,157,302,52
32070, 삼척시,085005, 84세,2021,380,117,263,44.5,380,117,263,44.5
32070, 삼척시,090,85~89세,2021,1411,423,988,42.8,1411,423,988,42.8
32070, 삼척시,090001, 85세,2021,381,128,253,50.6,381,128,253,50.6
32070, 삼척시,090002, 86세,2021,329,105,224,46.9,329,105,224,46.9
32070, 삼척시,090003, 87세,2021,275,80,195,41,275,80,195,41
32070, 삼척시,090004, 88세,2021,203,54,149,36.2,203,54,149,36.2
32070, 삼척시,090005, 89세,2021,223,56,167,33.5,223,56,167,33.5
32070, 삼척시,095,90~94세,2021,453,102,351,29.1,453,102,351,29.1
32070, 삼척시,095001, 90세,2021,139,40,99,40.4,139,40,99,40.4
32070, 삼척시,095002, 91세,2021,114,26,88,29.5,114,26,88,29.5
32070, 삼척시,095003, 92세,2021,98,21,77,27.3,98,21,77,27.3
32070, 삼척시,095004, 93세,2021,58,8,50,16,58,8,50,16
32070, 삼척시,095005, 94세,2021,44,7,37,18.9,44,7,37,18.9
32070, 삼척시,100,95~99세,2021,89,12,77,15.6,89,12,77,15.6
32070, 삼척시,100001, 95세,2021,37,5,32,15.6,37,5,32,15.6
32070, 삼척시,100002, 96세,2021,24,X,21,14.3,24,X,21,14.3
32070, 삼척시,100003, 97세,2021,13,X,9,44.4,13,X,9,44.4
32070, 삼척시,100004, 98세,2021,11,X,11,0,11,X,11,0
32070, 삼척시,100005, 99세,2021,X,X,X,0,X,X,X,0
32070, 삼척시,101,100세이상,2021,13,X,13,0,13,X,13,0
32070, 삼척시,102,15세미만,2021,5774,2946,2828,104.2,5773,2946,2827,104.2
32070, 삼척시,103,15~64세,2021,42422,23430,18992,123.4,41566,22935,18631,123.1
32070, 삼척시,104,65세이상,2021,16268,6917,9351,74,16249,6912,9337,74
32070, 삼척시,086,85세이상,2021,1966,537,1429,37.6,1966,537,1429,37.6
32070, 삼척시,126,평균연령,2021,47.9,45.7,50.2,,48,45.9,50.3,
32070, 삼척시,127,중위연령,2021,51,48.6,53.8,,51.3,48.9,54.1,
32310, 홍천군,000,합계,2021,65658,33711,31947,105.5,64482,33098,31384,105.5
32310, 홍천군,005,0~4세,2021,1523,766,757,101.2,1518,763,755,101.1
32310, 홍천군,005001, 0세,2021,275,145,130,111.5,274,145,129,112.4
32310, 홍천군,005002, 1세,2021,292,138,154,89.6,292,138,154,89.6
32310, 홍천군,005003, 2세,2021,302,153,149,102.7,300,152,148,102.7
32310, 홍천군,005004, 3세,2021,314,157,157,100,314,157,157,100
32310, 홍천군,005005, 4세,2021,340,173,167,103.6,338,171,167,102.4
32310, 홍천군,010,5~9세,2021,2023,1051,972,108.1,2017,1045,972,107.5
32310, 홍천군,010001, 5세,2021,387,222,165,134.5,385,220,165,133.3
32310, 홍천군,010002, 6세,2021,407,216,191,113.1,406,215,191,112.6
32310, 홍천군,010003, 7세,2021,363,183,180,101.7,362,182,180,101.1
32310, 홍천군,010004, 8세,2021,405,206,199,103.5,404,205,199,103
32310, 홍천군,010005, 9세,2021,461,224,237,94.5,460,223,237,94.1
32310, 홍천군,015,10~14세,2021,2300,1148,1152,99.7,2291,1142,1149,99.4
32310, 홍천군,015001, 10세,2021,419,205,214,95.8,419,205,214,95.8
32310, 홍천군,015002, 11세,2021,468,227,241,94.2,466,225,241,93.4
32310, 홍천군,015003, 12세,2021,441,230,211,109,438,228,210,108.6
32310, 홍천군,015004, 13세,2021,474,234,240,97.5,473,233,240,97.1
32310, 홍천군,015005, 14세,2021,498,252,246,102.4,495,251,244,102.9
32310, 홍천군,020,15~19세,2021,2387,1186,1201,98.8,2383,1185,1198,98.9
32310, 홍천군,020001, 15세,2021,442,226,216,104.6,441,226,215,105.1
32310, 홍천군,020002, 16세,2021,500,242,258,93.8,500,242,258,93.8
32310, 홍천군,020003, 17세,2021,563,270,293,92.2,563,270,293,92.2
32310, 홍천군,020004, 18세,2021,537,262,275,95.3,536,262,274,95.6
32310, 홍천군,020005, 19세,2021,345,186,159,117,343,185,158,117.1
32310, 홍천군,025,20~24세,2021,2733,1711,1022,167.4,2668,1678,990,169.5
32310, 홍천군,025001, 20세,2021,476,324,152,213.2,472,322,150,214.7
32310, 홍천군,025002, 21세,2021,498,315,183,172.1,491,314,177,177.4
32310, 홍천군,025003, 22세,2021,539,318,221,143.9,533,313,220,142.3
32310, 홍천군,025004, 23세,2021,579,351,228,153.9,557,336,221,152
32310, 홍천군,025005, 24세,2021,641,403,238,169.3,615,393,222,177
32310, 홍천군,030,25~29세,2021,3175,1956,1219,160.5,2975,1848,1127,164
32310, 홍천군,030001, 25세,2021,622,371,251,147.8,594,357,237,150.6
32310, 홍천군,030002, 26세,2021,612,405,207,195.7,577,388,189,205.3
32310, 홍천군,030003, 27세,2021,654,399,255,156.5,611,380,231,164.5
32310, 홍천군,030004, 28세,2021,638,393,245,160.4,589,362,227,159.5
32310, 홍천군,030005, 29세,2021,649,388,261,148.7,604,361,243,148.6
32310, 홍천군,035,30~34세,2021,2818,1598,1220,131,2609,1476,1133,130.3
32310, 홍천군,035001, 30세,2021,612,352,260,135.4,565,324,241,134.4
32310, 홍천군,035002, 31세,2021,585,350,235,148.9,540,323,217,148.8
32310, 홍천군,035003, 32세,2021,561,325,236,137.7,507,289,218,132.6
32310, 홍천군,035004, 33세,2021,517,272,245,111,488,259,229,113.1
32310, 홍천군,035005, 34세,2021,543,299,244,122.5,509,281,228,123.2
32310, 홍천군,040,35~39세,2021,3010,1623,1387,117,2805,1500,1305,114.9
32310, 홍천군,040001, 35세,2021,547,313,234,133.8,511,291,220,132.3
32310, 홍천군,040002, 36세,2021,567,302,265,114,519,277,242,114.5
32310, 홍천군,040003, 37세,2021,549,297,252,117.9,510,276,234,117.9
32310, 홍천군,040004, 38세,2021,621,333,288,115.6,580,304,276,110.1
32310, 홍천군,040005, 39세,2021,726,378,348,108.6,685,352,333,105.7
32310, 홍천군,045,40~44세,2021,3495,1859,1636,113.6,3380,1789,1591,112.4
32310, 홍천군,045001, 40세,2021,700,393,307,128,674,376,298,126.2
32310, 홍천군,045002, 41세,2021,753,391,362,108,723,371,352,105.4
32310, 홍천군,045003, 42세,2021,652,334,318,105,626,318,308,103.2
32310, 홍천군,045004, 43세,2021,644,349,295,118.3,628,340,288,118.1
32310, 홍천군,045005, 44세,2021,746,392,354,110.7,729,384,345,111.3
32310, 홍천군,050,45~49세,2021,4155,2224,1931,115.2,4086,2198,1888,116.4
32310, 홍천군,050001, 45세,2021,714,374,340,110,700,369,331,111.5
32310, 홍천군,050002, 46세,2021,756,415,341,121.7,744,411,333,123.4
32310, 홍천군,050003, 47세,2021,885,480,405,118.5,870,477,393,121.4
32310, 홍천군,050004, 48세,2021,915,489,426,114.8,901,486,415,117.1
32310, 홍천군,050005, 49세,2021,885,466,419,111.2,871,455,416,109.4
32310, 홍천군,055,50~54세,2021,5306,2767,2539,109,5225,2740,2485,110.3
32310, 홍천군,055001, 50세,2021,965,516,449,114.9,951,509,442,115.2
32310, 홍천군,055002, 51세,2021,959,510,449,113.6,943,503,440,114.3
32310, 홍천군,055003, 52세,2021,1110,569,541,105.2,1090,564,526,107.2
32310, 홍천군,055004, 53세,2021,1175,618,557,111,1155,614,541,113.5
32310, 홍천군,055005, 54세,2021,1097,554,543,102,1086,550,536,102.6
32310, 홍천군,060,55~59세,2021,6326,3333,2993,111.4,6233,3294,2939,112.1
32310, 홍천군,060001, 55세,2021,1187,629,558,112.7,1163,620,543,114.2
32310, 홍천군,060002, 56세,2021,1103,554,549,100.9,1084,547,537,101.9
32310, 홍천군,060003, 57세,2021,1274,710,564,125.9,1251,702,549,127.9
32310, 홍천군,060004, 58세,2021,1318,688,630,109.2,1309,684,625,109.4
32310, 홍천군,060005, 59세,2021,1444,752,692,108.7,1426,741,685,108.2
32310, 홍천군,065,60~64세,2021,8093,4130,3963,104.2,8028,4101,3927,104.4
32310, 홍천군,065001, 60세,2021,1752,868,884,98.2,1735,861,874,98.5
32310, 홍천군,065002, 61세,2021,1565,765,800,95.6,1554,758,796,95.2
32310, 홍천군,065003, 62세,2021,1563,812,751,108.1,1549,806,743,108.5
32310, 홍천군,065004, 63세,2021,1614,831,783,106.1,1597,825,772,106.9
32310, 홍천군,065005, 64세,2021,1599,854,745,114.6,1593,851,742,114.7
32310, 홍천군,070,65~69세,2021,6236,3300,2936,112.4,6208,3287,2921,112.5
32310, 홍천군,070001, 65세,2021,1434,747,687,108.7,1425,742,683,108.6
32310, 홍천군,070002, 66세,2021,1387,732,655,111.8,1380,731,649,112.6
32310, 홍천군,070003, 67세,2021,1169,621,548,113.3,1164,618,546,113.2
32310, 홍천군,070004, 68세,2021,954,490,464,105.6,949,487,462,105.4
32310, 홍천군,070005, 69세,2021,1292,710,582,122,1290,709,581,122
32310, 홍천군,075,70~74세,2021,3578,1821,1757,103.6,3567,1817,1750,103.8
32310, 홍천군,075001, 70세,2021,635,319,316,100.9,634,319,315,101.3
32310, 홍천군,075002, 71세,2021,687,357,330,108.2,684,356,328,108.5
32310, 홍천군,075003, 72세,2021,674,353,321,110,672,352,320,110
32310, 홍천군,075004, 73세,2021,785,385,400,96.3,782,383,399,96
32310, 홍천군,075005, 74세,2021,797,407,390,104.4,795,407,388,104.9
32310, 홍천군,080,75~79세,2021,3352,1465,1887,77.6,3345,1462,1883,77.6
32310, 홍천군,080001, 75세,2021,688,322,366,88,687,322,365,88.2
32310, 홍천군,080002, 76세,2021,639,299,340,87.9,636,298,338,88.2
32310, 홍천군,080003, 77세,2021,626,277,349,79.4,625,276,349,79.1
32310, 홍천군,080004, 78세,2021,653,276,377,73.2,651,275,376,73.1
32310, 홍천군,080005, 79세,2021,746,291,455,64,746,291,455,64
32310, 홍천군,085,80~84세,2021,2981,1184,1797,65.9,2978,1184,1794,66
32310, 홍천군,085001, 80세,2021,667,291,376,77.4,666,291,375,77.6
32310, 홍천군,085002, 81세,2021,623,249,374,66.6,623,249,374,66.6
32310, 홍천군,085003, 82세,2021,607,225,382,58.9,606,225,381,59.1
32310, 홍천군,085004, 83세,2021,586,233,353,66,585,233,352,66.2
32310, 홍천군,085005, 84세,2021,498,186,312,59.6,498,186,312,59.6
32310, 홍천군,090,85~89세,2021,1519,444,1075,41.3,1518,444,1074,41.3
32310, 홍천군,090001, 85세,2021,409,151,258,58.5,408,151,257,58.8
32310, 홍천군,090002, 86세,2021,367,103,264,39,367,103,264,39
32310, 홍천군,090003, 87세,2021,321,84,237,35.4,321,84,237,35.4
32310, 홍천군,090004, 88세,2021,243,66,177,37.3,243,66,177,37.3
32310, 홍천군,090005, 89세,2021,179,40,139,28.8,179,40,139,28.8
32310, 홍천군,095,90~94세,2021,507,112,395,28.4,507,112,395,28.4
32310, 홍천군,095001, 90세,2021,150,32,118,27.1,150,32,118,27.1
32310, 홍천군,095002, 91세,2021,141,35,106,33,141,35,106,33
32310, 홍천군,095003, 92세,2021,89,19,70,27.1,89,19,70,27.1
32310, 홍천군,095004, 93세,2021,73,17,56,30.4,73,17,56,30.4
32310, 홍천군,095005, 94세,2021,54,9,45,20,54,9,45,20
32310, 홍천군,100,95~99세,2021,119,31,88,35.2,119,31,88,35.2
32310, 홍천군,100001, 95세,2021,38,11,27,40.7,38,11,27,40.7
32310, 홍천군,100002, 96세,2021,35,7,28,25,35,7,28,25
32310, 홍천군,100003, 97세,2021,21,8,13,61.5,21,8,13,61.5
32310, 홍천군,100004, 98세,2021,17,X,13,30.8,17,X,13,30.8
32310, 홍천군,100005, 99세,2021,8,X,7,14.3,8,X,7,14.3
32310, 홍천군,101,100세이상,2021,22,X,20,10,22,X,20,10
32310, 홍천군,102,15세미만,2021,5846,2965,2881,102.9,5826,2950,2876,102.6
32310, 홍천군,103,15~64세,2021,41498,22387,19111,117.1,40392,21809,18583,117.4
32310, 홍천군,104,65세이상,2021,18314,8359,9955,84,18264,8339,9925,84
32310, 홍천군,086,85세이상,2021,2167,589,1578,37.3,2166,589,1577,37.3
32310, 홍천군,126,평균연령,2021,50.5,48.9,52.2,,50.7,49.1,52.4,
32310, 홍천군,127,중위연령,2021,54.9,53.2,56.7,,55.2,53.6,57,
32320, 횡성군,000,합계,2021,44712,22791,21921,104,43717,22271,21446,103.8
32320, 횡성군,005,0~4세,2021,915,496,419,118.4,911,493,418,117.9
32320, 횡성군,005001, 0세,2021,158,87,71,122.5,158,87,71,122.5
32320, 횡성군,005002, 1세,2021,164,81,83,97.6,163,80,83,96.4
32320, 횡성군,005003, 2세,2021,187,102,85,120,186,101,85,118.8
32320, 횡성군,005004, 3세,2021,183,107,76,140.8,182,106,76,139.5
32320, 횡성군,005005, 4세,2021,223,119,104,114.4,222,119,103,115.5
32320, 횡성군,010,5~9세,2021,1145,591,554,106.7,1142,590,552,106.9
32320, 횡성군,010001, 5세,2021,198,108,90,120,197,108,89,121.3
32320, 횡성군,010002, 6세,2021,229,107,122,87.7,228,106,122,86.9
32320, 횡성군,010003, 7세,2021,222,113,109,103.7,222,113,109,103.7
32320, 횡성군,010004, 8세,2021,220,117,103,113.6,219,117,102,114.7
32320, 횡성군,010005, 9세,2021,276,146,130,112.3,276,146,130,112.3
32320, 횡성군,015,10~14세,2021,1423,745,678,109.9,1415,740,675,109.6
32320, 횡성군,015001, 10세,2021,266,146,120,121.7,266,146,120,121.7
32320, 횡성군,015002, 11세,2021,275,135,140,96.4,274,135,139,97.1
32320, 횡성군,015003, 12세,2021,273,137,136,100.7,273,137,136,100.7
32320, 횡성군,015004, 13세,2021,289,165,124,133.1,285,163,122,133.6
32320, 횡성군,015005, 14세,2021,320,162,158,102.5,317,159,158,100.6
32320, 횡성군,020,15~19세,2021,2001,1063,938,113.3,1997,1061,936,113.4
32320, 횡성군,020001, 15세,2021,302,153,149,102.7,301,152,149,102
32320, 횡성군,020002, 16세,2021,438,229,209,109.6,438,229,209,109.6
32320, 횡성군,020003, 17세,2021,440,236,204,115.7,439,235,204,115.2
32320, 횡성군,020004, 18세,2021,436,225,211,106.6,436,225,211,106.6
32320, 횡성군,020005, 19세,2021,385,220,165,133.3,383,220,163,135
32320, 횡성군,025,20~24세,2021,1915,1118,797,140.3,1831,1072,759,141.2
32320, 횡성군,025001, 20세,2021,378,217,161,134.8,375,216,159,135.8
32320, 횡성군,025002, 21세,2021,381,219,162,135.2,377,217,160,135.6
32320, 횡성군,025003, 22세,2021,389,227,162,140.1,370,216,154,140.3
32320, 횡성군,025004, 23세,2021,383,243,140,173.6,359,230,129,178.3
32320, 횡성군,025005, 24세,2021,384,212,172,123.3,350,193,157,122.9
32320, 횡성군,030,25~29세,2021,1772,1021,751,136,1621,928,693,133.9
32320, 횡성군,030001, 25세,2021,367,219,148,148,340,198,142,139.4
32320, 횡성군,030002, 26세,2021,359,205,154,133.1,333,191,142,134.5
32320, 횡성군,030003, 27세,2021,359,213,146,145.9,331,195,136,143.4
32320, 횡성군,030004, 28세,2021,331,193,138,139.9,292,170,122,139.3
32320, 횡성군,030005, 29세,2021,356,191,165,115.8,325,174,151,115.2
32320, 횡성군,035,30~34세,2021,1575,850,725,117.2,1372,734,638,115
32320, 횡성군,035001, 30세,2021,343,195,148,131.8,297,170,127,133.9
32320, 횡성군,035002, 31세,2021,325,173,152,113.8,287,150,137,109.5
32320, 횡성군,035003, 32세,2021,312,178,134,132.8,261,152,109,139.4
32320, 횡성군,035004, 33세,2021,280,137,143,95.8,244,119,125,95.2
32320, 횡성군,035005, 34세,2021,315,167,148,112.8,283,143,140,102.1
32320, 횡성군,040,35~39세,2021,1821,946,875,108.1,1674,862,812,106.2
32320, 횡성군,040001, 35세,2021,339,166,173,96,310,152,158,96.2
32320, 횡성군,040002, 36세,2021,355,192,163,117.8,321,170,151,112.6
32320, 횡성군,040003, 37세,2021,344,183,161,113.7,310,168,142,118.3
32320, 횡성군,040004, 38세,2021,398,217,181,119.9,369,197,172,114.5
32320, 횡성군,040005, 39세,2021,385,188,197,95.4,364,175,189,92.6
32320, 횡성군,045,40~44세,2021,2118,1142,976,117,2023,1104,919,120.1
32320, 횡성군,045001, 40세,2021,430,232,198,117.2,403,220,183,120.2
32320, 횡성군,045002, 41세,2021,424,244,180,135.6,403,233,170,137.1
32320, 횡성군,045003, 42세,2021,432,218,214,101.9,413,211,202,104.5
32320, 횡성군,045004, 43세,2021,411,221,190,116.3,403,219,184,119
32320, 횡성군,045005, 44세,2021,421,227,194,117,401,221,180,122.8
32320, 횡성군,050,45~49세,2021,2525,1380,1145,120.5,2465,1350,1115,121.1
32320, 횡성군,050001, 45세,2021,428,253,175,144.6,410,244,166,147
32320, 횡성군,050002, 46세,2021,448,248,200,124,438,243,195,124.6
32320, 횡성군,050003, 47세,2021,518,265,253,104.7,517,265,252,105.2
32320, 횡성군,050004, 48세,2021,574,322,252,127.8,559,312,247,126.3
32320, 횡성군,050005, 49세,2021,557,292,265,110.2,541,286,255,112.2
32320, 횡성군,055,50~54세,2021,3704,1916,1788,107.2,3607,1872,1735,107.9
32320, 횡성군,055001, 50세,2021,686,366,320,114.4,661,356,305,116.7
32320, 횡성군,055002, 51세,2021,691,356,335,106.3,678,351,327,107.3
32320, 횡성군,055003, 52세,2021,786,415,371,111.9,767,407,360,113.1
32320, 횡성군,055004, 53세,2021,752,392,360,108.9,725,377,348,108.3
32320, 횡성군,055005, 54세,2021,789,387,402,96.3,776,381,395,96.5
32320, 횡성군,060,55~59세,2021,4314,2215,2099,105.5,4265,2195,2070,106
32320, 횡성군,060001, 55세,2021,780,427,353,121,771,422,349,120.9
32320, 횡성군,060002, 56세,2021,838,416,422,98.6,825,410,415,98.8
32320, 횡성군,060003, 57세,2021,778,407,371,109.7,765,401,364,110.2
32320, 횡성군,060004, 58세,2021,891,445,446,99.8,887,445,442,100.7
32320, 횡성군,060005, 59세,2021,1027,520,507,102.6,1017,517,500,103.4
32320, 횡성군,065,60~64세,2021,5850,3015,2835,106.3,5796,2991,2805,106.6
32320, 횡성군,065001, 60세,2021,1190,607,583,104.1,1181,604,577,104.7
32320, 횡성군,065002, 61세,2021,1267,631,636,99.2,1258,626,632,99.1
32320, 횡성군,065003, 62세,2021,1115,582,533,109.2,1106,579,527,109.9
32320, 횡성군,065004, 63세,2021,1184,597,587,101.7,1170,591,579,102.1
32320, 횡성군,065005, 64세,2021,1094,598,496,120.6,1081,591,490,120.6
32320, 횡성군,070,65~69세,2021,4652,2413,2239,107.8,4638,2407,2231,107.9
32320, 횡성군,070001, 65세,2021,1071,526,545,96.5,1067,524,543,96.5
32320, 횡성군,070002, 66세,2021,986,532,454,117.2,981,529,452,117
32320, 횡성군,070003, 67세,2021,903,459,444,103.4,901,459,442,103.8
32320, 횡성군,070004, 68세,2021,709,386,323,119.5,707,385,322,119.6
32320, 횡성군,070005, 69세,2021,983,510,473,107.8,982,510,472,108.1
32320, 횡성군,075,70~74세,2021,2713,1403,1310,107.1,2700,1399,1301,107.5
32320, 횡성군,075001, 70세,2021,473,250,223,112.1,471,248,223,111.2
32320, 횡성군,075002, 71세,2021,531,270,261,103.4,525,269,256,105.1
32320, 횡성군,075003, 72세,2021,529,281,248,113.3,527,281,246,114.2
32320, 횡성군,075004, 73세,2021,569,274,295,92.9,568,273,295,92.5
32320, 횡성군,075005, 74세,2021,611,328,283,115.9,609,328,281,116.7
32320, 횡성군,080,75~79세,2021,2520,1141,1379,82.7,2514,1138,1376,82.7
32320, 횡성군,080001, 75세,2021,497,229,268,85.4,495,227,268,84.7
32320, 횡성군,080002, 76세,2021,485,242,243,99.6,483,241,242,99.6
32320, 횡성군,080003, 77세,2021,500,214,286,74.8,500,214,286,74.8
32320, 횡성군,080004, 78세,2021,497,211,286,73.8,497,211,286,73.8
32320, 횡성군,080005, 79세,2021,541,245,296,82.8,539,245,294,83.3
32320, 횡성군,085,80~84세,2021,2165,910,1255,72.5,2163,909,1254,72.5
32320, 횡성군,085001, 80세,2021,539,237,302,78.5,539,237,302,78.5
32320, 횡성군,085002, 81세,2021,417,183,234,78.2,417,183,234,78.2
32320, 횡성군,085003, 82세,2021,423,162,261,62.1,422,161,261,61.7
32320, 횡성군,085004, 83세,2021,413,171,242,70.7,412,171,241,71
32320, 횡성군,085005, 84세,2021,373,157,216,72.7,373,157,216,72.7
32320, 횡성군,090,85~89세,2021,1069,319,750,42.5,1068,319,749,42.6
32320, 횡성군,090001, 85세,2021,296,113,183,61.7,296,113,183,61.7
32320, 횡성군,090002, 86세,2021,254,73,181,40.3,253,73,180,40.6
32320, 횡성군,090003, 87세,2021,216,63,153,41.2,216,63,153,41.2
32320, 횡성군,090004, 88세,2021,167,44,123,35.8,167,44,123,35.8
32320, 횡성군,090005, 89세,2021,136,26,110,23.6,136,26,110,23.6
32320, 횡성군,095,90~94세,2021,408,90,318,28.3,408,90,318,28.3
32320, 횡성군,095001, 90세,2021,104,23,81,28.4,104,23,81,28.4
32320, 횡성군,095002, 91세,2021,110,22,88,25,110,22,88,25
32320, 횡성군,095003, 92세,2021,83,22,61,36.1,83,22,61,36.1
32320, 횡성군,095004, 93세,2021,61,11,50,22,61,11,50,22
32320, 횡성군,095005, 94세,2021,50,12,38,31.6,50,12,38,31.6
32320, 횡성군,100,95~99세,2021,87,16,71,22.5,87,16,71,22.5
32320, 횡성군,100001, 95세,2021,30,X,27,11.1,30,X,27,11.1
32320, 횡성군,100002, 96세,2021,24,X,20,20,24,X,20,20
32320, 횡성군,100003, 97세,2021,8,X,5,60,8,X,5,60
32320, 횡성군,100004, 98세,2021,12,X,9,33.3,12,X,9,33.3
32320, 횡성군,100005, 99세,2021,13,X,10,30,13,X,10,30
32320, 횡성군,101,100세이상,2021,20,X,19,5.3,20,X,19,5.3
32320, 횡성군,102,15세미만,2021,3483,1832,1651,111,3468,1823,1645,110.8
32320, 횡성군,103,15~64세,2021,27595,14666,12929,113.4,26651,14169,12482,113.5
32320, 횡성군,104,65세이상,2021,13634,6293,7341,85.7,13598,6279,7319,85.8
32320, 횡성군,086,85세이상,2021,1584,426,1158,36.8,1583,426,1157,36.8
32320, 횡성군,126,평균연령,2021,51.9,50.3,53.5,,52.2,50.6,53.8,
32320, 횡성군,127,중위연령,2021,56.8,55.3,58.4,,57.3,55.8,58.8,
32330, 영월군,000,합계,2021,35728,18415,17313,106.4,35339,18273,17066,107.1
32330, 영월군,005,0~4세,2021,638,333,305,109.2,637,333,304,109.5
32330, 영월군,005001, 0세,2021,96,45,51,88.2,96,45,51,88.2
32330, 영월군,005002, 1세,2021,123,62,61,101.6,123,62,61,101.6
32330, 영월군,005003, 2세,2021,140,73,67,109,139,73,66,110.6
32330, 영월군,005004, 3세,2021,132,77,55,140,132,77,55,140
32330, 영월군,005005, 4세,2021,147,76,71,107,147,76,71,107
32330, 영월군,010,5~9세,2021,920,486,434,112,914,486,428,113.6
32330, 영월군,010001, 5세,2021,155,84,71,118.3,155,84,71,118.3
32330, 영월군,010002, 6세,2021,170,85,85,100,168,85,83,102.4
32330, 영월군,010003, 7세,2021,195,99,96,103.1,191,99,92,107.6
32330, 영월군,010004, 8세,2021,192,102,90,113.3,192,102,90,113.3
32330, 영월군,010005, 9세,2021,208,116,92,126.1,208,116,92,126.1
32330, 영월군,015,10~14세,2021,1097,578,519,111.4,1096,577,519,111.2
32330, 영월군,015001, 10세,2021,235,117,118,99.2,235,117,118,99.2
32330, 영월군,015002, 11세,2021,215,112,103,108.7,215,112,103,108.7
32330, 영월군,015003, 12세,2021,205,112,93,120.4,205,112,93,120.4
32330, 영월군,015004, 13세,2021,207,113,94,120.2,207,113,94,120.2
32330, 영월군,015005, 14세,2021,235,124,111,111.7,234,123,111,110.8
32330, 영월군,020,15~19세,2021,1427,811,616,131.7,1427,811,616,131.7
32330, 영월군,020001, 15세,2021,266,138,128,107.8,266,138,128,107.8
32330, 영월군,020002, 16세,2021,296,182,114,159.6,296,182,114,159.6
32330, 영월군,020003, 17세,2021,349,192,157,122.3,349,192,157,122.3
32330, 영월군,020004, 18세,2021,281,161,120,134.2,281,161,120,134.2
32330, 영월군,020005, 19세,2021,235,138,97,142.3,235,138,97,142.3
32330, 영월군,025,20~24세,2021,1367,831,536,155,1350,827,523,158.1
32330, 영월군,025001, 20세,2021,302,192,110,174.5,301,192,109,176.1
32330, 영월군,025002, 21세,2021,287,179,108,165.7,283,179,104,172.1
32330, 영월군,025003, 22세,2021,271,158,113,139.8,268,158,110,143.6
32330, 영월군,025004, 23세,2021,240,136,104,130.8,236,134,102,131.4
32330, 영월군,025005, 24세,2021,267,166,101,164.4,262,164,98,167.3
32330, 영월군,030,25~29세,2021,1232,716,516,138.8,1169,692,477,145.1
32330, 영월군,030001, 25세,2021,252,135,117,115.4,238,130,108,120.4
32330, 영월군,030002, 26세,2021,239,134,105,127.6,232,131,101,129.7
32330, 영월군,030003, 27세,2021,244,142,102,139.2,228,135,93,145.2
32330, 영월군,030004, 28세,2021,264,169,95,177.9,251,162,89,182
32330, 영월군,030005, 29세,2021,233,136,97,140.2,220,134,86,155.8
32330, 영월군,035,30~34세,2021,1167,636,531,119.8,1116,620,496,125
32330, 영월군,035001, 30세,2021,254,151,103,146.6,232,141,91,154.9
32330, 영월군,035002, 31세,2021,208,112,96,116.7,199,110,89,123.6
32330, 영월군,035003, 32세,2021,223,115,108,106.5,215,112,103,108.7
32330, 영월군,035004, 33세,2021,237,131,106,123.6,229,130,99,131.3
32330, 영월군,035005, 34세,2021,245,127,118,107.6,241,127,114,111.4
32330, 영월군,040,35~39세,2021,1428,767,661,116,1380,750,630,119
32330, 영월군,040001, 35세,2021,243,141,102,138.2,232,137,95,144.2
32330, 영월군,040002, 36세,2021,240,120,120,100,226,116,110,105.5
32330, 영월군,040003, 37세,2021,273,144,129,111.6,265,141,124,113.7
32330, 영월군,040004, 38세,2021,298,170,128,132.8,292,169,123,137.4
32330, 영월군,040005, 39세,2021,374,192,182,105.5,365,187,178,105.1
32330, 영월군,045,40~44세,2021,1734,909,825,110.2,1687,887,800,110.9
32330, 영월군,045001, 40세,2021,324,184,140,131.4,316,178,138,129
32330, 영월군,045002, 41세,2021,358,187,171,109.4,345,182,163,111.7
32330, 영월군,045003, 42세,2021,347,169,178,94.9,339,167,172,97.1
32330, 영월군,045004, 43세,2021,353,183,170,107.6,342,178,164,108.5
32330, 영월군,045005, 44세,2021,352,186,166,112,345,182,163,111.7
32330, 영월군,050,45~49세,2021,2354,1250,1104,113.2,2316,1238,1078,114.8
32330, 영월군,050001, 45세,2021,385,206,179,115.1,381,203,178,114
32330, 영월군,050002, 46세,2021,437,240,197,121.8,429,238,191,124.6
32330, 영월군,050003, 47세,2021,515,244,271,90,507,242,265,91.3
32330, 영월군,050004, 48세,2021,531,297,234,126.9,521,296,225,131.6
32330, 영월군,050005, 49세,2021,486,263,223,117.9,478,259,219,118.3
32330, 영월군,055,50~54세,2021,3152,1734,1418,122.3,3110,1718,1392,123.4
32330, 영월군,055001, 50세,2021,606,345,261,132.2,595,340,255,133.3
32330, 영월군,055002, 51세,2021,590,337,253,133.2,578,331,247,134
32330, 영월군,055003, 52세,2021,613,320,293,109.2,609,319,290,110
32330, 영월군,055004, 53세,2021,719,396,323,122.6,713,394,319,123.5
32330, 영월군,055005, 54세,2021,624,336,288,116.7,615,334,281,118.9
32330, 영월군,060,55~59세,2021,3615,1979,1636,121,3580,1964,1616,121.5
32330, 영월군,060001, 55세,2021,718,401,317,126.5,710,398,312,127.6
32330, 영월군,060002, 56세,2021,669,344,325,105.8,662,341,321,106.2
32330, 영월군,060003, 57세,2021,621,343,278,123.4,615,342,273,125.3
32330, 영월군,060004, 58세,2021,761,437,324,134.9,751,432,319,135.4
32330, 영월군,060005, 59세,2021,846,454,392,115.8,842,451,391,115.3
32330, 영월군,065,60~64세,2021,4414,2314,2100,110.2,4398,2309,2089,110.5
32330, 영월군,065001, 60세,2021,862,475,387,122.7,859,474,385,123.1
32330, 영월군,065002, 61세,2021,967,467,500,93.4,964,466,498,93.6
32330, 영월군,065003, 62세,2021,881,468,413,113.3,879,466,413,112.8
32330, 영월군,065004, 63세,2021,865,452,413,109.4,860,452,408,110.8
32330, 영월군,065005, 64세,2021,839,452,387,116.8,836,451,385,117.1
32330, 영월군,070,65~69세,2021,3621,1909,1712,111.5,3608,1902,1706,111.5
32330, 영월군,070001, 65세,2021,767,410,357,114.8,763,408,355,114.9
32330, 영월군,070002, 66세,2021,796,419,377,111.1,793,418,375,111.5
32330, 영월군,070003, 67세,2021,685,370,315,117.5,683,368,315,116.8
32330, 영월군,070004, 68세,2021,586,295,291,101.4,583,294,289,101.7
32330, 영월군,070005, 69세,2021,787,415,372,111.6,786,414,372,111.3
32330, 영월군,075,70~74세,2021,2342,1125,1217,92.4,2338,1125,1213,92.7
32330, 영월군,075001, 70세,2021,448,214,234,91.5,448,214,234,91.5
32330, 영월군,075002, 71세,2021,470,214,256,83.6,469,214,255,83.9
32330, 영월군,075003, 72세,2021,463,224,239,93.7,463,224,239,93.7
32330, 영월군,075004, 73세,2021,492,238,254,93.7,490,238,252,94.4
32330, 영월군,075005, 74세,2021,469,235,234,100.4,468,235,233,100.9
32330, 영월군,080,75~79세,2021,2208,963,1245,77.3,2204,960,1244,77.2
32330, 영월군,080001, 75세,2021,395,189,206,91.7,394,188,206,91.3
32330, 영월군,080002, 76세,2021,415,200,215,93,414,200,214,93.5
32330, 영월군,080003, 77세,2021,462,184,278,66.2,461,183,278,65.8
32330, 영월군,080004, 78세,2021,413,172,241,71.4,412,171,241,71
32330, 영월군,080005, 79세,2021,523,218,305,71.5,523,218,305,71.5
32330, 영월군,085,80~84세,2021,1833,720,1113,64.7,1831,720,1111,64.8
32330, 영월군,085001, 80세,2021,431,171,260,65.8,430,171,259,66
32330, 영월군,085002, 81세,2021,422,178,244,73,422,178,244,73
32330, 영월군,085003, 82세,2021,374,150,224,67,373,150,223,67.3
32330, 영월군,085004, 83세,2021,339,124,215,57.7,339,124,215,57.7
32330, 영월군,085005, 84세,2021,267,97,170,57.1,267,97,170,57.1
32330, 영월군,090,85~89세,2021,856,262,594,44.1,855,262,593,44.2
32330, 영월군,090001, 85세,2021,230,91,139,65.5,230,91,139,65.5
32330, 영월군,090002, 86세,2021,200,74,126,58.7,200,74,126,58.7
32330, 영월군,090003, 87세,2021,192,46,146,31.5,191,46,145,31.7
32330, 영월군,090004, 88세,2021,132,29,103,28.2,132,29,103,28.2
32330, 영월군,090005, 89세,2021,102,22,80,27.5,102,22,80,27.5
32330, 영월군,095,90~94세,2021,260,70,190,36.8,260,70,190,36.8
32330, 영월군,095001, 90세,2021,76,28,48,58.3,76,28,48,58.3
32330, 영월군,095002, 91세,2021,57,9,48,18.8,57,9,48,18.8
32330, 영월군,095003, 92세,2021,63,16,47,34,63,16,47,34
32330, 영월군,095004, 93세,2021,28,8,20,40,28,8,20,40
32330, 영월군,095005, 94세,2021,36,9,27,33.3,36,9,27,33.3
32330, 영월군,100,95~99세,2021,53,17,36,47.2,53,17,36,47.2
32330, 영월군,100001, 95세,2021,11,X,8,37.5,11,X,8,37.5
32330, 영월군,100002, 96세,2021,20,7,13,53.8,20,7,13,53.8
32330, 영월군,100003, 97세,2021,8,5,X,166.7,8,5,X,166.7
32330, 영월군,100004, 98세,2021,11,X,9,22.2,11,X,9,22.2
32330, 영월군,100005, 99세,2021,X,X,X,0,X,X,X,0
32330, 영월군,101,100세이상,2021,10,5,5,100,10,5,5,100
32330, 영월군,102,15세미만,2021,2655,1397,1258,111,2647,1396,1251,111.6
32330, 영월군,103,15~64세,2021,21890,11947,9943,120.2,21533,11816,9717,121.6
32330, 영월군,104,65세이상,2021,11183,5071,6112,83,11159,5061,6098,83
32330, 영월군,086,85세이상,2021,1179,354,825,42.9,1178,354,824,43
32330, 영월군,126,평균연령,2021,52.6,50.9,54.5,,52.7,51,54.6,
32330, 영월군,127,중위연령,2021,56.9,55.4,58.8,,57.2,55.5,59.1,
32340, 평창군,000,합계,2021,38613,19781,18832,105,37931,19481,18450,105.6
32340, 평창군,005,0~4세,2021,674,326,348,93.7,668,323,345,93.6
32340, 평창군,005001, 0세,2021,104,40,64,62.5,103,39,64,60.9
32340, 평창군,005002, 1세,2021,110,49,61,80.3,109,49,60,81.7
32340, 평창군,005003, 2세,2021,135,72,63,114.3,134,72,62,116.1
32340, 평창군,005004, 3세,2021,146,70,76,92.1,144,69,75,92
32340, 평창군,005005, 4세,2021,179,95,84,113.1,178,94,84,111.9
32340, 평창군,010,5~9세,2021,1008,497,511,97.3,1000,495,505,98
32340, 평창군,010001, 5세,2021,171,80,91,87.9,170,80,90,88.9
32340, 평창군,010002, 6세,2021,181,84,97,86.6,179,84,95,88.4
32340, 평창군,010003, 7세,2021,188,84,104,80.8,186,83,103,80.6
32340, 평창군,010004, 8세,2021,226,126,100,126,224,126,98,128.6
32340, 평창군,010005, 9세,2021,242,123,119,103.4,241,122,119,102.5
32340, 평창군,015,10~14세,2021,1248,650,598,108.7,1243,647,596,108.6
32340, 평창군,015001, 10세,2021,235,120,115,104.3,232,118,114,103.5
32340, 평창군,015002, 11세,2021,238,124,114,108.8,238,124,114,108.8
32340, 평창군,015003, 12세,2021,233,120,113,106.2,233,120,113,106.2
32340, 평창군,015004, 13세,2021,273,142,131,108.4,271,141,130,108.5
32340, 평창군,015005, 14세,2021,269,144,125,115.2,269,144,125,115.2
32340, 평창군,020,15~19세,2021,1159,643,516,124.6,1149,636,513,124
32340, 평창군,020001, 15세,2021,260,148,112,132.1,258,146,112,130.4
32340, 평창군,020002, 16세,2021,242,131,111,118,239,129,110,117.3
32340, 평창군,020003, 17세,2021,265,141,124,113.7,264,140,124,112.9
32340, 평창군,020004, 18세,2021,247,133,114,116.7,245,132,113,116.8
32340, 평창군,020005, 19세,2021,145,90,55,163.6,143,89,54,164.8
32340, 평창군,025,20~24세,2021,1312,820,492,166.7,1285,814,471,172.8
32340, 평창군,025001, 20세,2021,226,159,67,237.3,224,158,66,239.4
32340, 평창군,025002, 21세,2021,294,192,102,188.2,291,192,99,193.9
32340, 평창군,025003, 22세,2021,245,157,88,178.4,239,156,83,188
32340, 평창군,025004, 23세,2021,272,158,114,138.6,264,156,108,144.4
32340, 평창군,025005, 24세,2021,275,154,121,127.3,267,152,115,132.2
32340, 평창군,030,25~29세,2021,1482,888,594,149.5,1384,839,545,153.9
32340, 평창군,030001, 25세,2021,300,186,114,163.2,289,180,109,165.1
32340, 평창군,030002, 26세,2021,271,168,103,163.1,254,160,94,170.2
32340, 평창군,030003, 27세,2021,320,195,125,156,291,179,112,159.8
32340, 평창군,030004, 28세,2021,288,163,125,130.4,264,151,113,133.6
32340, 평창군,030005, 29세,2021,303,176,127,138.6,286,169,117,144.4
32340, 평창군,035,30~34세,2021,1280,704,576,122.2,1191,671,520,129
32340, 평창군,035001, 30세,2021,284,156,128,121.9,265,150,115,130.4
32340, 평창군,035002, 31세,2021,240,141,99,142.4,222,130,92,141.3
32340, 평창군,035003, 32세,2021,263,143,120,119.2,248,140,108,129.6
32340, 평창군,035004, 33세,2021,245,134,111,120.7,228,127,101,125.7
32340, 평창군,035005, 34세,2021,248,130,118,110.2,228,124,104,119.2
32340, 평창군,040,35~39세,2021,1524,806,718,112.3,1438,766,672,114
32340, 평창군,040001, 35세,2021,263,144,119,121,243,130,113,115
32340, 평창군,040002, 36세,2021,265,132,133,99.2,244,121,123,98.4
32340, 평창군,040003, 37세,2021,284,146,138,105.8,266,140,126,111.1
32340, 평창군,040004, 38세,2021,325,176,149,118.1,315,172,143,120.3
32340, 평창군,040005, 39세,2021,387,208,179,116.2,370,203,167,121.6
32340, 평창군,045,40~44세,2021,2084,1116,968,115.3,2019,1089,930,117.1
32340, 평창군,045001, 40세,2021,407,227,180,126.1,391,222,169,131.4
32340, 평창군,045002, 41세,2021,415,235,180,130.6,403,230,173,132.9
32340, 평창군,045003, 42세,2021,430,230,200,115,412,224,188,119.1
32340, 평창군,045004, 43세,2021,403,218,185,117.8,397,214,183,116.9
32340, 평창군,045005, 44세,2021,429,206,223,92.4,416,199,217,91.7
32340, 평창군,050,45~49세,2021,2692,1472,1220,120.7,2638,1444,1194,120.9
32340, 평창군,050001, 45세,2021,440,263,177,148.6,430,255,175,145.7
32340, 평창군,050002, 46세,2021,499,254,245,103.7,488,249,239,104.2
32340, 평창군,050003, 47세,2021,546,288,258,111.6,537,283,254,111.4
32340, 평창군,050004, 48세,2021,599,330,269,122.7,588,324,264,122.7
32340, 평창군,050005, 49세,2021,608,337,271,124.4,595,333,262,127.1
32340, 평창군,055,50~54세,2021,3489,1861,1628,114.3,3421,1835,1586,115.7
32340, 평창군,055001, 50세,2021,646,352,294,119.7,632,347,285,121.8
32340, 평창군,055002, 51세,2021,642,344,298,115.4,637,341,296,115.2
32340, 평창군,055003, 52세,2021,719,375,344,109,700,367,333,110.2
32340, 평창군,055004, 53세,2021,782,413,369,111.9,763,407,356,114.3
32340, 평창군,055005, 54세,2021,700,377,323,116.7,689,373,316,118
32340, 평창군,060,55~59세,2021,3932,2058,1874,109.8,3862,2026,1836,110.3
32340, 평창군,060001, 55세,2021,736,404,332,121.7,718,396,322,123
32340, 평창군,060002, 56세,2021,751,395,356,111,740,389,351,110.8
32340, 평창군,060003, 57세,2021,683,333,350,95.1,667,327,340,96.2
32340, 평창군,060004, 58세,2021,821,440,381,115.5,805,432,373,115.8
32340, 평창군,060005, 59세,2021,941,486,455,106.8,932,482,450,107.1
32340, 평창군,065,60~64세,2021,5073,2643,2430,108.8,5025,2618,2407,108.8
32340, 평창군,065001, 60세,2021,1015,515,500,103,1003,509,494,103
32340, 평창군,065002, 61세,2021,1135,572,563,101.6,1123,566,557,101.6
32340, 평창군,065003, 62세,2021,962,515,447,115.2,956,513,443,115.8
32340, 평창군,065004, 63세,2021,978,522,456,114.5,971,520,451,115.3
32340, 평창군,065005, 64세,2021,983,519,464,111.9,972,510,462,110.4
32340, 평창군,070,65~69세,2021,3921,2043,1878,108.8,3887,2029,1858,109.2
32340, 평창군,070001, 65세,2021,847,439,408,107.6,839,437,402,108.7
32340, 평창군,070002, 66세,2021,893,474,419,113.1,885,470,415,113.3
32340, 평창군,070003, 67세,2021,725,389,336,115.8,718,384,334,115
32340, 평창군,070004, 68세,2021,640,323,317,101.9,634,322,312,103.2
32340, 평창군,070005, 69세,2021,816,418,398,105,811,416,395,105.3
32340, 평창군,075,70~74세,2021,2524,1218,1306,93.3,2520,1216,1304,93.3
32340, 평창군,075001, 70세,2021,439,204,235,86.8,439,204,235,86.8
32340, 평창군,075002, 71세,2021,470,222,248,89.5,468,221,247,89.5
32340, 평창군,075003, 72세,2021,522,260,262,99.2,522,260,262,99.2
32340, 평창군,075004, 73세,2021,546,271,275,98.5,545,271,274,98.9
32340, 평창군,075005, 74세,2021,547,261,286,91.3,546,260,286,90.9
32340, 평창군,080,75~79세,2021,2199,996,1203,82.8,2193,993,1200,82.8
32340, 평창군,080001, 75세,2021,405,200,205,97.6,404,199,205,97.1
32340, 평창군,080002, 76세,2021,489,219,270,81.1,486,218,268,81.3
32340, 평창군,080003, 77세,2021,451,192,259,74.1,450,191,259,73.7
32340, 평창군,080004, 78세,2021,403,192,211,91,403,192,211,91
32340, 평창군,080005, 79세,2021,451,193,258,74.8,450,193,257,75.1
32340, 평창군,085,80~84세,2021,1836,732,1104,66.3,1835,732,1103,66.4
32340, 평창군,085001, 80세,2021,421,178,243,73.3,421,178,243,73.3
32340, 평창군,085002, 81세,2021,407,165,242,68.2,407,165,242,68.2
32340, 평창군,085003, 82세,2021,412,165,247,66.8,412,165,247,66.8
32340, 평창군,085004, 83세,2021,308,118,190,62.1,307,118,189,62.4
32340, 평창군,085005, 84세,2021,288,106,182,58.2,288,106,182,58.2
32340, 평창군,090,85~89세,2021,822,243,579,42,819,243,576,42.2
32340, 평창군,090001, 85세,2021,250,91,159,57.2,250,91,159,57.2
32340, 평창군,090002, 86세,2021,205,62,143,43.4,205,62,143,43.4
32340, 평창군,090003, 87세,2021,143,36,107,33.6,142,36,106,34
32340, 평창군,090004, 88세,2021,121,33,88,37.5,120,33,87,37.9
32340, 평창군,090005, 89세,2021,103,21,82,25.6,102,21,81,25.9
32340, 평창군,095,90~94세,2021,268,46,222,20.7,268,46,222,20.7
32340, 평창군,095001, 90세,2021,74,10,64,15.6,74,10,64,15.6
32340, 평창군,095002, 91세,2021,67,13,54,24.1,67,13,54,24.1
32340, 평창군,095003, 92세,2021,61,10,51,19.6,61,10,51,19.6
32340, 평창군,095004, 93세,2021,40,6,34,17.6,40,6,34,17.6
32340, 평창군,095005, 94세,2021,26,7,19,36.8,26,7,19,36.8
32340, 평창군,100,95~99세,2021,70,15,55,27.3,70,15,55,27.3
32340, 평창군,100001, 95세,2021,21,X,19,10.5,21,X,19,10.5
32340, 평창군,100002, 96세,2021,18,X,16,12.5,18,X,16,12.5
32340, 평창군,100003, 97세,2021,21,9,12,75,21,9,12,75
32340, 평창군,100004, 98세,2021,7,X,5,40,7,X,5,40
32340, 평창군,100005, 99세,2021,X,X,X,0,X,X,X,0
32340, 평창군,101,100세이상,2021,16,X,12,33.3,16,X,12,33.3
32340, 평창군,102,15세미만,2021,2930,1473,1457,101.1,2911,1465,1446,101.3
32340, 평창군,103,15~64세,2021,24027,13011,11016,118.1,23412,12738,10674,119.3
32340, 평창군,104,65세이상,2021,11656,5297,6359,83.3,11608,5278,6330,83.4
32340, 평창군,086,85세이상,2021,1176,308,868,35.5,1173,308,865,35.6
32340, 평창군,126,평균연령,2021,52.6,51.1,54.3,,52.8,51.2,54.5,
32340, 평창군,127,중위연령,2021,56.8,55.3,58.5,,57.1,55.5,58.9,
32350, 정선군,000,합계,2021,33786,17544,16242,108,33397,17437,15960,109.3
32350, 정선군,005,0~4세,2021,678,340,338,100.6,677,340,337,100.9
32350, 정선군,005001, 0세,2021,129,61,68,89.7,129,61,68,89.7
32350, 정선군,005002, 1세,2021,132,61,71,85.9,132,61,71,85.9
32350, 정선군,005003, 2세,2021,137,70,67,104.5,137,70,67,104.5
32350, 정선군,005004, 3세,2021,137,69,68,101.5,136,69,67,103
32350, 정선군,005005, 4세,2021,143,79,64,123.4,143,79,64,123.4
32350, 정선군,010,5~9세,2021,958,498,460,108.3,958,498,460,108.3
32350, 정선군,010001, 5세,2021,152,84,68,123.5,152,84,68,123.5
32350, 정선군,010002, 6세,2021,172,91,81,112.3,172,91,81,112.3
32350, 정선군,010003, 7세,2021,187,90,97,92.8,187,90,97,92.8
32350, 정선군,010004, 8세,2021,204,106,98,108.2,204,106,98,108.2
32350, 정선군,010005, 9세,2021,243,127,116,109.5,243,127,116,109.5
32350, 정선군,015,10~14세,2021,1192,608,584,104.1,1191,608,583,104.3
32350, 정선군,015001, 10세,2021,212,105,107,98.1,212,105,107,98.1
32350, 정선군,015002, 11세,2021,257,126,131,96.2,257,126,131,96.2
32350, 정선군,015003, 12세,2021,241,132,109,121.1,241,132,109,121.1
32350, 정선군,015004, 13세,2021,250,124,126,98.4,250,124,126,98.4
32350, 정선군,015005, 14세,2021,232,121,111,109,231,121,110,110
32350, 정선군,020,15~19세,2021,1021,530,491,107.9,1020,530,490,108.2
32350, 정선군,020001, 15세,2021,220,110,110,100,220,110,110,100
32350, 정선군,020002, 16세,2021,228,116,112,103.6,228,116,112,103.6
32350, 정선군,020003, 17세,2021,234,112,122,91.8,233,112,121,92.6
32350, 정선군,020004, 18세,2021,204,108,96,112.5,204,108,96,112.5
32350, 정선군,020005, 19세,2021,135,84,51,164.7,135,84,51,164.7
32350, 정선군,025,20~24세,2021,1011,649,362,179.3,983,642,341,188.3
32350, 정선군,025001, 20세,2021,199,137,62,221,198,137,61,224.6
32350, 정선군,025002, 21세,2021,224,158,66,239.4,220,158,62,254.8
32350, 정선군,025003, 22세,2021,191,129,62,208.1,187,127,60,211.7
32350, 정선군,025004, 23세,2021,202,118,84,140.5,196,117,79,148.1
32350, 정선군,025005, 24세,2021,195,107,88,121.6,182,103,79,130.4
32350, 정선군,030,25~29세,2021,1105,640,465,137.6,1062,631,431,146.4
32350, 정선군,030001, 25세,2021,231,125,106,117.9,221,123,98,125.5
32350, 정선군,030002, 26세,2021,213,134,79,169.6,210,134,76,176.3
32350, 정선군,030003, 27세,2021,242,141,101,139.6,239,140,99,141.4
32350, 정선군,030004, 28세,2021,203,122,81,150.6,194,120,74,162.2
32350, 정선군,030005, 29세,2021,216,118,98,120.4,198,114,84,135.7
32350, 정선군,035,30~34세,2021,1262,683,579,118,1185,662,523,126.6
32350, 정선군,035001, 30세,2021,227,122,105,116.2,212,118,94,125.5
32350, 정선군,035002, 31세,2021,246,144,102,141.2,236,141,95,148.4
32350, 정선군,035003, 32세,2021,255,139,116,119.8,239,136,103,132
32350, 정선군,035004, 33세,2021,269,140,129,108.5,243,132,111,118.9
32350, 정선군,035005, 34세,2021,265,138,127,108.7,255,135,120,112.5
32350, 정선군,040,35~39세,2021,1562,853,709,120.3,1502,835,667,125.2
32350, 정선군,040001, 35세,2021,256,134,122,109.8,245,131,114,114.9
32350, 정선군,040002, 36세,2021,280,180,100,180,265,174,91,191.2
32350, 정선군,040003, 37세,2021,307,147,160,91.9,292,145,147,98.6
32350, 정선군,040004, 38세,2021,346,193,153,126.1,337,190,147,129.3
32350, 정선군,040005, 39세,2021,373,199,174,114.4,363,195,168,116.1
32350, 정선군,045,40~44세,2021,2027,1153,874,131.9,1996,1144,852,134.3
32350, 정선군,045001, 40세,2021,378,213,165,129.1,371,211,160,131.9
32350, 정선군,045002, 41세,2021,412,236,176,134.1,403,234,169,138.5
32350, 정선군,045003, 42세,2021,421,231,190,121.6,415,229,186,123.1
32350, 정선군,045004, 43세,2021,397,228,169,134.9,393,226,167,135.3
32350, 정선군,045005, 44세,2021,419,245,174,140.8,414,244,170,143.5
32350, 정선군,050,45~49세,2021,2443,1408,1035,136,2420,1406,1014,138.7
32350, 정선군,050001, 45세,2021,448,246,202,121.8,444,245,199,123.1
32350, 정선군,050002, 46세,2021,445,264,181,145.9,440,263,177,148.6
32350, 정선군,050003, 47세,2021,545,310,235,131.9,541,310,231,134.2
32350, 정선군,050004, 48세,2021,490,282,208,135.6,486,282,204,138.2
32350, 정선군,050005, 49세,2021,515,306,209,146.4,509,306,203,150.7
32350, 정선군,055,50~54세,2021,3091,1785,1306,136.7,3042,1771,1271,139.3
32350, 정선군,055001, 50세,2021,611,367,244,150.4,602,365,237,154
32350, 정선군,055002, 51세,2021,555,322,233,138.2,543,319,224,142.4
32350, 정선군,055003, 52세,2021,643,365,278,131.3,630,361,269,134.2
32350, 정선군,055004, 53세,2021,686,399,287,139,677,396,281,140.9
32350, 정선군,055005, 54세,2021,596,332,264,125.8,590,330,260,126.9
32350, 정선군,060,55~59세,2021,3307,1786,1521,117.4,3280,1778,1502,118.4
32350, 정선군,060001, 55세,2021,634,343,291,117.9,631,343,288,119.1
32350, 정선군,060002, 56세,2021,618,314,304,103.3,615,313,302,103.6
32350, 정선군,060003, 57세,2021,605,338,267,126.6,599,336,263,127.8
32350, 정선군,060004, 58세,2021,695,390,305,127.9,689,386,303,127.4
32350, 정선군,060005, 59세,2021,755,401,354,113.3,746,400,346,115.6
32350, 정선군,065,60~64세,2021,4293,2232,2061,108.3,4262,2219,2043,108.6
32350, 정선군,065001, 60세,2021,874,437,437,100,869,434,435,99.8
32350, 정선군,065002, 61세,2021,966,488,478,102.1,958,484,474,102.1
32350, 정선군,065003, 62세,2021,814,424,390,108.7,803,421,382,110.2
32350, 정선군,065004, 63세,2021,809,435,374,116.3,805,434,371,117
32350, 정선군,065005, 64세,2021,830,448,382,117.3,827,446,381,117.1
32350, 정선군,070,65~69세,2021,3214,1700,1514,112.3,3205,1696,1509,112.4
32350, 정선군,070001, 65세,2021,715,389,326,119.3,713,388,325,119.4
32350, 정선군,070002, 66세,2021,737,406,331,122.7,735,406,329,123.4
32350, 정선군,070003, 67세,2021,590,320,270,118.5,587,317,270,117.4
32350, 정선군,070004, 68세,2021,520,269,251,107.2,519,269,250,107.6
32350, 정선군,070005, 69세,2021,652,316,336,94,651,316,335,94.3
32350, 정선군,075,70~74세,2021,2171,993,1178,84.3,2167,991,1176,84.3
32350, 정선군,075001, 70세,2021,411,195,216,90.3,409,194,215,90.2
32350, 정선군,075002, 71세,2021,424,170,254,66.9,424,170,254,66.9
32350, 정선군,075003, 72세,2021,457,225,232,97,456,224,232,96.6
32350, 정선군,075004, 73세,2021,445,210,235,89.4,445,210,235,89.4
32350, 정선군,075005, 74세,2021,434,193,241,80.1,433,193,240,80.4
32350, 정선군,080,75~79세,2021,2003,881,1122,78.5,2001,881,1120,78.7
32350, 정선군,080001, 75세,2021,351,172,179,96.1,351,172,179,96.1
32350, 정선군,080002, 76세,2021,396,179,217,82.5,395,179,216,82.9
32350, 정선군,080003, 77세,2021,377,159,218,72.9,377,159,218,72.9
32350, 정선군,080004, 78세,2021,419,177,242,73.1,419,177,242,73.1
32350, 정선군,080005, 79세,2021,460,194,266,72.9,459,194,265,73.2
32350, 정선군,085,80~84세,2021,1487,560,927,60.4,1485,560,925,60.5
32350, 정선군,085001, 80세,2021,352,139,213,65.3,351,139,212,65.6
32350, 정선군,085002, 81세,2021,361,148,213,69.5,361,148,213,69.5
32350, 정선군,085003, 82세,2021,310,125,185,67.6,309,125,184,67.9
32350, 정선군,085004, 83세,2021,253,81,172,47.1,253,81,172,47.1
32350, 정선군,085005, 84세,2021,211,67,144,46.5,211,67,144,46.5
32350, 정선군,090,85~89세,2021,668,185,483,38.3,668,185,483,38.3
32350, 정선군,090001, 85세,2021,178,54,124,43.5,178,54,124,43.5
32350, 정선군,090002, 86세,2021,164,51,113,45.1,164,51,113,45.1
32350, 정선군,090003, 87세,2021,137,39,98,39.8,137,39,98,39.8
32350, 정선군,090004, 88세,2021,101,22,79,27.8,101,22,79,27.8
32350, 정선군,090005, 89세,2021,88,19,69,27.5,88,19,69,27.5
32350, 정선군,095,90~94세,2021,197,40,157,25.5,197,40,157,25.5
32350, 정선군,095001, 90세,2021,45,14,31,45.2,45,14,31,45.2
32350, 정선군,095002, 91세,2021,58,11,47,23.4,58,11,47,23.4
32350, 정선군,095003, 92세,2021,35,6,29,20.7,35,6,29,20.7
32350, 정선군,095004, 93세,2021,34,6,28,21.4,34,6,28,21.4
32350, 정선군,095005, 94세,2021,25,X,22,13.6,25,X,22,13.6
32350, 정선군,100,95~99세,2021,85,17,68,25,85,17,68,25
32350, 정선군,100001, 95세,2021,26,X,23,13,26,X,23,13
32350, 정선군,100002, 96세,2021,17,5,12,41.7,17,5,12,41.7
32350, 정선군,100003, 97세,2021,22,6,16,37.5,22,6,16,37.5
32350, 정선군,100004, 98세,2021,16,X,13,23.1,16,X,13,23.1
32350, 정선군,100005, 99세,2021,X,X,X,0,X,X,X,0
32350, 정선군,101,100세이상,2021,11,X,8,37.5,11,X,8,37.5
32350, 정선군,102,15세미만,2021,2828,1446,1382,104.6,2826,1446,1380,104.8
32350, 정선군,103,15~64세,2021,21122,11719,9403,124.6,20752,11618,9134,127.2
32350, 정선군,104,65세이상,2021,9836,4379,5457,80.2,9819,4373,5446,80.3
32350, 정선군,086,85세이상,2021,961,245,716,34.2,961,245,716,34.2
32350, 정선군,126,평균연령,2021,52,50.3,53.7,,52.1,50.4,54,
32350, 정선군,127,중위연령,2021,55.9,53.9,58.2,,56.1,54,58.5,
32360, 철원군,000,합계,2021,41855,21769,20086,108.4,40913,21228,19685,107.8
32360, 철원군,005,0~4세,2021,1535,751,784,95.8,1533,750,783,95.8
32360, 철원군,005001, 0세,2021,264,126,138,91.3,264,126,138,91.3
32360, 철원군,005002, 1세,2021,330,173,157,110.2,330,173,157,110.2
32360, 철원군,005003, 2세,2021,316,171,145,117.9,315,170,145,117.2
32360, 철원군,005004, 3세,2021,314,135,179,75.4,313,135,178,75.8
32360, 철원군,005005, 4세,2021,311,146,165,88.5,311,146,165,88.5
32360, 철원군,010,5~9세,2021,1614,801,813,98.5,1614,801,813,98.5
32360, 철원군,010001, 5세,2021,325,162,163,99.4,325,162,163,99.4
32360, 철원군,010002, 6세,2021,314,154,160,96.3,314,154,160,96.3
32360, 철원군,010003, 7세,2021,343,170,173,98.3,343,170,173,98.3
32360, 철원군,010004, 8세,2021,300,147,153,96.1,300,147,153,96.1
32360, 철원군,010005, 9세,2021,332,168,164,102.4,332,168,164,102.4
32360, 철원군,015,10~14세,2021,1666,881,785,112.2,1666,881,785,112.2
32360, 철원군,015001, 10세,2021,333,177,156,113.5,333,177,156,113.5
32360, 철원군,015002, 11세,2021,333,189,144,131.3,333,189,144,131.3
32360, 철원군,015003, 12세,2021,307,163,144,113.2,307,163,144,113.2
32360, 철원군,015004, 13세,2021,358,175,183,95.6,358,175,183,95.6
32360, 철원군,015005, 14세,2021,335,177,158,112,335,177,158,112
32360, 철원군,020,15~19세,2021,1629,867,762,113.8,1628,866,762,113.6
32360, 철원군,020001, 15세,2021,363,196,167,117.4,363,196,167,117.4
32360, 철원군,020002, 16세,2021,336,178,158,112.7,336,178,158,112.7
32360, 철원군,020003, 17세,2021,359,196,163,120.2,359,196,163,120.2
32360, 철원군,020004, 18세,2021,334,171,163,104.9,334,171,163,104.9
32360, 철원군,020005, 19세,2021,237,126,111,113.5,236,125,111,112.6
32360, 철원군,025,20~24세,2021,2087,1403,684,205.1,1996,1340,656,204.3
32360, 철원군,025001, 20세,2021,311,219,92,238,305,214,91,235.2
32360, 철원군,025002, 21세,2021,403,274,129,212.4,392,269,123,218.7
32360, 철원군,025003, 22세,2021,398,255,143,178.3,380,242,138,175.4
32360, 철원군,025004, 23세,2021,452,296,156,189.7,437,285,152,187.5
32360, 철원군,025005, 24세,2021,523,359,164,218.9,482,330,152,217.1
32360, 철원군,030,25~29세,2021,2878,1897,981,193.4,2641,1741,900,193.4
32360, 철원군,030001, 25세,2021,521,355,166,213.9,471,322,149,216.1
32360, 철원군,030002, 26세,2021,596,410,186,220.4,545,373,172,216.9
32360, 철원군,030003, 27세,2021,610,402,208,193.3,562,372,190,195.8
32360, 철원군,030004, 28세,2021,550,351,199,176.4,509,326,183,178.1
32360, 철원군,030005, 29세,2021,601,379,222,170.7,554,348,206,168.9
32360, 철원군,035,30~34세,2021,2383,1372,1011,135.7,2203,1264,939,134.6
32360, 철원군,035001, 30세,2021,570,344,226,152.2,521,314,207,151.7
32360, 철원군,035002, 31세,2021,492,294,198,148.5,457,274,183,149.7
32360, 철원군,035003, 32세,2021,459,272,187,145.5,425,247,178,138.8
32360, 철원군,035004, 33세,2021,429,223,206,108.3,401,206,195,105.6
32360, 철원군,035005, 34세,2021,433,239,194,123.2,399,223,176,126.7
32360, 철원군,040,35~39세,2021,2285,1240,1045,118.7,2123,1149,974,118
32360, 철원군,040001, 35세,2021,427,230,197,116.8,383,205,178,115.2
32360, 철원군,040002, 36세,2021,437,243,194,125.3,404,227,177,128.2
32360, 철원군,040003, 37세,2021,418,222,196,113.3,384,203,181,112.2
32360, 철원군,040004, 38세,2021,490,279,211,132.2,460,259,201,128.9
32360, 철원군,040005, 39세,2021,513,266,247,107.7,492,255,237,107.6
32360, 철원군,045,40~44세,2021,2514,1288,1226,105.1,2408,1232,1176,104.8
32360, 철원군,045001, 40세,2021,527,271,256,105.9,504,256,248,103.2
32360, 철원군,045002, 41세,2021,523,263,260,101.2,492,246,246,100
32360, 철원군,045003, 42세,2021,475,245,230,106.5,453,235,218,107.8
32360, 철원군,045004, 43세,2021,496,256,240,106.7,481,248,233,106.4
32360, 철원군,045005, 44세,2021,493,253,240,105.4,478,247,231,106.9
32360, 철원군,050,45~49세,2021,2831,1537,1294,118.8,2785,1517,1268,119.6
32360, 철원군,050001, 45세,2021,490,268,222,120.7,474,261,213,122.5
32360, 철원군,050002, 46세,2021,490,268,222,120.7,480,261,219,119.2
32360, 철원군,050003, 47세,2021,608,324,284,114.1,599,322,277,116.2
32360, 철원군,050004, 48세,2021,603,316,287,110.1,595,312,283,110.2
32360, 철원군,050005, 49세,2021,640,361,279,129.4,637,361,276,130.8
32360, 철원군,055,50~54세,2021,3179,1693,1486,113.9,3137,1676,1461,114.7
32360, 철원군,055001, 50세,2021,629,341,288,118.4,621,336,285,117.9
32360, 철원군,055002, 51세,2021,625,345,280,123.2,613,338,275,122.9
32360, 철원군,055003, 52세,2021,637,342,295,115.9,625,338,287,117.8
32360, 철원군,055004, 53세,2021,668,352,316,111.4,663,351,312,112.5
32360, 철원군,055005, 54세,2021,620,313,307,102,615,313,302,103.6
32360, 철원군,060,55~59세,2021,3496,1836,1660,110.6,3466,1823,1643,111
32360, 철원군,060001, 55세,2021,686,366,320,114.4,677,359,318,112.9
32360, 철원군,060002, 56세,2021,658,327,331,98.8,651,325,326,99.7
32360, 철원군,060003, 57세,2021,625,333,292,114,621,332,289,114.9
32360, 철원군,060004, 58세,2021,774,396,378,104.8,771,396,375,105.6
32360, 철원군,060005, 59세,2021,753,414,339,122.1,746,411,335,122.7
32360, 철원군,065,60~64세,2021,3899,1999,1900,105.2,3872,1988,1884,105.5
32360, 철원군,065001, 60세,2021,841,452,389,116.2,836,450,386,116.6
32360, 철원군,065002, 61세,2021,846,428,418,102.4,839,424,415,102.2
32360, 철원군,065003, 62세,2021,731,356,375,94.9,724,355,369,96.2
32360, 철원군,065004, 63세,2021,758,379,379,100,756,378,378,100
32360, 철원군,065005, 64세,2021,723,384,339,113.3,717,381,336,113.4
32360, 철원군,070,65~69세,2021,2928,1370,1558,87.9,2918,1366,1552,88
32360, 철원군,070001, 65세,2021,639,306,333,91.9,636,305,331,92.1
32360, 철원군,070002, 66세,2021,683,332,351,94.6,681,332,349,95.1
32360, 철원군,070003, 67세,2021,659,326,333,97.9,658,325,333,97.6
32360, 철원군,070004, 68세,2021,486,216,270,80,485,215,270,79.6
32360, 철원군,070005, 69세,2021,461,190,271,70.1,458,189,269,70.3
32360, 철원군,075,70~74세,2021,2168,1003,1165,86.1,2162,1003,1159,86.5
32360, 철원군,075001, 70세,2021,344,161,183,88,343,161,182,88.5
32360, 철원군,075002, 71세,2021,404,190,214,88.8,403,190,213,89.2
32360, 철원군,075003, 72세,2021,484,226,258,87.6,483,226,257,87.9
32360, 철원군,075004, 73세,2021,453,197,256,77,450,197,253,77.9
32360, 철원군,075005, 74세,2021,483,229,254,90.2,483,229,254,90.2
32360, 철원군,080,75~79세,2021,2181,934,1247,74.9,2181,934,1247,74.9
32360, 철원군,080001, 75세,2021,379,180,199,90.5,379,180,199,90.5
32360, 철원군,080002, 76세,2021,484,223,261,85.4,484,223,261,85.4
32360, 철원군,080003, 77세,2021,426,174,252,69,426,174,252,69
32360, 철원군,080004, 78세,2021,429,171,258,66.3,429,171,258,66.3
32360, 철원군,080005, 79세,2021,463,186,277,67.1,463,186,277,67.1
32360, 철원군,085,80~84세,2021,1652,629,1023,61.5,1651,629,1022,61.5
32360, 철원군,085001, 80세,2021,403,162,241,67.2,402,162,240,67.5
32360, 철원군,085002, 81세,2021,373,144,229,62.9,373,144,229,62.9
32360, 철원군,085003, 82세,2021,345,122,223,54.7,345,122,223,54.7
32360, 철원군,085004, 83세,2021,281,112,169,66.3,281,112,169,66.3
32360, 철원군,085005, 84세,2021,250,89,161,55.3,250,89,161,55.3
32360, 철원군,090,85~89세,2021,599,195,404,48.3,598,195,403,48.4
32360, 철원군,090001, 85세,2021,175,57,118,48.3,175,57,118,48.3
32360, 철원군,090002, 86세,2021,142,46,96,47.9,141,46,95,48.4
32360, 철원군,090003, 87세,2021,104,25,79,31.6,104,25,79,31.6
32360, 철원군,090004, 88세,2021,104,33,71,46.5,104,33,71,46.5
32360, 철원군,090005, 89세,2021,74,34,40,85,74,34,40,85
32360, 철원군,095,90~94세,2021,262,62,200,31,262,62,200,31
32360, 철원군,095001, 90세,2021,58,18,40,45,58,18,40,45
32360, 철원군,095002, 91세,2021,66,17,49,34.7,66,17,49,34.7
32360, 철원군,095003, 92세,2021,57,9,48,18.8,57,9,48,18.8
32360, 철원군,095004, 93세,2021,48,9,39,23.1,48,9,39,23.1
32360, 철원군,095005, 94세,2021,33,9,24,37.5,33,9,24,37.5
32360, 철원군,100,95~99세,2021,60,9,51,17.6,60,9,51,17.6
32360, 철원군,100001, 95세,2021,23,X,21,9.5,23,X,21,9.5
32360, 철원군,100002, 96세,2021,9,X,7,28.6,9,X,7,28.6
32360, 철원군,100003, 97세,2021,15,X,14,7.1,15,X,14,7.1
32360, 철원군,100004, 98세,2021,9,X,5,80,9,X,5,80
32360, 철원군,100005, 99세,2021,X,X,X,0,X,X,X,0
32360, 철원군,101,100세이상,2021,9,X,7,28.6,9,X,7,28.6
32360, 철원군,102,15세미만,2021,4815,2433,2382,102.1,4813,2432,2381,102.1
32360, 철원군,103,15~64세,2021,27181,15132,12049,125.6,26259,14596,11663,125.1
32360, 철원군,104,65세이상,2021,9859,4204,5655,74.3,9841,4200,5641,74.5
32360, 철원군,086,85세이상,2021,930,268,662,40.5,929,268,661,40.5
32360, 철원군,126,평균연령,2021,46.6,44.5,48.9,,46.8,44.8,49.1,
32360, 철원군,127,중위연령,2021,49.2,46.4,52.3,,49.8,47.2,52.8,
32370, 화천군,000,합계,2021,23092,12520,10572,118.4,22758,12371,10387,119.1
32370, 화천군,005,0~4세,2021,812,415,397,104.5,812,415,397,104.5
32370, 화천군,005001, 0세,2021,141,85,56,151.8,141,85,56,151.8
32370, 화천군,005002, 1세,2021,171,83,88,94.3,171,83,88,94.3
32370, 화천군,005003, 2세,2021,184,88,96,91.7,184,88,96,91.7
32370, 화천군,005004, 3세,2021,164,78,86,90.7,164,78,86,90.7
32370, 화천군,005005, 4세,2021,152,81,71,114.1,152,81,71,114.1
32370, 화천군,010,5~9세,2021,902,462,440,105,902,462,440,105
32370, 화천군,010001, 5세,2021,166,78,88,88.6,166,78,88,88.6
32370, 화천군,010002, 6세,2021,205,109,96,113.5,205,109,96,113.5
32370, 화천군,010003, 7세,2021,183,104,79,131.6,183,104,79,131.6
32370, 화천군,010004, 8세,2021,165,88,77,114.3,165,88,77,114.3
32370, 화천군,010005, 9세,2021,183,83,100,83,183,83,100,83
32370, 화천군,015,10~14세,2021,799,391,408,95.8,799,391,408,95.8
32370, 화천군,015001, 10세,2021,167,82,85,96.5,167,82,85,96.5
32370, 화천군,015002, 11세,2021,173,85,88,96.6,173,85,88,96.6
32370, 화천군,015003, 12세,2021,151,68,83,81.9,151,68,83,81.9
32370, 화천군,015004, 13세,2021,157,79,78,101.3,157,79,78,101.3
32370, 화천군,015005, 14세,2021,151,77,74,104.1,151,77,74,104.1
32370, 화천군,020,15~19세,2021,741,387,354,109.3,741,387,354,109.3
32370, 화천군,020001, 15세,2021,171,91,80,113.8,171,91,80,113.8
32370, 화천군,020002, 16세,2021,136,73,63,115.9,136,73,63,115.9
32370, 화천군,020003, 17세,2021,169,81,88,92,169,81,88,92
32370, 화천군,020004, 18세,2021,151,81,70,115.7,151,81,70,115.7
32370, 화천군,020005, 19세,2021,114,61,53,115.1,114,61,53,115.1
32370, 화천군,025,20~24세,2021,1391,980,411,238.4,1365,968,397,243.8
32370, 화천군,025001, 20세,2021,164,108,56,192.9,163,108,55,196.4
32370, 화천군,025002, 21세,2021,216,149,67,222.4,214,148,66,224.2
32370, 화천군,025003, 22세,2021,229,173,56,308.9,225,171,54,316.7
32370, 화천군,025004, 23세,2021,354,251,103,243.7,345,246,99,248.5
32370, 화천군,025005, 24세,2021,428,299,129,231.8,418,295,123,239.8
32370, 화천군,030,25~29세,2021,1893,1348,545,247.3,1838,1315,523,251.4
32370, 화천군,030001, 25세,2021,365,265,100,265,351,258,93,277.4
32370, 화천군,030002, 26세,2021,397,295,102,289.2,385,288,97,296.9
32370, 화천군,030003, 27세,2021,406,285,121,235.5,396,279,117,238.5
32370, 화천군,030004, 28세,2021,333,242,91,265.9,326,237,89,266.3
32370, 화천군,030005, 29세,2021,392,261,131,199.2,380,253,127,199.2
32370, 화천군,035,30~34세,2021,1532,975,557,175,1470,949,521,182.1
32370, 화천군,035001, 30세,2021,354,228,126,181,342,225,117,192.3
32370, 화천군,035002, 31세,2021,335,228,107,213.1,320,220,100,220
32370, 화천군,035003, 32세,2021,291,188,103,182.5,282,183,99,184.8
32370, 화천군,035004, 33세,2021,289,175,114,153.5,276,168,108,155.6
32370, 화천군,035005, 34세,2021,263,156,107,145.8,250,153,97,157.7
32370, 화천군,040,35~39세,2021,1229,645,584,110.4,1178,630,548,115
32370, 화천군,040001, 35세,2021,255,125,130,96.2,238,119,119,100
32370, 화천군,040002, 36세,2021,223,124,99,125.3,218,124,94,131.9
32370, 화천군,040003, 37세,2021,263,136,127,107.1,247,131,116,112.9
32370, 화천군,040004, 38세,2021,205,108,97,111.3,200,106,94,112.8
32370, 화천군,040005, 39세,2021,283,152,131,116,275,150,125,120
32370, 화천군,045,40~44세,2021,1212,678,534,127,1166,652,514,126.8
32370, 화천군,045001, 40세,2021,269,149,120,124.2,256,142,114,124.6
32370, 화천군,045002, 41세,2021,245,131,114,114.9,235,129,106,121.7
32370, 화천군,045003, 42세,2021,236,137,99,138.4,230,132,98,134.7
32370, 화천군,045004, 43세,2021,215,136,79,172.2,208,131,77,170.1
32370, 화천군,045005, 44세,2021,247,125,122,102.5,237,118,119,99.2
32370, 화천군,050,45~49세,2021,1327,710,617,115.1,1305,697,608,114.6
32370, 화천군,050001, 45세,2021,223,116,107,108.4,219,114,105,108.6
32370, 화천군,050002, 46세,2021,240,138,102,135.3,233,134,99,135.4
32370, 화천군,050003, 47세,2021,283,152,131,116,278,148,130,113.8
32370, 화천군,050004, 48세,2021,286,143,143,100,282,141,141,100
32370, 화천군,050005, 49세,2021,295,161,134,120.1,293,160,133,120.3
32370, 화천군,055,50~54세,2021,1696,919,777,118.3,1677,911,766,118.9
32370, 화천군,055001, 50세,2021,313,169,144,117.4,309,167,142,117.6
32370, 화천군,055002, 51세,2021,319,174,145,120,317,174,143,121.7
32370, 화천군,055003, 52세,2021,358,193,165,117,354,190,164,115.9
32370, 화천군,055004, 53세,2021,371,205,166,123.5,365,203,162,125.3
32370, 화천군,055005, 54세,2021,335,178,157,113.4,332,177,155,114.2
32370, 화천군,060,55~59세,2021,1866,995,871,114.2,1840,986,854,115.5
32370, 화천군,060001, 55세,2021,353,187,166,112.7,346,182,164,111
32370, 화천군,060002, 56세,2021,348,182,166,109.6,341,180,161,111.8
32370, 화천군,060003, 57세,2021,406,206,200,103,401,204,197,103.6
32370, 화천군,060004, 58세,2021,375,199,176,113.1,372,199,173,115
32370, 화천군,060005, 59세,2021,384,221,163,135.6,380,221,159,139
32370, 화천군,065,60~64세,2021,2259,1217,1042,116.8,2243,1212,1031,117.6
32370, 화천군,065001, 60세,2021,530,280,250,112,527,278,249,111.6
32370, 화천군,065002, 61세,2021,460,237,223,106.3,454,235,219,107.3
32370, 화천군,065003, 62세,2021,433,240,193,124.4,431,240,191,125.7
32370, 화천군,065004, 63세,2021,395,221,174,127,393,221,172,128.5
32370, 화천군,065005, 64세,2021,441,239,202,118.3,438,238,200,119
32370, 화천군,070,65~69세,2021,1676,895,781,114.6,1671,893,778,114.8
32370, 화천군,070001, 65세,2021,356,185,171,108.2,355,185,170,108.8
32370, 화천군,070002, 66세,2021,388,208,180,115.6,387,207,180,115
32370, 화천군,070003, 67세,2021,359,198,161,123,358,197,161,122.4
32370, 화천군,070004, 68세,2021,290,155,135,114.8,290,155,135,114.8
32370, 화천군,070005, 69세,2021,283,149,134,111.2,281,149,132,112.9
32370, 화천군,075,70~74세,2021,1008,453,555,81.6,1006,453,553,81.9
32370, 화천군,075001, 70세,2021,150,64,86,74.4,149,64,85,75.3
32370, 화천군,075002, 71세,2021,187,83,104,79.8,186,83,103,80.6
32370, 화천군,075003, 72세,2021,215,86,129,66.7,215,86,129,66.7
32370, 화천군,075004, 73세,2021,225,111,114,97.4,225,111,114,97.4
32370, 화천군,075005, 74세,2021,231,109,122,89.3,231,109,122,89.3
32370, 화천군,080,75~79세,2021,1150,504,646,78,1148,504,644,78.3
32370, 화천군,080001, 75세,2021,220,103,117,88,219,103,116,88.8
32370, 화천군,080002, 76세,2021,213,79,134,59,213,79,134,59
32370, 화천군,080003, 77세,2021,202,105,97,108.2,201,105,96,109.4
32370, 화천군,080004, 78세,2021,255,119,136,87.5,255,119,136,87.5
32370, 화천군,080005, 79세,2021,260,98,162,60.5,260,98,162,60.5
32370, 화천군,085,80~84세,2021,982,363,619,58.6,981,363,618,58.7
32370, 화천군,085001, 80세,2021,245,95,150,63.3,244,95,149,63.8
32370, 화천군,085002, 81세,2021,211,80,131,61.1,211,80,131,61.1
32370, 화천군,085003, 82세,2021,200,78,122,63.9,200,78,122,63.9
32370, 화천군,085004, 83세,2021,167,51,116,44,167,51,116,44
32370, 화천군,085005, 84세,2021,159,59,100,59,159,59,100,59
32370, 화천군,090,85~89세,2021,420,136,284,47.9,420,136,284,47.9
32370, 화천군,090001, 85세,2021,121,36,85,42.4,121,36,85,42.4
32370, 화천군,090002, 86세,2021,106,27,79,34.2,106,27,79,34.2
32370, 화천군,090003, 87세,2021,76,27,49,55.1,76,27,49,55.1
32370, 화천군,090004, 88세,2021,65,29,36,80.6,65,29,36,80.6
32370, 화천군,090005, 89세,2021,52,17,35,48.6,52,17,35,48.6
32370, 화천군,095,90~94세,2021,148,30,118,25.4,147,30,117,25.6
32370, 화천군,095001, 90세,2021,39,9,30,30,39,9,30,30
32370, 화천군,095002, 91세,2021,50,12,38,31.6,49,12,37,32.4
32370, 화천군,095003, 92세,2021,27,X,23,17.4,27,X,23,17.4
32370, 화천군,095004, 93세,2021,22,X,19,15.8,22,X,19,15.8
32370, 화천군,095005, 94세,2021,10,X,8,25,10,X,8,25
32370, 화천군,100,95~99세,2021,42,14,28,50,42,14,28,50
32370, 화천군,100001, 95세,2021,11,X,9,22.2,11,X,9,22.2
32370, 화천군,100002, 96세,2021,9,X,7,28.6,9,X,7,28.6
32370, 화천군,100003, 97세,2021,6,X,X,100,6,X,X,100
32370, 화천군,100004, 98세,2021,10,X,6,66.7,10,X,6,66.7
32370, 화천군,100005, 99세,2021,6,X,X,100,6,X,X,100
32370, 화천군,101,100세이상,2021,7,X,X,75,7,X,X,75
32370, 화천군,102,15세미만,2021,2513,1268,1245,101.8,2513,1268,1245,101.8
32370, 화천군,103,15~64세,2021,15146,8854,6292,140.7,14823,8707,6116,142.4
32370, 화천군,104,65세이상,2021,5433,2398,3035,79,5422,2396,3026,79.2
32370, 화천군,086,85세이상,2021,617,183,434,42.2,616,183,433,42.3
32370, 화천군,126,평균연령,2021,46.5,44.2,49.2,,46.6,44.3,49.4,
32370, 화천군,127,중위연령,2021,49,44.8,52.9,,49.3,45.1,53.2,
32380, 양구군,000,합계,2021,21121,11111,10010,111,20710,10902,9808,111.2
32380, 양구군,005,0~4세,2021,808,400,408,98,808,400,408,98
32380, 양구군,005001, 0세,2021,159,79,80,98.8,159,79,80,98.8
32380, 양구군,005002, 1세,2021,152,77,75,102.7,152,77,75,102.7
32380, 양구군,005003, 2세,2021,152,76,76,100,152,76,76,100
32380, 양구군,005004, 3세,2021,161,84,77,109.1,161,84,77,109.1
32380, 양구군,005005, 4세,2021,184,84,100,84,184,84,100,84
32380, 양구군,010,5~9세,2021,857,436,421,103.6,855,435,420,103.6
32380, 양구군,010001, 5세,2021,178,81,97,83.5,178,81,97,83.5
32380, 양구군,010002, 6세,2021,175,92,83,110.8,175,92,83,110.8
32380, 양구군,010003, 7세,2021,148,81,67,120.9,147,80,67,119.4
32380, 양구군,010004, 8세,2021,167,83,84,98.8,167,83,84,98.8
32380, 양구군,010005, 9세,2021,189,99,90,110,188,99,89,111.2
32380, 양구군,015,10~14세,2021,817,421,396,106.3,817,421,396,106.3
32380, 양구군,015001, 10세,2021,180,100,80,125,180,100,80,125
32380, 양구군,015002, 11세,2021,170,78,92,84.8,170,78,92,84.8
32380, 양구군,015003, 12세,2021,140,76,64,118.8,140,76,64,118.8
32380, 양구군,015004, 13세,2021,161,77,84,91.7,161,77,84,91.7
32380, 양구군,015005, 14세,2021,166,90,76,118.4,166,90,76,118.4
32380, 양구군,020,15~19세,2021,1066,506,560,90.4,1066,506,560,90.4
32380, 양구군,020001, 15세,2021,179,86,93,92.5,179,86,93,92.5
32380, 양구군,020002, 16세,2021,253,130,123,105.7,253,130,123,105.7
32380, 양구군,020003, 17세,2021,272,106,166,63.9,272,106,166,63.9
32380, 양구군,020004, 18세,2021,224,106,118,89.8,224,106,118,89.8
32380, 양구군,020005, 19세,2021,138,78,60,130,138,78,60,130
32380, 양구군,025,20~24세,2021,1053,742,311,238.6,1037,738,299,246.8
32380, 양구군,025001, 20세,2021,122,89,33,269.7,121,89,32,278.1
32380, 양구군,025002, 21세,2021,180,125,55,227.3,179,125,54,231.5
32380, 양구군,025003, 22세,2021,188,129,59,218.6,187,129,58,222.4
32380, 양구군,025004, 23세,2021,274,194,80,242.5,268,193,75,257.3
32380, 양구군,025005, 24세,2021,289,205,84,244,282,202,80,252.5
32380, 양구군,030,25~29세,2021,1492,983,509,193.1,1448,960,488,196.7
32380, 양구군,030001, 25세,2021,276,190,86,220.9,269,185,84,220.2
32380, 양구군,030002, 26세,2021,309,204,105,194.3,300,199,101,197
32380, 양구군,030003, 27세,2021,310,225,85,264.7,301,221,80,276.3
32380, 양구군,030004, 28세,2021,291,171,120,142.5,279,165,114,144.7
32380, 양구군,030005, 29세,2021,306,193,113,170.8,299,190,109,174.3
32380, 양구군,035,30~34세,2021,1297,740,557,132.9,1240,715,525,136.2
32380, 양구군,035001, 30세,2021,293,176,117,150.4,286,175,111,157.7
32380, 양구군,035002, 31세,2021,272,165,107,154.2,255,155,100,155
32380, 양구군,035003, 32세,2021,246,136,110,123.6,231,129,102,126.5
32380, 양구군,035004, 33세,2021,254,142,112,126.8,246,139,107,129.9
32380, 양구군,035005, 34세,2021,232,121,111,109,222,117,105,111.4
32380, 양구군,040,35~39세,2021,1284,713,571,124.9,1175,631,544,116
32380, 양구군,040001, 35세,2021,240,135,105,128.6,225,124,101,122.8
32380, 양구군,040002, 36세,2021,228,141,87,162.1,203,125,78,160.3
32380, 양구군,040003, 37세,2021,251,140,111,126.1,226,120,106,113.2
32380, 양구군,040004, 38세,2021,262,138,124,111.3,238,118,120,98.3
32380, 양구군,040005, 39세,2021,303,159,144,110.4,283,144,139,103.6
32380, 양구군,045,40~44세,2021,1173,631,542,116.4,1103,585,518,112.9
32380, 양구군,045001, 40세,2021,251,132,119,110.9,235,121,114,106.1
32380, 양구군,045002, 41세,2021,254,146,108,135.2,238,133,105,126.7
32380, 양구군,045003, 42세,2021,217,109,108,100.9,201,102,99,103
32380, 양구군,045004, 43세,2021,233,131,102,128.4,222,125,97,128.9
32380, 양구군,045005, 44세,2021,218,113,105,107.6,207,104,103,101
32380, 양구군,050,45~49세,2021,1253,675,578,116.8,1222,663,559,118.6
32380, 양구군,050001, 45세,2021,227,118,109,108.3,218,111,107,103.7
32380, 양구군,050002, 46세,2021,224,115,109,105.5,217,114,103,110.7
32380, 양구군,050003, 47세,2021,261,146,115,127,254,145,109,133
32380, 양구군,050004, 48세,2021,287,157,130,120.8,285,157,128,122.7
32380, 양구군,050005, 49세,2021,254,139,115,120.9,248,136,112,121.4
32380, 양구군,055,50~54세,2021,1542,823,719,114.5,1512,819,693,118.2
32380, 양구군,055001, 50세,2021,270,140,130,107.7,264,139,125,111.2
32380, 양구군,055002, 51세,2021,298,153,145,105.5,290,152,138,110.1
32380, 양구군,055003, 52세,2021,312,175,137,127.7,309,175,134,130.6
32380, 양구군,055004, 53세,2021,335,181,154,117.5,326,180,146,123.3
32380, 양구군,055005, 54세,2021,327,174,153,113.7,323,173,150,115.3
32380, 양구군,060,55~59세,2021,1754,907,847,107.1,1733,904,829,109
32380, 양구군,060001, 55세,2021,292,145,147,98.6,290,145,145,100
32380, 양구군,060002, 56세,2021,323,163,160,101.9,316,161,155,103.9
32380, 양구군,060003, 57세,2021,359,195,164,118.9,357,195,162,120.4
32380, 양구군,060004, 58세,2021,373,192,181,106.1,369,191,178,107.3
32380, 양구군,060005, 59세,2021,407,212,195,108.7,401,212,189,112.2
32380, 양구군,065,60~64세,2021,2053,1075,978,109.9,2041,1072,969,110.6
32380, 양구군,065001, 60세,2021,464,240,224,107.1,458,238,220,108.2
32380, 양구군,065002, 61세,2021,450,235,215,109.3,450,235,215,109.3
32380, 양구군,065003, 62세,2021,373,202,171,118.1,372,202,170,118.8
32380, 양구군,065004, 63세,2021,401,208,193,107.8,398,207,191,108.4
32380, 양구군,065005, 64세,2021,365,190,175,108.6,363,190,173,109.8
32380, 양구군,070,65~69세,2021,1458,786,672,117,1448,782,666,117.4
32380, 양구군,070001, 65세,2021,348,186,162,114.8,344,185,159,116.4
32380, 양구군,070002, 66세,2021,331,187,144,129.9,331,187,144,129.9
32380, 양구군,070003, 67세,2021,332,179,153,117,330,179,151,118.5
32380, 양구군,070004, 68세,2021,212,107,105,101.9,209,105,104,101
32380, 양구군,070005, 69세,2021,235,127,108,117.6,234,126,108,116.7
32380, 양구군,075,70~74세,2021,886,387,499,77.6,881,386,495,78
32380, 양구군,075001, 70세,2021,167,77,90,85.6,166,77,89,86.5
32380, 양구군,075002, 71세,2021,163,72,91,79.1,163,72,91,79.1
32380, 양구군,075003, 72세,2021,179,76,103,73.8,179,76,103,73.8
32380, 양구군,075004, 73세,2021,178,84,94,89.4,175,83,92,90.2
32380, 양구군,075005, 74세,2021,199,78,121,64.5,198,78,120,65
32380, 양구군,080,75~79세,2021,1008,439,569,77.2,1005,438,567,77.2
32380, 양구군,080001, 75세,2021,176,79,97,81.4,176,79,97,81.4
32380, 양구군,080002, 76세,2021,180,87,93,93.5,179,87,92,94.6
32380, 양구군,080003, 77세,2021,214,102,112,91.1,214,102,112,91.1
32380, 양구군,080004, 78세,2021,206,83,123,67.5,206,83,123,67.5
32380, 양구군,080005, 79세,2021,232,88,144,61.1,230,87,143,60.8
32380, 양구군,085,80~84세,2021,791,298,493,60.4,790,298,492,60.6
32380, 양구군,085001, 80세,2021,190,82,108,75.9,190,82,108,75.9
32380, 양구군,085002, 81세,2021,169,62,107,57.9,168,62,106,58.5
32380, 양구군,085003, 82세,2021,178,66,112,58.9,178,66,112,58.9
32380, 양구군,085004, 83세,2021,130,43,87,49.4,130,43,87,49.4
32380, 양구군,085005, 84세,2021,124,45,79,57,124,45,79,57
32380, 양구군,090,85~89세,2021,360,105,255,41.2,360,105,255,41.2
32380, 양구군,090001, 85세,2021,101,37,64,57.8,101,37,64,57.8
32380, 양구군,090002, 86세,2021,75,22,53,41.5,75,22,53,41.5
32380, 양구군,090003, 87세,2021,71,14,57,24.6,71,14,57,24.6
32380, 양구군,090004, 88세,2021,70,19,51,37.3,70,19,51,37.3
32380, 양구군,090005, 89세,2021,43,13,30,43.3,43,13,30,43.3
32380, 양구군,095,90~94세,2021,138,34,104,32.7,138,34,104,32.7
32380, 양구군,095001, 90세,2021,51,13,38,34.2,51,13,38,34.2
32380, 양구군,095002, 91세,2021,23,X,19,21.1,23,X,19,21.1
32380, 양구군,095003, 92세,2021,27,8,19,42.1,27,8,19,42.1
32380, 양구군,095004, 93세,2021,15,5,10,50,15,5,10,50
32380, 양구군,095005, 94세,2021,22,X,18,22.2,22,X,18,22.2
32380, 양구군,100,95~99세,2021,25,7,18,38.9,25,7,18,38.9
32380, 양구군,100001, 95세,2021,6,X,X,50,6,X,X,50
32380, 양구군,100002, 96세,2021,6,X,5,20,6,X,5,20
32380, 양구군,100003, 97세,2021,6,X,5,20,6,X,5,20
32380, 양구군,100004, 98세,2021,5,X,X,66.7,5,X,X,66.7
32380, 양구군,100005, 99세,2021,X,X,X,100,X,X,X,100
32380, 양구군,101,100세이상,2021,6,X,X,100,6,X,X,100
32380, 양구군,102,15세미만,2021,2482,1257,1225,102.6,2480,1256,1224,102.6
32380, 양구군,103,15~64세,2021,13967,7795,6172,126.3,13577,7593,5984,126.9
32380, 양구군,104,65세이상,2021,4672,2059,2613,78.8,4653,2053,2600,79
32380, 양구군,086,85세이상,2021,529,149,380,39.2,529,149,380,39.2
32380, 양구군,126,평균연령,2021,45.7,43.9,47.7,,45.8,44,47.8,
32380, 양구군,127,중위연령,2021,48,44.8,51.1,,48.4,45.5,51.4,
32390, 인제군,000,합계,2021,30670,16598,14072,118,30183,16366,13817,118.4
32390, 인제군,005,0~4세,2021,1203,606,597,101.5,1201,604,597,101.2
32390, 인제군,005001, 0세,2021,225,112,113,99.1,224,111,113,98.2
32390, 인제군,005002, 1세,2021,234,129,105,122.9,234,129,105,122.9
32390, 인제군,005003, 2세,2021,256,124,132,93.9,256,124,132,93.9
32390, 인제군,005004, 3세,2021,226,110,116,94.8,226,110,116,94.8
32390, 인제군,005005, 4세,2021,262,131,131,100,261,130,131,99.2
32390, 인제군,010,5~9세,2021,1275,646,629,102.7,1274,646,628,102.9
32390, 인제군,010001, 5세,2021,258,140,118,118.6,258,140,118,118.6
32390, 인제군,010002, 6세,2021,265,137,128,107,265,137,128,107
32390, 인제군,010003, 7세,2021,232,116,116,100,232,116,116,100
32390, 인제군,010004, 8세,2021,243,116,127,91.3,242,116,126,92.1
32390, 인제군,010005, 9세,2021,277,137,140,97.9,277,137,140,97.9
32390, 인제군,015,10~14세,2021,1129,607,522,116.3,1128,606,522,116.1
32390, 인제군,015001, 10세,2021,242,129,113,114.2,242,129,113,114.2
32390, 인제군,015002, 11세,2021,247,139,108,128.7,247,139,108,128.7
32390, 인제군,015003, 12세,2021,203,117,86,136,203,117,86,136
32390, 인제군,015004, 13세,2021,217,111,106,104.7,217,111,106,104.7
32390, 인제군,015005, 14세,2021,220,111,109,101.8,219,110,109,100.9
32390, 인제군,020,15~19세,2021,859,456,403,113.2,859,456,403,113.2
32390, 인제군,020001, 15세,2021,221,107,114,93.9,221,107,114,93.9
32390, 인제군,020002, 16세,2021,201,97,104,93.3,201,97,104,93.3
32390, 인제군,020003, 17세,2021,179,103,76,135.5,179,103,76,135.5
32390, 인제군,020004, 18세,2021,173,94,79,119,173,94,79,119
32390, 인제군,020005, 19세,2021,85,55,30,183.3,85,55,30,183.3
32390, 인제군,025,20~24세,2021,1588,1120,468,239.3,1558,1108,450,246.2
32390, 인제군,025001, 20세,2021,201,143,58,246.6,199,143,56,255.4
32390, 인제군,025002, 21세,2021,256,179,77,232.5,255,178,77,231.2
32390, 인제군,025003, 22세,2021,317,233,84,277.4,309,227,82,276.8
32390, 인제군,025004, 23세,2021,380,267,113,236.3,373,266,107,248.6
32390, 인제군,025005, 24세,2021,434,298,136,219.1,422,294,128,229.7
32390, 인제군,030,25~29세,2021,2172,1469,703,209,2087,1426,661,215.7
32390, 인제군,030001, 25세,2021,397,294,103,285.4,386,289,97,297.9
32390, 인제군,030002, 26세,2021,412,291,121,240.5,395,281,114,246.5
32390, 인제군,030003, 27세,2021,463,307,156,196.8,447,303,144,210.4
32390, 인제군,030004, 28세,2021,446,291,155,187.7,429,281,148,189.9
32390, 인제군,030005, 29세,2021,454,286,168,170.2,430,272,158,172.2
32390, 인제군,035,30~34세,2021,1998,1169,829,141,1926,1132,794,142.6
32390, 인제군,035001, 30세,2021,436,272,164,165.9,420,261,159,164.2
32390, 인제군,035002, 31세,2021,442,249,193,129,425,240,185,129.7
32390, 인제군,035003, 32세,2021,404,238,166,143.4,392,232,160,145
32390, 인제군,035004, 33세,2021,348,208,140,148.6,332,201,131,153.4
32390, 인제군,035005, 34세,2021,368,202,166,121.7,357,198,159,124.5
32390, 인제군,040,35~39세,2021,1916,1076,840,128.1,1830,1030,800,128.8
32390, 인제군,040001, 35세,2021,367,210,157,133.8,353,202,151,133.8
32390, 인제군,040002, 36세,2021,386,239,147,162.6,369,228,141,161.7
32390, 인제군,040003, 37세,2021,359,197,162,121.6,338,183,155,118.1
32390, 인제군,040004, 38세,2021,361,193,168,114.9,347,188,159,118.2
32390, 인제군,040005, 39세,2021,443,237,206,115,423,229,194,118
32390, 인제군,045,40~44세,2021,1941,1024,917,111.7,1885,997,888,112.3
32390, 인제군,045001, 40세,2021,427,237,190,124.7,415,229,186,123.1
32390, 인제군,045002, 41세,2021,408,213,195,109.2,390,207,183,113.1
32390, 인제군,045003, 42세,2021,398,210,188,111.7,389,205,184,111.4
32390, 인제군,045004, 43세,2021,352,194,158,122.8,344,190,154,123.4
32390, 인제군,045005, 44세,2021,356,170,186,91.4,347,166,181,91.7
32390, 인제군,050,45~49세,2021,1914,1092,822,132.8,1874,1080,794,136
32390, 인제군,050001, 45세,2021,338,192,146,131.5,334,189,145,130.3
32390, 인제군,050002, 46세,2021,375,203,172,118,365,203,162,125.3
32390, 인제군,050003, 47세,2021,391,235,156,150.6,385,234,151,155
32390, 인제군,050004, 48세,2021,384,214,170,125.9,374,209,165,126.7
32390, 인제군,050005, 49세,2021,426,248,178,139.3,416,245,171,143.3
32390, 인제군,055,50~54세,2021,2274,1254,1020,122.9,2227,1233,994,124
32390, 인제군,055001, 50세,2021,440,243,197,123.4,427,237,190,124.7
32390, 인제군,055002, 51세,2021,430,231,199,116.1,422,227,195,116.4
32390, 인제군,055003, 52세,2021,484,283,201,140.8,475,279,196,142.3
32390, 인제군,055004, 53세,2021,490,263,227,115.9,480,259,221,117.2
32390, 인제군,055005, 54세,2021,430,234,196,119.4,423,231,192,120.3
32390, 인제군,060,55~59세,2021,2682,1388,1294,107.3,2644,1368,1276,107.2
32390, 인제군,060001, 55세,2021,490,280,210,133.3,483,275,208,132.2
32390, 인제군,060002, 56세,2021,475,230,245,93.9,465,225,240,93.8
32390, 인제군,060003, 57세,2021,520,255,265,96.2,516,253,263,96.2
32390, 인제군,060004, 58세,2021,588,297,291,102.1,578,293,285,102.8
32390, 인제군,060005, 59세,2021,609,326,283,115.2,602,322,280,115
32390, 인제군,065,60~64세,2021,3156,1692,1464,115.6,3141,1687,1454,116
32390, 인제군,065001, 60세,2021,732,378,354,106.8,731,378,353,107.1
32390, 인제군,065002, 61세,2021,647,331,316,104.7,643,330,313,105.4
32390, 인제군,065003, 62세,2021,571,303,268,113.1,566,300,266,112.8
32390, 인제군,065004, 63세,2021,582,328,254,129.1,580,328,252,130.2
32390, 인제군,065005, 64세,2021,624,352,272,129.4,621,351,270,130
32390, 인제군,070,65~69세,2021,2262,1181,1081,109.3,2254,1177,1077,109.3
32390, 인제군,070001, 65세,2021,523,281,242,116.1,522,281,241,116.6
32390, 인제군,070002, 66세,2021,529,276,253,109.1,528,275,253,108.7
32390, 인제군,070003, 67세,2021,427,216,211,102.4,425,215,210,102.4
32390, 인제군,070004, 68세,2021,345,182,163,111.7,343,181,162,111.7
32390, 인제군,070005, 69세,2021,438,226,212,106.6,436,225,211,106.6
32390, 인제군,075,70~74세,2021,1245,606,639,94.8,1242,605,637,95
32390, 인제군,075001, 70세,2021,233,117,116,100.9,233,117,116,100.9
32390, 인제군,075002, 71세,2021,219,98,121,81,219,98,121,81
32390, 인제군,075003, 72세,2021,255,120,135,88.9,253,120,133,90.2
32390, 인제군,075004, 73세,2021,254,129,125,103.2,254,129,125,103.2
32390, 인제군,075005, 74세,2021,284,142,142,100,283,141,142,99.3
32390, 인제군,080,75~79세,2021,1285,597,688,86.8,1283,596,687,86.8
32390, 인제군,080001, 75세,2021,227,117,110,106.4,226,116,110,105.5
32390, 인제군,080002, 76세,2021,272,127,145,87.6,272,127,145,87.6
32390, 인제군,080003, 77세,2021,267,132,135,97.8,267,132,135,97.8
32390, 인제군,080004, 78세,2021,262,107,155,69,262,107,155,69
32390, 인제군,080005, 79세,2021,257,114,143,79.7,256,114,142,80.3
32390, 인제군,085,80~84세,2021,1041,403,638,63.2,1041,403,638,63.2
32390, 인제군,085001, 80세,2021,247,105,142,73.9,247,105,142,73.9
32390, 인제군,085002, 81세,2021,220,90,130,69.2,220,90,130,69.2
32390, 인제군,085003, 82세,2021,213,72,141,51.1,213,72,141,51.1
32390, 인제군,085004, 83세,2021,201,64,137,46.7,201,64,137,46.7
32390, 인제군,085005, 84세,2021,160,72,88,81.8,160,72,88,81.8
32390, 인제군,090,85~89세,2021,476,143,333,42.9,476,143,333,42.9
32390, 인제군,090001, 85세,2021,132,47,85,55.3,132,47,85,55.3
32390, 인제군,090002, 86세,2021,115,34,81,42,115,34,81,42
32390, 인제군,090003, 87세,2021,84,20,64,31.3,84,20,64,31.3
32390, 인제군,090004, 88세,2021,81,28,53,52.8,81,28,53,52.8
32390, 인제군,090005, 89세,2021,64,14,50,28,64,14,50,28
32390, 인제군,095,90~94세,2021,188,40,148,27,188,40,148,27
32390, 인제군,095001, 90세,2021,49,11,38,28.9,49,11,38,28.9
32390, 인제군,095002, 91세,2021,44,5,39,12.8,44,5,39,12.8
32390, 인제군,095003, 92세,2021,30,6,24,25,30,6,24,25
32390, 인제군,095004, 93세,2021,39,11,28,39.3,39,11,28,39.3
32390, 인제군,095005, 94세,2021,26,7,19,36.8,26,7,19,36.8
32390, 인제군,100,95~99세,2021,59,25,34,73.5,58,25,33,75.8
32390, 인제군,100001, 95세,2021,19,6,13,46.2,18,6,12,50
32390, 인제군,100002, 96세,2021,10,X,7,42.9,10,X,7,42.9
32390, 인제군,100003, 97세,2021,18,10,8,125,18,10,8,125
32390, 인제군,100004, 98세,2021,9,X,5,80,9,X,5,80
32390, 인제군,100005, 99세,2021,X,X,X,200,X,X,X,200
32390, 인제군,101,100세이상,2021,7,X,X,133.3,7,X,X,133.3
32390, 인제군,102,15세미만,2021,3607,1859,1748,106.4,3603,1856,1747,106.2
32390, 인제군,103,15~64세,2021,20500,11740,8760,134,20031,11517,8514,135.3
32390, 인제군,104,65세이상,2021,6563,2999,3564,84.1,6549,2993,3556,84.2
32390, 인제군,086,85세이상,2021,730,212,518,40.9,729,212,517,41
32390, 인제군,126,평균연령,2021,46,44.3,48.1,,46.1,44.3,48.3,
32390, 인제군,127,중위연령,2021,48.4,45.7,51.5,,48.7,45.9,51.9,
32400, 고성군,000,합계,2021,26650,13975,12675,110.3,25110,12876,12234,105.2
32400, 고성군,005,0~4세,2021,535,260,275,94.5,534,260,274,94.9
32400, 고성군,005001, 0세,2021,95,47,48,97.9,95,47,48,97.9
32400, 고성군,005002, 1세,2021,98,51,47,108.5,98,51,47,108.5
32400, 고성군,005003, 2세,2021,126,67,59,113.6,125,67,58,115.5
32400, 고성군,005004, 3세,2021,110,50,60,83.3,110,50,60,83.3
32400, 고성군,005005, 4세,2021,106,45,61,73.8,106,45,61,73.8
32400, 고성군,010,5~9세,2021,739,391,348,112.4,737,390,347,112.4
32400, 고성군,010001, 5세,2021,139,72,67,107.5,137,71,66,107.6
32400, 고성군,010002, 6세,2021,139,83,56,148.2,139,83,56,148.2
32400, 고성군,010003, 7세,2021,154,79,75,105.3,154,79,75,105.3
32400, 고성군,010004, 8세,2021,146,70,76,92.1,146,70,76,92.1
32400, 고성군,010005, 9세,2021,161,87,74,117.6,161,87,74,117.6
32400, 고성군,015,10~14세,2021,708,385,323,119.2,708,385,323,119.2
32400, 고성군,015001, 10세,2021,165,92,73,126,165,92,73,126
32400, 고성군,015002, 11세,2021,134,73,61,119.7,134,73,61,119.7
32400, 고성군,015003, 12세,2021,125,59,66,89.4,125,59,66,89.4
32400, 고성군,015004, 13세,2021,153,91,62,146.8,153,91,62,146.8
32400, 고성군,015005, 14세,2021,131,70,61,114.8,131,70,61,114.8
32400, 고성군,020,15~19세,2021,784,430,354,121.5,746,405,341,118.8
32400, 고성군,020001, 15세,2021,146,79,67,117.9,146,79,67,117.9
32400, 고성군,020002, 16세,2021,153,85,68,125,153,85,68,125
32400, 고성군,020003, 17세,2021,171,88,83,106,170,87,83,104.8
32400, 고성군,020004, 18세,2021,180,85,95,89.5,169,79,90,87.8
32400, 고성군,020005, 19세,2021,134,93,41,226.8,108,75,33,227.3
32400, 고성군,025,20~24세,2021,1667,1153,514,224.3,1121,767,354,216.7
32400, 고성군,025001, 20세,2021,226,165,61,270.5,154,116,38,305.3
32400, 고성군,025002, 21세,2021,334,224,110,203.6,218,147,71,207
32400, 고성군,025003, 22세,2021,335,238,97,245.4,222,155,67,231.3
32400, 고성군,025004, 23세,2021,375,260,115,226.1,245,166,79,210.1
32400, 고성군,025005, 24세,2021,397,266,131,203.1,282,183,99,184.8
32400, 고성군,030,25~29세,2021,1631,1133,498,227.5,1241,829,412,201.2
32400, 고성군,030001, 25세,2021,416,317,99,320.2,277,208,69,301.4
32400, 고성군,030002, 26세,2021,336,218,118,184.7,244,150,94,159.6
32400, 고성군,030003, 27세,2021,328,239,89,268.5,267,185,82,225.6
32400, 고성군,030004, 28세,2021,272,183,89,205.6,216,141,75,188
32400, 고성군,030005, 29세,2021,279,176,103,170.9,237,145,92,157.6
32400, 고성군,035,30~34세,2021,1240,769,471,163.3,1066,635,431,147.3
32400, 고성군,035001, 30세,2021,277,179,98,182.7,237,150,87,172.4
32400, 고성군,035002, 31세,2021,264,159,105,151.4,222,127,95,133.7
32400, 고성군,035003, 32세,2021,241,153,88,173.9,208,124,84,147.6
32400, 고성군,035004, 33세,2021,226,136,90,151.1,197,117,80,146.3
32400, 고성군,035005, 34세,2021,232,142,90,157.8,202,117,85,137.6
32400, 고성군,040,35~39세,2021,1220,701,519,135.1,1084,595,489,121.7
32400, 고성군,040001, 35세,2021,230,132,98,134.7,208,115,93,123.7
32400, 고성군,040002, 36세,2021,235,149,86,173.3,203,127,76,167.1
32400, 고성군,040003, 37세,2021,243,131,112,117,220,114,106,107.5
32400, 고성군,040004, 38세,2021,251,137,114,120.2,220,108,112,96.4
32400, 고성군,040005, 39세,2021,261,152,109,139.4,233,131,102,128.4
32400, 고성군,045,40~44세,2021,1319,723,596,121.3,1212,648,564,114.9
32400, 고성군,045001, 40세,2021,273,157,116,135.3,245,135,110,122.7
32400, 고성군,045002, 41세,2021,285,148,137,108,261,133,128,103.9
32400, 고성군,045003, 42세,2021,258,148,110,134.5,239,133,106,125.5
32400, 고성군,045004, 43세,2021,246,136,110,123.6,230,125,105,119
32400, 고성군,045005, 44세,2021,257,134,123,108.9,237,122,115,106.1
32400, 고성군,050,45~49세,2021,1680,932,748,124.6,1612,894,718,124.5
32400, 고성군,050001, 45세,2021,287,159,128,124.2,273,150,123,122
32400, 고성군,050002, 46세,2021,298,166,132,125.8,291,162,129,125.6
32400, 고성군,050003, 47세,2021,370,210,160,131.3,353,203,150,135.3
32400, 고성군,050004, 48세,2021,330,179,151,118.5,315,170,145,117.2
32400, 고성군,050005, 49세,2021,395,218,177,123.2,380,209,171,122.2
32400, 고성군,055,50~54세,2021,2076,1139,937,121.6,2051,1128,923,122.2
32400, 고성군,055001, 50세,2021,421,230,191,120.4,416,228,188,121.3
32400, 고성군,055002, 51세,2021,408,231,177,130.5,404,229,175,130.9
32400, 고성군,055003, 52세,2021,438,243,195,124.6,429,239,190,125.8
32400, 고성군,055004, 53세,2021,408,225,183,123,403,223,180,123.9
32400, 고성군,055005, 54세,2021,401,210,191,109.9,399,209,190,110
32400, 고성군,060,55~59세,2021,2339,1191,1148,103.7,2315,1183,1132,104.5
32400, 고성군,060001, 55세,2021,457,251,206,121.8,452,247,205,120.5
32400, 고성군,060002, 56세,2021,437,226,211,107.1,431,222,209,106.2
32400, 고성군,060003, 57세,2021,413,208,205,101.5,410,208,202,103
32400, 고성군,060004, 58세,2021,514,254,260,97.7,508,254,254,100
32400, 고성군,060005, 59세,2021,518,252,266,94.7,514,252,262,96.2
32400, 고성군,065,60~64세,2021,2914,1471,1443,101.9,2899,1465,1434,102.2
32400, 고성군,065001, 60세,2021,643,309,334,92.5,640,308,332,92.8
32400, 고성군,065002, 61세,2021,613,307,306,100.3,609,306,303,101
32400, 고성군,065003, 62세,2021,577,295,282,104.6,572,292,280,104.3
32400, 고성군,065004, 63세,2021,552,275,277,99.3,550,275,275,100
32400, 고성군,065005, 64세,2021,529,285,244,116.8,528,284,244,116.4
32400, 고성군,070,65~69세,2021,2359,1171,1188,98.6,2355,1169,1186,98.6
32400, 고성군,070001, 65세,2021,479,236,243,97.1,478,235,243,96.7
32400, 고성군,070002, 66세,2021,568,278,290,95.9,567,277,290,95.5
32400, 고성군,070003, 67세,2021,511,248,263,94.3,510,248,262,94.7
32400, 고성군,070004, 68세,2021,381,206,175,117.7,381,206,175,117.7
32400, 고성군,070005, 69세,2021,420,203,217,93.5,419,203,216,94
32400, 고성군,075,70~74세,2021,1583,721,862,83.6,1578,720,858,83.9
32400, 고성군,075001, 70세,2021,286,131,155,84.5,284,131,153,85.6
32400, 고성군,075002, 71세,2021,303,139,164,84.8,303,139,164,84.8
32400, 고성군,075003, 72세,2021,332,147,185,79.5,332,147,185,79.5
32400, 고성군,075004, 73세,2021,334,163,171,95.3,334,163,171,95.3
32400, 고성군,075005, 74세,2021,328,141,187,75.4,325,140,185,75.7
32400, 고성군,080,75~79세,2021,1707,697,1010,69,1705,697,1008,69.1
32400, 고성군,080001, 75세,2021,341,148,193,76.7,339,148,191,77.5
32400, 고성군,080002, 76세,2021,356,154,202,76.2,356,154,202,76.2
32400, 고성군,080003, 77세,2021,322,121,201,60.2,322,121,201,60.2
32400, 고성군,080004, 78세,2021,306,123,183,67.2,306,123,183,67.2
32400, 고성군,080005, 79세,2021,382,151,231,65.4,382,151,231,65.4
32400, 고성군,085,80~84세,2021,1263,467,796,58.7,1262,467,795,58.7
32400, 고성군,085001, 80세,2021,283,99,184,53.8,283,99,184,53.8
32400, 고성군,085002, 81세,2021,296,121,175,69.1,295,121,174,69.5
32400, 고성군,085003, 82세,2021,254,101,153,66,254,101,153,66
32400, 고성군,085004, 83세,2021,236,93,143,65,236,93,143,65
32400, 고성군,085005, 84세,2021,194,53,141,37.6,194,53,141,37.6
32400, 고성군,090,85~89세,2021,576,164,412,39.8,575,163,412,39.6
32400, 고성군,090001, 85세,2021,160,50,110,45.5,159,49,110,44.5
32400, 고성군,090002, 86세,2021,145,41,104,39.4,145,41,104,39.4
32400, 고성군,090003, 87세,2021,106,32,74,43.2,106,32,74,43.2
32400, 고성군,090004, 88세,2021,92,23,69,33.3,92,23,69,33.3
32400, 고성군,090005, 89세,2021,73,18,55,32.7,73,18,55,32.7
32400, 고성군,095,90~94세,2021,241,58,183,31.7,240,57,183,31.1
32400, 고성군,095001, 90세,2021,57,17,40,42.5,57,17,40,42.5
32400, 고성군,095002, 91세,2021,55,16,39,41,55,16,39,41
32400, 고성군,095003, 92세,2021,53,13,40,32.5,53,13,40,32.5
32400, 고성군,095004, 93세,2021,42,6,36,16.7,41,5,36,13.9
32400, 고성군,095005, 94세,2021,34,6,28,21.4,34,6,28,21.4
32400, 고성군,100,95~99세,2021,59,17,42,40.5,59,17,42,40.5
32400, 고성군,100001, 95세,2021,18,6,12,50,18,6,12,50
32400, 고성군,100002, 96세,2021,13,X,9,44.4,13,X,9,44.4
32400, 고성군,100003, 97세,2021,10,X,9,11.1,10,X,9,11.1
32400, 고성군,100004, 98세,2021,12,X,10,20,12,X,10,20
32400, 고성군,100005, 99세,2021,6,X,X,200,6,X,X,200
32400, 고성군,101,100세이상,2021,10,X,8,25,10,X,8,25
32400, 고성군,102,15세미만,2021,1982,1036,946,109.5,1979,1035,944,109.6
32400, 고성군,103,15~64세,2021,16870,9642,7228,133.4,15347,8549,6798,125.8
32400, 고성군,104,65세이상,2021,7798,3297,4501,73.3,7784,3292,4492,73.3
32400, 고성군,086,85세이상,2021,886,241,645,37.4,884,239,645,37.1
32400, 고성군,126,평균연령,2021,50.6,47.5,54,,51.8,49.1,54.8,
32400, 고성군,127,중위연령,2021,54.3,50.5,58.5,,56,52.7,59.3,
32410, 양양군,000,합계,2021,26632,13559,13073,103.7,26228,13350,12878,103.7
32410, 양양군,005,0~4세,2021,501,250,251,99.6,500,249,251,99.2
32410, 양양군,005001, 0세,2021,83,45,38,118.4,83,45,38,118.4
32410, 양양군,005002, 1세,2021,89,51,38,134.2,88,50,38,131.6
32410, 양양군,005003, 2세,2021,107,51,56,91.1,107,51,56,91.1
32410, 양양군,005004, 3세,2021,111,52,59,88.1,111,52,59,88.1
32410, 양양군,005005, 4세,2021,111,51,60,85,111,51,60,85
32410, 양양군,010,5~9세,2021,759,389,370,105.1,758,389,369,105.4
32410, 양양군,010001, 5세,2021,133,67,66,101.5,133,67,66,101.5
32410, 양양군,010002, 6세,2021,151,70,81,86.4,151,70,81,86.4
32410, 양양군,010003, 7세,2021,136,72,64,112.5,136,72,64,112.5
32410, 양양군,010004, 8세,2021,177,97,80,121.3,176,97,79,122.8
32410, 양양군,010005, 9세,2021,162,83,79,105.1,162,83,79,105.1
32410, 양양군,015,10~14세,2021,823,434,389,111.6,823,434,389,111.6
32410, 양양군,015001, 10세,2021,173,91,82,111,173,91,82,111
32410, 양양군,015002, 11세,2021,160,88,72,122.2,160,88,72,122.2
32410, 양양군,015003, 12세,2021,148,75,73,102.7,148,75,73,102.7
32410, 양양군,015004, 13세,2021,161,88,73,120.5,161,88,73,120.5
32410, 양양군,015005, 14세,2021,181,92,89,103.4,181,92,89,103.4
32410, 양양군,020,15~19세,2021,795,439,356,123.3,794,439,355,123.7
32410, 양양군,020001, 15세,2021,148,77,71,108.5,147,77,70,110
32410, 양양군,020002, 16세,2021,161,82,79,103.8,161,82,79,103.8
32410, 양양군,020003, 17세,2021,188,118,70,168.6,188,118,70,168.6
32410, 양양군,020004, 18세,2021,175,85,90,94.4,175,85,90,94.4
32410, 양양군,020005, 19세,2021,123,77,46,167.4,123,77,46,167.4
32410, 양양군,025,20~24세,2021,935,570,365,156.2,904,554,350,158.3
32410, 양양군,025001, 20세,2021,160,101,59,171.2,160,101,59,171.2
32410, 양양군,025002, 21세,2021,184,130,54,240.7,182,129,53,243.4
32410, 양양군,025003, 22세,2021,194,112,82,136.6,182,107,75,142.7
32410, 양양군,025004, 23세,2021,181,113,68,166.2,172,108,64,168.8
32410, 양양군,025005, 24세,2021,216,114,102,111.8,208,109,99,110.1
32410, 양양군,030,25~29세,2021,1077,665,412,161.4,1000,619,381,162.5
32410, 양양군,030001, 25세,2021,212,132,80,165,198,121,77,157.1
32410, 양양군,030002, 26세,2021,227,150,77,194.8,216,143,73,195.9
32410, 양양군,030003, 27세,2021,204,132,72,183.3,185,120,65,184.6
32410, 양양군,030004, 28세,2021,227,130,97,134,209,123,86,143
32410, 양양군,030005, 29세,2021,207,121,86,140.7,192,112,80,140
32410, 양양군,035,30~34세,2021,1018,573,445,128.8,949,534,415,128.7
32410, 양양군,035001, 30세,2021,190,126,64,196.9,177,119,58,205.2
32410, 양양군,035002, 31세,2021,196,112,84,133.3,183,102,81,125.9
32410, 양양군,035003, 32세,2021,209,111,98,113.3,191,102,89,114.6
32410, 양양군,035004, 33세,2021,193,108,85,127.1,183,103,80,128.8
32410, 양양군,035005, 34세,2021,230,116,114,101.8,215,108,107,100.9
32410, 양양군,040,35~39세,2021,1235,696,539,129.1,1182,665,517,128.6
32410, 양양군,040001, 35세,2021,198,113,85,132.9,186,109,77,141.6
32410, 양양군,040002, 36세,2021,232,130,102,127.5,220,122,98,124.5
32410, 양양군,040003, 37세,2021,224,140,84,166.7,218,136,82,165.9
32410, 양양군,040004, 38세,2021,283,152,131,116,274,144,130,110.8
32410, 양양군,040005, 39세,2021,298,161,137,117.5,284,154,130,118.5
32410, 양양군,045,40~44세,2021,1545,823,722,114,1516,805,711,113.2
32410, 양양군,045001, 40세,2021,284,159,125,127.2,276,151,125,120.8
32410, 양양군,045002, 41세,2021,343,181,162,111.7,335,176,159,110.7
32410, 양양군,045003, 42세,2021,315,166,149,111.4,312,165,147,112.2
32410, 양양군,045004, 43세,2021,304,161,143,112.6,302,159,143,111.2
32410, 양양군,045005, 44세,2021,299,156,143,109.1,291,154,137,112.4
32410, 양양군,050,45~49세,2021,1735,966,769,125.6,1702,949,753,126
32410, 양양군,050001, 45세,2021,280,176,104,169.2,273,174,99,175.8
32410, 양양군,050002, 46세,2021,345,177,168,105.4,339,174,165,105.5
32410, 양양군,050003, 47세,2021,363,201,162,124.1,354,197,157,125.5
32410, 양양군,050004, 48세,2021,382,226,156,144.9,378,222,156,142.3
32410, 양양군,050005, 49세,2021,365,186,179,103.9,358,182,176,103.4
32410, 양양군,055,50~54세,2021,2255,1239,1016,121.9,2227,1231,996,123.6
32410, 양양군,055001, 50세,2021,404,213,191,111.5,398,210,188,111.7
32410, 양양군,055002, 51세,2021,447,255,192,132.8,441,254,187,135.8
32410, 양양군,055003, 52세,2021,483,257,226,113.7,480,256,224,114.3
32410, 양양군,055004, 53세,2021,487,276,211,130.8,483,274,209,131.1
32410, 양양군,055005, 54세,2021,434,238,196,121.4,425,237,188,126.1
32410, 양양군,060,55~59세,2021,2476,1240,1236,100.3,2442,1228,1214,101.2
32410, 양양군,060001, 55세,2021,475,263,212,124.1,471,263,208,126.4
32410, 양양군,060002, 56세,2021,464,222,242,91.7,458,221,237,93.2
32410, 양양군,060003, 57세,2021,467,212,255,83.1,458,209,249,83.9
32410, 양양군,060004, 58세,2021,521,264,257,102.7,515,261,254,102.8
32410, 양양군,060005, 59세,2021,549,279,270,103.3,540,274,266,103
32410, 양양군,065,60~64세,2021,3138,1599,1539,103.9,3109,1586,1523,104.1
32410, 양양군,065001, 60세,2021,659,337,322,104.7,653,335,318,105.3
32410, 양양군,065002, 61세,2021,643,332,311,106.8,638,331,307,107.8
32410, 양양군,065003, 62세,2021,596,303,293,103.4,592,301,291,103.4
32410, 양양군,065004, 63세,2021,612,318,294,108.2,609,316,293,107.8
32410, 양양군,065005, 64세,2021,628,309,319,96.9,617,303,314,96.5
32410, 양양군,070,65~69세,2021,2577,1252,1325,94.5,2568,1247,1321,94.4
32410, 양양군,070001, 65세,2021,497,251,246,102,495,249,246,101.2
32410, 양양군,070002, 66세,2021,614,307,307,100,610,306,304,100.7
32410, 양양군,070003, 67세,2021,546,258,288,89.6,544,256,288,88.9
32410, 양양군,070004, 68세,2021,414,208,206,101,413,208,205,101.5
32410, 양양군,070005, 69세,2021,506,228,278,82,506,228,278,82
32410, 양양군,075,70~74세,2021,1771,863,908,95,1768,862,906,95.1
32410, 양양군,075001, 70세,2021,318,162,156,103.8,317,162,155,104.5
32410, 양양군,075002, 71세,2021,330,153,177,86.4,329,153,176,86.9
32410, 양양군,075003, 72세,2021,354,185,169,109.5,354,185,169,109.5
32410, 양양군,075004, 73세,2021,364,163,201,81.1,363,162,201,80.6
32410, 양양군,075005, 74세,2021,405,200,205,97.6,405,200,205,97.6
32410, 양양군,080,75~79세,2021,1760,771,989,78,1756,770,986,78.1
32410, 양양군,080001, 75세,2021,333,169,164,103,332,169,163,103.7
32410, 양양군,080002, 76세,2021,362,141,221,63.8,361,141,220,64.1
32410, 양양군,080003, 77세,2021,358,152,206,73.8,357,151,206,73.3
32410, 양양군,080004, 78세,2021,352,153,199,76.9,352,153,199,76.9
32410, 양양군,080005, 79세,2021,355,156,199,78.4,354,156,198,78.8
32410, 양양군,085,80~84세,2021,1293,516,777,66.4,1292,515,777,66.3
32410, 양양군,085001, 80세,2021,310,124,186,66.7,310,124,186,66.7
32410, 양양군,085002, 81세,2021,296,126,170,74.1,295,125,170,73.5
32410, 양양군,085003, 82세,2021,260,105,155,67.7,260,105,155,67.7
32410, 양양군,085004, 83세,2021,255,95,160,59.4,255,95,160,59.4
32410, 양양군,085005, 84세,2021,172,66,106,62.3,172,66,106,62.3
32410, 양양군,090,85~89세,2021,629,205,424,48.3,628,205,423,48.5
32410, 양양군,090001, 85세,2021,196,64,132,48.5,196,64,132,48.5
32410, 양양군,090002, 86세,2021,151,64,87,73.6,151,64,87,73.6
32410, 양양군,090003, 87세,2021,114,31,83,37.3,113,31,82,37.8
32410, 양양군,090004, 88세,2021,94,27,67,40.3,94,27,67,40.3
32410, 양양군,090005, 89세,2021,74,19,55,34.5,74,19,55,34.5
32410, 양양군,095,90~94세,2021,225,56,169,33.1,225,56,169,33.1
32410, 양양군,095001, 90세,2021,62,19,43,44.2,62,19,43,44.2
32410, 양양군,095002, 91세,2021,42,11,31,35.5,42,11,31,35.5
32410, 양양군,095003, 92세,2021,45,12,33,36.4,45,12,33,36.4
32410, 양양군,095004, 93세,2021,42,9,33,27.3,42,9,33,27.3
32410, 양양군,095005, 94세,2021,34,5,29,17.2,34,5,29,17.2
32410, 양양군,100,95~99세,2021,75,12,63,19,75,12,63,19
32410, 양양군,100001, 95세,2021,28,X,25,12,28,X,25,12
32410, 양양군,100002, 96세,2021,19,X,17,11.8,19,X,17,11.8
32410, 양양군,100003, 97세,2021,15,X,11,36.4,15,X,11,36.4
32410, 양양군,100004, 98세,2021,8,X,5,60,8,X,5,60
32410, 양양군,100005, 99세,2021,5,X,5,0,5,X,5,0
32410, 양양군,101,100세이상,2021,10,X,9,11.1,10,X,9,11.1
32410, 양양군,102,15세미만,2021,2083,1073,1010,106.2,2081,1072,1009,106.2
32410, 양양군,103,15~64세,2021,16209,8810,7399,119.1,15825,8610,7215,119.3
32410, 양양군,104,65세이상,2021,8340,3676,4664,78.8,8322,3668,4654,78.8
32410, 양양군,086,85세이상,2021,939,274,665,41.2,938,274,664,41.3
32410, 양양군,126,평균연령,2021,52.4,50.4,54.5,,52.6,50.6,54.7,
32410, 양양군,127,중위연령,2021,56.4,53.9,58.8,,56.6,54.2,59,
33,충청북도,000,합계,2021,1624764,828073,796691,103.9,1568133,794362,773771,102.7
33,충청북도,005,0~4세,2021,49661,25522,24139,105.7,48618,24977,23641,105.7
33,충청북도,005001, 0세,2021,8440,4306,4134,104.2,8282,4227,4055,104.2
33,충청북도,005002, 1세,2021,8941,4631,4310,107.4,8737,4521,4216,107.2
33,충청북도,005003, 2세,2021,9678,5011,4667,107.4,9452,4898,4554,107.6
33,충청북도,005004, 3세,2021,10979,5583,5396,103.5,10750,5468,5282,103.5
33,충청북도,005005, 4세,2021,11623,5991,5632,106.4,11397,5863,5534,105.9
33,충청북도,010,5~9세,2021,68719,34959,33760,103.6,67749,34479,33270,103.6
33,충청북도,010001, 5세,2021,13077,6727,6350,105.9,12835,6605,6230,106
33,충청북도,010002, 6세,2021,13444,6836,6608,103.5,13232,6732,6500,103.6
33,충청북도,010003, 7세,2021,13465,6749,6716,100.5,13276,6652,6624,100.4
33,충청북도,010004, 8세,2021,13750,6990,6760,103.4,13577,6910,6667,103.6
33,충청북도,010005, 9세,2021,14983,7657,7326,104.5,14829,7580,7249,104.6
33,충청북도,015,10~14세,2021,72793,37578,35215,106.7,72159,37265,34894,106.8
33,충청북도,015001, 10세,2021,15000,7678,7322,104.9,14853,7613,7240,105.2
33,충청북도,015002, 11세,2021,14428,7404,7024,105.4,14297,7338,6959,105.4
33,충청북도,015003, 12세,2021,13800,7194,6606,108.9,13676,7127,6549,108.8
33,충청북도,015004, 13세,2021,14517,7563,6954,108.8,14407,7507,6900,108.8
33,충청북도,015005, 14세,2021,15048,7739,7309,105.9,14926,7680,7246,106
33,충청북도,020,15~19세,2021,74333,38856,35477,109.5,73621,38478,35143,109.5
33,충청북도,020001, 15세,2021,13607,7026,6581,106.8,13508,6969,6539,106.6
33,충청북도,020002, 16세,2021,13613,7111,6502,109.4,13511,7062,6449,109.5
33,충청북도,020003, 17세,2021,14695,7723,6972,110.8,14605,7678,6927,110.8
33,충청북도,020004, 18세,2021,15227,7974,7253,109.9,15101,7907,7194,109.9
33,충청북도,020005, 19세,2021,17191,9022,8169,110.4,16896,8862,8034,110.3
33,충청북도,025,20~24세,2021,104543,57048,47495,120.1,99144,53843,45301,118.9
33,충청북도,025001, 20세,2021,19601,10177,9424,108,19103,9915,9188,107.9
33,충청북도,025002, 21세,2021,21214,10995,10219,107.6,20377,10527,9850,106.9
33,충청북도,025003, 22세,2021,20855,11509,9346,123.1,19721,10867,8854,122.7
33,충청북도,025004, 23세,2021,21138,11935,9203,129.7,19797,11107,8690,127.8
33,충청북도,025005, 24세,2021,21735,12432,9303,133.6,20146,11427,8719,131.1
33,충청북도,030,25~29세,2021,109466,63488,45978,138.1,100476,57629,42847,134.5
33,충청북도,030001, 25세,2021,21843,12712,9131,139.2,20125,11546,8579,134.6
33,충청북도,030002, 26세,2021,21882,12500,9382,133.2,20087,11328,8759,129.3
33,충청북도,030003, 27세,2021,21912,12785,9127,140.1,20116,11613,8503,136.6
33,충청북도,030004, 28세,2021,22132,12859,9273,138.7,20335,11692,8643,135.3
33,충청북도,030005, 29세,2021,21697,12632,9065,139.3,19813,11450,8363,136.9
33,충청북도,035,30~34세,2021,96856,53699,43157,124.4,87190,47521,39669,119.8
33,충청북도,035001, 30세,2021,20313,11504,8809,130.6,18369,10223,8146,125.5
33,충청북도,035002, 31세,2021,19576,11029,8547,129,17631,9811,7820,125.5
33,충청북도,035003, 32세,2021,18803,10471,8332,125.7,16892,9253,7639,121.1
33,충청북도,035004, 33세,2021,18909,10296,8613,119.5,17019,9104,7915,115
33,충청북도,035005, 34세,2021,19255,10399,8856,117.4,17279,9130,8149,112
33,충청북도,040,35~39세,2021,106838,56792,50046,113.5,99118,51924,47194,110
33,충청북도,040001, 35세,2021,19378,10538,8840,119.2,17635,9451,8184,115.5
33,충청북도,040002, 36세,2021,19445,10346,9099,113.7,17856,9345,8511,109.8
33,충청북도,040003, 37세,2021,20806,11177,9629,116.1,19289,10229,9060,112.9
33,충청북도,040004, 38세,2021,22490,11829,10661,111,21047,10884,10163,107.1
33,충청북도,040005, 39세,2021,24719,12902,11817,109.2,23291,12015,11276,106.6
33,충청북도,045,40~44세,2021,115376,60308,55068,109.5,109926,56910,53016,107.3
33,충청북도,045001, 40세,2021,23352,12349,11003,112.2,22084,11558,10526,109.8
33,충청북도,045002, 41세,2021,24413,12713,11700,108.7,23265,11964,11301,105.9
33,충청북도,045003, 42세,2021,23479,12321,11158,110.4,22361,11618,10743,108.1
33,충청북도,045004, 43세,2021,21663,11288,10375,108.8,20668,10687,9981,107.1
33,충청북도,045005, 44세,2021,22469,11637,10832,107.4,21548,11083,10465,105.9
33,충청북도,050,45~49세,2021,123134,63538,59596,106.6,118973,61218,57755,106
33,충청북도,050001, 45세,2021,22254,11574,10680,108.4,21392,11069,10323,107.2
33,충청북도,050002, 46세,2021,23569,11962,11607,103.1,22737,11494,11243,102.2
33,충청북도,050003, 47세,2021,26043,13475,12568,107.2,25279,13071,12208,107.1
33,충청북도,050004, 48세,2021,26321,13499,12822,105.3,25499,13036,12463,104.6
33,충청북도,050005, 49세,2021,24947,13028,11919,109.3,24066,12548,11518,108.9
33,충청북도,055,50~54세,2021,139405,71068,68337,104,135348,68849,66499,103.5
33,충청북도,055001, 50세,2021,27581,14261,13320,107.1,26704,13766,12938,106.4
33,충청북도,055002, 51세,2021,26759,13828,12931,106.9,25895,13333,12562,106.1
33,충청북도,055003, 52세,2021,29494,14952,14542,102.8,28674,14516,14158,102.5
33,충청북도,055004, 53세,2021,28888,14436,14452,99.9,28086,14007,14079,99.5
33,충청북도,055005, 54세,2021,26683,13591,13092,103.8,25989,13227,12762,103.6
33,충청북도,060,55~59세,2021,130685,67367,63318,106.4,127130,65483,61647,106.2
33,충청북도,060001, 55세,2021,26424,13684,12740,107.4,25718,13318,12400,107.4
33,충청북도,060002, 56세,2021,27323,13997,13326,105,26581,13581,13000,104.5
33,충청북도,060003, 57세,2021,23623,12059,11564,104.3,22929,11695,11234,104.1
33,충청북도,060004, 58세,2021,25441,13255,12186,108.8,24614,12814,11800,108.6
33,충청북도,060005, 59세,2021,27874,14372,13502,106.4,27288,14075,13213,106.5
33,충청북도,065,60~64세,2021,137471,69364,68107,101.8,135216,68236,66980,101.9
33,충청북도,065001, 60세,2021,31820,16167,15653,103.3,31408,15970,15438,103.4
33,충청북도,065002, 61세,2021,28431,14130,14301,98.8,27887,13875,14012,99
33,충청북도,065003, 62세,2021,26363,13201,13162,100.3,25921,12987,12934,100.4
33,충청북도,065004, 63세,2021,25514,13056,12458,104.8,25073,12810,12263,104.5
33,충청북도,065005, 64세,2021,25343,12810,12533,102.2,24927,12594,12333,102.1
33,충청북도,070,65~69세,2021,99920,49420,50500,97.9,98726,48795,49931,97.7
33,충청북도,070001, 65세,2021,22736,11459,11277,101.6,22431,11298,11133,101.5
33,충청북도,070002, 66세,2021,22209,10932,11277,96.9,21921,10777,11144,96.7
33,충청북도,070003, 67세,2021,19351,9565,9786,97.7,19085,9427,9658,97.6
33,충청북도,070004, 68세,2021,16682,8235,8447,97.5,16499,8124,8375,97
33,충청북도,070005, 69세,2021,18942,9229,9713,95,18790,9169,9621,95.3
33,충청북도,075,70~74세,2021,64180,30567,33613,90.9,63705,30357,33348,91
33,충청북도,075001, 70세,2021,12225,5838,6387,91.4,12092,5771,6321,91.3
33,충청북도,075002, 71세,2021,12889,6166,6723,91.7,12781,6121,6660,91.9
33,충청북도,075003, 72세,2021,13322,6490,6832,95,13228,6446,6782,95
33,충청북도,075004, 73세,2021,12993,6213,6780,91.6,12920,6182,6738,91.7
33,충청북도,075005, 74세,2021,12751,5860,6891,85,12684,5837,6847,85.2
33,충청북도,080,75~79세,2021,54105,23060,31045,74.3,53927,22993,30934,74.3
33,충청북도,080001, 75세,2021,9692,4458,5234,85.2,9633,4433,5200,85.3
33,충청북도,080002, 76세,2021,10199,4554,5645,80.7,10168,4541,5627,80.7
33,충청북도,080003, 77세,2021,10466,4337,6129,70.8,10437,4328,6109,70.8
33,충청북도,080004, 78세,2021,10853,4479,6374,70.3,10820,4465,6355,70.3
33,충청북도,080005, 79세,2021,12895,5232,7663,68.3,12869,5226,7643,68.4
33,충청북도,085,80~84세,2021,43666,16238,27428,59.2,43554,16216,27338,59.3
33,충청북도,085001, 80세,2021,10155,3989,6166,64.7,10123,3983,6140,64.9
33,충청북도,085002, 81세,2021,8991,3422,5569,61.4,8969,3418,5551,61.6
33,충청북도,085003, 82세,2021,9229,3432,5797,59.2,9206,3427,5779,59.3
33,충청북도,085004, 83세,2021,7998,2863,5135,55.8,7977,2862,5115,56
33,충청북도,085005, 84세,2021,7293,2532,4761,53.2,7279,2526,4753,53.1
33,충청북도,090,85~89세,2021,24160,7162,16998,42.1,24108,7152,16956,42.2
33,충청북도,090001, 85세,2021,6576,2138,4438,48.2,6559,2137,4422,48.3
33,충청북도,090002, 86세,2021,5969,1853,4116,45,5957,1850,4107,45
33,충청북도,090003, 87세,2021,4725,1364,3361,40.6,4713,1359,3354,40.5
33,충청북도,090004, 88세,2021,3828,1025,2803,36.6,3821,1025,2796,36.7
33,충청북도,090005, 89세,2021,3062,782,2280,34.3,3058,781,2277,34.3
33,충청북도,095,90~94세,2021,7648,1706,5942,28.7,7642,1705,5937,28.7
33,충청북도,095001, 90세,2021,2138,492,1646,29.9,2135,491,1644,29.9
33,충청북도,095002, 91세,2021,1982,438,1544,28.4,1982,438,1544,28.4
33,충청북도,095003, 92세,2021,1533,353,1180,29.9,1531,353,1178,30
33,충청북도,095004, 93세,2021,1125,234,891,26.3,1125,234,891,26.3
33,충청북도,095005, 94세,2021,870,189,681,27.8,869,189,680,27.8
33,충청북도,100,95~99세,2021,1573,301,1272,23.7,1571,300,1271,23.6
33,충청북도,100001, 95세,2021,499,89,410,21.7,499,89,410,21.7
33,충청북도,100002, 96세,2021,412,74,338,21.9,411,74,337,22
33,충청북도,100003, 97세,2021,264,62,202,30.7,263,61,202,30.2
33,충청북도,100004, 98세,2021,222,35,187,18.7,222,35,187,18.7
33,충청북도,100005, 99세,2021,176,41,135,30.4,176,41,135,30.4
33,충청북도,101,100세이상,2021,232,32,200,16,232,32,200,16
33,충청북도,102,15세미만,2021,191173,98059,93114,105.3,188526,96721,91805,105.4
33,충청북도,103,15~64세,2021,1138107,601528,536579,112.1,1086142,570091,516051,110.5
33,충청북도,104,65세이상,2021,295484,128486,166998,76.9,293465,127550,165915,76.9
33,충청북도,086,85세이상,2021,33613,9201,24412,37.7,33553,9189,24364,37.7
33,충청북도,126,평균연령,2021,44.2,42.7,45.6,,44.4,43,45.8,
33,충청북도,127,중위연령,2021,45.6,43.8,47.5,,46.2,44.5,47.8,
33004, 읍부,000,합계,2021,352408,183219,169189,108.3,336091,173331,162760,106.5
33004, 읍부,005,0~4세,2021,13290,6904,6386,108.1,12895,6698,6197,108.1
33004, 읍부,005001, 0세,2021,2204,1143,1061,107.7,2156,1116,1040,107.3
33004, 읍부,005002, 1세,2021,2398,1303,1095,119,2322,1261,1061,118.9
33004, 읍부,005003, 2세,2021,2661,1398,1263,110.7,2570,1351,1219,110.8
33004, 읍부,005004, 3세,2021,2937,1478,1459,101.3,2847,1439,1408,102.2
33004, 읍부,005005, 4세,2021,3090,1582,1508,104.9,3000,1531,1469,104.2
33004, 읍부,010,5~9세,2021,17942,9151,8791,104.1,17577,8959,8618,104
33004, 읍부,010001, 5세,2021,3543,1836,1707,107.6,3443,1779,1664,106.9
33004, 읍부,010002, 6세,2021,3560,1825,1735,105.2,3487,1789,1698,105.4
33004, 읍부,010003, 7세,2021,3468,1749,1719,101.7,3404,1712,1692,101.2
33004, 읍부,010004, 8세,2021,3555,1803,1752,102.9,3486,1768,1718,102.9
33004, 읍부,010005, 9세,2021,3816,1938,1878,103.2,3757,1911,1846,103.5
33004, 읍부,015,10~14세,2021,17720,9170,8550,107.3,17497,9066,8431,107.5
33004, 읍부,015001, 10세,2021,3715,1920,1795,107,3657,1898,1759,107.9
33004, 읍부,015002, 11세,2021,3573,1857,1716,108.2,3530,1840,1690,108.9
33004, 읍부,015003, 12세,2021,3362,1763,1599,110.3,3317,1737,1580,109.9
33004, 읍부,015004, 13세,2021,3520,1825,1695,107.7,3484,1805,1679,107.5
33004, 읍부,015005, 14세,2021,3550,1805,1745,103.4,3509,1786,1723,103.7
33004, 읍부,020,15~19세,2021,16099,8456,7643,110.6,15887,8341,7546,110.5
33004, 읍부,020001, 15세,2021,3089,1598,1491,107.2,3049,1575,1474,106.9
33004, 읍부,020002, 16세,2021,3066,1635,1431,114.3,3035,1622,1413,114.8
33004, 읍부,020003, 17세,2021,3285,1729,1556,111.1,3254,1712,1542,111
33004, 읍부,020004, 18세,2021,3262,1680,1582,106.2,3238,1669,1569,106.4
33004, 읍부,020005, 19세,2021,3397,1814,1583,114.6,3311,1763,1548,113.9
33004, 읍부,025,20~24세,2021,20038,11344,8694,130.5,18809,10547,8262,127.7
33004, 읍부,025001, 20세,2021,3855,2148,1707,125.8,3715,2067,1648,125.4
33004, 읍부,025002, 21세,2021,4151,2265,1886,120.1,3965,2137,1828,116.9
33004, 읍부,025003, 22세,2021,3943,2234,1709,130.7,3708,2081,1627,127.9
33004, 읍부,025004, 23세,2021,3912,2269,1643,138.1,3625,2078,1547,134.3
33004, 읍부,025005, 24세,2021,4177,2428,1749,138.8,3796,2184,1612,135.5
33004, 읍부,030,25~29세,2021,23248,13794,9454,145.9,20801,12159,8642,140.7
33004, 읍부,030001, 25세,2021,4357,2600,1757,148,3893,2263,1630,138.8
33004, 읍부,030002, 26세,2021,4561,2649,1912,138.5,4098,2346,1752,133.9
33004, 읍부,030003, 27세,2021,4593,2774,1819,152.5,4091,2451,1640,149.5
33004, 읍부,030004, 28세,2021,4813,2863,1950,146.8,4337,2534,1803,140.5
33004, 읍부,030005, 29세,2021,4924,2908,2016,144.2,4382,2565,1817,141.2
33004, 읍부,035,30~34세,2021,23457,13164,10293,127.9,20660,11336,9324,121.6
33004, 읍부,035001, 30세,2021,4663,2728,1935,141,4097,2346,1751,134
33004, 읍부,035002, 31세,2021,4736,2751,1985,138.6,4186,2380,1806,131.8
33004, 읍부,035003, 32세,2021,4561,2567,1994,128.7,3998,2207,1791,123.2
33004, 읍부,035004, 33세,2021,4639,2511,2128,118,4102,2177,1925,113.1
33004, 읍부,035005, 34세,2021,4858,2607,2251,115.8,4277,2226,2051,108.5
33004, 읍부,040,35~39세,2021,26867,14450,12417,116.4,24681,13062,11619,112.4
33004, 읍부,040001, 35세,2021,4825,2631,2194,119.9,4340,2327,2013,115.6
33004, 읍부,040002, 36세,2021,4933,2638,2295,114.9,4486,2348,2138,109.8
33004, 읍부,040003, 37세,2021,5295,2868,2427,118.2,4854,2597,2257,115.1
33004, 읍부,040004, 38세,2021,5674,3073,2601,118.1,5274,2805,2469,113.6
33004, 읍부,040005, 39세,2021,6140,3240,2900,111.7,5727,2985,2742,108.9
33004, 읍부,045,40~44세,2021,28403,15110,13293,113.7,26809,14123,12686,111.3
33004, 읍부,045001, 40세,2021,5800,3100,2700,114.8,5441,2886,2555,113
33004, 읍부,045002, 41세,2021,6160,3210,2950,108.8,5838,3016,2822,106.9
33004, 읍부,045003, 42세,2021,5817,3120,2697,115.7,5470,2902,2568,113
33004, 읍부,045004, 43세,2021,5395,2897,2498,116,5104,2709,2395,113.1
33004, 읍부,045005, 44세,2021,5231,2783,2448,113.7,4956,2610,2346,111.3
33004, 읍부,050,45~49세,2021,27384,14720,12664,116.2,26193,14036,12157,115.5
33004, 읍부,050001, 45세,2021,5148,2767,2381,116.2,4887,2608,2279,114.4
33004, 읍부,050002, 46세,2021,5350,2869,2481,115.6,5130,2737,2393,114.4
33004, 읍부,050003, 47세,2021,5792,3095,2697,114.8,5572,2981,2591,115.1
33004, 읍부,050004, 48세,2021,5823,3130,2693,116.2,5583,2990,2593,115.3
33004, 읍부,050005, 49세,2021,5271,2859,2412,118.5,5021,2720,2301,118.2
33004, 읍부,055,50~54세,2021,28500,15261,13239,115.3,27250,14578,12672,115
33004, 읍부,055001, 50세,2021,5896,3141,2755,114,5632,2991,2641,113.3
33004, 읍부,055002, 51세,2021,5555,3051,2504,121.8,5271,2899,2372,122.2
33004, 읍부,055003, 52세,2021,6085,3270,2815,116.2,5833,3128,2705,115.6
33004, 읍부,055004, 53세,2021,5759,3058,2701,113.2,5527,2932,2595,113
33004, 읍부,055005, 54세,2021,5205,2741,2464,111.2,4987,2628,2359,111.4
33004, 읍부,060,55~59세,2021,25432,13587,11845,114.7,24293,12952,11341,114.2
33004, 읍부,060001, 55세,2021,5177,2772,2405,115.3,4937,2649,2288,115.8
33004, 읍부,060002, 56세,2021,5309,2812,2497,112.6,5073,2678,2395,111.8
33004, 읍부,060003, 57세,2021,4581,2474,2107,117.4,4371,2350,2021,116.3
33004, 읍부,060004, 58세,2021,4912,2597,2315,112.2,4648,2439,2209,110.4
33004, 읍부,060005, 59세,2021,5453,2932,2521,116.3,5264,2836,2428,116.8
33004, 읍부,065,60~64세,2021,26229,13242,12987,102,25555,12909,12646,102.1
33004, 읍부,065001, 60세,2021,6124,3110,3014,103.2,6006,3050,2956,103.2
33004, 읍부,065002, 61세,2021,5473,2743,2730,100.5,5310,2671,2639,101.2
33004, 읍부,065003, 62세,2021,5044,2521,2523,99.9,4919,2474,2445,101.2
33004, 읍부,065004, 63세,2021,4724,2428,2296,105.7,4591,2346,2245,104.5
33004, 읍부,065005, 64세,2021,4864,2440,2424,100.7,4729,2368,2361,100.3
33004, 읍부,070,65~69세,2021,19198,9400,9798,95.9,18831,9193,9638,95.4
33004, 읍부,070001, 65세,2021,4293,2139,2154,99.3,4204,2089,2115,98.8
33004, 읍부,070002, 66세,2021,4374,2135,2239,95.4,4281,2081,2200,94.6
33004, 읍부,070003, 67세,2021,3692,1786,1906,93.7,3609,1739,1870,93
33004, 읍부,070004, 68세,2021,3213,1600,1613,99.2,3163,1565,1598,97.9
33004, 읍부,070005, 69세,2021,3626,1740,1886,92.3,3574,1719,1855,92.7
33004, 읍부,075,70~74세,2021,12732,5993,6739,88.9,12587,5929,6658,89.1
33004, 읍부,075001, 70세,2021,2386,1128,1258,89.7,2350,1108,1242,89.2
33004, 읍부,075002, 71세,2021,2611,1213,1398,86.8,2574,1199,1375,87.2
33004, 읍부,075003, 72세,2021,2703,1337,1366,97.9,2677,1321,1356,97.4
33004, 읍부,075004, 73세,2021,2513,1169,1344,87,2492,1162,1330,87.4
33004, 읍부,075005, 74세,2021,2519,1146,1373,83.5,2494,1139,1355,84.1
33004, 읍부,080,75~79세,2021,10691,4514,6177,73.1,10640,4496,6144,73.2
33004, 읍부,080001, 75세,2021,1965,884,1081,81.8,1947,876,1071,81.8
33004, 읍부,080002, 76세,2021,1964,879,1085,81,1955,875,1080,81
33004, 읍부,080003, 77세,2021,2010,821,1189,69,2001,819,1182,69.3
33004, 읍부,080004, 78세,2021,2197,900,1297,69.4,2189,897,1292,69.4
33004, 읍부,080005, 79세,2021,2555,1030,1525,67.5,2548,1029,1519,67.7
33004, 읍부,085,80~84세,2021,8528,3220,5308,60.7,8492,3213,5279,60.9
33004, 읍부,085001, 80세,2021,1972,788,1184,66.6,1964,785,1179,66.6
33004, 읍부,085002, 81세,2021,1747,694,1053,65.9,1740,694,1046,66.3
33004, 읍부,085003, 82세,2021,1783,643,1140,56.4,1777,641,1136,56.4
33004, 읍부,085004, 83세,2021,1598,582,1016,57.3,1587,582,1005,57.9
33004, 읍부,085005, 84세,2021,1428,513,915,56.1,1424,511,913,56
33004, 읍부,090,85~89세,2021,4791,1335,3456,38.6,4777,1331,3446,38.6
33004, 읍부,090001, 85세,2021,1305,401,904,44.4,1302,400,902,44.3
33004, 읍부,090002, 86세,2021,1181,326,855,38.1,1177,325,852,38.1
33004, 읍부,090003, 87세,2021,927,273,654,41.7,924,271,653,41.5
33004, 읍부,090004, 88세,2021,718,182,536,34,716,182,534,34.1
33004, 읍부,090005, 89세,2021,660,153,507,30.2,658,153,505,30.3
33004, 읍부,095,90~94세,2021,1519,344,1175,29.3,1518,343,1175,29.2
33004, 읍부,095001, 90세,2021,461,108,353,30.6,460,107,353,30.3
33004, 읍부,095002, 91세,2021,377,90,287,31.4,377,90,287,31.4
33004, 읍부,095003, 92세,2021,297,73,224,32.6,297,73,224,32.6
33004, 읍부,095004, 93세,2021,231,37,194,19.1,231,37,194,19.1
33004, 읍부,095005, 94세,2021,153,36,117,30.8,153,36,117,30.8
33004, 읍부,100,95~99세,2021,307,56,251,22.3,306,56,250,22.4
33004, 읍부,100001, 95세,2021,96,14,82,17.1,96,14,82,17.1
33004, 읍부,100002, 96세,2021,81,16,65,24.6,80,16,64,25
33004, 읍부,100003, 97세,2021,56,18,38,47.4,56,18,38,47.4
33004, 읍부,100004, 98세,2021,46,X,43,7,46,X,43,7
33004, 읍부,100005, 99세,2021,28,5,23,21.7,28,5,23,21.7
33004, 읍부,101,100세이상,2021,33,X,29,13.8,33,X,29,13.8
33004, 읍부,102,15세미만,2021,48952,25225,23727,106.3,47969,24723,23246,106.4
33004, 읍부,103,15~64세,2021,245657,133128,112529,118.3,230938,124043,106895,116
33004, 읍부,104,65세이상,2021,57799,24866,32933,75.5,57184,24565,32619,75.3
33004, 읍부,086,85세이상,2021,6650,1739,4911,35.4,6634,1734,4900,35.4
33004, 읍부,126,평균연령,2021,42.5,41.2,44,,42.7,41.4,44.2,
33004, 읍부,127,중위연령,2021,43,41.6,44.6,,43.5,42.2,45,
33005, 면부,000,합계,2021,331000,174370,156630,111.3,311247,160778,150469,106.9
33005, 면부,005,0~4세,2021,6677,3361,3316,101.4,6528,3289,3239,101.5
33005, 면부,005001, 0세,2021,1175,574,601,95.5,1147,564,583,96.7
33005, 면부,005002, 1세,2021,1248,610,638,95.6,1220,595,625,95.2
33005, 면부,005003, 2세,2021,1360,710,650,109.2,1327,692,635,109
33005, 면부,005004, 3세,2021,1446,758,688,110.2,1420,746,674,110.7
33005, 면부,005005, 4세,2021,1448,709,739,95.9,1414,692,722,95.8
33005, 면부,010,5~9세,2021,8472,4315,4157,103.8,8322,4251,4071,104.4
33005, 면부,010001, 5세,2021,1616,862,754,114.3,1573,843,730,115.5
33005, 면부,010002, 6세,2021,1618,824,794,103.8,1589,808,781,103.5
33005, 면부,010003, 7세,2021,1670,829,841,98.6,1636,815,821,99.3
33005, 면부,010004, 8세,2021,1701,852,849,100.4,1680,845,835,101.2
33005, 면부,010005, 9세,2021,1867,948,919,103.2,1844,940,904,104
33005, 면부,015,10~14세,2021,8685,4544,4141,109.7,8599,4509,4090,110.2
33005, 면부,015001, 10세,2021,1866,976,890,109.7,1854,973,881,110.4
33005, 면부,015002, 11세,2021,1711,859,852,100.8,1692,849,843,100.7
33005, 면부,015003, 12세,2021,1588,841,747,112.6,1578,837,741,113
33005, 면부,015004, 13세,2021,1729,925,804,115,1701,912,789,115.6
33005, 면부,015005, 14세,2021,1791,943,848,111.2,1774,938,836,112.2
33005, 면부,020,15~19세,2021,10336,5604,4732,118.4,10237,5548,4689,118.3
33005, 면부,020001, 15세,2021,1603,825,778,106,1592,820,772,106.2
33005, 면부,020002, 16세,2021,1696,927,769,120.5,1683,921,762,120.9
33005, 면부,020003, 17세,2021,1911,1035,876,118.2,1903,1033,870,118.7
33005, 면부,020004, 18세,2021,2070,1146,924,124,2043,1128,915,123.3
33005, 면부,020005, 19세,2021,3056,1671,1385,120.6,3016,1646,1370,120.1
33005, 면부,025,20~24세,2021,16151,9727,6424,151.4,14678,8661,6017,143.9
33005, 면부,025001, 20세,2021,3048,1615,1433,112.7,2957,1561,1396,111.8
33005, 면부,025002, 21세,2021,3161,1713,1448,118.3,3003,1617,1386,116.7
33005, 면부,025003, 22세,2021,3262,2011,1251,160.8,3016,1840,1176,156.5
33005, 면부,025004, 23세,2021,3257,2093,1164,179.8,2848,1790,1058,169.2
33005, 면부,025005, 24세,2021,3423,2295,1128,203.5,2854,1853,1001,185.1
33005, 면부,030,25~29세,2021,17100,11003,6097,180.5,13359,8203,5156,159.1
33005, 면부,030001, 25세,2021,3402,2259,1143,197.6,2736,1752,984,178
33005, 면부,030002, 26세,2021,3298,2086,1212,172.1,2578,1547,1031,150
33005, 면부,030003, 27세,2021,3390,2147,1243,172.7,2631,1569,1062,147.7
33005, 면부,030004, 28세,2021,3524,2281,1243,183.5,2732,1692,1040,162.7
33005, 면부,030005, 29세,2021,3486,2230,1256,177.5,2682,1643,1039,158.1
33005, 면부,035,30~34세,2021,16408,10128,6280,161.3,12422,7209,5213,138.3
33005, 면부,035001, 30세,2021,3389,2149,1240,173.3,2532,1503,1029,146.1
33005, 면부,035002, 31세,2021,3373,2090,1283,162.9,2545,1504,1041,144.5
33005, 면부,035003, 32세,2021,3206,1971,1235,159.6,2417,1397,1020,137
33005, 면부,035004, 33세,2021,3233,1974,1259,156.8,2474,1427,1047,136.3
33005, 면부,035005, 34세,2021,3207,1944,1263,153.9,2454,1378,1076,128.1
33005, 면부,040,35~39세,2021,16691,9974,6717,148.5,13631,7738,5893,131.3
33005, 면부,040001, 35세,2021,3163,1898,1265,150,2454,1384,1070,129.3
33005, 면부,040002, 36세,2021,3115,1881,1234,152.4,2485,1419,1066,133.1
33005, 면부,040003, 37세,2021,3223,2005,1218,164.6,2631,1561,1070,145.9
33005, 면부,040004, 38세,2021,3480,2036,1444,141,2906,1609,1297,124.1
33005, 면부,040005, 39세,2021,3710,2154,1556,138.4,3155,1765,1390,127
33005, 면부,045,40~44세,2021,16888,9889,6999,141.3,14849,8441,6408,131.7
33005, 면부,045001, 40세,2021,3532,2100,1432,146.6,3027,1739,1288,135
33005, 면부,045002, 41세,2021,3484,2035,1449,140.4,3018,1692,1326,127.6
33005, 면부,045003, 42세,2021,3485,2026,1459,138.9,3089,1741,1348,129.2
33005, 면부,045004, 43세,2021,3095,1806,1289,140.1,2748,1565,1183,132.3
33005, 면부,045005, 44세,2021,3292,1922,1370,140.3,2967,1704,1263,134.9
33005, 면부,050,45~49세,2021,18707,10754,7953,135.2,17273,9862,7411,133.1
33005, 면부,050001, 45세,2021,3225,1882,1343,140.1,2911,1672,1239,134.9
33005, 면부,050002, 46세,2021,3519,2026,1493,135.7,3222,1841,1381,133.3
33005, 면부,050003, 47세,2021,3852,2240,1612,139,3596,2086,1510,138.1
33005, 면부,050004, 48세,2021,4128,2354,1774,132.7,3842,2176,1666,130.6
33005, 면부,050005, 49세,2021,3983,2252,1731,130.1,3702,2087,1615,129.2
33005, 면부,055,50~54세,2021,25935,13986,11949,117,24673,13243,11430,115.9
33005, 면부,055001, 50세,2021,4603,2568,2035,126.2,4327,2393,1934,123.7
33005, 면부,055002, 51세,2021,4658,2592,2066,125.5,4404,2442,1962,124.5
33005, 면부,055003, 52세,2021,5427,2913,2514,115.9,5176,2768,2408,115
33005, 면부,055004, 53세,2021,5655,2974,2681,110.9,5389,2823,2566,110
33005, 면부,055005, 54세,2021,5592,2939,2653,110.8,5377,2817,2560,110
33005, 면부,060,55~59세,2021,31131,16616,14515,114.5,30031,15986,14045,113.8
33005, 면부,060001, 55세,2021,5893,3196,2697,118.5,5692,3076,2616,117.6
33005, 면부,060002, 56세,2021,6338,3402,2936,115.9,6107,3260,2847,114.5
33005, 면부,060003, 57세,2021,5685,2946,2739,107.6,5446,2813,2633,106.8
33005, 면부,060004, 58세,2021,6211,3406,2805,121.4,5952,3264,2688,121.4
33005, 면부,060005, 59세,2021,7004,3666,3338,109.8,6834,3573,3261,109.6
33005, 면부,065,60~64세,2021,38515,20368,18147,112.2,37883,20004,17879,111.9
33005, 면부,065001, 60세,2021,8528,4548,3980,114.3,8402,4481,3921,114.3
33005, 면부,065002, 61세,2021,7783,3981,3802,104.7,7630,3898,3732,104.4
33005, 면부,065003, 62세,2021,7367,3920,3447,113.7,7239,3842,3397,113.1
33005, 면부,065004, 63세,2021,7387,3954,3433,115.2,7275,3882,3393,114.4
33005, 면부,065005, 64세,2021,7450,3965,3485,113.8,7337,3901,3436,113.5
33005, 면부,070,65~69세,2021,30604,15923,14681,108.5,30269,15745,14524,108.4
33005, 면부,070001, 65세,2021,6795,3612,3183,113.5,6718,3571,3147,113.5
33005, 면부,070002, 66세,2021,6704,3451,3253,106.1,6628,3412,3216,106.1
33005, 면부,070003, 67세,2021,6101,3141,2960,106.1,6016,3093,2923,105.8
33005, 면부,070004, 68세,2021,5109,2672,2437,109.6,5052,2638,2414,109.3
33005, 면부,070005, 69세,2021,5895,3047,2848,107,5855,3031,2824,107.3
33005, 면부,075,70~74세,2021,20448,10340,10108,102.3,20319,10274,10045,102.3
33005, 면부,075001, 70세,2021,3907,1957,1950,100.4,3875,1942,1933,100.5
33005, 면부,075002, 71세,2021,4075,2090,1985,105.3,4042,2071,1971,105.1
33005, 면부,075003, 72세,2021,4343,2206,2137,103.2,4317,2194,2123,103.3
33005, 면부,075004, 73세,2021,4110,2079,2031,102.4,4089,2069,2020,102.4
33005, 면부,075005, 74세,2021,4013,2008,2005,100.1,3996,1998,1998,100
33005, 면부,080,75~79세,2021,18327,7907,10420,75.9,18283,7891,10392,75.9
33005, 면부,080001, 75세,2021,3154,1542,1612,95.7,3137,1532,1605,95.5
33005, 면부,080002, 76세,2021,3340,1516,1824,83.1,3332,1515,1817,83.4
33005, 면부,080003, 77세,2021,3495,1425,2070,68.8,3487,1424,2063,69
33005, 면부,080004, 78세,2021,3731,1545,2186,70.7,3722,1541,2181,70.7
33005, 면부,080005, 79세,2021,4607,1879,2728,68.9,4605,1879,2726,68.9
33005, 면부,085,80~84세,2021,16499,6146,10353,59.4,16476,6141,10335,59.4
33005, 면부,085001, 80세,2021,3750,1493,2257,66.1,3743,1493,2250,66.4
33005, 면부,085002, 81세,2021,3364,1266,2098,60.3,3358,1265,2093,60.4
33005, 면부,085003, 82세,2021,3526,1329,2197,60.5,3524,1328,2196,60.5
33005, 면부,085004, 83세,2021,3038,1086,1952,55.6,3033,1085,1948,55.7
33005, 면부,085005, 84세,2021,2821,972,1849,52.6,2818,970,1848,52.5
33005, 면부,090,85~89세,2021,9656,2905,6751,43,9646,2903,6743,43.1
33005, 면부,090001, 85세,2021,2543,833,1710,48.7,2541,833,1708,48.8
33005, 면부,090002, 86세,2021,2388,738,1650,44.7,2386,738,1648,44.8
33005, 면부,090003, 87세,2021,1919,549,1370,40.1,1915,547,1368,40
33005, 면부,090004, 88세,2021,1607,449,1158,38.8,1605,449,1156,38.8
33005, 면부,090005, 89세,2021,1199,336,863,38.9,1199,336,863,38.9
33005, 면부,095,90~94세,2021,3069,726,2343,31,3068,726,2342,31
33005, 면부,095001, 90세,2021,865,205,660,31.1,864,205,659,31.1
33005, 면부,095002, 91세,2021,782,177,605,29.3,782,177,605,29.3
33005, 면부,095003, 92세,2021,605,150,455,33,605,150,455,33
33005, 면부,095004, 93세,2021,463,111,352,31.5,463,111,352,31.5
33005, 면부,095005, 94세,2021,354,83,271,30.6,354,83,271,30.6
33005, 면부,100,95~99세,2021,593,135,458,29.5,593,135,458,29.5
33005, 면부,100001, 95세,2021,193,44,149,29.5,193,44,149,29.5
33005, 면부,100002, 96세,2021,160,31,129,24,160,31,129,24
33005, 면부,100003, 97세,2021,102,29,73,39.7,102,29,73,39.7
33005, 면부,100004, 98세,2021,81,15,66,22.7,81,15,66,22.7
33005, 면부,100005, 99세,2021,57,16,41,39,57,16,41,39
33005, 면부,101,100세이상,2021,108,19,89,21.3,108,19,89,21.3
33005, 면부,102,15세미만,2021,23834,12220,11614,105.2,23449,12049,11400,105.7
33005, 면부,103,15~64세,2021,207862,118049,89813,131.4,189036,104895,84141,124.7
33005, 면부,104,65세이상,2021,99304,44101,55203,79.9,98762,43834,54928,79.8
33005, 면부,086,85세이상,2021,13426,3785,9641,39.3,13415,3783,9632,39.3
33005, 면부,126,평균연령,2021,51.5,49.3,54,,52.4,50.3,54.6,
33005, 면부,127,중위연령,2021,55.6,52.9,58.4,,56.9,54.8,59.3,
33003, 동부,000,합계,2021,941356,470484,470872,99.9,920795,460253,460542,99.9
33003, 동부,005,0~4세,2021,29694,15257,14437,105.7,29195,14990,14205,105.5
33003, 동부,005001, 0세,2021,5061,2589,2472,104.7,4979,2547,2432,104.7
33003, 동부,005002, 1세,2021,5295,2718,2577,105.5,5195,2665,2530,105.3
33003, 동부,005003, 2세,2021,5657,2903,2754,105.4,5555,2855,2700,105.7
33003, 동부,005004, 3세,2021,6596,3347,3249,103,6483,3283,3200,102.6
33003, 동부,005005, 4세,2021,7085,3700,3385,109.3,6983,3640,3343,108.9
33003, 동부,010,5~9세,2021,42305,21493,20812,103.3,41850,21269,20581,103.3
33003, 동부,010001, 5세,2021,7918,4029,3889,103.6,7819,3983,3836,103.8
33003, 동부,010002, 6세,2021,8266,4187,4079,102.6,8156,4135,4021,102.8
33003, 동부,010003, 7세,2021,8327,4171,4156,100.4,8236,4125,4111,100.3
33003, 동부,010004, 8세,2021,8494,4335,4159,104.2,8411,4297,4114,104.4
33003, 동부,010005, 9세,2021,9300,4771,4529,105.3,9228,4729,4499,105.1
33003, 동부,015,10~14세,2021,46388,23864,22524,105.9,46063,23690,22373,105.9
33003, 동부,015001, 10세,2021,9419,4782,4637,103.1,9342,4742,4600,103.1
33003, 동부,015002, 11세,2021,9144,4688,4456,105.2,9075,4649,4426,105
33003, 동부,015003, 12세,2021,8850,4590,4260,107.7,8781,4553,4228,107.7
33003, 동부,015004, 13세,2021,9268,4813,4455,108,9222,4790,4432,108.1
33003, 동부,015005, 14세,2021,9707,4991,4716,105.8,9643,4956,4687,105.7
33003, 동부,020,15~19세,2021,47898,24796,23102,107.3,47497,24589,22908,107.3
33003, 동부,020001, 15세,2021,8915,4603,4312,106.7,8867,4574,4293,106.5
33003, 동부,020002, 16세,2021,8851,4549,4302,105.7,8793,4519,4274,105.7
33003, 동부,020003, 17세,2021,9499,4959,4540,109.2,9448,4933,4515,109.3
33003, 동부,020004, 18세,2021,9895,5148,4747,108.4,9820,5110,4710,108.5
33003, 동부,020005, 19세,2021,10738,5537,5201,106.5,10569,5453,5116,106.6
33003, 동부,025,20~24세,2021,68354,35977,32377,111.1,65657,34635,31022,111.6
33003, 동부,025001, 20세,2021,12698,6414,6284,102.1,12431,6287,6144,102.3
33003, 동부,025002, 21세,2021,13902,7017,6885,101.9,13409,6773,6636,102.1
33003, 동부,025003, 22세,2021,13650,7264,6386,113.7,12997,6946,6051,114.8
33003, 동부,025004, 23세,2021,13969,7573,6396,118.4,13324,7239,6085,119
33003, 동부,025005, 24세,2021,14135,7709,6426,120,13496,7390,6106,121
33003, 동부,030,25~29세,2021,69118,38691,30427,127.2,66316,37267,29049,128.3
33003, 동부,030001, 25세,2021,14084,7853,6231,126,13496,7531,5965,126.3
33003, 동부,030002, 26세,2021,14023,7765,6258,124.1,13411,7435,5976,124.4
33003, 동부,030003, 27세,2021,13929,7864,6065,129.7,13394,7593,5801,130.9
33003, 동부,030004, 28세,2021,13795,7715,6080,126.9,13266,7466,5800,128.7
33003, 동부,030005, 29세,2021,13287,7494,5793,129.4,12749,7242,5507,131.5
33003, 동부,035,30~34세,2021,56991,30407,26584,114.4,54108,28976,25132,115.3
33003, 동부,035001, 30세,2021,12261,6627,5634,117.6,11740,6374,5366,118.8
33003, 동부,035002, 31세,2021,11467,6188,5279,117.2,10900,5927,4973,119.2
33003, 동부,035003, 32세,2021,11036,5933,5103,116.3,10477,5649,4828,117
33003, 동부,035004, 33세,2021,11037,5811,5226,111.2,10443,5500,4943,111.3
33003, 동부,035005, 34세,2021,11190,5848,5342,109.5,10548,5526,5022,110
33003, 동부,040,35~39세,2021,63280,32368,30912,104.7,60806,31124,29682,104.9
33003, 동부,040001, 35세,2021,11390,6009,5381,111.7,10841,5740,5101,112.5
33003, 동부,040002, 36세,2021,11397,5827,5570,104.6,10885,5578,5307,105.1
33003, 동부,040003, 37세,2021,12288,6304,5984,105.3,11804,6071,5733,105.9
33003, 동부,040004, 38세,2021,13336,6720,6616,101.6,12867,6470,6397,101.1
33003, 동부,040005, 39세,2021,14869,7508,7361,102,14409,7265,7144,101.7
33003, 동부,045,40~44세,2021,70085,35309,34776,101.5,68268,34346,33922,101.2
33003, 동부,045001, 40세,2021,14020,7149,6871,104,13616,6933,6683,103.7
33003, 동부,045002, 41세,2021,14769,7468,7301,102.3,14409,7256,7153,101.4
33003, 동부,045003, 42세,2021,14177,7175,7002,102.5,13802,6975,6827,102.2
33003, 동부,045004, 43세,2021,13173,6585,6588,100,12816,6413,6403,100.2
33003, 동부,045005, 44세,2021,13946,6932,7014,98.8,13625,6769,6856,98.7
33003, 동부,050,45~49세,2021,77043,38064,38979,97.7,75507,37320,38187,97.7
33003, 동부,050001, 45세,2021,13881,6925,6956,99.6,13594,6789,6805,99.8
33003, 동부,050002, 46세,2021,14700,7067,7633,92.6,14385,6916,7469,92.6
33003, 동부,050003, 47세,2021,16399,8140,8259,98.6,16111,8004,8107,98.7
33003, 동부,050004, 48세,2021,16370,8015,8355,95.9,16074,7870,8204,95.9
33003, 동부,050005, 49세,2021,15693,7917,7776,101.8,15343,7741,7602,101.8
33003, 동부,055,50~54세,2021,84970,41821,43149,96.9,83425,41028,42397,96.8
33003, 동부,055001, 50세,2021,17082,8552,8530,100.3,16745,8382,8363,100.2
33003, 동부,055002, 51세,2021,16546,8185,8361,97.9,16220,7992,8228,97.1
33003, 동부,055003, 52세,2021,17982,8769,9213,95.2,17665,8620,9045,95.3
33003, 동부,055004, 53세,2021,17474,8404,9070,92.7,17170,8252,8918,92.5
33003, 동부,055005, 54세,2021,15886,7911,7975,99.2,15625,7782,7843,99.2
33003, 동부,060,55~59세,2021,74122,37164,36958,100.6,72806,36545,36261,100.8
33003, 동부,060001, 55세,2021,15354,7716,7638,101,15089,7593,7496,101.3
33003, 동부,060002, 56세,2021,15676,7783,7893,98.6,15401,7643,7758,98.5
33003, 동부,060003, 57세,2021,13357,6639,6718,98.8,13112,6532,6580,99.3
33003, 동부,060004, 58세,2021,14318,7252,7066,102.6,14014,7111,6903,103
33003, 동부,060005, 59세,2021,15417,7774,7643,101.7,15190,7666,7524,101.9
33003, 동부,065,60~64세,2021,72727,35754,36973,96.7,71778,35323,36455,96.9
33003, 동부,065001, 60세,2021,17168,8509,8659,98.3,17000,8439,8561,98.6
33003, 동부,065002, 61세,2021,15175,7406,7769,95.3,14947,7306,7641,95.6
33003, 동부,065003, 62세,2021,13952,6760,7192,94,13763,6671,7092,94.1
33003, 동부,065004, 63세,2021,13403,6674,6729,99.2,13207,6582,6625,99.4
33003, 동부,065005, 64세,2021,13029,6405,6624,96.7,12861,6325,6536,96.8
33003, 동부,070,65~69세,2021,50118,24097,26021,92.6,49626,23857,25769,92.6
33003, 동부,070001, 65세,2021,11648,5708,5940,96.1,11509,5638,5871,96
33003, 동부,070002, 66세,2021,11131,5346,5785,92.4,11012,5284,5728,92.2
33003, 동부,070003, 67세,2021,9558,4638,4920,94.3,9460,4595,4865,94.5
33003, 동부,070004, 68세,2021,8360,3963,4397,90.1,8284,3921,4363,89.9
33003, 동부,070005, 69세,2021,9421,4442,4979,89.2,9361,4419,4942,89.4
33003, 동부,075,70~74세,2021,31000,14234,16766,84.9,30799,14154,16645,85
33003, 동부,075001, 70세,2021,5932,2753,3179,86.6,5867,2721,3146,86.5
33003, 동부,075002, 71세,2021,6203,2863,3340,85.7,6165,2851,3314,86
33003, 동부,075003, 72세,2021,6276,2947,3329,88.5,6234,2931,3303,88.7
33003, 동부,075004, 73세,2021,6370,2965,3405,87.1,6339,2951,3388,87.1
33003, 동부,075005, 74세,2021,6219,2706,3513,77,6194,2700,3494,77.3
33003, 동부,080,75~79세,2021,25087,10639,14448,73.6,25004,10606,14398,73.7
33003, 동부,080001, 75세,2021,4573,2032,2541,80,4549,2025,2524,80.2
33003, 동부,080002, 76세,2021,4895,2159,2736,78.9,4881,2151,2730,78.8
33003, 동부,080003, 77세,2021,4961,2091,2870,72.9,4949,2085,2864,72.8
33003, 동부,080004, 78세,2021,4925,2034,2891,70.4,4909,2027,2882,70.3
33003, 동부,080005, 79세,2021,5733,2323,3410,68.1,5716,2318,3398,68.2
33003, 동부,085,80~84세,2021,18639,6872,11767,58.4,18586,6862,11724,58.5
33003, 동부,085001, 80세,2021,4433,1708,2725,62.7,4416,1705,2711,62.9
33003, 동부,085002, 81세,2021,3880,1462,2418,60.5,3871,1459,2412,60.5
33003, 동부,085003, 82세,2021,3920,1460,2460,59.3,3905,1458,2447,59.6
33003, 동부,085004, 83세,2021,3362,1195,2167,55.1,3357,1195,2162,55.3
33003, 동부,085005, 84세,2021,3044,1047,1997,52.4,3037,1045,1992,52.5
33003, 동부,090,85~89세,2021,9713,2922,6791,43,9685,2918,6767,43.1
33003, 동부,090001, 85세,2021,2728,904,1824,49.6,2716,904,1812,49.9
33003, 동부,090002, 86세,2021,2400,789,1611,49,2394,787,1607,49
33003, 동부,090003, 87세,2021,1879,542,1337,40.5,1874,541,1333,40.6
33003, 동부,090004, 88세,2021,1503,394,1109,35.5,1500,394,1106,35.6
33003, 동부,090005, 89세,2021,1203,293,910,32.2,1201,292,909,32.1
33003, 동부,095,90~94세,2021,3060,636,2424,26.2,3056,636,2420,26.3
33003, 동부,095001, 90세,2021,812,179,633,28.3,811,179,632,28.3
33003, 동부,095002, 91세,2021,823,171,652,26.2,823,171,652,26.2
33003, 동부,095003, 92세,2021,631,130,501,25.9,629,130,499,26.1
33003, 동부,095004, 93세,2021,431,86,345,24.9,431,86,345,24.9
33003, 동부,095005, 94세,2021,363,70,293,23.9,362,70,292,24
33003, 동부,100,95~99세,2021,673,110,563,19.5,672,109,563,19.4
33003, 동부,100001, 95세,2021,210,31,179,17.3,210,31,179,17.3
33003, 동부,100002, 96세,2021,171,27,144,18.8,171,27,144,18.8
33003, 동부,100003, 97세,2021,106,15,91,16.5,105,14,91,15.4
33003, 동부,100004, 98세,2021,95,17,78,21.8,95,17,78,21.8
33003, 동부,100005, 99세,2021,91,20,71,28.2,91,20,71,28.2
33003, 동부,101,100세이상,2021,91,9,82,11,91,9,82,11
33003, 동부,102,15세미만,2021,118387,60614,57773,104.9,117108,59949,57159,104.9
33003, 동부,103,15~64세,2021,684588,350351,334237,104.8,666168,341153,325015,105
33003, 동부,104,65세이상,2021,138381,59519,78862,75.5,137519,59151,78368,75.5
33003, 동부,086,85세이상,2021,13537,3677,9860,37.3,13504,3672,9832,37.3
33003, 동부,126,평균연령,2021,42.2,40.9,43.4,,42.3,41,43.5,
33003, 동부,127,중위연령,2021,43.3,41.7,44.9,,43.6,41.9,45.2,
33020, 충주시,000,합계,2021,215349,109926,105423,104.3,208450,105756,102694,103
33020, 충주시,005,0~4세,2021,5735,2939,2796,105.1,5676,2913,2763,105.4
33020, 충주시,005001, 0세,2021,952,471,481,97.9,941,467,474,98.5
33020, 충주시,005002, 1세,2021,1040,531,509,104.3,1037,529,508,104.1
33020, 충주시,005003, 2세,2021,1153,615,538,114.3,1137,609,528,115.3
33020, 충주시,005004, 3세,2021,1233,612,621,98.6,1219,607,612,99.2
33020, 충주시,005005, 4세,2021,1357,710,647,109.7,1342,701,641,109.4
33020, 충주시,010,5~9세,2021,8063,4017,4046,99.3,8015,3994,4021,99.3
33020, 충주시,010001, 5세,2021,1552,789,763,103.4,1539,781,758,103
33020, 충주시,010002, 6세,2021,1580,781,799,97.7,1567,777,790,98.4
33020, 충주시,010003, 7세,2021,1577,759,818,92.8,1570,754,816,92.4
33020, 충주시,010004, 8세,2021,1613,833,780,106.8,1603,829,774,107.1
33020, 충주시,010005, 9세,2021,1741,855,886,96.5,1736,853,883,96.6
33020, 충주시,015,10~14세,2021,9123,4726,4397,107.5,9093,4712,4381,107.6
33020, 충주시,015001, 10세,2021,1870,1000,870,114.9,1866,999,867,115.2
33020, 충주시,015002, 11세,2021,1786,877,909,96.5,1779,873,906,96.4
33020, 충주시,015003, 12세,2021,1666,853,813,104.9,1660,850,810,104.9
33020, 충주시,015004, 13세,2021,1844,984,860,114.4,1837,982,855,114.9
33020, 충주시,015005, 14세,2021,1957,1012,945,107.1,1951,1008,943,106.9
33020, 충주시,020,15~19세,2021,9983,5248,4735,110.8,9940,5228,4712,111
33020, 충주시,020001, 15세,2021,1700,879,821,107.1,1696,878,818,107.3
33020, 충주시,020002, 16세,2021,1668,883,785,112.5,1663,879,784,112.1
33020, 충주시,020003, 17세,2021,1899,942,957,98.4,1894,938,956,98.1
33020, 충주시,020004, 18세,2021,2026,1056,970,108.9,2015,1051,964,109
33020, 충주시,020005, 19세,2021,2690,1488,1202,123.8,2672,1482,1190,124.5
33020, 충주시,025,20~24세,2021,15135,8584,6551,131,14182,8011,6171,129.8
33020, 충주시,025001, 20세,2021,2805,1409,1396,100.9,2758,1390,1368,101.6
33020, 충주시,025002, 21세,2021,2923,1528,1395,109.5,2832,1477,1355,109
33020, 충주시,025003, 22세,2021,3128,1810,1318,137.3,2883,1667,1216,137.1
33020, 충주시,025004, 23세,2021,3219,1878,1341,140,2948,1709,1239,137.9
33020, 충주시,025005, 24세,2021,3060,1959,1101,177.9,2761,1768,993,178
33020, 충주시,030,25~29세,2021,13618,8295,5323,155.8,12250,7371,4879,151.1
33020, 충주시,030001, 25세,2021,2877,1783,1094,163,2612,1586,1026,154.6
33020, 충주시,030002, 26세,2021,2738,1672,1066,156.8,2454,1473,981,150.2
33020, 충주시,030003, 27세,2021,2634,1558,1076,144.8,2383,1389,994,139.7
33020, 충주시,030004, 28세,2021,2659,1615,1044,154.7,2369,1436,933,153.9
33020, 충주시,030005, 29세,2021,2710,1667,1043,159.8,2432,1487,945,157.4
33020, 충주시,035,30~34세,2021,11652,6647,5005,132.8,10442,5885,4557,129.1
33020, 충주시,035001, 30세,2021,2522,1432,1090,131.4,2266,1274,992,128.4
33020, 충주시,035002, 31세,2021,2405,1388,1017,136.5,2144,1222,922,132.5
33020, 충주시,035003, 32세,2021,2190,1253,937,133.7,1940,1094,846,129.3
33020, 충주시,035004, 33세,2021,2215,1276,939,135.9,2004,1142,862,132.5
33020, 충주시,035005, 34세,2021,2320,1298,1022,127,2088,1153,935,123.3
33020, 충주시,040,35~39세,2021,12755,6840,5915,115.6,11880,6295,5585,112.7
33020, 충주시,040001, 35세,2021,2286,1239,1047,118.3,2082,1117,965,115.8
33020, 충주시,040002, 36세,2021,2290,1261,1029,122.5,2107,1138,969,117.4
33020, 충주시,040003, 37세,2021,2541,1390,1151,120.8,2366,1279,1087,117.7
33020, 충주시,040004, 38세,2021,2683,1406,1277,110.1,2531,1311,1220,107.5
33020, 충주시,040005, 39세,2021,2955,1544,1411,109.4,2794,1450,1344,107.9
33020, 충주시,045,40~44세,2021,14143,7301,6842,106.7,13562,6949,6613,105.1
33020, 충주시,045001, 40세,2021,2840,1553,1287,120.7,2712,1475,1237,119.2
33020, 충주시,045002, 41세,2021,2944,1485,1459,101.8,2810,1392,1418,98.2
33020, 충주시,045003, 42세,2021,2919,1493,1426,104.7,2805,1429,1376,103.9
33020, 충주시,045004, 43세,2021,2635,1358,1277,106.3,2526,1302,1224,106.4
33020, 충주시,045005, 44세,2021,2805,1412,1393,101.4,2709,1351,1358,99.5
33020, 충주시,050,45~49세,2021,15969,8246,7723,106.8,15480,7964,7516,106
33020, 충주시,050001, 45세,2021,2848,1479,1369,108,2743,1415,1328,106.6
33020, 충주시,050002, 46세,2021,3009,1498,1511,99.1,2915,1446,1469,98.4
33020, 충주시,050003, 47세,2021,3412,1792,1620,110.6,3330,1745,1585,110.1
33020, 충주시,050004, 48세,2021,3437,1771,1666,106.3,3343,1714,1629,105.2
33020, 충주시,050005, 49세,2021,3263,1706,1557,109.6,3149,1644,1505,109.2
33020, 충주시,055,50~54세,2021,18614,9386,9228,101.7,18183,9140,9043,101.1
33020, 충주시,055001, 50세,2021,3644,1852,1792,103.3,3552,1806,1746,103.4
33020, 충주시,055002, 51세,2021,3488,1773,1715,103.4,3400,1715,1685,101.8
33020, 충주시,055003, 52세,2021,3958,1976,1982,99.7,3865,1922,1943,98.9
33020, 충주시,055004, 53세,2021,3926,1987,1939,102.5,3842,1942,1900,102.2
33020, 충주시,055005, 54세,2021,3598,1798,1800,99.9,3524,1755,1769,99.2
33020, 충주시,060,55~59세,2021,18008,9300,8708,106.8,17641,9113,8528,106.9
33020, 충주시,060001, 55세,2021,3580,1887,1693,111.5,3518,1855,1663,111.5
33020, 충주시,060002, 56세,2021,3768,1946,1822,106.8,3693,1903,1790,106.3
33020, 충주시,060003, 57세,2021,3230,1650,1580,104.4,3144,1609,1535,104.8
33020, 충주시,060004, 58세,2021,3569,1814,1755,103.4,3485,1773,1712,103.6
33020, 충주시,060005, 59세,2021,3861,2003,1858,107.8,3801,1973,1828,107.9
33020, 충주시,065,60~64세,2021,19446,9851,9595,102.7,19220,9730,9490,102.5
33020, 충주시,065001, 60세,2021,4492,2252,2240,100.5,4458,2237,2221,100.7
33020, 충주시,065002, 61세,2021,4019,2013,2006,100.3,3968,1989,1979,100.5
33020, 충주시,065003, 62세,2021,3746,1932,1814,106.5,3705,1912,1793,106.6
33020, 충주시,065004, 63세,2021,3629,1844,1785,103.3,3574,1809,1765,102.5
33020, 충주시,065005, 64세,2021,3560,1810,1750,103.4,3515,1783,1732,102.9
33020, 충주시,070,65~69세,2021,14379,7061,7318,96.5,14252,6993,7259,96.3
33020, 충주시,070001, 65세,2021,3336,1687,1649,102.3,3301,1670,1631,102.4
33020, 충주시,070002, 66세,2021,3074,1521,1553,97.9,3043,1504,1539,97.7
33020, 충주시,070003, 67세,2021,2700,1364,1336,102.1,2675,1351,1324,102
33020, 충주시,070004, 68세,2021,2389,1144,1245,91.9,2366,1129,1237,91.3
33020, 충주시,070005, 69세,2021,2880,1345,1535,87.6,2867,1339,1528,87.6
33020, 충주시,075,70~74세,2021,8869,4139,4730,87.5,8822,4122,4700,87.7
33020, 충주시,075001, 70세,2021,1653,790,863,91.5,1637,781,856,91.2
33020, 충주시,075002, 71세,2021,1697,787,910,86.5,1689,786,903,87
33020, 충주시,075003, 72세,2021,1840,857,983,87.2,1829,854,975,87.6
33020, 충주시,075004, 73세,2021,1771,839,932,90,1764,837,927,90.3
33020, 충주시,075005, 74세,2021,1908,866,1042,83.1,1903,864,1039,83.2
33020, 충주시,080,75~79세,2021,8065,3449,4616,74.7,8043,3444,4599,74.9
33020, 충주시,080001, 75세,2021,1442,651,791,82.3,1433,647,786,82.3
33020, 충주시,080002, 76세,2021,1521,650,871,74.6,1519,649,870,74.6
33020, 충주시,080003, 77세,2021,1655,698,957,72.9,1651,698,953,73.2
33020, 충주시,080004, 78세,2021,1564,655,909,72.1,1559,655,904,72.5
33020, 충주시,080005, 79세,2021,1883,795,1088,73.1,1881,795,1086,73.2
33020, 충주시,085,80~84세,2021,6800,2516,4284,58.7,6784,2512,4272,58.8
33020, 충주시,085001, 80세,2021,1596,620,976,63.5,1592,620,972,63.8
33020, 충주시,085002, 81세,2021,1413,535,878,60.9,1408,534,874,61.1
33020, 충주시,085003, 82세,2021,1512,543,969,56,1507,542,965,56.2
33020, 충주시,085004, 83세,2021,1212,435,777,56,1212,435,777,56
33020, 충주시,085005, 84세,2021,1067,383,684,56,1065,381,684,55.7
33020, 충주시,090,85~89세,2021,3612,1061,2551,41.6,3605,1060,2545,41.7
33020, 충주시,090001, 85세,2021,960,320,640,50,957,320,637,50.2
33020, 충주시,090002, 86세,2021,873,257,616,41.7,872,256,616,41.6
33020, 충주시,090003, 87세,2021,744,216,528,40.9,742,216,526,41.1
33020, 충주시,090004, 88세,2021,574,158,416,38,573,158,415,38.1
33020, 충주시,090005, 89세,2021,461,110,351,31.3,461,110,351,31.3
33020, 충주시,095,90~94세,2021,1113,256,857,29.9,1113,256,857,29.9
33020, 충주시,095001, 90세,2021,316,72,244,29.5,316,72,244,29.5
33020, 충주시,095002, 91세,2021,284,63,221,28.5,284,63,221,28.5
33020, 충주시,095003, 92세,2021,236,65,171,38,236,65,171,38
33020, 충주시,095004, 93세,2021,157,31,126,24.6,157,31,126,24.6
33020, 충주시,095005, 94세,2021,120,25,95,26.3,120,25,95,26.3
33020, 충주시,100,95~99세,2021,239,60,179,33.5,239,60,179,33.5
33020, 충주시,100001, 95세,2021,78,17,61,27.9,78,17,61,27.9
33020, 충주시,100002, 96세,2021,58,15,43,34.9,58,15,43,34.9
33020, 충주시,100003, 97세,2021,39,14,25,56,39,14,25,56
33020, 충주시,100004, 98세,2021,33,8,25,32,33,8,25,32
33020, 충주시,100005, 99세,2021,31,6,25,24,31,6,25,24
33020, 충주시,101,100세이상,2021,28,X,24,16.7,28,X,24,16.7
33020, 충주시,102,15세미만,2021,22921,11682,11239,103.9,22784,11619,11165,104.1
33020, 충주시,103,15~64세,2021,149323,79698,69625,114.5,142780,75686,67094,112.8
33020, 충주시,104,65세이상,2021,43105,18546,24559,75.5,42886,18451,24435,75.5
33020, 충주시,086,85세이상,2021,4992,1381,3611,38.2,4985,1380,3605,38.3
33020, 충주시,126,평균연령,2021,45.4,43.7,47.1,,45.6,44,47.3,
33020, 충주시,127,중위연령,2021,47.5,45.2,49.6,,48.1,46.1,50.1,
33030, 제천시,000,합계,2021,133750,67024,66726,100.4,131640,66027,65613,100.6
33030, 제천시,005,0~4세,2021,3274,1696,1578,107.5,3264,1690,1574,107.4
33030, 제천시,005001, 0세,2021,560,294,266,110.5,560,294,266,110.5
33030, 제천시,005002, 1세,2021,573,293,280,104.6,571,292,279,104.7
33030, 제천시,005003, 2세,2021,622,321,301,106.6,620,321,299,107.4
33030, 제천시,005004, 3세,2021,765,382,383,99.7,762,379,383,99
33030, 제천시,005005, 4세,2021,754,406,348,116.7,751,404,347,116.4
33030, 제천시,010,5~9세,2021,4835,2469,2366,104.4,4828,2465,2363,104.3
33030, 제천시,010001, 5세,2021,917,504,413,122,914,501,413,121.3
33030, 제천시,010002, 6세,2021,913,450,463,97.2,912,450,462,97.4
33030, 제천시,010003, 7세,2021,977,485,492,98.6,975,484,491,98.6
33030, 제천시,010004, 8세,2021,959,478,481,99.4,958,478,480,99.6
33030, 제천시,010005, 9세,2021,1069,552,517,106.8,1069,552,517,106.8
33030, 제천시,015,10~14세,2021,5372,2712,2660,102,5363,2707,2656,101.9
33030, 제천시,015001, 10세,2021,1061,525,536,97.9,1059,525,534,98.3
33030, 제천시,015002, 11세,2021,1073,517,556,93,1070,514,556,92.4
33030, 제천시,015003, 12세,2021,994,509,485,104.9,994,509,485,104.9
33030, 제천시,015004, 13세,2021,1104,594,510,116.5,1103,593,510,116.3
33030, 제천시,015005, 14세,2021,1140,567,573,99,1137,566,571,99.1
33030, 제천시,020,15~19세,2021,6467,3334,3133,106.4,6391,3295,3096,106.4
33030, 제천시,020001, 15세,2021,1087,583,504,115.7,1085,582,503,115.7
33030, 제천시,020002, 16세,2021,1080,575,505,113.9,1078,573,505,113.5
33030, 제천시,020003, 17세,2021,1130,594,536,110.8,1124,591,533,110.9
33030, 제천시,020004, 18세,2021,1291,654,637,102.7,1278,648,630,102.9
33030, 제천시,020005, 19세,2021,1879,928,951,97.6,1826,901,925,97.4
33030, 제천시,025,20~24세,2021,10067,5255,4812,109.2,9696,5079,4617,110
33030, 제천시,025001, 20세,2021,2073,952,1121,84.9,2033,931,1102,84.5
33030, 제천시,025002, 21세,2021,2156,908,1248,72.8,2083,878,1205,72.9
33030, 제천시,025003, 22세,2021,2078,1085,993,109.3,1997,1054,943,111.8
33030, 제천시,025004, 23세,2021,1981,1217,764,159.3,1887,1165,722,161.4
33030, 제천시,025005, 24세,2021,1779,1093,686,159.3,1696,1051,645,162.9
33030, 제천시,030,25~29세,2021,7027,4135,2892,143,6728,3982,2746,145
33030, 제천시,030001, 25세,2021,1565,945,620,152.4,1498,909,589,154.3
33030, 제천시,030002, 26세,2021,1440,836,604,138.4,1380,799,581,137.5
33030, 제천시,030003, 27세,2021,1339,804,535,150.3,1282,777,505,153.9
33030, 제천시,030004, 28세,2021,1368,801,567,141.3,1315,775,540,143.5
33030, 제천시,030005, 29세,2021,1315,749,566,132.3,1253,722,531,136
33030, 제천시,035,30~34세,2021,5737,3036,2701,112.4,5415,2884,2531,113.9
33030, 제천시,035001, 30세,2021,1163,633,530,119.4,1104,605,499,121.2
33030, 제천시,035002, 31세,2021,1154,630,524,120.2,1094,603,491,122.8
33030, 제천시,035003, 32세,2021,1139,596,543,109.8,1081,564,517,109.1
33030, 제천시,035004, 33세,2021,1131,584,547,106.8,1063,554,509,108.8
33030, 제천시,035005, 34세,2021,1150,593,557,106.5,1073,558,515,108.3
33030, 제천시,040,35~39세,2021,6867,3598,3269,110.1,6609,3474,3135,110.8
33030, 제천시,040001, 35세,2021,1238,673,565,119.1,1181,645,536,120.3
33030, 제천시,040002, 36세,2021,1200,642,558,115.1,1150,619,531,116.6
33030, 제천시,040003, 37세,2021,1330,687,643,106.8,1292,669,623,107.4
33030, 제천시,040004, 38세,2021,1461,749,712,105.2,1402,719,683,105.3
33030, 제천시,040005, 39세,2021,1638,847,791,107.1,1584,822,762,107.9
33030, 제천시,045,40~44세,2021,7953,4108,3845,106.8,7779,4023,3756,107.1
33030, 제천시,045001, 40세,2021,1583,806,777,103.7,1545,785,760,103.3
33030, 제천시,045002, 41세,2021,1673,856,817,104.8,1635,837,798,104.9
33030, 제천시,045003, 42세,2021,1567,804,763,105.4,1535,789,746,105.8
33030, 제천시,045004, 43세,2021,1527,789,738,106.9,1490,774,716,108.1
33030, 제천시,045005, 44세,2021,1603,853,750,113.7,1574,838,736,113.9
33030, 제천시,050,45~49세,2021,9466,4823,4643,103.9,9319,4759,4560,104.4
33030, 제천시,050001, 45세,2021,1614,833,781,106.7,1577,815,762,107
33030, 제천시,050002, 46세,2021,1780,864,916,94.3,1749,852,897,95
33030, 제천시,050003, 47세,2021,2006,1016,990,102.6,1977,1004,973,103.2
33030, 제천시,050004, 48세,2021,1984,998,986,101.2,1966,992,974,101.8
33030, 제천시,050005, 49세,2021,2082,1112,970,114.6,2050,1096,954,114.9
33030, 제천시,055,50~54세,2021,11758,6047,5711,105.9,11617,5987,5630,106.3
33030, 제천시,055001, 50세,2021,2271,1178,1093,107.8,2238,1161,1077,107.8
33030, 제천시,055002, 51세,2021,2218,1142,1076,106.1,2191,1130,1061,106.5
33030, 제천시,055003, 52세,2021,2437,1259,1178,106.9,2407,1249,1158,107.9
33030, 제천시,055004, 53세,2021,2521,1265,1256,100.7,2494,1253,1241,101
33030, 제천시,055005, 54세,2021,2311,1203,1108,108.6,2287,1194,1093,109.2
33030, 제천시,060,55~59세,2021,11411,5765,5646,102.1,11291,5711,5580,102.3
33030, 제천시,060001, 55세,2021,2297,1184,1113,106.4,2279,1174,1105,106.2
33030, 제천시,060002, 56세,2021,2349,1208,1141,105.9,2323,1197,1126,106.3
33030, 제천시,060003, 57세,2021,1991,997,994,100.3,1961,985,976,100.9
33030, 제천시,060004, 58세,2021,2235,1121,1114,100.6,2208,1110,1098,101.1
33030, 제천시,060005, 59세,2021,2539,1255,1284,97.7,2520,1245,1275,97.6
33030, 제천시,065,60~64세,2021,13445,6713,6732,99.7,13355,6674,6681,99.9
33030, 제천시,065001, 60세,2021,2932,1495,1437,104,2914,1488,1426,104.3
33030, 제천시,065002, 61세,2021,2743,1344,1399,96.1,2729,1340,1389,96.5
33030, 제천시,065003, 62세,2021,2580,1265,1315,96.2,2559,1254,1305,96.1
33030, 제천시,065004, 63세,2021,2653,1340,1313,102.1,2632,1330,1302,102.2
33030, 제천시,065005, 64세,2021,2537,1269,1268,100.1,2521,1262,1259,100.2
33030, 제천시,070,65~69세,2021,10447,5250,5197,101,10407,5229,5178,101
33030, 제천시,070001, 65세,2021,2328,1174,1154,101.7,2313,1169,1144,102.2
33030, 제천시,070002, 66세,2021,2199,1137,1062,107.1,2190,1131,1059,106.8
33030, 제천시,070003, 67세,2021,1942,931,1011,92.1,1936,927,1009,91.9
33030, 제천시,070004, 68세,2021,1775,912,863,105.7,1770,909,861,105.6
33030, 제천시,070005, 69세,2021,2203,1096,1107,99,2198,1093,1105,98.9
33030, 제천시,075,70~74세,2021,6479,3071,3408,90.1,6459,3063,3396,90.2
33030, 제천시,075001, 70세,2021,1237,574,663,86.6,1228,571,657,86.9
33030, 제천시,075002, 71세,2021,1255,621,634,97.9,1253,619,634,97.6
33030, 제천시,075003, 72세,2021,1279,608,671,90.6,1276,607,669,90.7
33030, 제천시,075004, 73세,2021,1354,658,696,94.5,1354,658,696,94.5
33030, 제천시,075005, 74세,2021,1354,610,744,82,1348,608,740,82.2
33030, 제천시,080,75~79세,2021,5659,2437,3222,75.6,5644,2433,3211,75.8
33030, 제천시,080001, 75세,2021,969,431,538,80.1,966,430,536,80.2
33030, 제천시,080002, 76세,2021,1077,478,599,79.8,1074,477,597,79.9
33030, 제천시,080003, 77세,2021,1147,506,641,78.9,1146,505,641,78.8
33030, 제천시,080004, 78세,2021,1127,483,644,75,1123,482,641,75.2
33030, 제천시,080005, 79세,2021,1339,539,800,67.4,1335,539,796,67.7
33030, 제천시,085,80~84세,2021,4461,1713,2748,62.3,4457,1711,2746,62.3
33030, 제천시,085001, 80세,2021,1064,434,630,68.9,1064,434,630,68.9
33030, 제천시,085002, 81세,2021,921,339,582,58.2,920,338,582,58.1
33030, 제천시,085003, 82세,2021,897,349,548,63.7,894,348,546,63.7
33030, 제천시,085004, 83세,2021,833,317,516,61.4,833,317,516,61.4
33030, 제천시,085005, 84세,2021,746,274,472,58.1,746,274,472,58.1
33030, 제천시,090,85~89세,2021,2168,684,1484,46.1,2163,683,1480,46.1
33030, 제천시,090001, 85세,2021,611,215,396,54.3,609,215,394,54.6
33030, 제천시,090002, 86세,2021,535,186,349,53.3,534,186,348,53.4
33030, 제천시,090003, 87세,2021,428,132,296,44.6,427,131,296,44.3
33030, 제천시,090004, 88세,2021,335,90,245,36.7,335,90,245,36.7
33030, 제천시,090005, 89세,2021,259,61,198,30.8,258,61,197,31
33030, 제천시,095,90~94세,2021,681,148,533,27.8,679,148,531,27.9
33030, 제천시,095001, 90세,2021,187,48,139,34.5,187,48,139,34.5
33030, 제천시,095002, 91세,2021,197,40,157,25.5,197,40,157,25.5
33030, 제천시,095003, 92세,2021,121,33,88,37.5,120,33,87,37.9
33030, 제천시,095004, 93세,2021,94,16,78,20.5,94,16,78,20.5
33030, 제천시,095005, 94세,2021,82,11,71,15.5,81,11,70,15.7
33030, 제천시,100,95~99세,2021,144,26,118,22,144,26,118,22
33030, 제천시,100001, 95세,2021,46,6,40,15,46,6,40,15
33030, 제천시,100002, 96세,2021,35,6,29,20.7,35,6,29,20.7
33030, 제천시,100003, 97세,2021,28,X,24,16.7,28,X,24,16.7
33030, 제천시,100004, 98세,2021,18,X,15,20,18,X,15,20
33030, 제천시,100005, 99세,2021,17,7,10,70,17,7,10,70
33030, 제천시,101,100세이상,2021,32,X,28,14.3,32,X,28,14.3
33030, 제천시,102,15세미만,2021,13481,6877,6604,104.1,13455,6862,6593,104.1
33030, 제천시,103,15~64세,2021,90198,46814,43384,107.9,88200,45868,42332,108.4
33030, 제천시,104,65세이상,2021,30071,13333,16738,79.7,29985,13297,16688,79.7
33030, 제천시,086,85세이상,2021,3025,862,2163,39.9,3018,861,2157,39.9
33030, 제천시,126,평균연령,2021,46.7,45.3,48,,46.8,45.5,48.2,
33030, 제천시,127,중위연령,2021,49.9,48.5,51.3,,50.2,48.7,51.7,
33040, 청주시,000,합계,2021,856923,431607,425316,101.5,837034,421236,415798,101.3
33040, 청주시,005,0~4세,2021,30517,15614,14903,104.8,29993,15332,14661,104.6
33040, 청주시,005001, 0세,2021,5282,2687,2595,103.5,5195,2643,2552,103.6
33040, 청주시,005002, 1세,2021,5497,2837,2660,106.7,5386,2776,2610,106.4
33040, 청주시,005003, 2세,2021,5823,2991,2832,105.6,5716,2939,2777,105.8
33040, 청주시,005004, 3세,2021,6792,3436,3356,102.4,6673,3370,3303,102
33040, 청주시,005005, 4세,2021,7123,3663,3460,105.9,7023,3604,3419,105.4
33040, 청주시,010,5~9세,2021,41294,21023,20271,103.7,40814,20793,20021,103.9
33040, 청주시,010001, 5세,2021,7848,3988,3860,103.3,7745,3943,3802,103.7
33040, 청주시,010002, 6세,2021,8166,4189,3977,105.3,8048,4133,3915,105.6
33040, 청주시,010003, 7세,2021,8063,4050,4013,100.9,7965,4002,3963,101
33040, 청주시,010004, 8세,2021,8251,4209,4042,104.1,8170,4172,3998,104.4
33040, 청주시,010005, 9세,2021,8966,4587,4379,104.7,8886,4543,4343,104.6
33040, 청주시,015,10~14세,2021,42469,21872,20597,106.2,42145,21704,20441,106.2
33040, 청주시,015001, 10세,2021,8782,4429,4353,101.7,8701,4386,4315,101.6
33040, 청주시,015002, 11세,2021,8395,4335,4060,106.8,8330,4301,4029,106.8
33040, 청주시,015003, 12세,2021,8170,4278,3892,109.9,8102,4241,3861,109.8
33040, 청주시,015004, 13세,2021,8425,4349,4076,106.7,8378,4326,4052,106.8
33040, 청주시,015005, 14세,2021,8697,4481,4216,106.3,8634,4450,4184,106.4
33040, 청주시,020,15~19세,2021,42096,21887,20209,108.3,41756,21709,20047,108.3
33040, 청주시,020001, 15세,2021,7925,4086,3839,106.4,7879,4057,3822,106.1
33040, 청주시,020002, 16세,2021,7799,4011,3788,105.9,7744,3986,3758,106.1
33040, 청주시,020003, 17세,2021,8467,4463,4004,111.5,8423,4441,3982,111.5
33040, 청주시,020004, 18세,2021,8711,4551,4160,109.4,8649,4519,4130,109.4
33040, 청주시,020005, 19세,2021,9194,4776,4418,108.1,9061,4706,4355,108.1
33040, 청주시,025,20~24세,2021,57912,30512,27400,111.4,55833,29457,26376,111.7
33040, 청주시,025001, 20세,2021,10624,5504,5120,107.5,10398,5392,5006,107.7
33040, 청주시,025002, 21세,2021,11755,6106,5649,108.1,11356,5906,5450,108.4
33040, 청주시,025003, 22세,2021,11412,6082,5330,114.1,10950,5858,5092,115
33040, 청주시,025004, 23세,2021,11729,6242,5487,113.8,11249,5991,5258,113.9
33040, 청주시,025005, 24세,2021,12392,6578,5814,113.1,11880,6310,5570,113.3
33040, 청주시,030,25~29세,2021,66088,36932,29156,126.7,63286,35416,27870,127.1
33040, 청주시,030001, 25세,2021,12869,7135,5734,124.4,12314,6824,5490,124.3
33040, 청주시,030002, 26세,2021,13240,7250,5990,121,12652,6933,5719,121.2
33040, 청주시,030003, 27세,2021,13446,7619,5827,130.8,12871,7306,5565,131.3
33040, 청주시,030004, 28세,2021,13483,7569,5914,128,12939,7274,5665,128.4
33040, 청주시,030005, 29세,2021,13050,7359,5691,129.3,12510,7079,5431,130.3
33040, 청주시,035,30~34세,2021,58208,31272,26936,116.1,55122,29575,25547,115.8
33040, 청주시,035001, 30세,2021,12249,6704,5545,120.9,11675,6385,5290,120.7
33040, 청주시,035002, 31세,2021,11661,6382,5279,120.9,11034,6049,4985,121.3
33040, 청주시,035003, 32세,2021,11337,6127,5210,117.6,10746,5800,4946,117.3
33040, 청주시,035004, 33세,2021,11442,6025,5417,111.2,10799,5668,5131,110.5
33040, 청주시,035005, 34세,2021,11519,6034,5485,110,10868,5673,5195,109.2
33040, 청주시,040,35~39세,2021,63317,32804,30513,107.5,60715,31380,29335,107
33040, 청주시,040001, 35세,2021,11505,6121,5384,113.7,10923,5803,5120,113.3
33040, 청주시,040002, 36세,2021,11571,5964,5607,106.4,11035,5690,5345,106.5
33040, 청주시,040003, 37세,2021,12375,6485,5890,110.1,11868,6215,5653,109.9
33040, 청주시,040004, 38세,2021,13259,6796,6463,105.2,12751,6504,6247,104.1
33040, 청주시,040005, 39세,2021,14607,7438,7169,103.8,14138,7168,6970,102.8
33040, 청주시,045,40~44세,2021,66639,34170,32469,105.2,64803,33151,31652,104.7
33040, 청주시,045001, 40세,2021,13575,7039,6536,107.7,13139,6797,6342,107.2
33040, 청주시,045002, 41세,2021,14204,7323,6881,106.4,13837,7112,6725,105.8
33040, 청주시,045003, 42세,2021,13514,6956,6558,106.1,13136,6739,6397,105.3
33040, 청주시,045004, 43세,2021,12450,6373,6077,104.9,12116,6189,5927,104.4
33040, 청주시,045005, 44세,2021,12896,6479,6417,101,12575,6314,6261,100.8
33040, 청주시,050,45~49세,2021,68756,34367,34389,99.9,67304,33631,33673,99.9
33040, 청주시,050001, 45세,2021,12621,6372,6249,102,12345,6232,6113,101.9
33040, 청주시,050002, 46세,2021,13303,6564,6739,97.4,12997,6408,6589,97.3
33040, 청주시,050003, 47세,2021,14580,7325,7255,101,14300,7182,7118,100.9
33040, 청주시,050004, 48세,2021,14584,7187,7397,97.2,14299,7052,7247,97.3
33040, 청주시,050005, 49세,2021,13668,6919,6749,102.5,13363,6757,6606,102.3
33040, 청주시,055,50~54세,2021,73842,36525,37317,97.9,72412,35785,36627,97.7
33040, 청주시,055001, 50세,2021,14912,7522,7390,101.8,14602,7356,7246,101.5
33040, 청주시,055002, 51세,2021,14403,7205,7198,100.1,14084,7023,7061,99.5
33040, 청주시,055003, 52세,2021,15723,7727,7996,96.6,15433,7581,7852,96.5
33040, 청주시,055004, 53세,2021,15017,7192,7825,91.9,14744,7064,7680,92
33040, 청주시,055005, 54세,2021,13787,6879,6908,99.6,13549,6761,6788,99.6
33040, 청주시,060,55~59세,2021,64320,32418,31902,101.6,63053,31828,31225,101.9
33040, 청주시,060001, 55세,2021,13275,6655,6620,100.5,13011,6535,6476,100.9
33040, 청주시,060002, 56세,2021,13674,6785,6889,98.5,13386,6637,6749,98.3
33040, 청주시,060003, 57세,2021,11681,5838,5843,99.9,11465,5746,5719,100.5
33040, 청주시,060004, 58세,2021,12404,6368,6036,105.5,12115,6230,5885,105.9
33040, 청주시,060005, 59세,2021,13286,6772,6514,104,13076,6680,6396,104.4
33040, 청주시,065,60~64세,2021,62551,30863,31688,97.4,61674,30467,31207,97.6
33040, 청주시,065001, 60세,2021,14896,7428,7468,99.5,14743,7362,7381,99.7
33040, 청주시,065002, 61세,2021,12999,6375,6624,96.2,12771,6269,6502,96.4
33040, 청주시,065003, 62세,2021,11994,5822,6172,94.3,11821,5744,6077,94.5
33040, 청주시,065004, 63세,2021,11409,5716,5693,100.4,11242,5641,5601,100.7
33040, 청주시,065005, 64세,2021,11253,5522,5731,96.4,11097,5451,5646,96.5
33040, 청주시,070,65~69세,2021,42660,20691,21969,94.2,42188,20467,21721,94.2
33040, 청주시,070001, 65세,2021,9910,4915,4995,98.4,9786,4852,4934,98.3
33040, 청주시,070002, 66세,2021,9703,4630,5073,91.3,9589,4574,5015,91.2
33040, 청주시,070003, 67세,2021,8262,4015,4247,94.5,8162,3973,4189,94.8
33040, 청주시,070004, 68세,2021,7075,3410,3665,93,7003,3371,3632,92.8
33040, 청주시,070005, 69세,2021,7710,3721,3989,93.3,7648,3697,3951,93.6
33040, 청주시,075,70~74세,2021,26607,12473,14134,88.2,26427,12399,14028,88.4
33040, 청주시,075001, 70세,2021,5124,2421,2703,89.6,5070,2394,2676,89.5
33040, 청주시,075002, 71세,2021,5402,2534,2868,88.4,5364,2523,2841,88.8
33040, 청주시,075003, 72세,2021,5497,2645,2852,92.7,5462,2631,2831,92.9
33040, 청주시,075004, 73세,2021,5431,2550,2881,88.5,5399,2535,2864,88.5
33040, 청주시,075005, 74세,2021,5153,2323,2830,82.1,5132,2316,2816,82.2
33040, 청주시,080,75~79세,2021,21119,9004,12115,74.3,21050,8974,12076,74.3
33040, 청주시,080001, 75세,2021,3916,1792,2124,84.4,3895,1786,2109,84.7
33040, 청주시,080002, 76세,2021,4059,1826,2233,81.8,4046,1819,2227,81.7
33040, 청주시,080003, 77세,2021,4055,1671,2384,70.1,4043,1666,2377,70.1
33040, 청주시,080004, 78세,2021,4192,1731,2461,70.3,4182,1725,2457,70.2
33040, 청주시,080005, 79세,2021,4897,1984,2913,68.1,4884,1978,2906,68.1
33040, 청주시,085,80~84세,2021,15945,5839,10106,57.8,15901,5832,10069,57.9
33040, 청주시,085001, 80세,2021,3723,1437,2286,62.9,3707,1434,2273,63.1
33040, 청주시,085002, 81세,2021,3265,1239,2026,61.2,3258,1237,2021,61.2
33040, 청주시,085003, 82세,2021,3324,1223,2101,58.2,3317,1223,2094,58.4
33040, 청주시,085004, 83세,2021,2905,1013,1892,53.5,2898,1013,1885,53.7
33040, 청주시,085005, 84세,2021,2728,927,1801,51.5,2721,925,1796,51.5
33040, 청주시,090,85~89세,2021,9022,2627,6395,41.1,9001,2623,6378,41.1
33040, 청주시,090001, 85세,2021,2485,774,1711,45.2,2478,774,1704,45.4
33040, 청주시,090002, 86세,2021,2243,710,1533,46.3,2238,709,1529,46.4
33040, 청주시,090003, 87세,2021,1694,476,1218,39.1,1690,474,1216,39
33040, 청주시,090004, 88세,2021,1438,382,1056,36.2,1435,382,1053,36.3
33040, 청주시,090005, 89세,2021,1162,285,877,32.5,1160,284,876,32.4
33040, 청주시,095,90~94세,2021,2880,606,2274,26.6,2877,606,2271,26.7
33040, 청주시,095001, 90세,2021,767,164,603,27.2,765,164,601,27.3
33040, 청주시,095002, 91세,2021,751,167,584,28.6,751,167,584,28.6
33040, 청주시,095003, 92세,2021,588,106,482,22,587,106,481,22
33040, 청주시,095004, 93세,2021,441,102,339,30.1,441,102,339,30.1
33040, 청주시,095005, 94세,2021,333,67,266,25.2,333,67,266,25.2
33040, 청주시,100,95~99세,2021,600,98,502,19.5,599,97,502,19.3
33040, 청주시,100001, 95세,2021,192,31,161,19.3,192,31,161,19.3
33040, 청주시,100002, 96세,2021,152,23,129,17.8,152,23,129,17.8
33040, 청주시,100003, 97세,2021,100,19,81,23.5,99,18,81,22.2
33040, 청주시,100004, 98세,2021,84,13,71,18.3,84,13,71,18.3
33040, 청주시,100005, 99세,2021,72,12,60,20,72,12,60,20
33040, 청주시,101,100세이상,2021,81,10,71,14.1,81,10,71,14.1
33040, 청주시,102,15세미만,2021,114280,58509,55771,104.9,112952,57829,55123,104.9
33040, 청주시,103,15~64세,2021,623729,321750,301979,106.5,605958,312399,293559,106.4
33040, 청주시,104,65세이상,2021,118914,51348,67566,76,118124,51008,67116,76
33040, 청주시,086,85세이상,2021,12583,3341,9242,36.2,12558,3336,9222,36.2
33040, 청주시,126,평균연령,2021,41.4,40.2,42.6,,41.5,40.3,42.7,
33040, 청주시,127,중위연령,2021,41.9,40.6,43.4,,42.1,40.8,43.7,
33041, 상당구,000,합계,2021,189611,94232,95379,98.8,188000,93566,94434,99.1
33041, 상당구,005,0~4세,2021,6529,3291,3238,101.6,6507,3279,3228,101.6
33041, 상당구,005001, 0세,2021,1119,572,547,104.6,1117,570,547,104.2
33041, 상당구,005002, 1세,2021,1207,609,598,101.8,1205,608,597,101.8
33041, 상당구,005003, 2세,2021,1240,622,618,100.6,1231,617,614,100.5
33041, 상당구,005004, 3세,2021,1444,720,724,99.4,1440,716,724,98.9
33041, 상당구,005005, 4세,2021,1519,768,751,102.3,1514,768,746,102.9
33041, 상당구,010,5~9세,2021,9326,4761,4565,104.3,9315,4756,4559,104.3
33041, 상당구,010001, 5세,2021,1723,878,845,103.9,1718,876,842,104
33041, 상당구,010002, 6세,2021,1810,909,901,100.9,1808,908,900,100.9
33041, 상당구,010003, 7세,2021,1851,915,936,97.8,1850,915,935,97.9
33041, 상당구,010004, 8세,2021,1897,1017,880,115.6,1897,1017,880,115.6
33041, 상당구,010005, 9세,2021,2045,1042,1003,103.9,2042,1040,1002,103.8
33041, 상당구,015,10~14세,2021,9624,4974,4650,107,9606,4964,4642,106.9
33041, 상당구,015001, 10세,2021,1988,986,1002,98.4,1983,983,1000,98.3
33041, 상당구,015002, 11세,2021,1936,1043,893,116.8,1933,1041,892,116.7
33041, 상당구,015003, 12세,2021,1802,940,862,109,1799,938,861,108.9
33041, 상당구,015004, 13세,2021,1893,972,921,105.5,1890,971,919,105.7
33041, 상당구,015005, 14세,2021,2005,1033,972,106.3,2001,1031,970,106.3
33041, 상당구,020,15~19세,2021,9454,5027,4427,113.6,9443,5021,4422,113.5
33041, 상당구,020001, 15세,2021,1765,890,875,101.7,1765,890,875,101.7
33041, 상당구,020002, 16세,2021,1825,947,878,107.9,1823,946,877,107.9
33041, 상당구,020003, 17세,2021,2044,1106,938,117.9,2043,1106,937,118
33041, 상당구,020004, 18세,2021,2005,1070,935,114.4,2004,1069,935,114.3
33041, 상당구,020005, 19세,2021,1815,1014,801,126.6,1808,1010,798,126.6
33041, 상당구,025,20~24세,2021,10899,6008,4891,122.8,10783,5959,4824,123.5
33041, 상당구,025001, 20세,2021,2008,1151,857,134.3,1994,1145,849,134.9
33041, 상당구,025002, 21세,2021,2241,1283,958,133.9,2223,1277,946,135
33041, 상당구,025003, 22세,2021,2106,1176,930,126.5,2083,1167,916,127.4
33041, 상당구,025004, 23세,2021,2249,1197,1052,113.8,2224,1189,1035,114.9
33041, 상당구,025005, 24세,2021,2295,1201,1094,109.8,2259,1181,1078,109.6
33041, 상당구,030,25~29세,2021,12155,6548,5607,116.8,11947,6466,5481,118
33041, 상당구,030001, 25세,2021,2381,1286,1095,117.4,2344,1270,1074,118.2
33041, 상당구,030002, 26세,2021,2456,1326,1130,117.3,2408,1305,1103,118.3
33041, 상당구,030003, 27세,2021,2520,1384,1136,121.8,2478,1366,1112,122.8
33041, 상당구,030004, 28세,2021,2470,1330,1140,116.7,2428,1317,1111,118.5
33041, 상당구,030005, 29세,2021,2328,1222,1106,110.5,2289,1208,1081,111.7
33041, 상당구,035,30~34세,2021,10623,5519,5104,108.1,10364,5399,4965,108.7
33041, 상당구,035001, 30세,2021,2149,1128,1021,110.5,2104,1110,994,111.7
33041, 상당구,035002, 31세,2021,2134,1131,1003,112.8,2074,1106,968,114.3
33041, 상당구,035003, 32세,2021,2036,1074,962,111.6,1986,1044,942,110.8
33041, 상당구,035004, 33세,2021,2142,1076,1066,100.9,2086,1053,1033,101.9
33041, 상당구,035005, 34세,2021,2162,1110,1052,105.5,2114,1086,1028,105.6
33041, 상당구,040,35~39세,2021,12605,6352,6253,101.6,12390,6265,6125,102.3
33041, 상당구,040001, 35세,2021,2227,1146,1081,106,2167,1122,1045,107.4
33041, 상당구,040002, 36세,2021,2293,1143,1150,99.4,2252,1130,1122,100.7
33041, 상당구,040003, 37세,2021,2432,1238,1194,103.7,2391,1222,1169,104.5
33041, 상당구,040004, 38세,2021,2688,1321,1367,96.6,2658,1311,1347,97.3
33041, 상당구,040005, 39세,2021,2965,1504,1461,102.9,2922,1480,1442,102.6
33041, 상당구,045,40~44세,2021,14359,7136,7223,98.8,14209,7068,7141,99
33041, 상당구,045001, 40세,2021,2886,1444,1442,100.1,2850,1428,1422,100.4
33041, 상당구,045002, 41세,2021,3076,1537,1539,99.9,3049,1522,1527,99.7
33041, 상당구,045003, 42세,2021,2901,1481,1420,104.3,2865,1465,1400,104.6
33041, 상당구,045004, 43세,2021,2633,1275,1358,93.9,2606,1264,1342,94.2
33041, 상당구,045005, 44세,2021,2863,1399,1464,95.6,2839,1389,1450,95.8
33041, 상당구,050,45~49세,2021,15510,7600,7910,96.1,15394,7562,7832,96.6
33041, 상당구,050001, 45세,2021,2777,1397,1380,101.2,2753,1390,1363,102
33041, 상당구,050002, 46세,2021,2898,1398,1500,93.2,2874,1391,1483,93.8
33041, 상당구,050003, 47세,2021,3304,1608,1696,94.8,3280,1601,1679,95.4
33041, 상당구,050004, 48세,2021,3354,1607,1747,92,3328,1599,1729,92.5
33041, 상당구,050005, 49세,2021,3177,1590,1587,100.2,3159,1581,1578,100.2
33041, 상당구,055,50~54세,2021,17354,8423,8931,94.3,17214,8370,8844,94.6
33041, 상당구,055001, 50세,2021,3493,1739,1754,99.1,3472,1732,1740,99.5
33041, 상당구,055002, 51세,2021,3322,1640,1682,97.5,3297,1629,1668,97.7
33041, 상당구,055003, 52세,2021,3638,1713,1925,89,3611,1702,1909,89.2
33041, 상당구,055004, 53세,2021,3546,1676,1870,89.6,3514,1664,1850,89.9
33041, 상당구,055005, 54세,2021,3355,1655,1700,97.4,3320,1643,1677,98
33041, 상당구,060,55~59세,2021,15657,7923,7734,102.4,15526,7874,7652,102.9
33041, 상당구,060001, 55세,2021,3275,1658,1617,102.5,3250,1649,1601,103
33041, 상당구,060002, 56세,2021,3312,1626,1686,96.4,3282,1621,1661,97.6
33041, 상당구,060003, 57세,2021,2841,1427,1414,100.9,2820,1418,1402,101.1
33041, 상당구,060004, 58세,2021,3012,1549,1463,105.9,2982,1536,1446,106.2
33041, 상당구,060005, 59세,2021,3217,1663,1554,107,3192,1650,1542,107
33041, 상당구,065,60~64세,2021,15224,7545,7679,98.3,15116,7499,7617,98.5
33041, 상당구,065001, 60세,2021,3629,1821,1808,100.7,3606,1809,1797,100.7
33041, 상당구,065002, 61세,2021,3124,1537,1587,96.8,3106,1531,1575,97.2
33041, 상당구,065003, 62세,2021,2825,1354,1471,92,2806,1347,1459,92.3
33041, 상당구,065004, 63세,2021,2797,1391,1406,98.9,2770,1379,1391,99.1
33041, 상당구,065005, 64세,2021,2849,1442,1407,102.5,2828,1433,1395,102.7
33041, 상당구,070,65~69세,2021,10696,5217,5479,95.2,10639,5190,5449,95.2
33041, 상당구,070001, 65세,2021,2400,1188,1212,98,2386,1181,1205,98
33041, 상당구,070002, 66세,2021,2375,1135,1240,91.5,2364,1127,1237,91.1
33041, 상당구,070003, 67세,2021,2107,1066,1041,102.4,2095,1062,1033,102.8
33041, 상당구,070004, 68세,2021,1811,882,929,94.9,1801,877,924,94.9
33041, 상당구,070005, 69세,2021,2003,946,1057,89.5,1993,943,1050,89.8
33041, 상당구,075,70~74세,2021,6759,3194,3565,89.6,6732,3185,3547,89.8
33041, 상당구,075001, 70세,2021,1280,633,647,97.8,1274,629,645,97.5
33041, 상당구,075002, 71세,2021,1350,634,716,88.5,1343,633,710,89.2
33041, 상당구,075003, 72세,2021,1398,687,711,96.6,1393,686,707,97
33041, 상당구,075004, 73세,2021,1389,640,749,85.4,1382,638,744,85.8
33041, 상당구,075005, 74세,2021,1342,600,742,80.9,1340,599,741,80.8
33041, 상당구,080,75~79세,2021,5473,2310,3163,73,5462,2307,3155,73.1
33041, 상당구,080001, 75세,2021,967,441,526,83.8,963,440,523,84.1
33041, 상당구,080002, 76세,2021,1025,454,571,79.5,1023,454,569,79.8
33041, 상당구,080003, 77세,2021,1059,426,633,67.3,1058,425,633,67.1
33041, 상당구,080004, 78세,2021,1084,462,622,74.3,1083,461,622,74.1
33041, 상당구,080005, 79세,2021,1338,527,811,65,1335,527,808,65.2
33041, 상당구,085,80~84세,2021,4177,1505,2672,56.3,4169,1503,2666,56.4
33041, 상당구,085001, 80세,2021,988,390,598,65.2,985,389,596,65.3
33041, 상당구,085002, 81세,2021,841,307,534,57.5,840,307,533,57.6
33041, 상당구,085003, 82세,2021,844,325,519,62.6,844,325,519,62.6
33041, 상당구,085004, 83세,2021,757,250,507,49.3,755,250,505,49.5
33041, 상당구,085005, 84세,2021,747,233,514,45.3,745,232,513,45.2
33041, 상당구,090,85~89세,2021,2272,697,1575,44.3,2270,697,1573,44.3
33041, 상당구,090001, 85세,2021,644,208,436,47.7,644,208,436,47.7
33041, 상당구,090002, 86세,2021,585,199,386,51.6,585,199,386,51.6
33041, 상당구,090003, 87세,2021,429,134,295,45.4,428,134,294,45.6
33041, 상당구,090004, 88세,2021,339,90,249,36.1,338,90,248,36.3
33041, 상당구,090005, 89세,2021,275,66,209,31.6,275,66,209,31.6
33041, 상당구,095,90~94세,2021,747,171,576,29.7,746,171,575,29.7
33041, 상당구,095001, 90세,2021,173,34,139,24.5,172,34,138,24.6
33041, 상당구,095002, 91세,2021,204,46,158,29.1,204,46,158,29.1
33041, 상당구,095003, 92세,2021,158,31,127,24.4,158,31,127,24.4
33041, 상당구,095004, 93세,2021,120,38,82,46.3,120,38,82,46.3
33041, 상당구,095005, 94세,2021,92,22,70,31.4,92,22,70,31.4
33041, 상당구,100,95~99세,2021,149,29,120,24.2,149,29,120,24.2
33041, 상당구,100001, 95세,2021,52,11,41,26.8,52,11,41,26.8
33041, 상당구,100002, 96세,2021,25,5,20,25,25,5,20,25
33041, 상당구,100003, 97세,2021,30,X,26,15.4,30,X,26,15.4
33041, 상당구,100004, 98세,2021,21,X,17,23.5,21,X,17,23.5
33041, 상당구,100005, 99세,2021,21,5,16,31.3,21,5,16,31.3
33041, 상당구,101,100세이상,2021,19,X,17,11.8,19,X,17,11.8
33041, 상당구,102,15세미만,2021,25479,13026,12453,104.6,25428,12999,12429,104.6
33041, 상당구,103,15~64세,2021,133840,68081,65759,103.5,132386,67483,64903,104
33041, 상당구,104,65세이상,2021,30292,13125,17167,76.5,30186,13084,17102,76.5
33041, 상당구,086,85세이상,2021,3187,899,2288,39.3,3184,899,2285,39.3
33041, 상당구,126,평균연령,2021,43,41.7,44.2,,43,41.7,44.2,
33041, 상당구,127,중위연령,2021,44.7,43.1,46.2,,44.8,43.2,46.3,
33042, 서원구,000,합계,2021,195526,96900,98626,98.2,190947,94637,96310,98.3
33042, 서원구,005,0~4세,2021,5205,2697,2508,107.5,5081,2630,2451,107.3
33042, 서원구,005001, 0세,2021,861,450,411,109.5,839,438,401,109.2
33042, 서원구,005002, 1세,2021,945,494,451,109.5,911,477,434,109.9
33042, 서원구,005003, 2세,2021,957,503,454,110.8,933,491,442,111.1
33042, 서원구,005004, 3세,2021,1184,605,579,104.5,1165,593,572,103.7
33042, 서원구,005005, 4세,2021,1258,645,613,105.2,1233,631,602,104.8
33042, 서원구,010,5~9세,2021,7707,3893,3814,102.1,7566,3824,3742,102.2
33042, 서원구,010001, 5세,2021,1363,677,686,98.7,1334,662,672,98.5
33042, 서원구,010002, 6세,2021,1484,779,705,110.5,1447,761,686,110.9
33042, 서원구,010003, 7세,2021,1500,766,734,104.4,1472,753,719,104.7
33042, 서원구,010004, 8세,2021,1539,733,806,90.9,1508,717,791,90.6
33042, 서원구,010005, 9세,2021,1821,938,883,106.2,1805,931,874,106.5
33042, 서원구,015,10~14세,2021,9254,4779,4475,106.8,9160,4731,4429,106.8
33042, 서원구,015001, 10세,2021,1837,918,919,99.9,1816,907,909,99.8
33042, 서원구,015002, 11세,2021,1769,911,858,106.2,1748,901,847,106.4
33042, 서원구,015003, 12세,2021,1778,943,835,112.9,1754,931,823,113.1
33042, 서원구,015004, 13세,2021,1932,980,952,102.9,1918,972,946,102.7
33042, 서원구,015005, 14세,2021,1938,1027,911,112.7,1924,1020,904,112.8
33042, 서원구,020,15~19세,2021,10138,5208,4930,105.6,10029,5149,4880,105.5
33042, 서원구,020001, 15세,2021,1885,966,919,105.1,1872,957,915,104.6
33042, 서원구,020002, 16세,2021,1855,947,908,104.3,1836,937,899,104.2
33042, 서원구,020003, 17세,2021,1954,1017,937,108.5,1937,1009,928,108.7
33042, 서원구,020004, 18세,2021,2109,1101,1008,109.2,2091,1087,1004,108.3
33042, 서원구,020005, 19세,2021,2335,1177,1158,101.6,2293,1159,1134,102.2
33042, 서원구,025,20~24세,2021,15354,7900,7454,106,14821,7648,7173,106.6
33042, 서원구,025001, 20세,2021,2752,1378,1374,100.3,2686,1345,1341,100.3
33042, 서원구,025002, 21세,2021,3151,1566,1585,98.8,3044,1514,1530,99
33042, 서원구,025003, 22세,2021,3056,1573,1483,106.1,2950,1526,1424,107.2
33042, 서원구,025004, 23세,2021,3138,1665,1473,113,3019,1605,1414,113.5
33042, 서원구,025005, 24세,2021,3257,1718,1539,111.6,3122,1658,1464,113.3
33042, 서원구,030,25~29세,2021,14574,8184,6390,128.1,13932,7866,6066,129.7
33042, 서원구,030001, 25세,2021,3239,1868,1371,136.3,3110,1801,1309,137.6
33042, 서원구,030002, 26세,2021,2977,1628,1349,120.7,2846,1568,1278,122.7
33042, 서원구,030003, 27세,2021,2927,1647,1280,128.7,2818,1590,1228,129.5
33042, 서원구,030004, 28세,2021,2790,1533,1257,122,2651,1471,1180,124.7
33042, 서원구,030005, 29세,2021,2641,1508,1133,133.1,2507,1436,1071,134.1
33042, 서원구,035,30~34세,2021,11120,5936,5184,114.5,10482,5597,4885,114.6
33042, 서원구,035001, 30세,2021,2483,1356,1127,120.3,2374,1288,1086,118.6
33042, 서원구,035002, 31세,2021,2259,1230,1029,119.5,2137,1170,967,121
33042, 서원구,035003, 32세,2021,2112,1116,996,112,1975,1055,920,114.7
33042, 서원구,035004, 33세,2021,2076,1097,979,112.1,1939,1025,914,112.1
33042, 서원구,035005, 34세,2021,2190,1137,1053,108,2057,1059,998,106.1
33042, 서원구,040,35~39세,2021,11657,5956,5701,104.5,11093,5655,5438,104
33042, 서원구,040001, 35세,2021,2076,1094,982,111.4,1946,1021,925,110.4
33042, 서원구,040002, 36세,2021,2119,1097,1022,107.3,2007,1041,966,107.8
33042, 서원구,040003, 37세,2021,2255,1148,1107,103.7,2159,1099,1060,103.7
33042, 서원구,040004, 38세,2021,2455,1223,1232,99.3,2339,1159,1180,98.2
33042, 서원구,040005, 39세,2021,2752,1394,1358,102.7,2642,1335,1307,102.1
33042, 서원구,045,40~44세,2021,13689,6815,6874,99.1,13283,6603,6680,98.8
33042, 서원구,045001, 40세,2021,2739,1379,1360,101.4,2638,1327,1311,101.2
33042, 서원구,045002, 41세,2021,2736,1374,1362,100.9,2654,1327,1327,100
33042, 서원구,045003, 42세,2021,2730,1342,1388,96.7,2670,1314,1356,96.9
33042, 서원구,045004, 43세,2021,2670,1323,1347,98.2,2586,1274,1312,97.1
33042, 서원구,045005, 44세,2021,2814,1397,1417,98.6,2735,1361,1374,99.1
33042, 서원구,050,45~49세,2021,15955,7789,8166,95.4,15602,7632,7970,95.8
33042, 서원구,050001, 45세,2021,2803,1386,1417,97.8,2747,1364,1383,98.6
33042, 서원구,050002, 46세,2021,3042,1457,1585,91.9,2964,1423,1541,92.3
33042, 서원구,050003, 47세,2021,3366,1662,1704,97.5,3280,1628,1652,98.5
33042, 서원구,050004, 48세,2021,3429,1633,1796,90.9,3361,1601,1760,91
33042, 서원구,050005, 49세,2021,3315,1651,1664,99.2,3250,1616,1634,98.9
33042, 서원구,055,50~54세,2021,18105,8767,9338,93.9,17776,8610,9166,93.9
33042, 서원구,055001, 50세,2021,3561,1758,1803,97.5,3488,1720,1768,97.3
33042, 서원구,055002, 51세,2021,3494,1700,1794,94.8,3425,1662,1763,94.3
33042, 서원구,055003, 52세,2021,3839,1832,2007,91.3,3771,1807,1964,92
33042, 서원구,055004, 53세,2021,3688,1752,1936,90.5,3625,1723,1902,90.6
33042, 서원구,055005, 54세,2021,3523,1725,1798,95.9,3467,1698,1769,96
33042, 서원구,060,55~59세,2021,15700,7823,7877,99.3,15437,7702,7735,99.6
33042, 서원구,060001, 55세,2021,3187,1594,1593,100.1,3133,1565,1568,99.8
33042, 서원구,060002, 56세,2021,3303,1666,1637,101.8,3248,1639,1609,101.9
33042, 서원구,060003, 57세,2021,2820,1356,1464,92.6,2775,1341,1434,93.5
33042, 서원구,060004, 58세,2021,3063,1540,1523,101.1,3008,1515,1493,101.5
33042, 서원구,060005, 59세,2021,3327,1667,1660,100.4,3273,1642,1631,100.7
33042, 서원구,065,60~64세,2021,15872,7754,8118,95.5,15682,7669,8013,95.7
33042, 서원구,065001, 60세,2021,3747,1852,1895,97.7,3712,1841,1871,98.4
33042, 서원구,065002, 61세,2021,3281,1567,1714,91.4,3224,1540,1684,91.4
33042, 서원구,065003, 62세,2021,3017,1445,1572,91.9,2988,1430,1558,91.8
33042, 서원구,065004, 63세,2021,2916,1461,1455,100.4,2875,1442,1433,100.6
33042, 서원구,065005, 64세,2021,2911,1429,1482,96.4,2883,1416,1467,96.5
33042, 서원구,070,65~69세,2021,11025,5290,5735,92.2,10918,5242,5676,92.4
33042, 서원구,070001, 65세,2021,2579,1275,1304,97.8,2554,1264,1290,98
33042, 서원구,070002, 66세,2021,2468,1171,1297,90.3,2442,1158,1284,90.2
33042, 서원구,070003, 67세,2021,2133,1053,1080,97.5,2108,1043,1065,97.9
33042, 서원구,070004, 68세,2021,1831,820,1011,81.1,1812,810,1002,80.8
33042, 서원구,070005, 69세,2021,2014,971,1043,93.1,2002,967,1035,93.4
33042, 서원구,075,70~74세,2021,7033,3189,3844,83,6984,3172,3812,83.2
33042, 서원구,075001, 70세,2021,1328,604,724,83.4,1317,600,717,83.7
33042, 서원구,075002, 71세,2021,1464,658,806,81.6,1453,654,799,81.9
33042, 서원구,075003, 72세,2021,1434,658,776,84.8,1421,653,768,85
33042, 서원구,075004, 73세,2021,1431,660,771,85.6,1423,657,766,85.8
33042, 서원구,075005, 74세,2021,1376,609,767,79.4,1370,608,762,79.8
33042, 서원구,080,75~79세,2021,5591,2437,3154,77.3,5572,2427,3145,77.2
33042, 서원구,080001, 75세,2021,1057,495,562,88.1,1050,491,559,87.8
33042, 서원구,080002, 76세,2021,1068,489,579,84.5,1066,487,579,84.1
33042, 서원구,080003, 77세,2021,1093,482,611,78.9,1090,481,609,79
33042, 서원구,080004, 78세,2021,1083,442,641,69,1079,440,639,68.9
33042, 서원구,080005, 79세,2021,1290,529,761,69.5,1287,528,759,69.6
33042, 서원구,085,80~84세,2021,4181,1580,2601,60.7,4167,1578,2589,61
33042, 서원구,085001, 80세,2021,977,365,612,59.6,971,365,606,60.2
33042, 서원구,085002, 81세,2021,874,338,536,63.1,872,337,535,63
33042, 서원구,085003, 82세,2021,848,317,531,59.7,846,317,529,59.9
33042, 서원구,085004, 83세,2021,755,285,470,60.6,754,285,469,60.8
33042, 서원구,085005, 84세,2021,727,275,452,60.8,724,274,450,60.9
33042, 서원구,090,85~89세,2021,2399,717,1682,42.6,2396,716,1680,42.6
33042, 서원구,090001, 85세,2021,643,218,425,51.3,642,218,424,51.4
33042, 서원구,090002, 86세,2021,601,190,411,46.2,600,189,411,46
33042, 서원구,090003, 87세,2021,456,123,333,36.9,456,123,333,36.9
33042, 서원구,090004, 88세,2021,385,112,273,41,384,112,272,41.2
33042, 서원구,090005, 89세,2021,314,74,240,30.8,314,74,240,30.8
33042, 서원구,095,90~94세,2021,774,160,614,26.1,773,160,613,26.1
33042, 서원구,095001, 90세,2021,219,38,181,21,218,38,180,21.1
33042, 서원구,095002, 91세,2021,180,46,134,34.3,180,46,134,34.3
33042, 서원구,095003, 92세,2021,160,32,128,25,160,32,128,25
33042, 서원구,095004, 93세,2021,106,27,79,34.2,106,27,79,34.2
33042, 서원구,095005, 94세,2021,109,17,92,18.5,109,17,92,18.5
33042, 서원구,100,95~99세,2021,169,24,145,16.6,169,24,145,16.6
33042, 서원구,100001, 95세,2021,52,8,44,18.2,52,8,44,18.2
33042, 서원구,100002, 96세,2021,49,7,42,16.7,49,7,42,16.7
33042, 서원구,100003, 97세,2021,28,X,25,12,28,X,25,12
33042, 서원구,100004, 98세,2021,22,X,18,22.2,22,X,18,22.2
33042, 서원구,100005, 99세,2021,18,X,16,12.5,18,X,16,12.5
33042, 서원구,101,100세이상,2021,24,X,22,9.1,24,X,22,9.1
33042, 서원구,102,15세미만,2021,22166,11369,10797,105.3,21807,11185,10622,105.3
33042, 서원구,103,15~64세,2021,142164,72132,70032,103,138137,70131,68006,103.1
33042, 서원구,104,65세이상,2021,31196,13399,17797,75.3,31003,13321,17682,75.3
33042, 서원구,086,85세이상,2021,3366,903,2463,36.7,3362,902,2460,36.7
33042, 서원구,126,평균연령,2021,43.1,41.8,44.4,,43.3,41.9,44.6,
33042, 서원구,127,중위연령,2021,44.7,42.9,46.4,,45,43.2,46.7,
33043, 흥덕구,000,합계,2021,273483,138633,134850,102.8,265367,134316,131051,102.5
33043, 흥덕구,005,0~4세,2021,10625,5412,5213,103.8,10350,5262,5088,103.4
33043, 흥덕구,005001, 0세,2021,1911,951,960,99.1,1862,926,936,98.9
33043, 흥덕구,005002, 1세,2021,1865,937,928,101,1810,908,902,100.7
33043, 흥덕구,005003, 2세,2021,2054,1044,1010,103.4,2000,1016,984,103.3
33043, 흥덕구,005004, 3세,2021,2330,1188,1142,104,2266,1155,1111,104
33043, 흥덕구,005005, 4세,2021,2465,1292,1173,110.1,2412,1257,1155,108.8
33043, 흥덕구,010,5~9세,2021,13258,6782,6476,104.7,13029,6673,6356,105
33043, 흥덕구,010001, 5세,2021,2548,1308,1240,105.5,2499,1289,1210,106.5
33043, 흥덕구,010002, 6세,2021,2672,1381,1291,107,2622,1358,1264,107.4
33043, 흥덕구,010003, 7세,2021,2598,1309,1289,101.6,2552,1285,1267,101.4
33043, 흥덕구,010004, 8세,2021,2662,1368,1294,105.7,2623,1351,1272,106.2
33043, 흥덕구,010005, 9세,2021,2778,1416,1362,104,2733,1390,1343,103.5
33043, 흥덕구,015,10~14세,2021,13314,6902,6412,107.6,13142,6807,6335,107.5
33043, 흥덕구,015001, 10세,2021,2779,1412,1367,103.3,2738,1388,1350,102.8
33043, 흥덕구,015002, 11세,2021,2661,1363,1298,105,2628,1344,1284,104.7
33043, 흥덕구,015003, 12세,2021,2598,1346,1252,107.5,2563,1326,1237,107.2
33043, 흥덕구,015004, 13세,2021,2603,1391,1212,114.8,2577,1380,1197,115.3
33043, 흥덕구,015005, 14세,2021,2673,1390,1283,108.3,2636,1369,1267,108.1
33043, 흥덕구,020,15~19세,2021,12971,6687,6284,106.4,12795,6597,6198,106.4
33043, 흥덕구,020001, 15세,2021,2470,1287,1183,108.8,2438,1267,1171,108.2
33043, 흥덕구,020002, 16세,2021,2392,1199,1193,100.5,2362,1186,1176,100.9
33043, 흥덕구,020003, 17세,2021,2663,1399,1264,110.7,2641,1387,1254,110.6
33043, 흥덕구,020004, 18세,2021,2708,1404,1304,107.7,2670,1390,1280,108.6
33043, 흥덕구,020005, 19세,2021,2738,1398,1340,104.3,2684,1367,1317,103.8
33043, 흥덕구,025,20~24세,2021,18421,9606,8815,109,17660,9206,8454,108.9
33043, 흥덕구,025001, 20세,2021,3352,1755,1597,109.9,3258,1708,1550,110.2
33043, 흥덕구,025002, 21세,2021,3658,1921,1737,110.6,3518,1848,1670,110.7
33043, 흥덕구,025003, 22세,2021,3616,1927,1689,114.1,3456,1835,1621,113.2
33043, 흥덕구,025004, 23세,2021,3696,1892,1804,104.9,3525,1800,1725,104.3
33043, 흥덕구,025005, 24세,2021,4099,2111,1988,106.2,3903,2015,1888,106.7
33043, 흥덕구,030,25~29세,2021,24195,13357,10838,123.2,23129,12773,10356,123.3
33043, 흥덕구,030001, 25세,2021,4474,2369,2105,112.5,4253,2251,2002,112.4
33043, 흥덕구,030002, 26세,2021,4768,2557,2211,115.6,4549,2432,2117,114.9
33043, 흥덕구,030003, 27세,2021,4930,2787,2143,130.1,4692,2651,2041,129.9
33043, 흥덕구,030004, 28세,2021,5060,2858,2202,129.8,4873,2747,2126,129.2
33043, 흥덕구,030005, 29세,2021,4963,2786,2177,128,4762,2692,2070,130
33043, 흥덕구,035,30~34세,2021,21474,11439,10035,114,20221,10752,9469,113.5
33043, 흥덕구,035001, 30세,2021,4566,2495,2071,120.5,4332,2370,1962,120.8
33043, 흥덕구,035002, 31세,2021,4325,2313,2012,115,4068,2182,1886,115.7
33043, 흥덕구,035003, 32세,2021,4214,2284,1930,118.3,3983,2150,1833,117.3
33043, 흥덕구,035004, 33세,2021,4265,2224,2041,109,4005,2064,1941,106.3
33043, 흥덕구,035005, 34세,2021,4104,2123,1981,107.2,3833,1986,1847,107.5
33043, 흥덕구,040,35~39세,2021,22120,11556,10564,109.4,21077,10976,10101,108.7
33043, 흥덕구,040001, 35세,2021,4140,2218,1922,115.4,3909,2087,1822,114.5
33043, 흥덕구,040002, 36세,2021,4008,2092,1916,109.2,3788,1980,1808,109.5
33043, 흥덕구,040003, 37세,2021,4318,2282,2036,112.1,4111,2168,1943,111.6
33043, 흥덕구,040004, 38세,2021,4637,2418,2219,109,4441,2307,2134,108.1
33043, 흥덕구,040005, 39세,2021,5017,2546,2471,103,4828,2434,2394,101.7
33043, 흥덕구,045,40~44세,2021,21752,11216,10536,106.5,20967,10762,10205,105.5
33043, 흥덕구,045001, 40세,2021,4447,2338,2109,110.9,4270,2242,2028,110.6
33043, 흥덕구,045002, 41세,2021,4615,2394,2221,107.8,4463,2301,2162,106.4
33043, 흥덕구,045003, 42세,2021,4490,2295,2195,104.6,4307,2182,2125,102.7
33043, 흥덕구,045004, 43세,2021,4078,2135,1943,109.9,3938,2053,1885,108.9
33043, 흥덕구,045005, 44세,2021,4122,2054,2068,99.3,3989,1984,2005,99
33043, 흥덕구,050,45~49세,2021,21905,10984,10921,100.6,21326,10677,10649,100.3
33043, 흥덕구,050001, 45세,2021,4011,2003,2008,99.8,3896,1942,1954,99.4
33043, 흥덕구,050002, 46세,2021,4299,2152,2147,100.2,4179,2088,2091,99.9
33043, 흥덕구,050003, 47세,2021,4616,2295,2321,98.9,4520,2241,2279,98.3
33043, 흥덕구,050004, 48세,2021,4671,2319,2352,98.6,4561,2262,2299,98.4
33043, 흥덕구,050005, 49세,2021,4308,2215,2093,105.8,4170,2144,2026,105.8
33043, 흥덕구,055,50~54세,2021,23462,11682,11780,99.2,22879,11370,11509,98.8
33043, 흥덕구,055001, 50세,2021,4764,2419,2345,103.2,4637,2354,2283,103.1
33043, 흥덕구,055002, 51세,2021,4709,2374,2335,101.7,4572,2293,2279,100.6
33043, 흥덕구,055003, 52세,2021,5050,2508,2542,98.7,4937,2448,2489,98.4
33043, 흥덕구,055004, 53세,2021,4760,2280,2480,91.9,4638,2220,2418,91.8
33043, 흥덕구,055005, 54세,2021,4179,2101,2078,101.1,4095,2055,2040,100.7
33043, 흥덕구,060,55~59세,2021,20114,10084,10030,100.5,19581,9836,9745,100.9
33043, 흥덕구,060001, 55세,2021,4152,2040,2112,96.6,4042,1993,2049,97.3
33043, 흥덕구,060002, 56세,2021,4299,2098,2201,95.3,4187,2036,2151,94.7
33043, 흥덕구,060003, 57세,2021,3750,1887,1863,101.3,3647,1841,1806,101.9
33043, 흥덕구,060004, 58세,2021,3876,2005,1871,107.2,3747,1946,1801,108.1
33043, 흥덕구,060005, 59세,2021,4037,2054,1983,103.6,3958,2020,1938,104.2
33043, 흥덕구,065,60~64세,2021,18501,9181,9320,98.5,18146,9017,9129,98.8
33043, 흥덕구,065001, 60세,2021,4469,2266,2203,102.9,4413,2242,2171,103.3
33043, 흥덕구,065002, 61세,2021,3922,1951,1971,99,3830,1904,1926,98.9
33043, 흥덕구,065003, 62세,2021,3564,1743,1821,95.7,3478,1703,1775,95.9
33043, 흥덕구,065004, 63세,2021,3334,1684,1650,102.1,3276,1662,1614,103
33043, 흥덕구,065005, 64세,2021,3212,1537,1675,91.8,3149,1506,1643,91.7
33043, 흥덕구,070,65~69세,2021,11914,5821,6093,95.5,11716,5728,5988,95.7
33043, 흥덕구,070001, 65세,2021,2816,1416,1400,101.1,2759,1387,1372,101.1
33043, 흥덕구,070002, 66세,2021,2762,1319,1443,91.4,2711,1299,1412,92
33043, 흥덕구,070003, 67세,2021,2295,1092,1203,90.8,2252,1072,1180,90.8
33043, 흥덕구,070004, 68세,2021,1929,983,946,103.9,1902,968,934,103.6
33043, 흥덕구,070005, 69세,2021,2112,1011,1101,91.8,2092,1002,1090,91.9
33043, 흥덕구,075,70~74세,2021,7145,3408,3737,91.2,7085,3380,3705,91.2
33043, 흥덕구,075001, 70세,2021,1434,666,768,86.7,1409,654,755,86.6
33043, 흥덕구,075002, 71세,2021,1449,699,750,93.2,1439,696,743,93.7
33043, 흥덕구,075003, 72세,2021,1513,741,772,96,1504,736,768,95.8
33043, 흥덕구,075004, 73세,2021,1432,700,732,95.6,1424,695,729,95.3
33043, 흥덕구,075005, 74세,2021,1317,602,715,84.2,1309,599,710,84.4
33043, 흥덕구,080,75~79세,2021,5307,2277,3030,75.1,5284,2266,3018,75.1
33043, 흥덕구,080001, 75세,2021,999,460,539,85.3,995,460,535,86
33043, 흥덕구,080002, 76세,2021,1068,495,573,86.4,1062,491,571,86
33043, 흥덕구,080003, 77세,2021,1005,409,596,68.6,1002,408,594,68.7
33043, 흥덕구,080004, 78세,2021,1089,428,661,64.8,1085,426,659,64.6
33043, 흥덕구,080005, 79세,2021,1146,485,661,73.4,1140,481,659,73
33043, 흥덕구,085,80~84세,2021,3869,1396,2473,56.4,3856,1394,2462,56.6
33043, 흥덕구,085001, 80세,2021,934,359,575,62.4,931,358,573,62.5
33043, 흥덕구,085002, 81세,2021,784,304,480,63.3,781,303,478,63.4
33043, 흥덕구,085003, 82세,2021,842,296,546,54.2,838,296,542,54.6
33043, 흥덕구,085004, 83세,2021,668,233,435,53.6,667,233,434,53.7
33043, 흥덕구,085005, 84세,2021,641,204,437,46.7,639,204,435,46.9
33043, 흥덕구,090,85~89세,2021,2294,677,1617,41.9,2284,675,1609,42
33043, 흥덕구,090001, 85세,2021,641,202,439,46,638,202,436,46.3
33043, 흥덕구,090002, 86세,2021,591,199,392,50.8,589,199,390,51
33043, 흥덕구,090003, 87세,2021,401,113,288,39.2,399,112,287,39
33043, 흥덕구,090004, 88세,2021,375,100,275,36.4,374,100,274,36.5
33043, 흥덕구,090005, 89세,2021,286,63,223,28.3,284,62,222,27.9
33043, 흥덕구,095,90~94세,2021,683,140,543,25.8,682,140,542,25.8
33043, 흥덕구,095001, 90세,2021,180,39,141,27.7,180,39,141,27.7
33043, 흥덕구,095002, 91세,2021,193,42,151,27.8,193,42,151,27.8
33043, 흥덕구,095003, 92세,2021,140,24,116,20.7,139,24,115,20.9
33043, 흥덕구,095004, 93세,2021,108,19,89,21.3,108,19,89,21.3
33043, 흥덕구,095005, 94세,2021,62,16,46,34.8,62,16,46,34.8
33043, 흥덕구,100,95~99세,2021,146,24,122,19.7,145,23,122,18.9
33043, 흥덕구,100001, 95세,2021,43,5,38,13.2,43,5,38,13.2
33043, 흥덕구,100002, 96세,2021,44,7,37,18.9,44,7,37,18.9
33043, 흥덕구,100003, 97세,2021,17,5,12,41.7,16,X,12,33.3
33043, 흥덕구,100004, 98세,2021,21,X,18,16.7,21,X,18,16.7
33043, 흥덕구,100005, 99세,2021,21,X,17,23.5,21,X,17,23.5
33043, 흥덕구,101,100세이상,2021,13,X,11,18.2,13,X,11,18.2
33043, 흥덕구,102,15세미만,2021,37197,19096,18101,105.5,36521,18742,17779,105.4
33043, 흥덕구,103,15~64세,2021,204915,105792,99123,106.7,197781,101966,95815,106.4
33043, 흥덕구,104,65세이상,2021,31371,13745,17626,78,31065,13608,17457,78
33043, 흥덕구,086,85세이상,2021,3136,843,2293,36.8,3124,840,2284,36.8
33043, 흥덕구,126,평균연령,2021,40.1,39.1,41.1,,40.2,39.2,41.2,
33043, 흥덕구,127,중위연령,2021,40.1,39,41.3,,40.3,39.2,41.5,
33044, 청원구,000,합계,2021,198303,101842,96461,105.6,192720,98717,94003,105
33044, 청원구,005,0~4세,2021,8158,4214,3944,106.8,8055,4161,3894,106.9
33044, 청원구,005001, 0세,2021,1391,714,677,105.5,1377,709,668,106.1
33044, 청원구,005002, 1세,2021,1480,797,683,116.7,1460,783,677,115.7
33044, 청원구,005003, 2세,2021,1572,822,750,109.6,1552,815,737,110.6
33044, 청원구,005004, 3세,2021,1834,923,911,101.3,1802,906,896,101.1
33044, 청원구,005005, 4세,2021,1881,958,923,103.8,1864,948,916,103.5
33044, 청원구,010,5~9세,2021,11003,5587,5416,103.2,10904,5540,5364,103.3
33044, 청원구,010001, 5세,2021,2214,1125,1089,103.3,2194,1116,1078,103.5
33044, 청원구,010002, 6세,2021,2200,1120,1080,103.7,2171,1106,1065,103.8
33044, 청원구,010003, 7세,2021,2114,1060,1054,100.6,2091,1049,1042,100.7
33044, 청원구,010004, 8세,2021,2153,1091,1062,102.7,2142,1087,1055,103
33044, 청원구,010005, 9세,2021,2322,1191,1131,105.3,2306,1182,1124,105.2
33044, 청원구,015,10~14세,2021,10277,5217,5060,103.1,10237,5202,5035,103.3
33044, 청원구,015001, 10세,2021,2178,1113,1065,104.5,2164,1108,1056,104.9
33044, 청원구,015002, 11세,2021,2029,1018,1011,100.7,2021,1015,1006,100.9
33044, 청원구,015003, 12세,2021,1992,1049,943,111.2,1986,1046,940,111.3
33044, 청원구,015004, 13세,2021,1997,1006,991,101.5,1993,1003,990,101.3
33044, 청원구,015005, 14세,2021,2081,1031,1050,98.2,2073,1030,1043,98.8
33044, 청원구,020,15~19세,2021,9533,4965,4568,108.7,9489,4942,4547,108.7
33044, 청원구,020001, 15세,2021,1805,943,862,109.4,1804,943,861,109.5
33044, 청원구,020002, 16세,2021,1727,918,809,113.5,1723,917,806,113.8
33044, 청원구,020003, 17세,2021,1806,941,865,108.8,1802,939,863,108.8
33044, 청원구,020004, 18세,2021,1889,976,913,106.9,1884,973,911,106.8
33044, 청원구,020005, 19세,2021,2306,1187,1119,106.1,2276,1170,1106,105.8
33044, 청원구,025,20~24세,2021,13238,6998,6240,112.1,12569,6644,5925,112.1
33044, 청원구,025001, 20세,2021,2512,1220,1292,94.4,2460,1194,1266,94.3
33044, 청원구,025002, 21세,2021,2705,1336,1369,97.6,2571,1267,1304,97.2
33044, 청원구,025003, 22세,2021,2634,1406,1228,114.5,2461,1330,1131,117.6
33044, 청원구,025004, 23세,2021,2646,1488,1158,128.5,2481,1397,1084,128.9
33044, 청원구,025005, 24세,2021,2741,1548,1193,129.8,2596,1456,1140,127.7
33044, 청원구,030,25~29세,2021,15164,8843,6321,139.9,14278,8311,5967,139.3
33044, 청원구,030001, 25세,2021,2775,1612,1163,138.6,2607,1502,1105,135.9
33044, 청원구,030002, 26세,2021,3039,1739,1300,133.8,2849,1628,1221,133.3
33044, 청원구,030003, 27세,2021,3069,1801,1268,142,2883,1699,1184,143.5
33044, 청원구,030004, 28세,2021,3163,1848,1315,140.5,2987,1739,1248,139.3
33044, 청원구,030005, 29세,2021,3118,1843,1275,144.5,2952,1743,1209,144.2
33044, 청원구,035,30~34세,2021,14991,8378,6613,126.7,14055,7827,6228,125.7
33044, 청원구,035001, 30세,2021,3051,1725,1326,130.1,2865,1617,1248,129.6
33044, 청원구,035002, 31세,2021,2943,1708,1235,138.3,2755,1591,1164,136.7
33044, 청원구,035003, 32세,2021,2975,1653,1322,125,2802,1551,1251,124
33044, 청원구,035004, 33세,2021,2959,1628,1331,122.3,2769,1526,1243,122.8
33044, 청원구,035005, 34세,2021,3063,1664,1399,118.9,2864,1542,1322,116.6
33044, 청원구,040,35~39세,2021,16935,8940,7995,111.8,16155,8484,7671,110.6
33044, 청원구,040001, 35세,2021,3062,1663,1399,118.9,2901,1573,1328,118.4
33044, 청원구,040002, 36세,2021,3151,1632,1519,107.4,2988,1539,1449,106.2
33044, 청원구,040003, 37세,2021,3370,1817,1553,117,3207,1726,1481,116.5
33044, 청원구,040004, 38세,2021,3479,1834,1645,111.5,3313,1727,1586,108.9
33044, 청원구,040005, 39세,2021,3873,1994,1879,106.1,3746,1919,1827,105
33044, 청원구,045,40~44세,2021,16839,9003,7836,114.9,16344,8718,7626,114.3
33044, 청원구,045001, 40세,2021,3503,1878,1625,115.6,3381,1800,1581,113.9
33044, 청원구,045002, 41세,2021,3777,2018,1759,114.7,3671,1962,1709,114.8
33044, 청원구,045003, 42세,2021,3393,1838,1555,118.2,3294,1778,1516,117.3
33044, 청원구,045004, 43세,2021,3069,1640,1429,114.8,2986,1598,1388,115.1
33044, 청원구,045005, 44세,2021,3097,1629,1468,111,3012,1580,1432,110.3
33044, 청원구,050,45~49세,2021,15386,7994,7392,108.1,14982,7760,7222,107.4
33044, 청원구,050001, 45세,2021,3030,1586,1444,109.8,2949,1536,1413,108.7
33044, 청원구,050002, 46세,2021,3064,1557,1507,103.3,2980,1506,1474,102.2
33044, 청원구,050003, 47세,2021,3294,1760,1534,114.7,3220,1712,1508,113.5
33044, 청원구,050004, 48세,2021,3130,1628,1502,108.4,3049,1590,1459,109
33044, 청원구,050005, 49세,2021,2868,1463,1405,104.1,2784,1416,1368,103.5
33044, 청원구,055,50~54세,2021,14921,7653,7268,105.3,14543,7435,7108,104.6
33044, 청원구,055001, 50세,2021,3094,1606,1488,107.9,3005,1550,1455,106.5
33044, 청원구,055002, 51세,2021,2878,1491,1387,107.5,2790,1439,1351,106.5
33044, 청원구,055003, 52세,2021,3196,1674,1522,110,3114,1624,1490,109
33044, 청원구,055004, 53세,2021,3023,1484,1539,96.4,2967,1457,1510,96.5
33044, 청원구,055005, 54세,2021,2730,1398,1332,105,2667,1365,1302,104.8
33044, 청원구,060,55~59세,2021,12849,6588,6261,105.2,12509,6416,6093,105.3
33044, 청원구,060001, 55세,2021,2661,1363,1298,105,2586,1328,1258,105.6
33044, 청원구,060002, 56세,2021,2760,1395,1365,102.2,2669,1341,1328,101
33044, 청원구,060003, 57세,2021,2270,1168,1102,106,2223,1146,1077,106.4
33044, 청원구,060004, 58세,2021,2453,1274,1179,108.1,2378,1233,1145,107.7
33044, 청원구,060005, 59세,2021,2705,1388,1317,105.4,2653,1368,1285,106.5
33044, 청원구,065,60~64세,2021,12954,6383,6571,97.1,12730,6282,6448,97.4
33044, 청원구,065001, 60세,2021,3051,1489,1562,95.3,3012,1470,1542,95.3
33044, 청원구,065002, 61세,2021,2672,1320,1352,97.6,2611,1294,1317,98.3
33044, 청원구,065003, 62세,2021,2588,1280,1308,97.9,2549,1264,1285,98.4
33044, 청원구,065004, 63세,2021,2362,1180,1182,99.8,2321,1158,1163,99.6
33044, 청원구,065005, 64세,2021,2281,1114,1167,95.5,2237,1096,1141,96.1
33044, 청원구,070,65~69세,2021,9025,4363,4662,93.6,8915,4307,4608,93.5
33044, 청원구,070001, 65세,2021,2115,1036,1079,96,2087,1020,1067,95.6
33044, 청원구,070002, 66세,2021,2098,1005,1093,91.9,2072,990,1082,91.5
33044, 청원구,070003, 67세,2021,1727,804,923,87.1,1707,796,911,87.4
33044, 청원구,070004, 68세,2021,1504,725,779,93.1,1488,716,772,92.7
33044, 청원구,070005, 69세,2021,1581,793,788,100.6,1561,785,776,101.2
33044, 청원구,075,70~74세,2021,5670,2682,2988,89.8,5626,2662,2964,89.8
33044, 청원구,075001, 70세,2021,1082,518,564,91.8,1070,511,559,91.4
33044, 청원구,075002, 71세,2021,1139,543,596,91.1,1129,540,589,91.7
33044, 청원구,075003, 72세,2021,1152,559,593,94.3,1144,556,588,94.6
33044, 청원구,075004, 73세,2021,1179,550,629,87.4,1170,545,625,87.2
33044, 청원구,075005, 74세,2021,1118,512,606,84.5,1113,510,603,84.6
33044, 청원구,080,75~79세,2021,4748,1980,2768,71.5,4732,1974,2758,71.6
33044, 청원구,080001, 75세,2021,893,396,497,79.7,887,395,492,80.3
33044, 청원구,080002, 76세,2021,898,388,510,76.1,895,387,508,76.2
33044, 청원구,080003, 77세,2021,898,354,544,65.1,893,352,541,65.1
33044, 청원구,080004, 78세,2021,936,399,537,74.3,935,398,537,74.1
33044, 청원구,080005, 79세,2021,1123,443,680,65.1,1122,442,680,65
33044, 청원구,085,80~84세,2021,3718,1358,2360,57.5,3709,1357,2352,57.7
33044, 청원구,085001, 80세,2021,824,323,501,64.5,820,322,498,64.7
33044, 청원구,085002, 81세,2021,766,290,476,60.9,765,290,475,61.1
33044, 청원구,085003, 82세,2021,790,285,505,56.4,789,285,504,56.5
33044, 청원구,085004, 83세,2021,725,245,480,51,722,245,477,51.4
33044, 청원구,085005, 84세,2021,613,215,398,54,613,215,398,54
33044, 청원구,090,85~89세,2021,2057,536,1521,35.2,2051,535,1516,35.3
33044, 청원구,090001, 85세,2021,557,146,411,35.5,554,146,408,35.8
33044, 청원구,090002, 86세,2021,466,122,344,35.5,464,122,342,35.7
33044, 청원구,090003, 87세,2021,408,106,302,35.1,407,105,302,34.8
33044, 청원구,090004, 88세,2021,339,80,259,30.9,339,80,259,30.9
33044, 청원구,090005, 89세,2021,287,82,205,40,287,82,205,40
33044, 청원구,095,90~94세,2021,676,135,541,25,676,135,541,25
33044, 청원구,095001, 90세,2021,195,53,142,37.3,195,53,142,37.3
33044, 청원구,095002, 91세,2021,174,33,141,23.4,174,33,141,23.4
33044, 청원구,095003, 92세,2021,130,19,111,17.1,130,19,111,17.1
33044, 청원구,095004, 93세,2021,107,18,89,20.2,107,18,89,20.2
33044, 청원구,095005, 94세,2021,70,12,58,20.7,70,12,58,20.7
33044, 청원구,100,95~99세,2021,136,21,115,18.3,136,21,115,18.3
33044, 청원구,100001, 95세,2021,45,7,38,18.4,45,7,38,18.4
33044, 청원구,100002, 96세,2021,34,X,30,13.3,34,X,30,13.3
33044, 청원구,100003, 97세,2021,25,7,18,38.9,25,7,18,38.9
33044, 청원구,100004, 98세,2021,20,X,18,11.1,20,X,18,11.1
33044, 청원구,100005, 99세,2021,12,X,11,9.1,12,X,11,9.1
33044, 청원구,101,100세이상,2021,25,X,21,19,25,X,21,19
33044, 청원구,102,15세미만,2021,29438,15018,14420,104.1,29196,14903,14293,104.3
33044, 청원구,103,15~64세,2021,142810,75745,67065,112.9,137654,72819,64835,112.3
33044, 청원구,104,65세이상,2021,26055,11079,14976,74,25870,10995,14875,73.9
33044, 청원구,086,85세이상,2021,2894,696,2198,31.7,2888,695,2193,31.7
33044, 청원구,126,평균연령,2021,40.2,39,41.4,,40.3,39.1,41.5,
33044, 청원구,127,중위연령,2021,40,38.9,41.3,,40.2,39.1,41.5,
33320, 보은군,000,합계,2021,30929,15543,15386,101,30214,15192,15022,101.1
33320, 보은군,005,0~4세,2021,549,275,274,100.4,545,274,271,101.1
33320, 보은군,005001, 0세,2021,82,37,45,82.2,80,36,44,81.8
33320, 보은군,005002, 1세,2021,102,55,47,117,101,55,46,119.6
33320, 보은군,005003, 2세,2021,107,53,54,98.1,107,53,54,98.1
33320, 보은군,005004, 3세,2021,134,67,67,100,134,67,67,100
33320, 보은군,005005, 4세,2021,124,63,61,103.3,123,63,60,105
33320, 보은군,010,5~9세,2021,782,404,378,106.9,775,404,371,108.9
33320, 보은군,010001, 5세,2021,153,91,62,146.8,150,91,59,154.2
33320, 보은군,010002, 6세,2021,147,73,74,98.6,146,73,73,100
33320, 보은군,010003, 7세,2021,152,79,73,108.2,150,79,71,111.3
33320, 보은군,010004, 8세,2021,158,72,86,83.7,157,72,85,84.7
33320, 보은군,010005, 9세,2021,172,89,83,107.2,172,89,83,107.2
33320, 보은군,015,10~14세,2021,949,517,432,119.7,947,517,430,120.2
33320, 보은군,015001, 10세,2021,202,107,95,112.6,202,107,95,112.6
33320, 보은군,015002, 11세,2021,194,114,80,142.5,194,114,80,142.5
33320, 보은군,015003, 12세,2021,185,92,93,98.9,184,92,92,100
33320, 보은군,015004, 13세,2021,170,92,78,117.9,170,92,78,117.9
33320, 보은군,015005, 14세,2021,198,112,86,130.2,197,112,85,131.8
33320, 보은군,020,15~19세,2021,968,528,440,120,966,526,440,119.5
33320, 보은군,020001, 15세,2021,163,91,72,126.4,162,90,72,125
33320, 보은군,020002, 16세,2021,209,129,80,161.3,209,129,80,161.3
33320, 보은군,020003, 17세,2021,236,116,120,96.7,236,116,120,96.7
33320, 보은군,020004, 18세,2021,206,104,102,102,206,104,102,102
33320, 보은군,020005, 19세,2021,154,88,66,133.3,153,87,66,131.8
33320, 보은군,025,20~24세,2021,1078,678,400,169.5,1025,652,373,174.8
33320, 보은군,025001, 20세,2021,203,144,59,244.1,199,143,56,255.4
33320, 보은군,025002, 21세,2021,229,148,81,182.7,226,147,79,186.1
33320, 보은군,025003, 22세,2021,215,132,83,159,206,126,80,157.5
33320, 보은군,025004, 23세,2021,225,127,98,129.6,211,120,91,131.9
33320, 보은군,025005, 24세,2021,206,127,79,160.8,183,116,67,173.1
33320, 보은군,030,25~29세,2021,1073,638,435,146.7,946,565,381,148.3
33320, 보은군,030001, 25세,2021,232,149,83,179.5,205,125,80,156.3
33320, 보은군,030002, 26세,2021,204,109,95,114.7,174,102,72,141.7
33320, 보은군,030003, 27세,2021,198,116,82,141.5,176,99,77,128.6
33320, 보은군,030004, 28세,2021,219,130,89,146.1,198,118,80,147.5
33320, 보은군,030005, 29세,2021,220,134,86,155.8,193,121,72,168.1
33320, 보은군,035,30~34세,2021,950,537,413,130,841,484,357,135.6
33320, 보은군,035001, 30세,2021,190,112,78,143.6,161,93,68,136.8
33320, 보은군,035002, 31세,2021,178,100,78,128.2,158,92,66,139.4
33320, 보은군,035003, 32세,2021,182,100,82,122,159,92,67,137.3
33320, 보은군,035004, 33세,2021,182,105,77,136.4,165,95,70,135.7
33320, 보은군,035005, 34세,2021,218,120,98,122.4,198,112,86,130.2
33320, 보은군,040,35~39세,2021,1197,640,557,114.9,1084,577,507,113.8
33320, 보은군,040001, 35세,2021,219,123,96,128.1,193,107,86,124.4
33320, 보은군,040002, 36세,2021,230,124,106,117,212,113,99,114.1
33320, 보은군,040003, 37세,2021,197,103,94,109.6,183,98,85,115.3
33320, 보은군,040004, 38세,2021,250,136,114,119.3,223,116,107,108.4
33320, 보은군,040005, 39세,2021,301,154,147,104.8,273,143,130,110
33320, 보은군,045,40~44세,2021,1336,733,603,121.6,1261,701,560,125.2
33320, 보은군,045001, 40세,2021,298,162,136,119.1,277,153,124,123.4
33320, 보은군,045002, 41세,2021,264,149,115,129.6,248,141,107,131.8
33320, 보은군,045003, 42세,2021,289,160,129,124,277,157,120,130.8
33320, 보은군,045004, 43세,2021,239,134,105,127.6,224,126,98,128.6
33320, 보은군,045005, 44세,2021,246,128,118,108.5,235,124,111,111.7
33320, 보은군,050,45~49세,2021,1704,927,777,119.3,1663,911,752,121.1
33320, 보은군,050001, 45세,2021,278,158,120,131.7,272,155,117,132.5
33320, 보은군,050002, 46세,2021,303,153,150,102,288,148,140,105.7
33320, 보은군,050003, 47세,2021,376,206,170,121.2,369,203,166,122.3
33320, 보은군,050004, 48세,2021,367,197,170,115.9,360,194,166,116.9
33320, 보은군,050005, 49세,2021,380,213,167,127.5,374,211,163,129.4
33320, 보은군,055,50~54세,2021,2401,1300,1101,118.1,2350,1276,1074,118.8
33320, 보은군,055001, 50세,2021,457,259,198,130.8,446,254,192,132.3
33320, 보은군,055002, 51세,2021,421,221,200,110.5,411,216,195,110.8
33320, 보은군,055003, 52세,2021,482,260,222,117.1,469,256,213,120.2
33320, 보은군,055004, 53세,2021,511,266,245,108.6,503,260,243,107
33320, 보은군,055005, 54세,2021,530,294,236,124.6,521,290,231,125.5
33320, 보은군,060,55~59세,2021,3013,1639,1374,119.3,2951,1610,1341,120.1
33320, 보은군,060001, 55세,2021,575,325,250,130,558,318,240,132.5
33320, 보은군,060002, 56세,2021,606,323,283,114.1,593,317,276,114.9
33320, 보은군,060003, 57세,2021,518,270,248,108.9,508,264,244,108.2
33320, 보은군,060004, 58세,2021,591,324,267,121.3,580,318,262,121.4
33320, 보은군,060005, 59세,2021,723,397,326,121.8,712,393,319,123.2
33320, 보은군,065,60~64세,2021,3849,2000,1849,108.2,3810,1982,1828,108.4
33320, 보은군,065001, 60세,2021,879,465,414,112.3,869,462,407,113.5
33320, 보은군,065002, 61세,2021,760,379,381,99.5,749,374,375,99.7
33320, 보은군,065003, 62세,2021,724,375,349,107.4,716,371,345,107.5
33320, 보은군,065004, 63세,2021,746,400,346,115.6,741,397,344,115.4
33320, 보은군,065005, 64세,2021,740,381,359,106.1,735,378,357,105.9
33320, 보은군,070,65~69세,2021,3164,1585,1579,100.4,3148,1577,1571,100.4
33320, 보은군,070001, 65세,2021,726,376,350,107.4,723,374,349,107.2
33320, 보은군,070002, 66세,2021,707,349,358,97.5,702,346,356,97.2
33320, 보은군,070003, 67세,2021,635,323,312,103.5,634,323,311,103.9
33320, 보은군,070004, 68세,2021,535,262,273,96,530,259,271,95.6
33320, 보은군,070005, 69세,2021,561,275,286,96.2,559,275,284,96.8
33320, 보은군,075,70~74세,2021,2285,1137,1148,99,2276,1131,1145,98.8
33320, 보은군,075001, 70세,2021,424,216,208,103.8,423,215,208,103.4
33320, 보은군,075002, 71세,2021,463,225,238,94.5,461,223,238,93.7
33320, 보은군,075003, 72세,2021,503,261,242,107.9,501,259,242,107
33320, 보은군,075004, 73세,2021,449,227,222,102.3,446,226,220,102.7
33320, 보은군,075005, 74세,2021,446,208,238,87.4,445,208,237,87.8
33320, 보은군,080,75~79세,2021,2037,842,1195,70.5,2035,842,1193,70.6
33320, 보은군,080001, 75세,2021,360,164,196,83.7,360,164,196,83.7
33320, 보은군,080002, 76세,2021,351,161,190,84.7,351,161,190,84.7
33320, 보은군,080003, 77세,2021,371,157,214,73.4,370,157,213,73.7
33320, 보은군,080004, 78세,2021,438,173,265,65.3,437,173,264,65.5
33320, 보은군,080005, 79세,2021,517,187,330,56.7,517,187,330,56.7
33320, 보은군,085,80~84세,2021,1946,707,1239,57.1,1944,707,1237,57.2
33320, 보은군,085001, 80세,2021,431,147,284,51.8,431,147,284,51.8
33320, 보은군,085002, 81세,2021,407,151,256,59,406,151,255,59.2
33320, 보은군,085003, 82세,2021,410,158,252,62.7,410,158,252,62.7
33320, 보은군,085004, 83세,2021,355,137,218,62.8,354,137,217,63.1
33320, 보은군,085005, 84세,2021,343,114,229,49.8,343,114,229,49.8
33320, 보은군,090,85~89세,2021,1168,347,821,42.3,1167,347,820,42.3
33320, 보은군,090001, 85세,2021,304,86,218,39.4,304,86,218,39.4
33320, 보은군,090002, 86세,2021,289,98,191,51.3,288,98,190,51.6
33320, 보은군,090003, 87세,2021,235,67,168,39.9,235,67,168,39.9
33320, 보은군,090004, 88세,2021,184,49,135,36.3,184,49,135,36.3
33320, 보은군,090005, 89세,2021,156,47,109,43.1,156,47,109,43.1
33320, 보은군,095,90~94세,2021,397,91,306,29.7,397,91,306,29.7
33320, 보은군,095001, 90세,2021,103,28,75,37.3,103,28,75,37.3
33320, 보은군,095002, 91세,2021,103,22,81,27.2,103,22,81,27.2
33320, 보은군,095003, 92세,2021,83,18,65,27.7,83,18,65,27.7
33320, 보은군,095004, 93세,2021,50,11,39,28.2,50,11,39,28.2
33320, 보은군,095005, 94세,2021,58,12,46,26.1,58,12,46,26.1
33320, 보은군,100,95~99세,2021,72,18,54,33.3,72,18,54,33.3
33320, 보은군,100001, 95세,2021,27,9,18,50,27,9,18,50
33320, 보은군,100002, 96세,2021,20,X,16,25,20,X,16,25
33320, 보은군,100003, 97세,2021,15,X,12,25,15,X,12,25
33320, 보은군,100004, 98세,2021,7,X,6,16.7,7,X,6,16.7
33320, 보은군,100005, 99세,2021,X,X,X,50,X,X,X,50
33320, 보은군,101,100세이상,2021,11,X,11,0,11,X,11,0
33320, 보은군,102,15세미만,2021,2280,1196,1084,110.3,2267,1195,1072,111.5
33320, 보은군,103,15~64세,2021,17569,9620,7949,121,16897,9284,7613,121.9
33320, 보은군,104,65세이상,2021,11080,4727,6353,74.4,11050,4713,6337,74.4
33320, 보은군,086,85세이상,2021,1648,456,1192,38.3,1647,456,1191,38.3
33320, 보은군,126,평균연령,2021,54.6,52.1,57.1,,54.9,52.4,57.5,
33320, 보은군,127,중위연령,2021,59.3,56.8,61.2,,59.7,57.3,61.7,
33330, 옥천군,000,합계,2021,48507,24362,24145,100.9,47569,23822,23747,100.3
33330, 옥천군,005,0~4세,2021,913,480,433,110.9,906,476,430,110.7
33330, 옥천군,005001, 0세,2021,158,88,70,125.7,156,86,70,122.9
33330, 옥천군,005002, 1세,2021,171,90,81,111.1,170,90,80,112.5
33330, 옥천군,005003, 2세,2021,167,89,78,114.1,165,88,77,114.3
33330, 옥천군,005004, 3세,2021,192,105,87,120.7,191,105,86,122.1
33330, 옥천군,005005, 4세,2021,225,108,117,92.3,224,107,117,91.5
33330, 옥천군,010,5~9세,2021,1480,758,722,105,1478,757,721,105
33330, 옥천군,010001, 5세,2021,258,140,118,118.6,258,140,118,118.6
33330, 옥천군,010002, 6세,2021,272,146,126,115.9,272,146,126,115.9
33330, 옥천군,010003, 7세,2021,297,145,152,95.4,297,145,152,95.4
33330, 옥천군,010004, 8세,2021,299,158,141,112.1,299,158,141,112.1
33330, 옥천군,010005, 9세,2021,354,169,185,91.4,352,168,184,91.3
33330, 옥천군,015,10~14세,2021,1844,969,875,110.7,1840,967,873,110.8
33330, 옥천군,015001, 10세,2021,390,214,176,121.6,389,214,175,122.3
33330, 옥천군,015002, 11세,2021,362,193,169,114.2,362,193,169,114.2
33330, 옥천군,015003, 12세,2021,339,174,165,105.5,339,174,165,105.5
33330, 옥천군,015004, 13세,2021,369,184,185,99.5,366,182,184,98.9
33330, 옥천군,015005, 14세,2021,384,204,180,113.3,384,204,180,113.3
33330, 옥천군,020,15~19세,2021,1694,935,759,123.2,1688,933,755,123.6
33330, 옥천군,020001, 15세,2021,355,190,165,115.2,355,190,165,115.2
33330, 옥천군,020002, 16세,2021,337,182,155,117.4,337,182,155,117.4
33330, 옥천군,020003, 17세,2021,359,186,173,107.5,357,185,172,107.6
33330, 옥천군,020004, 18세,2021,327,181,146,124,325,181,144,125.7
33330, 옥천군,020005, 19세,2021,316,196,120,163.3,314,195,119,163.9
33330, 옥천군,025,20~24세,2021,2070,1257,813,154.6,1994,1212,782,155
33330, 옥천군,025001, 20세,2021,414,262,152,172.4,411,261,150,174
33330, 옥천군,025002, 21세,2021,402,257,145,177.2,393,252,141,178.7
33330, 옥천군,025003, 22세,2021,395,238,157,151.6,388,234,154,151.9
33330, 옥천군,025004, 23세,2021,409,232,177,131.1,382,218,164,132.9
33330, 옥천군,025005, 24세,2021,450,268,182,147.3,420,247,173,142.8
33330, 옥천군,030,25~29세,2021,1923,1088,835,130.3,1768,987,781,126.4
33330, 옥천군,030001, 25세,2021,436,251,185,135.7,408,234,174,134.5
33330, 옥천군,030002, 26세,2021,414,237,177,133.9,385,217,168,129.2
33330, 옥천군,030003, 27세,2021,358,203,155,131,327,180,147,122.4
33330, 옥천군,030004, 28세,2021,353,203,150,135.3,326,184,142,129.6
33330, 옥천군,030005, 29세,2021,362,194,168,115.5,322,172,150,114.7
33330, 옥천군,035,30~34세,2021,1672,914,758,120.6,1505,819,686,119.4
33330, 옥천군,035001, 30세,2021,331,195,136,143.4,307,179,128,139.8
33330, 옥천군,035002, 31세,2021,359,204,155,131.6,314,176,138,127.5
33330, 옥천군,035003, 32세,2021,311,171,140,122.1,294,162,132,122.7
33330, 옥천군,035004, 33세,2021,332,168,164,102.4,289,147,142,103.5
33330, 옥천군,035005, 34세,2021,339,176,163,108,301,155,146,106.2
33330, 옥천군,040,35~39세,2021,2145,1110,1035,107.2,1999,1014,985,102.9
33330, 옥천군,040001, 35세,2021,362,196,166,118.1,331,174,157,110.8
33330, 옥천군,040002, 36세,2021,372,190,182,104.4,344,171,173,98.8
33330, 옥천군,040003, 37세,2021,401,202,199,101.5,372,183,189,96.8
33330, 옥천군,040004, 38세,2021,470,247,223,110.8,442,227,215,105.6
33330, 옥천군,040005, 39세,2021,540,275,265,103.8,510,259,251,103.2
33330, 옥천군,045,40~44세,2021,2660,1405,1255,112,2558,1348,1210,111.4
33330, 옥천군,045001, 40세,2021,516,268,248,108.1,491,254,237,107.2
33330, 옥천군,045002, 41세,2021,547,276,271,101.8,527,262,265,98.9
33330, 옥천군,045003, 42세,2021,528,295,233,126.6,512,286,226,126.5
33330, 옥천군,045004, 43세,2021,547,285,262,108.8,526,275,251,109.6
33330, 옥천군,045005, 44세,2021,522,281,241,116.6,502,271,231,117.3
33330, 옥천군,050,45~49세,2021,3214,1728,1486,116.3,3142,1690,1452,116.4
33330, 옥천군,050001, 45세,2021,548,301,247,121.9,533,292,241,121.2
33330, 옥천군,050002, 46세,2021,612,327,285,114.7,596,319,277,115.2
33330, 옥천군,050003, 47세,2021,668,342,326,104.9,658,339,319,106.3
33330, 옥천군,050004, 48세,2021,742,413,329,125.5,720,397,323,122.9
33330, 옥천군,050005, 49세,2021,644,345,299,115.4,635,343,292,117.5
33330, 옥천군,055,50~54세,2021,4142,2137,2005,106.6,4078,2111,1967,107.3
33330, 옥천군,055001, 50세,2021,783,408,375,108.8,774,403,371,108.6
33330, 옥천군,055002, 51세,2021,743,417,326,127.9,730,411,319,128.8
33330, 옥천군,055003, 52세,2021,908,455,453,100.4,892,449,443,101.4
33330, 옥천군,055004, 53세,2021,883,432,451,95.8,872,430,442,97.3
33330, 옥천군,055005, 54세,2021,825,425,400,106.3,810,418,392,106.6
33330, 옥천군,060,55~59세,2021,4458,2389,2069,115.5,4397,2355,2042,115.3
33330, 옥천군,060001, 55세,2021,834,443,391,113.3,820,437,383,114.1
33330, 옥천군,060002, 56세,2021,868,457,411,111.2,859,450,409,110
33330, 옥천군,060003, 57세,2021,829,436,393,110.9,814,428,386,110.9
33330, 옥천군,060004, 58세,2021,905,502,403,124.6,892,495,397,124.7
33330, 옥천군,060005, 59세,2021,1022,551,471,117,1012,545,467,116.7
33330, 옥천군,065,60~64세,2021,5430,2735,2695,101.5,5397,2717,2680,101.4
33330, 옥천군,065001, 60세,2021,1210,595,615,96.7,1201,593,608,97.5
33330, 옥천군,065002, 61세,2021,1136,546,590,92.5,1127,540,587,92
33330, 옥천군,065003, 62세,2021,1022,527,495,106.5,1017,523,494,105.9
33330, 옥천군,065004, 63세,2021,962,491,471,104.2,957,487,470,103.6
33330, 옥천군,065005, 64세,2021,1100,576,524,109.9,1095,574,521,110.2
33330, 옥천군,070,65~69세,2021,4539,2236,2303,97.1,4516,2224,2292,97
33330, 옥천군,070001, 65세,2021,980,482,498,96.8,972,478,494,96.8
33330, 옥천군,070002, 66세,2021,988,484,504,96,982,480,502,95.6
33330, 옥천군,070003, 67세,2021,889,450,439,102.5,886,448,438,102.3
33330, 옥천군,070004, 68세,2021,790,394,396,99.5,789,393,396,99.2
33330, 옥천군,070005, 69세,2021,892,426,466,91.4,887,425,462,92
33330, 옥천군,075,70~74세,2021,3343,1675,1668,100.4,3328,1669,1659,100.6
33330, 옥천군,075001, 70세,2021,657,321,336,95.5,654,320,334,95.8
33330, 옥천군,075002, 71세,2021,729,394,335,117.6,725,392,333,117.7
33330, 옥천군,075003, 72세,2021,703,366,337,108.6,703,366,337,108.6
33330, 옥천군,075004, 73세,2021,609,296,313,94.6,605,295,310,95.2
33330, 옥천군,075005, 74세,2021,645,298,347,85.9,641,296,345,85.8
33330, 옥천군,080,75~79세,2021,2761,1153,1608,71.7,2757,1150,1607,71.6
33330, 옥천군,080001, 75세,2021,457,202,255,79.2,457,202,255,79.2
33330, 옥천군,080002, 76세,2021,460,215,245,87.8,458,214,244,87.7
33330, 옥천군,080003, 77세,2021,504,203,301,67.4,502,201,301,66.8
33330, 옥천군,080004, 78세,2021,572,231,341,67.7,572,231,341,67.7
33330, 옥천군,080005, 79세,2021,768,302,466,64.8,768,302,466,64.8
33330, 옥천군,085,80~84세,2021,2231,824,1407,58.6,2230,824,1406,58.6
33330, 옥천군,085001, 80세,2021,522,206,316,65.2,522,206,316,65.2
33330, 옥천군,085002, 81세,2021,437,166,271,61.3,436,166,270,61.5
33330, 옥천군,085003, 82세,2021,496,173,323,53.6,496,173,323,53.6
33330, 옥천군,085004, 83세,2021,403,141,262,53.8,403,141,262,53.8
33330, 옥천군,085005, 84세,2021,373,138,235,58.7,373,138,235,58.7
33330, 옥천군,090,85~89세,2021,1433,433,1000,43.3,1433,433,1000,43.3
33330, 옥천군,090001, 85세,2021,359,118,241,49,359,118,241,49
33330, 옥천군,090002, 86세,2021,362,116,246,47.2,362,116,246,47.2
33330, 옥천군,090003, 87세,2021,295,81,214,37.9,295,81,214,37.9
33330, 옥천군,090004, 88세,2021,238,64,174,36.8,238,64,174,36.8
33330, 옥천군,090005, 89세,2021,179,54,125,43.2,179,54,125,43.2
33330, 옥천군,095,90~94세,2021,462,114,348,32.8,462,114,348,32.8
33330, 옥천군,095001, 90세,2021,140,32,108,29.6,140,32,108,29.6
33330, 옥천군,095002, 91세,2021,107,26,81,32.1,107,26,81,32.1
33330, 옥천군,095003, 92세,2021,89,27,62,43.5,89,27,62,43.5
33330, 옥천군,095004, 93세,2021,70,17,53,32.1,70,17,53,32.1
33330, 옥천군,095005, 94세,2021,56,12,44,27.3,56,12,44,27.3
33330, 옥천군,100,95~99세,2021,84,22,62,35.5,84,22,62,35.5
33330, 옥천군,100001, 95세,2021,23,7,16,43.8,23,7,16,43.8
33330, 옥천군,100002, 96세,2021,25,X,21,19,25,X,21,19
33330, 옥천군,100003, 97세,2021,11,X,7,57.1,11,X,7,57.1
33330, 옥천군,100004, 98세,2021,16,X,12,33.3,16,X,12,33.3
33330, 옥천군,100005, 99세,2021,9,X,6,50,9,X,6,50
33330, 옥천군,101,100세이상,2021,9,X,9,0,9,X,9,0
33330, 옥천군,102,15세미만,2021,4237,2207,2030,108.7,4224,2200,2024,108.7
33330, 옥천군,103,15~64세,2021,29408,15698,13710,114.5,28526,15186,13340,113.8
33330, 옥천군,104,65세이상,2021,14862,6457,8405,76.8,14819,6436,8383,76.8
33330, 옥천군,086,85세이상,2021,1988,569,1419,40.1,1988,569,1419,40.1
33330, 옥천군,126,평균연령,2021,51.6,49.6,53.7,,51.9,49.8,53.9,
33330, 옥천군,127,중위연령,2021,55.6,53.6,57.7,,56,54,58.1,
33340, 영동군,000,합계,2021,45546,22784,22762,100.1,44511,22201,22310,99.5
33340, 영동군,005,0~4세,2021,901,474,427,111,897,473,424,111.6
33340, 영동군,005001, 0세,2021,160,84,76,110.5,158,84,74,113.5
33340, 영동군,005002, 1세,2021,191,105,86,122.1,191,105,86,122.1
33340, 영동군,005003, 2세,2021,175,89,86,103.5,175,89,86,103.5
33340, 영동군,005004, 3세,2021,194,112,82,136.6,194,112,82,136.6
33340, 영동군,005005, 4세,2021,181,84,97,86.6,179,83,96,86.5
33340, 영동군,010,5~9세,2021,1180,583,597,97.7,1177,581,596,97.5
33340, 영동군,010001, 5세,2021,209,110,99,111.1,209,110,99,111.1
33340, 영동군,010002, 6세,2021,230,113,117,96.6,230,113,117,96.6
33340, 영동군,010003, 7세,2021,242,118,124,95.2,241,118,123,95.9
33340, 영동군,010004, 8세,2021,227,112,115,97.4,226,111,115,96.5
33340, 영동군,010005, 9세,2021,272,130,142,91.5,271,129,142,90.8
33340, 영동군,015,10~14세,2021,1455,788,667,118.1,1451,785,666,117.9
33340, 영동군,015001, 10세,2021,298,157,141,111.3,297,157,140,112.1
33340, 영동군,015002, 11세,2021,290,165,125,132,289,164,125,131.2
33340, 영동군,015003, 12세,2021,266,142,124,114.5,265,141,124,113.7
33340, 영동군,015004, 13세,2021,274,154,120,128.3,273,153,120,127.5
33340, 영동군,015005, 14세,2021,327,170,157,108.3,327,170,157,108.3
33340, 영동군,020,15~19세,2021,1769,916,853,107.4,1723,883,840,105.1
33340, 영동군,020001, 15세,2021,302,150,152,98.7,302,150,152,98.7
33340, 영동군,020002, 16세,2021,294,161,133,121.1,294,161,133,121.1
33340, 영동군,020003, 17세,2021,331,165,166,99.4,331,165,166,99.4
33340, 영동군,020004, 18세,2021,352,179,173,103.5,346,174,172,101.2
33340, 영동군,020005, 19세,2021,490,261,229,114,450,233,217,107.4
33340, 영동군,025,20~24세,2021,2747,1674,1073,156,2533,1502,1031,145.7
33340, 영동군,025001, 20세,2021,538,308,230,133.9,500,282,218,129.4
33340, 영동군,025002, 21세,2021,623,358,265,135.1,570,309,261,118.4
33340, 영동군,025003, 22세,2021,568,331,237,139.7,522,294,228,128.9
33340, 영동군,025004, 23세,2021,495,324,171,189.5,463,300,163,184
33340, 영동군,025005, 24세,2021,523,353,170,207.6,478,317,161,196.9
33340, 영동군,030,25~29세,2021,1768,1061,707,150.1,1599,959,640,149.8
33340, 영동군,030001, 25세,2021,452,284,168,169,407,249,158,157.6
33340, 영동군,030002, 26세,2021,345,200,145,137.9,302,177,125,141.6
33340, 영동군,030003, 27세,2021,343,213,130,163.8,319,196,123,159.3
33340, 영동군,030004, 28세,2021,295,171,124,137.9,259,155,104,149
33340, 영동군,030005, 29세,2021,333,193,140,137.9,312,182,130,140
33340, 영동군,035,30~34세,2021,1394,734,660,111.2,1248,663,585,113.3
33340, 영동군,035001, 30세,2021,302,175,127,137.8,262,155,107,144.9
33340, 영동군,035002, 31세,2021,256,140,116,120.7,238,131,107,122.4
33340, 영동군,035003, 32세,2021,275,145,130,111.5,244,131,113,115.9
33340, 영동군,035004, 33세,2021,287,149,138,108,260,138,122,113.1
33340, 영동군,035005, 34세,2021,274,125,149,83.9,244,108,136,79.4
33340, 영동군,040,35~39세,2021,1681,863,818,105.5,1574,820,754,108.8
33340, 영동군,040001, 35세,2021,296,154,142,108.5,270,141,129,109.3
33340, 영동군,040002, 36세,2021,308,156,152,102.6,290,150,140,107.1
33340, 영동군,040003, 37세,2021,337,183,154,118.8,313,172,141,122
33340, 영동군,040004, 38세,2021,354,173,181,95.6,339,168,171,98.2
33340, 영동군,040005, 39세,2021,386,197,189,104.2,362,189,173,109.2
33340, 영동군,045,40~44세,2021,2069,1076,993,108.4,1989,1035,954,108.5
33340, 영동군,045001, 40세,2021,380,205,175,117.1,358,194,164,118.3
33340, 영동군,045002, 41세,2021,424,216,208,103.8,408,208,200,104
33340, 영동군,045003, 42세,2021,441,221,220,100.5,425,212,213,99.5
33340, 영동군,045004, 43세,2021,414,216,198,109.1,400,207,193,107.3
33340, 영동군,045005, 44세,2021,410,218,192,113.5,398,214,184,116.3
33340, 영동군,050,45~49세,2021,2761,1506,1255,120,2699,1480,1219,121.4
33340, 영동군,050001, 45세,2021,444,239,205,116.6,430,231,199,116.1
33340, 영동군,050002, 46세,2021,503,271,232,116.8,498,270,228,118.4
33340, 영동군,050003, 47세,2021,594,334,260,128.5,583,331,252,131.3
33340, 영동군,050004, 48세,2021,651,363,288,126,638,357,281,127
33340, 영동군,050005, 49세,2021,569,299,270,110.7,550,291,259,112.4
33340, 영동군,055,50~54세,2021,3640,1942,1698,114.4,3574,1915,1659,115.4
33340, 영동군,055001, 50세,2021,638,345,293,117.7,624,339,285,118.9
33340, 영동군,055002, 51세,2021,701,380,321,118.4,688,372,316,117.7
33340, 영동군,055003, 52세,2021,762,405,357,113.4,753,403,350,115.1
33340, 영동군,055004, 53세,2021,781,415,366,113.4,762,407,355,114.6
33340, 영동군,055005, 54세,2021,758,397,361,110,747,394,353,111.6
33340, 영동군,060,55~59세,2021,4127,2131,1996,106.8,4072,2110,1962,107.5
33340, 영동군,060001, 55세,2021,808,426,382,111.5,795,420,375,112
33340, 영동군,060002, 56세,2021,827,450,377,119.4,815,444,371,119.7
33340, 영동군,060003, 57세,2021,731,359,372,96.5,717,354,363,97.5
33340, 영동군,060004, 58세,2021,792,410,382,107.3,786,408,378,107.9
33340, 영동군,060005, 59세,2021,969,486,483,100.6,959,484,475,101.9
33340, 영동군,065,60~64세,2021,5160,2657,2503,106.2,5121,2637,2484,106.2
33340, 영동군,065001, 60세,2021,1153,595,558,106.6,1149,593,556,106.7
33340, 영동군,065002, 61세,2021,1041,510,531,96,1034,507,527,96.2
33340, 영동군,065003, 62세,2021,991,499,492,101.4,980,493,487,101.2
33340, 영동군,065004, 63세,2021,950,529,421,125.7,940,522,418,124.9
33340, 영동군,065005, 64세,2021,1025,524,501,104.6,1018,522,496,105.2
33340, 영동군,070,65~69세,2021,4211,2159,2052,105.2,4184,2144,2040,105.1
33340, 영동군,070001, 65세,2021,877,428,449,95.3,873,426,447,95.3
33340, 영동군,070002, 66세,2021,978,527,451,116.9,971,522,449,116.3
33340, 영동군,070003, 67세,2021,820,432,388,111.3,814,429,385,111.4
33340, 영동군,070004, 68세,2021,738,393,345,113.9,734,391,343,114
33340, 영동군,070005, 69세,2021,798,379,419,90.5,792,376,416,90.4
33340, 영동군,075,70~74세,2021,3244,1505,1739,86.5,3232,1499,1733,86.5
33340, 영동군,075001, 70세,2021,626,288,338,85.2,623,285,338,84.3
33340, 영동군,075002, 71세,2021,663,300,363,82.6,659,300,359,83.6
33340, 영동군,075003, 72세,2021,726,330,396,83.3,722,327,395,82.8
33340, 영동군,075004, 73세,2021,642,305,337,90.5,641,305,336,90.8
33340, 영동군,075005, 74세,2021,587,282,305,92.5,587,282,305,92.5
33340, 영동군,080,75~79세,2021,3005,1260,1745,72.2,3005,1260,1745,72.2
33340, 영동군,080001, 75세,2021,521,238,283,84.1,521,238,283,84.1
33340, 영동군,080002, 76세,2021,496,226,270,83.7,496,226,270,83.7
33340, 영동군,080003, 77세,2021,555,215,340,63.2,555,215,340,63.2
33340, 영동군,080004, 78세,2021,658,272,386,70.5,658,272,386,70.5
33340, 영동군,080005, 79세,2021,775,309,466,66.3,775,309,466,66.3
33340, 영동군,085,80~84세,2021,2508,918,1590,57.7,2507,918,1589,57.8
33340, 영동군,085001, 80세,2021,563,215,348,61.8,563,215,348,61.8
33340, 영동군,085002, 81세,2021,498,193,305,63.3,498,193,305,63.3
33340, 영동군,085003, 82세,2021,538,200,338,59.2,537,200,337,59.3
33340, 영동군,085004, 83세,2021,468,170,298,57,468,170,298,57
33340, 영동군,085005, 84세,2021,441,140,301,46.5,441,140,301,46.5
33340, 영동군,090,85~89세,2021,1367,425,942,45.1,1367,425,942,45.1
33340, 영동군,090001, 85세,2021,395,131,264,49.6,395,131,264,49.6
33340, 영동군,090002, 86세,2021,337,109,228,47.8,337,109,228,47.8
33340, 영동군,090003, 87세,2021,261,77,184,41.8,261,77,184,41.8
33340, 영동군,090004, 88세,2021,201,52,149,34.9,201,52,149,34.9
33340, 영동군,090005, 89세,2021,173,56,117,47.9,173,56,117,47.9
33340, 영동군,095,90~94세,2021,448,97,351,27.6,448,97,351,27.6
33340, 영동군,095001, 90세,2021,135,30,105,28.6,135,30,105,28.6
33340, 영동군,095002, 91세,2021,90,17,73,23.3,90,17,73,23.3
33340, 영동군,095003, 92세,2021,95,19,76,25,95,19,76,25
33340, 영동군,095004, 93세,2021,67,11,56,19.6,67,11,56,19.6
33340, 영동군,095005, 94세,2021,61,20,41,48.8,61,20,41,48.8
33340, 영동군,100,95~99세,2021,98,15,83,18.1,98,15,83,18.1
33340, 영동군,100001, 95세,2021,34,5,29,17.2,34,5,29,17.2
33340, 영동군,100002, 96세,2021,25,X,22,13.6,25,X,22,13.6
33340, 영동군,100003, 97세,2021,13,X,9,44.4,13,X,9,44.4
33340, 영동군,100004, 98세,2021,13,X,11,18.2,13,X,11,18.2
33340, 영동군,100005, 99세,2021,13,X,12,8.3,13,X,12,8.3
33340, 영동군,101,100세이상,2021,13,X,13,0,13,X,13,0
33340, 영동군,102,15세미만,2021,3536,1845,1691,109.1,3525,1839,1686,109.1
33340, 영동군,103,15~64세,2021,27116,14560,12556,116,26132,14004,12128,115.5
33340, 영동군,104,65세이상,2021,14894,6379,8515,74.9,14854,6358,8496,74.8
33340, 영동군,086,85세이상,2021,1926,537,1389,38.7,1926,537,1389,38.7
33340, 영동군,126,평균연령,2021,52.3,50,54.6,,52.6,50.4,54.9,
33340, 영동군,127,중위연령,2021,56.7,54.4,59.2,,57.3,55,59.6,
33350, 진천군,000,합계,2021,91779,49328,42451,116.2,82421,43193,39228,110.1
33350, 진천군,005,0~4세,2021,3409,1794,1615,111.1,3140,1646,1494,110.2
33350, 진천군,005001, 0세,2021,543,294,249,118.1,515,274,241,113.7
33350, 진천군,005002, 1세,2021,627,340,287,118.5,572,312,260,120
33350, 진천군,005003, 2세,2021,713,374,339,110.3,649,341,308,110.7
33350, 진천군,005004, 3세,2021,716,373,343,108.7,660,345,315,109.5
33350, 진천군,005005, 4세,2021,810,413,397,104,744,374,370,101.1
33350, 진천군,010,5~9세,2021,4547,2312,2235,103.4,4272,2167,2105,102.9
33350, 진천군,010001, 5세,2021,890,468,422,110.9,815,425,390,109
33350, 진천군,010002, 6세,2021,930,461,469,98.3,872,431,441,97.7
33350, 진천군,010003, 7세,2021,868,449,419,107.2,821,423,398,106.3
33350, 진천군,010004, 8세,2021,935,468,467,100.2,883,441,442,99.8
33350, 진천군,010005, 9세,2021,924,466,458,101.7,881,447,434,103
33350, 진천군,015,10~14세,2021,4457,2313,2144,107.9,4301,2240,2061,108.7
33350, 진천군,015001, 10세,2021,946,483,463,104.3,909,472,437,108
33350, 진천군,015002, 11세,2021,909,469,440,106.6,875,454,421,107.8
33350, 진천군,015003, 12세,2021,822,423,399,106,790,406,384,105.7
33350, 진천군,015004, 13세,2021,891,479,412,116.3,864,463,401,115.5
33350, 진천군,015005, 14세,2021,889,459,430,106.7,863,445,418,106.5
33350, 진천군,020,15~19세,2021,4011,2100,1911,109.9,3887,2033,1854,109.7
33350, 진천군,020001, 15세,2021,774,394,380,103.7,746,377,369,102.2
33350, 진천군,020002, 16세,2021,786,393,393,100,756,381,375,101.6
33350, 진천군,020003, 17세,2021,850,445,405,109.9,829,434,395,109.9
33350, 진천군,020004, 18세,2021,829,453,376,120.5,809,441,368,119.8
33350, 진천군,020005, 19세,2021,772,415,357,116.2,747,400,347,115.3
33350, 진천군,025,20~24세,2021,4684,2790,1894,147.3,4141,2418,1723,140.3
33350, 진천군,025001, 20세,2021,855,535,320,167.2,813,514,299,171.9
33350, 진천군,025002, 21세,2021,918,560,358,156.4,860,520,340,152.9
33350, 진천군,025003, 22세,2021,913,540,373,144.8,830,486,344,141.3
33350, 진천군,025004, 23세,2021,930,543,387,140.3,777,429,348,123.3
33350, 진천군,025005, 24세,2021,1068,612,456,134.2,861,469,392,119.6
33350, 진천군,030,25~29세,2021,6160,3863,2297,168.2,4870,2907,1963,148.1
33350, 진천군,030001, 25세,2021,1098,692,406,170.4,861,506,355,142.5
33350, 진천군,030002, 26세,2021,1167,740,427,173.3,918,546,372,146.8
33350, 진천군,030003, 27세,2021,1221,759,462,164.3,969,576,393,146.6
33350, 진천군,030004, 28세,2021,1304,816,488,167.2,1044,623,421,148
33350, 진천군,030005, 29세,2021,1370,856,514,166.5,1078,656,422,155.5
33350, 진천군,035,30~34세,2021,6550,3956,2594,152.5,4940,2790,2150,129.8
33350, 진천군,035001, 30세,2021,1338,847,491,172.5,1011,598,413,144.8
33350, 진천군,035002, 31세,2021,1349,836,513,163,1033,600,433,138.6
33350, 진천군,035003, 32세,2021,1281,766,515,148.7,940,527,413,127.6
33350, 진천군,035004, 33세,2021,1277,749,528,141.9,977,539,438,123.1
33350, 진천군,035005, 34세,2021,1305,758,547,138.6,979,526,453,116.1
33350, 진천군,040,35~39세,2021,7504,4297,3207,134,6165,3355,2810,119.4
33350, 진천군,040001, 35세,2021,1361,793,568,139.6,1069,590,479,123.2
33350, 진천군,040002, 36세,2021,1368,791,577,137.1,1091,591,500,118.2
33350, 진천군,040003, 37세,2021,1464,825,639,129.1,1182,628,554,113.4
33350, 진천군,040004, 38세,2021,1615,922,693,133,1377,746,631,118.2
33350, 진천군,040005, 39세,2021,1696,966,730,132.3,1446,800,646,123.8
33350, 진천군,045,40~44세,2021,7793,4320,3473,124.4,6799,3612,3187,113.3
33350, 진천군,045001, 40세,2021,1586,875,711,123.1,1363,715,648,110.3
33350, 진천군,045002, 41세,2021,1703,903,800,112.9,1494,754,740,101.9
33350, 진천군,045003, 42세,2021,1575,908,667,136.1,1368,758,610,124.3
33350, 진천군,045004, 43세,2021,1456,817,639,127.9,1263,680,583,116.6
33350, 진천군,045005, 44세,2021,1473,817,656,124.5,1311,705,606,116.3
33350, 진천군,050,45~49세,2021,7219,4029,3190,126.3,6456,3567,2889,123.5
33350, 진천군,050001, 45세,2021,1437,821,616,133.3,1270,717,553,129.7
33350, 진천군,050002, 46세,2021,1474,794,680,116.8,1314,684,630,108.6
33350, 진천군,050003, 47세,2021,1446,805,641,125.6,1320,742,578,128.4
33350, 진천군,050004, 48세,2021,1506,845,661,127.8,1342,748,594,125.9
33350, 진천군,050005, 49세,2021,1356,764,592,129.1,1210,676,534,126.6
33350, 진천군,055,50~54세,2021,7555,4115,3440,119.6,6840,3715,3125,118.9
33350, 진천군,055001, 50세,2021,1560,867,693,125.1,1386,765,621,123.2
33350, 진천군,055002, 51세,2021,1457,783,674,116.2,1310,699,611,114.4
33350, 진천군,055003, 52세,2021,1568,852,716,119,1444,784,660,118.8
33350, 진천군,055004, 53세,2021,1560,834,726,114.9,1413,760,653,116.4
33350, 진천군,055005, 54세,2021,1410,779,631,123.5,1287,707,580,121.9
33350, 진천군,060,55~59세,2021,6968,3802,3166,120.1,6352,3441,2911,118.2
33350, 진천군,060001, 55세,2021,1443,791,652,121.3,1329,731,598,122.2
33350, 진천군,060002, 56세,2021,1472,799,673,118.7,1349,727,622,116.9
33350, 진천군,060003, 57세,2021,1294,701,593,118.2,1167,615,552,111.4
33350, 진천군,060004, 58세,2021,1350,754,596,126.5,1196,665,531,125.2
33350, 진천군,060005, 59세,2021,1409,757,652,116.1,1311,703,608,115.6
33350, 진천군,065,60~64세,2021,6674,3475,3199,108.6,6304,3271,3033,107.8
33350, 진천군,065001, 60세,2021,1615,834,781,106.8,1548,796,752,105.9
33350, 진천군,065002, 61세,2021,1390,726,664,109.3,1300,680,620,109.7
33350, 진천군,065003, 62세,2021,1266,660,606,108.9,1196,623,573,108.7
33350, 진천군,065004, 63세,2021,1188,630,558,112.9,1109,582,527,110.4
33350, 진천군,065005, 64세,2021,1215,625,590,105.9,1151,590,561,105.2
33350, 진천군,070,65~69세,2021,4743,2340,2403,97.4,4567,2256,2311,97.6
33350, 진천군,070001, 65세,2021,1078,562,516,108.9,1030,536,494,108.5
33350, 진천군,070002, 66세,2021,1043,515,528,97.5,1005,500,505,99
33350, 진천군,070003, 67세,2021,949,449,500,89.8,905,428,477,89.7
33350, 진천군,070004, 68세,2021,802,398,404,98.5,781,382,399,95.7
33350, 진천군,070005, 69세,2021,871,416,455,91.4,846,410,436,94
33350, 진천군,075,70~74세,2021,3005,1470,1535,95.8,2933,1436,1497,95.9
33350, 진천군,075001, 70세,2021,560,280,280,100,543,272,271,100.4
33350, 진천군,075002, 71세,2021,604,279,325,85.8,587,272,315,86.3
33350, 진천군,075003, 72세,2021,624,327,297,110.1,607,315,292,107.9
33350, 진천군,075004, 73세,2021,636,308,328,93.9,624,303,321,94.4
33350, 진천군,075005, 74세,2021,581,276,305,90.5,572,274,298,91.9
33350, 진천군,080,75~79세,2021,2489,1051,1438,73.1,2467,1042,1425,73.1
33350, 진천군,080001, 75세,2021,445,218,227,96,439,215,224,96
33350, 진천군,080002, 76세,2021,507,213,294,72.4,503,212,291,72.9
33350, 진천군,080003, 77세,2021,449,181,268,67.5,447,181,266,68
33350, 진천군,080004, 78세,2021,495,196,299,65.6,486,191,295,64.7
33350, 진천군,080005, 79세,2021,593,243,350,69.4,592,243,349,69.6
33350, 진천군,085,80~84세,2021,2239,832,1407,59.1,2223,830,1393,59.6
33350, 진천군,085001, 80세,2021,459,180,279,64.5,455,179,276,64.9
33350, 진천군,085002, 81세,2021,456,182,274,66.4,454,182,272,66.9
33350, 진천군,085003, 82세,2021,493,166,327,50.8,491,165,326,50.6
33350, 진천군,085004, 83세,2021,434,173,261,66.3,426,173,253,68.4
33350, 진천군,085005, 84세,2021,397,131,266,49.2,397,131,266,49.2
33350, 진천군,090,85~89세,2021,1299,368,931,39.5,1292,367,925,39.7
33350, 진천군,090001, 85세,2021,371,123,248,49.6,369,123,246,50
33350, 진천군,090002, 86세,2021,322,75,247,30.4,320,74,246,30.1
33350, 진천군,090003, 87세,2021,254,69,185,37.3,253,69,184,37.5
33350, 진천군,090004, 88세,2021,216,60,156,38.5,214,60,154,39
33350, 진천군,090005, 89세,2021,136,41,95,43.2,136,41,95,43.2
33350, 진천군,095,90~94세,2021,380,86,294,29.3,379,85,294,28.9
33350, 진천군,095001, 90세,2021,119,26,93,28,118,25,93,26.9
33350, 진천군,095002, 91세,2021,84,15,69,21.7,84,15,69,21.7
33350, 진천군,095003, 92세,2021,70,24,46,52.2,70,24,46,52.2
33350, 진천군,095004, 93세,2021,63,10,53,18.9,63,10,53,18.9
33350, 진천군,095005, 94세,2021,44,11,33,33.3,44,11,33,33.3
33350, 진천군,100,95~99세,2021,82,11,71,15.5,82,11,71,15.5
33350, 진천군,100001, 95세,2021,25,X,23,8.7,25,X,23,8.7
33350, 진천군,100002, 96세,2021,22,X,19,15.8,22,X,19,15.8
33350, 진천군,100003, 97세,2021,15,X,11,36.4,15,X,11,36.4
33350, 진천군,100004, 98세,2021,14,X,14,0,14,X,14,0
33350, 진천군,100005, 99세,2021,6,X,X,50,6,X,X,50
33350, 진천군,101,100세이상,2021,11,X,7,57.1,11,X,7,57.1
33350, 진천군,102,15세미만,2021,12413,6419,5994,107.1,11713,6053,5660,106.9
33350, 진천군,103,15~64세,2021,65118,36747,28371,129.5,56754,31109,25645,121.3
33350, 진천군,104,65세이상,2021,14248,6162,8086,76.2,13954,6031,7923,76.1
33350, 진천군,086,85세이상,2021,1772,469,1303,36,1764,467,1297,36
33350, 진천군,126,평균연령,2021,42.5,41.1,44.1,,43,41.7,44.5,
33350, 진천군,127,중위연령,2021,42.8,41.4,44.8,,44,42.8,45.5,
33360, 괴산군,000,합계,2021,37526,19435,18091,107.4,36264,18666,17598,106.1
33360, 괴산군,005,0~4세,2021,457,234,223,104.9,452,231,221,104.5
33360, 괴산군,005001, 0세,2021,84,39,45,86.7,83,38,45,84.4
33360, 괴산군,005002, 1세,2021,74,41,33,124.2,73,41,32,128.1
33360, 괴산군,005003, 2세,2021,87,48,39,123.1,86,47,39,120.5
33360, 괴산군,005004, 3세,2021,97,53,44,120.5,95,52,43,120.9
33360, 괴산군,005005, 4세,2021,115,53,62,85.5,115,53,62,85.5
33360, 괴산군,010,5~9세,2021,717,371,346,107.2,708,363,345,105.2
33360, 괴산군,010001, 5세,2021,119,69,50,138,115,65,50,130
33360, 괴산군,010002, 6세,2021,118,54,64,84.4,118,54,64,84.4
33360, 괴산군,010003, 7세,2021,166,82,84,97.6,164,80,84,95.2
33360, 괴산군,010004, 8세,2021,139,66,73,90.4,137,65,72,90.3
33360, 괴산군,010005, 9세,2021,175,100,75,133.3,174,99,75,132
33360, 괴산군,015,10~14세,2021,887,425,462,92,886,424,462,91.8
33360, 괴산군,015001, 10세,2021,157,75,82,91.5,157,75,82,91.5
33360, 괴산군,015002, 11세,2021,176,91,85,107.1,175,90,85,105.9
33360, 괴산군,015003, 12세,2021,180,77,103,74.8,180,77,103,74.8
33360, 괴산군,015004, 13세,2021,186,91,95,95.8,186,91,95,95.8
33360, 괴산군,015005, 14세,2021,188,91,97,93.8,188,91,97,93.8
33360, 괴산군,020,15~19세,2021,1204,660,544,121.3,1199,658,541,121.6
33360, 괴산군,020001, 15세,2021,157,72,85,84.7,156,72,84,85.7
33360, 괴산군,020002, 16세,2021,184,102,82,124.4,182,101,81,124.7
33360, 괴산군,020003, 17세,2021,159,97,62,156.5,159,97,62,156.5
33360, 괴산군,020004, 18세,2021,242,153,89,171.9,241,152,89,170.8
33360, 괴산군,020005, 19세,2021,462,236,226,104.4,461,236,225,104.9
33360, 괴산군,025,20~24세,2021,2617,1555,1062,146.4,2404,1416,988,143.3
33360, 괴산군,025001, 20세,2021,552,259,293,88.4,524,241,283,85.2
33360, 괴산군,025002, 21세,2021,555,247,308,80.2,500,215,285,75.4
33360, 괴산군,025003, 22세,2021,572,360,212,169.8,524,325,199,163.3
33360, 괴산군,025004, 23세,2021,501,361,140,257.9,456,333,123,270.7
33360, 괴산군,025005, 24세,2021,437,328,109,300.9,400,302,98,308.2
33360, 괴산군,030,25~29세,2021,1529,965,564,171.1,1298,822,476,172.7
33360, 괴산군,030001, 25세,2021,389,265,124,213.7,338,233,105,221.9
33360, 괴산군,030002, 26세,2021,320,199,121,164.5,267,164,103,159.2
33360, 괴산군,030003, 27세,2021,290,195,95,205.3,252,171,81,211.1
33360, 괴산군,030004, 28세,2021,268,157,111,141.4,231,135,96,140.6
33360, 괴산군,030005, 29세,2021,262,149,113,131.9,210,119,91,130.8
33360, 괴산군,035,30~34세,2021,1196,708,488,145.1,966,570,396,143.9
33360, 괴산군,035001, 30세,2021,265,171,94,181.9,204,126,78,161.5
33360, 괴산군,035002, 31세,2021,259,147,112,131.3,214,121,93,130.1
33360, 괴산군,035003, 32세,2021,233,145,88,164.8,185,122,63,193.7
33360, 괴산군,035004, 33세,2021,230,130,100,130,187,107,80,133.8
33360, 괴산군,035005, 34세,2021,209,115,94,122.3,176,94,82,114.6
33360, 괴산군,040,35~39세,2021,1303,730,573,127.4,1134,617,517,119.3
33360, 괴산군,040001, 35세,2021,239,135,104,129.8,203,111,92,120.7
33360, 괴산군,040002, 36세,2021,219,118,101,116.8,182,93,89,104.5
33360, 괴산군,040003, 37세,2021,258,148,110,134.5,227,127,100,127
33360, 괴산군,040004, 38세,2021,272,149,123,121.1,242,129,113,114.2
33360, 괴산군,040005, 39세,2021,315,180,135,133.3,280,157,123,127.6
33360, 괴산군,045,40~44세,2021,1556,852,704,121,1458,794,664,119.6
33360, 괴산군,045001, 40세,2021,302,172,130,132.3,279,156,123,126.8
33360, 괴산군,045002, 41세,2021,334,188,146,128.8,309,171,138,123.9
33360, 괴산군,045003, 42세,2021,322,167,155,107.7,301,156,145,107.6
33360, 괴산군,045004, 43세,2021,297,157,140,112.1,283,150,133,112.8
33360, 괴산군,045005, 44세,2021,301,168,133,126.3,286,161,125,128.8
33360, 괴산군,050,45~49세,2021,1913,1133,780,145.3,1854,1098,756,145.2
33360, 괴산군,050001, 45세,2021,307,173,134,129.1,299,167,132,126.5
33360, 괴산군,050002, 46세,2021,359,221,138,160.1,350,215,135,159.3
33360, 괴산군,050003, 47세,2021,389,233,156,149.4,374,225,149,151
33360, 괴산군,050004, 48세,2021,434,254,180,141.1,421,248,173,143.4
33360, 괴산군,050005, 49세,2021,424,252,172,146.5,410,243,167,145.5
33360, 괴산군,055,50~54세,2021,2914,1620,1294,125.2,2839,1581,1258,125.7
33360, 괴산군,055001, 50세,2021,534,295,239,123.4,523,292,231,126.4
33360, 괴산군,055002, 51세,2021,519,318,201,158.2,503,309,194,159.3
33360, 괴산군,055003, 52세,2021,586,315,271,116.2,567,303,264,114.8
33360, 괴산군,055004, 53세,2021,618,347,271,128,606,339,267,127
33360, 괴산군,055005, 54세,2021,657,345,312,110.6,640,338,302,111.9
33360, 괴산군,060,55~59세,2021,3742,1926,1816,106.1,3676,1895,1781,106.4
33360, 괴산군,060001, 55세,2021,740,396,344,115.1,727,389,338,115.1
33360, 괴산군,060002, 56세,2021,721,372,349,106.6,710,368,342,107.6
33360, 괴산군,060003, 57세,2021,663,346,317,109.1,650,339,311,109
33360, 괴산군,060004, 58세,2021,765,394,371,106.2,749,387,362,106.9
33360, 괴산군,060005, 59세,2021,853,418,435,96.1,840,412,428,96.3
33360, 괴산군,065,60~64세,2021,4816,2577,2239,115.1,4760,2548,2212,115.2
33360, 괴산군,065001, 60세,2021,1009,536,473,113.3,1000,532,468,113.7
33360, 괴산군,065002, 61세,2021,986,515,471,109.3,970,510,460,110.9
33360, 괴산군,065003, 62세,2021,930,492,438,112.3,919,485,434,111.8
33360, 괴산군,065004, 63세,2021,995,545,450,121.1,985,540,445,121.3
33360, 괴산군,065005, 64세,2021,896,489,407,120.1,886,481,405,118.8
33360, 괴산군,070,65~69세,2021,3917,2030,1887,107.6,3888,2009,1879,106.9
33360, 괴산군,070001, 65세,2021,881,482,399,120.8,875,479,396,121
33360, 괴산군,070002, 66세,2021,846,436,410,106.3,842,433,409,105.9
33360, 괴산군,070003, 67세,2021,804,408,396,103,795,400,395,101.3
33360, 괴산군,070004, 68세,2021,665,322,343,93.9,657,316,341,92.7
33360, 괴산군,070005, 69세,2021,721,382,339,112.7,719,381,338,112.7
33360, 괴산군,075,70~74세,2021,2706,1375,1331,103.3,2695,1368,1327,103.1
33360, 괴산군,075001, 70세,2021,525,251,274,91.6,520,248,272,91.2
33360, 괴산군,075002, 71세,2021,542,279,263,106.1,539,277,262,105.7
33360, 괴산군,075003, 72세,2021,552,294,258,114,551,293,258,113.6
33360, 괴산군,075004, 73세,2021,534,278,256,108.6,534,278,256,108.6
33360, 괴산군,075005, 74세,2021,553,273,280,97.5,551,272,279,97.5
33360, 괴산군,080,75~79세,2021,2368,1004,1364,73.6,2365,1002,1363,73.5
33360, 괴산군,080001, 75세,2021,390,195,195,100,388,194,194,100
33360, 괴산군,080002, 76세,2021,485,222,263,84.4,484,221,263,84
33360, 괴산군,080003, 77세,2021,428,168,260,64.6,428,168,260,64.6
33360, 괴산군,080004, 78세,2021,495,196,299,65.6,495,196,299,65.6
33360, 괴산군,080005, 79세,2021,570,223,347,64.3,570,223,347,64.3
33360, 괴산군,085,80~84세,2021,2140,836,1304,64.1,2139,836,1303,64.2
33360, 괴산군,085001, 80세,2021,500,200,300,66.7,500,200,300,66.7
33360, 괴산군,085002, 81세,2021,439,170,269,63.2,439,170,269,63.2
33360, 괴산군,085003, 82세,2021,446,181,265,68.3,446,181,265,68.3
33360, 괴산군,085004, 83세,2021,408,166,242,68.6,407,166,241,68.9
33360, 괴산군,085005, 84세,2021,347,119,228,52.2,347,119,228,52.2
33360, 괴산군,090,85~89세,2021,1123,335,788,42.5,1122,335,787,42.6
33360, 괴산군,090001, 85세,2021,305,104,201,51.7,305,104,201,51.7
33360, 괴산군,090002, 86세,2021,251,81,170,47.6,250,81,169,47.9
33360, 괴산군,090003, 87세,2021,239,69,170,40.6,239,69,170,40.6
33360, 괴산군,090004, 88세,2021,183,41,142,28.9,183,41,142,28.9
33360, 괴산군,090005, 89세,2021,145,40,105,38.1,145,40,105,38.1
33360, 괴산군,095,90~94세,2021,343,82,261,31.4,343,82,261,31.4
33360, 괴산군,095001, 90세,2021,111,29,82,35.4,111,29,82,35.4
33360, 괴산군,095002, 91세,2021,97,23,74,31.1,97,23,74,31.1
33360, 괴산군,095003, 92세,2021,64,13,51,25.5,64,13,51,25.5
33360, 괴산군,095004, 93세,2021,48,11,37,29.7,48,11,37,29.7
33360, 괴산군,095005, 94세,2021,23,6,17,35.3,23,6,17,35.3
33360, 괴산군,100,95~99세,2021,62,14,48,29.2,62,14,48,29.2
33360, 괴산군,100001, 95세,2021,15,X,12,25,15,X,12,25
33360, 괴산군,100002, 96세,2021,20,5,15,33.3,20,5,15,33.3
33360, 괴산군,100003, 97세,2021,10,X,9,11.1,10,X,9,11.1
33360, 괴산군,100004, 98세,2021,9,X,7,28.6,9,X,7,28.6
33360, 괴산군,100005, 99세,2021,8,X,5,60,8,X,5,60
33360, 괴산군,101,100세이상,2021,16,X,13,23.1,16,X,13,23.1
33360, 괴산군,102,15세미만,2021,2061,1030,1031,99.9,2046,1018,1028,99
33360, 괴산군,103,15~64세,2021,22790,12726,10064,126.5,21588,11999,9589,125.1
33360, 괴산군,104,65세이상,2021,12675,5679,6996,81.2,12630,5649,6981,80.9
33360, 괴산군,086,85세이상,2021,1544,434,1110,39.1,1543,434,1109,39.1
33360, 괴산군,126,평균연령,2021,53.6,51.5,55.9,,54.2,52.2,56.4,
33360, 괴산군,127,중위연령,2021,58.5,56.2,60.4,,59.1,57,60.8,
33370, 음성군,000,합계,2021,100866,55530,45336,122.5,87944,46472,41472,112.1
33370, 음성군,005,0~4세,2021,2251,1142,1109,103,2103,1074,1029,104.4
33370, 음성군,005001, 0세,2021,363,179,184,97.3,339,172,167,103
33370, 음성군,005002, 1세,2021,387,186,201,92.5,361,171,190,90
33370, 음성군,005003, 2세,2021,489,248,241,102.9,457,229,228,100.4
33370, 음성군,005004, 3세,2021,467,252,215,117.2,436,241,195,123.6
33370, 음성군,005005, 4세,2021,545,277,268,103.4,510,261,249,104.8
33370, 음성군,010,5~9세,2021,3430,1791,1639,109.3,3307,1730,1577,109.7
33370, 음성군,010001, 5세,2021,674,335,339,98.8,641,319,322,99.1
33370, 음성군,010002, 6세,2021,641,334,307,108.8,621,320,301,106.3
33370, 음성군,010003, 7세,2021,655,351,304,115.5,627,336,291,115.5
33370, 음성군,010004, 8세,2021,670,329,341,96.5,648,321,327,98.2
33370, 음성군,010005, 9세,2021,790,442,348,127,770,434,336,129.2
33370, 음성군,015,10~14세,2021,3626,1888,1738,108.6,3534,1845,1689,109.2
33370, 음성군,015001, 10세,2021,761,409,352,116.2,745,402,343,117.2
33370, 음성군,015002, 11세,2021,719,366,353,103.7,701,358,343,104.4
33370, 음성군,015003, 12세,2021,676,372,304,122.4,662,363,299,121.4
33370, 음성군,015004, 13세,2021,715,356,359,99.2,692,345,347,99.4
33370, 음성군,015005, 14세,2021,755,385,370,104.1,734,377,357,105.6
33370, 음성군,020,15~19세,2021,3748,1991,1757,113.3,3688,1960,1728,113.4
33370, 음성군,020001, 15세,2021,683,343,340,100.9,668,335,333,100.6
33370, 음성군,020002, 16세,2021,737,388,349,111.2,730,384,346,111
33370, 음성군,020003, 17세,2021,769,450,319,141.1,761,448,313,143.1
33370, 음성군,020004, 18세,2021,763,397,366,108.5,753,391,362,108
33370, 음성군,020005, 19세,2021,796,413,383,107.8,776,402,374,107.5
33370, 음성군,025,20~24세,2021,5202,3072,2130,144.2,4404,2478,1926,128.7
33370, 음성군,025001, 20세,2021,964,499,465,107.3,902,458,444,103.2
33370, 음성군,025002, 21세,2021,1024,567,457,124.1,944,516,428,120.6
33370, 음성군,025003, 22세,2021,1014,619,395,156.7,879,520,359,144.8
33370, 음성군,025004, 23세,2021,1015,639,376,169.9,810,485,325,149.2
33370, 음성군,025005, 24세,2021,1185,748,437,171.2,869,499,370,134.9
33370, 음성군,030,25~29세,2021,6914,4483,2431,184.4,4564,2702,1862,145.1
33370, 음성군,030001, 25세,2021,1260,802,458,175.1,856,499,357,139.8
33370, 음성군,030002, 26세,2021,1321,861,460,187.2,909,539,370,145.7
33370, 음성군,030003, 27세,2021,1395,883,512,172.5,891,505,386,130.8
33370, 음성군,030004, 28세,2021,1493,986,507,194.5,992,600,392,153.1
33370, 음성군,030005, 29세,2021,1445,951,494,192.5,916,559,357,156.6
33370, 음성군,035,30~34세,2021,6570,4287,2283,187.8,4041,2367,1674,141.4
33370, 음성군,035001, 30세,2021,1363,901,462,195,836,496,340,145.9
33370, 음성군,035002, 31세,2021,1386,902,484,186.4,879,535,344,155.5
33370, 음성군,035003, 32세,2021,1253,813,440,184.8,765,441,324,136.1
33370, 음성군,035004, 33세,2021,1266,815,451,180.7,769,443,326,135.9
33370, 음성군,035005, 34세,2021,1302,856,446,191.9,792,452,340,132.9
33370, 음성군,040,35~39세,2021,6573,4005,2568,156,4684,2601,2083,124.9
33370, 음성군,040001, 35세,2021,1260,771,489,157.7,820,454,366,124
33370, 음성군,040002, 36세,2021,1263,770,493,156.2,867,471,396,118.9
33370, 음성군,040003, 37세,2021,1251,786,465,169,887,515,372,138.4
33370, 음성군,040004, 38세,2021,1337,816,521,156.6,986,550,436,126.1
33370, 음성군,040005, 39세,2021,1462,862,600,143.7,1124,611,513,119.1
33370, 음성군,045,40~44세,2021,7258,4233,3025,139.9,5898,3255,2643,123.2
33370, 음성군,045001, 40세,2021,1500,875,625,140,1177,645,532,121.2
33370, 음성군,045002, 41세,2021,1488,860,628,136.9,1196,643,553,116.3
33370, 음성군,045003, 42세,2021,1489,881,608,144.9,1203,671,532,126.1
33370, 음성군,045004, 43세,2021,1347,757,590,128.3,1116,598,518,115.4
33370, 음성군,045005, 44세,2021,1434,860,574,149.8,1206,698,508,137.4
33370, 음성군,050,45~49세,2021,7711,4380,3331,131.5,6741,3765,2976,126.5
33370, 음성군,050001, 45세,2021,1388,788,600,131.3,1177,641,536,119.6
33370, 음성군,050002, 46세,2021,1424,822,602,136.5,1250,717,533,134.5
33370, 음성군,050003, 47세,2021,1624,904,720,125.6,1437,792,645,122.8
33370, 음성군,050004, 48세,2021,1651,943,708,133.2,1466,817,649,125.9
33370, 음성군,050005, 49세,2021,1624,923,701,131.7,1411,798,613,130.2
33370, 음성군,055,50~54세,2021,9095,5152,3943,130.7,8140,4550,3590,126.7
33370, 음성군,055001, 50세,2021,1738,1004,734,136.8,1531,864,667,129.5
33370, 음성군,055002, 51세,2021,1810,1037,773,134.2,1605,920,685,134.3
33370, 음성군,055003, 52세,2021,1919,1091,828,131.8,1726,971,755,128.6
33370, 음성군,055004, 53세,2021,1903,1099,804,136.7,1715,969,746,129.9
33370, 음성군,055005, 54세,2021,1725,921,804,114.6,1563,826,737,112.1
33370, 음성군,060,55~59세,2021,8997,4998,3999,125,8175,4479,3696,121.2
33370, 음성군,060001, 55세,2021,1774,989,785,126,1608,882,726,121.5
33370, 음성군,060002, 56세,2021,1912,1075,837,128.4,1751,968,783,123.6
33370, 음성군,060003, 57세,2021,1665,911,754,120.8,1503,814,689,118.1
33370, 음성군,060004, 58세,2021,1732,976,756,129.1,1533,852,681,125.1
33370, 음성군,060005, 59세,2021,1914,1047,867,120.8,1780,963,817,117.9
33370, 음성군,065,60~64세,2021,9384,5056,4328,116.8,8949,4818,4131,116.6
33370, 음성군,065001, 60세,2021,2144,1204,940,128.1,2051,1152,899,128.1
33370, 음성군,065002, 61세,2021,1976,1057,919,115,1875,1008,867,116.3
33370, 음성군,065003, 62세,2021,1840,963,877,109.8,1761,925,836,110.6
33370, 음성군,065004, 63세,2021,1757,940,817,115.1,1681,892,789,113.1
33370, 음성군,065005, 64세,2021,1667,892,775,115.1,1581,841,740,113.6
33370, 음성군,070,65~69세,2021,6789,3518,3271,107.6,6549,3372,3177,106.1
33370, 음성군,070001, 65세,2021,1503,790,713,110.8,1450,755,695,108.6
33370, 음성군,070002, 66세,2021,1554,781,773,101,1490,742,748,99.2
33370, 음성군,070003, 67세,2021,1322,668,654,102.1,1262,630,632,99.7
33370, 음성군,070004, 68세,2021,1101,598,503,118.9,1064,577,487,118.5
33370, 음성군,070005, 69세,2021,1309,681,628,108.4,1283,668,615,108.6
33370, 음성군,075,70~74세,2021,4228,2082,2146,97,4143,2043,2100,97.3
33370, 음성군,075001, 70세,2021,784,382,402,95,767,375,392,95.7
33370, 음성군,075002, 71세,2021,872,434,438,99.1,848,420,428,98.1
33370, 음성군,075003, 72세,2021,905,456,449,101.6,889,451,438,103
33370, 음성군,075004, 73세,2021,830,405,425,95.3,816,398,418,95.2
33370, 음성군,075005, 74세,2021,837,405,432,93.8,823,399,424,94.1
33370, 음성군,080,75~79세,2021,3680,1657,2023,81.9,3644,1645,1999,82.3
33370, 음성군,080001, 75세,2021,688,339,349,97.1,673,330,343,96.2
33370, 음성군,080002, 76세,2021,686,323,363,89,680,322,358,89.9
33370, 음성군,080003, 77세,2021,722,304,418,72.7,716,304,412,73.8
33370, 음성군,080004, 78세,2021,699,303,396,76.5,695,301,394,76.4
33370, 음성군,080005, 79세,2021,885,388,497,78.1,880,388,492,78.9
33370, 음성군,085,80~84세,2021,3000,1122,1878,59.7,2977,1117,1860,60.1
33370, 음성군,085001, 80세,2021,720,302,418,72.2,713,301,412,73.1
33370, 음성군,085002, 81세,2021,657,249,408,61,652,249,403,61.8
33370, 음성군,085003, 82세,2021,621,246,375,65.6,617,245,372,65.9
33370, 음성군,085004, 83세,2021,518,169,349,48.4,516,168,348,48.3
33370, 음성군,085005, 84세,2021,484,156,328,47.6,479,154,325,47.4
33370, 음성군,090,85~89세,2021,1709,515,1194,43.1,1702,513,1189,43.1
33370, 음성군,090001, 85세,2021,438,151,287,52.6,436,150,286,52.4
33370, 음성군,090002, 86세,2021,444,133,311,42.8,443,133,310,42.9
33370, 음성군,090003, 87세,2021,336,103,233,44.2,333,102,231,44.2
33370, 음성군,090004, 88세,2021,259,74,185,40,258,74,184,40.2
33370, 음성군,090005, 89세,2021,232,54,178,30.3,232,54,178,30.3
33370, 음성군,095,90~94세,2021,560,131,429,30.5,560,131,429,30.5
33370, 음성군,095001, 90세,2021,160,36,124,29,160,36,124,29
33370, 음성군,095002, 91세,2021,147,35,112,31.3,147,35,112,31.3
33370, 음성군,095003, 92세,2021,113,26,87,29.9,113,26,87,29.9
33370, 음성군,095004, 93세,2021,86,18,68,26.5,86,18,68,26.5
33370, 음성군,095005, 94세,2021,54,16,38,42.1,54,16,38,42.1
33370, 음성군,100,95~99세,2021,123,22,101,21.8,123,22,101,21.8
33370, 음성군,100001, 95세,2021,38,X,35,8.6,38,X,35,8.6
33370, 음성군,100002, 96세,2021,41,10,31,32.3,41,10,31,32.3
33370, 음성군,100003, 97세,2021,18,X,14,28.6,18,X,14,28.6
33370, 음성군,100004, 98세,2021,18,X,17,5.9,18,X,17,5.9
33370, 음성군,100005, 99세,2021,8,X,X,100,8,X,X,100
33370, 음성군,101,100세이상,2021,18,5,13,38.5,18,5,13,38.5
33370, 음성군,102,15세미만,2021,9307,4821,4486,107.5,8944,4649,4295,108.2
33370, 음성군,103,15~64세,2021,71452,41657,29795,139.8,59284,32975,26309,125.3
33370, 음성군,104,65세이상,2021,20107,9052,11055,81.9,19716,8848,10868,81.4
33370, 음성군,086,85세이상,2021,2410,673,1737,38.7,2403,671,1732,38.7
33370, 음성군,126,평균연령,2021,46.4,44.8,48.3,,47.6,46.2,49.1,
33370, 음성군,127,중위연령,2021,48.3,46.1,50.9,,50.7,49.3,52.3,
33380, 단양군,000,합계,2021,26937,13584,13353,101.7,26675,13492,13183,102.3
33380, 단양군,005,0~4세,2021,427,229,198,115.7,427,229,198,115.7
33380, 단양군,005001, 0세,2021,75,40,35,114.3,75,40,35,114.3
33380, 단양군,005002, 1세,2021,69,33,36,91.7,69,33,36,91.7
33380, 단양군,005003, 2세,2021,79,46,33,139.4,79,46,33,139.4
33380, 단양군,005004, 3세,2021,105,57,48,118.8,105,57,48,118.8
33380, 단양군,005005, 4세,2021,99,53,46,115.2,99,53,46,115.2
33380, 단양군,010,5~9세,2021,633,325,308,105.5,633,325,308,105.5
33380, 단양군,010001, 5세,2021,108,45,63,71.4,108,45,63,71.4
33380, 단양군,010002, 6세,2021,128,67,61,109.8,128,67,61,109.8
33380, 단양군,010003, 7세,2021,121,69,52,132.7,121,69,52,132.7
33380, 단양군,010004, 8세,2021,114,60,54,111.1,114,60,54,111.1
33380, 단양군,010005, 9세,2021,162,84,78,107.7,162,84,78,107.7
33380, 단양군,015,10~14세,2021,857,455,402,113.2,857,455,402,113.2
33380, 단양군,015001, 10세,2021,157,86,71,121.1,157,86,71,121.1
33380, 단양군,015002, 11세,2021,154,82,72,113.9,154,82,72,113.9
33380, 단양군,015003, 12세,2021,169,92,77,119.5,169,92,77,119.5
33380, 단양군,015004, 13세,2021,190,102,88,115.9,190,102,88,115.9
33380, 단양군,015005, 14세,2021,187,93,94,98.9,187,93,94,98.9
33380, 단양군,020,15~19세,2021,923,508,415,122.4,921,507,414,122.5
33380, 단양군,020001, 15세,2021,176,85,91,93.4,176,85,91,93.4
33380, 단양군,020002, 16세,2021,200,117,83,141,199,116,83,139.8
33380, 단양군,020003, 17세,2021,231,131,100,131,231,131,100,131
33380, 단양군,020004, 18세,2021,200,105,95,110.5,199,105,94,111.7
33380, 단양군,020005, 19세,2021,116,70,46,152.2,116,70,46,152.2
33380, 단양군,025,20~24세,2021,784,486,298,163.1,771,486,285,170.5
33380, 단양군,025001, 20세,2021,151,102,49,208.2,150,102,48,212.5
33380, 단양군,025002, 21세,2021,157,98,59,166.1,155,98,57,171.9
33380, 단양군,025003, 22세,2021,142,94,48,195.8,140,94,46,204.3
33380, 단양군,025004, 23세,2021,169,100,69,144.9,167,100,67,149.3
33380, 단양군,025005, 24세,2021,165,92,73,126,159,92,67,137.3
33380, 단양군,030,25~29세,2021,928,530,398,133.2,901,521,380,137.1
33380, 단양군,030001, 25세,2021,201,129,72,179.2,199,127,72,176.4
33380, 단양군,030002, 26세,2021,181,86,95,90.5,171,85,86,98.8
33380, 단양군,030003, 27세,2021,200,117,83,141,195,117,78,150
33380, 단양군,030004, 28세,2021,169,94,75,125.3,166,91,75,121.3
33380, 단양군,030005, 29세,2021,177,104,73,142.5,170,101,69,146.4
33380, 단양군,035,30~34세,2021,834,465,369,126,779,448,331,135.3
33380, 단양군,035001, 30세,2021,159,93,66,140.9,151,93,58,160.3
33380, 단양군,035002, 31세,2021,165,90,75,120,156,89,67,132.8
33380, 단양군,035003, 32세,2021,171,97,74,131.1,159,93,66,140.9
33380, 단양군,035004, 33세,2021,153,91,62,146.8,145,85,60,141.7
33380, 단양군,035005, 34세,2021,186,94,92,102.2,168,88,80,110
33380, 단양군,040,35~39세,2021,961,513,448,114.5,917,492,425,115.8
33380, 단양군,040001, 35세,2021,148,89,59,150.8,139,82,57,143.9
33380, 단양군,040002, 36세,2021,178,85,93,91.4,166,81,85,95.3
33380, 단양군,040003, 37세,2021,185,105,80,131.3,175,100,75,133.3
33380, 단양군,040004, 38세,2021,211,104,107,97.2,203,101,102,99
33380, 단양군,040005, 39세,2021,239,130,109,119.3,234,128,106,120.8
33380, 단양군,045,40~44세,2021,1280,676,604,111.9,1242,663,579,114.5
33380, 단양군,045001, 40세,2021,250,118,132,89.4,242,116,126,92.1
33380, 단양군,045002, 41세,2021,261,150,111,135.1,255,147,108,136.1
33380, 단양군,045003, 42세,2021,268,137,131,104.6,258,135,123,109.8
33380, 단양군,045004, 43세,2021,249,136,113,120.4,243,132,111,118.9
33380, 단양군,045005, 44세,2021,252,135,117,115.4,244,133,111,119.8
33380, 단양군,050,45~49세,2021,1661,910,751,121.2,1641,904,737,122.7
33380, 단양군,050001, 45세,2021,273,154,119,129.4,268,153,115,133
33380, 단양군,050002, 46세,2021,281,155,126,123,280,154,126,122.2
33380, 단양군,050003, 47세,2021,330,173,157,110.2,328,172,156,110.3
33380, 단양군,050004, 48세,2021,385,213,172,123.8,381,211,170,124.1
33380, 단양군,050005, 49세,2021,392,215,177,121.5,384,214,170,125.9
33380, 단양군,055,50~54세,2021,2311,1208,1103,109.5,2295,1204,1091,110.4
33380, 단양군,055001, 50세,2021,428,202,226,89.4,425,202,223,90.6
33380, 단양군,055002, 51세,2021,426,248,178,139.3,426,248,178,139.3
33380, 단양군,055003, 52세,2021,471,265,206,128.6,468,263,205,128.3
33380, 단양군,055004, 53세,2021,524,261,263,99.2,517,259,258,100.4
33380, 단양군,055005, 54세,2021,462,232,230,100.9,459,232,227,102.2
33380, 단양군,060,55~59세,2021,2777,1479,1298,113.9,2755,1469,1286,114.2
33380, 단양군,060001, 55세,2021,520,285,235,121.3,516,284,232,122.4
33380, 단양군,060002, 56세,2021,546,285,261,109.2,538,280,258,108.5
33380, 단양군,060003, 57세,2021,512,273,239,114.2,510,273,237,115.2
33380, 단양군,060004, 58세,2021,539,287,252,113.9,536,286,250,114.4
33380, 단양군,060005, 59세,2021,660,349,311,112.2,655,346,309,112
33380, 단양군,065,60~64세,2021,3686,1883,1803,104.4,3675,1878,1797,104.5
33380, 단양군,065001, 60세,2021,812,432,380,113.7,810,430,380,113.2
33380, 단양군,065002, 61세,2021,749,335,414,80.9,745,334,411,81.3
33380, 단양군,065003, 62세,2021,684,349,335,104.2,684,349,335,104.2
33380, 단양군,065004, 63세,2021,695,358,337,106.2,694,357,337,105.9
33380, 단양군,065005, 64세,2021,746,409,337,121.4,742,408,334,122.2
33380, 단양군,070,65~69세,2021,2832,1465,1367,107.2,2822,1460,1362,107.2
33380, 단양군,070001, 65세,2021,609,325,284,114.4,607,324,283,114.5
33380, 단양군,070002, 66세,2021,637,322,315,102.2,633,320,313,102.2
33380, 단양군,070003, 67세,2021,580,305,275,110.9,578,304,274,110.9
33380, 단양군,070004, 68세,2021,450,222,228,97.4,450,222,228,97.4
33380, 단양군,070005, 69세,2021,556,291,265,109.8,554,290,264,109.8
33380, 단양군,075,70~74세,2021,1966,938,1028,91.2,1963,937,1026,91.3
33380, 단양군,075001, 70세,2021,340,168,172,97.7,340,168,172,97.7
33380, 단양군,075002, 71세,2021,379,168,211,79.6,379,168,211,79.6
33380, 단양군,075003, 72세,2021,426,220,206,106.8,424,219,205,106.8
33380, 단양군,075004, 73세,2021,430,201,229,87.8,430,201,229,87.8
33380, 단양군,075005, 74세,2021,391,181,210,86.2,390,181,209,86.6
33380, 단양군,080,75~79세,2021,1687,678,1009,67.2,1687,678,1009,67.2
33380, 단양군,080001, 75세,2021,281,121,160,75.6,281,121,160,75.6
33380, 단양군,080002, 76세,2021,319,130,189,68.8,319,130,189,68.8
33380, 단양군,080003, 77세,2021,349,135,214,63.1,349,135,214,63.1
33380, 단양군,080004, 78세,2021,344,138,206,67,344,138,206,67
33380, 단양군,080005, 79세,2021,394,154,240,64.2,394,154,240,64.2
33380, 단양군,085,80~84세,2021,1407,547,860,63.6,1407,547,860,63.6
33380, 단양군,085001, 80세,2021,340,158,182,86.8,340,158,182,86.8
33380, 단양군,085002, 81세,2021,297,109,188,58,297,109,188,58
33380, 단양군,085003, 82세,2021,293,119,174,68.4,293,119,174,68.4
33380, 단양군,085004, 83세,2021,265,76,189,40.2,265,76,189,40.2
33380, 단양군,085005, 84세,2021,212,85,127,66.9,212,85,127,66.9
33380, 단양군,090,85~89세,2021,704,219,485,45.2,704,219,485,45.2
33380, 단양군,090001, 85세,2021,193,64,129,49.6,193,64,129,49.6
33380, 단양군,090002, 86세,2021,174,51,123,41.5,174,51,123,41.5
33380, 단양군,090003, 87세,2021,136,42,94,44.7,136,42,94,44.7
33380, 단양군,090004, 88세,2021,107,36,71,50.7,107,36,71,50.7
33380, 단양군,090005, 89세,2021,94,26,68,38.2,94,26,68,38.2
33380, 단양군,095,90~94세,2021,229,58,171,33.9,229,58,171,33.9
33380, 단양군,095001, 90세,2021,54,16,38,42.1,54,16,38,42.1
33380, 단양군,095002, 91세,2021,80,20,60,33.3,80,20,60,33.3
33380, 단양군,095003, 92세,2021,44,14,30,46.7,44,14,30,46.7
33380, 단양군,095004, 93세,2021,30,5,25,20,30,5,25,20
33380, 단양군,095005, 94세,2021,21,X,18,16.7,21,X,18,16.7
33380, 단양군,100,95~99세,2021,39,10,29,34.5,38,10,28,35.7
33380, 단양군,100001, 95세,2021,9,X,6,50,9,X,6,50
33380, 단양군,100002, 96세,2021,8,X,7,14.3,7,X,6,16.7
33380, 단양군,100003, 97세,2021,10,5,5,100,10,5,5,100
33380, 단양군,100004, 98세,2021,6,X,5,20,6,X,5,20
33380, 단양군,100005, 99세,2021,6,X,6,0,6,X,6,0
33380, 단양군,101,100세이상,2021,11,X,9,22.2,11,X,9,22.2
33380, 단양군,102,15세미만,2021,1917,1009,908,111.1,1917,1009,908,111.1
33380, 단양군,103,15~64세,2021,16145,8658,7487,115.6,15897,8572,7325,117
33380, 단양군,104,65세이상,2021,8875,3917,4958,79,8861,3911,4950,79
33380, 단양군,086,85세이상,2021,983,289,694,41.6,982,289,693,41.7
33380, 단양군,126,평균연령,2021,53.9,52,55.9,,54,52,56.1,
33380, 단양군,127,중위연령,2021,58.5,56.7,60.2,,58.7,56.8,60.4,
33390, 증평군,000,합계,2021,36652,18950,17702,107.1,35411,18305,17106,107
33390, 증평군,005,0~4세,2021,1228,645,583,110.6,1215,639,576,110.9
33390, 증평군,005001, 0세,2021,181,93,88,105.7,180,93,87,106.9
33390, 증평군,005002, 1세,2021,210,120,90,133.3,206,117,89,131.5
33390, 증평군,005003, 2세,2021,263,137,126,108.7,261,136,125,108.8
33390, 증평군,005004, 3세,2021,284,134,150,89.3,281,133,148,89.9
33390, 증평군,005005, 4세,2021,290,161,129,124.8,287,160,127,126
33390, 증평군,010,5~9세,2021,1758,906,852,106.3,1742,900,842,106.9
33390, 증평군,010001, 5세,2021,349,188,161,116.8,341,185,156,118.6
33390, 증평군,010002, 6세,2021,319,168,151,111.3,318,168,150,112
33390, 증평군,010003, 7세,2021,347,162,185,87.6,345,162,183,88.5
33390, 증평군,010004, 8세,2021,385,205,180,113.9,382,203,179,113.4
33390, 증평군,010005, 9세,2021,358,183,175,104.6,356,182,174,104.6
33390, 증평군,015,10~14세,2021,1754,913,841,108.6,1742,909,833,109.1
33390, 증평군,015001, 10세,2021,376,193,183,105.5,371,190,181,105
33390, 증평군,015002, 11세,2021,370,195,175,111.4,368,195,173,112.7
33390, 증평군,015003, 12세,2021,333,182,151,120.5,331,182,149,122.1
33390, 증평군,015004, 13세,2021,349,178,171,104.1,348,178,170,104.7
33390, 증평군,015005, 14세,2021,326,165,161,102.5,324,164,160,102.5
33390, 증평군,020,15~19세,2021,1470,749,721,103.9,1462,746,716,104.2
33390, 증평군,020001, 15세,2021,285,153,132,115.9,283,153,130,117.7
33390, 증평군,020002, 16세,2021,319,170,149,114.1,319,170,149,114.1
33390, 증평군,020003, 17세,2021,264,134,130,103.1,260,132,128,103.1
33390, 증평군,020004, 18세,2021,280,141,139,101.4,280,141,139,101.4
33390, 증평군,020005, 19세,2021,322,151,171,88.3,320,150,170,88.2
33390, 증평군,025,20~24세,2021,2247,1185,1062,111.6,2161,1132,1029,110
33390, 증평군,025001, 20세,2021,422,203,219,92.7,415,201,214,93.9
33390, 증평군,025002, 21세,2021,472,218,254,85.8,458,209,249,83.9
33390, 증평군,025003, 22세,2021,418,218,200,109,402,209,193,108.3
33390, 증평군,025004, 23세,2021,465,272,193,140.9,447,257,190,135.3
33390, 증평군,025005, 24세,2021,470,274,196,139.8,439,256,183,139.9
33390, 증평군,030,25~29세,2021,2438,1498,940,159.4,2266,1397,869,160.8
33390, 증평군,030001, 25세,2021,464,277,187,148.1,427,254,173,146.8
33390, 증평군,030002, 26세,2021,512,310,202,153.5,475,293,182,161
33390, 증평군,030003, 27세,2021,488,318,170,187.1,451,297,154,192.9
33390, 증평군,030004, 28세,2021,521,317,204,155.4,496,301,195,154.4
33390, 증평군,030005, 29세,2021,453,276,177,155.9,417,252,165,152.7
33390, 증평군,035,30~34세,2021,2093,1143,950,120.3,1891,1036,855,121.2
33390, 증평군,035001, 30세,2021,431,241,190,126.8,392,219,173,126.6
33390, 증평군,035002, 31세,2021,404,210,194,108.2,367,193,174,110.9
33390, 증평군,035003, 32세,2021,431,258,173,149.1,379,227,152,149.3
33390, 증평군,035004, 33세,2021,394,204,190,107.4,361,186,175,106.3
33390, 증평군,035005, 34세,2021,433,230,203,113.3,392,211,181,116.6
33390, 증평군,040,35~39세,2021,2535,1392,1143,121.8,2357,1299,1058,122.8
33390, 증평군,040001, 35세,2021,464,244,220,110.9,424,227,197,115.2
33390, 증평군,040002, 36세,2021,446,245,201,121.9,412,228,184,123.9
33390, 증평군,040003, 37세,2021,467,263,204,128.9,424,243,181,134.3
33390, 증평군,040004, 38세,2021,578,331,247,134,551,313,238,131.5
33390, 증평군,040005, 39세,2021,580,309,271,114,546,288,258,111.6
33390, 증평군,045,40~44세,2021,2689,1434,1255,114.3,2577,1379,1198,115.1
33390, 증평군,045001, 40세,2021,522,276,246,112.2,501,268,233,115
33390, 증평군,045002, 41세,2021,571,307,264,116.3,546,297,249,119.3
33390, 증평군,045003, 42세,2021,567,299,268,111.6,541,286,255,112.2
33390, 증평군,045004, 43세,2021,502,266,236,112.7,481,254,227,111.9
33390, 증평군,045005, 44세,2021,527,286,241,118.7,508,274,234,117.1
33390, 증평군,050,45~49세,2021,2760,1489,1271,117.2,2674,1449,1225,118.3
33390, 증평군,050001, 45세,2021,496,256,240,106.7,478,251,227,110.6
33390, 증평군,050002, 46세,2021,521,293,228,128.5,500,281,219,128.3
33390, 증평군,050003, 47세,2021,618,345,273,126.4,603,336,267,125.8
33390, 증평군,050004, 48세,2021,580,315,265,118.9,563,306,257,119.1
33390, 증평군,050005, 49세,2021,545,280,265,105.7,530,275,255,107.8
33390, 증평군,055,50~54세,2021,3133,1636,1497,109.3,3020,1585,1435,110.5
33390, 증평군,055001, 50세,2021,616,329,287,114.6,603,324,279,116.1
33390, 증평군,055002, 51세,2021,573,304,269,113,547,290,257,112.8
33390, 증평군,055003, 52세,2021,680,347,333,104.2,650,335,315,106.3
33390, 증평군,055004, 53세,2021,644,338,306,110.5,618,324,294,110.2
33390, 증평군,055005, 54세,2021,620,318,302,105.3,602,312,290,107.6
33390, 증평군,060,55~59세,2021,2864,1520,1344,113.1,2767,1472,1295,113.7
33390, 증평군,060001, 55세,2021,578,303,275,110.2,557,293,264,111
33390, 증평군,060002, 56세,2021,580,297,283,104.9,564,290,274,105.8
33390, 증평군,060003, 57세,2021,509,278,231,120.3,490,268,222,120.7
33390, 증평군,060004, 58세,2021,559,305,254,120.1,534,290,244,118.9
33390, 증평군,060005, 59세,2021,638,337,301,112,622,331,291,113.7
33390, 증평군,065,60~64세,2021,3030,1554,1476,105.3,2951,1514,1437,105.4
33390, 증평군,065001, 60세,2021,678,331,347,95.4,665,325,340,95.6
33390, 증평군,065002, 61세,2021,632,330,302,109.3,619,324,295,109.8
33390, 증평군,065003, 62세,2021,586,317,269,117.8,563,308,255,120.8
33390, 증평군,065004, 63세,2021,530,263,267,98.5,518,253,265,95.5
33390, 증평군,065005, 64세,2021,604,313,291,107.6,586,304,282,107.8
33390, 증평군,070,65~69세,2021,2239,1085,1154,94,2205,1064,1141,93.3
33390, 증평군,070001, 65세,2021,508,238,270,88.1,501,235,266,88.3
33390, 증평군,070002, 66세,2021,480,230,250,92,474,225,249,90.4
33390, 증평군,070003, 67세,2021,448,220,228,96.5,438,214,224,95.5
33390, 증평군,070004, 68세,2021,362,180,182,98.9,355,175,180,97.2
33390, 증평군,070005, 69세,2021,441,217,224,96.9,437,215,222,96.8
33390, 증평군,075,70~74세,2021,1448,702,746,94.1,1427,690,737,93.6
33390, 증평군,075001, 70세,2021,295,147,148,99.3,287,142,145,97.9
33390, 증평군,075002, 71세,2021,283,145,138,105.1,277,141,136,103.7
33390, 증평군,075003, 72세,2021,267,126,141,89.4,264,124,140,88.6
33390, 증평군,075004, 73세,2021,307,146,161,90.7,307,146,161,90.7
33390, 증평군,075005, 74세,2021,296,138,158,87.3,292,137,155,88.4
33390, 증평군,080,75~79세,2021,1235,525,710,73.9,1230,523,707,74
33390, 증평군,080001, 75세,2021,223,107,116,92.2,220,106,114,93
33390, 증평군,080002, 76세,2021,238,110,128,85.9,238,110,128,85.9
33390, 증평군,080003, 77세,2021,231,99,132,75,230,98,132,74.2
33390, 증평군,080004, 78세,2021,269,101,168,60.1,269,101,168,60.1
33390, 증평군,080005, 79세,2021,274,108,166,65.1,273,108,165,65.5
33390, 증평군,085,80~84세,2021,989,384,605,63.5,985,382,603,63.3
33390, 증평군,085001, 80세,2021,237,90,147,61.2,236,89,147,60.5
33390, 증평군,085002, 81세,2021,201,89,112,79.5,201,89,112,79.5
33390, 증평군,085003, 82세,2021,199,74,125,59.2,198,73,125,58.4
33390, 증평군,085004, 83세,2021,197,66,131,50.4,195,66,129,51.2
33390, 증평군,085005, 84세,2021,155,65,90,72.2,155,65,90,72.2
33390, 증평군,090,85~89세,2021,555,148,407,36.4,552,147,405,36.3
33390, 증평군,090001, 85세,2021,155,52,103,50.5,154,52,102,51
33390, 증평군,090002, 86세,2021,139,37,102,36.3,139,37,102,36.3
33390, 증평군,090003, 87세,2021,103,32,71,45.1,102,31,71,43.7
33390, 증평군,090004, 88세,2021,93,19,74,25.7,93,19,74,25.7
33390, 증평군,090005, 89세,2021,65,8,57,14,64,8,56,14.3
33390, 증평군,095,90~94세,2021,155,37,118,31.4,155,37,118,31.4
33390, 증평군,095001, 90세,2021,46,11,35,31.4,46,11,35,31.4
33390, 증평군,095002, 91세,2021,42,10,32,31.3,42,10,32,31.3
33390, 증평군,095003, 92세,2021,30,8,22,36.4,30,8,22,36.4
33390, 증평군,095004, 93세,2021,19,X,17,11.8,19,X,17,11.8
33390, 증평군,095005, 94세,2021,18,6,12,50,18,6,12,50
33390, 증평군,100,95~99세,2021,30,5,25,20,30,5,25,20
33390, 증평군,100001, 95세,2021,12,X,9,33.3,12,X,9,33.3
33390, 증평군,100002, 96세,2021,6,X,6,0,6,X,6,0
33390, 증평군,100003, 97세,2021,5,X,5,0,5,X,5,0
33390, 증평군,100004, 98세,2021,X,X,X,0,X,X,X,0
33390, 증평군,100005, 99세,2021,X,X,X,200,X,X,X,200
33390, 증평군,101,100세이상,2021,X,X,X,0,X,X,X,0
33390, 증평군,102,15세미만,2021,4740,2464,2276,108.3,4699,2448,2251,108.8
33390, 증평군,103,15~64세,2021,25259,13600,11659,116.6,24126,13009,11117,117
33390, 증평군,104,65세이상,2021,6653,2886,3767,76.6,6586,2848,3738,76.2
33390, 증평군,086,85세이상,2021,742,190,552,34.4,739,189,550,34.4
33390, 증평군,126,평균연령,2021,43.9,42.5,45.3,,44,42.6,45.5,
33390, 증평군,127,중위연령,2021,45.2,43.6,47.1,,45.6,44,47.5,
34,충청남도,000,합계,2021,2175960,1116818,1059142,105.4,2077348,1059208,1018140,104
34,충청남도,005,0~4세,2021,68991,35349,33642,105.1,67041,34393,32648,105.3
34,충청남도,005001, 0세,2021,11564,6020,5544,108.6,11195,5836,5359,108.9
34,충청남도,005002, 1세,2021,12591,6451,6140,105.1,12225,6281,5944,105.7
34,충청남도,005003, 2세,2021,13710,6967,6743,103.3,13326,6772,6554,103.3
34,충청남도,005004, 3세,2021,14882,7545,7337,102.8,14473,7346,7127,103.1
34,충청남도,005005, 4세,2021,16244,8366,7878,106.2,15822,8158,7664,106.4
34,충청남도,010,5~9세,2021,96901,49566,47335,104.7,95193,48687,46506,104.7
34,충청남도,010001, 5세,2021,18175,9231,8944,103.2,17734,9024,8710,103.6
34,충청남도,010002, 6세,2021,19279,9851,9428,104.5,18911,9672,9239,104.7
34,충청남도,010003, 7세,2021,18905,9731,9174,106.1,18586,9547,9039,105.6
34,충청남도,010004, 8세,2021,19491,9955,9536,104.4,19220,9806,9414,104.2
34,충청남도,010005, 9세,2021,21051,10798,10253,105.3,20742,10638,10104,105.3
34,충청남도,015,10~14세,2021,101779,52812,48967,107.9,100703,52247,48456,107.8
34,충청남도,015001, 10세,2021,20868,10804,10064,107.4,20623,10697,9926,107.8
34,충청남도,015002, 11세,2021,20279,10564,9715,108.7,20039,10428,9611,108.5
34,충청남도,015003, 12세,2021,19434,10087,9347,107.9,19225,9976,9249,107.9
34,충청남도,015004, 13세,2021,20470,10541,9929,106.2,20279,10435,9844,106
34,충청남도,015005, 14세,2021,20728,10816,9912,109.1,20537,10711,9826,109
34,충청남도,020,15~19세,2021,102279,53049,49230,107.8,100723,52286,48437,107.9
34,충청남도,020001, 15세,2021,19091,9846,9245,106.5,18933,9763,9170,106.5
34,충청남도,020002, 16세,2021,18518,9554,8964,106.6,18380,9473,8907,106.4
34,충청남도,020003, 17세,2021,20481,10748,9733,110.4,20299,10666,9633,110.7
34,충청남도,020004, 18세,2021,20808,10906,9902,110.1,20512,10753,9759,110.2
34,충청남도,020005, 19세,2021,23381,11995,11386,105.3,22599,11631,10968,106
34,충청남도,025,20~24세,2021,133478,71315,62163,114.7,123739,66129,57610,114.8
34,충청남도,025001, 20세,2021,26123,13060,13063,100,24810,12468,12342,101
34,충청남도,025002, 21세,2021,27750,14159,13591,104.2,26119,13380,12739,105
34,충청남도,025003, 22세,2021,26830,14294,12536,114,24889,13280,11609,114.4
34,충청남도,025004, 23세,2021,26572,14940,11632,128.4,24189,13617,10572,128.8
34,충청남도,025005, 24세,2021,26203,14862,11341,131,23732,13384,10348,129.3
34,충청남도,030,25~29세,2021,134304,77079,57225,134.7,119588,67645,51943,130.2
34,충청남도,030001, 25세,2021,26220,15065,11155,135.1,23525,13383,10142,132
34,충청남도,030002, 26세,2021,26168,15157,11011,137.7,23290,13356,9934,134.4
34,충청남도,030003, 27세,2021,26538,15467,11071,139.7,23536,13535,10001,135.3
34,충청남도,030004, 28세,2021,27422,15563,11859,131.2,24410,13587,10823,125.5
34,충청남도,030005, 29세,2021,27956,15827,12129,130.5,24827,13784,11043,124.8
34,충청남도,035,30~34세,2021,132294,73946,58348,126.7,115955,63548,52407,121.3
34,충청남도,035001, 30세,2021,26166,14884,11282,131.9,23025,12870,10155,126.7
34,충청남도,035002, 31세,2021,26172,14770,11402,129.5,22859,12650,10209,123.9
34,충청남도,035003, 32세,2021,26117,14761,11356,130,22832,12631,10201,123.8
34,충청남도,035004, 33세,2021,26581,14644,11937,122.7,23284,12585,10699,117.6
34,충청남도,035005, 34세,2021,27258,14887,12371,120.3,23955,12812,11143,115
34,충청남도,040,35~39세,2021,151521,82072,69449,118.2,137511,73270,64241,114.1
34,충청남도,040001, 35세,2021,27437,15004,12433,120.7,24403,13112,11291,116.1
34,충청남도,040002, 36세,2021,27676,15105,12571,120.2,24710,13256,11454,115.7
34,충청남도,040003, 37세,2021,29108,15656,13452,116.4,26382,13955,12427,112.3
34,충청남도,040004, 38세,2021,32041,17346,14695,118,29391,15642,13749,113.8
34,충청남도,040005, 39세,2021,35259,18961,16298,116.3,32625,17305,15320,113
34,충청남도,045,40~44세,2021,165136,88911,76225,116.6,155136,82749,72387,114.3
34,충청남도,045001, 40세,2021,34317,18647,15670,119,32055,17260,14795,116.7
34,충청남도,045002, 41세,2021,35378,18959,16419,115.5,33243,17610,15633,112.6
34,충청남도,045003, 42세,2021,33166,17717,15449,114.7,31022,16378,14644,111.8
34,충청남도,045004, 43세,2021,30673,16705,13968,119.6,28844,15591,13253,117.6
34,충청남도,045005, 44세,2021,31602,16883,14719,114.7,29972,15910,14062,113.1
34,충청남도,050,45~49세,2021,167069,88887,78182,113.7,159125,84189,74936,112.3
34,충청남도,050001, 45세,2021,30825,16340,14485,112.8,29178,15354,13824,111.1
34,충청남도,050002, 46세,2021,32145,16913,15232,111,30554,15954,14600,109.3
34,충청남도,050003, 47세,2021,35259,18858,16401,115,33730,17946,15784,113.7
34,충청남도,050004, 48세,2021,34975,18565,16410,113.1,33490,17709,15781,112.2
34,충청남도,050005, 49세,2021,33865,18211,15654,116.3,32173,17226,14947,115.2
34,충청남도,055,50~54세,2021,178200,94286,83914,112.4,171305,90520,80785,112.1
34,충청남도,055001, 50세,2021,37060,19991,17069,117.1,35469,19087,16382,116.5
34,충청남도,055002, 51세,2021,35037,18710,16327,114.6,33510,17887,15623,114.5
34,충청남도,055003, 52세,2021,36964,19529,17435,112,35569,18776,16793,111.8
34,충청남도,055004, 53세,2021,36182,18856,17326,108.8,34871,18145,16726,108.5
34,충청남도,055005, 54세,2021,32957,17200,15757,109.2,31886,16625,15261,108.9
34,충청남도,060,55~59세,2021,163026,85599,77427,110.6,157321,82751,74570,111
34,충청남도,060001, 55세,2021,30474,16150,14324,112.7,29317,15578,13739,113.4
34,충청남도,060002, 56세,2021,34819,18219,16600,109.8,33566,17582,15984,110
34,충청남도,060003, 57세,2021,31114,16224,14890,109,30026,15658,14368,109
34,충청남도,060004, 58세,2021,32310,16979,15331,110.7,31056,16367,14689,111.4
34,충청남도,060005, 59세,2021,34309,18027,16282,110.7,33356,17566,15790,111.2
34,충청남도,065,60~64세,2021,169640,85800,83840,102.3,166177,84108,82069,102.5
34,충청남도,065001, 60세,2021,38860,19994,18866,106,38230,19676,18554,106
34,충청남도,065002, 61세,2021,37936,19011,18925,100.5,37090,18628,18462,100.9
34,충청남도,065003, 62세,2021,32559,16280,16279,100,31897,15963,15934,100.2
34,충청남도,065004, 63세,2021,30121,15118,15003,100.8,29451,14782,14669,100.8
34,충청남도,065005, 64세,2021,30164,15397,14767,104.3,29509,15059,14450,104.2
34,충청남도,070,65~69세,2021,125219,61426,63793,96.3,123226,60523,62703,96.5
34,충청남도,070001, 65세,2021,27850,13889,13961,99.5,27320,13649,13671,99.8
34,충청남도,070002, 66세,2021,29243,14420,14823,97.3,28765,14202,14563,97.5
34,충청남도,070003, 67세,2021,24608,11957,12651,94.5,24214,11787,12427,94.8
34,충청남도,070004, 68세,2021,20305,9957,10348,96.2,19996,9817,10179,96.4
34,충청남도,070005, 69세,2021,23213,11203,12010,93.3,22931,11068,11863,93.3
34,충청남도,075,70~74세,2021,95159,45517,49642,91.7,94331,45168,49163,91.9
34,충청남도,075001, 70세,2021,17883,8685,9198,94.4,17656,8580,9076,94.5
34,충청남도,075002, 71세,2021,20169,9599,10570,90.8,19993,9527,10466,91
34,충청남도,075003, 72세,2021,20108,9705,10403,93.3,19924,9626,10298,93.5
34,충청남도,075004, 73세,2021,18656,8914,9742,91.5,18538,8865,9673,91.6
34,충청남도,075005, 74세,2021,18343,8614,9729,88.5,18220,8570,9650,88.8
34,충청남도,080,75~79세,2021,74383,32049,42334,75.7,74023,31929,42094,75.9
34,충청남도,080001, 75세,2021,13206,6367,6839,93.1,13112,6336,6776,93.5
34,충청남도,080002, 76세,2021,13215,5866,7349,79.8,13137,5844,7293,80.1
34,충청남도,080003, 77세,2021,14603,6178,8425,73.3,14522,6152,8370,73.5
34,충청남도,080004, 78세,2021,14636,6150,8486,72.5,14584,6129,8455,72.5
34,충청남도,080005, 79세,2021,18723,7488,11235,66.6,18668,7468,11200,66.7
34,충청남도,085,80~84세,2021,62909,23388,39521,59.2,62680,23331,39349,59.3
34,충청남도,085001, 80세,2021,13676,5345,8331,64.2,13619,5326,8293,64.2
34,충청남도,085002, 81세,2021,12492,4788,7704,62.1,12447,4778,7669,62.3
34,충청남도,085003, 82세,2021,13541,5007,8534,58.7,13500,5000,8500,58.8
34,충청남도,085004, 83세,2021,12128,4322,7806,55.4,12077,4309,7768,55.5
34,충청남도,085005, 84세,2021,11072,3926,7146,54.9,11037,3918,7119,55
34,충청남도,090,85~89세,2021,38580,12293,26287,46.8,38506,12269,26237,46.8
34,충청남도,090001, 85세,2021,10101,3466,6635,52.2,10082,3462,6620,52.3
34,충청남도,090002, 86세,2021,9383,3021,6362,47.5,9362,3013,6349,47.5
34,충청남도,090003, 87세,2021,7467,2405,5062,47.5,7455,2400,5055,47.5
34,충청남도,090004, 88세,2021,6219,1852,4367,42.4,6207,1848,4359,42.4
34,충청남도,090005, 89세,2021,5410,1549,3861,40.1,5400,1546,3854,40.1
34,충청남도,095,90~94세,2021,12176,2933,9243,31.7,12154,2927,9227,31.7
34,충청남도,095001, 90세,2021,3543,909,2634,34.5,3538,909,2629,34.6
34,충청남도,095002, 91세,2021,3020,742,2278,32.6,3012,741,2271,32.6
34,충청남도,095003, 92세,2021,2462,583,1879,31,2458,579,1879,30.8
34,충청남도,095004, 93세,2021,1858,393,1465,26.8,1856,392,1464,26.8
34,충청남도,095005, 94세,2021,1293,306,987,31,1290,306,984,31.1
34,충청남도,100,95~99세,2021,2535,482,2053,23.5,2531,481,2050,23.5
34,충청남도,100001, 95세,2021,859,169,690,24.5,859,169,690,24.5
34,충청남도,100002, 96세,2021,628,138,490,28.2,627,138,489,28.2
34,충청남도,100003, 97세,2021,402,73,329,22.2,401,73,328,22.3
34,충청남도,100004, 98세,2021,389,67,322,20.8,388,67,321,20.9
34,충청남도,100005, 99세,2021,257,35,222,15.8,256,34,222,15.3
34,충청남도,101,100세이상,2021,381,59,322,18.3,380,58,322,18
34,충청남도,102,15세미만,2021,267671,137727,129944,106,262937,135327,127610,106
34,충청남도,103,15~64세,2021,1496947,800944,696003,115.1,1406580,747195,659385,113.3
34,충청남도,104,65세이상,2021,411342,178147,233195,76.4,407831,176686,231145,76.4
34,충청남도,086,85세이상,2021,53672,15767,37905,41.6,53571,15735,37836,41.6
34,충청남도,126,평균연령,2021,44.1,42.8,45.6,,44.4,43.1,45.9,
34,충청남도,127,중위연령,2021,45,43.5,46.8,,45.8,44.3,47.4,
34004, 읍부,000,합계,2021,506877,260947,245930,106.1,487274,249394,237880,104.8
34004, 읍부,005,0~4세,2021,15718,8032,7686,104.5,15450,7889,7561,104.3
34004, 읍부,005001, 0세,2021,2662,1403,1259,111.4,2603,1370,1233,111.1
34004, 읍부,005002, 1세,2021,2852,1473,1379,106.8,2804,1451,1353,107.2
34004, 읍부,005003, 2세,2021,3136,1592,1544,103.1,3081,1560,1521,102.6
34004, 읍부,005004, 3세,2021,3331,1676,1655,101.3,3282,1651,1631,101.2
34004, 읍부,005005, 4세,2021,3737,1888,1849,102.1,3680,1857,1823,101.9
34004, 읍부,010,5~9세,2021,22583,11669,10914,106.9,22350,11540,10810,106.8
34004, 읍부,010001, 5세,2021,4101,2066,2035,101.5,4047,2036,2011,101.2
34004, 읍부,010002, 6세,2021,4482,2357,2125,110.9,4434,2330,2104,110.7
34004, 읍부,010003, 7세,2021,4365,2266,2099,108,4312,2235,2077,107.6
34004, 읍부,010004, 8세,2021,4547,2379,2168,109.7,4503,2355,2148,109.6
34004, 읍부,010005, 9세,2021,5088,2601,2487,104.6,5054,2584,2470,104.6
34004, 읍부,015,10~14세,2021,24697,12867,11830,108.8,24537,12779,11758,108.7
34004, 읍부,015001, 10세,2021,4975,2574,2401,107.2,4941,2559,2382,107.4
34004, 읍부,015002, 11세,2021,4873,2546,2327,109.4,4834,2519,2315,108.8
34004, 읍부,015003, 12세,2021,4747,2496,2251,110.9,4710,2479,2231,111.1
34004, 읍부,015004, 13세,2021,4997,2592,2405,107.8,4976,2579,2397,107.6
34004, 읍부,015005, 14세,2021,5105,2659,2446,108.7,5076,2643,2433,108.6
34004, 읍부,020,15~19세,2021,25333,13137,12196,107.7,25087,13003,12084,107.6
34004, 읍부,020001, 15세,2021,4612,2366,2246,105.3,4594,2355,2239,105.2
34004, 읍부,020002, 16세,2021,4610,2354,2256,104.3,4581,2335,2246,104
34004, 읍부,020003, 17세,2021,5335,2757,2578,106.9,5300,2740,2560,107
34004, 읍부,020004, 18세,2021,5322,2854,2468,115.6,5277,2828,2449,115.5
34004, 읍부,020005, 19세,2021,5454,2806,2648,106,5335,2745,2590,106
34004, 읍부,025,20~24세,2021,29497,16265,13232,122.9,27636,15284,12352,123.7
34004, 읍부,025001, 20세,2021,6038,3064,2974,103,5742,2940,2802,104.9
34004, 읍부,025002, 21세,2021,6315,3333,2982,111.8,5976,3169,2807,112.9
34004, 읍부,025003, 22세,2021,5883,3282,2601,126.2,5543,3112,2431,128
34004, 읍부,025004, 23세,2021,5731,3345,2386,140.2,5299,3104,2195,141.4
34004, 읍부,025005, 24세,2021,5530,3241,2289,141.6,5076,2959,2117,139.8
34004, 읍부,030,25~29세,2021,28231,16492,11739,140.5,25212,14507,10705,135.5
34004, 읍부,030001, 25세,2021,5506,3237,2269,142.7,4965,2888,2077,139
34004, 읍부,030002, 26세,2021,5532,3302,2230,148.1,4974,2926,2048,142.9
34004, 읍부,030003, 27세,2021,5536,3284,2252,145.8,4922,2871,2051,140
34004, 읍부,030004, 28세,2021,5716,3277,2439,134.4,5085,2875,2210,130.1
34004, 읍부,030005, 29세,2021,5941,3392,2549,133.1,5266,2947,2319,127.1
34004, 읍부,035,30~34세,2021,28398,15761,12637,124.7,25078,13655,11423,119.5
34004, 읍부,035001, 30세,2021,5572,3158,2414,130.8,4959,2785,2174,128.1
34004, 읍부,035002, 31세,2021,5565,3115,2450,127.1,4877,2685,2192,122.5
34004, 읍부,035003, 32세,2021,5641,3165,2476,127.8,4976,2739,2237,122.4
34004, 읍부,035004, 33세,2021,5775,3169,2606,121.6,5088,2722,2366,115
34004, 읍부,035005, 34세,2021,5845,3154,2691,117.2,5178,2724,2454,111
34004, 읍부,040,35~39세,2021,33834,18236,15598,116.9,30944,16372,14572,112.4
34004, 읍부,040001, 35세,2021,5952,3265,2687,121.5,5314,2849,2465,115.6
34004, 읍부,040002, 36세,2021,6148,3333,2815,118.4,5505,2930,2575,113.8
34004, 읍부,040003, 37세,2021,6571,3545,3026,117.2,6029,3212,2817,114
34004, 읍부,040004, 38세,2021,7203,3893,3310,117.6,6645,3516,3129,112.4
34004, 읍부,040005, 39세,2021,7960,4200,3760,111.7,7451,3865,3586,107.8
34004, 읍부,045,40~44세,2021,38681,20843,17838,116.8,36721,19663,17058,115.3
34004, 읍부,045001, 40세,2021,7781,4282,3499,122.4,7327,4014,3313,121.2
34004, 읍부,045002, 41세,2021,8231,4405,3826,115.1,7814,4148,3666,113.1
34004, 읍부,045003, 42세,2021,7792,4150,3642,113.9,7387,3905,3482,112.1
34004, 읍부,045004, 43세,2021,7317,3971,3346,118.7,6948,3751,3197,117.3
34004, 읍부,045005, 44세,2021,7560,4035,3525,114.5,7245,3845,3400,113.1
34004, 읍부,050,45~49세,2021,40521,21751,18770,115.9,38901,20818,18083,115.1
34004, 읍부,050001, 45세,2021,7356,3945,3411,115.7,7045,3766,3279,114.9
34004, 읍부,050002, 46세,2021,7804,4111,3693,111.3,7473,3915,3558,110
34004, 읍부,050003, 47세,2021,8475,4534,3941,115,8163,4356,3807,114.4
34004, 읍부,050004, 48세,2021,8534,4615,3919,117.8,8222,4436,3786,117.2
34004, 읍부,050005, 49세,2021,8352,4546,3806,119.4,7998,4345,3653,118.9
34004, 읍부,055,50~54세,2021,42745,23033,19712,116.8,41327,22254,19073,116.7
34004, 읍부,055001, 50세,2021,8983,4898,4085,119.9,8658,4710,3948,119.3
34004, 읍부,055002, 51세,2021,8540,4629,3911,118.4,8207,4446,3761,118.2
34004, 읍부,055003, 52세,2021,8829,4746,4083,116.2,8548,4592,3956,116.1
34004, 읍부,055004, 53세,2021,8647,4624,4023,114.9,8370,4471,3899,114.7
34004, 읍부,055005, 54세,2021,7746,4136,3610,114.6,7544,4035,3509,115
34004, 읍부,060,55~59세,2021,38445,20351,18094,112.5,37304,19799,17505,113.1
34004, 읍부,060001, 55세,2021,7275,3897,3378,115.4,7059,3793,3266,116.1
34004, 읍부,060002, 56세,2021,8265,4348,3917,111,7999,4211,3788,111.2
34004, 읍부,060003, 57세,2021,7340,3850,3490,110.3,7118,3743,3375,110.9
34004, 읍부,060004, 58세,2021,7566,3993,3573,111.8,7337,3891,3446,112.9
34004, 읍부,060005, 59세,2021,7999,4263,3736,114.1,7791,4161,3630,114.6
34004, 읍부,065,60~64세,2021,40435,20329,20106,101.1,39705,19960,19745,101.1
34004, 읍부,065001, 60세,2021,9189,4690,4499,104.2,9062,4619,4443,104
34004, 읍부,065002, 61세,2021,8985,4494,4491,100.1,8819,4411,4408,100.1
34004, 읍부,065003, 62세,2021,7753,3829,3924,97.6,7601,3760,3841,97.9
34004, 읍부,065004, 63세,2021,7162,3559,3603,98.8,7015,3488,3527,98.9
34004, 읍부,065005, 64세,2021,7346,3757,3589,104.7,7208,3682,3526,104.4
34004, 읍부,070,65~69세,2021,30058,14455,15603,92.6,29657,14265,15392,92.7
34004, 읍부,070001, 65세,2021,6611,3284,3327,98.7,6506,3237,3269,99
34004, 읍부,070002, 66세,2021,6953,3340,3613,92.4,6860,3292,3568,92.3
34004, 읍부,070003, 67세,2021,6004,2856,3148,90.7,5924,2823,3101,91
34004, 읍부,070004, 68세,2021,4883,2350,2533,92.8,4811,2317,2494,92.9
34004, 읍부,070005, 69세,2021,5607,2625,2982,88,5556,2596,2960,87.7
34004, 읍부,075,70~74세,2021,23353,11024,12329,89.4,23170,10951,12219,89.6
34004, 읍부,075001, 70세,2021,4454,2118,2336,90.7,4399,2094,2305,90.8
34004, 읍부,075002, 71세,2021,4877,2270,2607,87.1,4840,2251,2589,86.9
34004, 읍부,075003, 72세,2021,4840,2294,2546,90.1,4799,2280,2519,90.5
34004, 읍부,075004, 73세,2021,4651,2209,2442,90.5,4632,2202,2430,90.6
34004, 읍부,075005, 74세,2021,4531,2133,2398,88.9,4500,2124,2376,89.4
34004, 읍부,080,75~79세,2021,17904,7802,10102,77.2,17825,7773,10052,77.3
34004, 읍부,080001, 75세,2021,3328,1600,1728,92.6,3308,1595,1713,93.1
34004, 읍부,080002, 76세,2021,3193,1450,1743,83.2,3178,1449,1729,83.8
34004, 읍부,080003, 77세,2021,3474,1478,1996,74,3460,1473,1987,74.1
34004, 읍부,080004, 78세,2021,3588,1510,2078,72.7,3574,1501,2073,72.4
34004, 읍부,080005, 79세,2021,4321,1764,2557,69,4305,1755,2550,68.8
34004, 읍부,085,80~84세,2021,14352,5373,8979,59.8,14302,5358,8944,59.9
34004, 읍부,085001, 80세,2021,3157,1242,1915,64.9,3143,1238,1905,65
34004, 읍부,085002, 81세,2021,2863,1118,1745,64.1,2854,1116,1738,64.2
34004, 읍부,085003, 82세,2021,3128,1164,1964,59.3,3121,1162,1959,59.3
34004, 읍부,085004, 83세,2021,2740,993,1747,56.8,2728,989,1739,56.9
34004, 읍부,085005, 84세,2021,2464,856,1608,53.2,2456,853,1603,53.2
34004, 읍부,090,85~89세,2021,8613,2728,5885,46.4,8596,2726,5870,46.4
34004, 읍부,090001, 85세,2021,2274,784,1490,52.6,2268,783,1485,52.7
34004, 읍부,090002, 86세,2021,2096,659,1437,45.9,2092,658,1434,45.9
34004, 읍부,090003, 87세,2021,1663,522,1141,45.7,1659,522,1137,45.9
34004, 읍부,090004, 88세,2021,1375,417,958,43.5,1374,417,957,43.6
34004, 읍부,090005, 89세,2021,1205,346,859,40.3,1203,346,857,40.4
34004, 읍부,095,90~94세,2021,2770,670,2100,31.9,2765,669,2096,31.9
34004, 읍부,095001, 90세,2021,811,199,612,32.5,809,199,610,32.6
34004, 읍부,095002, 91세,2021,679,176,503,35,678,176,502,35.1
34004, 읍부,095003, 92세,2021,566,139,427,32.6,566,139,427,32.6
34004, 읍부,095004, 93세,2021,415,85,330,25.8,413,84,329,25.5
34004, 읍부,095005, 94세,2021,299,71,228,31.1,299,71,228,31.1
34004, 읍부,100,95~99세,2021,615,109,506,21.5,613,109,504,21.6
34004, 읍부,100001, 95세,2021,202,41,161,25.5,202,41,161,25.5
34004, 읍부,100002, 96세,2021,159,27,132,20.5,159,27,132,20.5
34004, 읍부,100003, 97세,2021,100,18,82,22,99,18,81,22.2
34004, 읍부,100004, 98세,2021,102,14,88,15.9,101,14,87,16.1
34004, 읍부,100005, 99세,2021,52,9,43,20.9,52,9,43,20.9
34004, 읍부,101,100세이상,2021,94,20,74,27,94,20,74,27
34004, 읍부,102,15세미만,2021,62998,32568,30430,107,62337,32208,30129,106.9
34004, 읍부,103,15~64세,2021,346120,186198,159922,116.4,327915,175315,152600,114.9
34004, 읍부,104,65세이상,2021,97759,42181,55578,75.9,97022,41871,55151,75.9
34004, 읍부,086,85세이상,2021,12092,3527,8565,41.2,12068,3524,8544,41.2
34004, 읍부,126,평균연령,2021,44.4,43,45.9,,44.7,43.3,46.2,
34004, 읍부,127,중위연령,2021,45.9,44.3,47.6,,46.5,45,48,
34005, 면부,000,합계,2021,646390,338364,308026,109.8,600419,308574,291845,105.7
34005, 면부,005,0~4세,2021,13390,6801,6589,103.2,12594,6430,6164,104.3
34005, 면부,005001, 0세,2021,2106,1104,1002,110.2,1947,1032,915,112.8
34005, 면부,005002, 1세,2021,2363,1184,1179,100.4,2210,1110,1100,100.9
34005, 면부,005003, 2세,2021,2720,1370,1350,101.5,2570,1302,1268,102.7
34005, 면부,005004, 3세,2021,3013,1505,1508,99.8,2839,1426,1413,100.9
34005, 면부,005005, 4세,2021,3188,1638,1550,105.7,3028,1560,1468,106.3
34005, 면부,010,5~9세,2021,19341,9945,9396,105.8,18653,9590,9063,105.8
34005, 면부,010001, 5세,2021,3668,1865,1803,103.4,3479,1778,1701,104.5
34005, 면부,010002, 6세,2021,3753,1923,1830,105.1,3609,1857,1752,106
34005, 면부,010003, 7세,2021,3863,1958,1905,102.8,3746,1887,1859,101.5
34005, 면부,010004, 8세,2021,3860,1980,1880,105.3,3752,1915,1837,104.2
34005, 면부,010005, 9세,2021,4197,2219,1978,112.2,4067,2153,1914,112.5
34005, 면부,015,10~14세,2021,21011,10979,10032,109.4,20519,10731,9788,109.6
34005, 면부,015001, 10세,2021,4310,2258,2052,110,4203,2215,1988,111.4
34005, 면부,015002, 11세,2021,4198,2177,2021,107.7,4088,2123,1965,108
34005, 면부,015003, 12세,2021,3988,2125,1863,114.1,3892,2074,1818,114.1
34005, 면부,015004, 13세,2021,4216,2120,2096,101.1,4124,2071,2053,100.9
34005, 면부,015005, 14세,2021,4299,2299,2000,115,4212,2248,1964,114.5
34005, 면부,020,15~19세,2021,22377,11706,10671,109.7,21624,11331,10293,110.1
34005, 면부,020001, 15세,2021,4033,2079,1954,106.4,3970,2044,1926,106.1
34005, 면부,020002, 16세,2021,3853,1968,1885,104.4,3802,1939,1863,104.1
34005, 면부,020003, 17세,2021,4198,2178,2020,107.8,4116,2142,1974,108.5
34005, 면부,020004, 18세,2021,4467,2342,2125,110.2,4314,2260,2054,110
34005, 면부,020005, 19세,2021,5826,3139,2687,116.8,5422,2946,2476,119
34005, 면부,025,20~24세,2021,33175,19052,14123,134.9,28151,16142,12009,134.4
34005, 면부,025001, 20세,2021,6442,3291,3151,104.4,5849,2994,2855,104.9
34005, 면부,025002, 21세,2021,6646,3463,3183,108.8,5923,3104,2819,110.1
34005, 면부,025003, 22세,2021,6730,3884,2846,136.5,5748,3324,2424,137.1
34005, 면부,025004, 23세,2021,6748,4171,2577,161.9,5440,3391,2049,165.5
34005, 면부,025005, 24세,2021,6609,4243,2366,179.3,5191,3329,1862,178.8
34005, 면부,030,25~29세,2021,32114,20733,11381,182.2,23716,14804,8912,166.1
34005, 면부,030001, 25세,2021,6313,4027,2286,176.2,4795,2997,1798,166.7
34005, 면부,030002, 26세,2021,6363,4124,2239,184.2,4676,2964,1712,173.1
34005, 면부,030003, 27세,2021,6367,4144,2223,186.4,4619,2910,1709,170.3
34005, 면부,030004, 28세,2021,6522,4198,2324,180.6,4800,2949,1851,159.3
34005, 면부,030005, 29세,2021,6549,4240,2309,183.6,4826,2984,1842,162
34005, 면부,035,30~34세,2021,31514,19471,12043,161.7,23025,13428,9597,139.9
34005, 면부,035001, 30세,2021,6297,3977,2320,171.4,4570,2731,1839,148.5
34005, 면부,035002, 31세,2021,6345,3974,2371,167.6,4589,2722,1867,145.8
34005, 면부,035003, 32세,2021,6232,3922,2310,169.8,4510,2660,1850,143.8
34005, 면부,035004, 33세,2021,6200,3711,2489,149.1,4535,2571,1964,130.9
34005, 면부,035005, 34세,2021,6440,3887,2553,152.3,4821,2744,2077,132.1
34005, 면부,040,35~39세,2021,34797,20718,14079,147.2,27955,15976,11979,133.4
34005, 면부,040001, 35세,2021,6297,3787,2510,150.9,4831,2773,2058,134.7
34005, 면부,040002, 36세,2021,6470,3850,2620,146.9,5032,2852,2180,130.8
34005, 면부,040003, 37세,2021,6659,3932,2727,144.2,5323,2993,2330,128.5
34005, 면부,040004, 38세,2021,7312,4342,2970,146.2,6002,3424,2578,132.8
34005, 면부,040005, 39세,2021,8059,4807,3252,147.8,6767,3934,2833,138.9
34005, 면부,045,40~44세,2021,37629,22093,15536,142.2,32871,18917,13954,135.6
34005, 면부,045001, 40세,2021,7769,4531,3238,139.9,6631,3766,2865,131.4
34005, 면부,045002, 41세,2021,7924,4675,3249,143.9,6905,3976,2929,135.7
34005, 면부,045003, 42세,2021,7503,4360,3143,138.7,6495,3696,2799,132
34005, 면부,045004, 43세,2021,7110,4201,2909,144.4,6276,3647,2629,138.7
34005, 면부,045005, 44세,2021,7323,4326,2997,144.3,6564,3832,2732,140.3
34005, 면부,050,45~49세,2021,40683,23809,16874,141.1,37234,21566,15668,137.6
34005, 면부,050001, 45세,2021,7378,4326,3052,141.7,6615,3824,2791,137
34005, 면부,050002, 46세,2021,7739,4530,3209,141.2,7016,4055,2961,136.9
34005, 면부,050003, 47세,2021,8561,5035,3526,142.8,7879,4600,3279,140.3
34005, 면부,050004, 48세,2021,8552,4981,3571,139.5,7953,4596,3357,136.9
34005, 면부,050005, 49세,2021,8453,4937,3516,140.4,7771,4491,3280,136.9
34005, 면부,055,50~54세,2021,48086,27002,21084,128.1,45569,25521,20048,127.3
34005, 면부,055001, 50세,2021,9376,5455,3921,139.1,8792,5092,3700,137.6
34005, 면부,055002, 51세,2021,8992,5141,3851,133.5,8446,4835,3611,133.9
34005, 면부,055003, 52세,2021,10087,5682,4405,129,9574,5383,4191,128.4
34005, 면부,055004, 53세,2021,10086,5534,4552,121.6,9624,5262,4362,120.6
34005, 면부,055005, 54세,2021,9545,5190,4355,119.2,9133,4949,4184,118.3
34005, 면부,060,55~59세,2021,52766,28324,24442,115.9,50900,27292,23608,115.6
34005, 면부,060001, 55세,2021,9138,4984,4154,120,8740,4762,3978,119.7
34005, 면부,060002, 56세,2021,10793,5920,4873,121.5,10396,5704,4692,121.6
34005, 면부,060003, 57세,2021,10158,5350,4808,111.3,9799,5139,4660,110.3
34005, 면부,060004, 58세,2021,10695,5742,4953,115.9,10284,5509,4775,115.4
34005, 면부,060005, 59세,2021,11982,6328,5654,111.9,11681,6178,5503,112.3
34005, 면부,065,60~64세,2021,65114,33242,31872,104.3,64136,32739,31397,104.3
34005, 면부,065001, 60세,2021,14208,7312,6896,106,14021,7220,6801,106.2
34005, 면부,065002, 61세,2021,14377,7304,7073,103.3,14134,7183,6951,103.3
34005, 면부,065003, 62세,2021,12526,6397,6129,104.4,12344,6308,6036,104.5
34005, 면부,065004, 63세,2021,11939,6025,5914,101.9,11735,5914,5821,101.6
34005, 면부,065005, 64세,2021,12064,6204,5860,105.9,11902,6114,5788,105.6
34005, 면부,070,65~69세,2021,53334,26810,26524,101.1,52817,26582,26235,101.3
34005, 면부,070001, 65세,2021,11588,5898,5690,103.7,11446,5837,5609,104.1
34005, 면부,070002, 66세,2021,12306,6229,6077,102.5,12177,6169,6008,102.7
34005, 면부,070003, 67세,2021,10565,5268,5297,99.5,10458,5218,5240,99.6
34005, 면부,070004, 68세,2021,8790,4381,4409,99.4,8721,4350,4371,99.5
34005, 면부,070005, 69세,2021,10085,5034,5051,99.7,10015,5008,5007,100
34005, 면부,075,70~74세,2021,43201,21217,21984,96.5,42988,21124,21864,96.6
34005, 면부,075001, 70세,2021,8063,3971,4092,97,8011,3948,4063,97.2
34005, 면부,075002, 71세,2021,9153,4513,4640,97.3,9096,4488,4608,97.4
34005, 면부,075003, 72세,2021,9219,4594,4625,99.3,9173,4575,4598,99.5
34005, 면부,075004, 73세,2021,8437,4130,4307,95.9,8404,4115,4289,95.9
34005, 면부,075005, 74세,2021,8329,4009,4320,92.8,8304,3998,4306,92.8
34005, 면부,080,75~79세,2021,35774,15473,20301,76.2,35675,15439,20236,76.3
34005, 면부,080001, 75세,2021,5871,2866,3005,95.4,5843,2854,2989,95.5
34005, 면부,080002, 76세,2021,6223,2776,3447,80.5,6197,2768,3429,80.7
34005, 면부,080003, 77세,2021,7049,3013,4036,74.7,7027,3006,4021,74.8
34005, 면부,080004, 78세,2021,7093,2988,4105,72.8,7084,2984,4100,72.8
34005, 면부,080005, 79세,2021,9538,3830,5708,67.1,9524,3827,5697,67.2
34005, 면부,085,80~84세,2021,32831,12207,20624,59.2,32770,12190,20580,59.2
34005, 면부,085001, 80세,2021,6987,2734,4253,64.3,6972,2730,4242,64.4
34005, 면부,085002, 81세,2021,6418,2465,3953,62.4,6409,2460,3949,62.3
34005, 면부,085003, 82세,2021,7077,2608,4469,58.4,7064,2605,4459,58.4
34005, 면부,085004, 83세,2021,6438,2264,4174,54.2,6425,2260,4165,54.3
34005, 면부,085005, 84세,2021,5911,2136,3775,56.6,5900,2135,3765,56.7
34005, 면부,090,85~89세,2021,21148,6879,14269,48.2,21126,6871,14255,48.2
34005, 면부,090001, 85세,2021,5496,1951,3545,55,5491,1950,3541,55.1
34005, 면부,090002, 86세,2021,5122,1675,3447,48.6,5117,1673,3444,48.6
34005, 면부,090003, 87세,2021,4137,1327,2810,47.2,4136,1326,2810,47.2
34005, 면부,090004, 88세,2021,3430,1047,2383,43.9,3423,1044,2379,43.9
34005, 면부,090005, 89세,2021,2963,879,2084,42.2,2959,878,2081,42.2
34005, 면부,095,90~94세,2021,6629,1621,5008,32.4,6622,1620,5002,32.4
34005, 면부,095001, 90세,2021,1958,522,1436,36.4,1956,522,1434,36.4
34005, 면부,095002, 91세,2021,1643,405,1238,32.7,1639,404,1235,32.7
34005, 면부,095003, 92세,2021,1340,301,1039,29,1340,301,1039,29
34005, 면부,095004, 93세,2021,1008,217,791,27.4,1008,217,791,27.4
34005, 면부,095005, 94세,2021,680,176,504,34.9,679,176,503,35
34005, 면부,100,95~99세,2021,1291,260,1031,25.2,1290,260,1030,25.2
34005, 면부,100001, 95세,2021,440,85,355,23.9,440,85,355,23.9
34005, 면부,100002, 96세,2021,318,82,236,34.7,317,82,235,34.9
34005, 면부,100003, 97세,2021,207,36,171,21.1,207,36,171,21.1
34005, 면부,100004, 98세,2021,184,41,143,28.7,184,41,143,28.7
34005, 면부,100005, 99세,2021,142,16,126,12.7,142,16,126,12.7
34005, 면부,101,100세이상,2021,185,22,163,13.5,184,21,163,12.9
34005, 면부,102,15세미만,2021,53742,27725,26017,106.6,51766,26751,25015,106.9
34005, 면부,103,15~64세,2021,398255,226150,172105,131.4,355181,197716,157465,125.6
34005, 면부,104,65세이상,2021,194393,84489,109904,76.9,193472,84107,109365,76.9
34005, 면부,086,85세이상,2021,29253,8782,20471,42.9,29222,8772,20450,42.9
34005, 면부,126,평균연령,2021,50.7,48.4,53.3,,51.9,49.6,54.2,
34005, 면부,127,중위연령,2021,53.9,50.7,57.7,,55.9,53,59.1,
34003, 동부,000,합계,2021,1022693,517507,505186,102.4,989655,501240,488415,102.6
34003, 동부,005,0~4세,2021,39883,20516,19367,105.9,38997,20074,18923,106.1
34003, 동부,005001, 0세,2021,6796,3513,3283,107,6645,3434,3211,106.9
34003, 동부,005002, 1세,2021,7376,3794,3582,105.9,7211,3720,3491,106.6
34003, 동부,005003, 2세,2021,7854,4005,3849,104.1,7675,3910,3765,103.9
34003, 동부,005004, 3세,2021,8538,4364,4174,104.6,8352,4269,4083,104.6
34003, 동부,005005, 4세,2021,9319,4840,4479,108.1,9114,4741,4373,108.4
34003, 동부,010,5~9세,2021,54977,27952,27025,103.4,54190,27557,26633,103.5
34003, 동부,010001, 5세,2021,10406,5300,5106,103.8,10208,5210,4998,104.2
34003, 동부,010002, 6세,2021,11044,5571,5473,101.8,10868,5485,5383,101.9
34003, 동부,010003, 7세,2021,10677,5507,5170,106.5,10528,5425,5103,106.3
34003, 동부,010004, 8세,2021,11084,5596,5488,102,10965,5536,5429,102
34003, 동부,010005, 9세,2021,11766,5978,5788,103.3,11621,5901,5720,103.2
34003, 동부,015,10~14세,2021,56071,28966,27105,106.9,55647,28737,26910,106.8
34003, 동부,015001, 10세,2021,11583,5972,5611,106.4,11479,5923,5556,106.6
34003, 동부,015002, 11세,2021,11208,5841,5367,108.8,11117,5786,5331,108.5
34003, 동부,015003, 12세,2021,10699,5466,5233,104.5,10623,5423,5200,104.3
34003, 동부,015004, 13세,2021,11257,5829,5428,107.4,11179,5785,5394,107.2
34003, 동부,015005, 14세,2021,11324,5858,5466,107.2,11249,5820,5429,107.2
34003, 동부,020,15~19세,2021,54569,28206,26363,107,54012,27952,26060,107.3
34003, 동부,020001, 15세,2021,10446,5401,5045,107.1,10369,5364,5005,107.2
34003, 동부,020002, 16세,2021,10055,5232,4823,108.5,9997,5199,4798,108.4
34003, 동부,020003, 17세,2021,10948,5813,5135,113.2,10883,5784,5099,113.4
34003, 동부,020004, 18세,2021,11019,5710,5309,107.6,10921,5665,5256,107.8
34003, 동부,020005, 19세,2021,12101,6050,6051,100,11842,5940,5902,100.6
34003, 동부,025,20~24세,2021,70806,35998,34808,103.4,67952,34703,33249,104.4
34003, 동부,025001, 20세,2021,13643,6705,6938,96.6,13219,6534,6685,97.7
34003, 동부,025002, 21세,2021,14789,7363,7426,99.2,14220,7107,7113,99.9
34003, 동부,025003, 22세,2021,14217,7128,7089,100.6,13598,6844,6754,101.3
34003, 동부,025004, 23세,2021,14093,7424,6669,111.3,13450,7122,6328,112.5
34003, 동부,025005, 24세,2021,14064,7378,6686,110.3,13465,7096,6369,111.4
34003, 동부,030,25~29세,2021,73959,39854,34105,116.9,70660,38334,32326,118.6
34003, 동부,030001, 25세,2021,14401,7801,6600,118.2,13765,7498,6267,119.6
34003, 동부,030002, 26세,2021,14273,7731,6542,118.2,13640,7466,6174,120.9
34003, 동부,030003, 27세,2021,14635,8039,6596,121.9,13995,7754,6241,124.2
34003, 동부,030004, 28세,2021,15184,8088,7096,114,14525,7763,6762,114.8
34003, 동부,030005, 29세,2021,15466,8195,7271,112.7,14735,7853,6882,114.1
34003, 동부,035,30~34세,2021,72382,38714,33668,115,67852,36465,31387,116.2
34003, 동부,035001, 30세,2021,14297,7749,6548,118.3,13496,7354,6142,119.7
34003, 동부,035002, 31세,2021,14262,7681,6581,116.7,13393,7243,6150,117.8
34003, 동부,035003, 32세,2021,14244,7674,6570,116.8,13346,7232,6114,118.3
34003, 동부,035004, 33세,2021,14606,7764,6842,113.5,13661,7292,6369,114.5
34003, 동부,035005, 34세,2021,14973,7846,7127,110.1,13956,7344,6612,111.1
34003, 동부,040,35~39세,2021,82890,43118,39772,108.4,78612,40922,37690,108.6
34003, 동부,040001, 35세,2021,15188,7952,7236,109.9,14258,7490,6768,110.7
34003, 동부,040002, 36세,2021,15058,7922,7136,111,14173,7474,6699,111.6
34003, 동부,040003, 37세,2021,15878,8179,7699,106.2,15030,7750,7280,106.5
34003, 동부,040004, 38세,2021,17526,9111,8415,108.3,16744,8702,8042,108.2
34003, 동부,040005, 39세,2021,19240,9954,9286,107.2,18407,9506,8901,106.8
34003, 동부,045,40~44세,2021,88826,45975,42851,107.3,85544,44169,41375,106.8
34003, 동부,045001, 40세,2021,18767,9834,8933,110.1,18097,9480,8617,110
34003, 동부,045002, 41세,2021,19223,9879,9344,105.7,18524,9486,9038,105
34003, 동부,045003, 42세,2021,17871,9207,8664,106.3,17140,8777,8363,105
34003, 동부,045004, 43세,2021,16246,8533,7713,110.6,15620,8193,7427,110.3
34003, 동부,045005, 44세,2021,16719,8522,8197,104,16163,8233,7930,103.8
34003, 동부,050,45~49세,2021,85865,43327,42538,101.9,82990,41805,41185,101.5
34003, 동부,050001, 45세,2021,16091,8069,8022,100.6,15518,7764,7754,100.1
34003, 동부,050002, 46세,2021,16602,8272,8330,99.3,16065,7984,8081,98.8
34003, 동부,050003, 47세,2021,18223,9289,8934,104,17688,8990,8698,103.4
34003, 동부,050004, 48세,2021,17889,8969,8920,100.5,17315,8677,8638,100.5
34003, 동부,050005, 49세,2021,17060,8728,8332,104.8,16404,8390,8014,104.7
34003, 동부,055,50~54세,2021,87369,44251,43118,102.6,84409,42745,41664,102.6
34003, 동부,055001, 50세,2021,18701,9638,9063,106.3,18019,9285,8734,106.3
34003, 동부,055002, 51세,2021,17505,8940,8565,104.4,16857,8606,8251,104.3
34003, 동부,055003, 52세,2021,18048,9101,8947,101.7,17447,8801,8646,101.8
34003, 동부,055004, 53세,2021,17449,8698,8751,99.4,16877,8412,8465,99.4
34003, 동부,055005, 54세,2021,15666,7874,7792,101.1,15209,7641,7568,101
34003, 동부,060,55~59세,2021,71815,36924,34891,105.8,69117,35660,33457,106.6
34003, 동부,060001, 55세,2021,14061,7269,6792,107,13518,7023,6495,108.1
34003, 동부,060002, 56세,2021,15761,7951,7810,101.8,15171,7667,7504,102.2
34003, 동부,060003, 57세,2021,13616,7024,6592,106.6,13109,6776,6333,107
34003, 동부,060004, 58세,2021,14049,7244,6805,106.5,13435,6967,6468,107.7
34003, 동부,060005, 59세,2021,14328,7436,6892,107.9,13884,7227,6657,108.6
34003, 동부,065,60~64세,2021,64091,32229,31862,101.2,62336,31409,30927,101.6
34003, 동부,065001, 60세,2021,15463,7992,7471,107,15147,7837,7310,107.2
34003, 동부,065002, 61세,2021,14574,7213,7361,98,14137,7034,7103,99
34003, 동부,065003, 62세,2021,12280,6054,6226,97.2,11952,5895,6057,97.3
34003, 동부,065004, 63세,2021,11020,5534,5486,100.9,10701,5380,5321,101.1
34003, 동부,065005, 64세,2021,10754,5436,5318,102.2,10399,5263,5136,102.5
34003, 동부,070,65~69세,2021,41827,20161,21666,93.1,40752,19676,21076,93.4
34003, 동부,070001, 65세,2021,9651,4707,4944,95.2,9368,4575,4793,95.5
34003, 동부,070002, 66세,2021,9984,4851,5133,94.5,9728,4741,4987,95.1
34003, 동부,070003, 67세,2021,8039,3833,4206,91.1,7832,3746,4086,91.7
34003, 동부,070004, 68세,2021,6632,3226,3406,94.7,6464,3150,3314,95.1
34003, 동부,070005, 69세,2021,7521,3544,3977,89.1,7360,3464,3896,88.9
34003, 동부,075,70~74세,2021,28605,13276,15329,86.6,28173,13093,15080,86.8
34003, 동부,075001, 70세,2021,5366,2596,2770,93.7,5246,2538,2708,93.7
34003, 동부,075002, 71세,2021,6139,2816,3323,84.7,6057,2788,3269,85.3
34003, 동부,075003, 72세,2021,6049,2817,3232,87.2,5952,2771,3181,87.1
34003, 동부,075004, 73세,2021,5568,2575,2993,86,5502,2548,2954,86.3
34003, 동부,075005, 74세,2021,5483,2472,3011,82.1,5416,2448,2968,82.5
34003, 동부,080,75~79세,2021,20705,8774,11931,73.5,20523,8717,11806,73.8
34003, 동부,080001, 75세,2021,4007,1901,2106,90.3,3961,1887,2074,91
34003, 동부,080002, 76세,2021,3799,1640,2159,76,3762,1627,2135,76.2
34003, 동부,080003, 77세,2021,4080,1687,2393,70.5,4035,1673,2362,70.8
34003, 동부,080004, 78세,2021,3955,1652,2303,71.7,3926,1644,2282,72
34003, 동부,080005, 79세,2021,4864,1894,2970,63.8,4839,1886,2953,63.9
34003, 동부,085,80~84세,2021,15726,5808,9918,58.6,15608,5783,9825,58.9
34003, 동부,085001, 80세,2021,3532,1369,2163,63.3,3504,1358,2146,63.3
34003, 동부,085002, 81세,2021,3211,1205,2006,60.1,3184,1202,1982,60.6
34003, 동부,085003, 82세,2021,3336,1235,2101,58.8,3315,1233,2082,59.2
34003, 동부,085004, 83세,2021,2950,1065,1885,56.5,2924,1060,1864,56.9
34003, 동부,085005, 84세,2021,2697,934,1763,53,2681,930,1751,53.1
34003, 동부,090,85~89세,2021,8819,2686,6133,43.8,8784,2672,6112,43.7
34003, 동부,090001, 85세,2021,2331,731,1600,45.7,2323,729,1594,45.7
34003, 동부,090002, 86세,2021,2165,687,1478,46.5,2153,682,1471,46.4
34003, 동부,090003, 87세,2021,1667,556,1111,50,1660,552,1108,49.8
34003, 동부,090004, 88세,2021,1414,388,1026,37.8,1410,387,1023,37.8
34003, 동부,090005, 89세,2021,1242,324,918,35.3,1238,322,916,35.2
34003, 동부,095,90~94세,2021,2777,642,2135,30.1,2767,638,2129,30
34003, 동부,095001, 90세,2021,774,188,586,32.1,773,188,585,32.1
34003, 동부,095002, 91세,2021,698,161,537,30,695,161,534,30.1
34003, 동부,095003, 92세,2021,556,143,413,34.6,552,139,413,33.7
34003, 동부,095004, 93세,2021,435,91,344,26.5,435,91,344,26.5
34003, 동부,095005, 94세,2021,314,59,255,23.1,312,59,253,23.3
34003, 동부,100,95~99세,2021,629,113,516,21.9,628,112,516,21.7
34003, 동부,100001, 95세,2021,217,43,174,24.7,217,43,174,24.7
34003, 동부,100002, 96세,2021,151,29,122,23.8,151,29,122,23.8
34003, 동부,100003, 97세,2021,95,19,76,25,95,19,76,25
34003, 동부,100004, 98세,2021,103,12,91,13.2,103,12,91,13.2
34003, 동부,100005, 99세,2021,63,10,53,18.9,62,9,53,17
34003, 동부,101,100세이상,2021,102,17,85,20,102,17,85,20
34003, 동부,102,15세미만,2021,150931,77434,73497,105.4,148834,76368,72466,105.4
34003, 동부,103,15~64세,2021,752572,388596,363976,106.8,723484,374164,349320,107.1
34003, 동부,104,65세이상,2021,119190,51477,67713,76,117337,50708,66629,76.1
34003, 동부,086,85세이상,2021,12327,3458,8869,39,12281,3439,8842,38.9
34003, 동부,126,평균연령,2021,39.8,38.9,40.7,,39.8,38.9,40.7,
34003, 동부,127,중위연령,2021,40.3,39.5,41.2,,40.4,39.6,41.3,
34010, 천안시,000,합계,2021,683888,349740,334148,104.7,655410,333702,321708,103.7
34010, 천안시,005,0~4세,2021,25632,13215,12417,106.4,24989,12890,12099,106.5
34010, 천안시,005001, 0세,2021,4545,2396,2149,111.5,4425,2331,2094,111.3
34010, 천안시,005002, 1세,2021,4744,2420,2324,104.1,4624,2362,2262,104.4
34010, 천안시,005003, 2세,2021,4965,2524,2441,103.4,4833,2454,2379,103.2
34010, 천안시,005004, 3세,2021,5524,2824,2700,104.6,5391,2760,2631,104.9
34010, 천안시,005005, 4세,2021,5854,3051,2803,108.8,5716,2983,2733,109.1
34010, 천안시,010,5~9세,2021,34219,17429,16790,103.8,33708,17170,16538,103.8
34010, 천안시,010001, 5세,2021,6589,3351,3238,103.5,6454,3290,3164,104
34010, 천안시,010002, 6세,2021,6909,3525,3384,104.2,6793,3472,3321,104.5
34010, 천안시,010003, 7세,2021,6610,3400,3210,105.9,6513,3344,3169,105.5
34010, 천안시,010004, 8세,2021,6809,3458,3351,103.2,6736,3416,3320,102.9
34010, 천안시,010005, 9세,2021,7302,3695,3607,102.4,7212,3648,3564,102.4
34010, 천안시,015,10~14세,2021,34355,17763,16592,107.1,34058,17610,16448,107.1
34010, 천안시,015001, 10세,2021,7065,3620,3445,105.1,6991,3585,3406,105.3
34010, 천안시,015002, 11세,2021,6860,3565,3295,108.2,6788,3517,3271,107.5
34010, 천안시,015003, 12세,2021,6564,3395,3169,107.1,6511,3373,3138,107.5
34010, 천안시,015004, 13세,2021,6905,3604,3301,109.2,6863,3580,3283,109
34010, 천안시,015005, 14세,2021,6961,3579,3382,105.8,6905,3555,3350,106.1
34010, 천안시,020,15~19세,2021,35035,18040,16995,106.1,34582,17836,16746,106.5
34010, 천안시,020001, 15세,2021,6347,3325,3022,110,6299,3305,2994,110.4
34010, 천안시,020002, 16세,2021,6186,3195,2991,106.8,6143,3168,2975,106.5
34010, 천안시,020003, 17세,2021,6673,3548,3125,113.5,6627,3523,3104,113.5
34010, 천안시,020004, 18세,2021,7006,3619,3387,106.8,6929,3586,3343,107.3
34010, 천안시,020005, 19세,2021,8823,4353,4470,97.4,8584,4254,4330,98.2
34010, 천안시,025,20~24세,2021,51572,25868,25704,100.6,48599,24386,24213,100.7
34010, 천안시,025001, 20세,2021,10027,4600,5427,84.8,9536,4403,5133,85.8
34010, 천안시,025002, 21세,2021,10471,5036,5435,92.7,9879,4773,5106,93.5
34010, 천안시,025003, 22세,2021,10437,5225,5212,100.2,9841,4942,4899,100.9
34010, 천안시,025004, 23세,2021,10354,5524,4830,114.4,9713,5148,4565,112.8
34010, 천안시,025005, 24세,2021,10283,5483,4800,114.2,9630,5120,4510,113.5
34010, 천안시,030,25~29세,2021,53775,29147,24628,118.3,50124,26944,23180,116.2
34010, 천안시,030001, 25세,2021,10424,5732,4692,122.2,9745,5324,4421,120.4
34010, 천안시,030002, 26세,2021,10426,5719,4707,121.5,9701,5304,4397,120.6
34010, 천안시,030003, 27세,2021,10511,5788,4723,122.5,9784,5345,4439,120.4
34010, 천안시,030004, 28세,2021,11075,5851,5224,112,10361,5418,4943,109.6
34010, 천안시,030005, 29세,2021,11339,6057,5282,114.7,10533,5553,4980,111.5
34010, 천안시,035,30~34세,2021,51873,28145,23728,118.6,47435,25401,22034,115.3
34010, 천안시,035001, 30세,2021,10218,5580,4638,120.3,9419,5090,4329,117.6
34010, 천안시,035002, 31세,2021,10261,5532,4729,117,9345,4964,4381,113.3
34010, 천안시,035003, 32세,2021,10204,5627,4577,122.9,9298,5047,4251,118.7
34010, 천안시,035004, 33세,2021,10486,5704,4782,119.3,9611,5164,4447,116.1
34010, 천안시,035005, 34세,2021,10704,5702,5002,114,9762,5136,4626,111
34010, 천안시,040,35~39세,2021,56898,30497,26401,115.5,53067,28148,24919,113
34010, 천안시,040001, 35세,2021,10683,5849,4834,121,9832,5326,4506,118.2
34010, 천안시,040002, 36세,2021,10495,5668,4827,117.4,9679,5173,4506,114.8
34010, 천안시,040003, 37세,2021,10915,5801,5114,113.4,10185,5362,4823,111.2
34010, 천안시,040004, 38세,2021,11951,6351,5600,113.4,11234,5916,5318,111.2
34010, 천안시,040005, 39세,2021,12854,6828,6026,113.3,12137,6371,5766,110.5
34010, 천안시,045,40~44세,2021,58186,30928,27258,113.5,55407,29237,26170,111.7
34010, 천안시,045001, 40세,2021,12492,6723,5769,116.5,11897,6367,5530,115.1
34010, 천안시,045002, 41세,2021,12639,6726,5913,113.7,12013,6334,5679,111.5
34010, 천안시,045003, 42세,2021,11648,6156,5492,112.1,11041,5764,5277,109.2
34010, 천안시,045004, 43세,2021,10602,5690,4912,115.8,10121,5404,4717,114.6
34010, 천안시,045005, 44세,2021,10805,5633,5172,108.9,10335,5368,4967,108.1
34010, 천안시,050,45~49세,2021,56025,28548,27477,103.9,53687,27193,26494,102.6
34010, 천안시,050001, 45세,2021,10508,5392,5116,105.4,10047,5123,4924,104
34010, 천안시,050002, 46세,2021,10906,5468,5438,100.6,10430,5181,5249,98.7
34010, 천안시,050003, 47세,2021,11837,6057,5780,104.8,11410,5808,5602,103.7
34010, 천안시,050004, 48세,2021,11535,5905,5630,104.9,11091,5660,5431,104.2
34010, 천안시,050005, 49세,2021,11239,5726,5513,103.9,10709,5421,5288,102.5
34010, 천안시,055,50~54세,2021,57693,29325,28368,103.4,55499,28126,27373,102.8
34010, 천안시,055001, 50세,2021,12204,6322,5882,107.5,11722,6058,5664,107
34010, 천안시,055002, 51세,2021,11581,5964,5617,106.2,11096,5697,5399,105.5
34010, 천안시,055003, 52세,2021,11898,6023,5875,102.5,11437,5782,5655,102.2
34010, 천안시,055004, 53세,2021,11623,5858,5765,101.6,11186,5615,5571,100.8
34010, 천안시,055005, 54세,2021,10387,5158,5229,98.6,10058,4974,5084,97.8
34010, 천안시,060,55~59세,2021,48518,25072,23446,106.9,46575,24090,22485,107.1
34010, 천안시,060001, 55세,2021,9495,4894,4601,106.4,9106,4694,4412,106.4
34010, 천안시,060002, 56세,2021,10579,5421,5158,105.1,10140,5187,4953,104.7
34010, 천안시,060003, 57세,2021,9210,4680,4530,103.3,8871,4510,4361,103.4
34010, 천안시,060004, 58세,2021,9557,4970,4587,108.3,9119,4758,4361,109.1
34010, 천안시,060005, 59세,2021,9677,5107,4570,111.8,9339,4941,4398,112.3
34010, 천안시,065,60~64세,2021,43396,22229,21167,105,42181,21638,20543,105.3
34010, 천안시,065001, 60세,2021,10486,5456,5030,108.5,10284,5351,4933,108.5
34010, 천안시,065002, 61세,2021,9992,5088,4904,103.8,9693,4952,4741,104.5
34010, 천안시,065003, 62세,2021,8324,4153,4171,99.6,8081,4037,4044,99.8
34010, 천안시,065004, 63세,2021,7430,3815,3615,105.5,7206,3699,3507,105.5
34010, 천안시,065005, 64세,2021,7164,3717,3447,107.8,6917,3599,3318,108.5
34010, 천안시,070,65~69세,2021,27252,13437,13815,97.3,26521,13102,13419,97.6
34010, 천안시,070001, 65세,2021,6248,3098,3150,98.3,6061,3025,3036,99.6
34010, 천안시,070002, 66세,2021,6550,3227,3323,97.1,6364,3138,3226,97.3
34010, 천안시,070003, 67세,2021,5226,2542,2684,94.7,5081,2480,2601,95.3
34010, 천안시,070004, 68세,2021,4324,2187,2137,102.3,4207,2126,2081,102.2
34010, 천안시,070005, 69세,2021,4904,2383,2521,94.5,4808,2333,2475,94.3
34010, 천안시,075,70~74세,2021,17934,8433,9501,88.8,17673,8330,9343,89.2
34010, 천안시,075001, 70세,2021,3419,1672,1747,95.7,3343,1639,1704,96.2
34010, 천안시,075002, 71세,2021,3759,1739,2020,86.1,3716,1723,1993,86.5
34010, 천안시,075003, 72세,2021,3749,1761,1988,88.6,3696,1739,1957,88.9
34010, 천안시,075004, 73세,2021,3519,1688,1831,92.2,3469,1668,1801,92.6
34010, 천안시,075005, 74세,2021,3488,1573,1915,82.1,3449,1561,1888,82.7
34010, 천안시,080,75~79세,2021,13115,5652,7463,75.7,13004,5620,7384,76.1
34010, 천안시,080001, 75세,2021,2520,1212,1308,92.7,2494,1205,1289,93.5
34010, 천안시,080002, 76세,2021,2413,1078,1335,80.7,2390,1072,1318,81.3
34010, 천안시,080003, 77세,2021,2594,1102,1492,73.9,2567,1095,1472,74.4
34010, 천안시,080004, 78세,2021,2565,1052,1513,69.5,2551,1047,1504,69.6
34010, 천안시,080005, 79세,2021,3023,1208,1815,66.6,3002,1201,1801,66.7
34010, 천안시,085,80~84세,2021,10242,3764,6478,58.1,10161,3740,6421,58.2
34010, 천안시,085001, 80세,2021,2342,893,1449,61.6,2323,885,1438,61.5
34010, 천안시,085002, 81세,2021,2131,822,1309,62.8,2116,818,1298,63
34010, 천안시,085003, 82세,2021,2166,798,1368,58.3,2151,795,1356,58.6
34010, 천안시,085004, 83세,2021,1898,685,1213,56.5,1877,679,1198,56.7
34010, 천안시,085005, 84세,2021,1705,566,1139,49.7,1694,563,1131,49.8
34010, 천안시,090,85~89세,2021,5791,1731,4060,42.6,5768,1725,4043,42.7
34010, 천안시,090001, 85세,2021,1513,501,1012,49.5,1510,501,1009,49.7
34010, 천안시,090002, 86세,2021,1386,417,969,43,1379,415,964,43
34010, 천안시,090003, 87세,2021,1134,357,777,45.9,1128,354,774,45.7
34010, 천안시,090004, 88세,2021,936,250,686,36.4,933,250,683,36.6
34010, 천안시,090005, 89세,2021,822,206,616,33.4,818,205,613,33.4
34010, 천안시,095,90~94세,2021,1888,429,1459,29.4,1884,429,1455,29.5
34010, 천안시,095001, 90세,2021,540,122,418,29.2,538,122,416,29.3
34010, 천안시,095002, 91세,2021,443,116,327,35.5,442,116,326,35.6
34010, 천안시,095003, 92세,2021,403,95,308,30.8,403,95,308,30.8
34010, 천안시,095004, 93세,2021,285,56,229,24.5,285,56,229,24.5
34010, 천안시,095005, 94세,2021,217,40,177,22.6,216,40,176,22.7
34010, 천안시,100,95~99세,2021,425,77,348,22.1,424,76,348,21.8
34010, 천안시,100001, 95세,2021,133,23,110,20.9,133,23,110,20.9
34010, 천안시,100002, 96세,2021,100,24,76,31.6,100,24,76,31.6
34010, 천안시,100003, 97세,2021,60,13,47,27.7,60,13,47,27.7
34010, 천안시,100004, 98세,2021,81,12,69,17.4,81,12,69,17.4
34010, 천안시,100005, 99세,2021,51,5,46,10.9,50,X,46,8.7
34010, 천안시,101,100세이상,2021,64,11,53,20.8,64,11,53,20.8
34010, 천안시,102,15세미만,2021,94206,48407,45799,105.7,92755,47670,45085,105.7
34010, 천안시,103,15~64세,2021,512971,267799,245172,109.2,487156,252999,234157,108
34010, 천안시,104,65세이상,2021,76711,33534,43177,77.7,75499,33033,42466,77.8
34010, 천안시,086,85세이상,2021,8168,2248,5920,38,8140,2241,5899,38
34010, 천안시,126,평균연령,2021,39.8,39,40.6,,39.9,39.1,40.7,
34010, 천안시,127,중위연령,2021,39.9,39.2,40.7,,40.1,39.4,40.8,
34011, 동남구,000,합계,2021,270836,137117,133719,102.5,258423,130010,128413,101.2
34011, 동남구,005,0~4세,2021,7828,4064,3764,108,7545,3915,3630,107.9
34011, 동남구,005001, 0세,2021,1306,710,596,119.1,1252,682,570,119.6
34011, 동남구,005002, 1세,2021,1443,738,705,104.7,1385,711,674,105.5
34011, 동남구,005003, 2세,2021,1570,804,766,105,1517,773,744,103.9
34011, 동남구,005004, 3세,2021,1706,866,840,103.1,1651,840,811,103.6
34011, 동남구,005005, 4세,2021,1803,946,857,110.4,1740,909,831,109.4
34011, 동남구,010,5~9세,2021,11483,5907,5576,105.9,11253,5782,5471,105.7
34011, 동남구,010001, 5세,2021,2108,1111,997,111.4,2042,1074,968,111
34011, 동남구,010002, 6세,2021,2301,1161,1140,101.8,2249,1138,1111,102.4
34011, 동남구,010003, 7세,2021,2210,1131,1079,104.8,2170,1113,1057,105.3
34011, 동남구,010004, 8세,2021,2354,1213,1141,106.3,2324,1192,1132,105.3
34011, 동남구,010005, 9세,2021,2510,1291,1219,105.9,2468,1265,1203,105.2
34011, 동남구,015,10~14세,2021,12865,6656,6209,107.2,12735,6593,6142,107.3
34011, 동남구,015001, 10세,2021,2602,1344,1258,106.8,2567,1328,1239,107.2
34011, 동남구,015002, 11세,2021,2481,1278,1203,106.2,2449,1259,1190,105.8
34011, 동남구,015003, 12세,2021,2489,1298,1191,109,2470,1289,1181,109.1
34011, 동남구,015004, 13세,2021,2606,1337,1269,105.4,2590,1329,1261,105.4
34011, 동남구,015005, 14세,2021,2687,1399,1288,108.6,2659,1388,1271,109.2
34011, 동남구,020,15~19세,2021,15062,7757,7305,106.2,14836,7667,7169,106.9
34011, 동남구,020001, 15세,2021,2418,1270,1148,110.6,2395,1261,1134,111.2
34011, 동남구,020002, 16세,2021,2442,1269,1173,108.2,2423,1257,1166,107.8
34011, 동남구,020003, 17세,2021,2821,1570,1251,125.5,2798,1560,1238,126
34011, 동남구,020004, 18세,2021,3081,1654,1427,115.9,3031,1636,1395,117.3
34011, 동남구,020005, 19세,2021,4300,1994,2306,86.5,4189,1953,2236,87.3
34011, 동남구,025,20~24세,2021,22148,10766,11382,94.6,21065,10162,10903,93.2
34011, 동남구,025001, 20세,2021,4596,1955,2641,74,4460,1890,2570,73.5
34011, 동남구,025002, 21세,2021,4514,2046,2468,82.9,4343,1958,2385,82.1
34011, 동남구,025003, 22세,2021,4509,2211,2298,96.2,4269,2086,2183,95.6
34011, 동남구,025004, 23세,2021,4349,2300,2049,112.2,4087,2140,1947,109.9
34011, 동남구,025005, 24세,2021,4180,2254,1926,117,3906,2088,1818,114.9
34011, 동남구,030,25~29세,2021,19172,10599,8573,123.6,17616,9658,7958,121.4
34011, 동남구,030001, 25세,2021,4025,2209,1816,121.6,3735,2033,1702,119.4
34011, 동남구,030002, 26세,2021,3822,2149,1673,128.5,3511,1974,1537,128.4
34011, 동남구,030003, 27세,2021,3781,2073,1708,121.4,3462,1879,1583,118.7
34011, 동남구,030004, 28세,2021,3758,2043,1715,119.1,3450,1861,1589,117.1
34011, 동남구,030005, 29세,2021,3786,2125,1661,127.9,3458,1911,1547,123.5
34011, 동남구,035,30~34세,2021,16358,9031,7327,123.3,14417,7816,6601,118.4
34011, 동남구,035001, 30세,2021,3410,1887,1523,123.9,3037,1653,1384,119.4
34011, 동남구,035002, 31세,2021,3292,1839,1453,126.6,2874,1584,1290,122.8
34011, 동남구,035003, 32세,2021,3185,1781,1404,126.9,2814,1534,1280,119.8
34011, 동남구,035004, 33세,2021,3181,1726,1455,118.6,2828,1504,1324,113.6
34011, 동남구,035005, 34세,2021,3290,1798,1492,120.5,2864,1541,1323,116.5
34011, 동남구,040,35~39세,2021,18397,9704,8693,111.6,16799,8718,8081,107.9
34011, 동남구,040001, 35세,2021,3248,1784,1464,121.9,2890,1562,1328,117.6
34011, 동남구,040002, 36세,2021,3394,1812,1582,114.5,3056,1618,1438,112.5
34011, 동남구,040003, 37세,2021,3553,1828,1725,106,3243,1635,1608,101.7
34011, 동남구,040004, 38세,2021,3868,2036,1832,111.1,3591,1859,1732,107.3
34011, 동남구,040005, 39세,2021,4334,2244,2090,107.4,4019,2044,1975,103.5
34011, 동남구,045,40~44세,2021,21141,11086,10055,110.3,19975,10337,9638,107.3
34011, 동남구,045001, 40세,2021,4215,2234,1981,112.8,3977,2078,1899,109.4
34011, 동남구,045002, 41세,2021,4566,2369,2197,107.8,4284,2189,2095,104.5
34011, 동남구,045003, 42세,2021,4283,2175,2108,103.2,4044,2015,2029,99.3
34011, 동남구,045004, 43세,2021,3977,2154,1823,118.2,3766,2020,1746,115.7
34011, 동남구,045005, 44세,2021,4100,2154,1946,110.7,3904,2035,1869,108.9
34011, 동남구,050,45~49세,2021,21997,11334,10663,106.3,20932,10722,10210,105
34011, 동남구,050001, 45세,2021,4029,2094,1935,108.2,3824,1979,1845,107.3
34011, 동남구,050002, 46세,2021,4345,2230,2115,105.4,4127,2094,2033,103
34011, 동남구,050003, 47세,2021,4660,2376,2284,104,4472,2263,2209,102.4
34011, 동남구,050004, 48세,2021,4572,2368,2204,107.4,4371,2254,2117,106.5
34011, 동남구,050005, 49세,2021,4391,2266,2125,106.6,4138,2132,2006,106.3
34011, 동남구,055,50~54세,2021,23451,11851,11600,102.2,22412,11273,11139,101.2
34011, 동남구,055001, 50세,2021,4823,2490,2333,106.7,4608,2370,2238,105.9
34011, 동남구,055002, 51세,2021,4686,2401,2285,105.1,4470,2277,2193,103.8
34011, 동남구,055003, 52세,2021,4827,2436,2391,101.9,4593,2306,2287,100.8
34011, 동남구,055004, 53세,2021,4720,2334,2386,97.8,4500,2217,2283,97.1
34011, 동남구,055005, 54세,2021,4395,2190,2205,99.3,4241,2103,2138,98.4
34011, 동남구,060,55~59세,2021,21053,10707,10346,103.5,20107,10234,9873,103.7
34011, 동남구,060001, 55세,2021,3980,2048,1932,106,3797,1950,1847,105.6
34011, 동남구,060002, 56세,2021,4530,2280,2250,101.3,4330,2178,2152,101.2
34011, 동남구,060003, 57세,2021,4044,2037,2007,101.5,3868,1947,1921,101.4
34011, 동남구,060004, 58세,2021,4158,2140,2018,106,3931,2033,1898,107.1
34011, 동남구,060005, 59세,2021,4341,2202,2139,102.9,4181,2126,2055,103.5
34011, 동남구,065,60~64세,2021,20491,10393,10098,102.9,19887,10094,9793,103.1
34011, 동남구,065001, 60세,2021,4954,2539,2415,105.1,4843,2479,2364,104.9
34011, 동남구,065002, 61세,2021,4664,2346,2318,101.2,4512,2277,2235,101.9
34011, 동남구,065003, 62세,2021,3877,1948,1929,101,3760,1902,1858,102.4
34011, 동남구,065004, 63세,2021,3543,1796,1747,102.8,3435,1739,1696,102.5
34011, 동남구,065005, 64세,2021,3453,1764,1689,104.4,3337,1697,1640,103.5
34011, 동남구,070,65~69세,2021,13555,6673,6882,97,13221,6521,6700,97.3
34011, 동남구,070001, 65세,2021,3094,1501,1593,94.2,3017,1471,1546,95.1
34011, 동남구,070002, 66세,2021,3183,1561,1622,96.2,3092,1522,1570,96.9
34011, 동남구,070003, 67세,2021,2619,1295,1324,97.8,2559,1274,1285,99.1
34011, 동남구,070004, 68세,2021,2184,1110,1074,103.4,2131,1079,1052,102.6
34011, 동남구,070005, 69세,2021,2475,1206,1269,95,2422,1175,1247,94.2
34011, 동남구,075,70~74세,2021,9146,4364,4782,91.3,9027,4321,4706,91.8
34011, 동남구,075001, 70세,2021,1748,874,874,100,1714,858,856,100.2
34011, 동남구,075002, 71세,2021,1948,905,1043,86.8,1930,900,1030,87.4
34011, 동남구,075003, 72세,2021,1904,917,987,92.9,1884,909,975,93.2
34011, 동남구,075004, 73세,2021,1771,863,908,95,1745,854,891,95.8
34011, 동남구,075005, 74세,2021,1775,805,970,83,1754,800,954,83.9
34011, 동남구,080,75~79세,2021,6768,2926,3842,76.2,6722,2915,3807,76.6
34011, 동남구,080001, 75세,2021,1258,598,660,90.6,1248,595,653,91.1
34011, 동남구,080002, 76세,2021,1257,570,687,83,1249,567,682,83.1
34011, 동남구,080003, 77세,2021,1390,596,794,75.1,1380,594,786,75.6
34011, 동남구,080004, 78세,2021,1296,532,764,69.6,1288,531,757,70.1
34011, 동남구,080005, 79세,2021,1567,630,937,67.2,1557,628,929,67.6
34011, 동남구,085,80~84세,2021,5454,2071,3383,61.2,5417,2058,3359,61.3
34011, 동남구,085001, 80세,2021,1244,495,749,66.1,1234,490,744,65.9
34011, 동남구,085002, 81세,2021,1121,453,668,67.8,1115,451,664,67.9
34011, 동남구,085003, 82세,2021,1141,444,697,63.7,1134,443,691,64.1
34011, 동남구,085004, 83세,2021,1023,364,659,55.2,1015,360,655,55
34011, 동남구,085005, 84세,2021,925,315,610,51.6,919,314,605,51.9
34011, 동남구,090,85~89세,2021,3152,946,2206,42.9,3144,942,2202,42.8
34011, 동남구,090001, 85세,2021,822,279,543,51.4,822,279,543,51.4
34011, 동남구,090002, 86세,2021,769,246,523,47,765,245,520,47.1
34011, 동남구,090003, 87세,2021,583,176,407,43.2,581,174,407,42.8
34011, 동남구,090004, 88세,2021,510,135,375,36,510,135,375,36
34011, 동남구,090005, 89세,2021,468,110,358,30.7,466,109,357,30.5
34011, 동남구,095,90~94세,2021,1035,230,805,28.6,1033,230,803,28.6
34011, 동남구,095001, 90세,2021,298,64,234,27.4,297,64,233,27.5
34011, 동남구,095002, 91세,2021,254,69,185,37.3,253,69,184,37.5
34011, 동남구,095003, 92세,2021,216,54,162,33.3,216,54,162,33.3
34011, 동남구,095004, 93세,2021,154,26,128,20.3,154,26,128,20.3
34011, 동남구,095005, 94세,2021,113,17,96,17.7,113,17,96,17.7
34011, 동남구,100,95~99세,2021,243,45,198,22.7,243,45,198,22.7
34011, 동남구,100001, 95세,2021,80,14,66,21.2,80,14,66,21.2
34011, 동남구,100002, 96세,2021,59,14,45,31.1,59,14,45,31.1
34011, 동남구,100003, 97세,2021,29,9,20,45,29,9,20,45
34011, 동남구,100004, 98세,2021,46,6,40,15,46,6,40,15
34011, 동남구,100005, 99세,2021,29,X,27,7.4,29,X,27,7.4
34011, 동남구,101,100세이상,2021,37,7,30,23.3,37,7,30,23.3
34011, 동남구,102,15세미만,2021,32176,16627,15549,106.9,31533,16290,15243,106.9
34011, 동남구,103,15~64세,2021,199270,103228,96042,107.5,188046,96681,91365,105.8
34011, 동남구,104,65세이상,2021,39390,17262,22128,78,38844,17039,21805,78.1
34011, 동남구,086,85세이상,2021,4467,1228,3239,37.9,4457,1224,3233,37.9
34011, 동남구,126,평균연령,2021,42.1,41.1,43.1,,42.2,41.2,43.2,
34011, 동남구,127,중위연령,2021,42.8,41.8,44,,43.2,42.2,44.3,
34012, 서북구,000,합계,2021,413052,212623,200429,106.1,396987,203692,193295,105.4
34012, 서북구,005,0~4세,2021,17804,9151,8653,105.8,17444,8975,8469,106
34012, 서북구,005001, 0세,2021,3239,1686,1553,108.6,3173,1649,1524,108.2
34012, 서북구,005002, 1세,2021,3301,1682,1619,103.9,3239,1651,1588,104
34012, 서북구,005003, 2세,2021,3395,1720,1675,102.7,3316,1681,1635,102.8
34012, 서북구,005004, 3세,2021,3818,1958,1860,105.3,3740,1920,1820,105.5
34012, 서북구,005005, 4세,2021,4051,2105,1946,108.2,3976,2074,1902,109
34012, 서북구,010,5~9세,2021,22736,11522,11214,102.7,22455,11388,11067,102.9
34012, 서북구,010001, 5세,2021,4481,2240,2241,100,4412,2216,2196,100.9
34012, 서북구,010002, 6세,2021,4608,2364,2244,105.3,4544,2334,2210,105.6
34012, 서북구,010003, 7세,2021,4400,2269,2131,106.5,4343,2231,2112,105.6
34012, 서북구,010004, 8세,2021,4455,2245,2210,101.6,4412,2224,2188,101.6
34012, 서북구,010005, 9세,2021,4792,2404,2388,100.7,4744,2383,2361,100.9
34012, 서북구,015,10~14세,2021,21490,11107,10383,107,21323,11017,10306,106.9
34012, 서북구,015001, 10세,2021,4463,2276,2187,104.1,4424,2257,2167,104.2
34012, 서북구,015002, 11세,2021,4379,2287,2092,109.3,4339,2258,2081,108.5
34012, 서북구,015003, 12세,2021,4075,2097,1978,106,4041,2084,1957,106.5
34012, 서북구,015004, 13세,2021,4299,2267,2032,111.6,4273,2251,2022,111.3
34012, 서북구,015005, 14세,2021,4274,2180,2094,104.1,4246,2167,2079,104.2
34012, 서북구,020,15~19세,2021,19973,10283,9690,106.1,19746,10169,9577,106.2
34012, 서북구,020001, 15세,2021,3929,2055,1874,109.7,3904,2044,1860,109.9
34012, 서북구,020002, 16세,2021,3744,1926,1818,105.9,3720,1911,1809,105.6
34012, 서북구,020003, 17세,2021,3852,1978,1874,105.5,3829,1963,1866,105.2
34012, 서북구,020004, 18세,2021,3925,1965,1960,100.3,3898,1950,1948,100.1
34012, 서북구,020005, 19세,2021,4523,2359,2164,109,4395,2301,2094,109.9
34012, 서북구,025,20~24세,2021,29424,15102,14322,105.4,27534,14224,13310,106.9
34012, 서북구,025001, 20세,2021,5431,2645,2786,94.9,5076,2513,2563,98
34012, 서북구,025002, 21세,2021,5957,2990,2967,100.8,5536,2815,2721,103.5
34012, 서북구,025003, 22세,2021,5928,3014,2914,103.4,5572,2856,2716,105.2
34012, 서북구,025004, 23세,2021,6005,3224,2781,115.9,5626,3008,2618,114.9
34012, 서북구,025005, 24세,2021,6103,3229,2874,112.4,5724,3032,2692,112.6
34012, 서북구,030,25~29세,2021,34603,18548,16055,115.5,32508,17286,15222,113.6
34012, 서북구,030001, 25세,2021,6399,3523,2876,122.5,6010,3291,2719,121
34012, 서북구,030002, 26세,2021,6604,3570,3034,117.7,6190,3330,2860,116.4
34012, 서북구,030003, 27세,2021,6730,3715,3015,123.2,6322,3466,2856,121.4
34012, 서북구,030004, 28세,2021,7317,3808,3509,108.5,6911,3557,3354,106.1
34012, 서북구,030005, 29세,2021,7553,3932,3621,108.6,7075,3642,3433,106.1
34012, 서북구,035,30~34세,2021,35515,19114,16401,116.5,33018,17585,15433,113.9
34012, 서북구,035001, 30세,2021,6808,3693,3115,118.6,6382,3437,2945,116.7
34012, 서북구,035002, 31세,2021,6969,3693,3276,112.7,6471,3380,3091,109.3
34012, 서북구,035003, 32세,2021,7019,3846,3173,121.2,6484,3513,2971,118.2
34012, 서북구,035004, 33세,2021,7305,3978,3327,119.6,6783,3660,3123,117.2
34012, 서북구,035005, 34세,2021,7414,3904,3510,111.2,6898,3595,3303,108.8
34012, 서북구,040,35~39세,2021,38501,20793,17708,117.4,36268,19430,16838,115.4
34012, 서북구,040001, 35세,2021,7435,4065,3370,120.6,6942,3764,3178,118.4
34012, 서북구,040002, 36세,2021,7101,3856,3245,118.8,6623,3555,3068,115.9
34012, 서북구,040003, 37세,2021,7362,3973,3389,117.2,6942,3727,3215,115.9
34012, 서북구,040004, 38세,2021,8083,4315,3768,114.5,7643,4057,3586,113.1
34012, 서북구,040005, 39세,2021,8520,4584,3936,116.5,8118,4327,3791,114.1
34012, 서북구,045,40~44세,2021,37045,19842,17203,115.3,35432,18900,16532,114.3
34012, 서북구,045001, 40세,2021,8277,4489,3788,118.5,7920,4289,3631,118.1
34012, 서북구,045002, 41세,2021,8073,4357,3716,117.2,7729,4145,3584,115.7
34012, 서북구,045003, 42세,2021,7365,3981,3384,117.6,6997,3749,3248,115.4
34012, 서북구,045004, 43세,2021,6625,3536,3089,114.5,6355,3384,2971,113.9
34012, 서북구,045005, 44세,2021,6705,3479,3226,107.8,6431,3333,3098,107.6
34012, 서북구,050,45~49세,2021,34028,17214,16814,102.4,32755,16471,16284,101.1
34012, 서북구,050001, 45세,2021,6479,3298,3181,103.7,6223,3144,3079,102.1
34012, 서북구,050002, 46세,2021,6561,3238,3323,97.4,6303,3087,3216,96
34012, 서북구,050003, 47세,2021,7177,3681,3496,105.3,6938,3545,3393,104.5
34012, 서북구,050004, 48세,2021,6963,3537,3426,103.2,6720,3406,3314,102.8
34012, 서북구,050005, 49세,2021,6848,3460,3388,102.1,6571,3289,3282,100.2
34012, 서북구,055,50~54세,2021,34242,17474,16768,104.2,33087,16853,16234,103.8
34012, 서북구,055001, 50세,2021,7381,3832,3549,108,7114,3688,3426,107.6
34012, 서북구,055002, 51세,2021,6895,3563,3332,106.9,6626,3420,3206,106.7
34012, 서북구,055003, 52세,2021,7071,3587,3484,103,6844,3476,3368,103.2
34012, 서북구,055004, 53세,2021,6903,3524,3379,104.3,6686,3398,3288,103.3
34012, 서북구,055005, 54세,2021,5992,2968,3024,98.1,5817,2871,2946,97.5
34012, 서북구,060,55~59세,2021,27465,14365,13100,109.7,26468,13856,12612,109.9
34012, 서북구,060001, 55세,2021,5515,2846,2669,106.6,5309,2744,2565,107
34012, 서북구,060002, 56세,2021,6049,3141,2908,108,5810,3009,2801,107.4
34012, 서북구,060003, 57세,2021,5166,2643,2523,104.8,5003,2563,2440,105
34012, 서북구,060004, 58세,2021,5399,2830,2569,110.2,5188,2725,2463,110.6
34012, 서북구,060005, 59세,2021,5336,2905,2431,119.5,5158,2815,2343,120.1
34012, 서북구,065,60~64세,2021,22905,11836,11069,106.9,22294,11544,10750,107.4
34012, 서북구,065001, 60세,2021,5532,2917,2615,111.5,5441,2872,2569,111.8
34012, 서북구,065002, 61세,2021,5328,2742,2586,106,5181,2675,2506,106.7
34012, 서북구,065003, 62세,2021,4447,2205,2242,98.3,4321,2135,2186,97.7
34012, 서북구,065004, 63세,2021,3887,2019,1868,108.1,3771,1960,1811,108.2
34012, 서북구,065005, 64세,2021,3711,1953,1758,111.1,3580,1902,1678,113.3
34012, 서북구,070,65~69세,2021,13697,6764,6933,97.6,13300,6581,6719,97.9
34012, 서북구,070001, 65세,2021,3154,1597,1557,102.6,3044,1554,1490,104.3
34012, 서북구,070002, 66세,2021,3367,1666,1701,97.9,3272,1616,1656,97.6
34012, 서북구,070003, 67세,2021,2607,1247,1360,91.7,2522,1206,1316,91.6
34012, 서북구,070004, 68세,2021,2140,1077,1063,101.3,2076,1047,1029,101.7
34012, 서북구,070005, 69세,2021,2429,1177,1252,94,2386,1158,1228,94.3
34012, 서북구,075,70~74세,2021,8788,4069,4719,86.2,8646,4009,4637,86.5
34012, 서북구,075001, 70세,2021,1671,798,873,91.4,1629,781,848,92.1
34012, 서북구,075002, 71세,2021,1811,834,977,85.4,1786,823,963,85.5
34012, 서북구,075003, 72세,2021,1845,844,1001,84.3,1812,830,982,84.5
34012, 서북구,075004, 73세,2021,1748,825,923,89.4,1724,814,910,89.5
34012, 서북구,075005, 74세,2021,1713,768,945,81.3,1695,761,934,81.5
34012, 서북구,080,75~79세,2021,6347,2726,3621,75.3,6282,2705,3577,75.6
34012, 서북구,080001, 75세,2021,1262,614,648,94.8,1246,610,636,95.9
34012, 서북구,080002, 76세,2021,1156,508,648,78.4,1141,505,636,79.4
34012, 서북구,080003, 77세,2021,1204,506,698,72.5,1187,501,686,73
34012, 서북구,080004, 78세,2021,1269,520,749,69.4,1263,516,747,69.1
34012, 서북구,080005, 79세,2021,1456,578,878,65.8,1445,573,872,65.7
34012, 서북구,085,80~84세,2021,4788,1693,3095,54.7,4744,1682,3062,54.9
34012, 서북구,085001, 80세,2021,1098,398,700,56.9,1089,395,694,56.9
34012, 서북구,085002, 81세,2021,1010,369,641,57.6,1001,367,634,57.9
34012, 서북구,085003, 82세,2021,1025,354,671,52.8,1017,352,665,52.9
34012, 서북구,085004, 83세,2021,875,321,554,57.9,862,319,543,58.7
34012, 서북구,085005, 84세,2021,780,251,529,47.4,775,249,526,47.3
34012, 서북구,090,85~89세,2021,2639,785,1854,42.3,2624,783,1841,42.5
34012, 서북구,090001, 85세,2021,691,222,469,47.3,688,222,466,47.6
34012, 서북구,090002, 86세,2021,617,171,446,38.3,614,170,444,38.3
34012, 서북구,090003, 87세,2021,551,181,370,48.9,547,180,367,49
34012, 서북구,090004, 88세,2021,426,115,311,37,423,115,308,37.3
34012, 서북구,090005, 89세,2021,354,96,258,37.2,352,96,256,37.5
34012, 서북구,095,90~94세,2021,853,199,654,30.4,851,199,652,30.5
34012, 서북구,095001, 90세,2021,242,58,184,31.5,241,58,183,31.7
34012, 서북구,095002, 91세,2021,189,47,142,33.1,189,47,142,33.1
34012, 서북구,095003, 92세,2021,187,41,146,28.1,187,41,146,28.1
34012, 서북구,095004, 93세,2021,131,30,101,29.7,131,30,101,29.7
34012, 서북구,095005, 94세,2021,104,23,81,28.4,103,23,80,28.8
34012, 서북구,100,95~99세,2021,182,32,150,21.3,181,31,150,20.7
34012, 서북구,100001, 95세,2021,53,9,44,20.5,53,9,44,20.5
34012, 서북구,100002, 96세,2021,41,10,31,32.3,41,10,31,32.3
34012, 서북구,100003, 97세,2021,31,X,27,14.8,31,X,27,14.8
34012, 서북구,100004, 98세,2021,35,6,29,20.7,35,6,29,20.7
34012, 서북구,100005, 99세,2021,22,X,19,15.8,21,X,19,10.5
34012, 서북구,101,100세이상,2021,27,X,23,17.4,27,X,23,17.4
34012, 서북구,102,15세미만,2021,62030,31780,30250,105.1,61222,31380,29842,105.2
34012, 서북구,103,15~64세,2021,313701,164571,149130,110.4,299110,156318,142792,109.5
34012, 서북구,104,65세이상,2021,37321,16272,21049,77.3,36655,15994,20661,77.4
34012, 서북구,086,85세이상,2021,3701,1020,2681,38,3683,1017,2666,38.1
34012, 서북구,126,평균연령,2021,38.3,37.7,38.9,,38.3,37.7,39,
34012, 서북구,127,중위연령,2021,38.4,37.9,38.9,,38.5,38,39.1,
34020, 공주시,000,합계,2021,106915,52782,54133,97.5,104211,51409,52802,97.4
34020, 공주시,005,0~4세,2021,2120,1078,1042,103.5,2107,1074,1033,104
34020, 공주시,005001, 0세,2021,381,202,179,112.8,378,202,176,114.8
34020, 공주시,005002, 1세,2021,420,212,208,101.9,416,210,206,101.9
34020, 공주시,005003, 2세,2021,422,204,218,93.6,420,203,217,93.5
34020, 공주시,005004, 3세,2021,405,214,191,112,402,213,189,112.7
34020, 공주시,005005, 4세,2021,492,246,246,100,491,246,245,100.4
34020, 공주시,010,5~9세,2021,3158,1650,1508,109.4,3140,1639,1501,109.2
34020, 공주시,010001, 5세,2021,513,265,248,106.9,508,263,245,107.3
34020, 공주시,010002, 6세,2021,628,314,314,100,621,309,312,99
34020, 공주시,010003, 7세,2021,607,335,272,123.2,603,332,271,122.5
34020, 공주시,010004, 8세,2021,694,366,328,111.6,693,366,327,111.9
34020, 공주시,010005, 9세,2021,716,370,346,106.9,715,369,346,106.6
34020, 공주시,015,10~14세,2021,3698,1923,1775,108.3,3688,1919,1769,108.5
34020, 공주시,015001, 10세,2021,746,388,358,108.4,741,385,356,108.1
34020, 공주시,015002, 11세,2021,723,382,341,112,722,381,341,111.7
34020, 공주시,015003, 12세,2021,702,364,338,107.7,702,364,338,107.7
34020, 공주시,015004, 13세,2021,733,373,360,103.6,731,373,358,104.2
34020, 공주시,015005, 14세,2021,794,416,378,110.1,792,416,376,110.6
34020, 공주시,020,15~19세,2021,6083,3193,2890,110.5,6035,3163,2872,110.1
34020, 공주시,020001, 15세,2021,742,370,372,99.5,742,370,372,99.5
34020, 공주시,020002, 16세,2021,790,424,366,115.8,788,424,364,116.5
34020, 공주시,020003, 17세,2021,1216,726,490,148.2,1215,725,490,148
34020, 공주시,020004, 18세,2021,1414,794,620,128.1,1405,787,618,127.3
34020, 공주시,020005, 19세,2021,1921,879,1042,84.4,1885,857,1028,83.4
34020, 공주시,025,20~24세,2021,8108,3757,4351,86.3,7711,3581,4130,86.7
34020, 공주시,025001, 20세,2021,1685,650,1035,62.8,1617,628,989,63.5
34020, 공주시,025002, 21세,2021,1869,807,1062,76,1797,772,1025,75.3
34020, 공주시,025003, 22세,2021,1733,776,957,81.1,1659,745,914,81.5
34020, 공주시,025004, 23세,2021,1495,789,706,111.8,1404,747,657,113.7
34020, 공주시,025005, 24세,2021,1326,735,591,124.4,1234,689,545,126.4
34020, 공주시,030,25~29세,2021,5687,3285,2402,136.8,5146,2972,2174,136.7
34020, 공주시,030001, 25세,2021,1235,689,546,126.2,1134,631,503,125.4
34020, 공주시,030002, 26세,2021,1191,690,501,137.7,1072,617,455,135.6
34020, 공주시,030003, 27세,2021,1166,709,457,155.1,1056,651,405,160.7
34020, 공주시,030004, 28세,2021,1078,612,466,131.3,963,544,419,129.8
34020, 공주시,030005, 29세,2021,1017,585,432,135.4,921,529,392,134.9
34020, 공주시,035,30~34세,2021,4566,2542,2024,125.6,4100,2288,1812,126.3
34020, 공주시,035001, 30세,2021,957,540,417,129.5,851,482,369,130.6
34020, 공주시,035002, 31세,2021,947,544,403,135,858,490,368,133.2
34020, 공주시,035003, 32세,2021,869,493,376,131.1,769,438,331,132.3
34020, 공주시,035004, 33세,2021,887,456,431,105.8,797,414,383,108.1
34020, 공주시,035005, 34세,2021,906,509,397,128.2,825,464,361,128.5
34020, 공주시,040,35~39세,2021,4903,2535,2368,107.1,4569,2372,2197,108
34020, 공주시,040001, 35세,2021,919,486,433,112.2,843,447,396,112.9
34020, 공주시,040002, 36세,2021,858,443,415,106.7,792,413,379,109
34020, 공주시,040003, 37세,2021,927,489,438,111.6,860,455,405,112.3
34020, 공주시,040004, 38세,2021,1102,569,533,106.8,1033,534,499,107
34020, 공주시,040005, 39세,2021,1097,548,549,99.8,1041,523,518,101
34020, 공주시,045,40~44세,2021,5992,3125,2867,109,5769,3016,2753,109.6
34020, 공주시,045001, 40세,2021,1182,609,573,106.3,1128,583,545,107
34020, 공주시,045002, 41세,2021,1261,637,624,102.1,1209,611,598,102.2
34020, 공주시,045003, 42세,2021,1170,603,567,106.3,1131,581,550,105.6
34020, 공주시,045004, 43세,2021,1183,652,531,122.8,1136,633,503,125.8
34020, 공주시,045005, 44세,2021,1196,624,572,109.1,1165,608,557,109.2
34020, 공주시,050,45~49세,2021,6688,3496,3192,109.5,6513,3398,3115,109.1
34020, 공주시,050001, 45세,2021,1135,605,530,114.2,1100,587,513,114.4
34020, 공주시,050002, 46세,2021,1259,687,572,120.1,1213,658,555,118.6
34020, 공주시,050003, 47세,2021,1439,760,679,111.9,1412,746,666,112
34020, 공주시,050004, 48세,2021,1461,733,728,100.7,1428,713,715,99.7
34020, 공주시,050005, 49세,2021,1394,711,683,104.1,1360,694,666,104.2
34020, 공주시,055,50~54세,2021,8549,4389,4160,105.5,8382,4308,4074,105.7
34020, 공주시,055001, 50세,2021,1627,835,792,105.4,1595,820,775,105.8
34020, 공주시,055002, 51세,2021,1618,805,813,99,1582,790,792,99.7
34020, 공주시,055003, 52세,2021,1799,936,863,108.5,1765,915,850,107.6
34020, 공주시,055004, 53세,2021,1780,918,862,106.5,1744,903,841,107.4
34020, 공주시,055005, 54세,2021,1725,895,830,107.8,1696,880,816,107.8
34020, 공주시,060,55~59세,2021,8905,4466,4439,100.6,8764,4405,4359,101.1
34020, 공주시,060001, 55세,2021,1451,738,713,103.5,1423,724,699,103.6
34020, 공주시,060002, 56세,2021,1873,935,938,99.7,1833,918,915,100.3
34020, 공주시,060003, 57세,2021,1748,885,863,102.5,1722,867,855,101.4
34020, 공주시,060004, 58세,2021,1833,902,931,96.9,1806,897,909,98.7
34020, 공주시,060005, 59세,2021,2000,1006,994,101.2,1980,999,981,101.8
34020, 공주시,065,60~64세,2021,10585,5268,5317,99.1,10510,5237,5273,99.3
34020, 공주시,065001, 60세,2021,2396,1228,1168,105.1,2377,1220,1157,105.4
34020, 공주시,065002, 61세,2021,2250,1113,1137,97.9,2233,1105,1128,98
34020, 공주시,065003, 62세,2021,2045,1002,1043,96.1,2033,997,1036,96.2
34020, 공주시,065004, 63세,2021,1943,947,996,95.1,1926,941,985,95.5
34020, 공주시,065005, 64세,2021,1951,978,973,100.5,1941,974,967,100.7
34020, 공주시,070,65~69세,2021,8308,4109,4199,97.9,8261,4087,4174,97.9
34020, 공주시,070001, 65세,2021,1819,931,888,104.8,1807,926,881,105.1
34020, 공주시,070002, 66세,2021,2007,991,1016,97.5,1996,986,1010,97.6
34020, 공주시,070003, 67세,2021,1574,755,819,92.2,1567,751,816,92
34020, 공주시,070004, 68세,2021,1333,648,685,94.6,1328,646,682,94.7
34020, 공주시,070005, 69세,2021,1575,784,791,99.1,1563,778,785,99.1
34020, 공주시,075,70~74세,2021,6217,3080,3137,98.2,6191,3073,3118,98.6
34020, 공주시,075001, 70세,2021,1156,585,571,102.5,1154,585,569,102.8
34020, 공주시,075002, 71세,2021,1380,691,689,100.3,1372,689,683,100.9
34020, 공주시,075003, 72세,2021,1307,640,667,96,1299,637,662,96.2
34020, 공주시,075004, 73세,2021,1233,599,634,94.5,1228,597,631,94.6
34020, 공주시,075005, 74세,2021,1141,565,576,98.1,1138,565,573,98.6
34020, 공주시,080,75~79세,2021,4956,2037,2919,69.8,4943,2032,2911,69.8
34020, 공주시,080001, 75세,2021,840,395,445,88.8,835,393,442,88.9
34020, 공주시,080002, 76세,2021,884,373,511,73,883,372,511,72.8
34020, 공주시,080003, 77세,2021,1012,395,617,64,1010,395,615,64.2
34020, 공주시,080004, 78세,2021,895,363,532,68.2,891,361,530,68.1
34020, 공주시,080005, 79세,2021,1325,511,814,62.8,1324,511,813,62.9
34020, 공주시,085,80~84세,2021,4452,1658,2794,59.3,4446,1657,2789,59.4
34020, 공주시,085001, 80세,2021,947,401,546,73.4,947,401,546,73.4
34020, 공주시,085002, 81세,2021,888,333,555,60,886,333,553,60.2
34020, 공주시,085003, 82세,2021,980,350,630,55.6,978,349,629,55.5
34020, 공주시,085004, 83세,2021,830,285,545,52.3,829,285,544,52.4
34020, 공주시,085005, 84세,2021,807,289,518,55.8,806,289,517,55.9
34020, 공주시,090,85~89세,2021,2793,898,1895,47.4,2790,895,1895,47.2
34020, 공주시,090001, 85세,2021,705,231,474,48.7,704,230,474,48.5
34020, 공주시,090002, 86세,2021,665,228,437,52.2,664,227,437,51.9
34020, 공주시,090003, 87세,2021,564,182,382,47.6,564,182,382,47.6
34020, 공주시,090004, 88세,2021,451,143,308,46.4,450,142,308,46.1
34020, 공주시,090005, 89세,2021,408,114,294,38.8,408,114,294,38.8
34020, 공주시,095,90~94세,2021,935,242,693,34.9,934,242,692,35
34020, 공주시,095001, 90세,2021,295,83,212,39.2,295,83,212,39.2
34020, 공주시,095002, 91세,2021,224,55,169,32.5,224,55,169,32.5
34020, 공주시,095003, 92세,2021,198,46,152,30.3,198,46,152,30.3
34020, 공주시,095004, 93세,2021,133,35,98,35.7,133,35,98,35.7
34020, 공주시,095005, 94세,2021,85,23,62,37.1,84,23,61,37.7
34020, 공주시,100,95~99세,2021,181,45,136,33.1,181,45,136,33.1
34020, 공주시,100001, 95세,2021,74,23,51,45.1,74,23,51,45.1
34020, 공주시,100002, 96세,2021,37,9,28,32.1,37,9,28,32.1
34020, 공주시,100003, 97세,2021,25,6,19,31.6,25,6,19,31.6
34020, 공주시,100004, 98세,2021,23,5,18,27.8,23,5,18,27.8
34020, 공주시,100005, 99세,2021,22,X,20,10,22,X,20,10
34020, 공주시,101,100세이상,2021,31,6,25,24,31,6,25,24
34020, 공주시,102,15세미만,2021,8976,4651,4325,107.5,8935,4632,4303,107.6
34020, 공주시,103,15~64세,2021,70066,36056,34010,106,67499,34740,32759,106
34020, 공주시,104,65세이상,2021,27873,12075,15798,76.4,27777,12037,15740,76.5
34020, 공주시,086,85세이상,2021,3940,1191,2749,43.3,3936,1188,2748,43.2
34020, 공주시,126,평균연령,2021,48.3,46.7,49.8,,48.6,47,50.2,
34020, 공주시,127,중위연령,2021,51.5,49.7,53.2,,52.1,50.3,53.7,
34030, 보령시,000,합계,2021,97390,50364,47026,107.1,93413,47415,45998,103.1
34030, 보령시,005,0~4세,2021,2286,1166,1120,104.1,2277,1163,1114,104.4
34030, 보령시,005001, 0세,2021,380,195,185,105.4,378,194,184,105.4
34030, 보령시,005002, 1세,2021,435,228,207,110.1,433,228,205,111.2
34030, 보령시,005003, 2세,2021,461,226,235,96.2,458,225,233,96.6
34030, 보령시,005004, 3세,2021,455,224,231,97,454,223,231,96.5
34030, 보령시,005005, 4세,2021,555,293,262,111.8,554,293,261,112.3
34030, 보령시,010,5~9세,2021,3312,1684,1628,103.4,3290,1675,1615,103.7
34030, 보령시,010001, 5세,2021,615,320,295,108.5,608,316,292,108.2
34030, 보령시,010002, 6세,2021,636,304,332,91.6,632,302,330,91.5
34030, 보령시,010003, 7세,2021,655,329,326,100.9,651,328,323,101.5
34030, 보령시,010004, 8세,2021,699,366,333,109.9,695,365,330,110.6
34030, 보령시,010005, 9세,2021,707,365,342,106.7,704,364,340,107.1
34030, 보령시,015,10~14세,2021,3916,1980,1936,102.3,3909,1974,1935,102
34030, 보령시,015001, 10세,2021,829,405,424,95.5,829,405,424,95.5
34030, 보령시,015002, 11세,2021,778,393,385,102.1,776,391,385,101.6
34030, 보령시,015003, 12세,2021,729,372,357,104.2,728,371,357,103.9
34030, 보령시,015004, 13세,2021,804,401,403,99.5,801,399,402,99.3
34030, 보령시,015005, 14세,2021,776,409,367,111.4,775,408,367,111.2
34030, 보령시,020,15~19세,2021,3440,1860,1580,117.7,3419,1847,1572,117.5
34030, 보령시,020001, 15세,2021,764,398,366,108.7,761,398,363,109.6
34030, 보령시,020002, 16세,2021,737,409,328,124.7,735,407,328,124.1
34030, 보령시,020003, 17세,2021,725,387,338,114.5,721,384,337,113.9
34030, 보령시,020004, 18세,2021,661,344,317,108.5,658,341,317,107.6
34030, 보령시,020005, 19세,2021,553,322,231,139.4,544,317,227,139.6
34030, 보령시,025,20~24세,2021,4215,2613,1602,163.1,3890,2361,1529,154.4
34030, 보령시,025001, 20세,2021,776,505,271,186.3,760,495,265,186.8
34030, 보령시,025002, 21세,2021,821,502,319,157.4,788,482,306,157.5
34030, 보령시,025003, 22세,2021,804,489,315,155.2,745,441,304,145.1
34030, 보령시,025004, 23세,2021,919,571,348,164.1,816,491,325,151.1
34030, 보령시,025005, 24세,2021,895,546,349,156.4,781,452,329,137.4
34030, 보령시,030,25~29세,2021,4863,3077,1786,172.3,4131,2480,1651,150.2
34030, 보령시,030001, 25세,2021,992,622,370,168.1,880,530,350,151.4
34030, 보령시,030002, 26세,2021,956,571,385,148.3,823,463,360,128.6
34030, 보령시,030003, 27세,2021,944,598,346,172.8,799,481,318,151.3
34030, 보령시,030004, 28세,2021,1006,666,340,195.9,836,524,312,167.9
34030, 보령시,030005, 29세,2021,965,620,345,179.7,793,482,311,155
34030, 보령시,035,30~34세,2021,4694,2818,1876,150.2,3825,2115,1710,123.7
34030, 보령시,035001, 30세,2021,1007,619,388,159.5,829,473,356,132.9
34030, 보령시,035002, 31세,2021,895,546,349,156.4,716,398,318,125.2
34030, 보령시,035003, 32세,2021,918,577,341,169.2,757,445,312,142.6
34030, 보령시,035004, 33세,2021,899,532,367,145,733,401,332,120.8
34030, 보령시,035005, 34세,2021,975,544,431,126.2,790,398,392,101.5
34030, 보령시,040,35~39세,2021,5408,3039,2369,128.3,4738,2517,2221,113.3
34030, 보령시,040001, 35세,2021,975,557,418,133.3,822,433,389,111.3
34030, 보령시,040002, 36세,2021,974,544,430,126.5,835,433,402,107.7
34030, 보령시,040003, 37세,2021,1030,572,458,124.9,910,477,433,110.2
34030, 보령시,040004, 38세,2021,1161,656,505,129.9,1025,556,469,118.6
34030, 보령시,040005, 39세,2021,1268,710,558,127.2,1146,618,528,117
34030, 보령시,045,40~44세,2021,6306,3557,2749,129.4,5834,3205,2629,121.9
34030, 보령시,045001, 40세,2021,1223,691,532,129.9,1115,607,508,119.5
34030, 보령시,045002, 41세,2021,1350,767,583,131.6,1236,677,559,121.1
34030, 보령시,045003, 42세,2021,1291,704,587,119.9,1194,633,561,112.8
34030, 보령시,045004, 43세,2021,1195,673,522,128.9,1106,606,500,121.2
34030, 보령시,045005, 44세,2021,1247,722,525,137.5,1183,682,501,136.1
34030, 보령시,050,45~49세,2021,7312,4021,3291,122.2,6958,3778,3180,118.8
34030, 보령시,050001, 45세,2021,1276,680,596,114.1,1196,623,573,108.7
34030, 보령시,050002, 46세,2021,1366,755,611,123.6,1292,702,590,119
34030, 보령시,050003, 47세,2021,1587,887,700,126.7,1510,833,677,123
34030, 보령시,050004, 48세,2021,1573,875,698,125.4,1517,837,680,123.1
34030, 보령시,050005, 49세,2021,1510,824,686,120.1,1443,783,660,118.6
34030, 보령시,055,50~54세,2021,8061,4325,3736,115.8,7860,4206,3654,115.1
34030, 보령시,055001, 50세,2021,1617,896,721,124.3,1572,863,709,121.7
34030, 보령시,055002, 51세,2021,1514,801,713,112.3,1469,778,691,112.6
34030, 보령시,055003, 52세,2021,1657,874,783,111.6,1609,847,762,111.2
34030, 보령시,055004, 53세,2021,1735,932,803,116.1,1698,910,788,115.5
34030, 보령시,055005, 54세,2021,1538,822,716,114.8,1512,808,704,114.8
34030, 보령시,060,55~59세,2021,8170,4289,3881,110.5,8022,4220,3802,111
34030, 보령시,060001, 55세,2021,1445,810,635,127.6,1417,796,621,128.2
34030, 보령시,060002, 56세,2021,1663,852,811,105.1,1637,839,798,105.1
34030, 보령시,060003, 57세,2021,1654,861,793,108.6,1620,846,774,109.3
34030, 보령시,060004, 58세,2021,1584,825,759,108.7,1550,813,737,110.3
34030, 보령시,060005, 59세,2021,1824,941,883,106.6,1798,926,872,106.2
34030, 보령시,065,60~64세,2021,9664,4812,4852,99.2,9606,4790,4816,99.5
34030, 보령시,065001, 60세,2021,2198,1115,1083,103,2190,1112,1078,103.2
34030, 보령시,065002, 61세,2021,2075,1019,1056,96.5,2060,1015,1045,97.1
34030, 보령시,065003, 62세,2021,1860,902,958,94.2,1844,896,948,94.5
34030, 보령시,065004, 63세,2021,1755,856,899,95.2,1746,854,892,95.7
34030, 보령시,065005, 64세,2021,1776,920,856,107.5,1766,913,853,107
34030, 보령시,070,65~69세,2021,7700,3698,4002,92.4,7659,3681,3978,92.5
34030, 보령시,070001, 65세,2021,1656,827,829,99.8,1645,823,822,100.1
34030, 보령시,070002, 66세,2021,1841,911,930,98,1827,904,923,97.9
34030, 보령시,070003, 67세,2021,1580,768,812,94.6,1576,767,809,94.8
34030, 보령시,070004, 68세,2021,1222,564,658,85.7,1215,561,654,85.8
34030, 보령시,070005, 69세,2021,1401,628,773,81.2,1396,626,770,81.3
34030, 보령시,075,70~74세,2021,6304,2961,3343,88.6,6274,2948,3326,88.6
34030, 보령시,075001, 70세,2021,1218,599,619,96.8,1210,594,616,96.4
34030, 보령시,075002, 71세,2021,1322,624,698,89.4,1314,620,694,89.3
34030, 보령시,075003, 72세,2021,1363,649,714,90.9,1358,648,710,91.3
34030, 보령시,075004, 73세,2021,1212,568,644,88.2,1209,567,642,88.3
34030, 보령시,075005, 74세,2021,1189,521,668,78,1183,519,664,78.2
34030, 보령시,080,75~79세,2021,4732,2040,2692,75.8,4725,2035,2690,75.7
34030, 보령시,080001, 75세,2021,845,405,440,92,844,404,440,91.8
34030, 보령시,080002, 76세,2021,856,358,498,71.9,855,358,497,72
34030, 보령시,080003, 77세,2021,950,401,549,73,948,399,549,72.7
34030, 보령시,080004, 78세,2021,962,434,528,82.2,960,433,527,82.2
34030, 보령시,080005, 79세,2021,1119,442,677,65.3,1118,441,677,65.1
34030, 보령시,085,80~84세,2021,3911,1500,2411,62.2,3903,1497,2406,62.2
34030, 보령시,085001, 80세,2021,849,333,516,64.5,848,333,515,64.7
34030, 보령시,085002, 81세,2021,792,313,479,65.3,789,312,477,65.4
34030, 보령시,085003, 82세,2021,830,315,515,61.2,828,314,514,61.1
34030, 보령시,085004, 83세,2021,781,279,502,55.6,780,278,502,55.4
34030, 보령시,085005, 84세,2021,659,260,399,65.2,658,260,398,65.3
34030, 보령시,090,85~89세,2021,2239,726,1513,48,2237,725,1512,47.9
34030, 보령시,090001, 85세,2021,598,197,401,49.1,598,197,401,49.1
34030, 보령시,090002, 86세,2021,588,197,391,50.4,586,196,390,50.3
34030, 보령시,090003, 87세,2021,397,129,268,48.1,397,129,268,48.1
34030, 보령시,090004, 88세,2021,349,128,221,57.9,349,128,221,57.9
34030, 보령시,090005, 89세,2021,307,75,232,32.3,307,75,232,32.3
34030, 보령시,095,90~94세,2021,689,169,520,32.5,688,169,519,32.6
34030, 보령시,095001, 90세,2021,203,59,144,41,202,59,143,41.3
34030, 보령시,095002, 91세,2021,172,32,140,22.9,172,32,140,22.9
34030, 보령시,095003, 92세,2021,147,37,110,33.6,147,37,110,33.6
34030, 보령시,095004, 93세,2021,105,25,80,31.3,105,25,80,31.3
34030, 보령시,095005, 94세,2021,62,16,46,34.8,62,16,46,34.8
34030, 보령시,100,95~99세,2021,146,25,121,20.7,146,25,121,20.7
34030, 보령시,100001, 95세,2021,53,9,44,20.5,53,9,44,20.5
34030, 보령시,100002, 96세,2021,34,7,27,25.9,34,7,27,25.9
34030, 보령시,100003, 97세,2021,22,6,16,37.5,22,6,16,37.5
34030, 보령시,100004, 98세,2021,26,X,23,13,26,X,23,13
34030, 보령시,100005, 99세,2021,11,X,11,0,11,X,11,0
34030, 보령시,101,100세이상,2021,22,X,18,22.2,22,X,18,22.2
34030, 보령시,102,15세미만,2021,9514,4830,4684,103.1,9476,4812,4664,103.2
34030, 보령시,103,15~64세,2021,62133,34411,27722,124.1,58283,31519,26764,117.8
34030, 보령시,104,65세이상,2021,25743,11123,14620,76.1,25654,11084,14570,76.1
34030, 보령시,086,85세이상,2021,3096,924,2172,42.5,3093,923,2170,42.5
34030, 보령시,126,평균연령,2021,49.1,47,51.3,,49.6,47.7,51.5,
34030, 보령시,127,중위연령,2021,51.9,49.2,54.8,,52.9,50.7,55.3,
34040, 아산시,000,합계,2021,348727,182939,165788,110.3,320384,166242,154142,107.8
34040, 아산시,005,0~4세,2021,13626,6934,6692,103.6,12737,6506,6231,104.4
34040, 아산시,005001, 0세,2021,2087,1094,993,110.2,1921,1013,908,111.6
34040, 아산시,005002, 1세,2021,2402,1232,1170,105.3,2236,1152,1084,106.3
34040, 아산시,005003, 2세,2021,2795,1419,1376,103.1,2620,1335,1285,103.9
34040, 아산시,005004, 3세,2021,3027,1499,1528,98.1,2839,1412,1427,98.9
34040, 아산시,005005, 4세,2021,3315,1690,1625,104,3121,1594,1527,104.4
34040, 아산시,010,5~9세,2021,19561,10090,9471,106.5,18745,9669,9076,106.5
34040, 아산시,010001, 5세,2021,3828,1929,1899,101.6,3607,1827,1780,102.6
34040, 아산시,010002, 6세,2021,3889,2045,1844,110.9,3727,1971,1756,112.2
34040, 아산시,010003, 7세,2021,3734,1938,1796,107.9,3591,1849,1742,106.1
34040, 아산시,010004, 8세,2021,3876,2011,1865,107.8,3742,1933,1809,106.9
34040, 아산시,010005, 9세,2021,4234,2167,2067,104.8,4078,2089,1989,105
34040, 아산시,015,10~14세,2021,19324,10018,9306,107.7,18786,9732,9054,107.5
34040, 아산시,015001, 10세,2021,4177,2159,2018,107,4060,2110,1950,108.2
34040, 아산시,015002, 11세,2021,3898,2041,1857,109.9,3779,1982,1797,110.3
34040, 아산시,015003, 12세,2021,3749,1953,1796,108.7,3638,1889,1749,108
34040, 아산시,015004, 13세,2021,3816,1922,1894,101.5,3714,1863,1851,100.6
34040, 아산시,015005, 14세,2021,3684,1943,1741,111.6,3595,1888,1707,110.6
34040, 아산시,020,15~19세,2021,17414,8711,8703,100.1,16674,8347,8327,100.2
34040, 아산시,020001, 15세,2021,3406,1717,1689,101.7,3328,1668,1660,100.5
34040, 아산시,020002, 16세,2021,3174,1631,1543,105.7,3124,1606,1518,105.8
34040, 아산시,020003, 17세,2021,3444,1642,1802,91.1,3367,1609,1758,91.5
34040, 아산시,020004, 18세,2021,3400,1725,1675,103,3253,1648,1605,102.7
34040, 아산시,020005, 19세,2021,3990,1996,1994,100.1,3602,1816,1786,101.7
34040, 아산시,025,20~24세,2021,22851,12255,10596,115.7,20018,10749,9269,116
34040, 아산시,025001, 20세,2021,4380,2174,2206,98.5,3889,1934,1955,98.9
34040, 아산시,025002, 21세,2021,4755,2334,2421,96.4,4253,2091,2162,96.7
34040, 아산시,025003, 22세,2021,4535,2461,2074,118.7,3976,2163,1813,119.3
34040, 아산시,025004, 23세,2021,4619,2594,2025,128.1,3984,2270,1714,132.4
34040, 아산시,025005, 24세,2021,4562,2692,1870,144,3916,2291,1625,141
34040, 아산시,030,25~29세,2021,23169,13613,9556,142.5,19683,11253,8430,133.5
34040, 아산시,030001, 25세,2021,4333,2562,1771,144.7,3674,2125,1549,137.2
34040, 아산시,030002, 26세,2021,4315,2563,1752,146.3,3646,2122,1524,139.2
34040, 아산시,030003, 27세,2021,4572,2697,1875,143.8,3858,2209,1649,134
34040, 아산시,030004, 28세,2021,4930,2894,2036,142.1,4197,2387,1810,131.9
34040, 아산시,030005, 29세,2021,5019,2897,2122,136.5,4308,2410,1898,127
34040, 아산시,035,30~34세,2021,25203,14120,11083,127.4,20816,11271,9545,118.1
34040, 아산시,035001, 30세,2021,4837,2798,2039,137.2,4039,2269,1770,128.2
34040, 아산시,035002, 31세,2021,4837,2769,2068,133.9,3971,2186,1785,122.5
34040, 아산시,035003, 32세,2021,5002,2805,2197,127.7,4101,2224,1877,118.5
34040, 아산시,035004, 33세,2021,5139,2773,2366,117.2,4231,2194,2037,107.7
34040, 아산시,035005, 34세,2021,5388,2975,2413,123.3,4474,2398,2076,115.5
34040, 아산시,040,35~39세,2021,30703,16742,13961,119.9,26745,14200,12545,113.2
34040, 아산시,040001, 35세,2021,5504,2959,2545,116.3,4678,2436,2242,108.7
34040, 아산시,040002, 36세,2021,5627,3121,2506,124.5,4814,2587,2227,116.2
34040, 아산시,040003, 37세,2021,5859,3143,2716,115.7,5072,2651,2421,109.5
34040, 아산시,040004, 38세,2021,6428,3500,2928,119.5,5635,2978,2657,112.1
34040, 아산시,040005, 39세,2021,7285,4019,3266,123.1,6546,3548,2998,118.3
34040, 아산시,045,40~44세,2021,32631,17950,14681,122.3,29657,16087,13570,118.5
34040, 아산시,045001, 40세,2021,6932,3841,3091,124.3,6262,3428,2834,121
34040, 아산시,045002, 41세,2021,7047,3837,3210,119.5,6447,3451,2996,115.2
34040, 아산시,045003, 42세,2021,6711,3674,3037,121,6015,3246,2769,117.2
34040, 아산시,045004, 43세,2021,5926,3279,2647,123.9,5404,2953,2451,120.5
34040, 아산시,045005, 44세,2021,6015,3319,2696,123.1,5529,3009,2520,119.4
34040, 아산시,050,45~49세,2021,28843,15748,13095,120.3,26519,14346,12173,117.9
34040, 아산시,050001, 45세,2021,5728,3090,2638,117.1,5221,2784,2437,114.2
34040, 아산시,050002, 46세,2021,5649,3061,2588,118.3,5204,2786,2418,115.2
34040, 아산시,050003, 47세,2021,5964,3250,2714,119.7,5515,2984,2531,117.9
34040, 아산시,050004, 48세,2021,5884,3176,2708,117.3,5466,2940,2526,116.4
34040, 아산시,050005, 49세,2021,5618,3171,2447,129.6,5113,2852,2261,126.1
34040, 아산시,055,50~54세,2021,27621,14969,12652,118.3,25665,13879,11786,117.8
34040, 아산시,055001, 50세,2021,6067,3376,2691,125.5,5623,3119,2504,124.6
34040, 아산시,055002, 51세,2021,5667,3139,2528,124.2,5224,2880,2344,122.9
34040, 아산시,055003, 52세,2021,5755,3101,2654,116.8,5361,2888,2473,116.8
34040, 아산시,055004, 53세,2021,5334,2770,2564,108,4976,2581,2395,107.8
34040, 아산시,055005, 54세,2021,4798,2583,2215,116.6,4481,2411,2070,116.5
34040, 아산시,060,55~59세,2021,22699,12205,10494,116.3,21166,11448,9718,117.8
34040, 아산시,060001, 55세,2021,4641,2525,2116,119.3,4310,2372,1938,122.4
34040, 아산시,060002, 56세,2021,4920,2649,2271,116.6,4579,2467,2112,116.8
34040, 아산시,060003, 57세,2021,4219,2252,1967,114.5,3935,2101,1834,114.6
34040, 아산시,060004, 58세,2021,4387,2363,2024,116.7,4053,2202,1851,119
34040, 아산시,060005, 59세,2021,4532,2416,2116,114.2,4289,2306,1983,116.3
34040, 아산시,065,60~64세,2021,20818,10588,10230,103.5,19876,10137,9739,104.1
34040, 아산시,065001, 60세,2021,4876,2550,2326,109.6,4705,2468,2237,110.3
34040, 아산시,065002, 61세,2021,4774,2424,2350,103.1,4530,2320,2210,105
34040, 아산시,065003, 62세,2021,3993,2040,1953,104.5,3827,1960,1867,105
34040, 아산시,065004, 63세,2021,3565,1782,1783,99.9,3381,1695,1686,100.5
34040, 아산시,065005, 64세,2021,3610,1792,1818,98.6,3433,1694,1739,97.4
34040, 아산시,070,65~69세,2021,14505,6995,7510,93.1,13973,6775,7198,94.1
34040, 아산시,070001, 65세,2021,3313,1639,1674,97.9,3172,1575,1597,98.6
34040, 아산시,070002, 66세,2021,3395,1629,1766,92.2,3272,1581,1691,93.5
34040, 아산시,070003, 67세,2021,2766,1330,1436,92.6,2657,1285,1372,93.7
34040, 아산시,070004, 68세,2021,2386,1150,1236,93,2309,1121,1188,94.4
34040, 아산시,070005, 69세,2021,2645,1247,1398,89.2,2563,1213,1350,89.9
34040, 아산시,075,70~74세,2021,10350,4809,5541,86.8,10101,4703,5398,87.1
34040, 아산시,075001, 70세,2021,1934,899,1035,86.9,1861,868,993,87.4
34040, 아산시,075002, 71세,2021,2177,974,1203,81,2124,958,1166,82.2
34040, 아산시,075003, 72세,2021,2145,1036,1109,93.4,2086,1009,1077,93.7
34040, 아산시,075004, 73세,2021,2068,972,1096,88.7,2036,959,1077,89
34040, 아산시,075005, 74세,2021,2026,928,1098,84.5,1994,909,1085,83.8
34040, 아산시,080,75~79세,2021,7957,3340,4617,72.3,7856,3308,4548,72.7
34040, 아산시,080001, 75세,2021,1483,664,819,81.1,1457,653,804,81.2
34040, 아산시,080002, 76세,2021,1470,625,845,74,1448,619,829,74.7
34040, 아산시,080003, 77세,2021,1578,679,899,75.5,1554,674,880,76.6
34040, 아산시,080004, 78세,2021,1543,618,925,66.8,1527,613,914,67.1
34040, 아산시,080005, 79세,2021,1883,754,1129,66.8,1870,749,1121,66.8
34040, 아산시,085,80~84세,2021,6414,2379,4035,59,6352,2368,3984,59.4
34040, 아산시,085001, 80세,2021,1401,567,834,68,1385,562,823,68.3
34040, 아산시,085002, 81세,2021,1277,481,796,60.4,1265,479,786,60.9
34040, 아산시,085003, 82세,2021,1397,505,892,56.6,1384,504,880,57.3
34040, 아산시,085004, 83세,2021,1174,432,742,58.2,1164,430,734,58.6
34040, 아산시,085005, 84세,2021,1165,394,771,51.1,1154,393,761,51.6
34040, 아산시,090,85~89세,2021,3649,1170,2479,47.2,3630,1162,2468,47.1
34040, 아산시,090001, 85세,2021,957,345,612,56.4,952,344,608,56.6
34040, 아산시,090002, 86세,2021,905,305,600,50.8,900,302,598,50.5
34040, 아산시,090003, 87세,2021,703,206,497,41.4,700,204,496,41.1
34040, 아산시,090004, 88세,2021,580,155,425,36.5,577,154,423,36.4
34040, 아산시,090005, 89세,2021,504,159,345,46.1,501,158,343,46.1
34040, 아산시,095,90~94세,2021,1138,254,884,28.7,1135,253,882,28.7
34040, 아산시,095001, 90세,2021,325,83,242,34.3,324,83,241,34.4
34040, 아산시,095002, 91세,2021,293,65,228,28.5,292,65,227,28.6
34040, 아산시,095003, 92세,2021,223,51,172,29.7,223,51,172,29.7
34040, 아산시,095004, 93세,2021,182,32,150,21.3,181,31,150,20.7
34040, 아산시,095005, 94세,2021,115,23,92,25,115,23,92,25
34040, 아산시,100,95~99세,2021,213,43,170,25.3,212,43,169,25.4
34040, 아산시,100001, 95세,2021,71,13,58,22.4,71,13,58,22.4
34040, 아산시,100002, 96세,2021,53,11,42,26.2,53,11,42,26.2
34040, 아산시,100003, 97세,2021,36,8,28,28.6,35,8,27,29.6
34040, 아산시,100004, 98세,2021,32,6,26,23.1,32,6,26,23.1
34040, 아산시,100005, 99세,2021,21,5,16,31.3,21,5,16,31.3
34040, 아산시,101,100세이상,2021,38,6,32,18.8,38,6,32,18.8
34040, 아산시,102,15세미만,2021,52511,27042,25469,106.2,50268,25907,24361,106.3
34040, 아산시,103,15~64세,2021,251952,136901,115051,119,226819,121717,105102,115.8
34040, 아산시,104,65세이상,2021,44264,18996,25268,75.2,43297,18618,24679,75.4
34040, 아산시,086,85세이상,2021,5038,1473,3565,41.3,5015,1464,3551,41.2
34040, 아산시,126,평균연령,2021,40.1,39.2,41.1,,40.4,39.5,41.4,
34040, 아산시,127,중위연령,2021,40.4,39.7,41.1,,41,40.4,41.6,
34050, 서산시,000,합계,2021,177497,92741,84756,109.4,171473,89453,82020,109.1
34050, 서산시,005,0~4세,2021,6291,3182,3109,102.3,6169,3120,3049,102.3
34050, 서산시,005001, 0세,2021,1071,532,539,98.7,1052,524,528,99.2
34050, 서산시,005002, 1세,2021,1169,584,585,99.8,1145,572,573,99.8
34050, 서산시,005003, 2세,2021,1271,646,625,103.4,1249,631,618,102.1
34050, 서산시,005004, 3세,2021,1350,671,679,98.8,1324,662,662,100
34050, 서산시,005005, 4세,2021,1430,749,681,110,1399,731,668,109.4
34050, 서산시,010,5~9세,2021,8657,4432,4225,104.9,8538,4376,4162,105.1
34050, 서산시,010001, 5세,2021,1635,847,788,107.5,1611,836,775,107.9
34050, 서산시,010002, 6세,2021,1713,861,852,101.1,1687,848,839,101.1
34050, 서산시,010003, 7세,2021,1742,902,840,107.4,1717,894,823,108.6
34050, 서산시,010004, 8세,2021,1709,839,870,96.4,1686,827,859,96.3
34050, 서산시,010005, 9세,2021,1858,983,875,112.3,1837,971,866,112.1
34050, 서산시,015,10~14세,2021,8828,4630,4198,110.3,8759,4599,4160,110.6
34050, 서산시,015001, 10세,2021,1776,948,828,114.5,1758,942,816,115.4
34050, 서산시,015002, 11세,2021,1790,927,863,107.4,1778,921,857,107.5
34050, 서산시,015003, 12세,2021,1671,883,788,112.1,1662,878,784,112
34050, 서산시,015004, 13세,2021,1757,925,832,111.2,1743,918,825,111.3
34050, 서산시,015005, 14세,2021,1834,947,887,106.8,1818,940,878,107.1
34050, 서산시,020,15~19세,2021,7594,4094,3500,117,7522,4058,3464,117.1
34050, 서산시,020001, 15세,2021,1615,818,797,102.6,1606,813,793,102.5
34050, 서산시,020002, 16세,2021,1490,780,710,109.9,1478,773,705,109.6
34050, 서산시,020003, 17세,2021,1617,886,731,121.2,1600,882,718,122.8
34050, 서산시,020004, 18세,2021,1523,818,705,116,1512,811,701,115.7
34050, 서산시,020005, 19세,2021,1349,792,557,142.2,1326,779,547,142.4
34050, 서산시,025,20~24세,2021,8695,5016,3679,136.3,8138,4738,3400,139.4
34050, 서산시,025001, 20세,2021,1710,973,737,132,1655,951,704,135.1
34050, 서산시,025002, 21세,2021,1807,1053,754,139.7,1720,1014,706,143.6
34050, 서산시,025003, 22세,2021,1703,963,740,130.1,1572,902,670,134.6
34050, 서산시,025004, 23세,2021,1699,1004,695,144.5,1547,923,624,147.9
34050, 서산시,025005, 24세,2021,1776,1023,753,135.9,1644,948,696,136.2
34050, 서산시,030,25~29세,2021,10210,6251,3959,157.9,9465,5807,3658,158.7
34050, 서산시,030001, 25세,2021,1847,1131,716,158,1697,1032,665,155.2
34050, 서산시,030002, 26세,2021,1952,1209,743,162.7,1811,1124,687,163.6
34050, 서산시,030003, 27세,2021,2113,1297,816,158.9,1964,1213,751,161.5
34050, 서산시,030004, 28세,2021,2124,1327,797,166.5,1987,1242,745,166.7
34050, 서산시,030005, 29세,2021,2174,1287,887,145.1,2006,1196,810,147.7
34050, 서산시,035,30~34세,2021,10833,6256,4577,136.7,9969,5769,4200,137.4
34050, 서산시,035001, 30세,2021,2118,1257,861,146,1946,1152,794,145.1
34050, 서산시,035002, 31세,2021,2171,1276,895,142.6,2015,1184,831,142.5
34050, 서산시,035003, 32세,2021,2228,1278,950,134.5,2074,1194,880,135.7
34050, 서산시,035004, 33세,2021,2142,1213,929,130.6,1943,1104,839,131.6
34050, 서산시,035005, 34세,2021,2174,1232,942,130.8,1991,1135,856,132.6
34050, 서산시,040,35~39세,2021,12145,6559,5586,117.4,11272,6068,5204,116.6
34050, 서산시,040001, 35세,2021,2108,1135,973,116.6,1946,1055,891,118.4
34050, 서산시,040002, 36세,2021,2174,1181,993,118.9,1984,1073,911,117.8
34050, 서산시,040003, 37세,2021,2391,1305,1086,120.2,2204,1200,1004,119.5
34050, 서산시,040004, 38세,2021,2577,1386,1191,116.4,2427,1295,1132,114.4
34050, 서산시,040005, 39세,2021,2895,1552,1343,115.6,2711,1445,1266,114.1
34050, 서산시,045,40~44세,2021,13989,7513,6476,116,13289,7104,6185,114.9
34050, 서산시,045001, 40세,2021,2815,1532,1283,119.4,2651,1436,1215,118.2
34050, 서산시,045002, 41세,2021,2998,1612,1386,116.3,2847,1517,1330,114.1
34050, 서산시,045003, 42세,2021,2797,1502,1295,116,2659,1423,1236,115.1
34050, 서산시,045004, 43세,2021,2716,1475,1241,118.9,2582,1397,1185,117.9
34050, 서산시,045005, 44세,2021,2663,1392,1271,109.5,2550,1331,1219,109.2
34050, 서산시,050,45~49세,2021,14333,7701,6632,116.1,13799,7381,6418,115
34050, 서산시,050001, 45세,2021,2620,1415,1205,117.4,2505,1340,1165,115
34050, 서산시,050002, 46세,2021,2726,1386,1340,103.4,2619,1326,1293,102.6
34050, 서산시,050003, 47세,2021,2963,1632,1331,122.6,2852,1565,1287,121.6
34050, 서산시,050004, 48세,2021,3098,1683,1415,118.9,3000,1624,1376,118
34050, 서산시,050005, 49세,2021,2926,1585,1341,118.2,2823,1526,1297,117.7
34050, 서산시,055,50~54세,2021,15308,8254,7054,117,14817,8000,6817,117.4
34050, 서산시,055001, 50세,2021,3175,1747,1428,122.3,3071,1691,1380,122.5
34050, 서산시,055002, 51세,2021,2981,1611,1370,117.6,2870,1561,1309,119.3
34050, 서산시,055003, 52세,2021,3186,1722,1464,117.6,3089,1670,1419,117.7
34050, 서산시,055004, 53세,2021,3132,1640,1492,109.9,3046,1588,1458,108.9
34050, 서산시,055005, 54세,2021,2834,1534,1300,118,2741,1490,1251,119.1
34050, 서산시,060,55~59세,2021,13666,7313,6353,115.1,13286,7117,6169,115.4
34050, 서산시,060001, 55세,2021,2642,1416,1226,115.5,2571,1383,1188,116.4
34050, 서산시,060002, 56세,2021,2929,1579,1350,117,2844,1535,1309,117.3
34050, 서산시,060003, 57세,2021,2550,1360,1190,114.3,2480,1325,1155,114.7
34050, 서산시,060004, 58세,2021,2698,1451,1247,116.4,2606,1397,1209,115.6
34050, 서산시,060005, 59세,2021,2847,1507,1340,112.5,2785,1477,1308,112.9
34050, 서산시,065,60~64세,2021,13776,7027,6749,104.1,13539,6912,6627,104.3
34050, 서산시,065001, 60세,2021,3233,1689,1544,109.4,3182,1666,1516,109.9
34050, 서산시,065002, 61세,2021,3135,1570,1565,100.3,3076,1538,1538,100
34050, 서산시,065003, 62세,2021,2642,1345,1297,103.7,2601,1325,1276,103.8
34050, 서산시,065004, 63세,2021,2383,1213,1170,103.7,2337,1195,1142,104.6
34050, 서산시,065005, 64세,2021,2383,1210,1173,103.2,2343,1188,1155,102.9
34050, 서산시,070,65~69세,2021,9768,4801,4967,96.7,9624,4737,4887,96.9
34050, 서산시,070001, 65세,2021,2192,1088,1104,98.6,2159,1068,1091,97.9
34050, 서산시,070002, 66세,2021,2185,1047,1138,92,2155,1038,1117,92.9
34050, 서산시,070003, 67세,2021,1894,918,976,94.1,1860,900,960,93.8
34050, 서산시,070004, 68세,2021,1612,819,793,103.3,1587,811,776,104.5
34050, 서산시,070005, 69세,2021,1885,929,956,97.2,1863,920,943,97.6
34050, 서산시,075,70~74세,2021,7775,3806,3969,95.9,7710,3777,3933,96
34050, 서산시,075001, 70세,2021,1436,710,726,97.8,1422,702,720,97.5
34050, 서산시,075002, 71세,2021,1648,807,841,96,1636,803,833,96.4
34050, 서산시,075003, 72세,2021,1712,857,855,100.2,1697,849,848,100.1
34050, 서산시,075004, 73세,2021,1548,777,771,100.8,1535,771,764,100.9
34050, 서산시,075005, 74세,2021,1431,655,776,84.4,1420,652,768,84.9
34050, 서산시,080,75~79세,2021,6138,2742,3396,80.7,6103,2730,3373,80.9
34050, 서산시,080001, 75세,2021,1162,573,589,97.3,1153,569,584,97.4
34050, 서산시,080002, 76세,2021,1042,479,563,85.1,1034,478,556,86
34050, 서산시,080003, 77세,2021,1154,507,647,78.4,1149,505,644,78.4
34050, 서산시,080004, 78세,2021,1160,536,624,85.9,1155,533,622,85.7
34050, 서산시,080005, 79세,2021,1620,647,973,66.5,1612,645,967,66.7
34050, 서산시,085,80~84세,2021,4949,1908,3041,62.7,4938,1905,3033,62.8
34050, 서산시,085001, 80세,2021,1053,419,634,66.1,1051,419,632,66.3
34050, 서산시,085002, 81세,2021,941,372,569,65.4,935,369,566,65.2
34050, 서산시,085003, 82세,2021,1055,405,650,62.3,1054,405,649,62.4
34050, 서산시,085004, 83세,2021,1024,389,635,61.3,1022,389,633,61.5
34050, 서산시,085005, 84세,2021,876,323,553,58.4,876,323,553,58.4
34050, 서산시,090,85~89세,2021,3277,1002,2275,44,3271,1001,2270,44.1
34050, 서산시,090001, 85세,2021,835,275,560,49.1,834,275,559,49.2
34050, 서산시,090002, 86세,2021,775,247,528,46.8,773,247,526,47
34050, 서산시,090003, 87세,2021,618,193,425,45.4,618,193,425,45.4
34050, 서산시,090004, 88세,2021,554,157,397,39.5,552,157,395,39.7
34050, 서산시,090005, 89세,2021,495,130,365,35.6,494,129,365,35.3
34050, 서산시,095,90~94세,2021,988,218,770,28.3,988,218,770,28.3
34050, 서산시,095001, 90세,2021,289,66,223,29.6,289,66,223,29.6
34050, 서산시,095002, 91세,2021,233,56,177,31.6,233,56,177,31.6
34050, 서산시,095003, 92세,2021,222,54,168,32.1,222,54,168,32.1
34050, 서산시,095004, 93세,2021,149,23,126,18.3,149,23,126,18.3
34050, 서산시,095005, 94세,2021,95,19,76,25,95,19,76,25
34050, 서산시,100,95~99세,2021,244,34,210,16.2,244,34,210,16.2
34050, 서산시,100001, 95세,2021,73,13,60,21.7,73,13,60,21.7
34050, 서산시,100002, 96세,2021,65,8,57,14,65,8,57,14
34050, 서산시,100003, 97세,2021,51,6,45,13.3,51,6,45,13.3
34050, 서산시,100004, 98세,2021,27,X,24,12.5,27,X,24,12.5
34050, 서산시,100005, 99세,2021,28,X,24,16.7,28,X,24,16.7
34050, 서산시,101,100세이상,2021,33,X,31,6.5,33,X,31,6.5
34050, 서산시,102,15세미만,2021,23776,12244,11532,106.2,23466,12095,11371,106.4
34050, 서산시,103,15~64세,2021,120549,65984,54565,120.9,115096,62954,52142,120.7
34050, 서산시,104,65세이상,2021,33172,14513,18659,77.8,32911,14404,18507,77.8
34050, 서산시,086,85세이상,2021,4542,1256,3286,38.2,4536,1255,3281,38.3
34050, 서산시,126,평균연령,2021,44.2,42.7,45.8,,44.4,42.9,46,
34050, 서산시,127,중위연령,2021,45.6,43.9,47.4,,46,44.3,47.8,
34060, 논산시,000,합계,2021,117262,58442,58820,99.4,111868,55794,56074,99.5
34060, 논산시,005,0~4세,2021,2815,1434,1381,103.8,2766,1413,1353,104.4
34060, 논산시,005001, 0세,2021,475,233,242,96.3,462,228,234,97.4
34060, 논산시,005002, 1세,2021,486,243,243,100,481,242,239,101.3
34060, 논산시,005003, 2세,2021,588,292,296,98.6,575,286,289,99
34060, 논산시,005004, 3세,2021,601,329,272,121,592,323,269,120.1
34060, 논산시,005005, 4세,2021,665,337,328,102.7,656,334,322,103.7
34060, 논산시,010,5~9세,2021,3981,2019,1962,102.9,3941,2001,1940,103.1
34060, 논산시,010001, 5세,2021,740,379,361,105,732,375,357,105
34060, 논산시,010002, 6세,2021,796,396,400,99,787,391,396,98.7
34060, 논산시,010003, 7세,2021,785,401,384,104.4,777,398,379,105
34060, 논산시,010004, 8세,2021,787,402,385,104.4,779,399,380,105
34060, 논산시,010005, 9세,2021,873,441,432,102.1,866,438,428,102.3
34060, 논산시,015,10~14세,2021,4525,2346,2179,107.7,4494,2325,2169,107.2
34060, 논산시,015001, 10세,2021,851,447,404,110.6,845,443,402,110.2
34060, 논산시,015002, 11세,2021,889,456,433,105.3,882,453,429,105.6
34060, 논산시,015003, 12세,2021,856,433,423,102.4,848,427,421,101.4
34060, 논산시,015004, 13세,2021,981,488,493,99,976,485,491,98.8
34060, 논산시,015005, 14세,2021,948,522,426,122.5,943,517,426,121.4
34060, 논산시,020,15~19세,2021,5584,3013,2571,117.2,5525,2985,2540,117.5
34060, 논산시,020001, 15세,2021,949,472,477,99,946,471,475,99.2
34060, 논산시,020002, 16세,2021,939,492,447,110.1,929,485,444,109.2
34060, 논산시,020003, 17세,2021,1352,755,597,126.5,1343,750,593,126.5
34060, 논산시,020004, 18세,2021,1245,682,563,121.1,1236,678,558,121.5
34060, 논산시,020005, 19세,2021,1099,612,487,125.7,1071,601,470,127.9
34060, 논산시,025,20~24세,2021,6548,3693,2855,129.4,5902,3405,2497,136.4
34060, 논산시,025001, 20세,2021,1190,665,525,126.7,1145,647,498,129.9
34060, 논산시,025002, 21세,2021,1354,773,581,133,1277,735,542,135.6
34060, 논산시,025003, 22세,2021,1355,753,602,125.1,1236,698,538,129.7
34060, 논산시,025004, 23세,2021,1356,772,584,132.2,1157,688,469,146.7
34060, 논산시,025005, 24세,2021,1293,730,563,129.7,1087,637,450,141.6
34060, 논산시,030,25~29세,2021,6363,3463,2900,119.4,5094,2854,2240,127.4
34060, 논산시,030001, 25세,2021,1287,685,602,113.8,1048,587,461,127.3
34060, 논산시,030002, 26세,2021,1240,682,558,122.2,985,566,419,135.1
34060, 논산시,030003, 27세,2021,1286,689,597,115.4,1047,577,470,122.8
34060, 논산시,030004, 28세,2021,1257,695,562,123.7,989,553,436,126.8
34060, 논산시,030005, 29세,2021,1293,712,581,122.5,1025,571,454,125.8
34060, 논산시,035,30~34세,2021,5612,3032,2580,117.5,4616,2530,2086,121.3
34060, 논산시,035001, 30세,2021,1181,651,530,122.8,976,558,418,133.5
34060, 논산시,035002, 31세,2021,1181,673,508,132.5,963,569,394,144.4
34060, 논산시,035003, 32세,2021,1084,586,498,117.7,888,483,405,119.3
34060, 논산시,035004, 33세,2021,1144,593,551,107.6,946,486,460,105.7
34060, 논산시,035005, 34세,2021,1022,529,493,107.3,843,434,409,106.1
34060, 논산시,040,35~39세,2021,5909,3078,2831,108.7,5161,2681,2480,108.1
34060, 논산시,040001, 35세,2021,1090,562,528,106.4,938,486,452,107.5
34060, 논산시,040002, 36세,2021,1065,542,523,103.6,907,459,448,102.5
34060, 논산시,040003, 37세,2021,1115,581,534,108.8,968,492,476,103.4
34060, 논산시,040004, 38세,2021,1285,685,600,114.2,1158,614,544,112.9
34060, 논산시,040005, 39세,2021,1354,708,646,109.6,1190,630,560,112.5
34060, 논산시,045,40~44세,2021,6835,3537,3298,107.2,6357,3298,3059,107.8
34060, 논산시,045001, 40세,2021,1385,706,679,104,1260,645,615,104.9
34060, 논산시,045002, 41세,2021,1415,724,691,104.8,1313,675,638,105.8
34060, 논산시,045003, 42세,2021,1371,732,639,114.6,1276,682,594,114.8
34060, 논산시,045004, 43세,2021,1245,664,581,114.3,1161,618,543,113.8
34060, 논산시,045005, 44세,2021,1419,711,708,100.4,1347,678,669,101.3
34060, 논산시,050,45~49세,2021,7884,4195,3689,113.7,7560,4034,3526,114.4
34060, 논산시,050001, 45세,2021,1344,721,623,115.7,1270,684,586,116.7
34060, 논산시,050002, 46세,2021,1531,802,729,110,1463,772,691,111.7
34060, 논산시,050003, 47세,2021,1684,919,765,120.1,1629,887,742,119.5
34060, 논산시,050004, 48세,2021,1642,858,784,109.4,1577,825,752,109.7
34060, 논산시,050005, 49세,2021,1683,895,788,113.6,1621,866,755,114.7
34060, 논산시,055,50~54세,2021,9277,4906,4371,112.2,8988,4759,4229,112.5
34060, 논산시,055001, 50세,2021,1911,996,915,108.9,1834,957,877,109.1
34060, 논산시,055002, 51세,2021,1726,937,789,118.8,1663,910,753,120.8
34060, 논산시,055003, 52세,2021,1896,1000,896,111.6,1843,973,870,111.8
34060, 논산시,055004, 53세,2021,1941,1040,901,115.4,1891,1011,880,114.9
34060, 논산시,055005, 54세,2021,1803,933,870,107.2,1757,908,849,106.9
34060, 논산시,060,55~59세,2021,9485,4891,4594,106.5,9280,4795,4485,106.9
34060, 논산시,060001, 55세,2021,1689,890,799,111.4,1641,870,771,112.8
34060, 논산시,060002, 56세,2021,1998,983,1015,96.8,1960,965,995,97
34060, 논산시,060003, 57세,2021,1859,958,901,106.3,1812,936,876,106.8
34060, 논산시,060004, 58세,2021,1888,998,890,112.1,1841,976,865,112.8
34060, 논산시,060005, 59세,2021,2051,1062,989,107.4,2026,1048,978,107.2
34060, 논산시,065,60~64세,2021,11190,5609,5581,100.5,11051,5542,5509,100.6
34060, 논산시,065001, 60세,2021,2391,1194,1197,99.7,2363,1180,1183,99.7
34060, 논산시,065002, 61세,2021,2422,1195,1227,97.4,2393,1182,1211,97.6
34060, 논산시,065003, 62세,2021,2253,1132,1121,101,2219,1116,1103,101.2
34060, 논산시,065004, 63세,2021,2069,1037,1032,100.5,2041,1021,1020,100.1
34060, 논산시,065005, 64세,2021,2055,1051,1004,104.7,2035,1043,992,105.1
34060, 논산시,070,65~69세,2021,8966,4444,4522,98.3,8897,4409,4488,98.2
34060, 논산시,070001, 65세,2021,1986,998,988,101,1959,987,972,101.5
34060, 논산시,070002, 66세,2021,2060,1052,1008,104.4,2047,1045,1002,104.3
34060, 논산시,070003, 67세,2021,1862,917,945,97,1848,907,941,96.4
34060, 논산시,070004, 68세,2021,1494,736,758,97.1,1487,731,756,96.7
34060, 논산시,070005, 69세,2021,1564,741,823,90,1556,739,817,90.5
34060, 논산시,075,70~74세,2021,6971,3273,3698,88.5,6942,3262,3680,88.6
34060, 논산시,075001, 70세,2021,1310,629,681,92.4,1303,626,677,92.5
34060, 논산시,075002, 71세,2021,1492,717,775,92.5,1481,712,769,92.6
34060, 논산시,075003, 72세,2021,1446,663,783,84.7,1441,662,779,85
34060, 논산시,075004, 73세,2021,1372,626,746,83.9,1370,625,745,83.9
34060, 논산시,075005, 74세,2021,1351,638,713,89.5,1347,637,710,89.7
34060, 논산시,080,75~79세,2021,5659,2411,3248,74.2,5650,2407,3243,74.2
34060, 논산시,080001, 75세,2021,910,432,478,90.4,909,431,478,90.2
34060, 논산시,080002, 76세,2021,1018,443,575,77,1017,442,575,76.9
34060, 논산시,080003, 77세,2021,1147,475,672,70.7,1144,475,669,71
34060, 논산시,080004, 78세,2021,1113,450,663,67.9,1112,450,662,68
34060, 논산시,080005, 79세,2021,1471,611,860,71,1468,609,859,70.9
34060, 논산시,085,80~84세,2021,5108,1792,3316,54,5101,1792,3309,54.2
34060, 논산시,085001, 80세,2021,1113,396,717,55.2,1109,396,713,55.5
34060, 논산시,085002, 81세,2021,1007,373,634,58.8,1005,373,632,59
34060, 논산시,085003, 82세,2021,1084,399,685,58.2,1084,399,685,58.2
34060, 논산시,085004, 83세,2021,959,303,656,46.2,958,303,655,46.3
34060, 논산시,085005, 84세,2021,945,321,624,51.4,945,321,624,51.4
34060, 논산시,090,85~89세,2021,3254,998,2256,44.2,3251,997,2254,44.2
34060, 논산시,090001, 85세,2021,834,276,558,49.5,832,275,557,49.4
34060, 논산시,090002, 86세,2021,808,249,559,44.5,807,249,558,44.6
34060, 논산시,090003, 87세,2021,634,189,445,42.5,634,189,445,42.5
34060, 논산시,090004, 88세,2021,520,156,364,42.9,520,156,364,42.9
34060, 논산시,090005, 89세,2021,458,128,330,38.8,458,128,330,38.8
34060, 논산시,095,90~94세,2021,1063,269,794,33.9,1059,266,793,33.5
34060, 논산시,095001, 90세,2021,301,80,221,36.2,301,80,221,36.2
34060, 논산시,095002, 91세,2021,259,66,193,34.2,259,66,193,34.2
34060, 논산시,095003, 92세,2021,202,53,149,35.6,199,50,149,33.6
34060, 논산시,095004, 93세,2021,160,34,126,27,160,34,126,27
34060, 논산시,095005, 94세,2021,141,36,105,34.3,140,36,104,34.6
34060, 논산시,100,95~99세,2021,200,34,166,20.5,200,34,166,20.5
34060, 논산시,100001, 95세,2021,67,6,61,9.8,67,6,61,9.8
34060, 논산시,100002, 96세,2021,58,13,45,28.9,58,13,45,28.9
34060, 논산시,100003, 97세,2021,31,X,27,14.8,31,X,27,14.8
34060, 논산시,100004, 98세,2021,28,7,21,33.3,28,7,21,33.3
34060, 논산시,100005, 99세,2021,16,X,12,33.3,16,X,12,33.3
34060, 논산시,101,100세이상,2021,33,5,28,17.9,33,5,28,17.9
34060, 논산시,102,15세미만,2021,11321,5799,5522,105,11201,5739,5462,105.1
34060, 논산시,103,15~64세,2021,74687,39417,35270,111.8,69534,36883,32651,113
34060, 논산시,104,65세이상,2021,31254,13226,18028,73.4,31133,13172,17961,73.3
34060, 논산시,086,85세이상,2021,4550,1306,3244,40.3,4543,1302,3241,40.2
34060, 논산시,126,평균연령,2021,48.5,46.5,50.5,,49.2,47.1,51.2,
34060, 논산시,127,중위연령,2021,51.4,49.3,53.6,,52.6,50.4,54.9,
34070, 계룡시,000,합계,2021,41415,20614,20801,99.1,41153,20500,20653,99.3
34070, 계룡시,005,0~4세,2021,1348,691,657,105.2,1348,691,657,105.2
34070, 계룡시,005001, 0세,2021,188,83,105,79,188,83,105,79
34070, 계룡시,005002, 1세,2021,233,128,105,121.9,233,128,105,121.9
34070, 계룡시,005003, 2세,2021,248,134,114,117.5,248,134,114,117.5
34070, 계룡시,005004, 3세,2021,322,156,166,94,322,156,166,94
34070, 계룡시,005005, 4세,2021,357,190,167,113.8,357,190,167,113.8
34070, 계룡시,010,5~9세,2021,2355,1166,1189,98.1,2355,1166,1189,98.1
34070, 계룡시,010001, 5세,2021,418,213,205,103.9,418,213,205,103.9
34070, 계룡시,010002, 6세,2021,453,218,235,92.8,453,218,235,92.8
34070, 계룡시,010003, 7세,2021,480,230,250,92,480,230,250,92
34070, 계룡시,010004, 8세,2021,465,230,235,97.9,465,230,235,97.9
34070, 계룡시,010005, 9세,2021,539,275,264,104.2,539,275,264,104.2
34070, 계룡시,015,10~14세,2021,2954,1579,1375,114.8,2951,1578,1373,114.9
34070, 계룡시,015001, 10세,2021,566,299,267,112,564,298,266,112
34070, 계룡시,015002, 11세,2021,543,295,248,119,542,295,247,119.4
34070, 계룡시,015003, 12세,2021,565,306,259,118.1,565,306,259,118.1
34070, 계룡시,015004, 13세,2021,609,317,292,108.6,609,317,292,108.6
34070, 계룡시,015005, 14세,2021,671,362,309,117.2,671,362,309,117.2
34070, 계룡시,020,15~19세,2021,2623,1315,1308,100.5,2622,1315,1307,100.6
34070, 계룡시,020001, 15세,2021,672,345,327,105.5,672,345,327,105.5
34070, 계룡시,020002, 16세,2021,580,301,279,107.9,580,301,279,107.9
34070, 계룡시,020003, 17세,2021,524,254,270,94.1,523,254,269,94.4
34070, 계룡시,020004, 18세,2021,521,255,266,95.9,521,255,266,95.9
34070, 계룡시,020005, 19세,2021,326,160,166,96.4,326,160,166,96.4
34070, 계룡시,025,20~24세,2021,2162,1284,878,146.2,2138,1266,872,145.2
34070, 계룡시,025001, 20세,2021,459,273,186,146.8,459,273,186,146.8
34070, 계룡시,025002, 21세,2021,470,296,174,170.1,467,295,172,171.5
34070, 계룡시,025003, 22세,2021,456,272,184,147.8,451,268,183,146.4
34070, 계룡시,025004, 23세,2021,369,209,160,130.6,364,205,159,128.9
34070, 계룡시,025005, 24세,2021,408,234,174,134.5,397,225,172,130.8
34070, 계룡시,030,25~29세,2021,1966,1124,842,133.5,1925,1100,825,133.3
34070, 계룡시,030001, 25세,2021,412,233,179,130.2,405,229,176,130.1
34070, 계룡시,030002, 26세,2021,385,237,148,160.1,376,230,146,157.5
34070, 계룡시,030003, 27세,2021,401,242,159,152.2,392,236,156,151.3
34070, 계룡시,030004, 28세,2021,365,188,177,106.2,358,185,173,106.9
34070, 계룡시,030005, 29세,2021,403,224,179,125.1,394,220,174,126.4
34070, 계룡시,035,30~34세,2021,1731,882,849,103.9,1693,868,825,105.2
34070, 계룡시,035001, 30세,2021,320,160,160,100,307,154,153,100.7
34070, 계룡시,035002, 31세,2021,351,201,150,134,341,196,145,135.2
34070, 계룡시,035003, 32세,2021,356,175,181,96.7,351,175,176,99.4
34070, 계룡시,035004, 33세,2021,330,167,163,102.5,326,166,160,103.8
34070, 계룡시,035005, 34세,2021,374,179,195,91.8,368,177,191,92.7
34070, 계룡시,040,35~39세,2021,2650,1276,1374,92.9,2623,1268,1355,93.6
34070, 계룡시,040001, 35세,2021,378,182,196,92.9,372,179,193,92.7
34070, 계룡시,040002, 36세,2021,458,238,220,108.2,453,235,218,107.8
34070, 계룡시,040003, 37세,2021,502,222,280,79.3,499,222,277,80.1
34070, 계룡시,040004, 38세,2021,595,298,297,100.3,588,297,291,102.1
34070, 계룡시,040005, 39세,2021,717,336,381,88.2,711,335,376,89.1
34070, 계룡시,045,40~44세,2021,3710,1720,1990,86.4,3686,1713,1973,86.8
34070, 계룡시,045001, 40세,2021,677,314,363,86.5,669,311,358,86.9
34070, 계룡시,045002, 41세,2021,732,344,388,88.7,727,343,384,89.3
34070, 계룡시,045003, 42세,2021,743,319,424,75.2,740,317,423,74.9
34070, 계룡시,045004, 43세,2021,710,336,374,89.8,707,336,371,90.6
34070, 계룡시,045005, 44세,2021,848,407,441,92.3,843,406,437,92.9
34070, 계룡시,050,45~49세,2021,4394,2206,2188,100.8,4375,2197,2178,100.9
34070, 계룡시,050001, 45세,2021,801,387,414,93.5,798,386,412,93.7
34070, 계룡시,050002, 46세,2021,855,423,432,97.9,851,422,429,98.4
34070, 계룡시,050003, 47세,2021,1004,508,496,102.4,1000,505,495,102
34070, 계룡시,050004, 48세,2021,843,401,442,90.7,836,397,439,90.4
34070, 계룡시,050005, 49세,2021,891,487,404,120.5,890,487,403,120.8
34070, 계룡시,055,50~54세,2021,4166,2061,2105,97.9,4137,2052,2085,98.4
34070, 계룡시,055001, 50세,2021,946,460,486,94.7,942,460,482,95.4
34070, 계룡시,055002, 51세,2021,841,422,419,100.7,835,421,414,101.7
34070, 계룡시,055003, 52세,2021,884,442,442,100,880,440,440,100
34070, 계룡시,055004, 53세,2021,803,389,414,94,795,385,410,93.9
34070, 계룡시,055005, 54세,2021,692,348,344,101.2,685,346,339,102.1
34070, 계룡시,060,55~59세,2021,3016,1524,1492,102.1,2989,1516,1473,102.9
34070, 계룡시,060001, 55세,2021,646,343,303,113.2,642,342,300,114
34070, 계룡시,060002, 56세,2021,619,306,313,97.8,615,304,311,97.7
34070, 계룡시,060003, 57세,2021,582,307,275,111.6,573,304,269,113
34070, 계룡시,060004, 58세,2021,574,277,297,93.3,567,275,292,94.2
34070, 계룡시,060005, 59세,2021,595,291,304,95.7,592,291,301,96.7
34070, 계룡시,065,60~64세,2021,2885,1388,1497,92.7,2875,1380,1495,92.3
34070, 계룡시,065001, 60세,2021,665,330,335,98.5,664,329,335,98.2
34070, 계룡시,065002, 61세,2021,622,302,320,94.4,622,302,320,94.4
34070, 계룡시,065003, 62세,2021,540,248,292,84.9,538,246,292,84.2
34070, 계룡시,065004, 63세,2021,548,257,291,88.3,544,254,290,87.6
34070, 계룡시,065005, 64세,2021,510,251,259,96.9,507,249,258,96.5
34070, 계룡시,070,65~69세,2021,2007,1003,1004,99.9,1998,999,999,100
34070, 계룡시,070001, 65세,2021,453,219,234,93.6,450,216,234,92.3
34070, 계룡시,070002, 66세,2021,462,236,226,104.4,460,235,225,104.4
34070, 계룡시,070003, 67세,2021,400,196,204,96.1,397,196,201,97.5
34070, 계룡시,070004, 68세,2021,353,192,161,119.3,352,192,160,120
34070, 계룡시,070005, 69세,2021,339,160,179,89.4,339,160,179,89.4
34070, 계룡시,075,70~74세,2021,1239,620,619,100.2,1232,616,616,100
34070, 계룡시,075001, 70세,2021,234,122,112,108.9,233,122,111,109.9
34070, 계룡시,075002, 71세,2021,252,120,132,90.9,249,117,132,88.6
34070, 계룡시,075003, 72세,2021,284,126,158,79.7,282,125,157,79.6
34070, 계룡시,075004, 73세,2021,232,121,111,109,232,121,111,109
34070, 계룡시,075005, 74세,2021,237,131,106,123.6,236,131,105,124.8
34070, 계룡시,080,75~79세,2021,863,363,500,72.6,862,363,499,72.7
34070, 계룡시,080001, 75세,2021,146,72,74,97.3,145,72,73,98.6
34070, 계룡시,080002, 76세,2021,172,79,93,84.9,172,79,93,84.9
34070, 계룡시,080003, 77세,2021,183,86,97,88.7,183,86,97,88.7
34070, 계룡시,080004, 78세,2021,175,71,104,68.3,175,71,104,68.3
34070, 계룡시,080005, 79세,2021,187,55,132,41.7,187,55,132,41.7
34070, 계룡시,085,80~84세,2021,694,252,442,57,693,252,441,57.1
34070, 계룡시,085001, 80세,2021,145,51,94,54.3,145,51,94,54.3
34070, 계룡시,085002, 81세,2021,132,61,71,85.9,132,61,71,85.9
34070, 계룡시,085003, 82세,2021,165,59,106,55.7,165,59,106,55.7
34070, 계룡시,085004, 83세,2021,127,39,88,44.3,126,39,87,44.8
34070, 계룡시,085005, 84세,2021,125,42,83,50.6,125,42,83,50.6
34070, 계룡시,090,85~89세,2021,449,121,328,36.9,449,121,328,36.9
34070, 계룡시,090001, 85세,2021,101,28,73,38.4,101,28,73,38.4
34070, 계룡시,090002, 86세,2021,107,28,79,35.4,107,28,79,35.4
34070, 계룡시,090003, 87세,2021,106,31,75,41.3,106,31,75,41.3
34070, 계룡시,090004, 88세,2021,77,20,57,35.1,77,20,57,35.1
34070, 계룡시,090005, 89세,2021,58,14,44,31.8,58,14,44,31.8
34070, 계룡시,095,90~94세,2021,167,33,134,24.6,167,33,134,24.6
34070, 계룡시,095001, 90세,2021,42,7,35,20,42,7,35,20
34070, 계룡시,095002, 91세,2021,38,9,29,31,38,9,29,31
34070, 계룡시,095003, 92세,2021,27,X,23,17.4,27,X,23,17.4
34070, 계룡시,095004, 93세,2021,33,9,24,37.5,33,9,24,37.5
34070, 계룡시,095005, 94세,2021,27,X,23,17.4,27,X,23,17.4
34070, 계룡시,100,95~99세,2021,35,5,30,16.7,34,5,29,17.2
34070, 계룡시,100001, 95세,2021,11,X,9,22.2,11,X,9,22.2
34070, 계룡시,100002, 96세,2021,10,X,8,25,9,X,7,28.6
34070, 계룡시,100003, 97세,2021,X,X,X,0,X,X,X,0
34070, 계룡시,100004, 98세,2021,9,X,8,12.5,9,X,8,12.5
34070, 계룡시,100005, 99세,2021,X,X,X,0,X,X,X,0
34070, 계룡시,101,100세이상,2021,X,X,X,,X,X,X,
34070, 계룡시,102,15세미만,2021,6657,3436,3221,106.7,6654,3435,3219,106.7
34070, 계룡시,103,15~64세,2021,29303,14780,14523,101.8,29063,14675,14388,102
34070, 계룡시,104,65세이상,2021,5455,2398,3057,78.4,5436,2390,3046,78.5
34070, 계룡시,086,85세이상,2021,652,160,492,32.5,651,160,491,32.6
34070, 계룡시,126,평균연령,2021,41.3,40,42.4,,41.2,40,42.4,
34070, 계룡시,127,중위연령,2021,44.1,43,44.9,,44.1,43.1,44.9,
34080, 당진시,000,합계,2021,169507,91060,78447,116.1,161479,85940,75539,113.8
34080, 당진시,005,0~4세,2021,6220,3205,3015,106.3,6076,3135,2941,106.6
34080, 당진시,005001, 0세,2021,985,495,490,101,959,481,478,100.6
34080, 당진시,005002, 1세,2021,1079,564,515,109.5,1050,554,496,111.7
34080, 당진시,005003, 2세,2021,1253,650,603,107.8,1231,641,590,108.6
34080, 당진시,005004, 3세,2021,1363,708,655,108.1,1331,687,644,106.7
34080, 당진시,005005, 4세,2021,1540,788,752,104.8,1505,772,733,105.3
34080, 당진시,010,5~9세,2021,8553,4311,4242,101.6,8452,4256,4196,101.4
34080, 당진시,010001, 5세,2021,1574,796,778,102.3,1552,786,766,102.6
34080, 당진시,010002, 6세,2021,1750,881,869,101.4,1726,868,858,101.2
34080, 당진시,010003, 7세,2021,1717,853,864,98.7,1694,837,857,97.7
34080, 당진시,010004, 8세,2021,1716,866,850,101.9,1698,858,840,102.1
34080, 당진시,010005, 9세,2021,1796,915,881,103.9,1782,907,875,103.7
34080, 당진시,015,10~14세,2021,8517,4469,4048,110.4,8459,4437,4022,110.3
34080, 당진시,015001, 10세,2021,1813,948,865,109.6,1804,945,859,110
34080, 당진시,015002, 11세,2021,1756,936,820,114.1,1745,928,817,113.6
34080, 당진시,015003, 12세,2021,1634,827,807,102.5,1623,822,801,102.6
34080, 당진시,015004, 13세,2021,1643,864,779,110.9,1626,855,771,110.9
34080, 당진시,015005, 14세,2021,1671,894,777,115.1,1661,887,774,114.6
34080, 당진시,020,15~19세,2021,6958,3701,3257,113.6,6908,3673,3235,113.5
34080, 당진시,020001, 15세,2021,1448,765,683,112,1438,761,677,112.4
34080, 당진시,020002, 16세,2021,1365,700,665,105.3,1356,693,663,104.5
34080, 당진시,020003, 17세,2021,1399,723,676,107,1388,718,670,107.2
34080, 당진시,020004, 18세,2021,1308,711,597,119.1,1302,709,593,119.6
34080, 당진시,020005, 19세,2021,1438,802,636,126.1,1424,792,632,125.3
34080, 당진시,025,20~24세,2021,7716,4411,3305,133.5,7341,4170,3171,131.5
34080, 당진시,025001, 20세,2021,1630,923,707,130.6,1600,901,699,128.9
34080, 당진시,025002, 21세,2021,1635,932,703,132.6,1582,904,678,133.3
34080, 당진시,025003, 22세,2021,1440,807,633,127.5,1374,767,607,126.4
34080, 당진시,025004, 23세,2021,1471,868,603,143.9,1364,809,555,145.8
34080, 당진시,025005, 24세,2021,1540,881,659,133.7,1421,789,632,124.8
34080, 당진시,030,25~29세,2021,9064,5608,3456,162.3,7960,4795,3165,151.5
34080, 당진시,030001, 25세,2021,1708,1042,666,156.5,1511,905,606,149.3
34080, 당진시,030002, 26세,2021,1703,1073,630,170.3,1494,914,580,157.6
34080, 당진시,030003, 27세,2021,1745,1087,658,165.2,1529,934,595,157
34080, 당진시,030004, 28세,2021,1910,1167,743,157.1,1687,996,691,144.1
34080, 당진시,030005, 29세,2021,1998,1239,759,163.2,1739,1046,693,150.9
34080, 당진시,035,30~34세,2021,10645,6395,4250,150.5,9275,5459,3816,143.1
34080, 당진시,035001, 30세,2021,1977,1251,726,172.3,1754,1088,666,163.4
34080, 당진시,035002, 31세,2021,2070,1254,816,153.7,1779,1053,726,145
34080, 당진시,035003, 32세,2021,2143,1289,854,150.9,1852,1081,771,140.2
34080, 당진시,035004, 33세,2021,2222,1330,892,149.1,1933,1150,783,146.9
34080, 당진시,035005, 34세,2021,2233,1271,962,132.1,1957,1087,870,124.9
34080, 당진시,040,35~39세,2021,13240,7630,5610,136,11958,6766,5192,130.3
34080, 당진시,040001, 35세,2021,2306,1331,975,136.5,2007,1131,876,129.1
34080, 당진시,040002, 36세,2021,2410,1381,1029,134.2,2130,1201,929,129.3
34080, 당진시,040003, 37세,2021,2547,1463,1084,135,2314,1303,1011,128.9
34080, 당진시,040004, 38세,2021,2821,1635,1186,137.9,2582,1465,1117,131.2
34080, 당진시,040005, 39세,2021,3156,1820,1336,136.2,2925,1666,1259,132.3
34080, 당진시,045,40~44세,2021,14128,7989,6139,130.1,13283,7435,5848,127.1
34080, 당진시,045001, 40세,2021,3001,1718,1283,133.9,2813,1583,1230,128.7
34080, 당진시,045002, 41세,2021,3034,1694,1340,126.4,2864,1578,1286,122.7
34080, 당진시,045003, 42세,2021,2831,1593,1238,128.7,2672,1493,1179,126.6
34080, 당진시,045004, 43세,2021,2538,1437,1101,130.5,2365,1329,1036,128.3
34080, 당진시,045005, 44세,2021,2724,1547,1177,131.4,2569,1452,1117,130
34080, 당진시,050,45~49세,2021,13350,7573,5777,131.1,12650,7139,5511,129.5
34080, 당진시,050001, 45세,2021,2470,1340,1130,118.6,2320,1254,1066,117.6
34080, 당진시,050002, 46세,2021,2566,1482,1084,136.7,2437,1392,1045,133.2
34080, 당진시,050003, 47세,2021,2830,1652,1178,140.2,2703,1578,1125,140.3
34080, 당진시,050004, 48세,2021,2864,1597,1267,126,2722,1505,1217,123.7
34080, 당진시,050005, 49세,2021,2620,1502,1118,134.3,2468,1410,1058,133.3
34080, 당진시,055,50~54세,2021,13857,7884,5973,132,13188,7495,5693,131.7
34080, 당진시,055001, 50세,2021,2953,1735,1218,142.4,2775,1624,1151,141.1
34080, 당진시,055002, 51세,2021,2631,1479,1152,128.4,2472,1386,1086,127.6
34080, 당진시,055003, 52세,2021,2922,1655,1267,130.6,2805,1591,1214,131.1
34080, 당진시,055004, 53세,2021,2771,1584,1187,133.4,2642,1513,1129,134
34080, 당진시,055005, 54세,2021,2580,1431,1149,124.5,2494,1381,1113,124.1
34080, 당진시,060,55~59세,2021,12729,7115,5614,126.7,12121,6787,5334,127.2
34080, 당진시,060001, 55세,2021,2365,1335,1030,129.6,2253,1278,975,131.1
34080, 당진시,060002, 56세,2021,2809,1560,1249,124.9,2670,1489,1181,126.1
34080, 당진시,060003, 57세,2021,2408,1356,1052,128.9,2280,1282,998,128.5
34080, 당진시,060004, 58세,2021,2496,1397,1099,127.1,2379,1330,1049,126.8
34080, 당진시,060005, 59세,2021,2651,1467,1184,123.9,2539,1408,1131,124.5
34080, 당진시,065,60~64세,2021,12865,6753,6112,110.5,12487,6538,5949,109.9
34080, 당진시,065001, 60세,2021,2939,1553,1386,112,2876,1511,1365,110.7
34080, 당진시,065002, 61세,2021,2879,1527,1352,112.9,2796,1485,1311,113.3
34080, 당진시,065003, 62세,2021,2472,1286,1186,108.4,2389,1244,1145,108.6
34080, 당진시,065004, 63세,2021,2239,1176,1063,110.6,2161,1128,1033,109.2
34080, 당진시,065005, 64세,2021,2336,1211,1125,107.6,2265,1170,1095,106.8
34080, 당진시,070,65~69세,2021,9358,4648,4710,98.7,9161,4548,4613,98.6
34080, 당진시,070001, 65세,2021,2157,1072,1085,98.8,2105,1039,1066,97.5
34080, 당진시,070002, 66세,2021,2184,1114,1070,104.1,2143,1095,1048,104.5
34080, 당진시,070003, 67세,2021,1744,852,892,95.5,1701,834,867,96.2
34080, 당진시,070004, 68세,2021,1475,718,757,94.8,1445,706,739,95.5
34080, 당진시,070005, 69세,2021,1798,892,906,98.5,1767,874,893,97.9
34080, 당진시,075,70~74세,2021,7377,3626,3751,96.7,7306,3592,3714,96.7
34080, 당진시,075001, 70세,2021,1360,680,680,100,1339,669,670,99.9
34080, 당진시,075002, 71세,2021,1613,756,857,88.2,1601,748,853,87.7
34080, 당진시,075003, 72세,2021,1555,771,784,98.3,1538,762,776,98.2
34080, 당진시,075004, 73세,2021,1404,700,704,99.4,1396,696,700,99.4
34080, 당진시,075005, 74세,2021,1445,719,726,99,1432,717,715,100.3
34080, 당진시,080,75~79세,2021,5662,2557,3105,82.4,5624,2541,3083,82.4
34080, 당진시,080001, 75세,2021,1027,505,522,96.7,1015,501,514,97.5
34080, 당진시,080002, 76세,2021,989,479,510,93.9,980,475,505,94.1
34080, 당진시,080003, 77세,2021,1073,476,597,79.7,1065,472,593,79.6
34080, 당진시,080004, 78세,2021,1083,489,594,82.3,1077,486,591,82.2
34080, 당진시,080005, 79세,2021,1490,608,882,68.9,1487,607,880,69
34080, 당진시,085,80~84세,2021,4993,1901,3092,61.5,4971,1895,3076,61.6
34080, 당진시,085001, 80세,2021,1058,431,627,68.7,1052,429,623,68.9
34080, 당진시,085002, 81세,2021,973,377,596,63.3,969,377,592,63.7
34080, 당진시,085003, 82세,2021,1056,401,655,61.2,1052,400,652,61.3
34080, 당진시,085004, 83세,2021,1005,388,617,62.9,1000,386,614,62.9
34080, 당진시,085005, 84세,2021,901,304,597,50.9,898,303,595,50.9
34080, 당진시,090,85~89세,2021,3090,1001,2089,47.9,3078,998,2080,48
34080, 당진시,090001, 85세,2021,849,286,563,50.8,843,285,558,51.1
34080, 당진시,090002, 86세,2021,771,248,523,47.4,769,247,522,47.3
34080, 당진시,090003, 87세,2021,595,212,383,55.4,594,212,382,55.5
34080, 당진시,090004, 88세,2021,481,140,341,41.1,479,139,340,40.9
34080, 당진시,090005, 89세,2021,394,115,279,41.2,393,115,278,41.4
34080, 당진시,095,90~94세,2021,956,237,719,33,952,235,717,32.8
34080, 당진시,095001, 90세,2021,250,59,191,30.9,250,59,191,30.9
34080, 당진시,095002, 91세,2021,265,64,201,31.8,262,63,199,31.7
34080, 당진시,095003, 92세,2021,189,45,144,31.3,188,44,144,30.6
34080, 당진시,095004, 93세,2021,159,42,117,35.9,159,42,117,35.9
34080, 당진시,095005, 94세,2021,93,27,66,40.9,93,27,66,40.9
34080, 당진시,100,95~99세,2021,195,43,152,28.3,195,43,152,28.3
34080, 당진시,100001, 95세,2021,62,14,48,29.2,62,14,48,29.2
34080, 당진시,100002, 96세,2021,47,13,34,38.2,47,13,34,38.2
34080, 당진시,100003, 97세,2021,37,10,27,37,37,10,27,37
34080, 당진시,100004, 98세,2021,27,X,23,17.4,27,X,23,17.4
34080, 당진시,100005, 99세,2021,22,X,20,10,22,X,20,10
34080, 당진시,101,100세이상,2021,34,X,31,9.7,34,X,31,9.7
34080, 당진시,102,15세미만,2021,23290,11985,11305,106,22987,11828,11159,106
34080, 당진시,103,15~64세,2021,114552,65059,49493,131.5,107171,60257,46914,128.4
34080, 당진시,104,65세이상,2021,31665,14016,17649,79.4,31321,13855,17466,79.3
34080, 당진시,086,85세이상,2021,4275,1284,2991,42.9,4259,1279,2980,42.9
34080, 당진시,126,평균연령,2021,44.1,42.8,45.5,,44.3,43,45.7,
34080, 당진시,127,중위연령,2021,44.9,43.6,46.7,,45.4,44.2,47.1,
34310, 금산군,000,합계,2021,52436,26146,26290,99.5,49653,24813,24840,99.9
34310, 금산군,005,0~4세,2021,922,442,480,92.1,909,434,475,91.4
34310, 금산군,005001, 0세,2021,154,73,81,90.1,149,70,79,88.6
34310, 금산군,005002, 1세,2021,174,80,94,85.1,173,79,94,84
34310, 금산군,005003, 2세,2021,187,101,86,117.4,183,99,84,117.9
34310, 금산군,005004, 3세,2021,178,75,103,72.8,176,74,102,72.5
34310, 금산군,005005, 4세,2021,229,113,116,97.4,228,112,116,96.6
34310, 금산군,010,5~9세,2021,1394,738,656,112.5,1387,732,655,111.8
34310, 금산군,010001, 5세,2021,231,110,121,90.9,231,110,121,90.9
34310, 금산군,010002, 6세,2021,255,120,135,88.9,251,117,134,87.3
34310, 금산군,010003, 7세,2021,275,146,129,113.2,274,145,129,112.4
34310, 금산군,010004, 8세,2021,302,172,130,132.3,302,172,130,132.3
34310, 금산군,010005, 9세,2021,331,190,141,134.8,329,188,141,133.3
34310, 금산군,015,10~14세,2021,2035,1056,979,107.9,2029,1053,976,107.9
34310, 금산군,015001, 10세,2021,381,194,187,103.7,381,194,187,103.7
34310, 금산군,015002, 11세,2021,389,203,186,109.1,386,201,185,108.6
34310, 금산군,015003, 12세,2021,366,188,178,105.6,364,187,177,105.6
34310, 금산군,015004, 13세,2021,423,225,198,113.6,422,225,197,114.2
34310, 금산군,015005, 14세,2021,476,246,230,107,476,246,230,107
34310, 금산군,020,15~19세,2021,2550,1307,1243,105.1,2535,1300,1235,105.3
34310, 금산군,020001, 15세,2021,394,205,189,108.5,394,205,189,108.5
34310, 금산군,020002, 16세,2021,442,222,220,100.9,442,222,220,100.9
34310, 금산군,020003, 17세,2021,431,238,193,123.3,430,238,192,124
34310, 금산군,020004, 18세,2021,500,260,240,108.3,494,258,236,109.3
34310, 금산군,020005, 19세,2021,783,382,401,95.3,775,377,398,94.7
34310, 금산군,025,20~24세,2021,3779,2043,1736,117.7,3088,1678,1410,119
34310, 금산군,025001, 20세,2021,714,319,395,80.8,671,294,377,78
34310, 금산군,025002, 21세,2021,830,374,456,82,724,320,404,79.2
34310, 금산군,025003, 22세,2021,798,437,361,121.1,634,349,285,122.5
34310, 금산군,025004, 23세,2021,763,476,287,165.9,557,362,195,185.6
34310, 금산군,025005, 24세,2021,674,437,237,184.4,502,353,149,236.9
34310, 금산군,030,25~29세,2021,2366,1343,1023,131.3,1688,1021,667,153.1
34310, 금산군,030001, 25세,2021,538,314,224,140.2,399,254,145,175.2
34310, 금산군,030002, 26세,2021,492,282,210,134.3,357,220,137,160.6
34310, 금산군,030003, 27세,2021,496,281,215,130.7,339,206,133,154.9
34310, 금산군,030004, 28세,2021,429,243,186,130.6,301,176,125,140.8
34310, 금산군,030005, 29세,2021,411,223,188,118.6,292,165,127,129.9
34310, 금산군,035,30~34세,2021,1773,910,863,105.4,1361,719,642,112
34310, 금산군,035001, 30세,2021,343,176,167,105.4,253,140,113,123.9
34310, 금산군,035002, 31세,2021,366,184,182,101.1,284,152,132,115.2
34310, 금산군,035003, 32세,2021,350,189,161,117.4,260,139,121,114.9
34310, 금산군,035004, 33세,2021,369,183,186,98.4,278,139,139,100
34310, 금산군,035005, 34세,2021,345,178,167,106.6,286,149,137,108.8
34310, 금산군,040,35~39세,2021,2123,1097,1026,106.9,1818,956,862,110.9
34310, 금산군,040001, 35세,2021,393,197,196,100.5,324,166,158,105.1
34310, 금산군,040002, 36세,2021,392,198,194,102.1,322,167,155,107.7
34310, 금산군,040003, 37세,2021,404,218,186,117.2,341,187,154,121.4
34310, 금산군,040004, 38세,2021,437,234,203,115.3,386,205,181,113.3
34310, 금산군,040005, 39세,2021,497,250,247,101.2,445,231,214,107.9
34310, 금산군,045,40~44세,2021,2689,1400,1289,108.6,2477,1303,1174,111
34310, 금산군,045001, 40세,2021,558,298,260,114.6,500,267,233,114.6
34310, 금산군,045002, 41세,2021,538,269,269,100,499,255,244,104.5
34310, 금산군,045003, 42세,2021,551,279,272,102.6,501,255,246,103.7
34310, 금산군,045004, 43세,2021,511,272,239,113.8,474,259,215,120.5
34310, 금산군,045005, 44세,2021,531,282,249,113.3,503,267,236,113.1
34310, 금산군,050,45~49세,2021,3239,1774,1465,121.1,3073,1694,1379,122.8
34310, 금산군,050001, 45세,2021,584,309,275,112.4,552,287,265,108.3
34310, 금산군,050002, 46세,2021,601,337,264,127.7,559,316,243,130
34310, 금산군,050003, 47세,2021,675,381,294,129.6,644,368,276,133.3
34310, 금산군,050004, 48세,2021,686,363,323,112.4,657,350,307,114
34310, 금산군,050005, 49세,2021,693,384,309,124.3,661,373,288,129.5
34310, 금산군,055,50~54세,2021,4112,2200,1912,115.1,4012,2159,1853,116.5
34310, 금산군,055001, 50세,2021,809,429,380,112.9,783,420,363,115.7
34310, 금산군,055002, 51세,2021,814,443,371,119.4,788,433,355,122
34310, 금산군,055003, 52세,2021,836,472,364,129.7,818,463,355,130.4
34310, 금산군,055004, 53세,2021,814,422,392,107.7,798,414,384,107.8
34310, 금산군,055005, 54세,2021,839,434,405,107.2,825,429,396,108.3
34310, 금산군,060,55~59세,2021,4344,2359,1985,118.8,4263,2320,1943,119.4
34310, 금산군,060001, 55세,2021,761,408,353,115.6,736,394,342,115.2
34310, 금산군,060002, 56세,2021,898,491,407,120.6,883,487,396,123
34310, 금산군,060003, 57세,2021,827,439,388,113.1,814,432,382,113.1
34310, 금산군,060004, 58세,2021,906,497,409,121.5,889,487,402,121.1
34310, 금산군,060005, 59세,2021,952,524,428,122.4,941,520,421,123.5
34310, 금산군,065,60~64세,2021,5398,2732,2666,102.5,5346,2715,2631,103.2
34310, 금산군,065001, 60세,2021,1163,611,552,110.7,1148,605,543,111.4
34310, 금산군,065002, 61세,2021,1198,601,597,100.7,1184,596,588,101.4
34310, 금산군,065003, 62세,2021,982,465,517,89.9,973,464,509,91.2
34310, 금산군,065004, 63세,2021,998,487,511,95.3,987,482,505,95.4
34310, 금산군,065005, 64세,2021,1057,568,489,116.2,1054,568,486,116.9
34310, 금산군,070,65~69세,2021,4467,2226,2241,99.3,4442,2214,2228,99.4
34310, 금산군,070001, 65세,2021,923,479,444,107.9,916,475,441,107.7
34310, 금산군,070002, 66세,2021,985,498,487,102.3,977,492,485,101.4
34310, 금산군,070003, 67세,2021,959,479,480,99.8,955,478,477,100.2
34310, 금산군,070004, 68세,2021,718,330,388,85.1,714,329,385,85.5
34310, 금산군,070005, 69세,2021,882,440,442,99.5,880,440,440,100
34310, 금산군,075,70~74세,2021,3526,1722,1804,95.5,3514,1721,1793,96
34310, 금산군,075001, 70세,2021,668,318,350,90.9,665,318,347,91.6
34310, 금산군,075002, 71세,2021,732,374,358,104.5,729,373,356,104.8
34310, 금산군,075003, 72세,2021,708,369,339,108.8,707,369,338,109.2
34310, 금산군,075004, 73세,2021,698,335,363,92.3,697,335,362,92.5
34310, 금산군,075005, 74세,2021,720,326,394,82.7,716,326,390,83.6
34310, 금산군,080,75~79세,2021,3062,1296,1766,73.4,3058,1294,1764,73.4
34310, 금산군,080001, 75세,2021,545,257,288,89.2,544,257,287,89.5
34310, 금산군,080002, 76세,2021,520,221,299,73.9,520,221,299,73.9
34310, 금산군,080003, 77세,2021,526,215,311,69.1,524,214,310,69
34310, 금산군,080004, 78세,2021,635,258,377,68.4,635,258,377,68.4
34310, 금산군,080005, 79세,2021,836,345,491,70.3,835,344,491,70.1
34310, 금산군,085,80~84세,2021,2598,897,1701,52.7,2596,897,1699,52.8
34310, 금산군,085001, 80세,2021,541,194,347,55.9,540,194,346,56.1
34310, 금산군,085002, 81세,2021,543,197,346,56.9,543,197,346,56.9
34310, 금산군,085003, 82세,2021,569,198,371,53.4,569,198,371,53.4
34310, 금산군,085004, 83세,2021,529,173,356,48.6,529,173,356,48.6
34310, 금산군,085005, 84세,2021,416,135,281,48,415,135,280,48.2
34310, 금산군,090,85~89세,2021,1503,476,1027,46.3,1501,475,1026,46.3
34310, 금산군,090001, 85세,2021,397,132,265,49.8,397,132,265,49.8
34310, 금산군,090002, 86세,2021,373,110,263,41.8,372,110,262,42
34310, 금산군,090003, 87세,2021,289,94,195,48.2,289,94,195,48.2
34310, 금산군,090004, 88세,2021,226,69,157,43.9,225,68,157,43.3
34310, 금산군,090005, 89세,2021,218,71,147,48.3,218,71,147,48.3
34310, 금산군,095,90~94세,2021,452,106,346,30.6,452,106,346,30.6
34310, 금산군,095001, 90세,2021,131,39,92,42.4,131,39,92,42.4
34310, 금산군,095002, 91세,2021,124,22,102,21.6,124,22,102,21.6
34310, 금산군,095003, 92세,2021,80,21,59,35.6,80,21,59,35.6
34310, 금산군,095004, 93세,2021,64,11,53,20.8,64,11,53,20.8
34310, 금산군,095005, 94세,2021,53,13,40,32.5,53,13,40,32.5
34310, 금산군,100,95~99세,2021,92,20,72,27.8,92,20,72,27.8
34310, 금산군,100001, 95세,2021,25,7,18,38.9,25,7,18,38.9
34310, 금산군,100002, 96세,2021,25,6,19,31.6,25,6,19,31.6
34310, 금산군,100003, 97세,2021,18,X,14,28.6,18,X,14,28.6
34310, 금산군,100004, 98세,2021,16,X,13,23.1,16,X,13,23.1
34310, 금산군,100005, 99세,2021,8,X,8,0,8,X,8,0
34310, 금산군,101,100세이상,2021,12,X,10,20,12,X,10,20
34310, 금산군,102,15세미만,2021,4351,2236,2115,105.7,4325,2219,2106,105.4
34310, 금산군,103,15~64세,2021,32373,17165,15208,112.9,29661,15865,13796,115
34310, 금산군,104,65세이상,2021,15712,6745,8967,75.2,15667,6729,8938,75.3
34310, 금산군,086,85세이상,2021,2059,604,1455,41.5,2057,603,1454,41.5
34310, 금산군,126,평균연령,2021,50.2,48.4,52.1,,51.2,49.3,53.1,
34310, 금산군,127,중위연령,2021,54.1,52.2,56.3,,55.6,53.5,57.9,
34330, 부여군,000,합계,2021,62415,30882,31533,97.9,60788,30065,30723,97.9
34330, 부여군,005,0~4세,2021,941,504,437,115.3,939,504,435,115.9
34330, 부여군,005001, 0세,2021,130,72,58,124.1,129,72,57,126.3
34330, 부여군,005002, 1세,2021,184,102,82,124.4,184,102,82,124.4
34330, 부여군,005003, 2세,2021,167,85,82,103.7,167,85,82,103.7
34330, 부여군,005004, 3세,2021,225,122,103,118.4,225,122,103,118.4
34330, 부여군,005005, 4세,2021,235,123,112,109.8,234,123,111,110.8
34330, 부여군,010,5~9세,2021,1692,891,801,111.2,1690,890,800,111.3
34330, 부여군,010001, 5세,2021,289,142,147,96.6,289,142,147,96.6
34330, 부여군,010002, 6세,2021,333,170,163,104.3,332,170,162,104.9
34330, 부여군,010003, 7세,2021,339,176,163,108,339,176,163,108
34330, 부여군,010004, 8세,2021,340,191,149,128.2,340,191,149,128.2
34330, 부여군,010005, 9세,2021,391,212,179,118.4,390,211,179,117.9
34330, 부여군,015,10~14세,2021,1967,1049,918,114.3,1965,1048,917,114.3
34330, 부여군,015001, 10세,2021,360,201,159,126.4,360,201,159,126.4
34330, 부여군,015002, 11세,2021,393,218,175,124.6,392,217,175,124
34330, 부여군,015003, 12세,2021,375,201,174,115.5,375,201,174,115.5
34330, 부여군,015004, 13세,2021,416,203,213,95.3,416,203,213,95.3
34330, 부여군,015005, 14세,2021,423,226,197,114.7,422,226,196,115.3
34330, 부여군,020,15~19세,2021,2068,1132,936,120.9,2065,1130,935,120.9
34330, 부여군,020001, 15세,2021,444,236,208,113.5,444,236,208,113.5
34330, 부여군,020002, 16세,2021,440,224,216,103.7,439,223,216,103.2
34330, 부여군,020003, 17세,2021,411,236,175,134.9,410,236,174,135.6
34330, 부여군,020004, 18세,2021,468,267,201,132.8,467,266,201,132.3
34330, 부여군,020005, 19세,2021,305,169,136,124.3,305,169,136,124.3
34330, 부여군,025,20~24세,2021,2636,1494,1142,130.8,2492,1423,1069,133.1
34330, 부여군,025001, 20세,2021,494,291,203,143.3,484,288,196,146.9
34330, 부여군,025002, 21세,2021,549,283,266,106.4,532,276,256,107.8
34330, 부여군,025003, 22세,2021,544,318,226,140.7,517,308,209,147.4
34330, 부여군,025004, 23세,2021,514,285,229,124.5,479,264,215,122.8
34330, 부여군,025005, 24세,2021,535,317,218,145.4,480,287,193,148.7
34330, 부여군,030,25~29세,2021,2554,1494,1060,140.9,2197,1301,896,145.2
34330, 부여군,030001, 25세,2021,583,326,257,126.8,522,295,227,130
34330, 부여군,030002, 26세,2021,517,311,206,151,449,280,169,165.7
34330, 부여군,030003, 27세,2021,526,326,200,163,449,279,170,164.1
34330, 부여군,030004, 28세,2021,437,248,189,131.2,366,210,156,134.6
34330, 부여군,030005, 29세,2021,491,283,208,136.1,411,237,174,136.2
34330, 부여군,035,30~34세,2021,2110,1185,925,128.1,1754,987,767,128.7
34330, 부여군,035001, 30세,2021,441,249,192,129.7,365,209,156,134
34330, 부여군,035002, 31세,2021,421,241,180,133.9,333,189,144,131.3
34330, 부여군,035003, 32세,2021,381,226,155,145.8,309,181,128,141.4
34330, 부여군,035004, 33세,2021,410,227,183,124,345,192,153,125.5
34330, 부여군,035005, 34세,2021,457,242,215,112.6,402,216,186,116.1
34330, 부여군,040,35~39세,2021,2413,1287,1126,114.3,2135,1144,991,115.4
34330, 부여군,040001, 35세,2021,428,213,215,99.1,357,179,178,100.6
34330, 부여군,040002, 36세,2021,459,241,218,110.6,388,204,184,110.9
34330, 부여군,040003, 37세,2021,432,222,210,105.7,391,204,187,109.1
34330, 부여군,040004, 38세,2021,526,294,232,126.7,478,268,210,127.6
34330, 부여군,040005, 39세,2021,568,317,251,126.3,521,289,232,124.6
34330, 부여군,045,40~44세,2021,2893,1528,1365,111.9,2745,1463,1282,114.1
34330, 부여군,045001, 40세,2021,546,284,262,108.4,512,270,242,111.6
34330, 부여군,045002, 41세,2021,583,313,270,115.9,552,299,253,118.2
34330, 부여군,045003, 42세,2021,554,284,270,105.2,516,267,249,107.2
34330, 부여군,045004, 43세,2021,591,322,269,119.7,568,314,254,123.6
34330, 부여군,045005, 44세,2021,619,325,294,110.5,597,313,284,110.2
34330, 부여군,050,45~49세,2021,3719,2012,1707,117.9,3614,1966,1648,119.3
34330, 부여군,050001, 45세,2021,619,330,289,114.2,603,325,278,116.9
34330, 부여군,050002, 46세,2021,695,380,315,120.6,674,374,300,124.7
34330, 부여군,050003, 47세,2021,799,426,373,114.2,768,412,356,115.7
34330, 부여군,050004, 48세,2021,816,448,368,121.7,804,441,363,121.5
34330, 부여군,050005, 49세,2021,790,428,362,118.2,765,414,351,117.9
34330, 부여군,055,50~54세,2021,4665,2481,2184,113.6,4588,2448,2140,114.4
34330, 부여군,055001, 50세,2021,875,475,400,118.8,857,468,389,120.3
34330, 부여군,055002, 51세,2021,866,465,401,116,854,462,392,117.9
34330, 부여군,055003, 52세,2021,957,486,471,103.2,944,478,466,102.6
34330, 부여군,055004, 53세,2021,1016,534,482,110.8,997,528,469,112.6
34330, 부여군,055005, 54세,2021,951,521,430,121.2,936,512,424,120.8
34330, 부여군,060,55~59세,2021,5239,2671,2568,104,5169,2640,2529,104.4
34330, 부여군,060001, 55세,2021,868,448,420,106.7,854,442,412,107.3
34330, 부여군,060002, 56세,2021,1080,576,504,114.3,1063,567,496,114.3
34330, 부여군,060003, 57세,2021,1037,509,528,96.4,1018,499,519,96.1
34330, 부여군,060004, 58세,2021,1043,504,539,93.5,1029,499,530,94.2
34330, 부여군,060005, 59세,2021,1211,634,577,109.9,1205,633,572,110.7
34330, 부여군,065,60~64세,2021,7037,3532,3505,100.8,6990,3512,3478,101
34330, 부여군,065001, 60세,2021,1499,756,743,101.7,1483,750,733,102.3
34330, 부여군,065002, 61세,2021,1519,730,789,92.5,1509,726,783,92.7
34330, 부여군,065003, 62세,2021,1330,665,665,100,1324,662,662,100
34330, 부여군,065004, 63세,2021,1298,650,648,100.3,1290,648,642,100.9
34330, 부여군,065005, 64세,2021,1391,731,660,110.8,1384,726,658,110.3
34330, 부여군,070,65~69세,2021,6039,2984,3055,97.7,6020,2977,3043,97.8
34330, 부여군,070001, 65세,2021,1371,704,667,105.5,1364,701,663,105.7
34330, 부여군,070002, 66세,2021,1341,650,691,94.1,1339,650,689,94.3
34330, 부여군,070003, 67세,2021,1219,601,618,97.2,1216,601,615,97.7
34330, 부여군,070004, 68세,2021,988,472,516,91.5,983,469,514,91.2
34330, 부여군,070005, 69세,2021,1120,557,563,98.9,1118,556,562,98.9
34330, 부여군,075,70~74세,2021,4981,2330,2651,87.9,4975,2327,2648,87.9
34330, 부여군,075001, 70세,2021,926,450,476,94.5,926,450,476,94.5
34330, 부여군,075002, 71세,2021,1061,512,549,93.3,1058,510,548,93.1
34330, 부여군,075003, 72세,2021,1096,501,595,84.2,1094,501,593,84.5
34330, 부여군,075004, 73세,2021,952,433,519,83.4,952,433,519,83.4
34330, 부여군,075005, 74세,2021,946,434,512,84.8,945,433,512,84.6
34330, 부여군,080,75~79세,2021,4103,1794,2309,77.7,4095,1792,2303,77.8
34330, 부여군,080001, 75세,2021,653,327,326,100.3,649,326,323,100.9
34330, 부여군,080002, 76세,2021,757,352,405,86.9,756,352,404,87.1
34330, 부여군,080003, 77세,2021,813,338,475,71.2,812,337,475,70.9
34330, 부여군,080004, 78세,2021,820,357,463,77.1,819,357,462,77.3
34330, 부여군,080005, 79세,2021,1060,420,640,65.6,1059,420,639,65.7
34330, 부여군,085,80~84세,2021,3859,1426,2433,58.6,3858,1426,2432,58.6
34330, 부여군,085001, 80세,2021,856,339,517,65.6,856,339,517,65.6
34330, 부여군,085002, 81세,2021,761,304,457,66.5,761,304,457,66.5
34330, 부여군,085003, 82세,2021,825,292,533,54.8,825,292,533,54.8
34330, 부여군,085004, 83세,2021,725,241,484,49.8,724,241,483,49.9
34330, 부여군,085005, 84세,2021,692,250,442,56.6,692,250,442,56.6
34330, 부여군,090,85~89세,2021,2470,837,1633,51.3,2470,837,1633,51.3
34330, 부여군,090001, 85세,2021,607,222,385,57.7,607,222,385,57.7
34330, 부여군,090002, 86세,2021,615,202,413,48.9,615,202,413,48.9
34330, 부여군,090003, 87세,2021,497,169,328,51.5,497,169,328,51.5
34330, 부여군,090004, 88세,2021,407,135,272,49.6,407,135,272,49.6
34330, 부여군,090005, 89세,2021,344,109,235,46.4,344,109,235,46.4
34330, 부여군,095,90~94세,2021,822,219,603,36.3,821,219,602,36.4
34330, 부여군,095001, 90세,2021,239,60,179,33.5,239,60,179,33.5
34330, 부여군,095002, 91세,2021,214,65,149,43.6,213,65,148,43.9
34330, 부여군,095003, 92세,2021,135,35,100,35,135,35,100,35
34330, 부여군,095004, 93세,2021,140,39,101,38.6,140,39,101,38.6
34330, 부여군,095005, 94세,2021,94,20,74,27,94,20,74,27
34330, 부여군,100,95~99세,2021,177,27,150,18,177,27,150,18
34330, 부여군,100001, 95세,2021,75,12,63,19,75,12,63,19
34330, 부여군,100002, 96세,2021,42,7,35,20,42,7,35,20
34330, 부여군,100003, 97세,2021,22,X,19,15.8,22,X,19,15.8
34330, 부여군,100004, 98세,2021,23,X,20,15,23,X,20,15
34330, 부여군,100005, 99세,2021,15,X,13,15.4,15,X,13,15.4
34330, 부여군,101,100세이상,2021,30,5,25,20,29,X,25,16
34330, 부여군,102,15세미만,2021,4600,2444,2156,113.4,4594,2442,2152,113.5
34330, 부여군,103,15~64세,2021,35334,18816,16518,113.9,33749,18014,15735,114.5
34330, 부여군,104,65세이상,2021,22481,9622,12859,74.8,22445,9609,12836,74.9
34330, 부여군,086,85세이상,2021,3499,1088,2411,45.1,3497,1087,2410,45.1
34330, 부여군,126,평균연령,2021,54,51.5,56.3,,54.4,51.9,56.8,
34330, 부여군,127,중위연령,2021,58.5,55.9,60.8,,59.2,56.5,61.3,
34340, 서천군,000,합계,2021,50012,24936,25076,99.4,48258,23650,24608,96.1
34340, 서천군,005,0~4세,2021,834,422,412,102.4,832,422,410,102.9
34340, 서천군,005001, 0세,2021,156,85,71,119.7,155,85,70,121.4
34340, 서천군,005002, 1세,2021,168,80,88,90.9,167,80,87,92
34340, 서천군,005003, 2세,2021,149,74,75,98.7,149,74,75,98.7
34340, 서천군,005004, 3세,2021,184,100,84,119,184,100,84,119
34340, 서천군,005005, 4세,2021,177,83,94,88.3,177,83,94,88.3
34340, 서천군,010,5~9세,2021,1262,632,630,100.3,1261,631,630,100.2
34340, 서천군,010001, 5세,2021,204,100,104,96.2,204,100,104,96.2
34340, 서천군,010002, 6세,2021,247,125,122,102.5,247,125,122,102.5
34340, 서천군,010003, 7세,2021,257,137,120,114.2,257,137,120,114.2
34340, 서천군,010004, 8세,2021,269,127,142,89.4,269,127,142,89.4
34340, 서천군,010005, 9세,2021,285,143,142,100.7,284,142,142,100
34340, 서천군,015,10~14세,2021,1497,764,733,104.2,1493,763,730,104.5
34340, 서천군,015001, 10세,2021,307,158,149,106,306,158,148,106.8
34340, 서천군,015002, 11세,2021,307,148,159,93.1,306,148,158,93.7
34340, 서천군,015003, 12세,2021,264,148,116,127.6,264,148,116,127.6
34340, 서천군,015004, 13세,2021,312,158,154,102.6,311,157,154,101.9
34340, 서천군,015005, 14세,2021,307,152,155,98.1,306,152,154,98.7
34340, 서천군,020,15~19세,2021,1652,865,787,109.9,1649,863,786,109.8
34340, 서천군,020001, 15세,2021,306,163,143,114,306,163,143,114
34340, 서천군,020002, 16세,2021,353,178,175,101.7,353,178,175,101.7
34340, 서천군,020003, 17세,2021,387,178,209,85.2,387,178,209,85.2
34340, 서천군,020004, 18세,2021,391,204,187,109.1,389,203,186,109.1
34340, 서천군,020005, 19세,2021,215,142,73,194.5,214,141,73,193.2
34340, 서천군,025,20~24세,2021,1645,1048,597,175.5,1540,971,569,170.7
34340, 서천군,025001, 20세,2021,298,196,102,192.2,292,193,99,194.9
34340, 서천군,025002, 21세,2021,338,224,114,196.5,327,216,111,194.6
34340, 서천군,025003, 22세,2021,313,192,121,158.7,300,182,118,154.2
34340, 서천군,025004, 23세,2021,350,228,122,186.9,318,203,115,176.5
34340, 서천군,025005, 24세,2021,346,208,138,150.7,303,177,126,140.5
34340, 서천군,030,25~29세,2021,1918,1185,733,161.7,1542,880,662,132.9
34340, 서천군,030001, 25세,2021,380,221,159,139,315,173,142,121.8
34340, 서천군,030002, 26세,2021,414,259,155,167.1,340,195,145,134.5
34340, 서천군,030003, 27세,2021,362,232,130,178.5,287,169,118,143.2
34340, 서천군,030004, 28세,2021,405,252,153,164.7,321,190,131,145
34340, 서천군,030005, 29세,2021,357,221,136,162.5,279,153,126,121.4
34340, 서천군,035,30~34세,2021,1783,1075,708,151.8,1359,766,593,129.2
34340, 서천군,035001, 30세,2021,413,251,162,154.9,311,175,136,128.7
34340, 서천군,035002, 31세,2021,346,206,140,147.1,272,155,117,132.5
34340, 서천군,035003, 32세,2021,342,212,130,163.1,263,150,113,132.7
34340, 서천군,035004, 33세,2021,321,183,138,132.6,237,124,113,109.7
34340, 서천군,035005, 34세,2021,361,223,138,161.6,276,162,114,142.1
34340, 서천군,040,35~39세,2021,1963,1140,823,138.5,1659,915,744,123
34340, 서천군,040001, 35세,2021,343,201,142,141.5,274,148,126,117.5
34340, 서천군,040002, 36세,2021,337,210,127,165.4,272,166,106,156.6
34340, 서천군,040003, 37세,2021,385,217,168,129.2,329,177,152,116.4
34340, 서천군,040004, 38세,2021,411,233,178,130.9,358,195,163,119.6
34340, 서천군,040005, 39세,2021,487,279,208,134.1,426,229,197,116.2
34340, 서천군,045,40~44세,2021,2398,1329,1069,124.3,2201,1170,1031,113.5
34340, 서천군,045001, 40세,2021,444,248,196,126.5,404,213,191,111.5
34340, 서천군,045002, 41세,2021,512,281,231,121.6,470,247,223,110.8
34340, 서천군,045003, 42세,2021,480,263,217,121.2,439,231,208,111.1
34340, 서천군,045004, 43세,2021,454,258,196,131.6,416,229,187,122.5
34340, 서천군,045005, 44세,2021,508,279,229,121.8,472,250,222,112.6
34340, 서천군,050,45~49세,2021,3017,1644,1373,119.7,2860,1539,1321,116.5
34340, 서천군,050001, 45세,2021,533,319,214,149.1,500,295,205,143.9
34340, 서천군,050002, 46세,2021,538,282,256,110.2,508,265,243,109.1
34340, 서천군,050003, 47세,2021,653,344,309,111.3,616,317,299,106
34340, 서천군,050004, 48세,2021,637,345,292,118.2,599,320,279,114.7
34340, 서천군,050005, 49세,2021,656,354,302,117.2,637,342,295,115.9
34340, 서천군,055,50~54세,2021,3801,2062,1739,118.6,3712,2011,1701,118.2
34340, 서천군,055001, 50세,2021,766,430,336,128,741,412,329,125.2
34340, 서천군,055002, 51세,2021,728,407,321,126.8,707,397,310,128.1
34340, 서천군,055003, 52세,2021,770,426,344,123.8,753,417,336,124.1
34340, 서천군,055004, 53세,2021,765,389,376,103.5,750,381,369,103.3
34340, 서천군,055005, 54세,2021,772,410,362,113.3,761,404,357,113.2
34340, 서천군,060,55~59세,2021,4088,2208,1880,117.4,4039,2179,1860,117.2
34340, 서천군,060001, 55세,2021,644,357,287,124.4,638,352,286,123.1
34340, 서천군,060002, 56세,2021,836,437,399,109.5,828,433,395,109.6
34340, 서천군,060003, 57세,2021,796,436,360,121.1,780,426,354,120.3
34340, 서천군,060004, 58세,2021,851,468,383,122.2,840,461,379,121.6
34340, 서천군,060005, 59세,2021,961,510,451,113.1,953,507,446,113.7
34340, 서천군,065,60~64세,2021,5288,2596,2692,96.4,5266,2584,2682,96.3
34340, 서천군,065001, 60세,2021,1083,540,543,99.4,1079,537,542,99.1
34340, 서천군,065002, 61세,2021,1145,542,603,89.9,1142,541,601,90
34340, 서천군,065003, 62세,2021,1079,535,544,98.3,1075,533,542,98.3
34340, 서천군,065004, 63세,2021,1016,486,530,91.7,1010,483,527,91.7
34340, 서천군,065005, 64세,2021,965,493,472,104.4,960,490,470,104.3
34340, 서천군,070,65~69세,2021,4871,2337,2534,92.2,4858,2330,2528,92.2
34340, 서천군,070001, 65세,2021,1001,513,488,105.1,998,512,486,105.3
34340, 서천군,070002, 66세,2021,1152,577,575,100.3,1148,574,574,100
34340, 서천군,070003, 67세,2021,1015,454,561,80.9,1012,452,560,80.7
34340, 서천군,070004, 68세,2021,755,347,408,85,752,346,406,85.2
34340, 서천군,070005, 69세,2021,948,446,502,88.8,948,446,502,88.8
34340, 서천군,075,70~74세,2021,4333,2084,2249,92.7,4330,2083,2247,92.7
34340, 서천군,075001, 70세,2021,808,387,421,91.9,808,387,421,91.9
34340, 서천군,075002, 71세,2021,914,438,476,92,911,437,474,92.2
34340, 서천군,075003, 72세,2021,834,393,441,89.1,834,393,441,89.1
34340, 서천군,075004, 73세,2021,842,403,439,91.8,842,403,439,91.8
34340, 서천군,075005, 74세,2021,935,463,472,98.1,935,463,472,98.1
34340, 서천군,080,75~79세,2021,3471,1448,2023,71.6,3469,1446,2023,71.5
34340, 서천군,080001, 75세,2021,550,254,296,85.8,550,254,296,85.8
34340, 서천군,080002, 76세,2021,616,285,331,86.1,615,284,331,85.8
34340, 서천군,080003, 77세,2021,643,260,383,67.9,643,260,383,67.9
34340, 서천군,080004, 78세,2021,761,292,469,62.3,760,291,469,62
34340, 서천군,080005, 79세,2021,901,357,544,65.6,901,357,544,65.6
34340, 서천군,085,80~84세,2021,3223,1184,2039,58.1,3221,1184,2037,58.1
34340, 서천군,085001, 80세,2021,678,251,427,58.8,677,251,426,58.9
34340, 서천군,085002, 81세,2021,617,226,391,57.8,617,226,391,57.8
34340, 서천군,085003, 82세,2021,700,264,436,60.6,700,264,436,60.6
34340, 서천군,085004, 83세,2021,624,211,413,51.1,623,211,412,51.2
34340, 서천군,085005, 84세,2021,604,232,372,62.4,604,232,372,62.4
34340, 서천군,090,85~89세,2021,2067,698,1369,51,2066,698,1368,51
34340, 서천군,090001, 85세,2021,531,194,337,57.6,531,194,337,57.6
34340, 서천군,090002, 86세,2021,488,170,318,53.5,488,170,318,53.5
34340, 서천군,090003, 87세,2021,391,130,261,49.8,390,130,260,50
34340, 서천군,090004, 88세,2021,353,111,242,45.9,353,111,242,45.9
34340, 서천군,090005, 89세,2021,304,93,211,44.1,304,93,211,44.1
34340, 서천군,095,90~94세,2021,748,182,566,32.2,748,182,566,32.2
34340, 서천군,095001, 90세,2021,214,57,157,36.3,214,57,157,36.3
34340, 서천군,095002, 91세,2021,206,56,150,37.3,206,56,150,37.3
34340, 서천군,095003, 92세,2021,154,32,122,26.2,154,32,122,26.2
34340, 서천군,095004, 93세,2021,93,19,74,25.7,93,19,74,25.7
34340, 서천군,095005, 94세,2021,81,18,63,28.6,81,18,63,28.6
34340, 서천군,100,95~99세,2021,137,32,105,30.5,137,32,105,30.5
34340, 서천군,100001, 95세,2021,52,14,38,36.8,52,14,38,36.8
34340, 서천군,100002, 96세,2021,27,X,23,17.4,27,X,23,17.4
34340, 서천군,100003, 97세,2021,25,6,19,31.6,25,6,19,31.6
34340, 서천군,100004, 98세,2021,22,5,17,29.4,22,5,17,29.4
34340, 서천군,100005, 99세,2021,11,X,8,37.5,11,X,8,37.5
34340, 서천군,101,100세이상,2021,16,X,15,6.7,16,X,15,6.7
34340, 서천군,102,15세미만,2021,3593,1818,1775,102.4,3586,1816,1770,102.6
34340, 서천군,103,15~64세,2021,27553,15152,12401,122.2,25827,13878,11949,116.1
34340, 서천군,104,65세이상,2021,18866,7966,10900,73.1,18845,7956,10889,73.1
34340, 서천군,086,85세이상,2021,2968,913,2055,44.4,2967,913,2054,44.4
34340, 서천군,126,평균연령,2021,54.7,52,57.3,,55.3,52.9,57.7,
34340, 서천군,127,중위연령,2021,59.1,55.8,61.8,,60,57.3,62.2,
34350, 청양군,000,합계,2021,30103,15322,14781,103.7,29221,14886,14335,103.8
34350, 청양군,005,0~4세,2021,460,244,216,113,456,242,214,113.1
34350, 청양군,005001, 0세,2021,86,50,36,138.9,83,49,34,144.1
34350, 청양군,005002, 1세,2021,86,45,41,109.8,85,44,41,107.3
34350, 청양군,005003, 2세,2021,87,43,44,97.7,87,43,44,97.7
34350, 청양군,005004, 3세,2021,97,51,46,110.9,97,51,46,110.9
34350, 청양군,005005, 4세,2021,104,55,49,112.2,104,55,49,112.2
34350, 청양군,010,5~9세,2021,690,347,343,101.2,686,347,339,102.4
34350, 청양군,010001, 5세,2021,116,55,61,90.2,116,55,61,90.2
34350, 청양군,010002, 6세,2021,120,62,58,106.9,118,62,56,110.7
34350, 청양군,010003, 7세,2021,143,64,79,81,142,64,78,82.1
34350, 청양군,010004, 8세,2021,153,86,67,128.4,152,86,66,130.3
34350, 청양군,010005, 9세,2021,158,80,78,102.6,158,80,78,102.6
34350, 청양군,015,10~14세,2021,849,443,406,109.1,846,442,404,109.4
34350, 청양군,015001, 10세,2021,174,94,80,117.5,174,94,80,117.5
34350, 청양군,015002, 11세,2021,177,84,93,90.3,177,84,93,90.3
34350, 청양군,015003, 12세,2021,161,86,75,114.7,159,86,73,117.8
34350, 청양군,015004, 13세,2021,171,96,75,128,171,96,75,128
34350, 청양군,015005, 14세,2021,166,83,83,100,165,82,83,98.8
34350, 청양군,020,15~19세,2021,1125,608,517,117.6,1122,608,514,118.3
34350, 청양군,020001, 15세,2021,174,94,80,117.5,174,94,80,117.5
34350, 청양군,020002, 16세,2021,166,83,83,100,166,83,83,100
34350, 청양군,020003, 17세,2021,212,109,103,105.8,210,109,101,107.9
34350, 청양군,020004, 18세,2021,222,117,105,111.4,222,117,105,111.4
34350, 청양군,020005, 19세,2021,351,205,146,140.4,350,205,145,141.4
34350, 청양군,025,20~24세,2021,1441,854,587,145.5,1396,830,566,146.6
34350, 청양군,025001, 20세,2021,350,198,152,130.3,350,198,152,130.3
34350, 청양군,025002, 21세,2021,315,171,144,118.8,312,170,142,119.7
34350, 청양군,025003, 22세,2021,281,182,99,183.8,272,177,95,186.3
34350, 청양군,025004, 23세,2021,254,156,98,159.2,238,147,91,161.5
34350, 청양군,025005, 24세,2021,241,147,94,156.4,224,138,86,160.5
34350, 청양군,030,25~29세,2021,1237,752,485,155.1,1054,638,416,153.4
34350, 청양군,030001, 25세,2021,279,167,112,149.1,243,149,94,158.5
34350, 청양군,030002, 26세,2021,256,160,96,166.7,224,140,84,166.7
34350, 청양군,030003, 27세,2021,267,160,107,149.5,224,134,90,148.9
34350, 청양군,030004, 28세,2021,211,123,88,139.8,177,101,76,132.9
34350, 청양군,030005, 29세,2021,224,142,82,173.2,186,114,72,158.3
34350, 청양군,035,30~34세,2021,1049,608,441,137.9,853,508,345,147.2
34350, 청양군,035001, 30세,2021,202,117,85,137.6,158,92,66,139.4
34350, 청양군,035002, 31세,2021,209,120,89,134.8,178,110,68,161.8
34350, 청양군,035003, 32세,2021,214,130,84,154.8,181,109,72,151.4
34350, 청양군,035004, 33세,2021,205,121,84,144,162,99,63,157.1
34350, 청양군,035005, 34세,2021,219,120,99,121.2,174,98,76,128.9
34350, 청양군,040,35~39세,2021,1100,608,492,123.6,973,539,434,124.2
34350, 청양군,040001, 35세,2021,208,121,87,139.1,181,104,77,135.1
34350, 청양군,040002, 36세,2021,201,97,104,93.3,169,81,88,92
34350, 청양군,040003, 37세,2021,219,134,85,157.6,202,128,74,173
34350, 청양군,040004, 38세,2021,232,119,113,105.3,205,106,99,107.1
34350, 청양군,040005, 39세,2021,240,137,103,133,216,120,96,125
34350, 청양군,045,40~44세,2021,1237,702,535,131.2,1159,669,490,136.5
34350, 청양군,045001, 40세,2021,248,149,99,150.5,231,142,89,159.6
34350, 청양군,045002, 41세,2021,244,134,110,121.8,228,128,100,128
34350, 청양군,045003, 42세,2021,261,145,116,125,240,134,106,126.4
34350, 청양군,045004, 43세,2021,231,138,93,148.4,215,131,84,156
34350, 청양군,045005, 44세,2021,253,136,117,116.2,245,134,111,120.7
34350, 청양군,050,45~49세,2021,1667,966,701,137.8,1613,945,668,141.5
34350, 청양군,050001, 45세,2021,301,188,113,166.4,284,178,106,167.9
34350, 청양군,050002, 46세,2021,313,173,140,123.6,303,170,133,127.8
34350, 청양군,050003, 47세,2021,298,178,120,148.3,291,174,117,148.7
34350, 청양군,050004, 48세,2021,371,215,156,137.8,360,212,148,143.2
34350, 청양군,050005, 49세,2021,384,212,172,123.3,375,211,164,128.7
34350, 청양군,055,50~54세,2021,2202,1232,970,127,2138,1203,935,128.7
34350, 청양군,055001, 50세,2021,408,238,170,140,400,235,165,142.4
34350, 청양군,055002, 51세,2021,408,226,182,124.2,396,220,176,125
34350, 청양군,055003, 52세,2021,461,257,204,126,442,249,193,129
34350, 청양군,055004, 53세,2021,493,271,222,122.1,479,263,216,121.8
34350, 청양군,055005, 54세,2021,432,240,192,125,421,236,185,127.6
34350, 청양군,060,55~59세,2021,2718,1441,1277,112.8,2664,1425,1239,115
34350, 청양군,060001, 55세,2021,451,252,199,126.6,445,251,194,129.4
34350, 청양군,060002, 56세,2021,573,320,253,126.5,565,319,246,129.7
34350, 청양군,060003, 57세,2021,522,276,246,112.2,506,270,236,114.4
34350, 청양군,060004, 58세,2021,519,258,261,98.9,507,255,252,101.2
34350, 청양군,060005, 59세,2021,653,335,318,105.3,641,330,311,106.1
34350, 청양군,065,60~64세,2021,3472,1759,1713,102.7,3436,1744,1692,103.1
34350, 청양군,065001, 60세,2021,758,392,366,107.1,753,392,361,108.6
34350, 청양군,065002, 61세,2021,767,405,362,111.9,756,400,356,112.4
34350, 청양군,065003, 62세,2021,667,332,335,99.1,659,327,332,98.5
34350, 청양군,065004, 63세,2021,617,298,319,93.4,613,295,318,92.8
34350, 청양군,065005, 64세,2021,663,332,331,100.3,655,330,325,101.5
34350, 청양군,070,65~69세,2021,2844,1446,1398,103.4,2827,1440,1387,103.8
34350, 청양군,070001, 65세,2021,604,294,310,94.8,599,293,306,95.8
34350, 청양군,070002, 66세,2021,686,348,338,103,682,346,336,103
34350, 청양군,070003, 67세,2021,565,297,268,110.8,562,297,265,112.1
34350, 청양군,070004, 68세,2021,475,254,221,114.9,471,251,220,114.1
34350, 청양군,070005, 69세,2021,514,253,261,96.9,513,253,260,97.3
34350, 청양군,075,70~74세,2021,2362,1174,1188,98.8,2352,1170,1182,99
34350, 청양군,075001, 70세,2021,438,239,199,120.1,436,238,198,120.2
34350, 청양군,075002, 71세,2021,523,262,261,100.4,521,260,261,99.6
34350, 청양군,075003, 72세,2021,502,247,255,96.9,499,246,253,97.2
34350, 청양군,075004, 73세,2021,482,235,247,95.1,481,235,246,95.5
34350, 청양군,075005, 74세,2021,417,191,226,84.5,415,191,224,85.3
34350, 청양군,080,75~79세,2021,1996,860,1136,75.7,1993,859,1134,75.7
34350, 청양군,080001, 75세,2021,334,164,170,96.5,334,164,170,96.5
34350, 청양군,080002, 76세,2021,355,172,183,94,354,172,182,94.5
34350, 청양군,080003, 77세,2021,395,152,243,62.6,394,151,243,62.1
34350, 청양군,080004, 78세,2021,379,156,223,70,379,156,223,70
34350, 청양군,080005, 79세,2021,533,216,317,68.1,532,216,316,68.4
34350, 청양군,085,80~84세,2021,1916,710,1206,58.9,1915,709,1206,58.8
34350, 청양군,085001, 80세,2021,416,176,240,73.3,415,175,240,72.9
34350, 청양군,085002, 81세,2021,371,125,246,50.8,371,125,246,50.8
34350, 청양군,085003, 82세,2021,410,163,247,66,410,163,247,66
34350, 청양군,085004, 83세,2021,352,129,223,57.8,352,129,223,57.8
34350, 청양군,085005, 84세,2021,367,117,250,46.8,367,117,250,46.8
34350, 청양군,090,85~89세,2021,1288,444,844,52.6,1288,444,844,52.6
34350, 청양군,090001, 85세,2021,347,130,217,59.9,347,130,217,59.9
34350, 청양군,090002, 86세,2021,318,101,217,46.5,318,101,217,46.5
34350, 청양군,090003, 87세,2021,253,82,171,48,253,82,171,48
34350, 청양군,090004, 88세,2021,193,74,119,62.2,193,74,119,62.2
34350, 청양군,090005, 89세,2021,177,57,120,47.5,177,57,120,47.5
34350, 청양군,095,90~94세,2021,372,95,277,34.3,372,95,277,34.3
34350, 청양군,095001, 90세,2021,113,30,83,36.1,113,30,83,36.1
34350, 청양군,095002, 91세,2021,89,30,59,50.8,89,30,59,50.8
34350, 청양군,095003, 92세,2021,80,20,60,33.3,80,20,60,33.3
34350, 청양군,095004, 93세,2021,57,7,50,14,57,7,50,14
34350, 청양군,095005, 94세,2021,33,8,25,32,33,8,25,32
34350, 청양군,100,95~99세,2021,71,26,45,57.8,71,26,45,57.8
34350, 청양군,100001, 95세,2021,31,8,23,34.8,31,8,23,34.8
34350, 청양군,100002, 96세,2021,18,10,8,125,18,10,8,125
34350, 청양군,100003, 97세,2021,9,X,6,50,9,X,6,50
34350, 청양군,100004, 98세,2021,6,X,X,100,6,X,X,100
34350, 청양군,100005, 99세,2021,7,X,5,40,7,X,5,40
34350, 청양군,101,100세이상,2021,7,X,X,75,7,X,X,75
34350, 청양군,102,15세미만,2021,1999,1034,965,107.2,1988,1031,957,107.7
34350, 청양군,103,15~64세,2021,17248,9530,7718,123.5,16408,9109,7299,124.8
34350, 청양군,104,65세이상,2021,10856,4758,6098,78,10825,4746,6079,78.1
34350, 청양군,086,85세이상,2021,1738,568,1170,48.5,1738,568,1170,48.5
34350, 청양군,126,평균연령,2021,54.1,51.8,56.6,,54.6,52.2,57.1,
34350, 청양군,127,중위연령,2021,58.9,56.1,61.1,,59.5,56.7,61.7,
34360, 홍성군,000,합계,2021,101618,50955,50663,100.6,98266,48803,49463,98.7
34360, 홍성군,005,0~4세,2021,3099,1605,1494,107.4,3072,1589,1483,107.1
34360, 홍성군,005001, 0세,2021,521,276,245,112.7,517,274,243,112.8
34360, 홍성군,005002, 1세,2021,569,313,256,122.3,562,310,252,123
34360, 홍성군,005003, 2세,2021,618,319,299,106.7,613,315,298,105.7
34360, 홍성군,005004, 3세,2021,654,328,326,100.6,647,323,324,99.7
34360, 홍성군,005005, 4세,2021,737,369,368,100.3,733,367,366,100.3
34360, 홍성군,010,5~9세,2021,4301,2241,2060,108.8,4264,2219,2045,108.5
34360, 홍성군,010001, 5세,2021,770,397,373,106.4,758,389,369,105.4
34360, 홍성군,010002, 6세,2021,859,446,413,108,852,440,412,106.8
34360, 홍성군,010003, 7세,2021,826,449,377,119.1,818,444,374,118.7
34360, 홍성군,010004, 8세,2021,872,439,433,101.4,869,438,431,101.6
34360, 홍성군,010005, 9세,2021,974,510,464,109.9,967,508,459,110.7
34360, 홍성군,015,10~14세,2021,4832,2454,2378,103.2,4802,2439,2363,103.2
34360, 홍성군,015001, 10세,2021,959,494,465,106.2,952,491,461,106.5
34360, 홍성군,015002, 11세,2021,956,484,472,102.5,950,480,470,102.1
34360, 홍성군,015003, 12세,2021,943,478,465,102.8,935,474,461,102.8
34360, 홍성군,015004, 13세,2021,973,494,479,103.1,970,493,477,103.4
34360, 홍성군,015005, 14세,2021,1001,504,497,101.4,995,501,494,101.4
34360, 홍성군,020,15~19세,2021,5007,2515,2492,100.9,4942,2479,2463,100.6
34360, 홍성군,020001, 15세,2021,890,470,420,111.9,886,467,419,111.5
34360, 홍성군,020002, 16세,2021,845,418,427,97.9,839,414,425,97.4
34360, 홍성군,020003, 17세,2021,1074,549,525,104.6,1065,544,521,104.4
34360, 홍성군,020004, 18세,2021,1059,539,520,103.7,1043,530,513,103.3
34360, 홍성군,020005, 19세,2021,1139,539,600,89.8,1109,524,585,89.6
34360, 홍성군,025,20~24세,2021,6015,3217,2798,115,5705,3021,2684,112.6
34360, 홍성군,025001, 20세,2021,1280,607,673,90.2,1240,584,656,89
34360, 홍성군,025002, 21세,2021,1334,647,687,94.2,1288,623,665,93.7
34360, 홍성군,025003, 22세,2021,1213,669,544,123,1154,633,521,121.5
34360, 홍성군,025004, 23세,2021,1116,649,467,139,1050,611,439,139.2
34360, 홍성군,025005, 24세,2021,1072,645,427,151.1,973,570,403,141.4
34360, 홍성군,030,25~29세,2021,5078,2965,2113,140.3,4393,2475,1918,129
34360, 홍성군,030001, 25세,2021,974,567,407,139.3,867,487,380,128.2
34360, 홍성군,030002, 26세,2021,1052,626,426,146.9,911,528,383,137.9
34360, 홍성군,030003, 27세,2021,994,600,394,152.3,845,494,351,140.7
34360, 홍성군,030004, 28세,2021,968,563,405,139,819,455,364,125
34360, 홍성군,030005, 29세,2021,1090,609,481,126.6,951,511,440,116.1
34360, 홍성군,035,30~34세,2021,4955,2722,2233,121.9,4363,2294,2069,110.9
34360, 홍성군,035001, 30세,2021,1009,560,449,124.7,870,462,408,113.2
34360, 홍성군,035002, 31세,2021,1022,561,461,121.7,908,477,431,110.7
34360, 홍성군,035003, 32세,2021,957,537,420,127.9,845,458,387,118.3
34360, 홍성군,035004, 33세,2021,982,544,438,124.2,864,459,405,113.3
34360, 홍성군,035005, 34세,2021,985,520,465,111.8,876,438,438,100
34360, 홍성군,040,35~39세,2021,5941,3094,2847,108.7,5477,2780,2697,103.1
34360, 홍성군,040001, 35세,2021,1034,578,456,126.8,933,514,419,122.7
34360, 홍성군,040002, 36세,2021,1109,602,507,118.7,1011,528,483,109.3
34360, 홍성군,040003, 37세,2021,1170,602,568,106,1072,542,530,102.3
34360, 홍성군,040004, 38세,2021,1227,647,580,111.6,1144,585,559,104.7
34360, 홍성군,040005, 39세,2021,1401,665,736,90.4,1317,611,706,86.5
34360, 홍성군,045,40~44세,2021,6817,3561,3256,109.4,6496,3358,3138,107
34360, 홍성군,045001, 40세,2021,1409,737,672,109.7,1331,697,634,109.9
34360, 홍성군,045002, 41세,2021,1437,756,681,111,1363,712,651,109.4
34360, 홍성군,045003, 42세,2021,1338,684,654,104.6,1283,645,638,101.1
34360, 홍성군,045004, 43세,2021,1335,693,642,107.9,1270,652,618,105.5
34360, 홍성군,045005, 44세,2021,1298,691,607,113.8,1249,652,597,109.2
34360, 홍성군,050,45~49세,2021,7541,3953,3588,110.2,7304,3811,3493,109.1
34360, 홍성군,050001, 45세,2021,1319,674,645,104.5,1271,649,622,104.3
34360, 홍성군,050002, 46세,2021,1487,741,746,99.3,1440,715,725,98.6
34360, 홍성군,050003, 47세,2021,1612,845,767,110.2,1552,807,745,108.3
34360, 홍성군,050004, 48세,2021,1547,824,723,114,1509,799,710,112.5
34360, 홍성군,050005, 49세,2021,1576,869,707,122.9,1532,841,691,121.7
34360, 홍성군,055,50~54세,2021,7924,4227,3697,114.3,7722,4115,3607,114.1
34360, 홍성군,055001, 50세,2021,1623,886,737,120.2,1568,852,716,119
34360, 홍성군,055002, 51세,2021,1546,828,718,115.3,1507,806,701,115
34360, 홍성군,055003, 52세,2021,1619,866,753,115,1584,846,738,114.6
34360, 홍성군,055004, 53세,2021,1648,887,761,116.6,1606,867,739,117.3
34360, 홍성군,055005, 54세,2021,1488,760,728,104.4,1457,744,713,104.3
34360, 홍성군,060,55~59세,2021,7653,3942,3711,106.2,7482,3858,3624,106.5
34360, 홍성군,060001, 55세,2021,1316,676,640,105.6,1281,656,625,105
34360, 홍성군,060002, 56세,2021,1593,821,772,106.3,1559,804,755,106.5
34360, 홍성군,060003, 57세,2021,1464,745,719,103.6,1430,732,698,104.9
34360, 홍성군,060004, 58세,2021,1591,828,763,108.5,1555,810,745,108.7
34360, 홍성군,060005, 59세,2021,1689,872,817,106.7,1657,856,801,106.9
34360, 홍성군,065,60~64세,2021,8398,4202,4196,100.1,8296,4156,4140,100.4
34360, 홍성군,065001, 60세,2021,1878,933,945,98.7,1863,929,934,99.5
34360, 홍성군,065002, 61세,2021,1906,927,979,94.7,1877,912,965,94.5
34360, 홍성군,065003, 62세,2021,1580,815,765,106.5,1565,810,755,107.3
34360, 홍성군,065004, 63세,2021,1511,744,767,97,1491,735,756,97.2
34360, 홍성군,065005, 64세,2021,1523,783,740,105.8,1500,770,730,105.5
34360, 홍성군,070,65~69세,2021,6737,3248,3489,93.1,6677,3219,3458,93.1
34360, 홍성군,070001, 65세,2021,1454,713,741,96.2,1436,704,732,96.2
34360, 홍성군,070002, 66세,2021,1604,772,832,92.8,1590,765,825,92.7
34360, 홍성군,070003, 67세,2021,1369,670,699,95.9,1359,668,691,96.7
34360, 홍성군,070004, 68세,2021,1057,513,544,94.3,1050,508,542,93.7
34360, 홍성군,070005, 69세,2021,1253,580,673,86.2,1242,574,668,85.9
34360, 홍성군,075,70~74세,2021,5542,2629,2913,90.3,5519,2617,2902,90.2
34360, 홍성군,075001, 70세,2021,1097,523,574,91.1,1088,519,569,91.2
34360, 홍성군,075002, 71세,2021,1109,501,608,82.4,1106,499,607,82.2
34360, 홍성군,075003, 72세,2021,1239,608,631,96.4,1233,606,627,96.7
34360, 홍성군,075004, 73세,2021,1075,515,560,92,1073,513,560,91.6
34360, 홍성군,075005, 74세,2021,1022,482,540,89.3,1019,480,539,89.1
34360, 홍성군,080,75~79세,2021,4420,1900,2520,75.4,4406,1896,2510,75.5
34360, 홍성군,080001, 75세,2021,772,386,386,100,769,386,383,100.8
34360, 홍성군,080002, 76세,2021,700,314,386,81.3,696,313,383,81.7
34360, 홍성군,080003, 77세,2021,888,366,522,70.1,884,364,520,70
34360, 홍성군,080004, 78세,2021,907,376,531,70.8,906,376,530,70.9
34360, 홍성군,080005, 79세,2021,1153,458,695,65.9,1151,457,694,65.9
34360, 홍성군,085,80~84세,2021,3833,1404,2429,57.8,3825,1401,2424,57.8
34360, 홍성군,085001, 80세,2021,802,304,498,61,800,303,497,61
34360, 홍성군,085002, 81세,2021,727,269,458,58.7,727,269,458,58.7
34360, 홍성군,085003, 82세,2021,839,311,528,58.9,838,311,527,59
34360, 홍성군,085004, 83세,2021,800,280,520,53.8,798,278,520,53.5
34360, 홍성군,085005, 84세,2021,665,240,425,56.5,662,240,422,56.9
34360, 홍성군,090,85~89세,2021,2578,851,1727,49.3,2577,851,1726,49.3
34360, 홍성군,090001, 85세,2021,733,263,470,56,732,263,469,56.1
34360, 홍성군,090002, 86세,2021,601,200,401,49.9,601,200,401,49.9
34360, 홍성군,090003, 87세,2021,492,174,318,54.7,492,174,318,54.7
34360, 홍성군,090004, 88세,2021,392,105,287,36.6,392,105,287,36.6
34360, 홍성군,090005, 89세,2021,360,109,251,43.4,360,109,251,43.4
34360, 홍성군,095,90~94세,2021,748,182,566,32.2,746,182,564,32.3
34360, 홍성군,095001, 90세,2021,225,57,168,33.9,224,57,167,34.1
34360, 홍성군,095002, 91세,2021,179,44,135,32.6,179,44,135,32.6
34360, 홍성군,095003, 92세,2021,173,44,129,34.1,173,44,129,34.1
34360, 홍성군,095004, 93세,2021,105,20,85,23.5,104,20,84,23.8
34360, 홍성군,095005, 94세,2021,66,17,49,34.7,66,17,49,34.7
34360, 홍성군,100,95~99세,2021,177,40,137,29.2,176,40,136,29.4
34360, 홍성군,100001, 95세,2021,54,13,41,31.7,54,13,41,31.7
34360, 홍성군,100002, 96세,2021,41,16,25,64,41,16,25,64
34360, 홍성군,100003, 97세,2021,26,X,25,4,26,X,25,4
34360, 홍성군,100004, 98세,2021,37,6,31,19.4,36,6,30,20
34360, 홍성군,100005, 99세,2021,19,X,15,26.7,19,X,15,26.7
34360, 홍성군,101,100세이상,2021,22,X,19,15.8,22,X,19,15.8
34360, 홍성군,102,15세미만,2021,12232,6300,5932,106.2,12138,6247,5891,106
34360, 홍성군,103,15~64세,2021,65329,34398,30931,111.2,62180,32347,29833,108.4
34360, 홍성군,104,65세이상,2021,24057,10257,13800,74.3,23948,10209,13739,74.3
34360, 홍성군,086,85세이상,2021,3525,1076,2449,43.9,3521,1076,2445,44
34360, 홍성군,126,평균연령,2021,46.3,44.6,48,,46.6,45,48.2,
34360, 홍성군,127,중위연령,2021,48.2,46.6,50.1,,48.9,47.5,50.5,
34370, 예산군,000,합계,2021,76490,38853,37637,103.2,73448,36855,36593,100.7
34370, 예산군,005,0~4세,2021,1293,662,631,104.9,1266,647,619,104.5
34370, 예산군,005001, 0세,2021,224,121,103,117.5,218,117,101,115.8
34370, 예산군,005002, 1세,2021,237,128,109,117.4,233,126,107,117.8
34370, 예산군,005003, 2세,2021,271,138,133,103.8,267,137,130,105.4
34370, 예산군,005004, 3세,2021,265,129,136,94.9,259,125,134,93.3
34370, 예산군,005005, 4세,2021,296,146,150,97.3,289,142,147,96.6
34370, 예산군,010,5~9세,2021,2033,1069,964,110.9,2009,1054,955,110.4
34370, 예산군,010001, 5세,2021,335,171,164,104.3,330,168,162,103.7
34370, 예산군,010002, 6세,2021,376,210,166,126.5,371,206,165,124.8
34370, 예산군,010003, 7세,2021,406,208,198,105.1,403,207,196,105.6
34370, 예산군,010004, 8세,2021,428,218,210,103.8,423,215,208,103.4
34370, 예산군,010005, 9세,2021,488,262,226,115.9,482,258,224,115.2
34370, 예산군,015,10~14세,2021,2515,1314,1201,109.4,2502,1306,1196,109.2
34370, 예산군,015001, 10세,2021,493,260,233,111.6,488,257,231,111.3
34370, 예산군,015002, 11세,2021,479,247,232,106.5,477,246,231,106.5
34370, 예산군,015003, 12세,2021,464,241,223,108.1,461,239,222,107.7
34370, 예산군,015004, 13세,2021,485,250,235,106.4,485,250,235,106.4
34370, 예산군,015005, 14세,2021,594,316,278,113.7,591,314,277,113.4
34370, 예산군,020,15~19세,2021,3028,1584,1444,109.7,3012,1576,1436,109.7
34370, 예산군,020001, 15세,2021,516,248,268,92.5,513,247,266,92.9
34370, 예산군,020002, 16세,2021,614,315,299,105.4,611,314,297,105.7
34370, 예산군,020003, 17세,2021,662,372,290,128.3,660,371,289,128.4
34370, 예산군,020004, 18세,2021,660,352,308,114.3,657,350,307,114
34370, 예산군,020005, 19세,2021,576,297,279,106.5,571,294,277,106.1
34370, 예산군,025,20~24세,2021,3467,1978,1489,132.8,3280,1853,1427,129.9
34370, 예산군,025001, 20세,2021,655,359,296,121.3,645,356,289,123.2
34370, 예산군,025002, 21세,2021,710,394,316,124.7,693,386,307,125.7
34370, 예산군,025003, 22세,2021,701,398,303,131.4,667,373,294,126.9
34370, 예산군,025004, 23세,2021,718,429,289,148.4,663,390,273,142.9
34370, 예산군,025005, 24세,2021,683,398,285,139.6,612,348,264,131.8
34370, 예산군,030,25~29세,2021,3450,2097,1353,155,2931,1712,1219,140.4
34370, 예산군,030001, 25세,2021,710,430,280,153.6,618,356,262,135.9
34370, 예산군,030002, 26세,2021,706,414,292,141.8,602,341,261,130.7
34370, 예산군,030003, 27세,2021,645,409,236,173.3,538,325,213,152.6
34370, 예산군,030004, 28세,2021,729,436,293,148.8,617,356,261,136.4
34370, 예산군,030005, 29세,2021,660,408,252,161.9,556,334,222,150.5
34370, 예산군,035,30~34세,2021,3176,1899,1277,148.7,2606,1485,1121,132.5
34370, 예산군,035001, 30세,2021,685,407,278,146.4,561,312,249,125.3
34370, 예산군,035002, 31세,2021,647,385,262,146.9,523,304,219,138.8
34370, 예산군,035003, 32세,2021,600,361,239,151,494,284,210,135.2
34370, 예산군,035004, 33세,2021,592,352,240,146.7,488,274,214,128
34370, 예산군,035005, 34세,2021,652,394,258,152.7,540,311,229,135.8
34370, 예산군,040,35~39세,2021,3336,1906,1430,133.3,2863,1580,1283,123.1
34370, 예산군,040001, 35세,2021,566,328,238,137.8,470,261,209,124.9
34370, 예산군,040002, 36세,2021,631,365,266,137.2,536,304,232,131
34370, 예산군,040003, 37세,2021,679,389,290,134.1,572,308,264,116.7
34370, 예산군,040004, 38세,2021,674,385,289,133.2,598,333,265,125.7
34370, 예산군,040005, 39세,2021,786,439,347,126.5,687,374,313,119.5
34370, 예산군,045,40~44세,2021,3926,2124,1802,117.9,3623,1925,1698,113.4
34370, 예산군,045001, 40세,2021,765,423,342,123.7,697,378,319,118.5
34370, 예산군,045002, 41세,2021,836,445,391,113.8,776,403,373,108
34370, 예산군,045003, 42세,2021,774,408,366,111.5,718,373,345,108.1
34370, 예산군,045004, 43세,2021,737,408,329,124,675,364,311,117
34370, 예산군,045005, 44세,2021,814,440,374,117.6,757,407,350,116.3
34370, 예산군,050,45~49세,2021,5121,2824,2297,122.9,4852,2670,2182,122.4
34370, 예산군,050001, 45세,2021,893,495,398,124.4,843,464,379,122.4
34370, 예산군,050002, 46세,2021,902,504,398,126.6,855,478,377,126.8
34370, 예산군,050003, 47세,2021,1077,566,511,110.8,1030,536,494,108.5
34370, 예산군,050004, 48세,2021,1156,653,503,129.8,1100,624,476,131.1
34370, 예산군,050005, 49세,2021,1093,606,487,124.4,1024,568,456,124.6
34370, 예산군,055,50~54세,2021,6163,3393,2770,122.5,5922,3248,2674,121.5
34370, 예산군,055001, 50세,2021,1168,647,521,124.2,1110,612,498,122.9
34370, 예산군,055002, 51세,2021,1184,665,519,128.1,1135,637,498,127.9
34370, 예산군,055003, 52세,2021,1329,751,578,129.9,1267,712,555,128.3
34370, 예산군,055004, 53세,2021,1326,706,620,113.9,1288,683,605,112.9
34370, 예산군,055005, 54세,2021,1156,624,532,117.3,1122,604,518,116.6
34370, 예산군,060,55~59세,2021,6581,3424,3157,108.5,6368,3313,3055,108.4
34370, 예산군,060001, 55세,2021,1114,584,530,110.2,1073,557,516,107.9
34370, 예산군,060002, 56세,2021,1378,720,658,109.4,1332,704,628,112.1
34370, 예산군,060003, 57세,2021,1252,660,592,111.5,1216,641,575,111.5
34370, 예산군,060004, 58세,2021,1313,675,638,105.8,1264,649,615,105.5
34370, 예산군,060005, 59세,2021,1524,785,739,106.2,1483,762,721,105.7
34370, 예산군,065,60~64세,2021,8283,4083,4200,97.2,8180,4024,4156,96.8
34370, 예산군,065001, 60세,2021,1891,953,938,101.6,1870,938,932,100.6
34370, 예산군,065002, 61세,2021,1822,842,980,85.9,1799,831,968,85.8
34370, 예산군,065003, 62세,2021,1538,755,783,96.4,1521,745,776,96
34370, 예산군,065004, 63세,2021,1494,746,748,99.7,1470,732,738,99.2
34370, 예산군,065005, 64세,2021,1538,787,751,104.8,1520,778,742,104.9
34370, 예산군,070,65~69세,2021,6803,3383,3420,98.9,6761,3363,3398,99
34370, 예산군,070001, 65세,2021,1456,753,703,107.1,1443,748,695,107.6
34370, 예산군,070002, 66세,2021,1567,784,783,100.1,1558,778,780,99.7
34370, 예산군,070003, 67세,2021,1352,660,692,95.4,1344,655,689,95.1
34370, 예산군,070004, 68세,2021,1128,556,572,97.2,1119,553,566,97.7
34370, 예산군,070005, 69세,2021,1300,630,670,94,1297,629,668,94.2
34370, 예산군,075,70~74세,2021,5524,2617,2907,90,5503,2607,2896,90
34370, 예산군,075001, 70세,2021,1022,449,573,78.4,1017,446,571,78.1
34370, 예산군,075002, 71세,2021,1195,569,626,90.9,1188,567,621,91.3
34370, 예산군,075003, 72세,2021,1141,562,579,97.1,1137,559,578,96.7
34370, 예산군,075004, 73세,2021,1097,515,582,88.5,1096,515,581,88.6
34370, 예산군,075005, 74세,2021,1069,522,547,95.4,1065,520,545,95.4
34370, 예산군,080,75~79세,2021,4481,1910,2571,74.3,4474,1909,2565,74.4
34370, 예산군,080001, 75세,2021,745,364,381,95.5,742,364,378,96.3
34370, 예산군,080002, 76세,2021,750,293,457,64.1,746,292,454,64.3
34370, 예산군,080003, 77세,2021,884,375,509,73.7,884,375,509,73.7
34370, 예산군,080004, 78세,2021,893,402,491,81.9,893,402,491,81.9
34370, 예산군,080005, 79세,2021,1209,476,733,64.9,1209,476,733,64.9
34370, 예산군,085,80~84세,2021,4013,1567,2446,64.1,4001,1564,2437,64.2
34370, 예산군,085001, 80세,2021,864,354,510,69.4,861,353,508,69.5
34370, 예산군,085002, 81세,2021,787,325,462,70.3,786,325,461,70.5
34370, 예산군,085003, 82세,2021,862,320,542,59,861,320,541,59.1
34370, 예산군,085004, 83세,2021,796,289,507,57,792,289,503,57.5
34370, 예산군,085005, 84세,2021,704,279,425,65.6,701,277,424,65.3
34370, 예산군,090,85~89세,2021,2440,826,1614,51.2,2439,826,1613,51.2
34370, 예산군,090001, 85세,2021,652,244,408,59.8,652,244,408,59.8
34370, 예산군,090002, 86세,2021,574,196,378,51.9,574,196,378,51.9
34370, 예산군,090003, 87세,2021,490,169,321,52.6,489,169,320,52.8
34370, 예산군,090004, 88세,2021,410,124,286,43.4,410,124,286,43.4
34370, 예산군,090005, 89세,2021,314,93,221,42.1,314,93,221,42.1
34370, 예산군,095,90~94세,2021,704,176,528,33.3,703,176,527,33.4
34370, 예산군,095001, 90세,2021,226,62,164,37.8,226,62,164,37.8
34370, 예산군,095002, 91세,2021,169,37,132,28,168,37,131,28.2
34370, 예산군,095003, 92세,2021,128,32,96,33.3,128,32,96,33.3
34370, 예산군,095004, 93세,2021,101,16,85,18.8,101,16,85,18.8
34370, 예산군,095005, 94세,2021,80,29,51,56.9,80,29,51,56.9
34370, 예산군,100,95~99세,2021,125,14,111,12.6,125,14,111,12.6
34370, 예산군,100001, 95세,2021,39,7,32,21.9,39,7,32,21.9
34370, 예산군,100002, 96세,2021,35,X,31,12.9,35,X,31,12.9
34370, 예산군,100003, 97세,2021,18,X,17,5.9,18,X,17,5.9
34370, 예산군,100004, 98세,2021,18,X,16,12.5,18,X,16,12.5
34370, 예산군,100005, 99세,2021,15,X,15,0,15,X,15,0
34370, 예산군,101,100세이상,2021,28,X,25,12,28,X,25,12
34370, 예산군,102,15세미만,2021,5841,3045,2796,108.9,5777,3007,2770,108.6
34370, 예산군,103,15~64세,2021,46531,25312,21219,119.3,43637,23386,20251,115.5
34370, 예산군,104,65세이상,2021,24118,10496,13622,77.1,24034,10462,13572,77.1
34370, 예산군,086,85세이상,2021,3297,1019,2278,44.7,3295,1019,2276,44.8
34370, 예산군,126,평균연령,2021,51.8,49.7,54.1,,52.4,50.3,54.5,
34370, 예산군,127,중위연령,2021,55.7,52.9,58.6,,56.6,54,59.2,
34380, 태안군,000,합계,2021,60285,31042,29243,106.2,58323,29681,28642,103.6
34380, 태안군,005,0~4세,2021,1104,565,539,104.8,1098,563,535,105.2
34380, 태안군,005001, 0세,2021,181,113,68,166.2,181,113,68,166.2
34380, 태안군,005002, 1세,2021,205,92,113,81.4,203,92,111,82.9
34380, 태안군,005003, 2세,2021,228,112,116,96.6,226,110,116,94.8
34380, 태안군,005004, 3세,2021,232,115,117,98.3,230,115,115,100
34380, 태안군,005005, 4세,2021,258,133,125,106.4,258,133,125,106.4
34380, 태안군,010,5~9세,2021,1733,867,866,100.1,1727,862,865,99.7
34380, 태안군,010001, 5세,2021,318,156,162,96.3,316,154,162,95.1
34380, 태안군,010002, 6세,2021,315,174,141,123.4,314,173,141,122.7
34380, 태안군,010003, 7세,2021,329,163,166,98.2,327,162,165,98.2
34380, 태안군,010004, 8세,2021,372,184,188,97.9,371,183,188,97.3
34380, 태안군,010005, 9세,2021,399,190,209,90.9,399,190,209,90.9
34380, 태안군,015,10~14세,2021,1967,1024,943,108.6,1962,1022,940,108.7
34380, 태안군,015001, 10세,2021,371,189,182,103.8,370,189,181,104.4
34380, 태안군,015002, 11세,2021,341,185,156,118.6,339,184,155,118.7
34380, 태안군,015003, 12세,2021,391,212,179,118.4,390,211,179,117.9
34380, 태안군,015004, 13세,2021,442,221,221,100,441,221,220,100.5
34380, 태안군,015005, 14세,2021,422,217,205,105.9,422,217,205,105.9
34380, 태안군,020,15~19세,2021,2118,1111,1007,110.3,2111,1106,1005,110
34380, 태안군,020001, 15세,2021,424,220,204,107.8,424,220,204,107.8
34380, 태안군,020002, 16세,2021,397,182,215,84.7,397,182,215,84.7
34380, 태안군,020003, 17세,2021,354,145,209,69.4,353,145,208,69.7
34380, 태안군,020004, 18세,2021,430,219,211,103.8,424,214,210,101.9
34380, 태안군,020005, 19세,2021,513,345,168,205.4,513,345,168,205.4
34380, 태안군,025,20~24세,2021,2628,1784,844,211.4,2501,1697,804,211.1
34380, 태안군,025001, 20세,2021,475,327,148,220.9,467,323,144,224.3
34380, 태안군,025002, 21세,2021,492,333,159,209.4,480,323,157,205.7
34380, 태안군,025003, 22세,2021,517,352,165,213.3,491,332,159,208.8
34380, 태안군,025004, 23세,2021,575,386,189,204.2,535,359,176,204
34380, 태안군,025005, 24세,2021,569,386,183,210.9,528,360,168,214.3
34380, 태안군,030,25~29세,2021,2604,1675,929,180.3,2255,1413,842,167.8
34380, 태안군,030001, 25세,2021,518,344,174,197.7,467,306,161,190.1
34380, 태안군,030002, 26세,2021,563,361,202,178.7,499,312,187,166.8
34380, 태안군,030003, 27세,2021,510,352,158,222.8,425,282,143,197.2
34380, 태안군,030004, 28세,2021,498,298,200,149,431,250,181,138.1
34380, 태안군,030005, 29세,2021,515,320,195,164.1,433,263,170,154.7
34380, 태안군,035,30~34세,2021,2291,1357,934,145.3,1930,1088,842,129.2
34380, 태안군,035001, 30세,2021,458,268,190,141.1,386,214,172,124.4
34380, 태안군,035002, 31세,2021,448,278,170,163.5,373,223,150,148.7
34380, 태안군,035003, 32세,2021,469,276,193,143,390,223,167,133.5
34380, 태안군,035004, 33세,2021,453,266,187,142.2,390,219,171,128.1
34380, 태안군,035005, 34세,2021,463,269,194,138.7,391,209,182,114.8
34380, 태안군,040,35~39세,2021,2789,1584,1205,131.5,2453,1336,1117,119.6
34380, 태안군,040001, 35세,2021,502,305,197,154.8,426,247,179,138
34380, 태안군,040002, 36세,2021,486,274,212,129.2,418,232,186,124.7
34380, 태안군,040003, 37세,2021,533,298,235,126.8,463,247,216,114.4
34380, 태안군,040004, 38세,2021,614,354,260,136.2,540,295,245,120.4
34380, 태안군,040005, 39세,2021,654,353,301,117.3,606,315,291,108.2
34380, 태안군,045,40~44세,2021,3399,1948,1451,134.3,3153,1766,1387,127.3
34380, 태안군,045001, 40세,2021,640,374,266,140.6,585,333,252,132.1
34380, 태안군,045002, 41세,2021,752,420,332,126.5,699,380,319,119.1
34380, 태안군,045003, 42세,2021,646,371,275,134.9,597,334,263,127
34380, 태안군,045004, 43세,2021,699,408,291,140.2,644,366,278,131.7
34380, 태안군,045005, 44세,2021,662,375,287,130.7,628,353,275,128.4
34380, 태안군,050,45~49세,2021,3936,2226,1710,130.2,3748,2098,1650,127.2
34380, 태안군,050001, 45세,2021,694,395,299,132.1,668,375,293,128
34380, 태안군,050002, 46세,2021,751,432,319,135.4,706,397,309,128.5
34380, 태안군,050003, 47세,2021,837,453,384,118,798,426,372,114.5
34380, 태안군,050004, 48세,2021,862,489,373,131.1,824,462,362,127.6
34380, 태안군,050005, 49세,2021,792,457,335,136.4,752,438,314,139.5
34380, 태안군,055,50~54세,2021,4801,2578,2223,116,4675,2511,2164,116
34380, 태안군,055001, 50세,2021,911,519,392,132.4,876,496,380,130.5
34380, 태안군,055002, 51세,2021,932,518,414,125.1,912,509,403,126.3
34380, 태안군,055003, 52세,2021,995,518,477,108.6,972,505,467,108.1
34380, 태안군,055004, 53세,2021,1001,516,485,106.4,975,503,472,106.6
34380, 태안군,055005, 54세,2021,962,507,455,111.4,940,498,442,112.7
34380, 태안군,060,55~59세,2021,5215,2679,2536,105.6,5133,2638,2495,105.7
34380, 태안군,060001, 55세,2021,946,474,472,100.4,927,467,460,101.5
34380, 태안군,060002, 56세,2021,1071,569,502,113.3,1058,564,494,114.2
34380, 태안군,060003, 57세,2021,986,500,486,102.9,969,487,482,101
34380, 태안군,060004, 58세,2021,1070,566,504,112.3,1051,558,493,113.2
34380, 태안군,060005, 59세,2021,1142,570,572,99.7,1128,562,566,99.3
34380, 태안군,065,60~64세,2021,6585,3222,3363,95.8,6538,3199,3339,95.8
34380, 태안군,065001, 60세,2021,1404,694,710,97.7,1393,688,705,97.6
34380, 태안군,065002, 61세,2021,1430,726,704,103.1,1420,723,697,103.7
34380, 태안군,065003, 62세,2021,1254,605,649,93.2,1248,601,647,92.9
34380, 태안군,065004, 63세,2021,1255,624,631,98.9,1248,620,628,98.7
34380, 태안군,065005, 64세,2021,1242,573,669,85.7,1229,567,662,85.6
34380, 태안군,070,65~69세,2021,5594,2667,2927,91.1,5547,2642,2905,90.9
34380, 태안군,070001, 65세,2021,1217,561,656,85.5,1206,557,649,85.8
34380, 태안군,070002, 66세,2021,1224,584,640,91.3,1207,575,632,91
34380, 태안군,070003, 67세,2021,1083,518,565,91.7,1079,516,563,91.7
34380, 태안군,070004, 68세,2021,985,471,514,91.6,977,467,510,91.6
34380, 태안군,070005, 69세,2021,1085,533,552,96.6,1078,527,551,95.6
34380, 태안군,075,70~74세,2021,4724,2353,2371,99.2,4709,2342,2367,98.9
34380, 태안군,075001, 70세,2021,857,423,434,97.5,851,417,434,96.1
34380, 태안군,075002, 71세,2021,992,515,477,108,987,511,476,107.4
34380, 태안군,075003, 72세,2021,1027,522,505,103.4,1023,521,502,103.8
34380, 태안군,075004, 73세,2021,922,427,495,86.3,922,427,495,86.3
34380, 태안군,075005, 74세,2021,926,466,460,101.3,926,466,460,101.3
34380, 태안군,080,75~79세,2021,3768,1699,2069,82.1,3761,1697,2064,82.2
34380, 태안군,080001, 75세,2021,674,357,317,112.6,672,357,315,113.3
34380, 태안군,080002, 76세,2021,673,315,358,88,671,315,356,88.5
34380, 태안군,080003, 77세,2021,763,351,412,85.2,761,350,411,85.2
34380, 태안군,080004, 78세,2021,745,296,449,65.9,744,295,449,65.7
34380, 태안군,080005, 79세,2021,913,380,533,71.3,913,380,533,71.3
34380, 태안군,085,80~84세,2021,2704,1046,1658,63.1,2699,1044,1655,63.1
34380, 태안군,085001, 80세,2021,611,236,375,62.9,610,235,375,62.7
34380, 태안군,085002, 81세,2021,545,210,335,62.7,545,210,335,62.7
34380, 태안군,085003, 82세,2021,603,227,376,60.4,601,227,374,60.7
34380, 태안군,085004, 83세,2021,504,199,305,65.2,503,199,304,65.5
34380, 태안군,085005, 84세,2021,441,174,267,65.2,440,173,267,64.8
34380, 태안군,090,85~89세,2021,1692,514,1178,43.6,1691,514,1177,43.7
34380, 태안군,090001, 85세,2021,442,142,300,47.3,442,142,300,47.3
34380, 태안군,090002, 86세,2021,409,123,286,43,409,123,286,43
34380, 태안군,090003, 87세,2021,304,88,216,40.7,304,88,216,40.7
34380, 태안군,090004, 88세,2021,290,85,205,41.5,290,85,205,41.5
34380, 태안군,090005, 89세,2021,247,76,171,44.4,246,76,170,44.7
34380, 태안군,095,90~94세,2021,506,122,384,31.8,505,122,383,31.9
34380, 태안군,095001, 90세,2021,150,45,105,42.9,150,45,105,42.9
34380, 태안군,095002, 91세,2021,112,25,87,28.7,111,25,86,29.1
34380, 태안군,095003, 92세,2021,101,14,87,16.1,101,14,87,16.1
34380, 태안군,095004, 93세,2021,92,25,67,37.3,92,25,67,37.3
34380, 태안군,095005, 94세,2021,51,13,38,34.2,51,13,38,34.2
34380, 태안군,100,95~99세,2021,117,17,100,17,117,17,100,17
34380, 태안군,100001, 95세,2021,39,5,34,14.7,39,5,34,14.7
34380, 태안군,100002, 96세,2021,36,X,32,12.5,36,X,32,12.5
34380, 태안군,100003, 97세,2021,19,X,17,11.8,19,X,17,11.8
34380, 태안군,100004, 98세,2021,14,X,10,40,14,X,10,40
34380, 태안군,100005, 99세,2021,9,X,7,28.6,9,X,7,28.6
34380, 태안군,101,100세이상,2021,10,X,6,66.7,10,X,6,66.7
34380, 태안군,102,15세미만,2021,4804,2456,2348,104.6,4787,2447,2340,104.6
34380, 태안군,103,15~64세,2021,36366,20164,16202,124.5,34497,18852,15645,120.5
34380, 태안군,104,65세이상,2021,19115,8422,10693,78.8,19039,8382,10657,78.7
34380, 태안군,086,85세이상,2021,2325,657,1668,39.4,2323,657,1666,39.4
34380, 태안군,126,평균연령,2021,51.8,49.5,54.3,,52.3,50,54.6,
34380, 태안군,127,중위연령,2021,55.8,52.7,59,,56.6,53.8,59.4,
35,전라북도,000,합계,2021,1787053,891295,895758,99.5,1746006,869614,876392,99.2
35,전라북도,005,0~4세,2021,47000,23980,23020,104.2,46614,23772,22842,104.1
35,전라북도,005001, 0세,2021,7737,3947,3790,104.1,7666,3910,3756,104.1
35,전라북도,005002, 1세,2021,8301,4233,4068,104.1,8232,4205,4027,104.4
35,전라북도,005003, 2세,2021,9215,4681,4534,103.2,9127,4631,4496,103
35,전라북도,005004, 3세,2021,10306,5263,5043,104.4,10234,5222,5012,104.2
35,전라북도,005005, 4세,2021,11441,5856,5585,104.9,11355,5804,5551,104.6
35,전라북도,010,5~9세,2021,73014,37641,35373,106.4,72722,37472,35250,106.3
35,전라북도,010001, 5세,2021,13172,6794,6378,106.5,13092,6750,6342,106.4
35,전라북도,010002, 6세,2021,14246,7319,6927,105.7,14191,7283,6908,105.4
35,전라북도,010003, 7세,2021,14332,7393,6939,106.5,14268,7356,6912,106.4
35,전라북도,010004, 8세,2021,14942,7771,7171,108.4,14892,7744,7148,108.3
35,전라북도,010005, 9세,2021,16322,8364,7958,105.1,16279,8339,7940,105
35,전라북도,015,10~14세,2021,81088,41788,39300,106.3,80909,41694,39215,106.3
35,전라북도,015001, 10세,2021,16564,8453,8111,104.2,16521,8431,8090,104.2
35,전라북도,015002, 11세,2021,15920,8212,7708,106.5,15881,8193,7688,106.6
35,전라북도,015003, 12세,2021,15409,7934,7475,106.1,15373,7912,7461,106
35,전라북도,015004, 13세,2021,16244,8441,7803,108.2,16209,8423,7786,108.2
35,전라북도,015005, 14세,2021,16951,8748,8203,106.6,16925,8735,8190,106.7
35,전라북도,020,15~19세,2021,87145,46109,41036,112.4,86407,45715,40692,112.3
35,전라북도,020001, 15세,2021,15578,8084,7494,107.9,15552,8075,7477,108
35,전라북도,020002, 16세,2021,16107,8479,7628,111.2,16085,8465,7620,111.1
35,전라북도,020003, 17세,2021,17603,9200,8403,109.5,17549,9170,8379,109.4
35,전라북도,020004, 18세,2021,18303,9605,8698,110.4,18161,9522,8639,110.2
35,전라북도,020005, 19세,2021,19554,10741,8813,121.9,19060,10483,8577,122.2
35,전라북도,025,20~24세,2021,118283,65327,52956,123.4,110932,61234,49698,123.2
35,전라북도,025001, 20세,2021,22317,11939,10378,115,21456,11511,9945,115.7
35,전라북도,025002, 21세,2021,24867,13398,11469,116.8,23466,12632,10834,116.6
35,전라북도,025003, 22세,2021,23635,12982,10653,121.9,22067,12136,9931,122.2
35,전라북도,025004, 23세,2021,24011,13647,10364,131.7,22217,12617,9600,131.4
35,전라북도,025005, 24세,2021,23453,13361,10092,132.4,21726,12338,9388,131.4
35,전라북도,030,25~29세,2021,106105,58432,47673,122.6,98188,53878,44310,121.6
35,전라북도,030001, 25세,2021,22871,12963,9908,130.8,21158,11958,9200,130
35,전라북도,030002, 26세,2021,21803,12139,9664,125.6,20156,11185,8971,124.7
35,전라북도,030003, 27세,2021,21350,11748,9602,122.3,19748,10839,8909,121.7
35,전라북도,030004, 28세,2021,20253,10986,9267,118.5,18742,10131,8611,117.7
35,전라북도,030005, 29세,2021,19828,10596,9232,114.8,18384,9765,8619,113.3
35,전라북도,035,30~34세,2021,87868,46480,41388,112.3,80983,42590,38393,110.9
35,전라북도,035001, 30세,2021,18674,9995,8679,115.2,17198,9167,8031,114.1
35,전라북도,035002, 31세,2021,17858,9583,8275,115.8,16425,8765,7660,114.4
35,전라북도,035003, 32세,2021,17149,9152,7997,114.4,15782,8363,7419,112.7
35,전라북도,035004, 33세,2021,17015,8834,8181,108,15663,8097,7566,107
35,전라북도,035005, 34세,2021,17172,8916,8256,108,15915,8198,7717,106.2
35,전라북도,040,35~39세,2021,101130,51697,49433,104.6,96120,49013,47107,104
35,전라북도,040001, 35세,2021,17821,9176,8645,106.1,16690,8543,8147,104.9
35,전라북도,040002, 36세,2021,18163,9224,8939,103.2,17093,8647,8446,102.4
35,전라북도,040003, 37세,2021,19688,10083,9605,105,18650,9528,9122,104.5
35,전라북도,040004, 38세,2021,21671,11114,10557,105.3,20729,10635,10094,105.4
35,전라북도,040005, 39세,2021,23787,12100,11687,103.5,22958,11660,11298,103.2
35,전라북도,045,40~44세,2021,119858,61185,58673,104.3,116363,59426,56937,104.4
35,전라북도,045001, 40세,2021,23414,12052,11362,106.1,22641,11643,10998,105.9
35,전라북도,045002, 41세,2021,25052,12705,12347,102.9,24284,12312,11972,102.8
35,전라북도,045003, 42세,2021,24188,12442,11746,105.9,23401,12026,11375,105.7
35,전라북도,045004, 43세,2021,23081,11739,11342,103.5,22450,11434,11016,103.8
35,전라북도,045005, 44세,2021,24123,12247,11876,103.1,23587,12011,11576,103.8
35,전라북도,050,45~49세,2021,136383,69943,66440,105.3,133848,68767,65081,105.7
35,전라북도,050001, 45세,2021,24070,12373,11697,105.8,23531,12093,11438,105.7
35,전라북도,050002, 46세,2021,25260,12866,12394,103.8,24763,12637,12126,104.2
35,전라북도,050003, 47세,2021,29307,15052,14255,105.6,28845,14854,13991,106.2
35,전라북도,050004, 48세,2021,29121,14742,14379,102.5,28602,14511,14091,103
35,전라북도,050005, 49세,2021,28625,14910,13715,108.7,28107,14672,13435,109.2
35,전라북도,055,50~54세,2021,150432,77417,73015,106,148238,76461,71777,106.5
35,전라북도,055001, 50세,2021,31297,16328,14969,109.1,30844,16120,14724,109.5
35,전라북도,055002, 51세,2021,29721,15364,14357,107,29225,15142,14083,107.5
35,전라북도,055003, 52세,2021,30301,15541,14760,105.3,29854,15345,14509,105.8
35,전라북도,055004, 53세,2021,30801,15795,15006,105.3,30347,15602,14745,105.8
35,전라북도,055005, 54세,2021,28312,14389,13923,103.3,27968,14252,13716,103.9
35,전라북도,060,55~59세,2021,141576,72797,68779,105.8,139749,72019,67730,106.3
35,전라북도,060001, 55세,2021,28787,14957,13830,108.1,28387,14785,13602,108.7
35,전라북도,060002, 56세,2021,28839,14732,14107,104.4,28441,14577,13864,105.1
35,전라북도,060003, 57세,2021,26250,13497,12753,105.8,25907,13342,12565,106.2
35,전라북도,060004, 58세,2021,28386,14594,13792,105.8,28018,14430,13588,106.2
35,전라북도,060005, 59세,2021,29314,15017,14297,105,28996,14885,14111,105.5
35,전라북도,065,60~64세,2021,148521,73674,74847,98.4,147379,73207,74172,98.7
35,전라북도,065001, 60세,2021,32307,16060,16247,98.8,32085,15979,16106,99.2
35,전라북도,065002, 61세,2021,33852,16668,17184,97,33569,16554,17015,97.3
35,전라북도,065003, 62세,2021,28912,14217,14695,96.7,28698,14128,14570,97
35,전라북도,065004, 63세,2021,26163,12966,13197,98.2,25936,12868,13068,98.5
35,전라북도,065005, 64세,2021,27287,13763,13524,101.8,27091,13678,13413,102
35,전라북도,070,65~69세,2021,112693,54915,57778,95,112133,54649,57484,95.1
35,전라북도,070001, 65세,2021,24604,12196,12408,98.3,24444,12122,12322,98.4
35,전라북도,070002, 66세,2021,26404,12921,13483,95.8,26277,12858,13419,95.8
35,전라북도,070003, 67세,2021,22578,10964,11614,94.4,22474,10915,11559,94.4
35,전라북도,070004, 68세,2021,18422,8865,9557,92.8,18321,8823,9498,92.9
35,전라북도,070005, 69세,2021,20685,9969,10716,93,20617,9931,10686,92.9
35,전라북도,075,70~74세,2021,93950,43946,50004,87.9,93655,43834,49821,88
35,전라북도,075001, 70세,2021,17983,8639,9344,92.5,17908,8607,9301,92.5
35,전라북도,075002, 71세,2021,20368,9625,10743,89.6,20300,9597,10703,89.7
35,전라북도,075003, 72세,2021,18349,8399,9950,84.4,18295,8387,9908,84.6
35,전라북도,075004, 73세,2021,17822,8261,9561,86.4,17772,8238,9534,86.4
35,전라북도,075005, 74세,2021,19428,9022,10406,86.7,19380,9005,10375,86.8
35,전라북도,080,75~79세,2021,74278,31124,43154,72.1,74159,31074,43085,72.1
35,전라북도,080001, 75세,2021,14496,6695,7801,85.8,14464,6682,7782,85.9
35,전라북도,080002, 76세,2021,13002,5603,7399,75.7,12965,5581,7384,75.6
35,전라북도,080003, 77세,2021,13186,5561,7625,72.9,13162,5556,7606,73
35,전라북도,080004, 78세,2021,13990,5650,8340,67.7,13975,5645,8330,67.8
35,전라북도,080005, 79세,2021,19604,7615,11989,63.5,19593,7610,11983,63.5
35,전라북도,085,80~84세,2021,58681,21334,37347,57.1,58602,21317,37285,57.2
35,전라북도,085001, 80세,2021,13262,5135,8127,63.2,13247,5130,8117,63.2
35,전라북도,085002, 81세,2021,11958,4408,7550,58.4,11938,4405,7533,58.5
35,전라북도,085003, 82세,2021,12458,4604,7854,58.6,12438,4600,7838,58.7
35,전라북도,085004, 83세,2021,11089,3822,7267,52.6,11077,3820,7257,52.6
35,전라북도,085005, 84세,2021,9914,3365,6549,51.4,9902,3362,6540,51.4
35,전라북도,090,85~89세,2021,34528,10354,24174,42.8,34499,10344,24155,42.8
35,전라북도,090001, 85세,2021,8922,2879,6043,47.6,8913,2876,6037,47.6
35,전라북도,090002, 86세,2021,8393,2651,5742,46.2,8385,2649,5736,46.2
35,전라북도,090003, 87세,2021,6978,2088,4890,42.7,6973,2087,4886,42.7
35,전라북도,090004, 88세,2021,5674,1564,4110,38.1,5670,1561,4109,38
35,전라북도,090005, 89세,2021,4561,1172,3389,34.6,4558,1171,3387,34.6
35,전라북도,095,90~94세,2021,11949,2706,9243,29.3,11938,2703,9235,29.3
35,전라북도,095001, 90세,2021,3514,874,2640,33.1,3510,871,2639,33
35,전라북도,095002, 91세,2021,2983,642,2341,27.4,2981,642,2339,27.4
35,전라북도,095003, 92세,2021,2253,541,1712,31.6,2249,541,1708,31.7
35,전라북도,095004, 93세,2021,1838,382,1456,26.2,1837,382,1455,26.3
35,전라북도,095005, 94세,2021,1361,267,1094,24.4,1361,267,1094,24.4
35,전라북도,100,95~99세,2021,2214,400,1814,22.1,2212,399,1813,22
35,전라북도,100001, 95세,2021,736,142,594,23.9,736,142,594,23.9
35,전라북도,100002, 96세,2021,528,99,429,23.1,526,98,428,22.9
35,전라북도,100003, 97세,2021,333,60,273,22,333,60,273,22
35,전라북도,100004, 98세,2021,362,56,306,18.3,362,56,306,18.3
35,전라북도,100005, 99세,2021,255,43,212,20.3,255,43,212,20.3
35,전라북도,101,100세이상,2021,357,46,311,14.8,356,46,310,14.8
35,전라북도,102,15세미만,2021,201102,103409,97693,105.9,200245,102938,97307,105.8
35,전라북도,103,15~64세,2021,1197301,623061,574240,108.5,1158207,602310,555897,108.3
35,전라북도,104,65세이상,2021,388650,164825,223825,73.6,387554,164366,223188,73.6
35,전라북도,086,85세이상,2021,49048,13506,35542,38,49005,13492,35513,38
35,전라북도,126,평균연령,2021,45.7,44,47.4,,46,44.3,47.7,
35,전라북도,127,중위연령,2021,47.8,46,49.5,,48.2,46.6,49.9,
35004, 읍부,000,합계,2021,155086,78039,77047,101.3,149947,75311,74636,100.9
35004, 읍부,005,0~4세,2021,4420,2270,2150,105.6,4372,2241,2131,105.2
35004, 읍부,005001, 0세,2021,732,377,355,106.2,720,369,351,105.1
35004, 읍부,005002, 1세,2021,852,440,412,106.8,841,435,406,107.1
35004, 읍부,005003, 2세,2021,883,451,432,104.4,878,449,429,104.7
35004, 읍부,005004, 3세,2021,894,455,439,103.6,887,451,436,103.4
35004, 읍부,005005, 4세,2021,1059,547,512,106.8,1046,537,509,105.5
35004, 읍부,010,5~9세,2021,6629,3450,3179,108.5,6610,3434,3176,108.1
35004, 읍부,010001, 5세,2021,1191,629,562,111.9,1187,626,561,111.6
35004, 읍부,010002, 6세,2021,1235,638,597,106.9,1230,633,597,106
35004, 읍부,010003, 7세,2021,1300,680,620,109.7,1295,676,619,109.2
35004, 읍부,010004, 8세,2021,1420,737,683,107.9,1420,737,683,107.9
35004, 읍부,010005, 9세,2021,1483,766,717,106.8,1478,762,716,106.4
35004, 읍부,015,10~14세,2021,7696,4000,3696,108.2,7683,3991,3692,108.1
35004, 읍부,015001, 10세,2021,1579,822,757,108.6,1576,819,757,108.2
35004, 읍부,015002, 11세,2021,1533,838,695,120.6,1531,837,694,120.6
35004, 읍부,015003, 12세,2021,1501,736,765,96.2,1499,735,764,96.2
35004, 읍부,015004, 13세,2021,1524,799,725,110.2,1521,796,725,109.8
35004, 읍부,015005, 14세,2021,1559,805,754,106.8,1556,804,752,106.9
35004, 읍부,020,15~19세,2021,8009,4273,3736,114.4,7904,4209,3695,113.9
35004, 읍부,020001, 15세,2021,1405,710,695,102.2,1404,710,694,102.3
35004, 읍부,020002, 16세,2021,1489,782,707,110.6,1486,779,707,110.2
35004, 읍부,020003, 17세,2021,1647,917,730,125.6,1644,916,728,125.8
35004, 읍부,020004, 18세,2021,1651,850,801,106.1,1625,835,790,105.7
35004, 읍부,020005, 19세,2021,1817,1014,803,126.3,1745,969,776,124.9
35004, 읍부,025,20~24세,2021,9305,5518,3787,145.7,8341,4900,3441,142.4
35004, 읍부,025001, 20세,2021,2030,1168,862,135.5,1937,1106,831,133.1
35004, 읍부,025002, 21세,2021,2051,1200,851,141,1822,1051,771,136.3
35004, 읍부,025003, 22세,2021,1798,1086,712,152.5,1586,945,641,147.4
35004, 읍부,025004, 23세,2021,1751,1057,694,152.3,1544,933,611,152.7
35004, 읍부,025005, 24세,2021,1675,1007,668,150.7,1452,865,587,147.4
35004, 읍부,030,25~29세,2021,7764,4333,3431,126.3,6822,3823,2999,127.5
35004, 읍부,030001, 25세,2021,1643,961,682,140.9,1424,824,600,137.3
35004, 읍부,030002, 26세,2021,1568,911,657,138.7,1370,801,569,140.8
35004, 읍부,030003, 27세,2021,1566,879,687,127.9,1370,772,598,129.1
35004, 읍부,030004, 28세,2021,1546,844,702,120.2,1363,753,610,123.4
35004, 읍부,030005, 29세,2021,1441,738,703,105,1295,673,622,108.2
35004, 읍부,035,30~34세,2021,6848,3626,3222,112.5,6005,3182,2823,112.7
35004, 읍부,035001, 30세,2021,1420,772,648,119.1,1246,675,571,118.2
35004, 읍부,035002, 31세,2021,1345,746,599,124.5,1157,641,516,124.2
35004, 읍부,035003, 32세,2021,1317,699,618,113.1,1158,612,546,112.1
35004, 읍부,035004, 33세,2021,1359,699,660,105.9,1197,622,575,108.2
35004, 읍부,035005, 34세,2021,1407,710,697,101.9,1247,632,615,102.8
35004, 읍부,040,35~39세,2021,8395,4168,4227,98.6,7767,3848,3919,98.2
35004, 읍부,040001, 35세,2021,1411,699,712,98.2,1277,616,661,93.2
35004, 읍부,040002, 36세,2021,1552,757,795,95.2,1425,693,732,94.7
35004, 읍부,040003, 37세,2021,1633,807,826,97.7,1498,744,754,98.7
35004, 읍부,040004, 38세,2021,1808,914,894,102.2,1692,868,824,105.3
35004, 읍부,040005, 39세,2021,1991,991,1000,99.1,1875,927,948,97.8
35004, 읍부,045,40~44세,2021,10450,5371,5079,105.7,10010,5161,4849,106.4
35004, 읍부,045001, 40세,2021,2021,1011,1010,100.1,1923,961,962,99.9
35004, 읍부,045002, 41세,2021,2179,1073,1106,97,2087,1028,1059,97.1
35004, 읍부,045003, 42세,2021,2168,1138,1030,110.5,2062,1086,976,111.3
35004, 읍부,045004, 43세,2021,1971,1011,960,105.3,1890,972,918,105.9
35004, 읍부,045005, 44세,2021,2111,1138,973,117,2048,1114,934,119.3
35004, 읍부,050,45~49세,2021,11446,6160,5286,116.5,11121,6024,5097,118.2
35004, 읍부,050001, 45세,2021,2101,1167,934,124.9,2043,1144,899,127.3
35004, 읍부,050002, 46세,2021,2139,1159,980,118.3,2078,1133,945,119.9
35004, 읍부,050003, 47세,2021,2488,1328,1160,114.5,2421,1301,1120,116.2
35004, 읍부,050004, 48세,2021,2455,1295,1160,111.6,2386,1260,1126,111.9
35004, 읍부,050005, 49세,2021,2263,1211,1052,115.1,2193,1186,1007,117.8
35004, 읍부,055,50~54세,2021,12390,6727,5663,118.8,12135,6608,5527,119.6
35004, 읍부,055001, 50세,2021,2651,1464,1187,123.3,2600,1438,1162,123.8
35004, 읍부,055002, 51세,2021,2390,1261,1129,111.7,2340,1237,1103,112.1
35004, 읍부,055003, 52세,2021,2458,1347,1111,121.2,2396,1319,1077,122.5
35004, 읍부,055004, 53세,2021,2590,1433,1157,123.9,2538,1411,1127,125.2
35004, 읍부,055005, 54세,2021,2301,1222,1079,113.3,2261,1203,1058,113.7
35004, 읍부,060,55~59세,2021,11624,6229,5395,115.5,11382,6118,5264,116.2
35004, 읍부,060001, 55세,2021,2353,1295,1058,122.4,2299,1272,1027,123.9
35004, 읍부,060002, 56세,2021,2357,1305,1052,124,2303,1281,1022,125.3
35004, 읍부,060003, 57세,2021,2160,1153,1007,114.5,2119,1130,989,114.3
35004, 읍부,060004, 58세,2021,2285,1178,1107,106.4,2236,1159,1077,107.6
35004, 읍부,060005, 59세,2021,2469,1298,1171,110.8,2425,1276,1149,111.1
35004, 읍부,065,60~64세,2021,12789,6422,6367,100.9,12607,6338,6269,101.1
35004, 읍부,065001, 60세,2021,2752,1357,1395,97.3,2712,1342,1370,98
35004, 읍부,065002, 61세,2021,2899,1445,1454,99.4,2858,1425,1433,99.4
35004, 읍부,065003, 62세,2021,2486,1255,1231,101.9,2449,1235,1214,101.7
35004, 읍부,065004, 63세,2021,2239,1128,1111,101.5,2204,1110,1094,101.5
35004, 읍부,065005, 64세,2021,2413,1237,1176,105.2,2384,1226,1158,105.9
35004, 읍부,070,65~69세,2021,10182,4992,5190,96.2,10118,4959,5159,96.1
35004, 읍부,070001, 65세,2021,2213,1086,1127,96.4,2194,1078,1116,96.6
35004, 읍부,070002, 66세,2021,2401,1183,1218,97.1,2386,1174,1212,96.9
35004, 읍부,070003, 67세,2021,2016,978,1038,94.2,2007,972,1035,93.9
35004, 읍부,070004, 68세,2021,1676,844,832,101.4,1663,839,824,101.8
35004, 읍부,070005, 69세,2021,1876,901,975,92.4,1868,896,972,92.2
35004, 읍부,075,70~74세,2021,8621,4005,4616,86.8,8587,3993,4594,86.9
35004, 읍부,075001, 70세,2021,1593,747,846,88.3,1582,742,840,88.3
35004, 읍부,075002, 71세,2021,1853,876,977,89.7,1849,876,973,90
35004, 읍부,075003, 72세,2021,1688,768,920,83.5,1681,766,915,83.7
35004, 읍부,075004, 73세,2021,1665,772,893,86.5,1659,768,891,86.2
35004, 읍부,075005, 74세,2021,1822,842,980,85.9,1816,841,975,86.3
35004, 읍부,080,75~79세,2021,6992,2877,4115,69.9,6971,2867,4104,69.9
35004, 읍부,080001, 75세,2021,1340,610,730,83.6,1333,608,725,83.9
35004, 읍부,080002, 76세,2021,1248,519,729,71.2,1241,513,728,70.5
35004, 읍부,080003, 77세,2021,1246,539,707,76.2,1242,538,704,76.4
35004, 읍부,080004, 78세,2021,1286,502,784,64,1283,501,782,64.1
35004, 읍부,080005, 79세,2021,1872,707,1165,60.7,1872,707,1165,60.7
35004, 읍부,085,80~84세,2021,6034,2158,3876,55.7,6024,2156,3868,55.7
35004, 읍부,085001, 80세,2021,1326,503,823,61.1,1324,502,822,61.1
35004, 읍부,085002, 81세,2021,1225,443,782,56.6,1223,443,780,56.8
35004, 읍부,085003, 82세,2021,1311,460,851,54.1,1307,460,847,54.3
35004, 읍부,085004, 83세,2021,1186,428,758,56.5,1184,427,757,56.4
35004, 읍부,085005, 84세,2021,986,324,662,48.9,986,324,662,48.9
35004, 읍부,090,85~89세,2021,3866,1129,2737,41.2,3862,1128,2734,41.3
35004, 읍부,090001, 85세,2021,992,311,681,45.7,989,310,679,45.7
35004, 읍부,090002, 86세,2021,935,285,650,43.8,934,285,649,43.9
35004, 읍부,090003, 87세,2021,811,216,595,36.3,811,216,595,36.3
35004, 읍부,090004, 88세,2021,623,186,437,42.6,623,186,437,42.6
35004, 읍부,090005, 89세,2021,505,131,374,35,505,131,374,35
35004, 읍부,095,90~94세,2021,1303,280,1023,27.4,1303,280,1023,27.4
35004, 읍부,095001, 90세,2021,371,83,288,28.8,371,83,288,28.8
35004, 읍부,095002, 91세,2021,341,66,275,24,341,66,275,24
35004, 읍부,095003, 92세,2021,239,58,181,32,239,58,181,32
35004, 읍부,095004, 93세,2021,192,41,151,27.2,192,41,151,27.2
35004, 읍부,095005, 94세,2021,160,32,128,25,160,32,128,25
35004, 읍부,100,95~99세,2021,271,41,230,17.8,271,41,230,17.8
35004, 읍부,100001, 95세,2021,94,14,80,17.5,94,14,80,17.5
35004, 읍부,100002, 96세,2021,72,11,61,18,72,11,61,18
35004, 읍부,100003, 97세,2021,31,8,23,34.8,31,8,23,34.8
35004, 읍부,100004, 98세,2021,40,X,36,11.1,40,X,36,11.1
35004, 읍부,100005, 99세,2021,34,X,30,13.3,34,X,30,13.3
35004, 읍부,101,100세이상,2021,52,10,42,23.8,52,10,42,23.8
35004, 읍부,102,15세미만,2021,18745,9720,9025,107.7,18665,9666,8999,107.4
35004, 읍부,103,15~64세,2021,99020,52827,46193,114.4,94094,50211,43883,114.4
35004, 읍부,104,65세이상,2021,37321,15492,21829,71,37188,15434,21754,70.9
35004, 읍부,086,85세이상,2021,5492,1460,4032,36.2,5488,1459,4029,36.2
35004, 읍부,126,평균연령,2021,46.5,44.4,48.5,,46.8,44.8,48.9,
35004, 읍부,127,중위연령,2021,48.5,46.7,50.6,,49.2,47.5,51.3,
35005, 면부,000,합계,2021,346174,173046,173128,100,336432,167332,169100,99
35005, 면부,005,0~4세,2021,5136,2587,2549,101.5,5122,2580,2542,101.5
35005, 면부,005001, 0세,2021,921,469,452,103.8,919,468,451,103.8
35005, 면부,005002, 1세,2021,989,501,488,102.7,985,499,486,102.7
35005, 면부,005003, 2세,2021,1018,495,523,94.6,1014,492,522,94.3
35005, 면부,005004, 3세,2021,1056,548,508,107.9,1054,548,506,108.3
35005, 면부,005005, 4세,2021,1152,574,578,99.3,1150,573,577,99.3
35005, 면부,010,5~9세,2021,7411,3825,3586,106.7,7393,3816,3577,106.7
35005, 면부,010001, 5세,2021,1303,644,659,97.7,1299,641,658,97.4
35005, 면부,010002, 6세,2021,1394,728,666,109.3,1391,725,666,108.9
35005, 면부,010003, 7세,2021,1485,751,734,102.3,1482,750,732,102.5
35005, 면부,010004, 8세,2021,1513,791,722,109.6,1509,790,719,109.9
35005, 면부,010005, 9세,2021,1716,911,805,113.2,1712,910,802,113.5
35005, 면부,015,10~14세,2021,8542,4531,4011,113,8518,4521,3997,113.1
35005, 면부,015001, 10세,2021,1766,952,814,117,1765,952,813,117.1
35005, 면부,015002, 11세,2021,1683,858,825,104,1677,856,821,104.3
35005, 면부,015003, 12세,2021,1581,836,745,112.2,1576,833,743,112.1
35005, 면부,015004, 13세,2021,1717,915,802,114.1,1711,913,798,114.4
35005, 면부,015005, 14세,2021,1795,970,825,117.6,1789,967,822,117.6
35005, 면부,020,15~19세,2021,9217,5181,4036,128.4,9188,5166,4022,128.4
35005, 면부,020001, 15세,2021,1709,930,779,119.4,1706,930,776,119.8
35005, 면부,020002, 16세,2021,1937,1048,889,117.9,1933,1045,888,117.7
35005, 면부,020003, 17세,2021,2029,1137,892,127.5,2021,1132,889,127.3
35005, 면부,020004, 18세,2021,1893,1079,814,132.6,1884,1073,811,132.3
35005, 면부,020005, 19세,2021,1649,987,662,149.1,1644,986,658,149.8
35005, 면부,025,20~24세,2021,12133,7224,4909,147.2,11246,6695,4551,147.1
35005, 면부,025001, 20세,2021,2092,1249,843,148.2,2070,1243,827,150.3
35005, 면부,025002, 21세,2021,2542,1466,1076,136.2,2472,1428,1044,136.8
35005, 면부,025003, 22세,2021,2391,1432,959,149.3,2249,1362,887,153.6
35005, 면부,025004, 23세,2021,2528,1496,1032,145,2211,1284,927,138.5
35005, 면부,025005, 24세,2021,2580,1581,999,158.3,2244,1378,866,159.1
35005, 면부,030,25~29세,2021,12983,7879,5104,154.4,10679,6350,4329,146.7
35005, 면부,030001, 25세,2021,2584,1537,1047,146.8,2164,1274,890,143.1
35005, 면부,030002, 26세,2021,2738,1703,1035,164.5,2281,1386,895,154.9
35005, 면부,030003, 27세,2021,2645,1629,1016,160.3,2157,1318,839,157.1
35005, 면부,030004, 28세,2021,2497,1499,998,150.2,2040,1201,839,143.1
35005, 면부,030005, 29세,2021,2519,1511,1008,149.9,2037,1171,866,135.2
35005, 면부,035,30~34세,2021,11558,6742,4816,140,9434,5322,4112,129.4
35005, 면부,035001, 30세,2021,2345,1376,969,142,1901,1082,819,132.1
35005, 면부,035002, 31세,2021,2372,1396,976,143,1929,1099,830,132.4
35005, 면부,035003, 32세,2021,2294,1341,953,140.7,1860,1038,822,126.3
35005, 면부,035004, 33세,2021,2303,1338,965,138.7,1867,1052,815,129.1
35005, 면부,035005, 34세,2021,2244,1291,953,135.5,1877,1051,826,127.2
35005, 면부,040,35~39세,2021,12279,6947,5332,130.3,10804,6045,4759,127
35005, 면부,040001, 35세,2021,2257,1261,996,126.6,1917,1042,875,119.1
35005, 면부,040002, 36세,2021,2270,1268,1002,126.5,1931,1054,877,120.2
35005, 면부,040003, 37세,2021,2380,1341,1039,129.1,2093,1176,917,128.2
35005, 면부,040004, 38세,2021,2579,1494,1085,137.7,2316,1335,981,136.1
35005, 면부,040005, 39세,2021,2793,1583,1210,130.8,2547,1438,1109,129.7
35005, 면부,045,40~44세,2021,14303,8405,5898,142.5,13377,7893,5484,143.9
35005, 면부,045001, 40세,2021,2741,1588,1153,137.7,2548,1476,1072,137.7
35005, 면부,045002, 41세,2021,2909,1669,1240,134.6,2684,1546,1138,135.9
35005, 면부,045003, 42세,2021,2925,1730,1195,144.8,2716,1618,1098,147.4
35005, 면부,045004, 43세,2021,2778,1676,1102,152.1,2629,1594,1035,154
35005, 면부,045005, 44세,2021,2950,1742,1208,144.2,2800,1659,1141,145.4
35005, 면부,050,45~49세,2021,18810,11120,7690,144.6,18210,10843,7367,147.2
35005, 면부,050001, 45세,2021,3053,1825,1228,148.6,2915,1746,1169,149.4
35005, 면부,050002, 46세,2021,3347,1990,1357,146.6,3237,1940,1297,149.6
35005, 면부,050003, 47세,2021,4016,2417,1599,151.2,3912,2371,1541,153.9
35005, 면부,050004, 48세,2021,4178,2419,1759,137.5,4065,2371,1694,140
35005, 면부,050005, 49세,2021,4216,2469,1747,141.3,4081,2415,1666,145
35005, 면부,055,50~54세,2021,25919,14454,11465,126.1,25420,14263,11157,127.8
35005, 면부,055001, 50세,2021,4738,2746,1992,137.9,4628,2703,1925,140.4
35005, 면부,055002, 51세,2021,4708,2658,2050,129.7,4609,2620,1989,131.7
35005, 면부,055003, 52세,2021,5292,2924,2368,123.5,5189,2886,2303,125.3
35005, 면부,055004, 53세,2021,5668,3119,2549,122.4,5554,3072,2482,123.8
35005, 면부,055005, 54세,2021,5513,3007,2506,120,5440,2982,2458,121.3
35005, 면부,060,55~59세,2021,31624,16956,14668,115.6,31216,16804,14412,116.6
35005, 면부,060001, 55세,2021,5932,3231,2701,119.6,5852,3200,2652,120.7
35005, 면부,060002, 56세,2021,6240,3376,2864,117.9,6142,3343,2799,119.4
35005, 면부,060003, 57세,2021,5786,3083,2703,114.1,5707,3055,2652,115.2
35005, 면부,060004, 58세,2021,6452,3447,3005,114.7,6365,3406,2959,115.1
35005, 면부,060005, 59세,2021,7214,3819,3395,112.5,7150,3800,3350,113.4
35005, 면부,065,60~64세,2021,40050,20550,19500,105.4,39847,20483,19364,105.8
35005, 면부,065001, 60세,2021,8362,4318,4044,106.8,8320,4305,4015,107.2
35005, 면부,065002, 61세,2021,8983,4576,4407,103.8,8934,4557,4377,104.1
35005, 면부,065003, 62세,2021,7747,3939,3808,103.4,7705,3930,3775,104.1
35005, 면부,065004, 63세,2021,7238,3688,3550,103.9,7206,3673,3533,104
35005, 면부,065005, 64세,2021,7720,4029,3691,109.2,7682,4018,3664,109.7
35005, 면부,070,65~69세,2021,33669,16807,16862,99.7,33554,16756,16798,99.7
35005, 면부,070001, 65세,2021,7158,3682,3476,105.9,7128,3670,3458,106.1
35005, 면부,070002, 66세,2021,7686,3872,3814,101.5,7662,3860,3802,101.5
35005, 면부,070003, 67세,2021,6912,3441,3471,99.1,6887,3431,3456,99.3
35005, 면부,070004, 68세,2021,5478,2715,2763,98.3,5460,2707,2753,98.3
35005, 면부,070005, 69세,2021,6435,3097,3338,92.8,6417,3088,3329,92.8
35005, 면부,075,70~74세,2021,30781,14564,16217,89.8,30713,14538,16175,89.9
35005, 면부,075001, 70세,2021,5751,2772,2979,93.1,5734,2767,2967,93.3
35005, 면부,075002, 71세,2021,6485,3122,3363,92.8,6469,3114,3355,92.8
35005, 면부,075003, 72세,2021,5966,2763,3203,86.3,5955,2760,3195,86.4
35005, 면부,075004, 73세,2021,6007,2866,3141,91.2,5994,2859,3135,91.2
35005, 면부,075005, 74세,2021,6572,3041,3531,86.1,6561,3038,3523,86.2
35005, 면부,080,75~79세,2021,27570,11202,16368,68.4,27544,11192,16352,68.4
35005, 면부,080001, 75세,2021,4929,2266,2663,85.1,4921,2263,2658,85.1
35005, 면부,080002, 76세,2021,4589,1974,2615,75.5,4582,1970,2612,75.4
35005, 면부,080003, 77세,2021,4821,1946,2875,67.7,4818,1946,2872,67.8
35005, 면부,080004, 78세,2021,5393,2121,3272,64.8,5389,2119,3270,64.8
35005, 면부,080005, 79세,2021,7838,2895,4943,58.6,7834,2894,4940,58.6
35005, 면부,085,80~84세,2021,24087,8470,15617,54.2,24071,8465,15606,54.2
35005, 면부,085001, 80세,2021,5358,1985,3373,58.8,5354,1985,3369,58.9
35005, 면부,085002, 81세,2021,4809,1700,3109,54.7,4805,1698,3107,54.7
35005, 면부,085003, 82세,2021,5190,1849,3341,55.3,5187,1848,3339,55.3
35005, 면부,085004, 83세,2021,4550,1530,3020,50.7,4548,1530,3018,50.7
35005, 면부,085005, 84세,2021,4180,1406,2774,50.7,4177,1404,2773,50.6
35005, 면부,090,85~89세,2021,14357,4272,10085,42.4,14353,4270,10083,42.3
35005, 면부,090001, 85세,2021,3751,1156,2595,44.5,3751,1156,2595,44.5
35005, 면부,090002, 86세,2021,3486,1092,2394,45.6,3484,1091,2393,45.6
35005, 면부,090003, 87세,2021,2880,898,1982,45.3,2879,897,1982,45.3
35005, 면부,090004, 88세,2021,2334,630,1704,37,2333,630,1703,37
35005, 면부,090005, 89세,2021,1906,496,1410,35.2,1906,496,1410,35.2
35005, 면부,095,90~94세,2021,4769,1134,3635,31.2,4768,1134,3634,31.2
35005, 면부,095001, 90세,2021,1504,402,1102,36.5,1504,402,1102,36.5
35005, 면부,095002, 91세,2021,1166,248,918,27,1166,248,918,27
35005, 면부,095003, 92세,2021,861,217,644,33.7,861,217,644,33.7
35005, 면부,095004, 93세,2021,705,156,549,28.4,704,156,548,28.5
35005, 면부,095005, 94세,2021,533,111,422,26.3,533,111,422,26.3
35005, 면부,100,95~99세,2021,842,176,666,26.4,841,176,665,26.5
35005, 면부,100001, 95세,2021,290,69,221,31.2,290,69,221,31.2
35005, 면부,100002, 96세,2021,203,40,163,24.5,202,40,162,24.7
35005, 면부,100003, 97세,2021,116,22,94,23.4,116,22,94,23.4
35005, 면부,100004, 98세,2021,140,25,115,21.7,140,25,115,21.7
35005, 면부,100005, 99세,2021,93,20,73,27.4,93,20,73,27.4
35005, 면부,101,100세이상,2021,134,20,114,17.5,134,20,114,17.5
35005, 면부,102,15세미만,2021,21089,10943,10146,107.9,21033,10917,10116,107.9
35005, 면부,103,15~64세,2021,188876,105458,83418,126.4,179421,99864,79557,125.5
35005, 면부,104,65세이상,2021,136209,56645,79564,71.2,135978,56551,79427,71.2
35005, 면부,086,85세이상,2021,20102,5602,14500,38.6,20096,5600,14496,38.6
35005, 면부,126,평균연령,2021,56.1,53.2,59,,56.6,53.8,59.5,
35005, 면부,127,중위연령,2021,60.4,57.3,63.1,,60.9,58.2,63.6,
35003, 동부,000,합계,2021,1285793,640210,645583,99.2,1259627,626971,632656,99.1
35003, 동부,005,0~4세,2021,37444,19123,18321,104.4,37120,18951,18169,104.3
35003, 동부,005001, 0세,2021,6084,3101,2983,104,6027,3073,2954,104
35003, 동부,005002, 1세,2021,6460,3292,3168,103.9,6406,3271,3135,104.3
35003, 동부,005003, 2세,2021,7314,3735,3579,104.4,7235,3690,3545,104.1
35003, 동부,005004, 3세,2021,8356,4260,4096,104,8293,4223,4070,103.8
35003, 동부,005005, 4세,2021,9230,4735,4495,105.3,9159,4694,4465,105.1
35003, 동부,010,5~9세,2021,58974,30366,28608,106.1,58719,30222,28497,106.1
35003, 동부,010001, 5세,2021,10678,5521,5157,107.1,10606,5483,5123,107
35003, 동부,010002, 6세,2021,11617,5953,5664,105.1,11570,5925,5645,105
35003, 동부,010003, 7세,2021,11547,5962,5585,106.8,11491,5930,5561,106.6
35003, 동부,010004, 8세,2021,12009,6243,5766,108.3,11963,6217,5746,108.2
35003, 동부,010005, 9세,2021,13123,6687,6436,103.9,13089,6667,6422,103.8
35003, 동부,015,10~14세,2021,64850,33257,31593,105.3,64708,33182,31526,105.3
35003, 동부,015001, 10세,2021,13219,6679,6540,102.1,13180,6660,6520,102.1
35003, 동부,015002, 11세,2021,12704,6516,6188,105.3,12673,6500,6173,105.3
35003, 동부,015003, 12세,2021,12327,6362,5965,106.7,12298,6344,5954,106.6
35003, 동부,015004, 13세,2021,13003,6727,6276,107.2,12977,6714,6263,107.2
35003, 동부,015005, 14세,2021,13597,6973,6624,105.3,13580,6964,6616,105.3
35003, 동부,020,15~19세,2021,69919,36655,33264,110.2,69315,36340,32975,110.2
35003, 동부,020001, 15세,2021,12464,6444,6020,107,12442,6435,6007,107.1
35003, 동부,020002, 16세,2021,12681,6649,6032,110.2,12666,6641,6025,110.2
35003, 동부,020003, 17세,2021,13927,7146,6781,105.4,13884,7122,6762,105.3
35003, 동부,020004, 18세,2021,14759,7676,7083,108.4,14652,7614,7038,108.2
35003, 동부,020005, 19세,2021,16088,8740,7348,118.9,15671,8528,7143,119.4
35003, 동부,025,20~24세,2021,96845,52585,44260,118.8,91345,49639,41706,119
35003, 동부,025001, 20세,2021,18195,9522,8673,109.8,17449,9162,8287,110.6
35003, 동부,025002, 21세,2021,20274,10732,9542,112.5,19172,10153,9019,112.6
35003, 동부,025003, 22세,2021,19446,10464,8982,116.5,18232,9829,8403,117
35003, 동부,025004, 23세,2021,19732,11094,8638,128.4,18462,10400,8062,129
35003, 동부,025005, 24세,2021,19198,10773,8425,127.9,18030,10095,7935,127.2
35003, 동부,030,25~29세,2021,85358,46220,39138,118.1,80687,43705,36982,118.2
35003, 동부,030001, 25세,2021,18644,10465,8179,127.9,17570,9860,7710,127.9
35003, 동부,030002, 26세,2021,17497,9525,7972,119.5,16505,8998,7507,119.9
35003, 동부,030003, 27세,2021,17139,9240,7899,117,16221,8749,7472,117.1
35003, 동부,030004, 28세,2021,16210,8643,7567,114.2,15339,8177,7162,114.2
35003, 동부,030005, 29세,2021,15868,8347,7521,111,15052,7921,7131,111.1
35003, 동부,035,30~34세,2021,69462,36112,33350,108.3,65544,34086,31458,108.4
35003, 동부,035001, 30세,2021,14909,7847,7062,111.1,14051,7410,6641,111.6
35003, 동부,035002, 31세,2021,14141,7441,6700,111.1,13339,7025,6314,111.3
35003, 동부,035003, 32세,2021,13538,7112,6426,110.7,12764,6713,6051,110.9
35003, 동부,035004, 33세,2021,13353,6797,6556,103.7,12599,6423,6176,104
35003, 동부,035005, 34세,2021,13521,6915,6606,104.7,12791,6515,6276,103.8
35003, 동부,040,35~39세,2021,80456,40582,39874,101.8,77549,39120,38429,101.8
35003, 동부,040001, 35세,2021,14153,7216,6937,104,13496,6885,6611,104.1
35003, 동부,040002, 36세,2021,14341,7199,7142,100.8,13737,6900,6837,100.9
35003, 동부,040003, 37세,2021,15675,7935,7740,102.5,15059,7608,7451,102.1
35003, 동부,040004, 38세,2021,17284,8706,8578,101.5,16721,8432,8289,101.7
35003, 동부,040005, 39세,2021,19003,9526,9477,100.5,18536,9295,9241,100.6
35003, 동부,045,40~44세,2021,95105,47409,47696,99.4,92976,46372,46604,99.5
35003, 동부,045001, 40세,2021,18652,9453,9199,102.8,18170,9206,8964,102.7
35003, 동부,045002, 41세,2021,19964,9963,10001,99.6,19513,9738,9775,99.6
35003, 동부,045003, 42세,2021,19095,9574,9521,100.6,18623,9322,9301,100.2
35003, 동부,045004, 43세,2021,18332,9052,9280,97.5,17931,8868,9063,97.8
35003, 동부,045005, 44세,2021,19062,9367,9695,96.6,18739,9238,9501,97.2
35003, 동부,050,45~49세,2021,106127,52663,53464,98.5,104517,51900,52617,98.6
35003, 동부,050001, 45세,2021,18916,9381,9535,98.4,18573,9203,9370,98.2
35003, 동부,050002, 46세,2021,19774,9717,10057,96.6,19448,9564,9884,96.8
35003, 동부,050003, 47세,2021,22803,11307,11496,98.4,22512,11182,11330,98.7
35003, 동부,050004, 48세,2021,22488,11028,11460,96.2,22151,10880,11271,96.5
35003, 동부,050005, 49세,2021,22146,11230,10916,102.9,21833,11071,10762,102.9
35003, 동부,055,50~54세,2021,112123,56236,55887,100.6,110683,55590,55093,100.9
35003, 동부,055001, 50세,2021,23908,12118,11790,102.8,23616,11979,11637,102.9
35003, 동부,055002, 51세,2021,22623,11445,11178,102.4,22276,11285,10991,102.7
35003, 동부,055003, 52세,2021,22551,11270,11281,99.9,22269,11140,11129,100.1
35003, 동부,055004, 53세,2021,22543,11243,11300,99.5,22255,11119,11136,99.8
35003, 동부,055005, 54세,2021,20498,10160,10338,98.3,20267,10067,10200,98.7
35003, 동부,060,55~59세,2021,98328,49612,48716,101.8,97151,49097,48054,102.2
35003, 동부,060001, 55세,2021,20502,10431,10071,103.6,20236,10313,9923,103.9
35003, 동부,060002, 56세,2021,20242,10051,10191,98.6,19996,9953,10043,99.1
35003, 동부,060003, 57세,2021,18304,9261,9043,102.4,18081,9157,8924,102.6
35003, 동부,060004, 58세,2021,19649,9969,9680,103,19417,9865,9552,103.3
35003, 동부,060005, 59세,2021,19631,9900,9731,101.7,19421,9809,9612,102
35003, 동부,065,60~64세,2021,95682,46702,48980,95.3,94925,46386,48539,95.6
35003, 동부,065001, 60세,2021,21193,10385,10808,96.1,21053,10332,10721,96.4
35003, 동부,065002, 61세,2021,21970,10647,11323,94,21777,10572,11205,94.4
35003, 동부,065003, 62세,2021,18679,9023,9656,93.4,18544,8963,9581,93.5
35003, 동부,065004, 63세,2021,16686,8150,8536,95.5,16526,8085,8441,95.8
35003, 동부,065005, 64세,2021,17154,8497,8657,98.2,17025,8434,8591,98.2
35003, 동부,070,65~69세,2021,68842,33116,35726,92.7,68461,32934,35527,92.7
35003, 동부,070001, 65세,2021,15233,7428,7805,95.2,15122,7374,7748,95.2
35003, 동부,070002, 66세,2021,16317,7866,8451,93.1,16229,7824,8405,93.1
35003, 동부,070003, 67세,2021,13650,6545,7105,92.1,13580,6512,7068,92.1
35003, 동부,070004, 68세,2021,11268,5306,5962,89,11198,5277,5921,89.1
35003, 동부,070005, 69세,2021,12374,5971,6403,93.3,12332,5947,6385,93.1
35003, 동부,075,70~74세,2021,54548,25377,29171,87,54355,25303,29052,87.1
35003, 동부,075001, 70세,2021,10639,5120,5519,92.8,10592,5098,5494,92.8
35003, 동부,075002, 71세,2021,12030,5627,6403,87.9,11982,5607,6375,88
35003, 동부,075003, 72세,2021,10695,4868,5827,83.5,10659,4861,5798,83.8
35003, 동부,075004, 73세,2021,10150,4623,5527,83.6,10119,4611,5508,83.7
35003, 동부,075005, 74세,2021,11034,5139,5895,87.2,11003,5126,5877,87.2
35003, 동부,080,75~79세,2021,39716,17045,22671,75.2,39644,17015,22629,75.2
35003, 동부,080001, 75세,2021,8227,3819,4408,86.6,8210,3811,4399,86.6
35003, 동부,080002, 76세,2021,7165,3110,4055,76.7,7142,3098,4044,76.6
35003, 동부,080003, 77세,2021,7119,3076,4043,76.1,7102,3072,4030,76.2
35003, 동부,080004, 78세,2021,7311,3027,4284,70.7,7303,3025,4278,70.7
35003, 동부,080005, 79세,2021,9894,4013,5881,68.2,9887,4009,5878,68.2
35003, 동부,085,80~84세,2021,28560,10706,17854,60,28507,10696,17811,60.1
35003, 동부,085001, 80세,2021,6578,2647,3931,67.3,6569,2643,3926,67.3
35003, 동부,085002, 81세,2021,5924,2265,3659,61.9,5910,2264,3646,62.1
35003, 동부,085003, 82세,2021,5957,2295,3662,62.7,5944,2292,3652,62.8
35003, 동부,085004, 83세,2021,5353,1864,3489,53.4,5345,1863,3482,53.5
35003, 동부,085005, 84세,2021,4748,1635,3113,52.5,4739,1634,3105,52.6
35003, 동부,090,85~89세,2021,16305,4953,11352,43.6,16284,4946,11338,43.6
35003, 동부,090001, 85세,2021,4179,1412,2767,51,4173,1410,2763,51
35003, 동부,090002, 86세,2021,3972,1274,2698,47.2,3967,1273,2694,47.3
35003, 동부,090003, 87세,2021,3287,974,2313,42.1,3283,974,2309,42.2
35003, 동부,090004, 88세,2021,2717,748,1969,38,2714,745,1969,37.8
35003, 동부,090005, 89세,2021,2150,545,1605,34,2147,544,1603,33.9
35003, 동부,095,90~94세,2021,5877,1292,4585,28.2,5867,1289,4578,28.2
35003, 동부,095001, 90세,2021,1639,389,1250,31.1,1635,386,1249,30.9
35003, 동부,095002, 91세,2021,1476,328,1148,28.6,1474,328,1146,28.6
35003, 동부,095003, 92세,2021,1153,266,887,30,1149,266,883,30.1
35003, 동부,095004, 93세,2021,941,185,756,24.5,941,185,756,24.5
35003, 동부,095005, 94세,2021,668,124,544,22.8,668,124,544,22.8
35003, 동부,100,95~99세,2021,1101,183,918,19.9,1100,182,918,19.8
35003, 동부,100001, 95세,2021,352,59,293,20.1,352,59,293,20.1
35003, 동부,100002, 96세,2021,253,48,205,23.4,252,47,205,22.9
35003, 동부,100003, 97세,2021,186,30,156,19.2,186,30,156,19.2
35003, 동부,100004, 98세,2021,182,27,155,17.4,182,27,155,17.4
35003, 동부,100005, 99세,2021,128,19,109,17.4,128,19,109,17.4
35003, 동부,101,100세이상,2021,171,16,155,10.3,170,16,154,10.4
35003, 동부,102,15세미만,2021,161268,82746,78522,105.4,160547,82355,78192,105.3
35003, 동부,103,15~64세,2021,909405,464776,444629,104.5,884692,452235,432457,104.6
35003, 동부,104,65세이상,2021,215120,92688,122432,75.7,214388,92381,122007,75.7
35003, 동부,086,85세이상,2021,23454,6444,17010,37.9,23421,6433,16988,37.9
35003, 동부,126,평균연령,2021,42.9,41.5,44.2,,43,41.7,44.4,
35003, 동부,127,중위연령,2021,44.2,42.6,45.7,,44.6,43,46.1,
35010, 전주시,000,합계,2021,670411,331251,339160,97.7,658902,325887,333015,97.9
35010, 전주시,005,0~4세,2021,20276,10397,9879,105.2,20083,10291,9792,105.1
35010, 전주시,005001, 0세,2021,3289,1625,1664,97.7,3255,1606,1649,97.4
35010, 전주시,005002, 1세,2021,3509,1829,1680,108.9,3475,1815,1660,109.3
35010, 전주시,005003, 2세,2021,3991,2023,1968,102.8,3936,1992,1944,102.5
35010, 전주시,005004, 3세,2021,4502,2329,2173,107.2,4469,2308,2161,106.8
35010, 전주시,005005, 4세,2021,4985,2591,2394,108.2,4948,2570,2378,108.1
35010, 전주시,010,5~9세,2021,31446,16114,15332,105.1,31311,16042,15269,105.1
35010, 전주시,010001, 5세,2021,5725,2997,2728,109.9,5684,2977,2707,110
35010, 전주시,010002, 6세,2021,6269,3168,3101,102.2,6248,3156,3092,102.1
35010, 전주시,010003, 7세,2021,6194,3176,3018,105.2,6164,3162,3002,105.3
35010, 전주시,010004, 8세,2021,6355,3287,3068,107.1,6329,3273,3056,107.1
35010, 전주시,010005, 9세,2021,6903,3486,3417,102,6886,3474,3412,101.8
35010, 전주시,015,10~14세,2021,33954,17499,16455,106.3,33894,17472,16422,106.4
35010, 전주시,015001, 10세,2021,6841,3459,3382,102.3,6823,3451,3372,102.3
35010, 전주시,015002, 11세,2021,6728,3493,3235,108,6711,3485,3226,108
35010, 전주시,015003, 12세,2021,6481,3329,3152,105.6,6471,3323,3148,105.6
35010, 전주시,015004, 13세,2021,6850,3529,3321,106.3,6841,3527,3314,106.4
35010, 전주시,015005, 14세,2021,7054,3689,3365,109.6,7048,3686,3362,109.6
35010, 전주시,020,15~19세,2021,36804,19225,17579,109.4,36450,19036,17414,109.3
35010, 전주시,020001, 15세,2021,6488,3393,3095,109.6,6480,3390,3090,109.7
35010, 전주시,020002, 16세,2021,6594,3455,3139,110.1,6590,3454,3136,110.1
35010, 전주시,020003, 17세,2021,7323,3749,3574,104.9,7301,3737,3564,104.9
35010, 전주시,020004, 18세,2021,7743,4031,3712,108.6,7671,3992,3679,108.5
35010, 전주시,020005, 19세,2021,8656,4597,4059,113.3,8408,4463,3945,113.1
35010, 전주시,025,20~24세,2021,53599,28349,25250,112.3,50391,26718,23673,112.9
35010, 전주시,025001, 20세,2021,10051,5148,4903,105,9543,4912,4631,106.1
35010, 전주시,025002, 21세,2021,11256,5828,5428,107.4,10549,5465,5084,107.5
35010, 전주시,025003, 22세,2021,10663,5612,5051,111.1,9953,5251,4702,111.7
35010, 전주시,025004, 23세,2021,10864,5883,4981,118.1,10203,5551,4652,119.3
35010, 전주시,025005, 24세,2021,10765,5878,4887,120.3,10143,5539,4604,120.3
35010, 전주시,030,25~29세,2021,47973,25553,22420,114,45828,24518,21310,115.1
35010, 전주시,030001, 25세,2021,10403,5754,4649,123.8,9885,5494,4391,125.1
35010, 전주시,030002, 26세,2021,9797,5260,4537,115.9,9332,5041,4291,117.5
35010, 전주시,030003, 27세,2021,9639,5081,4558,111.5,9219,4872,4347,112.1
35010, 전주시,030004, 28세,2021,9078,4759,4319,110.2,8689,4564,4125,110.6
35010, 전주시,030005, 29세,2021,9056,4699,4357,107.8,8703,4547,4156,109.4
35010, 전주시,035,30~34세,2021,38995,19936,19059,104.6,37388,19217,18171,105.8
35010, 전주시,035001, 30세,2021,8516,4404,4112,107.1,8162,4249,3913,108.6
35010, 전주시,035002, 31세,2021,8010,4189,3821,109.6,7689,4041,3648,110.8
35010, 전주시,035003, 32세,2021,7570,3886,3684,105.5,7242,3736,3506,106.6
35010, 전주시,035004, 33세,2021,7417,3723,3694,100.8,7089,3583,3506,102.2
35010, 전주시,035005, 34세,2021,7482,3734,3748,99.6,7206,3608,3598,100.3
35010, 전주시,040,35~39세,2021,43373,21635,21738,99.5,42286,21166,21120,100.2
35010, 전주시,040001, 35세,2021,7804,3935,3869,101.7,7543,3831,3712,103.2
35010, 전주시,040002, 36세,2021,7817,3943,3874,101.8,7581,3847,3734,103
35010, 전주시,040003, 37세,2021,8444,4194,4250,98.7,8236,4091,4145,98.7
35010, 전주시,040004, 38세,2021,9260,4616,4644,99.4,9053,4527,4526,100
35010, 전주시,040005, 39세,2021,10048,4947,5101,97,9873,4870,5003,97.3
35010, 전주시,045,40~44세,2021,49797,24512,25285,96.9,49040,24189,24851,97.3
35010, 전주시,045001, 40세,2021,9817,4908,4909,100,9641,4825,4816,100.2
35010, 전주시,045002, 41세,2021,10495,5150,5345,96.4,10334,5081,5253,96.7
35010, 전주시,045003, 42세,2021,9981,4962,5019,98.9,9816,4882,4934,98.9
35010, 전주시,045004, 43세,2021,9545,4607,4938,93.3,9407,4556,4851,93.9
35010, 전주시,045005, 44세,2021,9959,4885,5074,96.3,9842,4845,4997,97
35010, 전주시,050,45~49세,2021,54492,26554,27938,95,53912,26301,27611,95.3
35010, 전주시,050001, 45세,2021,9779,4750,5029,94.5,9654,4686,4968,94.3
35010, 전주시,050002, 46세,2021,10181,4964,5217,95.2,10074,4919,5155,95.4
35010, 전주시,050003, 47세,2021,11624,5669,5955,95.2,11507,5624,5883,95.6
35010, 전주시,050004, 48세,2021,11576,5516,6060,91,11453,5470,5983,91.4
35010, 전주시,050005, 49세,2021,11332,5655,5677,99.6,11224,5602,5622,99.6
35010, 전주시,055,50~54세,2021,57398,28444,28954,98.2,56874,28226,28648,98.5
35010, 전주시,055001, 50세,2021,12284,6187,6097,101.5,12187,6144,6043,101.7
35010, 전주시,055002, 51세,2021,11647,5812,5835,99.6,11516,5758,5758,100
35010, 전주시,055003, 52세,2021,11525,5631,5894,95.5,11423,5587,5836,95.7
35010, 전주시,055004, 53세,2021,11482,5659,5823,97.2,11379,5617,5762,97.5
35010, 전주시,055005, 54세,2021,10460,5155,5305,97.2,10369,5120,5249,97.5
35010, 전주시,060,55~59세,2021,50184,24811,25373,97.8,49794,24660,25134,98.1
35010, 전주시,060001, 55세,2021,10551,5231,5320,98.3,10462,5194,5268,98.6
35010, 전주시,060002, 56세,2021,10376,5037,5339,94.3,10281,5006,5275,94.9
35010, 전주시,060003, 57세,2021,9407,4679,4728,99,9330,4647,4683,99.2
35010, 전주시,060004, 58세,2021,9889,4937,4952,99.7,9821,4908,4913,99.9
35010, 전주시,060005, 59세,2021,9961,4927,5034,97.9,9900,4905,4995,98.2
35010, 전주시,065,60~64세,2021,47539,22921,24618,93.1,47303,22833,24470,93.3
35010, 전주시,065001, 60세,2021,10591,5139,5452,94.3,10542,5121,5421,94.5
35010, 전주시,065002, 61세,2021,11125,5388,5737,93.9,11063,5367,5696,94.2
35010, 전주시,065003, 62세,2021,9370,4411,4959,88.9,9334,4394,4940,88.9
35010, 전주시,065004, 63세,2021,8078,3953,4125,95.8,8024,3934,4090,96.2
35010, 전주시,065005, 64세,2021,8375,4030,4345,92.8,8340,4017,4323,92.9
35010, 전주시,070,65~69세,2021,33958,16219,17739,91.4,33838,16175,17663,91.6
35010, 전주시,070001, 65세,2021,7531,3677,3854,95.4,7498,3667,3831,95.7
35010, 전주시,070002, 66세,2021,7973,3817,4156,91.8,7940,3802,4138,91.9
35010, 전주시,070003, 67세,2021,6735,3214,3521,91.3,6710,3209,3501,91.7
35010, 전주시,070004, 68세,2021,5679,2642,3037,87,5658,2633,3025,87
35010, 전주시,070005, 69세,2021,6040,2869,3171,90.5,6032,2864,3168,90.4
35010, 전주시,075,70~74세,2021,26541,12278,14263,86.1,26478,12253,14225,86.1
35010, 전주시,075001, 70세,2021,5121,2456,2665,92.2,5103,2448,2655,92.2
35010, 전주시,075002, 71세,2021,5899,2728,3171,86,5889,2724,3165,86.1
35010, 전주시,075003, 72세,2021,5214,2335,2879,81.1,5201,2333,2868,81.3
35010, 전주시,075004, 73세,2021,5006,2284,2722,83.9,4998,2280,2718,83.9
35010, 전주시,075005, 74세,2021,5301,2475,2826,87.6,5287,2468,2819,87.5
35010, 전주시,080,75~79세,2021,19080,8294,10786,76.9,19060,8286,10774,76.9
35010, 전주시,080001, 75세,2021,3990,1862,2128,87.5,3985,1860,2125,87.5
35010, 전주시,080002, 76세,2021,3423,1498,1925,77.8,3418,1495,1923,77.7
35010, 전주시,080003, 77세,2021,3393,1494,1899,78.7,3387,1491,1896,78.6
35010, 전주시,080004, 78세,2021,3480,1463,2017,72.5,3477,1463,2014,72.6
35010, 전주시,080005, 79세,2021,4794,1977,2817,70.2,4793,1977,2816,70.2
35010, 전주시,085,80~84세,2021,13815,5325,8490,62.7,13796,5322,8474,62.8
35010, 전주시,085001, 80세,2021,3161,1290,1871,68.9,3158,1289,1869,69
35010, 전주시,085002, 81세,2021,2843,1122,1721,65.2,2839,1121,1718,65.3
35010, 전주시,085003, 82세,2021,2922,1167,1755,66.5,2917,1166,1751,66.6
35010, 전주시,085004, 83세,2021,2542,904,1638,55.2,2539,904,1635,55.3
35010, 전주시,085005, 84세,2021,2347,842,1505,55.9,2343,842,1501,56.1
35010, 전주시,090,85~89세,2021,7766,2416,5350,45.2,7760,2414,5346,45.2
35010, 전주시,090001, 85세,2021,2001,685,1316,52.1,2000,685,1315,52.1
35010, 전주시,090002, 86세,2021,1905,622,1283,48.5,1903,622,1281,48.6
35010, 전주시,090003, 87세,2021,1546,470,1076,43.7,1545,470,1075,43.7
35010, 전주시,090004, 88세,2021,1245,351,894,39.3,1243,349,894,39
35010, 전주시,090005, 89세,2021,1069,288,781,36.9,1069,288,781,36.9
35010, 전주시,095,90~94세,2021,2818,673,2145,31.4,2814,672,2142,31.4
35010, 전주시,095001, 90세,2021,808,207,601,34.4,807,206,601,34.3
35010, 전주시,095002, 91세,2021,681,156,525,29.7,679,156,523,29.8
35010, 전주시,095003, 92세,2021,550,133,417,31.9,549,133,416,32
35010, 전주시,095004, 93세,2021,456,99,357,27.7,456,99,357,27.7
35010, 전주시,095005, 94세,2021,323,78,245,31.8,323,78,245,31.8
35010, 전주시,100,95~99세,2021,514,88,426,20.7,514,88,426,20.7
35010, 전주시,100001, 95세,2021,173,32,141,22.7,173,32,141,22.7
35010, 전주시,100002, 96세,2021,117,22,95,23.2,117,22,95,23.2
35010, 전주시,100003, 97세,2021,73,8,65,12.3,73,8,65,12.3
35010, 전주시,100004, 98세,2021,88,16,72,22.2,88,16,72,22.2
35010, 전주시,100005, 99세,2021,63,10,53,18.9,63,10,53,18.9
35010, 전주시,101,100세이상,2021,89,8,81,9.9,88,8,80,10
35010, 전주시,102,15세미만,2021,85676,44010,41666,105.6,85288,43805,41483,105.6
35010, 전주시,103,15~64세,2021,480154,241940,238214,101.6,469266,236864,232402,101.9
35010, 전주시,104,65세이상,2021,104581,45301,59280,76.4,104348,45218,59130,76.5
35010, 전주시,086,85세이상,2021,11187,3185,8002,39.8,11176,3182,7994,39.8
35010, 전주시,126,평균연령,2021,42,40.8,43.3,,42.2,40.9,43.4,
35010, 전주시,127,중위연령,2021,42.8,41.4,44.3,,43.2,41.7,44.7,
35011, 완산구,000,합계,2021,342394,167393,175001,95.7,336897,164807,172090,95.8
35011, 완산구,005,0~4세,2021,8987,4647,4340,107.1,8940,4618,4322,106.8
35011, 완산구,005001, 0세,2021,1418,711,707,100.6,1410,705,705,100
35011, 완산구,005002, 1세,2021,1564,804,760,105.8,1560,802,758,105.8
35011, 완산구,005003, 2세,2021,1762,912,850,107.3,1747,903,844,107
35011, 완산구,005004, 3세,2021,1998,1063,935,113.7,1987,1058,929,113.9
35011, 완산구,005005, 4세,2021,2245,1157,1088,106.3,2236,1150,1086,105.9
35011, 완산구,010,5~9세,2021,14217,7294,6923,105.4,14188,7280,6908,105.4
35011, 완산구,010001, 5세,2021,2613,1356,1257,107.9,2604,1354,1250,108.3
35011, 완산구,010002, 6세,2021,2780,1382,1398,98.9,2777,1380,1397,98.8
35011, 완산구,010003, 7세,2021,2800,1456,1344,108.3,2795,1453,1342,108.3
35011, 완산구,010004, 8세,2021,2863,1486,1377,107.9,2854,1482,1372,108
35011, 완산구,010005, 9세,2021,3161,1614,1547,104.3,3158,1611,1547,104.1
35011, 완산구,015,10~14세,2021,16078,8310,7768,107,16061,8303,7758,107
35011, 완산구,015001, 10세,2021,3172,1591,1581,100.6,3169,1589,1580,100.6
35011, 완산구,015002, 11세,2021,3159,1675,1484,112.9,3156,1673,1483,112.8
35011, 완산구,015003, 12세,2021,3099,1618,1481,109.3,3095,1616,1479,109.3
35011, 완산구,015004, 13세,2021,3243,1661,1582,105,3239,1661,1578,105.3
35011, 완산구,015005, 14세,2021,3405,1765,1640,107.6,3402,1764,1638,107.7
35011, 완산구,020,15~19세,2021,19343,10219,9124,112,19112,10091,9021,111.9
35011, 완산구,020001, 15세,2021,3210,1684,1526,110.4,3207,1683,1524,110.4
35011, 완산구,020002, 16세,2021,3379,1794,1585,113.2,3378,1794,1584,113.3
35011, 완산구,020003, 17세,2021,3995,2120,1875,113.1,3985,2115,1870,113.1
35011, 완산구,020004, 18세,2021,4221,2255,1966,114.7,4174,2228,1946,114.5
35011, 완산구,020005, 19세,2021,4538,2366,2172,108.9,4368,2271,2097,108.3
35011, 완산구,025,20~24세,2021,27698,14490,13208,109.7,25787,13448,12339,109
35011, 완산구,025001, 20세,2021,5237,2687,2550,105.4,4891,2508,2383,105.2
35011, 완산구,025002, 21세,2021,5862,3046,2816,108.2,5370,2781,2589,107.4
35011, 완산구,025003, 22세,2021,5608,2928,2680,109.3,5166,2686,2480,108.3
35011, 완산구,025004, 23세,2021,5559,2950,2609,113.1,5230,2776,2454,113.1
35011, 완산구,025005, 24세,2021,5432,2879,2553,112.8,5130,2697,2433,110.9
35011, 완산구,030,25~29세,2021,24445,12723,11722,108.5,23573,12334,11239,109.7
35011, 완산구,030001, 25세,2021,5219,2788,2431,114.7,4986,2671,2315,115.4
35011, 완산구,030002, 26세,2021,4998,2600,2398,108.4,4821,2523,2298,109.8
35011, 완산구,030003, 27세,2021,5030,2582,2448,105.5,4844,2500,2344,106.7
35011, 완산구,030004, 28세,2021,4589,2359,2230,105.8,4445,2295,2150,106.7
35011, 완산구,030005, 29세,2021,4609,2394,2215,108.1,4477,2345,2132,110
35011, 완산구,035,30~34세,2021,19171,9827,9344,105.2,18510,9566,8944,107
35011, 완산구,035001, 30세,2021,4286,2231,2055,108.6,4135,2178,1957,111.3
35011, 완산구,035002, 31세,2021,3906,2084,1822,114.4,3784,2031,1753,115.9
35011, 완산구,035003, 32세,2021,3749,1922,1827,105.2,3611,1861,1750,106.3
35011, 완산구,035004, 33세,2021,3615,1762,1853,95.1,3479,1713,1766,97
35011, 완산구,035005, 34세,2021,3615,1828,1787,102.3,3501,1783,1718,103.8
35011, 완산구,040,35~39세,2021,20283,10113,10170,99.4,19818,9924,9894,100.3
35011, 완산구,040001, 35세,2021,3667,1875,1792,104.6,3564,1837,1727,106.4
35011, 완산구,040002, 36세,2021,3589,1818,1771,102.7,3487,1775,1712,103.7
35011, 완산구,040003, 37세,2021,4040,1995,2045,97.6,3951,1950,2001,97.5
35011, 완산구,040004, 38세,2021,4302,2120,2182,97.2,4210,2088,2122,98.4
35011, 완산구,040005, 39세,2021,4685,2305,2380,96.8,4606,2274,2332,97.5
35011, 완산구,045,40~44세,2021,23582,11493,12089,95.1,23227,11342,11885,95.4
35011, 완산구,045001, 40세,2021,4558,2280,2278,100.1,4482,2248,2234,100.6
35011, 완산구,045002, 41세,2021,4923,2366,2557,92.5,4854,2336,2518,92.8
35011, 완산구,045003, 42세,2021,4661,2312,2349,98.4,4576,2271,2305,98.5
35011, 완산구,045004, 43세,2021,4610,2231,2379,93.8,4544,2205,2339,94.3
35011, 완산구,045005, 44세,2021,4830,2304,2526,91.2,4771,2282,2489,91.7
35011, 완산구,050,45~49세,2021,27604,13073,14531,90,27346,12955,14391,90
35011, 완산구,050001, 45세,2021,4753,2240,2513,89.1,4700,2208,2492,88.6
35011, 완산구,050002, 46세,2021,5099,2424,2675,90.6,5046,2403,2643,90.9
35011, 완산구,050003, 47세,2021,5916,2777,3139,88.5,5856,2752,3104,88.7
35011, 완산구,050004, 48세,2021,5969,2788,3181,87.6,5918,2766,3152,87.8
35011, 완산구,050005, 49세,2021,5867,2844,3023,94.1,5826,2826,3000,94.2
35011, 완산구,055,50~54세,2021,30536,14914,15622,95.5,30285,14804,15481,95.6
35011, 완산구,055001, 50세,2021,6500,3176,3324,95.5,6456,3154,3302,95.5
35011, 완산구,055002, 51세,2021,6137,3070,3067,100.1,6083,3048,3035,100.4
35011, 완산구,055003, 52세,2021,6145,2946,3199,92.1,6088,2921,3167,92.2
35011, 완산구,055004, 53세,2021,6139,3008,3131,96.1,6095,2989,3106,96.2
35011, 완산구,055005, 54세,2021,5615,2714,2901,93.6,5563,2692,2871,93.8
35011, 완산구,060,55~59세,2021,27180,13243,13937,95,26983,13167,13816,95.3
35011, 완산구,060001, 55세,2021,5644,2736,2908,94.1,5600,2721,2879,94.5
35011, 완산구,060002, 56세,2021,5610,2708,2902,93.3,5560,2690,2870,93.7
35011, 완산구,060003, 57세,2021,5129,2520,2609,96.6,5093,2507,2586,96.9
35011, 완산구,060004, 58세,2021,5380,2606,2774,93.9,5342,2589,2753,94
35011, 완산구,060005, 59세,2021,5417,2673,2744,97.4,5388,2660,2728,97.5
35011, 완산구,065,60~64세,2021,26146,12433,13713,90.7,26049,12397,13652,90.8
35011, 완산구,065001, 60세,2021,5874,2815,3059,92,5849,2806,3043,92.2
35011, 완산구,065002, 61세,2021,5968,2829,3139,90.1,5942,2819,3123,90.3
35011, 완산구,065003, 62세,2021,5150,2394,2756,86.9,5135,2387,2748,86.9
35011, 완산구,065004, 63세,2021,4478,2168,2310,93.9,4457,2162,2295,94.2
35011, 완산구,065005, 64세,2021,4676,2227,2449,90.9,4666,2223,2443,91
35011, 완산구,070,65~69세,2021,18665,8918,9747,91.5,18609,8899,9710,91.6
35011, 완산구,070001, 65세,2021,4123,2002,2121,94.4,4106,1996,2110,94.6
35011, 완산구,070002, 66세,2021,4350,2086,2264,92.1,4336,2080,2256,92.2
35011, 완산구,070003, 67세,2021,3758,1803,1955,92.2,3746,1802,1944,92.7
35011, 완산구,070004, 68세,2021,3059,1413,1646,85.8,3050,1409,1641,85.9
35011, 완산구,070005, 69세,2021,3375,1614,1761,91.7,3371,1612,1759,91.6
35011, 완산구,075,70~74세,2021,14470,6673,7797,85.6,14443,6663,7780,85.6
35011, 완산구,075001, 70세,2021,2789,1304,1485,87.8,2783,1300,1483,87.7
35011, 완산구,075002, 71세,2021,3207,1475,1732,85.2,3202,1473,1729,85.2
35011, 완산구,075003, 72세,2021,2850,1273,1577,80.7,2843,1272,1571,81
35011, 완산구,075004, 73세,2021,2703,1264,1439,87.8,2700,1263,1437,87.9
35011, 완산구,075005, 74세,2021,2921,1357,1564,86.8,2915,1355,1560,86.9
35011, 완산구,080,75~79세,2021,10286,4463,5823,76.6,10277,4459,5818,76.6
35011, 완산구,080001, 75세,2021,2160,1029,1131,91,2158,1028,1130,91
35011, 완산구,080002, 76세,2021,1874,812,1062,76.5,1871,810,1061,76.3
35011, 완산구,080003, 77세,2021,1805,795,1010,78.7,1803,794,1009,78.7
35011, 완산구,080004, 78세,2021,1899,787,1112,70.8,1898,787,1111,70.8
35011, 완산구,080005, 79세,2021,2548,1040,1508,69,2547,1040,1507,69
35011, 완산구,085,80~84세,2021,7416,2826,4590,61.6,7409,2825,4584,61.6
35011, 완산구,085001, 80세,2021,1714,683,1031,66.2,1713,682,1031,66.1
35011, 완산구,085002, 81세,2021,1510,594,916,64.8,1508,594,914,65
35011, 완산구,085003, 82세,2021,1556,632,924,68.4,1553,632,921,68.6
35011, 완산구,085004, 83세,2021,1369,470,899,52.3,1369,470,899,52.3
35011, 완산구,085005, 84세,2021,1267,447,820,54.5,1266,447,819,54.6
35011, 완산구,090,85~89세,2021,4314,1306,3008,43.4,4310,1304,3006,43.4
35011, 완산구,090001, 85세,2021,1075,354,721,49.1,1075,354,721,49.1
35011, 완산구,090002, 86세,2021,1063,333,730,45.6,1062,333,729,45.7
35011, 완산구,090003, 87세,2021,874,265,609,43.5,873,265,608,43.6
35011, 완산구,090004, 88세,2021,686,186,500,37.2,684,184,500,36.8
35011, 완산구,090005, 89세,2021,616,168,448,37.5,616,168,448,37.5
35011, 완산구,095,90~94세,2021,1613,372,1241,30,1611,372,1239,30
35011, 완산구,095001, 90세,2021,459,114,345,33,459,114,345,33
35011, 완산구,095002, 91세,2021,398,91,307,29.6,396,91,305,29.8
35011, 완산구,095003, 92세,2021,302,74,228,32.5,302,74,228,32.5
35011, 완산구,095004, 93세,2021,274,52,222,23.4,274,52,222,23.4
35011, 완산구,095005, 94세,2021,180,41,139,29.5,180,41,139,29.5
35011, 완산구,100,95~99세,2021,310,51,259,19.7,310,51,259,19.7
35011, 완산구,100001, 95세,2021,110,22,88,25,110,22,88,25
35011, 완산구,100002, 96세,2021,63,12,51,23.5,63,12,51,23.5
35011, 완산구,100003, 97세,2021,43,X,39,10.3,43,X,39,10.3
35011, 완산구,100004, 98세,2021,54,8,46,17.4,54,8,46,17.4
35011, 완산구,100005, 99세,2021,40,5,35,14.3,40,5,35,14.3
35011, 완산구,101,100세이상,2021,50,5,45,11.1,49,5,44,11.4
35011, 완산구,102,15세미만,2021,39282,20251,19031,106.4,39189,20201,18988,106.4
35011, 완산구,103,15~64세,2021,245988,122528,123460,99.2,240690,120028,120662,99.5
35011, 완산구,104,65세이상,2021,57124,24614,32510,75.7,57018,24578,32440,75.8
35011, 완산구,086,85세이상,2021,6287,1734,4553,38.1,6280,1732,4548,38.1
35011, 완산구,126,평균연령,2021,43,41.7,44.4,,43.2,41.8,44.6,
35011, 완산구,127,중위연령,2021,44.5,42.6,46.1,,44.8,43,46.5,
35012, 덕진구,000,합계,2021,328017,163858,164159,99.8,322005,161080,160925,100.1
35012, 덕진구,005,0~4세,2021,11289,5750,5539,103.8,11143,5673,5470,103.7
35012, 덕진구,005001, 0세,2021,1871,914,957,95.5,1845,901,944,95.4
35012, 덕진구,005002, 1세,2021,1945,1025,920,111.4,1915,1013,902,112.3
35012, 덕진구,005003, 2세,2021,2229,1111,1118,99.4,2189,1089,1100,99
35012, 덕진구,005004, 3세,2021,2504,1266,1238,102.3,2482,1250,1232,101.5
35012, 덕진구,005005, 4세,2021,2740,1434,1306,109.8,2712,1420,1292,109.9
35012, 덕진구,010,5~9세,2021,17229,8820,8409,104.9,17123,8762,8361,104.8
35012, 덕진구,010001, 5세,2021,3112,1641,1471,111.6,3080,1623,1457,111.4
35012, 덕진구,010002, 6세,2021,3489,1786,1703,104.9,3471,1776,1695,104.8
35012, 덕진구,010003, 7세,2021,3394,1720,1674,102.7,3369,1709,1660,103
35012, 덕진구,010004, 8세,2021,3492,1801,1691,106.5,3475,1791,1684,106.4
35012, 덕진구,010005, 9세,2021,3742,1872,1870,100.1,3728,1863,1865,99.9
35012, 덕진구,015,10~14세,2021,17876,9189,8687,105.8,17833,9169,8664,105.8
35012, 덕진구,015001, 10세,2021,3669,1868,1801,103.7,3654,1862,1792,103.9
35012, 덕진구,015002, 11세,2021,3569,1818,1751,103.8,3555,1812,1743,104
35012, 덕진구,015003, 12세,2021,3382,1711,1671,102.4,3376,1707,1669,102.3
35012, 덕진구,015004, 13세,2021,3607,1868,1739,107.4,3602,1866,1736,107.5
35012, 덕진구,015005, 14세,2021,3649,1924,1725,111.5,3646,1922,1724,111.5
35012, 덕진구,020,15~19세,2021,17461,9006,8455,106.5,17338,8945,8393,106.6
35012, 덕진구,020001, 15세,2021,3278,1709,1569,108.9,3273,1707,1566,109
35012, 덕진구,020002, 16세,2021,3215,1661,1554,106.9,3212,1660,1552,107
35012, 덕진구,020003, 17세,2021,3328,1629,1699,95.9,3316,1622,1694,95.7
35012, 덕진구,020004, 18세,2021,3522,1776,1746,101.7,3497,1764,1733,101.8
35012, 덕진구,020005, 19세,2021,4118,2231,1887,118.2,4040,2192,1848,118.6
35012, 덕진구,025,20~24세,2021,25901,13859,12042,115.1,24604,13270,11334,117.1
35012, 덕진구,025001, 20세,2021,4814,2461,2353,104.6,4652,2404,2248,106.9
35012, 덕진구,025002, 21세,2021,5394,2782,2612,106.5,5179,2684,2495,107.6
35012, 덕진구,025003, 22세,2021,5055,2684,2371,113.2,4787,2565,2222,115.4
35012, 덕진구,025004, 23세,2021,5305,2933,2372,123.7,4973,2775,2198,126.3
35012, 덕진구,025005, 24세,2021,5333,2999,2334,128.5,5013,2842,2171,130.9
35012, 덕진구,030,25~29세,2021,23528,12830,10698,119.9,22255,12184,10071,121
35012, 덕진구,030001, 25세,2021,5184,2966,2218,133.7,4899,2823,2076,136
35012, 덕진구,030002, 26세,2021,4799,2660,2139,124.4,4511,2518,1993,126.3
35012, 덕진구,030003, 27세,2021,4609,2499,2110,118.4,4375,2372,2003,118.4
35012, 덕진구,030004, 28세,2021,4489,2400,2089,114.9,4244,2269,1975,114.9
35012, 덕진구,030005, 29세,2021,4447,2305,2142,107.6,4226,2202,2024,108.8
35012, 덕진구,035,30~34세,2021,19824,10109,9715,104.1,18878,9651,9227,104.6
35012, 덕진구,035001, 30세,2021,4230,2173,2057,105.6,4027,2071,1956,105.9
35012, 덕진구,035002, 31세,2021,4104,2105,1999,105.3,3905,2010,1895,106.1
35012, 덕진구,035003, 32세,2021,3821,1964,1857,105.8,3631,1875,1756,106.8
35012, 덕진구,035004, 33세,2021,3802,1961,1841,106.5,3610,1870,1740,107.5
35012, 덕진구,035005, 34세,2021,3867,1906,1961,97.2,3705,1825,1880,97.1
35012, 덕진구,040,35~39세,2021,23090,11522,11568,99.6,22468,11242,11226,100.1
35012, 덕진구,040001, 35세,2021,4137,2060,2077,99.2,3979,1994,1985,100.5
35012, 덕진구,040002, 36세,2021,4228,2125,2103,101,4094,2072,2022,102.5
35012, 덕진구,040003, 37세,2021,4404,2199,2205,99.7,4285,2141,2144,99.9
35012, 덕진구,040004, 38세,2021,4958,2496,2462,101.4,4843,2439,2404,101.5
35012, 덕진구,040005, 39세,2021,5363,2642,2721,97.1,5267,2596,2671,97.2
35012, 덕진구,045,40~44세,2021,26215,13019,13196,98.7,25813,12847,12966,99.1
35012, 덕진구,045001, 40세,2021,5259,2628,2631,99.9,5159,2577,2582,99.8
35012, 덕진구,045002, 41세,2021,5572,2784,2788,99.9,5480,2745,2735,100.4
35012, 덕진구,045003, 42세,2021,5320,2650,2670,99.3,5240,2611,2629,99.3
35012, 덕진구,045004, 43세,2021,4935,2376,2559,92.8,4863,2351,2512,93.6
35012, 덕진구,045005, 44세,2021,5129,2581,2548,101.3,5071,2563,2508,102.2
35012, 덕진구,050,45~49세,2021,26888,13481,13407,100.6,26566,13346,13220,101
35012, 덕진구,050001, 45세,2021,5026,2510,2516,99.8,4954,2478,2476,100.1
35012, 덕진구,050002, 46세,2021,5082,2540,2542,99.9,5028,2516,2512,100.2
35012, 덕진구,050003, 47세,2021,5708,2892,2816,102.7,5651,2872,2779,103.3
35012, 덕진구,050004, 48세,2021,5607,2728,2879,94.8,5535,2704,2831,95.5
35012, 덕진구,050005, 49세,2021,5465,2811,2654,105.9,5398,2776,2622,105.9
35012, 덕진구,055,50~54세,2021,26862,13530,13332,101.5,26589,13422,13167,101.9
35012, 덕진구,055001, 50세,2021,5784,3011,2773,108.6,5731,2990,2741,109.1
35012, 덕진구,055002, 51세,2021,5510,2742,2768,99.1,5433,2710,2723,99.5
35012, 덕진구,055003, 52세,2021,5380,2685,2695,99.6,5335,2666,2669,99.9
35012, 덕진구,055004, 53세,2021,5343,2651,2692,98.5,5284,2628,2656,98.9
35012, 덕진구,055005, 54세,2021,4845,2441,2404,101.5,4806,2428,2378,102.1
35012, 덕진구,060,55~59세,2021,23004,11568,11436,101.2,22811,11493,11318,101.5
35012, 덕진구,060001, 55세,2021,4907,2495,2412,103.4,4862,2473,2389,103.5
35012, 덕진구,060002, 56세,2021,4766,2329,2437,95.6,4721,2316,2405,96.3
35012, 덕진구,060003, 57세,2021,4278,2159,2119,101.9,4237,2140,2097,102.1
35012, 덕진구,060004, 58세,2021,4509,2331,2178,107,4479,2319,2160,107.4
35012, 덕진구,060005, 59세,2021,4544,2254,2290,98.4,4512,2245,2267,99
35012, 덕진구,065,60~64세,2021,21393,10488,10905,96.2,21254,10436,10818,96.5
35012, 덕진구,065001, 60세,2021,4717,2324,2393,97.1,4693,2315,2378,97.4
35012, 덕진구,065002, 61세,2021,5157,2559,2598,98.5,5121,2548,2573,99
35012, 덕진구,065003, 62세,2021,4220,2017,2203,91.6,4199,2007,2192,91.6
35012, 덕진구,065004, 63세,2021,3600,1785,1815,98.3,3567,1772,1795,98.7
35012, 덕진구,065005, 64세,2021,3699,1803,1896,95.1,3674,1794,1880,95.4
35012, 덕진구,070,65~69세,2021,15293,7301,7992,91.4,15229,7276,7953,91.5
35012, 덕진구,070001, 65세,2021,3408,1675,1733,96.7,3392,1671,1721,97.1
35012, 덕진구,070002, 66세,2021,3623,1731,1892,91.5,3604,1722,1882,91.5
35012, 덕진구,070003, 67세,2021,2977,1411,1566,90.1,2964,1407,1557,90.4
35012, 덕진구,070004, 68세,2021,2620,1229,1391,88.4,2608,1224,1384,88.4
35012, 덕진구,070005, 69세,2021,2665,1255,1410,89,2661,1252,1409,88.9
35012, 덕진구,075,70~74세,2021,12071,5605,6466,86.7,12035,5590,6445,86.7
35012, 덕진구,075001, 70세,2021,2332,1152,1180,97.6,2320,1148,1172,98
35012, 덕진구,075002, 71세,2021,2692,1253,1439,87.1,2687,1251,1436,87.1
35012, 덕진구,075003, 72세,2021,2364,1062,1302,81.6,2358,1061,1297,81.8
35012, 덕진구,075004, 73세,2021,2303,1020,1283,79.5,2298,1017,1281,79.4
35012, 덕진구,075005, 74세,2021,2380,1118,1262,88.6,2372,1113,1259,88.4
35012, 덕진구,080,75~79세,2021,8794,3831,4963,77.2,8783,3827,4956,77.2
35012, 덕진구,080001, 75세,2021,1830,833,997,83.6,1827,832,995,83.6
35012, 덕진구,080002, 76세,2021,1549,686,863,79.5,1547,685,862,79.5
35012, 덕진구,080003, 77세,2021,1588,699,889,78.6,1584,697,887,78.6
35012, 덕진구,080004, 78세,2021,1581,676,905,74.7,1579,676,903,74.9
35012, 덕진구,080005, 79세,2021,2246,937,1309,71.6,2246,937,1309,71.6
35012, 덕진구,085,80~84세,2021,6399,2499,3900,64.1,6387,2497,3890,64.2
35012, 덕진구,085001, 80세,2021,1447,607,840,72.3,1445,607,838,72.4
35012, 덕진구,085002, 81세,2021,1333,528,805,65.6,1331,527,804,65.5
35012, 덕진구,085003, 82세,2021,1366,535,831,64.4,1364,534,830,64.3
35012, 덕진구,085004, 83세,2021,1173,434,739,58.7,1170,434,736,59
35012, 덕진구,085005, 84세,2021,1080,395,685,57.7,1077,395,682,57.9
35012, 덕진구,090,85~89세,2021,3452,1110,2342,47.4,3450,1110,2340,47.4
35012, 덕진구,090001, 85세,2021,926,331,595,55.6,925,331,594,55.7
35012, 덕진구,090002, 86세,2021,842,289,553,52.3,841,289,552,52.4
35012, 덕진구,090003, 87세,2021,672,205,467,43.9,672,205,467,43.9
35012, 덕진구,090004, 88세,2021,559,165,394,41.9,559,165,394,41.9
35012, 덕진구,090005, 89세,2021,453,120,333,36,453,120,333,36
35012, 덕진구,095,90~94세,2021,1205,301,904,33.3,1203,300,903,33.2
35012, 덕진구,095001, 90세,2021,349,93,256,36.3,348,92,256,35.9
35012, 덕진구,095002, 91세,2021,283,65,218,29.8,283,65,218,29.8
35012, 덕진구,095003, 92세,2021,248,59,189,31.2,247,59,188,31.4
35012, 덕진구,095004, 93세,2021,182,47,135,34.8,182,47,135,34.8
35012, 덕진구,095005, 94세,2021,143,37,106,34.9,143,37,106,34.9
35012, 덕진구,100,95~99세,2021,204,37,167,22.2,204,37,167,22.2
35012, 덕진구,100001, 95세,2021,63,10,53,18.9,63,10,53,18.9
35012, 덕진구,100002, 96세,2021,54,10,44,22.7,54,10,44,22.7
35012, 덕진구,100003, 97세,2021,30,X,26,15.4,30,X,26,15.4
35012, 덕진구,100004, 98세,2021,34,8,26,30.8,34,8,26,30.8
35012, 덕진구,100005, 99세,2021,23,5,18,27.8,23,5,18,27.8
35012, 덕진구,101,100세이상,2021,39,X,36,8.3,39,X,36,8.3
35012, 덕진구,102,15세미만,2021,46394,23759,22635,105,46099,23604,22495,104.9
35012, 덕진구,103,15~64세,2021,234166,119412,114754,104.1,228576,116836,111740,104.6
35012, 덕진구,104,65세이상,2021,47457,20687,26770,77.3,47330,20640,26690,77.3
35012, 덕진구,086,85세이상,2021,4900,1451,3449,42.1,4896,1450,3446,42.1
35012, 덕진구,126,평균연령,2021,41,39.9,42.1,,41.1,40,42.2,
35012, 덕진구,127,중위연령,2021,41.5,40.3,42.6,,41.8,40.6,42.9,
35020, 군산시,000,합계,2021,267635,136413,131222,104,259861,131613,128248,102.6
35020, 군산시,005,0~4세,2021,7399,3744,3655,102.4,7350,3717,3633,102.3
35020, 군산시,005001, 0세,2021,1193,617,576,107.1,1188,616,572,107.7
35020, 군산시,005002, 1세,2021,1319,657,662,99.2,1310,652,658,99.1
35020, 군산시,005003, 2세,2021,1395,708,687,103.1,1389,705,684,103.1
35020, 군산시,005004, 3세,2021,1650,836,814,102.7,1639,830,809,102.6
35020, 군산시,005005, 4세,2021,1842,926,916,101.1,1824,914,910,100.4
35020, 군산시,010,5~9세,2021,12162,6232,5930,105.1,12103,6200,5903,105
35020, 군산시,010001, 5세,2021,2163,1082,1081,100.1,2147,1076,1071,100.5
35020, 군산시,010002, 6세,2021,2427,1237,1190,103.9,2415,1230,1185,103.8
35020, 군산시,010003, 7세,2021,2382,1253,1129,111,2370,1245,1125,110.7
35020, 군산시,010004, 8세,2021,2554,1310,1244,105.3,2545,1304,1241,105.1
35020, 군산시,010005, 9세,2021,2636,1350,1286,105,2626,1345,1281,105
35020, 군산시,015,10~14세,2021,12854,6612,6242,105.9,12811,6589,6222,105.9
35020, 군산시,015001, 10세,2021,2676,1388,1288,107.8,2667,1382,1285,107.5
35020, 군산시,015002, 11세,2021,2561,1272,1289,98.7,2556,1270,1286,98.8
35020, 군산시,015003, 12세,2021,2476,1274,1202,106,2465,1267,1198,105.8
35020, 군산시,015004, 13세,2021,2482,1338,1144,117,2471,1332,1139,116.9
35020, 군산시,015005, 14세,2021,2659,1340,1319,101.6,2652,1338,1314,101.8
35020, 군산시,020,15~19세,2021,12906,6749,6157,109.6,12733,6663,6070,109.8
35020, 군산시,020001, 15세,2021,2376,1215,1161,104.7,2368,1214,1154,105.2
35020, 군산시,020002, 16세,2021,2311,1206,1105,109.1,2306,1203,1103,109.1
35020, 군산시,020003, 17세,2021,2558,1308,1250,104.6,2545,1301,1244,104.6
35020, 군산시,020004, 18세,2021,2669,1356,1313,103.3,2644,1340,1304,102.8
35020, 군산시,020005, 19세,2021,2992,1664,1328,125.3,2870,1605,1265,126.9
35020, 군산시,025,20~24세,2021,17306,9731,7575,128.5,16325,9139,7186,127.2
35020, 군산시,025001, 20세,2021,3360,1796,1564,114.8,3227,1722,1505,114.4
35020, 군산시,025002, 21세,2021,3627,1918,1709,112.2,3452,1827,1625,112.4
35020, 군산시,025003, 22세,2021,3545,1957,1588,123.2,3334,1837,1497,122.7
35020, 군산시,025004, 23세,2021,3440,2034,1406,144.7,3201,1872,1329,140.9
35020, 군산시,025005, 24세,2021,3334,2026,1308,154.9,3111,1881,1230,152.9
35020, 군산시,030,25~29세,2021,15183,8680,6503,133.5,13848,7757,6091,127.4
35020, 군산시,030001, 25세,2021,3283,1920,1363,140.9,2993,1731,1262,137.2
35020, 군산시,030002, 26세,2021,3074,1755,1319,133.1,2818,1582,1236,128
35020, 군산시,030003, 27세,2021,2971,1737,1234,140.8,2704,1548,1156,133.9
35020, 군산시,030004, 28세,2021,2925,1638,1287,127.3,2672,1464,1208,121.2
35020, 군산시,030005, 29세,2021,2930,1630,1300,125.4,2661,1432,1229,116.5
35020, 군산시,035,30~34세,2021,13590,7473,6117,122.2,12131,6465,5666,114.1
35020, 군산시,035001, 30세,2021,2777,1565,1212,129.1,2454,1343,1111,120.9
35020, 군산시,035002, 31세,2021,2690,1465,1225,119.6,2402,1273,1129,112.8
35020, 군산시,035003, 32세,2021,2693,1472,1221,120.6,2415,1276,1139,112
35020, 군산시,035004, 33세,2021,2637,1427,1210,117.9,2366,1240,1126,110.1
35020, 군산시,035005, 34세,2021,2793,1544,1249,123.6,2494,1333,1161,114.8
35020, 군산시,040,35~39세,2021,17250,9117,8133,112.1,16213,8405,7808,107.6
35020, 군산시,040001, 35세,2021,2894,1575,1319,119.4,2672,1419,1253,113.2
35020, 군산시,040002, 36세,2021,2970,1552,1418,109.4,2766,1405,1361,103.2
35020, 군산시,040003, 37세,2021,3284,1759,1525,115.3,3059,1601,1458,109.8
35020, 군산시,040004, 38세,2021,3758,1971,1787,110.3,3560,1846,1714,107.7
35020, 군산시,040005, 39세,2021,4344,2260,2084,108.4,4156,2134,2022,105.5
35020, 군산시,045,40~44세,2021,20324,10719,9605,111.6,19567,10261,9306,110.3
35020, 군산시,045001, 40세,2021,4100,2177,1923,113.2,3943,2081,1862,111.8
35020, 군산시,045002, 41세,2021,4288,2292,1996,114.8,4121,2189,1932,113.3
35020, 군산시,045003, 42세,2021,4134,2190,1944,112.7,3948,2070,1878,110.2
35020, 군산시,045004, 43세,2021,3821,2009,1812,110.9,3689,1936,1753,110.4
35020, 군산시,045005, 44세,2021,3981,2051,1930,106.3,3866,1985,1881,105.5
35020, 군산시,050,45~49세,2021,22079,11536,10543,109.4,21548,11241,10307,109.1
35020, 군산시,050001, 45세,2021,3840,2001,1839,108.8,3721,1938,1783,108.7
35020, 군산시,050002, 46세,2021,4235,2171,2064,105.2,4129,2111,2018,104.6
35020, 군산시,050003, 47세,2021,4756,2448,2308,106.1,4663,2404,2259,106.4
35020, 군산시,050004, 48세,2021,4594,2420,2174,111.3,4487,2356,2131,110.6
35020, 군산시,050005, 49세,2021,4654,2496,2158,115.7,4548,2432,2116,114.9
35020, 군산시,055,50~54세,2021,23031,12028,11003,109.3,22554,11782,10772,109.4
35020, 군산시,055001, 50세,2021,4992,2632,2360,111.5,4888,2579,2309,111.7
35020, 군산시,055002, 51세,2021,4760,2516,2244,112.1,4650,2455,2195,111.8
35020, 군산시,055003, 52세,2021,4577,2422,2155,112.4,4489,2375,2114,112.3
35020, 군산시,055004, 53세,2021,4610,2388,2222,107.5,4506,2338,2168,107.8
35020, 군산시,055005, 54세,2021,4092,2070,2022,102.4,4021,2035,1986,102.5
35020, 군산시,060,55~59세,2021,20469,10664,9805,108.8,20079,10482,9597,109.2
35020, 군산시,060001, 55세,2021,4106,2161,1945,111.1,4023,2118,1905,111.2
35020, 군산시,060002, 56세,2021,4119,2124,1995,106.5,4040,2090,1950,107.2
35020, 군산시,060003, 57세,2021,3820,2000,1820,109.9,3755,1972,1783,110.6
35020, 군산시,060004, 58세,2021,4202,2185,2017,108.3,4112,2141,1971,108.6
35020, 군산시,060005, 59세,2021,4222,2194,2028,108.2,4149,2161,1988,108.7
35020, 군산시,065,60~64세,2021,21623,10634,10989,96.8,21402,10534,10868,96.9
35020, 군산시,065001, 60세,2021,4610,2317,2293,101,4571,2300,2271,101.3
35020, 군산시,065002, 61세,2021,4741,2258,2483,90.9,4695,2237,2458,91
35020, 군산시,065003, 62세,2021,4286,2074,2212,93.8,4239,2055,2184,94.1
35020, 군산시,065004, 63세,2021,3916,1886,2030,92.9,3870,1866,2004,93.1
35020, 군산시,065005, 64세,2021,4070,2099,1971,106.5,4027,2076,1951,106.4
35020, 군산시,070,65~69세,2021,16369,8069,8300,97.2,16241,8005,8236,97.2
35020, 군산시,070001, 65세,2021,3614,1793,1821,98.5,3576,1771,1805,98.1
35020, 군산시,070002, 66세,2021,3853,1909,1944,98.2,3829,1899,1930,98.4
35020, 군산시,070003, 67세,2021,3322,1659,1663,99.8,3298,1646,1652,99.6
35020, 군산시,070004, 68세,2021,2622,1245,1377,90.4,2599,1239,1360,91.1
35020, 군산시,070005, 69세,2021,2958,1463,1495,97.9,2939,1450,1489,97.4
35020, 군산시,075,70~74세,2021,13194,6247,6947,89.9,13120,6219,6901,90.1
35020, 군산시,075001, 70세,2021,2673,1293,1380,93.7,2656,1285,1371,93.7
35020, 군산시,075002, 71세,2021,2852,1378,1474,93.5,2837,1373,1464,93.8
35020, 군산시,075003, 72세,2021,2508,1183,1325,89.3,2491,1178,1313,89.7
35020, 군산시,075004, 73세,2021,2403,1102,1301,84.7,2393,1098,1295,84.8
35020, 군산시,075005, 74세,2021,2758,1291,1467,88,2743,1285,1458,88.1
35020, 군산시,080,75~79세,2021,9792,4246,5546,76.6,9757,4229,5528,76.5
35020, 군산시,080001, 75세,2021,2035,969,1066,90.9,2025,963,1062,90.7
35020, 군산시,080002, 76세,2021,1795,811,984,82.4,1782,804,978,82.2
35020, 군산시,080003, 77세,2021,1803,762,1041,73.2,1796,762,1034,73.7
35020, 군산시,080004, 78세,2021,1804,761,1043,73,1801,759,1042,72.8
35020, 군산시,080005, 79세,2021,2355,943,1412,66.8,2353,941,1412,66.6
35020, 군산시,085,80~84세,2021,6638,2452,4186,58.6,6623,2448,4175,58.6
35020, 군산시,085001, 80세,2021,1510,596,914,65.2,1508,595,913,65.2
35020, 군산시,085002, 81세,2021,1407,525,882,59.5,1405,525,880,59.7
35020, 군산시,085003, 82세,2021,1339,531,808,65.7,1334,529,805,65.7
35020, 군산시,085004, 83세,2021,1307,426,881,48.4,1303,425,878,48.4
35020, 군산시,085005, 84세,2021,1075,374,701,53.4,1073,374,699,53.5
35020, 군산시,090,85~89세,2021,3786,1141,2645,43.1,3777,1139,2638,43.2
35020, 군산시,090001, 85세,2021,954,332,622,53.4,951,331,620,53.4
35020, 군산시,090002, 86세,2021,901,278,623,44.6,899,278,621,44.8
35020, 군산시,090003, 87세,2021,711,228,483,47.2,709,228,481,47.4
35020, 군산시,090004, 88세,2021,676,188,488,38.5,676,188,488,38.5
35020, 군산시,090005, 89세,2021,544,115,429,26.8,542,114,428,26.6
35020, 군산시,095,90~94세,2021,1397,298,1099,27.1,1396,297,1099,27
35020, 군산시,095001, 90세,2021,417,97,320,30.3,416,96,320,30
35020, 군산시,095002, 91세,2021,367,75,292,25.7,367,75,292,25.7
35020, 군산시,095003, 92세,2021,252,71,181,39.2,252,71,181,39.2
35020, 군산시,095004, 93세,2021,206,28,178,15.7,206,28,178,15.7
35020, 군산시,095005, 94세,2021,155,27,128,21.1,155,27,128,21.1
35020, 군산시,100,95~99세,2021,247,36,211,17.1,247,36,211,17.1
35020, 군산시,100001, 95세,2021,94,17,77,22.1,94,17,77,22.1
35020, 군산시,100002, 96세,2021,50,7,43,16.3,50,7,43,16.3
35020, 군산시,100003, 97세,2021,44,5,39,12.8,44,5,39,12.8
35020, 군산시,100004, 98세,2021,43,7,36,19.4,43,7,36,19.4
35020, 군산시,100005, 99세,2021,16,X,16,0,16,X,16,0
35020, 군산시,101,100세이상,2021,36,5,31,16.1,36,5,31,16.1
35020, 군산시,102,15세미만,2021,32415,16588,15827,104.8,32264,16506,15758,104.7
35020, 군산시,103,15~64세,2021,183761,97331,86430,112.6,176400,92729,83671,110.8
35020, 군산시,104,65세이상,2021,51459,22494,28965,77.7,51197,22378,28819,77.7
35020, 군산시,086,85세이상,2021,5466,1480,3986,37.1,5456,1477,3979,37.1
35020, 군산시,126,평균연령,2021,44.5,43,45.9,,44.7,43.3,46.1,
35020, 군산시,127,중위연령,2021,46.2,44.6,47.8,,46.8,45.3,48.1,
35030, 익산시,000,합계,2021,280150,140166,139984,100.1,273945,137098,136847,100.2
35030, 익산시,005,0~4세,2021,6709,3387,3322,102,6648,3356,3292,101.9
35030, 익산시,005001, 0세,2021,1095,584,511,114.3,1079,578,501,115.4
35030, 익산시,005002, 1세,2021,1115,554,561,98.8,1107,551,556,99.1
35030, 익산시,005003, 2세,2021,1340,699,641,109,1326,690,636,108.5
35030, 익산시,005004, 3세,2021,1493,740,753,98.3,1482,734,748,98.1
35030, 익산시,005005, 4세,2021,1666,810,856,94.6,1654,803,851,94.4
35030, 익산시,010,5~9세,2021,10838,5629,5209,108.1,10798,5603,5195,107.9
35030, 익산시,010001, 5세,2021,1962,993,969,102.5,1953,986,967,102
35030, 익산시,010002, 6세,2021,2071,1092,979,111.5,2066,1087,979,111
35030, 익산시,010003, 7세,2021,2033,1063,970,109.6,2022,1055,967,109.1
35030, 익산시,010004, 8세,2021,2200,1160,1040,111.5,2191,1156,1035,111.7
35030, 익산시,010005, 9세,2021,2572,1321,1251,105.6,2566,1319,1247,105.8
35030, 익산시,015,10~14세,2021,12417,6303,6114,103.1,12381,6280,6101,102.9
35030, 익산시,015001, 10세,2021,2544,1283,1261,101.7,2536,1279,1257,101.8
35030, 익산시,015002, 11세,2021,2362,1188,1174,101.2,2354,1183,1171,101
35030, 익산시,015003, 12세,2021,2336,1197,1139,105.1,2326,1191,1135,104.9
35030, 익산시,015004, 13세,2021,2519,1270,1249,101.7,2513,1266,1247,101.5
35030, 익산시,015005, 14세,2021,2656,1365,1291,105.7,2652,1361,1291,105.4
35030, 익산시,020,15~19세,2021,14849,7999,6850,116.8,14794,7968,6826,116.7
35030, 익산시,020001, 15세,2021,2445,1253,1192,105.1,2441,1249,1192,104.8
35030, 익산시,020002, 16세,2021,2624,1421,1203,118.1,2619,1418,1201,118.1
35030, 익산시,020003, 17세,2021,2896,1541,1355,113.7,2893,1539,1354,113.7
35030, 익산시,020004, 18세,2021,3159,1708,1451,117.7,3152,1703,1449,117.5
35030, 익산시,020005, 19세,2021,3725,2076,1649,125.9,3689,2059,1630,126.3
35030, 익산시,025,20~24세,2021,21542,11858,9684,122.4,20620,11382,9238,123.2
35030, 익산시,025001, 20세,2021,3939,1969,1970,99.9,3894,1951,1943,100.4
35030, 익산시,025002, 21세,2021,4482,2310,2172,106.4,4362,2255,2107,107
35030, 익산시,025003, 22세,2021,4361,2426,1935,125.4,4187,2343,1844,127.1
35030, 익산시,025004, 23세,2021,4542,2698,1844,146.3,4219,2521,1698,148.5
35030, 익산시,025005, 24세,2021,4218,2455,1763,139.3,3958,2312,1646,140.5
35030, 익산시,030,25~29세,2021,17905,9978,7927,125.9,16587,9274,7313,126.8
35030, 익산시,030001, 25세,2021,3951,2296,1655,138.7,3691,2145,1546,138.7
35030, 익산시,030002, 26세,2021,3756,2105,1651,127.5,3472,1941,1531,126.8
35030, 익산시,030003, 27세,2021,3623,1989,1634,121.7,3341,1851,1490,124.2
35030, 익산시,030004, 28세,2021,3389,1880,1509,124.6,3147,1763,1384,127.4
35030, 익산시,030005, 29세,2021,3186,1708,1478,115.6,2936,1574,1362,115.6
35030, 익산시,035,30~34세,2021,13360,7250,6110,118.7,12333,6701,5632,119
35030, 익산시,035001, 30세,2021,2928,1569,1359,115.5,2708,1458,1250,116.6
35030, 익산시,035002, 31세,2021,2763,1524,1239,123,2548,1410,1138,123.9
35030, 익산시,035003, 32세,2021,2600,1478,1122,131.7,2386,1356,1030,131.7
35030, 익산시,035004, 33세,2021,2555,1350,1205,112,2354,1248,1106,112.8
35030, 익산시,035005, 34세,2021,2514,1329,1185,112.2,2337,1229,1108,110.9
35030, 익산시,040,35~39세,2021,14974,7631,7343,103.9,14207,7262,6945,104.6
35030, 익산시,040001, 35세,2021,2666,1343,1323,101.5,2491,1251,1240,100.9
35030, 익산시,040002, 36세,2021,2669,1331,1338,99.5,2505,1259,1246,101
35030, 익산시,040003, 37세,2021,2933,1520,1413,107.6,2772,1439,1333,108
35030, 익산시,040004, 38세,2021,3233,1630,1603,101.7,3083,1561,1522,102.6
35030, 익산시,040005, 39세,2021,3473,1807,1666,108.5,3356,1752,1604,109.2
35030, 익산시,045,40~44세,2021,18174,9228,8946,103.2,17616,8971,8645,103.8
35030, 익산시,045001, 40세,2021,3489,1791,1698,105.5,3363,1736,1627,106.7
35030, 익산시,045002, 41세,2021,3776,1912,1864,102.6,3663,1853,1810,102.4
35030, 익산시,045003, 42세,2021,3640,1853,1787,103.7,3511,1793,1718,104.4
35030, 익산시,045004, 43세,2021,3587,1827,1760,103.8,3478,1771,1707,103.7
35030, 익산시,045005, 44세,2021,3682,1845,1837,100.4,3601,1818,1783,102
35030, 익산시,050,45~49세,2021,21443,10871,10572,102.8,21037,10708,10329,103.7
35030, 익산시,050001, 45세,2021,3799,1992,1807,110.2,3719,1950,1769,110.2
35030, 익산시,050002, 46세,2021,3901,1974,1927,102.4,3807,1937,1870,103.6
35030, 익산시,050003, 47세,2021,4656,2364,2292,103.1,4583,2331,2252,103.5
35030, 익산시,050004, 48세,2021,4611,2273,2338,97.2,4527,2244,2283,98.3
35030, 익산시,050005, 49세,2021,4476,2268,2208,102.7,4401,2246,2155,104.2
35030, 익산시,055,50~54세,2021,24303,12137,12166,99.8,23956,11988,11968,100.2
35030, 익산시,055001, 50세,2021,4959,2520,2439,103.3,4885,2484,2401,103.5
35030, 익산시,055002, 51세,2021,4738,2354,2384,98.7,4657,2319,2338,99.2
35030, 익산시,055003, 52세,2021,4925,2469,2456,100.5,4850,2436,2414,100.9
35030, 익산시,055004, 53세,2021,4954,2488,2466,100.9,4890,2462,2428,101.4
35030, 익산시,055005, 54세,2021,4727,2306,2421,95.2,4674,2287,2387,95.8
35030, 익산시,060,55~59세,2021,23205,11816,11389,103.7,22888,11676,11212,104.1
35030, 익산시,060001, 55세,2021,4721,2445,2276,107.4,4656,2416,2240,107.9
35030, 익산시,060002, 56세,2021,4710,2362,2348,100.6,4650,2335,2315,100.9
35030, 익산시,060003, 57세,2021,4326,2201,2125,103.6,4256,2168,2088,103.8
35030, 익산시,060004, 58세,2021,4672,2374,2298,103.3,4610,2349,2261,103.9
35030, 익산시,060005, 59세,2021,4776,2434,2342,103.9,4716,2408,2308,104.3
35030, 익산시,065,60~64세,2021,23684,11804,11880,99.4,23489,11718,11771,99.5
35030, 익산시,065001, 60세,2021,5180,2552,2628,97.1,5147,2541,2606,97.5
35030, 익산시,065002, 61세,2021,5439,2668,2771,96.3,5384,2644,2740,96.5
35030, 익산시,065003, 62세,2021,4595,2335,2260,103.3,4554,2318,2236,103.7
35030, 익산시,065004, 63세,2021,4133,2071,2062,100.4,4102,2052,2050,100.1
35030, 익산시,065005, 64세,2021,4337,2178,2159,100.9,4302,2163,2139,101.1
35030, 익산시,070,65~69세,2021,17624,8601,9023,95.3,17553,8565,8988,95.3
35030, 익산시,070001, 65세,2021,3995,2004,1991,100.7,3980,1997,1983,100.7
35030, 익산시,070002, 66세,2021,4148,2009,2139,93.9,4128,2000,2128,94
35030, 익산시,070003, 67세,2021,3426,1629,1797,90.7,3416,1625,1791,90.7
35030, 익산시,070004, 68세,2021,2858,1417,1441,98.3,2841,1407,1434,98.1
35030, 익산시,070005, 69세,2021,3197,1542,1655,93.2,3188,1536,1652,93
35030, 익산시,075,70~74세,2021,13922,6581,7341,89.6,13879,6566,7313,89.8
35030, 익산시,075001, 70세,2021,2761,1355,1406,96.4,2753,1352,1401,96.5
35030, 익산시,075002, 71세,2021,3104,1474,1630,90.4,3088,1468,1620,90.6
35030, 익산시,075003, 72세,2021,2670,1222,1448,84.4,2666,1222,1444,84.6
35030, 익산시,075004, 73세,2021,2599,1191,1408,84.6,2587,1187,1400,84.8
35030, 익산시,075005, 74세,2021,2788,1339,1449,92.4,2785,1337,1448,92.3
35030, 익산시,080,75~79세,2021,10538,4485,6053,74.1,10522,4477,6045,74.1
35030, 익산시,080001, 75세,2021,2025,915,1110,82.4,2022,914,1108,82.5
35030, 익산시,080002, 76세,2021,1853,815,1038,78.5,1846,809,1037,78
35030, 익산시,080003, 77세,2021,1818,774,1044,74.1,1816,774,1042,74.3
35030, 익산시,080004, 78세,2021,2018,827,1191,69.4,2016,827,1189,69.6
35030, 익산시,080005, 79세,2021,2824,1154,1670,69.1,2822,1153,1669,69.1
35030, 익산시,085,80~84세,2021,7896,2777,5119,54.2,7879,2775,5104,54.4
35030, 익산시,085001, 80세,2021,1755,677,1078,62.8,1752,676,1076,62.8
35030, 익산시,085002, 81세,2021,1576,558,1018,54.8,1568,558,1010,55.2
35030, 익산시,085003, 82세,2021,1718,622,1096,56.8,1715,622,1093,56.9
35030, 익산시,085004, 83세,2021,1506,496,1010,49.1,1505,496,1009,49.2
35030, 익산시,085005, 84세,2021,1341,424,917,46.2,1339,423,916,46.2
35030, 익산시,090,85~89세,2021,4708,1407,3301,42.6,4704,1405,3299,42.6
35030, 익산시,090001, 85세,2021,1184,381,803,47.4,1182,380,802,47.4
35030, 익산시,090002, 86세,2021,1093,344,749,45.9,1092,343,749,45.8
35030, 익산시,090003, 87세,2021,930,282,648,43.5,929,282,647,43.6
35030, 익산시,090004, 88세,2021,852,224,628,35.7,852,224,628,35.7
35030, 익산시,090005, 89세,2021,649,176,473,37.2,649,176,473,37.2
35030, 익산시,095,90~94세,2021,1705,361,1344,26.9,1701,360,1341,26.8
35030, 익산시,095001, 90세,2021,496,98,398,24.6,494,97,397,24.4
35030, 익산시,095002, 91세,2021,417,98,319,30.7,417,98,319,30.7
35030, 익산시,095003, 92세,2021,338,76,262,29,336,76,260,29.2
35030, 익산시,095004, 93세,2021,263,54,209,25.8,263,54,209,25.8
35030, 익산시,095005, 94세,2021,191,35,156,22.4,191,35,156,22.4
35030, 익산시,100,95~99세,2021,318,58,260,22.3,317,58,259,22.4
35030, 익산시,100001, 95세,2021,99,20,79,25.3,99,20,79,25.3
35030, 익산시,100002, 96세,2021,80,16,64,25,79,16,63,25.4
35030, 익산시,100003, 97세,2021,61,13,48,27.1,61,13,48,27.1
35030, 익산시,100004, 98세,2021,47,X,44,6.8,47,X,44,6.8
35030, 익산시,100005, 99세,2021,31,6,25,24,31,6,25,24
35030, 익산시,101,100세이상,2021,36,5,31,16.1,36,5,31,16.1
35030, 익산시,102,15세미만,2021,29964,15319,14645,104.6,29827,15239,14588,104.5
35030, 익산시,103,15~64세,2021,193439,100572,92867,108.3,187527,97648,89879,108.6
35030, 익산시,104,65세이상,2021,56747,24275,32472,74.8,56591,24211,32380,74.8
35030, 익산시,086,85세이상,2021,6767,1831,4936,37.1,6758,1828,4930,37.1
35030, 익산시,126,평균연령,2021,45.1,43.5,46.8,,45.3,43.7,47,
35030, 익산시,127,중위연령,2021,47.3,45.4,49.1,,47.8,45.9,49.5,
35040, 정읍시,000,합계,2021,104463,51984,52479,99.1,100988,49939,51049,97.8
35040, 정읍시,005,0~4세,2021,2246,1134,1112,102,2227,1128,1099,102.6
35040, 정읍시,005001, 0세,2021,357,190,167,113.8,356,189,167,113.2
35040, 정읍시,005002, 1세,2021,372,187,185,101.1,369,187,182,102.7
35040, 정읍시,005003, 2세,2021,467,224,243,92.2,463,223,240,92.9
35040, 정읍시,005004, 3세,2021,533,254,279,91,526,251,275,91.3
35040, 정읍시,005005, 4세,2021,517,279,238,117.2,513,278,235,118.3
35040, 정읍시,010,5~9세,2021,3613,1864,1749,106.6,3592,1850,1742,106.2
35040, 정읍시,010001, 5세,2021,640,325,315,103.2,635,321,314,102.2
35040, 정읍시,010002, 6세,2021,689,374,315,118.7,681,368,313,117.6
35040, 정읍시,010003, 7세,2021,734,365,369,98.9,731,363,368,98.6
35040, 정읍시,010004, 8세,2021,692,359,333,107.8,689,357,332,107.5
35040, 정읍시,010005, 9세,2021,858,441,417,105.8,856,441,415,106.3
35040, 정읍시,015,10~14세,2021,4223,2239,1984,112.9,4213,2235,1978,113
35040, 정읍시,015001, 10세,2021,878,457,421,108.6,877,457,420,108.8
35040, 정읍시,015002, 11세,2021,791,424,367,115.5,788,422,366,115.3
35040, 정읍시,015003, 12세,2021,773,430,343,125.4,772,429,343,125.1
35040, 정읍시,015004, 13세,2021,858,454,404,112.4,855,453,402,112.7
35040, 정읍시,015005, 14세,2021,923,474,449,105.6,921,474,447,106
35040, 정읍시,020,15~19세,2021,4301,2249,2052,109.6,4273,2237,2036,109.9
35040, 정읍시,020001, 15세,2021,844,462,382,120.9,841,462,379,121.9
35040, 정읍시,020002, 16세,2021,863,437,426,102.6,861,435,426,102.1
35040, 정읍시,020003, 17세,2021,955,499,456,109.4,950,495,455,108.8
35040, 정읍시,020004, 18세,2021,903,460,443,103.8,898,457,441,103.6
35040, 정읍시,020005, 19세,2021,736,391,345,113.3,723,388,335,115.8
35040, 정읍시,025,20~24세,2021,5212,3004,2208,136.1,4588,2603,1985,131.1
35040, 정읍시,025001, 20세,2021,914,563,351,160.4,849,529,320,165.3
35040, 정읍시,025002, 21세,2021,1102,693,409,169.4,979,609,370,164.6
35040, 정읍시,025003, 22세,2021,1054,570,484,117.8,915,485,430,112.8
35040, 정읍시,025004, 23세,2021,1023,555,468,118.6,901,477,424,112.5
35040, 정읍시,025005, 24세,2021,1119,623,496,125.6,944,503,441,114.1
35040, 정읍시,030,25~29세,2021,5077,2909,2168,134.2,4382,2456,1926,127.5
35040, 정읍시,030001, 25세,2021,1133,651,482,135.1,971,534,437,122.2
35040, 정읍시,030002, 26세,2021,1058,635,423,150.1,900,530,370,143.2
35040, 정읍시,030003, 27세,2021,1044,594,450,132,916,511,405,126.2
35040, 정읍시,030004, 28세,2021,942,522,420,124.3,804,439,365,120.3
35040, 정읍시,030005, 29세,2021,900,507,393,129,791,442,349,126.6
35040, 정읍시,035,30~34세,2021,4268,2357,1911,123.3,3682,1982,1700,116.6
35040, 정읍시,035001, 30세,2021,856,500,356,140.4,755,433,322,134.5
35040, 정읍시,035002, 31세,2021,875,485,390,124.4,743,396,347,114.1
35040, 정읍시,035003, 32세,2021,835,453,382,118.6,719,383,336,114
35040, 정읍시,035004, 33세,2021,883,482,401,120.2,753,400,353,113.3
35040, 정읍시,035005, 34세,2021,819,437,382,114.4,712,370,342,108.2
35040, 정읍시,040,35~39세,2021,4813,2566,2247,114.2,4385,2321,2064,112.5
35040, 정읍시,040001, 35세,2021,848,461,387,119.1,752,402,350,114.9
35040, 정읍시,040002, 36세,2021,841,437,404,108.2,746,377,369,102.2
35040, 정읍시,040003, 37세,2021,963,510,453,112.6,871,462,409,113
35040, 정읍시,040004, 38세,2021,1020,563,457,123.2,945,525,420,125
35040, 정읍시,040005, 39세,2021,1141,595,546,109,1071,555,516,107.6
35040, 정읍시,045,40~44세,2021,6210,3204,3006,106.6,5903,3027,2876,105.3
35040, 정읍시,045001, 40세,2021,1154,607,547,111,1077,560,517,108.3
35040, 정읍시,045002, 41세,2021,1211,620,591,104.9,1149,583,566,103
35040, 정읍시,045003, 42세,2021,1282,662,620,106.8,1217,627,590,106.3
35040, 정읍시,045004, 43세,2021,1260,657,603,109,1202,619,583,106.2
35040, 정읍시,045005, 44세,2021,1303,658,645,102,1258,638,620,102.9
35040, 정읍시,050,45~49세,2021,7632,4033,3599,112.1,7443,3927,3516,111.7
35040, 정읍시,050001, 45세,2021,1320,700,620,112.9,1285,676,609,111
35040, 정읍시,050002, 46세,2021,1427,734,693,105.9,1387,711,676,105.2
35040, 정읍시,050003, 47세,2021,1641,875,766,114.2,1615,865,750,115.3
35040, 정읍시,050004, 48세,2021,1656,859,797,107.8,1604,834,770,108.3
35040, 정읍시,050005, 49세,2021,1588,865,723,119.6,1552,841,711,118.3
35040, 정읍시,055,50~54세,2021,8742,4641,4101,113.2,8569,4569,4000,114.2
35040, 정읍시,055001, 50세,2021,1783,933,850,109.8,1744,917,827,110.9
35040, 정읍시,055002, 51세,2021,1681,912,769,118.6,1639,892,747,119.4
35040, 정읍시,055003, 52세,2021,1773,940,833,112.8,1741,929,812,114.4
35040, 정읍시,055004, 53세,2021,1809,953,856,111.3,1771,935,836,111.8
35040, 정읍시,055005, 54세,2021,1696,903,793,113.9,1674,896,778,115.2
35040, 정읍시,060,55~59세,2021,8671,4622,4049,114.2,8528,4546,3982,114.2
35040, 정읍시,060001, 55세,2021,1708,935,773,121,1671,910,761,119.6
35040, 정읍시,060002, 56세,2021,1842,980,862,113.7,1808,965,843,114.5
35040, 정읍시,060003, 57세,2021,1636,848,788,107.6,1611,835,776,107.6
35040, 정읍시,060004, 58세,2021,1755,923,832,110.9,1729,911,818,111.4
35040, 정읍시,060005, 59세,2021,1730,936,794,117.9,1709,925,784,118
35040, 정읍시,065,60~64세,2021,9759,4986,4773,104.5,9634,4945,4689,105.5
35040, 정읍시,065001, 60세,2021,2172,1096,1076,101.9,2150,1089,1061,102.6
35040, 정읍시,065002, 61세,2021,2128,1055,1073,98.3,2091,1042,1049,99.3
35040, 정읍시,065003, 62세,2021,1835,974,861,113.1,1816,970,846,114.7
35040, 정읍시,065004, 63세,2021,1740,862,878,98.2,1712,853,859,99.3
35040, 정읍시,065005, 64세,2021,1884,999,885,112.9,1865,991,874,113.4
35040, 정읍시,070,65~69세,2021,7515,3574,3941,90.7,7436,3528,3908,90.3
35040, 정읍시,070001, 65세,2021,1532,759,773,98.2,1506,745,761,97.9
35040, 정읍시,070002, 66세,2021,1834,877,957,91.6,1817,866,951,91.1
35040, 정읍시,070003, 67세,2021,1511,704,807,87.2,1498,696,802,86.8
35040, 정읍시,070004, 68세,2021,1211,552,659,83.8,1199,545,654,83.3
35040, 정읍시,070005, 69세,2021,1427,682,745,91.5,1416,676,740,91.4
35040, 정읍시,075,70~74세,2021,6875,3228,3647,88.5,6849,3217,3632,88.6
35040, 정읍시,075001, 70세,2021,1220,564,656,86,1211,559,652,85.7
35040, 정읍시,075002, 71세,2021,1409,671,738,90.9,1401,667,734,90.9
35040, 정읍시,075003, 72세,2021,1441,667,774,86.2,1439,666,773,86.2
35040, 정읍시,075004, 73세,2021,1336,660,676,97.6,1333,660,673,98.1
35040, 정읍시,075005, 74세,2021,1469,666,803,82.9,1465,665,800,83.1
35040, 정읍시,080,75~79세,2021,5943,2394,3549,67.5,5930,2390,3540,67.5
35040, 정읍시,080001, 75세,2021,1097,504,593,85,1096,504,592,85.1
35040, 정읍시,080002, 76세,2021,1025,408,617,66.1,1022,408,614,66.4
35040, 정읍시,080003, 77세,2021,1060,432,628,68.8,1057,431,626,68.8
35040, 정읍시,080004, 78세,2021,1157,456,701,65,1155,455,700,65
35040, 정읍시,080005, 79세,2021,1604,594,1010,58.8,1600,592,1008,58.7
35040, 정읍시,085,80~84세,2021,5057,1828,3229,56.6,5050,1826,3224,56.6
35040, 정읍시,085001, 80세,2021,1145,426,719,59.2,1142,425,717,59.3
35040, 정읍시,085002, 81세,2021,1062,411,651,63.1,1060,411,649,63.3
35040, 정읍시,085003, 82세,2021,1056,367,689,53.3,1055,367,688,53.3
35040, 정읍시,085004, 83세,2021,951,346,605,57.2,951,346,605,57.2
35040, 정읍시,085005, 84세,2021,843,278,565,49.2,842,277,565,49
35040, 정읍시,090,85~89세,2021,3104,914,2190,41.7,3102,914,2188,41.8
35040, 정읍시,090001, 85세,2021,810,263,547,48.1,809,263,546,48.2
35040, 정읍시,090002, 86세,2021,771,234,537,43.6,771,234,537,43.6
35040, 정읍시,090003, 87세,2021,633,194,439,44.2,633,194,439,44.2
35040, 정읍시,090004, 88세,2021,512,139,373,37.3,512,139,373,37.3
35040, 정읍시,090005, 89세,2021,378,84,294,28.6,377,84,293,28.7
35040, 정읍시,095,90~94세,2021,1011,205,806,25.4,1011,205,806,25.4
35040, 정읍시,095001, 90세,2021,296,63,233,27,296,63,233,27
35040, 정읍시,095002, 91세,2021,255,52,203,25.6,255,52,203,25.6
35040, 정읍시,095003, 92세,2021,187,42,145,29,187,42,145,29
35040, 정읍시,095004, 93세,2021,162,32,130,24.6,162,32,130,24.6
35040, 정읍시,095005, 94세,2021,111,16,95,16.8,111,16,95,16.8
35040, 정읍시,100,95~99세,2021,161,30,131,22.9,161,30,131,22.9
35040, 정읍시,100001, 95세,2021,47,8,39,20.5,47,8,39,20.5
35040, 정읍시,100002, 96세,2021,40,8,32,25,40,8,32,25
35040, 정읍시,100003, 97세,2021,32,8,24,33.3,32,8,24,33.3
35040, 정읍시,100004, 98세,2021,25,X,22,13.6,25,X,22,13.6
35040, 정읍시,100005, 99세,2021,17,X,14,21.4,17,X,14,21.4
35040, 정읍시,101,100세이상,2021,30,X,27,11.1,30,X,27,11.1
35040, 정읍시,102,15세미만,2021,10082,5237,4845,108.1,10032,5213,4819,108.2
35040, 정읍시,103,15~64세,2021,64685,34571,30114,114.8,61387,32613,28774,113.3
35040, 정읍시,104,65세이상,2021,29696,12176,17520,69.5,29569,12113,17456,69.4
35040, 정읍시,086,85세이상,2021,4306,1152,3154,36.5,4304,1152,3152,36.5
35040, 정읍시,126,평균연령,2021,49.8,47.4,52,,50.2,48,52.4,
35040, 정읍시,127,중위연령,2021,52.7,50.5,55.1,,53.4,51.3,55.8,
35050, 남원시,000,합계,2021,76551,37396,39155,95.5,75273,36888,38385,96.1
35050, 남원시,005,0~4세,2021,1969,1037,932,111.3,1962,1033,929,111.2
35050, 남원시,005001, 0세,2021,341,181,160,113.1,339,180,159,113.2
35050, 남원시,005002, 1세,2021,369,184,185,99.5,368,184,184,100
35050, 남원시,005003, 2세,2021,380,195,185,105.4,379,194,185,104.9
35050, 남원시,005004, 3세,2021,415,237,178,133.1,414,237,177,133.9
35050, 남원시,005005, 4세,2021,464,240,224,107.1,462,238,224,106.3
35050, 남원시,010,5~9세,2021,2655,1410,1245,113.3,2644,1404,1240,113.2
35050, 남원시,010001, 5세,2021,496,258,238,108.4,492,255,237,107.6
35050, 남원시,010002, 6세,2021,479,264,215,122.8,476,263,213,123.5
35050, 남원시,010003, 7세,2021,537,276,261,105.7,534,274,260,105.4
35050, 남원시,010004, 8세,2021,556,289,267,108.2,555,289,266,108.6
35050, 남원시,010005, 9세,2021,587,323,264,122.3,587,323,264,122.3
35050, 남원시,015,10~14세,2021,3230,1691,1539,109.9,3220,1685,1535,109.8
35050, 남원시,015001, 10세,2021,646,327,319,102.5,644,326,318,102.5
35050, 남원시,015002, 11세,2021,634,325,309,105.2,631,324,307,105.5
35050, 남원시,015003, 12세,2021,598,336,262,128.2,597,336,261,128.7
35050, 남원시,015004, 13세,2021,685,367,318,115.4,681,363,318,114.2
35050, 남원시,015005, 14세,2021,667,336,331,101.5,667,336,331,101.5
35050, 남원시,020,15~19세,2021,3202,1666,1536,108.5,3192,1660,1532,108.4
35050, 남원시,020001, 15세,2021,653,329,324,101.5,653,329,324,101.5
35050, 남원시,020002, 16세,2021,698,352,346,101.7,698,352,346,101.7
35050, 남원시,020003, 17세,2021,714,365,349,104.6,708,361,347,104
35050, 남원시,020004, 18세,2021,688,367,321,114.3,687,366,321,114
35050, 남원시,020005, 19세,2021,449,253,196,129.1,446,252,194,129.9
35050, 남원시,025,20~24세,2021,3040,1842,1198,153.8,2951,1800,1151,156.4
35050, 남원시,025001, 20세,2021,573,381,192,198.4,570,379,191,198.4
35050, 남원시,025002, 21세,2021,639,429,210,204.3,631,425,206,206.3
35050, 남원시,025003, 22세,2021,561,340,221,153.8,540,332,208,159.6
35050, 남원시,025004, 23세,2021,637,361,276,130.8,609,347,262,132.4
35050, 남원시,025005, 24세,2021,630,331,299,110.7,601,317,284,111.6
35050, 남원시,030,25~29세,2021,3331,1799,1532,117.4,3129,1712,1417,120.8
35050, 남원시,030001, 25세,2021,719,392,327,119.9,686,374,312,119.9
35050, 남원시,030002, 26세,2021,679,368,311,118.3,630,348,282,123.4
35050, 남원시,030003, 27세,2021,662,367,295,124.4,615,347,268,129.5
35050, 남원시,030004, 28세,2021,635,324,311,104.2,590,305,285,107
35050, 남원시,030005, 29세,2021,636,348,288,120.8,608,338,270,125.2
35050, 남원시,035,30~34세,2021,2839,1447,1392,104,2645,1369,1276,107.3
35050, 남원시,035001, 30세,2021,563,287,276,104,523,273,250,109.2
35050, 남원시,035002, 31세,2021,565,290,275,105.5,523,268,255,105.1
35050, 남원시,035003, 32세,2021,577,290,287,101,541,274,267,102.6
35050, 남원시,035004, 33세,2021,570,288,282,102.1,532,277,255,108.6
35050, 남원시,035005, 34세,2021,564,292,272,107.4,526,277,249,111.2
35050, 남원시,040,35~39세,2021,3349,1672,1677,99.7,3166,1615,1551,104.1
35050, 남원시,040001, 35세,2021,585,281,304,92.4,547,268,279,96.1
35050, 남원시,040002, 36세,2021,613,299,314,95.2,578,287,291,98.6
35050, 남원시,040003, 37세,2021,651,323,328,98.5,607,311,296,105.1
35050, 남원시,040004, 38세,2021,735,381,354,107.6,701,365,336,108.6
35050, 남원시,040005, 39세,2021,765,388,377,102.9,733,384,349,110
35050, 남원시,045,40~44세,2021,4327,2113,2214,95.4,4195,2064,2131,96.9
35050, 남원시,045001, 40세,2021,768,386,382,101,745,377,368,102.4
35050, 남원시,045002, 41세,2021,920,438,482,90.9,885,428,457,93.7
35050, 남원시,045003, 42세,2021,887,440,447,98.4,862,430,432,99.5
35050, 남원시,045004, 43세,2021,836,410,426,96.2,814,402,412,97.6
35050, 남원시,045005, 44세,2021,916,439,477,92,889,427,462,92.4
35050, 남원시,050,45~49세,2021,5638,2916,2722,107.1,5508,2865,2643,108.4
35050, 남원시,050001, 45세,2021,952,476,476,100,927,462,465,99.4
35050, 남원시,050002, 46세,2021,994,478,516,92.6,974,471,503,93.6
35050, 남원시,050003, 47세,2021,1206,637,569,112,1184,630,554,113.7
35050, 남원시,050004, 48세,2021,1229,666,563,118.3,1207,656,551,119.1
35050, 남원시,050005, 49세,2021,1257,659,598,110.2,1216,646,570,113.3
35050, 남원시,055,50~54세,2021,6725,3544,3181,111.4,6629,3508,3121,112.4
35050, 남원시,055001, 50세,2021,1350,707,643,110,1333,698,635,109.9
35050, 남원시,055002, 51세,2021,1208,675,533,126.6,1188,669,519,128.9
35050, 남원시,055003, 52세,2021,1442,775,667,116.2,1420,766,654,117.1
35050, 남원시,055004, 53세,2021,1396,705,691,102,1376,698,678,102.9
35050, 남원시,055005, 54세,2021,1329,682,647,105.4,1312,677,635,106.6
35050, 남원시,060,55~59세,2021,6433,3429,3004,114.1,6343,3396,2947,115.2
35050, 남원시,060001, 55세,2021,1338,678,660,102.7,1319,673,646,104.2
35050, 남원시,060002, 56세,2021,1315,703,612,114.9,1290,696,594,117.2
35050, 남원시,060003, 57세,2021,1056,574,482,119.1,1034,564,470,120
35050, 남원시,060004, 58세,2021,1294,705,589,119.7,1280,698,582,119.9
35050, 남원시,060005, 59세,2021,1430,769,661,116.3,1420,765,655,116.8
35050, 남원시,065,60~64세,2021,7240,3628,3612,100.4,7171,3601,3570,100.9
35050, 남원시,065001, 60세,2021,1563,746,817,91.3,1551,743,808,92
35050, 남원시,065002, 61세,2021,1685,859,826,104,1671,854,817,104.5
35050, 남원시,065003, 62세,2021,1417,706,711,99.3,1405,700,705,99.3
35050, 남원시,065004, 63세,2021,1283,650,633,102.7,1265,645,620,104
35050, 남원시,065005, 64세,2021,1292,667,625,106.7,1279,659,620,106.3
35050, 남원시,070,65~69세,2021,5876,2886,2990,96.5,5842,2867,2975,96.4
35050, 남원시,070001, 65세,2021,1242,583,659,88.5,1230,578,652,88.7
35050, 남원시,070002, 66세,2021,1364,668,696,96,1355,662,693,95.5
35050, 남원시,070003, 67세,2021,1162,593,569,104.2,1156,588,568,103.5
35050, 남원시,070004, 68세,2021,992,507,485,104.5,989,506,483,104.8
35050, 남원시,070005, 69세,2021,1116,535,581,92.1,1112,533,579,92.1
35050, 남원시,075,70~74세,2021,5212,2370,2842,83.4,5201,2366,2835,83.5
35050, 남원시,075001, 70세,2021,944,456,488,93.4,941,455,486,93.6
35050, 남원시,075002, 71세,2021,1062,503,559,90,1060,502,558,90
35050, 남원시,075003, 72세,2021,1012,435,577,75.4,1009,434,575,75.5
35050, 남원시,075004, 73세,2021,1056,446,610,73.1,1054,445,609,73.1
35050, 남원시,075005, 74세,2021,1138,530,608,87.2,1137,530,607,87.3
35050, 남원시,080,75~79세,2021,4311,1680,2631,63.9,4306,1679,2627,63.9
35050, 남원시,080001, 75세,2021,824,373,451,82.7,823,373,450,82.9
35050, 남원시,080002, 76세,2021,726,299,427,70,724,298,426,70
35050, 남원시,080003, 77세,2021,723,277,446,62.1,722,277,445,62.2
35050, 남원시,080004, 78세,2021,797,310,487,63.7,797,310,487,63.7
35050, 남원시,080005, 79세,2021,1241,421,820,51.3,1240,421,819,51.4
35050, 남원시,085,80~84세,2021,3817,1362,2455,55.5,3815,1361,2454,55.5
35050, 남원시,085001, 80세,2021,897,355,542,65.5,896,354,542,65.3
35050, 남원시,085002, 81세,2021,746,274,472,58.1,746,274,472,58.1
35050, 남원시,085003, 82세,2021,788,269,519,51.8,787,269,518,51.9
35050, 남원시,085004, 83세,2021,709,241,468,51.5,709,241,468,51.5
35050, 남원시,085005, 84세,2021,677,223,454,49.1,677,223,454,49.1
35050, 남원시,090,85~89세,2021,2354,670,1684,39.8,2353,670,1683,39.8
35050, 남원시,090001, 85세,2021,604,198,406,48.8,604,198,406,48.8
35050, 남원시,090002, 86세,2021,588,167,421,39.7,587,167,420,39.8
35050, 남원시,090003, 87세,2021,527,138,389,35.5,527,138,389,35.5
35050, 남원시,090004, 88세,2021,317,87,230,37.8,317,87,230,37.8
35050, 남원시,090005, 89세,2021,318,80,238,33.6,318,80,238,33.6
35050, 남원시,095,90~94세,2021,786,189,597,31.7,785,189,596,31.7
35050, 남원시,095001, 90세,2021,234,64,170,37.6,234,64,170,37.6
35050, 남원시,095002, 91세,2021,179,45,134,33.6,179,45,134,33.6
35050, 남원시,095003, 92세,2021,134,33,101,32.7,133,33,100,33
35050, 남원시,095004, 93세,2021,147,31,116,26.7,147,31,116,26.7
35050, 남원시,095005, 94세,2021,92,16,76,21.1,92,16,76,21.1
35050, 남원시,100,95~99세,2021,192,42,150,28,191,41,150,27.3
35050, 남원시,100001, 95세,2021,63,11,52,21.2,63,11,52,21.2
35050, 남원시,100002, 96세,2021,39,10,29,34.5,38,9,29,31
35050, 남원시,100003, 97세,2021,27,X,24,12.5,27,X,24,12.5
35050, 남원시,100004, 98세,2021,36,12,24,50,36,12,24,50
35050, 남원시,100005, 99세,2021,27,6,21,28.6,27,6,21,28.6
35050, 남원시,101,100세이상,2021,25,X,22,13.6,25,X,22,13.6
35050, 남원시,102,15세미만,2021,7854,4138,3716,111.4,7826,4122,3704,111.3
35050, 남원시,103,15~64세,2021,46124,24056,22068,109,44929,23590,21339,110.5
35050, 남원시,104,65세이상,2021,22573,9202,13371,68.8,22518,9176,13342,68.8
35050, 남원시,086,85세이상,2021,3357,904,2453,36.9,3354,903,2451,36.8
35050, 남원시,126,평균연령,2021,50.3,47.9,52.6,,50.5,48,52.8,
35050, 남원시,127,중위연령,2021,53.5,51.6,55.6,,53.8,51.8,56,
35060, 김제시,000,합계,2021,77998,38721,39277,98.6,75616,37127,38489,96.5
35060, 김제시,005,0~4세,2021,1465,749,716,104.6,1458,744,714,104.2
35060, 김제시,005001, 0세,2021,235,118,117,100.9,234,117,117,100
35060, 김제시,005002, 1세,2021,277,136,141,96.5,274,134,140,95.7
35060, 김제시,005003, 2세,2021,243,126,117,107.7,243,126,117,107.7
35060, 김제시,005004, 3세,2021,334,177,157,112.7,333,176,157,112.1
35060, 김제시,005005, 4세,2021,376,192,184,104.3,374,191,183,104.4
35060, 김제시,010,5~9세,2021,2379,1251,1128,110.9,2373,1247,1126,110.7
35060, 김제시,010001, 5세,2021,403,216,187,115.5,402,215,187,115
35060, 김제시,010002, 6세,2021,452,224,228,98.2,451,224,227,98.7
35060, 김제시,010003, 7세,2021,470,253,217,116.6,470,253,217,116.6
35060, 김제시,010004, 8세,2021,487,263,224,117.4,485,262,223,117.5
35060, 김제시,010005, 9세,2021,567,295,272,108.5,565,293,272,107.7
35060, 김제시,015,10~14세,2021,2776,1389,1387,100.1,2774,1388,1386,100.1
35060, 김제시,015001, 10세,2021,589,280,309,90.6,588,280,308,90.9
35060, 김제시,015002, 11세,2021,537,272,265,102.6,537,272,265,102.6
35060, 김제시,015003, 12세,2021,537,268,269,99.6,537,268,269,99.6
35060, 김제시,015004, 13세,2021,523,270,253,106.7,523,270,253,106.7
35060, 김제시,015005, 14세,2021,590,299,291,102.7,589,298,291,102.4
35060, 김제시,020,15~19세,2021,2778,1460,1318,110.8,2772,1457,1315,110.8
35060, 김제시,020001, 15세,2021,556,296,260,113.8,555,295,260,113.5
35060, 김제시,020002, 16세,2021,573,316,257,123,573,316,257,123
35060, 김제시,020003, 17세,2021,565,267,298,89.6,564,267,297,89.9
35060, 김제시,020004, 18세,2021,610,318,292,108.9,607,316,291,108.6
35060, 김제시,020005, 19세,2021,474,263,211,124.6,473,263,210,125.2
35060, 김제시,025,20~24세,2021,3232,1976,1256,157.3,3065,1856,1209,153.5
35060, 김제시,025001, 20세,2021,599,389,210,185.2,590,383,207,185
35060, 김제시,025002, 21세,2021,658,400,258,155,643,390,253,154.2
35060, 김제시,025003, 22세,2021,631,380,251,151.4,601,358,243,147.3
35060, 김제시,025004, 23세,2021,665,407,258,157.8,620,378,242,156.2
35060, 김제시,025005, 24세,2021,679,400,279,143.4,611,347,264,131.4
35060, 김제시,030,25~29세,2021,3579,2089,1490,140.2,3074,1714,1360,126
35060, 김제시,030001, 25세,2021,725,436,289,150.9,632,369,263,140.3
35060, 김제시,030002, 26세,2021,761,440,321,137.1,677,378,299,126.4
35060, 김제시,030003, 27세,2021,754,442,312,141.7,660,376,284,132.4
35060, 김제시,030004, 28세,2021,703,413,290,142.4,589,323,266,121.4
35060, 김제시,030005, 29세,2021,636,358,278,128.8,516,268,248,108.1
35060, 김제시,035,30~34세,2021,3130,1789,1341,133.4,2609,1423,1186,120
35060, 김제시,035001, 30세,2021,618,355,263,135,505,282,223,126.5
35060, 김제시,035002, 31세,2021,615,363,252,144,522,294,228,128.9
35060, 김제시,035003, 32세,2021,619,369,250,147.6,509,292,217,134.6
35060, 김제시,035004, 33세,2021,632,331,301,110,531,261,270,96.7
35060, 김제시,035005, 34세,2021,646,371,275,134.9,542,294,248,118.5
35060, 김제시,040,35~39세,2021,3577,1965,1612,121.9,3151,1667,1484,112.3
35060, 김제시,040001, 35세,2021,621,352,269,130.9,513,269,244,110.2
35060, 김제시,040002, 36세,2021,670,360,310,116.1,579,294,285,103.2
35060, 김제시,040003, 37세,2021,720,389,331,117.5,646,345,301,114.6
35060, 김제시,040004, 38세,2021,731,393,338,116.3,640,330,310,106.5
35060, 김제시,040005, 39세,2021,835,471,364,129.4,773,429,344,124.7
35060, 김제시,045,40~44세,2021,4195,2295,1900,120.8,3911,2104,1807,116.4
35060, 김제시,045001, 40세,2021,844,462,382,120.9,791,425,366,116.1
35060, 김제시,045002, 41세,2021,843,458,385,119,778,417,361,115.5
35060, 김제시,045003, 42세,2021,819,442,377,117.2,756,398,358,111.2
35060, 김제시,045004, 43세,2021,807,458,349,131.2,753,422,331,127.5
35060, 김제시,045005, 44세,2021,882,475,407,116.7,833,442,391,113
35060, 김제시,050,45~49세,2021,5043,2794,2249,124.2,4896,2699,2197,122.8
35060, 김제시,050001, 45세,2021,878,478,400,119.5,843,453,390,116.2
35060, 김제시,050002, 46세,2021,889,482,407,118.4,863,465,398,116.8
35060, 김제시,050003, 47세,2021,1089,622,467,133.2,1067,607,460,132
35060, 김제시,050004, 48세,2021,1091,592,499,118.6,1063,575,488,117.8
35060, 김제시,050005, 49세,2021,1096,620,476,130.3,1060,599,461,129.9
35060, 김제시,055,50~54세,2021,5979,3238,2741,118.1,5878,3191,2687,118.8
35060, 김제시,055001, 50세,2021,1116,631,485,130.1,1094,620,474,130.8
35060, 김제시,055002, 51세,2021,1173,635,538,118,1155,625,530,117.9
35060, 김제시,055003, 52세,2021,1166,625,541,115.5,1142,613,529,115.9
35060, 김제시,055004, 53세,2021,1295,681,614,110.9,1273,671,602,111.5
35060, 김제시,055005, 54세,2021,1229,666,563,118.3,1214,662,552,119.9
35060, 김제시,060,55~59세,2021,6508,3409,3099,110,6399,3360,3039,110.6
35060, 김제시,060001, 55세,2021,1201,666,535,124.5,1180,660,520,126.9
35060, 김제시,060002, 56세,2021,1289,686,603,113.8,1268,677,591,114.6
35060, 김제시,060003, 57세,2021,1253,660,593,111.3,1230,645,585,110.3
35060, 김제시,060004, 58세,2021,1367,688,679,101.3,1345,679,666,102
35060, 김제시,060005, 59세,2021,1398,709,689,102.9,1376,699,677,103.2
35060, 김제시,065,60~64세,2021,7798,3880,3918,99,7747,3860,3887,99.3
35060, 김제시,065001, 60세,2021,1608,823,785,104.8,1598,820,778,105.4
35060, 김제시,065002, 61세,2021,1814,889,925,96.1,1801,886,915,96.8
35060, 김제시,065003, 62세,2021,1439,705,734,96,1428,700,728,96.2
35060, 김제시,065004, 63세,2021,1425,686,739,92.8,1417,681,736,92.5
35060, 김제시,065005, 64세,2021,1512,777,735,105.7,1503,773,730,105.9
35060, 김제시,070,65~69세,2021,6431,3113,3318,93.8,6403,3102,3301,94
35060, 김제시,070001, 65세,2021,1393,708,685,103.4,1389,705,684,103.1
35060, 김제시,070002, 66세,2021,1497,734,763,96.2,1496,733,763,96.1
35060, 김제시,070003, 67세,2021,1281,600,681,88.1,1272,597,675,88.4
35060, 김제시,070004, 68세,2021,1032,496,536,92.5,1025,495,530,93.4
35060, 김제시,070005, 69세,2021,1228,575,653,88.1,1221,572,649,88.1
35060, 김제시,075,70~74세,2021,5929,2729,3200,85.3,5916,2725,3191,85.4
35060, 김제시,075001, 70세,2021,1150,550,600,91.7,1146,549,597,92
35060, 김제시,075002, 71세,2021,1309,585,724,80.8,1304,582,722,80.6
35060, 김제시,075003, 72세,2021,1123,506,617,82,1122,506,616,82.1
35060, 김제시,075004, 73세,2021,1070,529,541,97.8,1068,529,539,98.1
35060, 김제시,075005, 74세,2021,1277,559,718,77.9,1276,559,717,78
35060, 김제시,080,75~79세,2021,5006,2052,2954,69.5,5002,2049,2953,69.4
35060, 김제시,080001, 75세,2021,908,421,487,86.4,906,420,486,86.4
35060, 김제시,080002, 76세,2021,846,352,494,71.3,845,351,494,71.1
35060, 김제시,080003, 77세,2021,887,358,529,67.7,887,358,529,67.7
35060, 김제시,080004, 78세,2021,947,376,571,65.8,946,375,571,65.7
35060, 김제시,080005, 79세,2021,1418,545,873,62.4,1418,545,873,62.4
35060, 김제시,085,80~84세,2021,4248,1482,2766,53.6,4246,1482,2764,53.6
35060, 김제시,085001, 80세,2021,911,351,560,62.7,911,351,560,62.7
35060, 김제시,085002, 81세,2021,844,290,554,52.3,844,290,554,52.3
35060, 김제시,085003, 82세,2021,919,315,604,52.2,918,315,603,52.2
35060, 김제시,085004, 83세,2021,817,268,549,48.8,817,268,549,48.8
35060, 김제시,085005, 84세,2021,757,258,499,51.7,756,258,498,51.8
35060, 김제시,090,85~89세,2021,2785,790,1995,39.6,2783,788,1995,39.5
35060, 김제시,090001, 85세,2021,678,193,485,39.8,678,193,485,39.8
35060, 김제시,090002, 86세,2021,659,220,439,50.1,658,219,439,49.9
35060, 김제시,090003, 87세,2021,568,165,403,40.9,568,165,403,40.9
35060, 김제시,090004, 88세,2021,525,125,400,31.3,524,124,400,31
35060, 김제시,090005, 89세,2021,355,87,268,32.5,355,87,268,32.5
35060, 김제시,095,90~94세,2021,963,224,739,30.3,962,224,738,30.4
35060, 김제시,095001, 90세,2021,255,71,184,38.6,255,71,184,38.6
35060, 김제시,095002, 91세,2021,271,54,217,24.9,271,54,217,24.9
35060, 김제시,095003, 92세,2021,205,47,158,29.7,205,47,158,29.7
35060, 김제시,095004, 93세,2021,138,34,104,32.7,137,34,103,33
35060, 김제시,095005, 94세,2021,94,18,76,23.7,94,18,76,23.7
35060, 김제시,100,95~99세,2021,168,43,125,34.4,168,43,125,34.4
35060, 김제시,100001, 95세,2021,58,15,43,34.9,58,15,43,34.9
35060, 김제시,100002, 96세,2021,41,8,33,24.2,41,8,33,24.2
35060, 김제시,100003, 97세,2021,22,8,14,57.1,22,8,14,57.1
35060, 김제시,100004, 98세,2021,25,5,20,25,25,5,20,25
35060, 김제시,100005, 99세,2021,22,7,15,46.7,22,7,15,46.7
35060, 김제시,101,100세이상,2021,29,X,25,16,29,X,25,16
35060, 김제시,102,15세미만,2021,6620,3389,3231,104.9,6605,3379,3226,104.7
35060, 김제시,103,15~64세,2021,45819,24895,20924,119,43502,23331,20171,115.7
35060, 김제시,104,65세이상,2021,25559,10437,15122,69,25509,10417,15092,69
35060, 김제시,086,85세이상,2021,3945,1061,2884,36.8,3942,1059,2883,36.7
35060, 김제시,126,평균연령,2021,52.1,49.3,54.7,,52.5,49.9,55,
35060, 김제시,127,중위연령,2021,55.7,52.5,59.1,,56.5,53.6,59.6,
35310, 완주군,000,합계,2021,95029,48851,46178,105.8,90892,46451,44441,104.5
35310, 완주군,005,0~4세,2021,2414,1171,1243,94.2,2384,1155,1229,94
35310, 완주군,005001, 0세,2021,372,183,189,96.8,363,177,186,95.2
35310, 완주군,005002, 1세,2021,403,210,193,108.8,397,209,188,111.2
35310, 완주군,005003, 2세,2021,489,232,257,90.3,483,229,254,90.2
35310, 완주군,005004, 3세,2021,518,236,282,83.7,514,233,281,82.9
35310, 완주군,005005, 4세,2021,632,310,322,96.3,627,307,320,95.9
35310, 완주군,010,5~9세,2021,3925,1977,1948,101.5,3911,1966,1945,101.1
35310, 완주군,010001, 5세,2021,704,343,361,95,703,342,361,94.7
35310, 완주군,010002, 6세,2021,778,398,380,104.7,773,393,380,103.4
35310, 완주군,010003, 7세,2021,746,363,383,94.8,741,360,381,94.5
35310, 완주군,010004, 8세,2021,816,417,399,104.5,816,417,399,104.5
35310, 완주군,010005, 9세,2021,881,456,425,107.3,878,454,424,107.1
35310, 완주군,015,10~14세,2021,4127,2149,1978,108.6,4123,2147,1976,108.7
35310, 완주군,015001, 10세,2021,849,459,390,117.7,847,457,390,117.2
35310, 완주군,015002, 11세,2021,888,477,411,116.1,887,477,410,116.3
35310, 완주군,015003, 12세,2021,751,369,382,96.6,751,369,382,96.6
35310, 완주군,015004, 13세,2021,800,416,384,108.3,800,416,384,108.3
35310, 완주군,015005, 14세,2021,839,428,411,104.1,838,428,410,104.4
35310, 완주군,020,15~19세,2021,4736,2573,2163,119,4643,2513,2130,118
35310, 완주군,020001, 15세,2021,743,386,357,108.1,743,386,357,108.1
35310, 완주군,020002, 16세,2021,826,419,407,102.9,822,416,406,102.5
35310, 완주군,020003, 17세,2021,818,450,368,122.3,815,449,366,122.7
35310, 완주군,020004, 18세,2021,921,486,435,111.7,899,472,427,110.5
35310, 완주군,020005, 19세,2021,1428,832,596,139.6,1364,790,574,137.6
35310, 완주군,025,20~24세,2021,7081,4140,2941,140.8,5991,3422,2569,133.2
35310, 완주군,025001, 20세,2021,1528,793,735,107.9,1437,736,701,105
35310, 완주군,025002, 21세,2021,1551,848,703,120.6,1322,695,627,110.8
35310, 완주군,025003, 22세,2021,1441,859,582,147.6,1212,706,506,139.5
35310, 완주군,025004, 23세,2021,1324,845,479,176.4,1040,655,385,170.1
35310, 완주군,025005, 24세,2021,1237,795,442,179.9,980,630,350,180
35310, 완주군,030,25~29세,2021,5209,3009,2200,136.8,4324,2472,1852,133.5
35310, 완주군,030001, 25세,2021,1105,641,464,138.1,892,510,382,133.5
35310, 완주군,030002, 26세,2021,1074,647,427,151.5,878,519,359,144.6
35310, 완주군,030003, 27세,2021,1045,611,434,140.8,869,504,365,138.1
35310, 완주군,030004, 28세,2021,1018,569,449,126.7,868,484,384,126
35310, 완주군,030005, 29세,2021,967,541,426,127,817,455,362,125.7
35310, 완주군,035,30~34세,2021,4377,2349,2028,115.8,3750,1994,1756,113.6
35310, 완주군,035001, 30세,2021,898,495,403,122.8,764,410,354,115.8
35310, 완주군,035002, 31세,2021,866,490,376,130.3,715,405,310,130.6
35310, 완주군,035003, 32세,2021,832,446,386,115.5,708,374,334,112
35310, 완주군,035004, 33세,2021,874,463,411,112.7,761,399,362,110.2
35310, 완주군,035005, 34세,2021,907,455,452,100.7,802,406,396,102.5
35310, 완주군,040,35~39세,2021,5322,2738,2584,106,4869,2494,2375,105
35310, 완주군,040001, 35세,2021,923,473,450,105.1,816,410,406,101
35310, 완주군,040002, 36세,2021,990,509,481,105.8,896,457,439,104.1
35310, 완주군,040003, 37세,2021,1005,522,483,108.1,910,471,439,107.3
35310, 완주군,040004, 38세,2021,1128,576,552,104.3,1048,544,504,107.9
35310, 완주군,040005, 39세,2021,1276,658,618,106.5,1199,612,587,104.3
35310, 완주군,045,40~44세,2021,6382,3401,2981,114.1,6097,3253,2844,114.4
35310, 완주군,045001, 40세,2021,1319,692,627,110.4,1249,650,599,108.5
35310, 완주군,045002, 41세,2021,1381,725,656,110.5,1311,686,625,109.8
35310, 완주군,045003, 42세,2021,1306,699,607,115.2,1243,669,574,116.6
35310, 완주군,045004, 43세,2021,1187,644,543,118.6,1141,624,517,120.7
35310, 완주군,045005, 44세,2021,1189,641,548,117,1153,624,529,118
35310, 완주군,050,45~49세,2021,6844,3780,3064,123.4,6623,3682,2941,125.2
35310, 완주군,050001, 45세,2021,1277,708,569,124.4,1225,686,539,127.3
35310, 완주군,050002, 46세,2021,1305,734,571,128.5,1260,716,544,131.6
35310, 완주군,050003, 47세,2021,1441,801,640,125.2,1394,779,615,126.7
35310, 완주군,050004, 48세,2021,1421,769,652,117.9,1379,752,627,119.9
35310, 완주군,050005, 49세,2021,1400,768,632,121.5,1365,749,616,121.6
35310, 완주군,055,50~54세,2021,7499,4141,3358,123.3,7336,4051,3285,123.3
35310, 완주군,055001, 50세,2021,1592,888,704,126.1,1558,868,690,125.8
35310, 완주군,055002, 51세,2021,1429,780,649,120.2,1398,765,633,120.9
35310, 완주군,055003, 52세,2021,1449,788,661,119.2,1415,770,645,119.4
35310, 완주군,055004, 53세,2021,1632,913,719,127,1597,894,703,127.2
35310, 완주군,055005, 54세,2021,1397,772,625,123.5,1368,754,614,122.8
35310, 완주군,060,55~59세,2021,7390,3954,3436,115.1,7257,3892,3365,115.7
35310, 완주군,060001, 55세,2021,1515,835,680,122.8,1482,821,661,124.2
35310, 완주군,060002, 56세,2021,1468,786,682,115.2,1438,773,665,116.2
35310, 완주군,060003, 57세,2021,1339,725,614,118.1,1321,714,607,117.6
35310, 완주군,060004, 58세,2021,1499,776,723,107.3,1472,764,708,107.9
35310, 완주군,060005, 59세,2021,1569,832,737,112.9,1544,820,724,113.3
35310, 완주군,065,60~64세,2021,7906,4065,3841,105.8,7826,4024,3802,105.8
35310, 완주군,065001, 60세,2021,1786,924,862,107.2,1767,916,851,107.6
35310, 완주군,065002, 61세,2021,1799,935,864,108.2,1783,928,855,108.5
35310, 완주군,065003, 62세,2021,1530,775,755,102.6,1518,771,747,103.2
35310, 완주군,065004, 63세,2021,1377,716,661,108.3,1360,704,656,107.3
35310, 완주군,065005, 64세,2021,1414,715,699,102.3,1398,705,693,101.7
35310, 완주군,070,65~69세,2021,6169,3120,3049,102.3,6142,3109,3033,102.5
35310, 완주군,070001, 65세,2021,1375,695,680,102.2,1368,693,675,102.7
35310, 완주군,070002, 66세,2021,1473,764,709,107.8,1465,761,704,108.1
35310, 완주군,070003, 67세,2021,1282,634,648,97.8,1279,631,648,97.4
35310, 완주군,070004, 68세,2021,951,495,456,108.6,946,493,453,108.8
35310, 완주군,070005, 69세,2021,1088,532,556,95.7,1084,531,553,96
35310, 완주군,075,70~74세,2021,5030,2453,2577,95.2,5011,2448,2563,95.5
35310, 완주군,075001, 70세,2021,962,490,472,103.8,959,490,469,104.5
35310, 완주군,075002, 71세,2021,1118,552,566,97.5,1114,551,563,97.9
35310, 완주군,075003, 72세,2021,966,460,506,90.9,961,458,503,91.1
35310, 완주군,075004, 73세,2021,944,455,489,93,940,453,487,93
35310, 완주군,075005, 74세,2021,1040,496,544,91.2,1037,496,541,91.7
35310, 완주군,080,75~79세,2021,4103,1724,2379,72.5,4093,1722,2371,72.6
35310, 완주군,080001, 75세,2021,813,401,412,97.3,809,401,408,98.3
35310, 완주군,080002, 76세,2021,714,299,415,72,711,297,414,71.7
35310, 완주군,080003, 77세,2021,739,312,427,73.1,738,312,426,73.2
35310, 완주군,080004, 78세,2021,736,291,445,65.4,734,291,443,65.7
35310, 완주군,080005, 79세,2021,1101,421,680,61.9,1101,421,680,61.9
35310, 완주군,085,80~84세,2021,3413,1238,2175,56.9,3411,1238,2173,57
35310, 완주군,085001, 80세,2021,743,282,461,61.2,743,282,461,61.2
35310, 완주군,085002, 81세,2021,676,240,436,55,676,240,436,55
35310, 완주군,085003, 82세,2021,721,269,452,59.5,721,269,452,59.5
35310, 완주군,085004, 83세,2021,677,245,432,56.7,676,245,431,56.8
35310, 완주군,085005, 84세,2021,596,202,394,51.3,595,202,393,51.4
35310, 완주군,090,85~89세,2021,2149,649,1500,43.3,2148,649,1499,43.3
35310, 완주군,090001, 85세,2021,567,166,401,41.4,567,166,401,41.4
35310, 완주군,090002, 86세,2021,545,186,359,51.8,545,186,359,51.8
35310, 완주군,090003, 87세,2021,437,131,306,42.8,437,131,306,42.8
35310, 완주군,090004, 88세,2021,345,101,244,41.4,344,101,243,41.6
35310, 완주군,090005, 89세,2021,255,65,190,34.2,255,65,190,34.2
35310, 완주군,095,90~94세,2021,778,187,591,31.6,778,187,591,31.6
35310, 완주군,095001, 90세,2021,226,63,163,38.7,226,63,163,38.7
35310, 완주군,095002, 91세,2021,193,36,157,22.9,193,36,157,22.9
35310, 완주군,095003, 92세,2021,149,30,119,25.2,149,30,119,25.2
35310, 완주군,095004, 93세,2021,117,31,86,36,117,31,86,36
35310, 완주군,095005, 94세,2021,93,27,66,40.9,93,27,66,40.9
35310, 완주군,100,95~99세,2021,156,26,130,20,156,26,130,20
35310, 완주군,100001, 95세,2021,54,11,43,25.6,54,11,43,25.6
35310, 완주군,100002, 96세,2021,39,5,34,14.7,39,5,34,14.7
35310, 완주군,100003, 97세,2021,15,X,11,36.4,15,X,11,36.4
35310, 완주군,100004, 98세,2021,27,X,25,8,27,X,25,8
35310, 완주군,100005, 99세,2021,21,X,17,23.5,21,X,17,23.5
35310, 완주군,101,100세이상,2021,19,7,12,58.3,19,7,12,58.3
35310, 완주군,102,15세미만,2021,10466,5297,5169,102.5,10418,5268,5150,102.3
35310, 완주군,103,15~64세,2021,62746,34150,28596,119.4,58716,31797,26919,118.1
35310, 완주군,104,65세이상,2021,21817,9404,12413,75.8,21758,9386,12372,75.9
35310, 완주군,086,85세이상,2021,3102,869,2233,38.9,3101,869,2232,38.9
35310, 완주군,126,평균연령,2021,46.1,44.4,47.9,,46.7,45,48.4,
35310, 완주군,127,중위연령,2021,47.9,46.3,49.9,,49.1,47.5,50.9,
35320, 진안군,000,합계,2021,22760,11351,11409,99.5,22313,11183,11130,100.5
35320, 진안군,005,0~4세,2021,541,288,253,113.8,539,287,252,113.9
35320, 진안군,005001, 0세,2021,111,64,47,136.2,111,64,47,136.2
35320, 진안군,005002, 1세,2021,126,60,66,90.9,126,60,66,90.9
35320, 진안군,005003, 2세,2021,109,60,49,122.4,109,60,49,122.4
35320, 진안군,005004, 3세,2021,101,47,54,87,101,47,54,87
35320, 진안군,005005, 4세,2021,94,57,37,154.1,92,56,36,155.6
35320, 진안군,010,5~9세,2021,562,249,313,79.6,561,249,312,79.8
35320, 진안군,010001, 5세,2021,112,51,61,83.6,112,51,61,83.6
35320, 진안군,010002, 6세,2021,94,42,52,80.8,94,42,52,80.8
35320, 진안군,010003, 7세,2021,108,45,63,71.4,108,45,63,71.4
35320, 진안군,010004, 8세,2021,123,56,67,83.6,123,56,67,83.6
35320, 진안군,010005, 9세,2021,125,55,70,78.6,124,55,69,79.7
35320, 진안군,015,10~14세,2021,717,381,336,113.4,711,379,332,114.2
35320, 진안군,015001, 10세,2021,158,88,70,125.7,157,88,69,127.5
35320, 진안군,015002, 11세,2021,159,86,73,117.8,158,86,72,119.4
35320, 진안군,015003, 12세,2021,132,65,67,97,131,64,67,95.5
35320, 진안군,015004, 13세,2021,130,69,61,113.1,129,69,60,115
35320, 진안군,015005, 14세,2021,138,73,65,112.3,136,72,64,112.5
35320, 진안군,020,15~19세,2021,717,378,339,111.5,712,376,336,111.9
35320, 진안군,020001, 15세,2021,160,82,78,105.1,160,82,78,105.1
35320, 진안군,020002, 16세,2021,148,86,62,138.7,148,86,62,138.7
35320, 진안군,020003, 17세,2021,164,84,80,105,164,84,80,105
35320, 진안군,020004, 18세,2021,148,72,76,94.7,145,70,75,93.3
35320, 진안군,020005, 19세,2021,97,54,43,125.6,95,54,41,131.7
35320, 진안군,025,20~24세,2021,751,453,298,152,709,435,274,158.8
35320, 진안군,025001, 20세,2021,125,86,39,220.5,124,86,38,226.3
35320, 진안군,025002, 21세,2021,155,101,54,187,153,100,53,188.7
35320, 진안군,025003, 22세,2021,137,82,55,149.1,127,79,48,164.6
35320, 진안군,025004, 23세,2021,163,91,72,126.4,147,83,64,129.7
35320, 진안군,025005, 24세,2021,171,93,78,119.2,158,87,71,122.5
35320, 진안군,030,25~29세,2021,772,427,345,123.8,698,391,307,127.4
35320, 진안군,030001, 25세,2021,169,91,78,116.7,150,80,70,114.3
35320, 진안군,030002, 26세,2021,136,79,57,138.6,128,75,53,141.5
35320, 진안군,030003, 27세,2021,154,91,63,144.4,142,85,57,149.1
35320, 진안군,030004, 28세,2021,171,93,78,119.2,152,83,69,120.3
35320, 진안군,030005, 29세,2021,142,73,69,105.8,126,68,58,117.2
35320, 진안군,035,30~34세,2021,695,343,352,97.4,617,312,305,102.3
35320, 진안군,035001, 30세,2021,152,86,66,130.3,131,74,57,129.8
35320, 진안군,035002, 31세,2021,145,74,71,104.2,128,65,63,103.2
35320, 진안군,035003, 32세,2021,127,55,72,76.4,114,52,62,83.9
35320, 진안군,035004, 33세,2021,136,65,71,91.5,120,61,59,103.4
35320, 진안군,035005, 34세,2021,135,63,72,87.5,124,60,64,93.8
35320, 진안군,040,35~39세,2021,810,374,436,85.8,742,350,392,89.3
35320, 진안군,040001, 35세,2021,140,61,79,77.2,129,57,72,79.2
35320, 진안군,040002, 36세,2021,167,68,99,68.7,147,62,85,72.9
35320, 진안군,040003, 37세,2021,165,77,88,87.5,154,73,81,90.1
35320, 진안군,040004, 38세,2021,160,77,83,92.8,147,71,76,93.4
35320, 진안군,040005, 39세,2021,178,91,87,104.6,165,87,78,111.5
35320, 진안군,045,40~44세,2021,986,546,440,124.1,951,538,413,130.3
35320, 진안군,045001, 40세,2021,183,95,88,108,176,92,84,109.5
35320, 진안군,045002, 41세,2021,213,117,96,121.9,206,116,90,128.9
35320, 진안군,045003, 42세,2021,187,102,85,120,179,100,79,126.6
35320, 진안군,045004, 43세,2021,168,92,76,121.1,162,90,72,125
35320, 진안군,045005, 44세,2021,235,140,95,147.4,228,140,88,159.1
35320, 진안군,050,45~49세,2021,1294,754,540,139.6,1265,747,518,144.2
35320, 진안군,050001, 45세,2021,219,127,92,138,212,125,87,143.7
35320, 진안군,050002, 46세,2021,225,131,94,139.4,220,129,91,141.8
35320, 진안군,050003, 47세,2021,287,176,111,158.6,282,175,107,163.6
35320, 진안군,050004, 48세,2021,273,143,130,110,267,142,125,113.6
35320, 진안군,050005, 49세,2021,290,177,113,156.6,284,176,108,163
35320, 진안군,055,50~54세,2021,1772,974,798,122.1,1737,962,775,124.1
35320, 진안군,055001, 50세,2021,310,175,135,129.6,303,172,131,131.3
35320, 진안군,055002, 51세,2021,334,162,172,94.2,322,158,164,96.3
35320, 진안군,055003, 52세,2021,376,217,159,136.5,369,215,154,139.6
35320, 진안군,055004, 53세,2021,381,207,174,119,376,205,171,119.9
35320, 진안군,055005, 54세,2021,371,213,158,134.8,367,212,155,136.8
35320, 진안군,060,55~59세,2021,2173,1190,983,121.1,2133,1180,953,123.8
35320, 진안군,060001, 55세,2021,431,246,185,133,425,246,179,137.4
35320, 진안군,060002, 56세,2021,448,249,199,125.1,434,243,191,127.2
35320, 진안군,060003, 57세,2021,370,198,172,115.1,367,198,169,117.2
35320, 진안군,060004, 58세,2021,445,242,203,119.2,438,241,197,122.3
35320, 진안군,060005, 59세,2021,479,255,224,113.8,469,252,217,116.1
35320, 진안군,065,60~64세,2021,2631,1389,1242,111.8,2620,1384,1236,112
35320, 진안군,065001, 60세,2021,598,325,273,119,597,325,272,119.5
35320, 진안군,065002, 61세,2021,618,327,291,112.4,611,322,289,111.4
35320, 진안군,065003, 62세,2021,505,258,247,104.5,504,258,246,104.9
35320, 진안군,065004, 63세,2021,443,221,222,99.5,443,221,222,99.5
35320, 진안군,065005, 64세,2021,467,258,209,123.4,465,258,207,124.6
35320, 진안군,070,65~69세,2021,2138,1098,1040,105.6,2127,1093,1034,105.7
35320, 진안군,070001, 65세,2021,427,222,205,108.3,425,221,204,108.3
35320, 진안군,070002, 66세,2021,512,257,255,100.8,508,256,252,101.6
35320, 진안군,070003, 67세,2021,434,229,205,111.7,432,227,205,110.7
35320, 진안군,070004, 68세,2021,363,173,190,91.1,361,173,188,92
35320, 진안군,070005, 69세,2021,402,217,185,117.3,401,216,185,116.8
35320, 진안군,075,70~74세,2021,1927,914,1013,90.2,1919,909,1010,90
35320, 진안군,075001, 70세,2021,324,156,168,92.9,321,154,167,92.2
35320, 진안군,075002, 71세,2021,439,212,227,93.4,438,211,227,93
35320, 진안군,075003, 72세,2021,387,187,200,93.5,385,187,198,94.4
35320, 진안군,075004, 73세,2021,380,177,203,87.2,378,175,203,86.2
35320, 진안군,075005, 74세,2021,397,182,215,84.7,397,182,215,84.7
35320, 진안군,080,75~79세,2021,1653,730,923,79.1,1651,728,923,78.9
35320, 진안군,080001, 75세,2021,287,136,151,90.1,286,135,151,89.4
35320, 진안군,080002, 76세,2021,309,148,161,91.9,309,148,161,91.9
35320, 진안군,080003, 77세,2021,274,125,149,83.9,273,124,149,83.2
35320, 진안군,080004, 78세,2021,328,128,200,64,328,128,200,64
35320, 진안군,080005, 79세,2021,455,193,262,73.7,455,193,262,73.7
35320, 진안군,085,80~84세,2021,1457,522,935,55.8,1457,522,935,55.8
35320, 진안군,085001, 80세,2021,318,131,187,70.1,318,131,187,70.1
35320, 진안군,085002, 81세,2021,300,118,182,64.8,300,118,182,64.8
35320, 진안군,085003, 82세,2021,325,108,217,49.8,325,108,217,49.8
35320, 진안군,085004, 83세,2021,255,82,173,47.4,255,82,173,47.4
35320, 진안군,085005, 84세,2021,259,83,176,47.2,259,83,176,47.2
35320, 진안군,090,85~89세,2021,869,269,600,44.8,869,269,600,44.8
35320, 진안군,090001, 85세,2021,246,81,165,49.1,246,81,165,49.1
35320, 진안군,090002, 86세,2021,205,70,135,51.9,205,70,135,51.9
35320, 진안군,090003, 87세,2021,182,53,129,41.1,182,53,129,41.1
35320, 진안군,090004, 88세,2021,141,42,99,42.4,141,42,99,42.4
35320, 진안군,090005, 89세,2021,95,23,72,31.9,95,23,72,31.9
35320, 진안군,095,90~94세,2021,238,60,178,33.7,238,60,178,33.7
35320, 진안군,095001, 90세,2021,69,17,52,32.7,69,17,52,32.7
35320, 진안군,095002, 91세,2021,55,8,47,17,55,8,47,17
35320, 진안군,095003, 92세,2021,53,18,35,51.4,53,18,35,51.4
35320, 진안군,095004, 93세,2021,25,6,19,31.6,25,6,19,31.6
35320, 진안군,095005, 94세,2021,36,11,25,44,36,11,25,44
35320, 진안군,100,95~99세,2021,50,11,39,28.2,50,11,39,28.2
35320, 진안군,100001, 95세,2021,17,X,14,21.4,17,X,14,21.4
35320, 진안군,100002, 96세,2021,12,X,9,33.3,12,X,9,33.3
35320, 진안군,100003, 97세,2021,8,X,5,60,8,X,5,60
35320, 진안군,100004, 98세,2021,6,X,6,0,6,X,6,0
35320, 진안군,100005, 99세,2021,7,X,5,40,7,X,5,40
35320, 진안군,101,100세이상,2021,7,X,6,16.7,7,X,6,16.7
35320, 진안군,102,15세미만,2021,1820,918,902,101.8,1811,915,896,102.1
35320, 진안군,103,15~64세,2021,12601,6828,5773,118.3,12184,6675,5509,121.2
35320, 진안군,104,65세이상,2021,8339,3605,4734,76.2,8318,3593,4725,76
35320, 진안군,086,85세이상,2021,1164,341,823,41.4,1164,341,823,41.4
35320, 진안군,126,평균연령,2021,54.5,52.5,56.4,,54.8,52.8,56.8,
35320, 진안군,127,중위연령,2021,59.1,57.1,61,,59.5,57.4,61.4,
35330, 무주군,000,합계,2021,22305,11011,11294,97.5,22027,10933,11094,98.5
35330, 무주군,005,0~4세,2021,388,192,196,98,388,192,196,98
35330, 무주군,005001, 0세,2021,66,35,31,112.9,66,35,31,112.9
35330, 무주군,005002, 1세,2021,82,43,39,110.3,82,43,39,110.3
35330, 무주군,005003, 2세,2021,74,35,39,89.7,74,35,39,89.7
35330, 무주군,005004, 3세,2021,74,42,32,131.3,74,42,32,131.3
35330, 무주군,005005, 4세,2021,92,37,55,67.3,92,37,55,67.3
35330, 무주군,010,5~9세,2021,663,374,289,129.4,663,374,289,129.4
35330, 무주군,010001, 5세,2021,115,65,50,130,115,65,50,130
35330, 무주군,010002, 6세,2021,123,65,58,112.1,123,65,58,112.1
35330, 무주군,010003, 7세,2021,142,90,52,173.1,142,90,52,173.1
35330, 무주군,010004, 8세,2021,143,77,66,116.7,143,77,66,116.7
35330, 무주군,010005, 9세,2021,140,77,63,122.2,140,77,63,122.2
35330, 무주군,015,10~14세,2021,855,424,431,98.4,855,424,431,98.4
35330, 무주군,015001, 10세,2021,183,90,93,96.8,183,90,93,96.8
35330, 무주군,015002, 11세,2021,142,75,67,111.9,142,75,67,111.9
35330, 무주군,015003, 12세,2021,170,76,94,80.9,170,76,94,80.9
35330, 무주군,015004, 13세,2021,163,84,79,106.3,163,84,79,106.3
35330, 무주군,015005, 14세,2021,197,99,98,101,197,99,98,101
35330, 무주군,020,15~19세,2021,756,387,369,104.9,755,387,368,105.2
35330, 무주군,020001, 15세,2021,156,81,75,108,156,81,75,108
35330, 무주군,020002, 16세,2021,172,74,98,75.5,172,74,98,75.5
35330, 무주군,020003, 17세,2021,180,101,79,127.8,179,101,78,129.5
35330, 무주군,020004, 18세,2021,150,77,73,105.5,150,77,73,105.5
35330, 무주군,020005, 19세,2021,98,54,44,122.7,98,54,44,122.7
35330, 무주군,025,20~24세,2021,660,399,261,152.9,643,393,250,157.2
35330, 무주군,025001, 20세,2021,136,88,48,183.3,135,87,48,181.3
35330, 무주군,025002, 21세,2021,154,97,57,170.2,150,95,55,172.7
35330, 무주군,025003, 22세,2021,122,78,44,177.3,118,77,41,187.8
35330, 무주군,025004, 23세,2021,132,71,61,116.4,128,71,57,124.6
35330, 무주군,025005, 24세,2021,116,65,51,127.5,112,63,49,128.6
35330, 무주군,030,25~29세,2021,784,406,378,107.4,734,388,346,112.1
35330, 무주군,030001, 25세,2021,157,84,73,115.1,146,78,68,114.7
35330, 무주군,030002, 26세,2021,178,93,85,109.4,170,89,81,109.9
35330, 무주군,030003, 27세,2021,138,74,64,115.6,126,72,54,133.3
35330, 무주군,030004, 28세,2021,148,79,69,114.5,138,76,62,122.6
35330, 무주군,030005, 29세,2021,163,76,87,87.4,154,73,81,90.1
35330, 무주군,035,30~34세,2021,735,387,348,111.2,689,374,315,118.7
35330, 무주군,035001, 30세,2021,151,80,71,112.7,141,78,63,123.8
35330, 무주군,035002, 31세,2021,150,76,74,102.7,144,75,69,108.7
35330, 무주군,035003, 32세,2021,120,70,50,140,114,66,48,137.5
35330, 무주군,035004, 33세,2021,159,87,72,120.8,148,82,66,124.2
35330, 무주군,035005, 34세,2021,155,74,81,91.4,142,73,69,105.8
35330, 무주군,040,35~39세,2021,848,455,393,115.8,811,451,360,125.3
35330, 무주군,040001, 35세,2021,145,77,68,113.2,137,76,61,124.6
35330, 무주군,040002, 36세,2021,151,79,72,109.7,144,78,66,118.2
35330, 무주군,040003, 37세,2021,161,77,84,91.7,154,77,77,100
35330, 무주군,040004, 38세,2021,195,115,80,143.8,187,114,73,156.2
35330, 무주군,040005, 39세,2021,196,107,89,120.2,189,106,83,127.7
35330, 무주군,045,40~44세,2021,1129,588,541,108.7,1096,580,516,112.4
35330, 무주군,045001, 40세,2021,202,103,99,104,193,99,94,105.3
35330, 무주군,045002, 41세,2021,219,110,109,100.9,215,110,105,104.8
35330, 무주군,045003, 42세,2021,237,133,104,127.9,231,130,101,128.7
35330, 무주군,045004, 43세,2021,212,106,106,100,205,106,99,107.1
35330, 무주군,045005, 44세,2021,259,136,123,110.6,252,135,117,115.4
35330, 무주군,050,45~49세,2021,1478,836,642,130.2,1445,828,617,134.2
35330, 무주군,050001, 45세,2021,266,147,119,123.5,258,144,114,126.3
35330, 무주군,050002, 46세,2021,264,153,111,137.8,258,153,105,145.7
35330, 무주군,050003, 47세,2021,332,179,153,117,324,176,148,118.9
35330, 무주군,050004, 48세,2021,340,194,146,132.9,337,193,144,134
35330, 무주군,050005, 49세,2021,276,163,113,144.2,268,162,106,152.8
35330, 무주군,055,50~54세,2021,1830,1012,818,123.7,1810,1007,803,125.4
35330, 무주군,055001, 50세,2021,355,193,162,119.1,349,192,157,122.3
35330, 무주군,055002, 51세,2021,318,192,126,152.4,315,191,124,154
35330, 무주군,055003, 52세,2021,364,196,168,116.7,359,194,165,117.6
35330, 무주군,055004, 53세,2021,400,224,176,127.3,398,224,174,128.7
35330, 무주군,055005, 54세,2021,393,207,186,111.3,389,206,183,112.6
35330, 무주군,060,55~59세,2021,2033,1097,936,117.2,2014,1091,923,118.2
35330, 무주군,060001, 55세,2021,400,220,180,122.2,395,219,176,124.4
35330, 무주군,060002, 56세,2021,384,212,172,123.3,380,211,169,124.9
35330, 무주군,060003, 57세,2021,341,180,161,111.8,335,178,157,113.4
35330, 무주군,060004, 58세,2021,406,222,184,120.7,402,220,182,120.9
35330, 무주군,060005, 59세,2021,502,263,239,110,502,263,239,110
35330, 무주군,065,60~64세,2021,2433,1257,1176,106.9,2421,1253,1168,107.3
35330, 무주군,065001, 60세,2021,519,262,257,101.9,518,262,256,102.3
35330, 무주군,065002, 61세,2021,513,275,238,115.5,510,273,237,115.2
35330, 무주군,065003, 62세,2021,457,242,215,112.6,454,241,213,113.1
35330, 무주군,065004, 63세,2021,462,232,230,100.9,457,231,226,102.2
35330, 무주군,065005, 64세,2021,482,246,236,104.2,482,246,236,104.2
35330, 무주군,070,65~69세,2021,1960,994,966,102.9,1953,989,964,102.6
35330, 무주군,070001, 65세,2021,386,203,183,110.9,384,202,182,111
35330, 무주군,070002, 66세,2021,445,225,220,102.3,443,224,219,102.3
35330, 무주군,070003, 67세,2021,428,225,203,110.8,426,223,203,109.9
35330, 무주군,070004, 68세,2021,303,151,152,99.3,302,150,152,98.7
35330, 무주군,070005, 69세,2021,398,190,208,91.3,398,190,208,91.3
35330, 무주군,075,70~74세,2021,1625,743,882,84.2,1623,743,880,84.4
35330, 무주군,075001, 70세,2021,322,151,171,88.3,320,151,169,89.3
35330, 무주군,075002, 71세,2021,369,169,200,84.5,369,169,200,84.5
35330, 무주군,075003, 72세,2021,275,141,134,105.2,275,141,134,105.2
35330, 무주군,075004, 73세,2021,336,148,188,78.7,336,148,188,78.7
35330, 무주군,075005, 74세,2021,323,134,189,70.9,323,134,189,70.9
35330, 무주군,080,75~79세,2021,1545,591,954,61.9,1544,590,954,61.8
35330, 무주군,080001, 75세,2021,293,123,170,72.4,293,123,170,72.4
35330, 무주군,080002, 76세,2021,242,91,151,60.3,242,91,151,60.3
35330, 무주군,080003, 77세,2021,260,111,149,74.5,260,111,149,74.5
35330, 무주군,080004, 78세,2021,336,116,220,52.7,335,115,220,52.3
35330, 무주군,080005, 79세,2021,414,150,264,56.8,414,150,264,56.8
35330, 무주군,085,80~84세,2021,1443,533,910,58.6,1443,533,910,58.6
35330, 무주군,085001, 80세,2021,345,139,206,67.5,345,139,206,67.5
35330, 무주군,085002, 81세,2021,298,114,184,62,298,114,184,62
35330, 무주군,085003, 82세,2021,292,96,196,49,292,96,196,49
35330, 무주군,085004, 83세,2021,277,106,171,62,277,106,171,62
35330, 무주군,085005, 84세,2021,231,78,153,51,231,78,153,51
35330, 무주군,090,85~89세,2021,824,268,556,48.2,824,268,556,48.2
35330, 무주군,090001, 85세,2021,232,79,153,51.6,232,79,153,51.6
35330, 무주군,090002, 86세,2021,194,68,126,54,194,68,126,54
35330, 무주군,090003, 87세,2021,162,45,117,38.5,162,45,117,38.5
35330, 무주군,090004, 88세,2021,133,40,93,43,133,40,93,43
35330, 무주군,090005, 89세,2021,103,36,67,53.7,103,36,67,53.7
35330, 무주군,095,90~94세,2021,241,56,185,30.3,241,56,185,30.3
35330, 무주군,095001, 90세,2021,80,24,56,42.9,80,24,56,42.9
35330, 무주군,095002, 91세,2021,54,7,47,14.9,54,7,47,14.9
35330, 무주군,095003, 92세,2021,38,8,30,26.7,38,8,30,26.7
35330, 무주군,095004, 93세,2021,40,6,34,17.6,40,6,34,17.6
35330, 무주군,095005, 94세,2021,29,11,18,61.1,29,11,18,61.1
35330, 무주군,100,95~99세,2021,59,10,49,20.4,59,10,49,20.4
35330, 무주군,100001, 95세,2021,25,X,21,19,25,X,21,19
35330, 무주군,100002, 96세,2021,15,X,13,15.4,15,X,13,15.4
35330, 무주군,100003, 97세,2021,7,X,6,16.7,7,X,6,16.7
35330, 무주군,100004, 98세,2021,X,X,X,100,X,X,X,100
35330, 무주군,100005, 99세,2021,8,X,7,14.3,8,X,7,14.3
35330, 무주군,101,100세이상,2021,16,X,14,14.3,16,X,14,14.3
35330, 무주군,102,15세미만,2021,1906,990,916,108.1,1906,990,916,108.1
35330, 무주군,103,15~64세,2021,12686,6824,5862,116.4,12418,6752,5666,119.2
35330, 무주군,104,65세이상,2021,7713,3197,4516,70.8,7703,3191,4512,70.7
35330, 무주군,086,85세이상,2021,1140,336,804,41.8,1140,336,804,41.8
35330, 무주군,126,평균연령,2021,53.6,51.3,55.9,,53.8,51.4,56.1,
35330, 무주군,127,중위연령,2021,57.7,55.2,60.2,,58,55.3,60.5,
35340, 장수군,000,합계,2021,20335,10071,10264,98.1,19876,9894,9982,99.1
35340, 장수군,005,0~4세,2021,398,206,192,107.3,396,205,191,107.3
35340, 장수군,005001, 0세,2021,69,37,32,115.6,69,37,32,115.6
35340, 장수군,005002, 1세,2021,85,40,45,88.9,85,40,45,88.9
35340, 장수군,005003, 2세,2021,81,43,38,113.2,80,42,38,110.5
35340, 장수군,005004, 3세,2021,76,44,32,137.5,75,44,31,141.9
35340, 장수군,005005, 4세,2021,87,42,45,93.3,87,42,45,93.3
35340, 장수군,010,5~9세,2021,615,325,290,112.1,614,324,290,111.7
35340, 장수군,010001, 5세,2021,98,57,41,139,97,56,41,136.6
35340, 장수군,010002, 6세,2021,111,59,52,113.5,111,59,52,113.5
35340, 장수군,010003, 7세,2021,129,60,69,87,129,60,69,87
35340, 장수군,010004, 8세,2021,146,82,64,128.1,146,82,64,128.1
35340, 장수군,010005, 9세,2021,131,67,64,104.7,131,67,64,104.7
35340, 장수군,015,10~14세,2021,799,412,387,106.5,798,411,387,106.2
35340, 장수군,015001, 10세,2021,166,83,83,100,166,83,83,100
35340, 장수군,015002, 11세,2021,149,76,73,104.1,149,76,73,104.1
35340, 장수군,015003, 12세,2021,144,85,59,144.1,144,85,59,144.1
35340, 장수군,015004, 13세,2021,174,89,85,104.7,174,89,85,104.7
35340, 장수군,015005, 14세,2021,166,79,87,90.8,165,78,87,89.7
35340, 장수군,020,15~19세,2021,664,349,315,110.8,664,349,315,110.8
35340, 장수군,020001, 15세,2021,136,70,66,106.1,136,70,66,106.1
35340, 장수군,020002, 16세,2021,152,78,74,105.4,152,78,74,105.4
35340, 장수군,020003, 17세,2021,152,78,74,105.4,152,78,74,105.4
35340, 장수군,020004, 18세,2021,139,69,70,98.6,139,69,70,98.6
35340, 장수군,020005, 19세,2021,85,54,31,174.2,85,54,31,174.2
35340, 장수군,025,20~24세,2021,632,390,242,161.2,598,379,219,173.1
35340, 장수군,025001, 20세,2021,103,73,30,243.3,103,73,30,243.3
35340, 장수군,025002, 21세,2021,124,80,44,181.8,122,80,42,190.5
35340, 장수군,025003, 22세,2021,117,73,44,165.9,105,72,33,218.2
35340, 장수군,025004, 23세,2021,157,86,71,121.1,144,81,63,128.6
35340, 장수군,025005, 24세,2021,131,78,53,147.2,124,73,51,143.1
35340, 장수군,030,25~29세,2021,728,412,316,130.4,639,373,266,140.2
35340, 장수군,030001, 25세,2021,147,74,73,101.4,130,65,65,100
35340, 장수군,030002, 26세,2021,166,100,66,151.5,156,97,59,164.4
35340, 장수군,030003, 27세,2021,163,93,70,132.9,141,86,55,156.4
35340, 장수군,030004, 28세,2021,135,89,46,193.5,116,79,37,213.5
35340, 장수군,030005, 29세,2021,117,56,61,91.8,96,46,50,92
35340, 장수군,035,30~34세,2021,676,347,329,105.5,587,302,285,106
35340, 장수군,035001, 30세,2021,128,67,61,109.8,108,57,51,111.8
35340, 장수군,035002, 31세,2021,141,75,66,113.6,122,65,57,114
35340, 장수군,035003, 32세,2021,141,69,72,95.8,119,58,61,95.1
35340, 장수군,035004, 33세,2021,130,69,61,113.1,113,59,54,109.3
35340, 장수군,035005, 34세,2021,136,67,69,97.1,125,63,62,101.6
35340, 장수군,040,35~39세,2021,797,408,389,104.9,736,387,349,110.9
35340, 장수군,040001, 35세,2021,154,84,70,120,145,78,67,116.4
35340, 장수군,040002, 36세,2021,129,60,69,87,116,57,59,96.6
35340, 장수군,040003, 37세,2021,158,77,81,95.1,138,73,65,112.3
35340, 장수군,040004, 38세,2021,175,105,70,150,166,101,65,155.4
35340, 장수군,040005, 39세,2021,181,82,99,82.8,171,78,93,83.9
35340, 장수군,045,40~44세,2021,1048,584,464,125.9,1002,565,437,129.3
35340, 장수군,045001, 40세,2021,186,94,92,102.2,170,89,81,109.9
35340, 장수군,045002, 41세,2021,225,114,111,102.7,215,109,106,102.8
35340, 장수군,045003, 42세,2021,198,119,79,150.6,189,115,74,155.4
35340, 장수군,045004, 43세,2021,203,115,88,130.7,197,114,83,137.3
35340, 장수군,045005, 44세,2021,236,142,94,151.1,231,138,93,148.4
35340, 장수군,050,45~49세,2021,1211,653,558,117,1182,641,541,118.5
35340, 장수군,050001, 45세,2021,197,103,94,109.6,189,102,87,117.2
35340, 장수군,050002, 46세,2021,219,119,100,119,217,117,100,117
35340, 장수군,050003, 47세,2021,247,137,110,124.5,242,133,109,122
35340, 장수군,050004, 48세,2021,282,158,124,127.4,279,155,124,125
35340, 장수군,050005, 49세,2021,266,136,130,104.6,255,134,121,110.7
35340, 장수군,055,50~54세,2021,1603,886,717,123.6,1569,881,688,128.1
35340, 장수군,055001, 50세,2021,307,171,136,125.7,304,171,133,128.6
35340, 장수군,055002, 51세,2021,286,165,121,136.4,277,162,115,140.9
35340, 장수군,055003, 52세,2021,329,174,155,112.3,322,174,148,117.6
35340, 장수군,055004, 53세,2021,352,189,163,116,341,187,154,121.4
35340, 장수군,055005, 54세,2021,329,187,142,131.7,325,187,138,135.5
35340, 장수군,060,55~59세,2021,1756,951,805,118.1,1722,940,782,120.2
35340, 장수군,060001, 55세,2021,330,175,155,112.9,323,174,149,116.8
35340, 장수군,060002, 56세,2021,401,226,175,129.1,395,223,172,129.7
35340, 장수군,060003, 57세,2021,293,152,141,107.8,288,151,137,110.2
35340, 장수군,060004, 58세,2021,312,167,145,115.2,303,163,140,116.4
35340, 장수군,060005, 59세,2021,420,231,189,122.2,413,229,184,124.5
35340, 장수군,065,60~64세,2021,2206,1125,1081,104.1,2184,1119,1065,105.1
35340, 장수군,065001, 60세,2021,471,250,221,113.1,460,247,213,116
35340, 장수군,065002, 61세,2021,526,281,245,114.7,521,279,242,115.3
35340, 장수군,065003, 62세,2021,422,206,216,95.4,419,206,213,96.7
35340, 장수군,065004, 63세,2021,384,189,195,96.9,383,188,195,96.4
35340, 장수군,065005, 64세,2021,403,199,204,97.5,401,199,202,98.5
35340, 장수군,070,65~69세,2021,1928,955,973,98.2,1924,954,970,98.4
35340, 장수군,070001, 65세,2021,396,198,198,100,395,198,197,100.5
35340, 장수군,070002, 66세,2021,436,221,215,102.8,435,221,214,103.3
35340, 장수군,070003, 67세,2021,370,182,188,96.8,368,181,187,96.8
35340, 장수군,070004, 68세,2021,344,173,171,101.2,344,173,171,101.2
35340, 장수군,070005, 69세,2021,382,181,201,90,382,181,201,90
35340, 장수군,075,70~74세,2021,1640,799,841,95,1631,797,834,95.6
35340, 장수군,075001, 70세,2021,343,165,178,92.7,340,165,175,94.3
35340, 장수군,075002, 71세,2021,337,173,164,105.5,336,173,163,106.1
35340, 장수군,075003, 72세,2021,313,160,153,104.6,310,159,151,105.3
35340, 장수군,075004, 73세,2021,347,156,191,81.7,346,155,191,81.2
35340, 장수군,075005, 74세,2021,300,145,155,93.5,299,145,154,94.2
35340, 장수군,080,75~79세,2021,1355,532,823,64.6,1354,531,823,64.5
35340, 장수군,080001, 75세,2021,226,104,122,85.2,225,103,122,84.4
35340, 장수군,080002, 76세,2021,210,91,119,76.5,210,91,119,76.5
35340, 장수군,080003, 77세,2021,261,101,160,63.1,261,101,160,63.1
35340, 장수군,080004, 78세,2021,262,91,171,53.2,262,91,171,53.2
35340, 장수군,080005, 79세,2021,396,145,251,57.8,396,145,251,57.8
35340, 장수군,085,80~84세,2021,1257,424,833,50.9,1254,423,831,50.9
35340, 장수군,085001, 80세,2021,301,100,201,49.8,301,100,201,49.8
35340, 장수군,085002, 81세,2021,261,95,166,57.2,260,94,166,56.6
35340, 장수군,085003, 82세,2021,291,93,198,47,290,93,197,47.2
35340, 장수군,085004, 83세,2021,210,78,132,59.1,209,78,131,59.5
35340, 장수군,085005, 84세,2021,194,58,136,42.6,194,58,136,42.6
35340, 장수군,090,85~89세,2021,770,247,523,47.2,770,247,523,47.2
35340, 장수군,090001, 85세,2021,217,69,148,46.6,217,69,148,46.6
35340, 장수군,090002, 86세,2021,174,49,125,39.2,174,49,125,39.2
35340, 장수군,090003, 87세,2021,161,56,105,53.3,161,56,105,53.3
35340, 장수군,090004, 88세,2021,114,35,79,44.3,114,35,79,44.3
35340, 장수군,090005, 89세,2021,104,38,66,57.6,104,38,66,57.6
35340, 장수군,095,90~94세,2021,203,56,147,38.1,203,56,147,38.1
35340, 장수군,095001, 90세,2021,55,23,32,71.9,55,23,32,71.9
35340, 장수군,095002, 91세,2021,61,13,48,27.1,61,13,48,27.1
35340, 장수군,095003, 92세,2021,26,5,21,23.8,26,5,21,23.8
35340, 장수군,095004, 93세,2021,32,12,20,60,32,12,20,60
35340, 장수군,095005, 94세,2021,29,X,26,11.5,29,X,26,11.5
35340, 장수군,100,95~99세,2021,43,10,33,30.3,43,10,33,30.3
35340, 장수군,100001, 95세,2021,10,X,7,42.9,10,X,7,42.9
35340, 장수군,100002, 96세,2021,17,6,11,54.5,17,6,11,54.5
35340, 장수군,100003, 97세,2021,6,X,6,0,6,X,6,0
35340, 장수군,100004, 98세,2021,5,X,5,0,5,X,5,0
35340, 장수군,100005, 99세,2021,5,X,X,25,5,X,X,25
35340, 장수군,101,100세이상,2021,6,X,6,0,6,X,6,0
35340, 장수군,102,15세미만,2021,1812,943,869,108.5,1808,940,868,108.3
35340, 장수군,103,15~64세,2021,11321,6105,5216,117,10883,5936,4947,120
35340, 장수군,104,65세이상,2021,7202,3023,4179,72.3,7185,3018,4167,72.4
35340, 장수군,086,85세이상,2021,1022,313,709,44.1,1022,313,709,44.1
35340, 장수군,126,평균연령,2021,53.5,51.1,55.8,,53.8,51.3,56.2,
35340, 장수군,127,중위연령,2021,57.9,55.4,60.6,,58.5,55.7,61.1,
35350, 임실군,000,합계,2021,24997,12575,12422,101.2,24605,12433,12172,102.1
35350, 임실군,005,0~4세,2021,649,354,295,120,648,353,295,119.7
35350, 임실군,005001, 0세,2021,159,77,82,93.9,159,77,82,93.9
35350, 임실군,005002, 1세,2021,165,86,79,108.9,165,86,79,108.9
35350, 임실군,005003, 2세,2021,109,59,50,118,109,59,50,118
35350, 임실군,005004, 3세,2021,95,67,28,239.3,95,67,28,239.3
35350, 임실군,005005, 4세,2021,121,65,56,116.1,120,64,56,114.3
35350, 임실군,010,5~9세,2021,602,293,309,94.8,602,293,309,94.8
35350, 임실군,010001, 5세,2021,120,61,59,103.4,120,61,59,103.4
35350, 임실군,010002, 6세,2021,100,53,47,112.8,100,53,47,112.8
35350, 임실군,010003, 7세,2021,115,54,61,88.5,115,54,61,88.5
35350, 임실군,010004, 8세,2021,133,62,71,87.3,133,62,71,87.3
35350, 임실군,010005, 9세,2021,134,63,71,88.7,134,63,71,88.7
35350, 임실군,015,10~14세,2021,760,404,356,113.5,760,404,356,113.5
35350, 임실군,015001, 10세,2021,146,82,64,128.1,146,82,64,128.1
35350, 임실군,015002, 11세,2021,146,77,69,111.6,146,77,69,111.6
35350, 임실군,015003, 12세,2021,153,84,69,121.7,153,84,69,121.7
35350, 임실군,015004, 13세,2021,174,91,83,109.6,174,91,83,109.6
35350, 임실군,015005, 14세,2021,141,70,71,98.6,141,70,71,98.6
35350, 임실군,020,15~19세,2021,755,409,346,118.2,755,409,346,118.2
35350, 임실군,020001, 15세,2021,134,60,74,81.1,134,60,74,81.1
35350, 임실군,020002, 16세,2021,128,67,61,109.8,128,67,61,109.8
35350, 임실군,020003, 17세,2021,132,78,54,144.4,132,78,54,144.4
35350, 임실군,020004, 18세,2021,171,92,79,116.5,171,92,79,116.5
35350, 임실군,020005, 19세,2021,190,112,78,143.6,190,112,78,143.6
35350, 임실군,025,20~24세,2021,1109,620,489,126.8,1075,609,466,130.7
35350, 임실군,025001, 20세,2021,222,108,114,94.7,221,108,113,95.6
35350, 임실군,025002, 21세,2021,223,107,116,92.2,222,107,115,93
35350, 임실군,025003, 22세,2021,220,124,96,129.2,214,123,91,135.2
35350, 임실군,025004, 23세,2021,227,141,86,164,215,137,78,175.6
35350, 임실군,025005, 24세,2021,217,140,77,181.8,203,134,69,194.2
35350, 임실군,030,25~29세,2021,952,560,392,142.9,872,519,353,147
35350, 임실군,030001, 25세,2021,201,128,73,175.3,183,118,65,181.5
35350, 임실군,030002, 26세,2021,190,118,72,163.9,173,110,63,174.6
35350, 임실군,030003, 27세,2021,184,112,72,155.6,167,105,62,169.4
35350, 임실군,030004, 28세,2021,172,90,82,109.8,158,83,75,110.7
35350, 임실군,030005, 29세,2021,205,112,93,120.4,191,103,88,117
35350, 임실군,035,30~34세,2021,889,480,409,117.4,815,452,363,124.5
35350, 임실군,035001, 30세,2021,182,99,83,119.3,164,90,74,121.6
35350, 임실군,035002, 31세,2021,181,101,80,126.3,170,97,73,132.9
35350, 임실군,035003, 32세,2021,203,113,90,125.6,188,108,80,135
35350, 임실군,035004, 33세,2021,161,78,83,94,147,76,71,107
35350, 임실군,035005, 34세,2021,162,89,73,121.9,146,81,65,124.6
35350, 임실군,040,35~39세,2021,902,463,439,105.5,842,451,391,115.3
35350, 임실군,040001, 35세,2021,166,81,85,95.3,155,79,76,103.9
35350, 임실군,040002, 36세,2021,166,83,83,100,154,80,74,108.1
35350, 임실군,040003, 37세,2021,183,91,92,98.9,170,87,83,104.8
35350, 임실군,040004, 38세,2021,179,92,87,105.7,165,91,74,123
35350, 임실군,040005, 39세,2021,208,116,92,126.1,198,114,84,135.7
35350, 임실군,045,40~44세,2021,1096,648,448,144.6,1062,637,425,149.9
35350, 임실군,045001, 40세,2021,192,108,84,128.6,186,106,80,132.5
35350, 임실군,045002, 41세,2021,212,119,93,128,207,117,90,130
35350, 임실군,045003, 42세,2021,240,142,98,144.9,229,139,90,154.4
35350, 임실군,045004, 43세,2021,238,139,99,140.4,234,138,96,143.8
35350, 임실군,045005, 44세,2021,214,140,74,189.2,206,137,69,198.6
35350, 임실군,050,45~49세,2021,1361,797,564,141.3,1332,790,542,145.8
35350, 임실군,050001, 45세,2021,222,139,83,167.5,218,137,81,169.1
35350, 임실군,050002, 46세,2021,244,138,106,130.2,236,136,100,136
35350, 임실군,050003, 47세,2021,285,165,120,137.5,278,163,115,141.7
35350, 임실군,050004, 48세,2021,312,179,133,134.6,306,179,127,140.9
35350, 임실군,050005, 49세,2021,298,176,122,144.3,294,175,119,147.1
35350, 임실군,055,50~54세,2021,1836,1023,813,125.8,1796,1010,786,128.5
35350, 임실군,055001, 50세,2021,320,198,122,162.3,313,196,117,167.5
35350, 임실군,055002, 51세,2021,335,189,146,129.5,327,188,139,135.3
35350, 임실군,055003, 52세,2021,364,190,174,109.2,354,186,168,110.7
35350, 임실군,055004, 53세,2021,424,234,190,123.2,416,231,185,124.9
35350, 임실군,055005, 54세,2021,393,212,181,117.1,386,209,177,118.1
35350, 임실군,060,55~59세,2021,2157,1187,970,122.4,2146,1184,962,123.1
35350, 임실군,060001, 55세,2021,403,209,194,107.7,402,209,193,108.3
35350, 임실군,060002, 56세,2021,442,257,185,138.9,439,256,183,139.9
35350, 임실군,060003, 57세,2021,400,219,181,121,397,219,178,123
35350, 임실군,060004, 58세,2021,435,248,187,132.6,433,246,187,131.6
35350, 임실군,060005, 59세,2021,477,254,223,113.9,475,254,221,114.9
35350, 임실군,065,60~64세,2021,2610,1399,1211,115.5,2597,1392,1205,115.5
35350, 임실군,065001, 60세,2021,546,303,243,124.7,542,301,241,124.9
35350, 임실군,065002, 61세,2021,621,333,288,115.6,616,330,286,115.4
35350, 임실군,065003, 62세,2021,538,274,264,103.8,536,273,263,103.8
35350, 임실군,065004, 63세,2021,442,233,209,111.5,441,232,209,111
35350, 임실군,065005, 64세,2021,463,256,207,123.7,462,256,206,124.3
35350, 임실군,070,65~69세,2021,2140,1144,996,114.9,2133,1140,993,114.8
35350, 임실군,070001, 65세,2021,467,247,220,112.3,464,246,218,112.8
35350, 임실군,070002, 66세,2021,463,256,207,123.7,462,255,207,123.2
35350, 임실군,070003, 67세,2021,444,241,203,118.7,443,241,202,119.3
35350, 임실군,070004, 68세,2021,364,195,169,115.4,362,193,169,114.2
35350, 임실군,070005, 69세,2021,402,205,197,104.1,402,205,197,104.1
35350, 임실군,075,70~74세,2021,2139,998,1141,87.5,2134,996,1138,87.5
35350, 임실군,075001, 70세,2021,379,169,210,80.5,378,168,210,80
35350, 임실군,075002, 71세,2021,460,226,234,96.6,460,226,234,96.6
35350, 임실군,075003, 72세,2021,398,177,221,80.1,396,177,219,80.8
35350, 임실군,075004, 73세,2021,446,209,237,88.2,445,208,237,87.8
35350, 임실군,075005, 74세,2021,456,217,239,90.8,455,217,238,91.2
35350, 임실군,080,75~79세,2021,1843,744,1099,67.7,1841,744,1097,67.8
35350, 임실군,080001, 75세,2021,317,148,169,87.6,316,148,168,88.1
35350, 임실군,080002, 76세,2021,324,136,188,72.3,323,136,187,72.7
35350, 임실군,080003, 77세,2021,311,140,171,81.9,311,140,171,81.9
35350, 임실군,080004, 78세,2021,347,128,219,58.4,347,128,219,58.4
35350, 임실군,080005, 79세,2021,544,192,352,54.5,544,192,352,54.5
35350, 임실군,085,80~84세,2021,1790,641,1149,55.8,1788,639,1149,55.6
35350, 임실군,085001, 80세,2021,386,149,237,62.9,386,149,237,62.9
35350, 임실군,085002, 81세,2021,380,130,250,52,380,130,250,52
35350, 임실군,085003, 82세,2021,376,142,234,60.7,375,141,234,60.3
35350, 임실군,085004, 83세,2021,308,109,199,54.8,308,109,199,54.8
35350, 임실군,085005, 84세,2021,340,111,229,48.5,339,110,229,48
35350, 임실군,090,85~89세,2021,1013,320,693,46.2,1013,320,693,46.2
35350, 임실군,090001, 85세,2021,262,87,175,49.7,262,87,175,49.7
35350, 임실군,090002, 86세,2021,234,68,166,41,234,68,166,41
35350, 임실군,090003, 87세,2021,227,69,158,43.7,227,69,158,43.7
35350, 임실군,090004, 88세,2021,150,47,103,45.6,150,47,103,45.6
35350, 임실군,090005, 89세,2021,140,49,91,53.8,140,49,91,53.8
35350, 임실군,095,90~94세,2021,329,80,249,32.1,329,80,249,32.1
35350, 임실군,095001, 90세,2021,103,24,79,30.4,103,24,79,30.4
35350, 임실군,095002, 91세,2021,68,18,50,36,68,18,50,36
35350, 임실군,095003, 92세,2021,67,21,46,45.7,67,21,46,45.7
35350, 임실군,095004, 93세,2021,57,13,44,29.5,57,13,44,29.5
35350, 임실군,095005, 94세,2021,34,X,30,13.3,34,X,30,13.3
35350, 임실군,100,95~99세,2021,52,8,44,18.2,52,8,44,18.2
35350, 임실군,100001, 95세,2021,21,X,17,23.5,21,X,17,23.5
35350, 임실군,100002, 96세,2021,15,X,14,7.1,15,X,14,7.1
35350, 임실군,100003, 97세,2021,5,X,5,0,5,X,5,0
35350, 임실군,100004, 98세,2021,9,X,6,50,9,X,6,50
35350, 임실군,100005, 99세,2021,X,X,X,0,X,X,X,0
35350, 임실군,101,100세이상,2021,13,X,10,30,13,X,10,30
35350, 임실군,102,15세미만,2021,2011,1051,960,109.5,2010,1050,960,109.4
35350, 임실군,103,15~64세,2021,13667,7586,6081,124.7,13292,7453,5839,127.6
35350, 임실군,104,65세이상,2021,9319,3938,5381,73.2,9303,3930,5373,73.1
35350, 임실군,086,85세이상,2021,1407,411,996,41.3,1407,411,996,41.3
35350, 임실군,126,평균연령,2021,54.1,51.6,56.7,,54.4,51.8,57,
35350, 임실군,127,중위연령,2021,58.8,56.1,61.5,,59.2,56.3,61.9,
35360, 순창군,000,합계,2021,25483,12333,13150,93.8,25033,12174,12859,94.7
35360, 순창군,005,0~4세,2021,595,291,304,95.7,590,288,302,95.4
35360, 순창군,005001, 0세,2021,99,49,50,98,97,48,49,98
35360, 순창군,005002, 1세,2021,130,58,72,80.6,129,57,72,79.2
35360, 순창군,005003, 2세,2021,130,65,65,100,130,65,65,100
35360, 순창군,005004, 3세,2021,131,64,67,95.5,130,64,66,97
35360, 순창군,005005, 4세,2021,105,55,50,110,104,54,50,108
35360, 순창군,010,5~9세,2021,716,397,319,124.5,716,397,319,124.5
35360, 순창군,010001, 5세,2021,157,86,71,121.1,157,86,71,121.1
35360, 순창군,010002, 6세,2021,120,70,50,140,120,70,50,140
35360, 순창군,010003, 7세,2021,131,73,58,125.9,131,73,58,125.9
35360, 순창군,010004, 8세,2021,146,88,58,151.7,146,88,58,151.7
35360, 순창군,010005, 9세,2021,162,80,82,97.6,162,80,82,97.6
35360, 순창군,015,10~14세,2021,968,496,472,105.1,968,496,472,105.1
35360, 순창군,015001, 10세,2021,171,82,89,92.1,171,82,89,92.1
35360, 순창군,015002, 11세,2021,195,106,89,119.1,195,106,89,119.1
35360, 순창군,015003, 12세,2021,185,99,86,115.1,185,99,86,115.1
35360, 순창군,015004, 13세,2021,195,95,100,95,195,95,100,95
35360, 순창군,015005, 14세,2021,222,114,108,105.6,222,114,108,105.6
35360, 순창군,020,15~19세,2021,944,505,439,115,944,505,439,115
35360, 순창군,020001, 15세,2021,221,118,103,114.6,221,118,103,114.6
35360, 순창군,020002, 16세,2021,199,103,96,107.3,199,103,96,107.3
35360, 순창군,020003, 17세,2021,227,118,109,108.3,227,118,109,108.3
35360, 순창군,020004, 18세,2021,191,98,93,105.4,191,98,93,105.4
35360, 순창군,020005, 19세,2021,106,68,38,178.9,106,68,38,178.9
35360, 순창군,025,20~24세,2021,813,492,321,153.3,787,480,307,156.4
35360, 순창군,025001, 20세,2021,159,108,51,211.8,159,108,51,211.8
35360, 순창군,025002, 21세,2021,174,99,75,132,172,99,73,135.6
35360, 순창군,025003, 22세,2021,146,101,45,224.4,142,98,44,222.7
35360, 순창군,025004, 23세,2021,170,97,73,132.9,159,91,68,133.8
35360, 순창군,025005, 24세,2021,164,87,77,113,155,84,71,118.3
35360, 순창군,030,25~29세,2021,848,461,387,119.1,756,426,330,129.1
35360, 순창군,030001, 25세,2021,169,98,71,138,151,93,58,160.3
35360, 순창군,030002, 26세,2021,174,98,76,128.9,155,88,67,131.3
35360, 순창군,030003, 27세,2021,177,96,81,118.5,154,88,66,133.3
35360, 순창군,030004, 28세,2021,175,87,88,98.9,153,81,72,112.5
35360, 순창군,030005, 29세,2021,153,82,71,115.5,143,76,67,113.4
35360, 순창군,035,30~34세,2021,845,414,431,96.1,744,377,367,102.7
35360, 순창군,035001, 30세,2021,162,83,79,105.1,144,77,67,114.9
35360, 순창군,035002, 31세,2021,166,73,93,78.5,136,61,75,81.3
35360, 순창군,035003, 32세,2021,150,69,81,85.2,136,63,73,86.3
35360, 순창군,035004, 33세,2021,191,97,94,103.2,167,88,79,111.4
35360, 순창군,035005, 34세,2021,176,92,84,109.5,161,88,73,120.5
35360, 순창군,040,35~39세,2021,1014,477,537,88.8,960,455,505,90.1
35360, 순창군,040001, 35세,2021,185,75,110,68.2,172,69,103,67
35360, 순창군,040002, 36세,2021,189,88,101,87.1,176,85,91,93.4
35360, 순창군,040003, 37세,2021,198,99,99,100,184,93,91,102.2
35360, 순창군,040004, 38세,2021,215,105,110,95.5,209,102,107,95.3
35360, 순창군,040005, 39세,2021,227,110,117,94,219,106,113,93.8
35360, 순창군,045,40~44세,2021,1285,669,616,108.6,1247,662,585,113.2
35360, 순창군,045001, 40세,2021,234,124,110,112.7,224,121,103,117.5
35360, 순창군,045002, 41세,2021,256,125,131,95.4,247,123,124,99.2
35360, 순창군,045003, 42세,2021,274,144,130,110.8,266,143,123,116.3
35360, 순창군,045004, 43세,2021,255,143,112,127.7,249,142,107,132.7
35360, 순창군,045005, 44세,2021,266,133,133,100,261,133,128,103.9
35360, 순창군,050,45~49세,2021,1643,956,687,139.2,1612,946,666,142
35360, 순창군,050001, 45세,2021,264,168,96,175,259,167,92,181.5
35360, 순창군,050002, 46세,2021,289,165,124,133.1,288,164,124,132.3
35360, 순창군,050003, 47세,2021,379,209,170,122.9,373,209,164,127.4
35360, 순창군,050004, 48세,2021,354,209,145,144.1,342,203,139,146
35360, 순창군,050005, 49세,2021,357,205,152,134.9,350,203,147,138.1
35360, 순창군,055,50~54세,2021,2012,1117,895,124.8,1977,1108,869,127.5
35360, 순창군,055001, 50세,2021,416,239,177,135,406,238,168,141.7
35360, 순창군,055002, 51세,2021,347,186,161,115.5,341,184,157,117.2
35360, 순창군,055003, 52세,2021,441,251,190,132.1,433,249,184,135.3
35360, 순창군,055004, 53세,2021,423,236,187,126.2,416,234,182,128.6
35360, 순창군,055005, 54세,2021,385,205,180,113.9,381,203,178,114
35360, 순창군,060,55~59세,2021,2114,1094,1020,107.3,2079,1081,998,108.3
35360, 순창군,060001, 55세,2021,435,224,211,106.2,427,222,205,108.3
35360, 순창군,060002, 56세,2021,400,207,193,107.3,395,205,190,107.9
35360, 순창군,060003, 57세,2021,391,202,189,106.9,383,199,184,108.2
35360, 순창군,060004, 58세,2021,415,223,192,116.1,407,220,187,117.6
35360, 순창군,060005, 59세,2021,473,238,235,101.3,467,235,232,101.3
35360, 순창군,065,60~64세,2021,2656,1374,1282,107.2,2635,1367,1268,107.8
35360, 순창군,065001, 60세,2021,537,282,255,110.6,531,281,250,112.4
35360, 순창군,065002, 61세,2021,647,335,312,107.4,645,335,310,108.1
35360, 순창군,065003, 62세,2021,518,257,261,98.5,510,253,257,98.4
35360, 순창군,065004, 63세,2021,470,246,224,109.8,468,244,224,108.9
35360, 순창군,065005, 64세,2021,484,254,230,110.4,481,254,227,111.9
35360, 순창군,070,65~69세,2021,2106,1009,1097,92,2102,1008,1094,92.1
35360, 순창군,070001, 65세,2021,448,214,234,91.5,446,213,233,91.4
35360, 순창군,070002, 66세,2021,484,248,236,105.1,483,248,235,105.5
35360, 순창군,070003, 67세,2021,439,210,229,91.7,438,210,228,92.1
35360, 순창군,070004, 68세,2021,339,157,182,86.3,339,157,182,86.3
35360, 순창군,070005, 69세,2021,396,180,216,83.3,396,180,216,83.3
35360, 순창군,075,70~74세,2021,1940,886,1054,84.1,1938,885,1053,84
35360, 순창군,075001, 70세,2021,321,158,163,96.9,321,158,163,96.9
35360, 순창군,075002, 71세,2021,378,183,195,93.8,378,183,195,93.8
35360, 순창군,075003, 72세,2021,399,173,226,76.5,399,173,226,76.5
35360, 순창군,075004, 73세,2021,402,181,221,81.9,400,180,220,81.8
35360, 순창군,075005, 74세,2021,440,191,249,76.7,440,191,249,76.7
35360, 순창군,080,75~79세,2021,1925,717,1208,59.4,1922,716,1206,59.4
35360, 순창군,080001, 75세,2021,350,148,202,73.3,349,147,202,72.8
35360, 순창군,080002, 76세,2021,331,136,195,69.7,331,136,195,69.7
35360, 순창군,080003, 77세,2021,329,124,205,60.5,328,124,204,60.8
35360, 순창군,080004, 78세,2021,359,128,231,55.4,359,128,231,55.4
35360, 순창군,080005, 79세,2021,556,181,375,48.3,555,181,374,48.4
35360, 순창군,085,80~84세,2021,1742,593,1149,51.6,1740,593,1147,51.7
35360, 순창군,085001, 80세,2021,407,140,267,52.4,407,140,267,52.4
35360, 순창군,085002, 81세,2021,373,118,255,46.3,371,118,253,46.6
35360, 순창군,085003, 82세,2021,363,129,234,55.1,363,129,234,55.1
35360, 순창군,085004, 83세,2021,341,114,227,50.2,341,114,227,50.2
35360, 순창군,085005, 84세,2021,258,92,166,55.4,258,92,166,55.4
35360, 순창군,090,85~89세,2021,938,286,652,43.9,937,285,652,43.7
35360, 순창군,090001, 85세,2021,273,85,188,45.2,273,85,188,45.2
35360, 순창군,090002, 86세,2021,230,80,150,53.3,230,80,150,53.3
35360, 순창군,090003, 87세,2021,189,46,143,32.2,188,45,143,31.5
35360, 순창군,090004, 88세,2021,117,37,80,46.3,117,37,80,46.3
35360, 순창군,090005, 89세,2021,129,38,91,41.8,129,38,91,41.8
35360, 순창군,095,90~94세,2021,304,88,216,40.7,304,88,216,40.7
35360, 순창군,095001, 90세,2021,100,34,66,51.5,100,34,66,51.5
35360, 순창군,095002, 91세,2021,79,19,60,31.7,79,19,60,31.7
35360, 순창군,095003, 92세,2021,42,14,28,50,42,14,28,50
35360, 순창군,095004, 93세,2021,44,13,31,41.9,44,13,31,41.9
35360, 순창군,095005, 94세,2021,39,8,31,25.8,39,8,31,25.8
35360, 순창군,100,95~99세,2021,60,8,52,15.4,60,8,52,15.4
35360, 순창군,100001, 95세,2021,12,X,8,50,12,X,8,50
35360, 순창군,100002, 96세,2021,19,X,16,18.8,19,X,16,18.8
35360, 순창군,100003, 97세,2021,13,X,12,8.3,13,X,12,8.3
35360, 순창군,100004, 98세,2021,11,X,11,0,11,X,11,0
35360, 순창군,100005, 99세,2021,5,X,5,0,5,X,5,0
35360, 순창군,101,100세이상,2021,15,X,12,25,15,X,12,25
35360, 순창군,102,15세미만,2021,2279,1184,1095,108.1,2274,1181,1093,108.1
35360, 순창군,103,15~64세,2021,14174,7559,6615,114.3,13741,7407,6334,116.9
35360, 순창군,104,65세이상,2021,9030,3590,5440,66,9018,3586,5432,66
35360, 순창군,086,85세이상,2021,1317,385,932,41.3,1316,384,932,41.2
35360, 순창군,126,평균연령,2021,53.4,50.7,55.9,,53.7,50.9,56.3,
35360, 순창군,127,중위연령,2021,57.6,54.5,60.6,,58,54.7,61.1,
35370, 고창군,000,합계,2021,51180,25420,25760,98.7,49994,24833,25161,98.7
35370, 고창군,005,0~4세,2021,1009,539,470,114.7,1003,535,468,114.3
35370, 고창군,005001, 0세,2021,167,92,75,122.7,167,92,75,122.7
35370, 고창군,005002, 1세,2021,183,104,79,131.6,181,103,78,132.1
35370, 고창군,005003, 2세,2021,215,122,93,131.2,214,121,93,130.1
35370, 고창군,005004, 3세,2021,207,102,105,97.1,206,102,104,98.1
35370, 고창군,005005, 4세,2021,237,119,118,100.8,235,117,118,99.2
35370, 고창군,010,5~9세,2021,1445,780,665,117.3,1442,777,665,116.8
35370, 고창군,010001, 5세,2021,238,130,108,120.4,237,129,108,119.4
35370, 고창군,010002, 6세,2021,270,131,139,94.2,270,131,139,94.2
35370, 고창군,010003, 7세,2021,333,181,152,119.1,333,181,152,119.1
35370, 고창군,010004, 8세,2021,291,161,130,123.8,291,161,130,123.8
35370, 고창군,010005, 9세,2021,313,177,136,130.1,311,175,136,128.7
35370, 고창군,015,10~14세,2021,1827,974,853,114.2,1822,970,852,113.8
35370, 고창군,015001, 10세,2021,381,199,182,109.3,381,199,182,109.3
35370, 고창군,015002, 11세,2021,335,184,151,121.9,334,183,151,121.2
35370, 고창군,015003, 12세,2021,356,176,180,97.8,355,175,180,97.2
35370, 고창군,015004, 13세,2021,391,213,178,119.7,390,212,178,119.1
35370, 고창군,015005, 14세,2021,364,202,162,124.7,362,201,161,124.8
35370, 고창군,020,15~19세,2021,2148,1307,841,155.4,2140,1303,837,155.7
35370, 고창군,020001, 15세,2021,361,186,175,106.3,359,186,173,107.5
35370, 고창군,020002, 16세,2021,485,303,182,166.5,483,301,182,165.4
35370, 고창군,020003, 17세,2021,551,351,200,175.5,551,351,200,175.5
35370, 고창군,020004, 18세,2021,468,293,175,167.4,467,293,174,168.4
35370, 고창군,020005, 19세,2021,283,174,109,159.6,280,172,108,159.3
35370, 고창군,025,20~24세,2021,1671,1056,615,171.7,1624,1035,589,175.7
35370, 고창군,025001, 20세,2021,307,215,92,233.7,304,215,89,241.6
35370, 고창군,025002, 21세,2021,374,259,115,225.2,367,258,109,236.7
35370, 고창군,025003, 22세,2021,317,199,118,168.6,308,196,112,175
35370, 고창군,025004, 23세,2021,343,200,143,139.9,332,192,140,137.1
35370, 고창군,025005, 24세,2021,330,183,147,124.5,313,174,139,125.2
35370, 고창군,030,25~29세,2021,1922,1089,833,130.7,1687,956,731,130.8
35370, 고창군,030001, 25세,2021,362,193,169,114.2,328,179,149,120.1
35370, 고창군,030002, 26세,2021,379,220,159,138.4,340,201,139,144.6
35370, 고창군,030003, 27세,2021,420,242,178,136,362,205,157,130.6
35370, 고창군,030004, 28세,2021,372,216,156,138.5,323,189,134,141
35370, 고창군,030005, 29세,2021,389,218,171,127.5,334,182,152,119.7
35370, 고창군,035,30~34세,2021,1755,946,809,116.9,1517,805,712,113.1
35370, 고창군,035001, 30세,2021,345,184,161,114.3,298,156,142,109.9
35370, 고창군,035002, 31세,2021,389,211,178,118.5,326,175,151,115.9
35370, 고창군,035003, 32세,2021,335,190,145,131,285,159,126,126.2
35370, 고창군,035004, 33세,2021,338,181,157,115.3,302,160,142,112.7
35370, 고창군,035005, 34세,2021,348,180,168,107.1,306,155,151,102.6
35370, 고창군,040,35~39세,2021,2025,1085,940,115.4,1846,993,853,116.4
35370, 고창군,040001, 35세,2021,330,180,150,120,293,162,131,123.7
35370, 고창군,040002, 36세,2021,416,204,212,96.2,369,176,193,91.2
35370, 고창군,040003, 37세,2021,407,222,185,120,368,205,163,125.8
35370, 고창군,040004, 38세,2021,432,245,187,131,401,230,171,134.5
35370, 고창군,040005, 39세,2021,440,234,206,113.6,415,220,195,112.8
35370, 고창군,045,40~44세,2021,2484,1358,1126,120.6,2363,1307,1056,123.8
35370, 고창군,045001, 40세,2021,489,266,223,119.3,464,255,209,122
35370, 고창군,045002, 41세,2021,484,244,240,101.7,451,233,218,106.9
35370, 고창군,045003, 42세,2021,512,290,222,130.6,488,278,210,132.4
35370, 고창군,045004, 43세,2021,479,272,207,131.4,459,261,198,131.8
35370, 고창군,045005, 44세,2021,520,286,234,122.2,501,280,221,126.7
35370, 고창군,050,45~49세,2021,3160,1780,1380,129,3066,1745,1321,132.1
35370, 고창군,050001, 45세,2021,508,281,227,123.8,489,271,218,124.3
35370, 고창군,050002, 46세,2021,565,340,225,151.1,544,329,215,153
35370, 고창군,050003, 47세,2021,670,370,300,123.3,656,366,290,126.2
35370, 고창군,050004, 48세,2021,728,420,308,136.4,711,414,297,139.4
35370, 고창군,050005, 49세,2021,689,369,320,115.3,666,365,301,121.3
35370, 고창군,055,50~54세,2021,3935,2150,1785,120.4,3849,2118,1731,122.4
35370, 고창군,055001, 50세,2021,759,424,335,126.6,737,415,322,128.9
35370, 고창군,055002, 51세,2021,750,403,347,116.1,736,399,337,118.4
35370, 고창군,055003, 52세,2021,805,419,386,108.5,785,411,374,109.9
35370, 고창군,055004, 53세,2021,865,484,381,127,848,480,368,130.4
35370, 고창군,055005, 54세,2021,756,420,336,125,743,413,330,125.2
35370, 고창군,060,55~59세,2021,4300,2317,1983,116.8,4235,2293,1942,118.1
35370, 고창군,060001, 55세,2021,849,483,366,132,835,479,356,134.6
35370, 고창군,060002, 56세,2021,860,473,387,122.2,849,470,379,124
35370, 고창군,060003, 57세,2021,798,432,366,118,783,427,356,119.9
35370, 고창군,060004, 58세,2021,854,458,396,115.7,837,447,390,114.6
35370, 고창군,060005, 59세,2021,939,471,468,100.6,931,470,461,102
35370, 고창군,065,60~64세,2021,5364,2689,2675,100.5,5316,2667,2649,100.7
35370, 고창군,065001, 60세,2021,1117,571,546,104.6,1108,566,542,104.4
35370, 고창군,065002, 61세,2021,1135,547,588,93,1123,542,581,93.3
35370, 고창군,065003, 62세,2021,1002,498,504,98.8,988,491,497,98.8
35370, 고창군,065004, 63세,2021,1051,543,508,106.9,1044,540,504,107.1
35370, 고창군,065005, 64세,2021,1059,530,529,100.2,1053,528,525,100.6
35370, 고창군,070,65~69세,2021,4300,2090,2210,94.6,4275,2078,2197,94.6
35370, 고창군,070001, 65세,2021,940,468,472,99.2,931,463,468,98.9
35370, 고창군,070002, 66세,2021,957,474,483,98.1,954,472,482,97.9
35370, 고창군,070003, 67세,2021,873,422,451,93.6,869,420,449,93.5
35370, 고창군,070004, 68세,2021,691,322,369,87.3,685,319,366,87.2
35370, 고창군,070005, 69세,2021,839,404,435,92.9,836,404,432,93.5
35370, 고창군,075,70~74세,2021,4062,1912,2150,88.9,4051,1907,2144,88.9
35370, 고창군,075001, 70세,2021,726,345,381,90.6,725,344,381,90.3
35370, 고창군,075002, 71세,2021,828,403,425,94.8,826,402,424,94.8
35370, 고창군,075003, 72세,2021,842,380,462,82.3,841,380,461,82.4
35370, 고창군,075004, 73세,2021,781,367,414,88.6,779,365,414,88.2
35370, 고창군,075005, 74세,2021,885,417,468,89.1,880,416,464,89.7
35370, 고창군,080,75~79세,2021,3810,1535,2275,67.5,3803,1533,2270,67.5
35370, 고창군,080001, 75세,2021,683,303,380,79.7,681,303,378,80.2
35370, 고창군,080002, 76세,2021,620,258,362,71.3,618,256,362,70.7
35370, 고창군,080003, 77세,2021,706,298,408,73,704,298,406,73.4
35370, 고창군,080004, 78세,2021,757,304,453,67.1,756,304,452,67.3
35370, 고창군,080005, 79세,2021,1044,372,672,55.4,1044,372,672,55.4
35370, 고창군,085,80~84세,2021,3314,1145,2169,52.8,3307,1143,2164,52.8
35370, 고창군,085001, 80세,2021,776,283,493,57.4,773,283,490,57.8
35370, 고창군,085002, 81세,2021,649,215,434,49.5,648,214,434,49.3
35370, 고창군,085003, 82세,2021,713,267,446,59.9,712,267,445,60
35370, 고창군,085004, 83세,2021,648,216,432,50,646,215,431,49.9
35370, 고창군,085005, 84세,2021,528,164,364,45.1,528,164,364,45.1
35370, 고창군,090,85~89세,2021,1842,531,1311,40.5,1841,531,1310,40.5
35370, 고창군,090001, 85세,2021,461,129,332,38.9,460,129,331,39
35370, 고창군,090002, 86세,2021,483,153,330,46.4,483,153,330,46.4
35370, 고창군,090003, 87세,2021,388,115,273,42.1,388,115,273,42.1
35370, 고창군,090004, 88세,2021,269,74,195,37.9,269,74,195,37.9
35370, 고창군,090005, 89세,2021,241,60,181,33.1,241,60,181,33.1
35370, 고창군,095,90~94세,2021,657,119,538,22.1,657,119,538,22.1
35370, 고창군,095001, 90세,2021,206,42,164,25.6,206,42,164,25.6
35370, 고창군,095002, 91세,2021,172,35,137,25.5,172,35,137,25.5
35370, 고창군,095003, 92세,2021,122,24,98,24.5,122,24,98,24.5
35370, 고창군,095004, 93세,2021,79,12,67,17.9,79,12,67,17.9
35370, 고창군,095005, 94세,2021,78,6,72,8.3,78,6,72,8.3
35370, 고창군,100,95~99세,2021,128,17,111,15.3,128,17,111,15.3
35370, 고창군,100001, 95세,2021,43,5,38,13.2,43,5,38,13.2
35370, 고창군,100002, 96세,2021,26,5,21,23.8,26,5,21,23.8
35370, 고창군,100003, 97세,2021,14,X,10,40,14,X,10,40
35370, 고창군,100004, 98세,2021,21,X,20,5,21,X,20,5
35370, 고창군,100005, 99세,2021,24,X,22,9.1,24,X,22,9.1
35370, 고창군,101,100세이상,2021,22,X,21,4.8,22,X,21,4.8
35370, 고창군,102,15세미만,2021,4281,2293,1988,115.3,4267,2282,1985,115
35370, 고창군,103,15~64세,2021,28764,15777,12987,121.5,27643,15222,12421,122.6
35370, 고창군,104,65세이상,2021,18135,7350,10785,68.2,18084,7329,10755,68.1
35370, 고창군,086,85세이상,2021,2649,668,1981,33.7,2648,668,1980,33.7
35370, 고창군,126,평균연령,2021,53.4,50.2,56.5,,53.7,50.5,56.9,
35370, 고창군,127,중위연령,2021,57.6,54.2,61.1,,58.2,54.7,61.5,
35380, 부안군,000,합계,2021,47756,23752,24004,99,46681,23161,23520,98.5
35380, 부안군,005,0~4세,2021,942,491,451,108.9,938,488,450,108.4
35380, 부안군,005001, 0세,2021,184,95,89,106.7,183,94,89,105.6
35380, 부안군,005002, 1세,2021,166,85,81,104.9,164,84,80,105
35380, 부안군,005003, 2세,2021,192,90,102,88.2,192,90,102,88.2
35380, 부안군,005004, 3세,2021,177,88,89,98.9,176,87,89,97.8
35380, 부안군,005005, 4세,2021,223,133,90,147.8,223,133,90,147.8
35380, 부안군,010,5~9세,2021,1393,746,647,115.3,1392,746,646,115.5
35380, 부안군,010001, 5세,2021,239,130,109,119.3,238,130,108,120.4
35380, 부안군,010002, 6세,2021,263,142,121,117.4,263,142,121,117.4
35380, 부안군,010003, 7세,2021,278,141,137,102.9,278,141,137,102.9
35380, 부안군,010004, 8세,2021,300,160,140,114.3,300,160,140,114.3
35380, 부안군,010005, 9세,2021,313,173,140,123.6,313,173,140,123.6
35380, 부안군,015,10~14세,2021,1581,815,766,106.4,1579,814,765,106.4
35380, 부안군,015001, 10세,2021,336,176,160,110,335,175,160,109.4
35380, 부안군,015002, 11세,2021,293,157,136,115.4,293,157,136,115.4
35380, 부안군,015003, 12세,2021,317,146,171,85.4,316,146,170,85.9
35380, 부안군,015004, 13세,2021,300,156,144,108.3,300,156,144,108.3
35380, 부안군,015005, 14세,2021,335,180,155,116.1,335,180,155,116.1
35380, 부안군,020,15~19세,2021,1585,853,732,116.5,1580,852,728,117
35380, 부안군,020001, 15세,2021,305,153,152,100.7,305,153,152,100.7
35380, 부안군,020002, 16세,2021,334,162,172,94.2,334,162,172,94.2
35380, 부안군,020003, 17세,2021,368,211,157,134.4,368,211,157,134.4
35380, 부안군,020004, 18세,2021,343,178,165,107.9,340,177,163,108.6
35380, 부안군,020005, 19세,2021,235,149,86,173.3,233,149,84,177.4
35380, 부안군,025,20~24세,2021,1635,1017,618,164.6,1565,983,582,168.9
35380, 부안군,025001, 20세,2021,301,222,79,281,300,222,78,284.6
35380, 부안군,025002, 21세,2021,348,229,119,192.4,342,227,115,197.4
35380, 부안군,025003, 22세,2021,320,181,139,130.2,311,179,132,135.6
35380, 부안군,025004, 23세,2021,324,178,146,121.9,299,161,138,116.7
35380, 부안군,025005, 24세,2021,342,207,135,153.3,313,194,119,163
35380, 부안군,030,25~29세,2021,1842,1060,782,135.5,1630,922,708,130.2
35380, 부안군,030001, 25세,2021,347,205,142,144.4,320,188,132,142.4
35380, 부안군,030002, 26세,2021,381,221,160,138.1,327,186,141,131.9
35380, 부안군,030003, 27세,2021,376,219,157,139.5,332,189,143,132.2
35380, 부안군,030004, 28세,2021,390,227,163,139.3,343,198,145,136.6
35380, 부안군,030005, 29세,2021,348,188,160,117.5,308,161,147,109.5
35380, 부안군,035,30~34세,2021,1714,962,752,127.9,1476,817,659,124
35380, 부안군,035001, 30세,2021,398,221,177,124.9,341,187,154,121.4
35380, 부안군,035002, 31세,2021,302,167,135,123.7,257,140,117,119.7
35380, 부안군,035003, 32세,2021,347,192,155,123.9,306,166,140,118.6
35380, 부안군,035004, 33세,2021,332,193,139,138.8,280,163,117,139.3
35380, 부안군,035005, 34세,2021,335,189,146,129.5,292,161,131,122.9
35380, 부안군,040,35~39세,2021,2076,1111,965,115.1,1906,996,910,109.5
35380, 부안군,040001, 35세,2021,360,198,162,122.2,325,172,153,112.4
35380, 부안군,040002, 36세,2021,375,211,164,128.7,336,183,153,119.6
35380, 부안군,040003, 37세,2021,416,223,193,115.5,381,200,181,110.5
35380, 부안군,040004, 38세,2021,450,245,205,119.5,424,228,196,116.3
35380, 부안군,040005, 39세,2021,475,234,241,97.1,440,213,227,93.8
35380, 부안군,045,40~44세,2021,2421,1320,1101,119.9,2313,1268,1045,121.3
35380, 부안군,045001, 40세,2021,437,239,198,120.7,419,227,192,118.2
35380, 부안군,045002, 41세,2021,529,281,248,113.3,502,267,235,113.6
35380, 부안군,045003, 42세,2021,491,264,227,116.3,466,252,214,117.8
35380, 부안군,045004, 43세,2021,483,260,223,116.6,460,253,207,122.2
35380, 부안군,045005, 44세,2021,481,276,205,134.6,466,269,197,136.5
35380, 부안군,050,45~49세,2021,3065,1683,1382,121.8,2979,1647,1332,123.6
35380, 부안군,050001, 45세,2021,549,303,246,123.2,532,296,236,125.4
35380, 부안군,050002, 46세,2021,522,283,239,118.4,506,279,227,122.9
35380, 부안군,050003, 47세,2021,694,400,294,136.1,677,392,285,137.5
35380, 부안군,050004, 48세,2021,654,344,310,111,640,338,302,111.9
35380, 부안군,050005, 49세,2021,646,353,293,120.5,624,342,282,121.3
35380, 부안군,055,50~54세,2021,3767,2082,1685,123.6,3704,2060,1644,125.3
35380, 부안군,055001, 50세,2021,754,430,324,132.7,743,426,317,134.4
35380, 부안군,055002, 51세,2021,715,383,332,115.4,704,377,327,115.3
35380, 부안군,055003, 52세,2021,765,444,321,138.3,752,440,312,141
35380, 부안군,055004, 53세,2021,778,434,344,126.2,760,426,334,127.5
35380, 부안군,055005, 54세,2021,755,391,364,107.4,745,391,354,110.5
35380, 부안군,060,55~59세,2021,4183,2256,1927,117.1,4132,2238,1894,118.2
35380, 부안군,060001, 55세,2021,799,449,350,128.3,787,444,343,129.4
35380, 부안군,060002, 56세,2021,785,430,355,121.1,774,427,347,123.1
35380, 부안군,060003, 57세,2021,820,427,393,108.7,817,425,392,108.4
35380, 부안군,060004, 58세,2021,841,446,395,112.9,829,443,386,114.8
35380, 부안군,060005, 59세,2021,938,504,434,116.1,925,499,426,117.1
35380, 부안군,065,60~64세,2021,5072,2523,2549,99,5034,2510,2524,99.4
35380, 부안군,065001, 60세,2021,1009,470,539,87.2,1003,467,536,87.1
35380, 부안군,065002, 61세,2021,1061,518,543,95.4,1055,515,540,95.4
35380, 부안군,065003, 62세,2021,998,502,496,101.2,993,498,495,100.6
35380, 부안군,065004, 63세,2021,959,478,481,99.4,950,477,473,100.8
35380, 부안군,065005, 64세,2021,1045,555,490,113.3,1033,553,480,115.2
35380, 부안군,070,65~69세,2021,4179,2043,2136,95.6,4164,2036,2128,95.7
35380, 부안군,070001, 65세,2021,858,425,433,98.2,852,423,429,98.6
35380, 부안군,070002, 66세,2021,965,462,503,91.8,962,459,503,91.3
35380, 부안군,070003, 67세,2021,871,422,449,94,869,421,448,94
35380, 부안군,070004, 68세,2021,673,340,333,102.1,671,340,331,102.7
35380, 부안군,070005, 69세,2021,812,394,418,94.3,810,393,417,94.2
35380, 부안군,075,70~74세,2021,3914,1808,2106,85.8,3905,1803,2102,85.8
35380, 부안군,075001, 70세,2021,737,331,406,81.5,734,329,405,81.2
35380, 부안군,075002, 71세,2021,804,368,436,84.4,800,366,434,84.3
35380, 부안군,075003, 72세,2021,801,373,428,87.1,800,373,427,87.4
35380, 부안군,075004, 73세,2021,716,356,360,98.9,715,355,360,98.6
35380, 부안군,075005, 74세,2021,856,380,476,79.8,856,380,476,79.8
35380, 부안군,080,75~79세,2021,3374,1400,1974,70.9,3374,1400,1974,70.9
35380, 부안군,080001, 75세,2021,648,288,360,80,648,288,360,80
35380, 부안군,080002, 76세,2021,584,261,323,80.8,584,261,323,80.8
35380, 부안군,080003, 77세,2021,622,253,369,68.6,622,253,369,68.6
35380, 부안군,080004, 78세,2021,662,271,391,69.3,662,271,391,69.3
35380, 부안군,080005, 79세,2021,858,327,531,61.6,858,327,531,61.6
35380, 부안군,085,80~84세,2021,2794,1012,1782,56.8,2793,1012,1781,56.8
35380, 부안군,085001, 80세,2021,607,216,391,55.2,607,216,391,55.2
35380, 부안군,085002, 81세,2021,543,198,345,57.4,543,198,345,57.4
35380, 부안군,085003, 82세,2021,635,229,406,56.4,634,229,405,56.5
35380, 부안군,085004, 83세,2021,541,191,350,54.6,541,191,350,54.6
35380, 부안군,085005, 84세,2021,468,178,290,61.4,468,178,290,61.4
35380, 부안군,090,85~89세,2021,1620,446,1174,38,1618,445,1173,37.9
35380, 부안군,090001, 85세,2021,433,131,302,43.4,432,130,302,43
35380, 부안군,090002, 86세,2021,411,112,299,37.5,410,112,298,37.6
35380, 부안군,090003, 87세,2021,317,96,221,43.4,317,96,221,43.4
35380, 부안군,090004, 88세,2021,278,74,204,36.3,278,74,204,36.3
35380, 부안군,090005, 89세,2021,181,33,148,22.3,181,33,148,22.3
35380, 부안군,095,90~94세,2021,519,110,409,26.9,519,110,409,26.9
35380, 부안군,095001, 90세,2021,169,47,122,38.5,169,47,122,38.5
35380, 부안군,095002, 91세,2021,131,26,105,24.8,131,26,105,24.8
35380, 부안군,095003, 92세,2021,90,19,71,26.8,90,19,71,26.8
35380, 부안군,095004, 93세,2021,72,11,61,18,72,11,61,18
35380, 부안군,095005, 94세,2021,57,7,50,14,57,7,50,14
35380, 부안군,100,95~99세,2021,66,13,53,24.5,66,13,53,24.5
35380, 부안군,100001, 95세,2021,20,5,15,33.3,20,5,15,33.3
35380, 부안군,100002, 96세,2021,18,X,15,20,18,X,15,20
35380, 부안군,100003, 97세,2021,6,X,X,50,6,X,X,50
35380, 부안군,100004, 98세,2021,15,X,13,15.4,15,X,13,15.4
35380, 부안군,100005, 99세,2021,7,X,6,16.7,7,X,6,16.7
35380, 부안군,101,100세이상,2021,14,X,13,7.7,14,X,13,7.7
35380, 부안군,102,15세미만,2021,3916,2052,1864,110.1,3909,2048,1861,110
35380, 부안군,103,15~64세,2021,27360,14867,12493,119,26319,14293,12026,118.9
35380, 부안군,104,65세이상,2021,16480,6833,9647,70.8,16453,6820,9633,70.8
35380, 부안군,086,85세이상,2021,2219,570,1649,34.6,2217,569,1648,34.5
35380, 부안군,126,평균연령,2021,53.2,50.6,55.8,,53.5,50.9,56.1,
35380, 부안군,127,중위연령,2021,57.3,54.3,60.4,,57.9,55,60.7,
36,전라남도,000,합계,2021,1778124,897120,881004,101.8,1733965,870400,863565,100.8
36,전라남도,005,0~4세,2021,51335,26251,25084,104.7,51080,26119,24961,104.6
36,전라남도,005001, 0세,2021,8669,4347,4322,100.6,8615,4318,4297,100.5
36,전라남도,005002, 1세,2021,9623,4982,4641,107.3,9583,4965,4618,107.5
36,전라남도,005003, 2세,2021,10451,5291,5160,102.5,10398,5255,5143,102.2
36,전라남도,005004, 3세,2021,10894,5561,5333,104.3,10836,5531,5305,104.3
36,전라남도,005005, 4세,2021,11698,6070,5628,107.9,11648,6050,5598,108.1
36,전라남도,010,5~9세,2021,72690,36956,35734,103.4,72453,36849,35604,103.5
36,전라남도,010001, 5세,2021,13352,6803,6549,103.9,13297,6777,6520,103.9
36,전라남도,010002, 6세,2021,14033,7171,6862,104.5,13981,7150,6831,104.7
36,전라남도,010003, 7세,2021,14048,7137,6911,103.3,13998,7117,6881,103.4
36,전라남도,010004, 8세,2021,14957,7684,7273,105.7,14918,7667,7251,105.7
36,전라남도,010005, 9세,2021,16300,8161,8139,100.3,16259,8138,8121,100.2
36,전라남도,015,10~14세,2021,78516,40360,38156,105.8,78365,40299,38066,105.9
36,전라남도,015001, 10세,2021,16493,8362,8131,102.8,16458,8347,8111,102.9
36,전라남도,015002, 11세,2021,15367,8030,7337,109.4,15341,8020,7321,109.5
36,전라남도,015003, 12세,2021,14932,7649,7283,105,14904,7641,7263,105.2
36,전라남도,015004, 13세,2021,15633,8027,7606,105.5,15606,8015,7591,105.6
36,전라남도,015005, 14세,2021,16091,8292,7799,106.3,16056,8276,7780,106.4
36,전라남도,020,15~19세,2021,76785,40819,35966,113.5,76376,40588,35788,113.4
36,전라남도,020001, 15세,2021,14917,7689,7228,106.4,14885,7675,7210,106.4
36,전라남도,020002, 16세,2021,14735,7561,7174,105.4,14709,7545,7164,105.3
36,전라남도,020003, 17세,2021,16620,8672,7948,109.1,16582,8652,7930,109.1
36,전라남도,020004, 18세,2021,16376,8647,7729,111.9,16298,8614,7684,112.1
36,전라남도,020005, 19세,2021,14137,8250,5887,140.1,13902,8102,5800,139.7
36,전라남도,025,20~24세,2021,91569,54046,37523,144,87062,51286,35776,143.4
36,전라남도,025001, 20세,2021,17184,10676,6508,164,16827,10472,6355,164.8
36,전라남도,025002, 21세,2021,19370,11798,7572,155.8,18692,11411,7281,156.7
36,전라남도,025003, 22세,2021,17984,10587,7397,143.1,17133,10086,7047,143.1
36,전라남도,025004, 23세,2021,18039,10257,7782,131.8,16874,9531,7343,129.8
36,전라남도,025005, 24세,2021,18992,10728,8264,129.8,17536,9786,7750,126.3
36,전라남도,030,25~29세,2021,96458,55084,41374,133.1,87269,48745,38524,126.5
36,전라남도,030001, 25세,2021,19398,11190,8208,136.3,17887,10152,7735,131.2
36,전라남도,030002, 26세,2021,19786,11474,8312,138,17916,10187,7729,131.8
36,전라남도,030003, 27세,2021,19227,11140,8087,137.8,17338,9806,7532,130.2
36,전라남도,030004, 28세,2021,19080,10818,8262,130.9,17124,9497,7627,124.5
36,전라남도,030005, 29세,2021,18967,10462,8505,123,17004,9103,7901,115.2
36,전라남도,035,30~34세,2021,83905,45424,38481,118,75116,39663,35453,111.9
36,전라남도,035001, 30세,2021,17555,9742,7813,124.7,15636,8458,7178,117.8
36,전라남도,035002, 31세,2021,17136,9440,7696,122.7,15296,8195,7101,115.4
36,전라남도,035003, 32세,2021,16330,8870,7460,118.9,14602,7730,6872,112.5
36,전라남도,035004, 33세,2021,16165,8618,7547,114.2,14489,7551,6938,108.8
36,전라남도,035005, 34세,2021,16719,8754,7965,109.9,15093,7729,7364,105
36,전라남도,040,35~39세,2021,100987,53497,47490,112.6,94367,49316,45051,109.5
36,전라남도,040001, 35세,2021,17478,9286,8192,113.4,15968,8307,7661,108.4
36,전라남도,040002, 36세,2021,18183,9617,8566,112.3,16756,8740,8016,109
36,전라남도,040003, 37세,2021,19599,10267,9332,110,18305,9451,8854,106.7
36,전라남도,040004, 38세,2021,21666,11449,10217,112.1,20459,10683,9776,109.3
36,전라남도,040005, 39세,2021,24061,12878,11183,115.2,22879,12135,10744,112.9
36,전라남도,045,40~44세,2021,116676,61473,55203,111.4,112433,58924,53509,110.1
36,전라남도,045001, 40세,2021,23039,12333,10706,115.2,22010,11685,10325,113.2
36,전라남도,045002, 41세,2021,24545,12879,11666,110.4,23626,12332,11294,109.2
36,전라남도,045003, 42세,2021,23771,12438,11333,109.8,22944,11926,11018,108.2
36,전라남도,045004, 43세,2021,22150,11727,10423,112.5,21381,11297,10084,112
36,전라남도,045005, 44세,2021,23171,12096,11075,109.2,22472,11684,10788,108.3
36,전라남도,050,45~49세,2021,129210,68669,60541,113.4,126141,67019,59122,113.4
36,전라남도,050001, 45세,2021,22975,12292,10683,115.1,22255,11908,10347,115.1
36,전라남도,050002, 46세,2021,23911,12625,11286,111.9,23301,12271,11030,111.3
36,전라남도,050003, 47세,2021,26845,14303,12542,114,26245,13978,12267,113.9
36,전라남도,050004, 48세,2021,27638,14548,13090,111.1,27061,14253,12808,111.3
36,전라남도,050005, 49세,2021,27841,14901,12940,115.2,27279,14609,12670,115.3
36,전라남도,055,50~54세,2021,150362,79895,70467,113.4,147818,78746,69072,114
36,전라남도,055001, 50세,2021,30408,16347,14061,116.3,29849,16091,13758,117
36,전라남도,055002, 51세,2021,29427,15629,13798,113.3,28899,15369,13530,113.6
36,전라남도,055003, 52세,2021,29750,15725,14025,112.1,29215,15498,13717,113
36,전라남도,055004, 53세,2021,31545,16772,14773,113.5,31058,16549,14509,114.1
36,전라남도,055005, 54세,2021,29232,15422,13810,111.7,28797,15239,13558,112.4
36,전라남도,060,55~59세,2021,148699,78455,70244,111.7,146702,77621,69081,112.4
36,전라남도,060001, 55세,2021,30197,16395,13802,118.8,29787,16227,13560,119.7
36,전라남도,060002, 56세,2021,29901,15780,14121,111.7,29475,15602,13873,112.5
36,전라남도,060003, 57세,2021,28183,14636,13547,108,27759,14476,13283,109
36,전라남도,060004, 58세,2021,30741,16088,14653,109.8,30320,15913,14407,110.5
36,전라남도,060005, 59세,2021,29677,15556,14121,110.2,29361,15403,13958,110.4
36,전라남도,065,60~64세,2021,155641,78618,77023,102.1,154503,78096,76407,102.2
36,전라남도,065001, 60세,2021,32791,16495,16296,101.2,32565,16399,16166,101.4
36,전라남도,065002, 61세,2021,34659,17425,17234,101.1,34361,17285,17076,101.2
36,전라남도,065003, 62세,2021,31262,15676,15586,100.6,31064,15586,15478,100.7
36,전라남도,065004, 63세,2021,28613,14625,13988,104.6,28397,14520,13877,104.6
36,전라남도,065005, 64세,2021,28316,14397,13919,103.4,28116,14306,13810,103.6
36,전라남도,070,65~69세,2021,115614,56904,58710,96.9,115027,56633,58394,97
36,전라남도,070001, 65세,2021,24758,12458,12300,101.3,24602,12386,12216,101.4
36,전라남도,070002, 66세,2021,26621,13213,13408,98.5,26461,13136,13325,98.6
36,전라남도,070003, 67세,2021,22153,10862,11291,96.2,22050,10820,11230,96.3
36,전라남도,070004, 68세,2021,19317,9385,9932,94.5,19231,9342,9889,94.5
36,전라남도,070005, 69세,2021,22765,10986,11779,93.3,22683,10949,11734,93.3
36,전라남도,075,70~74세,2021,100699,47591,53108,89.6,100463,47476,52987,89.6
36,전라남도,075001, 70세,2021,19806,9571,10235,93.5,19737,9537,10200,93.5
36,전라남도,075002, 71세,2021,20351,9729,10622,91.6,20293,9705,10588,91.7
36,전라남도,075003, 72세,2021,20174,9648,10526,91.7,20122,9618,10504,91.6
36,전라남도,075004, 73세,2021,19631,9182,10449,87.9,19603,9171,10432,87.9
36,전라남도,075005, 74세,2021,20737,9461,11276,83.9,20708,9445,11263,83.9
36,전라남도,080,75~79세,2021,83680,34460,49220,70,83583,34432,49151,70.1
36,전라남도,080001, 75세,2021,15560,6970,8590,81.1,15541,6964,8577,81.2
36,전라남도,080002, 76세,2021,15672,6572,9100,72.2,15644,6566,9078,72.3
36,전라남도,080003, 77세,2021,14814,6104,8710,70.1,14801,6099,8702,70.1
36,전라남도,080004, 78세,2021,16586,6607,9979,66.2,16565,6602,9963,66.3
36,전라남도,080005, 79세,2021,21048,8207,12841,63.9,21032,8201,12831,63.9
36,전라남도,085,80~84세,2021,71450,25021,46429,53.9,71381,24999,46382,53.9
36,전라남도,085001, 80세,2021,16763,6303,10460,60.3,16746,6299,10447,60.3
36,전라남도,085002, 81세,2021,15490,5519,9971,55.4,15474,5515,9959,55.4
36,전라남도,085003, 82세,2021,14563,5149,9414,54.7,14549,5144,9405,54.7
36,전라남도,085004, 83세,2021,13009,4330,8679,49.9,13001,4327,8674,49.9
36,전라남도,085005, 84세,2021,11625,3720,7905,47.1,11611,3714,7897,47
36,전라남도,090,85~89세,2021,37653,10373,27280,38,37638,10368,27270,38
36,전라남도,090001, 85세,2021,9847,2943,6904,42.6,9843,2941,6902,42.6
36,전라남도,090002, 86세,2021,9006,2587,6419,40.3,9003,2586,6417,40.3
36,전라남도,090003, 87세,2021,7590,2051,5539,37,7588,2050,5538,37
36,전라남도,090004, 88세,2021,6081,1547,4534,34.1,6078,1547,4531,34.1
36,전라남도,090005, 89세,2021,5129,1245,3884,32.1,5126,1244,3882,32
36,전라남도,095,90~94세,2021,13186,2714,10472,25.9,13179,2711,10468,25.9
36,전라남도,095001, 90세,2021,3935,857,3078,27.8,3934,856,3078,27.8
36,전라남도,095002, 91세,2021,3700,689,3011,22.9,3698,689,3009,22.9
36,전라남도,095003, 92세,2021,2435,556,1879,29.6,2434,556,1878,29.6
36,전라남도,095004, 93세,2021,1804,370,1434,25.8,1801,368,1433,25.7
36,전라남도,095005, 94세,2021,1312,242,1070,22.6,1312,242,1070,22.6
36,전라남도,100,95~99세,2021,2618,470,2148,21.9,2618,470,2148,21.9
36,전라남도,100001, 95세,2021,802,150,652,23,802,150,652,23
36,전라남도,100002, 96세,2021,607,112,495,22.6,607,112,495,22.6
36,전라남도,100003, 97세,2021,441,95,346,27.5,441,95,346,27.5
36,전라남도,100004, 98세,2021,480,71,409,17.4,480,71,409,17.4
36,전라남도,100005, 99세,2021,288,42,246,17.1,288,42,246,17.1
36,전라남도,101,100세이상,2021,391,40,351,11.4,391,40,351,11.4
36,전라남도,102,15세미만,2021,202541,103567,98974,104.6,201898,103267,98631,104.7
36,전라남도,103,15~64세,2021,1150292,615980,534312,115.3,1107787,590004,517783,113.9
36,전라남도,104,65세이상,2021,425291,177573,247718,71.7,424280,177129,247151,71.7
36,전라남도,086,85세이상,2021,53848,13597,40251,33.8,53826,13589,40237,33.8
36,전라남도,126,평균연령,2021,47.1,45.1,49.1,,47.4,45.4,49.3,
36,전라남도,127,중위연령,2021,49.7,47.7,51.8,,50.2,48.4,52.2,
36004, 읍부,000,합계,2021,441857,222917,218940,101.8,427604,214016,213588,100.2
36004, 읍부,005,0~4세,2021,14739,7445,7294,102.1,14637,7388,7249,101.9
36004, 읍부,005001, 0세,2021,2552,1278,1274,100.3,2537,1270,1267,100.2
36004, 읍부,005002, 1세,2021,2790,1451,1339,108.4,2775,1444,1331,108.5
36004, 읍부,005003, 2세,2021,3105,1547,1558,99.3,3076,1527,1549,98.6
36004, 읍부,005004, 3세,2021,3064,1538,1526,100.8,3039,1524,1515,100.6
36004, 읍부,005005, 4세,2021,3228,1631,1597,102.1,3210,1623,1587,102.3
36004, 읍부,010,5~9세,2021,20384,10362,10022,103.4,20252,10298,9954,103.5
36004, 읍부,010001, 5세,2021,3702,1880,1822,103.2,3670,1863,1807,103.1
36004, 읍부,010002, 6세,2021,3885,1973,1912,103.2,3853,1961,1892,103.6
36004, 읍부,010003, 7세,2021,3990,2016,1974,102.1,3966,2006,1960,102.3
36004, 읍부,010004, 8세,2021,4228,2192,2036,107.7,4206,2181,2025,107.7
36004, 읍부,010005, 9세,2021,4579,2301,2278,101,4557,2287,2270,100.7
36004, 읍부,015,10~14세,2021,21795,11120,10675,104.2,21716,11087,10629,104.3
36004, 읍부,015001, 10세,2021,4613,2345,2268,103.4,4591,2336,2255,103.6
36004, 읍부,015002, 11세,2021,4231,2187,2044,107,4216,2180,2036,107.1
36004, 읍부,015003, 12세,2021,4182,2129,2053,103.7,4169,2125,2044,104
36004, 읍부,015004, 13세,2021,4320,2192,2128,103,4308,2187,2121,103.1
36004, 읍부,015005, 14세,2021,4449,2267,2182,103.9,4432,2259,2173,104
36004, 읍부,020,15~19세,2021,21056,11174,9882,113.1,20898,11078,9820,112.8
36004, 읍부,020001, 15세,2021,4163,2188,1975,110.8,4148,2180,1968,110.8
36004, 읍부,020002, 16세,2021,4024,2074,1950,106.4,4015,2069,1946,106.3
36004, 읍부,020003, 17세,2021,4760,2486,2274,109.3,4741,2476,2265,109.3
36004, 읍부,020004, 18세,2021,4574,2407,2167,111.1,4552,2396,2156,111.1
36004, 읍부,020005, 19세,2021,3535,2019,1516,133.2,3442,1957,1485,131.8
36004, 읍부,025,20~24세,2021,22583,13358,9225,144.8,21410,12628,8782,143.8
36004, 읍부,025001, 20세,2021,4291,2702,1589,170,4156,2620,1536,170.6
36004, 읍부,025002, 21세,2021,4907,3036,1871,162.3,4740,2939,1801,163.2
36004, 읍부,025003, 22세,2021,4528,2636,1892,139.3,4313,2508,1805,138.9
36004, 읍부,025004, 23세,2021,4337,2430,1907,127.4,4042,2250,1792,125.6
36004, 읍부,025005, 24세,2021,4520,2554,1966,129.9,4159,2311,1848,125.1
36004, 읍부,030,25~29세,2021,23162,13059,10103,129.3,20535,11168,9367,119.2
36004, 읍부,030001, 25세,2021,4643,2690,1953,137.7,4204,2373,1831,129.6
36004, 읍부,030002, 26세,2021,4715,2671,2044,130.7,4202,2310,1892,122.1
36004, 읍부,030003, 27세,2021,4571,2617,1954,133.9,4041,2223,1818,122.3
36004, 읍부,030004, 28세,2021,4562,2548,2014,126.5,3987,2134,1853,115.2
36004, 읍부,030005, 29세,2021,4671,2533,2138,118.5,4101,2128,1973,107.9
36004, 읍부,035,30~34세,2021,21329,11288,10041,112.4,18557,9396,9161,102.6
36004, 읍부,035001, 30세,2021,4319,2333,1986,117.5,3723,1911,1812,105.5
36004, 읍부,035002, 31세,2021,4367,2357,2010,117.3,3781,1960,1821,107.6
36004, 읍부,035003, 32세,2021,4079,2187,1892,115.6,3548,1821,1727,105.4
36004, 읍부,035004, 33세,2021,4192,2217,1975,112.3,3650,1853,1797,103.1
36004, 읍부,035005, 34세,2021,4372,2194,2178,100.7,3855,1851,2004,92.4
36004, 읍부,040,35~39세,2021,26776,13951,12825,108.8,24595,12498,12097,103.3
36004, 읍부,040001, 35세,2021,4496,2353,2143,109.8,4022,2030,1992,101.9
36004, 읍부,040002, 36세,2021,4810,2505,2305,108.7,4347,2211,2136,103.5
36004, 읍부,040003, 37세,2021,5121,2610,2511,103.9,4680,2316,2364,98
36004, 읍부,040004, 38세,2021,5745,2995,2750,108.9,5333,2711,2622,103.4
36004, 읍부,040005, 39세,2021,6604,3488,3116,111.9,6213,3230,2983,108.3
36004, 읍부,045,40~44세,2021,31344,16305,15039,108.4,29992,15447,14545,106.2
36004, 읍부,045001, 40세,2021,6166,3257,2909,112,5821,3036,2785,109
36004, 읍부,045002, 41세,2021,6582,3379,3203,105.5,6299,3199,3100,103.2
36004, 읍부,045003, 42세,2021,6401,3298,3103,106.3,6159,3142,3017,104.1
36004, 읍부,045004, 43세,2021,6023,3155,2868,110,5775,3003,2772,108.3
36004, 읍부,045005, 44세,2021,6172,3216,2956,108.8,5938,3067,2871,106.8
36004, 읍부,050,45~49세,2021,33826,17990,15836,113.6,32717,17359,15358,113
36004, 읍부,050001, 45세,2021,6134,3296,2838,116.1,5881,3143,2738,114.8
36004, 읍부,050002, 46세,2021,6311,3318,2993,110.9,6087,3182,2905,109.5
36004, 읍부,050003, 47세,2021,7159,3788,3371,112.4,6937,3674,3263,112.6
36004, 읍부,050004, 48세,2021,7090,3744,3346,111.9,6891,3636,3255,111.7
36004, 읍부,050005, 49세,2021,7132,3844,3288,116.9,6921,3724,3197,116.5
36004, 읍부,055,50~54세,2021,36928,19971,16957,117.8,35974,19518,16456,118.6
36004, 읍부,055001, 50세,2021,7779,4279,3500,122.3,7573,4190,3383,123.9
36004, 읍부,055002, 51세,2021,7364,3942,3422,115.2,7166,3849,3317,116
36004, 읍부,055003, 52세,2021,7276,3934,3342,117.7,7092,3854,3238,119
36004, 읍부,055004, 53세,2021,7598,4129,3469,119,7397,4024,3373,119.3
36004, 읍부,055005, 54세,2021,6911,3687,3224,114.4,6746,3601,3145,114.5
36004, 읍부,060,55~59세,2021,34763,18318,16445,111.4,33963,17949,16014,112.1
36004, 읍부,060001, 55세,2021,7181,3937,3244,121.4,7019,3862,3157,122.3
36004, 읍부,060002, 56세,2021,6898,3639,3259,111.7,6742,3565,3177,112.2
36004, 읍부,060003, 57세,2021,6578,3389,3189,106.3,6404,3317,3087,107.5
36004, 읍부,060004, 58세,2021,7126,3731,3395,109.9,6942,3648,3294,110.7
36004, 읍부,060005, 59세,2021,6980,3622,3358,107.9,6856,3557,3299,107.8
36004, 읍부,065,60~64세,2021,35693,18121,17572,103.1,35261,17912,17349,103.2
36004, 읍부,065001, 60세,2021,7593,3817,3776,101.1,7505,3778,3727,101.4
36004, 읍부,065002, 61세,2021,7979,4075,3904,104.4,7866,4021,3845,104.6
36004, 읍부,065003, 62세,2021,7144,3602,3542,101.7,7073,3563,3510,101.5
36004, 읍부,065004, 63세,2021,6463,3346,3117,107.3,6383,3306,3077,107.4
36004, 읍부,065005, 64세,2021,6514,3281,3233,101.5,6434,3244,3190,101.7
36004, 읍부,070,65~69세,2021,26315,12781,13534,94.4,26091,12674,13417,94.5
36004, 읍부,070001, 65세,2021,5625,2868,2757,104,5564,2840,2724,104.3
36004, 읍부,070002, 66세,2021,6012,2949,3063,96.3,5957,2919,3038,96.1
36004, 읍부,070003, 67세,2021,5032,2388,2644,90.3,4986,2369,2617,90.5
36004, 읍부,070004, 68세,2021,4464,2098,2366,88.7,4433,2083,2350,88.6
36004, 읍부,070005, 69세,2021,5182,2478,2704,91.6,5151,2463,2688,91.6
36004, 읍부,075,70~74세,2021,23200,10917,12283,88.9,23117,10881,12236,88.9
36004, 읍부,075001, 70세,2021,4603,2185,2418,90.4,4580,2173,2407,90.3
36004, 읍부,075002, 71세,2021,4715,2204,2511,87.8,4689,2197,2492,88.2
36004, 읍부,075003, 72세,2021,4625,2194,2431,90.3,4605,2183,2422,90.1
36004, 읍부,075004, 73세,2021,4466,2082,2384,87.3,4458,2080,2378,87.5
36004, 읍부,075005, 74세,2021,4791,2252,2539,88.7,4785,2248,2537,88.6
36004, 읍부,080,75~79세,2021,18926,7884,11042,71.4,18885,7873,11012,71.5
36004, 읍부,080001, 75세,2021,3598,1627,1971,82.5,3592,1625,1967,82.6
36004, 읍부,080002, 76세,2021,3602,1553,2049,75.8,3590,1552,2038,76.2
36004, 읍부,080003, 77세,2021,3299,1383,1916,72.2,3291,1380,1911,72.2
36004, 읍부,080004, 78세,2021,3739,1495,2244,66.6,3730,1493,2237,66.7
36004, 읍부,080005, 79세,2021,4688,1826,2862,63.8,4682,1823,2859,63.8
36004, 읍부,085,80~84세,2021,16025,5651,10374,54.5,16000,5644,10356,54.5
36004, 읍부,085001, 80세,2021,3744,1408,2336,60.3,3738,1407,2331,60.4
36004, 읍부,085002, 81세,2021,3515,1244,2271,54.8,3509,1243,2266,54.9
36004, 읍부,085003, 82세,2021,3262,1168,2094,55.8,3258,1167,2091,55.8
36004, 읍부,085004, 83세,2021,2905,1010,1895,53.3,2901,1008,1893,53.2
36004, 읍부,085005, 84세,2021,2599,821,1778,46.2,2594,819,1775,46.1
36004, 읍부,090,85~89세,2021,8826,2430,6396,38,8820,2428,6392,38
36004, 읍부,090001, 85세,2021,2222,677,1545,43.8,2221,676,1545,43.8
36004, 읍부,090002, 86세,2021,2112,613,1499,40.9,2111,613,1498,40.9
36004, 읍부,090003, 87세,2021,1813,498,1315,37.9,1812,498,1314,37.9
36004, 읍부,090004, 88세,2021,1420,352,1068,33,1419,352,1067,33
36004, 읍부,090005, 89세,2021,1259,290,969,29.9,1257,289,968,29.9
36004, 읍부,095,90~94세,2021,3368,672,2696,24.9,3365,670,2695,24.9
36004, 읍부,095001, 90세,2021,1016,215,801,26.8,1015,214,801,26.7
36004, 읍부,095002, 91세,2021,902,157,745,21.1,901,157,744,21.1
36004, 읍부,095003, 92세,2021,646,139,507,27.4,646,139,507,27.4
36004, 읍부,095004, 93세,2021,456,97,359,27,455,96,359,26.7
36004, 읍부,095005, 94세,2021,348,64,284,22.5,348,64,284,22.5
36004, 읍부,100,95~99세,2021,708,111,597,18.6,708,111,597,18.6
36004, 읍부,100001, 95세,2021,194,28,166,16.9,194,28,166,16.9
36004, 읍부,100002, 96세,2021,172,37,135,27.4,172,37,135,27.4
36004, 읍부,100003, 97세,2021,119,22,97,22.7,119,22,97,22.7
36004, 읍부,100004, 98세,2021,141,14,127,11,141,14,127,11
36004, 읍부,100005, 99세,2021,82,10,72,13.9,82,10,72,13.9
36004, 읍부,101,100세이상,2021,111,9,102,8.8,111,9,102,8.8
36004, 읍부,102,15세미만,2021,56918,28927,27991,103.3,56605,28773,27832,103.4
36004, 읍부,103,15~64세,2021,287460,153535,133925,114.6,273902,144953,128949,112.4
36004, 읍부,104,65세이상,2021,97479,40455,57024,70.9,97097,40290,56807,70.9
36004, 읍부,086,85세이상,2021,13013,3222,9791,32.9,13004,3218,9786,32.9
36004, 읍부,126,평균연령,2021,45.7,43.9,47.6,,46,44.2,47.8,
36004, 읍부,127,중위연령,2021,47.7,46,49.6,,48.3,46.9,49.9,
36005, 면부,000,합계,2021,558325,279676,278649,100.4,541930,269151,272779,98.7
36005, 면부,005,0~4세,2021,11206,5809,5397,107.6,11173,5789,5384,107.5
36005, 면부,005001, 0세,2021,1987,1015,972,104.4,1979,1009,970,104
36005, 면부,005002, 1세,2021,2237,1164,1073,108.5,2233,1162,1071,108.5
36005, 면부,005003, 2세,2021,2261,1159,1102,105.2,2254,1155,1099,105.1
36005, 면부,005004, 3세,2021,2262,1173,1089,107.7,2256,1170,1086,107.7
36005, 면부,005005, 4세,2021,2459,1298,1161,111.8,2451,1293,1158,111.7
36005, 면부,010,5~9세,2021,14650,7443,7207,103.3,14627,7431,7196,103.3
36005, 면부,010001, 5세,2021,2693,1377,1316,104.6,2690,1375,1315,104.6
36005, 면부,010002, 6세,2021,2831,1452,1379,105.3,2825,1449,1376,105.3
36005, 면부,010003, 7세,2021,2809,1412,1397,101.1,2804,1409,1395,101
36005, 면부,010004, 8세,2021,3051,1549,1502,103.1,3046,1547,1499,103.2
36005, 면부,010005, 9세,2021,3266,1653,1613,102.5,3262,1651,1611,102.5
36005, 면부,015,10~14세,2021,16073,8419,7654,110,16049,8411,7638,110.1
36005, 면부,015001, 10세,2021,3305,1734,1571,110.4,3300,1733,1567,110.6
36005, 면부,015002, 11세,2021,3124,1670,1454,114.9,3120,1669,1451,115
36005, 면부,015003, 12세,2021,2999,1566,1433,109.3,2996,1565,1431,109.4
36005, 면부,015004, 13세,2021,3225,1684,1541,109.3,3219,1681,1538,109.3
36005, 면부,015005, 14세,2021,3420,1765,1655,106.6,3414,1763,1651,106.8
36005, 면부,020,15~19세,2021,16299,8940,7359,121.5,16249,8918,7331,121.6
36005, 면부,020001, 15세,2021,3059,1607,1452,110.7,3053,1604,1449,110.7
36005, 면부,020002, 16세,2021,3314,1747,1567,111.5,3309,1743,1566,111.3
36005, 면부,020003, 17세,2021,3489,1868,1621,115.2,3478,1863,1615,115.4
36005, 면부,020004, 18세,2021,3366,1866,1500,124.4,3349,1860,1489,124.9
36005, 면부,020005, 19세,2021,3071,1852,1219,151.9,3060,1848,1212,152.5
36005, 면부,025,20~24세,2021,20781,12970,7811,166,19320,11976,7344,163.1
36005, 면부,025001, 20세,2021,3874,2500,1374,182,3827,2477,1350,183.5
36005, 면부,025002, 21세,2021,4273,2715,1558,174.3,4142,2644,1498,176.5
36005, 면부,025003, 22세,2021,3981,2445,1536,159.2,3755,2297,1458,157.5
36005, 면부,025004, 23세,2021,4207,2604,1603,162.4,3786,2296,1490,154.1
36005, 면부,025005, 24세,2021,4446,2706,1740,155.5,3810,2262,1548,146.1
36005, 면부,030,25~29세,2021,22922,14074,8848,159.1,18804,10992,7812,140.7
36005, 면부,030001, 25세,2021,4548,2803,1745,160.6,3913,2332,1581,147.5
36005, 면부,030002, 26세,2021,4782,2980,1802,165.4,3925,2322,1603,144.9
36005, 면부,030003, 27세,2021,4565,2839,1726,164.5,3690,2175,1515,143.6
36005, 면부,030004, 28세,2021,4521,2762,1759,157,3648,2136,1512,141.3
36005, 면부,030005, 29세,2021,4506,2690,1816,148.1,3628,2027,1601,126.6
36005, 면부,035,30~34세,2021,20264,11501,8763,131.2,16631,8993,7638,117.7
36005, 면부,035001, 30세,2021,4227,2472,1755,140.9,3408,1897,1511,125.5
36005, 면부,035002, 31세,2021,4134,2403,1731,138.8,3374,1860,1514,122.9
36005, 면부,035003, 32세,2021,3989,2237,1752,127.7,3245,1718,1527,112.5
36005, 면부,035004, 33세,2021,3898,2146,1752,122.5,3245,1712,1533,111.7
36005, 면부,035005, 34세,2021,4016,2243,1773,126.5,3359,1806,1553,116.3
36005, 면부,040,35~39세,2021,22856,12820,10036,127.7,20317,11211,9106,123.1
36005, 면부,040001, 35세,2021,4135,2300,1835,125.3,3526,1895,1631,116.2
36005, 면부,040002, 36세,2021,4128,2290,1838,124.6,3579,1942,1637,118.6
36005, 면부,040003, 37세,2021,4518,2468,2050,120.4,4048,2177,1871,116.4
36005, 면부,040004, 38세,2021,4859,2738,2121,129.1,4399,2456,1943,126.4
36005, 면부,040005, 39세,2021,5216,3024,2192,138,4765,2741,2024,135.4
36005, 면부,045,40~44세,2021,25844,14737,11107,132.7,24258,13801,10457,132
36005, 면부,045001, 40세,2021,4954,2831,2123,133.3,4568,2588,1980,130.7
36005, 면부,045002, 41세,2021,5435,3053,2382,128.2,5070,2841,2229,127.5
36005, 면부,045003, 42세,2021,5094,2918,2176,134.1,4771,2719,2052,132.5
36005, 면부,045004, 43세,2021,4983,2869,2114,135.7,4718,2729,1989,137.2
36005, 면부,045005, 44세,2021,5378,3066,2312,132.6,5131,2924,2207,132.5
36005, 면부,050,45~49세,2021,31641,18312,13329,137.4,30663,17793,12870,138.3
36005, 면부,050001, 45세,2021,5401,3135,2266,138.3,5172,3021,2151,140.4
36005, 면부,050002, 46세,2021,5616,3230,2386,135.4,5419,3110,2309,134.7
36005, 면부,050003, 47세,2021,6660,3926,2734,143.6,6469,3818,2651,144
36005, 면부,050004, 48세,2021,6937,3943,2994,131.7,6747,3852,2895,133.1
36005, 면부,050005, 49세,2021,7027,4078,2949,138.3,6856,3992,2864,139.4
36005, 면부,055,50~54세,2021,42287,23755,18532,128.2,41534,23424,18110,129.3
36005, 면부,055001, 50세,2021,7926,4613,3313,139.2,7760,4535,3225,140.6
36005, 면부,055002, 51세,2021,7898,4526,3372,134.2,7756,4448,3308,134.5
36005, 면부,055003, 52세,2021,8361,4631,3730,124.2,8191,4562,3629,125.7
36005, 면부,055004, 53세,2021,9228,5155,4073,126.6,9082,5097,3985,127.9
36005, 면부,055005, 54세,2021,8874,4830,4044,119.4,8745,4782,3963,120.7
36005, 면부,060,55~59세,2021,49652,27104,22548,120.2,49060,26885,22175,121.2
36005, 면부,060001, 55세,2021,9552,5334,4218,126.5,9433,5292,4141,127.8
36005, 면부,060002, 56세,2021,9714,5321,4393,121.1,9570,5270,4300,122.6
36005, 면부,060003, 57세,2021,9504,5182,4322,119.9,9379,5141,4238,121.3
36005, 면부,060004, 58세,2021,10436,5633,4803,117.3,10321,5589,4732,118.1
36005, 면부,060005, 59세,2021,10446,5634,4812,117.1,10357,5593,4764,117.4
36005, 면부,065,60~64세,2021,59347,30768,28579,107.7,59031,30629,28402,107.8
36005, 면부,065001, 60세,2021,11861,6175,5686,108.6,11801,6145,5656,108.6
36005, 면부,065002, 61세,2021,13011,6748,6263,107.7,12933,6712,6221,107.9
36005, 면부,065003, 62세,2021,12117,6240,5877,106.2,12061,6222,5839,106.6
36005, 면부,065004, 63세,2021,11289,5847,5442,107.4,11223,5817,5406,107.6
36005, 면부,065005, 64세,2021,11069,5758,5311,108.4,11013,5733,5280,108.6
36005, 면부,070,65~69세,2021,47558,23695,23863,99.3,47390,23623,23767,99.4
36005, 면부,070001, 65세,2021,9939,5120,4819,106.2,9894,5101,4793,106.4
36005, 면부,070002, 66세,2021,10813,5414,5399,100.3,10760,5394,5366,100.5
36005, 면부,070003, 67세,2021,8995,4454,4541,98.1,8972,4443,4529,98.1
36005, 면부,070004, 68세,2021,8136,4035,4101,98.4,8115,4025,4090,98.4
36005, 면부,070005, 69세,2021,9675,4672,5003,93.4,9649,4660,4989,93.4
36005, 면부,075,70~74세,2021,45499,21408,24091,88.9,45427,21371,24056,88.8
36005, 면부,075001, 70세,2021,8503,4053,4450,91.1,8481,4041,4440,91
36005, 면부,075002, 71세,2021,9060,4300,4760,90.3,9046,4294,4752,90.4
36005, 면부,075003, 72세,2021,9144,4438,4706,94.3,9123,4426,4697,94.2
36005, 면부,075004, 73세,2021,9151,4286,4865,88.1,9144,4284,4860,88.1
36005, 면부,075005, 74세,2021,9641,4331,5310,81.6,9633,4326,5307,81.5
36005, 면부,080,75~79세,2021,42323,16809,25514,65.9,42297,16800,25497,65.9
36005, 면부,080001, 75세,2021,7339,3221,4118,78.2,7332,3217,4115,78.2
36005, 면부,080002, 76세,2021,7694,3076,4618,66.6,7686,3074,4612,66.7
36005, 면부,080003, 77세,2021,7506,2963,4543,65.2,7504,2963,4541,65.2
36005, 면부,080004, 78세,2021,8442,3220,5222,61.7,8438,3220,5218,61.7
36005, 면부,080005, 79세,2021,11342,4329,7013,61.7,11337,4326,7011,61.7
36005, 면부,085,80~84세,2021,39610,13562,26048,52.1,39592,13556,26036,52.1
36005, 면부,085001, 80세,2021,9189,3400,5789,58.7,9184,3399,5785,58.8
36005, 면부,085002, 81세,2021,8466,2944,5522,53.3,8463,2943,5520,53.3
36005, 면부,085003, 82세,2021,8150,2831,5319,53.2,8147,2830,5317,53.2
36005, 면부,085004, 83세,2021,7244,2339,4905,47.7,7242,2338,4904,47.7
36005, 면부,085005, 84세,2021,6561,2048,4513,45.4,6556,2046,4510,45.4
36005, 면부,090,85~89세,2021,21019,5770,15249,37.8,21015,5768,15247,37.8
36005, 면부,090001, 85세,2021,5633,1655,3978,41.6,5631,1654,3977,41.6
36005, 면부,090002, 86세,2021,5083,1435,3648,39.3,5082,1435,3647,39.3
36005, 면부,090003, 87세,2021,4161,1122,3039,36.9,4160,1121,3039,36.9
36005, 면부,090004, 88세,2021,3373,864,2509,34.4,3373,864,2509,34.4
36005, 면부,090005, 89세,2021,2769,694,2075,33.4,2769,694,2075,33.4
36005, 면부,095,90~94세,2021,6949,1488,5461,27.2,6948,1488,5460,27.3
36005, 면부,095001, 90세,2021,2052,460,1592,28.9,2052,460,1592,28.9
36005, 면부,095002, 91세,2021,1960,383,1577,24.3,1960,383,1577,24.3
36005, 면부,095003, 92세,2021,1293,319,974,32.8,1293,319,974,32.8
36005, 면부,095004, 93세,2021,971,202,769,26.3,970,202,768,26.3
36005, 면부,095005, 94세,2021,673,124,549,22.6,673,124,549,22.6
36005, 면부,100,95~99세,2021,1347,269,1078,25,1347,269,1078,25
36005, 면부,100001, 95세,2021,424,90,334,26.9,424,90,334,26.9
36005, 면부,100002, 96세,2021,302,58,244,23.8,302,58,244,23.8
36005, 면부,100003, 97세,2021,224,54,170,31.8,224,54,170,31.8
36005, 면부,100004, 98세,2021,251,45,206,21.8,251,45,206,21.8
36005, 면부,100005, 99세,2021,146,22,124,17.7,146,22,124,17.7
36005, 면부,101,100세이상,2021,198,23,175,13.1,198,23,175,13.1
36005, 면부,102,15세미만,2021,41929,21671,20258,107,41849,21631,20218,107
36005, 면부,103,15~64세,2021,311893,174981,136912,127.8,295867,164622,131245,125.4
36005, 면부,104,65세이상,2021,204503,83024,121479,68.3,204214,82898,121316,68.3
36005, 면부,086,85세이상,2021,29513,7550,21963,34.4,29508,7548,21960,34.4
36005, 면부,126,평균연령,2021,54.3,51.3,57.4,,54.9,51.9,57.8,
36005, 면부,127,중위연령,2021,58.5,55.2,61.8,,59.3,56.1,62.2,
36003, 동부,000,합계,2021,777942,394527,383415,102.9,764431,387233,377198,102.7
36003, 동부,005,0~4세,2021,25390,12997,12393,104.9,25270,12942,12328,105
36003, 동부,005001, 0세,2021,4130,2054,2076,98.9,4099,2039,2060,99
36003, 동부,005002, 1세,2021,4596,2367,2229,106.2,4575,2359,2216,106.5
36003, 동부,005003, 2세,2021,5085,2585,2500,103.4,5068,2573,2495,103.1
36003, 동부,005004, 3세,2021,5568,2850,2718,104.9,5541,2837,2704,104.9
36003, 동부,005005, 4세,2021,6011,3141,2870,109.4,5987,3134,2853,109.8
36003, 동부,010,5~9세,2021,37656,19151,18505,103.5,37574,19120,18454,103.6
36003, 동부,010001, 5세,2021,6957,3546,3411,104,6937,3539,3398,104.1
36003, 동부,010002, 6세,2021,7317,3746,3571,104.9,7303,3740,3563,105
36003, 동부,010003, 7세,2021,7249,3709,3540,104.8,7228,3702,3526,105
36003, 동부,010004, 8세,2021,7678,3943,3735,105.6,7666,3939,3727,105.7
36003, 동부,010005, 9세,2021,8455,4207,4248,99,8440,4200,4240,99.1
36003, 동부,015,10~14세,2021,40648,20821,19827,105,40600,20801,19799,105.1
36003, 동부,015001, 10세,2021,8575,4283,4292,99.8,8567,4278,4289,99.7
36003, 동부,015002, 11세,2021,8012,4173,3839,108.7,8005,4171,3834,108.8
36003, 동부,015003, 12세,2021,7751,3954,3797,104.1,7739,3951,3788,104.3
36003, 동부,015004, 13세,2021,8088,4151,3937,105.4,8079,4147,3932,105.5
36003, 동부,015005, 14세,2021,8222,4260,3962,107.5,8210,4254,3956,107.5
36003, 동부,020,15~19세,2021,39430,20705,18725,110.6,39229,20592,18637,110.5
36003, 동부,020001, 15세,2021,7695,3894,3801,102.4,7684,3891,3793,102.6
36003, 동부,020002, 16세,2021,7397,3740,3657,102.3,7385,3733,3652,102.2
36003, 동부,020003, 17세,2021,8371,4318,4053,106.5,8363,4313,4050,106.5
36003, 동부,020004, 18세,2021,8436,4374,4062,107.7,8397,4358,4039,107.9
36003, 동부,020005, 19세,2021,7531,4379,3152,138.9,7400,4297,3103,138.5
36003, 동부,025,20~24세,2021,48205,27718,20487,135.3,46332,26682,19650,135.8
36003, 동부,025001, 20세,2021,9019,5474,3545,154.4,8844,5375,3469,154.9
36003, 동부,025002, 21세,2021,10190,6047,4143,146,9810,5828,3982,146.4
36003, 동부,025003, 22세,2021,9475,5506,3969,138.7,9065,5281,3784,139.6
36003, 동부,025004, 23세,2021,9495,5223,4272,122.3,9046,4985,4061,122.8
36003, 동부,025005, 24세,2021,10026,5468,4558,120,9567,5213,4354,119.7
36003, 동부,030,25~29세,2021,50374,27951,22423,124.7,47930,26585,21345,124.5
36003, 동부,030001, 25세,2021,10207,5697,4510,126.3,9770,5447,4323,126
36003, 동부,030002, 26세,2021,10289,5823,4466,130.4,9789,5555,4234,131.2
36003, 동부,030003, 27세,2021,10091,5684,4407,129,9607,5408,4199,128.8
36003, 동부,030004, 28세,2021,9997,5508,4489,122.7,9489,5227,4262,122.6
36003, 동부,030005, 29세,2021,9790,5239,4551,115.1,9275,4948,4327,114.4
36003, 동부,035,30~34세,2021,42312,22635,19677,115,39928,21274,18654,114
36003, 동부,035001, 30세,2021,9009,4937,4072,121.2,8505,4650,3855,120.6
36003, 동부,035002, 31세,2021,8635,4680,3955,118.3,8141,4375,3766,116.2
36003, 동부,035003, 32세,2021,8262,4446,3816,116.5,7809,4191,3618,115.8
36003, 동부,035004, 33세,2021,8075,4255,3820,111.4,7594,3986,3608,110.5
36003, 동부,035005, 34세,2021,8331,4317,4014,107.5,7879,4072,3807,107
36003, 동부,040,35~39세,2021,51355,26726,24629,108.5,49455,25607,23848,107.4
36003, 동부,040001, 35세,2021,8847,4633,4214,109.9,8420,4382,4038,108.5
36003, 동부,040002, 36세,2021,9245,4822,4423,109,8830,4587,4243,108.1
36003, 동부,040003, 37세,2021,9960,5189,4771,108.8,9577,4958,4619,107.3
36003, 동부,040004, 38세,2021,11062,5716,5346,106.9,10727,5516,5211,105.9
36003, 동부,040005, 39세,2021,12241,6366,5875,108.4,11901,6164,5737,107.4
36003, 동부,045,40~44세,2021,59488,30431,29057,104.7,58183,29676,28507,104.1
36003, 동부,045001, 40세,2021,11919,6245,5674,110.1,11621,6061,5560,109
36003, 동부,045002, 41세,2021,12528,6447,6081,106,12257,6292,5965,105.5
36003, 동부,045003, 42세,2021,12276,6222,6054,102.8,12014,6065,5949,101.9
36003, 동부,045004, 43세,2021,11144,5703,5441,104.8,10888,5565,5323,104.5
36003, 동부,045005, 44세,2021,11621,5814,5807,100.1,11403,5693,5710,99.7
36003, 동부,050,45~49세,2021,63743,32367,31376,103.2,62761,31867,30894,103.1
36003, 동부,050001, 45세,2021,11440,5861,5579,105.1,11202,5744,5458,105.2
36003, 동부,050002, 46세,2021,11984,6077,5907,102.9,11795,5979,5816,102.8
36003, 동부,050003, 47세,2021,13026,6589,6437,102.4,12839,6486,6353,102.1
36003, 동부,050004, 48세,2021,13611,6861,6750,101.6,13423,6765,6658,101.6
36003, 동부,050005, 49세,2021,13682,6979,6703,104.1,13502,6893,6609,104.3
36003, 동부,055,50~54세,2021,71147,36169,34978,103.4,70310,35804,34506,103.8
36003, 동부,055001, 50세,2021,14703,7455,7248,102.9,14516,7366,7150,103
36003, 동부,055002, 51세,2021,14165,7161,7004,102.2,13977,7072,6905,102.4
36003, 동부,055003, 52세,2021,14113,7160,6953,103,13932,7082,6850,103.4
36003, 동부,055004, 53세,2021,14719,7488,7231,103.6,14579,7428,7151,103.9
36003, 동부,055005, 54세,2021,13447,6905,6542,105.5,13306,6856,6450,106.3
36003, 동부,060,55~59세,2021,64284,33033,31251,105.7,63679,32787,30892,106.1
36003, 동부,060001, 55세,2021,13464,7124,6340,112.4,13335,7073,6262,113
36003, 동부,060002, 56세,2021,13289,6820,6469,105.4,13163,6767,6396,105.8
36003, 동부,060003, 57세,2021,12101,6065,6036,100.5,11976,6018,5958,101
36003, 동부,060004, 58세,2021,13179,6724,6455,104.2,13057,6676,6381,104.6
36003, 동부,060005, 59세,2021,12251,6300,5951,105.9,12148,6253,5895,106.1
36003, 동부,065,60~64세,2021,60601,29729,30872,96.3,60211,29555,30656,96.4
36003, 동부,065001, 60세,2021,13337,6503,6834,95.2,13259,6476,6783,95.5
36003, 동부,065002, 61세,2021,13669,6602,7067,93.4,13562,6552,7010,93.5
36003, 동부,065003, 62세,2021,12001,5834,6167,94.6,11930,5801,6129,94.6
36003, 동부,065004, 63세,2021,10861,5432,5429,100.1,10791,5397,5394,100.1
36003, 동부,065005, 64세,2021,10733,5358,5375,99.7,10669,5329,5340,99.8
36003, 동부,070,65~69세,2021,41741,20428,21313,95.8,41546,20336,21210,95.9
36003, 동부,070001, 65세,2021,9194,4470,4724,94.6,9144,4445,4699,94.6
36003, 동부,070002, 66세,2021,9796,4850,4946,98.1,9744,4823,4921,98
36003, 동부,070003, 67세,2021,8126,4020,4106,97.9,8092,4008,4084,98.1
36003, 동부,070004, 68세,2021,6717,3252,3465,93.9,6683,3234,3449,93.8
36003, 동부,070005, 69세,2021,7908,3836,4072,94.2,7883,3826,4057,94.3
36003, 동부,075,70~74세,2021,32000,15266,16734,91.2,31919,15224,16695,91.2
36003, 동부,075001, 70세,2021,6700,3333,3367,99,6676,3323,3353,99.1
36003, 동부,075002, 71세,2021,6576,3225,3351,96.2,6558,3214,3344,96.1
36003, 동부,075003, 72세,2021,6405,3016,3389,89,6394,3009,3385,88.9
36003, 동부,075004, 73세,2021,6014,2814,3200,87.9,6001,2807,3194,87.9
36003, 동부,075005, 74세,2021,6305,2878,3427,84,6290,2871,3419,84
36003, 동부,080,75~79세,2021,22431,9767,12664,77.1,22401,9759,12642,77.2
36003, 동부,080001, 75세,2021,4623,2122,2501,84.8,4617,2122,2495,85.1
36003, 동부,080002, 76세,2021,4376,1943,2433,79.9,4368,1940,2428,79.9
36003, 동부,080003, 77세,2021,4009,1758,2251,78.1,4006,1756,2250,78
36003, 동부,080004, 78세,2021,4405,1892,2513,75.3,4397,1889,2508,75.3
36003, 동부,080005, 79세,2021,5018,2052,2966,69.2,5013,2052,2961,69.3
36003, 동부,085,80~84세,2021,15815,5808,10007,58,15789,5799,9990,58
36003, 동부,085001, 80세,2021,3830,1495,2335,64,3824,1493,2331,64
36003, 동부,085002, 81세,2021,3509,1331,2178,61.1,3502,1329,2173,61.2
36003, 동부,085003, 82세,2021,3151,1150,2001,57.5,3144,1147,1997,57.4
36003, 동부,085004, 83세,2021,2860,981,1879,52.2,2858,981,1877,52.3
36003, 동부,085005, 84세,2021,2465,851,1614,52.7,2461,849,1612,52.7
36003, 동부,090,85~89세,2021,7808,2173,5635,38.6,7803,2172,5631,38.6
36003, 동부,090001, 85세,2021,1992,611,1381,44.2,1991,611,1380,44.3
36003, 동부,090002, 86세,2021,1811,539,1272,42.4,1810,538,1272,42.3
36003, 동부,090003, 87세,2021,1616,431,1185,36.4,1616,431,1185,36.4
36003, 동부,090004, 88세,2021,1288,331,957,34.6,1286,331,955,34.7
36003, 동부,090005, 89세,2021,1101,261,840,31.1,1100,261,839,31.1
36003, 동부,095,90~94세,2021,2869,554,2315,23.9,2866,553,2313,23.9
36003, 동부,095001, 90세,2021,867,182,685,26.6,867,182,685,26.6
36003, 동부,095002, 91세,2021,838,149,689,21.6,837,149,688,21.7
36003, 동부,095003, 92세,2021,496,98,398,24.6,495,98,397,24.7
36003, 동부,095004, 93세,2021,377,71,306,23.2,376,70,306,22.9
36003, 동부,095005, 94세,2021,291,54,237,22.8,291,54,237,22.8
36003, 동부,100,95~99세,2021,563,90,473,19,563,90,473,19
36003, 동부,100001, 95세,2021,184,32,152,21.1,184,32,152,21.1
36003, 동부,100002, 96세,2021,133,17,116,14.7,133,17,116,14.7
36003, 동부,100003, 97세,2021,98,19,79,24.1,98,19,79,24.1
36003, 동부,100004, 98세,2021,88,12,76,15.8,88,12,76,15.8
36003, 동부,100005, 99세,2021,60,10,50,20,60,10,50,20
36003, 동부,101,100세이상,2021,82,8,74,10.8,82,8,74,10.8
36003, 동부,102,15세미만,2021,103694,52969,50725,104.4,103444,52863,50581,104.5
36003, 동부,103,15~64세,2021,550939,287464,263475,109.1,538018,280429,257589,108.9
36003, 동부,104,65세이상,2021,123309,54094,69215,78.2,122969,53941,69028,78.1
36003, 동부,086,85세이상,2021,11322,2825,8497,33.2,11314,2823,8491,33.2
36003, 동부,126,평균연령,2021,42.8,41.5,44.1,,42.9,41.6,44.2,
36003, 동부,127,중위연령,2021,44.5,42.9,46.1,,44.8,43.3,46.3,
36010, 목포시,000,합계,2021,221178,110831,110347,100.4,216961,108409,108552,99.9
36010, 목포시,005,0~4세,2021,5868,3027,2841,106.5,5840,3016,2824,106.8
36010, 목포시,005001, 0세,2021,822,419,403,104,816,416,400,104
36010, 목포시,005002, 1세,2021,970,512,458,111.8,961,508,453,112.1
36010, 목포시,005003, 2세,2021,1202,609,593,102.7,1199,607,592,102.5
36010, 목포시,005004, 3세,2021,1360,722,638,113.2,1356,720,636,113.2
36010, 목포시,005005, 4세,2021,1514,765,749,102.1,1508,765,743,103
36010, 목포시,010,5~9세,2021,10672,5480,5192,105.5,10648,5472,5176,105.7
36010, 목포시,010001, 5세,2021,1900,984,916,107.4,1894,983,911,107.9
36010, 목포시,010002, 6세,2021,1965,1020,945,107.9,1963,1019,944,107.9
36010, 목포시,010003, 7세,2021,2042,1053,989,106.5,2035,1050,985,106.6
36010, 목포시,010004, 8세,2021,2229,1141,1088,104.9,2226,1141,1085,105.2
36010, 목포시,010005, 9세,2021,2536,1282,1254,102.2,2530,1279,1251,102.2
36010, 목포시,015,10~14세,2021,11948,6132,5816,105.4,11928,6125,5803,105.5
36010, 목포시,015001, 10세,2021,2484,1220,1264,96.5,2480,1217,1263,96.4
36010, 목포시,015002, 11세,2021,2405,1251,1154,108.4,2404,1251,1153,108.5
36010, 목포시,015003, 12세,2021,2315,1203,1112,108.2,2310,1202,1108,108.5
36010, 목포시,015004, 13세,2021,2331,1198,1133,105.7,2327,1198,1129,106.1
36010, 목포시,015005, 14세,2021,2413,1260,1153,109.3,2407,1257,1150,109.3
36010, 목포시,020,15~19세,2021,11201,5904,5297,111.5,11158,5880,5278,111.4
36010, 목포시,020001, 15세,2021,2192,1082,1110,97.5,2191,1082,1109,97.6
36010, 목포시,020002, 16세,2021,2115,1066,1049,101.6,2112,1063,1049,101.3
36010, 목포시,020003, 17세,2021,2260,1156,1104,104.7,2256,1154,1102,104.7
36010, 목포시,020004, 18세,2021,2379,1268,1111,114.1,2373,1265,1108,114.2
36010, 목포시,020005, 19세,2021,2255,1332,923,144.3,2226,1316,910,144.6
36010, 목포시,025,20~24세,2021,14067,8183,5884,139.1,13512,7847,5665,138.5
36010, 목포시,025001, 20세,2021,2739,1715,1024,167.5,2695,1692,1003,168.7
36010, 목포시,025002, 21세,2021,3179,1909,1270,150.3,3025,1809,1216,148.8
36010, 목포시,025003, 22세,2021,2835,1694,1141,148.5,2716,1621,1095,148
36010, 목포시,025004, 23세,2021,2718,1486,1232,120.6,2586,1411,1175,120.1
36010, 목포시,025005, 24세,2021,2596,1379,1217,113.3,2490,1314,1176,111.7
36010, 목포시,030,25~29세,2021,12438,6684,5754,116.2,11746,6257,5489,114
36010, 목포시,030001, 25세,2021,2621,1419,1202,118.1,2511,1359,1152,118
36010, 목포시,030002, 26세,2021,2598,1418,1180,120.2,2476,1353,1123,120.5
36010, 목포시,030003, 27세,2021,2484,1368,1116,122.6,2342,1281,1061,120.7
36010, 목포시,030004, 28세,2021,2349,1246,1103,113,2207,1150,1057,108.8
36010, 목포시,030005, 29세,2021,2386,1233,1153,106.9,2210,1114,1096,101.6
36010, 목포시,035,30~34세,2021,10334,5400,4934,109.4,9560,4928,4632,106.4
36010, 목포시,035001, 30세,2021,2153,1164,989,117.7,1993,1063,930,114.3
36010, 목포시,035002, 31세,2021,2054,1093,961,113.7,1883,989,894,110.6
36010, 목포시,035003, 32세,2021,2038,1063,975,109,1903,979,924,106
36010, 목포시,035004, 33세,2021,1950,1014,936,108.3,1797,921,876,105.1
36010, 목포시,035005, 34세,2021,2139,1066,1073,99.3,1984,976,1008,96.8
36010, 목포시,040,35~39세,2021,14219,7382,6837,108,13597,6981,6616,105.5
36010, 목포시,040001, 35세,2021,2274,1180,1094,107.9,2140,1097,1043,105.2
36010, 목포시,040002, 36세,2021,2481,1266,1215,104.2,2338,1174,1164,100.9
36010, 목포시,040003, 37세,2021,2842,1459,1383,105.5,2715,1380,1335,103.4
36010, 목포시,040004, 38세,2021,3147,1606,1541,104.2,3037,1537,1500,102.5
36010, 목포시,040005, 39세,2021,3475,1871,1604,116.6,3367,1793,1574,113.9
36010, 목포시,045,40~44세,2021,17530,9049,8481,106.7,17124,8810,8314,106
36010, 목포시,045001, 40세,2021,3424,1811,1613,112.3,3339,1754,1585,110.7
36010, 목포시,045002, 41세,2021,3686,1898,1788,106.2,3603,1854,1749,106
36010, 목포시,045003, 42세,2021,3670,1894,1776,106.6,3588,1842,1746,105.5
36010, 목포시,045004, 43세,2021,3310,1726,1584,109,3226,1683,1543,109.1
36010, 목포시,045005, 44세,2021,3440,1720,1720,100,3368,1677,1691,99.2
36010, 목포시,050,45~49세,2021,18723,9653,9070,106.4,18420,9487,8933,106.2
36010, 목포시,050001, 45세,2021,3370,1767,1603,110.2,3288,1725,1563,110.4
36010, 목포시,050002, 46세,2021,3627,1886,1741,108.3,3570,1853,1717,107.9
36010, 목포시,050003, 47세,2021,3809,1937,1872,103.5,3750,1903,1847,103
36010, 목포시,050004, 48세,2021,3985,2019,1966,102.7,3929,1987,1942,102.3
36010, 목포시,050005, 49세,2021,3932,2044,1888,108.3,3883,2019,1864,108.3
36010, 목포시,055,50~54세,2021,19124,9797,9327,105,18849,9674,9175,105.4
36010, 목포시,055001, 50세,2021,4165,2154,2011,107.1,4101,2121,1980,107.1
36010, 목포시,055002, 51세,2021,3924,1988,1936,102.7,3854,1959,1895,103.4
36010, 목포시,055003, 52세,2021,3821,1965,1856,105.9,3769,1941,1828,106.2
36010, 목포시,055004, 53세,2021,3716,1925,1791,107.5,3677,1907,1770,107.7
36010, 목포시,055005, 54세,2021,3498,1765,1733,101.8,3448,1746,1702,102.6
36010, 목포시,060,55~59세,2021,17389,8639,8750,98.7,17162,8547,8615,99.2
36010, 목포시,060001, 55세,2021,3599,1877,1722,109,3553,1861,1692,110
36010, 목포시,060002, 56세,2021,3622,1841,1781,103.4,3581,1825,1756,103.9
36010, 목포시,060003, 57세,2021,3269,1561,1708,91.4,3224,1546,1678,92.1
36010, 목포시,060004, 58세,2021,3524,1693,1831,92.5,3471,1668,1803,92.5
36010, 목포시,060005, 59세,2021,3375,1667,1708,97.6,3333,1647,1686,97.7
36010, 목포시,065,60~64세,2021,17861,8591,9270,92.7,17733,8529,9204,92.7
36010, 목포시,065001, 60세,2021,3870,1824,2046,89.1,3851,1815,2036,89.1
36010, 목포시,065002, 61세,2021,3914,1845,2069,89.2,3870,1825,2045,89.2
36010, 목포시,065003, 62세,2021,3583,1715,1868,91.8,3555,1701,1854,91.7
36010, 목포시,065004, 63세,2021,3263,1615,1648,98,3250,1607,1643,97.8
36010, 목포시,065005, 64세,2021,3231,1592,1639,97.1,3207,1581,1626,97.2
36010, 목포시,070,65~69세,2021,12671,6002,6669,90,12607,5969,6638,89.9
36010, 목포시,070001, 65세,2021,2815,1332,1483,89.8,2799,1324,1475,89.8
36010, 목포시,070002, 66세,2021,2966,1387,1579,87.8,2950,1375,1575,87.3
36010, 목포시,070003, 67세,2021,2288,1123,1165,96.4,2277,1121,1156,97
36010, 목포시,070004, 68세,2021,2126,1015,1111,91.4,2116,1009,1107,91.1
36010, 목포시,070005, 69세,2021,2476,1145,1331,86,2465,1140,1325,86
36010, 목포시,075,70~74세,2021,10240,4683,5557,84.3,10207,4670,5537,84.3
36010, 목포시,075001, 70세,2021,2172,994,1178,84.4,2163,993,1170,84.9
36010, 목포시,075002, 71세,2021,2042,964,1078,89.4,2034,961,1073,89.6
36010, 목포시,075003, 72세,2021,2090,932,1158,80.5,2085,930,1155,80.5
36010, 목포시,075004, 73세,2021,1889,868,1021,85,1884,864,1020,84.7
36010, 목포시,075005, 74세,2021,2047,925,1122,82.4,2041,922,1119,82.4
36010, 목포시,080,75~79세,2021,7886,3379,4507,75,7878,3376,4502,75
36010, 목포시,080001, 75세,2021,1731,765,966,79.2,1730,765,965,79.3
36010, 목포시,080002, 76세,2021,1632,721,911,79.1,1627,719,908,79.2
36010, 목포시,080003, 77세,2021,1404,581,823,70.6,1404,581,823,70.6
36010, 목포시,080004, 78세,2021,1371,595,776,76.7,1369,594,775,76.6
36010, 목포시,080005, 79세,2021,1748,717,1031,69.5,1748,717,1031,69.5
36010, 목포시,085,80~84세,2021,5444,1972,3472,56.8,5430,1967,3463,56.8
36010, 목포시,085001, 80세,2021,1338,512,826,62,1335,512,823,62.2
36010, 목포시,085002, 81세,2021,1209,459,750,61.2,1205,458,747,61.3
36010, 목포시,085003, 82세,2021,1045,388,657,59.1,1040,385,655,58.8
36010, 목포시,085004, 83세,2021,1012,332,680,48.8,1011,332,679,48.9
36010, 목포시,085005, 84세,2021,840,281,559,50.3,839,280,559,50.1
36010, 목포시,090,85~89세,2021,2466,665,1801,36.9,2465,665,1800,36.9
36010, 목포시,090001, 85세,2021,609,175,434,40.3,609,175,434,40.3
36010, 목포시,090002, 86세,2021,562,166,396,41.9,562,166,396,41.9
36010, 목포시,090003, 87세,2021,531,140,391,35.8,531,140,391,35.8
36010, 목포시,090004, 88세,2021,406,100,306,32.7,405,100,305,32.8
36010, 목포시,090005, 89세,2021,358,84,274,30.7,358,84,274,30.7
36010, 목포시,095,90~94세,2021,877,179,698,25.6,877,179,698,25.6
36010, 목포시,095001, 90세,2021,258,59,199,29.6,258,59,199,29.6
36010, 목포시,095002, 91세,2021,276,48,228,21.1,276,48,228,21.1
36010, 목포시,095003, 92세,2021,145,29,116,25,145,29,116,25
36010, 목포시,095004, 93세,2021,106,24,82,29.3,106,24,82,29.3
36010, 목포시,095005, 94세,2021,92,19,73,26,92,19,73,26
36010, 목포시,100,95~99세,2021,190,25,165,15.2,190,25,165,15.2
36010, 목포시,100001, 95세,2021,62,11,51,21.6,62,11,51,21.6
36010, 목포시,100002, 96세,2021,44,6,38,15.8,44,6,38,15.8
36010, 목포시,100003, 97세,2021,31,X,29,6.9,31,X,29,6.9
36010, 목포시,100004, 98세,2021,34,X,30,13.3,34,X,30,13.3
36010, 목포시,100005, 99세,2021,19,X,17,11.8,19,X,17,11.8
36010, 목포시,101,100세이상,2021,30,5,25,20,30,5,25,20
36010, 목포시,102,15세미만,2021,28488,14639,13849,105.7,28416,14613,13803,105.9
36010, 목포시,103,15~64세,2021,152886,79282,73604,107.7,148861,76940,71921,107
36010, 목포시,104,65세이상,2021,39804,16910,22894,73.9,39684,16856,22828,73.8
36010, 목포시,086,85세이상,2021,3563,874,2689,32.5,3562,874,2688,32.5
36010, 목포시,126,평균연령,2021,43.8,42.3,45.4,,44,42.4,45.5,
36010, 목포시,127,중위연령,2021,45.7,43.9,47.4,,46,44.3,47.6,
36020, 여수시,000,합계,2021,268687,138498,130189,106.4,262421,134168,128253,104.6
36020, 여수시,005,0~4세,2021,8042,4100,3942,104,8022,4093,3929,104.2
36020, 여수시,005001, 0세,2021,1379,667,712,93.7,1375,665,710,93.7
36020, 여수시,005002, 1세,2021,1484,782,702,111.4,1481,782,699,111.9
36020, 여수시,005003, 2세,2021,1562,814,748,108.8,1558,813,745,109.1
36020, 여수시,005004, 3세,2021,1710,840,870,96.6,1704,837,867,96.5
36020, 여수시,005005, 4세,2021,1907,997,910,109.6,1904,996,908,109.7
36020, 여수시,010,5~9세,2021,11539,5817,5722,101.7,11529,5812,5717,101.7
36020, 여수시,010001, 5세,2021,2200,1124,1076,104.5,2199,1123,1076,104.4
36020, 여수시,010002, 6세,2021,2275,1133,1142,99.2,2273,1132,1141,99.2
36020, 여수시,010003, 7세,2021,2228,1168,1060,110.2,2223,1167,1056,110.5
36020, 여수시,010004, 8세,2021,2365,1225,1140,107.5,2365,1225,1140,107.5
36020, 여수시,010005, 9세,2021,2471,1167,1304,89.5,2469,1165,1304,89.3
36020, 여수시,015,10~14세,2021,12194,6204,5990,103.6,12183,6201,5982,103.7
36020, 여수시,015001, 10세,2021,2636,1339,1297,103.2,2633,1338,1295,103.3
36020, 여수시,015002, 11세,2021,2307,1204,1103,109.2,2306,1204,1102,109.3
36020, 여수시,015003, 12세,2021,2255,1157,1098,105.4,2254,1157,1097,105.5
36020, 여수시,015004, 13세,2021,2459,1242,1217,102.1,2457,1241,1216,102.1
36020, 여수시,015005, 14세,2021,2537,1262,1275,99,2533,1261,1272,99.1
36020, 여수시,020,15~19세,2021,11792,6418,5374,119.4,11709,6364,5345,119.1
36020, 여수시,020001, 15세,2021,2336,1212,1124,107.8,2332,1211,1121,108
36020, 여수시,020002, 16세,2021,2272,1166,1106,105.4,2268,1165,1103,105.6
36020, 여수시,020003, 17세,2021,2581,1391,1190,116.9,2578,1388,1190,116.6
36020, 여수시,020004, 18세,2021,2491,1319,1172,112.5,2477,1310,1167,112.3
36020, 여수시,020005, 19세,2021,2112,1330,782,170.1,2054,1290,764,168.8
36020, 여수시,025,20~24세,2021,14039,8602,5437,158.2,13402,8182,5220,156.7
36020, 여수시,025001, 20세,2021,2513,1709,804,212.6,2448,1671,777,215.1
36020, 여수시,025002, 21세,2021,2841,1810,1031,175.6,2743,1750,993,176.2
36020, 여수시,025003, 22세,2021,2687,1625,1062,153,2570,1550,1020,152
36020, 여수시,025004, 23세,2021,2834,1621,1213,133.6,2670,1513,1157,130.8
36020, 여수시,025005, 24세,2021,3164,1837,1327,138.4,2971,1698,1273,133.4
36020, 여수시,030,25~29세,2021,16449,9710,6739,144.1,15226,8815,6411,137.5
36020, 여수시,030001, 25세,2021,3318,1982,1336,148.4,3110,1824,1286,141.8
36020, 여수시,030002, 26세,2021,3370,2018,1352,149.3,3094,1813,1281,141.5
36020, 여수시,030003, 27세,2021,3173,1887,1286,146.7,2971,1734,1237,140.2
36020, 여수시,030004, 28세,2021,3310,1930,1380,139.9,3027,1733,1294,133.9
36020, 여수시,030005, 29세,2021,3278,1893,1385,136.7,3024,1711,1313,130.3
36020, 여수시,035,30~34세,2021,13944,7873,6071,129.7,12648,6892,5756,119.7
36020, 여수시,035001, 30세,2021,2879,1637,1242,131.8,2637,1446,1191,121.4
36020, 여수시,035002, 31세,2021,2872,1597,1275,125.3,2601,1388,1213,114.4
36020, 여수시,035003, 32세,2021,2687,1544,1143,135.1,2427,1348,1079,124.9
36020, 여수시,035004, 33세,2021,2730,1545,1185,130.4,2463,1345,1118,120.3
36020, 여수시,035005, 34세,2021,2776,1550,1226,126.4,2520,1365,1155,118.2
36020, 여수시,040,35~39세,2021,16743,9093,7650,118.9,15679,8315,7364,112.9
36020, 여수시,040001, 35세,2021,2957,1638,1319,124.2,2720,1459,1261,115.7
36020, 여수시,040002, 36세,2021,2991,1642,1349,121.7,2767,1476,1291,114.3
36020, 여수시,040003, 37세,2021,3157,1727,1430,120.8,2949,1572,1377,114.2
36020, 여수시,040004, 38세,2021,3618,1902,1716,110.8,3426,1769,1657,106.8
36020, 여수시,040005, 39세,2021,4020,2184,1836,119,3817,2039,1778,114.7
36020, 여수시,045,40~44세,2021,19012,10081,8931,112.9,18331,9562,8769,109
36020, 여수시,045001, 40세,2021,3858,2104,1754,120,3682,1969,1713,114.9
36020, 여수시,045002, 41세,2021,3909,2090,1819,114.9,3759,1970,1789,110.1
36020, 여수시,045003, 42세,2021,3906,2047,1859,110.1,3766,1940,1826,106.2
36020, 여수시,045004, 43세,2021,3641,1899,1742,109,3523,1815,1708,106.3
36020, 여수시,045005, 44세,2021,3698,1941,1757,110.5,3601,1868,1733,107.8
36020, 여수시,050,45~49세,2021,20918,11122,9796,113.5,20435,10801,9634,112.1
36020, 여수시,050001, 45세,2021,3730,2022,1708,118.4,3627,1957,1670,117.2
36020, 여수시,050002, 46세,2021,3810,1989,1821,109.2,3698,1912,1786,107.1
36020, 여수시,050003, 47세,2021,4360,2292,2068,110.8,4263,2223,2040,109
36020, 여수시,050004, 48세,2021,4518,2406,2112,113.9,4434,2356,2078,113.4
36020, 여수시,050005, 49세,2021,4500,2413,2087,115.6,4413,2353,2060,114.2
36020, 여수시,055,50~54세,2021,23514,12308,11206,109.8,23173,12136,11037,110
36020, 여수시,055001, 50세,2021,4910,2604,2306,112.9,4833,2562,2271,112.8
36020, 여수시,055002, 51세,2021,4667,2475,2192,112.9,4590,2432,2158,112.7
36020, 여수시,055003, 52세,2021,4636,2470,2166,114,4554,2432,2122,114.6
36020, 여수시,055004, 53세,2021,4846,2501,2345,106.7,4788,2470,2318,106.6
36020, 여수시,055005, 54세,2021,4455,2258,2197,102.8,4408,2240,2168,103.3
36020, 여수시,060,55~59세,2021,22917,11922,10995,108.4,22696,11833,10863,108.9
36020, 여수시,060001, 55세,2021,4610,2414,2196,109.9,4567,2393,2174,110.1
36020, 여수시,060002, 56세,2021,4539,2342,2197,106.6,4479,2323,2156,107.7
36020, 여수시,060003, 57세,2021,4357,2276,2081,109.4,4306,2255,2051,109.9
36020, 여수시,060004, 58세,2021,4877,2514,2363,106.4,4841,2501,2340,106.9
36020, 여수시,060005, 59세,2021,4534,2376,2158,110.1,4503,2361,2142,110.2
36020, 여수시,065,60~64세,2021,23194,11355,11839,95.9,23086,11307,11779,96
36020, 여수시,065001, 60세,2021,4956,2391,2565,93.2,4928,2379,2549,93.3
36020, 여수시,065002, 61세,2021,5184,2505,2679,93.5,5155,2492,2663,93.6
36020, 여수시,065003, 62세,2021,4621,2272,2349,96.7,4607,2268,2339,97
36020, 여수시,065004, 63세,2021,4201,2083,2118,98.3,4178,2071,2107,98.3
36020, 여수시,065005, 64세,2021,4232,2104,2128,98.9,4218,2097,2121,98.9
36020, 여수시,070,65~69세,2021,17543,8602,8941,96.2,17486,8578,8908,96.3
36020, 여수시,070001, 65세,2021,3693,1807,1886,95.8,3675,1802,1873,96.2
36020, 여수시,070002, 66세,2021,4109,2039,2070,98.5,4093,2030,2063,98.4
36020, 여수시,070003, 67세,2021,3520,1735,1785,97.2,3510,1731,1779,97.3
36020, 여수시,070004, 68세,2021,2737,1325,1412,93.8,2731,1322,1409,93.8
36020, 여수시,070005, 69세,2021,3484,1696,1788,94.9,3477,1693,1784,94.9
36020, 여수시,075,70~74세,2021,14293,6926,7367,94,14276,6914,7362,93.9
36020, 여수시,075001, 70세,2021,2983,1522,1461,104.2,2979,1519,1460,104
36020, 여수시,075002, 71세,2021,2953,1454,1499,97,2948,1449,1499,96.7
36020, 여수시,075003, 72세,2021,2784,1365,1419,96.2,2782,1364,1418,96.2
36020, 여수시,075004, 73세,2021,2708,1273,1435,88.7,2705,1272,1433,88.8
36020, 여수시,075005, 74세,2021,2865,1312,1553,84.5,2862,1310,1552,84.4
36020, 여수시,080,75~79세,2021,9998,4351,5647,77,9993,4350,5643,77.1
36020, 여수시,080001, 75세,2021,2007,954,1053,90.6,2004,954,1050,90.9
36020, 여수시,080002, 76세,2021,1866,813,1053,77.2,1866,813,1053,77.2
36020, 여수시,080003, 77세,2021,1794,799,995,80.3,1793,799,994,80.4
36020, 여수시,080004, 78세,2021,2066,877,1189,73.8,2065,876,1189,73.7
36020, 여수시,080005, 79세,2021,2265,908,1357,66.9,2265,908,1357,66.9
36020, 여수시,085,80~84세,2021,7312,2723,4589,59.3,7305,2722,4583,59.4
36020, 여수시,085001, 80세,2021,1797,698,1099,63.5,1796,697,1099,63.4
36020, 여수시,085002, 81세,2021,1641,624,1017,61.4,1639,624,1015,61.5
36020, 여수시,085003, 82세,2021,1473,536,937,57.2,1471,536,935,57.3
36020, 여수시,085004, 83세,2021,1262,457,805,56.8,1262,457,805,56.8
36020, 여수시,085005, 84세,2021,1139,408,731,55.8,1137,408,729,56
36020, 여수시,090,85~89세,2021,3618,1011,2607,38.8,3616,1011,2605,38.8
36020, 여수시,090001, 85세,2021,943,278,665,41.8,942,278,664,41.9
36020, 여수시,090002, 86세,2021,827,233,594,39.2,826,233,593,39.3
36020, 여수시,090003, 87세,2021,717,209,508,41.1,717,209,508,41.1
36020, 여수시,090004, 88세,2021,598,167,431,38.7,598,167,431,38.7
36020, 여수시,090005, 89세,2021,533,124,409,30.3,533,124,409,30.3
36020, 여수시,095,90~94세,2021,1342,245,1097,22.3,1342,245,1097,22.3
36020, 여수시,095001, 90세,2021,421,83,338,24.6,421,83,338,24.6
36020, 여수시,095002, 91세,2021,358,64,294,21.8,358,64,294,21.8
36020, 여수시,095003, 92세,2021,237,43,194,22.2,237,43,194,22.2
36020, 여수시,095004, 93세,2021,188,32,156,20.5,188,32,156,20.5
36020, 여수시,095005, 94세,2021,138,23,115,20,138,23,115,20
36020, 여수시,100,95~99세,2021,253,33,220,15,253,33,220,15
36020, 여수시,100001, 95세,2021,72,6,66,9.1,72,6,66,9.1
36020, 여수시,100002, 96세,2021,60,10,50,20,60,10,50,20
36020, 여수시,100003, 97세,2021,41,9,32,28.1,41,9,32,28.1
36020, 여수시,100004, 98세,2021,52,X,48,8.3,52,X,48,8.3
36020, 여수시,100005, 99세,2021,28,X,24,16.7,28,X,24,16.7
36020, 여수시,101,100세이상,2021,31,X,29,6.9,31,X,29,6.9
36020, 여수시,102,15세미만,2021,31775,16121,15654,103,31734,16106,15628,103.1
36020, 여수시,103,15~64세,2021,182522,98484,84038,117.2,176385,94207,82178,114.6
36020, 여수시,104,65세이상,2021,54390,23893,30497,78.3,54302,23855,30447,78.3
36020, 여수시,086,85세이상,2021,5244,1291,3953,32.7,5242,1291,3951,32.7
36020, 여수시,126,평균연령,2021,45.3,43.7,47.1,,45.6,44,47.2,
36020, 여수시,127,중위연령,2021,47.7,45.7,49.7,,48.2,46.5,50,
36030, 순천시,000,합계,2021,273827,136395,137432,99.2,270979,135112,135867,99.4
36030, 순천시,005,0~4세,2021,9323,4823,4500,107.2,9299,4807,4492,107
36030, 순천시,005001, 0세,2021,1549,778,771,100.9,1542,774,768,100.8
36030, 순천시,005002, 1세,2021,1722,868,854,101.6,1720,867,853,101.6
36030, 순천시,005003, 2세,2021,1907,965,942,102.4,1902,961,941,102.1
36030, 순천시,005004, 3세,2021,1964,1039,925,112.3,1958,1035,923,112.1
36030, 순천시,005005, 4세,2021,2181,1173,1008,116.4,2177,1170,1007,116.2
36030, 순천시,010,5~9세,2021,13308,6758,6550,103.2,13283,6745,6538,103.2
36030, 순천시,010001, 5세,2021,2441,1221,1220,100.1,2435,1217,1218,99.9
36030, 순천시,010002, 6세,2021,2667,1408,1259,111.8,2661,1404,1257,111.7
36030, 순천시,010003, 7세,2021,2613,1309,1304,100.4,2610,1309,1301,100.6
36030, 순천시,010004, 8세,2021,2703,1378,1325,104,2697,1374,1323,103.9
36030, 순천시,010005, 9세,2021,2884,1442,1442,100,2880,1441,1439,100.1
36030, 순천시,015,10~14세,2021,14189,7379,6810,108.4,14178,7370,6808,108.3
36030, 순천시,015001, 10세,2021,2876,1485,1391,106.8,2875,1484,1391,106.7
36030, 순천시,015002, 11세,2021,2761,1466,1295,113.2,2758,1465,1293,113.3
36030, 순천시,015003, 12세,2021,2755,1395,1360,102.6,2754,1394,1360,102.5
36030, 순천시,015004, 13세,2021,2855,1498,1357,110.4,2852,1495,1357,110.2
36030, 순천시,015005, 14세,2021,2942,1535,1407,109.1,2939,1532,1407,108.9
36030, 순천시,020,15~19세,2021,14082,7375,6707,110,14024,7344,6680,109.9
36030, 순천시,020001, 15세,2021,2750,1388,1362,101.9,2742,1385,1357,102.1
36030, 순천시,020002, 16세,2021,2634,1375,1259,109.2,2633,1375,1258,109.3
36030, 순천시,020003, 17세,2021,2987,1533,1454,105.4,2985,1531,1454,105.3
36030, 순천시,020004, 18세,2021,2984,1576,1408,111.9,2972,1570,1402,112
36030, 순천시,020005, 19세,2021,2727,1503,1224,122.8,2692,1483,1209,122.7
36030, 순천시,025,20~24세,2021,17540,9639,7901,122,17162,9454,7708,122.7
36030, 순천시,025001, 20세,2021,3424,1915,1509,126.9,3378,1886,1492,126.4
36030, 순천시,025002, 21세,2021,3623,2016,1607,125.5,3558,1983,1575,125.9
36030, 순천시,025003, 22세,2021,3462,1891,1571,120.4,3390,1848,1542,119.8
36030, 순천시,025004, 23세,2021,3375,1855,1520,122,3285,1813,1472,123.2
36030, 순천시,025005, 24세,2021,3656,1962,1694,115.8,3551,1924,1627,118.3
36030, 순천시,030,25~29세,2021,17618,9498,8120,117,17068,9235,7833,117.9
36030, 순천시,030001, 25세,2021,3538,1927,1611,119.6,3444,1882,1562,120.5
36030, 순천시,030002, 26세,2021,3626,1981,1645,120.4,3511,1930,1581,122.1
36030, 순천시,030003, 27세,2021,3552,1941,1611,120.5,3432,1881,1551,121.3
36030, 순천시,030004, 28세,2021,3545,1917,1628,117.8,3432,1866,1566,119.2
36030, 순천시,030005, 29세,2021,3357,1732,1625,106.6,3249,1676,1573,106.5
36030, 순천시,035,30~34세,2021,14943,7747,7196,107.7,14452,7519,6933,108.5
36030, 순천시,035001, 30세,2021,3151,1658,1493,111.1,3040,1609,1431,112.4
36030, 순천시,035002, 31세,2021,3085,1633,1452,112.5,2984,1578,1406,112.2
36030, 순천시,035003, 32세,2021,2919,1520,1399,108.6,2815,1474,1341,109.9
36030, 순천시,035004, 33세,2021,2871,1453,1418,102.5,2784,1414,1370,103.2
36030, 순천시,035005, 34세,2021,2917,1483,1434,103.4,2829,1444,1385,104.3
36030, 순천시,040,35~39세,2021,17531,8853,8678,102,17195,8717,8478,102.8
36030, 순천시,040001, 35세,2021,3071,1561,1510,103.4,2992,1530,1462,104.7
36030, 순천시,040002, 36세,2021,3172,1638,1534,106.8,3091,1603,1488,107.7
36030, 순천시,040003, 37세,2021,3546,1772,1774,99.9,3489,1749,1740,100.5
36030, 순천시,040004, 38세,2021,3707,1875,1832,102.3,3650,1854,1796,103.2
36030, 순천시,040005, 39세,2021,4035,2007,2028,99,3973,1981,1992,99.4
36030, 순천시,045,40~44세,2021,19603,9646,9957,96.9,19351,9529,9822,97
36030, 순천시,045001, 40세,2021,3819,1898,1921,98.8,3771,1879,1892,99.3
36030, 순천시,045002, 41세,2021,4249,2117,2132,99.3,4192,2090,2102,99.4
36030, 순천시,045003, 42세,2021,3956,1944,2012,96.6,3897,1915,1982,96.6
36030, 순천시,045004, 43세,2021,3670,1806,1864,96.9,3624,1784,1840,97
36030, 순천시,045005, 44세,2021,3909,1881,2028,92.8,3867,1861,2006,92.8
36030, 순천시,050,45~49세,2021,21835,10642,11193,95.1,21613,10561,11052,95.6
36030, 순천시,050001, 45세,2021,3866,1850,2016,91.8,3815,1832,1983,92.4
36030, 순천시,050002, 46세,2021,4031,1930,2101,91.9,3986,1914,2072,92.4
36030, 순천시,050003, 47세,2021,4573,2273,2300,98.8,4539,2258,2281,99
36030, 순천시,050004, 48세,2021,4698,2266,2432,93.2,4657,2252,2405,93.6
36030, 순천시,050005, 49세,2021,4667,2323,2344,99.1,4616,2305,2311,99.7
36030, 순천시,055,50~54세,2021,24918,12330,12588,98,24738,12255,12483,98.2
36030, 순천시,055001, 50세,2021,4955,2475,2480,99.8,4912,2456,2456,100
36030, 순천시,055002, 51세,2021,4856,2422,2434,99.5,4828,2406,2422,99.3
36030, 순천시,055003, 52세,2021,4912,2381,2531,94.1,4872,2368,2504,94.6
36030, 순천시,055004, 53세,2021,5451,2703,2748,98.4,5414,2687,2727,98.5
36030, 순천시,055005, 54세,2021,4744,2349,2395,98.1,4712,2338,2374,98.5
36030, 순천시,060,55~59세,2021,22947,11696,11251,104,22806,11646,11160,104.4
36030, 순천시,060001, 55세,2021,4685,2392,2293,104.3,4661,2386,2275,104.9
36030, 순천시,060002, 56세,2021,4764,2358,2406,98,4734,2346,2388,98.2
36030, 순천시,060003, 57세,2021,4362,2219,2143,103.5,4331,2209,2122,104.1
36030, 순천시,060004, 58세,2021,4701,2431,2270,107.1,4673,2420,2253,107.4
36030, 순천시,060005, 59세,2021,4435,2296,2139,107.3,4407,2285,2122,107.7
36030, 순천시,065,60~64세,2021,21359,10705,10654,100.5,21268,10667,10601,100.6
36030, 순천시,065001, 60세,2021,4728,2354,2374,99.2,4706,2347,2359,99.5
36030, 순천시,065002, 61세,2021,4933,2479,2454,101,4910,2468,2442,101.1
36030, 순천시,065003, 62세,2021,4296,2100,2196,95.6,4278,2090,2188,95.5
36030, 순천시,065004, 63세,2021,3777,1962,1815,108.1,3760,1955,1805,108.3
36030, 순천시,065005, 64세,2021,3625,1810,1815,99.7,3614,1807,1807,100
36030, 순천시,070,65~69세,2021,13865,6914,6951,99.5,13821,6890,6931,99.4
36030, 순천시,070001, 65세,2021,3026,1525,1501,101.6,3017,1518,1499,101.3
36030, 순천시,070002, 66세,2021,3228,1645,1583,103.9,3214,1639,1575,104.1
36030, 순천시,070003, 67세,2021,2742,1334,1408,94.7,2737,1330,1407,94.5
36030, 순천시,070004, 68세,2021,2248,1122,1126,99.6,2238,1118,1120,99.8
36030, 순천시,070005, 69세,2021,2621,1288,1333,96.6,2615,1285,1330,96.6
36030, 순천시,075,70~74세,2021,10867,5250,5617,93.5,10845,5239,5606,93.5
36030, 순천시,075001, 70세,2021,2217,1109,1108,100.1,2212,1107,1105,100.2
36030, 순천시,075002, 71세,2021,2258,1118,1140,98.1,2253,1117,1136,98.3
36030, 순천시,075003, 72세,2021,2169,1055,1114,94.7,2163,1050,1113,94.3
36030, 순천시,075004, 73세,2021,2080,997,1083,92.1,2076,995,1081,92
36030, 순천시,075005, 74세,2021,2143,971,1172,82.8,2141,970,1171,82.8
36030, 순천시,080,75~79세,2021,7980,3359,4621,72.7,7967,3355,4612,72.7
36030, 순천시,080001, 75세,2021,1516,712,804,88.6,1514,710,804,88.3
36030, 순천시,080002, 76세,2021,1393,594,799,74.3,1389,594,795,74.7
36030, 순천시,080003, 77세,2021,1430,617,813,75.9,1428,615,813,75.6
36030, 순천시,080004, 78세,2021,1750,694,1056,65.7,1748,694,1054,65.8
36030, 순천시,080005, 79세,2021,1891,742,1149,64.6,1888,742,1146,64.7
36030, 순천시,085,80~84세,2021,6523,2385,4138,57.6,6516,2383,4133,57.7
36030, 순천시,085001, 80세,2021,1566,617,949,65,1562,617,945,65.3
36030, 순천시,085002, 81세,2021,1355,512,843,60.7,1354,511,843,60.6
36030, 순천시,085003, 82세,2021,1334,494,840,58.8,1334,494,840,58.8
36030, 순천시,085004, 83세,2021,1195,406,789,51.5,1194,406,788,51.5
36030, 순천시,085005, 84세,2021,1073,356,717,49.7,1072,355,717,49.5
36030, 순천시,090,85~89세,2021,3770,1062,2708,39.2,3767,1062,2705,39.3
36030, 순천시,090001, 85세,2021,953,281,672,41.8,952,281,671,41.9
36030, 순천시,090002, 86세,2021,924,275,649,42.4,924,275,649,42.4
36030, 순천시,090003, 87세,2021,772,214,558,38.4,772,214,558,38.4
36030, 순천시,090004, 88세,2021,636,170,466,36.5,635,170,465,36.6
36030, 순천시,090005, 89세,2021,485,122,363,33.6,484,122,362,33.7
36030, 순천시,095,90~94세,2021,1305,283,1022,27.7,1305,283,1022,27.7
36030, 순천시,095001, 90세,2021,385,96,289,33.2,385,96,289,33.2
36030, 순천시,095002, 91세,2021,367,73,294,24.8,367,73,294,24.8
36030, 순천시,095003, 92세,2021,251,55,196,28.1,251,55,196,28.1
36030, 순천시,095004, 93세,2021,173,36,137,26.3,173,36,137,26.3
36030, 순천시,095005, 94세,2021,129,23,106,21.7,129,23,106,21.7
36030, 순천시,100,95~99세,2021,273,47,226,20.8,273,47,226,20.8
36030, 순천시,100001, 95세,2021,92,17,75,22.7,92,17,75,22.7
36030, 순천시,100002, 96세,2021,69,11,58,19,69,11,58,19
36030, 순천시,100003, 97세,2021,36,8,28,28.6,36,8,28,28.6
36030, 순천시,100004, 98세,2021,35,6,29,20.7,35,6,29,20.7
36030, 순천시,100005, 99세,2021,41,5,36,13.9,41,5,36,13.9
36030, 순천시,101,100세이상,2021,48,X,44,9.1,48,X,44,9.1
36030, 순천시,102,15세미만,2021,36820,18960,17860,106.2,36760,18922,17838,106.1
36030, 순천시,103,15~64세,2021,192376,98131,94245,104.1,189677,96927,92750,104.5
36030, 순천시,104,65세이상,2021,44631,19304,25327,76.2,44542,19263,25279,76.2
36030, 순천시,086,85세이상,2021,5396,1396,4000,34.9,5393,1396,3997,34.9
36030, 순천시,126,평균연령,2021,43,41.6,44.3,,43,41.7,44.4,
36030, 순천시,127,중위연령,2021,44.7,43.1,46.1,,44.9,43.3,46.3,
36040, 나주시,000,합계,2021,115138,57482,57656,99.7,111507,55517,55990,99.2
36040, 나주시,005,0~4세,2021,4391,2275,2116,107.5,4341,2249,2092,107.5
36040, 나주시,005001, 0세,2021,747,381,366,104.1,734,377,357,105.6
36040, 나주시,005002, 1세,2021,825,425,400,106.3,821,424,397,106.8
36040, 나주시,005003, 2세,2021,823,428,395,108.4,813,419,394,106.3
36040, 나주시,005004, 3세,2021,975,511,464,110.1,964,505,459,110
36040, 나주시,005005, 4세,2021,1021,530,491,107.9,1009,524,485,108
36040, 나주시,010,5~9세,2021,5592,2864,2728,105,5559,2854,2705,105.5
36040, 나주시,010001, 5세,2021,1110,553,557,99.3,1101,550,551,99.8
36040, 나주시,010002, 6세,2021,1096,559,537,104.1,1089,558,531,105.1
36040, 나주시,010003, 7세,2021,1069,547,522,104.8,1061,543,518,104.8
36040, 나주시,010004, 8세,2021,1087,562,525,107,1081,561,520,107.9
36040, 나주시,010005, 9세,2021,1230,643,587,109.5,1227,642,585,109.7
36040, 나주시,015,10~14세,2021,4994,2536,2458,103.2,4981,2532,2449,103.4
36040, 나주시,015001, 10세,2021,1117,540,577,93.6,1115,539,576,93.6
36040, 나주시,015002, 11세,2021,995,522,473,110.4,991,520,471,110.4
36040, 나주시,015003, 12세,2021,952,484,468,103.4,947,484,463,104.5
36040, 나주시,015004, 13세,2021,982,494,488,101.2,981,493,488,101
36040, 나주시,015005, 14세,2021,948,496,452,109.7,947,496,451,110
36040, 나주시,020,15~19세,2021,4885,2523,2362,106.8,4860,2514,2346,107.2
36040, 나주시,020001, 15세,2021,848,447,401,111.5,847,446,401,111.2
36040, 나주시,020002, 16세,2021,836,434,402,108,832,431,401,107.5
36040, 나주시,020003, 17세,2021,1139,590,549,107.5,1138,590,548,107.7
36040, 나주시,020004, 18세,2021,1075,522,553,94.4,1067,522,545,95.8
36040, 나주시,020005, 19세,2021,987,530,457,116,976,525,451,116.4
36040, 나주시,025,20~24세,2021,5888,3219,2669,120.6,5258,2845,2413,117.9
36040, 나주시,025001, 20세,2021,1014,569,445,127.9,976,549,427,128.6
36040, 나주시,025002, 21세,2021,1176,623,553,112.7,1085,575,510,112.7
36040, 나주시,025003, 22세,2021,1195,662,533,124.2,1047,583,464,125.6
36040, 나주시,025004, 23세,2021,1255,691,564,122.5,1094,594,500,118.8
36040, 나주시,025005, 24세,2021,1248,674,574,117.4,1056,544,512,106.3
36040, 나주시,030,25~29세,2021,7052,3782,3270,115.7,6238,3265,2973,109.8
36040, 나주시,030001, 25세,2021,1282,699,583,119.9,1118,593,525,113
36040, 나주시,030002, 26세,2021,1370,758,612,123.9,1184,634,550,115.3
36040, 나주시,030003, 27세,2021,1436,774,662,116.9,1261,657,604,108.8
36040, 나주시,030004, 28세,2021,1487,807,680,118.7,1345,720,625,115.2
36040, 나주시,030005, 29세,2021,1477,744,733,101.5,1330,661,669,98.8
36040, 나주시,035,30~34세,2021,7027,3636,3391,107.2,6397,3297,3100,106.4
36040, 나주시,035001, 30세,2021,1447,763,684,111.5,1301,680,621,109.5
36040, 나주시,035002, 31세,2021,1381,755,626,120.6,1261,683,578,118.2
36040, 나주시,035003, 32세,2021,1402,694,708,98,1293,640,653,98
36040, 나주시,035004, 33세,2021,1381,710,671,105.8,1250,644,606,106.3
36040, 나주시,035005, 34세,2021,1416,714,702,101.7,1292,650,642,101.2
36040, 나주시,040,35~39세,2021,7853,4091,3762,108.7,7416,3855,3561,108.3
36040, 나주시,040001, 35세,2021,1417,737,680,108.4,1325,679,646,105.1
36040, 나주시,040002, 36세,2021,1469,740,729,101.5,1372,697,675,103.3
36040, 나주시,040003, 37세,2021,1457,756,701,107.8,1373,706,667,105.8
36040, 나주시,040004, 38세,2021,1687,898,789,113.8,1593,844,749,112.7
36040, 나주시,040005, 39세,2021,1823,960,863,111.2,1753,929,824,112.7
36040, 나주시,045,40~44세,2021,8462,4458,4004,111.3,8148,4304,3844,112
36040, 나주시,045001, 40세,2021,1827,976,851,114.7,1754,934,820,113.9
36040, 나주시,045002, 41세,2021,1780,911,869,104.8,1727,885,842,105.1
36040, 나주시,045003, 42세,2021,1734,912,822,110.9,1667,881,786,112.1
36040, 나주시,045004, 43세,2021,1563,823,740,111.2,1490,796,694,114.7
36040, 나주시,045005, 44세,2021,1558,836,722,115.8,1510,808,702,115.1
36040, 나주시,050,45~49세,2021,7790,4345,3445,126.1,7589,4244,3345,126.9
36040, 나주시,050001, 45세,2021,1503,840,663,126.7,1449,814,635,128.2
36040, 나주시,050002, 46세,2021,1532,842,690,122,1500,825,675,122.2
36040, 나주시,050003, 47세,2021,1572,876,696,125.9,1532,858,674,127.3
36040, 나주시,050004, 48세,2021,1609,913,696,131.2,1572,892,680,131.2
36040, 나주시,050005, 49세,2021,1574,874,700,124.9,1536,855,681,125.6
36040, 나주시,055,50~54세,2021,8089,4319,3770,114.6,7902,4244,3658,116
36040, 나주시,055001, 50세,2021,1639,930,709,131.2,1600,912,688,132.6
36040, 나주시,055002, 51세,2021,1662,905,757,119.6,1620,885,735,120.4
36040, 나주시,055003, 52세,2021,1555,794,761,104.3,1514,774,740,104.6
36040, 나주시,055004, 53세,2021,1647,852,795,107.2,1613,842,771,109.2
36040, 나주시,055005, 54세,2021,1586,838,748,112,1555,831,724,114.8
36040, 나주시,060,55~59세,2021,8231,4338,3893,111.4,8103,4288,3815,112.4
36040, 나주시,060001, 55세,2021,1658,878,780,112.6,1623,867,756,114.7
36040, 나주시,060002, 56세,2021,1667,899,768,117.1,1641,886,755,117.4
36040, 나주시,060003, 57세,2021,1566,769,797,96.5,1535,758,777,97.6
36040, 나주시,060004, 58세,2021,1704,918,786,116.8,1684,909,775,117.3
36040, 나주시,060005, 59세,2021,1636,874,762,114.7,1620,868,752,115.4
36040, 나주시,065,60~64세,2021,9062,4575,4487,102,8968,4535,4433,102.3
36040, 나주시,065001, 60세,2021,1832,917,915,100.2,1813,910,903,100.8
36040, 나주시,065002, 61세,2021,2039,1008,1031,97.8,2016,998,1018,98
36040, 나주시,065003, 62세,2021,1807,917,890,103,1788,908,880,103.2
36040, 나주시,065004, 63세,2021,1721,882,839,105.1,1704,875,829,105.5
36040, 나주시,065005, 64세,2021,1663,851,812,104.8,1647,844,803,105.1
36040, 나주시,070,65~69세,2021,6832,3357,3475,96.6,6786,3338,3448,96.8
36040, 나주시,070001, 65세,2021,1499,755,744,101.5,1489,749,740,101.2
36040, 나주시,070002, 66세,2021,1557,759,798,95.1,1547,756,791,95.6
36040, 나주시,070003, 67세,2021,1331,663,668,99.3,1319,657,662,99.2
36040, 나주시,070004, 68세,2021,1128,542,586,92.5,1118,538,580,92.8
36040, 나주시,070005, 69세,2021,1317,638,679,94,1313,638,675,94.5
36040, 나주시,075,70~74세,2021,5811,2735,3076,88.9,5795,2726,3069,88.8
36040, 나주시,075001, 70세,2021,1067,516,551,93.6,1061,511,550,92.9
36040, 나주시,075002, 71세,2021,1175,570,605,94.2,1172,568,604,94
36040, 나주시,075003, 72세,2021,1216,552,664,83.1,1214,551,663,83.1
36040, 나주시,075004, 73세,2021,1152,535,617,86.7,1151,535,616,86.9
36040, 나주시,075005, 74세,2021,1201,562,639,87.9,1197,561,636,88.2
36040, 나주시,080,75~79세,2021,5125,2076,3049,68.1,5119,2074,3045,68.1
36040, 나주시,080001, 75세,2021,849,358,491,72.9,847,358,489,73.2
36040, 나주시,080002, 76세,2021,993,396,597,66.3,993,396,597,66.3
36040, 나주시,080003, 77세,2021,942,409,533,76.7,942,409,533,76.7
36040, 나주시,080004, 78세,2021,1023,409,614,66.6,1020,407,613,66.4
36040, 나주시,080005, 79세,2021,1318,504,814,61.9,1317,504,813,62
36040, 나주시,085,80~84세,2021,4374,1464,2910,50.3,4370,1464,2906,50.4
36040, 나주시,085001, 80세,2021,996,383,613,62.5,995,383,612,62.6
36040, 나주시,085002, 81세,2021,941,318,623,51,941,318,623,51
36040, 나주시,085003, 82세,2021,860,276,584,47.3,859,276,583,47.3
36040, 나주시,085004, 83세,2021,805,263,542,48.5,805,263,542,48.5
36040, 나주시,085005, 84세,2021,772,224,548,40.9,770,224,546,41
36040, 나주시,090,85~89세,2021,2488,657,1831,35.9,2487,657,1830,35.9
36040, 나주시,090001, 85세,2021,611,178,433,41.1,611,178,433,41.1
36040, 나주시,090002, 86세,2021,592,171,421,40.6,592,171,421,40.6
36040, 나주시,090003, 87세,2021,516,127,389,32.6,516,127,389,32.6
36040, 나주시,090004, 88세,2021,418,95,323,29.4,417,95,322,29.5
36040, 나주시,090005, 89세,2021,351,86,265,32.5,351,86,265,32.5
36040, 나주시,095,90~94세,2021,948,175,773,22.6,946,175,771,22.7
36040, 나주시,095001, 90세,2021,278,50,228,21.9,278,50,228,21.9
36040, 나주시,095002, 91세,2021,262,40,222,18,261,40,221,18.1
36040, 나주시,095003, 92세,2021,172,40,132,30.3,171,40,131,30.5
36040, 나주시,095004, 93세,2021,133,30,103,29.1,133,30,103,29.1
36040, 나주시,095005, 94세,2021,103,15,88,17,103,15,88,17
36040, 나주시,100,95~99세,2021,208,51,157,32.5,208,51,157,32.5
36040, 나주시,100001, 95세,2021,69,12,57,21.1,69,12,57,21.1
36040, 나주시,100002, 96세,2021,46,14,32,43.8,46,14,32,43.8
36040, 나주시,100003, 97세,2021,31,10,21,47.6,31,10,21,47.6
36040, 나주시,100004, 98세,2021,41,8,33,24.2,41,8,33,24.2
36040, 나주시,100005, 99세,2021,21,7,14,50,21,7,14,50
36040, 나주시,101,100세이상,2021,36,6,30,20,36,6,30,20
36040, 나주시,102,15세미만,2021,14977,7675,7302,105.1,14881,7635,7246,105.4
36040, 나주시,103,15~64세,2021,74339,39286,35053,112.1,70879,37391,33488,111.7
36040, 나주시,104,65세이상,2021,25822,10521,15301,68.8,25747,10491,15256,68.8
36040, 나주시,086,85세이상,2021,3680,889,2791,31.9,3677,889,2788,31.9
36040, 나주시,126,평균연령,2021,45.3,43.4,47.2,,45.6,43.8,47.5,
36040, 나주시,127,중위연령,2021,45.9,44.2,48,,46.7,45.1,48.8,
36060, 광양시,000,합계,2021,144226,75350,68876,109.4,142036,74406,67630,110
36060, 광양시,005,0~4세,2021,5361,2723,2638,103.2,5337,2711,2626,103.2
36060, 광양시,005001, 0세,2021,929,480,449,106.9,925,477,448,106.5
36060, 광양시,005002, 1세,2021,984,491,493,99.6,979,487,492,99
36060, 광양시,005003, 2세,2021,1121,543,578,93.9,1119,541,578,93.6
36060, 광양시,005004, 3세,2021,1143,578,565,102.3,1136,575,561,102.5
36060, 광양시,005005, 4세,2021,1184,631,553,114.1,1178,631,547,115.4
36060, 광양시,010,5~9세,2021,7223,3677,3546,103.7,7201,3668,3533,103.8
36060, 광양시,010001, 5세,2021,1298,677,621,109,1295,675,620,108.9
36060, 광양시,010002, 6세,2021,1443,725,718,101,1437,723,714,101.3
36060, 광양시,010003, 7세,2021,1368,669,699,95.7,1362,667,695,96
36060, 광양시,010004, 8세,2021,1519,787,732,107.5,1516,786,730,107.7
36060, 광양시,010005, 9세,2021,1595,819,776,105.5,1591,817,774,105.6
36060, 광양시,015,10~14세,2021,7666,3950,3716,106.3,7654,3947,3707,106.5
36060, 광양시,015001, 10세,2021,1620,816,804,101.5,1617,816,801,101.9
36060, 광양시,015002, 11세,2021,1555,824,731,112.7,1551,823,728,113
36060, 광양시,015003, 12세,2021,1449,736,713,103.2,1447,735,712,103.2
36060, 광양시,015004, 13세,2021,1548,793,755,105,1548,793,755,105
36060, 광양시,015005, 14세,2021,1494,781,713,109.5,1491,780,711,109.7
36060, 광양시,020,15~19세,2021,6883,3666,3217,114,6862,3651,3211,113.7
36060, 광양시,020001, 15세,2021,1466,749,717,104.5,1465,749,716,104.6
36060, 광양시,020002, 16세,2021,1453,730,723,101,1452,729,723,100.8
36060, 광양시,020003, 17세,2021,1504,800,704,113.6,1502,799,703,113.7
36060, 광양시,020004, 18세,2021,1450,780,670,116.4,1448,780,668,116.8
36060, 광양시,020005, 19세,2021,1010,607,403,150.6,995,594,401,148.1
36060, 광양시,025,20~24세,2021,7385,4551,2834,160.6,7219,4488,2731,164.3
36060, 광양시,025001, 20세,2021,1253,857,396,216.4,1231,843,388,217.3
36060, 광양시,025002, 21세,2021,1563,1068,495,215.8,1543,1061,482,220.1
36060, 광양시,025003, 22세,2021,1338,812,526,154.4,1312,808,504,160.3
36060, 광양시,025004, 23세,2021,1472,821,651,126.1,1437,810,627,129.2
36060, 광양시,025005, 24세,2021,1759,993,766,129.6,1696,966,730,132.3
36060, 광양시,030,25~29세,2021,9289,5440,3849,141.3,8951,5291,3660,144.6
36060, 광양시,030001, 25세,2021,1814,1067,747,142.8,1759,1043,716,145.7
36060, 광양시,030002, 26세,2021,1915,1141,774,147.4,1861,1119,742,150.8
36060, 광양시,030003, 27세,2021,1893,1140,753,151.4,1812,1100,712,154.5
36060, 광양시,030004, 28세,2021,1808,1053,755,139.5,1730,1019,711,143.3
36060, 광양시,030005, 29세,2021,1859,1039,820,126.7,1789,1010,779,129.7
36060, 광양시,035,30~34세,2021,8188,4458,3730,119.5,7819,4301,3518,122.3
36060, 광양시,035001, 30세,2021,1822,1047,775,135.1,1740,1013,727,139.3
36060, 광양시,035002, 31세,2021,1688,923,765,120.7,1613,884,729,121.3
36060, 광양시,035003, 32세,2021,1586,899,687,130.9,1516,868,648,134
36060, 광양시,035004, 33세,2021,1528,786,742,105.9,1463,765,698,109.6
36060, 광양시,035005, 34세,2021,1564,803,761,105.5,1487,771,716,107.7
36060, 광양시,040,35~39세,2021,9732,5144,4588,112.1,9396,4999,4397,113.7
36060, 광양시,040001, 35세,2021,1691,892,799,111.6,1615,861,754,114.2
36060, 광양시,040002, 36세,2021,1789,926,863,107.3,1724,903,821,110
36060, 광양시,040003, 37세,2021,1844,955,889,107.4,1772,920,852,108
36060, 광양시,040004, 38세,2021,2089,1124,965,116.5,2027,1094,933,117.3
36060, 광양시,040005, 39세,2021,2319,1247,1072,116.3,2258,1221,1037,117.7
36060, 광양시,045,40~44세,2021,10933,5765,5168,111.6,10702,5660,5042,112.3
36060, 광양시,045001, 40세,2021,2136,1170,966,121.1,2079,1147,932,123.1
36060, 광양시,045002, 41세,2021,2331,1241,1090,113.9,2287,1222,1065,114.7
36060, 광양시,045003, 42세,2021,2251,1179,1072,110,2203,1157,1046,110.6
36060, 광양시,045004, 43세,2021,2082,1119,963,116.2,2037,1093,944,115.8
36060, 광양시,045005, 44세,2021,2133,1056,1077,98.1,2096,1041,1055,98.7
36060, 광양시,050,45~49세,2021,11578,5835,5743,101.6,11397,5753,5644,101.9
36060, 광양시,050001, 45세,2021,2054,1024,1030,99.4,2010,1002,1008,99.4
36060, 광양시,050002, 46세,2021,2122,1090,1032,105.6,2093,1079,1014,106.4
36060, 광양시,050003, 47세,2021,2350,1195,1155,103.5,2317,1182,1135,104.1
36060, 광양시,050004, 48세,2021,2489,1230,1259,97.7,2450,1212,1238,97.9
36060, 광양시,050005, 49세,2021,2563,1296,1267,102.3,2527,1278,1249,102.3
36060, 광양시,055,50~54세,2021,15593,8136,7457,109.1,15416,8063,7353,109.7
36060, 광양시,055001, 50세,2021,3006,1485,1521,97.6,2957,1462,1495,97.8
36060, 광양시,055002, 51세,2021,2914,1442,1472,98,2881,1427,1454,98.1
36060, 광양시,055003, 52세,2021,3127,1610,1517,106.1,3093,1599,1494,107
36060, 광양시,055004, 53세,2021,3408,1851,1557,118.9,3375,1838,1537,119.6
36060, 광양시,055005, 54세,2021,3138,1748,1390,125.8,3110,1737,1373,126.5
36060, 광양시,060,55~59세,2021,13118,7387,5731,128.9,12980,7328,5652,129.7
36060, 광양시,060001, 55세,2021,2991,1773,1218,145.6,2967,1767,1200,147.3
36060, 광양시,060002, 56세,2021,2817,1585,1232,128.7,2782,1570,1212,129.5
36060, 광양시,060003, 57세,2021,2361,1287,1074,119.8,2337,1275,1062,120.1
36060, 광양시,060004, 58세,2021,2601,1455,1146,127,2568,1441,1127,127.9
36060, 광양시,060005, 59세,2021,2348,1287,1061,121.3,2326,1275,1051,121.3
36060, 광양시,065,60~64세,2021,10940,5719,5221,109.5,10843,5681,5162,110.1
36060, 광양시,065001, 60세,2021,2578,1350,1228,109.9,2559,1346,1213,111
36060, 광양시,065002, 61세,2021,2511,1247,1264,98.7,2487,1238,1249,99.1
36060, 광양시,065003, 62세,2021,2128,1094,1034,105.8,2115,1090,1025,106.3
36060, 광양시,065004, 63세,2021,1901,1010,891,113.4,1878,1000,878,113.9
36060, 광양시,065005, 64세,2021,1822,1018,804,126.6,1804,1007,797,126.3
36060, 광양시,070,65~69세,2021,6744,3528,3216,109.7,6697,3506,3191,109.9
36060, 광양시,070001, 65세,2021,1531,816,715,114.1,1515,807,708,114
36060, 광양시,070002, 66세,2021,1601,822,779,105.5,1589,819,770,106.4
36060, 광양시,070003, 67세,2021,1421,732,689,106.2,1413,730,683,106.9
36060, 광양시,070004, 68세,2021,1045,544,501,108.6,1038,539,499,108
36060, 광양시,070005, 69세,2021,1146,614,532,115.4,1142,611,531,115.1
36060, 광양시,075,70~74세,2021,4921,2420,2501,96.8,4904,2413,2491,96.9
36060, 광양시,075001, 70세,2021,1035,537,498,107.8,1029,534,495,107.9
36060, 광양시,075002, 71세,2021,1031,517,514,100.6,1026,514,512,100.4
36060, 광양시,075003, 72세,2021,947,465,482,96.5,945,464,481,96.5
36060, 광양시,075004, 73세,2021,961,453,508,89.2,958,453,505,89.7
36060, 광양시,075005, 74세,2021,947,448,499,89.8,946,448,498,90
36060, 광양시,080,75~79세,2021,3270,1329,1941,68.5,3261,1328,1933,68.7
36060, 광양시,080001, 75세,2021,590,280,310,90.3,587,280,307,91.2
36060, 광양시,080002, 76세,2021,593,258,335,77,592,257,335,76.7
36060, 광양시,080003, 77세,2021,589,223,366,60.9,589,223,366,60.9
36060, 광양시,080004, 78세,2021,699,279,420,66.4,696,279,417,66.9
36060, 광양시,080005, 79세,2021,799,289,510,56.7,797,289,508,56.9
36060, 광양시,085,80~84세,2021,2941,1012,1929,52.5,2938,1010,1928,52.4
36060, 광양시,085001, 80세,2021,642,220,422,52.1,641,219,422,51.9
36060, 광양시,085002, 81세,2021,600,211,389,54.2,600,211,389,54.2
36060, 광양시,085003, 82세,2021,648,230,418,55,647,230,417,55.2
36060, 광양시,085004, 83세,2021,560,188,372,50.5,560,188,372,50.5
36060, 광양시,085005, 84세,2021,491,163,328,49.7,490,162,328,49.4
36060, 광양시,090,85~89세,2021,1684,475,1209,39.3,1683,474,1209,39.2
36060, 광양시,090001, 85세,2021,446,153,293,52.2,446,153,293,52.2
36060, 광양시,090002, 86세,2021,411,123,288,42.7,410,122,288,42.4
36060, 광양시,090003, 87세,2021,332,81,251,32.3,332,81,251,32.3
36060, 광양시,090004, 88세,2021,261,64,197,32.5,261,64,197,32.5
36060, 광양시,090005, 89세,2021,234,54,180,30,234,54,180,30
36060, 광양시,095,90~94세,2021,638,115,523,22,637,114,523,21.8
36060, 광양시,095001, 90세,2021,210,36,174,20.7,210,36,174,20.7
36060, 광양시,095002, 91세,2021,167,27,140,19.3,167,27,140,19.3
36060, 광양시,095003, 92세,2021,98,18,80,22.5,98,18,80,22.5
36060, 광양시,095004, 93세,2021,96,23,73,31.5,95,22,73,30.1
36060, 광양시,095005, 94세,2021,67,11,56,19.6,67,11,56,19.6
36060, 광양시,100,95~99세,2021,124,19,105,18.1,124,19,105,18.1
36060, 광양시,100001, 95세,2021,40,8,32,25,40,8,32,25
36060, 광양시,100002, 96세,2021,20,X,16,25,20,X,16,25
36060, 광양시,100003, 97세,2021,29,X,27,7.4,29,X,27,7.4
36060, 광양시,100004, 98세,2021,22,X,19,15.8,22,X,19,15.8
36060, 광양시,100005, 99세,2021,13,X,11,18.2,13,X,11,18.2
36060, 광양시,101,100세이상,2021,15,X,14,7.1,15,X,14,7.1
36060, 광양시,102,15세미만,2021,20250,10350,9900,104.5,20192,10326,9866,104.7
36060, 광양시,103,15~64세,2021,103639,56101,47538,118,101585,55215,46370,119.1
36060, 광양시,104,65세이상,2021,20337,8899,11438,77.8,20259,8865,11394,77.8
36060, 광양시,086,85세이상,2021,2461,610,1851,33,2459,608,1851,32.8
36060, 광양시,126,평균연령,2021,42.5,41.4,43.7,,42.6,41.5,43.8,
36060, 광양시,127,중위연령,2021,44.7,43.4,46.1,,44.9,43.6,46.4,
36310, 담양군,000,합계,2021,44034,21830,22204,98.3,42776,21230,21546,98.5
36310, 담양군,005,0~4세,2021,966,460,506,90.9,965,460,505,91.1
36310, 담양군,005001, 0세,2021,154,66,88,75,154,66,88,75
36310, 담양군,005002, 1세,2021,210,106,104,101.9,210,106,104,101.9
36310, 담양군,005003, 2세,2021,188,88,100,88,188,88,100,88
36310, 담양군,005004, 3세,2021,224,108,116,93.1,223,108,115,93.9
36310, 담양군,005005, 4세,2021,190,92,98,93.9,190,92,98,93.9
36310, 담양군,010,5~9세,2021,1182,582,600,97,1181,581,600,96.8
36310, 담양군,010001, 5세,2021,214,111,103,107.8,214,111,103,107.8
36310, 담양군,010002, 6세,2021,231,102,129,79.1,231,102,129,79.1
36310, 담양군,010003, 7세,2021,241,119,122,97.5,240,118,122,96.7
36310, 담양군,010004, 8세,2021,243,124,119,104.2,243,124,119,104.2
36310, 담양군,010005, 9세,2021,253,126,127,99.2,253,126,127,99.2
36310, 담양군,015,10~14세,2021,1312,703,609,115.4,1312,703,609,115.4
36310, 담양군,015001, 10세,2021,280,164,116,141.4,280,164,116,141.4
36310, 담양군,015002, 11세,2021,266,134,132,101.5,266,134,132,101.5
36310, 담양군,015003, 12세,2021,250,138,112,123.2,250,138,112,123.2
36310, 담양군,015004, 13세,2021,272,145,127,114.2,272,145,127,114.2
36310, 담양군,015005, 14세,2021,244,122,122,100,244,122,122,100
36310, 담양군,020,15~19세,2021,1860,978,882,110.9,1856,975,881,110.7
36310, 담양군,020001, 15세,2021,265,137,128,107,264,137,127,107.9
36310, 담양군,020002, 16세,2021,331,155,176,88.1,331,155,176,88.1
36310, 담양군,020003, 17세,2021,468,232,236,98.3,466,230,236,97.5
36310, 담양군,020004, 18세,2021,418,229,189,121.2,417,228,189,120.6
36310, 담양군,020005, 19세,2021,378,225,153,147.1,378,225,153,147.1
36310, 담양군,025,20~24세,2021,2191,1413,778,181.6,2070,1346,724,185.9
36310, 담양군,025001, 20세,2021,421,258,163,158.3,419,258,161,160.2
36310, 담양군,025002, 21세,2021,410,270,140,192.9,397,263,134,196.3
36310, 담양군,025003, 22세,2021,451,318,133,239.1,436,309,127,243.3
36310, 담양군,025004, 23세,2021,412,256,156,164.1,374,235,139,169.1
36310, 담양군,025005, 24세,2021,497,311,186,167.2,444,281,163,172.4
36310, 담양군,030,25~29세,2021,2290,1306,984,132.7,1921,1107,814,136
36310, 담양군,030001, 25세,2021,526,333,193,172.5,460,297,163,182.2
36310, 담양군,030002, 26세,2021,484,284,200,142,408,237,171,138.6
36310, 담양군,030003, 27세,2021,425,221,204,108.3,360,187,173,108.1
36310, 담양군,030004, 28세,2021,408,225,183,123,331,191,140,136.4
36310, 담양군,030005, 29세,2021,447,243,204,119.1,362,195,167,116.8
36310, 담양군,035,30~34세,2021,1661,849,812,104.6,1420,740,680,108.8
36310, 담양군,035001, 30세,2021,348,182,166,109.6,301,164,137,119.7
36310, 담양군,035002, 31세,2021,350,174,176,98.9,306,149,157,94.9
36310, 담양군,035003, 32세,2021,327,153,174,87.9,269,128,141,90.8
36310, 담양군,035004, 33세,2021,302,149,153,97.4,256,132,124,106.5
36310, 담양군,035005, 34세,2021,334,191,143,133.6,288,167,121,138
36310, 담양군,040,35~39세,2021,1901,977,924,105.7,1706,887,819,108.3
36310, 담양군,040001, 35세,2021,339,162,177,91.5,297,142,155,91.6
36310, 담양군,040002, 36세,2021,371,192,179,107.3,325,169,156,108.3
36310, 담양군,040003, 37세,2021,361,186,175,106.3,321,166,155,107.1
36310, 담양군,040004, 38세,2021,415,213,202,105.4,379,200,179,111.7
36310, 담양군,040005, 39세,2021,415,224,191,117.3,384,210,174,120.7
36310, 담양군,045,40~44세,2021,2046,1092,954,114.5,1937,1050,887,118.4
36310, 담양군,045001, 40세,2021,417,211,206,102.4,394,202,192,105.2
36310, 담양군,045002, 41세,2021,428,225,203,110.8,403,217,186,116.7
36310, 담양군,045003, 42세,2021,385,202,183,110.4,362,192,170,112.9
36310, 담양군,045004, 43세,2021,413,238,175,136,395,230,165,139.4
36310, 담양군,045005, 44세,2021,403,216,187,115.5,383,209,174,120.1
36310, 담양군,050,45~49세,2021,2642,1464,1178,124.3,2557,1424,1133,125.7
36310, 담양군,050001, 45세,2021,430,239,191,125.1,411,230,181,127.1
36310, 담양군,050002, 46세,2021,495,276,219,126,476,266,210,126.7
36310, 담양군,050003, 47세,2021,575,323,252,128.2,554,313,241,129.9
36310, 담양군,050004, 48세,2021,530,278,252,110.3,515,272,243,111.9
36310, 담양군,050005, 49세,2021,612,348,264,131.8,601,343,258,132.9
36310, 담양군,055,50~54세,2021,3580,1885,1695,111.2,3525,1858,1667,111.5
36310, 담양군,055001, 50세,2021,684,379,305,124.3,674,375,299,125.4
36310, 담양군,055002, 51세,2021,673,356,317,112.3,664,352,312,112.8
36310, 담양군,055003, 52세,2021,698,341,357,95.5,688,335,353,94.9
36310, 담양군,055004, 53세,2021,776,411,365,112.6,761,403,358,112.6
36310, 담양군,055005, 54세,2021,749,398,351,113.4,738,393,345,113.9
36310, 담양군,060,55~59세,2021,4031,2078,1953,106.4,3994,2069,1925,107.5
36310, 담양군,060001, 55세,2021,759,394,365,107.9,752,393,359,109.5
36310, 담양군,060002, 56세,2021,782,389,393,99,772,387,385,100.5
36310, 담양군,060003, 57세,2021,785,398,387,102.8,780,398,382,104.2
36310, 담양군,060004, 58세,2021,847,437,410,106.6,842,436,406,107.4
36310, 담양군,060005, 59세,2021,858,460,398,115.6,848,455,393,115.8
36310, 담양군,065,60~64세,2021,4589,2356,2233,105.5,4566,2348,2218,105.9
36310, 담양군,065001, 60세,2021,934,464,470,98.7,929,461,468,98.5
36310, 담양군,065002, 61세,2021,1025,535,490,109.2,1016,533,483,110.4
36310, 담양군,065003, 62세,2021,943,501,442,113.3,939,499,440,113.4
36310, 담양군,065004, 63세,2021,834,422,412,102.4,831,421,410,102.7
36310, 담양군,065005, 64세,2021,853,434,419,103.6,851,434,417,104.1
36310, 담양군,070,65~69세,2021,3493,1713,1780,96.2,3487,1713,1774,96.6
36310, 담양군,070001, 65세,2021,716,368,348,105.7,713,368,345,106.7
36310, 담양군,070002, 66세,2021,786,375,411,91.2,785,375,410,91.5
36310, 담양군,070003, 67세,2021,704,345,359,96.1,702,345,357,96.6
36310, 담양군,070004, 68세,2021,587,287,300,95.7,587,287,300,95.7
36310, 담양군,070005, 69세,2021,700,338,362,93.4,700,338,362,93.4
36310, 담양군,075,70~74세,2021,3096,1461,1635,89.4,3088,1458,1630,89.4
36310, 담양군,075001, 70세,2021,560,256,304,84.2,558,255,303,84.2
36310, 담양군,075002, 71세,2021,624,297,327,90.8,623,297,326,91.1
36310, 담양군,075003, 72세,2021,591,270,321,84.1,588,269,319,84.3
36310, 담양군,075004, 73세,2021,627,310,317,97.8,626,310,316,98.1
36310, 담양군,075005, 74세,2021,694,328,366,89.6,693,327,366,89.3
36310, 담양군,080,75~79세,2021,2761,1117,1644,67.9,2759,1116,1643,67.9
36310, 담양군,080001, 75세,2021,486,223,263,84.8,485,223,262,85.1
36310, 담양군,080002, 76세,2021,461,197,264,74.6,461,197,264,74.6
36310, 담양군,080003, 77세,2021,462,158,304,52,462,158,304,52
36310, 담양군,080004, 78세,2021,571,237,334,71,571,237,334,71
36310, 담양군,080005, 79세,2021,781,302,479,63,780,301,479,62.8
36310, 담양군,085,80~84세,2021,2500,884,1616,54.7,2499,883,1616,54.6
36310, 담양군,085001, 80세,2021,567,226,341,66.3,567,226,341,66.3
36310, 담양군,085002, 81세,2021,518,177,341,51.9,518,177,341,51.9
36310, 담양군,085003, 82세,2021,563,207,356,58.1,563,207,356,58.1
36310, 담양군,085004, 83세,2021,458,154,304,50.7,458,154,304,50.7
36310, 담양군,085005, 84세,2021,394,120,274,43.8,393,119,274,43.4
36310, 담양군,090,85~89세,2021,1340,380,960,39.6,1340,380,960,39.6
36310, 담양군,090001, 85세,2021,363,111,252,44,363,111,252,44
36310, 담양군,090002, 86세,2021,311,93,218,42.7,311,93,218,42.7
36310, 담양군,090003, 87세,2021,254,70,184,38,254,70,184,38
36310, 담양군,090004, 88세,2021,228,61,167,36.5,228,61,167,36.5
36310, 담양군,090005, 89세,2021,184,45,139,32.4,184,45,139,32.4
36310, 담양군,095,90~94세,2021,472,108,364,29.7,472,108,364,29.7
36310, 담양군,095001, 90세,2021,128,34,94,36.2,128,34,94,36.2
36310, 담양군,095002, 91세,2021,131,30,101,29.7,131,30,101,29.7
36310, 담양군,095003, 92세,2021,90,22,68,32.4,90,22,68,32.4
36310, 담양군,095004, 93세,2021,73,13,60,21.7,73,13,60,21.7
36310, 담양군,095005, 94세,2021,50,9,41,22,50,9,41,22
36310, 담양군,100,95~99세,2021,99,22,77,28.6,99,22,77,28.6
36310, 담양군,100001, 95세,2021,32,5,27,18.5,32,5,27,18.5
36310, 담양군,100002, 96세,2021,20,7,13,53.8,20,7,13,53.8
36310, 담양군,100003, 97세,2021,18,X,14,28.6,18,X,14,28.6
36310, 담양군,100004, 98세,2021,22,X,18,22.2,22,X,18,22.2
36310, 담양군,100005, 99세,2021,7,X,5,40,7,X,5,40
36310, 담양군,101,100세이상,2021,22,X,20,10,22,X,20,10
36310, 담양군,102,15세미만,2021,3460,1745,1715,101.7,3458,1744,1714,101.8
36310, 담양군,103,15~64세,2021,26791,14398,12393,116.2,25552,13804,11748,117.5
36310, 담양군,104,65세이상,2021,13783,5687,8096,70.2,13766,5682,8084,70.3
36310, 담양군,086,85세이상,2021,1933,512,1421,36,1933,512,1421,36
36310, 담양군,126,평균연령,2021,51.6,49.1,54,,52,49.5,54.5,
36310, 담양군,127,중위연령,2021,55.5,53,58.1,,56.2,53.7,58.8,
36320, 곡성군,000,합계,2021,26781,13177,13604,96.9,26192,12864,13328,96.5
36320, 곡성군,005,0~4세,2021,371,189,182,103.8,370,189,181,104.4
36320, 곡성군,005001, 0세,2021,49,22,27,81.5,49,22,27,81.5
36320, 곡성군,005002, 1세,2021,58,28,30,93.3,57,28,29,96.6
36320, 곡성군,005003, 2세,2021,75,42,33,127.3,75,42,33,127.3
36320, 곡성군,005004, 3세,2021,98,51,47,108.5,98,51,47,108.5
36320, 곡성군,005005, 4세,2021,91,46,45,102.2,91,46,45,102.2
36320, 곡성군,010,5~9세,2021,612,324,288,112.5,611,324,287,112.9
36320, 곡성군,010001, 5세,2021,106,54,52,103.8,106,54,52,103.8
36320, 곡성군,010002, 6세,2021,121,58,63,92.1,121,58,63,92.1
36320, 곡성군,010003, 7세,2021,114,59,55,107.3,113,59,54,109.3
36320, 곡성군,010004, 8세,2021,120,68,52,130.8,120,68,52,130.8
36320, 곡성군,010005, 9세,2021,151,85,66,128.8,151,85,66,128.8
36320, 곡성군,015,10~14세,2021,787,414,373,111,786,414,372,111.3
36320, 곡성군,015001, 10세,2021,161,78,83,94,160,78,82,95.1
36320, 곡성군,015002, 11세,2021,148,75,73,102.7,148,75,73,102.7
36320, 곡성군,015003, 12세,2021,149,86,63,136.5,149,86,63,136.5
36320, 곡성군,015004, 13세,2021,169,100,69,144.9,169,100,69,144.9
36320, 곡성군,015005, 14세,2021,160,75,85,88.2,160,75,85,88.2
36320, 곡성군,020,15~19세,2021,1241,708,533,132.8,1241,708,533,132.8
36320, 곡성군,020001, 15세,2021,163,91,72,126.4,163,91,72,126.4
36320, 곡성군,020002, 16세,2021,185,95,90,105.6,185,95,90,105.6
36320, 곡성군,020003, 17세,2021,249,128,121,105.8,249,128,121,105.8
36320, 곡성군,020004, 18세,2021,283,160,123,130.1,283,160,123,130.1
36320, 곡성군,020005, 19세,2021,361,234,127,184.3,361,234,127,184.3
36320, 곡성군,025,20~24세,2021,1576,931,645,144.3,1478,867,611,141.9
36320, 곡성군,025001, 20세,2021,475,303,172,176.2,470,300,170,176.5
36320, 곡성군,025002, 21세,2021,336,195,141,138.3,320,183,137,133.6
36320, 곡성군,025003, 22세,2021,270,159,111,143.2,247,143,104,137.5
36320, 곡성군,025004, 23세,2021,258,145,113,128.3,230,129,101,127.7
36320, 곡성군,025005, 24세,2021,237,129,108,119.4,211,112,99,113.1
36320, 곡성군,030,25~29세,2021,1119,630,489,128.8,987,553,434,127.4
36320, 곡성군,030001, 25세,2021,250,132,118,111.9,221,115,106,108.5
36320, 곡성군,030002, 26세,2021,228,134,94,142.6,204,119,85,140
36320, 곡성군,030003, 27세,2021,219,131,88,148.9,196,116,80,145
36320, 곡성군,030004, 28세,2021,216,113,103,109.7,189,102,87,117.2
36320, 곡성군,030005, 29세,2021,206,120,86,139.5,177,101,76,132.9
36320, 곡성군,035,30~34세,2021,799,441,358,123.2,693,384,309,124.3
36320, 곡성군,035001, 30세,2021,196,113,83,136.1,169,98,71,138
36320, 곡성군,035002, 31세,2021,165,94,71,132.4,141,83,58,143.1
36320, 곡성군,035003, 32세,2021,126,71,55,129.1,108,59,49,120.4
36320, 곡성군,035004, 33세,2021,157,85,72,118.1,134,72,62,116.1
36320, 곡성군,035005, 34세,2021,155,78,77,101.3,141,72,69,104.3
36320, 곡성군,040,35~39세,2021,869,467,402,116.2,797,426,371,114.8
36320, 곡성군,040001, 35세,2021,133,70,63,111.1,124,67,57,117.5
36320, 곡성군,040002, 36세,2021,161,89,72,123.6,144,76,68,111.8
36320, 곡성군,040003, 37세,2021,173,89,84,106,160,79,81,97.5
36320, 곡성군,040004, 38세,2021,190,110,80,137.5,173,103,70,147.1
36320, 곡성군,040005, 39세,2021,212,109,103,105.8,196,101,95,106.3
36320, 곡성군,045,40~44세,2021,1144,620,524,118.3,1099,597,502,118.9
36320, 곡성군,045001, 40세,2021,216,115,101,113.9,207,112,95,117.9
36320, 곡성군,045002, 41세,2021,227,133,94,141.5,217,126,91,138.5
36320, 곡성군,045003, 42세,2021,234,112,122,91.8,224,106,118,89.8
36320, 곡성군,045004, 43세,2021,211,122,89,137.1,207,122,85,143.5
36320, 곡성군,045005, 44세,2021,256,138,118,116.9,244,131,113,115.9
36320, 곡성군,050,45~49세,2021,1581,873,708,123.3,1542,864,678,127.4
36320, 곡성군,050001, 45세,2021,247,137,110,124.5,239,134,105,127.6
36320, 곡성군,050002, 46세,2021,282,147,135,108.9,278,147,131,112.2
36320, 곡성군,050003, 47세,2021,353,187,166,112.7,345,184,161,114.3
36320, 곡성군,050004, 48세,2021,333,191,142,134.5,320,190,130,146.2
36320, 곡성군,050005, 49세,2021,366,211,155,136.1,360,209,151,138.4
36320, 곡성군,055,50~54세,2021,2023,1102,921,119.7,1990,1092,898,121.6
36320, 곡성군,055001, 50세,2021,365,183,182,100.5,362,183,179,102.2
36320, 곡성군,055002, 51세,2021,409,225,184,122.3,399,221,178,124.2
36320, 곡성군,055003, 52세,2021,403,233,170,137.1,397,229,168,136.3
36320, 곡성군,055004, 53세,2021,437,238,199,119.6,430,237,193,122.8
36320, 곡성군,055005, 54세,2021,409,223,186,119.9,402,222,180,123.3
36320, 곡성군,060,55~59세,2021,2288,1238,1050,117.9,2260,1222,1038,117.7
36320, 곡성군,060001, 55세,2021,447,236,211,111.8,440,231,209,110.5
36320, 곡성군,060002, 56세,2021,464,273,191,142.9,458,268,190,141.1
36320, 곡성군,060003, 57세,2021,428,232,196,118.4,422,231,191,120.9
36320, 곡성군,060004, 58세,2021,452,236,216,109.3,446,232,214,108.4
36320, 곡성군,060005, 59세,2021,497,261,236,110.6,494,260,234,111.1
36320, 곡성군,065,60~64세,2021,2762,1457,1305,111.6,2751,1452,1299,111.8
36320, 곡성군,065001, 60세,2021,569,291,278,104.7,569,291,278,104.7
36320, 곡성군,065002, 61세,2021,607,321,286,112.2,602,319,283,112.7
36320, 곡성군,065003, 62세,2021,554,278,276,100.7,551,277,274,101.1
36320, 곡성군,065004, 63세,2021,522,284,238,119.3,521,283,238,118.9
36320, 곡성군,065005, 64세,2021,510,283,227,124.7,508,282,226,124.8
36320, 곡성군,070,65~69세,2021,2063,1023,1040,98.4,2053,1020,1033,98.7
36320, 곡성군,070001, 65세,2021,387,195,192,101.6,384,194,190,102.1
36320, 곡성군,070002, 66세,2021,468,233,235,99.1,466,231,235,98.3
36320, 곡성군,070003, 67세,2021,406,200,206,97.1,403,200,203,98.5
36320, 곡성군,070004, 68세,2021,356,181,175,103.4,355,181,174,104
36320, 곡성군,070005, 69세,2021,446,214,232,92.2,445,214,231,92.6
36320, 곡성군,075,70~74세,2021,2057,946,1111,85.1,2050,941,1109,84.9
36320, 곡성군,075001, 70세,2021,373,161,212,75.9,372,160,212,75.5
36320, 곡성군,075002, 71세,2021,407,199,208,95.7,405,198,207,95.7
36320, 곡성군,075003, 72세,2021,414,199,215,92.6,413,198,215,92.1
36320, 곡성군,075004, 73세,2021,421,187,234,79.9,421,187,234,79.9
36320, 곡성군,075005, 74세,2021,442,200,242,82.6,439,198,241,82.2
36320, 곡성군,080,75~79세,2021,1907,746,1161,64.3,1904,745,1159,64.3
36320, 곡성군,080001, 75세,2021,355,153,202,75.7,355,153,202,75.7
36320, 곡성군,080002, 76세,2021,313,119,194,61.3,311,118,193,61.1
36320, 곡성군,080003, 77세,2021,328,126,202,62.4,328,126,202,62.4
36320, 곡성군,080004, 78세,2021,366,153,213,71.8,366,153,213,71.8
36320, 곡성군,080005, 79세,2021,545,195,350,55.7,544,195,349,55.9
36320, 곡성군,085,80~84세,2021,1951,652,1299,50.2,1949,650,1299,50
36320, 곡성군,085001, 80세,2021,445,153,292,52.4,444,152,292,52.1
36320, 곡성군,085002, 81세,2021,407,132,275,48,407,132,275,48
36320, 곡성군,085003, 82세,2021,393,136,257,52.9,393,136,257,52.9
36320, 곡성군,085004, 83세,2021,352,118,234,50.4,352,118,234,50.4
36320, 곡성군,085005, 84세,2021,354,113,241,46.9,353,112,241,46.5
36320, 곡성군,090,85~89세,2021,1133,320,813,39.4,1133,320,813,39.4
36320, 곡성군,090001, 85세,2021,304,77,227,33.9,304,77,227,33.9
36320, 곡성군,090002, 86세,2021,289,79,210,37.6,289,79,210,37.6
36320, 곡성군,090003, 87세,2021,235,81,154,52.6,235,81,154,52.6
36320, 곡성군,090004, 88세,2021,159,43,116,37.1,159,43,116,37.1
36320, 곡성군,090005, 89세,2021,146,40,106,37.7,146,40,106,37.7
36320, 곡성군,095,90~94세,2021,394,77,317,24.3,394,77,317,24.3
36320, 곡성군,095001, 90세,2021,122,24,98,24.5,122,24,98,24.5
36320, 곡성군,095002, 91세,2021,106,17,89,19.1,106,17,89,19.1
36320, 곡성군,095003, 92세,2021,74,19,55,34.5,74,19,55,34.5
36320, 곡성군,095004, 93세,2021,54,7,47,14.9,54,7,47,14.9
36320, 곡성군,095005, 94세,2021,38,10,28,35.7,38,10,28,35.7
36320, 곡성군,100,95~99세,2021,96,19,77,24.7,96,19,77,24.7
36320, 곡성군,100001, 95세,2021,43,10,33,30.3,43,10,33,30.3
36320, 곡성군,100002, 96세,2021,21,X,17,23.5,21,X,17,23.5
36320, 곡성군,100003, 97세,2021,15,X,12,25,15,X,12,25
36320, 곡성군,100004, 98세,2021,9,X,8,12.5,9,X,8,12.5
36320, 곡성군,100005, 99세,2021,8,X,7,14.3,8,X,7,14.3
36320, 곡성군,101,100세이상,2021,8,X,8,0,8,X,8,0
36320, 곡성군,102,15세미만,2021,1770,927,843,110,1767,927,840,110.4
36320, 곡성군,103,15~64세,2021,15402,8467,6935,122.1,14838,8165,6673,122.4
36320, 곡성군,104,65세이상,2021,9609,3783,5826,64.9,9587,3772,5815,64.9
36320, 곡성군,086,85세이상,2021,1631,416,1215,34.2,1631,416,1215,34.2
36320, 곡성군,126,평균연령,2021,53.7,50.5,56.9,,54.1,50.8,57.3,
36320, 곡성군,127,중위연령,2021,57.8,54.5,61.2,,58.4,55.1,61.6,
36330, 구례군,000,합계,2021,23543,11325,12218,92.7,23267,11235,12032,93.4
36330, 구례군,005,0~4세,2021,377,187,190,98.4,377,187,190,98.4
36330, 구례군,005001, 0세,2021,84,40,44,90.9,84,40,44,90.9
36330, 구례군,005002, 1세,2021,77,43,34,126.5,77,43,34,126.5
36330, 구례군,005003, 2세,2021,79,40,39,102.6,79,40,39,102.6
36330, 구례군,005004, 3세,2021,53,22,31,71,53,22,31,71
36330, 구례군,005005, 4세,2021,84,42,42,100,84,42,42,100
36330, 구례군,010,5~9세,2021,632,307,325,94.5,632,307,325,94.5
36330, 구례군,010001, 5세,2021,105,48,57,84.2,105,48,57,84.2
36330, 구례군,010002, 6세,2021,112,50,62,80.6,112,50,62,80.6
36330, 구례군,010003, 7세,2021,118,67,51,131.4,118,67,51,131.4
36330, 구례군,010004, 8세,2021,156,79,77,102.6,156,79,77,102.6
36330, 구례군,010005, 9세,2021,141,63,78,80.8,141,63,78,80.8
36330, 구례군,015,10~14세,2021,804,414,390,106.2,804,414,390,106.2
36330, 구례군,015001, 10세,2021,175,84,91,92.3,175,84,91,92.3
36330, 구례군,015002, 11세,2021,147,76,71,107,147,76,71,107
36330, 구례군,015003, 12세,2021,149,81,68,119.1,149,81,68,119.1
36330, 구례군,015004, 13세,2021,153,85,68,125,153,85,68,125
36330, 구례군,015005, 14세,2021,180,88,92,95.7,180,88,92,95.7
36330, 구례군,020,15~19세,2021,668,356,312,114.1,668,356,312,114.1
36330, 구례군,020001, 15세,2021,141,72,69,104.3,141,72,69,104.3
36330, 구례군,020002, 16세,2021,167,89,78,114.1,167,89,78,114.1
36330, 구례군,020003, 17세,2021,136,80,56,142.9,136,80,56,142.9
36330, 구례군,020004, 18세,2021,128,63,65,96.9,128,63,65,96.9
36330, 구례군,020005, 19세,2021,96,52,44,118.2,96,52,44,118.2
36330, 구례군,025,20~24세,2021,762,459,303,151.5,739,455,284,160.2
36330, 구례군,025001, 20세,2021,152,105,47,223.4,151,105,46,228.3
36330, 구례군,025002, 21세,2021,168,115,53,217,167,115,52,221.2
36330, 구례군,025003, 22세,2021,161,97,64,151.6,156,97,59,164.4
36330, 구례군,025004, 23세,2021,144,70,74,94.6,133,67,66,101.5
36330, 구례군,025005, 24세,2021,137,72,65,110.8,132,71,61,116.4
36330, 구례군,030,25~29세,2021,745,418,327,127.8,700,398,302,131.8
36330, 구례군,030001, 25세,2021,151,81,70,115.7,141,79,62,127.4
36330, 구례군,030002, 26세,2021,173,101,72,140.3,160,92,68,135.3
36330, 구례군,030003, 27세,2021,142,89,53,167.9,139,86,53,162.3
36330, 구례군,030004, 28세,2021,144,74,70,105.7,129,71,58,122.4
36330, 구례군,030005, 29세,2021,135,73,62,117.7,131,70,61,114.8
36330, 구례군,035,30~34세,2021,639,297,342,86.8,601,287,314,91.4
36330, 구례군,035001, 30세,2021,137,50,87,57.5,126,47,79,59.5
36330, 구례군,035002, 31세,2021,118,61,57,107,112,60,52,115.4
36330, 구례군,035003, 32세,2021,124,50,74,67.6,117,48,69,69.6
36330, 구례군,035004, 33세,2021,129,66,63,104.8,122,64,58,110.3
36330, 구례군,035005, 34세,2021,131,70,61,114.8,124,68,56,121.4
36330, 구례군,040,35~39세,2021,823,441,382,115.4,784,431,353,122.1
36330, 구례군,040001, 35세,2021,134,58,76,76.3,124,54,70,77.1
36330, 구례군,040002, 36세,2021,159,91,68,133.8,152,89,63,141.3
36330, 구례군,040003, 37세,2021,157,83,74,112.2,149,82,67,122.4
36330, 구례군,040004, 38세,2021,167,97,70,138.6,157,95,62,153.2
36330, 구례군,040005, 39세,2021,206,112,94,119.1,202,111,91,122
36330, 구례군,045,40~44세,2021,1073,560,513,109.2,1039,549,490,112
36330, 구례군,045001, 40세,2021,193,110,83,132.5,190,109,81,134.6
36330, 구례군,045002, 41세,2021,213,105,108,97.2,206,104,102,102
36330, 구례군,045003, 42세,2021,224,112,112,100,216,110,106,103.8
36330, 구례군,045004, 43세,2021,211,110,101,108.9,205,108,97,111.3
36330, 구례군,045005, 44세,2021,232,123,109,112.8,222,118,104,113.5
36330, 구례군,050,45~49세,2021,1426,757,669,113.2,1405,751,654,114.8
36330, 구례군,050001, 45세,2021,248,118,130,90.8,245,118,127,92.9
36330, 구례군,050002, 46세,2021,244,123,121,101.7,240,123,117,105.1
36330, 구례군,050003, 47세,2021,301,169,132,128,295,167,128,130.5
36330, 구례군,050004, 48세,2021,336,180,156,115.4,331,178,153,116.3
36330, 구례군,050005, 49세,2021,297,167,130,128.5,294,165,129,127.9
36330, 구례군,055,50~54세,2021,2036,1146,890,128.8,2016,1141,875,130.4
36330, 구례군,055001, 50세,2021,369,214,155,138.1,368,214,154,139
36330, 구례군,055002, 51세,2021,389,223,166,134.3,387,222,165,134.5
36330, 구례군,055003, 52세,2021,447,248,199,124.6,440,245,195,125.6
36330, 구례군,055004, 53세,2021,413,231,182,126.9,405,230,175,131.4
36330, 구례군,055005, 54세,2021,418,230,188,122.3,416,230,186,123.7
36330, 구례군,060,55~59세,2021,2171,1158,1013,114.3,2146,1149,997,115.2
36330, 구례군,060001, 55세,2021,400,218,182,119.8,392,215,177,121.5
36330, 구례군,060002, 56세,2021,453,238,215,110.7,449,237,212,111.8
36330, 구례군,060003, 57세,2021,406,219,187,117.1,403,218,185,117.8
36330, 구례군,060004, 58세,2021,426,218,208,104.8,421,216,205,105.4
36330, 구례군,060005, 59세,2021,486,265,221,119.9,481,263,218,120.6
36330, 구례군,065,60~64세,2021,2603,1335,1268,105.3,2586,1327,1259,105.4
36330, 구례군,065001, 60세,2021,527,276,251,110,525,274,251,109.2
36330, 구례군,065002, 61세,2021,599,316,283,111.7,591,311,280,111.1
36330, 구례군,065003, 62세,2021,549,279,270,103.3,548,279,269,103.7
36330, 구례군,065004, 63세,2021,489,238,251,94.8,488,238,250,95.2
36330, 구례군,065005, 64세,2021,439,226,213,106.1,434,225,209,107.7
36330, 구례군,070,65~69세,2021,1998,962,1036,92.9,1991,957,1034,92.6
36330, 구례군,070001, 65세,2021,384,181,203,89.2,382,180,202,89.1
36330, 구례군,070002, 66세,2021,461,234,227,103.1,459,233,226,103.1
36330, 구례군,070003, 67세,2021,414,198,216,91.7,413,197,216,91.2
36330, 구례군,070004, 68세,2021,336,150,186,80.6,334,148,186,79.6
36330, 구례군,070005, 69세,2021,403,199,204,97.5,403,199,204,97.5
36330, 구례군,075,70~74세,2021,1870,864,1006,85.9,1864,862,1002,86
36330, 구례군,075001, 70세,2021,361,169,192,88,360,169,191,88.5
36330, 구례군,075002, 71세,2021,376,184,192,95.8,374,184,190,96.8
36330, 구례군,075003, 72세,2021,369,165,204,80.9,368,165,203,81.3
36330, 구례군,075004, 73세,2021,348,169,179,94.4,348,169,179,94.4
36330, 구례군,075005, 74세,2021,416,177,239,74.1,414,175,239,73.2
36330, 구례군,080,75~79세,2021,1822,699,1123,62.2,1821,699,1122,62.3
36330, 구례군,080001, 75세,2021,338,153,185,82.7,338,153,185,82.7
36330, 구례군,080002, 76세,2021,308,128,180,71.1,308,128,180,71.1
36330, 구례군,080003, 77세,2021,330,133,197,67.5,329,133,196,67.9
36330, 구례군,080004, 78세,2021,339,117,222,52.7,339,117,222,52.7
36330, 구례군,080005, 79세,2021,507,168,339,49.6,507,168,339,49.6
36330, 구례군,085,80~84세,2021,1702,602,1100,54.7,1702,602,1100,54.7
36330, 구례군,085001, 80세,2021,408,154,254,60.6,408,154,254,60.6
36330, 구례군,085002, 81세,2021,337,110,227,48.5,337,110,227,48.5
36330, 구례군,085003, 82세,2021,371,133,238,55.9,371,133,238,55.9
36330, 구례군,085004, 83세,2021,296,112,184,60.9,296,112,184,60.9
36330, 구례군,085005, 84세,2021,290,93,197,47.2,290,93,197,47.2
36330, 구례군,090,85~89세,2021,941,272,669,40.7,941,272,669,40.7
36330, 구례군,090001, 85세,2021,253,87,166,52.4,253,87,166,52.4
36330, 구례군,090002, 86세,2021,233,69,164,42.1,233,69,164,42.1
36330, 구례군,090003, 87세,2021,194,49,145,33.8,194,49,145,33.8
36330, 구례군,090004, 88세,2021,135,32,103,31.1,135,32,103,31.1
36330, 구례군,090005, 89세,2021,126,35,91,38.5,126,35,91,38.5
36330, 구례군,095,90~94세,2021,371,77,294,26.2,371,77,294,26.2
36330, 구례군,095001, 90세,2021,84,18,66,27.3,84,18,66,27.3
36330, 구례군,095002, 91세,2021,120,24,96,25,120,24,96,25
36330, 구례군,095003, 92세,2021,73,14,59,23.7,73,14,59,23.7
36330, 구례군,095004, 93세,2021,54,11,43,25.6,54,11,43,25.6
36330, 구례군,095005, 94세,2021,40,10,30,33.3,40,10,30,33.3
36330, 구례군,100,95~99세,2021,64,13,51,25.5,64,13,51,25.5
36330, 구례군,100001, 95세,2021,14,X,11,27.3,14,X,11,27.3
36330, 구례군,100002, 96세,2021,17,5,12,41.7,17,5,12,41.7
36330, 구례군,100003, 97세,2021,11,X,7,57.1,11,X,7,57.1
36330, 구례군,100004, 98세,2021,13,X,12,8.3,13,X,12,8.3
36330, 구례군,100005, 99세,2021,9,X,9,0,9,X,9,0
36330, 구례군,101,100세이상,2021,16,X,15,6.7,16,X,15,6.7
36330, 구례군,102,15세미만,2021,1813,908,905,100.3,1813,908,905,100.3
36330, 구례군,103,15~64세,2021,12946,6927,6019,115.1,12684,6844,5840,117.2
36330, 구례군,104,65세이상,2021,8784,3490,5294,65.9,8770,3483,5287,65.9
36330, 구례군,086,85세이상,2021,1392,363,1029,35.3,1392,363,1029,35.3
36330, 구례군,126,평균연령,2021,55.3,52.6,57.7,,55.4,52.7,58,
36330, 구례군,127,중위연령,2021,59.2,56.4,61.7,,59.4,56.5,62,
36350, 고흥군,000,합계,2021,58873,28758,30115,95.5,57565,27959,29606,94.4
36350, 고흥군,005,0~4세,2021,1059,523,536,97.6,1057,522,535,97.6
36350, 고흥군,005001, 0세,2021,205,109,96,113.5,205,109,96,113.5
36350, 고흥군,005002, 1세,2021,231,128,103,124.3,230,128,102,125.5
36350, 고흥군,005003, 2세,2021,210,100,110,90.9,210,100,110,90.9
36350, 고흥군,005004, 3세,2021,198,86,112,76.8,198,86,112,76.8
36350, 고흥군,005005, 4세,2021,215,100,115,87,214,99,115,86.1
36350, 고흥군,010,5~9세,2021,1321,665,656,101.4,1320,664,656,101.2
36350, 고흥군,010001, 5세,2021,242,111,131,84.7,242,111,131,84.7
36350, 고흥군,010002, 6세,2021,247,125,122,102.5,247,125,122,102.5
36350, 고흥군,010003, 7세,2021,243,123,120,102.5,243,123,120,102.5
36350, 고흥군,010004, 8세,2021,276,148,128,115.6,276,148,128,115.6
36350, 고흥군,010005, 9세,2021,313,158,155,101.9,312,157,155,101.3
36350, 고흥군,015,10~14세,2021,1597,851,746,114.1,1596,850,746,113.9
36350, 고흥군,015001, 10세,2021,308,165,143,115.4,308,165,143,115.4
36350, 고흥군,015002, 11세,2021,310,163,147,110.9,310,163,147,110.9
36350, 고흥군,015003, 12세,2021,308,162,146,111,308,162,146,111
36350, 고흥군,015004, 13세,2021,317,166,151,109.9,317,166,151,109.9
36350, 고흥군,015005, 14세,2021,354,195,159,122.6,353,194,159,122
36350, 고흥군,020,15~19세,2021,1529,852,677,125.8,1523,849,674,126
36350, 고흥군,020001, 15세,2021,345,189,156,121.2,344,188,156,120.5
36350, 고흥군,020002, 16세,2021,345,183,162,113,343,182,161,113
36350, 고흥군,020003, 17세,2021,304,168,136,123.5,304,168,136,123.5
36350, 고흥군,020004, 18세,2021,324,184,140,131.4,323,183,140,130.7
36350, 고흥군,020005, 19세,2021,211,128,83,154.2,209,128,81,158
36350, 고흥군,025,20~24세,2021,1626,1031,595,173.3,1525,969,556,174.3
36350, 고흥군,025001, 20세,2021,299,212,87,243.7,298,212,86,246.5
36350, 고흥군,025002, 21세,2021,338,232,106,218.9,330,230,100,230
36350, 고흥군,025003, 22세,2021,310,194,116,167.2,295,186,109,170.6
36350, 고흥군,025004, 23세,2021,350,201,149,134.9,322,181,141,128.4
36350, 고흥군,025005, 24세,2021,329,192,137,140.1,280,160,120,133.3
36350, 고흥군,030,25~29세,2021,1797,1106,691,160.1,1451,850,601,141.4
36350, 고흥군,030001, 25세,2021,349,216,133,162.4,302,185,117,158.1
36350, 고흥군,030002, 26세,2021,381,235,146,161,316,187,129,145
36350, 고흥군,030003, 27세,2021,362,234,128,182.8,283,174,109,159.6
36350, 고흥군,030004, 28세,2021,366,213,153,139.2,290,160,130,123.1
36350, 고흥군,030005, 29세,2021,339,208,131,158.8,260,144,116,124.1
36350, 고흥군,035,30~34세,2021,1650,920,730,126,1358,729,629,115.9
36350, 고흥군,035001, 30세,2021,331,199,132,150.8,252,143,109,131.2
36350, 고흥군,035002, 31세,2021,331,185,146,126.7,276,148,128,115.6
36350, 고흥군,035003, 32세,2021,289,157,132,118.9,237,122,115,106.1
36350, 고흥군,035004, 33세,2021,366,207,159,130.2,306,171,135,126.7
36350, 고흥군,035005, 34세,2021,333,172,161,106.8,287,145,142,102.1
36350, 고흥군,040,35~39세,2021,1938,1063,875,121.5,1765,963,802,120.1
36350, 고흥군,040001, 35세,2021,316,176,140,125.7,281,155,126,123
36350, 고흥군,040002, 36세,2021,344,199,145,137.2,295,171,124,137.9
36350, 고흥군,040003, 37세,2021,415,211,204,103.4,382,194,188,103.2
36350, 고흥군,040004, 38세,2021,393,198,195,101.5,361,181,180,100.6
36350, 고흥군,040005, 39세,2021,470,279,191,146.1,446,262,184,142.4
36350, 고흥군,045,40~44세,2021,2454,1338,1116,119.9,2341,1280,1061,120.6
36350, 고흥군,045001, 40세,2021,454,260,194,134,425,243,182,133.5
36350, 고흥군,045002, 41세,2021,494,249,245,101.6,469,240,229,104.8
36350, 고흥군,045003, 42세,2021,504,278,226,123,483,265,218,121.6
36350, 고흥군,045004, 43세,2021,471,267,204,130.9,447,253,194,130.4
36350, 고흥군,045005, 44세,2021,531,284,247,115,517,279,238,117.2
36350, 고흥군,050,45~49세,2021,3222,1889,1333,141.7,3132,1839,1293,142.2
36350, 고흥군,050001, 45세,2021,551,330,221,149.3,530,316,214,147.7
36350, 고흥군,050002, 46세,2021,548,307,241,127.4,527,293,234,125.2
36350, 고흥군,050003, 47세,2021,703,402,301,133.6,688,394,294,134
36350, 고흥군,050004, 48세,2021,701,420,281,149.5,682,412,270,152.6
36350, 고흥군,050005, 49세,2021,719,430,289,148.8,705,424,281,150.9
36350, 고흥군,055,50~54세,2021,4262,2455,1807,135.9,4198,2432,1766,137.7
36350, 고흥군,055001, 50세,2021,791,476,315,151.1,774,470,304,154.6
36350, 고흥군,055002, 51세,2021,833,472,361,130.7,826,469,357,131.4
36350, 고흥군,055003, 52세,2021,840,491,349,140.7,828,489,339,144.2
36350, 고흥군,055004, 53세,2021,960,548,412,133,947,540,407,132.7
36350, 고흥군,055005, 54세,2021,838,468,370,126.5,823,464,359,129.2
36350, 고흥군,060,55~59세,2021,4988,2674,2314,115.6,4934,2653,2281,116.3
36350, 고흥군,060001, 55세,2021,911,503,408,123.3,905,501,404,124
36350, 고흥군,060002, 56세,2021,948,500,448,111.6,936,496,440,112.7
36350, 고흥군,060003, 57세,2021,944,486,458,106.1,927,481,446,107.8
36350, 고흥군,060004, 58세,2021,1092,598,494,121.1,1086,595,491,121.2
36350, 고흥군,060005, 59세,2021,1093,587,506,116,1080,580,500,116
36350, 고흥군,065,60~64세,2021,6577,3289,3288,100,6552,3278,3274,100.1
36350, 고흥군,065001, 60세,2021,1292,648,644,100.6,1286,645,641,100.6
36350, 고흥군,065002, 61세,2021,1397,702,695,101,1392,699,693,100.9
36350, 고흥군,065003, 62세,2021,1399,702,697,100.7,1394,701,693,101.2
36350, 고흥군,065004, 63세,2021,1255,632,623,101.4,1253,632,621,101.8
36350, 고흥군,065005, 64세,2021,1234,605,629,96.2,1227,601,626,96
36350, 고흥군,070,65~69세,2021,5724,2770,2954,93.8,5700,2758,2942,93.7
36350, 고흥군,070001, 65세,2021,1112,541,571,94.7,1105,539,566,95.2
36350, 고흥군,070002, 66세,2021,1326,665,661,100.6,1318,660,658,100.3
36350, 고흥군,070003, 67세,2021,1135,533,602,88.5,1131,531,600,88.5
36350, 고흥군,070004, 68세,2021,993,474,519,91.3,991,473,518,91.3
36350, 고흥군,070005, 69세,2021,1158,557,601,92.7,1155,555,600,92.5
36350, 고흥군,075,70~74세,2021,5839,2733,3106,88,5831,2728,3103,87.9
36350, 고흥군,075001, 70세,2021,1140,544,596,91.3,1138,543,595,91.3
36350, 고흥군,075002, 71세,2021,1178,544,634,85.8,1175,542,633,85.6
36350, 고흥군,075003, 72세,2021,1150,546,604,90.4,1147,544,603,90.2
36350, 고흥군,075004, 73세,2021,1104,525,579,90.7,1104,525,579,90.7
36350, 고흥군,075005, 74세,2021,1267,574,693,82.8,1267,574,693,82.8
36350, 고흥군,080,75~79세,2021,4927,2006,2921,68.7,4922,2003,2919,68.6
36350, 고흥군,080001, 75세,2021,831,354,477,74.2,830,353,477,74
36350, 고흥군,080002, 76세,2021,924,352,572,61.5,923,352,571,61.6
36350, 고흥군,080003, 77세,2021,878,359,519,69.2,878,359,519,69.2
36350, 고흥군,080004, 78세,2021,996,395,601,65.7,996,395,601,65.7
36350, 고흥군,080005, 79세,2021,1298,546,752,72.6,1295,544,751,72.4
36350, 고흥군,085,80~84세,2021,4673,1613,3060,52.7,4671,1613,3058,52.7
36350, 고흥군,085001, 80세,2021,1084,407,677,60.1,1084,407,677,60.1
36350, 고흥군,085002, 81세,2021,1030,367,663,55.4,1030,367,663,55.4
36350, 고흥군,085003, 82세,2021,955,321,634,50.6,955,321,634,50.6
36350, 고흥군,085004, 83세,2021,768,251,517,48.5,768,251,517,48.5
36350, 고흥군,085005, 84세,2021,836,267,569,46.9,834,267,567,47.1
36350, 고흥군,090,85~89세,2021,2570,733,1837,39.9,2569,732,1837,39.8
36350, 고흥군,090001, 85세,2021,681,218,463,47.1,680,217,463,46.9
36350, 고흥군,090002, 86세,2021,563,183,380,48.2,563,183,380,48.2
36350, 고흥군,090003, 87세,2021,492,125,367,34.1,492,125,367,34.1
36350, 고흥군,090004, 88세,2021,447,120,327,36.7,447,120,327,36.7
36350, 고흥군,090005, 89세,2021,387,87,300,29,387,87,300,29
36350, 고흥군,095,90~94세,2021,909,213,696,30.6,909,213,696,30.6
36350, 고흥군,095001, 90세,2021,248,58,190,30.5,248,58,190,30.5
36350, 고흥군,095002, 91세,2021,270,62,208,29.8,270,62,208,29.8
36350, 고흥군,095003, 92세,2021,207,60,147,40.8,207,60,147,40.8
36350, 고흥군,095004, 93세,2021,118,25,93,26.9,118,25,93,26.9
36350, 고흥군,095005, 94세,2021,66,8,58,13.8,66,8,58,13.8
36350, 고흥군,100,95~99세,2021,178,30,148,20.3,178,30,148,20.3
36350, 고흥군,100001, 95세,2021,51,7,44,15.9,51,7,44,15.9
36350, 고흥군,100002, 96세,2021,40,9,31,29,40,9,31,29
36350, 고흥군,100003, 97세,2021,28,6,22,27.3,28,6,22,27.3
36350, 고흥군,100004, 98세,2021,43,X,40,7.5,43,X,40,7.5
36350, 고흥군,100005, 99세,2021,16,5,11,45.5,16,5,11,45.5
36350, 고흥군,101,100세이상,2021,33,X,29,13.8,33,X,29,13.8
36350, 고흥군,102,15세미만,2021,3977,2039,1938,105.2,3973,2036,1937,105.1
36350, 고흥군,103,15~64세,2021,30043,16617,13426,123.8,28779,15842,12937,122.5
36350, 고흥군,104,65세이상,2021,24853,10102,14751,68.5,24813,10081,14732,68.4
36350, 고흥군,086,85세이상,2021,3690,980,2710,36.2,3689,979,2710,36.1
36350, 고흥군,126,평균연령,2021,57,53.9,60,,57.5,54.5,60.4,
36350, 고흥군,127,중위연령,2021,61.5,58.3,64.5,,61.9,58.9,64.9,
36360, 보성군,000,합계,2021,36981,17798,19183,92.8,36402,17573,18829,93.3
36360, 보성군,005,0~4세,2021,643,331,312,106.1,642,331,311,106.4
36360, 보성군,005001, 0세,2021,97,42,55,76.4,97,42,55,76.4
36360, 보성군,005002, 1세,2021,122,74,48,154.2,122,74,48,154.2
36360, 보성군,005003, 2세,2021,147,76,71,107,147,76,71,107
36360, 보성군,005004, 3세,2021,128,65,63,103.2,128,65,63,103.2
36360, 보성군,005005, 4세,2021,149,74,75,98.7,148,74,74,100
36360, 보성군,010,5~9세,2021,873,463,410,112.9,868,461,407,113.3
36360, 보성군,010001, 5세,2021,158,80,78,102.6,157,80,77,103.9
36360, 보성군,010002, 6세,2021,162,87,75,116,161,87,74,117.6
36360, 보성군,010003, 7세,2021,162,90,72,125,162,90,72,125
36360, 보성군,010004, 8세,2021,195,98,97,101,194,98,96,102.1
36360, 보성군,010005, 9세,2021,196,108,88,122.7,194,106,88,120.5
36360, 보성군,015,10~14세,2021,1112,539,573,94.1,1112,539,573,94.1
36360, 보성군,015001, 10세,2021,242,126,116,108.6,242,126,116,108.6
36360, 보성군,015002, 11세,2021,215,101,114,88.6,215,101,114,88.6
36360, 보성군,015003, 12세,2021,198,92,106,86.8,198,92,106,86.8
36360, 보성군,015004, 13세,2021,200,88,112,78.6,200,88,112,78.6
36360, 보성군,015005, 14세,2021,257,132,125,105.6,257,132,125,105.6
36360, 보성군,020,15~19세,2021,1229,637,592,107.6,1229,637,592,107.6
36360, 보성군,020001, 15세,2021,230,121,109,111,230,121,109,111
36360, 보성군,020002, 16세,2021,275,145,130,111.5,275,145,130,111.5
36360, 보성군,020003, 17세,2021,286,132,154,85.7,286,132,154,85.7
36360, 보성군,020004, 18세,2021,290,155,135,114.8,290,155,135,114.8
36360, 보성군,020005, 19세,2021,148,84,64,131.3,148,84,64,131.3
36360, 보성군,025,20~24세,2021,1166,717,449,159.7,1121,704,417,168.8
36360, 보성군,025001, 20세,2021,205,131,74,177,203,131,72,181.9
36360, 보성군,025002, 21세,2021,267,185,82,225.6,265,185,80,231.3
36360, 보성군,025003, 22세,2021,222,138,84,164.3,212,137,75,182.7
36360, 보성군,025004, 23세,2021,230,141,89,158.4,219,137,82,167.1
36360, 보성군,025005, 24세,2021,242,122,120,101.7,222,114,108,105.6
36360, 보성군,030,25~29세,2021,1215,691,524,131.9,1083,631,452,139.6
36360, 보성군,030001, 25세,2021,264,150,114,131.6,242,138,104,132.7
36360, 보성군,030002, 26세,2021,251,147,104,141.3,226,137,89,153.9
36360, 보성군,030003, 27세,2021,240,141,99,142.4,215,128,87,147.1
36360, 보성군,030004, 28세,2021,227,125,102,122.5,200,115,85,135.3
36360, 보성군,030005, 29세,2021,233,128,105,121.9,200,113,87,129.9
36360, 보성군,035,30~34세,2021,1057,550,507,108.5,928,495,433,114.3
36360, 보성군,035001, 30세,2021,236,117,119,98.3,206,103,103,100
36360, 보성군,035002, 31세,2021,214,119,95,125.3,190,109,81,134.6
36360, 보성군,035003, 32세,2021,181,102,79,129.1,158,92,66,139.4
36360, 보성군,035004, 33세,2021,196,103,93,110.8,178,97,81,119.8
36360, 보성군,035005, 34세,2021,230,109,121,90.1,196,94,102,92.2
36360, 보성군,040,35~39세,2021,1250,636,614,103.6,1164,604,560,107.9
36360, 보성군,040001, 35세,2021,247,124,123,100.8,229,117,112,104.5
36360, 보성군,040002, 36세,2021,224,110,114,96.5,207,105,102,102.9
36360, 보성군,040003, 37세,2021,225,107,118,90.7,209,101,108,93.5
36360, 보성군,040004, 38세,2021,243,129,114,113.2,225,121,104,116.3
36360, 보성군,040005, 39세,2021,311,166,145,114.5,294,160,134,119.4
36360, 보성군,045,40~44세,2021,1576,839,737,113.8,1524,819,705,116.2
36360, 보성군,045001, 40세,2021,275,142,133,106.8,263,138,125,110.4
36360, 보성군,045002, 41세,2021,316,177,139,127.3,305,171,134,127.6
36360, 보성군,045003, 42세,2021,302,159,143,111.2,297,157,140,112.1
36360, 보성군,045004, 43세,2021,318,171,147,116.3,306,167,139,120.1
36360, 보성군,045005, 44세,2021,365,190,175,108.6,353,186,167,111.4
36360, 보성군,050,45~49세,2021,2029,1161,868,133.8,1993,1150,843,136.4
36360, 보성군,050001, 45세,2021,364,201,163,123.3,352,198,154,128.6
36360, 보성군,050002, 46세,2021,299,172,127,135.4,296,170,126,134.9
36360, 보성군,050003, 47세,2021,449,254,195,130.3,438,252,186,135.5
36360, 보성군,050004, 48세,2021,448,270,178,151.7,443,269,174,154.6
36360, 보성군,050005, 49세,2021,469,264,205,128.8,464,261,203,128.6
36360, 보성군,055,50~54세,2021,2792,1561,1231,126.8,2753,1547,1206,128.3
36360, 보성군,055001, 50세,2021,548,296,252,117.5,539,296,243,121.8
36360, 보성군,055002, 51세,2021,524,299,225,132.9,515,293,222,132
36360, 보성군,055003, 52세,2021,535,305,230,132.6,527,300,227,132.2
36360, 보성군,055004, 53세,2021,623,351,272,129,616,349,267,130.7
36360, 보성군,055005, 54세,2021,562,310,252,123,556,309,247,125.1
36360, 보성군,060,55~59세,2021,3194,1711,1483,115.4,3169,1703,1466,116.2
36360, 보성군,060001, 55세,2021,596,350,246,142.3,591,348,243,143.2
36360, 보성군,060002, 56세,2021,602,315,287,109.8,596,314,282,111.3
36360, 보성군,060003, 57세,2021,622,330,292,113,614,327,287,113.9
36360, 보성군,060004, 58세,2021,650,330,320,103.1,646,328,318,103.1
36360, 보성군,060005, 59세,2021,724,386,338,114.2,722,386,336,114.9
36360, 보성군,065,60~64세,2021,3906,2004,1902,105.4,3893,1998,1895,105.4
36360, 보성군,065001, 60세,2021,733,380,353,107.6,729,378,351,107.7
36360, 보성군,065002, 61세,2021,814,431,383,112.5,810,429,381,112.6
36360, 보성군,065003, 62세,2021,857,433,424,102.1,855,432,423,102.1
36360, 보성군,065004, 63세,2021,726,365,361,101.1,725,365,360,101.4
36360, 보성군,065005, 64세,2021,776,395,381,103.7,774,394,380,103.7
36360, 보성군,070,65~69세,2021,3332,1634,1698,96.2,3321,1632,1689,96.6
36360, 보성군,070001, 65세,2021,688,360,328,109.8,686,359,327,109.8
36360, 보성군,070002, 66세,2021,749,380,369,103,743,379,364,104.1
36360, 보성군,070003, 67세,2021,623,304,319,95.3,623,304,319,95.3
36360, 보성군,070004, 68세,2021,579,259,320,80.9,577,259,318,81.4
36360, 보성군,070005, 69세,2021,693,331,362,91.4,692,331,361,91.7
36360, 보성군,075,70~74세,2021,3254,1504,1750,85.9,3250,1502,1748,85.9
36360, 보성군,075001, 70세,2021,631,293,338,86.7,630,293,337,86.9
36360, 보성군,075002, 71세,2021,635,280,355,78.9,634,280,354,79.1
36360, 보성군,075003, 72세,2021,659,301,358,84.1,659,301,358,84.1
36360, 보성군,075004, 73세,2021,641,316,325,97.2,641,316,325,97.2
36360, 보성군,075005, 74세,2021,688,314,374,84,686,312,374,83.4
36360, 보성군,080,75~79세,2021,2915,1174,1741,67.4,2915,1174,1741,67.4
36360, 보성군,080001, 75세,2021,486,230,256,89.8,486,230,256,89.8
36360, 보성군,080002, 76세,2021,508,207,301,68.8,508,207,301,68.8
36360, 보성군,080003, 77세,2021,483,197,286,68.9,483,197,286,68.9
36360, 보성군,080004, 78세,2021,649,226,423,53.4,649,226,423,53.4
36360, 보성군,080005, 79세,2021,789,314,475,66.1,789,314,475,66.1
36360, 보성군,085,80~84세,2021,2966,1029,1937,53.1,2965,1029,1936,53.2
36360, 보성군,085001, 80세,2021,650,241,409,58.9,650,241,409,58.9
36360, 보성군,085002, 81세,2021,614,220,394,55.8,614,220,394,55.8
36360, 보성군,085003, 82세,2021,607,219,388,56.4,607,219,388,56.4
36360, 보성군,085004, 83세,2021,570,187,383,48.8,569,187,382,49
36360, 보성군,085005, 84세,2021,525,162,363,44.6,525,162,363,44.6
36360, 보성군,090,85~89세,2021,1680,453,1227,36.9,1680,453,1227,36.9
36360, 보성군,090001, 85세,2021,412,129,283,45.6,412,129,283,45.6
36360, 보성군,090002, 86세,2021,385,99,286,34.6,385,99,286,34.6
36360, 보성군,090003, 87세,2021,336,71,265,26.8,336,71,265,26.8
36360, 보성군,090004, 88세,2021,265,85,180,47.2,265,85,180,47.2
36360, 보성군,090005, 89세,2021,282,69,213,32.4,282,69,213,32.4
36360, 보성군,095,90~94세,2021,645,139,506,27.5,645,139,506,27.5
36360, 보성군,095001, 90세,2021,200,44,156,28.2,200,44,156,28.2
36360, 보성군,095002, 91세,2021,173,31,142,21.8,173,31,142,21.8
36360, 보성군,095003, 92세,2021,108,26,82,31.7,108,26,82,31.7
36360, 보성군,095004, 93세,2021,97,20,77,26,97,20,77,26
36360, 보성군,095005, 94세,2021,67,18,49,36.7,67,18,49,36.7
36360, 보성군,100,95~99세,2021,128,22,106,20.8,128,22,106,20.8
36360, 보성군,100001, 95세,2021,41,8,33,24.2,41,8,33,24.2
36360, 보성군,100002, 96세,2021,25,X,22,13.6,25,X,22,13.6
36360, 보성군,100003, 97세,2021,23,7,16,43.8,23,7,16,43.8
36360, 보성군,100004, 98세,2021,21,X,18,16.7,21,X,18,16.7
36360, 보성군,100005, 99세,2021,18,X,17,5.9,18,X,17,5.9
36360, 보성군,101,100세이상,2021,19,X,16,18.8,19,X,16,18.8
36360, 보성군,102,15세미만,2021,2628,1333,1295,102.9,2622,1331,1291,103.1
36360, 보성군,103,15~64세,2021,19414,10507,8907,118,18857,10288,8569,120.1
36360, 보성군,104,65세이상,2021,14939,5958,8981,66.3,14923,5954,8969,66.4
36360, 보성군,086,85세이상,2021,2472,617,1855,33.3,2472,617,1855,33.3
36360, 보성군,126,평균연령,2021,56.1,53.1,58.9,,56.4,53.3,59.3,
36360, 보성군,127,중위연령,2021,60.5,57.3,63.4,,60.8,57.6,63.8,
36370, 화순군,000,합계,2021,60136,29088,31048,93.7,59024,28606,30418,94
36370, 화순군,005,0~4세,2021,1278,657,621,105.8,1269,652,617,105.7
36370, 화순군,005001, 0세,2021,210,107,103,103.9,206,104,102,102
36370, 화순군,005002, 1세,2021,255,140,115,121.7,255,140,115,121.7
36370, 화순군,005003, 2세,2021,256,133,123,108.1,255,132,123,107.3
36370, 화순군,005004, 3세,2021,253,122,131,93.1,250,121,129,93.8
36370, 화순군,005005, 4세,2021,304,155,149,104,303,155,148,104.7
36370, 화순군,010,5~9세,2021,1923,975,948,102.8,1914,971,943,103
36370, 화순군,010001, 5세,2021,309,156,153,102,306,155,151,102.6
36370, 화순군,010002, 6세,2021,367,177,190,93.2,363,175,188,93.1
36370, 화순군,010003, 7세,2021,379,193,186,103.8,379,193,186,103.8
36370, 화순군,010004, 8세,2021,404,213,191,111.5,402,212,190,111.6
36370, 화순군,010005, 9세,2021,464,236,228,103.5,464,236,228,103.5
36370, 화순군,015,10~14세,2021,2451,1273,1178,108.1,2446,1271,1175,108.2
36370, 화순군,015001, 10세,2021,475,243,232,104.7,473,242,231,104.8
36370, 화순군,015002, 11세,2021,451,238,213,111.7,451,238,213,111.7
36370, 화순군,015003, 12세,2021,484,246,238,103.4,483,246,237,103.8
36370, 화순군,015004, 13세,2021,485,264,221,119.5,484,263,221,119
36370, 화순군,015005, 14세,2021,556,282,274,102.9,555,282,273,103.3
36370, 화순군,020,15~19세,2021,2777,1484,1293,114.8,2773,1482,1291,114.8
36370, 화순군,020001, 15세,2021,529,285,244,116.8,528,284,244,116.4
36370, 화순군,020002, 16세,2021,555,292,263,111,555,292,263,111
36370, 화순군,020003, 17세,2021,646,337,309,109.1,645,337,308,109.4
36370, 화순군,020004, 18세,2021,572,314,258,121.7,571,314,257,122.2
36370, 화순군,020005, 19세,2021,475,256,219,116.9,474,255,219,116.4
36370, 화순군,025,20~24세,2021,3229,1832,1397,131.1,3164,1805,1359,132.8
36370, 화순군,025001, 20세,2021,587,350,237,147.7,583,350,233,150.2
36370, 화순군,025002, 21세,2021,760,458,302,151.7,757,458,299,153.2
36370, 화순군,025003, 22세,2021,642,358,284,126.1,629,352,277,127.1
36370, 화순군,025004, 23세,2021,606,320,286,111.9,590,315,275,114.5
36370, 화순군,025005, 24세,2021,634,346,288,120.1,605,330,275,120
36370, 화순군,030,25~29세,2021,2966,1582,1384,114.3,2721,1449,1272,113.9
36370, 화순군,030001, 25세,2021,647,348,299,116.4,602,319,283,112.7
36370, 화순군,030002, 26세,2021,600,310,290,106.9,547,278,269,103.3
36370, 화순군,030003, 27세,2021,589,330,259,127.4,543,308,235,131.1
36370, 화순군,030004, 28세,2021,602,316,286,110.5,544,287,257,111.7
36370, 화순군,030005, 29세,2021,528,278,250,111.2,485,257,228,112.7
36370, 화순군,035,30~34세,2021,2186,1133,1053,107.6,1964,1020,944,108.1
36370, 화순군,035001, 30세,2021,482,242,240,100.8,430,213,217,98.2
36370, 화순군,035002, 31세,2021,500,279,221,126.2,444,250,194,128.9
36370, 화순군,035003, 32세,2021,402,226,176,128.4,361,201,160,125.6
36370, 화순군,035004, 33세,2021,406,208,198,105.1,367,187,180,103.9
36370, 화순군,035005, 34세,2021,396,178,218,81.7,362,169,193,87.6
36370, 화순군,040,35~39세,2021,2431,1218,1213,100.4,2275,1157,1118,103.5
36370, 화순군,040001, 35세,2021,433,208,225,92.4,388,190,198,96
36370, 화순군,040002, 36세,2021,407,206,201,102.5,373,192,181,106.1
36370, 화순군,040003, 37세,2021,479,247,232,106.5,457,239,218,109.6
36370, 화순군,040004, 38세,2021,527,275,252,109.1,502,264,238,110.9
36370, 화순군,040005, 39세,2021,585,282,303,93.1,555,272,283,96.1
36370, 화순군,045,40~44세,2021,3279,1603,1676,95.6,3179,1563,1616,96.7
36370, 화순군,045001, 40세,2021,601,294,307,95.8,573,284,289,98.3
36370, 화순군,045002, 41세,2021,651,322,329,97.9,631,313,318,98.4
36370, 화순군,045003, 42세,2021,689,338,351,96.3,670,328,342,95.9
36370, 화순군,045004, 43세,2021,636,298,338,88.2,617,290,327,88.7
36370, 화순군,045005, 44세,2021,702,351,351,100,688,348,340,102.4
36370, 화순군,050,45~49세,2021,4314,2150,2164,99.4,4224,2113,2111,100.1
36370, 화순군,050001, 45세,2021,706,345,361,95.6,688,340,348,97.7
36370, 화순군,050002, 46세,2021,772,392,380,103.2,752,383,369,103.8
36370, 화순군,050003, 47세,2021,960,492,468,105.1,936,478,458,104.4
36370, 화순군,050004, 48세,2021,909,425,484,87.8,894,417,477,87.4
36370, 화순군,050005, 49세,2021,967,496,471,105.3,954,495,459,107.8
36370, 화순군,055,50~54세,2021,5468,2870,2598,110.5,5402,2855,2547,112.1
36370, 화순군,055001, 50세,2021,1085,589,496,118.8,1075,587,488,120.3
36370, 화순군,055002, 51세,2021,1120,583,537,108.6,1106,580,526,110.3
36370, 화순군,055003, 52세,2021,1072,555,517,107.4,1055,549,506,108.5
36370, 화순군,055004, 53세,2021,1125,597,528,113.1,1114,595,519,114.6
36370, 화순군,055005, 54세,2021,1066,546,520,105,1052,544,508,107.1
36370, 화순군,060,55~59세,2021,5405,2810,2595,108.3,5341,2794,2547,109.7
36370, 화순군,060001, 55세,2021,1122,604,518,116.6,1108,600,508,118.1
36370, 화순군,060002, 56세,2021,1040,544,496,109.7,1031,542,489,110.8
36370, 화순군,060003, 57세,2021,1035,538,497,108.2,1015,537,478,112.3
36370, 화순군,060004, 58세,2021,1136,593,543,109.2,1122,586,536,109.3
36370, 화순군,060005, 59세,2021,1072,531,541,98.2,1065,529,536,98.7
36370, 화순군,065,60~64세,2021,5648,2897,2751,105.3,5604,2883,2721,106
36370, 화순군,065001, 60세,2021,1210,634,576,110.1,1198,631,567,111.3
36370, 화순군,065002, 61세,2021,1239,627,612,102.5,1228,623,605,103
36370, 화순군,065003, 62세,2021,1142,594,548,108.4,1136,592,544,108.8
36370, 화순군,065004, 63세,2021,1005,519,486,106.8,998,517,481,107.5
36370, 화순군,065005, 64세,2021,1052,523,529,98.9,1044,520,524,99.2
36370, 화순군,070,65~69세,2021,4050,2006,2044,98.1,4032,2000,2032,98.4
36370, 화순군,070001, 65세,2021,832,435,397,109.6,829,435,394,110.4
36370, 화순군,070002, 66세,2021,897,455,442,102.9,890,451,439,102.7
36370, 화순군,070003, 67세,2021,764,373,391,95.4,760,372,388,95.9
36370, 화순군,070004, 68세,2021,736,361,375,96.3,735,360,375,96
36370, 화순군,070005, 69세,2021,821,382,439,87,818,382,436,87.6
36370, 화순군,075,70~74세,2021,3639,1646,1993,82.6,3632,1643,1989,82.6
36370, 화순군,075001, 70세,2021,661,305,356,85.7,659,305,354,86.2
36370, 화순군,075002, 71세,2021,700,334,366,91.3,698,333,365,91.2
36370, 화순군,075003, 72세,2021,763,355,408,87,761,354,407,87
36370, 화순군,075004, 73세,2021,760,329,431,76.3,759,328,431,76.1
36370, 화순군,075005, 74세,2021,755,323,432,74.8,755,323,432,74.8
36370, 화순군,080,75~79세,2021,3473,1291,2182,59.2,3470,1289,2181,59.1
36370, 화순군,080001, 75세,2021,582,236,346,68.2,582,236,346,68.2
36370, 화순군,080002, 76세,2021,647,228,419,54.4,646,227,419,54.2
36370, 화순군,080003, 77세,2021,598,222,376,59,598,222,376,59
36370, 화순군,080004, 78세,2021,695,266,429,62,694,266,428,62.1
36370, 화순군,080005, 79세,2021,951,339,612,55.4,950,338,612,55.2
36370, 화순군,085,80~84세,2021,3146,1039,2107,49.3,3144,1039,2105,49.4
36370, 화순군,085001, 80세,2021,744,254,490,51.8,743,254,489,51.9
36370, 화순군,085002, 81세,2021,669,223,446,50,668,223,445,50.1
36370, 화순군,085003, 82세,2021,652,208,444,46.8,652,208,444,46.8
36370, 화순군,085004, 83세,2021,572,182,390,46.7,572,182,390,46.7
36370, 화순군,085005, 84세,2021,509,172,337,51,509,172,337,51
36370, 화순군,090,85~89세,2021,1736,463,1273,36.4,1734,461,1273,36.2
36370, 화순군,090001, 85세,2021,474,135,339,39.8,473,134,339,39.5
36370, 화순군,090002, 86세,2021,417,119,298,39.9,417,119,298,39.9
36370, 화순군,090003, 87세,2021,344,91,253,36,343,90,253,35.6
36370, 화순군,090004, 88세,2021,261,59,202,29.2,261,59,202,29.2
36370, 화순군,090005, 89세,2021,240,59,181,32.6,240,59,181,32.6
36370, 화순군,095,90~94세,2021,584,131,453,28.9,583,131,452,29
36370, 화순군,095001, 90세,2021,171,45,126,35.7,171,45,126,35.7
36370, 화순군,095002, 91세,2021,171,27,144,18.8,170,27,143,18.9
36370, 화순군,095003, 92세,2021,108,27,81,33.3,108,27,81,33.3
36370, 화순군,095004, 93세,2021,77,24,53,45.3,77,24,53,45.3
36370, 화순군,095005, 94세,2021,57,8,49,16.3,57,8,49,16.3
36370, 화순군,100,95~99세,2021,135,27,108,25,135,27,108,25
36370, 화순군,100001, 95세,2021,47,11,36,30.6,47,11,36,30.6
36370, 화순군,100002, 96세,2021,31,7,24,29.2,31,7,24,29.2
36370, 화순군,100003, 97세,2021,21,5,16,31.3,21,5,16,31.3
36370, 화순군,100004, 98세,2021,25,X,21,19,25,X,21,19
36370, 화순군,100005, 99세,2021,11,X,11,0,11,X,11,0
36370, 화순군,101,100세이상,2021,18,X,17,5.9,18,X,17,5.9
36370, 화순군,102,15세미만,2021,5652,2905,2747,105.8,5629,2894,2735,105.8
36370, 화순군,103,15~64세,2021,37703,19579,18124,108,36647,19121,17526,109.1
36370, 화순군,104,65세이상,2021,16781,6604,10177,64.9,16748,6591,10157,64.9
36370, 화순군,086,85세이상,2021,2473,622,1851,33.6,2470,620,1850,33.5
36370, 화순군,126,평균연령,2021,49.8,47.3,52.1,,50,47.5,52.4,
36370, 화순군,127,중위연령,2021,53,51.1,55,,53.3,51.4,55.4,
36380, 장흥군,000,합계,2021,34268,16684,17584,94.9,33555,16367,17188,95.2
36380, 장흥군,005,0~4세,2021,759,385,374,102.9,758,385,373,103.2
36380, 장흥군,005001, 0세,2021,163,75,88,85.2,163,75,88,85.2
36380, 장흥군,005002, 1세,2021,167,83,84,98.8,167,83,84,98.8
36380, 장흥군,005003, 2세,2021,159,79,80,98.8,159,79,80,98.8
36380, 장흥군,005004, 3세,2021,120,61,59,103.4,120,61,59,103.4
36380, 장흥군,005005, 4세,2021,150,87,63,138.1,149,87,62,140.3
36380, 장흥군,010,5~9세,2021,1058,523,535,97.8,1054,523,531,98.5
36380, 장흥군,010001, 5세,2021,176,97,79,122.8,175,97,78,124.4
36380, 장흥군,010002, 6세,2021,206,100,106,94.3,205,100,105,95.2
36380, 장흥군,010003, 7세,2021,201,89,112,79.5,200,89,111,80.2
36380, 장흥군,010004, 8세,2021,246,116,130,89.2,245,116,129,89.9
36380, 장흥군,010005, 9세,2021,229,121,108,112,229,121,108,112
36380, 장흥군,015,10~14세,2021,1178,603,575,104.9,1177,603,574,105.1
36380, 장흥군,015001, 10세,2021,238,131,107,122.4,238,131,107,122.4
36380, 장흥군,015002, 11세,2021,215,104,111,93.7,215,104,111,93.7
36380, 장흥군,015003, 12세,2021,231,108,123,87.8,231,108,123,87.8
36380, 장흥군,015004, 13세,2021,240,119,121,98.3,239,119,120,99.2
36380, 장흥군,015005, 14세,2021,254,141,113,124.8,254,141,113,124.8
36380, 장흥군,020,15~19세,2021,1061,618,443,139.5,1056,616,440,140
36380, 장흥군,020001, 15세,2021,239,142,97,146.4,238,142,96,147.9
36380, 장흥군,020002, 16세,2021,221,125,96,130.2,220,124,96,129.2
36380, 장흥군,020003, 17세,2021,226,134,92,145.7,226,134,92,145.7
36380, 장흥군,020004, 18세,2021,227,121,106,114.2,226,121,105,115.2
36380, 장흥군,020005, 19세,2021,148,96,52,184.6,146,95,51,186.3
36380, 장흥군,025,20~24세,2021,1244,761,483,157.6,1183,736,447,164.7
36380, 장흥군,025001, 20세,2021,242,168,74,227,237,168,69,243.5
36380, 장흥군,025002, 21세,2021,234,158,76,207.9,222,155,67,231.3
36380, 장흥군,025003, 22세,2021,252,153,99,154.5,246,151,95,158.9
36380, 장흥군,025004, 23세,2021,253,140,113,123.9,235,134,101,132.7
36380, 장흥군,025005, 24세,2021,263,142,121,117.4,243,128,115,111.3
36380, 장흥군,030,25~29세,2021,1254,704,550,128,1126,632,494,127.9
36380, 장흥군,030001, 25세,2021,237,124,113,109.7,215,109,106,102.8
36380, 장흥군,030002, 26세,2021,248,142,106,134,225,135,90,150
36380, 장흥군,030003, 27세,2021,243,149,94,158.5,217,135,82,164.6
36380, 장흥군,030004, 28세,2021,261,144,117,123.1,229,124,105,118.1
36380, 장흥군,030005, 29세,2021,265,145,120,120.8,240,129,111,116.2
36380, 장흥군,035,30~34세,2021,1208,610,598,102,1065,540,525,102.9
36380, 장흥군,035001, 30세,2021,240,124,116,106.9,215,109,106,102.8
36380, 장흥군,035002, 31세,2021,240,122,118,103.4,209,107,102,104.9
36380, 장흥군,035003, 32세,2021,251,127,124,102.4,227,118,109,108.3
36380, 장흥군,035004, 33세,2021,255,135,120,112.5,222,117,105,111.4
36380, 장흥군,035005, 34세,2021,222,102,120,85,192,89,103,86.4
36380, 장흥군,040,35~39세,2021,1377,725,652,111.2,1271,679,592,114.7
36380, 장흥군,040001, 35세,2021,242,124,118,105.1,221,111,110,100.9
36380, 장흥군,040002, 36세,2021,221,107,114,93.9,202,101,101,100
36380, 장흥군,040003, 37세,2021,281,146,135,108.1,256,133,123,108.1
36380, 장흥군,040004, 38세,2021,303,167,136,122.8,282,161,121,133.1
36380, 장흥군,040005, 39세,2021,330,181,149,121.5,310,173,137,126.3
36380, 장흥군,045,40~44세,2021,1639,879,760,115.7,1563,845,718,117.7
36380, 장흥군,045001, 40세,2021,346,195,151,129.1,323,179,144,124.3
36380, 장흥군,045002, 41세,2021,364,194,170,114.1,344,186,158,117.7
36380, 장흥군,045003, 42세,2021,317,171,146,117.1,309,169,140,120.7
36380, 장흥군,045004, 43세,2021,271,127,144,88.2,258,123,135,91.1
36380, 장흥군,045005, 44세,2021,341,192,149,128.9,329,188,141,133.3
36380, 장흥군,050,45~49세,2021,2027,1111,916,121.3,1975,1092,883,123.7
36380, 장흥군,050001, 45세,2021,347,203,144,141,341,200,141,141.8
36380, 장흥군,050002, 46세,2021,364,190,174,109.2,347,187,160,116.9
36380, 장흥군,050003, 47세,2021,424,242,182,133,412,238,174,136.8
36380, 장흥군,050004, 48세,2021,451,242,209,115.8,444,238,206,115.5
36380, 장흥군,050005, 49세,2021,441,234,207,113,431,229,202,113.4
36380, 장흥군,055,50~54세,2021,2730,1488,1242,119.8,2672,1468,1204,121.9
36380, 장흥군,055001, 50세,2021,560,302,258,117.1,544,299,245,122
36380, 장흥군,055002, 51세,2021,515,297,218,136.2,508,293,215,136.3
36380, 장흥군,055003, 52세,2021,565,292,273,107,553,289,264,109.5
36380, 장흥군,055004, 53세,2021,545,301,244,123.4,535,297,238,124.8
36380, 장흥군,055005, 54세,2021,545,296,249,118.9,532,290,242,119.8
36380, 장흥군,060,55~59세,2021,3021,1610,1411,114.1,2993,1605,1388,115.6
36380, 장흥군,060001, 55세,2021,599,330,269,122.7,594,330,264,125
36380, 장흥군,060002, 56세,2021,611,321,290,110.7,608,321,287,111.8
36380, 장흥군,060003, 57세,2021,562,299,263,113.7,558,298,260,114.6
36380, 장흥군,060004, 58세,2021,639,335,304,110.2,626,331,295,112.2
36380, 장흥군,060005, 59세,2021,610,325,285,114,607,325,282,115.2
36380, 장흥군,065,60~64세,2021,3562,1782,1780,100.1,3532,1768,1764,100.2
36380, 장흥군,065001, 60세,2021,702,343,359,95.5,697,339,358,94.7
36380, 장흥군,065002, 61세,2021,779,409,370,110.5,771,404,367,110.1
36380, 장흥군,065003, 62세,2021,717,359,358,100.3,715,359,356,100.8
36380, 장흥군,065004, 63세,2021,711,344,367,93.7,701,342,359,95.3
36380, 장흥군,065005, 64세,2021,653,327,326,100.3,648,324,324,100
36380, 장흥군,070,65~69세,2021,2854,1382,1472,93.9,2844,1377,1467,93.9
36380, 장흥군,070001, 65세,2021,620,310,310,100,619,309,310,99.7
36380, 장흥군,070002, 66세,2021,654,324,330,98.2,652,322,330,97.6
36380, 장흥군,070003, 67세,2021,537,245,292,83.9,534,243,291,83.5
36380, 장흥군,070004, 68세,2021,490,227,263,86.3,487,227,260,87.3
36380, 장흥군,070005, 69세,2021,553,276,277,99.6,552,276,276,100
36380, 장흥군,075,70~74세,2021,2696,1247,1449,86.1,2688,1242,1446,85.9
36380, 장흥군,075001, 70세,2021,512,264,248,106.5,506,259,247,104.9
36380, 장흥군,075002, 71세,2021,556,262,294,89.1,555,262,293,89.4
36380, 장흥군,075003, 72세,2021,491,220,271,81.2,490,220,270,81.5
36380, 장흥군,075004, 73세,2021,562,253,309,81.9,562,253,309,81.9
36380, 장흥군,075005, 74세,2021,575,248,327,75.8,575,248,327,75.8
36380, 장흥군,080,75~79세,2021,2357,952,1405,67.8,2356,952,1404,67.8
36380, 장흥군,080001, 75세,2021,417,173,244,70.9,417,173,244,70.9
36380, 장흥군,080002, 76세,2021,439,190,249,76.3,438,190,248,76.6
36380, 장흥군,080003, 77세,2021,399,190,209,90.9,399,190,209,90.9
36380, 장흥군,080004, 78세,2021,464,170,294,57.8,464,170,294,57.8
36380, 장흥군,080005, 79세,2021,638,229,409,56,638,229,409,56
36380, 장흥군,085,80~84세,2021,2294,818,1476,55.4,2293,818,1475,55.5
36380, 장흥군,085001, 80세,2021,521,215,306,70.3,521,215,306,70.3
36380, 장흥군,085002, 81세,2021,500,180,320,56.3,500,180,320,56.3
36380, 장흥군,085003, 82세,2021,490,167,323,51.7,489,167,322,51.9
36380, 장흥군,085004, 83세,2021,438,154,284,54.2,438,154,284,54.2
36380, 장흥군,085005, 84세,2021,345,102,243,42,345,102,243,42
36380, 장흥군,090,85~89세,2021,1373,370,1003,36.9,1373,370,1003,36.9
36380, 장흥군,090001, 85세,2021,363,104,259,40.2,363,104,259,40.2
36380, 장흥군,090002, 86세,2021,332,99,233,42.5,332,99,233,42.5
36380, 장흥군,090003, 87세,2021,278,67,211,31.8,278,67,211,31.8
36380, 장흥군,090004, 88세,2021,213,48,165,29.1,213,48,165,29.1
36380, 장흥군,090005, 89세,2021,187,52,135,38.5,187,52,135,38.5
36380, 장흥군,095,90~94세,2021,470,95,375,25.3,470,95,375,25.3
36380, 장흥군,095001, 90세,2021,136,27,109,24.8,136,27,109,24.8
36380, 장흥군,095002, 91세,2021,117,24,93,25.8,117,24,93,25.8
36380, 장흥군,095003, 92세,2021,107,25,82,30.5,107,25,82,30.5
36380, 장흥군,095004, 93세,2021,70,13,57,22.8,70,13,57,22.8
36380, 장흥군,095005, 94세,2021,40,6,34,17.6,40,6,34,17.6
36380, 장흥군,100,95~99세,2021,95,19,76,25,95,19,76,25
36380, 장흥군,100001, 95세,2021,28,X,24,16.7,28,X,24,16.7
36380, 장흥군,100002, 96세,2021,20,X,17,17.6,20,X,17,17.6
36380, 장흥군,100003, 97세,2021,16,X,12,33.3,16,X,12,33.3
36380, 장흥군,100004, 98세,2021,22,5,17,29.4,22,5,17,29.4
36380, 장흥군,100005, 99세,2021,9,X,6,50,9,X,6,50
36380, 장흥군,101,100세이상,2021,11,X,9,22.2,11,X,9,22.2
36380, 장흥군,102,15세미만,2021,2995,1511,1484,101.8,2989,1511,1478,102.2
36380, 장흥군,103,15~64세,2021,19123,10288,8835,116.4,18436,9981,8455,118
36380, 장흥군,104,65세이상,2021,12150,4885,7265,67.2,12130,4875,7255,67.2
36380, 장흥군,086,85세이상,2021,1949,486,1463,33.2,1949,486,1463,33.2
36380, 장흥군,126,평균연령,2021,53.6,50.7,56.2,,53.9,51,56.6,
36380, 장흥군,127,중위연령,2021,57.7,54.8,60.7,,58.2,55.2,61.2,
36390, 강진군,000,합계,2021,31941,15507,16434,94.4,31348,15239,16109,94.6
36390, 강진군,005,0~4세,2021,640,305,335,91,637,303,334,90.7
36390, 강진군,005001, 0세,2021,101,49,52,94.2,100,48,52,92.3
36390, 강진군,005002, 1세,2021,119,55,64,85.9,119,55,64,85.9
36390, 강진군,005003, 2세,2021,148,78,70,111.4,147,77,70,110
36390, 강진군,005004, 3세,2021,146,65,81,80.2,145,65,80,81.3
36390, 강진군,005005, 4세,2021,126,58,68,85.3,126,58,68,85.3
36390, 강진군,010,5~9세,2021,880,451,429,105.1,877,449,428,104.9
36390, 강진군,010001, 5세,2021,136,72,64,112.5,135,71,64,110.9
36390, 강진군,010002, 6세,2021,181,87,94,92.6,180,87,93,93.5
36390, 강진군,010003, 7세,2021,184,88,96,91.7,183,87,96,90.6
36390, 강진군,010004, 8세,2021,183,106,77,137.7,183,106,77,137.7
36390, 강진군,010005, 9세,2021,196,98,98,100,196,98,98,100
36390, 강진군,015,10~14세,2021,1145,595,550,108.2,1144,594,550,108
36390, 강진군,015001, 10세,2021,235,132,103,128.2,235,132,103,128.2
36390, 강진군,015002, 11세,2021,207,112,95,117.9,207,112,95,117.9
36390, 강진군,015003, 12세,2021,198,100,98,102,198,100,98,102
36390, 강진군,015004, 13세,2021,252,123,129,95.3,251,122,129,94.6
36390, 강진군,015005, 14세,2021,253,128,125,102.4,253,128,125,102.4
36390, 강진군,020,15~19세,2021,1155,638,517,123.4,1154,637,517,123.2
36390, 강진군,020001, 15세,2021,217,111,106,104.7,216,110,106,103.8
36390, 강진군,020002, 16세,2021,260,142,118,120.3,260,142,118,120.3
36390, 강진군,020003, 17세,2021,296,162,134,120.9,296,162,134,120.9
36390, 강진군,020004, 18세,2021,229,126,103,122.3,229,126,103,122.3
36390, 강진군,020005, 19세,2021,153,97,56,173.2,153,97,56,173.2
36390, 강진군,025,20~24세,2021,1185,719,466,154.3,1145,701,444,157.9
36390, 강진군,025001, 20세,2021,213,142,71,200,212,141,71,198.6
36390, 강진군,025002, 21세,2021,268,182,86,211.6,266,182,84,216.7
36390, 강진군,025003, 22세,2021,198,115,83,138.6,193,115,78,147.4
36390, 강진군,025004, 23세,2021,238,128,110,116.4,226,123,103,119.4
36390, 강진군,025005, 24세,2021,268,152,116,131,248,140,108,129.6
36390, 강진군,030,25~29세,2021,1208,696,512,135.9,1096,633,463,136.7
36390, 강진군,030001, 25세,2021,214,120,94,127.7,202,115,87,132.2
36390, 강진군,030002, 26세,2021,254,155,99,156.6,227,141,86,164
36390, 강진군,030003, 27세,2021,261,145,116,125,237,131,106,123.6
36390, 강진군,030004, 28세,2021,246,148,98,151,219,132,87,151.7
36390, 강진군,030005, 29세,2021,233,128,105,121.9,211,114,97,117.5
36390, 강진군,035,30~34세,2021,1033,555,478,116.1,916,492,424,116
36390, 강진군,035001, 30세,2021,211,127,84,151.2,188,115,73,157.5
36390, 강진군,035002, 31세,2021,207,107,100,107,184,94,90,104.4
36390, 강진군,035003, 32세,2021,206,105,101,104,179,88,91,96.7
36390, 강진군,035004, 33세,2021,218,111,107,103.7,199,99,100,99
36390, 강진군,035005, 34세,2021,191,105,86,122.1,166,96,70,137.1
36390, 강진군,040,35~39세,2021,1248,626,622,100.6,1158,586,572,102.4
36390, 강진군,040001, 35세,2021,235,113,122,92.6,213,100,113,88.5
36390, 강진군,040002, 36세,2021,211,116,95,122.1,198,109,89,122.5
36390, 강진군,040003, 37세,2021,211,111,100,111,191,105,86,122.1
36390, 강진군,040004, 38세,2021,277,128,149,85.9,266,124,142,87.3
36390, 강진군,040005, 39세,2021,314,158,156,101.3,290,148,142,104.2
36390, 강진군,045,40~44세,2021,1466,769,697,110.3,1407,749,658,113.8
36390, 강진군,045001, 40세,2021,280,145,135,107.4,264,138,126,109.5
36390, 강진군,045002, 41세,2021,311,158,153,103.3,297,155,142,109.2
36390, 강진군,045003, 42세,2021,288,155,133,116.5,277,152,125,121.6
36390, 강진군,045004, 43세,2021,265,137,128,107,257,133,124,107.3
36390, 강진군,045005, 44세,2021,322,174,148,117.6,312,171,141,121.3
36390, 강진군,050,45~49세,2021,1864,1025,839,122.2,1822,1006,816,123.3
36390, 강진군,050001, 45세,2021,311,178,133,133.8,301,174,127,137
36390, 강진군,050002, 46세,2021,346,187,159,117.6,340,185,155,119.4
36390, 강진군,050003, 47세,2021,356,190,166,114.5,348,187,161,116.1
36390, 강진군,050004, 48세,2021,390,213,177,120.3,382,210,172,122.1
36390, 강진군,050005, 49세,2021,461,257,204,126,451,250,201,124.4
36390, 강진군,055,50~54세,2021,2372,1300,1072,121.3,2321,1285,1036,124
36390, 강진군,055001, 50세,2021,495,277,218,127.1,481,273,208,131.3
36390, 강진군,055002, 51세,2021,431,237,194,122.2,424,236,188,125.5
36390, 강진군,055003, 52세,2021,467,237,230,103,459,235,224,104.9
36390, 강진군,055004, 53세,2021,512,281,231,121.6,500,278,222,125.2
36390, 강진군,055005, 54세,2021,467,268,199,134.7,457,263,194,135.6
36390, 강진군,060,55~59세,2021,2832,1484,1348,110.1,2799,1478,1321,111.9
36390, 강진군,060001, 55세,2021,524,286,238,120.2,515,284,231,122.9
36390, 강진군,060002, 56세,2021,559,296,263,112.5,553,296,257,115.2
36390, 강진군,060003, 57세,2021,519,262,257,101.9,513,261,252,103.6
36390, 강진군,060004, 58세,2021,605,297,308,96.4,600,296,304,97.4
36390, 강진군,060005, 59세,2021,625,343,282,121.6,618,341,277,123.1
36390, 강진군,065,60~64세,2021,3447,1728,1719,100.5,3419,1716,1703,100.8
36390, 강진군,065001, 60세,2021,655,315,340,92.6,652,314,338,92.9
36390, 강진군,065002, 61세,2021,738,366,372,98.4,731,365,366,99.7
36390, 강진군,065003, 62세,2021,740,377,363,103.9,737,375,362,103.6
36390, 강진군,065004, 63세,2021,663,342,321,106.5,653,338,315,107.3
36390, 강진군,065005, 64세,2021,651,328,323,101.5,646,324,322,100.6
36390, 강진군,070,65~69세,2021,2645,1289,1356,95.1,2637,1285,1352,95
36390, 강진군,070001, 65세,2021,554,279,275,101.5,550,277,273,101.5
36390, 강진군,070002, 66세,2021,583,282,301,93.7,580,281,299,94
36390, 강진군,070003, 67세,2021,473,227,246,92.3,473,227,246,92.3
36390, 강진군,070004, 68세,2021,483,250,233,107.3,482,249,233,106.9
36390, 강진군,070005, 69세,2021,552,251,301,83.4,552,251,301,83.4
36390, 강진군,075,70~74세,2021,2574,1187,1387,85.6,2570,1185,1385,85.6
36390, 강진군,075001, 70세,2021,466,215,251,85.7,464,214,250,85.6
36390, 강진군,075002, 71세,2021,526,245,281,87.2,524,244,280,87.1
36390, 강진군,075003, 72세,2021,511,258,253,102,511,258,253,102
36390, 강진군,075004, 73세,2021,545,239,306,78.1,545,239,306,78.1
36390, 강진군,075005, 74세,2021,526,230,296,77.7,526,230,296,77.7
36390, 강진군,080,75~79세,2021,2319,958,1361,70.4,2319,958,1361,70.4
36390, 강진군,080001, 75세,2021,432,179,253,70.8,432,179,253,70.8
36390, 강진군,080002, 76세,2021,454,194,260,74.6,454,194,260,74.6
36390, 강진군,080003, 77세,2021,415,183,232,78.9,415,183,232,78.9
36390, 강진군,080004, 78세,2021,423,183,240,76.3,423,183,240,76.3
36390, 강진군,080005, 79세,2021,595,219,376,58.2,595,219,376,58.2
36390, 강진군,085,80~84세,2021,2247,780,1467,53.2,2246,780,1466,53.2
36390, 강진군,085001, 80세,2021,482,183,299,61.2,482,183,299,61.2
36390, 강진군,085002, 81세,2021,516,172,344,50,516,172,344,50
36390, 강진군,085003, 82세,2021,455,164,291,56.4,454,164,290,56.6
36390, 강진군,085004, 83세,2021,446,148,298,49.7,446,148,298,49.7
36390, 강진군,085005, 84세,2021,348,113,235,48.1,348,113,235,48.1
36390, 강진군,090,85~89세,2021,1158,306,852,35.9,1158,306,852,35.9
36390, 강진군,090001, 85세,2021,322,88,234,37.6,322,88,234,37.6
36390, 강진군,090002, 86세,2021,288,90,198,45.5,288,90,198,45.5
36390, 강진군,090003, 87세,2021,213,51,162,31.5,213,51,162,31.5
36390, 강진군,090004, 88세,2021,176,46,130,35.4,176,46,130,35.4
36390, 강진군,090005, 89세,2021,159,31,128,24.2,159,31,128,24.2
36390, 강진군,095,90~94세,2021,461,82,379,21.6,461,82,379,21.6
36390, 강진군,095001, 90세,2021,153,26,127,20.5,153,26,127,20.5
36390, 강진군,095002, 91세,2021,133,26,107,24.3,133,26,107,24.3
36390, 강진군,095003, 92세,2021,76,16,60,26.7,76,16,60,26.7
36390, 강진군,095004, 93세,2021,53,8,45,17.8,53,8,45,17.8
36390, 강진군,095005, 94세,2021,46,6,40,15,46,6,40,15
36390, 강진군,100,95~99세,2021,55,11,44,25,55,11,44,25
36390, 강진군,100001, 95세,2021,16,X,12,33.3,16,X,12,33.3
36390, 강진군,100002, 96세,2021,14,X,11,27.3,14,X,11,27.3
36390, 강진군,100003, 97세,2021,13,X,11,18.2,13,X,11,18.2
36390, 강진군,100004, 98세,2021,8,X,7,14.3,8,X,7,14.3
36390, 강진군,100005, 99세,2021,X,X,X,33.3,X,X,X,33.3
36390, 강진군,101,100세이상,2021,7,X,X,75,7,X,X,75
36390, 강진군,102,15세미만,2021,2665,1351,1314,102.8,2658,1346,1312,102.6
36390, 강진군,103,15~64세,2021,17810,9540,8270,115.4,17237,9283,7954,116.7
36390, 강진군,104,65세이상,2021,11466,4616,6850,67.4,11453,4610,6843,67.4
36390, 강진군,086,85세이상,2021,1681,402,1279,31.4,1681,402,1279,31.4
36390, 강진군,126,평균연령,2021,53.8,50.9,56.4,,54,51.2,56.7,
36390, 강진군,127,중위연령,2021,58.3,55.3,61,,58.7,55.6,61.4,
36400, 해남군,000,합계,2021,63242,31437,31805,98.8,61440,30376,31064,97.8
36400, 해남군,005,0~4세,2021,1667,881,786,112.1,1663,879,784,112.1
36400, 해남군,005001, 0세,2021,307,162,145,111.7,307,162,145,111.7
36400, 해남군,005002, 1세,2021,337,173,164,105.5,337,173,164,105.5
36400, 해남군,005003, 2세,2021,349,182,167,109,346,180,166,108.4
36400, 해남군,005004, 3세,2021,337,181,156,116,337,181,156,116
36400, 해남군,005005, 4세,2021,337,183,154,118.8,336,183,153,119.6
36400, 해남군,010,5~9세,2021,1954,954,1000,95.4,1953,953,1000,95.3
36400, 해남군,010001, 5세,2021,349,181,168,107.7,349,181,168,107.7
36400, 해남군,010002, 6세,2021,359,181,178,101.7,359,181,178,101.7
36400, 해남군,010003, 7세,2021,368,183,185,98.9,368,183,185,98.9
36400, 해남군,010004, 8세,2021,407,187,220,85,407,187,220,85
36400, 해남군,010005, 9세,2021,471,222,249,89.2,470,221,249,88.8
36400, 해남군,015,10~14세,2021,2207,1128,1079,104.5,2204,1127,1077,104.6
36400, 해남군,015001, 10세,2021,462,226,236,95.8,462,226,236,95.8
36400, 해남군,015002, 11세,2021,398,212,186,114,398,212,186,114
36400, 해남군,015003, 12세,2021,429,234,195,120,429,234,195,120
36400, 해남군,015004, 13세,2021,493,241,252,95.6,492,241,251,96
36400, 해남군,015005, 14세,2021,425,215,210,102.4,423,214,209,102.4
36400, 해남군,020,15~19세,2021,1986,1037,949,109.3,1984,1037,947,109.5
36400, 해남군,020001, 15세,2021,484,251,233,107.7,484,251,233,107.7
36400, 해남군,020002, 16세,2021,411,199,212,93.9,411,199,212,93.9
36400, 해남군,020003, 17세,2021,431,235,196,119.9,431,235,196,119.9
36400, 해남군,020004, 18세,2021,374,191,183,104.4,374,191,183,104.4
36400, 해남군,020005, 19세,2021,286,161,125,128.8,284,161,123,130.9
36400, 해남군,025,20~24세,2021,2277,1404,873,160.8,2139,1318,821,160.5
36400, 해남군,025001, 20세,2021,461,324,137,236.5,460,323,137,235.8
36400, 해남군,025002, 21세,2021,502,346,156,221.8,490,343,147,233.3
36400, 해남군,025003, 22세,2021,447,267,180,148.3,419,255,164,155.5
36400, 해남군,025004, 23세,2021,437,235,202,116.3,389,203,186,109.1
36400, 해남군,025005, 24세,2021,430,232,198,117.2,381,194,187,103.7
36400, 해남군,030,25~29세,2021,2542,1457,1085,134.3,2169,1197,972,123.1
36400, 해남군,030001, 25세,2021,547,306,241,127,477,264,213,123.9
36400, 해남군,030002, 26세,2021,530,299,231,129.4,465,255,210,121.4
36400, 해남군,030003, 27세,2021,479,285,194,146.9,404,227,177,128.2
36400, 해남군,030004, 28세,2021,495,280,215,130.2,404,211,193,109.3
36400, 해남군,030005, 29세,2021,491,287,204,140.7,419,240,179,134.1
36400, 해남군,035,30~34세,2021,2222,1212,1010,120,1850,969,881,110
36400, 해남군,035001, 30세,2021,447,259,188,137.8,352,196,156,125.6
36400, 해남군,035002, 31세,2021,435,249,186,133.9,353,194,159,122
36400, 해남군,035003, 32세,2021,427,226,201,112.4,368,184,184,100
36400, 해남군,035004, 33세,2021,413,219,194,112.9,341,176,165,106.7
36400, 해남군,035005, 34세,2021,500,259,241,107.5,436,219,217,100.9
36400, 해남군,040,35~39세,2021,2688,1438,1250,115,2403,1258,1145,109.9
36400, 해남군,040001, 35세,2021,482,258,224,115.2,425,225,200,112.5
36400, 해남군,040002, 36세,2021,473,268,205,130.7,409,221,188,117.6
36400, 해남군,040003, 37세,2021,517,265,252,105.2,464,233,231,100.9
36400, 해남군,040004, 38세,2021,567,311,256,121.5,513,279,234,119.2
36400, 해남군,040005, 39세,2021,649,336,313,107.3,592,300,292,102.7
36400, 해남군,045,40~44세,2021,3296,1745,1551,112.5,3101,1640,1461,112.3
36400, 해남군,045001, 40세,2021,647,332,315,105.4,606,308,298,103.4
36400, 해남군,045002, 41세,2021,655,328,327,100.3,609,312,297,105.1
36400, 해남군,045003, 42세,2021,675,374,301,124.3,634,349,285,122.5
36400, 해남군,045004, 43세,2021,656,358,298,120.1,618,337,281,119.9
36400, 해남군,045005, 44세,2021,663,353,310,113.9,634,334,300,111.3
36400, 해남군,050,45~49세,2021,4057,2273,1784,127.4,3955,2231,1724,129.4
36400, 해남군,050001, 45세,2021,746,417,329,126.7,720,407,313,130
36400, 해남군,050002, 46세,2021,707,402,305,131.8,693,396,297,133.3
36400, 해남군,050003, 47세,2021,806,461,345,133.6,784,451,333,135.4
36400, 해남군,050004, 48세,2021,905,483,422,114.5,889,478,411,116.3
36400, 해남군,050005, 49세,2021,893,510,383,133.2,869,499,370,134.9
36400, 해남군,055,50~54세,2021,5022,2786,2236,124.6,4893,2734,2159,126.6
36400, 해남군,055001, 50세,2021,997,584,413,141.4,972,573,399,143.6
36400, 해남군,055002, 51세,2021,938,528,410,128.8,910,516,394,131
36400, 해남군,055003, 52세,2021,976,532,444,119.8,945,523,422,123.9
36400, 해남군,055004, 53세,2021,1056,576,480,120,1034,566,468,120.9
36400, 해남군,055005, 54세,2021,1055,566,489,115.7,1032,556,476,116.8
36400, 해남군,060,55~59세,2021,5591,3034,2557,118.7,5488,2989,2499,119.6
36400, 해남군,060001, 55세,2021,1120,615,505,121.8,1097,605,492,123
36400, 해남군,060002, 56세,2021,1101,628,473,132.8,1073,617,456,135.3
36400, 해남군,060003, 57세,2021,1090,565,525,107.6,1074,557,517,107.7
36400, 해남군,060004, 58세,2021,1153,630,523,120.5,1136,624,512,121.9
36400, 해남군,060005, 59세,2021,1127,596,531,112.2,1108,586,522,112.3
36400, 해남군,065,60~64세,2021,6625,3402,3223,105.6,6574,3379,3195,105.8
36400, 해남군,065001, 60세,2021,1296,670,626,107,1287,666,621,107.2
36400, 해남군,065002, 61세,2021,1400,754,646,116.7,1393,753,640,117.7
36400, 해남군,065003, 62세,2021,1396,685,711,96.3,1388,680,708,96
36400, 해남군,065004, 63세,2021,1298,654,644,101.6,1280,644,636,101.3
36400, 해남군,065005, 64세,2021,1235,639,596,107.2,1226,636,590,107.8
36400, 해남군,070,65~69세,2021,5258,2559,2699,94.8,5235,2549,2686,94.9
36400, 해남군,070001, 65세,2021,1170,590,580,101.7,1156,585,571,102.5
36400, 해남군,070002, 66세,2021,1109,557,552,100.9,1106,555,551,100.7
36400, 해남군,070003, 67세,2021,965,457,508,90,965,457,508,90
36400, 해남군,070004, 68세,2021,936,434,502,86.5,933,433,500,86.6
36400, 해남군,070005, 69세,2021,1078,521,557,93.5,1075,519,556,93.3
36400, 해남군,075,70~74세,2021,4958,2326,2632,88.4,4946,2318,2628,88.2
36400, 해남군,075001, 70세,2021,939,423,516,82,934,420,514,81.7
36400, 해남군,075002, 71세,2021,995,474,521,91,994,473,521,90.8
36400, 해남군,075003, 72세,2021,1045,521,524,99.4,1040,517,523,98.9
36400, 해남군,075004, 73세,2021,961,448,513,87.3,961,448,513,87.3
36400, 해남군,075005, 74세,2021,1018,460,558,82.4,1017,460,557,82.6
36400, 해남군,080,75~79세,2021,4411,1803,2608,69.1,4407,1801,2606,69.1
36400, 해남군,080001, 75세,2021,780,352,428,82.2,780,352,428,82.2
36400, 해남군,080002, 76세,2021,853,358,495,72.3,851,357,494,72.3
36400, 해남군,080003, 77세,2021,761,303,458,66.2,760,302,458,65.9
36400, 해남군,080004, 78세,2021,919,372,547,68,919,372,547,68
36400, 해남군,080005, 79세,2021,1098,418,680,61.5,1097,418,679,61.6
36400, 해남군,085,80~84세,2021,3814,1360,2454,55.4,3809,1359,2450,55.5
36400, 해남군,085001, 80세,2021,874,314,560,56.1,873,314,559,56.2
36400, 해남군,085002, 81세,2021,852,314,538,58.4,849,314,535,58.7
36400, 해남군,085003, 82세,2021,787,297,490,60.6,787,297,490,60.6
36400, 해남군,085004, 83세,2021,667,232,435,53.3,666,231,435,53.1
36400, 해남군,085005, 84세,2021,634,203,431,47.1,634,203,431,47.1
36400, 해남군,090,85~89세,2021,1891,496,1395,35.6,1891,496,1395,35.6
36400, 해남군,090001, 85세,2021,522,147,375,39.2,522,147,375,39.2
36400, 해남군,090002, 86세,2021,428,111,317,35,428,111,317,35
36400, 해남군,090003, 87세,2021,384,100,284,35.2,384,100,284,35.2
36400, 해남군,090004, 88세,2021,305,79,226,35,305,79,226,35
36400, 해남군,090005, 89세,2021,252,59,193,30.6,252,59,193,30.6
36400, 해남군,095,90~94세,2021,641,122,519,23.5,641,122,519,23.5
36400, 해남군,095001, 90세,2021,208,38,170,22.4,208,38,170,22.4
36400, 해남군,095002, 91세,2021,173,30,143,21,173,30,143,21
36400, 해남군,095003, 92세,2021,113,27,86,31.4,113,27,86,31.4
36400, 해남군,095004, 93세,2021,79,14,65,21.5,79,14,65,21.5
36400, 해남군,095005, 94세,2021,68,13,55,23.6,68,13,55,23.6
36400, 해남군,100,95~99세,2021,117,20,97,20.6,117,20,97,20.6
36400, 해남군,100001, 95세,2021,33,6,27,22.2,33,6,27,22.2
36400, 해남군,100002, 96세,2021,17,X,16,6.3,17,X,16,6.3
36400, 해남군,100003, 97세,2021,29,6,23,26.1,29,6,23,26.1
36400, 해남군,100004, 98세,2021,23,6,17,35.3,23,6,17,35.3
36400, 해남군,100005, 99세,2021,15,X,14,7.1,15,X,14,7.1
36400, 해남군,101,100세이상,2021,18,X,18,0,18,X,18,0
36400, 해남군,102,15세미만,2021,5828,2963,2865,103.4,5820,2959,2861,103.4
36400, 해남군,103,15~64세,2021,36306,19788,16518,119.8,34556,18752,15804,118.7
36400, 해남군,104,65세이상,2021,21108,8686,12422,69.9,21064,8665,12399,69.9
36400, 해남군,086,85세이상,2021,2667,638,2029,31.4,2667,638,2029,31.4
36400, 해남군,126,평균연령,2021,52.4,50,54.8,,52.9,50.5,55.2,
36400, 해남군,127,중위연령,2021,56.5,53.9,59.5,,57.2,54.7,60.1,
36410, 영암군,000,합계,2021,55998,30212,25786,117.2,50262,26064,24198,107.7
36410, 영암군,005,0~4세,2021,1403,727,676,107.5,1344,692,652,106.1
36410, 영암군,005001, 0세,2021,226,124,102,121.6,217,119,98,121.4
36410, 영암군,005002, 1세,2021,263,138,125,110.4,255,135,120,112.5
36410, 영암군,005003, 2세,2021,306,155,151,102.6,290,143,147,97.3
36410, 영암군,005004, 3세,2021,311,160,151,106,295,152,143,106.3
36410, 영암군,005005, 4세,2021,297,150,147,102,287,143,144,99.3
36410, 영암군,010,5~9세,2021,1882,962,920,104.6,1803,921,882,104.4
36410, 영암군,010001, 5세,2021,362,178,184,96.7,340,166,174,95.4
36410, 영암군,010002, 6세,2021,359,185,174,106.3,341,178,163,109.2
36410, 영암군,010003, 7세,2021,359,184,175,105.1,348,180,168,107.1
36410, 영암군,010004, 8세,2021,396,203,193,105.2,382,194,188,103.2
36410, 영암군,010005, 9세,2021,406,212,194,109.3,392,203,189,107.4
36410, 영암군,015,10~14세,2021,2084,1063,1021,104.1,2030,1041,989,105.3
36410, 영암군,015001, 10세,2021,447,214,233,91.8,432,207,225,92
36410, 영암군,015002, 11세,2021,416,214,202,105.9,408,211,197,107.1
36410, 영암군,015003, 12세,2021,405,215,190,113.2,394,212,182,116.5
36410, 영암군,015004, 13세,2021,376,191,185,103.2,368,188,180,104.4
36410, 영암군,015005, 14세,2021,440,229,211,108.5,428,223,205,108.8
36410, 영암군,020,15~19세,2021,2165,1171,994,117.8,2112,1142,970,117.7
36410, 영암군,020001, 15세,2021,384,208,176,118.2,375,202,173,116.8
36410, 영암군,020002, 16세,2021,401,210,191,109.9,395,207,188,110.1
36410, 영암군,020003, 17세,2021,414,214,200,107,404,209,195,107.2
36410, 영암군,020004, 18세,2021,484,270,214,126.2,471,264,207,127.5
36410, 영암군,020005, 19세,2021,482,269,213,126.3,467,260,207,125.6
36410, 영암군,025,20~24세,2021,3221,1955,1266,154.4,2862,1656,1206,137.3
36410, 영암군,025001, 20세,2021,593,354,239,148.1,575,339,236,143.6
36410, 영암군,025002, 21세,2021,728,415,313,132.6,669,365,304,120.1
36410, 영암군,025003, 22세,2021,656,381,275,138.5,590,326,264,123.5
36410, 영암군,025004, 23세,2021,602,387,215,180,506,305,201,151.7
36410, 영암군,025005, 24세,2021,642,418,224,186.6,522,321,201,159.7
36410, 영암군,030,25~29세,2021,3065,2020,1045,193.3,2127,1239,888,139.5
36410, 영암군,030001, 25세,2021,618,392,226,173.5,478,275,203,135.5
36410, 영암군,030002, 26세,2021,636,432,204,211.8,436,261,175,149.1
36410, 영암군,030003, 27세,2021,592,397,195,203.6,411,244,167,146.1
36410, 영암군,030004, 28세,2021,593,385,208,185.1,390,222,168,132.1
36410, 영암군,030005, 29세,2021,626,414,212,195.3,412,237,175,135.4
36410, 영암군,035,30~34세,2021,2837,1796,1041,172.5,1733,931,802,116.1
36410, 영암군,035001, 30세,2021,568,364,204,178.4,357,196,161,121.7
36410, 영암군,035002, 31세,2021,576,356,220,161.8,344,184,160,115
36410, 영암군,035003, 32세,2021,565,349,216,161.6,331,168,163,103.1
36410, 영암군,035004, 33세,2021,554,350,204,171.6,339,178,161,110.6
36410, 영암군,035005, 34세,2021,574,377,197,191.4,362,205,157,130.6
36410, 영암군,040,35~39세,2021,3434,2116,1318,160.5,2478,1367,1111,123
36410, 영암군,040001, 35세,2021,601,372,229,162.4,384,200,184,108.7
36410, 영암군,040002, 36세,2021,621,375,246,152.4,414,223,191,116.8
36410, 영암군,040003, 37세,2021,644,396,248,159.7,451,245,206,118.9
36410, 영암군,040004, 38세,2021,712,455,257,177,545,318,227,140.1
36410, 영암군,040005, 39세,2021,856,518,338,153.3,684,381,303,125.7
36410, 영암군,045,40~44세,2021,3724,2307,1417,162.8,3143,1884,1259,149.6
36410, 영암군,045001, 40세,2021,717,461,256,180.1,566,351,215,163.3
36410, 영암군,045002, 41세,2021,779,504,275,183.3,666,414,252,164.3
36410, 영암군,045003, 42세,2021,747,437,310,141,648,369,279,132.3
36410, 영암군,045004, 43세,2021,717,448,269,166.5,624,382,242,157.9
36410, 영암군,045005, 44세,2021,764,457,307,148.9,639,368,271,135.8
36410, 영암군,050,45~49세,2021,4214,2538,1676,151.4,3739,2232,1507,148.1
36410, 영암군,050001, 45세,2021,757,455,302,150.7,639,373,266,140.2
36410, 영암군,050002, 46세,2021,780,476,304,156.6,688,408,280,145.7
36410, 영암군,050003, 47세,2021,848,498,350,142.3,755,447,308,145.1
36410, 영암군,050004, 48세,2021,922,568,354,160.5,827,507,320,158.4
36410, 영암군,050005, 49세,2021,907,541,366,147.8,830,497,333,149.2
36410, 영암군,055,50~54세,2021,4685,2688,1997,134.6,4291,2451,1840,133.2
36410, 영암군,055001, 50세,2021,933,526,407,129.2,857,484,373,129.8
36410, 영암군,055002, 51세,2021,912,534,378,141.3,825,479,346,138.4
36410, 영암군,055003, 52세,2021,946,521,425,122.6,862,478,384,124.5
36410, 영암군,055004, 53세,2021,979,576,403,142.9,897,526,371,141.8
36410, 영암군,055005, 54세,2021,915,531,384,138.3,850,484,366,132.2
36410, 영암군,060,55~59세,2021,4877,2744,2133,128.6,4514,2542,1972,128.9
36410, 영암군,060001, 55세,2021,1023,596,427,139.6,945,552,393,140.5
36410, 영암군,060002, 56세,2021,938,536,402,133.3,874,494,380,130
36410, 영암군,060003, 57세,2021,942,533,409,130.3,864,493,371,132.9
36410, 영암군,060004, 58세,2021,1022,573,449,127.6,934,531,403,131.8
36410, 영암군,060005, 59세,2021,952,506,446,113.5,897,472,425,111.1
36410, 영암군,065,60~64세,2021,4697,2552,2145,119,4538,2459,2079,118.3
36410, 영암군,065001, 60세,2021,1039,581,458,126.9,1006,562,444,126.6
36410, 영암군,065002, 61세,2021,981,539,442,121.9,940,510,430,118.6
36410, 영암군,065003, 62세,2021,971,522,449,116.3,941,505,436,115.8
36410, 영암군,065004, 63세,2021,850,471,379,124.3,823,455,368,123.6
36410, 영암군,065005, 64세,2021,856,439,417,105.3,828,427,401,106.5
36410, 영암군,070,65~69세,2021,3527,1728,1799,96.1,3428,1679,1749,96
36410, 영암군,070001, 65세,2021,811,399,412,96.8,786,389,397,98
36410, 영암군,070002, 66세,2021,781,382,399,95.7,755,368,387,95.1
36410, 영암군,070003, 67세,2021,654,321,333,96.4,635,312,323,96.6
36410, 영암군,070004, 68세,2021,598,289,309,93.5,588,283,305,92.8
36410, 영암군,070005, 69세,2021,683,337,346,97.4,664,327,337,97
36410, 영암군,075,70~74세,2021,3045,1408,1637,86,3017,1398,1619,86.3
36410, 영암군,075001, 70세,2021,592,271,321,84.4,585,267,318,84
36410, 영암군,075002, 71세,2021,616,278,338,82.2,607,277,330,83.9
36410, 영암군,075003, 72세,2021,635,317,318,99.7,631,316,315,100.3
36410, 영암군,075004, 73세,2021,591,275,316,87,585,273,312,87.5
36410, 영암군,075005, 74세,2021,611,267,344,77.6,609,265,344,77
36410, 영암군,080,75~79세,2021,2819,1123,1696,66.2,2798,1120,1678,66.7
36410, 영암군,080001, 75세,2021,515,202,313,64.5,513,202,311,65
36410, 영암군,080002, 76세,2021,548,235,313,75.1,542,235,307,76.5
36410, 영암군,080003, 77세,2021,532,201,331,60.7,528,200,328,61
36410, 영암군,080004, 78세,2021,525,189,336,56.3,519,189,330,57.3
36410, 영암군,080005, 79세,2021,699,296,403,73.4,696,294,402,73.1
36410, 영암군,085,80~84세,2021,2497,832,1665,50,2487,830,1657,50.1
36410, 영암군,085001, 80세,2021,578,195,383,50.9,575,195,380,51.3
36410, 영암군,085002, 81세,2021,542,188,354,53.1,540,188,352,53.4
36410, 영암군,085003, 82세,2021,531,188,343,54.8,529,186,343,54.2
36410, 영암군,085004, 83세,2021,436,132,304,43.4,434,132,302,43.7
36410, 영암군,085005, 84세,2021,410,129,281,45.9,409,129,280,46.1
36410, 영암군,090,85~89세,2021,1327,377,950,39.7,1325,377,948,39.8
36410, 영암군,090001, 85세,2021,336,100,236,42.4,336,100,236,42.4
36410, 영암군,090002, 86세,2021,328,90,238,37.8,328,90,238,37.8
36410, 영암군,090003, 87세,2021,275,79,196,40.3,274,79,195,40.5
36410, 영암군,090004, 88세,2021,216,61,155,39.4,216,61,155,39.4
36410, 영암군,090005, 89세,2021,172,47,125,37.6,171,47,124,37.9
36410, 영암군,095,90~94세,2021,413,85,328,25.9,411,83,328,25.3
36410, 영암군,095001, 90세,2021,144,30,114,26.3,143,29,114,25.4
36410, 영암군,095002, 91세,2021,107,23,84,27.4,107,23,84,27.4
36410, 영암군,095003, 92세,2021,79,14,65,21.5,79,14,65,21.5
36410, 영암군,095004, 93세,2021,49,10,39,25.6,48,9,39,23.1
36410, 영암군,095005, 94세,2021,34,8,26,30.8,34,8,26,30.8
36410, 영암군,100,95~99세,2021,76,19,57,33.3,76,19,57,33.3
36410, 영암군,100001, 95세,2021,15,X,12,25,15,X,12,25
36410, 영암군,100002, 96세,2021,23,6,17,35.3,23,6,17,35.3
36410, 영암군,100003, 97세,2021,16,X,12,33.3,16,X,12,33.3
36410, 영암군,100004, 98세,2021,15,X,11,36.4,15,X,11,36.4
36410, 영암군,100005, 99세,2021,7,X,5,40,7,X,5,40
36410, 영암군,101,100세이상,2021,6,X,5,20,6,X,5,20
36410, 영암군,102,15세미만,2021,5369,2752,2617,105.2,5177,2654,2523,105.2
36410, 영암군,103,15~64세,2021,36919,21887,15032,145.6,31537,17903,13634,131.3
36410, 영암군,104,65세이상,2021,13710,5573,8137,68.5,13548,5507,8041,68.5
36410, 영암군,086,85세이상,2021,1822,482,1340,36,1818,480,1338,35.9
36410, 영암군,126,평균연령,2021,47.9,45.5,50.8,,49,46.9,51.4,
36410, 영암군,127,중위연령,2021,50,47.1,53.8,,52.1,49.9,55,
36420, 무안군,000,합계,2021,90094,45409,44685,101.6,87946,44209,43737,101.1
36420, 무안군,005,0~4세,2021,3118,1606,1512,106.2,3106,1598,1508,106
36420, 무안군,005001, 0세,2021,499,259,240,107.9,497,257,240,107.1
36420, 무안군,005002, 1세,2021,502,264,238,110.9,501,263,238,110.5
36420, 무안군,005003, 2세,2021,680,328,352,93.2,675,326,349,93.4
36420, 무안군,005004, 3세,2021,714,372,342,108.8,712,370,342,108.2
36420, 무안군,005005, 4세,2021,723,383,340,112.6,721,382,339,112.7
36420, 무안군,010,5~9세,2021,5021,2593,2428,106.8,5011,2588,2423,106.8
36420, 무안군,010001, 5세,2021,920,471,449,104.9,919,470,449,104.7
36420, 무안군,010002, 6세,2021,972,533,439,121.4,970,532,438,121.5
36420, 무안군,010003, 7세,2021,964,484,480,100.8,960,482,478,100.8
36420, 무안군,010004, 8세,2021,1003,520,483,107.7,1002,519,483,107.5
36420, 무안군,010005, 9세,2021,1162,585,577,101.4,1160,585,575,101.7
36420, 무안군,015,10~14세,2021,5106,2577,2529,101.9,5097,2573,2524,101.9
36420, 무안군,015001, 10세,2021,1062,530,532,99.6,1059,529,530,99.8
36420, 무안군,015002, 11세,2021,1058,525,533,98.5,1056,524,532,98.5
36420, 무안군,015003, 12세,2021,998,509,489,104.1,996,507,489,103.7
36420, 무안군,015004, 13세,2021,985,492,493,99.8,983,492,491,100.2
36420, 무안군,015005, 14세,2021,1003,521,482,108.1,1003,521,482,108.1
36420, 무안군,020,15~19세,2021,4826,2460,2366,104,4742,2410,2332,103.3
36420, 무안군,020001, 15세,2021,870,444,426,104.2,867,444,423,105
36420, 무안군,020002, 16세,2021,795,375,420,89.3,793,373,420,88.8
36420, 무안군,020003, 17세,2021,862,421,441,95.5,858,419,439,95.4
36420, 무안군,020004, 18세,2021,988,490,498,98.4,974,485,489,99.2
36420, 무안군,020005, 19세,2021,1311,730,581,125.6,1250,689,561,122.8
36420, 무안군,025,20~24세,2021,6557,3712,2845,130.5,6186,3496,2690,130
36420, 무안군,025001, 20세,2021,1299,664,635,104.6,1222,616,606,101.7
36420, 무안군,025002, 21세,2021,1448,733,715,102.5,1388,698,690,101.2
36420, 무안군,025003, 22세,2021,1400,782,618,126.5,1331,740,591,125.2
36420, 무안군,025004, 23세,2021,1246,789,457,172.6,1184,757,427,177.3
36420, 무안군,025005, 24세,2021,1164,744,420,177.1,1061,685,376,182.2
36420, 무안군,030,25~29세,2021,4897,2663,2234,119.2,4495,2404,2091,115
36420, 무안군,030001, 25세,2021,1028,640,388,164.9,955,586,369,158.8
36420, 무안군,030002, 26세,2021,986,557,429,129.8,894,498,396,125.8
36420, 무안군,030003, 27세,2021,919,458,461,99.3,831,404,427,94.6
36420, 무안군,030004, 28세,2021,949,505,444,113.7,866,453,413,109.7
36420, 무안군,030005, 29세,2021,1015,503,512,98.2,949,463,486,95.3
36420, 무안군,035,30~34세,2021,4764,2448,2316,105.7,4378,2225,2153,103.3
36420, 무안군,035001, 30세,2021,968,516,452,114.2,881,464,417,111.3
36420, 무안군,035002, 31세,2021,973,512,461,111.1,894,466,428,108.9
36420, 무안군,035003, 32세,2021,941,497,444,111.9,861,454,407,111.5
36420, 무안군,035004, 33세,2021,913,475,438,108.4,832,427,405,105.4
36420, 무안군,035005, 34세,2021,969,448,521,86,910,414,496,83.5
36420, 무안군,040,35~39세,2021,6509,3285,3224,101.9,6235,3139,3096,101.4
36420, 무안군,040001, 35세,2021,1039,554,485,114.2,978,522,456,114.5
36420, 무안군,040002, 36세,2021,1193,608,585,103.9,1139,576,563,102.3
36420, 무안군,040003, 37세,2021,1272,611,661,92.4,1204,578,626,92.3
36420, 무안군,040004, 38세,2021,1408,684,724,94.5,1360,657,703,93.5
36420, 무안군,040005, 39세,2021,1597,828,769,107.7,1554,806,748,107.8
36420, 무안군,045,40~44세,2021,7201,3673,3528,104.1,7009,3571,3438,103.9
36420, 무안군,045001, 40세,2021,1494,774,720,107.5,1450,755,695,108.6
36420, 무안군,045002, 41세,2021,1560,768,792,97,1512,745,767,97.1
36420, 무안군,045003, 42세,2021,1439,746,693,107.6,1399,718,681,105.4
36420, 무안군,045004, 43세,2021,1338,695,643,108.1,1305,676,629,107.5
36420, 무안군,045005, 44세,2021,1370,690,680,101.5,1343,677,666,101.7
36420, 무안군,050,45~49세,2021,6643,3529,3114,113.3,6513,3462,3051,113.5
36420, 무안군,050001, 45세,2021,1287,693,594,116.7,1256,679,577,117.7
36420, 무안군,050002, 46세,2021,1263,664,599,110.9,1239,650,589,110.4
36420, 무안군,050003, 47세,2021,1418,782,636,123,1394,769,625,123
36420, 무안군,050004, 48세,2021,1340,684,656,104.3,1314,672,642,104.7
36420, 무안군,050005, 49세,2021,1335,706,629,112.2,1310,692,618,112
36420, 무안군,055,50~54세,2021,6597,3588,3009,119.2,6484,3533,2951,119.7
36420, 무안군,055001, 50세,2021,1407,796,611,130.3,1383,784,599,130.9
36420, 무안군,055002, 51세,2021,1335,727,608,119.6,1307,712,595,119.7
36420, 무안군,055003, 52세,2021,1304,724,580,124.8,1285,714,571,125
36420, 무안군,055004, 53세,2021,1345,711,634,112.1,1320,698,622,112.2
36420, 무안군,055005, 54세,2021,1206,630,576,109.4,1189,625,564,110.8
36420, 무안군,060,55~59세,2021,5964,3160,2804,112.7,5871,3125,2746,113.8
36420, 무안군,060001, 55세,2021,1233,667,566,117.8,1213,658,555,118.6
36420, 무안군,060002, 56세,2021,1206,649,557,116.5,1182,640,542,118.1
36420, 무안군,060003, 57세,2021,1126,613,513,119.5,1111,608,503,120.9
36420, 무안군,060004, 58세,2021,1173,590,583,101.2,1152,582,570,102.1
36420, 무안군,060005, 59세,2021,1226,641,585,109.6,1213,637,576,110.6
36420, 무안군,065,60~64세,2021,6021,3044,2977,102.3,5987,3030,2957,102.5
36420, 무안군,065001, 60세,2021,1242,637,605,105.3,1235,635,600,105.8
36420, 무안군,065002, 61세,2021,1341,688,653,105.4,1332,685,647,105.9
36420, 무안군,065003, 62세,2021,1182,585,597,98,1178,582,596,97.7
36420, 무안군,065004, 63세,2021,1135,585,550,106.4,1126,580,546,106.2
36420, 무안군,065005, 64세,2021,1121,549,572,96,1116,548,568,96.5
36420, 무안군,070,65~69세,2021,4632,2260,2372,95.3,4612,2251,2361,95.3
36420, 무안군,070001, 65세,2021,968,482,486,99.2,964,480,484,99.2
36420, 무안군,070002, 66세,2021,1052,509,543,93.7,1047,507,540,93.9
36420, 무안군,070003, 67세,2021,903,421,482,87.3,899,419,480,87.3
36420, 무안군,070004, 68세,2021,788,412,376,109.6,785,409,376,108.8
36420, 무안군,070005, 69세,2021,921,436,485,89.9,917,436,481,90.6
36420, 무안군,075,70~74세,2021,4068,1968,2100,93.7,4059,1964,2095,93.7
36420, 무안군,075001, 70세,2021,817,400,417,95.9,815,400,415,96.4
36420, 무안군,075002, 71세,2021,792,378,414,91.3,792,378,414,91.3
36420, 무안군,075003, 72세,2021,831,404,427,94.6,825,401,424,94.6
36420, 무안군,075004, 73세,2021,831,411,420,97.9,830,410,420,97.6
36420, 무안군,075005, 74세,2021,797,375,422,88.9,797,375,422,88.9
36420, 무안군,080,75~79세,2021,3416,1443,1973,73.1,3413,1442,1971,73.2
36420, 무안군,080001, 75세,2021,655,305,350,87.1,655,305,350,87.1
36420, 무안군,080002, 76세,2021,662,290,372,78,661,290,371,78.2
36420, 무안군,080003, 77세,2021,597,245,352,69.6,595,244,351,69.5
36420, 무안군,080004, 78세,2021,614,253,361,70.1,614,253,361,70.1
36420, 무안군,080005, 79세,2021,888,350,538,65.1,888,350,538,65.1
36420, 무안군,085,80~84세,2021,2765,924,1841,50.2,2761,922,1839,50.1
36420, 무안군,085001, 80세,2021,675,253,422,60,674,252,422,59.7
36420, 무안군,085002, 81세,2021,621,201,420,47.9,619,200,419,47.7
36420, 무안군,085003, 82세,2021,529,172,357,48.2,528,172,356,48.3
36420, 무안군,085004, 83세,2021,525,170,355,47.9,525,170,355,47.9
36420, 무안군,085005, 84세,2021,415,128,287,44.6,415,128,287,44.6
36420, 무안군,090,85~89세,2021,1398,383,1015,37.7,1397,383,1014,37.8
36420, 무안군,090001, 85세,2021,341,91,250,36.4,341,91,250,36.4
36420, 무안군,090002, 86세,2021,345,99,246,40.2,344,99,245,40.4
36420, 무안군,090003, 87세,2021,298,93,205,45.4,298,93,205,45.4
36420, 무안군,090004, 88세,2021,247,63,184,34.2,247,63,184,34.2
36420, 무안군,090005, 89세,2021,167,37,130,28.5,167,37,130,28.5
36420, 무안군,095,90~94세,2021,485,83,402,20.6,484,83,401,20.7
36420, 무안군,095001, 90세,2021,129,30,99,30.3,129,30,99,30.3
36420, 무안군,095002, 91세,2021,141,20,121,16.5,141,20,121,16.5
36420, 무안군,095003, 92세,2021,89,15,74,20.3,89,15,74,20.3
36420, 무안군,095004, 93세,2021,79,11,68,16.2,78,11,67,16.4
36420, 무안군,095005, 94세,2021,47,7,40,17.5,47,7,40,17.5
36420, 무안군,100,95~99세,2021,89,10,79,12.7,89,10,79,12.7
36420, 무안군,100001, 95세,2021,27,X,24,12.5,27,X,24,12.5
36420, 무안군,100002, 96세,2021,28,X,24,16.7,28,X,24,16.7
36420, 무안군,100003, 97세,2021,14,X,12,16.7,14,X,12,16.7
36420, 무안군,100004, 98세,2021,12,X,11,9.1,12,X,11,9.1
36420, 무안군,100005, 99세,2021,8,X,8,0,8,X,8,0
36420, 무안군,101,100세이상,2021,17,X,17,0,17,X,17,0
36420, 무안군,102,15세미만,2021,13245,6776,6469,104.7,13214,6759,6455,104.7
36420, 무안군,103,15~64세,2021,59979,31562,28417,111.1,57900,30395,27505,110.5
36420, 무안군,104,65세이상,2021,16870,7071,9799,72.2,16832,7055,9777,72.2
36420, 무안군,086,85세이상,2021,1989,476,1513,31.5,1987,476,1511,31.5
36420, 무안군,126,평균연령,2021,42.6,41.1,44.1,,42.8,41.3,44.3,
36420, 무안군,127,중위연령,2021,42.8,41.8,44.1,,43.3,42.2,44.4,
36430, 함평군,000,합계,2021,29369,14660,14709,99.7,28507,14201,14306,99.3
36430, 함평군,005,0~4세,2021,519,267,252,106,517,266,251,106
36430, 함평군,005001, 0세,2021,91,43,48,89.6,91,43,48,89.6
36430, 함평군,005002, 1세,2021,110,54,56,96.4,109,53,56,94.6
36430, 함평군,005003, 2세,2021,100,53,47,112.8,99,53,46,115.2
36430, 함평군,005004, 3세,2021,106,54,52,103.8,106,54,52,103.8
36430, 함평군,005005, 4세,2021,112,63,49,128.6,112,63,49,128.6
36430, 함평군,010,5~9세,2021,675,350,325,107.7,675,350,325,107.7
36430, 함평군,010001, 5세,2021,123,72,51,141.2,123,72,51,141.2
36430, 함평군,010002, 6세,2021,102,47,55,85.5,102,47,55,85.5
36430, 함평군,010003, 7세,2021,126,59,67,88.1,126,59,67,88.1
36430, 함평군,010004, 8세,2021,159,83,76,109.2,159,83,76,109.2
36430, 함평군,010005, 9세,2021,165,89,76,117.1,165,89,76,117.1
36430, 함평군,015,10~14세,2021,878,472,406,116.3,878,472,406,116.3
36430, 함평군,015001, 10세,2021,189,109,80,136.3,189,109,80,136.3
36430, 함평군,015002, 11세,2021,165,85,80,106.3,165,85,80,106.3
36430, 함평군,015003, 12세,2021,153,88,65,135.4,153,88,65,135.4
36430, 함평군,015004, 13세,2021,184,96,88,109.1,184,96,88,109.1
36430, 함평군,015005, 14세,2021,187,94,93,101.1,187,94,93,101.1
36430, 함평군,020,15~19세,2021,1136,595,541,110,1131,594,537,110.6
36430, 함평군,020001, 15세,2021,170,92,78,117.9,170,92,78,117.9
36430, 함평군,020002, 16세,2021,214,114,100,114,214,114,100,114
36430, 함평군,020003, 17세,2021,312,154,158,97.5,310,153,157,97.5
36430, 함평군,020004, 18세,2021,276,137,139,98.6,275,137,138,99.3
36430, 함평군,020005, 19세,2021,164,98,66,148.5,162,98,64,153.1
36430, 함평군,025,20~24세,2021,1035,615,420,146.4,933,562,371,151.5
36430, 함평군,025001, 20세,2021,174,104,70,148.6,171,104,67,155.2
36430, 함평군,025002, 21세,2021,226,147,79,186.1,214,140,74,189.2
36430, 함평군,025003, 22세,2021,189,123,66,186.4,172,112,60,186.7
36430, 함평군,025004, 23세,2021,231,133,98,135.7,201,113,88,128.4
36430, 함평군,025005, 24세,2021,215,108,107,100.9,175,93,82,113.4
36430, 함평군,030,25~29세,2021,1148,722,426,169.5,929,582,347,167.7
36430, 함평군,030001, 25세,2021,250,156,94,166,218,133,85,156.5
36430, 함평군,030002, 26세,2021,229,140,89,157.3,182,110,72,152.8
36430, 함평군,030003, 27세,2021,243,164,79,207.6,190,130,60,216.7
36430, 함평군,030004, 28세,2021,204,122,82,148.8,161,96,65,147.7
36430, 함평군,030005, 29세,2021,222,140,82,170.7,178,113,65,173.8
36430, 함평군,035,30~34세,2021,924,493,431,114.4,764,415,349,118.9
36430, 함평군,035001, 30세,2021,195,123,72,170.8,153,104,49,212.2
36430, 함평군,035002, 31세,2021,194,112,82,136.6,160,92,68,135.3
36430, 함평군,035003, 32세,2021,171,83,88,94.3,142,67,75,89.3
36430, 함평군,035004, 33세,2021,190,81,109,74.3,158,71,87,81.6
36430, 함평군,035005, 34세,2021,174,94,80,117.5,151,81,70,115.7
36430, 함평군,040,35~39세,2021,1005,534,471,113.4,884,464,420,110.5
36430, 함평군,040001, 35세,2021,178,100,78,128.2,143,79,64,123.4
36430, 함평군,040002, 36세,2021,185,97,88,110.2,158,83,75,110.7
36430, 함평군,040003, 37세,2021,176,94,82,114.6,162,86,76,113.2
36430, 함평군,040004, 38세,2021,222,121,101,119.8,199,107,92,116.3
36430, 함평군,040005, 39세,2021,244,122,122,100,222,109,113,96.5
36430, 함평군,045,40~44세,2021,1308,756,552,137,1233,718,515,139.4
36430, 함평군,045001, 40세,2021,263,151,112,134.8,247,142,105,135.2
36430, 함평군,045002, 41세,2021,259,155,104,149,249,154,95,162.1
36430, 함평군,045003, 42세,2021,256,148,108,137,240,138,102,135.3
36430, 함평군,045004, 43세,2021,255,149,106,140.6,238,142,96,147.9
36430, 함평군,045005, 44세,2021,275,153,122,125.4,259,142,117,121.4
36430, 함평군,050,45~49세,2021,1721,990,731,135.4,1661,955,706,135.3
36430, 함평군,050001, 45세,2021,284,162,122,132.8,274,155,119,130.3
36430, 함평군,050002, 46세,2021,327,175,152,115.1,311,167,144,116
36430, 함평군,050003, 47세,2021,356,217,139,156.1,350,213,137,155.5
36430, 함평군,050004, 48세,2021,379,219,160,136.9,367,212,155,136.8
36430, 함평군,050005, 49세,2021,375,217,158,137.3,359,208,151,137.7
36430, 함평군,055,50~54세,2021,2242,1300,942,138,2199,1284,915,140.3
36430, 함평군,055001, 50세,2021,424,252,172,146.5,416,248,168,147.6
36430, 함평군,055002, 51세,2021,388,218,170,128.2,382,216,166,130.1
36430, 함평군,055003, 52세,2021,441,250,191,130.9,429,247,182,135.7
36430, 함평군,055004, 53세,2021,485,293,192,152.6,476,291,185,157.3
36430, 함평군,055005, 54세,2021,504,287,217,132.3,496,282,214,131.8
36430, 함평군,060,55~59세,2021,2576,1448,1128,128.4,2544,1437,1107,129.8
36430, 함평군,060001, 55세,2021,506,307,199,154.3,501,306,195,156.9
36430, 함평군,060002, 56세,2021,501,286,215,133,494,283,211,134.1
36430, 함평군,060003, 57세,2021,468,252,216,116.7,461,249,212,117.5
36430, 함평군,060004, 58세,2021,558,306,252,121.4,549,303,246,123.2
36430, 함평군,060005, 59세,2021,543,297,246,120.7,539,296,243,121.8
36430, 함평군,065,60~64세,2021,3099,1649,1450,113.7,3075,1641,1434,114.4
36430, 함평군,065001, 60세,2021,624,333,291,114.4,619,333,286,116.4
36430, 함평군,065002, 61세,2021,667,371,296,125.3,661,369,292,126.4
36430, 함평군,065003, 62세,2021,591,322,269,119.7,587,321,266,120.7
36430, 함평군,065004, 63세,2021,578,297,281,105.7,575,295,280,105.4
36430, 함평군,065005, 64세,2021,639,326,313,104.2,633,323,310,104.2
36430, 함평군,070,65~69세,2021,2596,1290,1306,98.8,2583,1284,1299,98.8
36430, 함평군,070001, 65세,2021,549,295,254,116.1,548,295,253,116.6
36430, 함평군,070002, 66세,2021,592,285,307,92.8,587,284,303,93.7
36430, 함평군,070003, 67세,2021,466,246,220,111.8,463,244,219,111.4
36430, 함평군,070004, 68세,2021,469,219,250,87.6,467,218,249,87.6
36430, 함평군,070005, 69세,2021,520,245,275,89.1,518,243,275,88.4
36430, 함평군,075,70~74세,2021,2350,1094,1256,87.1,2346,1093,1253,87.2
36430, 함평군,075001, 70세,2021,417,200,217,92.2,417,200,217,92.2
36430, 함평군,075002, 71세,2021,482,220,262,84,480,220,260,84.6
36430, 함평군,075003, 72세,2021,466,228,238,95.8,465,227,238,95.4
36430, 함평군,075004, 73세,2021,484,213,271,78.6,483,213,270,78.9
36430, 함평군,075005, 74세,2021,501,233,268,86.9,501,233,268,86.9
36430, 함평군,080,75~79세,2021,2356,927,1429,64.9,2354,926,1428,64.8
36430, 함평군,080001, 75세,2021,469,199,270,73.7,468,198,270,73.3
36430, 함평군,080002, 76세,2021,402,151,251,60.2,401,151,250,60.4
36430, 함평군,080003, 77세,2021,406,147,259,56.8,406,147,259,56.8
36430, 함평군,080004, 78세,2021,433,172,261,65.9,433,172,261,65.9
36430, 함평군,080005, 79세,2021,646,258,388,66.5,646,258,388,66.5
36430, 함평군,085,80~84세,2021,2170,727,1443,50.4,2170,727,1443,50.4
36430, 함평군,085001, 80세,2021,496,181,315,57.5,496,181,315,57.5
36430, 함평군,085002, 81세,2021,482,176,306,57.5,482,176,306,57.5
36430, 함평군,085003, 82세,2021,409,141,268,52.6,409,141,268,52.6
36430, 함평군,085004, 83세,2021,431,129,302,42.7,431,129,302,42.7
36430, 함평군,085005, 84세,2021,352,100,252,39.7,352,100,252,39.7
36430, 함평군,090,85~89세,2021,1146,314,832,37.7,1146,314,832,37.7
36430, 함평군,090001, 85세,2021,304,98,206,47.6,304,98,206,47.6
36430, 함평군,090002, 86세,2021,299,80,219,36.5,299,80,219,36.5
36430, 함평군,090003, 87세,2021,229,66,163,40.5,229,66,163,40.5
36430, 함평군,090004, 88세,2021,178,41,137,29.9,178,41,137,29.9
36430, 함평군,090005, 89세,2021,136,29,107,27.1,136,29,107,27.1
36430, 함평군,095,90~94세,2021,404,103,301,34.2,404,103,301,34.2
36430, 함평군,095001, 90세,2021,115,31,84,36.9,115,31,84,36.9
36430, 함평군,095002, 91세,2021,99,23,76,30.3,99,23,76,30.3
36430, 함평군,095003, 92세,2021,80,20,60,33.3,80,20,60,33.3
36430, 함평군,095004, 93세,2021,66,19,47,40.4,66,19,47,40.4
36430, 함평군,095005, 94세,2021,44,10,34,29.4,44,10,34,29.4
36430, 함평군,100,95~99세,2021,73,14,59,23.7,73,14,59,23.7
36430, 함평군,100001, 95세,2021,23,8,15,53.3,23,8,15,53.3
36430, 함평군,100002, 96세,2021,22,X,21,4.8,22,X,21,4.8
36430, 함평군,100003, 97세,2021,9,X,8,12.5,9,X,8,12.5
36430, 함평군,100004, 98세,2021,11,X,8,37.5,11,X,8,37.5
36430, 함평군,100005, 99세,2021,8,X,7,14.3,8,X,7,14.3
36430, 함평군,101,100세이상,2021,8,X,8,0,8,X,8,0
36430, 함평군,102,15세미만,2021,2072,1089,983,110.8,2070,1088,982,110.8
36430, 함평군,103,15~64세,2021,16194,9102,7092,128.3,15353,8652,6701,129.1
36430, 함평군,104,65세이상,2021,11103,4469,6634,67.4,11084,4461,6623,67.4
36430, 함평군,086,85세이상,2021,1631,431,1200,35.9,1631,431,1200,35.9
36430, 함평군,126,평균연령,2021,54.8,51.8,57.8,,55.4,52.3,58.4,
36430, 함평군,127,중위연령,2021,59.1,55.8,62.5,,59.8,56.5,63.2,
36440, 영광군,000,합계,2021,48981,24440,24541,99.6,47751,23735,24016,98.8
36440, 영광군,005,0~4세,2021,1996,1004,992,101.2,1990,1003,987,101.6
36440, 영광군,005001, 0세,2021,439,212,227,93.4,438,212,226,93.8
36440, 영광군,005002, 1세,2021,531,289,242,119.4,527,288,239,120.5
36440, 영광군,005003, 2세,2021,395,199,196,101.5,394,199,195,102.1
36440, 영광군,005004, 3세,2021,310,149,161,92.5,310,149,161,92.5
36440, 영광군,005005, 4세,2021,321,155,166,93.4,321,155,166,93.4
36440, 영광군,010,5~9세,2021,1618,809,809,100,1614,807,807,100
36440, 영광군,010001, 5세,2021,332,163,169,96.4,332,163,169,96.4
36440, 영광군,010002, 6세,2021,282,135,147,91.8,282,135,147,91.8
36440, 영광군,010003, 7세,2021,293,150,143,104.9,292,149,143,104.2
36440, 영광군,010004, 8세,2021,310,161,149,108.1,308,161,147,109.5
36440, 영광군,010005, 9세,2021,401,200,201,99.5,400,199,201,99
36440, 영광군,015,10~14세,2021,1875,955,920,103.8,1871,954,917,104
36440, 영광군,015001, 10세,2021,375,191,184,103.8,374,191,183,104.4
36440, 영광군,015002, 11세,2021,370,197,173,113.9,369,197,172,114.5
36440, 영광군,015003, 12세,2021,337,163,174,93.7,337,163,174,93.7
36440, 영광군,015004, 13세,2021,393,201,192,104.7,392,200,192,104.2
36440, 영광군,015005, 14세,2021,400,203,197,103,399,203,196,103.6
36440, 영광군,020,15~19세,2021,1830,979,851,115,1828,978,850,115.1
36440, 영광군,020001, 15세,2021,354,186,168,110.7,354,186,168,110.7
36440, 영광군,020002, 16세,2021,349,183,166,110.2,348,183,165,110.9
36440, 영광군,020003, 17세,2021,435,223,212,105.2,434,222,212,104.7
36440, 영광군,020004, 18세,2021,419,228,191,119.4,419,228,191,119.4
36440, 영광군,020005, 19세,2021,273,159,114,139.5,273,159,114,139.5
36440, 영광군,025,20~24세,2021,1859,1173,686,171,1763,1108,655,169.2
36440, 영광군,025001, 20세,2021,306,207,99,209.1,304,206,98,210.2
36440, 영광군,025002, 21세,2021,371,250,121,206.6,361,248,113,219.5
36440, 영광군,025003, 22세,2021,380,244,136,179.4,364,234,130,180
36440, 영광군,025004, 23세,2021,386,223,163,136.8,363,206,157,131.2
36440, 영광군,025005, 24세,2021,416,249,167,149.1,371,214,157,136.3
36440, 영광군,030,25~29세,2021,2278,1290,988,130.6,2030,1121,909,123.3
36440, 영광군,030001, 25세,2021,427,258,169,152.7,386,228,158,144.3
36440, 영광군,030002, 26세,2021,468,273,195,140,424,245,179,136.9
36440, 영광군,030003, 27세,2021,476,264,212,124.5,414,224,190,117.9
36440, 영광군,030004, 28세,2021,446,245,201,121.9,393,208,185,112.4
36440, 영광군,030005, 29세,2021,461,250,211,118.5,413,216,197,109.6
36440, 영광군,035,30~34세,2021,2274,1143,1131,101.1,2030,998,1032,96.7
36440, 영광군,035001, 30세,2021,423,223,200,111.5,377,193,184,104.9
36440, 영광군,035002, 31세,2021,478,234,244,95.9,421,199,222,89.6
36440, 영광군,035003, 32세,2021,448,240,208,115.4,404,210,194,108.2
36440, 영광군,035004, 33세,2021,446,221,225,98.2,398,196,202,97
36440, 영광군,035005, 34세,2021,479,225,254,88.6,430,200,230,87
36440, 영광군,040,35~39세,2021,2391,1253,1138,110.1,2213,1157,1056,109.6
36440, 영광군,040001, 35세,2021,433,227,206,110.2,392,206,186,110.8
36440, 영광군,040002, 36세,2021,463,223,240,92.9,427,207,220,94.1
36440, 영광군,040003, 37세,2021,476,247,229,107.9,441,229,212,108
36440, 영광군,040004, 38세,2021,477,249,228,109.2,447,233,214,108.9
36440, 영광군,040005, 39세,2021,542,307,235,130.6,506,282,224,125.9
36440, 영광군,045,40~44세,2021,2705,1461,1244,117.4,2578,1384,1194,115.9
36440, 영광군,045001, 40세,2021,532,261,271,96.3,496,236,260,90.8
36440, 영광군,045002, 41세,2021,553,294,259,113.5,519,273,246,111
36440, 영광군,045003, 42세,2021,581,315,266,118.4,561,303,258,117.4
36440, 영광군,045004, 43세,2021,529,281,248,113.3,511,271,240,112.9
36440, 영광군,045005, 44세,2021,510,310,200,155,491,301,190,158.4
36440, 영광군,050,45~49세,2021,3207,1786,1421,125.7,3116,1739,1377,126.3
36440, 영광군,050001, 45세,2021,537,313,224,139.7,524,306,218,140.4
36440, 영광군,050002, 46세,2021,611,325,286,113.6,590,313,277,113
36440, 영광군,050003, 47세,2021,708,390,318,122.6,698,386,312,123.7
36440, 영광군,050004, 48세,2021,680,387,293,132.1,661,378,283,133.6
36440, 영광군,050005, 49세,2021,671,371,300,123.7,643,356,287,124
36440, 영광군,055,50~54세,2021,3801,2138,1663,128.6,3730,2116,1614,131.1
36440, 영광군,055001, 50세,2021,783,441,342,128.9,766,435,331,131.4
36440, 영광군,055002, 51세,2021,716,402,314,128,703,397,306,129.7
36440, 영광군,055003, 52세,2021,711,408,303,134.7,700,406,294,138.1
36440, 영광군,055004, 53세,2021,788,428,360,118.9,772,423,349,121.2
36440, 영광군,055005, 54세,2021,803,459,344,133.4,789,455,334,136.2
36440, 영광군,060,55~59세,2021,4017,2130,1887,112.9,3942,2094,1848,113.3
36440, 영광군,060001, 55세,2021,760,402,358,112.3,744,394,350,112.6
36440, 영광군,060002, 56세,2021,809,425,384,110.7,793,415,378,109.8
36440, 영광군,060003, 57세,2021,825,446,379,117.7,808,439,369,119
36440, 영광군,060004, 58세,2021,826,437,389,112.3,809,432,377,114.6
36440, 영광군,060005, 59세,2021,797,420,377,111.4,788,414,374,110.7
36440, 영광군,065,60~64세,2021,4482,2327,2155,108,4436,2303,2133,108
36440, 영광군,065001, 60세,2021,896,477,419,113.8,892,475,417,113.9
36440, 영광군,065002, 61세,2021,1000,509,491,103.7,985,501,484,103.5
36440, 영광군,065003, 62세,2021,846,425,421,101,840,422,418,101
36440, 영광군,065004, 63세,2021,892,474,418,113.4,882,469,413,113.6
36440, 영광군,065005, 64세,2021,848,442,406,108.9,837,436,401,108.7
36440, 영광군,070,65~69세,2021,3626,1755,1871,93.8,3598,1742,1856,93.9
36440, 영광군,070001, 65세,2021,756,391,365,107.1,749,386,363,106.3
36440, 영광군,070002, 66세,2021,823,395,428,92.3,814,392,422,92.9
36440, 영광군,070003, 67세,2021,693,344,349,98.6,686,341,345,98.8
36440, 영광군,070004, 68세,2021,644,294,350,84,642,294,348,84.5
36440, 영광군,070005, 69세,2021,710,331,379,87.3,707,329,378,87
36440, 영광군,075,70~74세,2021,3487,1610,1877,85.8,3480,1606,1874,85.7
36440, 영광군,075001, 70세,2021,651,295,356,82.9,648,294,354,83.1
36440, 영광군,075002, 71세,2021,708,324,384,84.4,707,323,384,84.1
36440, 영광군,075003, 72세,2021,708,335,373,89.8,706,333,373,89.3
36440, 영광군,075004, 73세,2021,660,314,346,90.8,659,314,345,91
36440, 영광군,075005, 74세,2021,760,342,418,81.8,760,342,418,81.8
36440, 영광군,080,75~79세,2021,3130,1261,1869,67.5,3128,1260,1868,67.5
36440, 영광군,080001, 75세,2021,576,241,335,71.9,575,240,335,71.6
36440, 영광군,080002, 76세,2021,562,230,332,69.3,562,230,332,69.3
36440, 영광군,080003, 77세,2021,548,212,336,63.1,547,212,335,63.3
36440, 영광군,080004, 78세,2021,604,237,367,64.6,604,237,367,64.6
36440, 영광군,080005, 79세,2021,840,341,499,68.3,840,341,499,68.3
36440, 영광군,085,80~84세,2021,2651,902,1749,51.6,2651,902,1749,51.6
36440, 영광군,085001, 80세,2021,641,244,397,61.5,641,244,397,61.5
36440, 영광군,085002, 81세,2021,571,188,383,49.1,571,188,383,49.1
36440, 영광군,085003, 82세,2021,543,187,356,52.5,543,187,356,52.5
36440, 영광군,085004, 83세,2021,476,161,315,51.1,476,161,315,51.1
36440, 영광군,085005, 84세,2021,420,122,298,40.9,420,122,298,40.9
36440, 영광군,090,85~89세,2021,1278,361,917,39.4,1277,360,917,39.3
36440, 영광군,090001, 85세,2021,337,102,235,43.4,337,102,235,43.4
36440, 영광군,090002, 86세,2021,377,104,273,38.1,377,104,273,38.1
36440, 영광군,090003, 87세,2021,238,76,162,46.9,238,76,162,46.9
36440, 영광군,090004, 88세,2021,188,41,147,27.9,188,41,147,27.9
36440, 영광군,090005, 89세,2021,138,38,100,38,137,37,100,37
36440, 영광군,095,90~94세,2021,384,95,289,32.9,384,95,289,32.9
36440, 영광군,095001, 90세,2021,103,27,76,35.5,103,27,76,35.5
36440, 영광군,095002, 91세,2021,109,23,86,26.7,109,23,86,26.7
36440, 영광군,095003, 92세,2021,72,24,48,50,72,24,48,50
36440, 영광군,095004, 93세,2021,55,11,44,25,55,11,44,25
36440, 영광군,095005, 94세,2021,45,10,35,28.6,45,10,35,28.6
36440, 영광군,100,95~99세,2021,77,8,69,11.6,77,8,69,11.6
36440, 영광군,100001, 95세,2021,15,X,14,7.1,15,X,14,7.1
36440, 영광군,100002, 96세,2021,16,X,15,6.7,16,X,15,6.7
36440, 영광군,100003, 97세,2021,11,X,8,37.5,11,X,8,37.5
36440, 영광군,100004, 98세,2021,23,X,20,15,23,X,20,15
36440, 영광군,100005, 99세,2021,12,X,12,0,12,X,12,0
36440, 영광군,101,100세이상,2021,15,X,15,0,15,X,15,0
36440, 영광군,102,15세미만,2021,5489,2768,2721,101.7,5475,2764,2711,102
36440, 영광군,103,15~64세,2021,28844,15680,13164,119.1,27666,14998,12668,118.4
36440, 영광군,104,65세이상,2021,14648,5992,8656,69.2,14610,5973,8637,69.2
36440, 영광군,086,85세이상,2021,1754,464,1290,36,1753,463,1290,35.9
36440, 영광군,126,평균연령,2021,49.7,47.4,51.9,,50,47.7,52.2,
36440, 영광군,127,중위연령,2021,53.3,50.8,56.2,,53.9,51.5,56.7,
36450, 장성군,000,합계,2021,40604,20446,20158,101.4,39307,19691,19616,100.4
36450, 장성군,005,0~4세,2021,1011,521,490,106.3,1008,520,488,106.6
36450, 장성군,005001, 0세,2021,155,70,85,82.4,154,70,84,83.3
36450, 장성군,005002, 1세,2021,193,110,83,132.5,192,109,83,131.3
36450, 장성군,005003, 2세,2021,202,113,89,127,201,113,88,128.4
36450, 장성군,005004, 3세,2021,225,109,116,94,225,109,116,94
36450, 장성군,005005, 4세,2021,236,119,117,101.7,236,119,117,101.7
36450, 장성군,010,5~9세,2021,1427,696,731,95.2,1424,694,730,95.1
36450, 장성군,010001, 5세,2021,261,127,134,94.8,260,127,133,95.5
36450, 장성군,010002, 6세,2021,282,134,148,90.5,281,133,148,89.9
36450, 장성군,010003, 7세,2021,295,153,142,107.7,294,152,142,107
36450, 장성군,010004, 8세,2021,288,146,142,102.8,288,146,142,102.8
36450, 장성군,010005, 9세,2021,301,136,165,82.4,301,136,165,82.4
36450, 장성군,015,10~14세,2021,1500,802,698,114.9,1497,799,698,114.5
36450, 장성군,015001, 10세,2021,326,167,159,105,326,167,159,105
36450, 장성군,015002, 11세,2021,298,171,127,134.6,296,169,127,133.1
36450, 장성군,015003, 12세,2021,270,134,136,98.5,270,134,136,98.5
36450, 장성군,015004, 13세,2021,295,163,132,123.5,294,162,132,122.7
36450, 장성군,015005, 14세,2021,311,167,144,116,311,167,144,116
36450, 장성군,020,15~19세,2021,1584,873,711,122.8,1580,870,710,122.5
36450, 장성군,020001, 15세,2021,270,144,126,114.3,270,144,126,114.3
36450, 장성군,020002, 16세,2021,299,154,145,106.2,299,154,145,106.2
36450, 장성군,020003, 17세,2021,414,234,180,130,413,234,179,130.7
36450, 장성군,020004, 18세,2021,360,188,172,109.3,359,187,172,108.7
36450, 장성군,020005, 19세,2021,241,153,88,173.9,239,151,88,171.6
36450, 장성군,025,20~24세,2021,1544,962,582,165.3,1435,893,542,164.8
36450, 장성군,025001, 20세,2021,268,183,85,215.3,261,177,84,210.7
36450, 장성군,025002, 21세,2021,295,198,97,204.1,284,193,91,212.1
36450, 장성군,025003, 22세,2021,317,187,130,143.8,294,171,123,139
36450, 장성군,025004, 23세,2021,315,191,124,154,284,171,113,151.3
36450, 장성군,025005, 24세,2021,349,203,146,139,312,181,131,138.2
36450, 장성군,030,25~29세,2021,2063,1252,811,154.4,1770,1049,721,145.5
36450, 장성군,030001, 25세,2021,374,226,148,152.7,333,192,141,136.2
36450, 장성군,030002, 26세,2021,435,265,170,155.9,370,226,144,156.9
36450, 장성군,030003, 27세,2021,438,265,173,153.2,377,223,154,144.8
36450, 장성군,030004, 28세,2021,439,272,167,162.9,389,234,155,151
36450, 장성군,030005, 29세,2021,377,224,153,146.4,301,174,127,137
36450, 장성군,035,30~34세,2021,1678,919,759,121.1,1403,752,651,115.5
36450, 장성군,035001, 30세,2021,389,215,174,123.6,322,173,149,116.1
36450, 장성군,035002, 31세,2021,343,197,146,134.9,288,163,125,130.4
36450, 장성군,035003, 32세,2021,333,164,169,97,276,130,146,89
36450, 장성군,035004, 33세,2021,319,179,140,127.9,273,152,121,125.6
36450, 장성군,035005, 34세,2021,294,164,130,126.2,244,134,110,121.8
36450, 장성군,040,35~39세,2021,1921,1036,885,117.1,1706,918,788,116.5
36450, 장성군,040001, 35세,2021,361,182,179,101.7,320,160,160,100
36450, 장성군,040002, 36세,2021,308,173,135,128.1,267,150,117,128.2
36450, 장성군,040003, 37세,2021,364,197,167,118,318,178,140,127.1
36450, 장성군,040004, 38세,2021,409,225,184,122.3,361,195,166,117.5
36450, 장성군,040005, 39세,2021,479,259,220,117.7,440,235,205,114.6
36450, 장성군,045,40~44세,2021,2198,1188,1010,117.6,2082,1125,957,117.6
36450, 장성군,045001, 40세,2021,409,228,181,126,380,213,167,127.5
36450, 장성군,045002, 41세,2021,458,231,227,101.8,434,218,216,100.9
36450, 장성군,045003, 42세,2021,407,221,186,118.8,390,208,182,114.3
36450, 장성군,045004, 43세,2021,451,248,203,122.2,429,239,190,125.8
36450, 장성군,045005, 44세,2021,473,260,213,122.1,449,247,202,122.3
36450, 장성군,050,45~49세,2021,2628,1442,1186,121.6,2531,1395,1136,122.8
36450, 장성군,050001, 45세,2021,466,268,198,135.4,445,259,186,139.2
36450, 장성군,050002, 46세,2021,491,268,223,120.2,477,258,219,117.8
36450, 장성군,050003, 47세,2021,540,292,248,117.7,517,278,239,116.3
36450, 장성군,050004, 48세,2021,566,312,254,122.8,543,303,240,126.3
36450, 장성군,050005, 49세,2021,565,302,263,114.8,549,297,252,117.9
36450, 장성군,055,50~54세,2021,3213,1786,1427,125.2,3149,1754,1395,125.7
36450, 장성군,055001, 50세,2021,662,380,282,134.8,651,373,278,134.2
36450, 장성군,055002, 51세,2021,634,354,280,126.4,620,346,274,126.3
36450, 장성군,055003, 52세,2021,627,350,277,126.4,609,342,267,128.1
36450, 장성군,055004, 53세,2021,678,368,310,118.7,666,362,304,119.1
36450, 장성군,055005, 54세,2021,612,334,278,120.1,603,331,272,121.7
36450, 장성군,060,55~59세,2021,3483,1862,1621,114.9,3433,1848,1585,116.6
36450, 장성군,060001, 55세,2021,710,400,310,129,702,397,305,130.2
36450, 장성군,060002, 56세,2021,683,371,312,118.9,671,368,303,121.5
36450, 장성군,060003, 57세,2021,662,344,318,108.2,648,341,307,111.1
36450, 장성군,060004, 58세,2021,749,393,356,110.4,740,390,350,111.4
36450, 장성군,060005, 59세,2021,679,354,325,108.9,672,352,320,110
36450, 장성군,065,60~64세,2021,3836,1993,1843,108.1,3795,1972,1823,108.2
36450, 장성군,065001, 60세,2021,807,420,387,108.5,795,414,381,108.7
36450, 장성군,065002, 61세,2021,897,482,415,116.1,891,479,412,116.3
36450, 장성군,065003, 62세,2021,722,360,362,99.4,712,357,355,100.6
36450, 장성군,065004, 63세,2021,673,338,335,100.9,667,334,333,100.3
36450, 장성군,065005, 64세,2021,737,393,344,114.2,730,388,342,113.5
36450, 장성군,070,65~69세,2021,3010,1482,1528,97,2994,1475,1519,97.1
36450, 장성군,070001, 65세,2021,616,319,297,107.4,612,317,295,107.5
36450, 장성군,070002, 66세,2021,743,367,376,97.6,738,365,373,97.9
36450, 장성군,070003, 67세,2021,503,247,256,96.5,501,246,255,96.5
36450, 장성군,070004, 68세,2021,539,261,278,93.9,535,260,275,94.5
36450, 장성군,070005, 69세,2021,609,288,321,89.7,608,287,321,89.4
36450, 장성군,075,70~74세,2021,2815,1284,1531,83.9,2811,1282,1529,83.8
36450, 장성군,075001, 70세,2021,499,236,263,89.7,499,236,263,89.7
36450, 장성군,075002, 71세,2021,564,248,316,78.5,563,247,316,78.2
36450, 장성군,075003, 72세,2021,588,280,308,90.9,586,279,307,90.9
36450, 장성군,075004, 73세,2021,588,257,331,77.6,588,257,331,77.6
36450, 장성군,075005, 74세,2021,576,263,313,84,575,263,312,84.3
36450, 장성군,080,75~79세,2021,2559,1036,1523,68,2557,1035,1522,68
36450, 장성군,080001, 75세,2021,467,207,260,79.6,466,206,260,79.2
36450, 장성군,080002, 76세,2021,423,181,242,74.8,422,181,241,75.1
36450, 장성군,080003, 77세,2021,450,181,269,67.3,450,181,269,67.3
36450, 장성군,080004, 78세,2021,528,199,329,60.5,528,199,329,60.5
36450, 장성군,080005, 79세,2021,691,268,423,63.4,691,268,423,63.4
36450, 장성군,085,80~84세,2021,2362,826,1536,53.8,2360,824,1536,53.6
36450, 장성군,085001, 80세,2021,561,225,336,67,561,225,336,67
36450, 장성군,085002, 81세,2021,494,163,331,49.2,494,163,331,49.2
36450, 장성군,085003, 82세,2021,471,162,309,52.4,471,162,309,52.4
36450, 장성군,085004, 83세,2021,446,144,302,47.7,445,143,302,47.4
36450, 장성군,085005, 84세,2021,390,132,258,51.2,389,131,258,50.8
36450, 장성군,090,85~89세,2021,1275,380,895,42.5,1275,380,895,42.5
36450, 장성군,090001, 85세,2021,350,117,233,50.2,350,117,233,50.2
36450, 장성군,090002, 86세,2021,339,92,247,37.2,339,92,247,37.2
36450, 장성군,090003, 87세,2021,256,74,182,40.7,256,74,182,40.7
36450, 장성군,090004, 88세,2021,193,58,135,43,193,58,135,43
36450, 장성군,090005, 89세,2021,137,39,98,39.8,137,39,98,39.8
36450, 장성군,095,90~94세,2021,393,83,310,26.8,393,83,310,26.8
36450, 장성군,095001, 90세,2021,113,24,89,27,113,24,89,27
36450, 장성군,095002, 91세,2021,106,23,83,27.7,106,23,83,27.7
36450, 장성군,095003, 92세,2021,69,14,55,25.5,69,14,55,25.5
36450, 장성군,095004, 93세,2021,63,14,49,28.6,63,14,49,28.6
36450, 장성군,095005, 94세,2021,42,8,34,23.5,42,8,34,23.5
36450, 장성군,100,95~99세,2021,92,21,71,29.6,92,21,71,29.6
36450, 장성군,100001, 95세,2021,27,8,19,42.1,27,8,19,42.1
36450, 장성군,100002, 96세,2021,22,X,18,22.2,22,X,18,22.2
36450, 장성군,100003, 97세,2021,19,6,13,46.2,19,6,13,46.2
36450, 장성군,100004, 98세,2021,14,X,11,27.3,14,X,11,27.3
36450, 장성군,100005, 99세,2021,10,X,10,0,10,X,10,0
36450, 장성군,101,100세이상,2021,12,X,10,20,12,X,10,20
36450, 장성군,102,15세미만,2021,3938,2019,1919,105.2,3929,2013,1916,105.1
36450, 장성군,103,15~64세,2021,24148,13313,10835,122.9,22884,12576,10308,122
36450, 장성군,104,65세이상,2021,12518,5114,7404,69.1,12494,5102,7392,69
36450, 장성군,086,85세이상,2021,1772,486,1286,37.8,1772,486,1286,37.8
36450, 장성군,126,평균연령,2021,50.8,48.2,53.5,,51.3,48.7,53.9,
36450, 장성군,127,중위연령,2021,54.2,51.4,57.5,,55.1,52.3,58.2,
36460, 완도군,000,합계,2021,47210,24724,22486,110,44449,22463,21986,102.2
36460, 완도군,005,0~4세,2021,1259,637,622,102.4,1257,636,621,102.4
36460, 완도군,005001, 0세,2021,205,102,103,99,204,101,103,98.1
36460, 완도군,005002, 1세,2021,233,119,114,104.4,233,119,114,104.4
36460, 완도군,005003, 2세,2021,275,135,140,96.4,275,135,140,96.4
36460, 완도군,005004, 3세,2021,267,132,135,97.8,267,132,135,97.8
36460, 완도군,005005, 4세,2021,279,149,130,114.6,278,149,129,115.5
36460, 완도군,010,5~9세,2021,1660,857,803,106.7,1659,857,802,106.9
36460, 완도군,010001, 5세,2021,319,169,150,112.7,319,169,150,112.7
36460, 완도군,010002, 6세,2021,293,157,136,115.4,293,157,136,115.4
36460, 완도군,010003, 7세,2021,364,187,177,105.6,364,187,177,105.6
36460, 완도군,010004, 8세,2021,311,159,152,104.6,311,159,152,104.6
36460, 완도군,010005, 9세,2021,373,185,188,98.4,372,185,187,98.9
36460, 완도군,015,10~14세,2021,1632,851,781,109,1631,851,780,109.1
36460, 완도군,015001, 10세,2021,344,189,155,121.9,344,189,155,121.9
36460, 완도군,015002, 11세,2021,357,184,173,106.4,357,184,173,106.4
36460, 완도군,015003, 12세,2021,293,147,146,100.7,293,147,146,100.7
36460, 완도군,015004, 13세,2021,297,162,135,120,297,162,135,120
36460, 완도군,015005, 14세,2021,341,169,172,98.3,340,169,171,98.8
36460, 완도군,020,15~19세,2021,1370,749,621,120.6,1365,747,618,120.9
36460, 완도군,020001, 15세,2021,337,176,161,109.3,337,176,161,109.3
36460, 완도군,020002, 16세,2021,285,149,136,109.6,285,149,136,109.6
36460, 완도군,020003, 17세,2021,325,178,147,121.1,322,177,145,122.1
36460, 완도군,020004, 18세,2021,276,156,120,130,274,155,119,130.3
36460, 완도군,020005, 19세,2021,147,90,57,157.9,147,90,57,157.9
36460, 완도군,025,20~24세,2021,1448,977,471,207.4,1244,817,427,191.3
36460, 완도군,025001, 20세,2021,256,179,77,232.5,250,176,74,237.8
36460, 완도군,025002, 21세,2021,293,221,72,306.9,280,215,65,330.8
36460, 완도군,025003, 22세,2021,238,165,73,226,215,150,65,230.8
36460, 완도군,025004, 23세,2021,296,179,117,153,236,131,105,124.8
36460, 완도군,025005, 24세,2021,365,233,132,176.5,263,145,118,122.9
36460, 완도군,030,25~29세,2021,2278,1564,714,219,1466,852,614,138.8
36460, 완도군,030001, 25세,2021,420,265,155,171,303,164,139,118
36460, 완도군,030002, 26세,2021,462,320,142,225.4,310,180,130,138.5
36460, 완도군,030003, 27세,2021,486,346,140,247.1,301,181,120,150.8
36460, 완도군,030004, 28세,2021,441,316,125,252.8,282,175,107,163.6
36460, 완도군,030005, 29세,2021,469,317,152,208.6,270,152,118,128.8
36460, 완도군,035,30~34세,2021,2076,1377,699,197,1352,740,612,120.9
36460, 완도군,035001, 30세,2021,426,289,137,210.9,249,138,111,124.3
36460, 완도군,035002, 31세,2021,421,292,129,226.4,266,153,113,135.4
36460, 완도군,035003, 32세,2021,422,289,133,217.3,264,147,117,125.6
36460, 완도군,035004, 33세,2021,388,239,149,160.4,273,140,133,105.3
36460, 완도군,035005, 34세,2021,419,268,151,177.5,300,162,138,117.4
36460, 완도군,040,35~39세,2021,2437,1441,996,144.7,2001,1072,929,115.4
36460, 완도군,040001, 35세,2021,430,260,170,152.9,306,150,156,96.2
36460, 완도군,040002, 36세,2021,456,256,200,128,367,187,180,103.9
36460, 완도군,040003, 37세,2021,455,273,182,150,371,200,171,117
36460, 완도군,040004, 38세,2021,543,326,217,150.2,469,258,211,122.3
36460, 완도군,040005, 39세,2021,553,326,227,143.6,488,277,211,131.3
36460, 완도군,045,40~44세,2021,2869,1708,1161,147.1,2634,1517,1117,135.8
36460, 완도군,045001, 40세,2021,536,332,204,162.7,474,278,196,141.8
36460, 완도군,045002, 41세,2021,649,382,267,143.1,583,326,257,126.8
36460, 완도군,045003, 42세,2021,590,324,266,121.8,545,292,253,115.4
36460, 완도군,045004, 43세,2021,529,318,211,150.7,500,295,205,143.9
36460, 완도군,045005, 44세,2021,565,352,213,165.3,532,326,206,158.3
36460, 완도군,050,45~49세,2021,3000,1759,1241,141.7,2874,1674,1200,139.5
36460, 완도군,050001, 45세,2021,530,325,205,158.5,490,298,192,155.2
36460, 완도군,050002, 46세,2021,554,332,222,149.5,527,311,216,144
36460, 완도군,050003, 47세,2021,618,364,254,143.3,590,344,246,139.8
36460, 완도군,050004, 48세,2021,620,350,270,129.6,605,342,263,130
36460, 완도군,050005, 49세,2021,678,388,290,133.8,662,379,283,133.9
36460, 완도군,055,50~54세,2021,3557,2053,1504,136.5,3469,2010,1459,137.8
36460, 완도군,055001, 50세,2021,704,416,288,144.4,684,406,278,146
36460, 완도군,055002, 51세,2021,696,397,299,132.8,676,388,288,134.7
36460, 완도군,055003, 52세,2021,701,408,293,139.2,684,403,281,143.4
36460, 완도군,055004, 53세,2021,748,449,299,150.2,731,442,289,152.9
36460, 완도군,055005, 54세,2021,708,383,325,117.8,694,371,323,114.9
36460, 완도군,060,55~59세,2021,3883,2078,1805,115.1,3814,2044,1770,115.5
36460, 완도군,060001, 55세,2021,751,449,302,148.7,738,442,296,149.3
36460, 완도군,060002, 56세,2021,701,375,326,115,685,368,317,116.1
36460, 완도군,060003, 57세,2021,728,377,351,107.4,714,372,342,108.8
36460, 완도군,060004, 58세,2021,820,431,389,110.8,806,423,383,110.4
36460, 완도군,060005, 59세,2021,883,446,437,102.1,871,439,432,101.6
36460, 완도군,065,60~64세,2021,4547,2220,2327,95.4,4516,2205,2311,95.4
36460, 완도군,065001, 60세,2021,906,450,456,98.7,903,450,453,99.3
36460, 완도군,065002, 61세,2021,1072,509,563,90.4,1065,504,561,89.8
36460, 완도군,065003, 62세,2021,915,444,471,94.3,905,441,464,95
36460, 완도군,065004, 63세,2021,811,401,410,97.8,806,396,410,96.6
36460, 완도군,065005, 64세,2021,843,416,427,97.4,837,414,423,97.9
36460, 완도군,070,65~69세,2021,3693,1844,1849,99.7,3680,1838,1842,99.8
36460, 완도군,070001, 65세,2021,836,445,391,113.8,832,441,391,112.8
36460, 완도군,070002, 66세,2021,883,434,449,96.7,881,433,448,96.7
36460, 완도군,070003, 67세,2021,659,324,335,96.7,657,324,333,97.3
36460, 완도군,070004, 68세,2021,568,281,287,97.9,567,281,286,98.3
36460, 완도군,070005, 69세,2021,747,360,387,93,743,359,384,93.5
36460, 완도군,075,70~74세,2021,3652,1734,1918,90.4,3643,1731,1912,90.5
36460, 완도군,075001, 70세,2021,741,364,377,96.6,738,363,375,96.8
36460, 완도군,075002, 71세,2021,715,326,389,83.8,711,325,386,84.2
36460, 완도군,075003, 72세,2021,722,360,362,99.4,721,359,362,99.2
36460, 완도군,075004, 73세,2021,699,328,371,88.4,699,328,371,88.4
36460, 완도군,075005, 74세,2021,775,356,419,85,774,356,418,85.2
36460, 완도군,080,75~79세,2021,3284,1415,1869,75.7,3282,1414,1868,75.7
36460, 완도군,080001, 75세,2021,565,268,297,90.2,564,268,296,90.5
36460, 완도군,080002, 76세,2021,690,297,393,75.6,690,297,393,75.6
36460, 완도군,080003, 77세,2021,630,276,354,78,630,276,354,78
36460, 완도군,080004, 78세,2021,609,233,376,62,608,232,376,61.7
36460, 완도군,080005, 79세,2021,790,341,449,75.9,790,341,449,75.9
36460, 완도군,085,80~84세,2021,2751,993,1758,56.5,2748,991,1757,56.4
36460, 완도군,085001, 80세,2021,645,245,400,61.3,645,245,400,61.3
36460, 완도군,085002, 81세,2021,637,229,408,56.1,636,228,408,55.9
36460, 완도군,085003, 82세,2021,559,212,347,61.1,559,212,347,61.1
36460, 완도군,085004, 83세,2021,492,173,319,54.2,491,172,319,53.9
36460, 완도군,085005, 84세,2021,418,134,284,47.2,417,134,283,47.3
36460, 완도군,090,85~89세,2021,1288,354,934,37.9,1288,354,934,37.9
36460, 완도군,090001, 85세,2021,355,114,241,47.3,355,114,241,47.3
36460, 완도군,090002, 86세,2021,271,74,197,37.6,271,74,197,37.6
36460, 완도군,090003, 87세,2021,259,66,193,34.2,259,66,193,34.2
36460, 완도군,090004, 88세,2021,213,49,164,29.9,213,49,164,29.9
36460, 완도군,090005, 89세,2021,190,51,139,36.7,190,51,139,36.7
36460, 완도군,095,90~94세,2021,424,97,327,29.7,424,97,327,29.7
36460, 완도군,095001, 90세,2021,135,34,101,33.7,135,34,101,33.7
36460, 완도군,095002, 91세,2021,125,27,98,27.6,125,27,98,27.6
36460, 완도군,095003, 92세,2021,82,21,61,34.4,82,21,61,34.4
36460, 완도군,095004, 93세,2021,48,11,37,29.7,48,11,37,29.7
36460, 완도군,095005, 94세,2021,34,X,30,13.3,34,X,30,13.3
36460, 완도군,100,95~99세,2021,89,15,74,20.3,89,15,74,20.3
36460, 완도군,100001, 95세,2021,30,7,23,30.4,30,7,23,30.4
36460, 완도군,100002, 96세,2021,16,X,15,6.7,16,X,15,6.7
36460, 완도군,100003, 97세,2021,18,X,14,28.6,18,X,14,28.6
36460, 완도군,100004, 98세,2021,16,X,15,6.7,16,X,15,6.7
36460, 완도군,100005, 99세,2021,9,X,7,28.6,9,X,7,28.6
36460, 완도군,101,100세이상,2021,13,X,12,8.3,13,X,12,8.3
36460, 완도군,102,15세미만,2021,4551,2345,2206,106.3,4547,2344,2203,106.4
36460, 완도군,103,15~64세,2021,27465,15926,11539,138,24735,13678,11057,123.7
36460, 완도군,104,65세이상,2021,15194,6453,8741,73.8,15167,6441,8726,73.8
36460, 완도군,086,85세이상,2021,1814,467,1347,34.7,1814,467,1347,34.7
36460, 완도군,126,평균연령,2021,51.5,48.5,54.7,,52.5,50.1,55,
36460, 완도군,127,중위연령,2021,55,51.1,59.6,,56.8,53.6,60.1,
36470, 진도군,000,합계,2021,29013,14970,14043,106.6,27251,13543,13708,98.8
36470, 진도군,005,0~4세,2021,662,307,355,86.5,661,306,355,86.2
36470, 진도군,005001, 0세,2021,127,73,54,135.2,127,73,54,135.2
36470, 진도군,005002, 1세,2021,109,45,64,70.3,109,45,64,70.3
36470, 진도군,005003, 2세,2021,149,75,74,101.4,149,75,74,101.4
36470, 진도군,005004, 3세,2021,120,62,58,106.9,120,62,58,106.9
36470, 진도군,005005, 4세,2021,157,52,105,49.5,156,51,105,48.6
36470, 진도군,010,5~9세,2021,865,441,424,104,865,441,424,104
36470, 진도군,010001, 5세,2021,148,73,75,97.3,148,73,75,97.3
36470, 진도군,010002, 6세,2021,173,87,86,101.2,173,87,86,101.2
36470, 진도군,010003, 7세,2021,171,92,79,116.5,171,92,79,116.5
36470, 진도군,010004, 8세,2021,186,90,96,93.8,186,90,96,93.8
36470, 진도군,010005, 9세,2021,187,99,88,112.5,187,99,88,112.5
36470, 진도군,015,10~14세,2021,1016,507,509,99.6,1015,507,508,99.8
36470, 진도군,015001, 10세,2021,228,99,129,76.7,228,99,129,76.7
36470, 진도군,015002, 11세,2021,173,98,75,130.7,173,98,75,130.7
36470, 진도군,015003, 12세,2021,202,104,98,106.1,202,104,98,106.1
36470, 진도군,015004, 13세,2021,179,89,90,98.9,178,89,89,100
36470, 진도군,015005, 14세,2021,234,117,117,100,234,117,117,100
36470, 진도군,020,15~19세,2021,785,405,380,106.6,783,404,379,106.6
36470, 진도군,020001, 15세,2021,178,94,84,111.9,178,94,84,111.9
36470, 진도군,020002, 16세,2021,167,91,76,119.7,166,90,76,118.4
36470, 진도군,020003, 17세,2021,166,79,87,90.8,166,79,87,90.8
36470, 진도군,020004, 18세,2021,178,78,100,78,177,78,99,78.8
36470, 진도군,020005, 19세,2021,96,63,33,190.9,96,63,33,190.9
36470, 진도군,025,20~24세,2021,954,663,291,227.8,830,570,260,219.2
36470, 진도군,025001, 20세,2021,177,140,37,378.4,173,139,34,408.8
36470, 진도군,025002, 21세,2021,182,137,45,304.4,172,133,39,341
36470, 진도군,025003, 22세,2021,184,124,60,206.7,163,107,56,191.1
36470, 진도군,025004, 23세,2021,201,135,66,204.5,158,96,62,154.8
36470, 진도군,025005, 24세,2021,210,127,83,153,164,95,69,137.7
36470, 진도군,030,25~29세,2021,1523,1071,452,236.9,972,567,405,140
36470, 진도군,030001, 25세,2021,274,187,87,214.9,192,114,78,146.2
36470, 진도군,030002, 26세,2021,307,213,94,226.6,201,115,86,133.7
36470, 진도군,030003, 27세,2021,299,217,82,264.6,189,114,75,152
36470, 진도군,030004, 28세,2021,316,234,82,285.4,190,118,72,163.9
36470, 진도군,030005, 29세,2021,327,220,107,205.6,200,106,94,112.8
36470, 진도군,035,30~34세,2021,1258,798,460,173.5,822,418,404,103.5
36470, 진도군,035001, 30세,2021,277,182,95,191.6,171,88,83,106
36470, 진도군,035002, 31세,2021,278,189,89,212.4,174,95,79,120.3
36470, 진도군,035003, 32세,2021,245,160,85,188.2,156,85,71,119.7
36470, 진도군,035004, 33세,2021,211,126,85,148.2,146,67,79,84.8
36470, 진도군,035005, 34세,2021,247,141,106,133,175,83,92,90.2
36470, 진도군,040,35~39세,2021,1348,808,540,149.6,1068,584,484,120.7
36470, 진도군,040001, 35세,2021,248,147,101,145.5,174,86,88,97.7
36470, 진도군,040002, 36세,2021,235,141,94,150,175,97,78,124.4
36470, 진도군,040003, 37세,2021,287,170,117,145.3,241,133,108,123.1
36470, 진도군,040004, 38세,2021,282,173,109,158.7,229,125,104,120.2
36470, 진도군,040005, 39세,2021,296,177,119,148.7,249,143,106,134.9
36470, 진도군,045,40~44세,2021,1520,877,643,136.4,1376,772,604,127.8
36470, 진도군,045001, 40세,2021,300,177,123,143.9,260,148,112,132.1
36470, 진도군,045002, 41세,2021,336,189,147,128.6,301,163,138,118.1
36470, 진도군,045003, 42세,2021,280,157,123,127.6,251,133,118,112.7
36470, 진도군,045004, 43세,2021,278,162,116,139.7,253,144,109,132.1
36470, 진도군,045005, 44세,2021,326,192,134,143.3,311,184,127,144.9
36470, 진도군,050,45~49세,2021,1824,1051,773,136,1736,996,740,134.6
36470, 진도군,050001, 45세,2021,306,171,135,126.7,291,163,128,127.3
36470, 진도군,050002, 46세,2021,349,217,132,164.4,326,199,127,156.7
36470, 진도군,050003, 47세,2021,388,219,169,129.6,371,210,161,130.4
36470, 진도군,050004, 48세,2021,382,218,164,132.9,365,206,159,129.6
36470, 진도군,050005, 49세,2021,399,226,173,130.6,383,218,165,132.1
36470, 진도군,055,50~54세,2021,2143,1244,899,138.4,2086,1211,875,138.4
36470, 진도군,055001, 50세,2021,433,264,169,156.2,417,256,161,159
36470, 진도군,055002, 51세,2021,392,229,163,140.5,384,226,158,143
36470, 진도군,055003, 52세,2021,427,266,161,165.2,419,260,159,163.5
36470, 진도군,055004, 53세,2021,467,258,209,123.4,453,248,205,121
36470, 진도군,055005, 54세,2021,424,227,197,115.2,413,221,192,115.1
36470, 진도군,060,55~59세,2021,2473,1341,1132,118.5,2438,1327,1111,119.4
36470, 진도군,060001, 55세,2021,542,310,232,133.6,535,306,229,133.6
36470, 진도군,060002, 56세,2021,456,248,208,119.2,450,247,203,121.7
36470, 진도군,060003, 57세,2021,492,262,230,113.9,485,259,226,114.6
36470, 진도군,060004, 58세,2021,471,245,226,108.4,461,243,218,111.5
36470, 진도군,060005, 59세,2021,512,276,236,116.9,507,272,235,115.7
36470, 진도군,065,60~64세,2021,2939,1492,1447,103.1,2917,1484,1433,103.6
36470, 진도군,065001, 60세,2021,605,304,301,101,601,301,300,100.3
36470, 진도군,065002, 61세,2021,662,322,340,94.7,659,321,338,95
36470, 진도군,065003, 62세,2021,538,269,269,100,534,267,267,100
36470, 진도군,065004, 63세,2021,570,295,275,107.3,564,294,270,108.9
36470, 진도군,065005, 64세,2021,564,302,262,115.3,559,301,258,116.7
36470, 진도군,070,65~69세,2021,2276,1143,1133,100.9,2262,1137,1125,101.1
36470, 진도군,070001, 65세,2021,539,286,253,113,538,286,252,113.5
36470, 진도군,070002, 66세,2021,507,264,243,108.6,503,263,240,109.6
36470, 진도군,070003, 67세,2021,386,193,193,100,385,193,192,100.5
36470, 진도군,070004, 68세,2021,389,177,212,83.5,383,173,210,82.4
36470, 진도군,070005, 69세,2021,455,223,232,96.1,453,222,231,96.1
36470, 진도군,075,70~74세,2021,2215,1072,1143,93.8,2210,1069,1141,93.7
36470, 진도군,075001, 70세,2021,403,192,211,91,401,190,211,90
36470, 진도군,075002, 71세,2021,472,236,236,100,472,236,236,100
36470, 진도군,075003, 72세,2021,435,229,206,111.2,433,228,205,111.2
36470, 진도군,075004, 73세,2021,443,193,250,77.2,442,193,249,77.5
36470, 진도군,075005, 74세,2021,462,222,240,92.5,462,222,240,92.5
36470, 진도군,080,75~79세,2021,2107,818,1289,63.5,2105,818,1287,63.6
36470, 진도군,080001, 75세,2021,351,161,190,84.7,351,161,190,84.7
36470, 진도군,080002, 76세,2021,456,185,271,68.3,455,185,270,68.5
36470, 진도군,080003, 77세,2021,368,161,207,77.8,368,161,207,77.8
36470, 진도군,080004, 78세,2021,386,134,252,53.2,385,134,251,53.4
36470, 진도군,080005, 79세,2021,546,177,369,48,546,177,369,48
36470, 진도군,085,80~84세,2021,1894,642,1252,51.3,1894,642,1252,51.3
36470, 진도군,085001, 80세,2021,465,155,310,50,465,155,310,50
36470, 진도군,085002, 81세,2021,431,174,257,67.7,431,174,257,67.7
36470, 진도군,085003, 82세,2021,377,143,234,61.1,377,143,234,61.1
36470, 진도군,085004, 83세,2021,359,92,267,34.5,359,92,267,34.5
36470, 진도군,085005, 84세,2021,262,78,184,42.4,262,78,184,42.4
36470, 진도군,090,85~89세,2021,890,229,661,34.6,890,229,661,34.6
36470, 진도군,090001, 85세,2021,242,75,167,44.9,242,75,167,44.9
36470, 진도군,090002, 86세,2021,211,66,145,45.5,211,66,145,45.5
36470, 진도군,090003, 87세,2021,173,39,134,29.1,173,39,134,29.1
36470, 진도군,090004, 88세,2021,140,23,117,19.7,140,23,117,19.7
36470, 진도군,090005, 89세,2021,124,26,98,26.5,124,26,98,26.5
36470, 진도군,095,90~94세,2021,272,53,219,24.2,272,53,219,24.2
36470, 진도군,095001, 90세,2021,87,21,66,31.8,87,21,66,31.8
36470, 진도군,095002, 91세,2021,81,10,71,14.1,81,10,71,14.1
36470, 진도군,095003, 92세,2021,50,12,38,31.6,50,12,38,31.6
36470, 진도군,095004, 93세,2021,30,7,23,30.4,30,7,23,30.4
36470, 진도군,095005, 94세,2021,24,X,21,14.3,24,X,21,14.3
36470, 진도군,100,95~99세,2021,44,8,36,22.2,44,8,36,22.2
36470, 진도군,100001, 95세,2021,9,X,7,28.6,9,X,7,28.6
36470, 진도군,100002, 96세,2021,14,X,13,7.7,14,X,13,7.7
36470, 진도군,100003, 97세,2021,X,X,X,33.3,X,X,X,33.3
36470, 진도군,100004, 98세,2021,11,X,9,22.2,11,X,9,22.2
36470, 진도군,100005, 99세,2021,6,X,X,50,6,X,X,50
36470, 진도군,101,100세이상,2021,5,X,5,0,5,X,5,0
36470, 진도군,102,15세미만,2021,2543,1255,1288,97.4,2541,1254,1287,97.4
36470, 진도군,103,15~64세,2021,16767,9750,7017,138.9,15028,8333,6695,124.5
36470, 진도군,104,65세이상,2021,9703,3965,5738,69.1,9682,3956,5726,69.1
36470, 진도군,086,85세이상,2021,1211,290,921,31.5,1211,290,921,31.5
36470, 진도군,126,평균연령,2021,52.4,49.2,55.7,,53.5,50.9,56.1,
36470, 진도군,127,중위연령,2021,56.1,52.2,60.5,,57.9,55,61,
36480, 신안군,000,합계,2021,34000,18099,15901,113.8,33019,17433,15586,111.9
36480, 신안군,005,0~4세,2021,622,316,306,103.3,620,314,306,102.6
36480, 신안군,005001, 0세,2021,131,67,64,104.7,130,66,64,103.1
36480, 신안군,005002, 1세,2021,121,55,66,83.3,121,55,66,83.3
36480, 신안군,005003, 2세,2021,118,56,62,90.3,118,56,62,90.3
36480, 신안군,005004, 3세,2021,132,72,60,120,131,71,60,118.3
36480, 신안군,005005, 4세,2021,120,66,54,122.2,120,66,54,122.2
36480, 신안군,010,5~9세,2021,773,408,365,111.8,772,407,365,111.5
36480, 신안군,010001, 5세,2021,143,81,62,130.6,143,81,62,130.6
36480, 신안군,010002, 6세,2021,138,81,57,142.1,137,80,57,140.4
36480, 신안군,010003, 7세,2021,146,71,75,94.7,146,71,75,94.7
36480, 신안군,010004, 8세,2021,171,90,81,111.1,171,90,81,111.1
36480, 신안군,010005, 9세,2021,175,85,90,94.4,175,85,90,94.4
36480, 신안군,015,10~14세,2021,841,412,429,96,841,412,429,96
36480, 신안군,015001, 10세,2021,213,114,99,115.2,213,114,99,115.2
36480, 신안군,015002, 11세,2021,150,74,76,97.4,150,74,76,97.4
36480, 신안군,015003, 12세,2021,152,67,85,78.8,152,67,85,78.8
36480, 신안군,015004, 13세,2021,168,77,91,84.6,168,77,91,84.6
36480, 신안군,015005, 14세,2021,158,80,78,102.6,158,80,78,102.6
36480, 신안군,020,15~19세,2021,740,393,347,113.3,738,393,345,113.9
36480, 신안군,020001, 15세,2021,149,68,81,84,149,68,81,84
36480, 신안군,020002, 16세,2021,165,89,76,117.1,165,89,76,117.1
36480, 신안군,020003, 17세,2021,179,91,88,103.4,177,91,86,105.8
36480, 신안군,020004, 18세,2021,171,92,79,116.5,171,92,79,116.5
36480, 신안군,020005, 19세,2021,76,53,23,230.4,76,53,23,230.4
36480, 신안군,025,20~24세,2021,776,528,248,212.9,692,467,225,207.6
36480, 신안군,025001, 20세,2021,113,87,26,334.6,110,86,24,358.3
36480, 신안군,025002, 21세,2021,162,130,32,406.3,156,127,29,437.9
36480, 신안군,025003, 22세,2021,150,98,52,188.5,136,91,45,202.2
36480, 신안군,025004, 23세,2021,180,110,70,157.1,152,87,65,133.8
36480, 신안군,025005, 24세,2021,171,103,68,151.5,138,76,62,122.6
36480, 신안군,030,25~29세,2021,1224,798,426,187.3,997,618,379,163.1
36480, 신안군,030001, 25세,2021,249,162,87,186.2,218,138,80,172.5
36480, 신안군,030002, 26세,2021,235,151,84,179.8,195,122,73,167.1
36480, 신안군,030003, 27세,2021,276,194,82,236.6,213,141,72,195.8
36480, 신안군,030004, 28세,2021,228,148,80,185,177,110,67,164.2
36480, 신안군,030005, 29세,2021,236,143,93,153.8,194,107,87,123
36480, 신안군,035,30~34세,2021,1203,769,434,177.2,963,591,372,158.9
36480, 신안군,035001, 30세,2021,229,148,81,182.7,176,103,73,141.1
36480, 신안군,035002, 31세,2021,233,157,76,206.6,192,127,65,195.4
36480, 신안군,035003, 32세,2021,240,151,89,169.7,190,120,70,171.4
36480, 신안군,035004, 33세,2021,242,156,86,181.4,188,116,72,161.1
36480, 신안군,035005, 34세,2021,259,157,102,153.9,217,125,92,135.9
36480, 신안군,040,35~39세,2021,1339,870,469,185.5,1176,757,419,180.7
36480, 신안군,040001, 35세,2021,217,143,74,193.2,177,117,60,195
36480, 신안군,040002, 36세,2021,249,154,95,162.1,212,131,81,161.7
36480, 신안군,040003, 37세,2021,260,165,95,173.7,230,143,87,164.4
36480, 신안군,040004, 38세,2021,283,183,100,183,258,164,94,174.5
36480, 신안군,040005, 39세,2021,330,225,105,214.3,299,202,97,208.2
36480, 신안군,045,40~44세,2021,1638,1059,579,182.9,1532,996,536,185.8
36480, 신안군,045001, 40세,2021,295,186,109,170.6,267,166,101,164.4
36480, 신안군,045002, 41세,2021,337,208,129,161.2,313,194,119,163
36480, 신안군,045003, 42세,2021,336,213,123,173.2,317,202,115,175.7
36480, 신안군,045004, 43세,2021,335,225,110,204.5,311,214,97,220.6
36480, 신안군,045005, 44세,2021,335,227,108,210.2,324,220,104,211.5
36480, 신안군,050,45~49세,2021,1967,1274,693,183.8,1912,1250,662,188.8
36480, 신안군,050001, 45세,2021,335,234,101,231.7,320,228,92,247.8
36480, 신안군,050002, 46세,2021,357,235,122,192.6,347,232,115,201.7
36480, 신안군,050003, 47세,2021,378,248,130,190.8,369,243,126,192.9
36480, 신안군,050004, 48세,2021,447,274,173,158.4,437,270,167,161.7
36480, 신안군,050005, 49세,2021,450,283,167,169.5,439,277,162,171
36480, 신안군,055,50~54세,2021,2601,1615,986,163.8,2562,1603,959,167.2
36480, 신안군,055001, 50세,2021,493,324,169,191.7,483,322,161,200
36480, 신안군,055002, 51세,2021,499,316,183,172.7,490,314,176,178.4
36480, 신안군,055003, 52세,2021,539,344,195,176.4,533,340,193,176.2
36480, 신안군,055004, 53세,2021,540,323,217,148.8,534,320,214,149.5
36480, 신안군,055005, 54세,2021,530,308,222,138.7,522,307,215,142.8
36480, 신안군,060,55~59세,2021,3303,1913,1390,137.6,3275,1900,1375,138.2
36480, 신안군,060001, 55세,2021,651,394,257,153.3,644,391,253,154.5
36480, 신안군,060002, 56세,2021,638,361,277,130.3,633,359,274,131
36480, 신안군,060003, 57세,2021,634,368,266,138.3,629,364,265,137.4
36480, 신안군,060004, 58세,2021,715,428,287,149.1,707,426,281,151.6
36480, 신안군,060005, 59세,2021,665,362,303,119.5,662,360,302,119.2
36480, 신안군,065,60~64세,2021,3885,2146,1739,123.4,3864,2134,1730,123.4
36480, 신안군,065001, 60세,2021,790,436,354,123.2,785,433,352,123
36480, 신안군,065002, 61세,2021,860,460,400,115,856,459,397,115.6
36480, 신안군,065003, 62세,2021,765,443,322,137.6,761,440,321,137.1
36480, 신안군,065004, 63세,2021,738,412,326,126.4,734,409,325,125.8
36480, 신안군,065005, 64세,2021,732,395,337,117.2,728,393,335,117.3
36480, 신안군,070,65~69세,2021,3182,1661,1521,109.2,3173,1655,1518,109
36480, 신안군,070001, 65세,2021,656,347,309,112.3,654,346,308,112.3
36480, 신안군,070002, 66세,2021,746,420,326,128.8,744,418,326,128.2
36480, 신안군,070003, 67세,2021,566,297,269,110.4,564,296,268,110.4
36480, 신안군,070004, 68세,2021,542,281,261,107.7,542,281,261,107.7
36480, 신안군,070005, 69세,2021,672,316,356,88.8,669,314,355,88.5
36480, 신안군,075,70~74세,2021,2952,1493,1459,102.3,2951,1492,1459,102.3
36480, 신안군,075001, 70세,2021,569,305,264,115.5,569,305,264,115.5
36480, 신안군,075002, 71세,2021,546,277,269,103,546,277,269,103
36480, 신안군,075003, 72세,2021,590,291,299,97.3,589,290,299,97
36480, 신안군,075004, 73세,2021,576,289,287,100.7,576,289,287,100.7
36480, 신안군,075005, 74세,2021,671,331,340,97.4,671,331,340,97.4
36480, 신안군,080,75~79세,2021,2858,1197,1661,72.1,2855,1197,1658,72.2
36480, 신안군,080001, 75세,2021,562,265,297,89.2,562,265,297,89.2
36480, 신안군,080002, 76세,2021,545,248,297,83.5,544,248,296,83.8
36480, 신안군,080003, 77세,2021,470,181,289,62.6,469,181,288,62.8
36480, 신안군,080004, 78세,2021,556,217,339,64,555,217,338,64.2
36480, 신안군,080005, 79세,2021,725,286,439,65.1,725,286,439,65.1
36480, 신안군,085,80~84세,2021,2473,842,1631,51.6,2473,842,1631,51.6
36480, 신안군,085001, 80세,2021,588,228,360,63.3,588,228,360,63.3
36480, 신안군,085002, 81세,2021,523,181,342,52.9,523,181,342,52.9
36480, 신안군,085003, 82세,2021,511,168,343,49,511,168,343,49
36480, 신안군,085004, 83세,2021,443,145,298,48.7,443,145,298,48.7
36480, 신안군,085005, 84세,2021,408,120,288,41.7,408,120,288,41.7
36480, 신안군,090,85~89세,2021,1203,312,891,35,1203,312,891,35
36480, 신안군,090001, 85세,2021,326,85,241,35.3,326,85,241,35.3
36480, 신안군,090002, 86세,2021,274,72,202,35.6,274,72,202,35.6
36480, 신안군,090003, 87세,2021,264,82,182,45.1,264,82,182,45.1
36480, 신안군,090004, 88세,2021,198,42,156,26.9,198,42,156,26.9
36480, 신안군,090005, 89세,2021,141,31,110,28.2,141,31,110,28.2
36480, 신안군,095,90~94세,2021,354,74,280,26.4,354,74,280,26.4
36480, 신안군,095001, 90세,2021,107,22,85,25.9,107,22,85,25.9
36480, 신안군,095002, 91세,2021,108,17,91,18.7,108,17,91,18.7
36480, 신안군,095003, 92세,2021,55,15,40,37.5,55,15,40,37.5
36480, 신안군,095004, 93세,2021,43,7,36,19.4,43,7,36,19.4
36480, 신안군,095005, 94세,2021,41,13,28,46.4,41,13,28,46.4
36480, 신안군,100,95~99세,2021,63,17,46,37,63,17,46,37
36480, 신안군,100001, 95세,2021,16,6,10,60,16,6,10,60
36480, 신안군,100002, 96세,2021,22,7,15,46.7,22,7,15,46.7
36480, 신안군,100003, 97세,2021,8,X,6,33.3,8,X,6,33.3
36480, 신안군,100004, 98세,2021,8,X,7,14.3,8,X,7,14.3
36480, 신안군,100005, 99세,2021,9,X,8,12.5,9,X,8,12.5
36480, 신안군,101,100세이상,2021,X,X,X,200,X,X,X,200
36480, 신안군,102,15세미만,2021,2236,1136,1100,103.3,2233,1133,1100,103
36480, 신안군,103,15~64세,2021,18676,11365,7311,155.5,17711,10709,7002,152.9
36480, 신안군,104,65세이상,2021,13088,5598,7490,74.7,13075,5591,7484,74.7
36480, 신안군,086,85세이상,2021,1623,405,1218,33.3,1623,405,1218,33.3
36480, 신안군,126,평균연령,2021,55.9,53,59.3,,56.5,53.8,59.7,
36480, 신안군,127,중위연령,2021,60,56.6,63.6,,60.5,57.4,64.1,
37,경상북도,000,합계,2021,2635314,1332376,1302938,102.3,2562516,1289398,1273118,101.3
37,경상북도,005,0~4세,2021,73598,37778,35820,105.5,72555,37245,35310,105.5
37,경상북도,005001, 0세,2021,12292,6207,6085,102,12081,6112,5969,102.4
37,경상북도,005002, 1세,2021,13303,6868,6435,106.7,13110,6771,6339,106.8
37,경상북도,005003, 2세,2021,14657,7524,7133,105.5,14450,7411,7039,105.3
37,경상북도,005004, 3세,2021,15939,8276,7663,108,15751,8181,7570,108.1
37,경상북도,005005, 4세,2021,17407,8903,8504,104.7,17163,8770,8393,104.5
37,경상북도,010,5~9세,2021,105766,54532,51234,106.4,104872,54090,50782,106.5
37,경상북도,010001, 5세,2021,20021,10198,9823,103.8,19781,10089,9692,104.1
37,경상북도,010002, 6세,2021,21020,10794,10226,105.6,20817,10687,10130,105.5
37,경상북도,010003, 7세,2021,20512,10631,9881,107.6,20339,10551,9788,107.8
37,경상북도,010004, 8세,2021,21311,10972,10339,106.1,21167,10900,10267,106.2
37,경상북도,010005, 9세,2021,22902,11937,10965,108.9,22768,11863,10905,108.8
37,경상북도,015,10~14세,2021,108503,56406,52097,108.3,108010,56153,51857,108.3
37,경상북도,015001, 10세,2021,22516,11742,10774,109,22417,11692,10725,109
37,경상북도,015002, 11세,2021,21222,10934,10288,106.3,21100,10866,10234,106.2
37,경상북도,015003, 12세,2021,20656,10800,9856,109.6,20575,10756,9819,109.5
37,경상북도,015004, 13세,2021,21795,11374,10421,109.1,21694,11327,10367,109.3
37,경상북도,015005, 14세,2021,22314,11556,10758,107.4,22224,11512,10712,107.5
37,경상북도,020,15~19세,2021,114129,61531,52598,117,113183,61081,52102,117.2
37,경상북도,020001, 15세,2021,20736,10989,9747,112.7,20649,10952,9697,112.9
37,경상북도,020002, 16세,2021,21056,11109,9947,111.7,20968,11071,9897,111.9
37,경상북도,020003, 17세,2021,22964,12367,10597,116.7,22902,12333,10569,116.7
37,경상북도,020004, 18세,2021,23717,12694,11023,115.2,23534,12612,10922,115.5
37,경상북도,020005, 19세,2021,25656,14372,11284,127.4,25130,14113,11017,128.1
37,경상북도,025,20~24세,2021,151918,86399,65519,131.9,141802,80848,60954,132.6
37,경상북도,025001, 20세,2021,28982,15948,13034,122.4,28051,15509,12542,123.7
37,경상북도,025002, 21세,2021,32240,17866,14374,124.3,30395,16965,13430,126.3
37,경상북도,025003, 22세,2021,30496,17266,13230,130.5,28354,16112,12242,131.6
37,경상북도,025004, 23세,2021,29988,17565,12423,141.4,27464,16105,11359,141.8
37,경상북도,025005, 24세,2021,30212,17754,12458,142.5,27538,16157,11381,142
37,경상북도,030,25~29세,2021,147747,85403,62344,137,134123,76722,57401,133.7
37,경상북도,030001, 25세,2021,29778,17433,12345,141.2,27193,15808,11385,138.8
37,경상북도,030002, 26세,2021,29824,17411,12413,140.3,27115,15691,11424,137.4
37,경상북도,030003, 27세,2021,29284,17053,12231,139.4,26629,15371,11258,136.5
37,경상북도,030004, 28세,2021,29067,16738,12329,135.8,26296,14976,11320,132.3
37,경상북도,030005, 29세,2021,29794,16768,13026,128.7,26890,14876,12014,123.8
37,경상북도,035,30~34세,2021,137861,76992,60869,126.5,124380,68493,55887,122.6
37,경상북도,035001, 30세,2021,27976,15904,12072,131.7,25230,14116,11114,127
37,경상북도,035002, 31세,2021,27973,15819,12154,130.2,25107,14035,11072,126.8
37,경상북도,035003, 32세,2021,26888,15205,11683,130.1,24184,13507,10677,126.5
37,경상북도,035004, 33세,2021,26987,14978,12009,124.7,24422,13370,11052,121
37,경상북도,035005, 34세,2021,28037,15086,12951,116.5,25437,13465,11972,112.5
37,경상북도,040,35~39세,2021,158775,84213,74562,112.9,148098,77414,70684,109.5
37,경상북도,040001, 35세,2021,28357,15343,13014,117.9,25980,13817,12163,113.6
37,경상북도,040002, 36세,2021,28803,15558,13245,117.5,26507,14105,12402,113.7
37,경상북도,040003, 37세,2021,30262,16003,14259,112.2,28138,14675,13463,109
37,경상북도,040004, 38세,2021,33920,17844,16076,111,32010,16603,15407,107.8
37,경상북도,040005, 39세,2021,37433,19465,17968,108.3,35463,18214,17249,105.6
37,경상북도,045,40~44세,2021,179404,94013,85391,110.1,172360,89694,82666,108.5
37,경상북도,045001, 40세,2021,37171,19541,17630,110.8,35500,18508,16992,108.9
37,경상북도,045002, 41세,2021,38275,20123,18152,110.9,36716,19156,17560,109.1
37,경상북도,045003, 42세,2021,35777,18767,17010,110.3,34346,17868,16478,108.4
37,경상북도,045004, 43세,2021,33324,17547,15777,111.2,32078,16801,15277,110
37,경상북도,045005, 44세,2021,34857,18035,16822,107.2,33720,17361,16359,106.1
37,경상북도,050,45~49세,2021,195476,101086,94390,107.1,190583,98284,92299,106.5
37,경상북도,050001, 45세,2021,34526,17927,16599,108,33411,17265,16146,106.9
37,경상북도,050002, 46세,2021,37398,19286,18112,106.5,36435,18729,17706,105.8
37,경상북도,050003, 47세,2021,40857,21064,19793,106.4,39865,20513,19352,106
37,경상북도,050004, 48세,2021,41257,21083,20174,104.5,40302,20533,19769,103.9
37,경상북도,050005, 49세,2021,41438,21726,19712,110.2,40570,21244,19326,109.9
37,경상북도,055,50~54세,2021,223263,114704,108559,105.7,219496,112747,106749,105.6
37,경상북도,055001, 50세,2021,44108,23060,21048,109.6,43258,22579,20679,109.2
37,경상북도,055002, 51세,2021,44193,22699,21494,105.6,43350,22239,21111,105.3
37,경상북도,055003, 52세,2021,45027,23256,21771,106.8,44265,22863,21402,106.8
37,경상북도,055004, 53세,2021,46934,23967,22967,104.4,46231,23635,22596,104.6
37,경상북도,055005, 54세,2021,43001,21722,21279,102.1,42392,21431,20961,102.2
37,경상북도,060,55~59세,2021,221816,113909,107907,105.6,219150,112611,106539,105.7
37,경상북도,060001, 55세,2021,43612,22875,20737,110.3,43024,22586,20438,110.5
37,경상북도,060002, 56세,2021,44226,22408,21818,102.7,43660,22128,21532,102.8
37,경상북도,060003, 57세,2021,41980,21539,20441,105.4,41452,21289,20163,105.6
37,경상북도,060004, 58세,2021,45090,23080,22010,104.9,44576,22821,21755,104.9
37,경상북도,060005, 59세,2021,46908,24007,22901,104.8,46438,23787,22651,105
37,경상북도,065,60~64세,2021,235949,118407,117542,100.7,234336,117662,116674,100.8
37,경상북도,065001, 60세,2021,51921,26322,25599,102.8,51587,26157,25430,102.9
37,경상북도,065002, 61세,2021,51750,25586,26164,97.8,51347,25411,25936,98
37,경상북도,065003, 62세,2021,46588,23208,23380,99.3,46297,23068,23229,99.3
37,경상북도,065004, 63세,2021,42227,21270,20957,101.5,41918,21132,20786,101.7
37,경상북도,065005, 64세,2021,43463,22021,21442,102.7,43187,21894,21293,102.8
37,경상북도,070,65~69세,2021,184723,89890,94833,94.8,183912,89521,94391,94.8
37,경상북도,070001, 65세,2021,40700,20265,20435,99.2,40490,20163,20327,99.2
37,경상북도,070002, 66세,2021,40238,19528,20710,94.3,40047,19440,20607,94.3
37,경상북도,070003, 67세,2021,35190,17221,17969,95.8,35031,17150,17881,95.9
37,경상북도,070004, 68세,2021,33344,16135,17209,93.8,33211,16079,17132,93.9
37,경상북도,070005, 69세,2021,35251,16741,18510,90.4,35133,16689,18444,90.5
37,경상북도,075,70~74세,2021,135926,64628,71298,90.6,135515,64450,71065,90.7
37,경상북도,075001, 70세,2021,26856,12795,14061,91,26743,12740,14003,91
37,경상북도,075002, 71세,2021,27263,13021,14242,91.4,27160,12978,14182,91.5
37,경상북도,075003, 72세,2021,28985,13982,15003,93.2,28912,13954,14958,93.3
37,경상북도,075004, 73세,2021,27286,12971,14315,90.6,27211,12937,14274,90.6
37,경상북도,075005, 74세,2021,25536,11859,13677,86.7,25489,11841,13648,86.8
37,경상북도,080,75~79세,2021,103376,42970,60406,71.1,103219,42909,60310,71.1
37,경상북도,080001, 75세,2021,16506,7657,8849,86.5,16454,7637,8817,86.6
37,경상북도,080002, 76세,2021,17757,7655,10102,75.8,17728,7642,10086,75.8
37,경상북도,080003, 77세,2021,20578,8378,12200,68.7,20551,8369,12182,68.7
37,경상북도,080004, 78세,2021,22855,9149,13706,66.8,22831,9140,13691,66.8
37,경상북도,080005, 79세,2021,25680,10131,15549,65.2,25655,10121,15534,65.2
37,경상북도,085,80~84세,2021,88039,31206,56833,54.9,87940,31177,56763,54.9
37,경상북도,085001, 80세,2021,19777,7453,12324,60.5,19752,7446,12306,60.5
37,경상북도,085002, 81세,2021,18763,6895,11868,58.1,18742,6889,11853,58.1
37,경상북도,085003, 82세,2021,19062,6748,12314,54.8,19044,6744,12300,54.8
37,경상북도,085004, 83세,2021,16100,5416,10684,50.7,16080,5408,10672,50.7
37,경상북도,085005, 84세,2021,14337,4694,9643,48.7,14322,4690,9632,48.7
37,경상북도,090,85~89세,2021,49401,14366,35035,41,49355,14356,34999,41
37,경상북도,090001, 85세,2021,13149,4187,8962,46.7,13133,4183,8950,46.7
37,경상북도,090002, 86세,2021,12107,3615,8492,42.6,12096,3614,8482,42.6
37,경상북도,090003, 87세,2021,9754,2815,6939,40.6,9744,2814,6930,40.6
37,경상북도,090004, 88세,2021,7759,2066,5693,36.3,7753,2064,5689,36.3
37,경상북도,090005, 89세,2021,6632,1683,4949,34,6629,1681,4948,34
37,경상북도,095,90~94세,2021,15911,3396,12515,27.1,15900,3395,12505,27.1
37,경상북도,095001, 90세,2021,4710,1108,3602,30.8,4710,1108,3602,30.8
37,경상북도,095002, 91세,2021,3947,845,3102,27.2,3944,845,3099,27.3
37,경상북도,095003, 92세,2021,3053,638,2415,26.4,3048,637,2411,26.4
37,경상북도,095004, 93세,2021,2437,458,1979,23.1,2436,458,1978,23.2
37,경상북도,095005, 94세,2021,1764,347,1417,24.5,1762,347,1415,24.5
37,경상북도,100,95~99세,2021,3265,505,2760,18.3,3259,504,2755,18.3
37,경상북도,100001, 95세,2021,1109,169,940,18,1107,168,939,17.9
37,경상북도,100002, 96세,2021,881,134,747,17.9,879,134,745,18
37,경상북도,100003, 97세,2021,519,94,425,22.1,519,94,425,22.1
37,경상북도,100004, 98세,2021,460,67,393,17,459,67,392,17.1
37,경상북도,100005, 99세,2021,296,41,255,16.1,295,41,254,16.1
37,경상북도,101,100세이상,2021,468,42,426,9.9,468,42,426,9.9
37,경상북도,102,15세미만,2021,287867,148716,139151,106.9,285437,147488,137949,106.9
37,경상북도,103,15~64세,2021,1766338,936657,829681,112.9,1697511,895556,801955,111.7
37,경상북도,104,65세이상,2021,581109,247003,334106,73.9,579568,246354,333214,73.9
37,경상북도,086,85세이상,2021,69045,18309,50736,36.1,68982,18297,50685,36.1
37,경상북도,126,평균연령,2021,46.3,44.5,48.2,,46.7,44.8,48.5,
37,경상북도,127,중위연령,2021,48.7,46.6,50.8,,49.3,47.3,51.3,
37004, 읍부,000,합계,2021,647191,331348,315843,104.9,623706,316925,306781,103.3
37004, 읍부,005,0~4세,2021,19841,10223,9618,106.3,19512,10053,9459,106.3
37004, 읍부,005001, 0세,2021,3247,1640,1607,102.1,3178,1614,1564,103.2
37004, 읍부,005002, 1세,2021,3474,1784,1690,105.6,3416,1756,1660,105.8
37004, 읍부,005003, 2세,2021,4133,2125,2008,105.8,4067,2085,1982,105.2
37004, 읍부,005004, 3세,2021,4276,2225,2051,108.5,4217,2193,2024,108.3
37004, 읍부,005005, 4세,2021,4711,2449,2262,108.3,4634,2405,2229,107.9
37004, 읍부,010,5~9세,2021,28337,14662,13675,107.2,28063,14514,13549,107.1
37004, 읍부,010001, 5세,2021,5394,2741,2653,103.3,5324,2705,2619,103.3
37004, 읍부,010002, 6세,2021,5665,2972,2693,110.4,5599,2928,2671,109.6
37004, 읍부,010003, 7세,2021,5576,2861,2715,105.4,5515,2833,2682,105.6
37004, 읍부,010004, 8세,2021,5721,2928,2793,104.8,5674,2903,2771,104.8
37004, 읍부,010005, 9세,2021,5981,3160,2821,112,5951,3145,2806,112.1
37004, 읍부,015,10~14세,2021,27915,14458,13457,107.4,27777,14390,13387,107.5
37004, 읍부,015001, 10세,2021,5911,3067,2844,107.8,5888,3060,2828,108.2
37004, 읍부,015002, 11세,2021,5492,2844,2648,107.4,5456,2823,2633,107.2
37004, 읍부,015003, 12세,2021,5326,2791,2535,110.1,5299,2777,2522,110.1
37004, 읍부,015004, 13세,2021,5480,2852,2628,108.5,5451,2839,2612,108.7
37004, 읍부,015005, 14세,2021,5706,2904,2802,103.6,5683,2891,2792,103.5
37004, 읍부,020,15~19세,2021,30473,16061,14412,111.4,30120,15904,14216,111.9
37004, 읍부,020001, 15세,2021,5334,2847,2487,114.5,5318,2841,2477,114.7
37004, 읍부,020002, 16세,2021,5220,2715,2505,108.4,5196,2706,2490,108.7
37004, 읍부,020003, 17세,2021,5625,2952,2673,110.4,5605,2941,2664,110.4
37004, 읍부,020004, 18세,2021,6246,3233,3013,107.3,6183,3211,2972,108
37004, 읍부,020005, 19세,2021,8048,4314,3734,115.5,7818,4205,3613,116.4
37004, 읍부,025,20~24세,2021,41704,23194,18510,125.3,38479,21532,16947,127.1
37004, 읍부,025001, 20세,2021,8347,4181,4166,100.4,7956,4014,3942,101.8
37004, 읍부,025002, 21세,2021,9082,4722,4360,108.3,8388,4410,3978,110.9
37004, 읍부,025003, 22세,2021,8511,4722,3789,124.6,7836,4393,3443,127.6
37004, 읍부,025004, 23세,2021,8014,4813,3201,150.4,7295,4417,2878,153.5
37004, 읍부,025005, 24세,2021,7750,4756,2994,158.9,7004,4298,2706,158.8
37004, 읍부,030,25~29세,2021,36003,21144,14859,142.3,31905,18458,13447,137.3
37004, 읍부,030001, 25세,2021,7259,4352,2907,149.7,6560,3906,2654,147.2
37004, 읍부,030002, 26세,2021,7110,4269,2841,150.3,6334,3767,2567,146.7
37004, 읍부,030003, 27세,2021,7157,4228,2929,144.3,6332,3692,2640,139.8
37004, 읍부,030004, 28세,2021,7145,4191,2954,141.9,6249,3587,2662,134.7
37004, 읍부,030005, 29세,2021,7332,4104,3228,127.1,6430,3506,2924,119.9
37004, 읍부,035,30~34세,2021,36095,20406,15689,130.1,31622,17399,14223,122.3
37004, 읍부,035001, 30세,2021,7049,4094,2955,138.5,6200,3509,2691,130.4
37004, 읍부,035002, 31세,2021,7217,4082,3135,130.2,6237,3435,2802,122.6
37004, 읍부,035003, 32세,2021,7026,4024,3002,134,6124,3425,2699,126.9
37004, 읍부,035004, 33세,2021,7182,4038,3144,128.4,6307,3443,2864,120.2
37004, 읍부,035005, 34세,2021,7621,4168,3453,120.7,6754,3587,3167,113.3
37004, 읍부,040,35~39세,2021,42643,23004,19639,117.1,38989,20551,18438,111.5
37004, 읍부,040001, 35세,2021,7612,4175,3437,121.5,6815,3627,3188,113.8
37004, 읍부,040002, 36세,2021,7843,4358,3485,125.1,7068,3855,3213,120
37004, 읍부,040003, 37세,2021,8188,4443,3745,118.6,7447,3952,3495,113.1
37004, 읍부,040004, 38세,2021,8990,4802,4188,114.7,8346,4346,4000,108.7
37004, 읍부,040005, 39세,2021,10010,5226,4784,109.2,9313,4771,4542,105
37004, 읍부,045,40~44세,2021,47480,25285,22195,113.9,45172,23773,21399,111.1
37004, 읍부,045001, 40세,2021,9958,5347,4611,116,9420,4990,4430,112.6
37004, 읍부,045002, 41세,2021,10171,5429,4742,114.5,9672,5097,4575,111.4
37004, 읍부,045003, 42세,2021,9445,5015,4430,113.2,8968,4694,4274,109.8
37004, 읍부,045004, 43세,2021,8793,4715,4078,115.6,8392,4459,3933,113.4
37004, 읍부,045005, 44세,2021,9113,4779,4334,110.3,8720,4533,4187,108.3
37004, 읍부,050,45~49세,2021,49854,26438,23416,112.9,48270,25446,22824,111.5
37004, 읍부,050001, 45세,2021,8751,4672,4079,114.5,8414,4452,3962,112.4
37004, 읍부,050002, 46세,2021,9414,4957,4457,111.2,9092,4760,4332,109.9
37004, 읍부,050003, 47세,2021,10566,5615,4951,113.4,10229,5417,4812,112.6
37004, 읍부,050004, 48세,2021,10599,5562,5037,110.4,10289,5356,4933,108.6
37004, 읍부,050005, 49세,2021,10524,5632,4892,115.1,10246,5461,4785,114.1
37004, 읍부,055,50~54세,2021,54959,28763,26196,109.8,53737,28089,25648,109.5
37004, 읍부,055001, 50세,2021,11135,5865,5270,111.3,10839,5701,5138,111
37004, 읍부,055002, 51세,2021,10959,5723,5236,109.3,10686,5558,5128,108.4
37004, 읍부,055003, 52세,2021,11043,5859,5184,113,10804,5732,5072,113
37004, 읍부,055004, 53세,2021,11392,5943,5449,109.1,11172,5825,5347,108.9
37004, 읍부,055005, 54세,2021,10430,5373,5057,106.2,10236,5273,4963,106.2
37004, 읍부,060,55~59세,2021,52519,27379,25140,108.9,51659,26944,24715,109
37004, 읍부,060001, 55세,2021,10627,5659,4968,113.9,10432,5554,4878,113.9
37004, 읍부,060002, 56세,2021,10543,5414,5129,105.6,10354,5324,5030,105.8
37004, 읍부,060003, 57세,2021,10029,5240,4789,109.4,9867,5156,4711,109.4
37004, 읍부,060004, 58세,2021,10491,5414,5077,106.6,10328,5333,4995,106.8
37004, 읍부,060005, 59세,2021,10829,5652,5177,109.2,10678,5577,5101,109.3
37004, 읍부,065,60~64세,2021,53114,27108,26006,104.2,52606,26860,25746,104.3
37004, 읍부,065001, 60세,2021,11843,6170,5673,108.8,11739,6119,5620,108.9
37004, 읍부,065002, 61세,2021,11647,5878,5769,101.9,11525,5819,5706,102
37004, 읍부,065003, 62세,2021,10454,5301,5153,102.9,10362,5262,5100,103.2
37004, 읍부,065004, 63세,2021,9525,4854,4671,103.9,9420,4801,4619,103.9
37004, 읍부,065005, 64세,2021,9645,4905,4740,103.5,9560,4859,4701,103.4
37004, 읍부,070,65~69세,2021,39866,19515,20351,95.9,39614,19390,20224,95.9
37004, 읍부,070001, 65세,2021,8737,4412,4325,102,8663,4372,4291,101.9
37004, 읍부,070002, 66세,2021,8846,4322,4524,95.5,8788,4295,4493,95.6
37004, 읍부,070003, 67세,2021,7601,3671,3930,93.4,7553,3649,3904,93.5
37004, 읍부,070004, 68세,2021,7192,3533,3659,96.6,7158,3515,3643,96.5
37004, 읍부,070005, 69세,2021,7490,3577,3913,91.4,7452,3559,3893,91.4
37004, 읍부,075,70~74세,2021,29495,13856,15639,88.6,29367,13794,15573,88.6
37004, 읍부,075001, 70세,2021,5796,2724,3072,88.7,5759,2705,3054,88.6
37004, 읍부,075002, 71세,2021,5888,2765,3123,88.5,5853,2748,3105,88.5
37004, 읍부,075003, 72세,2021,6301,2983,3318,89.9,6283,2978,3305,90.1
37004, 읍부,075004, 73세,2021,5896,2795,3101,90.1,5871,2781,3090,90
37004, 읍부,075005, 74세,2021,5614,2589,3025,85.6,5601,2582,3019,85.5
37004, 읍부,080,75~79세,2021,22505,9171,13334,68.8,22464,9157,13307,68.8
37004, 읍부,080001, 75세,2021,3650,1679,1971,85.2,3636,1674,1962,85.3
37004, 읍부,080002, 76세,2021,3878,1605,2273,70.6,3868,1602,2266,70.7
37004, 읍부,080003, 77세,2021,4530,1826,2704,67.5,4526,1824,2702,67.5
37004, 읍부,080004, 78세,2021,4918,1917,3001,63.9,4912,1915,2997,63.9
37004, 읍부,080005, 79세,2021,5529,2144,3385,63.3,5522,2142,3380,63.4
37004, 읍부,085,80~84세,2021,19263,6662,12601,52.9,19238,6652,12586,52.9
37004, 읍부,085001, 80세,2021,4302,1559,2743,56.8,4294,1555,2739,56.8
37004, 읍부,085002, 81세,2021,4065,1491,2574,57.9,4058,1489,2569,58
37004, 읍부,085003, 82세,2021,4290,1449,2841,51,4287,1448,2839,51
37004, 읍부,085004, 83세,2021,3523,1163,2360,49.3,3519,1161,2358,49.2
37004, 읍부,085005, 84세,2021,3083,1000,2083,48,3080,999,2081,48
37004, 읍부,090,85~89세,2021,10825,3153,7672,41.1,10817,3153,7664,41.1
37004, 읍부,090001, 85세,2021,2894,938,1956,48,2891,938,1953,48
37004, 읍부,090002, 86세,2021,2663,808,1855,43.6,2660,808,1852,43.6
37004, 읍부,090003, 87세,2021,2067,601,1466,41,2066,601,1465,41
37004, 읍부,090004, 88세,2021,1673,437,1236,35.4,1672,437,1235,35.4
37004, 읍부,090005, 89세,2021,1528,369,1159,31.8,1528,369,1159,31.8
37004, 읍부,095,90~94세,2021,3432,729,2703,27,3429,729,2700,27
37004, 읍부,095001, 90세,2021,997,242,755,32.1,997,242,755,32.1
37004, 읍부,095002, 91세,2021,821,179,642,27.9,821,179,642,27.9
37004, 읍부,095003, 92세,2021,653,131,522,25.1,652,131,521,25.1
37004, 읍부,095004, 93세,2021,542,102,440,23.2,541,102,439,23.2
37004, 읍부,095005, 94세,2021,419,75,344,21.8,418,75,343,21.9
37004, 읍부,100,95~99세,2021,772,126,646,19.5,770,126,644,19.6
37004, 읍부,100001, 95세,2021,264,41,223,18.4,264,41,223,18.4
37004, 읍부,100002, 96세,2021,224,30,194,15.5,223,30,193,15.5
37004, 읍부,100003, 97세,2021,110,31,79,39.2,110,31,79,39.2
37004, 읍부,100004, 98세,2021,109,21,88,23.9,108,21,87,24.1
37004, 읍부,100005, 99세,2021,65,X,62,4.8,65,X,62,4.8
37004, 읍부,101,100세이상,2021,96,11,85,12.9,96,11,85,12.9
37004, 읍부,102,15세미만,2021,76093,39343,36750,107.1,75352,38957,36395,107
37004, 읍부,103,15~64세,2021,444844,238782,206062,115.9,422559,224956,197603,113.8
37004, 읍부,104,65세이상,2021,126254,53223,73031,72.9,125795,53012,72783,72.8
37004, 읍부,086,85세이상,2021,15125,4019,11106,36.2,15112,4019,11093,36.2
37004, 읍부,126,평균연령,2021,44.8,43.1,46.5,,45.1,43.4,46.9,
37004, 읍부,127,중위연령,2021,46.5,44.4,48.5,,47.3,45.4,49.1,
37005, 면부,000,합계,2021,589004,295927,293077,101,569916,282779,287137,98.5
37005, 면부,005,0~4세,2021,9816,5016,4800,104.5,9777,4996,4781,104.5
37005, 면부,005001, 0세,2021,1812,912,900,101.3,1807,909,898,101.2
37005, 면부,005002, 1세,2021,1981,1030,951,108.3,1970,1025,945,108.5
37005, 면부,005003, 2세,2021,1973,1032,941,109.7,1961,1025,936,109.5
37005, 면부,005004, 3세,2021,2024,1023,1001,102.2,2018,1020,998,102.2
37005, 면부,005005, 4세,2021,2026,1019,1007,101.2,2021,1017,1004,101.3
37005, 면부,010,5~9세,2021,11542,5999,5543,108.2,11505,5987,5518,108.5
37005, 면부,010001, 5세,2021,2255,1131,1124,100.6,2244,1128,1116,101.1
37005, 면부,010002, 6세,2021,2191,1156,1035,111.7,2182,1154,1028,112.3
37005, 면부,010003, 7세,2021,2126,1102,1024,107.6,2121,1101,1020,107.9
37005, 면부,010004, 8세,2021,2418,1244,1174,106,2412,1243,1169,106.3
37005, 면부,010005, 9세,2021,2552,1366,1186,115.2,2546,1361,1185,114.9
37005, 면부,015,10~14세,2021,12930,6786,6144,110.4,12908,6774,6134,110.4
37005, 면부,015001, 10세,2021,2562,1289,1273,101.3,2558,1289,1269,101.6
37005, 면부,015002, 11세,2021,2402,1253,1149,109.1,2398,1251,1147,109.1
37005, 면부,015003, 12세,2021,2437,1289,1148,112.3,2431,1285,1146,112.1
37005, 면부,015004, 13세,2021,2784,1528,1256,121.7,2780,1525,1255,121.5
37005, 면부,015005, 14세,2021,2745,1427,1318,108.3,2741,1424,1317,108.1
37005, 면부,020,15~19세,2021,13779,7561,6218,121.6,13701,7516,6185,121.5
37005, 면부,020001, 15세,2021,2593,1415,1178,120.1,2583,1412,1171,120.6
37005, 면부,020002, 16세,2021,2790,1540,1250,123.2,2780,1534,1246,123.1
37005, 면부,020003, 17세,2021,2857,1536,1321,116.3,2847,1530,1317,116.2
37005, 면부,020004, 18세,2021,2774,1525,1249,122.1,2749,1511,1238,122.1
37005, 면부,020005, 19세,2021,2765,1545,1220,126.6,2742,1529,1213,126.1
37005, 면부,025,20~24세,2021,19087,11542,7545,153,17512,10484,7028,149.2
37005, 면부,025001, 20세,2021,3602,2167,1435,151,3551,2139,1412,151.5
37005, 면부,025002, 21세,2021,3888,2351,1537,153,3758,2275,1483,153.4
37005, 면부,025003, 22세,2021,3620,2202,1418,155.3,3384,2047,1337,153.1
37005, 면부,025004, 23세,2021,3886,2389,1497,159.6,3348,2012,1336,150.6
37005, 면부,025005, 24세,2021,4091,2433,1658,146.7,3471,2011,1460,137.7
37005, 면부,030,25~29세,2021,22028,13931,8097,172.1,17687,10690,6997,152.8
37005, 면부,030001, 25세,2021,4172,2638,1534,172,3418,2070,1348,153.6
37005, 면부,030002, 26세,2021,4367,2756,1611,171.1,3534,2147,1387,154.8
37005, 면부,030003, 27세,2021,4507,2846,1661,171.3,3645,2213,1432,154.5
37005, 면부,030004, 28세,2021,4419,2811,1608,174.8,3515,2131,1384,154
37005, 면부,030005, 29세,2021,4563,2880,1683,171.1,3575,2129,1446,147.2
37005, 면부,035,30~34세,2021,21130,12804,8326,153.8,16908,9770,7138,136.9
37005, 면부,035001, 30세,2021,4321,2712,1609,168.6,3399,2006,1393,144
37005, 면부,035002, 31세,2021,4369,2620,1749,149.8,3439,1981,1458,135.9
37005, 면부,035003, 32세,2021,4164,2572,1592,161.6,3346,1979,1367,144.8
37005, 면부,035004, 33세,2021,4112,2472,1640,150.7,3360,1939,1421,136.5
37005, 면부,035005, 34세,2021,4164,2428,1736,139.9,3364,1865,1499,124.4
37005, 면부,040,35~39세,2021,21778,12688,9090,139.6,18540,10317,8223,125.5
37005, 면부,040001, 35세,2021,4077,2413,1664,145,3351,1876,1475,127.2
37005, 면부,040002, 36세,2021,3973,2360,1613,146.3,3264,1851,1413,131
37005, 면부,040003, 37세,2021,4097,2357,1740,135.5,3444,1893,1551,122.1
37005, 면부,040004, 38세,2021,4589,2677,1912,140,4005,2242,1763,127.2
37005, 면부,040005, 39세,2021,5042,2881,2161,133.3,4476,2455,2021,121.5
37005, 면부,045,40~44세,2021,24480,14449,10031,144,22433,13007,9426,138
37005, 면부,045001, 40세,2021,4887,2858,2029,140.9,4384,2512,1872,134.2
37005, 면부,045002, 41세,2021,5111,2977,2134,139.5,4644,2643,2001,132.1
37005, 면부,045003, 42세,2021,4926,2938,1988,147.8,4499,2628,1871,140.5
37005, 면부,045004, 43세,2021,4621,2784,1837,151.6,4263,2536,1727,146.8
37005, 면부,045005, 44세,2021,4935,2892,2043,141.6,4643,2688,1955,137.5
37005, 면부,050,45~49세,2021,30275,17749,12526,141.7,28993,16937,12056,140.5
37005, 면부,050001, 45세,2021,5133,3082,2051,150.3,4781,2842,1939,146.6
37005, 면부,050002, 46세,2021,5627,3327,2300,144.7,5377,3159,2218,142.4
37005, 면부,050003, 47세,2021,6244,3614,2630,137.4,5992,3468,2524,137.4
37005, 면부,050004, 48세,2021,6520,3804,2716,140.1,6287,3663,2624,139.6
37005, 면부,050005, 49세,2021,6751,3922,2829,138.6,6556,3805,2751,138.3
37005, 면부,055,50~54세,2021,43529,23747,19782,120,42613,23243,19370,120
37005, 면부,055001, 50세,2021,7781,4486,3295,136.1,7583,4358,3225,135.1
37005, 면부,055002, 51세,2021,7950,4387,3563,123.1,7738,4276,3462,123.5
37005, 면부,055003, 52세,2021,8816,4851,3965,122.3,8625,4737,3888,121.8
37005, 면부,055004, 53세,2021,9539,5086,4453,114.2,9369,5006,4363,114.7
37005, 면부,055005, 54세,2021,9443,4937,4506,109.6,9298,4866,4432,109.8
37005, 면부,060,55~59세,2021,55861,29490,26371,111.8,55254,29202,26052,112.1
37005, 면부,060001, 55세,2021,10065,5502,4563,120.6,9925,5443,4482,121.4
37005, 면부,060002, 56세,2021,10648,5649,4999,113,10540,5590,4950,112.9
37005, 면부,060003, 57세,2021,10523,5418,5105,106.1,10401,5366,5035,106.6
37005, 면부,060004, 58세,2021,11645,6108,5537,110.3,11520,6039,5481,110.2
37005, 면부,060005, 59세,2021,12980,6813,6167,110.5,12868,6764,6104,110.8
37005, 면부,065,60~64세,2021,71881,37002,34879,106.1,71523,36842,34681,106.2
37005, 면부,065001, 60세,2021,14941,7688,7253,106,14861,7649,7212,106.1
37005, 면부,065002, 61세,2021,15568,7811,7757,100.7,15477,7775,7702,100.9
37005, 면부,065003, 62세,2021,14307,7272,7035,103.4,14240,7237,7003,103.3
37005, 면부,065004, 63세,2021,13164,6926,6238,111,13099,6896,6203,111.2
37005, 면부,065005, 64세,2021,13901,7305,6596,110.7,13846,7285,6561,111
37005, 면부,070,65~69세,2021,63394,31540,31854,99,63224,31460,31764,99
37005, 면부,070001, 65세,2021,13439,6877,6562,104.8,13400,6856,6544,104.8
37005, 면부,070002, 66세,2021,13460,6692,6768,98.9,13417,6672,6745,98.9
37005, 면부,070003, 67세,2021,12098,6031,6067,99.4,12064,6014,6050,99.4
37005, 면부,070004, 68세,2021,11727,5842,5885,99.3,11699,5831,5868,99.4
37005, 면부,070005, 69세,2021,12670,6098,6572,92.8,12644,6087,6557,92.8
37005, 면부,075,70~74세,2021,51055,24698,26357,93.7,50968,24656,26312,93.7
37005, 면부,075001, 70세,2021,9760,4760,5000,95.2,9741,4749,4992,95.1
37005, 면부,075002, 71세,2021,10070,4830,5240,92.2,10050,4820,5230,92.2
37005, 면부,075003, 72세,2021,10944,5393,5551,97.2,10921,5383,5538,97.2
37005, 면부,075004, 73세,2021,10356,5045,5311,95,10339,5037,5302,95
37005, 면부,075005, 74세,2021,9925,4670,5255,88.9,9917,4667,5250,88.9
37005, 면부,080,75~79세,2021,43036,17675,25361,69.7,43003,17659,25344,69.7
37005, 면부,080001, 75세,2021,6256,2914,3342,87.2,6243,2909,3334,87.3
37005, 면부,080002, 76세,2021,7157,3077,4080,75.4,7152,3075,4077,75.4
37005, 면부,080003, 77세,2021,8408,3315,5093,65.1,8402,3311,5091,65
37005, 면부,080004, 78세,2021,9750,3859,5891,65.5,9745,3857,5888,65.5
37005, 면부,080005, 79세,2021,11465,4510,6955,64.8,11461,4507,6954,64.8
37005, 면부,085,80~84세,2021,40607,14377,26230,54.8,40588,14371,26217,54.8
37005, 면부,085001, 80세,2021,8875,3348,5527,60.6,8870,3347,5523,60.6
37005, 면부,085002, 81세,2021,8556,3107,5449,57,8554,3106,5448,57
37005, 면부,085003, 82세,2021,8810,3118,5692,54.8,8804,3117,5687,54.8
37005, 면부,085004, 83세,2021,7482,2535,4947,51.2,7478,2533,4945,51.2
37005, 면부,085005, 84세,2021,6884,2269,4615,49.2,6882,2268,4614,49.2
37005, 면부,090,85~89세,2021,23614,6961,16653,41.8,23600,6956,16644,41.8
37005, 면부,090001, 85세,2021,6245,1991,4254,46.8,6244,1990,4254,46.8
37005, 면부,090002, 86세,2021,5920,1774,4146,42.8,5917,1773,4144,42.8
37005, 면부,090003, 87세,2021,4726,1397,3329,42,4721,1396,3325,42
37005, 면부,090004, 88세,2021,3692,1000,2692,37.1,3689,999,2690,37.1
37005, 면부,090005, 89세,2021,3031,799,2232,35.8,3029,798,2231,35.8
37005, 면부,095,90~94세,2021,7485,1663,5822,28.6,7483,1663,5820,28.6
37005, 면부,095001, 90세,2021,2265,546,1719,31.8,2265,546,1719,31.8
37005, 면부,095002, 91세,2021,1884,417,1467,28.4,1882,417,1465,28.5
37005, 면부,095003, 92세,2021,1423,315,1108,28.4,1423,315,1108,28.4
37005, 면부,095004, 93세,2021,1126,215,911,23.6,1126,215,911,23.6
37005, 면부,095005, 94세,2021,787,170,617,27.6,787,170,617,27.6
37005, 면부,100,95~99세,2021,1479,226,1253,18,1478,226,1252,18.1
37005, 면부,100001, 95세,2021,510,71,439,16.2,509,71,438,16.2
37005, 면부,100002, 96세,2021,376,58,318,18.2,376,58,318,18.2
37005, 면부,100003, 97세,2021,251,37,214,17.3,251,37,214,17.3
37005, 면부,100004, 98세,2021,204,34,170,20,204,34,170,20
37005, 면부,100005, 99세,2021,138,26,112,23.2,138,26,112,23.2
37005, 면부,101,100세이상,2021,218,23,195,11.8,218,23,195,11.8
37005, 면부,102,15세미만,2021,34288,17801,16487,108,34190,17757,16433,108.1
37005, 면부,103,15~64세,2021,323828,180963,142865,126.7,305164,168008,137156,122.5
37005, 면부,104,65세이상,2021,230888,97163,133725,72.7,230562,97014,133548,72.6
37005, 면부,086,85세이상,2021,32796,8873,23923,37.1,32779,8868,23911,37.1
37005, 면부,126,평균연령,2021,56.2,53.3,59.1,,56.9,54.2,59.6,
37005, 면부,127,중위연령,2021,60.6,57.8,63,,61.1,58.9,63.4,
37003, 동부,000,합계,2021,1399119,705101,694018,101.6,1368894,689694,679200,101.5
37003, 동부,005,0~4세,2021,43941,22539,21402,105.3,43266,22196,21070,105.3
37003, 동부,005001, 0세,2021,7233,3655,3578,102.2,7096,3589,3507,102.3
37003, 동부,005002, 1세,2021,7848,4054,3794,106.9,7724,3990,3734,106.9
37003, 동부,005003, 2세,2021,8551,4367,4184,104.4,8422,4301,4121,104.4
37003, 동부,005004, 3세,2021,9639,5028,4611,109,9516,4968,4548,109.2
37003, 동부,005005, 4세,2021,10670,5435,5235,103.8,10508,5348,5160,103.6
37003, 동부,010,5~9세,2021,65887,33871,32016,105.8,65304,33589,31715,105.9
37003, 동부,010001, 5세,2021,12372,6326,6046,104.6,12213,6256,5957,105
37003, 동부,010002, 6세,2021,13164,6666,6498,102.6,13036,6605,6431,102.7
37003, 동부,010003, 7세,2021,12810,6668,6142,108.6,12703,6617,6086,108.7
37003, 동부,010004, 8세,2021,13172,6800,6372,106.7,13081,6754,6327,106.7
37003, 동부,010005, 9세,2021,14369,7411,6958,106.5,14271,7357,6914,106.4
37003, 동부,015,10~14세,2021,67658,35162,32496,108.2,67325,34989,32336,108.2
37003, 동부,015001, 10세,2021,14043,7386,6657,111,13971,7343,6628,110.8
37003, 동부,015002, 11세,2021,13328,6837,6491,105.3,13246,6792,6454,105.2
37003, 동부,015003, 12세,2021,12893,6720,6173,108.9,12845,6694,6151,108.8
37003, 동부,015004, 13세,2021,13531,6994,6537,107,13463,6963,6500,107.1
37003, 동부,015005, 14세,2021,13863,7225,6638,108.8,13800,7197,6603,109
37003, 동부,020,15~19세,2021,69877,37909,31968,118.6,69362,37661,31701,118.8
37003, 동부,020001, 15세,2021,12809,6727,6082,110.6,12748,6699,6049,110.7
37003, 동부,020002, 16세,2021,13046,6854,6192,110.7,12992,6831,6161,110.9
37003, 동부,020003, 17세,2021,14482,7879,6603,119.3,14450,7862,6588,119.3
37003, 동부,020004, 18세,2021,14697,7936,6761,117.4,14602,7890,6712,117.6
37003, 동부,020005, 19세,2021,14843,8513,6330,134.5,14570,8379,6191,135.3
37003, 동부,025,20~24세,2021,91127,51663,39464,130.9,85811,48832,36979,132.1
37003, 동부,025001, 20세,2021,17033,9600,7433,129.2,16544,9356,7188,130.2
37003, 동부,025002, 21세,2021,19270,10793,8477,127.3,18249,10280,7969,129
37003, 동부,025003, 22세,2021,18365,10342,8023,128.9,17134,9672,7462,129.6
37003, 동부,025004, 23세,2021,18088,10363,7725,134.1,16821,9676,7145,135.4
37003, 동부,025005, 24세,2021,18371,10565,7806,135.3,17063,9848,7215,136.5
37003, 동부,030,25~29세,2021,89716,50328,39388,127.8,84531,47574,36957,128.7
37003, 동부,030001, 25세,2021,18347,10443,7904,132.1,17215,9832,7383,133.2
37003, 동부,030002, 26세,2021,18347,10386,7961,130.5,17247,9777,7470,130.9
37003, 동부,030003, 27세,2021,17620,9979,7641,130.6,16652,9466,7186,131.7
37003, 동부,030004, 28세,2021,17503,9736,7767,125.4,16532,9258,7274,127.3
37003, 동부,030005, 29세,2021,17899,9784,8115,120.6,16885,9241,7644,120.9
37003, 동부,035,30~34세,2021,80636,43782,36854,118.8,75850,41324,34526,119.7
37003, 동부,035001, 30세,2021,16606,9098,7508,121.2,15631,8601,7030,122.3
37003, 동부,035002, 31세,2021,16387,9117,7270,125.4,15431,8619,6812,126.5
37003, 동부,035003, 32세,2021,15698,8609,7089,121.4,14714,8103,6611,122.6
37003, 동부,035004, 33세,2021,15693,8468,7225,117.2,14755,7988,6767,118
37003, 동부,035005, 34세,2021,16252,8490,7762,109.4,15319,8013,7306,109.7
37003, 동부,040,35~39세,2021,94354,48521,45833,105.9,90569,46546,44023,105.7
37003, 동부,040001, 35세,2021,16668,8755,7913,110.6,15814,8314,7500,110.9
37003, 동부,040002, 36세,2021,16987,8840,8147,108.5,16175,8399,7776,108
37003, 동부,040003, 37세,2021,17977,9203,8774,104.9,17247,8830,8417,104.9
37003, 동부,040004, 38세,2021,20341,10365,9976,103.9,19659,10015,9644,103.8
37003, 동부,040005, 39세,2021,22381,11358,11023,103,21674,10988,10686,102.8
37003, 동부,045,40~44세,2021,107444,54279,53165,102.1,104755,52914,51841,102.1
37003, 동부,045001, 40세,2021,22326,11336,10990,103.1,21696,11006,10690,103
37003, 동부,045002, 41세,2021,22993,11717,11276,103.9,22400,11416,10984,103.9
37003, 동부,045003, 42세,2021,21406,10814,10592,102.1,20879,10546,10333,102.1
37003, 동부,045004, 43세,2021,19910,10048,9862,101.9,19423,9806,9617,102
37003, 동부,045005, 44세,2021,20809,10364,10445,99.2,20357,10140,10217,99.2
37003, 동부,050,45~49세,2021,115347,56899,58448,97.3,113320,55901,57419,97.4
37003, 동부,050001, 45세,2021,20642,10173,10469,97.2,20216,9971,10245,97.3
37003, 동부,050002, 46세,2021,22357,11002,11355,96.9,21966,10810,11156,96.9
37003, 동부,050003, 47세,2021,24047,11835,12212,96.9,23644,11628,12016,96.8
37003, 동부,050004, 48세,2021,24138,11717,12421,94.3,23726,11514,12212,94.3
37003, 동부,050005, 49세,2021,24163,12172,11991,101.5,23768,11978,11790,101.6
37003, 동부,055,50~54세,2021,124775,62194,62581,99.4,123146,61415,61731,99.5
37003, 동부,055001, 50세,2021,25192,12709,12483,101.8,24836,12520,12316,101.7
37003, 동부,055002, 51세,2021,25284,12589,12695,99.2,24926,12405,12521,99.1
37003, 동부,055003, 52세,2021,25168,12546,12622,99.4,24836,12394,12442,99.6
37003, 동부,055004, 53세,2021,26003,12938,13065,99,25690,12804,12886,99.4
37003, 동부,055005, 54세,2021,23128,11412,11716,97.4,22858,11292,11566,97.6
37003, 동부,060,55~59세,2021,113436,57040,56396,101.1,112237,56465,55772,101.2
37003, 동부,060001, 55세,2021,22920,11714,11206,104.5,22667,11589,11078,104.6
37003, 동부,060002, 56세,2021,23035,11345,11690,97,22766,11214,11552,97.1
37003, 동부,060003, 57세,2021,21428,10881,10547,103.2,21184,10767,10417,103.4
37003, 동부,060004, 58세,2021,22954,11558,11396,101.4,22728,11449,11279,101.5
37003, 동부,060005, 59세,2021,23099,11542,11557,99.9,22892,11446,11446,100
37003, 동부,065,60~64세,2021,110954,54297,56657,95.8,110207,53960,56247,95.9
37003, 동부,065001, 60세,2021,25137,12464,12673,98.4,24987,12389,12598,98.3
37003, 동부,065002, 61세,2021,24535,11897,12638,94.1,24345,11817,12528,94.3
37003, 동부,065003, 62세,2021,21827,10635,11192,95,21695,10569,11126,95
37003, 동부,065004, 63세,2021,19538,9490,10048,94.4,19399,9435,9964,94.7
37003, 동부,065005, 64세,2021,19917,9811,10106,97.1,19781,9750,10031,97.2
37003, 동부,070,65~69세,2021,81463,38835,42628,91.1,81074,38671,42403,91.2
37003, 동부,070001, 65세,2021,18524,8976,9548,94,18427,8935,9492,94.1
37003, 동부,070002, 66세,2021,17932,8514,9418,90.4,17842,8473,9369,90.4
37003, 동부,070003, 67세,2021,15491,7519,7972,94.3,15414,7487,7927,94.4
37003, 동부,070004, 68세,2021,14425,6760,7665,88.2,14354,6733,7621,88.3
37003, 동부,070005, 69세,2021,15091,7066,8025,88,15037,7043,7994,88.1
37003, 동부,075,70~74세,2021,55376,26074,29302,89,55180,26000,29180,89.1
37003, 동부,075001, 70세,2021,11300,5311,5989,88.7,11243,5286,5957,88.7
37003, 동부,075002, 71세,2021,11305,5426,5879,92.3,11257,5410,5847,92.5
37003, 동부,075003, 72세,2021,11740,5606,6134,91.4,11708,5593,6115,91.5
37003, 동부,075004, 73세,2021,11034,5131,5903,86.9,11001,5119,5882,87
37003, 동부,075005, 74세,2021,9997,4600,5397,85.2,9971,4592,5379,85.4
37003, 동부,080,75~79세,2021,37835,16124,21711,74.3,37752,16093,21659,74.3
37003, 동부,080001, 75세,2021,6600,3064,3536,86.7,6575,3054,3521,86.7
37003, 동부,080002, 76세,2021,6722,2973,3749,79.3,6708,2965,3743,79.2
37003, 동부,080003, 77세,2021,7640,3237,4403,73.5,7623,3234,4389,73.7
37003, 동부,080004, 78세,2021,8187,3373,4814,70.1,8174,3368,4806,70.1
37003, 동부,080005, 79세,2021,8686,3477,5209,66.7,8672,3472,5200,66.8
37003, 동부,085,80~84세,2021,28169,10167,18002,56.5,28114,10154,17960,56.5
37003, 동부,085001, 80세,2021,6600,2546,4054,62.8,6588,2544,4044,62.9
37003, 동부,085002, 81세,2021,6142,2297,3845,59.7,6130,2294,3836,59.8
37003, 동부,085003, 82세,2021,5962,2181,3781,57.7,5953,2179,3774,57.7
37003, 동부,085004, 83세,2021,5095,1718,3377,50.9,5083,1714,3369,50.9
37003, 동부,085005, 84세,2021,4370,1425,2945,48.4,4360,1423,2937,48.5
37003, 동부,090,85~89세,2021,14962,4252,10710,39.7,14938,4247,10691,39.7
37003, 동부,090001, 85세,2021,4010,1258,2752,45.7,3998,1255,2743,45.8
37003, 동부,090002, 86세,2021,3524,1033,2491,41.5,3519,1033,2486,41.6
37003, 동부,090003, 87세,2021,2961,817,2144,38.1,2957,817,2140,38.2
37003, 동부,090004, 88세,2021,2394,629,1765,35.6,2392,628,1764,35.6
37003, 동부,090005, 89세,2021,2073,515,1558,33.1,2072,514,1558,33
37003, 동부,095,90~94세,2021,4994,1004,3990,25.2,4988,1003,3985,25.2
37003, 동부,095001, 90세,2021,1448,320,1128,28.4,1448,320,1128,28.4
37003, 동부,095002, 91세,2021,1242,249,993,25.1,1241,249,992,25.1
37003, 동부,095003, 92세,2021,977,192,785,24.5,973,191,782,24.4
37003, 동부,095004, 93세,2021,769,141,628,22.5,769,141,628,22.5
37003, 동부,095005, 94세,2021,558,102,456,22.4,557,102,455,22.4
37003, 동부,100,95~99세,2021,1014,153,861,17.8,1011,152,859,17.7
37003, 동부,100001, 95세,2021,335,57,278,20.5,334,56,278,20.1
37003, 동부,100002, 96세,2021,281,46,235,19.6,280,46,234,19.7
37003, 동부,100003, 97세,2021,158,26,132,19.7,158,26,132,19.7
37003, 동부,100004, 98세,2021,147,12,135,8.9,147,12,135,8.9
37003, 동부,100005, 99세,2021,93,12,81,14.8,92,12,80,15
37003, 동부,101,100세이상,2021,154,8,146,5.5,154,8,146,5.5
37003, 동부,102,15세미만,2021,177486,91572,85914,106.6,175895,90774,85121,106.6
37003, 동부,103,15~64세,2021,997666,516912,480754,107.5,969788,502592,467196,107.6
37003, 동부,104,65세이상,2021,223967,96617,127350,75.9,223211,96328,126883,75.9
37003, 동부,086,85세이상,2021,21124,5417,15707,34.5,21091,5410,15681,34.5
37003, 동부,126,평균연령,2021,42.9,41.4,44.4,,43.1,41.6,44.6,
37003, 동부,127,중위연령,2021,44.5,42.5,46.3,,44.9,42.9,46.7,
37010, 포항시,000,합계,2021,501251,254482,246769,103.1,493210,249846,243364,102.7
37010, 포항시,005,0~4세,2021,14492,7497,6995,107.2,14377,7435,6942,107.1
37010, 포항시,005001, 0세,2021,2267,1147,1120,102.4,2253,1139,1114,102.2
37010, 포항시,005002, 1세,2021,2558,1336,1222,109.3,2540,1329,1211,109.7
37010, 포항시,005003, 2세,2021,2901,1473,1428,103.2,2873,1456,1417,102.8
37010, 포항시,005004, 3세,2021,3194,1694,1500,112.9,3174,1682,1492,112.7
37010, 포항시,005005, 4세,2021,3572,1847,1725,107.1,3537,1829,1708,107.1
37010, 포항시,010,5~9세,2021,22923,11898,11025,107.9,22786,11834,10952,108.1
37010, 포항시,010001, 5세,2021,4274,2235,2039,109.6,4230,2213,2017,109.7
37010, 포항시,010002, 6세,2021,4633,2396,2237,107.1,4599,2378,2221,107.1
37010, 포항시,010003, 7세,2021,4521,2309,2212,104.4,4495,2299,2196,104.7
37010, 포항시,010004, 8세,2021,4583,2329,2254,103.3,4556,2319,2237,103.7
37010, 포항시,010005, 9세,2021,4912,2629,2283,115.2,4906,2625,2281,115.1
37010, 포항시,015,10~14세,2021,23060,11960,11100,107.7,23000,11926,11074,107.7
37010, 포항시,015001, 10세,2021,4872,2539,2333,108.8,4856,2533,2323,109
37010, 포항시,015002, 11세,2021,4651,2413,2238,107.8,4636,2400,2236,107.3
37010, 포항시,015003, 12세,2021,4429,2307,2122,108.7,4418,2300,2118,108.6
37010, 포항시,015004, 13세,2021,4516,2324,2192,106,4509,2321,2188,106.1
37010, 포항시,015005, 14세,2021,4592,2377,2215,107.3,4581,2372,2209,107.4
37010, 포항시,020,15~19세,2021,21729,11756,9973,117.9,21665,11728,9937,118
37010, 포항시,020001, 15세,2021,4334,2285,2049,111.5,4326,2280,2046,111.4
37010, 포항시,020002, 16세,2021,4347,2331,2016,115.6,4339,2327,2012,115.7
37010, 포항시,020003, 17세,2021,4582,2421,2161,112,4578,2419,2159,112
37010, 포항시,020004, 18세,2021,4539,2405,2134,112.7,4527,2401,2126,112.9
37010, 포항시,020005, 19세,2021,3927,2314,1613,143.5,3895,2301,1594,144.4
37010, 포항시,025,20~24세,2021,26773,15560,11213,138.8,25646,15006,10640,141
37010, 포항시,025001, 20세,2021,4911,2997,1914,156.6,4797,2947,1850,159.3
37010, 포항시,025002, 21세,2021,5635,3377,2258,149.6,5430,3297,2133,154.6
37010, 포항시,025003, 22세,2021,5229,2964,2265,130.9,5006,2858,2148,133.1
37010, 포항시,025004, 23세,2021,5323,3010,2313,130.1,5049,2864,2185,131.1
37010, 포항시,025005, 24세,2021,5675,3212,2463,130.4,5364,3040,2324,130.8
37010, 포항시,030,25~29세,2021,29234,17112,12122,141.2,27775,16189,11586,139.7
37010, 포항시,030001, 25세,2021,6002,3486,2516,138.6,5704,3302,2402,137.5
37010, 포항시,030002, 26세,2021,5885,3425,2460,139.2,5606,3246,2360,137.5
37010, 포항시,030003, 27세,2021,5790,3452,2338,147.6,5522,3284,2238,146.7
37010, 포항시,030004, 28세,2021,5756,3359,2397,140.1,5451,3171,2280,139.1
37010, 포항시,030005, 29세,2021,5801,3390,2411,140.6,5492,3186,2306,138.2
37010, 포항시,035,30~34세,2021,26585,14839,11746,126.3,25069,13879,11190,124
37010, 포항시,035001, 30세,2021,5481,3189,2292,139.1,5168,2978,2190,136
37010, 포항시,035002, 31세,2021,5517,3090,2427,127.3,5213,2913,2300,126.7
37010, 포항시,035003, 32세,2021,5261,2972,2289,129.8,4931,2758,2173,126.9
37010, 포항시,035004, 33세,2021,5086,2779,2307,120.5,4789,2595,2194,118.3
37010, 포항시,035005, 34세,2021,5240,2809,2431,115.5,4968,2635,2333,112.9
37010, 포항시,040,35~39세,2021,32336,16822,15514,108.4,31130,16092,15038,107
37010, 포항시,040001, 35세,2021,5539,2978,2561,116.3,5266,2808,2458,114.2
37010, 포항시,040002, 36세,2021,5671,2923,2748,106.4,5404,2760,2644,104.4
37010, 포항시,040003, 37세,2021,6314,3257,3057,106.5,6060,3107,2953,105.2
37010, 포항시,040004, 38세,2021,7019,3708,3311,112,6806,3575,3231,110.6
37010, 포항시,040005, 39세,2021,7793,3956,3837,103.1,7594,3842,3752,102.4
37010, 포항시,045,40~44세,2021,37075,18998,18077,105.1,36304,18522,17782,104.2
37010, 포항시,045001, 40세,2021,7918,4094,3824,107.1,7716,3975,3741,106.3
37010, 포항시,045002, 41세,2021,7776,3984,3792,105.1,7614,3887,3727,104.3
37010, 포항시,045003, 42세,2021,7418,3732,3686,101.2,7267,3631,3636,99.9
37010, 포항시,045004, 43세,2021,6783,3523,3260,108.1,6651,3437,3214,106.9
37010, 포항시,045005, 44세,2021,7180,3665,3515,104.3,7056,3592,3464,103.7
37010, 포항시,050,45~49세,2021,38890,19492,19398,100.5,38365,19182,19183,100
37010, 포항시,050001, 45세,2021,6677,3360,3317,101.3,6558,3291,3267,100.7
37010, 포항시,050002, 46세,2021,7406,3751,3655,102.6,7299,3688,3611,102.1
37010, 포항시,050003, 47세,2021,8177,4069,4108,99.1,8082,4011,4071,98.5
37010, 포항시,050004, 48세,2021,8343,4162,4181,99.5,8227,4088,4139,98.8
37010, 포항시,050005, 49세,2021,8287,4150,4137,100.3,8199,4104,4095,100.2
37010, 포항시,055,50~54세,2021,44659,22535,22124,101.9,44227,22313,21914,101.8
37010, 포항시,055001, 50세,2021,8840,4428,4412,100.4,8728,4371,4357,100.3
37010, 포항시,055002, 51세,2021,8988,4478,4510,99.3,8900,4428,4472,99
37010, 포항시,055003, 52세,2021,8939,4580,4359,105.1,8844,4530,4314,105
37010, 포항시,055004, 53세,2021,9489,4847,4642,104.4,9415,4814,4601,104.6
37010, 포항시,055005, 54세,2021,8403,4202,4201,100,8340,4170,4170,100
37010, 포항시,060,55~59세,2021,43822,21855,21967,99.5,43541,21730,21811,99.6
37010, 포항시,060001, 55세,2021,8594,4397,4197,104.8,8545,4379,4166,105.1
37010, 포항시,060002, 56세,2021,8940,4318,4622,93.4,8878,4286,4592,93.3
37010, 포항시,060003, 57세,2021,8087,4011,4076,98.4,8029,3988,4041,98.7
37010, 포항시,060004, 58세,2021,8976,4447,4529,98.2,8912,4420,4492,98.4
37010, 포항시,060005, 59세,2021,9225,4682,4543,103.1,9177,4657,4520,103
37010, 포항시,065,60~64세,2021,46524,22584,23940,94.3,46362,22509,23853,94.4
37010, 포항시,065001, 60세,2021,10104,4992,5112,97.7,10075,4980,5095,97.7
37010, 포항시,065002, 61세,2021,10024,4830,5194,93,9982,4812,5170,93.1
37010, 포항시,065003, 62세,2021,9341,4451,4890,91,9316,4436,4880,90.9
37010, 포항시,065004, 63세,2021,8452,4030,4422,91.1,8416,4015,4401,91.2
37010, 포항시,065005, 64세,2021,8603,4281,4322,99.1,8573,4266,4307,99
37010, 포항시,070,65~69세,2021,35696,17643,18053,97.7,35613,17607,18006,97.8
37010, 포항시,070001, 65세,2021,7981,3882,4099,94.7,7964,3874,4090,94.7
37010, 포항시,070002, 66세,2021,8115,3952,4163,94.9,8094,3944,4150,95
37010, 포항시,070003, 67세,2021,6881,3509,3372,104.1,6865,3500,3365,104
37010, 포항시,070004, 68세,2021,6203,3070,3133,98,6189,3064,3125,98
37010, 포항시,070005, 69세,2021,6516,3230,3286,98.3,6501,3225,3276,98.4
37010, 포항시,075,70~74세,2021,23122,11374,11748,96.8,23061,11351,11710,96.9
37010, 포항시,075001, 70세,2021,4840,2397,2443,98.1,4822,2390,2432,98.3
37010, 포항시,075002, 71세,2021,4694,2358,2336,100.9,4681,2351,2330,100.9
37010, 포항시,075003, 72세,2021,4878,2380,2498,95.3,4871,2378,2493,95.4
37010, 포항시,075004, 73세,2021,4516,2212,2304,96,4504,2207,2297,96.1
37010, 포항시,075005, 74세,2021,4194,2027,2167,93.5,4183,2025,2158,93.8
37010, 포항시,080,75~79세,2021,15192,6628,8564,77.4,15172,6620,8552,77.4
37010, 포항시,080001, 75세,2021,2759,1331,1428,93.2,2754,1329,1425,93.3
37010, 포항시,080002, 76세,2021,2815,1262,1553,81.3,2807,1259,1548,81.3
37010, 포항시,080003, 77세,2021,3087,1360,1727,78.7,3085,1360,1725,78.8
37010, 포항시,080004, 78세,2021,3166,1320,1846,71.5,3164,1319,1845,71.5
37010, 포항시,080005, 79세,2021,3365,1355,2010,67.4,3362,1353,2009,67.3
37010, 포항시,085,80~84세,2021,10955,3996,6959,57.4,10939,3992,6947,57.5
37010, 포항시,085001, 80세,2021,2667,1054,1613,65.3,2663,1052,1611,65.3
37010, 포항시,085002, 81세,2021,2396,917,1479,62,2393,916,1477,62
37010, 포항시,085003, 82세,2021,2305,854,1451,58.9,2303,853,1450,58.8
37010, 포항시,085004, 83세,2021,1907,609,1298,46.9,1904,609,1295,47
37010, 포항시,085005, 84세,2021,1680,562,1118,50.3,1676,562,1114,50.4
37010, 포항시,090,85~89세,2021,5731,1499,4232,35.4,5727,1498,4229,35.4
37010, 포항시,090001, 85세,2021,1554,461,1093,42.2,1552,460,1092,42.1
37010, 포항시,090002, 86세,2021,1339,349,990,35.3,1339,349,990,35.3
37010, 포항시,090003, 87세,2021,1134,302,832,36.3,1133,302,831,36.3
37010, 포항시,090004, 88세,2021,908,211,697,30.3,907,211,696,30.3
37010, 포항시,090005, 89세,2021,796,176,620,28.4,796,176,620,28.4
37010, 포항시,095,90~94세,2021,1997,364,1633,22.3,1995,363,1632,22.2
37010, 포항시,095001, 90세,2021,585,125,460,27.2,585,125,460,27.2
37010, 포항시,095002, 91세,2021,471,93,378,24.6,471,93,378,24.6
37010, 포항시,095003, 92세,2021,409,76,333,22.8,407,75,332,22.6
37010, 포항시,095004, 93세,2021,299,38,261,14.6,299,38,261,14.6
37010, 포항시,095005, 94세,2021,233,32,201,15.9,233,32,201,15.9
37010, 포항시,100,95~99세,2021,399,67,332,20.2,399,67,332,20.2
37010, 포항시,100001, 95세,2021,126,17,109,15.6,126,17,109,15.6
37010, 포항시,100002, 96세,2021,107,19,88,21.6,107,19,88,21.6
37010, 포항시,100003, 97세,2021,70,11,59,18.6,70,11,59,18.6
37010, 포항시,100004, 98세,2021,60,13,47,27.7,60,13,47,27.7
37010, 포항시,100005, 99세,2021,36,7,29,24.1,36,7,29,24.1
37010, 포항시,101,100세이상,2021,57,X,54,5.6,57,X,54,5.6
37010, 포항시,102,15세미만,2021,60475,31355,29120,107.7,60163,31195,28968,107.7
37010, 포항시,103,15~64세,2021,347627,181553,166074,109.3,340084,177150,162934,108.7
37010, 포항시,104,65세이상,2021,93149,41574,51575,80.6,92963,41501,51462,80.6
37010, 포항시,086,85세이상,2021,8184,1933,6251,30.9,8178,1931,6247,30.9
37010, 포항시,126,평균연령,2021,44.8,43.3,46.4,,44.9,43.4,46.5,
37010, 포항시,127,중위연령,2021,47.3,45.2,49.1,,47.6,45.7,49.4,
37011, 남구,000,합계,2021,228869,119399,109470,109.1,224701,116756,107945,108.2
37011, 남구,005,0~4세,2021,6128,3173,2955,107.4,6084,3149,2935,107.3
37011, 남구,005001, 0세,2021,1005,518,487,106.4,999,512,487,105.1
37011, 남구,005002, 1세,2021,1091,555,536,103.5,1083,554,529,104.7
37011, 남구,005003, 2세,2021,1204,615,589,104.4,1192,608,584,104.1
37011, 남구,005004, 3세,2021,1311,689,622,110.8,1304,685,619,110.7
37011, 남구,005005, 4세,2021,1517,796,721,110.4,1506,790,716,110.3
37011, 남구,010,5~9세,2021,10274,5325,4949,107.6,10229,5302,4927,107.6
37011, 남구,010001, 5세,2021,1873,986,887,111.2,1858,978,880,111.1
37011, 남구,010002, 6세,2021,2074,1070,1004,106.6,2064,1065,999,106.6
37011, 남구,010003, 7세,2021,2018,1038,980,105.9,2008,1034,974,106.2
37011, 남구,010004, 8세,2021,2044,1033,1011,102.2,2034,1027,1007,102
37011, 남구,010005, 9세,2021,2265,1198,1067,112.3,2265,1198,1067,112.3
37011, 남구,015,10~14세,2021,10557,5476,5081,107.8,10528,5463,5065,107.9
37011, 남구,015001, 10세,2021,2216,1152,1064,108.3,2207,1151,1056,109
37011, 남구,015002, 11세,2021,2150,1110,1040,106.7,2142,1103,1039,106.2
37011, 남구,015003, 12세,2021,2011,1064,947,112.4,2006,1061,945,112.3
37011, 남구,015004, 13세,2021,2095,1076,1019,105.6,2093,1076,1017,105.8
37011, 남구,015005, 14세,2021,2085,1074,1011,106.2,2080,1072,1008,106.3
37011, 남구,020,15~19세,2021,9912,5536,4376,126.5,9899,5527,4372,126.4
37011, 남구,020001, 15세,2021,1979,1032,947,109,1976,1030,946,108.9
37011, 남구,020002, 16세,2021,2054,1123,931,120.6,2050,1120,930,120.4
37011, 남구,020003, 17세,2021,2203,1182,1021,115.8,2201,1180,1021,115.6
37011, 남구,020004, 18세,2021,2096,1178,918,128.3,2096,1178,918,128.3
37011, 남구,020005, 19세,2021,1580,1021,559,182.6,1576,1019,557,182.9
37011, 남구,025,20~24세,2021,11538,7175,4363,164.5,11206,6992,4214,165.9
37011, 남구,025001, 20세,2021,2053,1372,681,201.5,2030,1363,667,204.3
37011, 남구,025002, 21세,2021,2326,1544,782,197.4,2286,1530,756,202.4
37011, 남구,025003, 22세,2021,2187,1313,874,150.2,2125,1280,845,151.5
37011, 남구,025004, 23세,2021,2303,1375,928,148.2,2217,1323,894,148
37011, 남구,025005, 24세,2021,2669,1571,1098,143.1,2548,1496,1052,142.2
37011, 남구,030,25~29세,2021,14300,8709,5591,155.8,13542,8196,5346,153.3
37011, 남구,030001, 25세,2021,2915,1756,1159,151.5,2778,1664,1114,149.4
37011, 남구,030002, 26세,2021,2867,1707,1160,147.2,2737,1625,1112,146.1
37011, 남구,030003, 27세,2021,2879,1793,1086,165.1,2731,1689,1042,162.1
37011, 남구,030004, 28세,2021,2853,1741,1112,156.6,2689,1632,1057,154.4
37011, 남구,030005, 29세,2021,2786,1712,1074,159.4,2607,1586,1021,155.3
37011, 남구,035,30~34세,2021,12298,7157,5141,139.2,11365,6522,4843,134.7
37011, 남구,035001, 30세,2021,2616,1604,1012,158.5,2428,1462,966,151.3
37011, 남구,035002, 31세,2021,2622,1510,1112,135.8,2439,1402,1037,135.2
37011, 남구,035003, 32세,2021,2381,1416,965,146.7,2173,1276,897,142.3
37011, 남구,035004, 33세,2021,2284,1311,973,134.7,2096,1178,918,128.3
37011, 남구,035005, 34세,2021,2395,1316,1079,122,2229,1204,1025,117.5
37011, 남구,040,35~39세,2021,14707,7825,6882,113.7,13976,7338,6638,110.5
37011, 남구,040001, 35세,2021,2544,1388,1156,120.1,2375,1279,1096,116.7
37011, 남구,040002, 36세,2021,2636,1395,1241,112.4,2460,1281,1179,108.7
37011, 남구,040003, 37세,2021,2748,1475,1273,115.9,2609,1379,1230,112.1
37011, 남구,040004, 38세,2021,3171,1703,1468,116,3049,1619,1430,113.2
37011, 남구,040005, 39세,2021,3608,1864,1744,106.9,3483,1780,1703,104.5
37011, 남구,045,40~44세,2021,17229,9142,8087,113,16785,8835,7950,111.1
37011, 남구,045001, 40세,2021,3678,1965,1713,114.7,3563,1889,1674,112.8
37011, 남구,045002, 41세,2021,3619,1896,1723,110,3528,1836,1692,108.5
37011, 남구,045003, 42세,2021,3437,1811,1626,111.4,3348,1745,1603,108.9
37011, 남구,045004, 43세,2021,3164,1702,1462,116.4,3080,1643,1437,114.3
37011, 남구,045005, 44세,2021,3331,1768,1563,113.1,3266,1722,1544,111.5
37011, 남구,050,45~49세,2021,18041,9303,8738,106.5,17742,9117,8625,105.7
37011, 남구,050001, 45세,2021,3097,1624,1473,110.3,3024,1580,1444,109.4
37011, 남구,050002, 46세,2021,3454,1763,1691,104.3,3396,1729,1667,103.7
37011, 남구,050003, 47세,2021,3852,1971,1881,104.8,3796,1940,1856,104.5
37011, 남구,050004, 48세,2021,3841,2013,1828,110.1,3778,1964,1814,108.3
37011, 남구,050005, 49세,2021,3797,1932,1865,103.6,3748,1904,1844,103.3
37011, 남구,055,50~54세,2021,20727,10910,9817,111.1,20502,10786,9716,111
37011, 남구,055001, 50세,2021,4073,2113,1960,107.8,4009,2078,1931,107.6
37011, 남구,055002, 51세,2021,4114,2172,1942,111.8,4065,2142,1923,111.4
37011, 남구,055003, 52세,2021,4076,2149,1927,111.5,4036,2125,1911,111.2
37011, 남구,055004, 53세,2021,4463,2373,2090,113.5,4425,2356,2069,113.9
37011, 남구,055005, 54세,2021,4001,2103,1898,110.8,3967,2085,1882,110.8
37011, 남구,060,55~59세,2021,19734,10111,9623,105.1,19596,10046,9550,105.2
37011, 남구,060001, 55세,2021,3911,2097,1814,115.6,3883,2086,1797,116.1
37011, 남구,060002, 56세,2021,4036,2015,2021,99.7,4005,2000,2005,99.8
37011, 남구,060003, 57세,2021,3622,1815,1807,100.4,3597,1805,1792,100.7
37011, 남구,060004, 58세,2021,4006,2034,1972,103.1,3976,2021,1955,103.4
37011, 남구,060005, 59세,2021,4159,2150,2009,107,4135,2134,2001,106.6
37011, 남구,065,60~64세,2021,21292,10387,10905,95.2,21209,10347,10862,95.3
37011, 남구,065001, 60세,2021,4573,2302,2271,101.4,4554,2294,2260,101.5
37011, 남구,065002, 61세,2021,4553,2244,2309,97.2,4535,2235,2300,97.2
37011, 남구,065003, 62세,2021,4316,2075,2241,92.6,4303,2065,2238,92.3
37011, 남구,065004, 63세,2021,3829,1767,2062,85.7,3812,1761,2051,85.9
37011, 남구,065005, 64세,2021,4021,1999,2022,98.9,4005,1992,2013,99
37011, 남구,070,65~69세,2021,16698,8297,8401,98.8,16647,8278,8369,98.9
37011, 남구,070001, 65세,2021,3720,1805,1915,94.3,3708,1800,1908,94.3
37011, 남구,070002, 66세,2021,3777,1898,1879,101,3766,1894,1872,101.2
37011, 남구,070003, 67세,2021,3179,1619,1560,103.8,3172,1616,1556,103.9
37011, 남구,070004, 68세,2021,2885,1426,1459,97.7,2875,1422,1453,97.9
37011, 남구,070005, 69세,2021,3137,1549,1588,97.5,3126,1546,1580,97.8
37011, 남구,075,70~74세,2021,10750,5303,5447,97.4,10723,5293,5430,97.5
37011, 남구,075001, 70세,2021,2251,1105,1146,96.4,2245,1102,1143,96.4
37011, 남구,075002, 71세,2021,2170,1107,1063,104.1,2165,1104,1061,104.1
37011, 남구,075003, 72세,2021,2323,1125,1198,93.9,2319,1125,1194,94.2
37011, 남구,075004, 73세,2021,2065,1024,1041,98.4,2058,1021,1037,98.5
37011, 남구,075005, 74세,2021,1941,942,999,94.3,1936,941,995,94.6
37011, 남구,080,75~79세,2021,6862,3102,3760,82.5,6854,3099,3755,82.5
37011, 남구,080001, 75세,2021,1258,605,653,92.6,1256,605,651,92.9
37011, 남구,080002, 76세,2021,1294,595,699,85.1,1290,594,696,85.3
37011, 남구,080003, 77세,2021,1372,621,751,82.7,1372,621,751,82.7
37011, 남구,080004, 78세,2021,1455,651,804,81,1454,650,804,80.8
37011, 남구,080005, 79세,2021,1483,630,853,73.9,1482,629,853,73.7
37011, 남구,085,80~84세,2021,4651,1727,2924,59.1,4646,1725,2921,59.1
37011, 남구,085001, 80세,2021,1160,463,697,66.4,1159,462,697,66.3
37011, 남구,085002, 81세,2021,1022,402,620,64.8,1022,402,620,64.8
37011, 남구,085003, 82세,2021,964,358,606,59.1,963,357,606,58.9
37011, 남구,085004, 83세,2021,789,263,526,50,789,263,526,50
37011, 남구,085005, 84세,2021,716,241,475,50.7,713,241,472,51.1
37011, 남구,090,85~89세,2021,2318,601,1717,35,2316,601,1715,35
37011, 남구,090001, 85세,2021,674,196,478,41,673,196,477,41.1
37011, 남구,090002, 86세,2021,538,141,397,35.5,538,141,397,35.5
37011, 남구,090003, 87세,2021,452,122,330,37,452,122,330,37
37011, 남구,090004, 88세,2021,347,77,270,28.5,346,77,269,28.6
37011, 남구,090005, 89세,2021,307,65,242,26.9,307,65,242,26.9
37011, 남구,095,90~94세,2021,694,116,578,20.1,693,116,577,20.1
37011, 남구,095001, 90세,2021,216,47,169,27.8,216,47,169,27.8
37011, 남구,095002, 91세,2021,164,29,135,21.5,164,29,135,21.5
37011, 남구,095003, 92세,2021,127,19,108,17.6,126,19,107,17.8
37011, 남구,095004, 93세,2021,107,11,96,11.5,107,11,96,11.5
37011, 남구,095005, 94세,2021,80,10,70,14.3,80,10,70,14.3
37011, 남구,100,95~99세,2021,138,23,115,20,138,23,115,20
37011, 남구,100001, 95세,2021,44,5,39,12.8,44,5,39,12.8
37011, 남구,100002, 96세,2021,38,8,30,26.7,38,8,30,26.7
37011, 남구,100003, 97세,2021,25,X,22,13.6,25,X,22,13.6
37011, 남구,100004, 98세,2021,20,X,17,17.6,20,X,17,17.6
37011, 남구,100005, 99세,2021,11,X,7,57.1,11,X,7,57.1
37011, 남구,101,100세이상,2021,21,X,20,5,21,X,20,5
37011, 남구,102,15세미만,2021,26959,13974,12985,107.6,26841,13914,12927,107.6
37011, 남구,103,15~64세,2021,159778,86255,73523,117.3,155822,83706,72116,116.1
37011, 남구,104,65세이상,2021,42132,19170,22962,83.5,42038,19136,22902,83.6
37011, 남구,086,85세이상,2021,3171,741,2430,30.5,3168,741,2427,30.5
37011, 남구,126,평균연령,2021,44.8,43.3,46.4,,44.9,43.4,46.6,
37011, 남구,127,중위연령,2021,47.2,45.1,49.2,,47.6,45.7,49.5,
37012, 북구,000,합계,2021,272382,135083,137299,98.4,268509,133090,135419,98.3
37012, 북구,005,0~4세,2021,8364,4324,4040,107,8293,4286,4007,107
37012, 북구,005001, 0세,2021,1262,629,633,99.4,1254,627,627,100
37012, 북구,005002, 1세,2021,1467,781,686,113.8,1457,775,682,113.6
37012, 북구,005003, 2세,2021,1697,858,839,102.3,1681,848,833,101.8
37012, 북구,005004, 3세,2021,1883,1005,878,114.5,1870,997,873,114.2
37012, 북구,005005, 4세,2021,2055,1051,1004,104.7,2031,1039,992,104.7
37012, 북구,010,5~9세,2021,12649,6573,6076,108.2,12557,6532,6025,108.4
37012, 북구,010001, 5세,2021,2401,1249,1152,108.4,2372,1235,1137,108.6
37012, 북구,010002, 6세,2021,2559,1326,1233,107.5,2535,1313,1222,107.4
37012, 북구,010003, 7세,2021,2503,1271,1232,103.2,2487,1265,1222,103.5
37012, 북구,010004, 8세,2021,2539,1296,1243,104.3,2522,1292,1230,105
37012, 북구,010005, 9세,2021,2647,1431,1216,117.7,2641,1427,1214,117.5
37012, 북구,015,10~14세,2021,12503,6484,6019,107.7,12472,6463,6009,107.6
37012, 북구,015001, 10세,2021,2656,1387,1269,109.3,2649,1382,1267,109.1
37012, 북구,015002, 11세,2021,2501,1303,1198,108.8,2494,1297,1197,108.4
37012, 북구,015003, 12세,2021,2418,1243,1175,105.8,2412,1239,1173,105.6
37012, 북구,015004, 13세,2021,2421,1248,1173,106.4,2416,1245,1171,106.3
37012, 북구,015005, 14세,2021,2507,1303,1204,108.2,2501,1300,1201,108.2
37012, 북구,020,15~19세,2021,11817,6220,5597,111.1,11766,6201,5565,111.4
37012, 북구,020001, 15세,2021,2355,1253,1102,113.7,2350,1250,1100,113.6
37012, 북구,020002, 16세,2021,2293,1208,1085,111.3,2289,1207,1082,111.6
37012, 북구,020003, 17세,2021,2379,1239,1140,108.7,2377,1239,1138,108.9
37012, 북구,020004, 18세,2021,2443,1227,1216,100.9,2431,1223,1208,101.2
37012, 북구,020005, 19세,2021,2347,1293,1054,122.7,2319,1282,1037,123.6
37012, 북구,025,20~24세,2021,15235,8385,6850,122.4,14440,8014,6426,124.7
37012, 북구,025001, 20세,2021,2858,1625,1233,131.8,2767,1584,1183,133.9
37012, 북구,025002, 21세,2021,3309,1833,1476,124.2,3144,1767,1377,128.3
37012, 북구,025003, 22세,2021,3042,1651,1391,118.7,2881,1578,1303,121.1
37012, 북구,025004, 23세,2021,3020,1635,1385,118.1,2832,1541,1291,119.4
37012, 북구,025005, 24세,2021,3006,1641,1365,120.2,2816,1544,1272,121.4
37012, 북구,030,25~29세,2021,14934,8403,6531,128.7,14233,7993,6240,128.1
37012, 북구,030001, 25세,2021,3087,1730,1357,127.5,2926,1638,1288,127.2
37012, 북구,030002, 26세,2021,3018,1718,1300,132.2,2869,1621,1248,129.9
37012, 북구,030003, 27세,2021,2911,1659,1252,132.5,2791,1595,1196,133.4
37012, 북구,030004, 28세,2021,2903,1618,1285,125.9,2762,1539,1223,125.8
37012, 북구,030005, 29세,2021,3015,1678,1337,125.5,2885,1600,1285,124.5
37012, 북구,035,30~34세,2021,14287,7682,6605,116.3,13704,7357,6347,115.9
37012, 북구,035001, 30세,2021,2865,1585,1280,123.8,2740,1516,1224,123.9
37012, 북구,035002, 31세,2021,2895,1580,1315,120.2,2774,1511,1263,119.6
37012, 북구,035003, 32세,2021,2880,1556,1324,117.5,2758,1482,1276,116.1
37012, 북구,035004, 33세,2021,2802,1468,1334,110,2693,1417,1276,111.1
37012, 북구,035005, 34세,2021,2845,1493,1352,110.4,2739,1431,1308,109.4
37012, 북구,040,35~39세,2021,17629,8997,8632,104.2,17154,8754,8400,104.2
37012, 북구,040001, 35세,2021,2995,1590,1405,113.2,2891,1529,1362,112.3
37012, 북구,040002, 36세,2021,3035,1528,1507,101.4,2944,1479,1465,101
37012, 북구,040003, 37세,2021,3566,1782,1784,99.9,3451,1728,1723,100.3
37012, 북구,040004, 38세,2021,3848,2005,1843,108.8,3757,1956,1801,108.6
37012, 북구,040005, 39세,2021,4185,2092,2093,100,4111,2062,2049,100.6
37012, 북구,045,40~44세,2021,19846,9856,9990,98.7,19519,9687,9832,98.5
37012, 북구,045001, 40세,2021,4240,2129,2111,100.9,4153,2086,2067,100.9
37012, 북구,045002, 41세,2021,4157,2088,2069,100.9,4086,2051,2035,100.8
37012, 북구,045003, 42세,2021,3981,1921,2060,93.3,3919,1886,2033,92.8
37012, 북구,045004, 43세,2021,3619,1821,1798,101.3,3571,1794,1777,101
37012, 북구,045005, 44세,2021,3849,1897,1952,97.2,3790,1870,1920,97.4
37012, 북구,050,45~49세,2021,20849,10189,10660,95.6,20623,10065,10558,95.3
37012, 북구,050001, 45세,2021,3580,1736,1844,94.1,3534,1711,1823,93.9
37012, 북구,050002, 46세,2021,3952,1988,1964,101.2,3903,1959,1944,100.8
37012, 북구,050003, 47세,2021,4325,2098,2227,94.2,4286,2071,2215,93.5
37012, 북구,050004, 48세,2021,4502,2149,2353,91.3,4449,2124,2325,91.4
37012, 북구,050005, 49세,2021,4490,2218,2272,97.6,4451,2200,2251,97.7
37012, 북구,055,50~54세,2021,23932,11625,12307,94.5,23725,11527,12198,94.5
37012, 북구,055001, 50세,2021,4767,2315,2452,94.4,4719,2293,2426,94.5
37012, 북구,055002, 51세,2021,4874,2306,2568,89.8,4835,2286,2549,89.7
37012, 북구,055003, 52세,2021,4863,2431,2432,100,4808,2405,2403,100.1
37012, 북구,055004, 53세,2021,5026,2474,2552,96.9,4990,2458,2532,97.1
37012, 북구,055005, 54세,2021,4402,2099,2303,91.1,4373,2085,2288,91.1
37012, 북구,060,55~59세,2021,24088,11744,12344,95.1,23945,11684,12261,95.3
37012, 북구,060001, 55세,2021,4683,2300,2383,96.5,4662,2293,2369,96.8
37012, 북구,060002, 56세,2021,4904,2303,2601,88.5,4873,2286,2587,88.4
37012, 북구,060003, 57세,2021,4465,2196,2269,96.8,4432,2183,2249,97.1
37012, 북구,060004, 58세,2021,4970,2413,2557,94.4,4936,2399,2537,94.6
37012, 북구,060005, 59세,2021,5066,2532,2534,99.9,5042,2523,2519,100.2
37012, 북구,065,60~64세,2021,25232,12197,13035,93.6,25153,12162,12991,93.6
37012, 북구,065001, 60세,2021,5531,2690,2841,94.7,5521,2686,2835,94.7
37012, 북구,065002, 61세,2021,5471,2586,2885,89.6,5447,2577,2870,89.8
37012, 북구,065003, 62세,2021,5025,2376,2649,89.7,5013,2371,2642,89.7
37012, 북구,065004, 63세,2021,4623,2263,2360,95.9,4604,2254,2350,95.9
37012, 북구,065005, 64세,2021,4582,2282,2300,99.2,4568,2274,2294,99.1
37012, 북구,070,65~69세,2021,18998,9346,9652,96.8,18966,9329,9637,96.8
37012, 북구,070001, 65세,2021,4261,2077,2184,95.1,4256,2074,2182,95.1
37012, 북구,070002, 66세,2021,4338,2054,2284,89.9,4328,2050,2278,90
37012, 북구,070003, 67세,2021,3702,1890,1812,104.3,3693,1884,1809,104.1
37012, 북구,070004, 68세,2021,3318,1644,1674,98.2,3314,1642,1672,98.2
37012, 북구,070005, 69세,2021,3379,1681,1698,99,3375,1679,1696,99
37012, 북구,075,70~74세,2021,12372,6071,6301,96.3,12338,6058,6280,96.5
37012, 북구,075001, 70세,2021,2589,1292,1297,99.6,2577,1288,1289,99.9
37012, 북구,075002, 71세,2021,2524,1251,1273,98.3,2516,1247,1269,98.3
37012, 북구,075003, 72세,2021,2555,1255,1300,96.5,2552,1253,1299,96.5
37012, 북구,075004, 73세,2021,2451,1188,1263,94.1,2446,1186,1260,94.1
37012, 북구,075005, 74세,2021,2253,1085,1168,92.9,2247,1084,1163,93.2
37012, 북구,080,75~79세,2021,8330,3526,4804,73.4,8318,3521,4797,73.4
37012, 북구,080001, 75세,2021,1501,726,775,93.7,1498,724,774,93.5
37012, 북구,080002, 76세,2021,1521,667,854,78.1,1517,665,852,78.1
37012, 북구,080003, 77세,2021,1715,739,976,75.7,1713,739,974,75.9
37012, 북구,080004, 78세,2021,1711,669,1042,64.2,1710,669,1041,64.3
37012, 북구,080005, 79세,2021,1882,725,1157,62.7,1880,724,1156,62.6
37012, 북구,085,80~84세,2021,6304,2269,4035,56.2,6293,2267,4026,56.3
37012, 북구,085001, 80세,2021,1507,591,916,64.5,1504,590,914,64.6
37012, 북구,085002, 81세,2021,1374,515,859,60,1371,514,857,60
37012, 북구,085003, 82세,2021,1341,496,845,58.7,1340,496,844,58.8
37012, 북구,085004, 83세,2021,1118,346,772,44.8,1115,346,769,45
37012, 북구,085005, 84세,2021,964,321,643,49.9,963,321,642,50
37012, 북구,090,85~89세,2021,3413,898,2515,35.7,3411,897,2514,35.7
37012, 북구,090001, 85세,2021,880,265,615,43.1,879,264,615,42.9
37012, 북구,090002, 86세,2021,801,208,593,35.1,801,208,593,35.1
37012, 북구,090003, 87세,2021,682,180,502,35.9,681,180,501,35.9
37012, 북구,090004, 88세,2021,561,134,427,31.4,561,134,427,31.4
37012, 북구,090005, 89세,2021,489,111,378,29.4,489,111,378,29.4
37012, 북구,095,90~94세,2021,1303,248,1055,23.5,1302,247,1055,23.4
37012, 북구,095001, 90세,2021,369,78,291,26.8,369,78,291,26.8
37012, 북구,095002, 91세,2021,307,64,243,26.3,307,64,243,26.3
37012, 북구,095003, 92세,2021,282,57,225,25.3,281,56,225,24.9
37012, 북구,095004, 93세,2021,192,27,165,16.4,192,27,165,16.4
37012, 북구,095005, 94세,2021,153,22,131,16.8,153,22,131,16.8
37012, 북구,100,95~99세,2021,261,44,217,20.3,261,44,217,20.3
37012, 북구,100001, 95세,2021,82,12,70,17.1,82,12,70,17.1
37012, 북구,100002, 96세,2021,69,11,58,19,69,11,58,19
37012, 북구,100003, 97세,2021,45,8,37,21.6,45,8,37,21.6
37012, 북구,100004, 98세,2021,40,10,30,33.3,40,10,30,33.3
37012, 북구,100005, 99세,2021,25,X,22,13.6,25,X,22,13.6
37012, 북구,101,100세이상,2021,36,X,34,5.9,36,X,34,5.9
37012, 북구,102,15세미만,2021,33516,17381,16135,107.7,33322,17281,16041,107.7
37012, 북구,103,15~64세,2021,187849,95298,92551,103,184262,93444,90818,102.9
37012, 북구,104,65세이상,2021,51017,22404,28613,78.3,50925,22365,28560,78.3
37012, 북구,086,85세이상,2021,5013,1192,3821,31.2,5010,1190,3820,31.2
37012, 북구,126,평균연령,2021,44.8,43.3,46.3,,45,43.4,46.5,
37012, 북구,127,중위연령,2021,47.3,45.4,49,,47.6,45.7,49.2,
37020, 경주시,000,합계,2021,261102,132338,128764,102.8,245260,122727,122533,100.2
37020, 경주시,005,0~4세,2021,6632,3411,3221,105.9,6249,3204,3045,105.2
37020, 경주시,005001, 0세,2021,1146,587,559,105,1071,549,522,105.2
37020, 경주시,005002, 1세,2021,1217,639,578,110.6,1155,605,550,110
37020, 경주시,005003, 2세,2021,1262,630,632,99.7,1190,589,601,98
37020, 경주시,005004, 3세,2021,1404,713,691,103.2,1332,678,654,103.7
37020, 경주시,005005, 4세,2021,1603,842,761,110.6,1501,783,718,109.1
37020, 경주시,010,5~9세,2021,9267,4718,4549,103.7,8911,4536,4375,103.7
37020, 경주시,010001, 5세,2021,1754,861,893,96.4,1669,822,847,97
37020, 경주시,010002, 6세,2021,1827,908,919,98.8,1744,865,879,98.4
37020, 경주시,010003, 7세,2021,1812,954,858,111.2,1741,919,822,111.8
37020, 경주시,010004, 8세,2021,1832,960,872,110.1,1779,932,847,110
37020, 경주시,010005, 9세,2021,2042,1035,1007,102.8,1978,998,980,101.8
37020, 경주시,015,10~14세,2021,9872,5091,4781,106.5,9613,4966,4647,106.9
37020, 경주시,015001, 10세,2021,2027,1053,974,108.1,1976,1025,951,107.8
37020, 경주시,015002, 11세,2021,1914,991,923,107.4,1851,959,892,107.5
37020, 경주시,015003, 12세,2021,1880,966,914,105.7,1847,951,896,106.1
37020, 경주시,015004, 13세,2021,2021,1035,986,105,1959,1010,949,106.4
37020, 경주시,015005, 14세,2021,2030,1046,984,106.3,1980,1021,959,106.5
37020, 경주시,020,15~19세,2021,10509,5663,4846,116.9,10280,5557,4723,117.7
37020, 경주시,020001, 15세,2021,2001,1031,970,106.3,1951,1008,943,106.9
37020, 경주시,020002, 16세,2021,1928,1018,910,111.9,1887,1002,885,113.2
37020, 경주시,020003, 17세,2021,2072,1123,949,118.3,2046,1109,937,118.4
37020, 경주시,020004, 18세,2021,2171,1151,1020,112.8,2136,1134,1002,113.2
37020, 경주시,020005, 19세,2021,2337,1340,997,134.4,2260,1304,956,136.4
37020, 경주시,025,20~24세,2021,16229,9146,7083,129.1,14438,8170,6268,130.3
37020, 경주시,025001, 20세,2021,2920,1610,1310,122.9,2809,1559,1250,124.7
37020, 경주시,025002, 21세,2021,3344,1774,1570,113,3131,1672,1459,114.6
37020, 경주시,025003, 22세,2021,3321,1837,1484,123.8,2885,1619,1266,127.9
37020, 경주시,025004, 23세,2021,3368,1979,1389,142.5,2863,1695,1168,145.1
37020, 경주시,025005, 24세,2021,3276,1946,1330,146.3,2750,1625,1125,144.4
37020, 경주시,030,25~29세,2021,14859,8717,6142,141.9,12278,7062,5216,135.4
37020, 경주시,030001, 25세,2021,3103,1823,1280,142.4,2609,1534,1075,142.7
37020, 경주시,030002, 26세,2021,3031,1783,1248,142.9,2512,1452,1060,137
37020, 경주시,030003, 27세,2021,2893,1732,1161,149.2,2372,1399,973,143.8
37020, 경주시,030004, 28세,2021,2913,1710,1203,142.1,2393,1378,1015,135.8
37020, 경주시,030005, 29세,2021,2919,1669,1250,133.5,2392,1299,1093,118.8
37020, 경주시,035,30~34세,2021,13976,8012,5964,134.3,11183,6164,5019,122.8
37020, 경주시,035001, 30세,2021,2909,1691,1218,138.8,2354,1325,1029,128.8
37020, 경주시,035002, 31세,2021,2902,1698,1204,141,2310,1302,1008,129.2
37020, 경주시,035003, 32세,2021,2765,1595,1170,136.3,2237,1243,994,125.1
37020, 경주시,035004, 33세,2021,2611,1491,1120,133.1,2058,1118,940,118.9
37020, 경주시,035005, 34세,2021,2789,1537,1252,122.8,2224,1176,1048,112.2
37020, 경주시,040,35~39세,2021,15073,8227,6846,120.2,12657,6603,6054,109.1
37020, 경주시,040001, 35세,2021,2661,1491,1170,127.4,2133,1152,981,117.4
37020, 경주시,040002, 36세,2021,2752,1509,1243,121.4,2237,1146,1091,105
37020, 경주시,040003, 37세,2021,2847,1525,1322,115.4,2355,1199,1156,103.7
37020, 경주시,040004, 38세,2021,3288,1780,1508,118,2852,1479,1373,107.7
37020, 경주시,040005, 39세,2021,3525,1922,1603,119.9,3080,1627,1453,112
37020, 경주시,045,40~44세,2021,17208,9219,7989,115.4,15551,8166,7385,110.6
37020, 경주시,045001, 40세,2021,3606,1958,1648,118.8,3241,1723,1518,113.5
37020, 경주시,045002, 41세,2021,3628,1923,1705,112.8,3270,1686,1584,106.4
37020, 경주시,045003, 42세,2021,3391,1854,1537,120.6,3059,1646,1413,116.5
37020, 경주시,045004, 43세,2021,3270,1724,1546,111.5,2941,1521,1420,107.1
37020, 경주시,045005, 44세,2021,3313,1760,1553,113.3,3040,1590,1450,109.7
37020, 경주시,050,45~49세,2021,19828,10209,9619,106.1,18658,9526,9132,104.3
37020, 경주시,050001, 45세,2021,3308,1699,1609,105.6,3043,1544,1499,103
37020, 경주시,050002, 46세,2021,3672,1954,1718,113.7,3460,1828,1632,112
37020, 경주시,050003, 47세,2021,4235,2158,2077,103.9,3987,2019,1968,102.6
37020, 경주시,050004, 48세,2021,4246,2106,2140,98.4,4019,1969,2050,96
37020, 경주시,050005, 49세,2021,4367,2292,2075,110.5,4149,2166,1983,109.2
37020, 경주시,055,50~54세,2021,23153,11841,11312,104.7,22242,11331,10911,103.8
37020, 경주시,055001, 50세,2021,4577,2362,2215,106.6,4386,2251,2135,105.4
37020, 경주시,055002, 51세,2021,4553,2366,2187,108.2,4336,2240,2096,106.9
37020, 경주시,055003, 52세,2021,4624,2369,2255,105.1,4450,2278,2172,104.9
37020, 경주시,055004, 53세,2021,4930,2499,2431,102.8,4746,2407,2339,102.9
37020, 경주시,055005, 54세,2021,4469,2245,2224,100.9,4324,2155,2169,99.4
37020, 경주시,060,55~59세,2021,23126,11947,11179,106.9,22480,11600,10880,106.6
37020, 경주시,060001, 55세,2021,4605,2426,2179,111.3,4447,2335,2112,110.6
37020, 경주시,060002, 56세,2021,4564,2366,2198,107.6,4426,2290,2136,107.2
37020, 경주시,060003, 57세,2021,4378,2228,2150,103.6,4246,2153,2093,102.9
37020, 경주시,060004, 58세,2021,4784,2475,2309,107.2,4673,2418,2255,107.2
37020, 경주시,060005, 59세,2021,4795,2452,2343,104.7,4688,2404,2284,105.3
37020, 경주시,065,60~64세,2021,23511,11816,11695,101,23153,11641,11512,101.1
37020, 경주시,065001, 60세,2021,5069,2575,2494,103.2,4996,2534,2462,102.9
37020, 경주시,065002, 61세,2021,5012,2521,2491,101.2,4929,2480,2449,101.3
37020, 경주시,065003, 62세,2021,4764,2415,2349,102.8,4692,2385,2307,103.4
37020, 경주시,065004, 63세,2021,4352,2184,2168,100.7,4278,2147,2131,100.8
37020, 경주시,065005, 64세,2021,4314,2121,2193,96.7,4258,2095,2163,96.9
37020, 경주시,070,65~69세,2021,18512,8858,9654,91.8,18345,8778,9567,91.8
37020, 경주시,070001, 65세,2021,4217,2051,2166,94.7,4174,2028,2146,94.5
37020, 경주시,070002, 66세,2021,4041,1952,2089,93.4,3998,1933,2065,93.6
37020, 경주시,070003, 67세,2021,3511,1693,1818,93.1,3480,1676,1804,92.9
37020, 경주시,070004, 68세,2021,3344,1611,1733,93,3318,1600,1718,93.1
37020, 경주시,070005, 69세,2021,3399,1551,1848,83.9,3375,1541,1834,84
37020, 경주시,075,70~74세,2021,14020,6529,7491,87.2,13953,6505,7448,87.3
37020, 경주시,075001, 70세,2021,2868,1329,1539,86.4,2853,1325,1528,86.7
37020, 경주시,075002, 71세,2021,2854,1303,1551,84,2829,1294,1535,84.3
37020, 경주시,075003, 72세,2021,3005,1422,1583,89.8,2990,1418,1572,90.2
37020, 경주시,075004, 73세,2021,2741,1302,1439,90.5,2736,1299,1437,90.4
37020, 경주시,075005, 74세,2021,2552,1173,1379,85.1,2545,1169,1376,85
37020, 경주시,080,75~79세,2021,10511,4414,6097,72.4,10480,4404,6076,72.5
37020, 경주시,080001, 75세,2021,1703,794,909,87.3,1692,790,902,87.6
37020, 경주시,080002, 76세,2021,1924,833,1091,76.4,1919,832,1087,76.5
37020, 경주시,080003, 77세,2021,2009,832,1177,70.7,2002,831,1171,71
37020, 경주시,080004, 78세,2021,2232,901,1331,67.7,2227,900,1327,67.8
37020, 경주시,080005, 79세,2021,2643,1054,1589,66.3,2640,1051,1589,66.1
37020, 경주시,085,80~84세,2021,8372,2851,5521,51.6,8355,2846,5509,51.7
37020, 경주시,085001, 80세,2021,1842,680,1162,58.5,1838,680,1158,58.7
37020, 경주시,085002, 81세,2021,1784,632,1152,54.9,1780,631,1149,54.9
37020, 경주시,085003, 82세,2021,1827,616,1211,50.9,1824,616,1208,51
37020, 경주시,085004, 83세,2021,1515,470,1045,45,1511,467,1044,44.7
37020, 경주시,085005, 84세,2021,1404,453,951,47.6,1402,452,950,47.6
37020, 경주시,090,85~89세,2021,4685,1327,3358,39.5,4680,1327,3353,39.6
37020, 경주시,090001, 85세,2021,1222,371,851,43.6,1221,371,850,43.6
37020, 경주시,090002, 86세,2021,1064,296,768,38.5,1061,296,765,38.7
37020, 경주시,090003, 87세,2021,941,263,678,38.8,940,263,677,38.8
37020, 경주시,090004, 88세,2021,818,212,606,35,818,212,606,35
37020, 경주시,090005, 89세,2021,640,185,455,40.7,640,185,455,40.7
37020, 경주시,095,90~94세,2021,1448,291,1157,25.2,1446,291,1155,25.2
37020, 경주시,095001, 90세,2021,433,93,340,27.4,433,93,340,27.4
37020, 경주시,095002, 91세,2021,357,69,288,24,357,69,288,24
37020, 경주시,095003, 92세,2021,304,62,242,25.6,303,62,241,25.7
37020, 경주시,095004, 93세,2021,204,43,161,26.7,203,43,160,26.9
37020, 경주시,095005, 94세,2021,150,24,126,19,150,24,126,19
37020, 경주시,100,95~99세,2021,270,47,223,21.1,267,46,221,20.8
37020, 경주시,100001, 95세,2021,75,14,61,23,74,13,61,21.3
37020, 경주시,100002, 96세,2021,74,11,63,17.5,72,11,61,18
37020, 경주시,100003, 97세,2021,41,12,29,41.4,41,12,29,41.4
37020, 경주시,100004, 98세,2021,51,7,44,15.9,51,7,44,15.9
37020, 경주시,100005, 99세,2021,29,X,26,11.5,29,X,26,11.5
37020, 경주시,101,100세이상,2021,41,X,37,10.8,41,X,37,10.8
37020, 경주시,102,15세미만,2021,25771,13220,12551,105.3,24773,12706,12067,105.3
37020, 경주시,103,15~64세,2021,177472,94797,82675,114.7,162920,85820,77100,111.3
37020, 경주시,104,65세이상,2021,57859,24321,33538,72.5,57567,24201,33366,72.5
37020, 경주시,086,85세이상,2021,6444,1669,4775,35,6434,1668,4766,35
37020, 경주시,126,평균연령,2021,46.8,44.9,48.8,,47.6,45.7,49.4,
37020, 경주시,127,중위연령,2021,49.3,47.1,51.5,,50.6,48.8,52.5,
37030, 김천시,000,합계,2021,137962,69158,68804,100.5,134762,67328,67434,99.8
37030, 김천시,005,0~4세,2021,4262,2211,2051,107.8,4228,2192,2036,107.7
37030, 김천시,005001, 0세,2021,768,389,379,102.6,761,384,377,101.9
37030, 김천시,005002, 1세,2021,768,416,352,118.2,761,413,348,118.7
37030, 김천시,005003, 2세,2021,863,442,421,105,851,435,416,104.6
37030, 김천시,005004, 3세,2021,891,461,430,107.2,886,459,427,107.5
37030, 김천시,005005, 4세,2021,972,503,469,107.2,969,501,468,107.1
37030, 김천시,010,5~9세,2021,5591,2871,2720,105.6,5570,2859,2711,105.5
37030, 김천시,010001, 5세,2021,1090,563,527,106.8,1082,559,523,106.9
37030, 김천시,010002, 6세,2021,1084,526,558,94.3,1080,524,556,94.2
37030, 김천시,010003, 7세,2021,1078,554,524,105.7,1074,552,522,105.7
37030, 김천시,010004, 8세,2021,1129,607,522,116.3,1127,605,522,115.9
37030, 김천시,010005, 9세,2021,1210,621,589,105.4,1207,619,588,105.3
37030, 김천시,015,10~14세,2021,5727,3007,2720,110.6,5721,3004,2717,110.6
37030, 김천시,015001, 10세,2021,1175,613,562,109.1,1174,613,561,109.3
37030, 김천시,015002, 11세,2021,1113,564,549,102.7,1111,563,548,102.7
37030, 김천시,015003, 12세,2021,1068,558,510,109.4,1067,557,510,109.2
37030, 김천시,015004, 13세,2021,1210,671,539,124.5,1210,671,539,124.5
37030, 김천시,015005, 14세,2021,1161,601,560,107.3,1159,600,559,107.3
37030, 김천시,020,15~19세,2021,6046,3422,2624,130.4,5978,3372,2606,129.4
37030, 김천시,020001, 15세,2021,1091,608,483,125.9,1089,607,482,125.9
37030, 김천시,020002, 16세,2021,1252,681,571,119.3,1249,678,571,118.7
37030, 김천시,020003, 17세,2021,1331,755,576,131.1,1328,753,575,131
37030, 김천시,020004, 18세,2021,1225,705,520,135.6,1213,696,517,134.6
37030, 김천시,020005, 19세,2021,1147,673,474,142,1099,638,461,138.4
37030, 김천시,025,20~24세,2021,7127,3965,3162,125.4,6647,3702,2945,125.7
37030, 김천시,025001, 20세,2021,1280,709,571,124.2,1236,685,551,124.3
37030, 김천시,025002, 21세,2021,1504,811,693,117,1437,784,653,120.1
37030, 김천시,025003, 22세,2021,1581,852,729,116.9,1458,790,668,118.3
37030, 김천시,025004, 23세,2021,1371,775,596,130,1259,704,555,126.8
37030, 김천시,025005, 24세,2021,1391,818,573,142.8,1257,739,518,142.7
37030, 김천시,030,25~29세,2021,7273,4141,3132,132.2,6632,3751,2881,130.2
37030, 김천시,030001, 25세,2021,1426,810,616,131.5,1302,739,563,131.3
37030, 김천시,030002, 26세,2021,1390,801,589,136,1258,723,535,135.1
37030, 김천시,030003, 27세,2021,1450,855,595,143.7,1315,777,538,144.4
37030, 김천시,030004, 28세,2021,1477,858,619,138.6,1355,776,579,134
37030, 김천시,030005, 29세,2021,1530,817,713,114.6,1402,736,666,110.5
37030, 김천시,035,30~34세,2021,7002,3854,3148,122.4,6414,3491,2923,119.4
37030, 김천시,035001, 30세,2021,1446,824,622,132.5,1331,752,579,129.9
37030, 김천시,035002, 31세,2021,1416,777,639,121.6,1283,699,584,119.7
37030, 김천시,035003, 32세,2021,1395,773,622,124.3,1265,694,571,121.5
37030, 김천시,035004, 33세,2021,1398,753,645,116.7,1293,683,610,112
37030, 김천시,035005, 34세,2021,1347,727,620,117.3,1242,663,579,114.5
37030, 김천시,040,35~39세,2021,8080,4167,3913,106.5,7637,3903,3734,104.5
37030, 김천시,040001, 35세,2021,1441,760,681,111.6,1318,683,635,107.6
37030, 김천시,040002, 36세,2021,1488,768,720,106.7,1396,713,683,104.4
37030, 김천시,040003, 37세,2021,1528,794,734,108.2,1436,743,693,107.2
37030, 김천시,040004, 38세,2021,1714,867,847,102.4,1638,820,818,100.2
37030, 김천시,040005, 39세,2021,1909,978,931,105,1849,944,905,104.3
37030, 김천시,045,40~44세,2021,9068,4799,4269,112.4,8789,4642,4147,111.9
37030, 김천시,045001, 40세,2021,1930,1026,904,113.5,1852,978,874,111.9
37030, 김천시,045002, 41세,2021,1937,1008,929,108.5,1884,986,898,109.8
37030, 김천시,045003, 42세,2021,1741,932,809,115.2,1689,904,785,115.2
37030, 김천시,045004, 43세,2021,1673,883,790,111.8,1617,851,766,111.1
37030, 김천시,045005, 44세,2021,1787,950,837,113.5,1747,923,824,112
37030, 김천시,050,45~49세,2021,9626,4997,4629,107.9,9433,4896,4537,107.9
37030, 김천시,050001, 45세,2021,1646,858,788,108.9,1614,839,775,108.3
37030, 김천시,050002, 46세,2021,1878,986,892,110.5,1831,960,871,110.2
37030, 김천시,050003, 47세,2021,1977,1007,970,103.8,1946,987,959,102.9
37030, 김천시,050004, 48세,2021,2047,1029,1018,101.1,2010,1014,996,101.8
37030, 김천시,050005, 49세,2021,2078,1117,961,116.2,2032,1096,936,117.1
37030, 김천시,055,50~54세,2021,11352,5853,5499,106.4,11193,5771,5422,106.4
37030, 김천시,055001, 50세,2021,2178,1131,1047,108,2143,1109,1034,107.3
37030, 김천시,055002, 51세,2021,2228,1165,1063,109.6,2198,1146,1052,108.9
37030, 김천시,055003, 52세,2021,2308,1186,1122,105.7,2270,1165,1105,105.4
37030, 김천시,055004, 53세,2021,2387,1211,1176,103,2355,1201,1154,104.1
37030, 김천시,055005, 54세,2021,2251,1160,1091,106.3,2227,1150,1077,106.8
37030, 김천시,060,55~59세,2021,11462,5930,5532,107.2,11348,5880,5468,107.5
37030, 김천시,060001, 55세,2021,2275,1174,1101,106.6,2246,1161,1085,107
37030, 김천시,060002, 56세,2021,2205,1145,1060,108,2175,1130,1045,108.1
37030, 김천시,060003, 57세,2021,2124,1124,1000,112.4,2103,1114,989,112.6
37030, 김천시,060004, 58세,2021,2397,1257,1140,110.3,2382,1251,1131,110.6
37030, 김천시,060005, 59세,2021,2461,1230,1231,99.9,2442,1224,1218,100.5
37030, 김천시,065,60~64세,2021,12496,6287,6209,101.3,12422,6246,6176,101.1
37030, 김천시,065001, 60세,2021,2778,1435,1343,106.9,2765,1429,1336,107
37030, 김천시,065002, 61세,2021,2732,1350,1382,97.7,2707,1336,1371,97.4
37030, 김천시,065003, 62세,2021,2445,1220,1225,99.6,2433,1212,1221,99.3
37030, 김천시,065004, 63세,2021,2215,1117,1098,101.7,2202,1109,1093,101.5
37030, 김천시,065005, 64세,2021,2326,1165,1161,100.3,2315,1160,1155,100.4
37030, 김천시,070,65~69세,2021,10213,4851,5362,90.5,10173,4841,5332,90.8
37030, 김천시,070001, 65세,2021,2215,1063,1152,92.3,2208,1061,1147,92.5
37030, 김천시,070002, 66세,2021,2151,1015,1136,89.3,2143,1011,1132,89.3
37030, 김천시,070003, 67세,2021,1930,917,1013,90.5,1924,917,1007,91.1
37030, 김천시,070004, 68세,2021,1883,893,990,90.2,1872,891,981,90.8
37030, 김천시,070005, 69세,2021,2034,963,1071,89.9,2026,961,1065,90.2
37030, 김천시,075,70~74세,2021,7477,3499,3978,88,7442,3488,3954,88.2
37030, 김천시,075001, 70세,2021,1403,664,739,89.9,1394,661,733,90.2
37030, 김천시,075002, 71세,2021,1499,723,776,93.2,1493,721,772,93.4
37030, 김천시,075003, 72세,2021,1610,743,867,85.7,1604,741,863,85.9
37030, 김천시,075004, 73세,2021,1505,702,803,87.4,1495,700,795,88.1
37030, 김천시,075005, 74세,2021,1460,667,793,84.1,1456,665,791,84.1
37030, 김천시,080,75~79세,2021,5700,2311,3389,68.2,5689,2302,3387,68
37030, 김천시,080001, 75세,2021,970,427,543,78.6,966,425,541,78.6
37030, 김천시,080002, 76세,2021,923,420,503,83.5,919,416,503,82.7
37030, 김천시,080003, 77세,2021,1173,479,694,69,1172,478,694,68.9
37030, 김천시,080004, 78세,2021,1265,477,788,60.5,1263,475,788,60.3
37030, 김천시,080005, 79세,2021,1369,508,861,59,1369,508,861,59
37030, 김천시,085,80~84세,2021,5221,1830,3391,54,5212,1826,3386,53.9
37030, 김천시,085001, 80세,2021,1131,411,720,57.1,1127,411,716,57.4
37030, 김천시,085002, 81세,2021,1137,406,731,55.5,1136,405,731,55.4
37030, 김천시,085003, 82세,2021,1090,376,714,52.7,1090,376,714,52.7
37030, 김천시,085004, 83세,2021,987,340,647,52.6,983,337,646,52.2
37030, 김천시,085005, 84세,2021,876,297,579,51.3,876,297,579,51.3
37030, 김천시,090,85~89세,2021,3011,899,2112,42.6,3008,898,2110,42.6
37030, 김천시,090001, 85세,2021,810,249,561,44.4,809,248,561,44.2
37030, 김천시,090002, 86세,2021,738,247,491,50.3,737,247,490,50.4
37030, 김천시,090003, 87세,2021,584,164,420,39,583,164,419,39.1
37030, 김천시,090004, 88세,2021,489,139,350,39.7,489,139,350,39.7
37030, 김천시,090005, 89세,2021,390,100,290,34.5,390,100,290,34.5
37030, 김천시,095,90~94세,2021,1011,237,774,30.6,1010,237,773,30.7
37030, 김천시,095001, 90세,2021,290,74,216,34.3,290,74,216,34.3
37030, 김천시,095002, 91세,2021,261,66,195,33.8,261,66,195,33.8
37030, 김천시,095003, 92세,2021,185,40,145,27.6,185,40,145,27.6
37030, 김천시,095004, 93세,2021,160,33,127,26,160,33,127,26
37030, 김천시,095005, 94세,2021,115,24,91,26.4,114,24,90,26.7
37030, 김천시,100,95~99세,2021,189,26,163,16,188,26,162,16
37030, 김천시,100001, 95세,2021,64,8,56,14.3,64,8,56,14.3
37030, 김천시,100002, 96세,2021,51,6,45,13.3,51,6,45,13.3
37030, 김천시,100003, 97세,2021,22,X,19,15.8,22,X,19,15.8
37030, 김천시,100004, 98세,2021,30,6,24,25,30,6,24,25
37030, 김천시,100005, 99세,2021,22,X,19,15.8,21,X,18,16.7
37030, 김천시,101,100세이상,2021,28,X,27,3.7,28,X,27,3.7
37030, 김천시,102,15세미만,2021,15580,8089,7491,108,15519,8055,7464,107.9
37030, 김천시,103,15~64세,2021,89532,47415,42117,112.6,86493,45654,40839,111.8
37030, 김천시,104,65세이상,2021,32850,13654,19196,71.1,32750,13619,19131,71.2
37030, 김천시,086,85세이상,2021,4239,1163,3076,37.8,4234,1162,3072,37.8
37030, 김천시,126,평균연령,2021,47,44.9,49.1,,47.3,45.2,49.3,
37030, 김천시,127,중위연령,2021,49.6,47.3,51.9,,50.2,48,52.4,
37040, 안동시,000,합계,2021,158064,78040,80024,97.5,156201,77240,78961,97.8
37040, 안동시,005,0~4세,2021,4178,2147,2031,105.7,4165,2143,2022,106
37040, 안동시,005001, 0세,2021,752,370,382,96.9,747,369,378,97.6
37040, 안동시,005002, 1세,2021,753,391,362,108,752,391,361,108.3
37040, 안동시,005003, 2세,2021,809,422,387,109,806,422,384,109.9
37040, 안동시,005004, 3세,2021,886,467,419,111.5,884,466,418,111.5
37040, 안동시,005005, 4세,2021,978,497,481,103.3,976,495,481,102.9
37040, 안동시,010,5~9세,2021,5884,3073,2811,109.3,5868,3066,2802,109.4
37040, 안동시,010001, 5세,2021,1069,554,515,107.6,1063,551,512,107.6
37040, 안동시,010002, 6세,2021,1138,597,541,110.4,1136,595,541,110
37040, 안동시,010003, 7세,2021,1115,565,550,102.7,1112,565,547,103.3
37040, 안동시,010004, 8세,2021,1238,652,586,111.3,1234,651,583,111.7
37040, 안동시,010005, 9세,2021,1324,705,619,113.9,1323,704,619,113.7
37040, 안동시,015,10~14세,2021,6301,3291,3010,109.3,6293,3286,3007,109.3
37040, 안동시,015001, 10세,2021,1240,666,574,116,1239,665,574,115.9
37040, 안동시,015002, 11세,2021,1245,662,583,113.6,1242,660,582,113.4
37040, 안동시,015003, 12세,2021,1208,618,590,104.7,1207,617,590,104.6
37040, 안동시,015004, 13세,2021,1300,671,629,106.7,1299,670,629,106.5
37040, 안동시,015005, 14세,2021,1308,674,634,106.3,1306,674,632,106.6
37040, 안동시,020,15~19세,2021,7553,3922,3631,108,7477,3875,3602,107.6
37040, 안동시,020001, 15세,2021,1270,677,593,114.2,1268,675,593,113.8
37040, 안동시,020002, 16세,2021,1283,686,597,114.9,1276,682,594,114.8
37040, 안동시,020003, 17세,2021,1502,786,716,109.8,1498,783,715,109.5
37040, 안동시,020004, 18세,2021,1521,759,762,99.6,1511,755,756,99.9
37040, 안동시,020005, 19세,2021,1977,1014,963,105.3,1924,980,944,103.8
37040, 안동시,025,20~24세,2021,10007,5235,4772,109.7,9815,5158,4657,110.8
37040, 안동시,025001, 20세,2021,2081,958,1123,85.3,2053,948,1105,85.8
37040, 안동시,025002, 21세,2021,2134,1027,1107,92.8,2089,1008,1081,93.2
37040, 안동시,025003, 22세,2021,2032,1093,939,116.4,1995,1079,916,117.8
37040, 안동시,025004, 23세,2021,1880,1057,823,128.4,1834,1040,794,131
37040, 안동시,025005, 24세,2021,1880,1100,780,141,1844,1083,761,142.3
37040, 안동시,030,25~29세,2021,8226,4546,3680,123.5,7922,4403,3519,125.1
37040, 안동시,030001, 25세,2021,1748,1001,747,134,1694,974,720,135.3
37040, 안동시,030002, 26세,2021,1754,947,807,117.3,1696,920,776,118.6
37040, 안동시,030003, 27세,2021,1638,904,734,123.2,1578,881,697,126.4
37040, 안동시,030004, 28세,2021,1559,864,695,124.3,1499,833,666,125.1
37040, 안동시,030005, 29세,2021,1527,830,697,119.1,1455,795,660,120.5
37040, 안동시,035,30~34세,2021,7160,3812,3348,113.9,6799,3662,3137,116.7
37040, 안동시,035001, 30세,2021,1528,833,695,119.9,1448,801,647,123.8
37040, 안동시,035002, 31세,2021,1426,787,639,123.2,1365,761,604,126
37040, 안동시,035003, 32세,2021,1371,735,636,115.6,1298,702,596,117.8
37040, 안동시,035004, 33세,2021,1372,731,641,114,1302,702,600,117
37040, 안동시,035005, 34세,2021,1463,726,737,98.5,1386,696,690,100.9
37040, 안동시,040,35~39세,2021,8101,4115,3986,103.2,7848,3999,3849,103.9
37040, 안동시,040001, 35세,2021,1438,740,698,106,1385,716,669,107
37040, 안동시,040002, 36세,2021,1399,737,662,111.3,1353,715,638,112.1
37040, 안동시,040003, 37세,2021,1527,793,734,108,1477,772,705,109.5
37040, 안동시,040004, 38세,2021,1756,873,883,98.9,1711,852,859,99.2
37040, 안동시,040005, 39세,2021,1981,972,1009,96.3,1922,944,978,96.5
37040, 안동시,045,40~44세,2021,9726,4911,4815,102,9577,4854,4723,102.8
37040, 안동시,045001, 40세,2021,1829,890,939,94.8,1796,877,919,95.4
37040, 안동시,045002, 41세,2021,2089,1056,1033,102.2,2055,1041,1014,102.7
37040, 안동시,045003, 42세,2021,1855,979,876,111.8,1827,967,860,112.4
37040, 안동시,045004, 43세,2021,1878,957,921,103.9,1856,951,905,105.1
37040, 안동시,045005, 44세,2021,2075,1029,1046,98.4,2043,1018,1025,99.3
37040, 안동시,050,45~49세,2021,11454,5977,5477,109.1,11324,5922,5402,109.6
37040, 안동시,050001, 45세,2021,2060,1053,1007,104.6,2033,1043,990,105.4
37040, 안동시,050002, 46세,2021,2290,1142,1148,99.5,2268,1131,1137,99.5
37040, 안동시,050003, 47세,2021,2360,1274,1086,117.3,2333,1261,1072,117.6
37040, 안동시,050004, 48세,2021,2423,1277,1146,111.4,2392,1263,1129,111.9
37040, 안동시,050005, 49세,2021,2321,1231,1090,112.9,2298,1224,1074,114
37040, 안동시,055,50~54세,2021,12958,6723,6235,107.8,12838,6683,6155,108.6
37040, 안동시,055001, 50세,2021,2546,1338,1208,110.8,2526,1331,1195,111.4
37040, 안동시,055002, 51세,2021,2596,1347,1249,107.8,2564,1335,1229,108.6
37040, 안동시,055003, 52세,2021,2650,1378,1272,108.3,2624,1371,1253,109.4
37040, 안동시,055004, 53세,2021,2702,1388,1314,105.6,2683,1382,1301,106.2
37040, 안동시,055005, 54세,2021,2464,1272,1192,106.7,2441,1264,1177,107.4
37040, 안동시,060,55~59세,2021,12426,6297,6129,102.7,12334,6262,6072,103.1
37040, 안동시,060001, 55세,2021,2487,1285,1202,106.9,2466,1277,1189,107.4
37040, 안동시,060002, 56세,2021,2396,1212,1184,102.4,2376,1205,1171,102.9
37040, 안동시,060003, 57세,2021,2396,1227,1169,105,2383,1224,1159,105.6
37040, 안동시,060004, 58세,2021,2530,1275,1255,101.6,2515,1270,1245,102
37040, 안동시,060005, 59세,2021,2617,1298,1319,98.4,2594,1286,1308,98.3
37040, 안동시,065,60~64세,2021,14540,7240,7300,99.2,14469,7208,7261,99.3
37040, 안동시,065001, 60세,2021,3290,1632,1658,98.4,3278,1626,1652,98.4
37040, 안동시,065002, 61세,2021,3271,1601,1670,95.9,3248,1589,1659,95.8
37040, 안동시,065003, 62세,2021,2654,1315,1339,98.2,2645,1310,1335,98.1
37040, 안동시,065004, 63세,2021,2634,1310,1324,98.9,2626,1306,1320,98.9
37040, 안동시,065005, 64세,2021,2691,1382,1309,105.6,2672,1377,1295,106.3
37040, 안동시,070,65~69세,2021,11846,5592,6254,89.4,11803,5576,6227,89.5
37040, 안동시,070001, 65세,2021,2560,1285,1275,100.8,2550,1282,1268,101.1
37040, 안동시,070002, 66세,2021,2473,1177,1296,90.8,2462,1172,1290,90.9
37040, 안동시,070003, 67세,2021,2207,1061,1146,92.6,2199,1057,1142,92.6
37040, 안동시,070004, 68세,2021,2265,992,1273,77.9,2257,989,1268,78
37040, 안동시,070005, 69세,2021,2341,1077,1264,85.2,2335,1076,1259,85.5
37040, 안동시,075,70~74세,2021,8907,4276,4631,92.3,8893,4268,4625,92.3
37040, 안동시,075001, 70세,2021,1749,809,940,86.1,1744,805,939,85.7
37040, 안동시,075002, 71세,2021,1700,826,874,94.5,1696,824,872,94.5
37040, 안동시,075003, 72세,2021,1905,951,954,99.7,1901,950,951,99.9
37040, 안동시,075004, 73세,2021,1826,871,955,91.2,1825,870,955,91.1
37040, 안동시,075005, 74세,2021,1727,819,908,90.2,1727,819,908,90.2
37040, 안동시,080,75~79세,2021,7454,3132,4322,72.5,7443,3126,4317,72.4
37040, 안동시,080001, 75세,2021,1190,553,637,86.8,1185,551,634,86.9
37040, 안동시,080002, 76세,2021,1230,538,692,77.7,1229,537,692,77.6
37040, 안동시,080003, 77세,2021,1475,565,910,62.1,1475,565,910,62.1
37040, 안동시,080004, 78세,2021,1676,695,981,70.8,1674,694,980,70.8
37040, 안동시,080005, 79세,2021,1883,781,1102,70.9,1880,779,1101,70.8
37040, 안동시,085,80~84세,2021,6259,2326,3933,59.1,6255,2325,3930,59.2
37040, 안동시,085001, 80세,2021,1422,554,868,63.8,1422,554,868,63.8
37040, 안동시,085002, 81세,2021,1354,517,837,61.8,1353,517,836,61.8
37040, 안동시,085003, 82세,2021,1380,500,880,56.8,1379,500,879,56.9
37040, 안동시,085004, 83세,2021,1111,407,704,57.8,1110,406,704,57.7
37040, 안동시,085005, 84세,2021,992,348,644,54,991,348,643,54.1
37040, 안동시,090,85~89세,2021,3600,1116,2484,44.9,3596,1115,2481,44.9
37040, 안동시,090001, 85세,2021,926,322,604,53.3,924,321,603,53.2
37040, 안동시,090002, 86세,2021,894,294,600,49,894,294,600,49
37040, 안동시,090003, 87세,2021,699,208,491,42.4,698,208,490,42.4
37040, 안동시,090004, 88세,2021,556,157,399,39.3,555,157,398,39.4
37040, 안동시,090005, 89세,2021,525,135,390,34.6,525,135,390,34.6
37040, 안동시,095,90~94세,2021,1181,245,936,26.2,1179,245,934,26.2
37040, 안동시,095001, 90세,2021,324,74,250,29.6,324,74,250,29.6
37040, 안동시,095002, 91세,2021,299,53,246,21.5,298,53,245,21.6
37040, 안동시,095003, 92세,2021,236,59,177,33.3,236,59,177,33.3
37040, 안동시,095004, 93세,2021,189,35,154,22.7,189,35,154,22.7
37040, 안동시,095005, 94세,2021,133,24,109,22,132,24,108,22.2
37040, 안동시,100,95~99세,2021,267,57,210,27.1,267,57,210,27.1
37040, 안동시,100001, 95세,2021,100,25,75,33.3,100,25,75,33.3
37040, 안동시,100002, 96세,2021,73,13,60,21.7,73,13,60,21.7
37040, 안동시,100003, 97세,2021,40,10,30,33.3,40,10,30,33.3
37040, 안동시,100004, 98세,2021,35,5,30,16.7,35,5,30,16.7
37040, 안동시,100005, 99세,2021,19,X,15,26.7,19,X,15,26.7
37040, 안동시,101,100세이상,2021,36,7,29,24.1,36,7,29,24.1
37040, 안동시,102,15세미만,2021,16363,8511,7852,108.4,16326,8495,7831,108.5
37040, 안동시,103,15~64세,2021,102151,52778,49373,106.9,100403,52026,48377,107.5
37040, 안동시,104,65세이상,2021,39550,16751,22799,73.5,39472,16719,22753,73.5
37040, 안동시,086,85세이상,2021,5084,1425,3659,38.9,5078,1424,3654,39
37040, 안동시,126,평균연령,2021,47.5,45.7,49.2,,47.6,45.8,49.4,
37040, 안동시,127,중위연령,2021,50.2,48.4,52,,50.4,48.6,52.3,
37050, 구미시,000,합계,2021,413963,213736,200227,106.7,407865,210519,197346,106.7
37050, 구미시,005,0~4세,2021,15673,8019,7654,104.8,15576,7975,7601,104.9
37050, 구미시,005001, 0세,2021,2485,1231,1254,98.2,2463,1221,1242,98.3
37050, 구미시,005002, 1세,2021,2781,1433,1348,106.3,2757,1422,1335,106.5
37050, 구미시,005003, 2세,2021,3097,1609,1488,108.1,3078,1601,1477,108.4
37050, 구미시,005004, 3세,2021,3493,1809,1684,107.4,3477,1800,1677,107.3
37050, 구미시,005005, 4세,2021,3817,1937,1880,103,3801,1931,1870,103.3
37050, 구미시,010,5~9세,2021,23357,12032,11325,106.2,23291,12009,11282,106.4
37050, 구미시,010001, 5세,2021,4465,2266,2199,103,4446,2261,2185,103.5
37050, 구미시,010002, 6세,2021,4774,2428,2346,103.5,4760,2425,2335,103.9
37050, 구미시,010003, 7세,2021,4583,2419,2164,111.8,4573,2415,2158,111.9
37050, 구미시,010004, 8세,2021,4604,2379,2225,106.9,4593,2373,2220,106.9
37050, 구미시,010005, 9세,2021,4931,2540,2391,106.2,4919,2535,2384,106.3
37050, 구미시,015,10~14세,2021,22497,11745,10752,109.2,22471,11727,10744,109.1
37050, 구미시,015001, 10세,2021,4782,2533,2249,112.6,4776,2529,2247,112.6
37050, 구미시,015002, 11세,2021,4408,2263,2145,105.5,4400,2257,2143,105.3
37050, 구미시,015003, 12세,2021,4206,2254,1952,115.5,4200,2250,1950,115.4
37050, 구미시,015004, 13세,2021,4486,2294,2192,104.7,4483,2291,2192,104.5
37050, 구미시,015005, 14세,2021,4615,2401,2214,108.4,4612,2400,2212,108.5
37050, 구미시,020,15~19세,2021,21713,11771,9942,118.4,21654,11748,9906,118.6
37050, 구미시,020001, 15세,2021,4067,2109,1958,107.7,4061,2109,1952,108
37050, 구미시,020002, 16세,2021,4046,2067,1979,104.4,4041,2066,1975,104.6
37050, 구미시,020003, 17세,2021,4496,2405,2091,115,4493,2405,2088,115.2
37050, 구미시,020004, 18세,2021,4732,2550,2182,116.9,4721,2544,2177,116.9
37050, 구미시,020005, 19세,2021,4372,2640,1732,152.4,4338,2624,1714,153.1
37050, 구미시,025,20~24세,2021,25929,15581,10348,150.6,25440,15311,10129,151.2
37050, 구미시,025001, 20세,2021,4963,3037,1926,157.7,4916,3015,1901,158.6
37050, 구미시,025002, 21세,2021,5413,3242,2171,149.3,5341,3210,2131,150.6
37050, 구미시,025003, 22세,2021,5122,3067,2055,149.2,5061,3034,2027,149.7
37050, 구미시,025004, 23세,2021,5101,3076,2025,151.9,4956,2993,1963,152.5
37050, 구미시,025005, 24세,2021,5330,3159,2171,145.5,5166,3059,2107,145.2
37050, 구미시,030,25~29세,2021,29280,16283,12997,125.3,28296,15729,12567,125.2
37050, 구미시,030001, 25세,2021,5334,3122,2212,141.1,5138,3010,2128,141.4
37050, 구미시,030002, 26세,2021,5816,3371,2445,137.9,5656,3273,2383,137.3
37050, 구미시,030003, 27세,2021,5874,3262,2612,124.9,5684,3150,2534,124.3
37050, 구미시,030004, 28세,2021,5903,3197,2706,118.1,5712,3095,2617,118.3
37050, 구미시,030005, 29세,2021,6353,3331,3022,110.2,6106,3201,2905,110.2
37050, 구미시,035,30~34세,2021,29694,16230,13464,120.5,28460,15530,12930,120.1
37050, 구미시,035001, 30세,2021,5735,3111,2624,118.6,5517,2990,2527,118.3
37050, 구미시,035002, 31세,2021,5893,3257,2636,123.6,5653,3123,2530,123.4
37050, 구미시,035003, 32세,2021,5691,3153,2538,124.2,5417,2999,2418,124
37050, 구미시,035004, 33세,2021,6038,3333,2705,123.2,5778,3186,2592,122.9
37050, 구미시,035005, 34세,2021,6337,3376,2961,114,6095,3232,2863,112.9
37050, 구미시,040,35~39세,2021,34969,18368,16601,110.6,34006,17839,16167,110.3
37050, 구미시,040001, 35세,2021,6587,3544,3043,116.5,6358,3412,2946,115.8
37050, 구미시,040002, 36세,2021,6481,3453,3028,114,6300,3358,2942,114.1
37050, 구미시,040003, 37세,2021,6558,3402,3156,107.8,6391,3312,3079,107.6
37050, 구미시,040004, 38세,2021,7333,3778,3555,106.3,7143,3674,3469,105.9
37050, 구미시,040005, 39세,2021,8010,4191,3819,109.7,7814,4083,3731,109.4
37050, 구미시,045,40~44세,2021,36637,18812,17825,105.5,35971,18472,17499,105.6
37050, 구미시,045001, 40세,2021,7772,4016,3756,106.9,7610,3928,3682,106.7
37050, 구미시,045002, 41세,2021,8081,4213,3868,108.9,7924,4128,3796,108.7
37050, 구미시,045003, 42세,2021,7249,3732,3517,106.1,7133,3670,3463,106
37050, 구미시,045004, 43세,2021,6624,3399,3225,105.4,6507,3352,3155,106.2
37050, 구미시,045005, 44세,2021,6911,3452,3459,99.8,6797,3394,3403,99.7
37050, 구미시,050,45~49세,2021,35622,17478,18144,96.3,35113,17213,17900,96.2
37050, 구미시,050001, 45세,2021,6781,3345,3436,97.4,6675,3291,3384,97.3
37050, 구미시,050002, 46세,2021,6886,3311,3575,92.6,6788,3260,3528,92.4
37050, 구미시,050003, 47세,2021,7339,3603,3736,96.4,7237,3548,3689,96.2
37050, 구미시,050004, 48세,2021,7281,3512,3769,93.2,7181,3458,3723,92.9
37050, 구미시,050005, 49세,2021,7335,3707,3628,102.2,7232,3656,3576,102.2
37050, 구미시,055,50~54세,2021,37448,18518,18930,97.8,37063,18328,18735,97.8
37050, 구미시,055001, 50세,2021,7571,3924,3647,107.6,7486,3874,3612,107.3
37050, 구미시,055002, 51세,2021,7644,3775,3869,97.6,7563,3734,3829,97.5
37050, 구미시,055003, 52세,2021,7723,3832,3891,98.5,7640,3791,3849,98.5
37050, 구미시,055004, 53세,2021,7608,3718,3890,95.6,7537,3685,3852,95.7
37050, 구미시,055005, 54세,2021,6902,3269,3633,90,6837,3244,3593,90.3
37050, 구미시,060,55~59세,2021,31869,16643,15226,109.3,31591,16511,15080,109.5
37050, 구미시,060001, 55세,2021,6476,3342,3134,106.6,6423,3317,3106,106.8
37050, 구미시,060002, 56세,2021,6711,3460,3251,106.4,6657,3437,3220,106.7
37050, 구미시,060003, 57세,2021,6108,3246,2862,113.4,6054,3225,2829,114
37050, 구미시,060004, 58세,2021,6314,3327,2987,111.4,6253,3292,2961,111.2
37050, 구미시,060005, 59세,2021,6260,3268,2992,109.2,6204,3240,2964,109.3
37050, 구미시,065,60~64세,2021,26697,13845,12852,107.7,26525,13774,12751,108
37050, 구미시,065001, 60세,2021,6557,3387,3170,106.8,6527,3372,3155,106.9
37050, 구미시,065002, 61세,2021,6231,3242,2989,108.5,6190,3229,2961,109.1
37050, 구미시,065003, 62세,2021,5187,2679,2508,106.8,5157,2666,2491,107
37050, 구미시,065004, 63세,2021,4401,2301,2100,109.6,4361,2287,2074,110.3
37050, 구미시,065005, 64세,2021,4321,2236,2085,107.2,4290,2220,2070,107.2
37050, 구미시,070,65~69세,2021,16236,8173,8063,101.4,16146,8135,8011,101.5
37050, 구미시,070001, 65세,2021,3850,2047,1803,113.5,3825,2034,1791,113.6
37050, 구미시,070002, 66세,2021,3581,1806,1775,101.7,3561,1798,1763,102
37050, 구미시,070003, 67세,2021,3096,1519,1577,96.3,3077,1511,1566,96.5
37050, 구미시,070004, 68세,2021,2820,1399,1421,98.5,2804,1395,1409,99
37050, 구미시,070005, 69세,2021,2889,1402,1487,94.3,2879,1397,1482,94.3
37050, 구미시,075,70~74세,2021,9720,4630,5090,91,9680,4614,5066,91.1
37050, 구미시,075001, 70세,2021,1960,919,1041,88.3,1949,915,1034,88.5
37050, 구미시,075002, 71세,2021,2019,965,1054,91.6,2009,963,1046,92.1
37050, 구미시,075003, 72세,2021,2028,1009,1019,99,2023,1007,1016,99.1
37050, 구미시,075004, 73세,2021,1945,891,1054,84.5,1937,886,1051,84.3
37050, 구미시,075005, 74세,2021,1768,846,922,91.8,1762,843,919,91.7
37050, 구미시,080,75~79세,2021,6732,2699,4033,66.9,6713,2697,4016,67.2
37050, 구미시,080001, 75세,2021,1142,537,605,88.8,1139,537,602,89.2
37050, 구미시,080002, 76세,2021,1104,457,647,70.6,1101,456,645,70.7
37050, 구미시,080003, 77세,2021,1349,538,811,66.3,1344,538,806,66.7
37050, 구미시,080004, 78세,2021,1490,549,941,58.3,1487,548,939,58.4
37050, 구미시,080005, 79세,2021,1647,618,1029,60.1,1642,618,1024,60.4
37050, 구미시,085,80~84세,2021,5499,1808,3691,49,5486,1807,3679,49.1
37050, 구미시,085001, 80세,2021,1255,431,824,52.3,1252,431,821,52.5
37050, 구미시,085002, 81세,2021,1133,408,725,56.3,1131,408,723,56.4
37050, 구미시,085003, 82세,2021,1213,389,824,47.2,1208,388,820,47.3
37050, 구미시,085004, 83세,2021,994,316,678,46.6,993,316,677,46.7
37050, 구미시,085005, 84세,2021,904,264,640,41.3,902,264,638,41.4
37050, 구미시,090,85~89세,2021,3124,866,2258,38.4,3117,865,2252,38.4
37050, 구미시,090001, 85세,2021,792,248,544,45.6,788,248,540,45.9
37050, 구미시,090002, 86세,2021,819,235,584,40.2,817,235,582,40.4
37050, 구미시,090003, 87세,2021,626,175,451,38.8,626,175,451,38.8
37050, 구미시,090004, 88세,2021,462,111,351,31.6,462,111,351,31.6
37050, 구미시,090005, 89세,2021,425,97,328,29.6,424,96,328,29.3
37050, 구미시,095,90~94세,2021,1012,201,811,24.8,1012,201,811,24.8
37050, 구미시,095001, 90세,2021,304,71,233,30.5,304,71,233,30.5
37050, 구미시,095002, 91세,2021,238,42,196,21.4,238,42,196,21.4
37050, 구미시,095003, 92세,2021,193,36,157,22.9,193,36,157,22.9
37050, 구미시,095004, 93세,2021,156,30,126,23.8,156,30,126,23.8
37050, 구미시,095005, 94세,2021,121,22,99,22.2,121,22,99,22.2
37050, 구미시,100,95~99세,2021,226,33,193,17.1,225,33,192,17.2
37050, 구미시,100001, 95세,2021,80,15,65,23.1,80,15,65,23.1
37050, 구미시,100002, 96세,2021,57,8,49,16.3,57,8,49,16.3
37050, 구미시,100003, 97세,2021,34,6,28,21.4,34,6,28,21.4
37050, 구미시,100004, 98세,2021,36,X,32,12.5,35,X,31,12.9
37050, 구미시,100005, 99세,2021,19,X,19,0,19,X,19,0
37050, 구미시,101,100세이상,2021,29,X,28,3.6,29,X,28,3.6
37050, 구미시,102,15세미만,2021,61527,31796,29731,106.9,61338,31711,29627,107
37050, 구미시,103,15~64세,2021,309858,163529,146329,111.8,304119,160455,143664,111.7
37050, 구미시,104,65세이상,2021,42578,18411,24167,76.2,42408,18353,24055,76.3
37050, 구미시,086,85세이상,2021,4391,1101,3290,33.5,4383,1100,3283,33.5
37050, 구미시,126,평균연령,2021,39.7,38.6,40.9,,39.7,38.6,40.9,
37050, 구미시,127,중위연령,2021,40.5,39.2,41.8,,40.6,39.4,42,
37060, 영주시,000,합계,2021,102414,50831,51583,98.5,101202,50309,50893,98.9
37060, 영주시,005,0~4세,2021,2171,1123,1048,107.2,2162,1120,1042,107.5
37060, 영주시,005001, 0세,2021,371,208,163,127.6,369,207,162,127.8
37060, 영주시,005002, 1세,2021,367,178,189,94.2,366,177,189,93.7
37060, 영주시,005003, 2세,2021,408,208,200,104,406,207,199,104
37060, 영주시,005004, 3세,2021,521,278,243,114.4,519,278,241,115.4
37060, 영주시,005005, 4세,2021,504,251,253,99.2,502,251,251,100
37060, 영주시,010,5~9세,2021,3499,1836,1663,110.4,3492,1832,1660,110.4
37060, 영주시,010001, 5세,2021,609,317,292,108.6,606,315,291,108.2
37060, 영주시,010002, 6세,2021,654,337,317,106.3,653,336,317,106
37060, 영주시,010003, 7세,2021,697,384,313,122.7,696,384,312,123.1
37060, 영주시,010004, 8세,2021,678,347,331,104.8,677,347,330,105.2
37060, 영주시,010005, 9세,2021,861,451,410,110,860,450,410,109.8
37060, 영주시,015,10~14세,2021,4062,2033,2029,100.2,4057,2029,2028,100
37060, 영주시,015001, 10세,2021,794,403,391,103.1,792,401,391,102.6
37060, 영주시,015002, 11세,2021,820,422,398,106,819,421,398,105.8
37060, 영주시,015003, 12세,2021,796,402,394,102,796,402,394,102
37060, 영주시,015004, 13세,2021,832,400,432,92.6,831,400,431,92.8
37060, 영주시,015005, 14세,2021,820,406,414,98.1,819,405,414,97.8
37060, 영주시,020,15~19세,2021,5055,2871,2184,131.5,5047,2868,2179,131.6
37060, 영주시,020001, 15세,2021,814,454,360,126.1,812,453,359,126.2
37060, 영주시,020002, 16세,2021,883,504,379,133,882,503,379,132.7
37060, 영주시,020003, 17세,2021,1067,639,428,149.3,1067,639,428,149.3
37060, 영주시,020004, 18세,2021,1065,594,471,126.1,1064,594,470,126.4
37060, 영주시,020005, 19세,2021,1226,680,546,124.5,1222,679,543,125
37060, 영주시,025,20~24세,2021,6089,3401,2688,126.5,5998,3367,2631,128
37060, 영주시,025001, 20세,2021,1433,705,728,96.8,1428,704,724,97.2
37060, 영주시,025002, 21세,2021,1393,747,646,115.6,1381,741,640,115.8
37060, 영주시,025003, 22세,2021,1199,667,532,125.4,1183,663,520,127.5
37060, 영주시,025004, 23세,2021,1024,640,384,166.7,1003,634,369,171.8
37060, 영주시,025005, 24세,2021,1040,642,398,161.3,1003,625,378,165.3
37060, 영주시,030,25~29세,2021,4461,2605,1856,140.4,4221,2486,1735,143.3
37060, 영주시,030001, 25세,2021,977,594,383,155.1,926,568,358,158.7
37060, 영주시,030002, 26세,2021,944,542,402,134.8,889,514,375,137.1
37060, 영주시,030003, 27세,2021,827,480,347,138.3,795,463,332,139.5
37060, 영주시,030004, 28세,2021,841,486,355,136.9,791,462,329,140.4
37060, 영주시,030005, 29세,2021,872,503,369,136.3,820,479,341,140.5
37060, 영주시,035,30~34세,2021,3678,2045,1633,125.2,3469,1948,1521,128.1
37060, 영주시,035001, 30세,2021,733,429,304,141.1,685,404,281,143.8
37060, 영주시,035002, 31세,2021,777,435,342,127.2,731,413,318,129.9
37060, 영주시,035003, 32세,2021,711,416,295,141,682,404,278,145.3
37060, 영주시,035004, 33세,2021,720,391,329,118.8,675,373,302,123.5
37060, 영주시,035005, 34세,2021,737,374,363,103,696,354,342,103.5
37060, 영주시,040,35~39세,2021,4434,2277,2157,105.6,4271,2218,2053,108
37060, 영주시,040001, 35세,2021,751,384,367,104.6,710,371,339,109.4
37060, 영주시,040002, 36세,2021,790,429,361,118.8,748,411,337,122
37060, 영주시,040003, 37세,2021,782,389,393,99,753,383,370,103.5
37060, 영주시,040004, 38세,2021,1020,503,517,97.3,989,493,496,99.4
37060, 영주시,040005, 39세,2021,1091,572,519,110.2,1071,560,511,109.6
37060, 영주시,045,40~44세,2021,5894,2999,2895,103.6,5757,2943,2814,104.6
37060, 영주시,045001, 40세,2021,1113,553,560,98.8,1072,535,537,99.6
37060, 영주시,045002, 41세,2021,1203,615,588,104.6,1170,596,574,103.8
37060, 영주시,045003, 42세,2021,1204,612,592,103.4,1182,608,574,105.9
37060, 영주시,045004, 43세,2021,1144,585,559,104.7,1128,577,551,104.7
37060, 영주시,045005, 44세,2021,1230,634,596,106.4,1205,627,578,108.5
37060, 영주시,050,45~49세,2021,7286,3744,3542,105.7,7183,3704,3479,106.5
37060, 영주시,050001, 45세,2021,1310,658,652,100.9,1280,646,634,101.9
37060, 영주시,050002, 46세,2021,1389,700,689,101.6,1372,690,682,101.2
37060, 영주시,050003, 47세,2021,1486,754,732,103,1467,745,722,103.2
37060, 영주시,050004, 48세,2021,1580,809,771,104.9,1558,805,753,106.9
37060, 영주시,050005, 49세,2021,1521,823,698,117.9,1506,818,688,118.9
37060, 영주시,055,50~54세,2021,8503,4420,4083,108.3,8425,4390,4035,108.8
37060, 영주시,055001, 50세,2021,1607,873,734,118.9,1588,866,722,119.9
37060, 영주시,055002, 51세,2021,1660,867,793,109.3,1640,861,779,110.5
37060, 영주시,055003, 52세,2021,1762,944,818,115.4,1744,936,808,115.8
37060, 영주시,055004, 53세,2021,1840,960,880,109.1,1830,954,876,108.9
37060, 영주시,055005, 54세,2021,1634,776,858,90.4,1623,773,850,90.9
37060, 영주시,060,55~59세,2021,8461,4267,4194,101.7,8394,4240,4154,102.1
37060, 영주시,060001, 55세,2021,1682,855,827,103.4,1663,849,814,104.3
37060, 영주시,060002, 56세,2021,1601,808,793,101.9,1593,801,792,101.1
37060, 영주시,060003, 57세,2021,1623,813,810,100.4,1606,807,799,101
37060, 영주시,060004, 58세,2021,1687,841,846,99.4,1676,837,839,99.8
37060, 영주시,060005, 59세,2021,1868,950,918,103.5,1856,946,910,104
37060, 영주시,065,60~64세,2021,10201,5020,5181,96.9,10147,4996,5151,97
37060, 영주시,065001, 60세,2021,2283,1131,1152,98.2,2268,1126,1142,98.6
37060, 영주시,065002, 61세,2021,2276,1093,1183,92.4,2266,1086,1180,92
37060, 영주시,065003, 62세,2021,1833,903,930,97.1,1824,898,926,97
37060, 영주시,065004, 63세,2021,1794,890,904,98.5,1784,886,898,98.7
37060, 영주시,065005, 64세,2021,2015,1003,1012,99.1,2005,1000,1005,99.5
37060, 영주시,070,65~69세,2021,8703,4120,4583,89.9,8673,4103,4570,89.8
37060, 영주시,070001, 65세,2021,1798,869,929,93.5,1792,866,926,93.5
37060, 영주시,070002, 66세,2021,1812,879,933,94.2,1805,875,930,94.1
37060, 영주시,070003, 67세,2021,1741,835,906,92.2,1734,831,903,92
37060, 영주시,070004, 68세,2021,1631,763,868,87.9,1626,759,867,87.5
37060, 영주시,070005, 69세,2021,1721,774,947,81.7,1716,772,944,81.8
37060, 영주시,075,70~74세,2021,6517,3126,3391,92.2,6509,3121,3388,92.1
37060, 영주시,075001, 70세,2021,1211,557,654,85.2,1208,555,653,85
37060, 영주시,075002, 71세,2021,1329,655,674,97.2,1326,653,673,97
37060, 영주시,075003, 72세,2021,1367,670,697,96.1,1367,670,697,96.1
37060, 영주시,075004, 73세,2021,1379,667,712,93.7,1379,667,712,93.7
37060, 영주시,075005, 74세,2021,1231,577,654,88.2,1229,576,653,88.2
37060, 영주시,080,75~79세,2021,5170,2189,2981,73.4,5170,2189,2981,73.4
37060, 영주시,080001, 75세,2021,719,329,390,84.4,719,329,390,84.4
37060, 영주시,080002, 76세,2021,884,383,501,76.4,884,383,501,76.4
37060, 영주시,080003, 77세,2021,1121,473,648,73,1121,473,648,73
37060, 영주시,080004, 78세,2021,1153,485,668,72.6,1153,485,668,72.6
37060, 영주시,080005, 79세,2021,1293,519,774,67.1,1293,519,774,67.1
37060, 영주시,085,80~84세,2021,4586,1751,2835,61.8,4585,1751,2834,61.8
37060, 영주시,085001, 80세,2021,1022,403,619,65.1,1022,403,619,65.1
37060, 영주시,085002, 81세,2021,934,345,589,58.6,934,345,589,58.6
37060, 영주시,085003, 82세,2021,1060,422,638,66.1,1060,422,638,66.1
37060, 영주시,085004, 83세,2021,868,322,546,59,867,322,545,59.1
37060, 영주시,085005, 84세,2021,702,259,443,58.5,702,259,443,58.5
37060, 영주시,090,85~89세,2021,2499,770,1729,44.5,2497,770,1727,44.6
37060, 영주시,090001, 85세,2021,679,255,424,60.1,679,255,424,60.1
37060, 영주시,090002, 86세,2021,613,188,425,44.2,612,188,424,44.3
37060, 영주시,090003, 87세,2021,481,140,341,41.1,481,140,341,41.1
37060, 영주시,090004, 88세,2021,384,104,280,37.1,384,104,280,37.1
37060, 영주시,090005, 89세,2021,342,83,259,32,341,83,258,32.2
37060, 영주시,095,90~94세,2021,894,201,693,29,894,201,693,29
37060, 영주시,095001, 90세,2021,283,71,212,33.5,283,71,212,33.5
37060, 영주시,095002, 91세,2021,203,42,161,26.1,203,42,161,26.1
37060, 영주시,095003, 92세,2021,173,35,138,25.4,173,35,138,25.4
37060, 영주시,095004, 93세,2021,149,29,120,24.2,149,29,120,24.2
37060, 영주시,095005, 94세,2021,86,24,62,38.7,86,24,62,38.7
37060, 영주시,100,95~99세,2021,205,26,179,14.5,205,26,179,14.5
37060, 영주시,100001, 95세,2021,64,9,55,16.4,64,9,55,16.4
37060, 영주시,100002, 96세,2021,59,7,52,13.5,59,7,52,13.5
37060, 영주시,100003, 97세,2021,37,X,34,8.8,37,X,34,8.8
37060, 영주시,100004, 98세,2021,24,X,21,14.3,24,X,21,14.3
37060, 영주시,100005, 99세,2021,21,X,17,23.5,21,X,17,23.5
37060, 영주시,101,100세이상,2021,46,7,39,17.9,46,7,39,17.9
37060, 영주시,102,15세미만,2021,9732,4992,4740,105.3,9711,4981,4730,105.3
37060, 영주시,103,15~64세,2021,64062,33649,30413,110.6,62912,33160,29752,111.5
37060, 영주시,104,65세이상,2021,28620,12190,16430,74.2,28579,12168,16411,74.1
37060, 영주시,086,85세이상,2021,3644,1004,2640,38,3642,1004,2638,38.1
37060, 영주시,126,평균연령,2021,49.3,47.2,51.4,,49.4,47.3,51.6,
37060, 영주시,127,중위연령,2021,52.7,50.6,55,,53,50.7,55.3,
37070, 영천시,000,합계,2021,99859,51049,48810,104.6,96040,48443,47597,101.8
37070, 영천시,005,0~4세,2021,2645,1348,1297,103.9,2621,1340,1281,104.6
37070, 영천시,005001, 0세,2021,535,265,270,98.1,529,264,265,99.6
37070, 영천시,005002, 1세,2021,549,280,269,104.1,545,279,266,104.9
37070, 영천시,005003, 2세,2021,510,266,244,109,505,264,241,109.5
37070, 영천시,005004, 3세,2021,519,262,257,101.9,516,260,256,101.6
37070, 영천시,005005, 4세,2021,532,275,257,107,526,273,253,107.9
37070, 영천시,010,5~9세,2021,2849,1443,1406,102.6,2824,1431,1393,102.7
37070, 영천시,010001, 5세,2021,545,273,272,100.4,537,270,267,101.1
37070, 영천시,010002, 6세,2021,596,301,295,102,590,297,293,101.4
37070, 영천시,010003, 7세,2021,532,288,244,118,529,287,242,118.6
37070, 영천시,010004, 8세,2021,565,289,276,104.7,563,287,276,104
37070, 영천시,010005, 9세,2021,611,292,319,91.5,605,290,315,92.1
37070, 영천시,015,10~14세,2021,3072,1660,1412,117.6,3062,1654,1408,117.5
37070, 영천시,015001, 10세,2021,586,308,278,110.8,586,308,278,110.8
37070, 영천시,015002, 11세,2021,607,313,294,106.5,604,312,292,106.8
37070, 영천시,015003, 12세,2021,599,332,267,124.3,595,329,266,123.7
37070, 영천시,015004, 13세,2021,616,337,279,120.8,616,337,279,120.8
37070, 영천시,015005, 14세,2021,664,370,294,125.9,661,368,293,125.6
37070, 영천시,020,15~19세,2021,3111,1668,1443,115.6,3099,1663,1436,115.8
37070, 영천시,020001, 15세,2021,578,295,283,104.2,576,295,281,105
37070, 영천시,020002, 16세,2021,669,342,327,104.6,667,341,326,104.6
37070, 영천시,020003, 17세,2021,707,366,341,107.3,707,366,341,107.3
37070, 영천시,020004, 18세,2021,645,348,297,117.2,642,346,296,116.9
37070, 영천시,020005, 19세,2021,512,317,195,162.6,507,315,192,164.1
37070, 영천시,025,20~24세,2021,4489,2824,1665,169.6,4112,2586,1526,169.5
37070, 영천시,025001, 20세,2021,700,453,247,183.4,693,451,242,186.4
37070, 영천시,025002, 21세,2021,887,602,285,211.2,870,598,272,219.9
37070, 영천시,025003, 22세,2021,864,544,320,170,818,514,304,169.1
37070, 영천시,025004, 23세,2021,1004,599,405,147.9,837,493,344,143.3
37070, 영천시,025005, 24세,2021,1034,626,408,153.4,894,530,364,145.6
37070, 영천시,030,25~29세,2021,5282,3186,2096,152,4483,2593,1890,137.2
37070, 영천시,030001, 25세,2021,1068,641,427,150.1,937,544,393,138.4
37070, 영천시,030002, 26세,2021,1090,651,439,148.3,926,537,389,138
37070, 영천시,030003, 27세,2021,1002,623,379,164.4,855,508,347,146.4
37070, 영천시,030004, 28세,2021,1045,631,414,152.4,886,513,373,137.5
37070, 영천시,030005, 29세,2021,1077,640,437,146.5,879,491,388,126.5
37070, 영천시,035,30~34세,2021,4935,2845,2090,136.1,4128,2258,1870,120.7
37070, 영천시,035001, 30세,2021,1012,588,424,138.7,838,455,383,118.8
37070, 영천시,035002, 31세,2021,1016,607,409,148.4,844,478,366,130.6
37070, 영천시,035003, 32세,2021,933,548,385,142.3,785,444,341,130.2
37070, 영천시,035004, 33세,2021,992,571,421,135.6,845,464,381,121.8
37070, 영천시,035005, 34세,2021,982,531,451,117.7,816,417,399,104.5
37070, 영천시,040,35~39세,2021,5174,2932,2242,130.8,4584,2481,2103,118
37070, 영천시,040001, 35세,2021,974,553,421,131.4,842,451,391,115.3
37070, 영천시,040002, 36세,2021,957,542,415,130.6,827,440,387,113.7
37070, 영천시,040003, 37세,2021,989,579,410,141.2,890,506,384,131.8
37070, 영천시,040004, 38세,2021,1110,616,494,124.7,998,531,467,113.7
37070, 영천시,040005, 39세,2021,1144,642,502,127.9,1027,553,474,116.7
37070, 영천시,045,40~44세,2021,5558,3049,2509,121.5,5135,2770,2365,117.1
37070, 영천시,045001, 40세,2021,1170,635,535,118.7,1066,565,501,112.8
37070, 영천시,045002, 41세,2021,1201,663,538,123.2,1103,601,502,119.7
37070, 영천시,045003, 42세,2021,1124,610,514,118.7,1041,554,487,113.8
37070, 영천시,045004, 43세,2021,1028,572,456,125.4,956,528,428,123.4
37070, 영천시,045005, 44세,2021,1035,569,466,122.1,969,522,447,116.8
37070, 영천시,050,45~49세,2021,6754,3672,3082,119.1,6498,3515,2983,117.8
37070, 영천시,050001, 45세,2021,1194,666,528,126.1,1118,616,502,122.7
37070, 영천시,050002, 46세,2021,1292,722,570,126.7,1239,691,548,126.1
37070, 영천시,050003, 47세,2021,1437,768,669,114.8,1391,741,650,114
37070, 영천시,050004, 48세,2021,1372,724,648,111.7,1333,700,633,110.6
37070, 영천시,050005, 49세,2021,1459,792,667,118.7,1417,767,650,118
37070, 영천시,055,50~54세,2021,8372,4434,3938,112.6,8157,4311,3846,112.1
37070, 영천시,055001, 50세,2021,1633,878,755,116.3,1578,843,735,114.7
37070, 영천시,055002, 51세,2021,1512,780,732,106.6,1475,757,718,105.4
37070, 영천시,055003, 52세,2021,1658,873,785,111.2,1618,845,773,109.3
37070, 영천시,055004, 53세,2021,1854,993,861,115.3,1800,967,833,116.1
37070, 영천시,055005, 54세,2021,1715,910,805,113,1686,899,787,114.2
37070, 영천시,060,55~59세,2021,8957,4631,4326,107.1,8814,4554,4260,106.9
37070, 영천시,060001, 55세,2021,1774,943,831,113.5,1745,929,816,113.8
37070, 영천시,060002, 56세,2021,1662,852,810,105.2,1636,838,798,105
37070, 영천시,060003, 57세,2021,1799,934,865,108,1768,916,852,107.5
37070, 영천시,060004, 58세,2021,1813,939,874,107.4,1780,922,858,107.5
37070, 영천시,060005, 59세,2021,1909,963,946,101.8,1885,949,936,101.4
37070, 영천시,065,60~64세,2021,10164,5177,4987,103.8,10088,5136,4952,103.7
37070, 영천시,065001, 60세,2021,2186,1122,1064,105.5,2167,1110,1057,105
37070, 영천시,065002, 61세,2021,2139,1042,1097,95,2120,1033,1087,95
37070, 영천시,065003, 62세,2021,2126,1076,1050,102.5,2109,1068,1041,102.6
37070, 영천시,065004, 63세,2021,1777,896,881,101.7,1766,891,875,101.8
37070, 영천시,065005, 64세,2021,1936,1041,895,116.3,1926,1034,892,115.9
37070, 영천시,070,65~69세,2021,8468,4118,4350,94.7,8431,4100,4331,94.7
37070, 영천시,070001, 65세,2021,1832,926,906,102.2,1821,921,900,102.3
37070, 영천시,070002, 66세,2021,1850,900,950,94.7,1843,895,948,94.4
37070, 영천시,070003, 67세,2021,1543,760,783,97.1,1535,757,778,97.3
37070, 영천시,070004, 68세,2021,1591,746,845,88.3,1585,744,841,88.5
37070, 영천시,070005, 69세,2021,1652,786,866,90.8,1647,783,864,90.6
37070, 영천시,075,70~74세,2021,6996,3392,3604,94.1,6983,3384,3599,94
37070, 영천시,075001, 70세,2021,1427,699,728,96,1423,696,727,95.7
37070, 영천시,075002, 71세,2021,1442,718,724,99.2,1439,717,722,99.3
37070, 영천시,075003, 72세,2021,1453,700,753,93,1450,697,753,92.6
37070, 영천시,075004, 73세,2021,1427,693,734,94.4,1424,692,732,94.5
37070, 영천시,075005, 74세,2021,1247,582,665,87.5,1247,582,665,87.5
37070, 영천시,080,75~79세,2021,5350,2203,3147,70,5342,2200,3142,70
37070, 영천시,080001, 75세,2021,826,374,452,82.7,824,373,451,82.7
37070, 영천시,080002, 76세,2021,942,400,542,73.8,941,399,542,73.6
37070, 영천시,080003, 77세,2021,1052,435,617,70.5,1050,434,616,70.5
37070, 영천시,080004, 78세,2021,1142,440,702,62.7,1141,440,701,62.8
37070, 영천시,080005, 79세,2021,1388,554,834,66.4,1386,554,832,66.6
37070, 영천시,085,80~84세,2021,4415,1553,2862,54.3,4411,1553,2858,54.3
37070, 영천시,085001, 80세,2021,1012,377,635,59.4,1012,377,635,59.4
37070, 영천시,085002, 81세,2021,919,342,577,59.3,919,342,577,59.3
37070, 영천시,085003, 82세,2021,950,327,623,52.5,950,327,623,52.5
37070, 영천시,085004, 83세,2021,814,278,536,51.9,811,278,533,52.2
37070, 영천시,085005, 84세,2021,720,229,491,46.6,719,229,490,46.7
37070, 영천시,090,85~89세,2021,2451,732,1719,42.6,2451,732,1719,42.6
37070, 영천시,090001, 85세,2021,664,208,456,45.6,664,208,456,45.6
37070, 영천시,090002, 86세,2021,582,179,403,44.4,582,179,403,44.4
37070, 영천시,090003, 87세,2021,490,147,343,42.9,490,147,343,42.9
37070, 영천시,090004, 88세,2021,398,109,289,37.7,398,109,289,37.7
37070, 영천시,090005, 89세,2021,317,89,228,39,317,89,228,39
37070, 영천시,095,90~94세,2021,690,159,531,29.9,690,159,531,29.9
37070, 영천시,095001, 90세,2021,228,50,178,28.1,228,50,178,28.1
37070, 영천시,095002, 91세,2021,185,51,134,38.1,185,51,134,38.1
37070, 영천시,095003, 92세,2021,128,24,104,23.1,128,24,104,23.1
37070, 영천시,095004, 93세,2021,91,17,74,23,91,17,74,23
37070, 영천시,095005, 94세,2021,58,17,41,41.5,58,17,41,41.5
37070, 영천시,100,95~99세,2021,110,19,91,20.9,110,19,91,20.9
37070, 영천시,100001, 95세,2021,44,9,35,25.7,44,9,35,25.7
37070, 영천시,100002, 96세,2021,26,6,20,30,26,6,20,30
37070, 영천시,100003, 97세,2021,14,X,13,7.7,14,X,13,7.7
37070, 영천시,100004, 98세,2021,9,X,8,12.5,9,X,8,12.5
37070, 영천시,100005, 99세,2021,17,X,15,13.3,17,X,15,13.3
37070, 영천시,101,100세이상,2021,17,X,13,30.8,17,X,13,30.8
37070, 영천시,102,15세미만,2021,8566,4451,4115,108.2,8507,4425,4082,108.4
37070, 영천시,103,15~64세,2021,62796,34418,28378,121.3,59098,31867,27231,117
37070, 영천시,104,65세이상,2021,28497,12180,16317,74.6,28435,12151,16284,74.6
37070, 영천시,086,85세이상,2021,3268,914,2354,38.8,3268,914,2354,38.8
37070, 영천시,126,평균연령,2021,50.2,47.9,52.6,,50.8,48.6,53,
37070, 영천시,127,중위연령,2021,53.7,51,56.5,,54.6,52.4,57.1,
37080, 상주시,000,합계,2021,93722,46229,47493,97.3,92382,45672,46710,97.8
37080, 상주시,005,0~4세,2021,1988,1011,977,103.5,1978,1003,975,102.9
37080, 상주시,005001, 0세,2021,329,165,164,100.6,327,163,164,99.4
37080, 상주시,005002, 1세,2021,375,196,179,109.5,372,193,179,107.8
37080, 상주시,005003, 2세,2021,405,199,206,96.6,404,198,206,96.1
37080, 상주시,005004, 3세,2021,433,223,210,106.2,431,223,208,107.2
37080, 상주시,005005, 4세,2021,446,228,218,104.6,444,226,218,103.7
37080, 상주시,010,5~9세,2021,2814,1496,1318,113.5,2800,1491,1309,113.9
37080, 상주시,010001, 5세,2021,511,258,253,102,506,257,249,103.2
37080, 상주시,010002, 6세,2021,549,301,248,121.4,547,300,247,121.5
37080, 상주시,010003, 7세,2021,526,286,240,119.2,522,284,238,119.3
37080, 상주시,010004, 8세,2021,594,309,285,108.4,591,308,283,108.8
37080, 상주시,010005, 9세,2021,634,342,292,117.1,634,342,292,117.1
37080, 상주시,015,10~14세,2021,3349,1758,1591,110.5,3343,1754,1589,110.4
37080, 상주시,015001, 10세,2021,647,335,312,107.4,647,335,312,107.4
37080, 상주시,015002, 11세,2021,637,327,310,105.5,636,326,310,105.2
37080, 상주시,015003, 12세,2021,651,327,324,100.9,650,327,323,101.2
37080, 상주시,015004, 13세,2021,701,373,328,113.7,699,372,327,113.8
37080, 상주시,015005, 14세,2021,713,396,317,124.9,711,394,317,124.3
37080, 상주시,020,15~19세,2021,3866,2154,1712,125.8,3860,2153,1707,126.1
37080, 상주시,020001, 15세,2021,684,355,329,107.9,682,355,327,108.6
37080, 상주시,020002, 16세,2021,766,396,370,107,765,396,369,107.3
37080, 상주시,020003, 17세,2021,812,450,362,124.3,811,450,361,124.7
37080, 상주시,020004, 18세,2021,857,476,381,124.9,856,476,380,125.3
37080, 상주시,020005, 19세,2021,747,477,270,176.7,746,476,270,176.3
37080, 상주시,025,20~24세,2021,4582,2864,1718,166.7,4494,2830,1664,170.1
37080, 상주시,025001, 20세,2021,877,524,353,148.4,874,523,351,149
37080, 상주시,025002, 21세,2021,980,621,359,173,969,618,351,176.1
37080, 상주시,025003, 22세,2021,904,562,342,164.3,890,556,334,166.5
37080, 상주시,025004, 23세,2021,922,588,334,176,902,580,322,180.1
37080, 상주시,025005, 24세,2021,899,569,330,172.4,859,553,306,180.7
37080, 상주시,030,25~29세,2021,3548,2097,1451,144.5,3305,1980,1325,149.4
37080, 상주시,030001, 25세,2021,809,498,311,160.1,776,480,296,162.2
37080, 상주시,030002, 26세,2021,727,436,291,149.8,676,413,263,157
37080, 상주시,030003, 27세,2021,682,389,293,132.8,633,365,268,136.2
37080, 상주시,030004, 28세,2021,644,374,270,138.5,585,339,246,137.8
37080, 상주시,030005, 29세,2021,686,400,286,139.9,635,383,252,152
37080, 상주시,035,30~34세,2021,3210,1705,1505,113.3,2967,1604,1363,117.7
37080, 상주시,035001, 30세,2021,662,348,314,110.8,606,327,279,117.2
37080, 상주시,035002, 31세,2021,643,348,295,118,594,320,274,116.8
37080, 상주시,035003, 32세,2021,622,339,283,119.8,574,318,256,124.2
37080, 상주시,035004, 33세,2021,596,314,282,111.3,565,298,267,111.6
37080, 상주시,035005, 34세,2021,687,356,331,107.6,628,341,287,118.8
37080, 상주시,040,35~39세,2021,3903,2083,1820,114.5,3728,2013,1715,117.4
37080, 상주시,040001, 35세,2021,695,376,319,117.9,655,359,296,121.3
37080, 상주시,040002, 36세,2021,683,376,307,122.5,640,357,283,126.1
37080, 상주시,040003, 37세,2021,764,403,361,111.6,733,396,337,117.5
37080, 상주시,040004, 38세,2021,842,437,405,107.9,810,420,390,107.7
37080, 상주시,040005, 39세,2021,919,491,428,114.7,890,481,409,117.6
37080, 상주시,045,40~44세,2021,4663,2424,2239,108.3,4534,2379,2155,110.4
37080, 상주시,045001, 40세,2021,929,496,433,114.5,901,483,418,115.6
37080, 상주시,045002, 41세,2021,987,502,485,103.5,955,492,463,106.3
37080, 상주시,045003, 42세,2021,926,487,439,110.9,898,480,418,114.8
37080, 상주시,045004, 43세,2021,864,457,407,112.3,841,449,392,114.5
37080, 상주시,045005, 44세,2021,957,482,475,101.5,939,475,464,102.4
37080, 상주시,050,45~49세,2021,5941,3099,2842,109,5825,3065,2760,111.1
37080, 상주시,050001, 45세,2021,989,522,467,111.8,964,512,452,113.3
37080, 상주시,050002, 46세,2021,1136,589,547,107.7,1119,586,533,109.9
37080, 상주시,050003, 47세,2021,1292,682,610,111.8,1266,673,593,113.5
37080, 상주시,050004, 48세,2021,1286,675,611,110.5,1260,667,593,112.5
37080, 상주시,050005, 49세,2021,1238,631,607,104,1216,627,589,106.5
37080, 상주시,055,50~54세,2021,7337,3920,3417,114.7,7231,3875,3356,115.5
37080, 상주시,055001, 50세,2021,1430,780,650,120,1414,770,644,119.6
37080, 상주시,055002, 51세,2021,1414,762,652,116.9,1392,756,636,118.9
37080, 상주시,055003, 52세,2021,1391,753,638,118,1371,747,624,119.7
37080, 상주시,055004, 53세,2021,1591,845,746,113.3,1566,833,733,113.6
37080, 상주시,055005, 54세,2021,1511,780,731,106.7,1488,769,719,107
37080, 상주시,060,55~59세,2021,8341,4310,4031,106.9,8254,4269,3985,107.1
37080, 상주시,060001, 55세,2021,1524,822,702,117.1,1506,813,693,117.3
37080, 상주시,060002, 56세,2021,1575,792,783,101.1,1558,785,773,101.6
37080, 상주시,060003, 57세,2021,1659,840,819,102.6,1634,830,804,103.2
37080, 상주시,060004, 58세,2021,1769,931,838,111.1,1751,921,830,111
37080, 상주시,060005, 59세,2021,1814,925,889,104,1805,920,885,104
37080, 상주시,065,60~64세,2021,10084,5081,5003,101.6,10033,5062,4971,101.8
37080, 상주시,065001, 60세,2021,2035,1045,990,105.6,2029,1042,987,105.6
37080, 상주시,065002, 61세,2021,2252,1100,1152,95.5,2241,1094,1147,95.4
37080, 상주시,065003, 62세,2021,1990,997,993,100.4,1982,995,987,100.8
37080, 상주시,065004, 63세,2021,1892,951,941,101.1,1879,948,931,101.8
37080, 상주시,065005, 64세,2021,1915,988,927,106.6,1902,983,919,107
37080, 상주시,070,65~69세,2021,8445,4025,4420,91.1,8412,4009,4403,91.1
37080, 상주시,070001, 65세,2021,1816,878,938,93.6,1806,872,934,93.4
37080, 상주시,070002, 66세,2021,1797,866,931,93,1792,864,928,93.1
37080, 상주시,070003, 67세,2021,1632,764,868,88,1624,761,863,88.2
37080, 상주시,070004, 68세,2021,1501,723,778,92.9,1497,722,775,93.2
37080, 상주시,070005, 69세,2021,1699,794,905,87.7,1693,790,903,87.5
37080, 상주시,075,70~74세,2021,6717,3150,3567,88.3,6696,3139,3557,88.2
37080, 상주시,075001, 70세,2021,1166,539,627,86,1161,535,626,85.5
37080, 상주시,075002, 71세,2021,1308,609,699,87.1,1300,605,695,87.1
37080, 상주시,075003, 72세,2021,1521,749,772,97,1520,748,772,96.9
37080, 상주시,075004, 73세,2021,1371,645,726,88.8,1365,643,722,89.1
37080, 상주시,075005, 74세,2021,1351,608,743,81.8,1350,608,742,81.9
37080, 상주시,080,75~79세,2021,5381,2162,3219,67.2,5376,2159,3217,67.1
37080, 상주시,080001, 75세,2021,815,387,428,90.4,812,386,426,90.6
37080, 상주시,080002, 76세,2021,871,377,494,76.3,870,376,494,76.1
37080, 상주시,080003, 77세,2021,1010,363,647,56.1,1009,362,647,56
37080, 상주시,080004, 78세,2021,1205,488,717,68.1,1205,488,717,68.1
37080, 상주시,080005, 79세,2021,1480,547,933,58.6,1480,547,933,58.6
37080, 상주시,085,80~84세,2021,5299,1782,3517,50.7,5295,1780,3515,50.6
37080, 상주시,085001, 80세,2021,1127,399,728,54.8,1126,399,727,54.9
37080, 상주시,085002, 81세,2021,1156,395,761,51.9,1155,395,760,52
37080, 상주시,085003, 82세,2021,1138,375,763,49.1,1137,374,763,49
37080, 상주시,085004, 83세,2021,972,330,642,51.4,972,330,642,51.4
37080, 상주시,085005, 84세,2021,906,283,623,45.4,905,282,623,45.3
37080, 상주시,090,85~89세,2021,2988,866,2122,40.8,2987,865,2122,40.8
37080, 상주시,090001, 85세,2021,800,240,560,42.9,800,240,560,42.9
37080, 상주시,090002, 86세,2021,734,240,494,48.6,733,239,494,48.4
37080, 상주시,090003, 87세,2021,600,171,429,39.9,600,171,429,39.9
37080, 상주시,090004, 88세,2021,459,112,347,32.3,459,112,347,32.3
37080, 상주시,090005, 89세,2021,395,103,292,35.3,395,103,292,35.3
37080, 상주시,095,90~94세,2021,993,207,786,26.3,991,207,784,26.4
37080, 상주시,095001, 90세,2021,293,71,222,32,293,71,222,32
37080, 상주시,095002, 91세,2021,239,50,189,26.5,238,50,188,26.6
37080, 상주시,095003, 92세,2021,183,36,147,24.5,182,36,146,24.7
37080, 상주시,095004, 93세,2021,158,30,128,23.4,158,30,128,23.4
37080, 상주시,095005, 94세,2021,120,20,100,20,120,20,100,20
37080, 상주시,100,95~99세,2021,243,34,209,16.3,243,34,209,16.3
37080, 상주시,100001, 95세,2021,97,11,86,12.8,97,11,86,12.8
37080, 상주시,100002, 96세,2021,55,11,44,25,55,11,44,25
37080, 상주시,100003, 97세,2021,40,6,34,17.6,40,6,34,17.6
37080, 상주시,100004, 98세,2021,25,X,25,0,25,X,25,0
37080, 상주시,100005, 99세,2021,26,6,20,30,26,6,20,30
37080, 상주시,101,100세이상,2021,30,X,29,3.4,30,X,29,3.4
37080, 상주시,102,15세미만,2021,8151,4265,3886,109.8,8121,4248,3873,109.7
37080, 상주시,103,15~64세,2021,55475,29737,25738,115.5,54231,29230,25001,116.9
37080, 상주시,104,65세이상,2021,30096,12227,17869,68.4,30030,12194,17836,68.4
37080, 상주시,086,85세이상,2021,4254,1108,3146,35.2,4251,1107,3144,35.2
37080, 상주시,126,평균연령,2021,51.8,49,54.6,,52,49.1,54.8,
37080, 상주시,127,중위연령,2021,56.1,53.2,59,,56.4,53.3,59.4,
37090, 문경시,000,합계,2021,67669,33175,34494,96.2,66733,32743,33990,96.3
37090, 문경시,005,0~4세,2021,1631,835,796,104.9,1624,830,794,104.5
37090, 문경시,005001, 0세,2021,292,151,141,107.1,291,150,141,106.4
37090, 문경시,005002, 1세,2021,339,177,162,109.3,337,175,162,108
37090, 문경시,005003, 2세,2021,316,156,160,97.5,316,156,160,97.5
37090, 문경시,005004, 3세,2021,314,162,152,106.6,311,161,150,107.3
37090, 문경시,005005, 4세,2021,370,189,181,104.4,369,188,181,103.9
37090, 문경시,010,5~9세,2021,2130,1088,1042,104.4,2126,1086,1040,104.4
37090, 문경시,010001, 5세,2021,392,190,202,94.1,392,190,202,94.1
37090, 문경시,010002, 6세,2021,415,211,204,103.4,415,211,204,103.4
37090, 문경시,010003, 7세,2021,399,207,192,107.8,398,206,192,107.3
37090, 문경시,010004, 8세,2021,450,232,218,106.4,448,232,216,107.4
37090, 문경시,010005, 9세,2021,474,248,226,109.7,473,247,226,109.3
37090, 문경시,015,10~14세,2021,2427,1309,1118,117.1,2423,1309,1114,117.5
37090, 문경시,015001, 10세,2021,524,283,241,117.4,524,283,241,117.4
37090, 문경시,015002, 11세,2021,442,232,210,110.5,440,232,208,111.5
37090, 문경시,015003, 12세,2021,455,240,215,111.6,455,240,215,111.6
37090, 문경시,015004, 13세,2021,488,274,214,128,487,274,213,128.6
37090, 문경시,015005, 14세,2021,518,280,238,117.6,517,280,237,118.1
37090, 문경시,020,15~19세,2021,2578,1450,1128,128.5,2574,1446,1128,128.2
37090, 문경시,020001, 15세,2021,498,286,212,134.9,498,286,212,134.9
37090, 문경시,020002, 16세,2021,564,313,251,124.7,563,312,251,124.3
37090, 문경시,020003, 17세,2021,572,316,256,123.4,570,314,256,122.7
37090, 문경시,020004, 18세,2021,541,306,235,130.2,541,306,235,130.2
37090, 문경시,020005, 19세,2021,403,229,174,131.6,402,228,174,131
37090, 문경시,025,20~24세,2021,2716,1557,1159,134.3,2631,1510,1121,134.7
37090, 문경시,025001, 20세,2021,572,359,213,168.5,567,356,211,168.7
37090, 문경시,025002, 21세,2021,627,374,253,147.8,613,366,247,148.2
37090, 문경시,025003, 22세,2021,504,280,224,125,493,276,217,127.2
37090, 문경시,025004, 23세,2021,481,271,210,129,466,260,206,126.2
37090, 문경시,025005, 24세,2021,532,273,259,105.4,492,252,240,105
37090, 문경시,030,25~29세,2021,2579,1430,1149,124.5,2426,1345,1081,124.4
37090, 문경시,030001, 25세,2021,542,282,260,108.5,514,269,245,109.8
37090, 문경시,030002, 26세,2021,533,304,229,132.8,501,286,215,133
37090, 문경시,030003, 27세,2021,494,288,206,139.8,457,264,193,136.8
37090, 문경시,030004, 28세,2021,484,271,213,127.2,456,257,199,129.1
37090, 문경시,030005, 29세,2021,526,285,241,118.3,498,269,229,117.5
37090, 문경시,035,30~34세,2021,2376,1276,1100,116,2226,1209,1017,118.9
37090, 문경시,035001, 30세,2021,425,232,193,120.2,395,213,182,117
37090, 문경시,035002, 31세,2021,459,261,198,131.8,425,248,177,140.1
37090, 문경시,035003, 32세,2021,459,229,230,99.6,431,217,214,101.4
37090, 문경시,035004, 33세,2021,497,266,231,115.2,468,254,214,118.7
37090, 문경시,035005, 34세,2021,536,288,248,116.1,507,277,230,120.4
37090, 문경시,040,35~39세,2021,3017,1567,1450,108.1,2901,1518,1383,109.8
37090, 문경시,040001, 35세,2021,490,247,243,101.6,465,236,229,103.1
37090, 문경시,040002, 36세,2021,528,297,231,128.6,501,284,217,130.9
37090, 문경시,040003, 37세,2021,620,329,291,113.1,600,319,281,113.5
37090, 문경시,040004, 38세,2021,628,334,294,113.6,613,328,285,115.1
37090, 문경시,040005, 39세,2021,751,360,391,92.1,722,351,371,94.6
37090, 문경시,045,40~44세,2021,3634,1921,1713,112.1,3552,1886,1666,113.2
37090, 문경시,045001, 40세,2021,681,356,325,109.5,665,345,320,107.8
37090, 문경시,045002, 41세,2021,749,401,348,115.2,729,394,335,117.6
37090, 문경시,045003, 42세,2021,741,396,345,114.8,724,388,336,115.5
37090, 문경시,045004, 43세,2021,703,354,349,101.4,691,350,341,102.6
37090, 문경시,045005, 44세,2021,760,414,346,119.7,743,409,334,122.5
37090, 문경시,050,45~49세,2021,4588,2452,2136,114.8,4508,2416,2092,115.5
37090, 문경시,050001, 45세,2021,768,406,362,112.2,759,399,360,110.8
37090, 문경시,050002, 46세,2021,927,484,443,109.3,902,477,425,112.2
37090, 문경시,050003, 47세,2021,1012,543,469,115.8,994,533,461,115.6
37090, 문경시,050004, 48세,2021,923,485,438,110.7,905,479,426,112.4
37090, 문경시,050005, 49세,2021,958,534,424,125.9,948,528,420,125.7
37090, 문경시,055,50~54세,2021,5325,2799,2526,110.8,5251,2771,2480,111.7
37090, 문경시,055001, 50세,2021,979,516,463,111.4,965,510,455,112.1
37090, 문경시,055002, 51세,2021,1033,544,489,111.2,1021,538,483,111.4
37090, 문경시,055003, 52세,2021,1085,570,515,110.7,1072,568,504,112.7
37090, 문경시,055004, 53세,2021,1112,595,517,115.1,1094,586,508,115.4
37090, 문경시,055005, 54세,2021,1116,574,542,105.9,1099,569,530,107.4
37090, 문경시,060,55~59세,2021,5997,3057,2940,104,5917,3024,2893,104.5
37090, 문경시,060001, 55세,2021,1126,577,549,105.1,1113,571,542,105.4
37090, 문경시,060002, 56세,2021,1134,563,571,98.6,1109,553,556,99.5
37090, 문경시,060003, 57세,2021,1156,596,560,106.4,1142,590,552,106.9
37090, 문경시,060004, 58세,2021,1297,664,633,104.9,1277,655,622,105.3
37090, 문경시,060005, 59세,2021,1284,657,627,104.8,1276,655,621,105.5
37090, 문경시,065,60~64세,2021,7265,3584,3681,97.4,7211,3563,3648,97.7
37090, 문경시,065001, 60세,2021,1489,731,758,96.4,1480,728,752,96.8
37090, 문경시,065002, 61세,2021,1603,786,817,96.2,1589,781,808,96.7
37090, 문경시,065003, 62세,2021,1362,673,689,97.7,1350,668,682,97.9
37090, 문경시,065004, 63세,2021,1375,694,681,101.9,1365,689,676,101.9
37090, 문경시,065005, 64세,2021,1436,700,736,95.1,1427,697,730,95.5
37090, 문경시,070,65~69세,2021,6194,2977,3217,92.5,6174,2970,3204,92.7
37090, 문경시,070001, 65세,2021,1382,674,708,95.2,1375,672,703,95.6
37090, 문경시,070002, 66세,2021,1317,648,669,96.9,1312,646,666,97
37090, 문경시,070003, 67세,2021,1153,557,596,93.5,1148,555,593,93.6
37090, 문경시,070004, 68세,2021,1159,540,619,87.2,1157,539,618,87.2
37090, 문경시,070005, 69세,2021,1183,558,625,89.3,1182,558,624,89.4
37090, 문경시,075,70~74세,2021,4876,2282,2594,88,4864,2275,2589,87.9
37090, 문경시,075001, 70세,2021,901,426,475,89.7,900,425,475,89.5
37090, 문경시,075002, 71세,2021,1024,484,540,89.6,1020,481,539,89.2
37090, 문경시,075003, 72세,2021,1071,510,561,90.9,1069,510,559,91.2
37090, 문경시,075004, 73세,2021,932,427,505,84.6,930,426,504,84.5
37090, 문경시,075005, 74세,2021,948,435,513,84.8,945,433,512,84.6
37090, 문경시,080,75~79세,2021,3989,1621,2368,68.5,3985,1618,2367,68.4
37090, 문경시,080001, 75세,2021,654,288,366,78.7,651,286,365,78.4
37090, 문경시,080002, 76세,2021,675,292,383,76.2,675,292,383,76.2
37090, 문경시,080003, 77세,2021,768,290,478,60.7,767,289,478,60.5
37090, 문경시,080004, 78세,2021,904,349,555,62.9,904,349,555,62.9
37090, 문경시,080005, 79세,2021,988,402,586,68.6,988,402,586,68.6
37090, 문경시,085,80~84세,2021,3589,1292,2297,56.2,3586,1291,2295,56.3
37090, 문경시,085001, 80세,2021,819,319,500,63.8,818,319,499,63.9
37090, 문경시,085002, 81세,2021,780,306,474,64.6,779,305,474,64.3
37090, 문경시,085003, 82세,2021,751,276,475,58.1,751,276,475,58.1
37090, 문경시,085004, 83세,2021,675,221,454,48.7,674,221,453,48.8
37090, 문경시,085005, 84세,2021,564,170,394,43.1,564,170,394,43.1
37090, 문경시,090,85~89세,2021,1937,520,1417,36.7,1933,518,1415,36.6
37090, 문경시,090001, 85세,2021,561,170,391,43.5,559,169,390,43.3
37090, 문경시,090002, 86세,2021,455,112,343,32.7,454,112,342,32.7
37090, 문경시,090003, 87세,2021,396,114,282,40.4,396,114,282,40.4
37090, 문경시,090004, 88세,2021,304,65,239,27.2,303,64,239,26.8
37090, 문경시,090005, 89세,2021,221,59,162,36.4,221,59,162,36.4
37090, 문경시,095,90~94세,2021,648,134,514,26.1,648,134,514,26.1
37090, 문경시,095001, 90세,2021,172,35,137,25.5,172,35,137,25.5
37090, 문경시,095002, 91세,2021,181,43,138,31.2,181,43,138,31.2
37090, 문경시,095003, 92세,2021,117,21,96,21.9,117,21,96,21.9
37090, 문경시,095004, 93세,2021,104,18,86,20.9,104,18,86,20.9
37090, 문경시,095005, 94세,2021,74,17,57,29.8,74,17,57,29.8
37090, 문경시,100,95~99세,2021,148,20,128,15.6,148,20,128,15.6
37090, 문경시,100001, 95세,2021,48,7,41,17.1,48,7,41,17.1
37090, 문경시,100002, 96세,2021,39,X,35,11.4,39,X,35,11.4
37090, 문경시,100003, 97세,2021,23,X,19,21.1,23,X,19,21.1
37090, 문경시,100004, 98세,2021,23,X,19,21.1,23,X,19,21.1
37090, 문경시,100005, 99세,2021,15,X,14,7.1,15,X,14,7.1
37090, 문경시,101,100세이상,2021,25,X,21,19,25,X,21,19
37090, 문경시,102,15세미만,2021,6188,3232,2956,109.3,6173,3225,2948,109.4
37090, 문경시,103,15~64세,2021,40075,21093,18982,111.1,39197,20688,18509,111.8
37090, 문경시,104,65세이상,2021,21406,8850,12556,70.5,21363,8830,12533,70.5
37090, 문경시,086,85세이상,2021,2758,678,2080,32.6,2754,676,2078,32.5
37090, 문경시,126,평균연령,2021,51.6,49.1,54,,51.8,49.3,54.2,
37090, 문경시,127,중위연령,2021,55.7,53.1,58.4,,56,53.3,58.7,
37100, 경산시,000,합계,2021,293418,147723,145695,101.4,279314,139624,139690,100
37100, 경산시,005,0~4세,2021,8376,4287,4089,104.8,8138,4168,3970,105
37100, 경산시,005001, 0세,2021,1449,732,717,102.1,1394,712,682,104.4
37100, 경산시,005002, 1세,2021,1483,745,738,100.9,1434,721,713,101.1
37100, 경산시,005003, 2세,2021,1688,896,792,113.1,1649,873,776,112.5
37100, 경산시,005004, 3세,2021,1819,928,891,104.2,1778,907,871,104.1
37100, 경산시,005005, 4세,2021,1937,986,951,103.7,1883,955,928,102.9
37100, 경산시,010,5~9세,2021,11625,5877,5748,102.2,11469,5794,5675,102.1
37100, 경산시,010001, 5세,2021,2312,1189,1123,105.9,2277,1171,1106,105.9
37100, 경산시,010002, 6세,2021,2258,1152,1106,104.2,2227,1132,1095,103.4
37100, 경산시,010003, 7세,2021,2279,1136,1143,99.4,2248,1122,1126,99.6
37100, 경산시,010004, 8세,2021,2340,1180,1160,101.7,2310,1163,1147,101.4
37100, 경산시,010005, 9세,2021,2436,1220,1216,100.3,2407,1206,1201,100.4
37100, 경산시,015,10~14세,2021,11209,5798,5411,107.2,11155,5769,5386,107.1
37100, 경산시,015001, 10세,2021,2444,1301,1143,113.8,2433,1294,1139,113.6
37100, 경산시,015002, 11세,2021,2136,1081,1055,102.5,2124,1076,1048,102.7
37100, 경산시,015003, 12세,2021,2133,1091,1042,104.7,2123,1086,1037,104.7
37100, 경산시,015004, 13세,2021,2183,1147,1036,110.7,2169,1138,1031,110.4
37100, 경산시,015005, 14세,2021,2313,1178,1135,103.8,2306,1175,1131,103.9
37100, 경산시,020,15~19세,2021,16215,8244,7971,103.4,15881,8105,7776,104.2
37100, 경산시,020001, 15세,2021,2092,1098,994,110.5,2090,1097,993,110.5
37100, 경산시,020002, 16세,2021,2007,1011,996,101.5,1998,1008,990,101.8
37100, 경산시,020003, 17세,2021,2364,1269,1095,115.9,2358,1265,1093,115.7
37100, 경산시,020004, 18세,2021,3125,1641,1484,110.6,3052,1614,1438,112.2
37100, 경산시,020005, 19세,2021,6627,3225,3402,94.8,6383,3121,3262,95.7
37100, 경산시,025,20~24세,2021,30739,15540,15199,102.2,26515,13244,13271,99.8
37100, 경산시,025001, 20세,2021,6022,2464,3558,69.3,5525,2227,3298,67.5
37100, 경산시,025002, 21세,2021,6705,2923,3782,77.3,5652,2378,3274,72.6
37100, 경산시,025003, 22세,2021,6492,3383,3109,108.8,5504,2828,2676,105.7
37100, 경산시,025004, 23세,2021,6119,3539,2580,137.2,5220,3034,2186,138.8
37100, 경산시,025005, 24세,2021,5401,3231,2170,148.9,4614,2777,1837,151.2
37100, 경산시,030,25~29세,2021,21627,12468,9159,136.1,18762,10726,8036,133.5
37100, 경산시,030001, 25세,2021,4826,2832,1994,142,4184,2424,1760,137.7
37100, 경산시,030002, 26세,2021,4481,2600,1881,138.2,3877,2236,1641,136.3
37100, 경산시,030003, 27세,2021,4216,2439,1777,137.3,3654,2097,1557,134.7
37100, 경산시,030004, 28세,2021,4044,2342,1702,137.6,3509,2026,1483,136.6
37100, 경산시,030005, 29세,2021,4060,2255,1805,124.9,3538,1943,1595,121.8
37100, 경산시,035,30~34세,2021,17627,9802,7825,125.3,15606,8631,6975,123.7
37100, 경산시,035001, 30세,2021,3748,2108,1640,128.5,3328,1850,1478,125.2
37100, 경산시,035002, 31세,2021,3615,2061,1554,132.6,3177,1805,1372,131.6
37100, 경산시,035003, 32세,2021,3444,1913,1531,125,3038,1692,1346,125.7
37100, 경산시,035004, 33세,2021,3376,1887,1489,126.7,2995,1671,1324,126.2
37100, 경산시,035005, 34세,2021,3444,1833,1611,113.8,3068,1613,1455,110.9
37100, 경산시,040,35~39세,2021,18606,9957,8649,115.1,17083,8999,8084,111.3
37100, 경산시,040001, 35세,2021,3301,1768,1533,115.3,2974,1555,1419,109.6
37100, 경산시,040002, 36세,2021,3560,1965,1595,123.2,3210,1758,1452,121.1
37100, 경산시,040003, 37세,2021,3538,1927,1611,119.6,3234,1741,1493,116.6
37100, 경산시,040004, 38세,2021,3906,2047,1859,110.1,3653,1884,1769,106.5
37100, 경산시,040005, 39세,2021,4301,2250,2051,109.7,4012,2061,1951,105.6
37100, 경산시,045,40~44세,2021,20398,10671,9727,109.7,19432,10068,9364,107.5
37100, 경산시,045001, 40세,2021,4307,2296,2011,114.2,4086,2161,1925,112.3
37100, 경산시,045002, 41세,2021,4381,2320,2061,112.6,4174,2191,1983,110.5
37100, 경산시,045003, 42세,2021,4189,2156,2033,106.1,3963,2013,1950,103.2
37100, 경산시,045004, 43세,2021,3727,1957,1770,110.6,3570,1859,1711,108.6
37100, 경산시,045005, 44세,2021,3794,1942,1852,104.9,3639,1844,1795,102.7
37100, 경산시,050,45~49세,2021,22106,11274,10832,104.1,21432,10872,10560,103
37100, 경산시,050001, 45세,2021,3928,2053,1875,109.5,3792,1969,1823,108
37100, 경산시,050002, 46세,2021,4167,2154,2013,107,4037,2075,1962,105.8
37100, 경산시,050003, 47세,2021,4589,2336,2253,103.7,4452,2261,2191,103.2
37100, 경산시,050004, 48세,2021,4713,2356,2357,100,4569,2267,2302,98.5
37100, 경산시,050005, 49세,2021,4709,2375,2334,101.8,4582,2300,2282,100.8
37100, 경산시,055,50~54세,2021,24022,11919,12103,98.5,23583,11663,11920,97.8
37100, 경산시,055001, 50세,2021,5055,2520,2535,99.4,4960,2459,2501,98.3
37100, 경산시,055002, 51세,2021,4747,2351,2396,98.1,4638,2277,2361,96.4
37100, 경산시,055003, 52세,2021,4773,2348,2425,96.8,4678,2300,2378,96.7
37100, 경산시,055004, 53세,2021,4989,2444,2545,96,4914,2405,2509,95.9
37100, 경산시,055005, 54세,2021,4458,2256,2202,102.5,4393,2222,2171,102.3
37100, 경산시,060,55~59세,2021,22030,11058,10972,100.8,21731,10904,10827,100.7
37100, 경산시,060001, 55세,2021,4512,2362,2150,109.9,4448,2326,2122,109.6
37100, 경산시,060002, 56세,2021,4474,2161,2313,93.4,4401,2131,2270,93.9
37100, 경산시,060003, 57세,2021,4153,2073,2080,99.7,4103,2048,2055,99.7
37100, 경산시,060004, 58세,2021,4348,2172,2176,99.8,4289,2136,2153,99.2
37100, 경산시,060005, 59세,2021,4543,2290,2253,101.6,4490,2263,2227,101.6
37100, 경산시,065,60~64세,2021,21391,10604,10787,98.3,21226,10525,10701,98.4
37100, 경산시,065001, 60세,2021,4800,2370,2430,97.5,4754,2347,2407,97.5
37100, 경산시,065002, 61세,2021,4603,2268,2335,97.1,4568,2253,2315,97.3
37100, 경산시,065003, 62세,2021,4436,2218,2218,100,4408,2206,2202,100.2
37100, 경산시,065004, 63세,2021,3697,1854,1843,100.6,3663,1837,1826,100.6
37100, 경산시,065005, 64세,2021,3855,1894,1961,96.6,3833,1882,1951,96.5
37100, 경산시,070,65~69세,2021,15781,7508,8273,90.8,15704,7465,8239,90.6
37100, 경산시,070001, 65세,2021,3503,1717,1786,96.1,3482,1704,1778,95.8
37100, 경산시,070002, 66세,2021,3490,1645,1845,89.2,3472,1633,1839,88.8
37100, 경산시,070003, 67세,2021,2993,1424,1569,90.8,2980,1422,1558,91.3
37100, 경산시,070004, 68세,2021,2818,1336,1482,90.1,2806,1330,1476,90.1
37100, 경산시,070005, 69세,2021,2977,1386,1591,87.1,2964,1376,1588,86.6
37100, 경산시,075,70~74세,2021,11826,5391,6435,83.8,11789,5374,6415,83.8
37100, 경산시,075001, 70세,2021,2396,1115,1281,87,2386,1111,1275,87.1
37100, 경산시,075002, 71세,2021,2328,1074,1254,85.6,2320,1069,1251,85.5
37100, 경산시,075003, 72세,2021,2550,1179,1371,86,2542,1174,1368,85.8
37100, 경산시,075004, 73세,2021,2362,1061,1301,81.6,2356,1060,1296,81.8
37100, 경산시,075005, 74세,2021,2190,962,1228,78.3,2185,960,1225,78.4
37100, 경산시,080,75~79세,2021,8328,3570,4758,75,8309,3565,4744,75.1
37100, 경산시,080001, 75세,2021,1353,644,709,90.8,1349,644,705,91.3
37100, 경산시,080002, 76세,2021,1476,649,827,78.5,1473,648,825,78.5
37100, 경산시,080003, 77세,2021,1726,710,1016,69.9,1722,708,1014,69.8
37100, 경산시,080004, 78세,2021,1822,770,1052,73.2,1819,769,1050,73.2
37100, 경산시,080005, 79세,2021,1951,797,1154,69.1,1946,796,1150,69.2
37100, 경산시,085,80~84세,2021,6577,2383,4194,56.8,6569,2381,4188,56.9
37100, 경산시,085001, 80세,2021,1515,589,926,63.6,1511,587,924,63.5
37100, 경산시,085002, 81세,2021,1459,527,932,56.5,1456,527,929,56.7
37100, 경산시,085003, 82세,2021,1388,523,865,60.5,1388,523,865,60.5
37100, 경산시,085004, 83세,2021,1173,411,762,53.9,1172,411,761,54
37100, 경산시,085005, 84세,2021,1042,333,709,47,1042,333,709,47
37100, 경산시,090,85~89세,2021,3582,1082,2500,43.3,3579,1081,2498,43.3
37100, 경산시,090001, 85세,2021,956,312,644,48.4,954,312,642,48.6
37100, 경산시,090002, 86세,2021,859,266,593,44.9,859,266,593,44.9
37100, 경산시,090003, 87세,2021,703,203,500,40.6,703,203,500,40.6
37100, 경산시,090004, 88세,2021,577,187,390,47.9,576,186,390,47.7
37100, 경산시,090005, 89세,2021,487,114,373,30.6,487,114,373,30.6
37100, 경산시,095,90~94세,2021,1112,256,856,29.9,1110,256,854,30
37100, 경산시,095001, 90세,2021,342,92,250,36.8,342,92,250,36.8
37100, 경산시,095002, 91세,2021,258,53,205,25.9,257,53,204,26
37100, 경산시,095003, 92세,2021,207,44,163,27,206,44,162,27.2
37100, 경산시,095004, 93세,2021,177,40,137,29.2,177,40,137,29.2
37100, 경산시,095005, 94세,2021,128,27,101,26.7,128,27,101,26.7
37100, 경산시,100,95~99세,2021,221,32,189,16.9,221,32,189,16.9
37100, 경산시,100001, 95세,2021,79,15,64,23.4,79,15,64,23.4
37100, 경산시,100002, 96세,2021,53,9,44,20.5,53,9,44,20.5
37100, 경산시,100003, 97세,2021,38,X,35,8.6,38,X,35,8.6
37100, 경산시,100004, 98세,2021,31,X,30,3.3,31,X,30,3.3
37100, 경산시,100005, 99세,2021,20,X,16,25,20,X,16,25
37100, 경산시,101,100세이상,2021,20,X,18,11.1,20,X,18,11.1
37100, 경산시,102,15세미만,2021,31210,15962,15248,104.7,30762,15731,15031,104.7
37100, 경산시,103,15~64세,2021,214761,111537,103224,108.1,201251,103737,97514,106.4
37100, 경산시,104,65세이상,2021,47447,20224,27223,74.3,47301,20156,27145,74.3
37100, 경산시,086,85세이상,2021,4935,1372,3563,38.5,4930,1371,3559,38.5
37100, 경산시,126,평균연령,2021,42.3,41.1,43.6,,42.9,41.6,44.2,
37100, 경산시,127,중위연령,2021,42.5,40.8,44.5,,43.8,42,45.7,
37310, 군위군,000,합계,2021,21285,10929,10356,105.5,20690,10493,10197,102.9
37310, 군위군,005,0~4세,2021,263,141,122,115.6,263,141,122,115.6
37310, 군위군,005001, 0세,2021,53,27,26,103.8,53,27,26,103.8
37310, 군위군,005002, 1세,2021,58,31,27,114.8,58,31,27,114.8
37310, 군위군,005003, 2세,2021,51,25,26,96.2,51,25,26,96.2
37310, 군위군,005004, 3세,2021,53,30,23,130.4,53,30,23,130.4
37310, 군위군,005005, 4세,2021,48,28,20,140,48,28,20,140
37310, 군위군,010,5~9세,2021,338,183,155,118.1,337,182,155,117.4
37310, 군위군,010001, 5세,2021,55,31,24,129.2,55,31,24,129.2
37310, 군위군,010002, 6세,2021,61,29,32,90.6,61,29,32,90.6
37310, 군위군,010003, 7세,2021,65,33,32,103.1,65,33,32,103.1
37310, 군위군,010004, 8세,2021,66,41,25,164,66,41,25,164
37310, 군위군,010005, 9세,2021,91,49,42,116.7,90,48,42,114.3
37310, 군위군,015,10~14세,2021,415,228,187,121.9,414,227,187,121.4
37310, 군위군,015001, 10세,2021,74,39,35,111.4,74,39,35,111.4
37310, 군위군,015002, 11세,2021,75,39,36,108.3,74,38,36,105.6
37310, 군위군,015003, 12세,2021,89,55,34,161.8,89,55,34,161.8
37310, 군위군,015004, 13세,2021,88,47,41,114.6,88,47,41,114.6
37310, 군위군,015005, 14세,2021,89,48,41,117.1,89,48,41,117.1
37310, 군위군,020,15~19세,2021,421,238,183,130.1,419,236,183,129
37310, 군위군,020001, 15세,2021,85,47,38,123.7,84,46,38,121.1
37310, 군위군,020002, 16세,2021,91,49,42,116.7,91,49,42,116.7
37310, 군위군,020003, 17세,2021,89,42,47,89.4,88,41,47,87.2
37310, 군위군,020004, 18세,2021,92,54,38,142.1,92,54,38,142.1
37310, 군위군,020005, 19세,2021,64,46,18,255.6,64,46,18,255.6
37310, 군위군,025,20~24세,2021,560,354,206,171.8,526,328,198,165.7
37310, 군위군,025001, 20세,2021,78,50,28,178.6,78,50,28,178.6
37310, 군위군,025002, 21세,2021,118,81,37,218.9,115,79,36,219.4
37310, 군위군,025003, 22세,2021,99,61,38,160.5,96,59,37,159.5
37310, 군위군,025004, 23세,2021,116,76,40,190,109,70,39,179.5
37310, 군위군,025005, 24세,2021,149,86,63,136.5,128,70,58,120.7
37310, 군위군,030,25~29세,2021,768,500,268,186.6,622,380,242,157
37310, 군위군,030001, 25세,2021,137,84,53,158.5,114,64,50,128
37310, 군위군,030002, 26세,2021,167,103,64,160.9,145,85,60,141.7
37310, 군위군,030003, 27세,2021,179,120,59,203.4,146,93,53,175.5
37310, 군위군,030004, 28세,2021,139,89,50,178,105,61,44,138.6
37310, 군위군,030005, 29세,2021,146,104,42,247.6,112,77,35,220
37310, 군위군,035,30~34세,2021,663,433,230,188.3,516,323,193,167.4
37310, 군위군,035001, 30세,2021,133,83,50,166,105,64,41,156.1
37310, 군위군,035002, 31세,2021,147,92,55,167.3,111,65,46,141.3
37310, 군위군,035003, 32세,2021,124,82,42,195.2,94,59,35,168.6
37310, 군위군,035004, 33세,2021,103,68,35,194.3,81,49,32,153.1
37310, 군위군,035005, 34세,2021,156,108,48,225,125,86,39,220.5
37310, 군위군,040,35~39세,2021,680,386,294,131.3,579,308,271,113.7
37310, 군위군,040001, 35세,2021,127,72,55,130.9,106,56,50,112
37310, 군위군,040002, 36세,2021,137,72,65,110.8,117,61,56,108.9
37310, 군위군,040003, 37세,2021,130,81,49,165.3,103,57,46,123.9
37310, 군위군,040004, 38세,2021,157,88,69,127.5,135,71,64,110.9
37310, 군위군,040005, 39세,2021,129,73,56,130.4,118,63,55,114.5
37310, 군위군,045,40~44세,2021,826,495,331,149.5,767,455,312,145.8
37310, 군위군,045001, 40세,2021,162,90,72,125,149,83,66,125.8
37310, 군위군,045002, 41세,2021,173,102,71,143.7,152,85,67,126.9
37310, 군위군,045003, 42세,2021,176,110,66,166.7,166,103,63,163.5
37310, 군위군,045004, 43세,2021,166,103,63,163.5,156,97,59,164.4
37310, 군위군,045005, 44세,2021,149,90,59,152.5,144,87,57,152.6
37310, 군위군,050,45~49세,2021,1048,608,440,138.2,1006,578,428,135
37310, 군위군,050001, 45세,2021,188,108,80,135,177,99,78,126.9
37310, 군위군,050002, 46세,2021,181,106,75,141.3,172,99,73,135.6
37310, 군위군,050003, 47세,2021,200,120,80,150,189,114,75,152
37310, 군위군,050004, 48세,2021,220,131,89,147.2,215,128,87,147.1
37310, 군위군,050005, 49세,2021,259,143,116,123.3,253,138,115,120
37310, 군위군,055,50~54세,2021,1529,846,683,123.9,1503,834,669,124.7
37310, 군위군,055001, 50세,2021,262,139,123,113,252,135,117,115.4
37310, 군위군,055002, 51세,2021,270,156,114,136.8,263,152,111,136.9
37310, 군위군,055003, 52세,2021,323,181,142,127.5,319,180,139,129.5
37310, 군위군,055004, 53세,2021,325,171,154,111,323,169,154,109.7
37310, 군위군,055005, 54세,2021,349,199,150,132.7,346,198,148,133.8
37310, 군위군,060,55~59세,2021,2161,1187,974,121.9,2138,1176,962,122.2
37310, 군위군,060001, 55세,2021,394,226,168,134.5,387,222,165,134.5
37310, 군위군,060002, 56세,2021,432,235,197,119.3,431,234,197,118.8
37310, 군위군,060003, 57세,2021,417,227,190,119.5,411,225,186,121
37310, 군위군,060004, 58세,2021,414,214,200,107,412,213,199,107
37310, 군위군,060005, 59세,2021,504,285,219,130.1,497,282,215,131.2
37310, 군위군,065,60~64세,2021,2671,1411,1260,112,2668,1410,1258,112.1
37310, 군위군,065001, 60세,2021,538,281,257,109.3,538,281,257,109.3
37310, 군위군,065002, 61세,2021,573,300,273,109.9,572,299,273,109.5
37310, 군위군,065003, 62세,2021,552,282,270,104.4,552,282,270,104.4
37310, 군위군,065004, 63세,2021,483,257,226,113.7,481,257,224,114.7
37310, 군위군,065005, 64세,2021,525,291,234,124.4,525,291,234,124.4
37310, 군위군,070,65~69세,2021,2459,1273,1186,107.3,2454,1271,1183,107.4
37310, 군위군,070001, 65세,2021,556,299,257,116.3,555,298,257,116
37310, 군위군,070002, 66세,2021,523,278,245,113.5,522,278,244,113.9
37310, 군위군,070003, 67세,2021,435,222,213,104.2,435,222,213,104.2
37310, 군위군,070004, 68세,2021,428,228,200,114,425,227,198,114.6
37310, 군위군,070005, 69세,2021,517,246,271,90.8,517,246,271,90.8
37310, 군위군,075,70~74세,2021,2063,1004,1059,94.8,2059,1003,1056,95
37310, 군위군,075001, 70세,2021,405,193,212,91,404,193,211,91.5
37310, 군위군,075002, 71세,2021,396,180,216,83.3,395,180,215,83.7
37310, 군위군,075003, 72세,2021,418,230,188,122.3,417,229,188,121.8
37310, 군위군,075004, 73세,2021,406,186,220,84.5,405,186,219,84.9
37310, 군위군,075005, 74세,2021,438,215,223,96.4,438,215,223,96.4
37310, 군위군,080,75~79세,2021,1708,739,969,76.3,1707,738,969,76.2
37310, 군위군,080001, 75세,2021,246,119,127,93.7,246,119,127,93.7
37310, 군위군,080002, 76세,2021,306,131,175,74.9,306,131,175,74.9
37310, 군위군,080003, 77세,2021,320,137,183,74.9,320,137,183,74.9
37310, 군위군,080004, 78세,2021,372,152,220,69.1,371,151,220,68.6
37310, 군위군,080005, 79세,2021,464,200,264,75.8,464,200,264,75.8
37310, 군위군,085,80~84세,2021,1549,559,990,56.5,1549,559,990,56.5
37310, 군위군,085001, 80세,2021,350,140,210,66.7,350,140,210,66.7
37310, 군위군,085002, 81세,2021,329,120,209,57.4,329,120,209,57.4
37310, 군위군,085003, 82세,2021,309,110,199,55.3,309,110,199,55.3
37310, 군위군,085004, 83세,2021,306,103,203,50.7,306,103,203,50.7
37310, 군위군,085005, 84세,2021,255,86,169,50.9,255,86,169,50.9
37310, 군위군,090,85~89세,2021,880,281,599,46.9,880,281,599,46.9
37310, 군위군,090001, 85세,2021,235,80,155,51.6,235,80,155,51.6
37310, 군위군,090002, 86세,2021,240,71,169,42,240,71,169,42
37310, 군위군,090003, 87세,2021,171,55,116,47.4,171,55,116,47.4
37310, 군위군,090004, 88세,2021,120,41,79,51.9,120,41,79,51.9
37310, 군위군,090005, 89세,2021,114,34,80,42.5,114,34,80,42.5
37310, 군위군,095,90~94세,2021,239,59,180,32.8,239,59,180,32.8
37310, 군위군,095001, 90세,2021,73,16,57,28.1,73,16,57,28.1
37310, 군위군,095002, 91세,2021,65,20,45,44.4,65,20,45,44.4
37310, 군위군,095003, 92세,2021,43,10,33,30.3,43,10,33,30.3
37310, 군위군,095004, 93세,2021,32,8,24,33.3,32,8,24,33.3
37310, 군위군,095005, 94세,2021,26,5,21,23.8,26,5,21,23.8
37310, 군위군,100,95~99세,2021,36,X,32,12.5,36,X,32,12.5
37310, 군위군,100001, 95세,2021,12,X,11,9.1,12,X,11,9.1
37310, 군위군,100002, 96세,2021,12,X,10,20,12,X,10,20
37310, 군위군,100003, 97세,2021,7,X,7,0,7,X,7,0
37310, 군위군,100004, 98세,2021,X,X,X,0,X,X,X,0
37310, 군위군,100005, 99세,2021,X,X,X,33.3,X,X,X,33.3
37310, 군위군,101,100세이상,2021,8,X,8,0,8,X,8,0
37310, 군위군,102,15세미만,2021,1016,552,464,119,1014,550,464,118.5
37310, 군위군,103,15~64세,2021,11327,6458,4869,132.6,10744,6028,4716,127.8
37310, 군위군,104,65세이상,2021,8942,3919,5023,78,8932,3915,5017,78
37310, 군위군,086,85세이상,2021,1163,344,819,42,1163,344,819,42
37310, 군위군,126,평균연령,2021,57.9,55.1,60.8,,58.5,56,61.1,
37310, 군위군,127,중위연령,2021,61.8,59.5,64.3,,62.3,60.3,64.6,
37320, 의성군,000,합계,2021,48021,23299,24722,94.2,47291,22922,24369,94.1
37320, 의성군,005,0~4세,2021,890,480,410,117.1,889,480,409,117.4
37320, 의성군,005001, 0세,2021,169,90,79,113.9,169,90,79,113.9
37320, 의성군,005002, 1세,2021,211,117,94,124.5,211,117,94,124.5
37320, 의성군,005003, 2세,2021,170,96,74,129.7,169,96,73,131.5
37320, 의성군,005004, 3세,2021,172,82,90,91.1,172,82,90,91.1
37320, 의성군,005005, 4세,2021,168,95,73,130.1,168,95,73,130.1
37320, 의성군,010,5~9세,2021,859,440,419,105,856,439,417,105.3
37320, 의성군,010001, 5세,2021,179,89,90,98.9,178,89,89,100
37320, 의성군,010002, 6세,2021,158,83,75,110.7,158,83,75,110.7
37320, 의성군,010003, 7세,2021,163,88,75,117.3,162,87,75,116
37320, 의성군,010004, 8세,2021,174,90,84,107.1,173,90,83,108.4
37320, 의성군,010005, 9세,2021,185,90,95,94.7,185,90,95,94.7
37320, 의성군,015,10~14세,2021,967,501,466,107.5,964,501,463,108.2
37320, 의성군,015001, 10세,2021,182,88,94,93.6,181,88,93,94.6
37320, 의성군,015002, 11세,2021,168,90,78,115.4,168,90,78,115.4
37320, 의성군,015003, 12세,2021,185,96,89,107.9,184,96,88,109.1
37320, 의성군,015004, 13세,2021,224,124,100,124,223,124,99,125.3
37320, 의성군,015005, 14세,2021,208,103,105,98.1,208,103,105,98.1
37320, 의성군,020,15~19세,2021,913,501,412,121.6,911,500,411,121.7
37320, 의성군,020001, 15세,2021,208,115,93,123.7,208,115,93,123.7
37320, 의성군,020002, 16세,2021,197,107,90,118.9,197,107,90,118.9
37320, 의성군,020003, 17세,2021,211,113,98,115.3,209,112,97,115.5
37320, 의성군,020004, 18세,2021,178,99,79,125.3,178,99,79,125.3
37320, 의성군,020005, 19세,2021,119,67,52,128.8,119,67,52,128.8
37320, 의성군,025,20~24세,2021,1133,708,425,166.6,1083,686,397,172.8
37320, 의성군,025001, 20세,2021,205,140,65,215.4,201,137,64,214.1
37320, 의성군,025002, 21세,2021,209,131,78,167.9,206,130,76,171.1
37320, 의성군,025003, 22세,2021,221,131,90,145.6,213,129,84,153.6
37320, 의성군,025004, 23세,2021,250,161,89,180.9,237,155,82,189
37320, 의성군,025005, 24세,2021,248,145,103,140.8,226,135,91,148.4
37320, 의성군,030,25~29세,2021,1470,839,631,133,1326,752,574,131
37320, 의성군,030001, 25세,2021,262,142,120,118.3,241,125,116,107.8
37320, 의성군,030002, 26세,2021,309,182,127,143.3,277,162,115,140.9
37320, 의성군,030003, 27세,2021,318,177,141,125.5,285,160,125,128
37320, 의성군,030004, 28세,2021,295,168,127,132.3,265,152,113,134.5
37320, 의성군,030005, 29세,2021,286,170,116,146.6,258,153,105,145.7
37320, 의성군,035,30~34세,2021,1473,847,626,135.3,1337,771,566,136.2
37320, 의성군,035001, 30세,2021,304,175,129,135.7,271,154,117,131.6
37320, 의성군,035002, 31세,2021,296,168,128,131.3,264,151,113,133.6
37320, 의성군,035003, 32세,2021,300,174,126,138.1,278,162,116,139.7
37320, 의성군,035004, 33세,2021,281,177,104,170.2,258,163,95,171.6
37320, 의성군,035005, 34세,2021,292,153,139,110.1,266,141,125,112.8
37320, 의성군,040,35~39세,2021,1539,834,705,118.3,1445,786,659,119.3
37320, 의성군,040001, 35세,2021,252,121,131,92.4,233,115,118,97.5
37320, 의성군,040002, 36세,2021,298,171,127,134.6,278,160,118,135.6
37320, 의성군,040003, 37세,2021,291,160,131,122.1,271,148,123,120.3
37320, 의성군,040004, 38세,2021,334,192,142,135.2,313,182,131,138.9
37320, 의성군,040005, 39세,2021,364,190,174,109.2,350,181,169,107.1
37320, 의성군,045,40~44세,2021,1778,996,782,127.4,1714,967,747,129.5
37320, 의성군,045001, 40세,2021,349,199,150,132.7,336,191,145,131.7
37320, 의성군,045002, 41세,2021,339,190,149,127.5,325,182,143,127.3
37320, 의성군,045003, 42세,2021,374,202,172,117.4,357,198,159,124.5
37320, 의성군,045004, 43세,2021,358,203,155,131,346,197,149,132.2
37320, 의성군,045005, 44세,2021,358,202,156,129.5,350,199,151,131.8
37320, 의성군,050,45~49세,2021,2261,1322,939,140.8,2207,1296,911,142.3
37320, 의성군,050001, 45세,2021,363,219,144,152.1,354,216,138,156.5
37320, 의성군,050002, 46세,2021,430,252,178,141.6,421,245,176,139.2
37320, 의성군,050003, 47세,2021,464,276,188,146.8,448,270,178,151.7
37320, 의성군,050004, 48세,2021,477,266,211,126.1,467,261,206,126.7
37320, 의성군,050005, 49세,2021,527,309,218,141.7,517,304,213,142.7
37320, 의성군,055,50~54세,2021,3263,1790,1473,121.5,3198,1758,1440,122.1
37320, 의성군,055001, 50세,2021,578,313,265,118.1,562,305,257,118.7
37320, 의성군,055002, 51세,2021,582,321,261,123,568,315,253,124.5
37320, 의성군,055003, 52세,2021,671,369,302,122.2,660,363,297,122.2
37320, 의성군,055004, 53세,2021,712,388,324,119.8,697,380,317,119.9
37320, 의성군,055005, 54세,2021,720,399,321,124.3,711,395,316,125
37320, 의성군,060,55~59세,2021,4480,2320,2160,107.4,4435,2302,2133,107.9
37320, 의성군,060001, 55세,2021,775,451,324,139.2,764,447,317,141
37320, 의성군,060002, 56세,2021,880,456,424,107.5,876,455,421,108.1
37320, 의성군,060003, 57세,2021,809,391,418,93.5,802,386,416,92.8
37320, 의성군,060004, 58세,2021,904,471,433,108.8,896,467,429,108.9
37320, 의성군,060005, 59세,2021,1112,551,561,98.2,1097,547,550,99.5
37320, 의성군,065,60~64세,2021,6039,3078,2961,104,6001,3058,2943,103.9
37320, 의성군,065001, 60세,2021,1200,619,581,106.5,1198,619,579,106.9
37320, 의성군,065002, 61세,2021,1276,631,645,97.8,1266,625,641,97.5
37320, 의성군,065003, 62세,2021,1154,589,565,104.2,1148,587,561,104.6
37320, 의성군,065004, 63세,2021,1204,602,602,100,1194,595,599,99.3
37320, 의성군,065005, 64세,2021,1205,637,568,112.1,1195,632,563,112.3
37320, 의성군,070,65~69세,2021,5555,2714,2841,95.5,5542,2706,2836,95.4
37320, 의성군,070001, 65세,2021,1164,607,557,109,1159,604,555,108.8
37320, 의성군,070002, 66세,2021,1163,550,613,89.7,1160,548,612,89.5
37320, 의성군,070003, 67세,2021,1080,528,552,95.7,1079,528,551,95.8
37320, 의성군,070004, 68세,2021,1074,514,560,91.8,1071,512,559,91.6
37320, 의성군,070005, 69세,2021,1074,515,559,92.1,1073,514,559,91.9
37320, 의성군,075,70~74세,2021,4592,2124,2468,86.1,4581,2117,2464,85.9
37320, 의성군,075001, 70세,2021,917,445,472,94.3,914,442,472,93.6
37320, 의성군,075002, 71세,2021,892,405,487,83.2,889,404,485,83.3
37320, 의성군,075003, 72세,2021,952,443,509,87,949,441,508,86.8
37320, 의성군,075004, 73세,2021,948,441,507,87,946,440,506,87
37320, 의성군,075005, 74세,2021,883,390,493,79.1,883,390,493,79.1
37320, 의성군,080,75~79세,2021,4029,1642,2387,68.8,4025,1641,2384,68.8
37320, 의성군,080001, 75세,2021,541,249,292,85.3,539,248,291,85.2
37320, 의성군,080002, 76세,2021,632,265,367,72.2,631,265,366,72.4
37320, 의성군,080003, 77세,2021,770,298,472,63.1,769,298,471,63.3
37320, 의성군,080004, 78세,2021,968,389,579,67.2,968,389,579,67.2
37320, 의성군,080005, 79세,2021,1118,441,677,65.1,1118,441,677,65.1
37320, 의성군,085,80~84세,2021,3779,1340,2439,54.9,3777,1339,2438,54.9
37320, 의성군,085001, 80세,2021,824,311,513,60.6,824,311,513,60.6
37320, 의성군,085002, 81세,2021,746,291,455,64,745,290,455,63.7
37320, 의성군,085003, 82세,2021,868,318,550,57.8,867,318,549,57.9
37320, 의성군,085004, 83세,2021,697,217,480,45.2,697,217,480,45.2
37320, 의성군,085005, 84세,2021,644,203,441,46,644,203,441,46
37320, 의성군,090,85~89세,2021,2212,655,1557,42.1,2211,655,1556,42.1
37320, 의성군,090001, 85세,2021,553,183,370,49.5,553,183,370,49.5
37320, 의성군,090002, 86세,2021,563,170,393,43.3,562,170,392,43.4
37320, 의성군,090003, 87세,2021,453,132,321,41.1,453,132,321,41.1
37320, 의성군,090004, 88세,2021,347,90,257,35,347,90,257,35
37320, 의성군,090005, 89세,2021,296,80,216,37,296,80,216,37
37320, 의성군,095,90~94세,2021,657,153,504,30.4,657,153,504,30.4
37320, 의성군,095001, 90세,2021,188,50,138,36.2,188,50,138,36.2
37320, 의성군,095002, 91세,2021,170,44,126,34.9,170,44,126,34.9
37320, 의성군,095003, 92세,2021,122,18,104,17.3,122,18,104,17.3
37320, 의성군,095004, 93세,2021,101,21,80,26.3,101,21,80,26.3
37320, 의성군,095005, 94세,2021,76,20,56,35.7,76,20,56,35.7
37320, 의성군,100,95~99세,2021,115,14,101,13.9,115,14,101,13.9
37320, 의성군,100001, 95세,2021,38,5,33,15.2,38,5,33,15.2
37320, 의성군,100002, 96세,2021,30,X,26,15.4,30,X,26,15.4
37320, 의성군,100003, 97세,2021,15,X,13,15.4,15,X,13,15.4
37320, 의성군,100004, 98세,2021,20,X,18,11.1,20,X,18,11.1
37320, 의성군,100005, 99세,2021,12,X,11,9.1,12,X,11,9.1
37320, 의성군,101,100세이상,2021,17,X,16,6.3,17,X,16,6.3
37320, 의성군,102,15세미만,2021,2716,1421,1295,109.7,2709,1420,1289,110.2
37320, 의성군,103,15~64세,2021,24349,13235,11114,119.1,23657,12876,10781,119.4
37320, 의성군,104,65세이상,2021,20956,8643,12313,70.2,20925,8626,12299,70.1
37320, 의성군,086,85세이상,2021,3001,823,2178,37.8,3000,823,2177,37.8
37320, 의성군,126,평균연령,2021,58.3,55.4,61,,58.6,55.7,61.3,
37320, 의성군,127,중위연령,2021,62.4,60.1,64.9,,62.7,60.4,65.2,
37330, 청송군,000,합계,2021,23288,11577,11711,98.9,23005,11491,11514,99.8
37330, 청송군,005,0~4세,2021,413,228,185,123.2,413,228,185,123.2
37330, 청송군,005001, 0세,2021,82,48,34,141.2,82,48,34,141.2
37330, 청송군,005002, 1세,2021,81,42,39,107.7,81,42,39,107.7
37330, 청송군,005003, 2세,2021,99,61,38,160.5,99,61,38,160.5
37330, 청송군,005004, 3세,2021,67,36,31,116.1,67,36,31,116.1
37330, 청송군,005005, 4세,2021,84,41,43,95.3,84,41,43,95.3
37330, 청송군,010,5~9세,2021,498,244,254,96.1,498,244,254,96.1
37330, 청송군,010001, 5세,2021,77,41,36,113.9,77,41,36,113.9
37330, 청송군,010002, 6세,2021,108,57,51,111.8,108,57,51,111.8
37330, 청송군,010003, 7세,2021,101,45,56,80.4,101,45,56,80.4
37330, 청송군,010004, 8세,2021,95,40,55,72.7,95,40,55,72.7
37330, 청송군,010005, 9세,2021,117,61,56,108.9,117,61,56,108.9
37330, 청송군,015,10~14세,2021,517,285,232,122.8,517,285,232,122.8
37330, 청송군,015001, 10세,2021,108,61,47,129.8,108,61,47,129.8
37330, 청송군,015002, 11세,2021,95,48,47,102.1,95,48,47,102.1
37330, 청송군,015003, 12세,2021,97,49,48,102.1,97,49,48,102.1
37330, 청송군,015004, 13세,2021,112,70,42,166.7,112,70,42,166.7
37330, 청송군,015005, 14세,2021,105,57,48,118.8,105,57,48,118.8
37330, 청송군,020,15~19세,2021,470,252,218,115.6,468,252,216,116.7
37330, 청송군,020001, 15세,2021,109,56,53,105.7,108,56,52,107.7
37330, 청송군,020002, 16세,2021,116,61,55,110.9,116,61,55,110.9
37330, 청송군,020003, 17세,2021,90,47,43,109.3,89,47,42,111.9
37330, 청송군,020004, 18세,2021,93,49,44,111.4,93,49,44,111.4
37330, 청송군,020005, 19세,2021,62,39,23,169.6,62,39,23,169.6
37330, 청송군,025,20~24세,2021,603,360,243,148.1,582,355,227,156.4
37330, 청송군,025001, 20세,2021,112,78,34,229.4,108,76,32,237.5
37330, 청송군,025002, 21세,2021,115,77,38,202.6,114,76,38,200
37330, 청송군,025003, 22세,2021,107,61,46,132.6,105,61,44,138.6
37330, 청송군,025004, 23세,2021,127,66,61,108.2,119,65,54,120.4
37330, 청송군,025005, 24세,2021,142,78,64,121.9,136,77,59,130.5
37330, 청송군,030,25~29세,2021,782,490,292,167.8,731,470,261,180.1
37330, 청송군,030001, 25세,2021,135,80,55,145.5,127,77,50,154
37330, 청송군,030002, 26세,2021,147,81,66,122.7,140,80,60,133.3
37330, 청송군,030003, 27세,2021,157,101,56,180.4,147,97,50,194
37330, 청송군,030004, 28세,2021,175,122,53,230.2,158,113,45,251.1
37330, 청송군,030005, 29세,2021,168,106,62,171,159,103,56,183.9
37330, 청송군,035,30~34세,2021,737,447,290,154.1,684,431,253,170.4
37330, 청송군,035001, 30세,2021,144,92,52,176.9,130,86,44,195.5
37330, 청송군,035002, 31세,2021,153,88,65,135.4,137,85,52,163.5
37330, 청송군,035003, 32세,2021,152,94,58,162.1,146,92,54,170.4
37330, 청송군,035004, 33세,2021,141,85,56,151.8,131,81,50,162
37330, 청송군,035005, 34세,2021,147,88,59,149.2,140,87,53,164.2
37330, 청송군,040,35~39세,2021,807,429,378,113.5,769,421,348,121
37330, 청송군,040001, 35세,2021,159,86,73,117.8,150,85,65,130.8
37330, 청송군,040002, 36세,2021,143,89,54,164.8,135,87,48,181.3
37330, 청송군,040003, 37세,2021,155,78,77,101.3,147,77,70,110
37330, 청송군,040004, 38세,2021,183,96,87,110.3,176,94,82,114.6
37330, 청송군,040005, 39세,2021,167,80,87,92,161,78,83,94
37330, 청송군,045,40~44세,2021,941,532,409,130.1,919,526,393,133.8
37330, 청송군,045001, 40세,2021,205,121,84,144,200,119,81,146.9
37330, 청송군,045002, 41세,2021,204,122,82,148.8,200,120,80,150
37330, 청송군,045003, 42세,2021,178,97,81,119.8,174,95,79,120.3
37330, 청송군,045004, 43세,2021,178,92,86,107,174,92,82,112.2
37330, 청송군,045005, 44세,2021,176,100,76,131.6,171,100,71,140.8
37330, 청송군,050,45~49세,2021,1231,699,532,131.4,1210,693,517,134
37330, 청송군,050001, 45세,2021,212,124,88,140.9,208,123,85,144.7
37330, 청송군,050002, 46세,2021,226,126,100,126,220,126,94,134
37330, 청송군,050003, 47세,2021,277,156,121,128.9,269,153,116,131.9
37330, 청송군,050004, 48세,2021,244,136,108,125.9,243,135,108,125
37330, 청송군,050005, 49세,2021,272,157,115,136.5,270,156,114,136.8
37330, 청송군,055,50~54세,2021,1845,1012,833,121.5,1821,1004,817,122.9
37330, 청송군,055001, 50세,2021,296,178,118,150.8,291,175,116,150.9
37330, 청송군,055002, 51세,2021,349,191,158,120.9,345,191,154,124
37330, 청송군,055003, 52세,2021,391,234,157,149,385,231,154,150
37330, 청송군,055004, 53세,2021,408,206,202,102,404,206,198,104
37330, 청송군,055005, 54세,2021,401,203,198,102.5,396,201,195,103.1
37330, 청송군,060,55~59세,2021,2402,1252,1150,108.9,2384,1246,1138,109.5
37330, 청송군,060001, 55세,2021,437,246,191,128.8,432,245,187,131
37330, 청송군,060002, 56세,2021,468,246,222,110.8,464,244,220,110.9
37330, 청송군,060003, 57세,2021,449,225,224,100.4,444,222,222,100
37330, 청송군,060004, 58세,2021,484,243,241,100.8,482,243,239,101.7
37330, 청송군,060005, 59세,2021,564,292,272,107.4,562,292,270,108.1
37330, 청송군,065,60~64세,2021,2893,1446,1447,99.9,2878,1442,1436,100.4
37330, 청송군,065001, 60세,2021,574,288,286,100.7,570,287,283,101.4
37330, 청송군,065002, 61세,2021,630,307,323,95,625,307,318,96.5
37330, 청송군,065003, 62세,2021,585,286,299,95.7,582,284,298,95.3
37330, 청송군,065004, 63세,2021,542,282,260,108.5,540,281,259,108.5
37330, 청송군,065005, 64세,2021,562,283,279,101.4,561,283,278,101.8
37330, 청송군,070,65~69세,2021,2525,1230,1295,95,2518,1226,1292,94.9
37330, 청송군,070001, 65세,2021,546,270,276,97.8,545,269,276,97.5
37330, 청송군,070002, 66세,2021,509,241,268,89.9,506,240,266,90.2
37330, 청송군,070003, 67세,2021,475,245,230,106.5,473,244,229,106.6
37330, 청송군,070004, 68세,2021,478,239,239,100,477,238,239,99.6
37330, 청송군,070005, 69세,2021,517,235,282,83.3,517,235,282,83.3
37330, 청송군,075,70~74세,2021,2076,1013,1063,95.3,2073,1013,1060,95.6
37330, 청송군,075001, 70세,2021,421,214,207,103.4,420,214,206,103.9
37330, 청송군,075002, 71세,2021,400,199,201,99,400,199,201,99
37330, 청송군,075003, 72세,2021,413,204,209,97.6,413,204,209,97.6
37330, 청송군,075004, 73세,2021,428,208,220,94.5,428,208,220,94.5
37330, 청송군,075005, 74세,2021,414,188,226,83.2,412,188,224,83.9
37330, 청송군,080,75~79세,2021,1785,717,1068,67.1,1779,714,1065,67
37330, 청송군,080001, 75세,2021,247,101,146,69.2,243,99,144,68.8
37330, 청송군,080002, 76세,2021,306,135,171,78.9,305,135,170,79.4
37330, 청송군,080003, 77세,2021,383,153,230,66.5,383,153,230,66.5
37330, 청송군,080004, 78세,2021,395,158,237,66.7,395,158,237,66.7
37330, 청송군,080005, 79세,2021,454,170,284,59.9,453,169,284,59.5
37330, 청송군,085,80~84세,2021,1586,575,1011,56.9,1586,575,1011,56.9
37330, 청송군,085001, 80세,2021,359,128,231,55.4,359,128,231,55.4
37330, 청송군,085002, 81세,2021,336,126,210,60,336,126,210,60
37330, 청송군,085003, 82세,2021,371,136,235,57.9,371,136,235,57.9
37330, 청송군,085004, 83세,2021,282,108,174,62.1,282,108,174,62.1
37330, 청송군,085005, 84세,2021,238,77,161,47.8,238,77,161,47.8
37330, 청송군,090,85~89세,2021,851,296,555,53.3,850,296,554,53.4
37330, 청송군,090001, 85세,2021,243,91,152,59.9,243,91,152,59.9
37330, 청송군,090002, 86세,2021,223,76,147,51.7,223,76,147,51.7
37330, 청송군,090003, 87세,2021,167,50,117,42.7,166,50,116,43.1
37330, 청송군,090004, 88세,2021,102,38,64,59.4,102,38,64,59.4
37330, 청송군,090005, 89세,2021,116,41,75,54.7,116,41,75,54.7
37330, 청송군,095,90~94세,2021,268,65,203,32,268,65,203,32
37330, 청송군,095001, 90세,2021,89,21,68,30.9,89,21,68,30.9
37330, 청송군,095002, 91세,2021,61,15,46,32.6,61,15,46,32.6
37330, 청송군,095003, 92세,2021,48,12,36,33.3,48,12,36,33.3
37330, 청송군,095004, 93세,2021,42,9,33,27.3,42,9,33,27.3
37330, 청송군,095005, 94세,2021,28,8,20,40,28,8,20,40
37330, 청송군,100,95~99세,2021,48,X,44,9.1,47,X,43,9.3
37330, 청송군,100001, 95세,2021,29,X,27,7.4,28,X,26,7.7
37330, 청송군,100002, 96세,2021,11,X,11,0,11,X,11,0
37330, 청송군,100003, 97세,2021,X,X,X,50,X,X,X,50
37330, 청송군,100004, 98세,2021,X,X,X,33.3,X,X,X,33.3
37330, 청송군,100005, 99세,2021,X,X,X,0,X,X,X,0
37330, 청송군,101,100세이상,2021,10,X,9,11.1,10,X,9,11.1
37330, 청송군,102,15세미만,2021,1428,757,671,112.8,1428,757,671,112.8
37330, 청송군,103,15~64세,2021,12711,6919,5792,119.5,12446,6840,5606,122
37330, 청송군,104,65세이상,2021,9149,3901,5248,74.3,9131,3894,5237,74.4
37330, 청송군,086,85세이상,2021,1177,366,811,45.1,1175,366,809,45.2
37330, 청송군,126,평균연령,2021,56.6,54,59.1,,56.8,54.1,59.5,
37330, 청송군,127,중위연령,2021,60.7,58.4,62.8,,60.9,58.5,63.1,
37340, 영양군,000,합계,2021,15558,7682,7876,97.5,15203,7573,7630,99.3
37340, 영양군,005,0~4세,2021,293,151,142,106.3,291,150,141,106.4
37340, 영양군,005001, 0세,2021,47,24,23,104.3,47,24,23,104.3
37340, 영양군,005002, 1세,2021,51,21,30,70,50,21,29,72.4
37340, 영양군,005003, 2세,2021,70,32,38,84.2,69,31,38,81.6
37340, 영양군,005004, 3세,2021,56,36,20,180,56,36,20,180
37340, 영양군,005005, 4세,2021,69,38,31,122.6,69,38,31,122.6
37340, 영양군,010,5~9세,2021,363,193,170,113.5,363,193,170,113.5
37340, 영양군,010001, 5세,2021,59,32,27,118.5,59,32,27,118.5
37340, 영양군,010002, 6세,2021,76,38,38,100,76,38,38,100
37340, 영양군,010003, 7세,2021,71,31,40,77.5,71,31,40,77.5
37340, 영양군,010004, 8세,2021,83,44,39,112.8,83,44,39,112.8
37340, 영양군,010005, 9세,2021,74,48,26,184.6,74,48,26,184.6
37340, 영양군,015,10~14세,2021,434,228,206,110.7,434,228,206,110.7
37340, 영양군,015001, 10세,2021,75,46,29,158.6,75,46,29,158.6
37340, 영양군,015002, 11세,2021,94,42,52,80.8,94,42,52,80.8
37340, 영양군,015003, 12세,2021,68,42,26,161.5,68,42,26,161.5
37340, 영양군,015004, 13세,2021,91,45,46,97.8,91,45,46,97.8
37340, 영양군,015005, 14세,2021,106,53,53,100,106,53,53,100
37340, 영양군,020,15~19세,2021,331,170,161,105.6,330,169,161,105
37340, 영양군,020001, 15세,2021,74,41,33,124.2,74,41,33,124.2
37340, 영양군,020002, 16세,2021,81,38,43,88.4,81,38,43,88.4
37340, 영양군,020003, 17세,2021,69,35,34,102.9,69,35,34,102.9
37340, 영양군,020004, 18세,2021,79,37,42,88.1,78,36,42,85.7
37340, 영양군,020005, 19세,2021,28,19,9,211.1,28,19,9,211.1
37340, 영양군,025,20~24세,2021,362,224,138,162.3,346,222,124,179
37340, 영양군,025001, 20세,2021,67,43,24,179.2,66,43,23,187
37340, 영양군,025002, 21세,2021,89,69,20,345,88,68,20,340
37340, 영양군,025003, 22세,2021,58,28,30,93.3,53,28,25,112
37340, 영양군,025004, 23세,2021,76,46,30,153.3,71,46,25,184
37340, 영양군,025005, 24세,2021,72,38,34,111.8,68,37,31,119.4
37340, 영양군,030,25~29세,2021,495,271,224,121,454,263,191,137.7
37340, 영양군,030001, 25세,2021,82,42,40,105,79,42,37,113.5
37340, 영양군,030002, 26세,2021,97,49,48,102.1,90,48,42,114.3
37340, 영양군,030003, 27세,2021,118,72,46,156.5,106,70,36,194.4
37340, 영양군,030004, 28세,2021,106,60,46,130.4,95,56,39,143.6
37340, 영양군,030005, 29세,2021,92,48,44,109.1,84,47,37,127
37340, 영양군,035,30~34세,2021,505,247,258,95.7,436,239,197,121.3
37340, 영양군,035001, 30세,2021,113,55,58,94.8,96,53,43,123.3
37340, 영양군,035002, 31세,2021,93,49,44,111.4,79,47,32,146.9
37340, 영양군,035003, 32세,2021,81,41,40,102.5,73,40,33,121.2
37340, 영양군,035004, 33세,2021,106,51,55,92.7,91,49,42,116.7
37340, 영양군,035005, 34세,2021,112,51,61,83.6,97,50,47,106.4
37340, 영양군,040,35~39세,2021,574,304,270,112.6,489,266,223,119.3
37340, 영양군,040001, 35세,2021,129,69,60,115,108,59,49,120.4
37340, 영양군,040002, 36세,2021,85,48,37,129.7,67,39,28,139.3
37340, 영양군,040003, 37세,2021,99,56,43,130.2,90,52,38,136.8
37340, 영양군,040004, 38세,2021,132,66,66,100,114,61,53,115.1
37340, 영양군,040005, 39세,2021,129,65,64,101.6,110,55,55,100
37340, 영양군,045,40~44세,2021,680,398,282,141.1,634,377,257,146.7
37340, 영양군,045001, 40세,2021,128,77,51,151,111,69,42,164.3
37340, 영양군,045002, 41세,2021,151,76,75,101.3,142,71,71,100
37340, 영양군,045003, 42세,2021,125,76,49,155.1,119,71,48,147.9
37340, 영양군,045004, 43세,2021,137,86,51,168.6,131,85,46,184.8
37340, 영양군,045005, 44세,2021,139,83,56,148.2,131,81,50,162
37340, 영양군,050,45~49세,2021,883,513,370,138.6,846,500,346,144.5
37340, 영양군,050001, 45세,2021,145,87,58,150,137,85,52,163.5
37340, 영양군,050002, 46세,2021,153,82,71,115.5,150,79,71,111.3
37340, 영양군,050003, 47세,2021,180,101,79,127.8,169,99,70,141.4
37340, 영양군,050004, 48세,2021,199,118,81,145.7,189,115,74,155.4
37340, 영양군,050005, 49세,2021,206,125,81,154.3,201,122,79,154.4
37340, 영양군,055,50~54세,2021,1217,711,506,140.5,1197,707,490,144.3
37340, 영양군,055001, 50세,2021,237,141,96,146.9,235,140,95,147.4
37340, 영양군,055002, 51세,2021,253,145,108,134.3,247,144,103,139.8
37340, 영양군,055003, 52세,2021,259,159,100,159,258,159,99,160.6
37340, 영양군,055004, 53세,2021,245,139,106,131.1,239,137,102,134.3
37340, 영양군,055005, 54세,2021,223,127,96,132.3,218,127,91,139.6
37340, 영양군,060,55~59세,2021,1470,778,692,112.4,1458,776,682,113.8
37340, 영양군,060001, 55세,2021,299,170,129,131.8,296,169,127,133.1
37340, 영양군,060002, 56세,2021,265,143,122,117.2,265,143,122,117.2
37340, 영양군,060003, 57세,2021,257,138,119,116,253,138,115,120
37340, 영양군,060004, 58세,2021,336,175,161,108.7,332,174,158,110.1
37340, 영양군,060005, 59세,2021,313,152,161,94.4,312,152,160,95
37340, 영양군,065,60~64세,2021,1872,940,932,100.9,1857,934,923,101.2
37340, 영양군,065001, 60세,2021,440,229,211,108.5,437,228,209,109.1
37340, 영양군,065002, 61세,2021,419,213,206,103.4,416,213,203,104.9
37340, 영양군,065003, 62세,2021,320,172,148,116.2,318,170,148,114.9
37340, 영양군,065004, 63세,2021,352,171,181,94.5,348,170,178,95.5
37340, 영양군,065005, 64세,2021,341,155,186,83.3,338,153,185,82.7
37340, 영양군,070,65~69세,2021,1623,831,792,104.9,1616,826,790,104.6
37340, 영양군,070001, 65세,2021,352,177,175,101.1,352,177,175,101.1
37340, 영양군,070002, 66세,2021,371,204,167,122.2,368,201,167,120.4
37340, 영양군,070003, 67세,2021,290,145,145,100,288,144,144,100
37340, 영양군,070004, 68세,2021,293,152,141,107.8,293,152,141,107.8
37340, 영양군,070005, 69세,2021,317,153,164,93.3,315,152,163,93.3
37340, 영양군,075,70~74세,2021,1272,600,672,89.3,1270,600,670,89.6
37340, 영양군,075001, 70세,2021,244,113,131,86.3,244,113,131,86.3
37340, 영양군,075002, 71세,2021,234,102,132,77.3,233,102,131,77.9
37340, 영양군,075003, 72세,2021,306,155,151,102.6,305,155,150,103.3
37340, 영양군,075004, 73세,2021,273,130,143,90.9,273,130,143,90.9
37340, 영양군,075005, 74세,2021,215,100,115,87,215,100,115,87
37340, 영양군,080,75~79세,2021,1244,500,744,67.2,1244,500,744,67.2
37340, 영양군,080001, 75세,2021,174,73,101,72.3,174,73,101,72.3
37340, 영양군,080002, 76세,2021,211,85,126,67.5,211,85,126,67.5
37340, 영양군,080003, 77세,2021,248,95,153,62.1,248,95,153,62.1
37340, 영양군,080004, 78세,2021,282,111,171,64.9,282,111,171,64.9
37340, 영양군,080005, 79세,2021,329,136,193,70.5,329,136,193,70.5
37340, 영양군,085,80~84세,2021,1139,413,726,56.9,1139,413,726,56.9
37340, 영양군,085001, 80세,2021,269,102,167,61.1,269,102,167,61.1
37340, 영양군,085002, 81세,2021,248,103,145,71,248,103,145,71
37340, 영양군,085003, 82세,2021,243,90,153,58.8,243,90,153,58.8
37340, 영양군,085004, 83세,2021,192,63,129,48.8,192,63,129,48.8
37340, 영양군,085005, 84세,2021,187,55,132,41.7,187,55,132,41.7
37340, 영양군,090,85~89세,2021,547,156,391,39.9,545,156,389,40.1
37340, 영양군,090001, 85세,2021,136,42,94,44.7,136,42,94,44.7
37340, 영양군,090002, 86세,2021,154,54,100,54,153,54,99,54.5
37340, 영양군,090003, 87세,2021,112,26,86,30.2,111,26,85,30.6
37340, 영양군,090004, 88세,2021,75,15,60,25,75,15,60,25
37340, 영양군,090005, 89세,2021,70,19,51,37.3,70,19,51,37.3
37340, 영양군,095,90~94세,2021,199,44,155,28.4,199,44,155,28.4
37340, 영양군,095001, 90세,2021,60,8,52,15.4,60,8,52,15.4
37340, 영양군,095002, 91세,2021,43,11,32,34.4,43,11,32,34.4
37340, 영양군,095003, 92세,2021,39,14,25,56,39,14,25,56
37340, 영양군,095004, 93세,2021,37,7,30,23.3,37,7,30,23.3
37340, 영양군,095005, 94세,2021,20,X,16,25,20,X,16,25
37340, 영양군,100,95~99세,2021,45,9,36,25,45,9,36,25
37340, 영양군,100001, 95세,2021,14,X,13,7.7,14,X,13,7.7
37340, 영양군,100002, 96세,2021,10,X,10,0,10,X,10,0
37340, 영양군,100003, 97세,2021,10,5,5,100,10,5,5,100
37340, 영양군,100004, 98세,2021,10,X,7,42.9,10,X,7,42.9
37340, 영양군,100005, 99세,2021,X,X,X,0,X,X,X,0
37340, 영양군,101,100세이상,2021,10,X,9,11.1,10,X,9,11.1
37340, 영양군,102,15세미만,2021,1090,572,518,110.4,1088,571,517,110.4
37340, 영양군,103,15~64세,2021,8389,4556,3833,118.9,8047,4453,3594,123.9
37340, 영양군,104,65세이상,2021,6079,2554,3525,72.5,6068,2549,3519,72.4
37340, 영양군,086,85세이상,2021,801,210,591,35.5,799,210,589,35.7
37340, 영양군,126,평균연령,2021,56.2,53.7,58.6,,56.6,53.9,59.2,
37340, 영양군,127,중위연령,2021,60.4,57.9,62.7,,60.7,58.1,63.4,
37350, 영덕군,000,합계,2021,33927,16428,17499,93.9,32671,15469,17202,89.9
37350, 영덕군,005,0~4세,2021,632,301,331,90.9,632,301,331,90.9
37350, 영덕군,005001, 0세,2021,110,52,58,89.7,110,52,58,89.7
37350, 영덕군,005002, 1세,2021,124,59,65,90.8,124,59,65,90.8
37350, 영덕군,005003, 2세,2021,127,65,62,104.8,127,65,62,104.8
37350, 영덕군,005004, 3세,2021,102,45,57,78.9,102,45,57,78.9
37350, 영덕군,005005, 4세,2021,169,80,89,89.9,169,80,89,89.9
37350, 영덕군,010,5~9세,2021,829,430,399,107.8,829,430,399,107.8
37350, 영덕군,010001, 5세,2021,154,70,84,83.3,154,70,84,83.3
37350, 영덕군,010002, 6세,2021,153,84,69,121.7,153,84,69,121.7
37350, 영덕군,010003, 7세,2021,163,83,80,103.8,163,83,80,103.8
37350, 영덕군,010004, 8세,2021,180,100,80,125,180,100,80,125
37350, 영덕군,010005, 9세,2021,179,93,86,108.1,179,93,86,108.1
37350, 영덕군,015,10~14세,2021,911,462,449,102.9,911,462,449,102.9
37350, 영덕군,015001, 10세,2021,159,82,77,106.5,159,82,77,106.5
37350, 영덕군,015002, 11세,2021,208,98,110,89.1,208,98,110,89.1
37350, 영덕군,015003, 12세,2021,168,92,76,121.1,168,92,76,121.1
37350, 영덕군,015004, 13세,2021,159,76,83,91.6,159,76,83,91.6
37350, 영덕군,015005, 14세,2021,217,114,103,110.7,217,114,103,110.7
37350, 영덕군,020,15~19세,2021,821,420,401,104.7,818,419,399,105
37350, 영덕군,020001, 15세,2021,204,105,99,106.1,203,105,98,107.1
37350, 영덕군,020002, 16세,2021,187,96,91,105.5,185,95,90,105.6
37350, 영덕군,020003, 17세,2021,178,89,89,100,178,89,89,100
37350, 영덕군,020004, 18세,2021,164,79,85,92.9,164,79,85,92.9
37350, 영덕군,020005, 19세,2021,88,51,37,137.8,88,51,37,137.8
37350, 영덕군,025,20~24세,2021,791,518,273,189.7,724,465,259,179.5
37350, 영덕군,025001, 20세,2021,138,107,31,345.2,137,106,31,341.9
37350, 영덕군,025002, 21세,2021,164,122,42,290.5,155,117,38,307.9
37350, 영덕군,025003, 22세,2021,138,89,49,181.6,130,82,48,170.8
37350, 영덕군,025004, 23세,2021,144,79,65,121.5,120,58,62,93.5
37350, 영덕군,025005, 24세,2021,207,121,86,140.7,182,102,80,127.5
37350, 영덕군,030,25~29세,2021,1289,819,470,174.3,1007,584,423,138.1
37350, 영덕군,030001, 25세,2021,243,151,92,164.1,189,105,84,125
37350, 영덕군,030002, 26세,2021,227,144,83,173.5,179,103,76,135.5
37350, 영덕군,030003, 27세,2021,290,187,103,181.6,224,136,88,154.5
37350, 영덕군,030004, 28세,2021,253,160,93,172,199,115,84,136.9
37350, 영덕군,030005, 29세,2021,276,177,99,178.8,216,125,91,137.4
37350, 영덕군,035,30~34세,2021,1118,679,439,154.7,869,479,390,122.8
37350, 영덕군,035001, 30세,2021,234,155,79,196.2,174,100,74,135.1
37350, 영덕군,035002, 31세,2021,230,137,93,147.3,176,95,81,117.3
37350, 영덕군,035003, 32세,2021,227,143,84,170.2,182,107,75,142.7
37350, 영덕군,035004, 33세,2021,212,122,90,135.6,174,92,82,112.2
37350, 영덕군,035005, 34세,2021,215,122,93,131.2,163,85,78,109
37350, 영덕군,040,35~39세,2021,1400,785,615,127.6,1156,592,564,105
37350, 영덕군,040001, 35세,2021,241,142,99,143.4,184,99,85,116.5
37350, 영덕군,040002, 36세,2021,237,133,104,127.9,195,102,93,109.7
37350, 영덕군,040003, 37세,2021,292,158,134,117.9,235,111,124,89.5
37350, 영덕군,040004, 38세,2021,298,168,130,129.2,257,133,124,107.3
37350, 영덕군,040005, 39세,2021,332,184,148,124.3,285,147,138,106.5
37350, 영덕군,045,40~44세,2021,1636,908,728,124.7,1466,769,697,110.3
37350, 영덕군,045001, 40세,2021,321,174,147,118.4,277,139,138,100.7
37350, 영덕군,045002, 41세,2021,341,191,150,127.3,312,166,146,113.7
37350, 영덕군,045003, 42세,2021,313,181,132,137.1,268,144,124,116.1
37350, 영덕군,045004, 43세,2021,322,189,133,142.1,290,163,127,128.3
37350, 영덕군,045005, 44세,2021,339,173,166,104.2,319,157,162,96.9
37350, 영덕군,050,45~49세,2021,1979,1137,842,135,1875,1058,817,129.5
37350, 영덕군,050001, 45세,2021,349,192,157,122.3,316,170,146,116.4
37350, 영덕군,050002, 46세,2021,321,187,134,139.6,303,172,131,131.3
37350, 영덕군,050003, 47세,2021,418,222,196,113.3,401,211,190,111.1
37350, 영덕군,050004, 48세,2021,429,265,164,161.6,406,247,159,155.3
37350, 영덕군,050005, 49세,2021,462,271,191,141.9,449,258,191,135.1
37350, 영덕군,055,50~54세,2021,2586,1456,1130,128.8,2529,1427,1102,129.5
37350, 영덕군,055001, 50세,2021,481,261,220,118.6,468,254,214,118.7
37350, 영덕군,055002, 51세,2021,506,288,218,132.1,489,277,212,130.7
37350, 영덕군,055003, 52세,2021,509,305,204,149.5,503,302,201,150.2
37350, 영덕군,055004, 53세,2021,579,323,256,126.2,568,319,249,128.1
37350, 영덕군,055005, 54세,2021,511,279,232,120.3,501,275,226,121.7
37350, 영덕군,060,55~59세,2021,3027,1558,1469,106.1,2988,1542,1446,106.6
37350, 영덕군,060001, 55세,2021,576,293,283,103.5,569,289,280,103.2
37350, 영덕군,060002, 56세,2021,580,313,267,117.2,574,313,261,119.9
37350, 영덕군,060003, 57세,2021,558,268,290,92.4,548,262,286,91.6
37350, 영덕군,060004, 58세,2021,678,349,329,106.1,666,346,320,108.1
37350, 영덕군,060005, 59세,2021,635,335,300,111.7,631,332,299,111
37350, 영덕군,065,60~64세,2021,3741,1808,1933,93.5,3718,1800,1918,93.8
37350, 영덕군,065001, 60세,2021,749,375,374,100.3,744,373,371,100.5
37350, 영덕군,065002, 61세,2021,799,391,408,95.8,795,390,405,96.3
37350, 영덕군,065003, 62세,2021,727,326,401,81.3,725,324,401,80.8
37350, 영덕군,065004, 63세,2021,711,364,347,104.9,706,363,343,105.8
37350, 영덕군,065005, 64세,2021,755,352,403,87.3,748,350,398,87.9
37350, 영덕군,070,65~69세,2021,3397,1591,1806,88.1,3389,1587,1802,88.1
37350, 영덕군,070001, 65세,2021,695,340,355,95.8,690,339,351,96.6
37350, 영덕군,070002, 66세,2021,704,334,370,90.3,703,333,370,90
37350, 영덕군,070003, 67세,2021,656,296,360,82.2,655,295,360,81.9
37350, 영덕군,070004, 68세,2021,670,322,348,92.5,669,321,348,92.2
37350, 영덕군,070005, 69세,2021,672,299,373,80.2,672,299,373,80.2
37350, 영덕군,075,70~74세,2021,2911,1309,1602,81.7,2908,1308,1600,81.8
37350, 영덕군,075001, 70세,2021,563,271,292,92.8,562,271,291,93.1
37350, 영덕군,075002, 71세,2021,518,226,292,77.4,518,226,292,77.4
37350, 영덕군,075003, 72세,2021,649,303,346,87.6,648,303,345,87.8
37350, 영덕군,075004, 73세,2021,619,257,362,71,618,256,362,70.7
37350, 영덕군,075005, 74세,2021,562,252,310,81.3,562,252,310,81.3
37350, 영덕군,080,75~79세,2021,2693,993,1700,58.4,2691,992,1699,58.4
37350, 영덕군,080001, 75세,2021,350,151,199,75.9,350,151,199,75.9
37350, 영덕군,080002, 76세,2021,429,153,276,55.4,429,153,276,55.4
37350, 영덕군,080003, 77세,2021,515,160,355,45.1,514,159,355,44.8
37350, 영덕군,080004, 78세,2021,701,279,422,66.1,700,279,421,66.3
37350, 영덕군,080005, 79세,2021,698,250,448,55.8,698,250,448,55.8
37350, 영덕군,085,80~84세,2021,2421,801,1620,49.4,2418,801,1617,49.5
37350, 영덕군,085001, 80세,2021,546,180,366,49.2,546,180,366,49.2
37350, 영덕군,085002, 81세,2021,498,165,333,49.5,496,165,331,49.8
37350, 영덕군,085003, 82세,2021,533,170,363,46.8,533,170,363,46.8
37350, 영덕군,085004, 83세,2021,458,161,297,54.2,458,161,297,54.2
37350, 영덕군,085005, 84세,2021,386,125,261,47.9,385,125,260,48.1
37350, 영덕군,090,85~89세,2021,1268,361,907,39.8,1266,361,905,39.9
37350, 영덕군,090001, 85세,2021,362,122,240,50.8,361,122,239,51
37350, 영덕군,090002, 86세,2021,316,84,232,36.2,316,84,232,36.2
37350, 영덕군,090003, 87세,2021,242,65,177,36.7,242,65,177,36.7
37350, 영덕군,090004, 88세,2021,189,45,144,31.3,188,45,143,31.5
37350, 영덕군,090005, 89세,2021,159,45,114,39.5,159,45,114,39.5
37350, 영덕군,095,90~94세,2021,392,81,311,26,392,81,311,26
37350, 영덕군,095001, 90세,2021,124,27,97,27.8,124,27,97,27.8
37350, 영덕군,095002, 91세,2021,104,20,84,23.8,104,20,84,23.8
37350, 영덕군,095003, 92세,2021,75,21,54,38.9,75,21,54,38.9
37350, 영덕군,095004, 93세,2021,54,11,43,25.6,54,11,43,25.6
37350, 영덕군,095005, 94세,2021,35,X,33,6.1,35,X,33,6.1
37350, 영덕군,100,95~99세,2021,76,10,66,15.2,76,10,66,15.2
37350, 영덕군,100001, 95세,2021,22,X,19,15.8,22,X,19,15.8
37350, 영덕군,100002, 96세,2021,26,X,22,18.2,26,X,22,18.2
37350, 영덕군,100003, 97세,2021,11,X,10,10,11,X,10,10
37350, 영덕군,100004, 98세,2021,11,X,10,10,11,X,10,10
37350, 영덕군,100005, 99세,2021,6,X,5,20,6,X,5,20
37350, 영덕군,101,100세이상,2021,9,X,8,12.5,9,X,8,12.5
37350, 영덕군,102,15세미만,2021,2372,1193,1179,101.2,2372,1193,1179,101.2
37350, 영덕군,103,15~64세,2021,18388,10088,8300,121.5,17150,9135,8015,114
37350, 영덕군,104,65세이상,2021,13167,5147,8020,64.2,13149,5141,8008,64.2
37350, 영덕군,086,85세이상,2021,1745,453,1292,35.1,1743,453,1290,35.1
37350, 영덕군,126,평균연령,2021,55.6,52.4,58.7,,56.4,53.4,59,
37350, 영덕군,127,중위연령,2021,59.9,56,63.1,,60.7,57.6,63.4,
37360, 청도군,000,합계,2021,40071,19376,20695,93.6,38704,18779,19925,94.2
37360, 청도군,005,0~4세,2021,563,288,275,104.7,562,287,275,104.4
37360, 청도군,005001, 0세,2021,87,44,43,102.3,87,44,43,102.3
37360, 청도군,005002, 1세,2021,112,58,54,107.4,112,58,54,107.4
37360, 청도군,005003, 2세,2021,109,48,61,78.7,108,47,61,77
37360, 청도군,005004, 3세,2021,127,70,57,122.8,127,70,57,122.8
37360, 청도군,005005, 4세,2021,128,68,60,113.3,128,68,60,113.3
37360, 청도군,010,5~9세,2021,784,398,386,103.1,783,397,386,102.8
37360, 청도군,010001, 5세,2021,139,72,67,107.5,139,72,67,107.5
37360, 청도군,010002, 6세,2021,147,74,73,101.4,147,74,73,101.4
37360, 청도군,010003, 7세,2021,152,75,77,97.4,152,75,77,97.4
37360, 청도군,010004, 8세,2021,164,82,82,100,164,82,82,100
37360, 청도군,010005, 9세,2021,182,95,87,109.2,181,94,87,108
37360, 청도군,015,10~14세,2021,1000,505,495,102,998,504,494,102
37360, 청도군,015001, 10세,2021,202,95,107,88.8,201,95,106,89.6
37360, 청도군,015002, 11세,2021,164,88,76,115.8,164,88,76,115.8
37360, 청도군,015003, 12세,2021,188,95,93,102.2,188,95,93,102.2
37360, 청도군,015004, 13세,2021,210,113,97,116.5,209,112,97,115.5
37360, 청도군,015005, 14세,2021,236,114,122,93.4,236,114,122,93.4
37360, 청도군,020,15~19세,2021,1318,717,601,119.3,1314,716,598,119.7
37360, 청도군,020001, 15세,2021,218,115,103,111.7,218,115,103,111.7
37360, 청도군,020002, 16세,2021,235,120,115,104.3,234,120,114,105.3
37360, 청도군,020003, 17세,2021,359,201,158,127.2,359,201,158,127.2
37360, 청도군,020004, 18세,2021,339,185,154,120.1,339,185,154,120.1
37360, 청도군,020005, 19세,2021,167,96,71,135.2,164,95,69,137.7
37360, 청도군,025,20~24세,2021,1199,710,489,145.2,1075,663,412,160.9
37360, 청도군,025001, 20세,2021,205,129,76,169.7,204,129,75,172
37360, 청도군,025002, 21세,2021,258,163,95,171.6,249,160,89,179.8
37360, 청도군,025003, 22세,2021,241,159,82,193.9,222,151,71,212.7
37360, 청도군,025004, 23세,2021,245,135,110,122.7,208,118,90,131.1
37360, 청도군,025005, 24세,2021,250,124,126,98.4,192,105,87,120.7
37360, 청도군,030,25~29세,2021,1482,803,679,118.3,1093,645,448,144
37360, 청도군,030001, 25세,2021,274,163,111,146.8,212,136,76,178.9
37360, 청도군,030002, 26세,2021,282,152,130,116.9,204,123,81,151.9
37360, 청도군,030003, 27세,2021,350,188,162,116,267,151,116,130.2
37360, 청도군,030004, 28세,2021,290,160,130,123.1,217,130,87,149.4
37360, 청도군,030005, 29세,2021,286,140,146,95.9,193,105,88,119.3
37360, 청도군,035,30~34세,2021,1394,764,630,121.3,1064,605,459,131.8
37360, 청도군,035001, 30세,2021,269,165,104,158.7,206,131,75,174.7
37360, 청도군,035002, 31세,2021,314,151,163,92.6,237,121,116,104.3
37360, 청도군,035003, 32세,2021,256,142,114,124.6,191,112,79,141.8
37360, 청도군,035004, 33세,2021,274,151,123,122.8,212,122,90,135.6
37360, 청도군,035005, 34세,2021,281,155,126,123,218,119,99,120.2
37360, 청도군,040,35~39세,2021,1459,768,691,111.1,1271,676,595,113.6
37360, 청도군,040001, 35세,2021,248,132,116,113.8,205,110,95,115.8
37360, 청도군,040002, 36세,2021,257,145,112,129.5,220,123,97,126.8
37360, 청도군,040003, 37세,2021,284,139,145,95.9,245,119,126,94.4
37360, 청도군,040004, 38세,2021,301,163,138,118.1,266,147,119,123.5
37360, 청도군,040005, 39세,2021,369,189,180,105,335,177,158,112
37360, 청도군,045,40~44세,2021,1788,904,884,102.3,1670,861,809,106.4
37360, 청도군,045001, 40세,2021,370,166,204,81.4,345,160,185,86.5
37360, 청도군,045002, 41세,2021,382,186,196,94.9,353,176,177,99.4
37360, 청도군,045003, 42세,2021,361,187,174,107.5,340,178,162,109.9
37360, 청도군,045004, 43세,2021,329,174,155,112.3,309,166,143,116.1
37360, 청도군,045005, 44세,2021,346,191,155,123.2,323,181,142,127.5
37360, 청도군,050,45~49세,2021,2159,1195,964,124,2091,1164,927,125.6
37360, 청도군,050001, 45세,2021,378,214,164,130.5,360,204,156,130.8
37360, 청도군,050002, 46세,2021,365,201,164,122.6,352,194,158,122.8
37360, 청도군,050003, 47세,2021,451,265,186,142.5,434,257,177,145.2
37360, 청도군,050004, 48세,2021,456,243,213,114.1,447,241,206,117
37360, 청도군,050005, 49세,2021,509,272,237,114.8,498,268,230,116.5
37360, 청도군,055,50~54세,2021,2929,1492,1437,103.8,2883,1472,1411,104.3
37360, 청도군,055001, 50세,2021,540,291,249,116.9,531,286,245,116.7
37360, 청도군,055002, 51세,2021,562,286,276,103.6,546,278,268,103.7
37360, 청도군,055003, 52세,2021,574,281,293,95.9,566,277,289,95.8
37360, 청도군,055004, 53세,2021,638,338,300,112.7,630,337,293,115
37360, 청도군,055005, 54세,2021,615,296,319,92.8,610,294,316,93
37360, 청도군,060,55~59세,2021,3677,1891,1786,105.9,3643,1877,1766,106.3
37360, 청도군,060001, 55세,2021,621,328,293,111.9,608,321,287,111.8
37360, 청도군,060002, 56세,2021,698,357,341,104.7,692,354,338,104.7
37360, 청도군,060003, 57세,2021,729,373,356,104.8,725,372,353,105.4
37360, 청도군,060004, 58세,2021,735,365,370,98.6,733,365,368,99.2
37360, 청도군,060005, 59세,2021,894,468,426,109.9,885,465,420,110.7
37360, 청도군,065,60~64세,2021,4899,2456,2443,100.5,4870,2439,2431,100.3
37360, 청도군,065001, 60세,2021,952,477,475,100.4,946,475,471,100.8
37360, 청도군,065002, 61세,2021,1091,497,594,83.7,1084,494,590,83.7
37360, 청도군,065003, 62세,2021,1084,563,521,108.1,1074,556,518,107.3
37360, 청도군,065004, 63세,2021,850,424,426,99.5,846,421,425,99.1
37360, 청도군,065005, 64세,2021,922,495,427,115.9,920,493,427,115.5
37360, 청도군,070,65~69세,2021,4382,2138,2244,95.3,4368,2135,2233,95.6
37360, 청도군,070001, 65세,2021,859,428,431,99.3,854,428,426,100.5
37360, 청도군,070002, 66세,2021,968,453,515,88,964,453,511,88.6
37360, 청도군,070003, 67세,2021,810,378,432,87.5,809,377,432,87.3
37360, 청도군,070004, 68세,2021,828,430,398,108,825,428,397,107.8
37360, 청도군,070005, 69세,2021,917,449,468,95.9,916,449,467,96.1
37360, 청도군,075,70~74세,2021,3741,1787,1954,91.5,3730,1783,1947,91.6
37360, 청도군,075001, 70세,2021,779,345,434,79.5,776,343,433,79.2
37360, 청도군,075002, 71세,2021,788,365,423,86.3,786,364,422,86.3
37360, 청도군,075003, 72세,2021,805,396,409,96.8,802,396,406,97.5
37360, 청도군,075004, 73세,2021,684,361,323,111.8,683,361,322,112.1
37360, 청도군,075005, 74세,2021,685,320,365,87.7,683,319,364,87.6
37360, 청도군,080,75~79세,2021,2638,1112,1526,72.9,2634,1109,1525,72.7
37360, 청도군,080001, 75세,2021,417,190,227,83.7,416,189,227,83.3
37360, 청도군,080002, 76세,2021,398,182,216,84.3,398,182,216,84.3
37360, 청도군,080003, 77세,2021,527,222,305,72.8,527,222,305,72.8
37360, 청도군,080004, 78세,2021,622,261,361,72.3,620,260,360,72.2
37360, 청도군,080005, 79세,2021,674,257,417,61.6,673,256,417,61.4
37360, 청도군,085,80~84세,2021,2548,892,1656,53.9,2545,890,1655,53.8
37360, 청도군,085001, 80세,2021,559,211,348,60.6,557,209,348,60.1
37360, 청도군,085002, 81세,2021,523,184,339,54.3,523,184,339,54.3
37360, 청도군,085003, 82세,2021,499,178,321,55.5,498,178,320,55.6
37360, 청도군,085004, 83세,2021,515,167,348,48,515,167,348,48
37360, 청도군,085005, 84세,2021,452,152,300,50.7,452,152,300,50.7
37360, 청도군,090,85~89세,2021,1546,439,1107,39.7,1545,439,1106,39.7
37360, 청도군,090001, 85세,2021,409,119,290,41,409,119,290,41
37360, 청도군,090002, 86세,2021,351,106,245,43.3,351,106,245,43.3
37360, 청도군,090003, 87세,2021,296,99,197,50.3,295,99,196,50.5
37360, 청도군,090004, 88세,2021,282,78,204,38.2,282,78,204,38.2
37360, 청도군,090005, 89세,2021,208,37,171,21.6,208,37,171,21.6
37360, 청도군,095,90~94세,2021,463,97,366,26.5,463,97,366,26.5
37360, 청도군,095001, 90세,2021,142,29,113,25.7,142,29,113,25.7
37360, 청도군,095002, 91세,2021,112,22,90,24.4,112,22,90,24.4
37360, 청도군,095003, 92세,2021,90,19,71,26.8,90,19,71,26.8
37360, 청도군,095004, 93세,2021,69,13,56,23.2,69,13,56,23.2
37360, 청도군,095005, 94세,2021,50,14,36,38.9,50,14,36,38.9
37360, 청도군,100,95~99세,2021,95,20,75,26.7,95,20,75,26.7
37360, 청도군,100001, 95세,2021,32,7,25,28,32,7,25,28
37360, 청도군,100002, 96세,2021,27,X,23,17.4,27,X,23,17.4
37360, 청도군,100003, 97세,2021,17,6,11,54.5,17,6,11,54.5
37360, 청도군,100004, 98세,2021,14,X,12,16.7,14,X,12,16.7
37360, 청도군,100005, 99세,2021,5,X,X,25,5,X,X,25
37360, 청도군,101,100세이상,2021,7,X,7,0,7,X,7,0
37360, 청도군,102,15세미만,2021,2347,1191,1156,103,2343,1188,1155,102.9
37360, 청도군,103,15~64세,2021,22304,11700,10604,110.3,20974,11118,9856,112.8
37360, 청도군,104,65세이상,2021,15420,6485,8935,72.6,15387,6473,8914,72.6
37360, 청도군,086,85세이상,2021,2111,556,1555,35.8,2110,556,1554,35.8
37360, 청도군,126,평균연령,2021,55.7,53.3,57.9,,56.4,53.9,58.7,
37360, 청도군,127,중위연령,2021,60.3,58.2,61.9,,61,59,62.6,
37370, 고령군,000,합계,2021,30399,15899,14500,109.6,28424,14368,14056,102.2
37370, 고령군,005,0~4세,2021,532,265,267,99.3,521,261,260,100.4
37370, 고령군,005001, 0세,2021,97,57,40,142.5,96,56,40,140
37370, 고령군,005002, 1세,2021,92,41,51,80.4,87,39,48,81.3
37370, 고령군,005003, 2세,2021,109,61,48,127.1,107,60,47,127.7
37370, 고령군,005004, 3세,2021,110,50,60,83.3,108,50,58,86.2
37370, 고령군,005005, 4세,2021,124,56,68,82.4,123,56,67,83.6
37370, 고령군,010,5~9세,2021,762,402,360,111.7,756,397,359,110.6
37370, 고령군,010001, 5세,2021,135,73,62,117.7,133,71,62,114.5
37370, 고령군,010002, 6세,2021,144,80,64,125,142,79,63,125.4
37370, 고령군,010003, 7세,2021,148,81,67,120.9,148,81,67,120.9
37370, 고령군,010004, 8세,2021,167,80,87,92,165,78,87,89.7
37370, 고령군,010005, 9세,2021,168,88,80,110,168,88,80,110
37370, 고령군,015,10~14세,2021,893,469,424,110.6,888,467,421,110.9
37370, 고령군,015001, 10세,2021,147,71,76,93.4,146,71,75,94.7
37370, 고령군,015002, 11세,2021,181,101,80,126.3,181,101,80,126.3
37370, 고령군,015003, 12세,2021,175,84,91,92.3,174,84,90,93.3
37370, 고령군,015004, 13세,2021,183,101,82,123.2,181,100,81,123.5
37370, 고령군,015005, 14세,2021,207,112,95,117.9,206,111,95,116.8
37370, 고령군,020,15~19세,2021,876,499,377,132.4,872,498,374,133.2
37370, 고령군,020001, 15세,2021,190,97,93,104.3,188,97,91,106.6
37370, 고령군,020002, 16세,2021,191,121,70,172.9,190,121,69,175.4
37370, 고령군,020003, 17세,2021,179,104,75,138.7,179,104,75,138.7
37370, 고령군,020004, 18세,2021,190,107,83,128.9,190,107,83,128.9
37370, 고령군,020005, 19세,2021,126,70,56,125,125,69,56,123.2
37370, 고령군,025,20~24세,2021,1240,785,455,172.5,1051,633,418,151.4
37370, 고령군,025001, 20세,2021,215,134,81,165.4,200,126,74,170.3
37370, 고령군,025002, 21세,2021,238,158,80,197.5,211,140,71,197.2
37370, 고령군,025003, 22세,2021,247,164,83,197.6,211,132,79,167.1
37370, 고령군,025004, 23세,2021,257,165,92,179.3,211,126,85,148.2
37370, 고령군,025005, 24세,2021,283,164,119,137.8,218,109,109,100
37370, 고령군,030,25~29세,2021,1343,879,464,189.4,957,551,406,135.7
37370, 고령군,030001, 25세,2021,264,167,97,172.2,193,111,82,135.4
37370, 고령군,030002, 26세,2021,283,188,95,197.9,209,129,80,161.3
37370, 고령군,030003, 27세,2021,231,147,84,175,172,100,72,138.9
37370, 고령군,030004, 28세,2021,293,197,96,205.2,201,114,87,131
37370, 고령군,030005, 29세,2021,272,180,92,195.7,182,97,85,114.1
37370, 고령군,035,30~34세,2021,1301,839,462,181.6,867,486,381,127.6
37370, 고령군,035001, 30세,2021,264,171,93,183.9,180,105,75,140
37370, 고령군,035002, 31세,2021,258,158,100,158,168,93,75,124
37370, 고령군,035003, 32세,2021,299,207,92,225,197,114,83,137.3
37370, 고령군,035004, 33세,2021,239,158,81,195.1,156,88,68,129.4
37370, 고령군,035005, 34세,2021,241,145,96,151,166,86,80,107.5
37370, 고령군,040,35~39세,2021,1422,860,562,153,1073,570,503,113.3
37370, 고령군,040001, 35세,2021,244,152,92,165.2,186,98,88,111.4
37370, 고령군,040002, 36세,2021,272,177,95,186.3,195,115,80,143.8
37370, 고령군,040003, 37세,2021,262,160,102,156.9,188,100,88,113.6
37370, 고령군,040004, 38세,2021,293,182,111,164,233,133,100,133
37370, 고령군,040005, 39세,2021,351,189,162,116.7,271,124,147,84.4
37370, 고령군,045,40~44세,2021,1610,924,686,134.7,1399,758,641,118.3
37370, 고령군,045001, 40세,2021,327,192,135,142.2,280,154,126,122.2
37370, 고령군,045002, 41세,2021,322,188,134,140.3,276,152,124,122.6
37370, 고령군,045003, 42세,2021,325,180,145,124.1,275,142,133,106.8
37370, 고령군,045004, 43세,2021,316,186,130,143.1,276,155,121,128.1
37370, 고령군,045005, 44세,2021,320,178,142,125.4,292,155,137,113.1
37370, 고령군,050,45~49세,2021,2043,1147,896,128,1903,1047,856,122.3
37370, 고령군,050001, 45세,2021,351,205,146,140.4,308,169,139,121.6
37370, 고령군,050002, 46세,2021,381,212,169,125.4,353,195,158,123.4
37370, 고령군,050003, 47세,2021,425,229,196,116.8,397,213,184,115.8
37370, 고령군,050004, 48세,2021,436,243,193,125.9,415,226,189,119.6
37370, 고령군,050005, 49세,2021,450,258,192,134.4,430,244,186,131.2
37370, 고령군,055,50~54세,2021,2555,1432,1123,127.5,2450,1368,1082,126.4
37370, 고령군,055001, 50세,2021,532,303,229,132.3,506,289,217,133.2
37370, 고령군,055002, 51세,2021,482,279,203,137.4,460,264,196,134.7
37370, 고령군,055003, 52세,2021,525,305,220,138.6,502,290,212,136.8
37370, 고령군,055004, 53세,2021,501,269,232,115.9,483,258,225,114.7
37370, 고령군,055005, 54세,2021,515,276,239,115.5,499,267,232,115.1
37370, 고령군,060,55~59세,2021,2920,1558,1362,114.4,2852,1522,1330,114.4
37370, 고령군,060001, 55세,2021,531,304,227,133.9,516,296,220,134.5
37370, 고령군,060002, 56세,2021,557,292,265,110.2,546,285,261,109.2
37370, 고령군,060003, 57세,2021,553,282,271,104.1,542,276,266,103.8
37370, 고령군,060004, 58세,2021,603,317,286,110.8,586,307,279,110
37370, 고령군,060005, 59세,2021,676,363,313,116,662,358,304,117.8
37370, 고령군,065,60~64세,2021,3309,1739,1570,110.8,3272,1722,1550,111.1
37370, 고령군,065001, 60세,2021,706,384,322,119.3,693,378,315,120
37370, 고령군,065002, 61세,2021,716,343,373,92,706,339,367,92.4
37370, 고령군,065003, 62세,2021,716,379,337,112.5,709,376,333,112.9
37370, 고령군,065004, 63세,2021,554,290,264,109.8,551,288,263,109.5
37370, 고령군,065005, 64세,2021,617,343,274,125.2,613,341,272,125.4
37370, 고령군,070,65~69세,2021,2785,1405,1380,101.8,2770,1399,1371,102
37370, 고령군,070001, 65세,2021,589,289,300,96.3,586,287,299,96
37370, 고령군,070002, 66세,2021,598,304,294,103.4,594,302,292,103.4
37370, 고령군,070003, 67세,2021,535,272,263,103.4,535,272,263,103.4
37370, 고령군,070004, 68세,2021,484,255,229,111.4,482,255,227,112.3
37370, 고령군,070005, 69세,2021,579,285,294,96.9,573,283,290,97.6
37370, 고령군,075,70~74세,2021,2235,1061,1174,90.4,2222,1055,1167,90.4
37370, 고령군,075001, 70세,2021,457,215,242,88.8,453,213,240,88.8
37370, 고령군,075002, 71세,2021,459,222,237,93.7,456,221,235,94
37370, 고령군,075003, 72세,2021,477,234,243,96.3,475,233,242,96.3
37370, 고령군,075004, 73세,2021,420,198,222,89.2,417,196,221,88.7
37370, 고령군,075005, 74세,2021,422,192,230,83.5,421,192,229,83.8
37370, 고령군,080,75~79세,2021,1728,717,1011,70.9,1727,716,1011,70.8
37370, 고령군,080001, 75세,2021,291,133,158,84.2,290,132,158,83.5
37370, 고령군,080002, 76세,2021,278,122,156,78.2,278,122,156,78.2
37370, 고령군,080003, 77세,2021,359,164,195,84.1,359,164,195,84.1
37370, 고령군,080004, 78세,2021,376,143,233,61.4,376,143,233,61.4
37370, 고령군,080005, 79세,2021,424,155,269,57.6,424,155,269,57.6
37370, 고령군,085,80~84세,2021,1615,545,1070,50.9,1615,545,1070,50.9
37370, 고령군,085001, 80세,2021,348,125,223,56.1,348,125,223,56.1
37370, 고령군,085002, 81세,2021,342,115,227,50.7,342,115,227,50.7
37370, 고령군,085003, 82세,2021,361,123,238,51.7,361,123,238,51.7
37370, 고령군,085004, 83세,2021,293,88,205,42.9,293,88,205,42.9
37370, 고령군,085005, 84세,2021,271,94,177,53.1,271,94,177,53.1
37370, 고령군,090,85~89세,2021,922,303,619,48.9,921,303,618,49
37370, 고령군,090001, 85세,2021,256,93,163,57.1,256,93,163,57.1
37370, 고령군,090002, 86세,2021,231,82,149,55,231,82,149,55
37370, 고령군,090003, 87세,2021,177,51,126,40.5,176,51,125,40.8
37370, 고령군,090004, 88세,2021,143,42,101,41.6,143,42,101,41.6
37370, 고령군,090005, 89세,2021,115,35,80,43.8,115,35,80,43.8
37370, 고령군,095,90~94세,2021,258,61,197,31,258,61,197,31
37370, 고령군,095001, 90세,2021,89,22,67,32.8,89,22,67,32.8
37370, 고령군,095002, 91세,2021,56,12,44,27.3,56,12,44,27.3
37370, 고령군,095003, 92세,2021,41,11,30,36.7,41,11,30,36.7
37370, 고령군,095004, 93세,2021,43,11,32,34.4,43,11,32,34.4
37370, 고령군,095005, 94세,2021,29,5,24,20.8,29,5,24,20.8
37370, 고령군,100,95~99세,2021,46,9,37,24.3,46,9,37,24.3
37370, 고령군,100001, 95세,2021,11,X,10,10,11,X,10,10
37370, 고령군,100002, 96세,2021,17,X,15,13.3,17,X,15,13.3
37370, 고령군,100003, 97세,2021,11,5,6,83.3,11,5,6,83.3
37370, 고령군,100004, 98세,2021,X,X,X,33.3,X,X,X,33.3
37370, 고령군,100005, 99세,2021,X,X,X,0,X,X,X,0
37370, 고령군,101,100세이상,2021,X,X,X,0,X,X,X,0
37370, 고령군,102,15세미만,2021,2187,1136,1051,108.1,2165,1125,1040,108.2
37370, 고령군,103,15~64세,2021,18619,10662,7957,134,16696,9155,7541,121.4
37370, 고령군,104,65세이상,2021,9593,4101,5492,74.7,9563,4088,5475,74.7
37370, 고령군,086,85세이상,2021,1230,373,857,43.5,1229,373,856,43.6
37370, 고령군,126,평균연령,2021,52.5,49.8,55.4,,53.6,51.4,55.9,
37370, 고령군,127,중위연령,2021,56.2,53,59.4,,57.8,55.5,60,
37380, 성주군,000,합계,2021,40804,21194,19610,108.1,38830,19729,19101,103.3
37380, 성주군,005,0~4세,2021,919,468,451,103.8,908,459,449,102.2
37380, 성주군,005001, 0세,2021,175,85,90,94.4,172,84,88,95.5
37380, 성주군,005002, 1세,2021,186,99,87,113.8,183,96,87,110.3
37380, 성주군,005003, 2세,2021,186,96,90,106.7,186,96,90,106.7
37380, 성주군,005004, 3세,2021,183,93,90,103.3,178,88,90,97.8
37380, 성주군,005005, 4세,2021,189,95,94,101.1,189,95,94,101.1
37380, 성주군,010,5~9세,2021,835,414,421,98.3,826,408,418,97.6
37380, 성주군,010001, 5세,2021,164,86,78,110.3,160,84,76,110.5
37380, 성주군,010002, 6세,2021,154,80,74,108.1,153,79,74,106.8
37380, 성주군,010003, 7세,2021,145,72,73,98.6,142,70,72,97.2
37380, 성주군,010004, 8세,2021,190,92,98,93.9,190,92,98,93.9
37380, 성주군,010005, 9세,2021,182,84,98,85.7,181,83,98,84.7
37380, 성주군,015,10~14세,2021,978,524,454,115.4,977,524,453,115.7
37380, 성주군,015001, 10세,2021,219,113,106,106.6,219,113,106,106.6
37380, 성주군,015002, 11세,2021,170,84,86,97.7,170,84,86,97.7
37380, 성주군,015003, 12세,2021,187,98,89,110.1,187,98,89,110.1
37380, 성주군,015004, 13세,2021,209,123,86,143,208,123,85,144.7
37380, 성주군,015005, 14세,2021,193,106,87,121.8,193,106,87,121.8
37380, 성주군,020,15~19세,2021,981,533,448,119,977,532,445,119.6
37380, 성주군,020001, 15세,2021,205,118,87,135.6,205,118,87,135.6
37380, 성주군,020002, 16세,2021,199,103,96,107.3,199,103,96,107.3
37380, 성주군,020003, 17세,2021,220,123,97,126.8,218,122,96,127.1
37380, 성주군,020004, 18세,2021,214,111,103,107.8,213,111,102,108.8
37380, 성주군,020005, 19세,2021,143,78,65,120,142,78,64,121.9
37380, 성주군,025,20~24세,2021,1330,861,469,183.6,1199,760,439,173.1
37380, 성주군,025001, 20세,2021,232,167,65,256.9,229,166,63,263.5
37380, 성주군,025002, 21세,2021,246,157,89,176.4,234,149,85,175.3
37380, 성주군,025003, 22세,2021,257,175,82,213.4,230,151,79,191.1
37380, 성주군,025004, 23세,2021,280,175,105,166.7,237,142,95,149.5
37380, 성주군,025005, 24세,2021,315,187,128,146.1,269,152,117,129.9
37380, 성주군,030,25~29세,2021,1883,1223,660,185.3,1455,876,579,151.3
37380, 성주군,030001, 25세,2021,336,195,141,138.3,269,145,124,116.9
37380, 성주군,030002, 26세,2021,355,230,125,184,274,165,109,151.4
37380, 성주군,030003, 27세,2021,399,275,124,221.8,323,210,113,185.8
37380, 성주군,030004, 28세,2021,395,259,136,190.4,286,173,113,153.1
37380, 성주군,030005, 29세,2021,398,264,134,197,303,183,120,152.5
37380, 성주군,035,30~34세,2021,1815,1109,706,157.1,1341,755,586,128.8
37380, 성주군,035001, 30세,2021,406,244,162,150.6,297,154,143,107.7
37380, 성주군,035002, 31세,2021,394,244,150,162.7,281,159,122,130.3
37380, 성주군,035003, 32세,2021,331,208,123,169.1,231,137,94,145.7
37380, 성주군,035004, 33세,2021,381,227,154,147.4,291,168,123,136.6
37380, 성주군,035005, 34세,2021,303,186,117,159,241,137,104,131.7
37380, 성주군,040,35~39세,2021,1840,1075,765,140.5,1478,796,682,116.7
37380, 성주군,040001, 35세,2021,356,214,142,150.7,257,138,119,116
37380, 성주군,040002, 36세,2021,353,197,156,126.3,278,146,132,110.6
37380, 성주군,040003, 37세,2021,346,206,140,147.1,273,149,124,120.2
37380, 성주군,040004, 38세,2021,370,210,160,131.3,314,167,147,113.6
37380, 성주군,040005, 39세,2021,415,248,167,148.5,356,196,160,122.5
37380, 성주군,045,40~44세,2021,1995,1236,759,162.8,1765,1061,704,150.7
37380, 성주군,045001, 40세,2021,343,207,136,152.2,291,166,125,132.8
37380, 성주군,045002, 41세,2021,440,274,166,165.1,392,234,158,148.1
37380, 성주군,045003, 42세,2021,405,241,164,147,357,206,151,136.4
37380, 성주군,045004, 43세,2021,362,221,141,156.7,328,197,131,150.4
37380, 성주군,045005, 44세,2021,445,293,152,192.8,397,258,139,185.6
37380, 성주군,050,45~49세,2021,2360,1370,990,138.4,2228,1278,950,134.5
37380, 성주군,050001, 45세,2021,392,243,149,163.1,359,218,141,154.6
37380, 성주군,050002, 46세,2021,427,236,191,123.6,400,218,182,119.8
37380, 성주군,050003, 47세,2021,505,289,216,133.8,479,271,208,130.3
37380, 성주군,050004, 48세,2021,513,302,211,143.1,484,283,201,140.8
37380, 성주군,050005, 49세,2021,523,300,223,134.5,506,288,218,132.1
37380, 성주군,055,50~54세,2021,3204,1735,1469,118.1,3129,1693,1436,117.9
37380, 성주군,055001, 50세,2021,562,321,241,133.2,541,309,232,133.2
37380, 성주군,055002, 51세,2021,603,336,267,125.8,579,323,256,126.2
37380, 성주군,055003, 52세,2021,622,353,269,131.2,609,346,263,131.6
37380, 성주군,055004, 53세,2021,712,366,346,105.8,708,364,344,105.8
37380, 성주군,055005, 54세,2021,705,359,346,103.8,692,351,341,102.9
37380, 성주군,060,55~59세,2021,4140,2182,1958,111.4,4083,2148,1935,111
37380, 성주군,060001, 55세,2021,735,395,340,116.2,728,391,337,116
37380, 성주군,060002, 56세,2021,825,453,372,121.8,811,443,368,120.4
37380, 성주군,060003, 57세,2021,792,399,393,101.5,780,395,385,102.6
37380, 성주군,060004, 58세,2021,831,433,398,108.8,819,425,394,107.9
37380, 성주군,060005, 59세,2021,957,502,455,110.3,945,494,451,109.5
37380, 성주군,065,60~64세,2021,4946,2591,2355,110,4914,2577,2337,110.3
37380, 성주군,065001, 60세,2021,1116,586,530,110.6,1109,583,526,110.8
37380, 성주군,065002, 61세,2021,1097,534,563,94.8,1085,529,556,95.1
37380, 성주군,065003, 62세,2021,1039,532,507,104.9,1035,530,505,105
37380, 성주군,065004, 63세,2021,835,469,366,128.1,831,467,364,128.3
37380, 성주군,065005, 64세,2021,859,470,389,120.8,854,468,386,121.2
37380, 성주군,070,65~69세,2021,4046,2033,2013,101,4026,2028,1998,101.5
37380, 성주군,070001, 65세,2021,838,459,379,121.1,833,457,376,121.5
37380, 성주군,070002, 66세,2021,896,435,461,94.4,889,433,456,95
37380, 성주군,070003, 67세,2021,719,362,357,101.4,715,362,353,102.5
37380, 성주군,070004, 68세,2021,729,381,348,109.5,727,380,347,109.5
37380, 성주군,070005, 69세,2021,864,396,468,84.6,862,396,466,85
37380, 성주군,075,70~74세,2021,3272,1591,1681,94.6,3265,1586,1679,94.5
37380, 성주군,075001, 70세,2021,636,323,313,103.2,633,321,312,102.9
37380, 성주군,075002, 71세,2021,686,326,360,90.6,685,325,360,90.3
37380, 성주군,075003, 72세,2021,702,340,362,93.9,700,339,361,93.9
37380, 성주군,075004, 73세,2021,651,316,335,94.3,650,315,335,94
37380, 성주군,075005, 74세,2021,597,286,311,92,597,286,311,92
37380, 성주군,080,75~79세,2021,2306,1001,1305,76.7,2306,1001,1305,76.7
37380, 성주군,080001, 75세,2021,388,177,211,83.9,388,177,211,83.9
37380, 성주군,080002, 76세,2021,373,178,195,91.3,373,178,195,91.3
37380, 성주군,080003, 77세,2021,458,199,259,76.8,458,199,259,76.8
37380, 성주군,080004, 78세,2021,519,214,305,70.2,519,214,305,70.2
37380, 성주군,080005, 79세,2021,568,233,335,69.6,568,233,335,69.6
37380, 성주군,085,80~84세,2021,2074,793,1281,61.9,2073,792,1281,61.8
37380, 성주군,085001, 80세,2021,465,197,268,73.5,465,197,268,73.5
37380, 성주군,085002, 81세,2021,451,172,279,61.6,451,172,279,61.6
37380, 성주군,085003, 82세,2021,454,169,285,59.3,454,169,285,59.3
37380, 성주군,085004, 83세,2021,380,140,240,58.3,380,140,240,58.3
37380, 성주군,085005, 84세,2021,324,115,209,55,323,114,209,54.5
37380, 성주군,090,85~89세,2021,1354,349,1005,34.7,1354,349,1005,34.7
37380, 성주군,090001, 85세,2021,349,86,263,32.7,349,86,263,32.7
37380, 성주군,090002, 86세,2021,321,81,240,33.8,321,81,240,33.8
37380, 성주군,090003, 87세,2021,267,74,193,38.3,267,74,193,38.3
37380, 성주군,090004, 88세,2021,225,60,165,36.4,225,60,165,36.4
37380, 성주군,090005, 89세,2021,192,48,144,33.3,192,48,144,33.3
37380, 성주군,095,90~94세,2021,419,92,327,28.1,419,92,327,28.1
37380, 성주군,095001, 90세,2021,105,24,81,29.6,105,24,81,29.6
37380, 성주군,095002, 91세,2021,122,22,100,22,122,22,100,22
37380, 성주군,095003, 92세,2021,65,18,47,38.3,65,18,47,38.3
37380, 성주군,095004, 93세,2021,79,17,62,27.4,79,17,62,27.4
37380, 성주군,095005, 94세,2021,48,11,37,29.7,48,11,37,29.7
37380, 성주군,100,95~99세,2021,94,13,81,16,94,13,81,16
37380, 성주군,100001, 95세,2021,36,X,34,5.9,36,X,34,5.9
37380, 성주군,100002, 96세,2021,21,X,17,23.5,21,X,17,23.5
37380, 성주군,100003, 97세,2021,20,X,18,11.1,20,X,18,11.1
37380, 성주군,100004, 98세,2021,10,X,7,42.9,10,X,7,42.9
37380, 성주군,100005, 99세,2021,7,X,5,40,7,X,5,40
37380, 성주군,101,100세이상,2021,13,X,12,8.3,13,X,12,8.3
37380, 성주군,102,15세미만,2021,2732,1406,1326,106,2711,1391,1320,105.4
37380, 성주군,103,15~64세,2021,24494,13915,10579,131.5,22569,12476,10093,123.6
37380, 성주군,104,65세이상,2021,13578,5873,7705,76.2,13550,5862,7688,76.2
37380, 성주군,086,85세이상,2021,1880,455,1425,31.9,1880,455,1425,31.9
37380, 성주군,126,평균연령,2021,53.6,51,56.4,,54.5,52.2,56.9,
37380, 성주군,127,중위연령,2021,57.9,55.1,60.5,,59,56.7,60.9,
37390, 칠곡군,000,합계,2021,114564,59705,54859,108.8,110002,56770,53232,106.6
37390, 칠곡군,005,0~4세,2021,3333,1692,1641,103.1,3254,1656,1598,103.6
37390, 칠곡군,005001, 0세,2021,481,246,235,104.7,465,241,224,107.6
37390, 칠곡군,005002, 1세,2021,506,252,254,99.2,493,246,247,99.6
37390, 칠곡군,005003, 2세,2021,661,324,337,96.1,643,314,329,95.4
37390, 칠곡군,005004, 3세,2021,809,421,388,108.5,794,414,380,108.9
37390, 칠곡군,005005, 4세,2021,876,449,427,105.2,859,441,418,105.5
37390, 칠곡군,010,5~9세,2021,5546,2901,2645,109.7,5483,2869,2614,109.8
37390, 칠곡군,010001, 5세,2021,1078,538,540,99.6,1061,531,530,100.2
37390, 칠곡군,010002, 6세,2021,1104,581,523,111.1,1082,570,512,111.3
37390, 칠곡군,010003, 7세,2021,1028,546,482,113.3,1017,539,478,112.8
37390, 칠곡군,010004, 8세,2021,1131,594,537,110.6,1125,591,534,110.7
37390, 칠곡군,010005, 9세,2021,1205,642,563,114,1198,638,560,113.9
37390, 칠곡군,015,10~14세,2021,5731,2919,2812,103.8,5697,2903,2794,103.9
37390, 칠곡군,015001, 10세,2021,1180,576,604,95.4,1173,575,598,96.2
37390, 칠곡군,015002, 11세,2021,1148,588,560,105,1141,584,557,104.8
37390, 칠곡군,015003, 12세,2021,1072,560,512,109.4,1063,554,509,108.8
37390, 칠곡군,015004, 13세,2021,1146,600,546,109.9,1142,598,544,109.9
37390, 칠곡군,015005, 14세,2021,1185,595,590,100.8,1178,592,586,101
37390, 칠곡군,020,15~19세,2021,5166,2844,2322,122.5,5116,2813,2303,122.1
37390, 칠곡군,020001, 15세,2021,1062,574,488,117.6,1058,571,487,117.2
37390, 칠곡군,020002, 16세,2021,1069,586,483,121.3,1065,584,481,121.4
37390, 칠곡군,020003, 17세,2021,1032,555,477,116.4,1027,553,474,116.7
37390, 칠곡군,020004, 18세,2021,1048,543,505,107.5,1026,531,495,107.3
37390, 칠곡군,020005, 19세,2021,955,586,369,158.8,940,574,366,156.8
37390, 칠곡군,025,20~24세,2021,5895,3599,2296,156.8,5535,3357,2178,154.1
37390, 칠곡군,025001, 20세,2021,1179,742,437,169.8,1145,722,423,170.7
37390, 칠곡군,025002, 21세,2021,1296,786,510,154.1,1251,761,490,155.3
37390, 칠곡군,025003, 22세,2021,1149,703,446,157.6,1093,667,426,156.6
37390, 칠곡군,025004, 23세,2021,1087,647,440,147,1004,592,412,143.7
37390, 칠곡군,025005, 24세,2021,1184,721,463,155.7,1042,615,427,144
37390, 칠곡군,030,25~29세,2021,6361,3658,2703,135.3,5507,3070,2437,126
37390, 칠곡군,030001, 25세,2021,1216,732,484,151.2,1077,636,441,144.2
37390, 칠곡군,030002, 26세,2021,1237,729,508,143.5,1060,601,459,130.9
37390, 칠곡군,030003, 27세,2021,1234,680,554,122.7,1070,569,501,113.6
37390, 칠곡군,030004, 28세,2021,1302,745,557,133.8,1118,626,492,127.2
37390, 칠곡군,030005, 29세,2021,1372,772,600,128.7,1182,638,544,117.3
37390, 칠곡군,035,30~34세,2021,6755,3845,2910,132.1,5803,3193,2610,122.3
37390, 칠곡군,035001, 30세,2021,1293,749,544,137.7,1112,622,490,126.9
37390, 칠곡군,035002, 31세,2021,1265,713,552,129.2,1063,579,484,119.6
37390, 칠곡군,035003, 32세,2021,1282,761,521,146.1,1098,642,456,140.8
37390, 칠곡군,035004, 33세,2021,1419,785,634,123.8,1232,656,576,113.9
37390, 칠곡군,035005, 34세,2021,1496,837,659,127,1298,694,604,114.9
37390, 칠곡군,040,35~39세,2021,8603,4668,3935,118.6,7796,4157,3639,114.2
37390, 칠곡군,040001, 35세,2021,1525,835,690,121,1361,728,633,115
37390, 칠곡군,040002, 36세,2021,1569,877,692,126.7,1385,766,619,123.7
37390, 칠곡군,040003, 37세,2021,1600,862,738,116.8,1439,764,675,113.2
37390, 칠곡군,040004, 38세,2021,1807,997,810,123.1,1666,900,766,117.5
37390, 칠곡군,040005, 39세,2021,2102,1097,1005,109.2,1945,999,946,105.6
37390, 칠곡군,045,40~44세,2021,10088,5400,4688,115.2,9600,5062,4538,111.5
37390, 칠곡군,045001, 40세,2021,2074,1126,948,118.8,1969,1057,912,115.9
37390, 칠곡군,045002, 41세,2021,2165,1194,971,123,2055,1120,935,119.8
37390, 칠곡군,045003, 42세,2021,2001,1075,926,116.1,1902,996,906,109.9
37390, 칠곡군,045004, 43세,2021,1906,1009,897,112.5,1814,943,871,108.3
37390, 칠곡군,045005, 44세,2021,1942,996,946,105.3,1860,946,914,103.5
37390, 칠곡군,050,45~49세,2021,10491,5610,4881,114.9,10177,5414,4763,113.7
37390, 칠곡군,050001, 45세,2021,1879,994,885,112.3,1808,950,858,110.7
37390, 칠곡군,050002, 46세,2021,2127,1113,1014,109.8,2050,1073,977,109.8
37390, 칠곡군,050003, 47세,2021,2183,1186,997,119,2118,1146,972,117.9
37390, 칠곡군,050004, 48세,2021,2155,1147,1008,113.8,2106,1111,995,111.7
37390, 칠곡군,050005, 49세,2021,2147,1170,977,119.8,2095,1134,961,118
37390, 칠곡군,055,50~54세,2021,10436,5484,4952,110.7,10208,5360,4848,110.6
37390, 칠곡군,055001, 50세,2021,2147,1173,974,120.4,2081,1140,941,121.1
37390, 칠곡군,055002, 51세,2021,2163,1151,1012,113.7,2114,1124,990,113.5
37390, 칠곡군,055003, 52세,2021,2105,1086,1019,106.6,2066,1063,1003,106
37390, 칠곡군,055004, 53세,2021,2106,1094,1012,108.1,2072,1073,999,107.4
37390, 칠곡군,055005, 54세,2021,1915,980,935,104.8,1875,960,915,104.9
37390, 칠곡군,060,55~59세,2021,9116,4898,4218,116.1,8963,4816,4147,116.1
37390, 칠곡군,060001, 55세,2021,1934,1046,888,117.8,1898,1028,870,118.2
37390, 칠곡군,060002, 56세,2021,1916,1011,905,111.7,1879,988,891,110.9
37390, 칠곡군,060003, 57세,2021,1722,943,779,121.1,1689,926,763,121.4
37390, 칠곡군,060004, 58세,2021,1703,909,794,114.5,1677,896,781,114.7
37390, 칠곡군,060005, 59세,2021,1841,989,852,116.1,1820,978,842,116.2
37390, 칠곡군,065,60~64세,2021,8378,4402,3976,110.7,8286,4361,3925,111.1
37390, 칠곡군,065001, 60세,2021,1946,1032,914,112.9,1928,1019,909,112.1
37390, 칠곡군,065002, 61세,2021,1857,974,883,110.3,1835,969,866,111.9
37390, 칠곡군,065003, 62세,2021,1619,822,797,103.1,1598,812,786,103.3
37390, 칠곡군,065004, 63세,2021,1443,789,654,120.6,1429,784,645,121.6
37390, 칠곡군,065005, 64세,2021,1513,785,728,107.8,1496,777,719,108.1
37390, 칠곡군,070,65~69세,2021,5887,2852,3035,94,5838,2827,3011,93.9
37390, 칠곡군,070001, 65세,2021,1349,666,683,97.5,1335,658,677,97.2
37390, 칠곡군,070002, 66세,2021,1290,616,674,91.4,1281,612,669,91.5
37390, 칠곡군,070003, 67세,2021,1138,549,589,93.2,1125,542,583,93
37390, 칠곡군,070004, 68세,2021,982,470,512,91.8,977,468,509,91.9
37390, 칠곡군,070005, 69세,2021,1128,551,577,95.5,1120,547,573,95.5
37390, 칠곡군,075,70~74세,2021,4219,2038,2181,93.4,4190,2021,2169,93.2
37390, 칠곡군,075001, 70세,2021,797,399,398,100.3,787,391,396,98.7
37390, 칠곡군,075002, 71세,2021,832,424,408,103.9,827,423,404,104.7
37390, 칠곡군,075003, 72세,2021,926,430,496,86.7,921,428,493,86.8
37390, 칠곡군,075004, 73세,2021,868,421,447,94.2,860,415,445,93.3
37390, 칠곡군,075005, 74세,2021,796,364,432,84.3,795,364,431,84.5
37390, 칠곡군,080,75~79세,2021,3314,1259,2055,61.3,3309,1257,2052,61.3
37390, 칠곡군,080001, 75세,2021,550,231,319,72.4,547,230,317,72.6
37390, 칠곡군,080002, 76세,2021,587,225,362,62.2,587,225,362,62.2
37390, 칠곡군,080003, 77세,2021,612,241,371,65,611,240,371,64.7
37390, 칠곡군,080004, 78세,2021,728,258,470,54.9,727,258,469,55
37390, 칠곡군,080005, 79세,2021,837,304,533,57,837,304,533,57
37390, 칠곡군,085,80~84세,2021,2887,975,1912,51,2882,973,1909,51
37390, 칠곡군,085001, 80세,2021,628,227,401,56.6,626,226,400,56.5
37390, 칠곡군,085002, 81세,2021,608,220,388,56.7,608,220,388,56.7
37390, 칠곡군,085003, 82세,2021,653,209,444,47.1,652,209,443,47.2
37390, 칠곡군,085004, 83세,2021,510,163,347,47,510,163,347,47
37390, 칠곡군,085005, 84세,2021,488,156,332,47,486,155,331,46.8
37390, 칠곡군,090,85~89세,2021,1679,498,1181,42.2,1679,498,1181,42.2
37390, 칠곡군,090001, 85세,2021,436,135,301,44.9,436,135,301,44.9
37390, 칠곡군,090002, 86세,2021,417,128,289,44.3,417,128,289,44.3
37390, 칠곡군,090003, 87세,2021,321,106,215,49.3,321,106,215,49.3
37390, 칠곡군,090004, 88세,2021,277,75,202,37.1,277,75,202,37.1
37390, 칠곡군,090005, 89세,2021,228,54,174,31,228,54,174,31
37390, 칠곡군,095,90~94세,2021,549,142,407,34.9,549,142,407,34.9
37390, 칠곡군,095001, 90세,2021,159,53,106,50,159,53,106,50
37390, 칠곡군,095002, 91세,2021,127,28,99,28.3,127,28,99,28.3
37390, 칠곡군,095003, 92세,2021,114,29,85,34.1,114,29,85,34.1
37390, 칠곡군,095004, 93세,2021,86,17,69,24.6,86,17,69,24.6
37390, 칠곡군,095005, 94세,2021,63,15,48,31.3,63,15,48,31.3
37390, 칠곡군,100,95~99세,2021,117,20,97,20.6,117,20,97,20.6
37390, 칠곡군,100001, 95세,2021,34,6,28,21.4,34,6,28,21.4
37390, 칠곡군,100002, 96세,2021,32,8,24,33.3,32,8,24,33.3
37390, 칠곡군,100003, 97세,2021,20,5,15,33.3,20,5,15,33.3
37390, 칠곡군,100004, 98세,2021,20,X,19,5.3,20,X,19,5.3
37390, 칠곡군,100005, 99세,2021,11,X,11,0,11,X,11,0
37390, 칠곡군,101,100세이상,2021,13,X,12,8.3,13,X,12,8.3
37390, 칠곡군,102,15세미만,2021,14610,7512,7098,105.8,14434,7428,7006,106
37390, 칠곡군,103,15~64세,2021,81289,44408,36881,120.4,76991,41603,35388,117.6
37390, 칠곡군,104,65세이상,2021,18665,7785,10880,71.6,18577,7739,10838,71.4
37390, 칠곡군,086,85세이상,2021,2358,661,1697,39,2358,661,1697,39
37390, 칠곡군,126,평균연령,2021,43.6,42.1,45.2,,43.9,42.4,45.5,
37390, 칠곡군,127,중위연령,2021,44.9,43.3,46.6,,45.7,44.3,47.1,
37400, 예천군,000,합계,2021,54267,26493,27774,95.4,53546,26211,27335,95.9
37400, 예천군,005,0~4세,2021,1882,935,947,98.7,1878,933,945,98.7
37400, 예천군,005001, 0세,2021,303,138,165,83.6,303,138,165,83.6
37400, 예천군,005002, 1세,2021,355,191,164,116.5,355,191,164,116.5
37400, 예천군,005003, 2세,2021,401,200,201,99.5,400,200,200,100
37400, 예천군,005004, 3세,2021,397,197,200,98.5,397,197,200,98.5
37400, 예천군,005005, 4세,2021,426,209,217,96.3,423,207,216,95.8
37400, 예천군,010,5~9세,2021,2556,1321,1235,107,2553,1320,1233,107.1
37400, 예천군,010001, 5세,2021,493,224,269,83.3,492,223,269,82.9
37400, 예천군,010002, 6세,2021,520,275,245,112.2,520,275,245,112.2
37400, 예천군,010003, 7세,2021,456,242,214,113.1,455,242,213,113.6
37400, 예천군,010004, 8세,2021,545,277,268,103.4,545,277,268,103.4
37400, 예천군,010005, 9세,2021,542,303,239,126.8,541,303,238,127.3
37400, 예천군,015,10~14세,2021,2416,1239,1177,105.3,2411,1237,1174,105.4
37400, 예천군,015001, 10세,2021,531,258,273,94.5,531,258,273,94.5
37400, 예천군,015002, 11세,2021,453,229,224,102.2,450,229,221,103.6
37400, 예천군,015003, 12세,2021,522,271,251,108,521,270,251,107.6
37400, 예천군,015004, 13세,2021,470,252,218,115.6,469,251,218,115.1
37400, 예천군,015005, 14세,2021,440,229,211,108.5,440,229,211,108.5
37400, 예천군,020,15~19세,2021,1821,939,882,106.5,1813,937,876,107
37400, 예천군,020001, 15세,2021,414,227,187,121.4,413,227,186,122
37400, 예천군,020002, 16세,2021,387,200,187,107,385,199,186,107
37400, 예천군,020003, 17세,2021,371,157,214,73.4,371,157,214,73.4
37400, 예천군,020004, 18세,2021,354,181,173,104.6,354,181,173,104.6
37400, 예천군,020005, 19세,2021,295,174,121,143.8,290,173,117,147.9
37400, 예천군,025,20~24세,2021,1720,1029,691,148.9,1685,1014,671,151.1
37400, 예천군,025001, 20세,2021,385,235,150,156.7,383,235,148,158.8
37400, 예천군,025002, 21세,2021,393,251,142,176.8,386,250,136,183.8
37400, 예천군,025003, 22세,2021,307,190,117,162.4,300,188,112,167.9
37400, 예천군,025004, 23세,2021,309,188,121,155.4,299,179,120,149.2
37400, 예천군,025005, 24세,2021,326,165,161,102.5,317,162,155,104.5
37400, 예천군,030,25~29세,2021,2007,1102,905,121.8,1877,1040,837,124.3
37400, 예천군,030001, 25세,2021,348,196,152,128.9,328,186,142,131
37400, 예천군,030002, 26세,2021,377,225,152,148,352,213,139,153.2
37400, 예천군,030003, 27세,2021,404,220,184,119.6,378,207,171,121.1
37400, 예천군,030004, 28세,2021,451,238,213,111.7,424,224,200,112
37400, 예천군,030005, 29세,2021,427,223,204,109.3,395,210,185,113.5
37400, 예천군,035,30~34세,2021,2405,1222,1183,103.3,2244,1153,1091,105.7
37400, 예천군,035001, 30세,2021,440,228,212,107.5,405,213,192,110.9
37400, 예천군,035002, 31세,2021,439,243,196,124,399,224,175,128
37400, 예천군,035003, 32세,2021,502,244,258,94.6,471,231,240,96.3
37400, 예천군,035004, 33세,2021,486,241,245,98.4,459,231,228,101.3
37400, 예천군,035005, 34세,2021,538,266,272,97.8,510,254,256,99.2
37400, 예천군,040,35~39세,2021,2975,1456,1519,95.9,2883,1423,1460,97.5
37400, 예천군,040001, 35세,2021,527,277,250,110.8,512,271,241,112.4
37400, 예천군,040002, 36세,2021,503,263,240,109.6,483,254,229,110.9
37400, 예천군,040003, 37세,2021,606,295,311,94.9,586,288,298,96.6
37400, 예천군,040004, 38세,2021,608,292,316,92.4,585,285,300,95
37400, 예천군,040005, 39세,2021,731,329,402,81.8,717,325,392,82.9
37400, 예천군,045,40~44세,2021,3592,1820,1772,102.7,3506,1794,1712,104.8
37400, 예천군,045001, 40세,2021,735,354,381,92.9,713,348,365,95.3
37400, 예천군,045002, 41세,2021,772,389,383,101.6,745,380,365,104.1
37400, 예천군,045003, 42세,2021,754,385,369,104.3,741,381,360,105.8
37400, 예천군,045004, 43세,2021,668,365,303,120.5,655,361,294,122.8
37400, 예천군,045005, 44세,2021,663,327,336,97.3,652,324,328,98.8
37400, 예천군,050,45~49세,2021,3480,1924,1556,123.7,3429,1911,1518,125.9
37400, 예천군,050001, 45세,2021,689,373,316,118,674,369,305,121
37400, 예천군,050002, 46세,2021,688,353,335,105.4,681,349,332,105.1
37400, 예천군,050003, 47세,2021,720,386,334,115.6,712,385,327,117.7
37400, 예천군,050004, 48세,2021,699,400,299,133.8,689,399,290,137.6
37400, 예천군,050005, 49세,2021,684,412,272,151.5,673,409,264,154.9
37400, 예천군,055,50~54세,2021,3642,1953,1689,115.6,3594,1939,1655,117.2
37400, 예천군,055001, 50세,2021,689,395,294,134.4,687,394,293,134.5
37400, 예천군,055002, 51세,2021,746,388,358,108.4,735,387,348,111.2
37400, 예천군,055003, 52세,2021,722,389,333,116.8,713,385,328,117.4
37400, 예천군,055004, 53세,2021,769,397,372,106.7,757,394,363,108.5
37400, 예천군,055005, 54세,2021,716,384,332,115.7,702,379,323,117.3
37400, 예천군,060,55~59세,2021,4040,2030,2010,101,3994,2011,1983,101.4
37400, 예천군,060001, 55세,2021,749,390,359,108.6,739,387,352,109.9
37400, 예천군,060002, 56세,2021,794,389,405,96,785,386,399,96.7
37400, 예천군,060003, 57세,2021,789,415,374,111,782,413,369,111.9
37400, 예천군,060004, 58세,2021,823,409,414,98.8,812,401,411,97.6
37400, 예천군,060005, 59세,2021,885,427,458,93.2,876,424,452,93.8
37400, 예천군,065,60~64세,2021,5005,2537,2468,102.8,4980,2523,2457,102.7
37400, 예천군,065001, 60세,2021,1022,527,495,106.5,1014,522,492,106.1
37400, 예천군,065002, 61세,2021,1093,551,542,101.7,1086,546,540,101.1
37400, 예천군,065003, 62세,2021,897,451,446,101.1,895,450,445,101.1
37400, 예천군,065004, 63세,2021,983,516,467,110.5,980,516,464,111.2
37400, 예천군,065005, 64세,2021,1010,492,518,95,1005,489,516,94.8
37400, 예천군,070,65~69세,2021,4490,2207,2283,96.7,4475,2200,2275,96.7
37400, 예천군,070001, 65세,2021,940,488,452,108,934,485,449,108
37400, 예천군,070002, 66세,2021,964,435,529,82.2,962,435,527,82.5
37400, 예천군,070003, 67세,2021,878,436,442,98.6,875,434,441,98.4
37400, 예천군,070004, 68세,2021,831,420,411,102.2,828,418,410,102
37400, 예천군,070005, 69세,2021,877,428,449,95.3,876,428,448,95.5
37400, 예천군,075,70~74세,2021,3572,1668,1904,87.6,3567,1668,1899,87.8
37400, 예천군,075001, 70세,2021,648,296,352,84.1,647,296,351,84.3
37400, 예천군,075002, 71세,2021,732,321,411,78.1,731,321,410,78.3
37400, 예천군,075003, 72세,2021,731,340,391,87,730,340,390,87.2
37400, 예천군,075004, 73세,2021,729,359,370,97,728,359,369,97.3
37400, 예천군,075005, 74세,2021,732,352,380,92.6,731,352,379,92.9
37400, 예천군,080,75~79세,2021,3059,1299,1760,73.8,3058,1299,1759,73.8
37400, 예천군,080001, 75세,2021,392,179,213,84,392,179,213,84
37400, 예천군,080002, 76세,2021,480,215,265,81.1,480,215,265,81.1
37400, 예천군,080003, 77세,2021,611,258,353,73.1,611,258,353,73.1
37400, 예천군,080004, 78세,2021,696,284,412,68.9,695,284,411,69.1
37400, 예천군,080005, 79세,2021,880,363,517,70.2,880,363,517,70.2
37400, 예천군,085,80~84세,2021,3057,1128,1929,58.5,3053,1126,1927,58.4
37400, 예천군,085001, 80세,2021,618,237,381,62.2,618,237,381,62.2
37400, 예천군,085002, 81세,2021,632,241,391,61.6,631,241,390,61.8
37400, 예천군,085003, 82세,2021,673,233,440,53,671,232,439,52.8
37400, 예천군,085004, 83세,2021,600,225,375,60,599,224,375,59.7
37400, 예천군,085005, 84세,2021,534,192,342,56.1,534,192,342,56.1
37400, 예천군,090,85~89세,2021,1876,563,1313,42.9,1874,562,1312,42.8
37400, 예천군,090001, 85세,2021,479,145,334,43.4,478,145,333,43.5
37400, 예천군,090002, 86세,2021,504,159,345,46.1,504,159,345,46.1
37400, 예천군,090003, 87세,2021,399,115,284,40.5,398,114,284,40.1
37400, 예천군,090004, 88세,2021,264,72,192,37.5,264,72,192,37.5
37400, 예천군,090005, 89세,2021,230,72,158,45.6,230,72,158,45.6
37400, 예천군,095,90~94세,2021,542,100,442,22.6,542,100,442,22.6
37400, 예천군,095001, 90세,2021,144,38,106,35.8,144,38,106,35.8
37400, 예천군,095002, 91세,2021,140,19,121,15.7,140,19,121,15.7
37400, 예천군,095003, 92세,2021,108,14,94,14.9,108,14,94,14.9
37400, 예천군,095004, 93세,2021,73,12,61,19.7,73,12,61,19.7
37400, 예천군,095005, 94세,2021,77,17,60,28.3,77,17,60,28.3
37400, 예천군,100,95~99세,2021,109,20,89,22.5,109,20,89,22.5
37400, 예천군,100001, 95세,2021,35,X,31,12.9,35,X,31,12.9
37400, 예천군,100002, 96세,2021,31,9,22,40.9,31,9,22,40.9
37400, 예천군,100003, 97세,2021,18,X,15,20,18,X,15,20
37400, 예천군,100004, 98세,2021,16,X,12,33.3,16,X,12,33.3
37400, 예천군,100005, 99세,2021,9,X,9,0,9,X,9,0
37400, 예천군,101,100세이상,2021,21,X,20,5,21,X,20,5
37400, 예천군,102,15세미만,2021,6854,3495,3359,104,6842,3490,3352,104.1
37400, 예천군,103,15~64세,2021,30687,16012,14675,109.1,30005,15745,14260,110.4
37400, 예천군,104,65세이상,2021,16726,6986,9740,71.7,16699,6976,9723,71.7
37400, 예천군,086,85세이상,2021,2548,684,1864,36.7,2546,683,1863,36.7
37400, 예천군,126,평균연령,2021,49.8,47.7,51.8,,50,47.8,52,
37400, 예천군,127,중위연령,2021,53.2,50.7,55.9,,53.5,50.9,56.4,
37410, 봉화군,000,합계,2021,29168,14479,14689,98.6,28701,14327,14374,99.7
37410, 봉화군,005,0~4세,2021,507,252,255,98.8,505,251,254,98.8
37410, 봉화군,005001, 0세,2021,72,40,32,125,71,39,32,121.9
37410, 봉화군,005002, 1세,2021,86,32,54,59.3,86,32,54,59.3
37410, 봉화군,005003, 2세,2021,115,64,51,125.5,114,64,50,128
37410, 봉화군,005004, 3세,2021,103,52,51,102,103,52,51,102
37410, 봉화군,005005, 4세,2021,131,64,67,95.5,131,64,67,95.5
37410, 봉화군,010,5~9세,2021,686,367,319,115,685,367,318,115.4
37410, 봉화군,010001, 5세,2021,127,71,56,126.8,127,71,56,126.8
37410, 봉화군,010002, 6세,2021,125,71,54,131.5,124,71,53,134
37410, 봉화군,010003, 7세,2021,126,67,59,113.6,126,67,59,113.6
37410, 봉화군,010004, 8세,2021,147,71,76,93.4,147,71,76,93.4
37410, 봉화군,010005, 9세,2021,161,87,74,117.6,161,87,74,117.6
37410, 봉화군,015,10~14세,2021,817,421,396,106.3,816,420,396,106.1
37410, 봉화군,015001, 10세,2021,185,92,93,98.9,185,92,93,98.9
37410, 봉화군,015002, 11세,2021,149,78,71,109.9,149,78,71,109.9
37410, 봉화군,015003, 12세,2021,153,97,56,173.2,152,96,56,171.4
37410, 봉화군,015004, 13세,2021,155,83,72,115.3,155,83,72,115.3
37410, 봉화군,015005, 14세,2021,175,71,104,68.3,175,71,104,68.3
37410, 봉화군,020,15~19세,2021,852,439,413,106.3,849,439,410,107.1
37410, 봉화군,020001, 15세,2021,178,91,87,104.6,177,91,86,105.8
37410, 봉화군,020002, 16세,2021,172,82,90,91.1,172,82,90,91.1
37410, 봉화군,020003, 17세,2021,214,94,120,78.3,214,94,120,78.3
37410, 봉화군,020004, 18세,2021,174,92,82,112.2,173,92,81,113.6
37410, 봉화군,020005, 19세,2021,114,80,34,235.3,113,80,33,242.4
37410, 봉화군,025,20~24세,2021,669,424,245,173.1,638,416,222,187.4
37410, 봉화군,025001, 20세,2021,128,93,35,265.7,128,93,35,265.7
37410, 봉화군,025002, 21세,2021,166,116,50,232,158,114,44,259.1
37410, 봉화군,025003, 22세,2021,123,74,49,151,119,74,45,164.4
37410, 봉화군,025004, 23세,2021,106,60,46,130.4,99,58,41,141.5
37410, 봉화군,025005, 24세,2021,146,81,65,124.6,134,77,57,135.1
37410, 봉화군,030,25~29세,2021,812,460,352,130.7,732,431,301,143.2
37410, 봉화군,030001, 25세,2021,161,84,77,109.1,150,80,70,114.3
37410, 봉화군,030002, 26세,2021,162,90,72,125,149,87,62,140.3
37410, 봉화군,030003, 27세,2021,172,94,78,120.5,155,89,66,134.8
37410, 봉화군,030004, 28세,2021,165,101,64,157.8,145,93,52,178.8
37410, 봉화군,030005, 29세,2021,152,91,61,149.2,133,82,51,160.8
37410, 봉화군,035,30~34세,2021,765,430,335,128.4,686,402,284,141.5
37410, 봉화군,035001, 30세,2021,136,75,61,123,118,66,52,126.9
37410, 봉화군,035002, 31세,2021,161,94,67,140.3,147,90,57,157.9
37410, 봉화군,035003, 32세,2021,161,89,72,123.6,142,83,59,140.7
37410, 봉화군,035004, 33세,2021,152,85,67,126.9,138,81,57,142.1
37410, 봉화군,035005, 34세,2021,155,87,68,127.9,141,82,59,139
37410, 봉화군,040,35~39세,2021,974,488,486,100.4,909,473,436,108.5
37410, 봉화군,040001, 35세,2021,169,85,84,101.2,163,84,79,106.3
37410, 봉화군,040002, 36세,2021,158,83,75,110.7,140,81,59,137.3
37410, 봉화군,040003, 37세,2021,196,106,90,117.8,179,99,80,123.8
37410, 봉화군,040004, 38세,2021,215,105,110,95.5,207,102,105,97.1
37410, 봉화군,040005, 39세,2021,236,109,127,85.8,220,107,113,94.7
37410, 봉화군,045,40~44세,2021,1220,682,538,126.8,1184,673,511,131.7
37410, 봉화군,045001, 40세,2021,225,122,103,118.4,217,121,96,126
37410, 봉화군,045002, 41세,2021,269,149,120,124.2,261,145,116,125
37410, 봉화군,045003, 42세,2021,255,147,108,136.1,245,146,99,147.5
37410, 봉화군,045004, 43세,2021,228,134,94,142.6,223,133,90,147.8
37410, 봉화군,045005, 44세,2021,243,130,113,115,238,128,110,116.4
37410, 봉화군,050,45~49세,2021,1644,962,682,141.1,1609,946,663,142.7
37410, 봉화군,050001, 45세,2021,276,167,109,153.2,266,163,103,158.3
37410, 봉화군,050002, 46세,2021,314,189,125,151.2,307,185,122,151.6
37410, 봉화군,050003, 47세,2021,356,208,148,140.5,350,206,144,143.1
37410, 봉화군,050004, 48세,2021,346,185,161,114.9,340,183,157,116.6
37410, 봉화군,050005, 49세,2021,352,213,139,153.2,346,209,137,152.6
37410, 봉화군,055,50~54세,2021,2263,1212,1051,115.3,2220,1202,1018,118.1
37410, 봉화군,055001, 50세,2021,401,235,166,141.6,392,232,160,145
37410, 봉화군,055002, 51세,2021,394,210,184,114.1,389,209,180,116.1
37410, 봉화군,055003, 52세,2021,467,241,226,106.6,454,238,216,110.2
37410, 봉화군,055004, 53세,2021,504,258,246,104.9,496,256,240,106.7
37410, 봉화군,055005, 54세,2021,497,268,229,117,489,267,222,120.3
37410, 봉화군,060,55~59세,2021,2983,1578,1405,112.3,2941,1561,1380,113.1
37410, 봉화군,060001, 55세,2021,540,297,243,122.2,531,295,236,125
37410, 봉화군,060002, 56세,2021,568,290,278,104.3,555,285,270,105.6
37410, 봉화군,060003, 57세,2021,528,282,246,114.6,522,278,244,113.9
37410, 봉화군,060004, 58세,2021,619,306,313,97.8,612,303,309,98.1
37410, 봉화군,060005, 59세,2021,728,403,325,124,721,400,321,124.6
37410, 봉화군,065,60~64세,2021,3679,1887,1792,105.3,3651,1879,1772,106
37410, 봉화군,065001, 60세,2021,749,408,341,119.6,742,407,335,121.5
37410, 봉화군,065002, 61세,2021,852,409,443,92.3,845,406,439,92.5
37410, 봉화군,065003, 62세,2021,681,328,353,92.9,674,326,348,93.7
37410, 봉화군,065004, 63세,2021,702,378,324,116.7,699,376,323,116.4
37410, 봉화군,065005, 64세,2021,695,364,331,110,691,364,327,111.3
37410, 봉화군,070,65~69세,2021,3105,1612,1493,108,3093,1607,1486,108.1
37410, 봉화군,070001, 65세,2021,644,362,282,128.4,642,362,280,129.3
37410, 봉화군,070002, 66세,2021,711,366,345,106.1,709,365,344,106.1
37410, 봉화군,070003, 67세,2021,628,326,302,107.9,624,324,300,108
37410, 봉화군,070004, 68세,2021,527,263,264,99.6,524,262,262,100
37410, 봉화군,070005, 69세,2021,595,295,300,98.3,594,294,300,98
37410, 봉화군,075,70~74세,2021,2461,1192,1269,93.9,2454,1189,1265,94
37410, 봉화군,075001, 70세,2021,474,238,236,100.8,473,238,235,101.3
37410, 봉화군,075002, 71세,2021,464,219,245,89.4,463,219,244,89.8
37410, 봉화군,075003, 72세,2021,501,257,244,105.3,501,257,244,105.3
37410, 봉화군,075004, 73세,2021,514,248,266,93.2,510,246,264,93.2
37410, 봉화군,075005, 74세,2021,508,230,278,82.7,507,229,278,82.4
37410, 봉화군,080,75~79세,2021,2052,841,1211,69.4,2052,841,1211,69.4
37410, 봉화군,080001, 75세,2021,266,137,129,106.2,266,137,129,106.2
37410, 봉화군,080002, 76세,2021,352,138,214,64.5,352,138,214,64.5
37410, 봉화군,080003, 77세,2021,439,184,255,72.2,439,184,255,72.2
37410, 봉화군,080004, 78세,2021,488,178,310,57.4,488,178,310,57.4
37410, 봉화군,080005, 79세,2021,507,204,303,67.3,507,204,303,67.3
37410, 봉화군,085,80~84세,2021,2001,731,1270,57.6,2000,730,1270,57.5
37410, 봉화군,085001, 80세,2021,436,168,268,62.7,436,168,268,62.7
37410, 봉화군,085002, 81세,2021,462,180,282,63.8,461,179,282,63.5
37410, 봉화군,085003, 82세,2021,405,162,243,66.7,405,162,243,66.7
37410, 봉화군,085004, 83세,2021,379,118,261,45.2,379,118,261,45.2
37410, 봉화군,085005, 84세,2021,319,103,216,47.7,319,103,216,47.7
37410, 봉화군,090,85~89세,2021,1180,392,788,49.7,1179,391,788,49.6
37410, 봉화군,090001, 85세,2021,312,119,193,61.7,312,119,193,61.7
37410, 봉화군,090002, 86세,2021,306,89,217,41,306,89,217,41
37410, 봉화군,090003, 87세,2021,229,82,147,55.8,229,82,147,55.8
37410, 봉화군,090004, 88세,2021,178,55,123,44.7,178,55,123,44.7
37410, 봉화군,090005, 89세,2021,155,47,108,43.5,154,46,108,42.6
37410, 봉화군,095,90~94세,2021,387,98,289,33.9,387,98,289,33.9
37410, 봉화군,095001, 90세,2021,110,27,83,32.5,110,27,83,32.5
37410, 봉화군,095002, 91세,2021,108,33,75,44,108,33,75,44
37410, 봉화군,095003, 92세,2021,75,22,53,41.5,75,22,53,41.5
37410, 봉화군,095004, 93세,2021,54,10,44,22.7,54,10,44,22.7
37410, 봉화군,095005, 94세,2021,40,6,34,17.6,40,6,34,17.6
37410, 봉화군,100,95~99세,2021,97,10,87,11.5,97,10,87,11.5
37410, 봉화군,100001, 95세,2021,36,X,34,5.9,36,X,34,5.9
37410, 봉화군,100002, 96세,2021,32,X,30,6.7,32,X,30,6.7
37410, 봉화군,100003, 97세,2021,11,X,8,37.5,11,X,8,37.5
37410, 봉화군,100004, 98세,2021,12,X,10,20,12,X,10,20
37410, 봉화군,100005, 99세,2021,6,X,5,20,6,X,5,20
37410, 봉화군,101,100세이상,2021,14,X,13,7.7,14,X,13,7.7
37410, 봉화군,102,15세미만,2021,2010,1040,970,107.2,2006,1038,968,107.2
37410, 봉화군,103,15~64세,2021,15861,8562,7299,117.3,15419,8422,6997,120.4
37410, 봉화군,104,65세이상,2021,11297,4877,6420,76,11276,4867,6409,75.9
37410, 봉화군,086,85세이상,2021,1678,501,1177,42.6,1677,500,1177,42.5
37410, 봉화군,126,평균연령,2021,56.3,54.1,58.5,,56.6,54.2,58.9,
37410, 봉화군,127,중위연령,2021,60.5,58.8,62.2,,60.8,58.9,62.6,
37420, 울진군,000,합계,2021,46369,24041,22328,107.7,44540,22482,22058,101.9
37420, 울진군,005,0~4세,2021,1160,602,558,107.9,1159,602,557,108.1
37420, 울진군,005001, 0세,2021,196,98,98,100,195,98,97,101
37420, 울진군,005002, 1세,2021,218,115,103,111.7,218,115,103,111.7
37420, 울진군,005003, 2세,2021,260,131,129,101.6,260,131,129,101.6
37420, 울진군,005004, 3세,2021,249,145,104,139.4,249,145,104,139.4
37420, 울진군,005005, 4세,2021,237,113,124,91.1,237,113,124,91.1
37420, 울진군,010,5~9세,2021,1548,800,748,107,1546,799,747,107
37420, 울진군,010001, 5세,2021,298,140,158,88.6,297,140,157,89.2
37420, 울진군,010002, 6세,2021,302,166,136,122.1,302,166,136,122.1
37420, 울진군,010003, 7세,2021,309,146,163,89.6,308,145,163,89
37420, 울진군,010004, 8세,2021,304,153,151,101.3,304,153,151,101.3
37420, 울진군,010005, 9세,2021,335,195,140,139.3,335,195,140,139.3
37420, 울진군,015,10~14세,2021,1629,866,763,113.5,1627,865,762,113.5
37420, 울진군,015001, 10세,2021,318,159,159,100,318,159,159,100
37420, 울진군,015002, 11세,2021,300,160,140,114.3,299,159,140,113.6
37420, 울진군,015003, 12세,2021,294,151,143,105.6,293,151,142,106.3
37420, 울진군,015004, 13세,2021,349,189,160,118.1,349,189,160,118.1
37420, 울진군,015005, 14세,2021,368,207,161,128.6,368,207,161,128.6
37420, 울진군,020,15~19세,2021,1623,980,643,152.4,1620,977,643,151.9
37420, 울진군,020001, 15세,2021,322,184,138,133.3,322,184,138,133.3
37420, 울진군,020002, 16세,2021,342,177,165,107.3,342,177,165,107.3
37420, 울진군,020003, 17세,2021,417,265,152,174.3,415,263,152,173
37420, 울진군,020004, 18세,2021,347,209,138,151.4,347,209,138,151.4
37420, 울진군,020005, 19세,2021,195,145,50,290,194,144,50,288
37420, 울진군,025,20~24세,2021,1483,988,495,199.6,1376,904,472,191.5
37420, 울진군,025001, 20세,2021,244,191,53,360.4,239,188,51,368.6
37420, 울진군,025002, 21세,2021,270,214,56,382.1,259,206,53,388.7
37420, 울진군,025003, 22세,2021,263,162,101,160.4,254,155,99,156.6
37420, 울진군,025004, 23세,2021,345,200,145,137.9,309,166,143,116.1
37420, 울진군,025005, 24세,2021,361,221,140,157.9,315,189,126,150
37420, 울진군,030,25~29세,2021,2263,1486,777,191.2,1871,1136,735,154.6
37420, 울진군,030001, 25세,2021,413,265,148,179.1,361,216,145,149
37420, 울진군,030002, 26세,2021,442,315,127,248,359,239,120,199.2
37420, 울진군,030003, 27세,2021,466,300,166,180.7,395,236,159,148.4
37420, 울진군,030004, 28세,2021,456,294,162,181.5,373,223,150,148.7
37420, 울진군,030005, 29세,2021,486,312,174,179.3,383,222,161,137.9
37420, 울진군,035,30~34세,2021,2302,1461,841,173.7,1880,1078,802,134.4
37420, 울진군,035001, 30세,2021,473,302,171,176.6,390,228,162,140.7
37420, 울진군,035002, 31세,2021,476,309,167,185,380,221,159,139
37420, 울진군,035003, 32세,2021,442,295,147,200.7,355,215,140,153.6
37420, 울진군,035004, 33세,2021,438,264,174,151.7,370,205,165,124.2
37420, 울진군,035005, 34세,2021,473,291,182,159.9,385,209,176,118.8
37420, 울진군,040,35~39세,2021,2349,1363,986,138.2,1992,1044,948,110.1
37420, 울진군,040001, 35세,2021,426,267,159,167.9,346,195,151,129.1
37420, 울진군,040002, 36세,2021,407,255,152,167.8,331,187,144,129.9
37420, 울진군,040003, 37세,2021,427,245,182,134.6,353,181,172,105.2
37420, 울진군,040004, 38세,2021,521,296,225,131.6,455,234,221,105.9
37420, 울진군,040005, 39세,2021,568,300,268,111.9,507,247,260,95
37420, 울진군,045,40~44세,2021,2864,1587,1277,124.3,2629,1378,1251,110.2
37420, 울진군,045001, 40세,2021,562,316,246,128.5,499,261,238,109.7
37420, 울진군,045002, 41세,2021,586,314,272,115.4,531,264,267,98.9
37420, 울진군,045003, 42세,2021,573,330,243,135.8,523,284,239,118.8
37420, 울진군,045004, 43세,2021,550,312,238,131.1,510,276,234,117.9
37420, 울진군,045005, 44세,2021,593,315,278,113.3,566,293,273,107.3
37420, 울진군,050,45~49세,2021,3179,1821,1358,134.1,3052,1715,1337,128.3
37420, 울진군,050001, 45세,2021,542,321,221,145.2,509,291,218,133.5
37420, 울진군,050002, 46세,2021,625,355,270,131.5,597,330,267,123.6
37420, 울진군,050003, 47세,2021,634,345,289,119.4,606,324,282,114.9
37420, 울진군,050004, 48세,2021,731,431,300,143.7,712,415,297,139.7
37420, 울진군,050005, 49세,2021,647,369,278,132.7,628,355,273,130
37420, 울진군,055,50~54세,2021,3876,2142,1734,123.5,3774,2074,1700,122
37420, 울진군,055001, 50세,2021,797,450,347,129.7,770,427,343,124.5
37420, 울진군,055002, 51세,2021,763,429,334,128.4,744,419,325,128.9
37420, 울진군,055003, 52세,2021,788,418,370,113,765,399,366,109
37420, 울진군,055004, 53세,2021,774,426,348,122.4,755,416,339,122.7
37420, 울진군,055005, 54세,2021,754,419,335,125.1,740,413,327,126.3
37420, 울진군,060,55~59세,2021,4068,2208,1860,118.7,4034,2190,1844,118.8
37420, 울진군,060001, 55세,2021,790,452,338,133.7,781,447,334,133.8
37420, 울진군,060002, 56세,2021,808,440,368,119.6,802,436,366,119.1
37420, 울진군,060003, 57세,2021,759,432,327,132.1,751,429,322,133.2
37420, 울진군,060004, 58세,2021,864,462,402,114.9,860,460,400,115
37420, 울진군,060005, 59세,2021,847,422,425,99.3,840,418,422,99.1
37420, 울진군,065,60~64세,2021,4691,2379,2312,102.9,4671,2370,2301,103
37420, 울진군,065001, 60세,2021,1114,585,529,110.6,1108,581,527,110.2
37420, 울진군,065002, 61세,2021,1023,503,520,96.7,1016,502,514,97.7
37420, 울진군,065003, 62세,2021,874,435,439,99.1,871,432,439,98.4
37420, 울진군,065004, 63세,2021,818,414,404,102.5,816,414,402,103
37420, 울진군,065005, 64세,2021,862,442,420,105.2,860,441,419,105.3
37420, 울진군,070,65~69세,2021,3683,1779,1904,93.4,3671,1773,1898,93.4
37420, 울진군,070001, 65세,2021,861,406,455,89.2,859,406,453,89.6
37420, 울진군,070002, 66세,2021,764,388,376,103.2,761,387,374,103.5
37420, 울진군,070003, 67세,2021,739,357,382,93.5,736,355,381,93.2
37420, 울진군,070004, 68세,2021,672,324,348,93.1,670,322,348,92.5
37420, 울진군,070005, 69세,2021,647,304,343,88.6,645,303,342,88.6
37420, 울진군,075,70~74세,2021,2781,1322,1459,90.6,2775,1320,1455,90.7
37420, 울진군,075001, 70세,2021,471,223,248,89.9,468,222,246,90.2
37420, 울진군,075002, 71세,2021,565,277,288,96.2,565,277,288,96.2
37420, 울진군,075003, 72세,2021,618,293,325,90.2,615,292,323,90.4
37420, 울진군,075004, 73세,2021,633,315,318,99.1,633,315,318,99.1
37420, 울진군,075005, 74세,2021,494,214,280,76.4,494,214,280,76.4
37420, 울진군,080,75~79세,2021,2606,1043,1563,66.7,2602,1043,1559,66.9
37420, 울진군,080001, 75세,2021,431,220,211,104.3,430,220,210,104.8
37420, 울진군,080002, 76세,2021,479,183,296,61.8,478,183,295,62
37420, 울진군,080003, 77세,2021,479,181,298,60.7,478,181,297,60.9
37420, 울진군,080004, 78세,2021,583,220,363,60.6,583,220,363,60.6
37420, 울진군,080005, 79세,2021,634,239,395,60.5,633,239,394,60.7
37420, 울진군,085,80~84세,2021,2329,769,1560,49.3,2328,769,1559,49.3
37420, 울진군,085001, 80세,2021,491,177,314,56.4,491,177,314,56.4
37420, 울진군,085002, 81세,2021,481,162,319,50.8,481,162,319,50.8
37420, 울진군,085003, 82세,2021,524,164,360,45.6,523,164,359,45.7
37420, 울진군,085004, 83세,2021,428,144,284,50.7,428,144,284,50.7
37420, 울진군,085005, 84세,2021,405,122,283,43.1,405,122,283,43.1
37420, 울진군,090,85~89세,2021,1322,340,982,34.6,1320,340,980,34.7
37420, 울진군,090001, 85세,2021,368,112,256,43.8,368,112,256,43.8
37420, 울진군,090002, 86세,2021,343,90,253,35.6,343,90,253,35.6
37420, 울진군,090003, 87세,2021,234,67,167,40.1,233,67,166,40.4
37420, 울진군,090004, 88세,2021,188,46,142,32.4,187,46,141,32.6
37420, 울진군,090005, 89세,2021,189,25,164,15.2,189,25,164,15.2
37420, 울진군,095,90~94세,2021,502,98,404,24.3,502,98,404,24.3
37420, 울진군,095001, 90세,2021,153,32,121,26.4,153,32,121,26.4
37420, 울진군,095002, 91세,2021,135,34,101,33.7,135,34,101,33.7
37420, 울진군,095003, 92세,2021,90,15,75,20,90,15,75,20
37420, 울진군,095004, 93세,2021,72,8,64,12.5,72,8,64,12.5
37420, 울진군,095005, 94세,2021,52,9,43,20.9,52,9,43,20.9
37420, 울진군,100,95~99세,2021,100,7,93,7.5,100,7,93,7.5
37420, 울진군,100001, 95세,2021,30,X,27,11.1,30,X,27,11.1
37420, 울진군,100002, 96세,2021,35,X,34,2.9,35,X,34,2.9
37420, 울진군,100003, 97세,2021,16,X,15,6.7,16,X,15,6.7
37420, 울진군,100004, 98세,2021,12,X,10,20,12,X,10,20
37420, 울진군,100005, 99세,2021,7,X,7,0,7,X,7,0
37420, 울진군,101,100세이상,2021,11,X,11,0,11,X,11,0
37420, 울진군,102,15세미만,2021,4337,2268,2069,109.6,4332,2266,2066,109.7
37420, 울진군,103,15~64세,2021,28698,16415,12283,133.6,26899,14866,12033,123.5
37420, 울진군,104,65세이상,2021,13334,5358,7976,67.2,13309,5350,7959,67.2
37420, 울진군,086,85세이상,2021,1935,445,1490,29.9,1933,445,1488,29.9
37420, 울진군,126,평균연령,2021,50.5,47.4,53.9,,51.1,48.2,54.1,
37420, 울진군,127,중위연령,2021,53.6,50.1,57.8,,54.7,51.8,58.1,
37430, 울릉군,000,합계,2021,8169,4513,3656,123.4,7940,4333,3607,120.1
37430, 울릉군,005,0~4세,2021,163,86,77,111.7,162,86,76,113.2
37430, 울릉군,005001, 0세,2021,26,13,13,100,26,13,13,100
37430, 울릉군,005002, 1세,2021,33,19,14,135.7,33,19,14,135.7
37430, 울릉군,005003, 2세,2021,40,20,20,100,39,20,19,105.3
37430, 울릉군,005004, 3세,2021,37,22,15,146.7,37,22,15,146.7
37430, 울릉군,005005, 4세,2021,27,12,15,80,27,12,15,80
37430, 울릉군,010,5~9세,2021,223,107,116,92.2,220,107,113,94.7
37430, 울릉군,010001, 5세,2021,42,25,17,147.1,41,25,16,156.3
37430, 울릉군,010002, 6세,2021,40,19,21,90.5,40,19,21,90.5
37430, 울릉군,010003, 7세,2021,43,20,23,87,41,20,21,95.2
37430, 울릉군,010004, 8세,2021,52,24,28,85.7,52,24,28,85.7
37430, 울릉군,010005, 9세,2021,46,19,27,70.4,46,19,27,70.4
37430, 울릉군,015,10~14세,2021,219,107,112,95.5,218,106,112,94.6
37430, 울릉군,015001, 10세,2021,45,28,17,164.7,44,27,17,158.8
37430, 울릉군,015002, 11세,2021,44,21,23,91.3,44,21,23,91.3
37430, 울릉군,015003, 12세,2021,33,15,18,83.3,33,15,18,83.3
37430, 울릉군,015004, 13세,2021,46,25,21,119,46,25,21,119
37430, 울릉군,015005, 14세,2021,51,18,33,54.5,51,18,33,54.5
37430, 울릉군,020,15~19세,2021,161,78,83,94,161,78,83,94
37430, 울릉군,020001, 15세,2021,38,21,17,123.5,38,21,17,123.5
37430, 울릉군,020002, 16세,2021,44,20,24,83.3,44,20,24,83.3
37430, 울릉군,020003, 17세,2021,30,12,18,66.7,30,12,18,66.7
37430, 울릉군,020004, 18세,2021,24,13,11,118.2,24,13,11,118.2
37430, 울릉군,020005, 19세,2021,25,12,13,92.3,25,12,13,92.3
37430, 울릉군,025,20~24세,2021,253,166,87,190.8,246,161,85,189.4
37430, 울릉군,025001, 20세,2021,35,23,12,191.7,35,23,12,191.7
37430, 울릉군,025002, 21세,2021,56,43,13,330.8,56,43,13,330.8
37430, 울릉군,025003, 22세,2021,38,20,18,111.1,35,18,17,105.9
37430, 울릉군,025004, 23세,2021,53,33,20,165,52,33,19,173.7
37430, 울릉군,025005, 24세,2021,71,47,24,195.8,68,44,24,183.3
37430, 울릉군,030,25~29세,2021,423,288,135,213.3,391,260,131,198.5
37430, 울릉군,030001, 25세,2021,72,43,29,148.3,69,41,28,146.4
37430, 울릉군,030002, 26세,2021,88,63,25,252,80,56,24,233.3
37430, 울릉군,030003, 27세,2021,100,68,32,212.5,96,65,31,209.7
37430, 울릉군,030004, 28세,2021,81,53,28,189.3,73,46,27,170.4
37430, 울릉군,030005, 29세,2021,82,61,21,290.5,73,52,21,247.6
37430, 울릉군,035,30~34세,2021,385,249,136,183.1,332,202,130,155.4
37430, 울릉군,035001, 30세,2021,88,57,31,183.9,76,45,31,145.2
37430, 울릉군,035002, 31세,2021,83,52,31,167.7,70,43,27,159.3
37430, 울릉군,035003, 32세,2021,79,52,27,192.6,68,42,26,161.5
37430, 울릉군,035004, 33세,2021,69,48,21,228.6,61,41,20,205
37430, 울릉군,035005, 34세,2021,66,40,26,153.8,57,31,26,119.2
37430, 울릉군,040,35~39세,2021,460,282,178,158.4,413,237,176,134.7
37430, 울릉군,040001, 35세,2021,77,50,27,185.2,63,36,27,133.3
37430, 울릉군,040002, 36세,2021,75,49,26,188.5,67,42,25,168
37430, 울릉군,040003, 37세,2021,107,59,48,122.9,100,52,48,108.3
37430, 울릉군,040004, 38세,2021,85,46,39,117.9,76,38,38,100
37430, 울릉군,040005, 39세,2021,116,78,38,205.3,107,69,38,181.6
37430, 울릉군,045,40~44세,2021,525,328,197,166.5,505,311,194,160.3
37430, 울릉군,045001, 40세,2021,115,77,38,202.6,108,70,38,184.2
37430, 울릉군,045002, 41세,2021,99,63,36,175,94,59,35,168.6
37430, 울릉군,045003, 42세,2021,99,66,33,200,96,63,33,190.9
37430, 울릉군,045004, 43세,2021,110,62,48,129.2,108,61,47,129.8
37430, 울릉군,045005, 44세,2021,102,60,42,142.9,99,58,41,141.5
37430, 울릉군,050,45~49세,2021,623,384,239,160.7,611,373,238,156.7
37430, 울릉군,050001, 45세,2021,101,60,41,146.3,99,58,41,141.5
37430, 울릉군,050002, 46세,2021,117,81,36,225,114,78,36,216.7
37430, 울릉군,050003, 47세,2021,140,87,53,164.2,138,85,53,160.4
37430, 울릉군,050004, 48세,2021,138,81,57,142.1,135,79,56,141.1
37430, 울릉군,050005, 49세,2021,127,75,52,144.2,125,73,52,140.4
37430, 울릉군,055,50~54세,2021,789,477,312,152.9,780,473,307,154.1
37430, 울릉군,055001, 50세,2021,170,110,60,183.3,168,109,59,184.7
37430, 울릉군,055002, 51세,2021,145,84,61,137.7,144,84,60,140
37430, 울릉군,055003, 52세,2021,158,102,56,182.1,154,99,55,180
37430, 울릉군,055004, 53세,2021,159,92,67,137.3,159,92,67,137.3
37430, 울릉군,055005, 54세,2021,157,89,68,130.9,155,89,66,134.8
37430, 울릉군,060,55~59세,2021,841,474,367,129.2,833,470,363,129.5
37430, 울릉군,060001, 55세,2021,176,94,82,114.6,173,92,81,113.6
37430, 울릉군,060002, 56세,2021,173,106,67,158.2,171,106,65,163.1
37430, 울릉군,060003, 57세,2021,135,72,63,114.3,135,72,63,114.3
37430, 울릉군,060004, 58세,2021,181,99,82,120.7,181,99,82,120.7
37430, 울릉군,060005, 59세,2021,176,103,73,141.1,173,101,72,140.3
37430, 울릉군,065,60~64세,2021,953,495,458,108.1,934,487,447,108.9
37430, 울릉군,065001, 60세,2021,224,111,113,98.2,221,110,111,99.1
37430, 울릉군,065002, 61세,2021,181,100,81,123.5,176,99,77,128.6
37430, 울릉군,065003, 62세,2021,202,96,106,90.6,200,95,105,90.5
37430, 울릉군,065004, 63세,2021,161,87,74,117.6,157,85,72,118.1
37430, 울릉군,065005, 64세,2021,185,101,84,120.2,180,98,82,119.5
37430, 울릉군,070,65~69세,2021,692,360,332,108.4,678,352,326,108
37430, 울릉군,070001, 65세,2021,153,82,71,115.5,149,79,70,112.9
37430, 울릉군,070002, 66세,2021,150,84,66,127.3,146,82,64,128.1
37430, 울릉군,070003, 67세,2021,120,66,54,122.2,116,64,52,123.1
37430, 울릉군,070004, 68세,2021,133,64,69,92.8,132,63,69,91.3
37430, 울릉군,070005, 69세,2021,136,64,72,88.9,135,64,71,90.1
37430, 울릉군,075,70~74세,2021,553,270,283,95.4,551,268,283,94.7
37430, 울릉군,075001, 70세,2021,123,66,57,115.8,122,65,57,114
37430, 울릉군,075002, 71세,2021,100,40,60,66.7,99,39,60,65
37430, 울릉군,075003, 72세,2021,99,44,55,80,99,44,55,80
37430, 울릉군,075004, 73세,2021,109,60,49,122.4,109,60,49,122.4
37430, 울릉군,075005, 74세,2021,122,60,62,96.8,122,60,62,96.8
37430, 울릉군,080,75~79세,2021,407,178,229,77.7,406,178,228,78.1
37430, 울릉군,080001, 75세,2021,82,33,49,67.3,82,33,49,67.3
37430, 울릉군,080002, 76세,2021,82,32,50,64,82,32,50,64
37430, 울릉군,080003, 77세,2021,87,41,46,89.1,87,41,46,89.1
37430, 울릉군,080004, 78세,2021,70,28,42,66.7,70,28,42,66.7
37430, 울릉군,080005, 79세,2021,86,44,42,104.8,85,44,41,107.3
37430, 울릉군,085,80~84세,2021,282,113,169,66.9,282,113,169,66.9
37430, 울릉군,085001, 80세,2021,72,33,39,84.6,72,33,39,84.6
37430, 울릉군,085002, 81세,2021,55,21,34,61.8,55,21,34,61.8
37430, 울릉군,085003, 82세,2021,67,28,39,71.8,67,28,39,71.8
37430, 울릉군,085004, 83세,2021,44,15,29,51.7,44,15,29,51.7
37430, 울릉군,085005, 84세,2021,44,16,28,57.1,44,16,28,57.1
37430, 울릉군,090,85~89세,2021,156,56,100,56,156,56,100,56
37430, 울릉군,090001, 85세,2021,47,24,23,104.3,47,24,23,104.3
37430, 울릉군,090002, 86세,2021,41,19,22,86.4,41,19,22,86.4
37430, 울릉군,090003, 87세,2021,32,6,26,23.1,32,6,26,23.1
37430, 울릉군,090004, 88세,2021,14,X,12,16.7,14,X,12,16.7
37430, 울릉군,090005, 89세,2021,22,5,17,29.4,22,5,17,29.4
37430, 울릉군,095,90~94세,2021,50,11,39,28.2,50,11,39,28.2
37430, 울릉군,095001, 90세,2021,20,5,15,33.3,20,5,15,33.3
37430, 울릉군,095002, 91세,2021,12,X,9,33.3,12,X,9,33.3
37430, 울릉군,095003, 92세,2021,8,X,6,33.3,8,X,6,33.3
37430, 울릉군,095004, 93세,2021,8,X,7,14.3,8,X,7,14.3
37430, 울릉군,095005, 94세,2021,X,X,X,0,X,X,X,0
37430, 울릉군,100,95~99세,2021,9,X,5,80,9,X,5,80
37430, 울릉군,100001, 95세,2021,X,X,X,200,X,X,X,200
37430, 울릉군,100002, 96세,2021,X,X,X,0,X,X,X,0
37430, 울릉군,100003, 97세,2021,X,X,X,,X,X,X,
37430, 울릉군,100004, 98세,2021,X,X,X,100,X,X,X,100
37430, 울릉군,100005, 99세,2021,X,X,X,,X,X,X,
37430, 울릉군,101,100세이상,2021,X,X,X,0,X,X,X,0
37430, 울릉군,102,15세미만,2021,605,300,305,98.4,600,299,301,99.3
37430, 울릉군,103,15~64세,2021,5413,3221,2192,146.9,5206,3052,2154,141.7
37430, 울릉군,104,65세이상,2021,2151,992,1159,85.6,2134,982,1152,85.2
37430, 울릉군,086,85세이상,2021,217,71,146,48.6,217,71,146,48.6
37430, 울릉군,126,평균연령,2021,51,49.3,53.1,,51.3,49.8,53.2,
37430, 울릉군,127,중위연령,2021,54.1,51.8,57.1,,54.6,52.5,57.2,
38,경상남도,000,합계,2021,3305931,1676753,1629178,102.9,3214095,1617823,1596272,101.4
38,경상남도,005,0~4세,2021,99686,51300,48386,106,98354,50643,47711,106.1
38,경상남도,005001, 0세,2021,15966,8235,7731,106.5,15718,8106,7612,106.5
38,경상남도,005002, 1세,2021,17448,8935,8513,105,17189,8805,8384,105
38,경상남도,005003, 2세,2021,19676,10091,9585,105.3,19429,9967,9462,105.3
38,경상남도,005004, 3세,2021,21884,11284,10600,106.5,21599,11148,10451,106.7
38,경상남도,005005, 4세,2021,24712,12755,11957,106.7,24419,12617,11802,106.9
38,경상남도,010,5~9세,2021,153280,78831,74449,105.9,151941,78153,73788,105.9
38,경상남도,010001, 5세,2021,28301,14487,13814,104.9,27978,14322,13656,104.9
38,경상남도,010002, 6세,2021,30195,15500,14695,105.5,29887,15337,14550,105.4
38,경상남도,010003, 7세,2021,30578,15779,14799,106.6,30319,15653,14666,106.7
38,경상남도,010004, 8세,2021,30603,15739,14864,105.9,30371,15619,14752,105.9
38,경상남도,010005, 9세,2021,33603,17326,16277,106.4,33386,17222,16164,106.5
38,경상남도,015,10~14세,2021,161109,83169,77940,106.7,160364,82784,77580,106.7
38,경상남도,015001, 10세,2021,33151,17054,16097,105.9,33001,16970,16031,105.9
38,경상남도,015002, 11세,2021,31895,16510,15385,107.3,31732,16434,15298,107.4
38,경상남도,015003, 12세,2021,30738,15915,14823,107.4,30588,15838,14750,107.4
38,경상남도,015004, 13세,2021,32372,16604,15768,105.3,32231,16532,15699,105.3
38,경상남도,015005, 14세,2021,32953,17086,15867,107.7,32812,17010,15802,107.6
38,경상남도,020,15~19세,2021,148364,78984,69380,113.8,147416,78538,68878,114
38,경상남도,020001, 15세,2021,29740,15494,14246,108.8,29616,15436,14180,108.9
38,경상남도,020002, 16세,2021,29089,15175,13914,109.1,29001,15131,13870,109.1
38,경상남도,020003, 17세,2021,31443,16499,14944,110.4,31341,16454,14887,110.5
38,경상남도,020004, 18세,2021,30673,16305,14368,113.5,30503,16218,14285,113.5
38,경상남도,020005, 19세,2021,27419,15511,11908,130.3,26955,15299,11656,131.3
38,경상남도,025,20~24세,2021,176035,101822,74213,137.2,168540,97412,71128,137
38,경상남도,025001, 20세,2021,32462,19200,13262,144.8,31785,18856,12929,145.8
38,경상남도,025002, 21세,2021,36798,21679,15119,143.4,35774,21153,14621,144.7
38,경상남도,025003, 22세,2021,34686,19983,14703,135.9,33291,19181,14110,135.9
38,경상남도,025004, 23세,2021,35511,20187,15324,131.7,33530,19007,14523,130.9
38,경상남도,025005, 24세,2021,36578,20773,15805,131.4,34160,19215,14945,128.6
38,경상남도,030,25~29세,2021,190608,108207,82401,131.3,174945,97552,77393,126
38,경상남도,030001, 25세,2021,37910,21851,16059,136.1,35183,20004,15179,131.8
38,경상남도,030002, 26세,2021,37794,21624,16170,133.7,34806,19596,15210,128.8
38,경상남도,030003, 27세,2021,37868,21515,16353,131.6,34757,19378,15379,126
38,경상남도,030004, 28세,2021,38407,21679,16728,129.6,35058,19432,15626,124.4
38,경상남도,030005, 29세,2021,38629,21538,17091,126,35141,19142,15999,119.6
38,경상남도,035,30~34세,2021,183462,100773,82689,121.9,165058,87935,77123,114
38,경상남도,035001, 30세,2021,37016,20511,16505,124.3,33492,18090,15402,117.5
38,경상남도,035002, 31세,2021,36777,20563,16214,126.8,32994,17918,15076,118.9
38,경상남도,035003, 32세,2021,36318,20107,16211,124,32674,17572,15102,116.4
38,경상남도,035004, 33세,2021,35958,19638,16320,120.3,32256,17016,15240,111.7
38,경상남도,035005, 34세,2021,37393,19954,17439,114.4,33642,17339,16303,106.4
38,경상남도,040,35~39세,2021,222205,117875,104330,113,206836,107022,99814,107.2
38,경상남도,040001, 35세,2021,38414,20879,17535,119.1,34907,18409,16498,111.6
38,경상남도,040002, 36세,2021,40154,21536,18618,115.7,36832,19169,17663,108.5
38,경상남도,040003, 37세,2021,42988,22760,20228,112.5,39918,20577,19341,106.4
38,경상남도,040004, 38세,2021,48153,25370,22783,111.4,45299,23343,21956,106.3
38,경상남도,040005, 39세,2021,52496,27330,25166,108.6,49880,25524,24356,104.8
38,경상남도,045,40~44세,2021,258302,134561,123741,108.7,248706,128113,120593,106.2
38,경상남도,045001, 40세,2021,53389,28012,25377,110.4,51093,26411,24682,107
38,경상남도,045002, 41세,2021,55529,28808,26721,107.8,53479,27390,26089,105
38,경상남도,045003, 42세,2021,52172,27224,24948,109.1,50209,25930,24279,106.8
38,경상남도,045004, 43세,2021,48396,25264,23132,109.2,46629,24112,22517,107.1
38,경상남도,045005, 44세,2021,48816,25253,23563,107.2,47296,24270,23026,105.4
38,경상남도,050,45~49세,2021,269224,138650,130574,106.2,262427,134392,128035,105
38,경상남도,050001, 45세,2021,47943,24939,23004,108.4,46421,23917,22504,106.3
38,경상남도,050002, 46세,2021,51544,26322,25222,104.4,50109,25432,24677,103.1
38,경상남도,050003, 47세,2021,55806,28657,27149,105.6,54500,27845,26655,104.5
38,경상남도,050004, 48세,2021,57729,29398,28331,103.8,56487,28659,27828,103
38,경상남도,050005, 49세,2021,56202,29334,26868,109.2,54910,28539,26371,108.2
38,경상남도,055,50~54세,2021,298716,151376,147340,102.7,293215,148309,144906,102.3
38,경상남도,055001, 50세,2021,60922,31150,29772,104.6,59673,30416,29257,104
38,경상남도,055002, 51세,2021,60021,30642,29379,104.3,58860,29954,28906,103.6
38,경상남도,055003, 52세,2021,60537,30878,29659,104.1,59427,30285,29142,103.9
38,경상남도,055004, 53세,2021,60795,30464,30331,100.4,59747,29886,29861,100.1
38,경상남도,055005, 54세,2021,56441,28242,28199,100.2,55508,27768,27740,100.1
38,경상남도,060,55~59세,2021,272262,139213,133049,104.6,268112,137050,131062,104.6
38,경상남도,060001, 55세,2021,55308,28838,26470,108.9,54459,28384,26075,108.9
38,경상남도,060002, 56세,2021,55622,27983,27639,101.2,54754,27523,27231,101.1
38,경상남도,060003, 57세,2021,49089,24826,24263,102.3,48271,24425,23846,102.4
38,경상남도,060004, 58세,2021,54441,28211,26230,107.6,53569,27756,25813,107.5
38,경상남도,060005, 59세,2021,57802,29355,28447,103.2,57059,28962,28097,103.1
38,경상남도,065,60~64세,2021,278977,139446,139531,99.9,276652,138297,138355,100
38,경상남도,065001, 60세,2021,63111,31325,31786,98.5,62600,31088,31512,98.7
38,경상남도,065002, 61세,2021,61455,30460,30995,98.3,60871,30168,30703,98.3
38,경상남도,065003, 62세,2021,53881,27131,26750,101.4,53454,26916,26538,101.4
38,경상남도,065004, 63세,2021,50429,25448,24981,101.9,49991,25234,24757,101.9
38,경상남도,065005, 64세,2021,50101,25082,25019,100.3,49736,24891,24845,100.2
38,경상남도,070,65~69세,2021,202349,98842,103507,95.5,201098,98273,102825,95.6
38,경상남도,070001, 65세,2021,45861,22658,23203,97.7,45497,22496,23001,97.8
38,경상남도,070002, 66세,2021,46964,22722,24242,93.7,46667,22564,24103,93.6
38,경상남도,070003, 67세,2021,38781,19267,19514,98.7,38536,19170,19366,99
38,경상남도,070004, 68세,2021,33794,16379,17415,94.1,33597,16292,17305,94.1
38,경상남도,070005, 69세,2021,36949,17816,19133,93.1,36801,17751,19050,93.2
38,경상남도,075,70~74세,2021,142025,66728,75297,88.6,141511,66508,75003,88.7
38,경상남도,075001, 70세,2021,28887,13729,15158,90.6,28756,13673,15083,90.7
38,경상남도,075002, 71세,2021,28892,13759,15133,90.9,28762,13703,15059,91
38,경상남도,075003, 72세,2021,29147,13781,15366,89.7,29035,13728,15307,89.7
38,경상남도,075004, 73세,2021,28501,13380,15121,88.5,28432,13348,15084,88.5
38,경상남도,075005, 74세,2021,26598,12079,14519,83.2,26526,12056,14470,83.3
38,경상남도,080,75~79세,2021,103393,42917,60476,71,103182,42842,60340,71
38,경상남도,080001, 75세,2021,19278,8773,10505,83.5,19227,8753,10474,83.6
38,경상남도,080002, 76세,2021,19447,8426,11021,76.5,19391,8407,10984,76.5
38,경상남도,080003, 77세,2021,20540,8533,12007,71.1,20502,8521,11981,71.1
38,경상남도,080004, 78세,2021,20854,8300,12554,66.1,20819,8285,12534,66.1
38,경상남도,080005, 79세,2021,23274,8885,14389,61.7,23243,8876,14367,61.8
38,경상남도,085,80~84세,2021,83014,28587,54427,52.5,82882,28546,54336,52.5
38,경상남도,085001, 80세,2021,19716,7335,12381,59.2,19685,7326,12359,59.3
38,경상남도,085002, 81세,2021,18034,6361,11673,54.5,18002,6350,11652,54.5
38,경상남도,085003, 82세,2021,17201,5829,11372,51.3,17174,5821,11353,51.3
38,경상남도,085004, 83세,2021,14429,4730,9699,48.8,14398,4722,9676,48.8
38,경상남도,085005, 84세,2021,13634,4332,9302,46.6,13623,4327,9296,46.5
38,경상남도,090,85~89세,2021,45002,12118,32884,36.9,44953,12104,32849,36.8
38,경상남도,090001, 85세,2021,12056,3598,8458,42.5,12041,3592,8449,42.5
38,경상남도,090002, 86세,2021,10706,3013,7693,39.2,10692,3009,7683,39.2
38,경상남도,090003, 87세,2021,9037,2363,6674,35.4,9026,2361,6665,35.4
38,경상남도,090004, 88세,2021,7085,1774,5311,33.4,7080,1772,5308,33.4
38,경상남도,090005, 89세,2021,6118,1370,4748,28.9,6114,1370,4744,28.9
38,경상남도,095,90~94세,2021,14794,2879,11915,24.2,14784,2877,11907,24.2
38,경상남도,095001, 90세,2021,4519,939,3580,26.2,4516,938,3578,26.2
38,경상남도,095002, 91세,2021,3679,674,3005,22.4,3677,674,3003,22.4
38,경상남도,095003, 92세,2021,2948,595,2353,25.3,2946,594,2352,25.3
38,경상남도,095004, 93세,2021,2138,404,1734,23.3,2137,404,1733,23.3
38,경상남도,095005, 94세,2021,1510,267,1243,21.5,1508,267,1241,21.5
38,경상남도,100,95~99세,2021,2780,423,2357,17.9,2776,422,2354,17.9
38,경상남도,100001, 95세,2021,997,169,828,20.4,996,169,827,20.4
38,경상남도,100002, 96세,2021,751,102,649,15.7,750,102,648,15.7
38,경상남도,100003, 97세,2021,427,61,366,16.7,426,61,365,16.7
38,경상남도,100004, 98세,2021,371,57,314,18.2,370,56,314,17.8
38,경상남도,100005, 99세,2021,234,34,200,17,234,34,200,17
38,경상남도,101,100세이상,2021,344,52,292,17.8,343,51,292,17.5
38,경상남도,102,15세미만,2021,414075,213300,200775,106.2,410659,211580,199079,106.3
38,경상남도,103,15~64세,2021,2298155,1210907,1087248,111.4,2211907,1154620,1057287,109.2
38,경상남도,104,65세이상,2021,593701,252546,341155,74,591529,251623,339906,74
38,경상남도,086,85세이상,2021,62920,15472,47448,32.6,62856,15454,47402,32.6
38,경상남도,126,평균연령,2021,44.3,42.7,45.9,,44.5,43,46.1,
38,경상남도,127,중위연령,2021,46.2,44.3,48.1,,46.8,45,48.4,
38004, 읍부,000,합계,2021,501128,251800,249328,101,488744,244562,244182,100.2
38004, 읍부,005,0~4세,2021,17274,8812,8462,104.1,17024,8696,8328,104.4
38004, 읍부,005001, 0세,2021,2613,1350,1263,106.9,2563,1323,1240,106.7
38004, 읍부,005002, 1세,2021,3088,1567,1521,103,3043,1547,1496,103.4
38004, 읍부,005003, 2세,2021,3435,1749,1686,103.7,3392,1731,1661,104.2
38004, 읍부,005004, 3세,2021,3917,1940,1977,98.1,3865,1919,1946,98.6
38004, 읍부,005005, 4세,2021,4221,2206,2015,109.5,4161,2176,1985,109.6
38004, 읍부,010,5~9세,2021,26548,13661,12887,106,26292,13536,12756,106.1
38004, 읍부,010001, 5세,2021,4936,2541,2395,106.1,4875,2514,2361,106.5
38004, 읍부,010002, 6세,2021,5276,2681,2595,103.3,5218,2654,2564,103.5
38004, 읍부,010003, 7세,2021,5306,2717,2589,104.9,5255,2691,2564,105
38004, 읍부,010004, 8세,2021,5238,2696,2542,106.1,5199,2672,2527,105.7
38004, 읍부,010005, 9세,2021,5792,3026,2766,109.4,5745,3005,2740,109.7
38004, 읍부,015,10~14세,2021,27408,14200,13208,107.5,27221,14113,13108,107.7
38004, 읍부,015001, 10세,2021,5781,2953,2828,104.4,5745,2937,2808,104.6
38004, 읍부,015002, 11세,2021,5445,2798,2647,105.7,5405,2782,2623,106.1
38004, 읍부,015003, 12세,2021,5202,2678,2524,106.1,5167,2659,2508,106
38004, 읍부,015004, 13세,2021,5531,2894,2637,109.7,5492,2877,2615,110
38004, 읍부,015005, 14세,2021,5449,2877,2572,111.9,5412,2858,2554,111.9
38004, 읍부,020,15~19세,2021,24559,13037,11522,113.1,24412,12971,11441,113.4
38004, 읍부,020001, 15세,2021,5001,2571,2430,105.8,4979,2561,2418,105.9
38004, 읍부,020002, 16세,2021,4939,2551,2388,106.8,4913,2539,2374,107
38004, 읍부,020003, 17세,2021,5220,2689,2531,106.2,5197,2680,2517,106.5
38004, 읍부,020004, 18세,2021,5060,2716,2344,115.9,5032,2702,2330,116
38004, 읍부,020005, 19세,2021,4339,2510,1829,137.2,4291,2489,1802,138.1
38004, 읍부,025,20~24세,2021,25827,14972,10855,137.9,24841,14387,10454,137.6
38004, 읍부,025001, 20세,2021,5024,2995,2029,147.6,4939,2956,1983,149.1
38004, 읍부,025002, 21세,2021,5629,3301,2328,141.8,5454,3204,2250,142.4
38004, 읍부,025003, 22세,2021,4999,2997,2002,149.7,4814,2880,1934,148.9
38004, 읍부,025004, 23세,2021,5026,2817,2209,127.5,4783,2664,2119,125.7
38004, 읍부,025005, 24세,2021,5149,2862,2287,125.1,4851,2683,2168,123.8
38004, 읍부,030,25~29세,2021,26827,14733,12094,121.8,24854,13483,11371,118.6
38004, 읍부,030001, 25세,2021,5337,3000,2337,128.4,4992,2779,2213,125.6
38004, 읍부,030002, 26세,2021,5278,2933,2345,125.1,4897,2690,2207,121.9
38004, 읍부,030003, 27세,2021,5278,2901,2377,122,4911,2666,2245,118.8
38004, 읍부,030004, 28세,2021,5419,2935,2484,118.2,4985,2674,2311,115.7
38004, 읍부,030005, 29세,2021,5515,2964,2551,116.2,5069,2674,2395,111.6
38004, 읍부,035,30~34세,2021,27094,14273,12821,111.3,24805,12835,11970,107.2
38004, 읍부,035001, 30세,2021,5238,2801,2437,114.9,4787,2530,2257,112.1
38004, 읍부,035002, 31세,2021,5344,2866,2478,115.7,4927,2608,2319,112.5
38004, 읍부,035003, 32세,2021,5338,2825,2513,112.4,4887,2545,2342,108.7
38004, 읍부,035004, 33세,2021,5358,2813,2545,110.5,4881,2493,2388,104.4
38004, 읍부,035005, 34세,2021,5816,2968,2848,104.2,5323,2659,2664,99.8
38004, 읍부,040,35~39세,2021,34883,17792,17091,104.1,32827,16490,16337,100.9
38004, 읍부,040001, 35세,2021,6002,3093,2909,106.3,5519,2800,2719,103
38004, 읍부,040002, 36세,2021,6071,3157,2914,108.3,5659,2886,2773,104.1
38004, 읍부,040003, 37세,2021,6763,3444,3319,103.8,6346,3180,3166,100.4
38004, 읍부,040004, 38세,2021,7683,3848,3835,100.3,7284,3600,3684,97.7
38004, 읍부,040005, 39세,2021,8364,4250,4114,103.3,8019,4024,3995,100.7
38004, 읍부,045,40~44세,2021,41314,20964,20350,103,40049,20214,19835,101.9
38004, 읍부,045001, 40세,2021,8503,4298,4205,102.2,8208,4116,4092,100.6
38004, 읍부,045002, 41세,2021,8820,4513,4307,104.8,8544,4353,4191,103.9
38004, 읍부,045003, 42세,2021,8309,4158,4151,100.2,8076,4028,4048,99.5
38004, 읍부,045004, 43세,2021,7868,3997,3871,103.3,7609,3845,3764,102.2
38004, 읍부,045005, 44세,2021,7814,3998,3816,104.8,7612,3872,3740,103.5
38004, 읍부,050,45~49세,2021,41521,21424,20097,106.6,40584,20898,19686,106.2
38004, 읍부,050001, 45세,2021,7528,3878,3650,106.2,7330,3757,3573,105.1
38004, 읍부,050002, 46세,2021,8095,4149,3946,105.1,7903,4041,3862,104.6
38004, 읍부,050003, 47세,2021,8606,4473,4133,108.2,8415,4369,4046,108
38004, 읍부,050004, 48세,2021,8684,4433,4251,104.3,8498,4337,4161,104.2
38004, 읍부,050005, 49세,2021,8608,4491,4117,109.1,8438,4394,4044,108.7
38004, 읍부,055,50~54세,2021,44197,22643,21554,105.1,43424,22228,21196,104.9
38004, 읍부,055001, 50세,2021,9140,4682,4458,105,8979,4593,4386,104.7
38004, 읍부,055002, 51세,2021,8907,4597,4310,106.7,8751,4512,4239,106.4
38004, 읍부,055003, 52세,2021,9000,4672,4328,107.9,8841,4588,4253,107.9
38004, 읍부,055004, 53세,2021,9031,4581,4450,102.9,8870,4487,4383,102.4
38004, 읍부,055005, 54세,2021,8119,4111,4008,102.6,7983,4048,3935,102.9
38004, 읍부,060,55~59세,2021,38873,19967,18906,105.6,38286,19679,18607,105.8
38004, 읍부,060001, 55세,2021,7997,4185,3812,109.8,7869,4119,3750,109.8
38004, 읍부,060002, 56세,2021,7924,4000,3924,101.9,7811,3942,3869,101.9
38004, 읍부,060003, 57세,2021,7107,3618,3489,103.7,6974,3560,3414,104.3
38004, 읍부,060004, 58세,2021,7647,3957,3690,107.2,7530,3903,3627,107.6
38004, 읍부,060005, 59세,2021,8198,4207,3991,105.4,8102,4155,3947,105.3
38004, 읍부,065,60~64세,2021,39298,19613,19685,99.6,38950,19451,19499,99.8
38004, 읍부,065001, 60세,2021,8889,4427,4462,99.2,8813,4396,4417,99.5
38004, 읍부,065002, 61세,2021,8585,4273,4312,99.1,8505,4239,4266,99.4
38004, 읍부,065003, 62세,2021,7586,3800,3786,100.4,7526,3767,3759,100.2
38004, 읍부,065004, 63세,2021,7104,3598,3506,102.6,7038,3569,3469,102.9
38004, 읍부,065005, 64세,2021,7134,3515,3619,97.1,7068,3480,3588,97
38004, 읍부,070,65~69세,2021,28304,13715,14589,94,28108,13633,14475,94.2
38004, 읍부,070001, 65세,2021,6484,3161,3323,95.1,6422,3140,3282,95.7
38004, 읍부,070002, 66세,2021,6460,3135,3325,94.3,6411,3105,3306,93.9
38004, 읍부,070003, 67세,2021,5435,2671,2764,96.6,5399,2657,2742,96.9
38004, 읍부,070004, 68세,2021,4707,2272,2435,93.3,4677,2263,2414,93.7
38004, 읍부,070005, 69세,2021,5218,2476,2742,90.3,5199,2468,2731,90.4
38004, 읍부,075,70~74세,2021,20243,9473,10770,88,20168,9450,10718,88.2
38004, 읍부,075001, 70세,2021,4078,1940,2138,90.7,4057,1935,2122,91.2
38004, 읍부,075002, 71세,2021,4120,1930,2190,88.1,4097,1923,2174,88.5
38004, 읍부,075003, 72세,2021,4253,1992,2261,88.1,4240,1986,2254,88.1
38004, 읍부,075004, 73세,2021,4029,1881,2148,87.6,4017,1877,2140,87.7
38004, 읍부,075005, 74세,2021,3763,1730,2033,85.1,3757,1729,2028,85.3
38004, 읍부,080,75~79세,2021,14730,6045,8685,69.6,14694,6030,8664,69.6
38004, 읍부,080001, 75세,2021,2772,1309,1463,89.5,2760,1304,1456,89.6
38004, 읍부,080002, 76세,2021,2753,1189,1564,76,2743,1185,1558,76.1
38004, 읍부,080003, 77세,2021,2936,1201,1735,69.2,2933,1200,1733,69.2
38004, 읍부,080004, 78세,2021,2968,1157,1811,63.9,2962,1154,1808,63.8
38004, 읍부,080005, 79세,2021,3301,1189,2112,56.3,3296,1187,2109,56.3
38004, 읍부,085,80~84세,2021,12377,4139,8238,50.2,12361,4134,8227,50.2
38004, 읍부,085001, 80세,2021,2934,1039,1895,54.8,2930,1039,1891,54.9
38004, 읍부,085002, 81세,2021,2705,952,1753,54.3,2700,951,1749,54.4
38004, 읍부,085003, 82세,2021,2559,853,1706,50,2556,852,1704,50
38004, 읍부,085004, 83세,2021,2126,667,1459,45.7,2123,665,1458,45.6
38004, 읍부,085005, 84세,2021,2053,628,1425,44.1,2052,627,1425,44
38004, 읍부,090,85~89세,2021,6895,1804,5091,35.4,6890,1802,5088,35.4
38004, 읍부,090001, 85세,2021,1833,522,1311,39.8,1831,521,1310,39.8
38004, 읍부,090002, 86세,2021,1640,421,1219,34.5,1639,420,1219,34.5
38004, 읍부,090003, 87세,2021,1368,354,1014,34.9,1367,354,1013,34.9
38004, 읍부,090004, 88세,2021,1089,295,794,37.2,1089,295,794,37.2
38004, 읍부,090005, 89세,2021,965,212,753,28.2,964,212,752,28.2
38004, 읍부,095,90~94세,2021,2446,460,1986,23.2,2444,459,1985,23.1
38004, 읍부,095001, 90세,2021,722,147,575,25.6,721,147,574,25.6
38004, 읍부,095002, 91세,2021,628,114,514,22.2,628,114,514,22.2
38004, 읍부,095003, 92세,2021,479,91,388,23.5,478,90,388,23.2
38004, 읍부,095004, 93세,2021,362,67,295,22.7,362,67,295,22.7
38004, 읍부,095005, 94세,2021,255,41,214,19.2,255,41,214,19.2
38004, 읍부,100,95~99세,2021,451,64,387,16.5,451,64,387,16.5
38004, 읍부,100001, 95세,2021,164,21,143,14.7,164,21,143,14.7
38004, 읍부,100002, 96세,2021,117,20,97,20.6,117,20,97,20.6
38004, 읍부,100003, 97세,2021,77,11,66,16.7,77,11,66,16.7
38004, 읍부,100004, 98세,2021,48,7,41,17.1,48,7,41,17.1
38004, 읍부,100005, 99세,2021,45,5,40,12.5,45,5,40,12.5
38004, 읍부,101,100세이상,2021,59,9,50,18,59,9,50,18
38004, 읍부,102,15세미만,2021,71230,36673,34557,106.1,70537,36345,34192,106.3
38004, 읍부,103,15~64세,2021,344393,179418,164975,108.8,333032,172636,160396,107.6
38004, 읍부,104,65세이상,2021,85505,35709,49796,71.7,85175,35581,49594,71.7
38004, 읍부,086,85세이상,2021,9851,2337,7514,31.1,9844,2334,7510,31.1
38004, 읍부,126,평균연령,2021,43.3,41.7,44.8,,43.4,41.9,45,
38004, 읍부,127,중위연령,2021,44.9,43.4,46.4,,45.3,43.9,46.8,
38005, 면부,000,합계,2021,681250,347158,334092,103.9,650627,324326,326301,99.4
38005, 면부,005,0~4세,2021,16338,8460,7878,107.4,16165,8378,7787,107.6
38005, 면부,005001, 0세,2021,2553,1327,1226,108.2,2514,1307,1207,108.3
38005, 면부,005002, 1세,2021,2887,1521,1366,111.3,2851,1499,1352,110.9
38005, 면부,005003, 2세,2021,3291,1666,1625,102.5,3264,1656,1608,103
38005, 면부,005004, 3세,2021,3595,1855,1740,106.6,3562,1842,1720,107.1
38005, 면부,005005, 4세,2021,4012,2091,1921,108.8,3974,2074,1900,109.2
38005, 면부,010,5~9세,2021,23953,12378,11575,106.9,23738,12273,11465,107
38005, 면부,010001, 5세,2021,4486,2306,2180,105.8,4435,2280,2155,105.8
38005, 면부,010002, 6세,2021,4776,2449,2327,105.2,4716,2415,2301,105
38005, 면부,010003, 7세,2021,4870,2506,2364,106,4833,2489,2344,106.2
38005, 면부,010004, 8세,2021,4794,2500,2294,109,4755,2484,2271,109.4
38005, 면부,010005, 9세,2021,5027,2617,2410,108.6,4999,2605,2394,108.8
38005, 면부,015,10~14세,2021,23575,12235,11340,107.9,23507,12198,11309,107.9
38005, 면부,015001, 10세,2021,4952,2600,2352,110.5,4934,2587,2347,110.2
38005, 면부,015002, 11세,2021,4749,2468,2281,108.2,4734,2462,2272,108.4
38005, 면부,015003, 12세,2021,4544,2311,2233,103.5,4535,2306,2229,103.5
38005, 면부,015004, 13세,2021,4676,2396,2280,105.1,4660,2388,2272,105.1
38005, 면부,015005, 14세,2021,4654,2460,2194,112.1,4644,2455,2189,112.2
38005, 면부,020,15~19세,2021,20050,10770,9280,116.1,19960,10717,9243,115.9
38005, 면부,020001, 15세,2021,4048,2121,1927,110.1,4033,2113,1920,110.1
38005, 면부,020002, 16세,2021,4215,2163,2052,105.4,4203,2157,2046,105.4
38005, 면부,020003, 17세,2021,4667,2476,2191,113,4654,2470,2184,113.1
38005, 면부,020004, 18세,2021,4181,2197,1984,110.7,4162,2184,1978,110.4
38005, 면부,020005, 19세,2021,2939,1813,1126,161,2908,1793,1115,160.8
38005, 면부,025,20~24세,2021,22422,14036,8386,167.4,20107,12502,7605,164.4
38005, 면부,025001, 20세,2021,3767,2543,1224,207.8,3705,2511,1194,210.3
38005, 면부,025002, 21세,2021,4435,2914,1521,191.6,4228,2801,1427,196.3
38005, 면부,025003, 22세,2021,4245,2593,1652,157,3846,2342,1504,155.7
38005, 면부,025004, 23세,2021,4697,2812,1885,149.2,4026,2377,1649,144.1
38005, 면부,025005, 24세,2021,5278,3174,2104,150.9,4302,2471,1831,135
38005, 면부,030,25~29세,2021,30058,18829,11229,167.7,23481,13775,9706,141.9
38005, 면부,030001, 25세,2021,5641,3536,2105,168,4504,2677,1827,146.5
38005, 면부,030002, 26세,2021,5971,3758,2213,169.8,4682,2799,1883,148.6
38005, 면부,030003, 27세,2021,6024,3813,2211,172.5,4711,2772,1939,143
38005, 면부,030004, 28세,2021,6131,3812,2319,164.4,4710,2742,1968,139.3
38005, 면부,030005, 29세,2021,6291,3910,2381,164.2,4874,2785,2089,133.3
38005, 면부,035,30~34세,2021,32369,19351,13018,148.6,25066,13530,11536,117.3
38005, 면부,035001, 30세,2021,6234,3806,2428,156.8,4813,2689,2124,126.6
38005, 면부,035002, 31세,2021,6535,3974,2561,155.2,4950,2740,2210,124
38005, 면부,035003, 32세,2021,6468,3904,2564,152.3,5055,2755,2300,119.8
38005, 면부,035004, 33세,2021,6490,3852,2638,146,5005,2657,2348,113.2
38005, 면부,035005, 34세,2021,6642,3815,2827,134.9,5243,2689,2554,105.3
38005, 면부,040,35~39세,2021,38797,22146,16651,133,33094,17529,15565,112.6
38005, 면부,040001, 35세,2021,6794,4047,2747,147.3,5475,2975,2500,119
38005, 면부,040002, 36세,2021,7146,4109,3037,135.3,5868,3061,2807,109
38005, 면부,040003, 37세,2021,7609,4322,3287,131.5,6491,3410,3081,110.7
38005, 면부,040004, 38세,2021,8345,4705,3640,129.3,7318,3874,3444,112.5
38005, 면부,040005, 39세,2021,8903,4963,3940,126,7942,4209,3733,112.8
38005, 면부,045,40~44세,2021,42185,23903,18282,130.7,38998,21433,17565,122
38005, 면부,045001, 40세,2021,8931,5009,3922,127.7,8148,4380,3768,116.2
38005, 면부,045002, 41세,2021,9301,5265,4036,130.5,8592,4705,3887,121
38005, 면부,045003, 42세,2021,8443,4875,3568,136.6,7788,4371,3417,127.9
38005, 면부,045004, 43세,2021,7739,4380,3359,130.4,7197,3955,3242,122
38005, 면부,045005, 44세,2021,7771,4374,3397,128.8,7273,4022,3251,123.7
38005, 면부,050,45~49세,2021,42921,24282,18639,130.3,41011,22933,18078,126.9
38005, 면부,050001, 45세,2021,7662,4457,3205,139.1,7192,4107,3085,133.1
38005, 면부,050002, 46세,2021,8151,4594,3557,129.2,7746,4310,3436,125.4
38005, 면부,050003, 47세,2021,8752,4956,3796,130.6,8395,4702,3693,127.3
38005, 면부,050004, 48세,2021,9286,5144,4142,124.2,8955,4926,4029,122.3
38005, 면부,050005, 49세,2021,9070,5131,3939,130.3,8723,4888,3835,127.5
38005, 면부,055,50~54세,2021,53277,28596,24681,115.9,52007,27809,24198,114.9
38005, 면부,055001, 50세,2021,10024,5504,4520,121.8,9729,5313,4416,120.3
38005, 면부,055002, 51세,2021,10274,5616,4658,120.6,10010,5435,4575,118.8
38005, 면부,055003, 52세,2021,10844,5896,4948,119.2,10568,5742,4826,119
38005, 면부,055004, 53세,2021,11154,5859,5295,110.7,10927,5718,5209,109.8
38005, 면부,055005, 54세,2021,10981,5721,5260,108.8,10773,5601,5172,108.3
38005, 면부,060,55~59세,2021,58579,30625,27954,109.6,57707,30165,27542,109.5
38005, 면부,060001, 55세,2021,11172,6044,5128,117.9,10987,5935,5052,117.5
38005, 면부,060002, 56세,2021,11591,6056,5535,109.4,11401,5963,5438,109.7
38005, 면부,060003, 57세,2021,10426,5328,5098,104.5,10258,5240,5018,104.4
38005, 면부,060004, 58세,2021,11872,6236,5636,110.6,11691,6148,5543,110.9
38005, 면부,060005, 59세,2021,13518,6961,6557,106.2,13370,6879,6491,106
38005, 면부,065,60~64세,2021,72302,36877,35425,104.1,71794,36618,35176,104.1
38005, 면부,065001, 60세,2021,15651,7902,7749,102,15548,7855,7693,102.1
38005, 면부,065002, 61세,2021,15628,7831,7797,100.4,15504,7756,7748,100.1
38005, 면부,065003, 62세,2021,13865,7110,6755,105.3,13771,7069,6702,105.5
38005, 면부,065004, 63세,2021,13291,6892,6399,107.7,13185,6835,6350,107.6
38005, 면부,065005, 64세,2021,13867,7142,6725,106.2,13786,7103,6683,106.3
38005, 면부,070,65~69세,2021,58741,29436,29305,100.4,58490,29303,29187,100.4
38005, 면부,070001, 65세,2021,12895,6648,6247,106.4,12818,6606,6212,106.3
38005, 면부,070002, 66세,2021,13341,6619,6722,98.5,13271,6580,6691,98.3
38005, 면부,070003, 67세,2021,11126,5584,5542,100.8,11083,5566,5517,100.9
38005, 면부,070004, 68세,2021,10133,5012,5121,97.9,10096,4992,5104,97.8
38005, 면부,070005, 69세,2021,11246,5573,5673,98.2,11222,5559,5663,98.2
38005, 면부,075,70~74세,2021,45471,21870,23601,92.7,45368,21822,23546,92.7
38005, 면부,075001, 70세,2021,8983,4370,4613,94.7,8956,4357,4599,94.7
38005, 면부,075002, 71세,2021,9060,4414,4646,95,9031,4401,4630,95.1
38005, 면부,075003, 72세,2021,9375,4605,4770,96.5,9351,4593,4758,96.5
38005, 면부,075004, 73세,2021,9244,4428,4816,91.9,9231,4421,4810,91.9
38005, 면부,075005, 74세,2021,8809,4053,4756,85.2,8799,4050,4749,85.3
38005, 면부,080,75~79세,2021,37433,15028,22405,67.1,37394,15016,22378,67.1
38005, 면부,080001, 75세,2021,6444,2895,3549,81.6,6437,2892,3545,81.6
38005, 면부,080002, 76세,2021,6734,2834,3900,72.7,6723,2831,3892,72.7
38005, 면부,080003, 77세,2021,7407,2968,4439,66.9,7401,2965,4436,66.8
38005, 면부,080004, 78세,2021,7706,2954,4752,62.2,7697,2953,4744,62.2
38005, 면부,080005, 79세,2021,9142,3377,5765,58.6,9136,3375,5761,58.6
38005, 면부,085,80~84세,2021,34705,11525,23180,49.7,34676,11517,23159,49.7
38005, 면부,085001, 80세,2021,7948,2875,5073,56.7,7941,2873,5068,56.7
38005, 면부,085002, 81세,2021,7417,2507,4910,51.1,7409,2504,4905,51
38005, 면부,085003, 82세,2021,7221,2339,4882,47.9,7216,2338,4878,47.9
38005, 면부,085004, 83세,2021,6209,1982,4227,46.9,6202,1980,4222,46.9
38005, 면부,085005, 84세,2021,5910,1822,4088,44.6,5908,1822,4086,44.6
38005, 면부,090,85~89세,2021,20079,5306,14773,35.9,20072,5305,14767,35.9
38005, 면부,090001, 85세,2021,5256,1552,3704,41.9,5256,1552,3704,41.9
38005, 면부,090002, 86세,2021,4710,1298,3412,38,4708,1298,3410,38.1
38005, 면부,090003, 87세,2021,4103,1067,3036,35.1,4101,1067,3034,35.2
38005, 면부,090004, 88세,2021,3255,769,2486,30.9,3253,768,2485,30.9
38005, 면부,090005, 89세,2021,2755,620,2135,29,2754,620,2134,29.1
38005, 면부,095,90~94세,2021,6577,1295,5282,24.5,6576,1295,5281,24.5
38005, 면부,095001, 90세,2021,1991,424,1567,27.1,1991,424,1567,27.1
38005, 면부,095002, 91세,2021,1621,303,1318,23,1621,303,1318,23
38005, 면부,095003, 92세,2021,1314,266,1048,25.4,1314,266,1048,25.4
38005, 면부,095004, 93세,2021,966,179,787,22.7,966,179,787,22.7
38005, 면부,095005, 94세,2021,685,123,562,21.9,684,123,561,21.9
38005, 면부,100,95~99세,2021,1265,189,1076,17.6,1264,188,1076,17.5
38005, 면부,100001, 95세,2021,477,89,388,22.9,477,89,388,22.9
38005, 면부,100002, 96세,2021,330,32,298,10.7,330,32,298,10.7
38005, 면부,100003, 97세,2021,185,29,156,18.6,185,29,156,18.6
38005, 면부,100004, 98세,2021,167,26,141,18.4,166,25,141,17.7
38005, 면부,100005, 99세,2021,106,13,93,14,106,13,93,14
38005, 면부,101,100세이상,2021,153,21,132,15.9,152,20,132,15.2
38005, 면부,102,15세미만,2021,63866,33073,30793,107.4,63410,32849,30561,107.5
38005, 면부,103,15~64세,2021,412960,229415,183545,125,383225,207011,176214,117.5
38005, 면부,104,65세이상,2021,204424,84670,119754,70.7,203992,84466,119526,70.7
38005, 면부,086,85세이상,2021,28074,6811,21263,32,28064,6808,21256,32
38005, 면부,126,평균연령,2021,51,48.3,53.8,,51.7,49.2,54.2,
38005, 면부,127,중위연령,2021,54.5,51.3,58.1,,55.7,53.1,58.6,
38003, 동부,000,합계,2021,2123553,1077795,1045758,103.1,2074724,1048935,1025789,102.3
38003, 동부,005,0~4세,2021,66074,34028,32046,106.2,65165,33569,31596,106.2
38003, 동부,005001, 0세,2021,10800,5558,5242,106,10641,5476,5165,106
38003, 동부,005002, 1세,2021,11473,5847,5626,103.9,11295,5759,5536,104
38003, 동부,005003, 2세,2021,12950,6676,6274,106.4,12773,6580,6193,106.2
38003, 동부,005004, 3세,2021,14372,7489,6883,108.8,14172,7387,6785,108.9
38003, 동부,005005, 4세,2021,16479,8458,8021,105.4,16284,8367,7917,105.7
38003, 동부,010,5~9세,2021,102779,52792,49987,105.6,101911,52344,49567,105.6
38003, 동부,010001, 5세,2021,18879,9640,9239,104.3,18668,9528,9140,104.2
38003, 동부,010002, 6세,2021,20143,10370,9773,106.1,19953,10268,9685,106
38003, 동부,010003, 7세,2021,20402,10556,9846,107.2,20231,10473,9758,107.3
38003, 동부,010004, 8세,2021,20571,10543,10028,105.1,20417,10463,9954,105.1
38003, 동부,010005, 9세,2021,22784,11683,11101,105.2,22642,11612,11030,105.3
38003, 동부,015,10~14세,2021,110126,56734,53392,106.3,109636,56473,53163,106.2
38003, 동부,015001, 10세,2021,22418,11501,10917,105.3,22322,11446,10876,105.2
38003, 동부,015002, 11세,2021,21701,11244,10457,107.5,21593,11190,10403,107.6
38003, 동부,015003, 12세,2021,20992,10926,10066,108.5,20886,10873,10013,108.6
38003, 동부,015004, 13세,2021,22165,11314,10851,104.3,22079,11267,10812,104.2
38003, 동부,015005, 14세,2021,22850,11749,11101,105.8,22756,11697,11059,105.8
38003, 동부,020,15~19세,2021,103755,55177,48578,113.6,103044,54850,48194,113.8
38003, 동부,020001, 15세,2021,20691,10802,9889,109.2,20604,10762,9842,109.3
38003, 동부,020002, 16세,2021,19935,10461,9474,110.4,19885,10435,9450,110.4
38003, 동부,020003, 17세,2021,21556,11334,10222,110.9,21490,11304,10186,111
38003, 동부,020004, 18세,2021,21432,11392,10040,113.5,21309,11332,9977,113.6
38003, 동부,020005, 19세,2021,20141,11188,8953,125,19756,11017,8739,126.1
38003, 동부,025,20~24세,2021,127786,72814,54972,132.5,123592,70523,53069,132.9
38003, 동부,025001, 20세,2021,23671,13662,10009,136.5,23141,13389,9752,137.3
38003, 동부,025002, 21세,2021,26734,15464,11270,137.2,26092,15148,10944,138.4
38003, 동부,025003, 22세,2021,25442,14393,11049,130.3,24631,13959,10672,130.8
38003, 동부,025004, 23세,2021,25788,14558,11230,129.6,24721,13966,10755,129.9
38003, 동부,025005, 24세,2021,26151,14737,11414,129.1,25007,14061,10946,128.5
38003, 동부,030,25~29세,2021,133723,74645,59078,126.3,126610,70294,56316,124.8
38003, 동부,030001, 25세,2021,26932,15315,11617,131.8,25687,14548,11139,130.6
38003, 동부,030002, 26세,2021,26545,14933,11612,128.6,25227,14107,11120,126.9
38003, 동부,030003, 27세,2021,26566,14801,11765,125.8,25135,13940,11195,124.5
38003, 동부,030004, 28세,2021,26857,14932,11925,125.2,25363,14016,11347,123.5
38003, 동부,030005, 29세,2021,26823,14664,12159,120.6,25198,13683,11515,118.8
38003, 동부,035,30~34세,2021,123999,67149,56850,118.1,115187,61570,53617,114.8
38003, 동부,035001, 30세,2021,25544,13904,11640,119.5,23892,12871,11021,116.8
38003, 동부,035002, 31세,2021,24898,13723,11175,122.8,23117,12570,10547,119.2
38003, 동부,035003, 32세,2021,24512,13378,11134,120.2,22732,12272,10460,117.3
38003, 동부,035004, 33세,2021,24110,12973,11137,116.5,22370,11866,10504,113
38003, 동부,035005, 34세,2021,24935,13171,11764,112,23076,11991,11085,108.2
38003, 동부,040,35~39세,2021,148525,77937,70588,110.4,140915,73003,67912,107.5
38003, 동부,040001, 35세,2021,25618,13739,11879,115.7,23913,12634,11279,112
38003, 동부,040002, 36세,2021,26937,14270,12667,112.7,25305,13222,12083,109.4
38003, 동부,040003, 37세,2021,28616,14994,13622,110.1,27081,13987,13094,106.8
38003, 동부,040004, 38세,2021,32125,16817,15308,109.9,30697,15869,14828,107
38003, 동부,040005, 39세,2021,35229,18117,17112,105.9,33919,17291,16628,104
38003, 동부,045,40~44세,2021,174803,89694,85109,105.4,169659,86466,83193,103.9
38003, 동부,045001, 40세,2021,35955,18705,17250,108.4,34737,17915,16822,106.5
38003, 동부,045002, 41세,2021,37408,19030,18378,103.5,36343,18332,18011,101.8
38003, 동부,045003, 42세,2021,35420,18191,17229,105.6,34345,17531,16814,104.3
38003, 동부,045004, 43세,2021,32789,16887,15902,106.2,31823,16312,15511,105.2
38003, 동부,045005, 44세,2021,33231,16881,16350,103.2,32411,16376,16035,102.1
38003, 동부,050,45~49세,2021,184782,92944,91838,101.2,180832,90561,90271,100.3
38003, 동부,050001, 45세,2021,32753,16604,16149,102.8,31899,16053,15846,101.3
38003, 동부,050002, 46세,2021,35298,17579,17719,99.2,34460,17081,17379,98.3
38003, 동부,050003, 47세,2021,38448,19228,19220,100,37690,18774,18916,99.2
38003, 동부,050004, 48세,2021,39759,19821,19938,99.4,39034,19396,19638,98.8
38003, 동부,050005, 49세,2021,38524,19712,18812,104.8,37749,19257,18492,104.1
38003, 동부,055,50~54세,2021,201242,100137,101105,99,197784,98272,99512,98.8
38003, 동부,055001, 50세,2021,41758,20964,20794,100.8,40965,20510,20455,100.3
38003, 동부,055002, 51세,2021,40840,20429,20411,100.1,40099,20007,20092,99.6
38003, 동부,055003, 52세,2021,40693,20310,20383,99.6,40018,19955,20063,99.5
38003, 동부,055004, 53세,2021,40610,20024,20586,97.3,39950,19681,20269,97.1
38003, 동부,055005, 54세,2021,37341,18410,18931,97.2,36752,18119,18633,97.2
38003, 동부,060,55~59세,2021,174810,88621,86189,102.8,172119,87206,84913,102.7
38003, 동부,060001, 55세,2021,36139,18609,17530,106.2,35603,18330,17273,106.1
38003, 동부,060002, 56세,2021,36107,17927,18180,98.6,35542,17618,17924,98.3
38003, 동부,060003, 57세,2021,31556,15880,15676,101.3,31039,15625,15414,101.4
38003, 동부,060004, 58세,2021,34922,18018,16904,106.6,34348,17705,16643,106.4
38003, 동부,060005, 59세,2021,36086,18187,17899,101.6,35587,17928,17659,101.5
38003, 동부,065,60~64세,2021,167377,82956,84421,98.3,165908,82228,83680,98.3
38003, 동부,065001, 60세,2021,38571,18996,19575,97,38239,18837,19402,97.1
38003, 동부,065002, 61세,2021,37242,18356,18886,97.2,36862,18173,18689,97.2
38003, 동부,065003, 62세,2021,32430,16221,16209,100.1,32157,16080,16077,100
38003, 동부,065004, 63세,2021,30034,14958,15076,99.2,29768,14830,14938,99.3
38003, 동부,065005, 64세,2021,29100,14425,14675,98.3,28882,14308,14574,98.2
38003, 동부,070,65~69세,2021,115304,55691,59613,93.4,114500,55337,59163,93.5
38003, 동부,070001, 65세,2021,26482,12849,13633,94.2,26257,12750,13507,94.4
38003, 동부,070002, 66세,2021,27163,12968,14195,91.4,26985,12879,14106,91.3
38003, 동부,070003, 67세,2021,22220,11012,11208,98.3,22054,10947,11107,98.6
38003, 동부,070004, 68세,2021,18954,9095,9859,92.3,18824,9037,9787,92.3
38003, 동부,070005, 69세,2021,20485,9767,10718,91.1,20380,9724,10656,91.3
38003, 동부,075,70~74세,2021,76311,35385,40926,86.5,75975,35236,40739,86.5
38003, 동부,075001, 70세,2021,15826,7419,8407,88.2,15743,7381,8362,88.3
38003, 동부,075002, 71세,2021,15712,7415,8297,89.4,15634,7379,8255,89.4
38003, 동부,075003, 72세,2021,15519,7184,8335,86.2,15444,7149,8295,86.2
38003, 동부,075004, 73세,2021,15228,7071,8157,86.7,15184,7050,8134,86.7
38003, 동부,075005, 74세,2021,14026,6296,7730,81.4,13970,6277,7693,81.6
38003, 동부,080,75~79세,2021,51230,21844,29386,74.3,51094,21796,29298,74.4
38003, 동부,080001, 75세,2021,10062,4569,5493,83.2,10030,4557,5473,83.3
38003, 동부,080002, 76세,2021,9960,4403,5557,79.2,9925,4391,5534,79.3
38003, 동부,080003, 77세,2021,10197,4364,5833,74.8,10168,4356,5812,74.9
38003, 동부,080004, 78세,2021,10180,4189,5991,69.9,10160,4178,5982,69.8
38003, 동부,080005, 79세,2021,10831,4319,6512,66.3,10811,4314,6497,66.4
38003, 동부,085,80~84세,2021,35932,12923,23009,56.2,35845,12895,22950,56.2
38003, 동부,085001, 80세,2021,8834,3421,5413,63.2,8814,3414,5400,63.2
38003, 동부,085002, 81세,2021,7912,2902,5010,57.9,7893,2895,4998,57.9
38003, 동부,085003, 82세,2021,7421,2637,4784,55.1,7402,2631,4771,55.1
38003, 동부,085004, 83세,2021,6094,2081,4013,51.9,6073,2077,3996,52
38003, 동부,085005, 84세,2021,5671,1882,3789,49.7,5663,1878,3785,49.6
38003, 동부,090,85~89세,2021,18028,5008,13020,38.5,17991,4997,12994,38.5
38003, 동부,090001, 85세,2021,4967,1524,3443,44.3,4954,1519,3435,44.2
38003, 동부,090002, 86세,2021,4356,1294,3062,42.3,4345,1291,3054,42.3
38003, 동부,090003, 87세,2021,3566,942,2624,35.9,3558,940,2618,35.9
38003, 동부,090004, 88세,2021,2741,710,2031,35,2738,709,2029,34.9
38003, 동부,090005, 89세,2021,2398,538,1860,28.9,2396,538,1858,29
38003, 동부,095,90~94세,2021,5771,1124,4647,24.2,5764,1123,4641,24.2
38003, 동부,095001, 90세,2021,1806,368,1438,25.6,1804,367,1437,25.5
38003, 동부,095002, 91세,2021,1430,257,1173,21.9,1428,257,1171,21.9
38003, 동부,095003, 92세,2021,1155,238,917,26,1154,238,916,26
38003, 동부,095004, 93세,2021,810,158,652,24.2,809,158,651,24.3
38003, 동부,095005, 94세,2021,570,103,467,22.1,569,103,466,22.1
38003, 동부,100,95~99세,2021,1064,170,894,19,1061,170,891,19.1
38003, 동부,100001, 95세,2021,356,59,297,19.9,355,59,296,19.9
38003, 동부,100002, 96세,2021,304,50,254,19.7,303,50,253,19.8
38003, 동부,100003, 97세,2021,165,21,144,14.6,164,21,143,14.7
38003, 동부,100004, 98세,2021,156,24,132,18.2,156,24,132,18.2
38003, 동부,100005, 99세,2021,83,16,67,23.9,83,16,67,23.9
38003, 동부,101,100세이상,2021,132,22,110,20,132,22,110,20
38003, 동부,102,15세미만,2021,278979,143554,135425,106,276712,142386,134326,106
38003, 동부,103,15~64세,2021,1540802,802074,738728,108.6,1495650,774973,720677,107.5
38003, 동부,104,65세이상,2021,303772,132167,171605,77,302362,131576,170786,77
38003, 동부,086,85세이상,2021,24995,6324,18671,33.9,24948,6312,18636,33.9
38003, 동부,126,평균연령,2021,42.4,41.1,43.7,,42.5,41.3,43.8,
38003, 동부,127,중위연령,2021,44.1,42.5,45.8,,44.4,42.9,46,
38030, 진주시,000,합계,2021,353389,175897,177492,99.1,347206,172422,174784,98.6
38030, 진주시,005,0~4세,2021,10719,5540,5179,107,10652,5501,5151,106.8
38030, 진주시,005001, 0세,2021,1778,950,828,114.7,1766,942,824,114.3
38030, 진주시,005002, 1세,2021,1883,939,944,99.5,1864,930,934,99.6
38030, 진주시,005003, 2세,2021,2114,1044,1070,97.6,2102,1037,1065,97.4
38030, 진주시,005004, 3세,2021,2370,1263,1107,114.1,2356,1256,1100,114.2
38030, 진주시,005005, 4세,2021,2574,1344,1230,109.3,2564,1336,1228,108.8
38030, 진주시,010,5~9세,2021,16167,8376,7791,107.5,16117,8346,7771,107.4
38030, 진주시,010001, 5세,2021,2963,1535,1428,107.5,2945,1523,1422,107.1
38030, 진주시,010002, 6세,2021,3171,1609,1562,103,3164,1603,1561,102.7
38030, 진주시,010003, 7세,2021,3355,1737,1618,107.4,3341,1727,1614,107
38030, 진주시,010004, 8세,2021,3161,1698,1463,116.1,3157,1697,1460,116.2
38030, 진주시,010005, 9세,2021,3517,1797,1720,104.5,3510,1796,1714,104.8
38030, 진주시,015,10~14세,2021,17234,9030,8204,110.1,17213,9017,8196,110
38030, 진주시,015001, 10세,2021,3519,1877,1642,114.3,3514,1873,1641,114.1
38030, 진주시,015002, 11세,2021,3412,1809,1603,112.9,3407,1807,1600,112.9
38030, 진주시,015003, 12세,2021,3252,1715,1537,111.6,3249,1713,1536,111.5
38030, 진주시,015004, 13세,2021,3506,1825,1681,108.6,3502,1822,1680,108.5
38030, 진주시,015005, 14세,2021,3545,1804,1741,103.6,3541,1802,1739,103.6
38030, 진주시,020,15~19세,2021,18172,9687,8485,114.2,18130,9672,8458,114.4
38030, 진주시,020001, 15세,2021,3240,1706,1534,111.2,3238,1704,1534,111.1
38030, 진주시,020002, 16세,2021,3119,1643,1476,111.3,3119,1643,1476,111.3
38030, 진주시,020003, 17세,2021,3555,1933,1622,119.2,3549,1930,1619,119.2
38030, 진주시,020004, 18세,2021,3733,1980,1753,112.9,3719,1977,1742,113.5
38030, 진주시,020005, 19세,2021,4525,2425,2100,115.5,4505,2418,2087,115.9
38030, 진주시,025,20~24세,2021,26089,14230,11859,120,25270,13807,11463,120.4
38030, 진주시,025001, 20세,2021,4668,2298,2370,97,4577,2269,2308,98.3
38030, 진주시,025002, 21세,2021,5376,2810,2566,109.5,5233,2729,2504,109
38030, 진주시,025003, 22세,2021,5389,2965,2424,122.3,5259,2898,2361,122.7
38030, 진주시,025004, 23세,2021,5469,3175,2294,138.4,5238,3043,2195,138.6
38030, 진주시,025005, 24세,2021,5187,2982,2205,135.2,4963,2868,2095,136.9
38030, 진주시,030,25~29세,2021,23421,13080,10341,126.5,22196,12378,9818,126.1
38030, 진주시,030001, 25세,2021,4974,2881,2093,137.6,4755,2754,2001,137.6
38030, 진주시,030002, 26세,2021,4707,2642,2065,127.9,4475,2503,1972,126.9
38030, 진주시,030003, 27세,2021,4633,2572,2061,124.8,4368,2420,1948,124.2
38030, 진주시,030004, 28세,2021,4647,2570,2077,123.7,4381,2423,1958,123.7
38030, 진주시,030005, 29세,2021,4460,2415,2045,118.1,4217,2278,1939,117.5
38030, 진주시,035,30~34세,2021,19895,10700,9195,116.4,18689,9977,8712,114.5
38030, 진주시,035001, 30세,2021,4092,2216,1876,118.1,3844,2068,1776,116.4
38030, 진주시,035002, 31세,2021,3995,2195,1800,121.9,3742,2043,1699,120.2
38030, 진주시,035003, 32세,2021,4016,2223,1793,124,3782,2082,1700,122.5
38030, 진주시,035004, 33세,2021,3807,2061,1746,118,3576,1921,1655,116.1
38030, 진주시,035005, 34세,2021,3985,2005,1980,101.3,3745,1863,1882,99
38030, 진주시,040,35~39세,2021,22300,11285,11015,102.5,21346,10670,10676,99.9
38030, 진주시,040001, 35세,2021,4046,2106,1940,108.6,3826,1959,1867,104.9
38030, 진주시,040002, 36세,2021,3966,2049,1917,106.9,3759,1927,1832,105.2
38030, 진주시,040003, 37세,2021,4311,2150,2161,99.5,4128,2038,2090,97.5
38030, 진주시,040004, 38세,2021,4776,2380,2396,99.3,4600,2255,2345,96.2
38030, 진주시,040005, 39세,2021,5201,2600,2601,100,5033,2491,2542,98
38030, 진주시,045,40~44세,2021,25516,12741,12775,99.7,24955,12427,12528,99.2
38030, 진주시,045001, 40세,2021,5162,2555,2607,98,5013,2473,2540,97.4
38030, 진주시,045002, 41세,2021,5377,2719,2658,102.3,5256,2656,2600,102.2
38030, 진주시,045003, 42세,2021,5234,2641,2593,101.9,5115,2580,2535,101.8
38030, 진주시,045004, 43세,2021,4873,2427,2446,99.2,4786,2375,2411,98.5
38030, 진주시,045005, 44세,2021,4870,2399,2471,97.1,4785,2343,2442,95.9
38030, 진주시,050,45~49세,2021,27720,13878,13842,100.3,27334,13675,13659,100.1
38030, 진주시,050001, 45세,2021,5045,2515,2530,99.4,4949,2458,2491,98.7
38030, 진주시,050002, 46세,2021,5172,2568,2604,98.6,5094,2529,2565,98.6
38030, 진주시,050003, 47세,2021,5743,2847,2896,98.3,5675,2812,2863,98.2
38030, 진주시,050004, 48세,2021,6015,3024,2991,101.1,5950,2993,2957,101.2
38030, 진주시,050005, 49세,2021,5745,2924,2821,103.7,5666,2883,2783,103.6
38030, 진주시,055,50~54세,2021,30521,15078,15443,97.6,30196,14917,15279,97.6
38030, 진주시,055001, 50세,2021,6134,3070,3064,100.2,6066,3033,3033,100
38030, 진주시,055002, 51세,2021,6262,3051,3211,95,6205,3022,3183,94.9
38030, 진주시,055003, 52세,2021,6317,3154,3163,99.7,6244,3116,3128,99.6
38030, 진주시,055004, 53세,2021,6156,3082,3074,100.3,6091,3051,3040,100.4
38030, 진주시,055005, 54세,2021,5652,2721,2931,92.8,5590,2695,2895,93.1
38030, 진주시,060,55~59세,2021,26561,13211,13350,99,26305,13097,13208,99.2
38030, 진주시,060001, 55세,2021,5474,2826,2648,106.7,5417,2794,2623,106.5
38030, 진주시,060002, 56세,2021,5420,2651,2769,95.7,5365,2629,2736,96.1
38030, 진주시,060003, 57세,2021,4641,2238,2403,93.1,4584,2218,2366,93.7
38030, 진주시,060004, 58세,2021,5330,2678,2652,101,5285,2658,2627,101.2
38030, 진주시,060005, 59세,2021,5696,2818,2878,97.9,5654,2798,2856,98
38030, 진주시,065,60~64세,2021,28072,13564,14508,93.5,27935,13503,14432,93.6
38030, 진주시,065001, 60세,2021,6653,3199,3454,92.6,6632,3192,3440,92.8
38030, 진주시,065002, 61세,2021,6188,2918,3270,89.2,6149,2901,3248,89.3
38030, 진주시,065003, 62세,2021,5163,2523,2640,95.6,5139,2513,2626,95.7
38030, 진주시,065004, 63세,2021,5098,2456,2642,93,5066,2441,2625,93
38030, 진주시,065005, 64세,2021,4970,2468,2502,98.6,4949,2456,2493,98.5
38030, 진주시,070,65~69세,2021,20401,9678,10723,90.3,20325,9647,10678,90.3
38030, 진주시,070001, 65세,2021,4569,2265,2304,98.3,4547,2255,2292,98.4
38030, 진주시,070002, 66세,2021,4753,2176,2577,84.4,4738,2167,2571,84.3
38030, 진주시,070003, 67세,2021,4067,2002,2065,96.9,4052,1999,2053,97.4
38030, 진주시,070004, 68세,2021,3375,1567,1808,86.7,3365,1563,1802,86.7
38030, 진주시,070005, 69세,2021,3637,1668,1969,84.7,3623,1663,1960,84.8
38030, 진주시,075,70~74세,2021,14825,6762,8063,83.9,14790,6741,8049,83.7
38030, 진주시,075001, 70세,2021,2881,1329,1552,85.6,2870,1321,1549,85.3
38030, 진주시,075002, 71세,2021,3136,1449,1687,85.9,3126,1446,1680,86.1
38030, 진주시,075003, 72세,2021,3029,1353,1676,80.7,3023,1348,1675,80.5
38030, 진주시,075004, 73세,2021,2984,1354,1630,83.1,2982,1353,1629,83.1
38030, 진주시,075005, 74세,2021,2795,1277,1518,84.1,2789,1273,1516,84
38030, 진주시,080,75~79세,2021,10981,4611,6370,72.4,10970,4606,6364,72.4
38030, 진주시,080001, 75세,2021,2122,956,1166,82,2119,954,1165,81.9
38030, 진주시,080002, 76세,2021,2144,952,1192,79.9,2140,950,1190,79.8
38030, 진주시,080003, 77세,2021,2192,896,1296,69.1,2191,896,1295,69.2
38030, 진주시,080004, 78세,2021,2197,906,1291,70.2,2197,906,1291,70.2
38030, 진주시,080005, 79세,2021,2326,901,1425,63.2,2323,900,1423,63.2
38030, 진주시,085,80~84세,2021,8462,2953,5509,53.6,8455,2951,5504,53.6
38030, 진주시,085001, 80세,2021,2059,795,1264,62.9,2055,793,1262,62.8
38030, 진주시,085002, 81세,2021,1903,682,1221,55.9,1903,682,1221,55.9
38030, 진주시,085003, 82세,2021,1716,584,1132,51.6,1714,584,1130,51.7
38030, 진주시,085004, 83세,2021,1458,465,993,46.8,1457,465,992,46.9
38030, 진주시,085005, 84세,2021,1326,427,899,47.5,1326,427,899,47.5
38030, 진주시,090,85~89세,2021,4512,1161,3351,34.6,4507,1158,3349,34.6
38030, 진주시,090001, 85세,2021,1227,346,881,39.3,1223,344,879,39.1
38030, 진주시,090002, 86세,2021,1076,294,782,37.6,1076,294,782,37.6
38030, 진주시,090003, 87세,2021,927,239,688,34.7,926,238,688,34.6
38030, 진주시,090004, 88세,2021,669,141,528,26.7,669,141,528,26.7
38030, 진주시,090005, 89세,2021,613,141,472,29.9,613,141,472,29.9
38030, 진주시,095,90~94세,2021,1473,280,1193,23.5,1473,280,1193,23.5
38030, 진주시,095001, 90세,2021,448,97,351,27.6,448,97,351,27.6
38030, 진주시,095002, 91세,2021,358,60,298,20.1,358,60,298,20.1
38030, 진주시,095003, 92세,2021,289,62,227,27.3,289,62,227,27.3
38030, 진주시,095004, 93세,2021,217,39,178,21.9,217,39,178,21.9
38030, 진주시,095005, 94세,2021,161,22,139,15.8,161,22,139,15.8
38030, 진주시,100,95~99세,2021,306,46,260,17.7,306,46,260,17.7
38030, 진주시,100001, 95세,2021,96,17,79,21.5,96,17,79,21.5
38030, 진주시,100002, 96세,2021,102,14,88,15.9,102,14,88,15.9
38030, 진주시,100003, 97세,2021,41,6,35,17.1,41,6,35,17.1
38030, 진주시,100004, 98세,2021,38,5,33,15.2,38,5,33,15.2
38030, 진주시,100005, 99세,2021,29,X,25,16,29,X,25,16
38030, 진주시,101,100세이상,2021,42,6,36,16.7,42,6,36,16.7
38030, 진주시,102,15세미만,2021,44120,22946,21174,108.4,43982,22864,21118,108.3
38030, 진주시,103,15~64세,2021,248267,127454,120813,105.5,242356,124123,118233,105
38030, 진주시,104,65세이상,2021,61002,25497,35505,71.8,60868,25435,35433,71.8
38030, 진주시,086,85세이상,2021,6333,1493,4840,30.8,6328,1490,4838,30.8
38030, 진주시,126,평균연령,2021,43.1,41.4,44.8,,43.3,41.5,45,
38030, 진주시,127,중위연령,2021,44.4,42.3,46.5,,44.8,42.7,46.8,
38050, 통영시,000,합계,2021,124829,64225,60604,106,120018,60346,59672,101.1
38050, 통영시,005,0~4세,2021,2920,1436,1484,96.8,2914,1432,1482,96.6
38050, 통영시,005001, 0세,2021,430,196,234,83.8,430,196,234,83.8
38050, 통영시,005002, 1세,2021,467,234,233,100.4,466,233,233,100
38050, 통영시,005003, 2세,2021,530,283,247,114.6,530,283,247,114.6
38050, 통영시,005004, 3세,2021,663,322,341,94.4,659,320,339,94.4
38050, 통영시,005005, 4세,2021,830,401,429,93.5,829,400,429,93.2
38050, 통영시,010,5~9세,2021,5723,2905,2818,103.1,5716,2900,2816,103
38050, 통영시,010001, 5세,2021,948,486,462,105.2,948,486,462,105.2
38050, 통영시,010002, 6세,2021,1121,553,568,97.4,1121,553,568,97.4
38050, 통영시,010003, 7세,2021,1128,576,552,104.3,1128,576,552,104.3
38050, 통영시,010004, 8세,2021,1182,621,561,110.7,1175,616,559,110.2
38050, 통영시,010005, 9세,2021,1344,669,675,99.1,1344,669,675,99.1
38050, 통영시,015,10~14세,2021,6779,3454,3325,103.9,6772,3448,3324,103.7
38050, 통영시,015001, 10세,2021,1399,697,702,99.3,1398,696,702,99.1
38050, 통영시,015002, 11세,2021,1396,724,672,107.7,1395,723,672,107.6
38050, 통영시,015003, 12세,2021,1300,681,619,110,1298,679,619,109.7
38050, 통영시,015004, 13세,2021,1355,676,679,99.6,1354,676,678,99.7
38050, 통영시,015005, 14세,2021,1329,676,653,103.5,1327,674,653,103.2
38050, 통영시,020,15~19세,2021,5176,2791,2385,117,5164,2785,2379,117.1
38050, 통영시,020001, 15세,2021,1119,592,527,112.3,1115,591,524,112.8
38050, 통영시,020002, 16세,2021,1121,576,545,105.7,1120,576,544,105.9
38050, 통영시,020003, 17세,2021,1114,577,537,107.4,1111,575,536,107.3
38050, 통영시,020004, 18세,2021,1080,563,517,108.9,1079,563,516,109.1
38050, 통영시,020005, 19세,2021,742,483,259,186.5,739,480,259,185.3
38050, 통영시,025,20~24세,2021,4995,3201,1794,178.4,4694,2955,1739,169.9
38050, 통영시,025001, 20세,2021,922,639,283,225.8,914,633,281,225.3
38050, 통영시,025002, 21세,2021,1071,707,364,194.2,1046,690,356,193.8
38050, 통영시,025003, 22세,2021,970,633,337,187.8,921,591,330,179.1
38050, 통영시,025004, 23세,2021,978,582,396,147,891,518,373,138.9
38050, 통영시,025005, 24세,2021,1054,640,414,154.6,922,523,399,131.1
38050, 통영시,030,25~29세,2021,5565,3344,2221,150.6,4567,2476,2091,118.4
38050, 통영시,030001, 25세,2021,1169,705,464,151.9,989,544,445,122.2
38050, 통영시,030002, 26세,2021,1109,706,403,175.2,937,556,381,145.9
38050, 통영시,030003, 27세,2021,1024,626,398,157.3,822,449,373,120.4
38050, 통영시,030004, 28세,2021,1103,631,472,133.7,887,448,439,102.1
38050, 통영시,030005, 29세,2021,1160,676,484,139.7,932,479,453,105.7
38050, 통영시,035,30~34세,2021,5823,3339,2484,134.4,4769,2442,2327,104.9
38050, 통영시,035001, 30세,2021,1080,617,463,133.3,884,451,433,104.2
38050, 통영시,035002, 31세,2021,1163,667,496,134.5,925,463,462,100.2
38050, 통영시,035003, 32세,2021,1137,670,467,143.5,932,497,435,114.3
38050, 통영시,035004, 33세,2021,1173,688,485,141.9,958,501,457,109.6
38050, 통영시,035005, 34세,2021,1270,697,573,121.6,1070,530,540,98.1
38050, 통영시,040,35~39세,2021,8256,4550,3706,122.8,7305,3732,3573,104.5
38050, 통영시,040001, 35세,2021,1274,734,540,135.9,1094,583,511,114.1
38050, 통영시,040002, 36세,2021,1437,794,643,123.5,1216,596,620,96.1
38050, 통영시,040003, 37세,2021,1672,936,736,127.2,1476,770,706,109.1
38050, 통영시,040004, 38세,2021,1799,961,838,114.7,1620,809,811,99.8
38050, 통영시,040005, 39세,2021,2074,1125,949,118.5,1899,974,925,105.3
38050, 통영시,045,40~44세,2021,10423,5652,4771,118.5,9849,5178,4671,110.9
38050, 통영시,045001, 40세,2021,2098,1125,973,115.6,1954,1000,954,104.8
38050, 통영시,045002, 41세,2021,2326,1274,1052,121.1,2202,1172,1030,113.8
38050, 통영시,045003, 42세,2021,2069,1126,943,119.4,1957,1035,922,112.3
38050, 통영시,045004, 43세,2021,1944,1062,882,120.4,1842,974,868,112.2
38050, 통영시,045005, 44세,2021,1986,1065,921,115.6,1894,997,897,111.1
38050, 통영시,050,45~49세,2021,10530,5749,4781,120.2,10195,5508,4687,117.5
38050, 통영시,050001, 45세,2021,1901,1054,847,124.4,1818,990,828,119.6
38050, 통영시,050002, 46세,2021,2122,1161,961,120.8,2041,1104,937,117.8
38050, 통영시,050003, 47세,2021,2126,1168,958,121.9,2073,1134,939,120.8
38050, 통영시,050004, 48세,2021,2207,1187,1020,116.4,2146,1144,1002,114.2
38050, 통영시,050005, 49세,2021,2174,1179,995,118.5,2117,1136,981,115.8
38050, 통영시,055,50~54세,2021,11058,5860,5198,112.7,10823,5703,5120,111.4
38050, 통영시,055001, 50세,2021,2259,1205,1054,114.3,2211,1170,1041,112.4
38050, 통영시,055002, 51세,2021,2255,1238,1017,121.7,2203,1196,1007,118.8
38050, 통영시,055003, 52세,2021,2171,1136,1035,109.8,2132,1115,1017,109.6
38050, 통영시,055004, 53세,2021,2275,1209,1066,113.4,2221,1172,1049,111.7
38050, 통영시,055005, 54세,2021,2098,1072,1026,104.5,2056,1050,1006,104.4
38050, 통영시,060,55~59세,2021,10308,5192,5116,101.5,10129,5104,5025,101.6
38050, 통영시,060001, 55세,2021,1996,1007,989,101.8,1970,990,980,101
38050, 통영시,060002, 56세,2021,2034,1033,1001,103.2,1988,1013,975,103.9
38050, 통영시,060003, 57세,2021,1838,936,902,103.8,1799,919,880,104.4
38050, 통영시,060004, 58세,2021,2100,1085,1015,106.9,2067,1066,1001,106.5
38050, 통영시,060005, 59세,2021,2340,1131,1209,93.5,2305,1116,1189,93.9
38050, 통영시,065,60~64세,2021,11799,5715,6084,93.9,11709,5664,6045,93.7
38050, 통영시,065001, 60세,2021,2591,1238,1353,91.5,2572,1228,1344,91.4
38050, 통영시,065002, 61세,2021,2631,1263,1368,92.3,2606,1248,1358,91.9
38050, 통영시,065003, 62세,2021,2367,1151,1216,94.7,2347,1140,1207,94.4
38050, 통영시,065004, 63세,2021,2086,1037,1049,98.9,2075,1030,1045,98.6
38050, 통영시,065005, 64세,2021,2124,1026,1098,93.4,2109,1018,1091,93.3
38050, 통영시,070,65~69세,2021,8971,4356,4615,94.4,8939,4344,4595,94.5
38050, 통영시,070001, 65세,2021,2066,1012,1054,96,2057,1007,1050,95.9
38050, 통영시,070002, 66세,2021,2032,983,1049,93.7,2026,982,1044,94.1
38050, 통영시,070003, 67세,2021,1676,794,882,90,1669,793,876,90.5
38050, 통영시,070004, 68세,2021,1500,707,793,89.2,1495,704,791,89
38050, 통영시,070005, 69세,2021,1697,860,837,102.7,1692,858,834,102.9
38050, 통영시,075,70~74세,2021,6589,3156,3433,91.9,6572,3153,3419,92.2
38050, 통영시,075001, 70세,2021,1416,691,725,95.3,1411,690,721,95.7
38050, 통영시,075002, 71세,2021,1242,598,644,92.9,1238,597,641,93.1
38050, 통영시,075003, 72세,2021,1369,678,691,98.1,1368,678,690,98.3
38050, 통영시,075004, 73세,2021,1360,629,731,86,1355,628,727,86.4
38050, 통영시,075005, 74세,2021,1202,560,642,87.2,1200,560,640,87.5
38050, 통영시,080,75~79세,2021,4507,1905,2602,73.2,4501,1904,2597,73.3
38050, 통영시,080001, 75세,2021,777,368,409,90,774,367,407,90.2
38050, 통영시,080002, 76세,2021,940,418,522,80.1,938,418,520,80.4
38050, 통영시,080003, 77세,2021,845,349,496,70.4,845,349,496,70.4
38050, 통영시,080004, 78세,2021,917,375,542,69.2,917,375,542,69.2
38050, 통영시,080005, 79세,2021,1028,395,633,62.4,1027,395,632,62.5
38050, 통영시,085,80~84세,2021,3241,1073,2168,49.5,3237,1071,2166,49.4
38050, 통영시,085001, 80세,2021,825,309,516,59.9,825,309,516,59.9
38050, 통영시,085002, 81세,2021,728,236,492,48,728,236,492,48
38050, 통영시,085003, 82세,2021,640,214,426,50.2,638,213,425,50.1
38050, 통영시,085004, 83세,2021,534,155,379,40.9,532,154,378,40.7
38050, 통영시,085005, 84세,2021,514,159,355,44.8,514,159,355,44.8
38050, 통영시,090,85~89세,2021,1569,439,1130,38.8,1567,439,1128,38.9
38050, 통영시,090001, 85세,2021,430,139,291,47.8,430,139,291,47.8
38050, 통영시,090002, 86세,2021,380,114,266,42.9,379,114,265,43
38050, 통영시,090003, 87세,2021,293,77,216,35.6,293,77,216,35.6
38050, 통영시,090004, 88세,2021,263,61,202,30.2,262,61,201,30.3
38050, 통영시,090005, 89세,2021,203,48,155,31,203,48,155,31
38050, 통영시,095,90~94세,2021,505,95,410,23.2,504,95,409,23.2
38050, 통영시,095001, 90세,2021,165,37,128,28.9,165,37,128,28.9
38050, 통영시,095002, 91세,2021,121,24,97,24.7,121,24,97,24.7
38050, 통영시,095003, 92세,2021,95,14,81,17.3,95,14,81,17.3
38050, 통영시,095004, 93세,2021,73,17,56,30.4,73,17,56,30.4
38050, 통영시,095005, 94세,2021,51,X,48,6.3,50,X,47,6.4
38050, 통영시,100,95~99세,2021,84,13,71,18.3,84,13,71,18.3
38050, 통영시,100001, 95세,2021,29,5,24,20.8,29,5,24,20.8
38050, 통영시,100002, 96세,2021,21,X,17,23.5,21,X,17,23.5
38050, 통영시,100003, 97세,2021,17,X,14,21.4,17,X,14,21.4
38050, 통영시,100004, 98세,2021,6,X,6,0,6,X,6,0
38050, 통영시,100005, 99세,2021,11,X,10,10,11,X,10,10
38050, 통영시,101,100세이상,2021,8,X,8,0,8,X,8,0
38050, 통영시,102,15세미만,2021,15422,7795,7627,102.2,15402,7780,7622,102.1
38050, 통영시,103,15~64세,2021,83933,45393,38540,117.8,79204,41547,37657,110.3
38050, 통영시,104,65세이상,2021,25474,11037,14437,76.4,25412,11019,14393,76.6
38050, 통영시,086,85세이상,2021,2166,547,1619,33.8,2163,547,1616,33.8
38050, 통영시,126,평균연령,2021,46,44.3,47.7,,46.3,44.8,47.8,
38050, 통영시,127,중위연령,2021,48.3,46.3,50.5,,49.1,47.6,50.7,
38060, 사천시,000,합계,2021,109646,56293,53353,105.5,105591,53263,52328,101.8
38060, 사천시,005,0~4세,2021,2999,1535,1464,104.8,2947,1514,1433,105.7
38060, 사천시,005001, 0세,2021,459,241,218,110.6,450,236,214,110.3
38060, 사천시,005002, 1세,2021,531,290,241,120.3,528,289,239,120.9
38060, 사천시,005003, 2세,2021,547,274,273,100.4,541,272,269,101.1
38060, 사천시,005004, 3세,2021,660,322,338,95.3,648,318,330,96.4
38060, 사천시,005005, 4세,2021,802,408,394,103.6,780,399,381,104.7
38060, 사천시,010,5~9세,2021,4793,2487,2306,107.8,4674,2434,2240,108.7
38060, 사천시,010001, 5세,2021,886,483,403,119.9,860,472,388,121.6
38060, 사천시,010002, 6세,2021,932,474,458,103.5,899,456,443,102.9
38060, 사천시,010003, 7세,2021,997,487,510,95.5,973,481,492,97.8
38060, 사천시,010004, 8세,2021,926,500,426,117.4,907,491,416,118
38060, 사천시,010005, 9세,2021,1052,543,509,106.7,1035,534,501,106.6
38060, 사천시,015,10~14세,2021,5259,2694,2565,105,5232,2681,2551,105.1
38060, 사천시,015001, 10세,2021,1044,573,471,121.7,1037,568,469,121.1
38060, 사천시,015002, 11세,2021,1068,525,543,96.7,1059,521,538,96.8
38060, 사천시,015003, 12세,2021,1049,524,525,99.8,1047,523,524,99.8
38060, 사천시,015004, 13세,2021,1062,550,512,107.4,1056,549,507,108.3
38060, 사천시,015005, 14세,2021,1036,522,514,101.6,1033,520,513,101.4
38060, 사천시,020,15~19세,2021,4363,2387,1976,120.8,4346,2378,1968,120.8
38060, 사천시,020001, 15세,2021,989,517,472,109.5,983,514,469,109.6
38060, 사천시,020002, 16세,2021,865,429,436,98.4,862,428,434,98.6
38060, 사천시,020003, 17세,2021,976,537,439,122.3,972,535,437,122.4
38060, 사천시,020004, 18세,2021,931,519,412,126,929,517,412,125.5
38060, 사천시,020005, 19세,2021,602,385,217,177.4,600,384,216,177.8
38060, 사천시,025,20~24세,2021,4446,2965,1481,200.2,4210,2791,1419,196.7
38060, 사천시,025001, 20세,2021,786,574,212,270.8,777,567,210,270
38060, 사천시,025002, 21세,2021,953,683,270,253,918,661,257,257.2
38060, 사천시,025003, 22세,2021,860,549,311,176.5,817,520,297,175.1
38060, 사천시,025004, 23세,2021,892,561,331,169.5,832,512,320,160
38060, 사천시,025005, 24세,2021,955,598,357,167.5,866,531,335,158.5
38060, 사천시,030,25~29세,2021,5563,3510,2053,171,4864,2967,1897,156.4
38060, 사천시,030001, 25세,2021,984,612,372,164.5,884,541,343,157.7
38060, 사천시,030002, 26세,2021,1077,698,379,184.2,943,590,353,167.1
38060, 사천시,030003, 27세,2021,1178,772,406,190.1,1028,654,374,174.9
38060, 사천시,030004, 28세,2021,1123,703,420,167.4,967,584,383,152.5
38060, 사천시,030005, 29세,2021,1201,725,476,152.3,1042,598,444,134.7
38060, 사천시,035,30~34세,2021,5594,3356,2238,150,4737,2643,2094,126.2
38060, 사천시,035001, 30세,2021,1105,692,413,167.6,944,559,385,145.2
38060, 사천시,035002, 31세,2021,1188,718,470,152.8,1001,566,435,130.1
38060, 사천시,035003, 32세,2021,1143,702,441,159.2,968,558,410,136.1
38060, 사천시,035004, 33세,2021,1038,616,422,146,872,474,398,119.1
38060, 사천시,035005, 34세,2021,1120,628,492,127.6,952,486,466,104.3
38060, 사천시,040,35~39세,2021,6892,3847,3045,126.3,6148,3251,2897,112.2
38060, 사천시,040001, 35세,2021,1161,678,483,140.4,1006,560,446,125.6
38060, 사천시,040002, 36세,2021,1189,694,495,140.2,1028,560,468,119.7
38060, 사천시,040003, 37세,2021,1322,717,605,118.5,1161,594,567,104.8
38060, 사천시,040004, 38세,2021,1547,835,712,117.3,1408,724,684,105.8
38060, 사천시,040005, 39세,2021,1673,923,750,123.1,1545,813,732,111.1
38060, 사천시,045,40~44세,2021,8558,4538,4020,112.9,8095,4166,3929,106
38060, 사천시,045001, 40세,2021,1726,913,813,112.3,1598,811,787,103
38060, 사천시,045002, 41세,2021,1774,909,865,105.1,1674,827,847,97.6
38060, 사천시,045003, 42세,2021,1721,918,803,114.3,1644,856,788,108.6
38060, 사천시,045004, 43세,2021,1639,872,767,113.7,1553,802,751,106.8
38060, 사천시,045005, 44세,2021,1698,926,772,119.9,1626,870,756,115.1
38060, 사천시,050,45~49세,2021,8953,4868,4085,119.2,8622,4616,4006,115.2
38060, 사천시,050001, 45세,2021,1593,887,706,125.6,1512,823,689,119.4
38060, 사천시,050002, 46세,2021,1736,900,836,107.7,1654,836,818,102.2
38060, 사천시,050003, 47세,2021,1811,996,815,122.2,1757,955,802,119.1
38060, 사천시,050004, 48세,2021,1973,1050,923,113.8,1918,1009,909,111
38060, 사천시,050005, 49세,2021,1840,1035,805,128.6,1781,993,788,126
38060, 사천시,055,50~54세,2021,9336,4963,4373,113.5,9160,4849,4311,112.5
38060, 사천시,055001, 50세,2021,1987,1077,910,118.4,1941,1045,896,116.6
38060, 사천시,055002, 51세,2021,1856,995,861,115.6,1824,978,846,115.6
38060, 사천시,055003, 52세,2021,1944,1045,899,116.2,1906,1021,885,115.4
38060, 사천시,055004, 53세,2021,1807,962,845,113.8,1776,939,837,112.2
38060, 사천시,055005, 54세,2021,1742,884,858,103,1713,866,847,102.2
38060, 사천시,060,55~59세,2021,8432,4444,3988,111.4,8274,4355,3919,111.1
38060, 사천시,060001, 55세,2021,1733,946,787,120.2,1712,939,773,121.5
38060, 사천시,060002, 56세,2021,1729,913,816,111.9,1695,890,805,110.6
38060, 사천시,060003, 57세,2021,1419,727,692,105.1,1391,711,680,104.6
38060, 사천시,060004, 58세,2021,1697,908,789,115.1,1654,886,768,115.4
38060, 사천시,060005, 59세,2021,1854,950,904,105.1,1822,929,893,104
38060, 사천시,065,60~64세,2021,9340,4519,4821,93.7,9234,4472,4762,93.9
38060, 사천시,065001, 60세,2021,2108,1030,1078,95.5,2081,1019,1062,96
38060, 사천시,065002, 61세,2021,2057,998,1059,94.2,2036,989,1047,94.5
38060, 사천시,065003, 62세,2021,1763,872,891,97.9,1742,862,880,98
38060, 사천시,065004, 63세,2021,1683,797,886,90,1660,786,874,89.9
38060, 사천시,065005, 64세,2021,1729,822,907,90.6,1715,816,899,90.8
38060, 사천시,070,65~69세,2021,7486,3586,3900,91.9,7444,3563,3881,91.8
38060, 사천시,070001, 65세,2021,1576,783,793,98.7,1563,775,788,98.4
38060, 사천시,070002, 66세,2021,1830,836,994,84.1,1815,828,987,83.9
38060, 사천시,070003, 67세,2021,1518,761,757,100.5,1513,760,753,100.9
38060, 사천시,070004, 68세,2021,1173,554,619,89.5,1168,549,619,88.7
38060, 사천시,070005, 69세,2021,1389,652,737,88.5,1385,651,734,88.7
38060, 사천시,075,70~74세,2021,5963,2715,3248,83.6,5946,2706,3240,83.5
38060, 사천시,075001, 70세,2021,1166,524,642,81.6,1163,524,639,82
38060, 사천시,075002, 71세,2021,1211,565,646,87.5,1208,563,645,87.3
38060, 사천시,075003, 72세,2021,1202,547,655,83.5,1197,544,653,83.3
38060, 사천시,075004, 73세,2021,1215,571,644,88.7,1212,569,643,88.5
38060, 사천시,075005, 74세,2021,1169,508,661,76.9,1166,506,660,76.7
38060, 사천시,080,75~79세,2021,4659,1849,2810,65.8,4655,1848,2807,65.8
38060, 사천시,080001, 75세,2021,882,391,491,79.6,879,390,489,79.8
38060, 사천시,080002, 76세,2021,929,364,565,64.4,929,364,565,64.4
38060, 사천시,080003, 77세,2021,908,360,548,65.7,908,360,548,65.7
38060, 사천시,080004, 78세,2021,931,374,557,67.1,931,374,557,67.1
38060, 사천시,080005, 79세,2021,1009,360,649,55.5,1008,360,648,55.6
38060, 사천시,085,80~84세,2021,3852,1318,2534,52,3848,1318,2530,52.1
38060, 사천시,085001, 80세,2021,925,361,564,64,925,361,564,64
38060, 사천시,085002, 81세,2021,818,267,551,48.5,816,267,549,48.6
38060, 사천시,085003, 82세,2021,789,268,521,51.4,788,268,520,51.5
38060, 사천시,085004, 83세,2021,670,207,463,44.7,669,207,462,44.8
38060, 사천시,085005, 84세,2021,650,215,435,49.4,650,215,435,49.4
38060, 사천시,090,85~89세,2021,2231,576,1655,34.8,2228,575,1653,34.8
38060, 사천시,090001, 85세,2021,636,184,452,40.7,636,184,452,40.7
38060, 사천시,090002, 86세,2021,496,138,358,38.5,495,138,357,38.7
38060, 사천시,090003, 87세,2021,428,119,309,38.5,427,119,308,38.6
38060, 사천시,090004, 88세,2021,333,69,264,26.1,332,68,264,25.8
38060, 사천시,090005, 89세,2021,338,66,272,24.3,338,66,272,24.3
38060, 사천시,095,90~94세,2021,746,119,627,19,746,119,627,19
38060, 사천시,095001, 90세,2021,251,45,206,21.8,251,45,206,21.8
38060, 사천시,095002, 91세,2021,175,21,154,13.6,175,21,154,13.6
38060, 사천시,095003, 92세,2021,141,21,120,17.5,141,21,120,17.5
38060, 사천시,095004, 93세,2021,101,20,81,24.7,101,20,81,24.7
38060, 사천시,095005, 94세,2021,78,12,66,18.2,78,12,66,18.2
38060, 사천시,100,95~99세,2021,159,13,146,8.9,159,13,146,8.9
38060, 사천시,100001, 95세,2021,62,5,57,8.8,62,5,57,8.8
38060, 사천시,100002, 96세,2021,43,5,38,13.2,43,5,38,13.2
38060, 사천시,100003, 97세,2021,27,X,25,8,27,X,25,8
38060, 사천시,100004, 98세,2021,11,X,11,0,11,X,11,0
38060, 사천시,100005, 99세,2021,16,X,15,6.7,16,X,15,6.7
38060, 사천시,101,100세이상,2021,22,X,18,22.2,22,X,18,22.2
38060, 사천시,102,15세미만,2021,13051,6716,6335,106,12853,6629,6224,106.5
38060, 사천시,103,15~64세,2021,71477,39397,32080,122.8,67690,36488,31202,116.9
38060, 사천시,104,65세이상,2021,25118,10180,14938,68.1,25048,10146,14902,68.1
38060, 사천시,086,85세이상,2021,3158,712,2446,29.1,3155,711,2444,29.1
38060, 사천시,126,평균연령,2021,46.7,44.2,49.4,,47.1,44.7,49.6,
38060, 사천시,127,중위연령,2021,48.6,45.9,51.6,,49.4,47.2,52,
38070, 김해시,000,합계,2021,547995,280496,267499,104.9,523759,264078,259681,101.7
38070, 김해시,005,0~4세,2021,18450,9519,8931,106.6,17955,9274,8681,106.8
38070, 김해시,005001, 0세,2021,2939,1561,1378,113.3,2837,1505,1332,113
38070, 김해시,005002, 1세,2021,3201,1636,1565,104.5,3098,1583,1515,104.5
38070, 김해시,005003, 2세,2021,3765,1961,1804,108.7,3658,1909,1749,109.1
38070, 김해시,005004, 3세,2021,4009,2051,1958,104.7,3920,2011,1909,105.3
38070, 김해시,005005, 4세,2021,4536,2310,2226,103.8,4442,2266,2176,104.1
38070, 김해시,010,5~9세,2021,28388,14437,13951,103.5,27928,14217,13711,103.7
38070, 김해시,010001, 5세,2021,5267,2692,2575,104.5,5157,2642,2515,105
38070, 김해시,010002, 6세,2021,5567,2892,2675,108.1,5462,2846,2616,108.8
38070, 김해시,010003, 7세,2021,5679,2894,2785,103.9,5592,2849,2743,103.9
38070, 김해시,010004, 8세,2021,5625,2844,2781,102.3,5538,2793,2745,101.7
38070, 김해시,010005, 9세,2021,6250,3115,3135,99.4,6179,3087,3092,99.8
38070, 김해시,015,10~14세,2021,30364,15520,14844,104.6,30066,15366,14700,104.5
38070, 김해시,015001, 10세,2021,6065,3070,2995,102.5,6000,3033,2967,102.2
38070, 김해시,015002, 11세,2021,5958,3049,2909,104.8,5894,3017,2877,104.9
38070, 김해시,015003, 12세,2021,5758,2974,2784,106.8,5701,2945,2756,106.9
38070, 김해시,015004, 13세,2021,6104,3141,2963,106,6048,3114,2934,106.1
38070, 김해시,015005, 14세,2021,6479,3286,3193,102.9,6423,3257,3166,102.9
38070, 김해시,020,15~19세,2021,27902,14613,13289,110,27567,14450,13117,110.2
38070, 김해시,020001, 15세,2021,5802,3010,2792,107.8,5753,2983,2770,107.7
38070, 김해시,020002, 16세,2021,5569,2957,2612,113.2,5522,2932,2590,113.2
38070, 김해시,020003, 17세,2021,5640,2863,2777,103.1,5608,2847,2761,103.1
38070, 김해시,020004, 18세,2021,5706,2938,2768,106.1,5652,2909,2743,106.1
38070, 김해시,020005, 19세,2021,5185,2845,2340,121.6,5032,2779,2253,123.3
38070, 김해시,025,20~24세,2021,33733,19154,14579,131.4,31885,17913,13972,128.2
38070, 김해시,025001, 20세,2021,6314,3663,2651,138.2,6179,3583,2596,138
38070, 김해시,025002, 21세,2021,7005,3988,3017,132.2,6782,3863,2919,132.3
38070, 김해시,025003, 22세,2021,6733,3764,2969,126.8,6369,3529,2840,124.3
38070, 김해시,025004, 23세,2021,6808,3820,2988,127.8,6314,3486,2828,123.3
38070, 김해시,025005, 24세,2021,6873,3919,2954,132.7,6241,3452,2789,123.8
38070, 김해시,030,25~29세,2021,35304,19948,15356,129.9,31372,17001,14371,118.3
38070, 김해시,030001, 25세,2021,7045,4025,3020,133.3,6372,3514,2858,123
38070, 김해시,030002, 26세,2021,6914,3956,2958,133.7,6190,3401,2789,121.9
38070, 김해시,030003, 27세,2021,7105,3953,3152,125.4,6326,3366,2960,113.7
38070, 김해시,030004, 28세,2021,7076,4040,3036,133.1,6224,3402,2822,120.6
38070, 김해시,030005, 29세,2021,7164,3974,3190,124.6,6260,3318,2942,112.8
38070, 김해시,035,30~34세,2021,33766,18700,15066,124.1,28861,15113,13748,109.9
38070, 김해시,035001, 30세,2021,6958,3881,3077,126.1,6038,3223,2815,114.5
38070, 김해시,035002, 31세,2021,6812,3811,3001,127,5819,3072,2747,111.8
38070, 김해시,035003, 32세,2021,6581,3674,2907,126.4,5641,2987,2654,112.5
38070, 김해시,035004, 33세,2021,6641,3639,3002,121.2,5622,2877,2745,104.8
38070, 김해시,035005, 34세,2021,6774,3695,3079,120,5741,2954,2787,106
38070, 김해시,040,35~39세,2021,40411,21556,18855,114.3,36256,18479,17777,103.9
38070, 김해시,040001, 35세,2021,7123,3926,3197,122.8,6165,3220,2945,109.3
38070, 김해시,040002, 36세,2021,7352,3988,3364,118.5,6452,3310,3142,105.3
38070, 김해시,040003, 37세,2021,7686,4092,3594,113.9,6855,3472,3383,102.6
38070, 김해시,040004, 38세,2021,8704,4578,4126,111,7929,4008,3921,102.2
38070, 김해시,040005, 39세,2021,9546,4972,4574,108.7,8855,4469,4386,101.9
38070, 김해시,045,40~44세,2021,47450,24267,23183,104.7,44929,22529,22400,100.6
38070, 김해시,045001, 40세,2021,9680,5053,4627,109.2,9089,4633,4456,104
38070, 김해시,045002, 41세,2021,10156,5202,4954,105,9657,4833,4824,100.2
38070, 김해시,045003, 42세,2021,9654,4909,4745,103.5,9128,4560,4568,99.8
38070, 김해시,045004, 43세,2021,8962,4575,4387,104.3,8481,4259,4222,100.9
38070, 김해시,045005, 44세,2021,8998,4528,4470,101.3,8574,4244,4330,98
38070, 김해시,050,45~49세,2021,50712,25148,25564,98.4,48882,23968,24914,96.2
38070, 김해시,050001, 45세,2021,8819,4447,4372,101.7,8406,4154,4252,97.7
38070, 김해시,050002, 46세,2021,9832,4842,4990,97,9422,4584,4838,94.7
38070, 김해시,050003, 47세,2021,10593,5217,5376,97,10223,4984,5239,95.1
38070, 김해시,050004, 48세,2021,10902,5318,5584,95.2,10588,5125,5463,93.8
38070, 김해시,050005, 49세,2021,10566,5324,5242,101.6,10243,5121,5122,100
38070, 김해시,055,50~54세,2021,54183,27230,26953,101,52794,26428,26366,100.2
38070, 김해시,055001, 50세,2021,11570,5825,5745,101.4,11239,5628,5611,100.3
38070, 김해시,055002, 51세,2021,10864,5456,5408,100.9,10570,5278,5292,99.7
38070, 김해시,055003, 52세,2021,10825,5434,5391,100.8,10560,5291,5269,100.4
38070, 김해시,055004, 53세,2021,10973,5494,5479,100.3,10704,5335,5369,99.4
38070, 김해시,055005, 54세,2021,9951,5021,4930,101.8,9721,4896,4825,101.5
38070, 김해시,060,55~59세,2021,44206,23027,21179,108.7,43192,22455,20737,108.3
38070, 김해시,060001, 55세,2021,9476,4946,4530,109.2,9243,4803,4440,108.2
38070, 김해시,060002, 56세,2021,9243,4707,4536,103.8,9039,4590,4449,103.2
38070, 김해시,060003, 57세,2021,8160,4196,3964,105.9,7954,4089,3865,105.8
38070, 김해시,060004, 58세,2021,8613,4590,4023,114.1,8426,4481,3945,113.6
38070, 김해시,060005, 59세,2021,8714,4588,4126,111.2,8530,4492,4038,111.2
38070, 김해시,065,60~64세,2021,37861,19539,18322,106.6,37322,19261,18061,106.6
38070, 김해시,065001, 60세,2021,8833,4518,4315,104.7,8713,4457,4256,104.7
38070, 김해시,065002, 61세,2021,8488,4408,4080,108,8337,4330,4007,108.1
38070, 김해시,065003, 62세,2021,7367,3864,3503,110.3,7272,3807,3465,109.9
38070, 김해시,065004, 63세,2021,6639,3413,3226,105.8,6544,3375,3169,106.5
38070, 김해시,065005, 64세,2021,6534,3336,3198,104.3,6456,3292,3164,104
38070, 김해시,070,65~69세,2021,23962,11859,12103,98,23667,11721,11946,98.1
38070, 김해시,070001, 65세,2021,5577,2775,2802,99,5494,2738,2756,99.3
38070, 김해시,070002, 66세,2021,5620,2813,2807,100.2,5549,2774,2775,100
38070, 김해시,070003, 67세,2021,4660,2357,2303,102.3,4603,2333,2270,102.8
38070, 김해시,070004, 68세,2021,3896,1890,2006,94.2,3852,1873,1979,94.6
38070, 김해시,070005, 69세,2021,4209,2024,2185,92.6,4169,2003,2166,92.5
38070, 김해시,075,70~74세,2021,15864,7253,8611,84.2,15748,7208,8540,84.4
38070, 김해시,075001, 70세,2021,3277,1545,1732,89.2,3246,1534,1712,89.6
38070, 김해시,075002, 71세,2021,3321,1591,1730,92,3291,1579,1712,92.2
38070, 김해시,075003, 72세,2021,3167,1471,1696,86.7,3140,1457,1683,86.6
38070, 김해시,075004, 73세,2021,3206,1397,1809,77.2,3192,1392,1800,77.3
38070, 김해시,075005, 74세,2021,2893,1249,1644,76,2879,1246,1633,76.3
38070, 김해시,080,75~79세,2021,11119,4592,6527,70.4,11061,4572,6489,70.5
38070, 김해시,080001, 75세,2021,2086,937,1149,81.5,2072,933,1139,81.9
38070, 김해시,080002, 76세,2021,2045,883,1162,76,2024,876,1148,76.3
38070, 김해시,080003, 77세,2021,2234,936,1298,72.1,2228,934,1294,72.2
38070, 김해시,080004, 78세,2021,2279,908,1371,66.2,2270,905,1365,66.3
38070, 김해시,080005, 79세,2021,2475,928,1547,60,2467,924,1543,59.9
38070, 김해시,085,80~84세,2021,8198,2711,5487,49.4,8165,2702,5463,49.5
38070, 김해시,085001, 80세,2021,1944,671,1273,52.7,1934,669,1265,52.9
38070, 김해시,085002, 81세,2021,1804,623,1181,52.8,1795,620,1175,52.8
38070, 김해시,085003, 82세,2021,1723,579,1144,50.6,1717,577,1140,50.6
38070, 김해시,085004, 83세,2021,1429,452,977,46.3,1424,451,973,46.4
38070, 김해시,085005, 84세,2021,1298,386,912,42.3,1295,385,910,42.3
38070, 김해시,090,85~89세,2021,4373,1118,3255,34.3,4362,1116,3246,34.4
38070, 김해시,090001, 85세,2021,1138,318,820,38.8,1135,317,818,38.8
38070, 김해시,090002, 86세,2021,1021,271,750,36.1,1019,270,749,36
38070, 김해시,090003, 87세,2021,904,233,671,34.7,901,233,668,34.9
38070, 김해시,090004, 88세,2021,702,173,529,32.7,702,173,529,32.7
38070, 김해시,090005, 89세,2021,608,123,485,25.4,605,123,482,25.5
38070, 김해시,095,90~94세,2021,1476,256,1220,21,1474,256,1218,21
38070, 김해시,095001, 90세,2021,439,80,359,22.3,438,80,358,22.3
38070, 김해시,095002, 91세,2021,373,66,307,21.5,373,66,307,21.5
38070, 김해시,095003, 92세,2021,296,53,243,21.8,296,53,243,21.8
38070, 김해시,095004, 93세,2021,214,30,184,16.3,214,30,184,16.3
38070, 김해시,095005, 94세,2021,154,27,127,21.3,153,27,126,21.4
38070, 김해시,100,95~99세,2021,245,44,201,21.9,245,44,201,21.9
38070, 김해시,100001, 95세,2021,73,16,57,28.1,73,16,57,28.1
38070, 김해시,100002, 96세,2021,66,10,56,17.9,66,10,56,17.9
38070, 김해시,100003, 97세,2021,37,6,31,19.4,37,6,31,19.4
38070, 김해시,100004, 98세,2021,50,9,41,22,50,9,41,22
38070, 김해시,100005, 99세,2021,19,X,16,18.8,19,X,16,18.8
38070, 김해시,101,100세이상,2021,28,5,23,21.7,28,5,23,21.7
38070, 김해시,102,15세미만,2021,77202,39476,37726,104.6,75949,38857,37092,104.8
38070, 김해시,103,15~64세,2021,405528,213182,192346,110.8,383060,197597,185463,106.5
38070, 김해시,104,65세이상,2021,65265,27838,37427,74.4,64750,27624,37126,74.4
38070, 김해시,086,85세이상,2021,6122,1423,4699,30.3,6109,1421,4688,30.3
38070, 김해시,126,평균연령,2021,41,39.9,42.2,,41.3,40.2,42.4,
38070, 김해시,127,중위연령,2021,42.6,41.3,44,,43.2,42.2,44.4,
38080, 밀양시,000,합계,2021,101837,49834,52003,95.8,98211,48360,49851,97
38080, 밀양시,005,0~4세,2021,2133,1108,1025,108.1,2115,1104,1011,109.2
38080, 밀양시,005001, 0세,2021,357,197,160,123.1,355,196,159,123.3
38080, 밀양시,005002, 1세,2021,385,199,186,107,378,198,180,110
38080, 밀양시,005003, 2세,2021,427,211,216,97.7,427,211,216,97.7
38080, 밀양시,005004, 3세,2021,438,242,196,123.5,434,240,194,123.7
38080, 밀양시,005005, 4세,2021,526,259,267,97,521,259,262,98.9
38080, 밀양시,010,5~9세,2021,3081,1573,1508,104.3,3076,1570,1506,104.2
38080, 밀양시,010001, 5세,2021,608,292,316,92.4,607,291,316,92.1
38080, 밀양시,010002, 6세,2021,560,292,268,109,559,292,267,109.4
38080, 밀양시,010003, 7세,2021,615,317,298,106.4,614,316,298,106
38080, 밀양시,010004, 8세,2021,622,300,322,93.2,620,299,321,93.1
38080, 밀양시,010005, 9세,2021,676,372,304,122.4,676,372,304,122.4
38080, 밀양시,015,10~14세,2021,3560,1816,1744,104.1,3559,1816,1743,104.2
38080, 밀양시,015001, 10세,2021,674,332,342,97.1,673,332,341,97.4
38080, 밀양시,015002, 11세,2021,677,354,323,109.6,677,354,323,109.6
38080, 밀양시,015003, 12세,2021,664,343,321,106.9,664,343,321,106.9
38080, 밀양시,015004, 13세,2021,760,377,383,98.4,760,377,383,98.4
38080, 밀양시,015005, 14세,2021,785,410,375,109.3,785,410,375,109.3
38080, 밀양시,020,15~19세,2021,3727,2041,1686,121.1,3718,2040,1678,121.6
38080, 밀양시,020001, 15세,2021,703,366,337,108.6,702,365,337,108.3
38080, 밀양시,020002, 16세,2021,729,387,342,113.2,729,387,342,113.2
38080, 밀양시,020003, 17세,2021,842,474,368,128.8,839,474,365,129.9
38080, 밀양시,020004, 18세,2021,806,422,384,109.9,804,422,382,110.5
38080, 밀양시,020005, 19세,2021,647,392,255,153.7,644,392,252,155.6
38080, 밀양시,025,20~24세,2021,4550,2466,2084,118.3,3970,2364,1606,147.2
38080, 밀양시,025001, 20세,2021,820,512,308,166.2,811,508,303,167.7
38080, 밀양시,025002, 21세,2021,958,547,411,133.1,900,543,357,152.1
38080, 밀양시,025003, 22세,2021,890,460,430,107,741,440,301,146.2
38080, 밀양시,025004, 23세,2021,912,462,450,102.7,738,432,306,141.2
38080, 밀양시,025005, 24세,2021,970,485,485,100,780,441,339,130.1
38080, 밀양시,030,25~29세,2021,5037,2819,2218,127.1,4056,2445,1611,151.8
38080, 밀양시,030001, 25세,2021,1053,585,468,125,826,508,318,159.7
38080, 밀양시,030002, 26세,2021,1006,545,461,118.2,788,471,317,148.6
38080, 밀양시,030003, 27세,2021,1033,584,449,130.1,837,508,329,154.4
38080, 밀양시,030004, 28세,2021,1010,593,417,142.2,833,522,311,167.8
38080, 밀양시,030005, 29세,2021,935,512,423,121,772,436,336,129.8
38080, 밀양시,035,30~34세,2021,4217,2290,1927,118.8,3536,1937,1599,121.1
38080, 밀양시,035001, 30세,2021,899,487,412,118.2,751,413,338,122.2
38080, 밀양시,035002, 31세,2021,850,465,385,120.8,691,389,302,128.8
38080, 밀양시,035003, 32세,2021,817,440,377,116.7,688,373,315,118.4
38080, 밀양시,035004, 33세,2021,814,457,357,128,684,387,297,130.3
38080, 밀양시,035005, 34세,2021,837,441,396,111.4,722,375,347,108.1
38080, 밀양시,040,35~39세,2021,4942,2570,2372,108.3,4439,2306,2133,108.1
38080, 밀양시,040001, 35세,2021,906,453,453,100,785,390,395,98.7
38080, 밀양시,040002, 36세,2021,911,468,443,105.6,803,414,389,106.4
38080, 밀양시,040003, 37세,2021,937,499,438,113.9,850,456,394,115.7
38080, 밀양시,040004, 38세,2021,1069,552,517,106.8,966,490,476,102.9
38080, 밀양시,040005, 39세,2021,1119,598,521,114.8,1035,556,479,116.1
38080, 밀양시,045,40~44세,2021,5861,3061,2800,109.3,5558,2917,2641,110.5
38080, 밀양시,045001, 40세,2021,1208,628,580,108.3,1133,593,540,109.8
38080, 밀양시,045002, 41세,2021,1206,626,580,107.9,1138,585,553,105.8
38080, 밀양시,045003, 42세,2021,1183,624,559,111.6,1126,599,527,113.7
38080, 밀양시,045004, 43세,2021,1119,587,532,110.3,1065,563,502,112.2
38080, 밀양시,045005, 44세,2021,1145,596,549,108.6,1096,577,519,111.2
38080, 밀양시,050,45~49세,2021,6449,3406,3043,111.9,6269,3328,2941,113.2
38080, 밀양시,050001, 45세,2021,1067,571,496,115.1,1019,545,474,115
38080, 밀양시,050002, 46세,2021,1213,651,562,115.8,1175,638,537,118.8
38080, 밀양시,050003, 47세,2021,1331,694,637,108.9,1302,684,618,110.7
38080, 밀양시,050004, 48세,2021,1434,751,683,110,1398,734,664,110.5
38080, 밀양시,050005, 49세,2021,1404,739,665,111.1,1375,727,648,112.2
38080, 밀양시,055,50~54세,2021,8137,4122,4015,102.7,8006,4067,3939,103.2
38080, 밀양시,055001, 50세,2021,1547,797,750,106.3,1514,780,734,106.3
38080, 밀양시,055002, 51세,2021,1519,765,754,101.5,1489,751,738,101.8
38080, 밀양시,055003, 52세,2021,1614,834,780,106.9,1586,824,762,108.1
38080, 밀양시,055004, 53세,2021,1717,886,831,106.6,1695,879,816,107.7
38080, 밀양시,055005, 54세,2021,1740,840,900,93.3,1722,833,889,93.7
38080, 밀양시,060,55~59세,2021,9331,4615,4716,97.9,9221,4567,4654,98.1
38080, 밀양시,060001, 55세,2021,1779,889,890,99.9,1760,882,878,100.5
38080, 밀양시,060002, 56세,2021,1767,841,926,90.8,1746,831,915,90.8
38080, 밀양시,060003, 57세,2021,1728,871,857,101.6,1703,856,847,101.1
38080, 밀양시,060004, 58세,2021,1967,997,970,102.8,1945,989,956,103.5
38080, 밀양시,060005, 59세,2021,2090,1017,1073,94.8,2067,1009,1058,95.4
38080, 밀양시,065,60~64세,2021,11403,5602,5801,96.6,11332,5576,5756,96.9
38080, 밀양시,065001, 60세,2021,2336,1175,1161,101.2,2317,1169,1148,101.8
38080, 밀양시,065002, 61세,2021,2328,1136,1192,95.3,2311,1131,1180,95.8
38080, 밀양시,065003, 62세,2021,2194,1071,1123,95.4,2183,1066,1117,95.4
38080, 밀양시,065004, 63세,2021,2235,1093,1142,95.7,2224,1088,1136,95.8
38080, 밀양시,065005, 64세,2021,2310,1127,1183,95.3,2297,1122,1175,95.5
38080, 밀양시,070,65~69세,2021,9534,4636,4898,94.7,9508,4625,4883,94.7
38080, 밀양시,070001, 65세,2021,2135,1061,1074,98.8,2131,1061,1070,99.2
38080, 밀양시,070002, 66세,2021,2122,1033,1089,94.9,2111,1027,1084,94.7
38080, 밀양시,070003, 67세,2021,1803,884,919,96.2,1795,880,915,96.2
38080, 밀양시,070004, 68세,2021,1634,784,850,92.2,1631,783,848,92.3
38080, 밀양시,070005, 69세,2021,1840,874,966,90.5,1840,874,966,90.5
38080, 밀양시,075,70~74세,2021,7039,3271,3768,86.8,7029,3266,3763,86.8
38080, 밀양시,075001, 70세,2021,1530,701,829,84.6,1526,700,826,84.7
38080, 밀양시,075002, 71세,2021,1393,661,732,90.3,1390,658,732,89.9
38080, 밀양시,075003, 72세,2021,1404,667,737,90.5,1402,666,736,90.5
38080, 밀양시,075004, 73세,2021,1363,633,730,86.7,1363,633,730,86.7
38080, 밀양시,075005, 74세,2021,1349,609,740,82.3,1348,609,739,82.4
38080, 밀양시,080,75~79세,2021,5260,2179,3081,70.7,5251,2176,3075,70.8
38080, 밀양시,080001, 75세,2021,949,429,520,82.5,945,427,518,82.4
38080, 밀양시,080002, 76세,2021,942,428,514,83.3,939,427,512,83.4
38080, 밀양시,080003, 77세,2021,1015,413,602,68.6,1014,413,601,68.7
38080, 밀양시,080004, 78세,2021,1087,425,662,64.2,1086,425,661,64.3
38080, 밀양시,080005, 79세,2021,1267,484,783,61.8,1267,484,783,61.8
38080, 밀양시,085,80~84세,2021,4366,1420,2946,48.2,4362,1419,2943,48.2
38080, 밀양시,085001, 80세,2021,1020,351,669,52.5,1019,351,668,52.5
38080, 밀양시,085002, 81세,2021,854,292,562,52,851,291,560,52
38080, 밀양시,085003, 82세,2021,928,302,626,48.2,928,302,626,48.2
38080, 밀양시,085004, 83세,2021,790,228,562,40.6,790,228,562,40.6
38080, 밀양시,085005, 84세,2021,774,247,527,46.9,774,247,527,46.9
38080, 밀양시,090,85~89세,2021,2372,671,1701,39.4,2369,670,1699,39.4
38080, 밀양시,090001, 85세,2021,606,188,418,45,605,187,418,44.7
38080, 밀양시,090002, 86세,2021,609,180,429,42,608,180,428,42.1
38080, 밀양시,090003, 87세,2021,481,137,344,39.8,480,137,343,39.9
38080, 밀양시,090004, 88세,2021,366,95,271,35.1,366,95,271,35.1
38080, 밀양시,090005, 89세,2021,310,71,239,29.7,310,71,239,29.7
38080, 밀양시,095,90~94세,2021,705,149,556,26.8,704,148,556,26.6
38080, 밀양시,095001, 90세,2021,212,46,166,27.7,212,46,166,27.7
38080, 밀양시,095002, 91세,2021,166,31,135,23,166,31,135,23
38080, 밀양시,095003, 92세,2021,158,37,121,30.6,157,36,121,29.8
38080, 밀양시,095004, 93세,2021,98,25,73,34.2,98,25,73,34.2
38080, 밀양시,095005, 94세,2021,71,10,61,16.4,71,10,61,16.4
38080, 밀양시,100,95~99세,2021,116,16,100,16,116,16,100,16
38080, 밀양시,100001, 95세,2021,38,8,30,26.7,38,8,30,26.7
38080, 밀양시,100002, 96세,2021,34,X,31,9.7,34,X,31,9.7
38080, 밀양시,100003, 97세,2021,16,X,14,14.3,16,X,14,14.3
38080, 밀양시,100004, 98세,2021,20,X,18,11.1,20,X,18,11.1
38080, 밀양시,100005, 99세,2021,8,X,7,14.3,8,X,7,14.3
38080, 밀양시,101,100세이상,2021,17,X,14,21.4,17,X,14,21.4
38080, 밀양시,102,15세미만,2021,8774,4497,4277,105.1,8750,4490,4260,105.4
38080, 밀양시,103,15~64세,2021,63654,32992,30662,107.6,60105,31547,28558,110.5
38080, 밀양시,104,65세이상,2021,29409,12345,17064,72.3,29356,12323,17033,72.3
38080, 밀양시,086,85세이상,2021,3210,839,2371,35.4,3206,837,2369,35.3
38080, 밀양시,126,평균연령,2021,50.5,48.4,52.5,,51.1,48.8,53.3,
38080, 밀양시,127,중위연령,2021,54.6,52.2,56.7,,55.5,53,57.9,
38090, 거제시,000,합계,2021,242426,128937,113489,113.6,234311,123500,110811,111.5
38090, 거제시,005,0~4세,2021,9074,4743,4331,109.5,8845,4632,4213,109.9
38090, 거제시,005001, 0세,2021,1276,658,618,106.5,1255,646,609,106.1
38090, 거제시,005002, 1세,2021,1508,792,716,110.6,1474,776,698,111.2
38090, 거제시,005003, 2세,2021,1734,918,816,112.5,1684,890,794,112.1
38090, 거제시,005004, 3세,2021,2053,1067,986,108.2,1991,1040,951,109.4
38090, 거제시,005005, 4세,2021,2503,1308,1195,109.5,2441,1280,1161,110.2
38090, 거제시,010,5~9세,2021,15695,8109,7586,106.9,15409,7948,7461,106.5
38090, 거제시,010001, 5세,2021,2959,1493,1466,101.8,2874,1442,1432,100.7
38090, 거제시,010002, 6세,2021,3222,1664,1558,106.8,3158,1622,1536,105.6
38090, 거제시,010003, 7세,2021,3076,1576,1500,105.1,3030,1553,1477,105.1
38090, 거제시,010004, 8세,2021,3114,1607,1507,106.6,3072,1589,1483,107.1
38090, 거제시,010005, 9세,2021,3324,1769,1555,113.8,3275,1742,1533,113.6
38090, 거제시,015,10~14세,2021,15059,7758,7301,106.3,14935,7696,7239,106.3
38090, 거제시,015001, 10세,2021,3311,1673,1638,102.1,3284,1659,1625,102.1
38090, 거제시,015002, 11세,2021,3127,1599,1528,104.6,3097,1588,1509,105.2
38090, 거제시,015003, 12세,2021,2819,1468,1351,108.7,2796,1456,1340,108.7
38090, 거제시,015004, 13세,2021,2909,1505,1404,107.2,2886,1491,1395,106.9
38090, 거제시,015005, 14세,2021,2893,1513,1380,109.6,2872,1502,1370,109.6
38090, 거제시,020,15~19세,2021,11366,6076,5290,114.9,11303,6042,5261,114.8
38090, 거제시,020001, 15세,2021,2553,1308,1245,105.1,2544,1304,1240,105.2
38090, 거제시,020002, 16세,2021,2383,1234,1149,107.4,2378,1231,1147,107.3
38090, 거제시,020003, 17세,2021,2543,1350,1193,113.2,2538,1348,1190,113.3
38090, 거제시,020004, 18세,2021,2335,1237,1098,112.7,2322,1230,1092,112.6
38090, 거제시,020005, 19세,2021,1552,947,605,156.5,1521,929,592,156.9
38090, 거제시,025,20~24세,2021,10328,6419,3909,164.2,9899,6141,3758,163.4
38090, 거제시,025001, 20세,2021,2056,1425,631,225.8,2013,1400,613,228.4
38090, 거제시,025002, 21세,2021,2276,1551,725,213.9,2234,1518,716,212
38090, 거제시,025003, 22세,2021,1909,1152,757,152.2,1832,1102,730,151
38090, 거제시,025004, 23세,2021,1957,1078,879,122.6,1848,1013,835,121.3
38090, 거제시,025005, 24세,2021,2130,1213,917,132.3,1972,1108,864,128.2
38090, 거제시,030,25~29세,2021,11129,6333,4796,132,10057,5582,4475,124.7
38090, 거제시,030001, 25세,2021,2203,1268,935,135.6,2009,1128,881,128
38090, 거제시,030002, 26세,2021,2233,1278,955,133.8,2032,1141,891,128.1
38090, 거제시,030003, 27세,2021,2139,1230,909,135.3,1936,1087,849,128
38090, 거제시,030004, 28세,2021,2228,1257,971,129.5,2027,1125,902,124.7
38090, 거제시,030005, 29세,2021,2326,1300,1026,126.7,2053,1101,952,115.7
38090, 거제시,035,30~34세,2021,13793,7469,6324,118.1,12348,6425,5923,108.5
38090, 거제시,035001, 30세,2021,2442,1312,1130,116.1,2184,1132,1052,107.6
38090, 거제시,035002, 31세,2021,2694,1534,1160,132.2,2406,1309,1097,119.3
38090, 거제시,035003, 32세,2021,2708,1496,1212,123.4,2402,1284,1118,114.8
38090, 거제시,035004, 33세,2021,2821,1477,1344,109.9,2530,1274,1256,101.4
38090, 거제시,035005, 34세,2021,3128,1650,1478,111.6,2826,1426,1400,101.9
38090, 거제시,040,35~39세,2021,22083,11948,10135,117.9,20664,10940,9724,112.5
38090, 거제시,040001, 35세,2021,3688,2009,1679,119.7,3388,1798,1590,113.1
38090, 거제시,040002, 36세,2021,4072,2168,1904,113.9,3755,1936,1819,106.4
38090, 거제시,040003, 37세,2021,4344,2339,2005,116.7,4066,2142,1924,111.3
38090, 거제시,040004, 38세,2021,4835,2632,2203,119.5,4559,2441,2118,115.3
38090, 거제시,040005, 39세,2021,5144,2800,2344,119.5,4896,2623,2273,115.4
38090, 거제시,045,40~44세,2021,24633,13648,10985,124.2,23628,12946,10682,121.2
38090, 거제시,045001, 40세,2021,5223,2899,2324,124.7,5023,2763,2260,122.3
38090, 거제시,045002, 41세,2021,5390,3031,2359,128.5,5168,2867,2301,124.6
38090, 거제시,045003, 42세,2021,5012,2769,2243,123.5,4783,2615,2168,120.6
38090, 거제시,045004, 43세,2021,4510,2480,2030,122.2,4314,2352,1962,119.9
38090, 거제시,045005, 44세,2021,4498,2469,2029,121.7,4340,2349,1991,118
38090, 거제시,050,45~49세,2021,23625,12872,10753,119.7,22919,12373,10546,117.3
38090, 거제시,050001, 45세,2021,4461,2398,2063,116.2,4299,2273,2026,112.2
38090, 거제시,050002, 46세,2021,4432,2360,2072,113.9,4289,2258,2031,111.2
38090, 거제시,050003, 47세,2021,4853,2611,2242,116.5,4719,2513,2206,113.9
38090, 거제시,050004, 48세,2021,5002,2731,2271,120.3,4867,2646,2221,119.1
38090, 거제시,050005, 49세,2021,4877,2772,2105,131.7,4745,2683,2062,130.1
38090, 거제시,055,50~54세,2021,22425,12295,10130,121.4,21890,11953,9937,120.3
38090, 거제시,055001, 50세,2021,4979,2789,2190,127.4,4850,2711,2139,126.7
38090, 거제시,055002, 51세,2021,4658,2589,2069,125.1,4550,2511,2039,123.1
38090, 거제시,055003, 52세,2021,4465,2431,2034,119.5,4350,2350,2000,117.5
38090, 거제시,055004, 53세,2021,4312,2303,2009,114.6,4223,2252,1971,114.3
38090, 거제시,055005, 54세,2021,4011,2183,1828,119.4,3917,2129,1788,119.1
38090, 거제시,060,55~59세,2021,17749,9549,8200,116.5,17379,9334,8045,116
38090, 거제시,060001, 55세,2021,3914,2247,1667,134.8,3835,2207,1628,135.6
38090, 거제시,060002, 56세,2021,3792,2030,1762,115.2,3715,1987,1728,115
38090, 거제시,060003, 57세,2021,3065,1625,1440,112.8,3003,1587,1416,112.1
38090, 거제시,060004, 58세,2021,3399,1808,1591,113.6,3315,1758,1557,112.9
38090, 거제시,060005, 59세,2021,3579,1839,1740,105.7,3511,1795,1716,104.6
38090, 거제시,065,60~64세,2021,17341,8939,8402,106.4,17113,8810,8303,106.1
38090, 거제시,065001, 60세,2021,3907,1860,2047,90.9,3852,1832,2020,90.7
38090, 거제시,065002, 61세,2021,3799,1894,1905,99.4,3751,1866,1885,99
38090, 거제시,065003, 62세,2021,3347,1779,1568,113.5,3304,1754,1550,113.2
38090, 거제시,065004, 63세,2021,3145,1686,1459,115.6,3106,1664,1442,115.4
38090, 거제시,065005, 64세,2021,3143,1720,1423,120.9,3100,1694,1406,120.5
38090, 거제시,070,65~69세,2021,11311,5750,5561,103.4,11200,5690,5510,103.3
38090, 거제시,070001, 65세,2021,2740,1444,1296,111.4,2711,1427,1284,111.1
38090, 거제시,070002, 66세,2021,2627,1325,1302,101.8,2602,1311,1291,101.5
38090, 거제시,070003, 67세,2021,2074,1067,1007,106,2049,1054,995,105.9
38090, 거제시,070004, 68세,2021,1819,894,925,96.6,1798,883,915,96.5
38090, 거제시,070005, 69세,2021,2051,1020,1031,98.9,2040,1015,1025,99
38090, 거제시,075,70~74세,2021,6824,3473,3351,103.6,6770,3448,3322,103.8
38090, 거제시,075001, 70세,2021,1414,716,698,102.6,1402,710,692,102.6
38090, 거제시,075002, 71세,2021,1355,687,668,102.8,1339,680,659,103.2
38090, 거제시,075003, 72세,2021,1438,726,712,102,1429,722,707,102.1
38090, 거제시,075004, 73세,2021,1363,721,642,112.3,1353,716,637,112.4
38090, 거제시,075005, 74세,2021,1254,623,631,98.7,1247,620,627,98.9
38090, 거제시,080,75~79세,2021,4348,1873,2475,75.7,4328,1866,2462,75.8
38090, 거제시,080001, 75세,2021,776,377,399,94.5,773,376,397,94.7
38090, 거제시,080002, 76세,2021,829,360,469,76.8,822,358,464,77.2
38090, 거제시,080003, 77세,2021,835,362,473,76.5,830,360,470,76.6
38090, 거제시,080004, 78세,2021,916,393,523,75.1,913,391,522,74.9
38090, 거제시,080005, 79세,2021,992,381,611,62.4,990,381,609,62.6
38090, 거제시,085,80~84세,2021,3134,1092,2042,53.5,3121,1085,2036,53.3
38090, 거제시,085001, 80세,2021,792,307,485,63.3,789,305,484,63
38090, 거제시,085002, 81세,2021,638,238,400,59.5,636,237,399,59.4
38090, 거제시,085003, 82세,2021,640,202,438,46.1,639,201,438,45.9
38090, 거제시,085004, 83세,2021,543,190,353,53.8,538,189,349,54.2
38090, 거제시,085005, 84세,2021,521,155,366,42.3,519,153,366,41.8
38090, 거제시,090,85~89세,2021,1782,477,1305,36.6,1777,476,1301,36.6
38090, 거제시,090001, 85세,2021,479,148,331,44.7,478,147,331,44.4
38090, 거제시,090002, 86세,2021,422,112,310,36.1,420,112,308,36.4
38090, 거제시,090003, 87세,2021,341,84,257,32.7,340,84,256,32.8
38090, 거제시,090004, 88세,2021,293,76,217,35,292,76,216,35.2
38090, 거제시,090005, 89세,2021,247,57,190,30,247,57,190,30
38090, 거제시,095,90~94세,2021,598,95,503,18.9,597,94,503,18.7
38090, 거제시,095001, 90세,2021,175,36,139,25.9,174,35,139,25.2
38090, 거제시,095002, 91세,2021,150,22,128,17.2,150,22,128,17.2
38090, 거제시,095003, 92세,2021,145,19,126,15.1,145,19,126,15.1
38090, 거제시,095004, 93세,2021,86,12,74,16.2,86,12,74,16.2
38090, 거제시,095005, 94세,2021,42,6,36,16.7,42,6,36,16.7
38090, 거제시,100,95~99세,2021,115,14,101,13.9,115,14,101,13.9
38090, 거제시,100001, 95세,2021,38,6,32,18.8,38,6,32,18.8
38090, 거제시,100002, 96세,2021,31,X,29,6.9,31,X,29,6.9
38090, 거제시,100003, 97세,2021,18,X,17,5.9,18,X,17,5.9
38090, 거제시,100004, 98세,2021,19,X,15,26.7,19,X,15,26.7
38090, 거제시,100005, 99세,2021,9,X,8,12.5,9,X,8,12.5
38090, 거제시,101,100세이상,2021,14,5,9,55.6,14,5,9,55.6
38090, 거제시,102,15세미만,2021,39828,20610,19218,107.2,39189,20276,18913,107.2
38090, 거제시,103,15~64세,2021,174472,95548,78924,121.1,167200,90546,76654,118.1
38090, 거제시,104,65세이상,2021,28126,12779,15347,83.3,27922,12678,15244,83.2
38090, 거제시,086,85세이상,2021,2509,591,1918,30.8,2503,589,1914,30.8
38090, 거제시,126,평균연령,2021,40.7,40,41.5,,40.8,40.1,41.6,
38090, 거제시,127,중위연령,2021,42.4,41.9,43.1,,42.7,42.3,43.3,
38100, 양산시,000,합계,2021,352610,177013,175597,100.8,344405,171980,172425,99.7
38100, 양산시,005,0~4세,2021,13657,7008,6649,105.4,13542,6954,6588,105.6
38100, 양산시,005001, 0세,2021,2110,1077,1033,104.3,2088,1069,1019,104.9
38100, 양산시,005002, 1세,2021,2473,1276,1197,106.6,2448,1261,1187,106.2
38100, 양산시,005003, 2세,2021,2677,1355,1322,102.5,2663,1352,1311,103.1
38100, 양산시,005004, 3세,2021,3050,1579,1471,107.3,3019,1562,1457,107.2
38100, 양산시,005005, 4세,2021,3347,1721,1626,105.8,3324,1710,1614,105.9
38100, 양산시,010,5~9세,2021,19324,9877,9447,104.6,19182,9801,9381,104.5
38100, 양산시,010001, 5세,2021,3721,1903,1818,104.7,3691,1887,1804,104.6
38100, 양산시,010002, 6세,2021,3951,1977,1974,100.2,3914,1955,1959,99.8
38100, 양산시,010003, 7세,2021,3875,2043,1832,111.5,3848,2030,1818,111.7
38100, 양산시,010004, 8세,2021,3720,1841,1879,98,3696,1828,1868,97.9
38100, 양산시,010005, 9세,2021,4057,2113,1944,108.7,4033,2101,1932,108.7
38100, 양산시,015,10~14세,2021,17955,9160,8795,104.2,17878,9117,8761,104.1
38100, 양산시,015001, 10세,2021,3932,1981,1951,101.5,3920,1976,1944,101.6
38100, 양산시,015002, 11세,2021,3584,1830,1754,104.3,3564,1820,1744,104.4
38100, 양산시,015003, 12세,2021,3377,1723,1654,104.2,3363,1713,1650,103.8
38100, 양산시,015004, 13세,2021,3556,1843,1713,107.6,3543,1835,1708,107.4
38100, 양산시,015005, 14세,2021,3506,1783,1723,103.5,3488,1773,1715,103.4
38100, 양산시,020,15~19세,2021,15921,8102,7819,103.6,15751,8023,7728,103.8
38100, 양산시,020001, 15세,2021,3194,1608,1586,101.4,3175,1602,1573,101.8
38100, 양산시,020002, 16세,2021,3078,1538,1540,99.9,3067,1531,1536,99.7
38100, 양산시,020003, 17세,2021,3374,1636,1738,94.1,3358,1627,1731,94
38100, 양산시,020004, 18세,2021,3123,1627,1496,108.8,3095,1614,1481,109
38100, 양산시,020005, 19세,2021,3152,1693,1459,116,3056,1649,1407,117.2
38100, 양산시,025,20~24세,2021,18434,10271,8163,125.8,17660,9797,7863,124.6
38100, 양산시,025001, 20세,2021,3615,2103,1512,139.1,3469,2026,1443,140.4
38100, 양산시,025002, 21세,2021,3895,2175,1720,126.5,3733,2087,1646,126.8
38100, 양산시,025003, 22세,2021,3516,1973,1543,127.9,3403,1901,1502,126.6
38100, 양산시,025004, 23세,2021,3619,1996,1623,123,3455,1888,1567,120.5
38100, 양산시,025005, 24세,2021,3789,2024,1765,114.7,3600,1895,1705,111.1
38100, 양산시,030,25~29세,2021,21272,11429,9843,116.1,19990,10573,9417,112.3
38100, 양산시,030001, 25세,2021,4124,2245,1879,119.5,3910,2096,1814,115.5
38100, 양산시,030002, 26세,2021,4101,2223,1878,118.4,3869,2067,1802,114.7
38100, 양산시,030003, 27세,2021,4084,2226,1858,119.8,3834,2060,1774,116.1
38100, 양산시,030004, 28세,2021,4416,2363,2053,115.1,4138,2179,1959,111.2
38100, 양산시,030005, 29세,2021,4547,2372,2175,109.1,4239,2171,2068,105
38100, 양산시,035,30~34세,2021,22031,11529,10502,109.8,20475,10514,9961,105.6
38100, 양산시,035001, 30세,2021,4426,2357,2069,113.9,4115,2156,1959,110.1
38100, 양산시,035002, 31세,2021,4223,2270,1953,116.2,3917,2068,1849,111.8
38100, 양산시,035003, 32세,2021,4389,2267,2122,106.8,4072,2057,2015,102.1
38100, 양산시,035004, 33세,2021,4383,2304,2079,110.8,4056,2093,1963,106.6
38100, 양산시,035005, 34세,2021,4610,2331,2279,102.3,4315,2140,2175,98.4
38100, 양산시,040,35~39세,2021,27159,14146,13013,108.7,25880,13318,12562,106
38100, 양산시,040001, 35세,2021,4543,2383,2160,110.3,4238,2177,2061,105.6
38100, 양산시,040002, 36세,2021,4791,2545,2246,113.3,4557,2398,2159,111.1
38100, 양산시,040003, 37세,2021,5421,2813,2608,107.9,5140,2626,2514,104.5
38100, 양산시,040004, 38세,2021,5871,3070,2801,109.6,5640,2923,2717,107.6
38100, 양산시,040005, 39세,2021,6533,3335,3198,104.3,6305,3194,3111,102.7
38100, 양산시,045,40~44세,2021,31112,15935,15177,105,30228,15363,14865,103.4
38100, 양산시,045001, 40세,2021,6599,3420,3179,107.6,6385,3270,3115,105
38100, 양산시,045002, 41세,2021,6805,3502,3303,106,6617,3381,3236,104.5
38100, 양산시,045003, 42세,2021,6239,3161,3078,102.7,6054,3042,3012,101
38100, 양산시,045004, 43세,2021,5682,2925,2757,106.1,5523,2826,2697,104.8
38100, 양산시,045005, 44세,2021,5787,2927,2860,102.3,5649,2844,2805,101.4
38100, 양산시,050,45~49세,2021,29721,15132,14589,103.7,29118,14761,14357,102.8
38100, 양산시,050001, 45세,2021,5373,2768,2605,106.3,5258,2690,2568,104.8
38100, 양산시,050002, 46세,2021,5971,3041,2930,103.8,5843,2966,2877,103.1
38100, 양산시,050003, 47세,2021,6161,3127,3034,103.1,6039,3043,2996,101.6
38100, 양산시,050004, 48세,2021,6123,3086,3037,101.6,6019,3029,2990,101.3
38100, 양산시,050005, 49세,2021,6093,3110,2983,104.3,5959,3033,2926,103.7
38100, 양산시,055,50~54세,2021,31157,15220,15937,95.5,30633,14948,15685,95.3
38100, 양산시,055001, 50세,2021,6295,3127,3168,98.7,6178,3073,3105,99
38100, 양산시,055002, 51세,2021,6380,3122,3258,95.8,6263,3057,3206,95.4
38100, 양산시,055003, 52세,2021,6343,3136,3207,97.8,6237,3082,3155,97.7
38100, 양산시,055004, 53세,2021,6299,3004,3295,91.2,6195,2940,3255,90.3
38100, 양산시,055005, 54세,2021,5840,2831,3009,94.1,5760,2796,2964,94.3
38100, 양산시,060,55~59세,2021,27301,13937,13364,104.3,26933,13739,13194,104.1
38100, 양산시,060001, 55세,2021,5604,2860,2744,104.2,5519,2819,2700,104.4
38100, 양산시,060002, 56세,2021,5661,2851,2810,101.5,5576,2803,2773,101.1
38100, 양산시,060003, 57세,2021,5041,2563,2478,103.4,4980,2530,2450,103.3
38100, 양산시,060004, 58세,2021,5398,2815,2583,109,5327,2773,2554,108.6
38100, 양산시,060005, 59세,2021,5597,2848,2749,103.6,5531,2814,2717,103.6
38100, 양산시,065,60~64세,2021,26596,13141,13455,97.7,26380,13029,13351,97.6
38100, 양산시,065001, 60세,2021,6062,3015,3047,98.9,6016,2991,3025,98.9
38100, 양산시,065002, 61세,2021,5815,2905,2910,99.8,5759,2873,2886,99.5
38100, 양산시,065003, 62세,2021,5207,2563,2644,96.9,5168,2545,2623,97
38100, 양산시,065004, 63세,2021,4827,2355,2472,95.3,4785,2334,2451,95.2
38100, 양산시,065005, 64세,2021,4685,2303,2382,96.7,4652,2286,2366,96.6
38100, 양산시,070,65~69세,2021,18552,8811,9741,90.5,18421,8762,9659,90.7
38100, 양산시,070001, 65세,2021,4154,1964,2190,89.7,4114,1952,2162,90.3
38100, 양산시,070002, 66세,2021,4342,2048,2294,89.3,4315,2033,2282,89.1
38100, 양산시,070003, 67세,2021,3575,1723,1852,93,3546,1712,1834,93.3
38100, 양산시,070004, 68세,2021,3144,1508,1636,92.2,3126,1504,1622,92.7
38100, 양산시,070005, 69세,2021,3337,1568,1769,88.6,3320,1561,1759,88.7
38100, 양산시,075,70~74세,2021,12655,5866,6789,86.4,12603,5842,6761,86.4
38100, 양산시,075001, 70세,2021,2582,1237,1345,92,2566,1229,1337,91.9
38100, 양산시,075002, 71세,2021,2686,1298,1388,93.5,2676,1295,1381,93.8
38100, 양산시,075003, 72세,2021,2504,1157,1347,85.9,2495,1153,1342,85.9
38100, 양산시,075004, 73세,2021,2588,1177,1411,83.4,2576,1170,1406,83.2
38100, 양산시,075005, 74세,2021,2295,997,1298,76.8,2290,995,1295,76.8
38100, 양산시,080,75~79세,2021,8974,3880,5094,76.2,8959,3875,5084,76.2
38100, 양산시,080001, 75세,2021,1691,734,957,76.7,1689,734,955,76.9
38100, 양산시,080002, 76세,2021,1708,781,927,84.3,1707,781,926,84.3
38100, 양산시,080003, 77세,2021,1760,778,982,79.2,1756,777,979,79.4
38100, 양산시,080004, 78세,2021,1868,775,1093,70.9,1864,773,1091,70.9
38100, 양산시,080005, 79세,2021,1947,812,1135,71.5,1943,810,1133,71.5
38100, 양산시,085,80~84세,2021,6438,2339,4099,57.1,6428,2336,4092,57.1
38100, 양산시,085001, 80세,2021,1534,583,951,61.3,1533,583,950,61.4
38100, 양산시,085002, 81세,2021,1487,548,939,58.4,1485,547,938,58.3
38100, 양산시,085003, 82세,2021,1344,489,855,57.2,1339,489,850,57.5
38100, 양산시,085004, 83세,2021,1080,384,696,55.2,1078,382,696,54.9
38100, 양산시,085005, 84세,2021,993,335,658,50.9,993,335,658,50.9
38100, 양산시,090,85~89세,2021,3120,963,2157,44.6,3114,961,2153,44.6
38100, 양산시,090001, 85세,2021,849,279,570,48.9,848,279,569,49
38100, 양산시,090002, 86세,2021,774,256,518,49.4,771,255,516,49.4
38100, 양산시,090003, 87세,2021,618,182,436,41.7,617,181,436,41.5
38100, 양산시,090004, 88세,2021,485,148,337,43.9,485,148,337,43.9
38100, 양산시,090005, 89세,2021,394,98,296,33.1,393,98,295,33.2
38100, 양산시,095,90~94세,2021,1003,230,773,29.8,1002,230,772,29.8
38100, 양산시,095001, 90세,2021,304,68,236,28.8,304,68,236,28.8
38100, 양산시,095002, 91세,2021,252,62,190,32.6,252,62,190,32.6
38100, 양산시,095003, 92세,2021,197,47,150,31.3,196,47,149,31.5
38100, 양산시,095004, 93세,2021,135,27,108,25,135,27,108,25
38100, 양산시,095005, 94세,2021,115,26,89,29.2,115,26,89,29.2
38100, 양산시,100,95~99세,2021,207,34,173,19.7,207,34,173,19.7
38100, 양산시,100001, 95세,2021,75,11,64,17.2,75,11,64,17.2
38100, 양산시,100002, 96세,2021,49,6,43,14,49,6,43,14
38100, 양산시,100003, 97세,2021,31,5,26,19.2,31,5,26,19.2
38100, 양산시,100004, 98세,2021,30,8,22,36.4,30,8,22,36.4
38100, 양산시,100005, 99세,2021,22,X,18,22.2,22,X,18,22.2
38100, 양산시,101,100세이상,2021,21,X,18,16.7,21,X,18,16.7
38100, 양산시,102,15세미만,2021,50936,26045,24891,104.6,50602,25872,24730,104.6
38100, 양산시,103,15~64세,2021,250704,128842,121862,105.7,243048,124065,118983,104.3
38100, 양산시,104,65세이상,2021,50970,22126,28844,76.7,50755,22043,28712,76.8
38100, 양산시,086,85세이상,2021,4351,1230,3121,39.4,4344,1228,3116,39.4
38100, 양산시,126,평균연령,2021,42,40.9,43.1,,42.1,41,43.2,
38100, 양산시,127,중위연령,2021,43.2,42,44.4,,43.5,42.4,44.7,
38110, 창원시,000,합계,2021,1025702,521016,504686,103.2,1007162,510117,497045,102.6
38110, 창원시,005,0~4세,2021,31767,16323,15444,105.7,31510,16191,15319,105.7
38110, 창원시,005001, 0세,2021,5355,2691,2664,101,5299,2665,2634,101.2
38110, 창원시,005002, 1세,2021,5590,2832,2758,102.7,5537,2805,2732,102.7
38110, 창원시,005003, 2세,2021,6226,3241,2985,108.6,6181,3217,2964,108.5
38110, 창원시,005004, 3세,2021,6878,3567,3311,107.7,6827,3536,3291,107.4
38110, 창원시,005005, 4세,2021,7718,3992,3726,107.1,7666,3968,3698,107.3
38110, 창원시,010,5~9세,2021,47474,24543,22931,107,47265,24443,22822,107.1
38110, 창원시,010001, 5세,2021,8752,4461,4291,104,8710,4442,4268,104.1
38110, 창원시,010002, 6세,2021,9310,4848,4462,108.7,9261,4826,4435,108.8
38110, 창원시,010003, 7세,2021,9334,4860,4474,108.6,9283,4835,4448,108.7
38110, 창원시,010004, 8세,2021,9606,4964,4642,106.9,9572,4948,4624,107
38110, 창원시,010005, 9세,2021,10472,5410,5062,106.9,10439,5392,5047,106.8
38110, 창원시,015,10~14세,2021,49148,25381,23767,106.8,49033,25323,23710,106.8
38110, 창원시,015001, 10세,2021,10102,5224,4878,107.1,10087,5215,4872,107
38110, 창원시,015002, 11세,2021,9636,4996,4640,107.7,9616,4984,4632,107.6
38110, 창원시,015003, 12세,2021,9461,4899,4562,107.4,9428,4886,4542,107.6
38110, 창원시,015004, 13세,2021,9857,4959,4898,101.2,9832,4947,4885,101.3
38110, 창원시,015005, 14세,2021,10092,5303,4789,110.7,10070,5291,4779,110.7
38110, 창원시,020,15~19세,2021,45286,24230,21056,115.1,45056,24125,20931,115.3
38110, 창원시,020001, 15세,2021,9151,4801,4350,110.4,9131,4792,4339,110.4
38110, 창원시,020002, 16세,2021,8708,4547,4161,109.3,8697,4543,4154,109.4
38110, 창원시,020003, 17세,2021,9413,4988,4425,112.7,9391,4980,4411,112.9
38110, 창원시,020004, 18세,2021,9344,5059,4285,118.1,9306,5038,4268,118
38110, 창원시,020005, 19세,2021,8670,4835,3835,126.1,8531,4772,3759,126.9
38110, 창원시,025,20~24세,2021,57768,32941,24827,132.7,56254,32148,24106,133.4
38110, 창원시,025001, 20세,2021,10445,6015,4430,135.8,10249,5918,4331,136.6
38110, 창원시,025002, 21세,2021,11949,6973,4976,140.1,11705,6877,4828,142.4
38110, 창원시,025003, 22세,2021,11432,6532,4900,133.3,11134,6367,4767,133.6
38110, 창원시,025004, 23세,2021,11671,6537,5134,127.3,11300,6332,4968,127.5
38110, 창원시,025005, 24세,2021,12271,6884,5387,127.8,11866,6654,5212,127.7
38110, 창원시,030,25~29세,2021,65629,36978,28651,129.1,63022,35399,27623,128.2
38110, 창원시,030001, 25세,2021,12852,7399,5453,135.7,12380,7109,5271,134.9
38110, 창원시,030002, 26세,2021,12949,7300,5649,129.2,12465,7008,5457,128.4
38110, 창원시,030003, 27세,2021,13189,7414,5775,128.4,12683,7112,5571,127.7
38110, 창원시,030004, 28세,2021,13239,7398,5841,126.7,12687,7053,5634,125.2
38110, 창원시,030005, 29세,2021,13400,7467,5933,125.9,12807,7117,5690,125.1
38110, 창원시,035,30~34세,2021,62188,33944,28244,120.2,58657,31696,26961,117.6
38110, 창원시,035001, 30세,2021,12765,7008,5757,121.7,12149,6617,5532,119.6
38110, 창원시,035002, 31세,2021,12611,6975,5636,123.8,11904,6525,5379,121.3
38110, 창원시,035003, 32세,2021,12344,6760,5584,121.1,11614,6293,5321,118.3
38110, 창원시,035004, 33세,2021,12132,6571,5561,118.2,11429,6128,5301,115.6
38110, 창원시,035005, 34세,2021,12336,6630,5706,116.2,11561,6133,5428,113
38110, 창원시,040,35~39세,2021,71305,37696,33609,112.2,68357,35775,32582,109.8
38110, 창원시,040001, 35세,2021,12328,6662,5666,117.6,11630,6210,5420,114.6
38110, 창원시,040002, 36세,2021,13099,6954,6145,113.2,12447,6540,5907,110.7
38110, 창원시,040003, 37세,2021,13633,7272,6361,114.3,13052,6862,6190,110.9
38110, 창원시,040004, 38세,2021,15443,8154,7289,111.9,14905,7799,7106,109.8
38110, 창원시,040005, 39세,2021,16802,8654,8148,106.2,16323,8364,7959,105.1
38110, 창원시,045,40~44세,2021,81807,42259,39548,106.9,79941,41090,38851,105.8
38110, 창원시,045001, 40세,2021,17200,8966,8234,108.9,16722,8649,8073,107.1
38110, 창원시,045002, 41세,2021,17599,8922,8677,102.8,17209,8679,8530,101.7
38110, 창원시,045003, 42세,2021,16432,8518,7914,107.6,16051,8279,7772,106.5
38110, 창원시,045004, 43세,2021,15282,7977,7305,109.2,14937,7768,7169,108.4
38110, 창원시,045005, 44세,2021,15294,7876,7418,106.2,15022,7715,7307,105.6
38110, 창원시,050,45~49세,2021,83453,42247,41206,102.5,81967,41364,40603,101.9
38110, 창원시,050001, 45세,2021,14954,7736,7218,107.2,14644,7548,7096,106.4
38110, 창원시,050002, 46세,2021,15826,7961,7865,101.2,15526,7788,7738,100.6
38110, 창원시,050003, 47세,2021,17412,8813,8599,102.5,17125,8647,8478,102
38110, 창원시,050004, 48세,2021,17876,8917,8959,99.5,17596,8752,8844,99
38110, 창원시,050005, 49세,2021,17385,8820,8565,103,17076,8629,8447,102.2
38110, 창원시,055,50~54세,2021,95004,46489,48515,95.8,93533,45678,47855,95.5
38110, 창원시,055001, 50세,2021,19078,9348,9730,96.1,18751,9145,9606,95.2
38110, 창원시,055002, 51세,2021,19089,9474,9615,98.5,18766,9293,9473,98.1
38110, 창원시,055003, 52세,2021,19357,9588,9769,98.1,19071,9440,9631,98
38110, 창원시,055004, 53세,2021,19493,9384,10109,92.8,19209,9238,9971,92.6
38110, 창원시,055005, 54세,2021,17987,8695,9292,93.6,17736,8562,9174,93.3
38110, 창원시,060,55~59세,2021,88555,44274,44281,100,87409,43683,43726,99.9
38110, 창원시,060001, 55세,2021,17771,8978,8793,102.1,17552,8865,8687,102
38110, 창원시,060002, 56세,2021,18154,8893,9261,96,17920,8760,9160,95.6
38110, 창원시,060003, 57세,2021,15982,7910,8072,98,15747,7793,7954,98
38110, 창원시,060004, 58세,2021,17922,9095,8827,103,17661,8966,8695,103.1
38110, 창원시,060005, 59세,2021,18726,9398,9328,100.8,18529,9299,9230,100.7
38110, 창원시,065,60~64세,2021,87538,43470,44068,98.6,86952,43192,43760,98.7
38110, 창원시,065001, 60세,2021,19976,9916,10060,98.6,19844,9855,9989,98.7
38110, 창원시,065002, 61세,2021,19616,9658,9958,97,19470,9591,9879,97.1
38110, 창원시,065003, 62세,2021,16978,8494,8484,100.1,16866,8441,8425,100.2
38110, 창원시,065004, 63세,2021,15733,7925,7808,101.5,15626,7871,7755,101.5
38110, 창원시,065005, 64세,2021,15235,7477,7758,96.4,15146,7434,7712,96.4
38110, 창원시,070,65~69세,2021,61484,30064,31420,95.7,61160,29921,31239,95.8
38110, 창원시,070001, 65세,2021,14095,6779,7316,92.7,14000,6738,7262,92.8
38110, 창원시,070002, 66세,2021,14506,6964,7542,92.3,14436,6933,7503,92.4
38110, 창원시,070003, 67세,2021,11699,5871,5828,100.7,11636,5845,5791,100.9
38110, 창원시,070004, 68세,2021,10337,5098,5239,97.3,10275,5067,5208,97.3
38110, 창원시,070005, 69세,2021,10847,5352,5495,97.4,10813,5338,5475,97.5
38110, 창원시,075,70~74세,2021,39564,18852,20712,91,39426,18794,20632,91.1
38110, 창원시,075001, 70세,2021,8317,3944,4373,90.2,8284,3929,4355,90.2
38110, 창원시,075002, 71세,2021,8106,3856,4250,90.7,8074,3841,4233,90.7
38110, 창원시,075003, 72세,2021,8230,3961,4269,92.8,8198,3949,4249,92.9
38110, 창원시,075004, 73세,2021,7722,3732,3990,93.5,7708,3725,3983,93.5
38110, 창원시,075005, 74세,2021,7189,3359,3830,87.7,7162,3350,3812,87.9
38110, 창원시,080,75~79세,2021,25822,11282,14540,77.6,25768,11266,14502,77.7
38110, 창원시,080001, 75세,2021,5169,2466,2703,91.2,5157,2462,2695,91.4
38110, 창원시,080002, 76세,2021,5019,2249,2770,81.2,5007,2245,2762,81.3
38110, 창원시,080003, 77세,2021,5237,2291,2946,77.8,5223,2288,2935,78
38110, 창원시,080004, 78세,2021,5033,2091,2942,71.1,5024,2087,2937,71.1
38110, 창원시,080005, 79세,2021,5364,2185,3179,68.7,5357,2184,3173,68.8
38110, 창원시,085,80~84세,2021,18512,6717,11795,56.9,18472,6707,11765,57
38110, 창원시,085001, 80세,2021,4520,1775,2745,64.7,4511,1773,2738,64.8
38110, 창원시,085002, 81세,2021,4048,1511,2537,59.6,4040,1508,2532,59.6
38110, 창원시,085003, 82세,2021,3783,1344,2439,55.1,3775,1341,2434,55.1
38110, 창원시,085004, 83세,2021,3177,1112,2065,53.8,3165,1111,2054,54.1
38110, 창원시,085005, 84세,2021,2984,975,2009,48.5,2981,974,2007,48.5
38110, 창원시,090,85~89세,2021,9613,2649,6964,38,9602,2645,6957,38
38110, 창원시,090001, 85세,2021,2638,820,1818,45.1,2634,819,1815,45.1
38110, 창원시,090002, 86세,2021,2309,675,1634,41.3,2305,673,1632,41.2
38110, 창원시,090003, 87세,2021,1883,488,1395,35,1882,488,1394,35
38110, 창원시,090004, 88세,2021,1479,385,1094,35.2,1477,384,1093,35.1
38110, 창원시,090005, 89세,2021,1304,281,1023,27.5,1304,281,1023,27.5
38110, 창원시,095,90~94세,2021,3150,580,2570,22.6,3146,580,2566,22.6
38110, 창원시,095001, 90세,2021,991,196,795,24.7,990,196,794,24.7
38110, 창원시,095002, 91세,2021,787,127,660,19.2,785,127,658,19.3
38110, 창원시,095003, 92세,2021,610,118,492,24,610,118,492,24
38110, 창원시,095004, 93세,2021,469,89,380,23.4,468,89,379,23.5
38110, 창원시,095005, 94세,2021,293,50,243,20.6,293,50,243,20.6
38110, 창원시,100,95~99세,2021,573,89,484,18.4,570,89,481,18.5
38110, 창원시,100001, 95세,2021,209,33,176,18.8,208,33,175,18.9
38110, 창원시,100002, 96세,2021,157,30,127,23.6,156,30,126,23.8
38110, 창원시,100003, 97세,2021,88,9,79,11.4,87,9,78,11.5
38110, 창원시,100004, 98세,2021,81,8,73,11,81,8,73,11
38110, 창원시,100005, 99세,2021,38,9,29,31,38,9,29,31
38110, 창원시,101,100세이상,2021,62,8,54,14.8,62,8,54,14.8
38110, 창원시,102,15세미만,2021,128389,66247,62142,106.6,127808,65957,61851,106.6
38110, 창원시,103,15~64세,2021,738533,384528,354005,108.6,721148,374150,346998,107.8
38110, 창원시,104,65세이상,2021,158780,70241,88539,79.3,158206,70010,88196,79.4
38110, 창원시,086,85세이상,2021,13398,3326,10072,33,13380,3322,10058,33
38110, 창원시,126,평균연령,2021,43.3,42,44.6,,43.3,42,44.7,
38110, 창원시,127,중위연령,2021,45,43.3,46.9,,45.3,43.6,47.1,
38111, 의창구,000,합계,2021,216915,110377,106538,103.6,212865,108105,104760,103.2
38111, 의창구,005,0~4세,2021,7167,3694,3473,106.4,7112,3665,3447,106.3
38111, 의창구,005001, 0세,2021,1273,648,625,103.7,1258,640,618,103.6
38111, 의창구,005002, 1세,2021,1213,590,623,94.7,1204,585,619,94.5
38111, 의창구,005003, 2세,2021,1426,746,680,109.7,1418,743,675,110.1
38111, 의창구,005004, 3세,2021,1512,783,729,107.4,1499,773,726,106.5
38111, 의창구,005005, 4세,2021,1743,927,816,113.6,1733,924,809,114.2
38111, 의창구,010,5~9세,2021,9979,5044,4935,102.2,9943,5025,4918,102.2
38111, 의창구,010001, 5세,2021,1896,948,948,100,1890,944,946,99.8
38111, 의창구,010002, 6세,2021,2024,1025,999,102.6,2014,1021,993,102.8
38111, 의창구,010003, 7세,2021,1944,1017,927,109.7,1935,1012,923,109.6
38111, 의창구,010004, 8세,2021,1983,991,992,99.9,1978,988,990,99.8
38111, 의창구,010005, 9세,2021,2132,1063,1069,99.4,2126,1060,1066,99.4
38111, 의창구,015,10~14세,2021,9777,5076,4701,108,9747,5059,4688,107.9
38111, 의창구,015001, 10세,2021,2044,1072,972,110.3,2040,1069,971,110.1
38111, 의창구,015002, 11세,2021,2000,1033,967,106.8,1991,1028,963,106.7
38111, 의창구,015003, 12세,2021,1888,961,927,103.7,1880,958,922,103.9
38111, 의창구,015004, 13세,2021,1900,986,914,107.9,1895,981,914,107.3
38111, 의창구,015005, 14세,2021,1945,1024,921,111.2,1941,1023,918,111.4
38111, 의창구,020,15~19세,2021,8797,4741,4056,116.9,8723,4710,4013,117.4
38111, 의창구,020001, 15세,2021,1739,894,845,105.8,1735,893,842,106.1
38111, 의창구,020002, 16세,2021,1667,895,772,115.9,1663,894,769,116.3
38111, 의창구,020003, 17세,2021,1889,992,897,110.6,1883,991,892,111.1
38111, 의창구,020004, 18세,2021,1846,992,854,116.2,1832,984,848,116
38111, 의창구,020005, 19세,2021,1656,968,688,140.7,1610,948,662,143.2
38111, 의창구,025,20~24세,2021,12807,7190,5617,128,12501,7053,5448,129.5
38111, 의창구,025001, 20세,2021,2184,1236,948,130.4,2136,1215,921,131.9
38111, 의창구,025002, 21세,2021,2529,1480,1049,141.1,2496,1475,1021,144.5
38111, 의창구,025003, 22세,2021,2506,1375,1131,121.6,2456,1354,1102,122.9
38111, 의창구,025004, 23세,2021,2684,1471,1213,121.3,2602,1431,1171,122.2
38111, 의창구,025005, 24세,2021,2904,1628,1276,127.6,2811,1578,1233,128
38111, 의창구,030,25~29세,2021,14841,8364,6477,129.1,14276,8037,6239,128.8
38111, 의창구,030001, 25세,2021,2942,1710,1232,138.8,2841,1650,1191,138.5
38111, 의창구,030002, 26세,2021,2944,1688,1256,134.4,2835,1624,1211,134.1
38111, 의창구,030003, 27세,2021,3003,1645,1358,121.1,2897,1580,1317,120
38111, 의창구,030004, 28세,2021,2979,1640,1339,122.5,2840,1570,1270,123.6
38111, 의창구,030005, 29세,2021,2973,1681,1292,130.1,2863,1613,1250,129
38111, 의창구,035,30~34세,2021,13671,7451,6220,119.8,12892,6960,5932,117.3
38111, 의창구,035001, 30세,2021,2939,1643,1296,126.8,2818,1558,1260,123.7
38111, 의창구,035002, 31세,2021,2754,1517,1237,122.6,2603,1426,1177,121.2
38111, 의창구,035003, 32세,2021,2687,1448,1239,116.9,2543,1356,1187,114.2
38111, 의창구,035004, 33세,2021,2640,1407,1233,114.1,2463,1303,1160,112.3
38111, 의창구,035005, 34세,2021,2651,1436,1215,118.2,2465,1317,1148,114.7
38111, 의창구,040,35~39세,2021,15434,8158,7276,112.1,14804,7768,7036,110.4
38111, 의창구,040001, 35세,2021,2660,1455,1205,120.7,2510,1364,1146,119
38111, 의창구,040002, 36세,2021,2915,1562,1353,115.4,2775,1478,1297,114
38111, 의창구,040003, 37세,2021,2953,1557,1396,111.5,2829,1470,1359,108.2
38111, 의창구,040004, 38세,2021,3302,1712,1590,107.7,3191,1644,1547,106.3
38111, 의창구,040005, 39세,2021,3604,1872,1732,108.1,3499,1812,1687,107.4
38111, 의창구,045,40~44세,2021,16754,8744,8010,109.2,16344,8502,7842,108.4
38111, 의창구,045001, 40세,2021,3661,1909,1752,109,3558,1843,1715,107.5
38111, 의창구,045002, 41세,2021,3684,1914,1770,108.1,3597,1860,1737,107.1
38111, 의창구,045003, 42세,2021,3297,1728,1569,110.1,3209,1676,1533,109.3
38111, 의창구,045004, 43세,2021,3104,1645,1459,112.7,3031,1601,1430,112
38111, 의창구,045005, 44세,2021,3008,1548,1460,106,2949,1522,1427,106.7
38111, 의창구,050,45~49세,2021,17056,8595,8461,101.6,16698,8403,8295,101.3
38111, 의창구,050001, 45세,2021,3074,1579,1495,105.6,2993,1535,1458,105.3
38111, 의창구,050002, 46세,2021,3113,1622,1491,108.8,3044,1581,1463,108.1
38111, 의창구,050003, 47세,2021,3438,1743,1695,102.8,3368,1709,1659,103
38111, 의창구,050004, 48세,2021,3728,1804,1924,93.8,3665,1775,1890,93.9
38111, 의창구,050005, 49세,2021,3703,1847,1856,99.5,3628,1803,1825,98.8
38111, 의창구,055,50~54세,2021,20780,9882,10898,90.7,20467,9711,10756,90.3
38111, 의창구,055001, 50세,2021,3997,1870,2127,87.9,3941,1836,2105,87.2
38111, 의창구,055002, 51세,2021,4069,1970,2099,93.9,4004,1931,2073,93.2
38111, 의창구,055003, 52세,2021,4292,2081,2211,94.1,4223,2044,2179,93.8
38111, 의창구,055004, 53세,2021,4336,2052,2284,89.8,4256,2013,2243,89.7
38111, 의창구,055005, 54세,2021,4086,1909,2177,87.7,4043,1887,2156,87.5
38111, 의창구,060,55~59세,2021,20058,10087,9971,101.2,19800,9956,9844,101.1
38111, 의창구,060001, 55세,2021,4058,2014,2044,98.5,4005,1985,2020,98.3
38111, 의창구,060002, 56세,2021,4257,2102,2155,97.5,4196,2068,2128,97.2
38111, 의창구,060003, 57세,2021,3544,1741,1803,96.6,3499,1719,1780,96.6
38111, 의창구,060004, 58세,2021,3995,2056,1939,106,3943,2033,1910,106.4
38111, 의창구,060005, 59세,2021,4204,2174,2030,107.1,4157,2151,2006,107.2
38111, 의창구,065,60~64세,2021,18899,9589,9310,103,18784,9540,9244,103.2
38111, 의창구,065001, 60세,2021,4418,2249,2169,103.7,4393,2242,2151,104.2
38111, 의창구,065002, 61세,2021,4301,2161,2140,101,4268,2144,2124,100.9
38111, 의창구,065003, 62세,2021,3648,1896,1752,108.2,3627,1886,1741,108.3
38111, 의창구,065004, 63세,2021,3353,1743,1610,108.3,3334,1734,1600,108.4
38111, 의창구,065005, 64세,2021,3179,1540,1639,94,3162,1534,1628,94.2
38111, 의창구,070,65~69세,2021,12459,6194,6265,98.9,12392,6165,6227,99
38111, 의창구,070001, 65세,2021,2937,1443,1494,96.6,2919,1436,1483,96.8
38111, 의창구,070002, 66세,2021,2874,1422,1452,97.9,2856,1413,1443,97.9
38111, 의창구,070003, 67세,2021,2412,1189,1223,97.2,2400,1185,1215,97.5
38111, 의창구,070004, 68세,2021,2070,1040,1030,101,2055,1033,1022,101.1
38111, 의창구,070005, 69세,2021,2166,1100,1066,103.2,2162,1098,1064,103.2
38111, 의창구,075,70~74세,2021,7434,3698,3736,99,7402,3683,3719,99
38111, 의창구,075001, 70세,2021,1606,800,806,99.3,1597,794,803,98.9
38111, 의창구,075002, 71세,2021,1514,763,751,101.6,1508,760,748,101.6
38111, 의창구,075003, 72세,2021,1542,753,789,95.4,1535,752,783,96
38111, 의창구,075004, 73세,2021,1424,721,703,102.6,1418,717,701,102.3
38111, 의창구,075005, 74세,2021,1348,661,687,96.2,1344,660,684,96.5
38111, 의창구,080,75~79세,2021,4692,2037,2655,76.7,4681,2035,2646,76.9
38111, 의창구,080001, 75세,2021,915,446,469,95.1,911,444,467,95.1
38111, 의창구,080002, 76세,2021,865,402,463,86.8,863,402,461,87.2
38111, 의창구,080003, 77세,2021,937,414,523,79.2,935,414,521,79.5
38111, 의창구,080004, 78세,2021,973,382,591,64.6,970,382,588,65
38111, 의창구,080005, 79세,2021,1002,393,609,64.5,1002,393,609,64.5
38111, 의창구,085,80~84세,2021,3543,1201,2342,51.3,3535,1201,2334,51.5
38111, 의창구,085001, 80세,2021,820,309,511,60.5,817,309,508,60.8
38111, 의창구,085002, 81세,2021,781,291,490,59.4,781,291,490,59.4
38111, 의창구,085003, 82세,2021,717,222,495,44.8,715,222,493,45
38111, 의창구,085004, 83세,2021,624,193,431,44.8,621,193,428,45.1
38111, 의창구,085005, 84세,2021,601,186,415,44.8,601,186,415,44.8
38111, 의창구,090,85~89세,2021,1974,507,1467,34.6,1973,507,1466,34.6
38111, 의창구,090001, 85세,2021,526,164,362,45.3,525,164,361,45.4
38111, 의창구,090002, 86세,2021,491,145,346,41.9,491,145,346,41.9
38111, 의창구,090003, 87세,2021,367,74,293,25.3,367,74,293,25.3
38111, 의창구,090004, 88세,2021,324,75,249,30.1,324,75,249,30.1
38111, 의창구,090005, 89세,2021,266,49,217,22.6,266,49,217,22.6
38111, 의창구,095,90~94세,2021,667,113,554,20.4,665,113,552,20.5
38111, 의창구,095001, 90세,2021,207,46,161,28.6,206,46,160,28.8
38111, 의창구,095002, 91세,2021,173,22,151,14.6,172,22,150,14.7
38111, 의창구,095003, 92세,2021,129,25,104,24,129,25,104,24
38111, 의창구,095004, 93세,2021,93,13,80,16.3,93,13,80,16.3
38111, 의창구,095005, 94세,2021,65,7,58,12.1,65,7,58,12.1
38111, 의창구,100,95~99세,2021,113,12,101,11.9,113,12,101,11.9
38111, 의창구,100001, 95세,2021,42,5,37,13.5,42,5,37,13.5
38111, 의창구,100002, 96세,2021,30,5,25,20,30,5,25,20
38111, 의창구,100003, 97세,2021,21,X,21,0,21,X,21,0
38111, 의창구,100004, 98세,2021,12,X,11,9.1,12,X,11,9.1
38111, 의창구,100005, 99세,2021,8,X,7,14.3,8,X,7,14.3
38111, 의창구,101,100세이상,2021,13,X,13,0,13,X,13,0
38111, 의창구,102,15세미만,2021,26923,13814,13109,105.4,26802,13749,13053,105.3
38111, 의창구,103,15~64세,2021,159097,82801,76296,108.5,155289,80640,74649,108
38111, 의창구,104,65세이상,2021,30895,13762,17133,80.3,30774,13716,17058,80.4
38111, 의창구,086,85세이상,2021,2767,632,2135,29.6,2764,632,2132,29.6
38111, 의창구,126,평균연령,2021,42.9,41.8,44.2,,43,41.8,44.3,
38111, 의창구,127,중위연령,2021,44.7,43,46.7,,45,43.2,46.9,
38112, 성산구,000,합계,2021,249909,128932,120977,106.6,245091,125859,119232,105.6
38112, 성산구,005,0~4세,2021,7487,3845,3642,105.6,7410,3801,3609,105.3
38112, 성산구,005001, 0세,2021,1297,661,636,103.9,1277,652,625,104.3
38112, 성산구,005002, 1세,2021,1355,690,665,103.8,1339,681,658,103.5
38112, 성산구,005003, 2세,2021,1431,718,713,100.7,1417,709,708,100.1
38112, 성산구,005004, 3세,2021,1667,872,795,109.7,1649,860,789,109
38112, 성산구,005005, 4세,2021,1737,904,833,108.5,1728,899,829,108.4
38112, 성산구,010,5~9세,2021,10993,5650,5343,105.7,10933,5628,5305,106.1
38112, 성산구,010001, 5세,2021,2019,1015,1004,101.1,2007,1014,993,102.1
38112, 성산구,010002, 6세,2021,2154,1122,1032,108.7,2143,1118,1025,109.1
38112, 성산구,010003, 7세,2021,2160,1113,1047,106.3,2143,1105,1038,106.5
38112, 성산구,010004, 8세,2021,2192,1130,1062,106.4,2182,1126,1056,106.6
38112, 성산구,010005, 9세,2021,2468,1270,1198,106,2458,1265,1193,106
38112, 성산구,015,10~14세,2021,12247,6405,5842,109.6,12215,6389,5826,109.7
38112, 성산구,015001, 10세,2021,2387,1256,1131,111.1,2383,1254,1129,111.1
38112, 성산구,015002, 11세,2021,2328,1194,1134,105.3,2320,1190,1130,105.3
38112, 성산구,015003, 12세,2021,2370,1248,1122,111.2,2361,1246,1115,111.7
38112, 성산구,015004, 13세,2021,2536,1296,1240,104.5,2532,1294,1238,104.5
38112, 성산구,015005, 14세,2021,2626,1411,1215,116.1,2619,1405,1214,115.7
38112, 성산구,020,15~19세,2021,12164,6676,5488,121.6,12132,6666,5466,122
38112, 성산구,020001, 15세,2021,2435,1302,1133,114.9,2428,1299,1129,115.1
38112, 성산구,020002, 16세,2021,2418,1297,1121,115.7,2415,1295,1120,115.6
38112, 성산구,020003, 17세,2021,2603,1417,1186,119.5,2597,1415,1182,119.7
38112, 성산구,020004, 18세,2021,2590,1414,1176,120.2,2587,1413,1174,120.4
38112, 성산구,020005, 19세,2021,2118,1246,872,142.9,2105,1244,861,144.5
38112, 성산구,025,20~24세,2021,15291,9028,6263,144.1,15009,8857,6152,144
38112, 성산구,025001, 20세,2021,2597,1634,963,169.7,2584,1627,957,170
38112, 성산구,025002, 21세,2021,3097,1987,1110,179,3075,1978,1097,180.3
38112, 성산구,025003, 22세,2021,2999,1798,1201,149.7,2944,1765,1179,149.7
38112, 성산구,025004, 23세,2021,3236,1790,1446,123.8,3156,1737,1419,122.4
38112, 성산구,025005, 24세,2021,3362,1819,1543,117.9,3250,1750,1500,116.7
38112, 성산구,030,25~29세,2021,19680,11129,8551,130.1,18956,10645,8311,128.1
38112, 성산구,030001, 25세,2021,3789,2166,1623,133.5,3668,2083,1585,131.4
38112, 성산구,030002, 26세,2021,3901,2197,1704,128.9,3778,2118,1660,127.6
38112, 성산구,030003, 27세,2021,4012,2315,1697,136.4,3867,2216,1651,134.2
38112, 성산구,030004, 28세,2021,3961,2209,1752,126.1,3822,2114,1708,123.8
38112, 성산구,030005, 29세,2021,4017,2242,1775,126.3,3821,2114,1707,123.8
38112, 성산구,035,30~34세,2021,18125,10153,7972,127.4,17134,9466,7668,123.4
38112, 성산구,035001, 30세,2021,3889,2145,1744,123,3712,2024,1688,119.9
38112, 성산구,035002, 31세,2021,3735,2129,1606,132.6,3521,1986,1535,129.4
38112, 성산구,035003, 32세,2021,3614,2034,1580,128.7,3403,1887,1516,124.5
38112, 성산구,035004, 33세,2021,3447,1923,1524,126.2,3271,1800,1471,122.4
38112, 성산구,035005, 34세,2021,3440,1922,1518,126.6,3227,1769,1458,121.3
38112, 성산구,040,35~39세,2021,17380,9239,8141,113.5,16578,8657,7921,109.3
38112, 성산구,040001, 35세,2021,3235,1761,1474,119.5,3063,1637,1426,114.8
38112, 성산구,040002, 36세,2021,3395,1846,1549,119.2,3205,1708,1497,114.1
38112, 성산구,040003, 37세,2021,3340,1804,1536,117.4,3189,1685,1504,112
38112, 성산구,040004, 38세,2021,3656,1941,1715,113.2,3507,1833,1674,109.5
38112, 성산구,040005, 39세,2021,3754,1887,1867,101.1,3614,1794,1820,98.6
38112, 성산구,045,40~44세,2021,19244,9626,9618,100.1,18739,9286,9453,98.2
38112, 성산구,045001, 40세,2021,3933,1979,1954,101.3,3805,1889,1916,98.6
38112, 성산구,045002, 41세,2021,4086,2033,2053,99,3980,1964,2016,97.4
38112, 성산구,045003, 42세,2021,3829,1920,1909,100.6,3734,1848,1886,98
38112, 성산구,045004, 43세,2021,3693,1859,1834,101.4,3594,1797,1797,100
38112, 성산구,045005, 44세,2021,3703,1835,1868,98.2,3626,1788,1838,97.3
38112, 성산구,050,45~49세,2021,21533,10127,11406,88.8,21183,9898,11285,87.7
38112, 성산구,050001, 45세,2021,3723,1819,1904,95.5,3663,1777,1886,94.2
38112, 성산구,050002, 46세,2021,3914,1793,2121,84.5,3834,1746,2088,83.6
38112, 성산구,050003, 47세,2021,4485,2087,2398,87,4417,2039,2378,85.7
38112, 성산구,050004, 48세,2021,4678,2162,2516,85.9,4603,2112,2491,84.8
38112, 성산구,050005, 49세,2021,4733,2266,2467,91.9,4666,2224,2442,91.1
38112, 성산구,055,50~54세,2021,26659,12448,14211,87.6,26284,12238,14046,87.1
38112, 성산구,055001, 50세,2021,5208,2476,2732,90.6,5136,2435,2701,90.2
38112, 성산구,055002, 51세,2021,5481,2603,2878,90.4,5388,2543,2845,89.4
38112, 성산구,055003, 52세,2021,5381,2461,2920,84.3,5308,2425,2883,84.1
38112, 성산구,055004, 53세,2021,5529,2545,2984,85.3,5460,2510,2950,85.1
38112, 성산구,055005, 54세,2021,5060,2363,2697,87.6,4992,2325,2667,87.2
38112, 성산구,060,55~59세,2021,24674,12367,12307,100.5,24378,12210,12168,100.3
38112, 성산구,060001, 55세,2021,4927,2437,2490,97.9,4885,2416,2469,97.9
38112, 성산구,060002, 56세,2021,5217,2542,2675,95,5154,2508,2646,94.8
38112, 성산구,060003, 57세,2021,4517,2212,2305,96,4454,2184,2270,96.2
38112, 성산구,060004, 58세,2021,4980,2591,2389,108.5,4907,2546,2361,107.8
38112, 성산구,060005, 59세,2021,5033,2585,2448,105.6,4978,2556,2422,105.5
38112, 성산구,065,60~64세,2021,20582,10931,9651,113.3,20425,10864,9561,113.6
38112, 성산구,065001, 60세,2021,5230,2653,2577,102.9,5189,2633,2556,103
38112, 성산구,065002, 61세,2021,4897,2594,2303,112.6,4859,2583,2276,113.5
38112, 성산구,065003, 62세,2021,3908,2144,1764,121.5,3880,2133,1747,122.1
38112, 성산구,065004, 63세,2021,3477,1907,1570,121.5,3451,1893,1558,121.5
38112, 성산구,065005, 64세,2021,3070,1633,1437,113.6,3046,1622,1424,113.9
38112, 성산구,070,65~69세,2021,10833,5638,5195,108.5,10753,5602,5151,108.8
38112, 성산구,070001, 65세,2021,2687,1381,1306,105.7,2665,1372,1293,106.1
38112, 성산구,070002, 66세,2021,2624,1313,1311,100.2,2603,1303,1300,100.2
38112, 성산구,070003, 67세,2021,2012,1088,924,117.7,1997,1082,915,118.3
38112, 성산구,070004, 68세,2021,1810,948,862,110,1797,940,857,109.7
38112, 성산구,070005, 69세,2021,1700,908,792,114.6,1691,905,786,115.1
38112, 성산구,075,70~74세,2021,5842,2979,2863,104.1,5810,2965,2845,104.2
38112, 성산구,075001, 70세,2021,1376,694,682,101.8,1367,689,678,101.6
38112, 성산구,075002, 71세,2021,1210,649,561,115.7,1204,647,557,116.2
38112, 성산구,075003, 72세,2021,1156,584,572,102.1,1149,580,569,101.9
38112, 성산구,075004, 73세,2021,1084,535,549,97.4,1081,533,548,97.3
38112, 성산구,075005, 74세,2021,1016,517,499,103.6,1009,516,493,104.7
38112, 성산구,080,75~79세,2021,3258,1482,1776,83.4,3244,1479,1765,83.8
38112, 성산구,080001, 75세,2021,716,365,351,104,711,365,346,105.5
38112, 성산구,080002, 76세,2021,644,323,321,100.6,641,322,319,100.9
38112, 성산구,080003, 77세,2021,616,257,359,71.6,615,256,359,71.3
38112, 성산구,080004, 78세,2021,615,275,340,80.9,614,274,340,80.6
38112, 성산구,080005, 79세,2021,667,262,405,64.7,663,262,401,65.3
38112, 성산구,085,80~84세,2021,2237,759,1478,51.4,2232,758,1474,51.4
38112, 성산구,085001, 80세,2021,525,202,323,62.5,524,202,322,62.7
38112, 성산구,085002, 81세,2021,490,159,331,48,490,159,331,48
38112, 성산구,085003, 82세,2021,493,160,333,48,493,160,333,48
38112, 성산구,085004, 83세,2021,372,124,248,50,369,124,245,50.6
38112, 성산구,085005, 84세,2021,357,114,243,46.9,356,113,243,46.5
38112, 성산구,090,85~89세,2021,1247,342,905,37.8,1247,342,905,37.8
38112, 성산구,090001, 85세,2021,327,95,232,40.9,327,95,232,40.9
38112, 성산구,090002, 86세,2021,314,88,226,38.9,314,88,226,38.9
38112, 성산구,090003, 87세,2021,237,56,181,30.9,237,56,181,30.9
38112, 성산구,090004, 88세,2021,200,61,139,43.9,200,61,139,43.9
38112, 성산구,090005, 89세,2021,169,42,127,33.1,169,42,127,33.1
38112, 성산구,095,90~94세,2021,368,90,278,32.4,367,90,277,32.5
38112, 성산구,095001, 90세,2021,120,30,90,33.3,120,30,90,33.3
38112, 성산구,095002, 91세,2021,92,23,69,33.3,92,23,69,33.3
38112, 성산구,095003, 92세,2021,66,16,50,32,66,16,50,32
38112, 성산구,095004, 93세,2021,51,11,40,27.5,50,11,39,28.2
38112, 성산구,095005, 94세,2021,39,10,29,34.5,39,10,29,34.5
38112, 성산구,100,95~99세,2021,60,16,44,36.4,57,16,41,39
38112, 성산구,100001, 95세,2021,20,7,13,53.8,19,7,12,58.3
38112, 성산구,100002, 96세,2021,18,7,11,63.6,17,7,10,70
38112, 성산구,100003, 97세,2021,15,X,14,7.1,14,X,13,7.7
38112, 성산구,100004, 98세,2021,X,X,X,33.3,X,X,X,33.3
38112, 성산구,100005, 99세,2021,X,X,X,0,X,X,X,0
38112, 성산구,101,100세이상,2021,5,X,X,66.7,5,X,X,66.7
38112, 성산구,102,15세미만,2021,30727,15900,14827,107.2,30558,15818,14740,107.3
38112, 성산구,103,15~64세,2021,195332,101724,93608,108.7,190818,98787,92031,107.3
38112, 성산구,104,65세이상,2021,23850,11308,12542,90.2,23715,11254,12461,90.3
38112, 성산구,086,85세이상,2021,1680,450,1230,36.6,1676,450,1226,36.7
38112, 성산구,126,평균연령,2021,41.1,40.2,42.1,,41.2,40.3,42.1,
38112, 성산구,127,중위연령,2021,42.9,41.2,44.8,,43.2,41.5,44.9,
38113, 마산합포구,000,합계,2021,180049,89581,90468,99,177345,88032,89313,98.6
38113, 마산합포구,005,0~4세,2021,5258,2702,2556,105.7,5242,2696,2546,105.9
38113, 마산합포구,005001, 0세,2021,896,427,469,91,893,425,468,90.8
38113, 마산합포구,005002, 1세,2021,917,467,450,103.8,915,465,450,103.3
38113, 마산합포구,005003, 2세,2021,1056,564,492,114.6,1052,563,489,115.1
38113, 마산합포구,005004, 3세,2021,1116,583,533,109.4,1114,583,531,109.8
38113, 마산합포구,005005, 4세,2021,1273,661,612,108,1268,660,608,108.6
38113, 마산합포구,010,5~9세,2021,7830,4046,3784,106.9,7812,4040,3772,107.1
38113, 마산합포구,010001, 5세,2021,1472,784,688,114,1470,783,687,114
38113, 마산합포구,010002, 6세,2021,1563,795,768,103.5,1557,794,763,104.1
38113, 마산합포구,010003, 7세,2021,1532,791,741,106.7,1530,790,740,106.8
38113, 마산합포구,010004, 8세,2021,1606,841,765,109.9,1602,839,763,110
38113, 마산합포구,010005, 9세,2021,1657,835,822,101.6,1653,834,819,101.8
38113, 마산합포구,015,10~14세,2021,7231,3720,3511,106,7221,3714,3507,105.9
38113, 마산합포구,015001, 10세,2021,1600,807,793,101.8,1599,806,793,101.6
38113, 마산합포구,015002, 11세,2021,1391,707,684,103.4,1390,706,684,103.2
38113, 마산합포구,015003, 12세,2021,1398,743,655,113.4,1395,741,654,113.3
38113, 마산합포구,015004, 13세,2021,1374,715,659,108.5,1371,714,657,108.7
38113, 마산합포구,015005, 14세,2021,1468,748,720,103.9,1466,747,719,103.9
38113, 마산합포구,020,15~19세,2021,6979,3656,3323,110,6955,3639,3316,109.7
38113, 마산합포구,020001, 15세,2021,1265,628,637,98.6,1264,627,637,98.4
38113, 마산합포구,020002, 16세,2021,1202,641,561,114.3,1202,641,561,114.3
38113, 마산합포구,020003, 17세,2021,1371,676,695,97.3,1367,674,693,97.3
38113, 마산합포구,020004, 18세,2021,1427,789,638,123.7,1422,786,636,123.6
38113, 마산합포구,020005, 19세,2021,1714,922,792,116.4,1700,911,789,115.5
38113, 마산합포구,025,20~24세,2021,10203,5782,4421,130.8,9765,5557,4208,132.1
38113, 마산합포구,025001, 20세,2021,1820,982,838,117.2,1760,955,805,118.6
38113, 마산합포구,025002, 21세,2021,2166,1206,960,125.6,2074,1172,902,129.9
38113, 마산합포구,025003, 22세,2021,2103,1184,919,128.8,1987,1113,874,127.3
38113, 마산합포구,025004, 23세,2021,2082,1218,864,141,1988,1166,822,141.8
38113, 마산합포구,025005, 24세,2021,2032,1192,840,141.9,1956,1151,805,143
38113, 마산합포구,030,25~29세,2021,9689,5384,4305,125.1,9282,5144,4138,124.3
38113, 마산합포구,030001, 25세,2021,1967,1124,843,133.3,1880,1075,805,133.5
38113, 마산합포구,030002, 26세,2021,1932,1055,877,120.3,1858,1006,852,118.1
38113, 마산합포구,030003, 27세,2021,1929,1072,857,125.1,1839,1019,820,124.3
38113, 마산합포구,030004, 28세,2021,1907,1068,839,127.3,1836,1023,813,125.8
38113, 마산합포구,030005, 29세,2021,1954,1065,889,119.8,1869,1021,848,120.4
38113, 마산합포구,035,30~34세,2021,9580,5121,4459,114.8,9124,4850,4274,113.5
38113, 마산합포구,035001, 30세,2021,1916,1021,895,114.1,1814,966,848,113.9
38113, 마산합포구,035002, 31세,2021,1924,1028,896,114.7,1825,968,857,113
38113, 마산합포구,035003, 32세,2021,1902,1037,865,119.9,1808,978,830,117.8
38113, 마산합포구,035004, 33세,2021,1885,1026,859,119.4,1797,970,827,117.3
38113, 마산합포구,035005, 34세,2021,1953,1009,944,106.9,1880,968,912,106.1
38113, 마산합포구,040,35~39세,2021,11989,6376,5613,113.6,11611,6130,5481,111.8
38113, 마산합포구,040001, 35세,2021,2051,1121,930,120.5,1957,1062,895,118.7
38113, 마산합포구,040002, 36세,2021,2219,1164,1055,110.3,2135,1114,1021,109.1
38113, 마산합포구,040003, 37세,2021,2240,1212,1028,117.9,2164,1157,1007,114.9
38113, 마산합포구,040004, 38세,2021,2603,1386,1217,113.9,2537,1339,1198,111.8
38113, 마산합포구,040005, 39세,2021,2876,1493,1383,108,2818,1458,1360,107.2
38113, 마산합포구,045,40~44세,2021,13440,7199,6241,115.4,13164,7018,6146,114.2
38113, 마산합포구,045001, 40세,2021,2935,1594,1341,118.9,2858,1540,1318,116.8
38113, 마산합포구,045002, 41세,2021,2921,1500,1421,105.6,2863,1463,1400,104.5
38113, 마산합포구,045003, 42세,2021,2742,1458,1284,113.6,2685,1424,1261,112.9
38113, 마산합포구,045004, 43세,2021,2433,1316,1117,117.8,2390,1285,1105,116.3
38113, 마산합포구,045005, 44세,2021,2409,1331,1078,123.5,2368,1306,1062,123
38113, 마산합포구,050,45~49세,2021,12622,6598,6024,109.5,12404,6467,5937,108.9
38113, 마산합포구,050001, 45세,2021,2277,1211,1066,113.6,2238,1185,1053,112.5
38113, 마산합포구,050002, 46세,2021,2494,1314,1180,111.4,2440,1284,1156,111.1
38113, 마산합포구,050003, 47세,2021,2598,1353,1245,108.7,2560,1332,1228,108.5
38113, 마산합포구,050004, 48세,2021,2713,1392,1321,105.4,2673,1368,1305,104.8
38113, 마산합포구,050005, 49세,2021,2540,1328,1212,109.6,2493,1298,1195,108.6
38113, 마산합포구,055,50~54세,2021,14581,7231,7350,98.4,14404,7144,7260,98.4
38113, 마산합포구,055001, 50세,2021,2906,1428,1478,96.6,2866,1404,1462,96
38113, 마산합포구,055002, 51세,2021,2859,1438,1421,101.2,2820,1420,1400,101.4
38113, 마산합포구,055003, 52세,2021,3017,1522,1495,101.8,2985,1510,1475,102.4
38113, 마산합포구,055004, 53세,2021,2999,1452,1547,93.9,2968,1435,1533,93.6
38113, 마산합포구,055005, 54세,2021,2800,1391,1409,98.7,2765,1375,1390,98.9
38113, 마산합포구,060,55~59세,2021,14214,6985,7229,96.6,14074,6922,7152,96.8
38113, 마산합포구,060001, 55세,2021,2753,1437,1316,109.2,2722,1423,1299,109.5
38113, 마산합포구,060002, 56세,2021,2850,1376,1474,93.4,2827,1367,1460,93.6
38113, 마산합포구,060003, 57세,2021,2521,1226,1295,94.7,2490,1212,1278,94.8
38113, 마산합포구,060004, 58세,2021,2892,1393,1499,92.9,2861,1380,1481,93.2
38113, 마산합포구,060005, 59세,2021,3198,1553,1645,94.4,3174,1540,1634,94.2
38113, 마산합포구,065,60~64세,2021,16853,7918,8935,88.6,16789,7879,8910,88.4
38113, 마산합포구,065001, 60세,2021,3543,1647,1896,86.9,3530,1639,1891,86.7
38113, 마산합포구,065002, 61세,2021,3555,1674,1881,89,3536,1662,1874,88.7
38113, 마산합포구,065003, 62세,2021,3407,1588,1819,87.3,3398,1582,1816,87.1
38113, 마산합포구,065004, 63세,2021,3152,1478,1674,88.3,3141,1472,1669,88.2
38113, 마산합포구,065005, 64세,2021,3196,1531,1665,92,3184,1524,1660,91.8
38113, 마산합포구,070,65~69세,2021,13924,6521,7403,88.1,13874,6505,7369,88.3
38113, 마산합포구,070001, 65세,2021,3074,1409,1665,84.6,3059,1405,1654,84.9
38113, 마산합포구,070002, 66세,2021,3297,1536,1761,87.2,3288,1534,1754,87.5
38113, 마산합포구,070003, 67세,2021,2659,1296,1363,95.1,2648,1291,1357,95.1
38113, 마산합포구,070004, 68세,2021,2334,1077,1257,85.7,2327,1075,1252,85.9
38113, 마산합포구,070005, 69세,2021,2560,1203,1357,88.7,2552,1200,1352,88.8
38113, 마산합포구,075,70~74세,2021,9966,4638,5328,87,9948,4631,5317,87.1
38113, 마산합포구,075001, 70세,2021,1963,909,1054,86.2,1960,908,1052,86.3
38113, 마산합포구,075002, 71세,2021,2077,972,1105,88,2072,969,1103,87.9
38113, 마산합포구,075003, 72세,2021,2129,1029,1100,93.5,2125,1027,1098,93.5
38113, 마산합포구,075004, 73세,2021,1945,909,1036,87.7,1944,909,1035,87.8
38113, 마산합포구,075005, 74세,2021,1852,819,1033,79.3,1847,818,1029,79.5
38113, 마산합포구,080,75~79세,2021,6915,2970,3945,75.3,6907,2965,3942,75.2
38113, 마산합포구,080001, 75세,2021,1343,599,744,80.5,1343,599,744,80.5
38113, 마산합포구,080002, 76세,2021,1375,602,773,77.9,1370,599,771,77.7
38113, 마산합포구,080003, 77세,2021,1422,617,805,76.6,1421,616,805,76.5
38113, 마산합포구,080004, 78세,2021,1322,535,787,68,1320,534,786,67.9
38113, 마산합포구,080005, 79세,2021,1453,617,836,73.8,1453,617,836,73.8
38113, 마산합포구,085,80~84세,2021,5045,1827,3218,56.8,5039,1824,3215,56.7
38113, 마산합포구,085001, 80세,2021,1289,507,782,64.8,1289,507,782,64.8
38113, 마산합포구,085002, 81세,2021,1081,405,676,59.9,1079,403,676,59.6
38113, 마산합포구,085003, 82세,2021,983,346,637,54.3,981,345,636,54.2
38113, 마산합포구,085004, 83세,2021,851,304,547,55.6,850,304,546,55.7
38113, 마산합포구,085005, 84세,2021,841,265,576,46,840,265,575,46.1
38113, 마산합포구,090,85~89세,2021,2607,710,1897,37.4,2607,710,1897,37.4
38113, 마산합포구,090001, 85세,2021,716,212,504,42.1,716,212,504,42.1
38113, 마산합포구,090002, 86세,2021,587,175,412,42.5,587,175,412,42.5
38113, 마산합포구,090003, 87세,2021,534,151,383,39.4,534,151,383,39.4
38113, 마산합포구,090004, 88세,2021,412,94,318,29.6,412,94,318,29.6
38113, 마산합포구,090005, 89세,2021,358,78,280,27.9,358,78,280,27.9
38113, 마산합포구,095,90~94세,2021,923,164,759,21.6,923,164,759,21.6
38113, 마산합포구,095001, 90세,2021,293,50,243,20.6,293,50,243,20.6
38113, 마산합포구,095002, 91세,2021,233,36,197,18.3,233,36,197,18.3
38113, 마산합포구,095003, 92세,2021,178,33,145,22.8,178,33,145,22.8
38113, 마산합포구,095004, 93세,2021,130,25,105,23.8,130,25,105,23.8
38113, 마산합포구,095005, 94세,2021,89,20,69,29,89,20,69,29
38113, 마산합포구,100,95~99세,2021,181,30,151,19.9,181,30,151,19.9
38113, 마산합포구,100001, 95세,2021,65,9,56,16.1,65,9,56,16.1
38113, 마산합포구,100002, 96세,2021,53,9,44,20.5,53,9,44,20.5
38113, 마산합포구,100003, 97세,2021,17,X,14,21.4,17,X,14,21.4
38113, 마산합포구,100004, 98세,2021,31,X,28,10.7,31,X,28,10.7
38113, 마산합포구,100005, 99세,2021,15,6,9,66.7,15,6,9,66.7
38113, 마산합포구,101,100세이상,2021,19,X,16,18.8,19,X,16,18.8
38113, 마산합포구,102,15세미만,2021,20319,10468,9851,106.3,20275,10450,9825,106.4
38113, 마산합포구,103,15~64세,2021,120150,62250,57900,107.5,117572,60750,56822,106.9
38113, 마산합포구,104,65세이상,2021,39580,16863,22717,74.2,39498,16832,22666,74.3
38113, 마산합포구,086,85세이상,2021,3730,907,2823,32.1,3730,907,2823,32.1
38113, 마산합포구,126,평균연령,2021,46.1,44.3,47.9,,46.2,44.4,48,
38113, 마산합포구,127,중위연령,2021,48.2,45.7,50.7,,48.5,46,50.9,
38114, 마산회원구,000,합계,2021,186464,93039,93425,99.6,183851,91660,92191,99.4
38114, 마산회원구,005,0~4세,2021,4585,2331,2254,103.4,4563,2322,2241,103.6
38114, 마산회원구,005001, 0세,2021,707,355,352,100.9,703,353,350,100.9
38114, 마산회원구,005002, 1세,2021,791,393,398,98.7,785,392,393,99.7
38114, 마산회원구,005003, 2세,2021,898,481,417,115.3,894,480,414,115.9
38114, 마산회원구,005004, 3세,2021,1017,505,512,98.6,1015,504,511,98.6
38114, 마산회원구,005005, 4세,2021,1172,597,575,103.8,1166,593,573,103.5
38114, 마산회원구,010,5~9세,2021,7594,3959,3635,108.9,7570,3941,3629,108.6
38114, 마산회원구,010001, 5세,2021,1318,667,651,102.5,1313,662,651,101.7
38114, 마산회원구,010002, 6세,2021,1472,768,704,109.1,1468,764,704,108.5
38114, 마산회원구,010003, 7세,2021,1496,795,701,113.4,1490,791,699,113.2
38114, 마산회원구,010004, 8세,2021,1540,783,757,103.4,1537,782,755,103.6
38114, 마산회원구,010005, 9세,2021,1768,946,822,115.1,1762,942,820,114.9
38114, 마산회원구,015,10~14세,2021,8600,4485,4115,109,8592,4483,4109,109.1
38114, 마산회원구,015001, 10세,2021,1721,903,818,110.4,1720,903,817,110.5
38114, 마산회원구,015002, 11세,2021,1661,860,801,107.4,1661,860,801,107.4
38114, 마산회원구,015003, 12세,2021,1643,877,766,114.5,1640,877,763,114.9
38114, 마산회원구,015004, 13세,2021,1762,875,887,98.6,1759,873,886,98.5
38114, 마산회원구,015005, 14세,2021,1813,970,843,115.1,1812,970,842,115.2
38114, 마산회원구,020,15~19세,2021,8667,4506,4161,108.3,8596,4476,4120,108.6
38114, 마산회원구,020001, 15세,2021,1723,913,810,112.7,1721,913,808,113
38114, 마산회원구,020002, 16세,2021,1613,803,810,99.1,1612,803,809,99.3
38114, 마산회원구,020003, 17세,2021,1662,881,781,112.8,1661,880,781,112.7
38114, 마산회원구,020004, 18세,2021,1792,959,833,115.1,1782,955,827,115.5
38114, 마산회원구,020005, 19세,2021,1877,950,927,102.5,1820,925,895,103.4
38114, 마산회원구,025,20~24세,2021,10620,5715,4905,116.5,10344,5576,4768,116.9
38114, 마산회원구,025001, 20세,2021,2177,1118,1059,105.6,2120,1089,1031,105.6
38114, 마산회원구,025002, 21세,2021,2330,1210,1120,108,2251,1172,1079,108.6
38114, 마산회원구,025003, 22세,2021,2020,1130,890,127,1984,1109,875,126.7
38114, 마산회원구,025004, 23세,2021,1996,1099,897,122.5,1942,1073,869,123.5
38114, 마산회원구,025005, 24세,2021,2097,1158,939,123.3,2047,1133,914,124
38114, 마산회원구,030,25~29세,2021,10691,5848,4843,120.8,10335,5676,4659,121.8
38114, 마산회원구,030001, 25세,2021,2136,1202,934,128.7,2064,1163,901,129.1
38114, 마산회원구,030002, 26세,2021,2158,1153,1005,114.7,2083,1115,968,115.2
38114, 마산회원구,030003, 27세,2021,2110,1136,974,116.6,2048,1117,931,120
38114, 마산회원구,030004, 28세,2021,2130,1149,981,117.1,2064,1114,950,117.3
38114, 마산회원구,030005, 29세,2021,2157,1208,949,127.3,2076,1167,909,128.4
38114, 마산회원구,035,30~34세,2021,9489,5119,4370,117.1,8972,4812,4160,115.7
38114, 마산회원구,035001, 30세,2021,1923,1052,871,120.8,1841,1006,835,120.5
38114, 마산회원구,035002, 31세,2021,1969,1081,888,121.7,1865,1013,852,118.9
38114, 마산회원구,035003, 32세,2021,1865,1020,845,120.7,1756,956,800,119.5
38114, 마산회원구,035004, 33세,2021,1849,972,877,110.8,1740,912,828,110.1
38114, 마산회원구,035005, 34세,2021,1883,994,889,111.8,1770,925,845,109.5
38114, 마산회원구,040,35~39세,2021,11262,5898,5364,110,10888,5686,5202,109.3
38114, 마산회원구,040001, 35세,2021,1906,1003,903,111.1,1803,937,866,108.2
38114, 마산회원구,040002, 36세,2021,1899,981,918,106.9,1826,944,882,107
38114, 마산회원구,040003, 37세,2021,2204,1160,1044,111.1,2127,1118,1009,110.8
38114, 마산회원구,040004, 38세,2021,2452,1316,1136,115.8,2387,1276,1111,114.9
38114, 마산회원구,040005, 39세,2021,2801,1438,1363,105.5,2745,1411,1334,105.8
38114, 마산회원구,045,40~44세,2021,14031,7186,6845,105,13808,7071,6737,105
38114, 마산회원구,045001, 40세,2021,2785,1459,1326,110,2721,1422,1299,109.5
38114, 마산회원구,045002, 41세,2021,2977,1519,1458,104.2,2931,1496,1435,104.3
38114, 마산회원구,045003, 42세,2021,2771,1440,1331,108.2,2733,1423,1310,108.6
38114, 마산회원구,045004, 43세,2021,2717,1375,1342,102.5,2674,1358,1316,103.2
38114, 마산회원구,045005, 44세,2021,2781,1393,1388,100.4,2749,1372,1377,99.6
38114, 마산회원구,050,45~49세,2021,14924,7624,7300,104.4,14741,7526,7215,104.3
38114, 마산회원구,050001, 45세,2021,2638,1350,1288,104.8,2590,1325,1265,104.7
38114, 마산회원구,050002, 46세,2021,2879,1431,1448,98.8,2838,1411,1427,98.9
38114, 마산회원구,050003, 47세,2021,3166,1641,1525,107.6,3136,1627,1509,107.8
38114, 마산회원구,050004, 48세,2021,3200,1651,1549,106.6,3173,1633,1540,106
38114, 마산회원구,050005, 49세,2021,3041,1551,1490,104.1,3004,1530,1474,103.8
38114, 마산회원구,055,50~54세,2021,17142,8491,8651,98.2,16934,8378,8556,97.9
38114, 마산회원구,055001, 50세,2021,3444,1675,1769,94.7,3386,1644,1742,94.4
38114, 마산회원구,055002, 51세,2021,3388,1709,1679,101.8,3347,1685,1662,101.4
38114, 마산회원구,055003, 52세,2021,3508,1809,1699,106.5,3471,1790,1681,106.5
38114, 마산회원구,055004, 53세,2021,3530,1697,1833,92.6,3491,1673,1818,92
38114, 마산회원구,055005, 54세,2021,3272,1601,1671,95.8,3239,1586,1653,95.9
38114, 마산회원구,060,55~59세,2021,16269,8065,8204,98.3,16085,7978,8107,98.4
38114, 마산회원구,060001, 55세,2021,3332,1686,1646,102.4,3289,1670,1619,103.2
38114, 마산회원구,060002, 56세,2021,3250,1579,1671,94.5,3217,1558,1659,93.9
38114, 마산회원구,060003, 57세,2021,2850,1429,1421,100.6,2816,1412,1404,100.6
38114, 마산회원구,060004, 58세,2021,3252,1626,1626,100,3205,1606,1599,100.4
38114, 마산회원구,060005, 59세,2021,3585,1745,1840,94.8,3558,1732,1826,94.9
38114, 마산회원구,065,60~64세,2021,17197,8256,8941,92.3,17114,8210,8904,92.2
38114, 마산회원구,065001, 60세,2021,3767,1893,1874,101,3752,1886,1866,101.1
38114, 마산회원구,065002, 61세,2021,3804,1798,2006,89.6,3779,1784,1995,89.4
38114, 마산회원구,065003, 62세,2021,3274,1569,1705,92,3259,1561,1698,91.9
38114, 마산회원구,065004, 63세,2021,3137,1496,1641,91.2,3120,1486,1634,90.9
38114, 마산회원구,065005, 64세,2021,3215,1500,1715,87.5,3204,1493,1711,87.3
38114, 마산회원구,070,65~69세,2021,13540,6485,7055,91.9,13491,6465,7026,92
38114, 마산회원구,070001, 65세,2021,2959,1383,1576,87.8,2940,1373,1567,87.6
38114, 마산회원구,070002, 66세,2021,3195,1510,1685,89.6,3189,1510,1679,89.9
38114, 마산회원구,070003, 67세,2021,2550,1244,1306,95.3,2540,1238,1302,95.1
38114, 마산회원구,070004, 68세,2021,2341,1137,1204,94.4,2332,1134,1198,94.7
38114, 마산회원구,070005, 69세,2021,2495,1211,1284,94.3,2490,1210,1280,94.5
38114, 마산회원구,075,70~74세,2021,9269,4246,5023,84.5,9254,4241,5013,84.6
38114, 마산회원구,075001, 70세,2021,1915,868,1047,82.9,1911,867,1044,83
38114, 마산회원구,075002, 71세,2021,1906,831,1075,77.3,1901,828,1073,77.2
38114, 마산회원구,075003, 72세,2021,1913,880,1033,85.2,1909,879,1030,85.3
38114, 마산회원구,075004, 73세,2021,1884,893,991,90.1,1884,893,991,90.1
38114, 마산회원구,075005, 74세,2021,1651,774,877,88.3,1649,774,875,88.5
38114, 마산회원구,080,75~79세,2021,5914,2636,3278,80.4,5908,2633,3275,80.4
38114, 마산회원구,080001, 75세,2021,1175,566,609,92.9,1174,565,609,92.8
38114, 마산회원구,080002, 76세,2021,1152,518,634,81.7,1152,518,634,81.7
38114, 마산회원구,080003, 77세,2021,1267,570,697,81.8,1264,569,695,81.9
38114, 마산회원구,080004, 78세,2021,1175,508,667,76.2,1173,507,666,76.1
38114, 마산회원구,080005, 79세,2021,1145,474,671,70.6,1145,474,671,70.6
38114, 마산회원구,085,80~84세,2021,4039,1541,2498,61.7,4030,1540,2490,61.8
38114, 마산회원구,085001, 80세,2021,1040,422,618,68.3,1038,421,617,68.2
38114, 마산회원구,085002, 81세,2021,911,347,564,61.5,909,347,562,61.7
38114, 마산회원구,085003, 82세,2021,845,332,513,64.7,844,332,512,64.8
38114, 마산회원구,085004, 83세,2021,682,243,439,55.4,679,243,436,55.7
38114, 마산회원구,085005, 84세,2021,561,197,364,54.1,560,197,363,54.3
38114, 마산회원구,090,85~89세,2021,1909,537,1372,39.1,1905,535,1370,39.1
38114, 마산회원구,090001, 85세,2021,569,179,390,45.9,568,179,389,46
38114, 마산회원구,090002, 86세,2021,472,139,333,41.7,469,137,332,41.3
38114, 마산회원구,090003, 87세,2021,358,96,262,36.6,358,96,262,36.6
38114, 마산회원구,090004, 88세,2021,257,62,195,31.8,257,62,195,31.8
38114, 마산회원구,090005, 89세,2021,253,61,192,31.8,253,61,192,31.8
38114, 마산회원구,095,90~94세,2021,599,93,506,18.4,598,93,505,18.4
38114, 마산회원구,095001, 90세,2021,191,30,161,18.6,191,30,161,18.6
38114, 마산회원구,095002, 91세,2021,136,21,115,18.3,135,21,114,18.4
38114, 마산회원구,095003, 92세,2021,122,13,109,11.9,122,13,109,11.9
38114, 마산회원구,095004, 93세,2021,97,21,76,27.6,97,21,76,27.6
38114, 마산회원구,095005, 94세,2021,53,8,45,17.8,53,8,45,17.8
38114, 마산회원구,100,95~99세,2021,110,16,94,17,110,16,94,17
38114, 마산회원구,100001, 95세,2021,41,X,37,10.8,41,X,37,10.8
38114, 마산회원구,100002, 96세,2021,30,7,23,30.4,30,7,23,30.4
38114, 마산회원구,100003, 97세,2021,15,X,13,15.4,15,X,13,15.4
38114, 마산회원구,100004, 98세,2021,15,X,14,7.1,15,X,14,7.1
38114, 마산회원구,100005, 99세,2021,9,X,7,28.6,9,X,7,28.6
38114, 마산회원구,101,100세이상,2021,13,X,11,18.2,13,X,11,18.2
38114, 마산회원구,102,15세미만,2021,20779,10775,10004,107.7,20725,10746,9979,107.7
38114, 마산회원구,103,15~64세,2021,130292,66708,63584,104.9,127817,65389,62428,104.7
38114, 마산회원구,104,65세이상,2021,35393,15556,19837,78.4,35309,15525,19784,78.5
38114, 마산회원구,086,85세이상,2021,2631,648,1983,32.7,2626,646,1980,32.6
38114, 마산회원구,126,평균연령,2021,45.1,43.8,46.5,,45.2,43.9,46.6,
38114, 마산회원구,127,중위연령,2021,47.7,46.1,49.3,,47.9,46.3,49.5,
38115, 진해구,000,합계,2021,192365,99087,93278,106.2,188010,96461,91549,105.4
38115, 진해구,005,0~4세,2021,7270,3751,3519,106.6,7183,3707,3476,106.6
38115, 진해구,005001, 0세,2021,1182,600,582,103.1,1168,595,573,103.8
38115, 진해구,005002, 1세,2021,1314,692,622,111.3,1294,682,612,111.4
38115, 진해구,005003, 2세,2021,1415,732,683,107.2,1400,722,678,106.5
38115, 진해구,005004, 3세,2021,1566,824,742,111.1,1550,816,734,111.2
38115, 진해구,005005, 4세,2021,1793,903,890,101.5,1771,892,879,101.5
38115, 진해구,010,5~9세,2021,11078,5844,5234,111.7,11007,5809,5198,111.8
38115, 진해구,010001, 5세,2021,2047,1047,1000,104.7,2030,1039,991,104.8
38115, 진해구,010002, 6세,2021,2097,1138,959,118.7,2079,1129,950,118.8
38115, 진해구,010003, 7세,2021,2202,1144,1058,108.1,2185,1137,1048,108.5
38115, 진해구,010004, 8세,2021,2285,1219,1066,114.4,2273,1213,1060,114.4
38115, 진해구,010005, 9세,2021,2447,1296,1151,112.6,2440,1291,1149,112.4
38115, 진해구,015,10~14세,2021,11293,5695,5598,101.7,11258,5678,5580,101.8
38115, 진해구,015001, 10세,2021,2350,1186,1164,101.9,2345,1183,1162,101.8
38115, 진해구,015002, 11세,2021,2256,1202,1054,114,2254,1200,1054,113.9
38115, 진해구,015003, 12세,2021,2162,1070,1092,98,2152,1064,1088,97.8
38115, 진해구,015004, 13세,2021,2285,1087,1198,90.7,2275,1085,1190,91.2
38115, 진해구,015005, 14세,2021,2240,1150,1090,105.5,2232,1146,1086,105.5
38115, 진해구,020,15~19세,2021,8679,4651,4028,115.5,8650,4634,4016,115.4
38115, 진해구,020001, 15세,2021,1989,1064,925,115,1983,1060,923,114.8
38115, 진해구,020002, 16세,2021,1808,911,897,101.6,1805,910,895,101.7
38115, 진해구,020003, 17세,2021,1888,1022,866,118,1883,1020,863,118.2
38115, 진해구,020004, 18세,2021,1689,905,784,115.4,1683,900,783,114.9
38115, 진해구,020005, 19세,2021,1305,749,556,134.7,1296,744,552,134.8
38115, 진해구,025,20~24세,2021,8847,5226,3621,144.3,8635,5105,3530,144.6
38115, 진해구,025001, 20세,2021,1667,1045,622,168,1649,1032,617,167.3
38115, 진해구,025002, 21세,2021,1827,1090,737,147.9,1809,1080,729,148.1
38115, 진해구,025003, 22세,2021,1804,1045,759,137.7,1763,1026,737,139.2
38115, 진해구,025004, 23세,2021,1673,959,714,134.3,1612,925,687,134.6
38115, 진해구,025005, 24세,2021,1876,1087,789,137.8,1802,1042,760,137.1
38115, 진해구,030,25~29세,2021,10728,6253,4475,139.7,10173,5897,4276,137.9
38115, 진해구,030001, 25세,2021,2018,1197,821,145.8,1927,1138,789,144.2
38115, 진해구,030002, 26세,2021,2014,1207,807,149.6,1911,1145,766,149.5
38115, 진해구,030003, 27세,2021,2135,1246,889,140.2,2032,1180,852,138.5
38115, 진해구,030004, 28세,2021,2262,1332,930,143.2,2125,1232,893,138
38115, 진해구,030005, 29세,2021,2299,1271,1028,123.6,2178,1202,976,123.2
38115, 진해구,035,30~34세,2021,11323,6100,5223,116.8,10535,5608,4927,113.8
38115, 진해구,035001, 30세,2021,2098,1147,951,120.6,1964,1063,901,118
38115, 진해구,035002, 31세,2021,2229,1220,1009,120.9,2090,1132,958,118.2
38115, 진해구,035003, 32세,2021,2276,1221,1055,115.7,2104,1116,988,113
38115, 진해구,035004, 33세,2021,2311,1243,1068,116.4,2158,1143,1015,112.6
38115, 진해구,035005, 34세,2021,2409,1269,1140,111.3,2219,1154,1065,108.4
38115, 진해구,040,35~39세,2021,15240,8025,7215,111.2,14476,7534,6942,108.5
38115, 진해구,040001, 35세,2021,2476,1322,1154,114.6,2297,1210,1087,111.3
38115, 진해구,040002, 36세,2021,2671,1401,1270,110.3,2506,1296,1210,107.1
38115, 진해구,040003, 37세,2021,2896,1539,1357,113.4,2743,1432,1311,109.2
38115, 진해구,040004, 38세,2021,3430,1799,1631,110.3,3283,1707,1576,108.3
38115, 진해구,040005, 39세,2021,3767,1964,1803,108.9,3647,1889,1758,107.5
38115, 진해구,045,40~44세,2021,18338,9504,8834,107.6,17886,9213,8673,106.2
38115, 진해구,045001, 40세,2021,3886,2025,1861,108.8,3780,1955,1825,107.1
38115, 진해구,045002, 41세,2021,3931,1956,1975,99,3838,1896,1942,97.6
38115, 진해구,045003, 42세,2021,3793,1972,1821,108.3,3690,1908,1782,107.1
38115, 진해구,045004, 43세,2021,3335,1782,1553,114.7,3248,1727,1521,113.5
38115, 진해구,045005, 44세,2021,3393,1769,1624,108.9,3330,1727,1603,107.7
38115, 진해구,050,45~49세,2021,17318,9303,8015,116.1,16941,9070,7871,115.2
38115, 진해구,050001, 45세,2021,3242,1777,1465,121.3,3160,1726,1434,120.4
38115, 진해구,050002, 46세,2021,3426,1801,1625,110.8,3370,1766,1604,110.1
38115, 진해구,050003, 47세,2021,3725,1989,1736,114.6,3644,1940,1704,113.8
38115, 진해구,050004, 48세,2021,3557,1908,1649,115.7,3482,1864,1618,115.2
38115, 진해구,050005, 49세,2021,3368,1828,1540,118.7,3285,1774,1511,117.4
38115, 진해구,055,50~54세,2021,15842,8437,7405,113.9,15444,8207,7237,113.4
38115, 진해구,055001, 50세,2021,3523,1899,1624,116.9,3422,1826,1596,114.4
38115, 진해구,055002, 51세,2021,3292,1754,1538,114,3207,1714,1493,114.8
38115, 진해구,055003, 52세,2021,3159,1715,1444,118.8,3084,1671,1413,118.3
38115, 진해구,055004, 53세,2021,3099,1638,1461,112.1,3034,1607,1427,112.6
38115, 진해구,055005, 54세,2021,2769,1431,1338,107,2697,1389,1308,106.2
38115, 진해구,060,55~59세,2021,13340,6770,6570,103,13072,6617,6455,102.5
38115, 진해구,060001, 55세,2021,2701,1404,1297,108.2,2651,1371,1280,107.1
38115, 진해구,060002, 56세,2021,2580,1294,1286,100.6,2526,1259,1267,99.4
38115, 진해구,060003, 57세,2021,2550,1302,1248,104.3,2488,1266,1222,103.6
38115, 진해구,060004, 58세,2021,2803,1429,1374,104,2745,1401,1344,104.2
38115, 진해구,060005, 59세,2021,2706,1341,1365,98.2,2662,1320,1342,98.4
38115, 진해구,065,60~64세,2021,14007,6776,7231,93.7,13840,6699,7141,93.8
38115, 진해구,065001, 60세,2021,3018,1474,1544,95.5,2980,1455,1525,95.4
38115, 진해구,065002, 61세,2021,3059,1431,1628,87.9,3028,1418,1610,88.1
38115, 진해구,065003, 62세,2021,2741,1297,1444,89.8,2702,1279,1423,89.9
38115, 진해구,065004, 63세,2021,2614,1301,1313,99.1,2580,1286,1294,99.4
38115, 진해구,065005, 64세,2021,2575,1273,1302,97.8,2550,1261,1289,97.8
38115, 진해구,070,65~69세,2021,10728,5226,5502,95,10650,5184,5466,94.8
38115, 진해구,070001, 65세,2021,2438,1163,1275,91.2,2417,1152,1265,91.1
38115, 진해구,070002, 66세,2021,2516,1183,1333,88.7,2500,1173,1327,88.4
38115, 진해구,070003, 67세,2021,2066,1054,1012,104.2,2051,1049,1002,104.7
38115, 진해구,070004, 68세,2021,1782,896,886,101.1,1764,885,879,100.7
38115, 진해구,070005, 69세,2021,1926,930,996,93.4,1918,925,993,93.2
38115, 진해구,075,70~74세,2021,7053,3291,3762,87.5,7012,3274,3738,87.6
38115, 진해구,075001, 70세,2021,1457,673,784,85.8,1449,671,778,86.2
38115, 진해구,075002, 71세,2021,1399,641,758,84.6,1389,637,752,84.7
38115, 진해구,075003, 72세,2021,1490,715,775,92.3,1480,711,769,92.5
38115, 진해구,075004, 73세,2021,1385,674,711,94.8,1381,673,708,95.1
38115, 진해구,075005, 74세,2021,1322,588,734,80.1,1313,582,731,79.6
38115, 진해구,080,75~79세,2021,5043,2157,2886,74.7,5028,2154,2874,74.9
38115, 진해구,080001, 75세,2021,1020,490,530,92.5,1018,489,529,92.4
38115, 진해구,080002, 76세,2021,983,404,579,69.8,981,404,577,70
38115, 진해구,080003, 77세,2021,995,433,562,77,988,433,555,78
38115, 진해구,080004, 78세,2021,948,391,557,70.2,947,390,557,70
38115, 진해구,080005, 79세,2021,1097,439,658,66.7,1094,438,656,66.8
38115, 진해구,085,80~84세,2021,3648,1389,2259,61.5,3636,1384,2252,61.5
38115, 진해구,085001, 80세,2021,846,335,511,65.6,843,334,509,65.6
38115, 진해구,085002, 81세,2021,785,309,476,64.9,781,308,473,65.1
38115, 진해구,085003, 82세,2021,745,284,461,61.6,742,282,460,61.3
38115, 진해구,085004, 83세,2021,648,248,400,62,646,247,399,61.9
38115, 진해구,085005, 84세,2021,624,213,411,51.8,624,213,411,51.8
38115, 진해구,090,85~89세,2021,1876,553,1323,41.8,1870,551,1319,41.8
38115, 진해구,090001, 85세,2021,500,170,330,51.5,498,169,329,51.4
38115, 진해구,090002, 86세,2021,445,128,317,40.4,444,128,316,40.5
38115, 진해구,090003, 87세,2021,387,111,276,40.2,386,111,275,40.4
38115, 진해구,090004, 88세,2021,286,93,193,48.2,284,92,192,47.9
38115, 진해구,090005, 89세,2021,258,51,207,24.6,258,51,207,24.6
38115, 진해구,095,90~94세,2021,593,120,473,25.4,593,120,473,25.4
38115, 진해구,095001, 90세,2021,180,40,140,28.6,180,40,140,28.6
38115, 진해구,095002, 91세,2021,153,25,128,19.5,153,25,128,19.5
38115, 진해구,095003, 92세,2021,115,31,84,36.9,115,31,84,36.9
38115, 진해구,095004, 93세,2021,98,19,79,24.1,98,19,79,24.1
38115, 진해구,095005, 94세,2021,47,5,42,11.9,47,5,42,11.9
38115, 진해구,100,95~99세,2021,109,15,94,16,109,15,94,16
38115, 진해구,100001, 95세,2021,41,8,33,24.2,41,8,33,24.2
38115, 진해구,100002, 96세,2021,26,X,24,8.3,26,X,24,8.3
38115, 진해구,100003, 97세,2021,20,X,17,17.6,20,X,17,17.6
38115, 진해구,100004, 98세,2021,19,X,17,11.8,19,X,17,11.8
38115, 진해구,100005, 99세,2021,X,X,X,0,X,X,X,0
38115, 진해구,101,100세이상,2021,12,X,11,9.1,12,X,11,9.1
38115, 진해구,102,15세미만,2021,29641,15290,14351,106.5,29448,15194,14254,106.6
38115, 진해구,103,15~64세,2021,133662,71045,62617,113.5,129652,68584,61068,112.3
38115, 진해구,104,65세이상,2021,29062,12752,16310,78.2,28910,12683,16227,78.2
38115, 진해구,086,85세이상,2021,2590,689,1901,36.2,2584,687,1897,36.2
38115, 진해구,126,평균연령,2021,41.9,40.7,43.2,,42,40.7,43.3,
38115, 진해구,127,중위연령,2021,43,42,44.3,,43.2,42.2,44.5,
38310, 의령군,000,합계,2021,25325,12499,12826,97.5,24381,11921,12460,95.7
38310, 의령군,005,0~4세,2021,433,208,225,92.4,422,200,222,90.1
38310, 의령군,005001, 0세,2021,77,38,39,97.4,72,36,36,100
38310, 의령군,005002, 1세,2021,90,49,41,119.5,86,45,41,109.8
38310, 의령군,005003, 2세,2021,74,33,41,80.5,73,32,41,78
38310, 의령군,005004, 3세,2021,100,39,61,63.9,100,39,61,63.9
38310, 의령군,005005, 4세,2021,92,49,43,114,91,48,43,111.6
38310, 의령군,010,5~9세,2021,567,317,250,126.8,563,315,248,127
38310, 의령군,010001, 5세,2021,106,52,54,96.3,106,52,54,96.3
38310, 의령군,010002, 6세,2021,110,66,44,150,110,66,44,150
38310, 의령군,010003, 7세,2021,100,59,41,143.9,100,59,41,143.9
38310, 의령군,010004, 8세,2021,106,58,48,120.8,104,56,48,116.7
38310, 의령군,010005, 9세,2021,145,82,63,130.2,143,82,61,134.4
38310, 의령군,015,10~14세,2021,657,336,321,104.7,655,336,319,105.3
38310, 의령군,015001, 10세,2021,131,62,69,89.9,131,62,69,89.9
38310, 의령군,015002, 11세,2021,127,61,66,92.4,126,61,65,93.8
38310, 의령군,015003, 12세,2021,131,77,54,142.6,130,77,53,145.3
38310, 의령군,015004, 13세,2021,133,72,61,118,133,72,61,118
38310, 의령군,015005, 14세,2021,135,64,71,90.1,135,64,71,90.1
38310, 의령군,020,15~19세,2021,648,349,299,116.7,645,348,297,117.2
38310, 의령군,020001, 15세,2021,125,69,56,123.2,124,68,56,121.4
38310, 의령군,020002, 16세,2021,135,77,58,132.8,135,77,58,132.8
38310, 의령군,020003, 17세,2021,155,65,90,72.2,154,65,89,73
38310, 의령군,020004, 18세,2021,144,77,67,114.9,143,77,66,116.7
38310, 의령군,020005, 19세,2021,89,61,28,217.9,89,61,28,217.9
38310, 의령군,025,20~24세,2021,765,489,276,177.2,710,450,260,173.1
38310, 의령군,025001, 20세,2021,127,97,30,323.3,126,96,30,320
38310, 의령군,025002, 21세,2021,161,111,50,222,159,109,50,218
38310, 의령군,025003, 22세,2021,156,98,58,169,145,88,57,154.4
38310, 의령군,025004, 23세,2021,152,78,74,105.4,136,68,68,100
38310, 의령군,025005, 24세,2021,169,105,64,164.1,144,89,55,161.8
38310, 의령군,030,25~29세,2021,1018,589,429,137.3,814,460,354,129.9
38310, 의령군,030001, 25세,2021,191,95,96,99,163,78,85,91.8
38310, 의령군,030002, 26세,2021,215,149,66,225.8,166,115,51,225.5
38310, 의령군,030003, 27세,2021,206,116,90,128.9,163,86,77,111.7
38310, 의령군,030004, 28세,2021,188,96,92,104.3,151,79,72,109.7
38310, 의령군,030005, 29세,2021,218,133,85,156.5,171,102,69,147.8
38310, 의령군,035,30~34세,2021,940,536,404,132.7,706,389,317,122.7
38310, 의령군,035001, 30세,2021,196,113,83,136.1,148,84,64,131.3
38310, 의령군,035002, 31세,2021,199,117,82,142.7,145,89,56,158.9
38310, 의령군,035003, 32세,2021,200,116,84,138.1,157,88,69,127.5
38310, 의령군,035004, 33세,2021,179,96,83,115.7,134,59,75,78.7
38310, 의령군,035005, 34세,2021,166,94,72,130.6,122,69,53,130.2
38310, 의령군,040,35~39세,2021,1007,556,451,123.3,824,438,386,113.5
38310, 의령군,040001, 35세,2021,223,123,100,123,176,94,82,114.6
38310, 의령군,040002, 36세,2021,158,90,68,132.4,131,75,56,133.9
38310, 의령군,040003, 37세,2021,196,110,86,127.9,158,82,76,107.9
38310, 의령군,040004, 38세,2021,221,115,106,108.5,182,91,91,100
38310, 의령군,040005, 39세,2021,209,118,91,129.7,177,96,81,118.5
38310, 의령군,045,40~44세,2021,1120,620,500,124,1042,571,471,121.2
38310, 의령군,045001, 40세,2021,218,113,105,107.6,199,98,101,97
38310, 의령군,045002, 41세,2021,227,123,104,118.3,208,112,96,116.7
38310, 의령군,045003, 42세,2021,238,131,107,122.4,225,122,103,118.4
38310, 의령군,045004, 43세,2021,213,122,91,134.1,201,116,85,136.5
38310, 의령군,045005, 44세,2021,224,131,93,140.9,209,123,86,143
38310, 의령군,050,45~49세,2021,1442,811,631,128.5,1386,779,607,128.3
38310, 의령군,050001, 45세,2021,227,127,100,127,218,119,99,120.2
38310, 의령군,050002, 46세,2021,267,144,123,117.1,263,141,122,115.6
38310, 의령군,050003, 47세,2021,302,191,111,172.1,289,184,105,175.2
38310, 의령군,050004, 48세,2021,331,182,149,122.1,315,174,141,123.4
38310, 의령군,050005, 49세,2021,315,167,148,112.8,301,161,140,115
38310, 의령군,055,50~54세,2021,1961,1107,854,129.6,1927,1092,835,130.8
38310, 의령군,055001, 50세,2021,368,210,158,132.9,362,207,155,133.5
38310, 의령군,055002, 51세,2021,349,204,145,140.7,338,199,139,143.2
38310, 의령군,055003, 52세,2021,419,251,168,149.4,410,247,163,151.5
38310, 의령군,055004, 53세,2021,427,227,200,113.5,425,225,200,112.5
38310, 의령군,055005, 54세,2021,398,215,183,117.5,392,214,178,120.2
38310, 의령군,060,55~59세,2021,2260,1208,1052,114.8,2222,1194,1028,116.1
38310, 의령군,060001, 55세,2021,411,221,190,116.3,406,220,186,118.3
38310, 의령군,060002, 56세,2021,455,247,208,118.8,443,243,200,121.5
38310, 의령군,060003, 57세,2021,412,212,200,106,404,210,194,108.2
38310, 의령군,060004, 58세,2021,447,254,193,131.6,442,251,191,131.4
38310, 의령군,060005, 59세,2021,535,274,261,105,527,270,257,105.1
38310, 의령군,065,60~64세,2021,2974,1586,1388,114.3,2951,1573,1378,114.2
38310, 의령군,065001, 60세,2021,650,358,292,122.6,643,353,290,121.7
38310, 의령군,065002, 61세,2021,634,320,314,101.9,631,318,313,101.6
38310, 의령군,065003, 62세,2021,575,302,273,110.6,571,300,271,110.7
38310, 의령군,065004, 63세,2021,557,295,262,112.6,550,291,259,112.4
38310, 의령군,065005, 64세,2021,558,311,247,125.9,556,311,245,126.9
38310, 의령군,070,65~69세,2021,2540,1308,1232,106.2,2527,1299,1228,105.8
38310, 의령군,070001, 65세,2021,558,291,267,109,557,291,266,109.4
38310, 의령군,070002, 66세,2021,589,307,282,108.9,582,301,281,107.1
38310, 의령군,070003, 67세,2021,478,245,233,105.2,474,243,231,105.2
38310, 의령군,070004, 68세,2021,397,203,194,104.6,397,203,194,104.6
38310, 의령군,070005, 69세,2021,518,262,256,102.3,517,261,256,102
38310, 의령군,075,70~74세,2021,1926,899,1027,87.5,1922,897,1025,87.5
38310, 의령군,075001, 70세,2021,351,165,186,88.7,351,165,186,88.7
38310, 의령군,075002, 71세,2021,405,186,219,84.9,404,185,219,84.5
38310, 의령군,075003, 72세,2021,414,188,226,83.2,414,188,226,83.2
38310, 의령군,075004, 73세,2021,386,190,196,96.9,383,189,194,97.4
38310, 의령군,075005, 74세,2021,370,170,200,85,370,170,200,85
38310, 의령군,080,75~79세,2021,1744,637,1107,57.5,1743,637,1106,57.6
38310, 의령군,080001, 75세,2021,289,129,160,80.6,289,129,160,80.6
38310, 의령군,080002, 76세,2021,281,112,169,66.3,281,112,169,66.3
38310, 의령군,080003, 77세,2021,344,119,225,52.9,344,119,225,52.9
38310, 의령군,080004, 78세,2021,377,120,257,46.7,377,120,257,46.7
38310, 의령군,080005, 79세,2021,453,157,296,53,452,157,295,53.2
38310, 의령군,085,80~84세,2021,1787,585,1202,48.7,1786,585,1201,48.7
38310, 의령군,085001, 80세,2021,433,140,293,47.8,433,140,293,47.8
38310, 의령군,085002, 81세,2021,371,118,253,46.6,371,118,253,46.6
38310, 의령군,085003, 82세,2021,364,123,241,51,364,123,241,51
38310, 의령군,085004, 83세,2021,298,100,198,50.5,298,100,198,50.5
38310, 의령군,085005, 84세,2021,321,104,217,47.9,320,104,216,48.1
38310, 의령군,090,85~89세,2021,1101,268,833,32.2,1101,268,833,32.2
38310, 의령군,090001, 85세,2021,307,81,226,35.8,307,81,226,35.8
38310, 의령군,090002, 86세,2021,257,69,188,36.7,257,69,188,36.7
38310, 의령군,090003, 87세,2021,212,44,168,26.2,212,44,168,26.2
38310, 의령군,090004, 88세,2021,164,38,126,30.2,164,38,126,30.2
38310, 의령군,090005, 89세,2021,161,36,125,28.8,161,36,125,28.8
38310, 의령군,095,90~94세,2021,366,78,288,27.1,366,78,288,27.1
38310, 의령군,095001, 90세,2021,113,27,86,31.4,113,27,86,31.4
38310, 의령군,095002, 91세,2021,87,16,71,22.5,87,16,71,22.5
38310, 의령군,095003, 92세,2021,67,10,57,17.5,67,10,57,17.5
38310, 의령군,095004, 93세,2021,60,17,43,39.5,60,17,43,39.5
38310, 의령군,095005, 94세,2021,39,8,31,25.8,39,8,31,25.8
38310, 의령군,100,95~99세,2021,63,11,52,21.2,63,11,52,21.2
38310, 의령군,100001, 95세,2021,22,5,17,29.4,22,5,17,29.4
38310, 의령군,100002, 96세,2021,12,X,10,20,12,X,10,20
38310, 의령군,100003, 97세,2021,8,X,8,0,8,X,8,0
38310, 의령군,100004, 98세,2021,10,X,8,25,10,X,8,25
38310, 의령군,100005, 99세,2021,11,X,9,22.2,11,X,9,22.2
38310, 의령군,101,100세이상,2021,6,X,5,20,6,X,5,20
38310, 의령군,102,15세미만,2021,1657,861,796,108.2,1640,851,789,107.9
38310, 의령군,103,15~64세,2021,14135,7851,6284,124.9,13227,7294,5933,122.9
38310, 의령군,104,65세이상,2021,9533,3787,5746,65.9,9514,3776,5738,65.8
38310, 의령군,086,85세이상,2021,1536,358,1178,30.4,1536,358,1178,30.4
38310, 의령군,126,평균연령,2021,55.4,52.2,58.5,,56.2,53.1,59.1,
38310, 의령군,127,중위연령,2021,59.7,56.4,62.4,,60.4,57.6,63,
38320, 함안군,000,합계,2021,63233,33146,30087,110.2,59253,30008,29245,102.6
38320, 함안군,005,0~4세,2021,1288,656,632,103.8,1253,639,614,104.1
38320, 함안군,005001, 0세,2021,177,91,86,105.8,171,88,83,106
38320, 함안군,005002, 1세,2021,196,102,94,108.5,193,102,91,112.1
38320, 함안군,005003, 2세,2021,284,136,148,91.9,275,130,145,89.7
38320, 함안군,005004, 3세,2021,311,157,154,101.9,306,155,151,102.6
38320, 함안군,005005, 4세,2021,320,170,150,113.3,308,164,144,113.9
38320, 함안군,010,5~9세,2021,2331,1176,1155,101.8,2315,1169,1146,102
38320, 함안군,010001, 5세,2021,400,208,192,108.3,396,206,190,108.4
38320, 함안군,010002, 6세,2021,439,222,217,102.3,437,222,215,103.3
38320, 함안군,010003, 7세,2021,447,217,230,94.3,445,217,228,95.2
38320, 함안군,010004, 8세,2021,500,258,242,106.6,498,257,241,106.6
38320, 함안군,010005, 9세,2021,545,271,274,98.9,539,267,272,98.2
38320, 함안군,015,10~14세,2021,2920,1495,1425,104.9,2903,1488,1415,105.2
38320, 함안군,015001, 10세,2021,581,273,308,88.6,575,271,304,89.1
38320, 함안군,015002, 11세,2021,542,286,256,111.7,540,286,254,112.6
38320, 함안군,015003, 12세,2021,611,319,292,109.2,607,316,291,108.6
38320, 함안군,015004, 13세,2021,601,312,289,108,599,311,288,108
38320, 함안군,015005, 14세,2021,585,305,280,108.9,582,304,278,109.4
38320, 함안군,020,15~19세,2021,2596,1414,1182,119.6,2582,1407,1175,119.7
38320, 함안군,020001, 15세,2021,530,290,240,120.8,529,289,240,120.4
38320, 함안군,020002, 16세,2021,564,285,279,102.2,562,285,277,102.9
38320, 함안군,020003, 17세,2021,603,325,278,116.9,598,324,274,118.2
38320, 함안군,020004, 18세,2021,550,300,250,120,546,297,249,119.3
38320, 함안군,020005, 19세,2021,349,214,135,158.5,347,212,135,157
38320, 함안군,025,20~24세,2021,2548,1619,929,174.3,2273,1387,886,156.5
38320, 함안군,025001, 20세,2021,459,301,158,190.5,450,294,156,188.5
38320, 함안군,025002, 21세,2021,528,334,194,172.2,502,312,190,164.2
38320, 함안군,025003, 22세,2021,477,295,182,162.1,424,251,173,145.1
38320, 함안군,025004, 23세,2021,511,333,178,187.1,432,265,167,158.7
38320, 함안군,025005, 24세,2021,573,356,217,164.1,465,265,200,132.5
38320, 함안군,030,25~29세,2021,3042,2015,1027,196.2,2269,1360,909,149.6
38320, 함안군,030001, 25세,2021,554,365,189,193.1,446,274,172,159.3
38320, 함안군,030002, 26세,2021,611,409,202,202.5,451,275,176,156.3
38320, 함안군,030003, 27세,2021,611,405,206,196.6,459,270,189,142.9
38320, 함안군,030004, 28세,2021,638,422,216,195.4,462,279,183,152.5
38320, 함안군,030005, 29세,2021,628,414,214,193.5,451,262,189,138.6
38320, 함안군,035,30~34세,2021,3052,1929,1123,171.8,2067,1116,951,117.4
38320, 함안군,035001, 30세,2021,619,415,204,203.4,408,244,164,148.8
38320, 함안군,035002, 31세,2021,594,388,206,188.3,408,238,170,140
38320, 함안군,035003, 32세,2021,586,359,227,158.1,403,209,194,107.7
38320, 함안군,035004, 33세,2021,611,385,226,170.4,407,207,200,103.5
38320, 함안군,035005, 34세,2021,642,382,260,146.9,441,218,223,97.8
38320, 함안군,040,35~39세,2021,3561,2035,1526,133.4,2812,1417,1395,101.6
38320, 함안군,040001, 35세,2021,626,378,248,152.4,447,231,216,106.9
38320, 함안군,040002, 36세,2021,667,411,256,160.5,486,251,235,106.8
38320, 함안군,040003, 37세,2021,681,360,321,112.1,535,245,290,84.5
38320, 함안군,040004, 38세,2021,808,444,364,122,686,341,345,98.8
38320, 함안군,040005, 39세,2021,779,442,337,131.2,658,349,309,112.9
38320, 함안군,045,40~44세,2021,4349,2396,1953,122.7,3916,2048,1868,109.6
38320, 함안군,045001, 40세,2021,831,463,368,125.8,740,389,351,110.8
38320, 함안군,045002, 41세,2021,951,515,436,118.1,845,432,413,104.6
38320, 함안군,045003, 42세,2021,855,486,369,131.7,766,411,355,115.8
38320, 함안군,045004, 43세,2021,815,439,376,116.8,737,381,356,107
38320, 함안군,045005, 44세,2021,897,493,404,122,828,435,393,110.7
38320, 함안군,050,45~49세,2021,4722,2631,2091,125.8,4472,2448,2024,120.9
38320, 함안군,050001, 45세,2021,851,471,380,123.9,791,426,365,116.7
38320, 함안군,050002, 46세,2021,944,525,419,125.3,896,488,408,119.6
38320, 함안군,050003, 47세,2021,971,534,437,122.2,918,493,425,116
38320, 함안군,050004, 48세,2021,951,521,430,121.2,912,493,419,117.7
38320, 함안군,050005, 49세,2021,1005,580,425,136.5,955,548,407,134.6
38320, 함안군,055,50~54세,2021,5289,2950,2339,126.1,5098,2824,2274,124.2
38320, 함안군,055001, 50세,2021,1091,628,463,135.6,1049,594,455,130.5
38320, 함안군,055002, 51세,2021,1042,579,463,125.1,1003,554,449,123.4
38320, 함안군,055003, 52세,2021,1051,587,464,126.5,1005,559,446,125.3
38320, 함안군,055004, 53세,2021,1095,607,488,124.4,1063,585,478,122.4
38320, 함안군,055005, 54세,2021,1010,549,461,119.1,978,532,446,119.3
38320, 함안군,060,55~59세,2021,5264,2795,2469,113.2,5142,2732,2410,113.4
38320, 함안군,060001, 55세,2021,1071,580,491,118.1,1040,562,478,117.6
38320, 함안군,060002, 56세,2021,1041,519,522,99.4,1016,507,509,99.6
38320, 함안군,060003, 57세,2021,970,528,442,119.5,950,520,430,120.9
38320, 함안군,060004, 58세,2021,1055,570,485,117.5,1025,557,468,119
38320, 함안군,060005, 59세,2021,1127,598,529,113,1111,586,525,111.6
38320, 함안군,065,60~64세,2021,6167,3254,2913,111.7,6113,3224,2889,111.6
38320, 함안군,065001, 60세,2021,1323,684,639,107,1311,680,631,107.8
38320, 함안군,065002, 61세,2021,1295,662,633,104.6,1278,650,628,103.5
38320, 함안군,065003, 62세,2021,1148,615,533,115.4,1139,611,528,115.7
38320, 함안군,065004, 63세,2021,1202,664,538,123.4,1193,658,535,123
38320, 함안군,065005, 64세,2021,1199,629,570,110.4,1192,625,567,110.2
38320, 함안군,070,65~69세,2021,4947,2502,2445,102.3,4905,2477,2428,102
38320, 함안군,070001, 65세,2021,1104,564,540,104.4,1089,557,532,104.7
38320, 함안군,070002, 66세,2021,1138,618,520,118.8,1123,606,517,117.2
38320, 함안군,070003, 67세,2021,974,466,508,91.7,968,463,505,91.7
38320, 함안군,070004, 68세,2021,851,440,411,107.1,848,438,410,106.8
38320, 함안군,070005, 69세,2021,880,414,466,88.8,877,413,464,89
38320, 함안군,075,70~74세,2021,3636,1788,1848,96.8,3619,1784,1835,97.2
38320, 함안군,075001, 70세,2021,686,351,335,104.8,683,350,333,105.1
38320, 함안군,075002, 71세,2021,771,371,400,92.8,766,370,396,93.4
38320, 함안군,075003, 72세,2021,725,348,377,92.3,719,347,372,93.3
38320, 함안군,075004, 73세,2021,773,396,377,105,771,395,376,105.1
38320, 함안군,075005, 74세,2021,681,322,359,89.7,680,322,358,89.9
38320, 함안군,080,75~79세,2021,2808,1100,1708,64.4,2802,1097,1705,64.3
38320, 함안군,080001, 75세,2021,476,209,267,78.3,476,209,267,78.3
38320, 함안군,080002, 76세,2021,508,200,308,64.9,506,199,307,64.8
38320, 함안군,080003, 77세,2021,590,236,354,66.7,589,236,353,66.9
38320, 함안군,080004, 78세,2021,570,224,346,64.7,567,222,345,64.3
38320, 함안군,080005, 79세,2021,664,231,433,53.3,664,231,433,53.3
38320, 함안군,085,80~84세,2021,2659,858,1801,47.6,2658,858,1800,47.7
38320, 함안군,085001, 80세,2021,633,218,415,52.5,633,218,415,52.5
38320, 함안군,085002, 81세,2021,564,189,375,50.4,563,189,374,50.5
38320, 함안군,085003, 82세,2021,511,164,347,47.3,511,164,347,47.3
38320, 함안군,085004, 83세,2021,484,145,339,42.8,484,145,339,42.8
38320, 함안군,085005, 84세,2021,467,142,325,43.7,467,142,325,43.7
38320, 함안군,090,85~89세,2021,1481,411,1070,38.4,1481,411,1070,38.4
38320, 함안군,090001, 85세,2021,368,103,265,38.9,368,103,265,38.9
38320, 함안군,090002, 86세,2021,354,105,249,42.2,354,105,249,42.2
38320, 함안군,090003, 87세,2021,319,79,240,32.9,319,79,240,32.9
38320, 함안군,090004, 88세,2021,227,63,164,38.4,227,63,164,38.4
38320, 함안군,090005, 89세,2021,213,61,152,40.1,213,61,152,40.1
38320, 함안군,095,90~94세,2021,489,109,380,28.7,489,109,380,28.7
38320, 함안군,095001, 90세,2021,141,33,108,30.6,141,33,108,30.6
38320, 함안군,095002, 91세,2021,111,30,81,37,111,30,81,37
38320, 함안군,095003, 92세,2021,113,21,92,22.8,113,21,92,22.8
38320, 함안군,095004, 93세,2021,83,15,68,22.1,83,15,68,22.1
38320, 함안군,095005, 94세,2021,41,10,31,32.3,41,10,31,32.3
38320, 함안군,100,95~99세,2021,73,12,61,19.7,73,12,61,19.7
38320, 함안군,100001, 95세,2021,29,6,23,26.1,29,6,23,26.1
38320, 함안군,100002, 96세,2021,19,X,16,18.8,19,X,16,18.8
38320, 함안군,100003, 97세,2021,14,X,11,27.3,14,X,11,27.3
38320, 함안군,100004, 98세,2021,7,X,7,0,7,X,7,0
38320, 함안군,100005, 99세,2021,X,X,X,0,X,X,X,0
38320, 함안군,101,100세이상,2021,11,X,10,10,11,X,10,10
38320, 함안군,102,15세미만,2021,6539,3327,3212,103.6,6471,3296,3175,103.8
38320, 함안군,103,15~64세,2021,40590,23038,17552,131.3,36744,19963,16781,119
38320, 함안군,104,65세이상,2021,16104,6781,9323,72.7,16038,6749,9289,72.7
38320, 함안군,086,85세이상,2021,2054,533,1521,35,2054,533,1521,35
38320, 함안군,126,평균연령,2021,48.5,46.2,51.1,,49.4,47.4,51.4,
38320, 함안군,127,중위연령,2021,51.1,48.6,54.3,,52.7,50.9,54.9,
38330, 창녕군,000,합계,2021,59664,30056,29608,101.5,56446,27938,28508,98
38330, 창녕군,005,0~4세,2021,1221,649,572,113.5,1180,629,551,114.2
38330, 창녕군,005001, 0세,2021,201,112,89,125.8,190,104,86,120.9
38330, 창녕군,005002, 1세,2021,206,108,98,110.2,203,107,96,111.5
38330, 창녕군,005003, 2세,2021,243,127,116,109.5,240,126,114,110.5
38330, 창녕군,005004, 3세,2021,277,136,141,96.5,264,132,132,100
38330, 창녕군,005005, 4세,2021,294,166,128,129.7,283,160,123,130.1
38330, 창녕군,010,5~9세,2021,1717,885,832,106.4,1685,869,816,106.5
38330, 창녕군,010001, 5세,2021,332,178,154,115.6,327,176,151,116.6
38330, 창녕군,010002, 6세,2021,306,150,156,96.2,297,144,153,94.1
38330, 창녕군,010003, 7세,2021,332,178,154,115.6,327,177,150,118
38330, 창녕군,010004, 8세,2021,375,195,180,108.3,370,193,177,109
38330, 창녕군,010005, 9세,2021,372,184,188,97.9,364,179,185,96.8
38330, 창녕군,015,10~14세,2021,1899,1038,861,120.6,1859,1016,843,120.5
38330, 창녕군,015001, 10세,2021,408,215,193,111.4,399,209,190,110
38330, 창녕군,015002, 11세,2021,368,193,175,110.3,362,191,171,111.7
38330, 창녕군,015003, 12세,2021,372,201,171,117.5,362,196,166,118.1
38330, 창녕군,015004, 13세,2021,369,195,174,112.1,359,189,170,111.2
38330, 창녕군,015005, 14세,2021,382,234,148,158.1,377,231,146,158.2
38330, 창녕군,020,15~19세,2021,2067,1115,952,117.1,2040,1103,937,117.7
38330, 창녕군,020001, 15세,2021,348,182,166,109.6,339,181,158,114.6
38330, 창녕군,020002, 16세,2021,463,244,219,111.4,460,242,218,111
38330, 창녕군,020003, 17세,2021,513,279,234,119.2,510,277,233,118.9
38330, 창녕군,020004, 18세,2021,463,230,233,98.7,457,227,230,98.7
38330, 창녕군,020005, 19세,2021,280,180,100,180,274,176,98,179.6
38330, 창녕군,025,20~24세,2021,2070,1276,794,160.7,1817,1102,715,154.1
38330, 창녕군,025001, 20세,2021,364,241,123,195.9,348,234,114,205.3
38330, 창녕군,025002, 21세,2021,395,236,159,148.4,374,224,150,149.3
38330, 창녕군,025003, 22세,2021,378,241,137,175.9,342,211,131,161.1
38330, 창녕군,025004, 23세,2021,449,276,173,159.5,373,228,145,157.2
38330, 창녕군,025005, 24세,2021,484,282,202,139.6,380,205,175,117.1
38330, 창녕군,030,25~29세,2021,2709,1683,1026,164,2021,1184,837,141.5
38330, 창녕군,030001, 25세,2021,516,326,190,171.6,401,237,164,144.5
38330, 창녕군,030002, 26세,2021,535,332,203,163.5,407,243,164,148.2
38330, 창녕군,030003, 27세,2021,533,340,193,176.2,393,231,162,142.6
38330, 창녕군,030004, 28세,2021,568,341,227,150.2,417,242,175,138.3
38330, 창녕군,030005, 29세,2021,557,344,213,161.5,403,231,172,134.3
38330, 창녕군,035,30~34세,2021,2694,1602,1092,146.7,2033,1143,890,128.4
38330, 창녕군,035001, 30세,2021,563,321,242,132.6,430,227,203,111.8
38330, 창녕군,035002, 31세,2021,553,328,225,145.8,426,240,186,129
38330, 창녕군,035003, 32세,2021,559,351,208,168.8,413,253,160,158.1
38330, 창녕군,035004, 33세,2021,499,291,208,139.9,374,207,167,124
38330, 창녕군,035005, 34세,2021,520,311,209,148.8,390,216,174,124.1
38330, 창녕군,040,35~39세,2021,2932,1640,1292,126.9,2424,1286,1138,113
38330, 창녕군,040001, 35세,2021,539,332,207,160.4,418,239,179,133.5
38330, 창녕군,040002, 36세,2021,502,295,207,142.5,403,228,175,130.3
38330, 창녕군,040003, 37세,2021,581,310,271,114.4,491,251,240,104.6
38330, 창녕군,040004, 38세,2021,625,344,281,122.4,519,270,249,108.4
38330, 창녕군,040005, 39세,2021,685,359,326,110.1,593,298,295,101
38330, 창녕군,045,40~44세,2021,3286,1847,1439,128.4,2979,1649,1330,124
38330, 창녕군,045001, 40세,2021,633,378,255,148.2,564,328,236,139
38330, 창녕군,045002, 41세,2021,756,401,355,113,676,352,324,108.6
38330, 창녕군,045003, 42세,2021,677,368,309,119.1,621,329,292,112.7
38330, 창녕군,045004, 43세,2021,633,354,279,126.9,568,316,252,125.4
38330, 창녕군,045005, 44세,2021,587,346,241,143.6,550,324,226,143.4
38330, 창녕군,050,45~49세,2021,3590,2010,1580,127.2,3351,1868,1483,126
38330, 창녕군,050001, 45세,2021,619,363,256,141.8,564,332,232,143.1
38330, 창녕군,050002, 46세,2021,656,368,288,127.8,609,340,269,126.4
38330, 창녕군,050003, 47세,2021,763,422,341,123.8,720,395,325,121.5
38330, 창녕군,050004, 48세,2021,773,430,343,125.4,718,397,321,123.7
38330, 창녕군,050005, 49세,2021,779,427,352,121.3,740,404,336,120.2
38330, 창녕군,055,50~54세,2021,4663,2561,2102,121.8,4498,2467,2031,121.5
38330, 창녕군,055001, 50세,2021,907,506,401,126.2,867,485,382,127
38330, 창녕군,055002, 51세,2021,879,523,356,146.9,846,499,347,143.8
38330, 창녕군,055003, 52세,2021,954,519,435,119.3,921,501,420,119.3
38330, 창녕군,055004, 53세,2021,978,522,456,114.5,954,511,443,115.3
38330, 창녕군,055005, 54세,2021,945,491,454,108.1,910,471,439,107.3
38330, 창녕군,060,55~59세,2021,5456,2783,2673,104.1,5344,2730,2614,104.4
38330, 창녕군,060001, 55세,2021,1006,554,452,122.6,985,543,442,122.9
38330, 창녕군,060002, 56세,2021,1033,547,486,112.6,1007,535,472,113.3
38330, 창녕군,060003, 57세,2021,1029,479,550,87.1,1010,473,537,88.1
38330, 창녕군,060004, 58세,2021,1147,567,580,97.8,1130,559,571,97.9
38330, 창녕군,060005, 59세,2021,1241,636,605,105.1,1212,620,592,104.7
38330, 창녕군,065,60~64세,2021,6642,3333,3309,100.7,6553,3281,3272,100.3
38330, 창녕군,065001, 60세,2021,1331,644,687,93.7,1313,634,679,93.4
38330, 창녕군,065002, 61세,2021,1441,704,737,95.5,1425,697,728,95.7
38330, 창녕군,065003, 62세,2021,1331,688,643,107,1317,679,638,106.4
38330, 창녕군,065004, 63세,2021,1222,641,581,110.3,1196,626,570,109.8
38330, 창녕군,065005, 64세,2021,1317,656,661,99.2,1302,645,657,98.2
38330, 창녕군,070,65~69세,2021,5438,2652,2786,95.2,5397,2635,2762,95.4
38330, 창녕군,070001, 65세,2021,1211,607,604,100.5,1202,604,598,101
38330, 창녕군,070002, 66세,2021,1245,606,639,94.8,1237,602,635,94.8
38330, 창녕군,070003, 67세,2021,973,482,491,98.2,965,477,488,97.7
38330, 창녕군,070004, 68세,2021,923,436,487,89.5,911,433,478,90.6
38330, 창녕군,070005, 69세,2021,1086,521,565,92.2,1082,519,563,92.2
38330, 창녕군,075,70~74세,2021,4201,1982,2219,89.3,4194,1980,2214,89.4
38330, 창녕군,075001, 70세,2021,814,396,418,94.7,813,396,417,95
38330, 창녕군,075002, 71세,2021,877,412,465,88.6,873,411,462,89
38330, 창녕군,075003, 72세,2021,840,384,456,84.2,839,383,456,84
38330, 창녕군,075004, 73세,2021,825,408,417,97.8,825,408,417,97.8
38330, 창녕군,075005, 74세,2021,845,382,463,82.5,844,382,462,82.7
38330, 창녕군,080,75~79세,2021,3456,1355,2101,64.5,3451,1353,2098,64.5
38330, 창녕군,080001, 75세,2021,617,278,339,82,615,277,338,82
38330, 창녕군,080002, 76세,2021,583,257,326,78.8,582,256,326,78.5
38330, 창녕군,080003, 77세,2021,708,270,438,61.6,707,270,437,61.8
38330, 창녕군,080004, 78세,2021,723,262,461,56.8,723,262,461,56.8
38330, 창녕군,080005, 79세,2021,825,288,537,53.6,824,288,536,53.7
38330, 창녕군,085,80~84세,2021,3224,1072,2152,49.8,3223,1071,2152,49.8
38330, 창녕군,085001, 80세,2021,768,276,492,56.1,768,276,492,56.1
38330, 창녕군,085002, 81세,2021,663,220,443,49.7,662,219,443,49.4
38330, 창녕군,085003, 82세,2021,661,200,461,43.4,661,200,461,43.4
38330, 창녕군,085004, 83세,2021,632,203,429,47.3,632,203,429,47.3
38330, 창녕군,085005, 84세,2021,500,173,327,52.9,500,173,327,52.9
38330, 창녕군,090,85~89세,2021,1752,458,1294,35.4,1751,458,1293,35.4
38330, 창녕군,090001, 85세,2021,427,122,305,40,427,122,305,40
38330, 창녕군,090002, 86세,2021,409,117,292,40.1,409,117,292,40.1
38330, 창녕군,090003, 87세,2021,358,79,279,28.3,357,79,278,28.4
38330, 창녕군,090004, 88세,2021,308,80,228,35.1,308,80,228,35.1
38330, 창녕군,090005, 89세,2021,250,60,190,31.6,250,60,190,31.6
38330, 창녕군,095,90~94세,2021,555,102,453,22.5,555,102,453,22.5
38330, 창녕군,095001, 90세,2021,170,37,133,27.8,170,37,133,27.8
38330, 창녕군,095002, 91세,2021,139,26,113,23,139,26,113,23
38330, 창녕군,095003, 92세,2021,110,17,93,18.3,110,17,93,18.3
38330, 창녕군,095004, 93세,2021,89,13,76,17.1,89,13,76,17.1
38330, 창녕군,095005, 94세,2021,47,9,38,23.7,47,9,38,23.7
38330, 창녕군,100,95~99세,2021,81,12,69,17.4,80,11,69,15.9
38330, 창녕군,100001, 95세,2021,32,6,26,23.1,32,6,26,23.1
38330, 창녕군,100002, 96세,2021,19,X,17,11.8,19,X,17,11.8
38330, 창녕군,100003, 97세,2021,16,X,14,14.3,16,X,14,14.3
38330, 창녕군,100004, 98세,2021,6,X,5,20,5,X,5,0
38330, 창녕군,100005, 99세,2021,8,X,7,14.3,8,X,7,14.3
38330, 창녕군,101,100세이상,2021,11,X,10,10,11,X,10,10
38330, 창녕군,102,15세미만,2021,4837,2572,2265,113.6,4724,2514,2210,113.8
38330, 창녕군,103,15~64세,2021,36109,19850,16259,122.1,33060,17813,15247,116.8
38330, 창녕군,104,65세이상,2021,18718,7634,11084,68.9,18662,7611,11051,68.9
38330, 창녕군,086,85세이상,2021,2399,573,1826,31.4,2397,572,1825,31.3
38330, 창녕군,126,평균연령,2021,51.9,49,54.9,,52.8,50,55.6,
38330, 창녕군,127,중위연령,2021,56,52.5,59.3,,57.3,54.3,60.1,
38340, 고성군,000,합계,2021,48803,24618,24185,101.8,47312,23590,23722,99.4
38340, 고성군,005,0~4세,2021,744,384,360,106.7,743,383,360,106.4
38340, 고성군,005001, 0세,2021,118,59,59,100,118,59,59,100
38340, 고성군,005002, 1세,2021,139,70,69,101.4,138,69,69,100
38340, 고성군,005003, 2세,2021,138,70,68,102.9,138,70,68,102.9
38340, 고성군,005004, 3세,2021,178,91,87,104.6,178,91,87,104.6
38340, 고성군,005005, 4세,2021,171,94,77,122.1,171,94,77,122.1
38340, 고성군,010,5~9세,2021,1526,758,768,98.7,1522,756,766,98.7
38340, 고성군,010001, 5세,2021,235,136,99,137.4,235,136,99,137.4
38340, 고성군,010002, 6세,2021,293,135,158,85.4,292,134,158,84.8
38340, 고성군,010003, 7세,2021,313,145,168,86.3,312,144,168,85.7
38340, 고성군,010004, 8세,2021,325,157,168,93.5,323,157,166,94.6
38340, 고성군,010005, 9세,2021,360,185,175,105.7,360,185,175,105.7
38340, 고성군,015,10~14세,2021,1866,1009,857,117.7,1865,1008,857,117.6
38340, 고성군,015001, 10세,2021,398,210,188,111.7,398,210,188,111.7
38340, 고성군,015002, 11세,2021,389,212,177,119.8,389,212,177,119.8
38340, 고성군,015003, 12세,2021,335,175,160,109.4,335,175,160,109.4
38340, 고성군,015004, 13세,2021,377,193,184,104.9,377,193,184,104.9
38340, 고성군,015005, 14세,2021,367,219,148,148,366,218,148,147.3
38340, 고성군,020,15~19세,2021,2067,1172,895,130.9,2054,1164,890,130.8
38340, 고성군,020001, 15세,2021,350,184,166,110.8,348,182,166,109.6
38340, 고성군,020002, 16세,2021,453,231,222,104.1,449,229,220,104.1
38340, 고성군,020003, 17세,2021,512,303,209,145,512,303,209,145
38340, 고성군,020004, 18세,2021,485,280,205,136.6,482,278,204,136.3
38340, 고성군,020005, 19세,2021,267,174,93,187.1,263,172,91,189
38340, 고성군,025,20~24세,2021,1545,994,551,180.4,1477,956,521,183.5
38340, 고성군,025001, 20세,2021,289,216,73,295.9,289,216,73,295.9
38340, 고성군,025002, 21세,2021,333,222,111,200,324,215,109,197.2
38340, 고성군,025003, 22세,2021,295,182,113,161.1,281,175,106,165.1
38340, 고성군,025004, 23세,2021,317,183,134,136.6,298,172,126,136.5
38340, 고성군,025005, 24세,2021,311,191,120,159.2,285,178,107,166.4
38340, 고성군,030,25~29세,2021,1840,1105,735,150.3,1568,908,660,137.6
38340, 고성군,030001, 25세,2021,379,237,142,166.9,331,198,133,148.9
38340, 고성군,030002, 26세,2021,373,225,148,152,319,190,129,147.3
38340, 고성군,030003, 27세,2021,372,214,158,135.4,323,180,143,125.9
38340, 고성군,030004, 28세,2021,354,196,158,124.1,298,158,140,112.9
38340, 고성군,030005, 29세,2021,362,233,129,180.6,297,182,115,158.3
38340, 고성군,035,30~34세,2021,1684,1025,659,155.5,1334,767,567,135.3
38340, 고성군,035001, 30세,2021,327,204,123,165.9,260,154,106,145.3
38340, 고성군,035002, 31세,2021,324,212,112,189.3,247,156,91,171.4
38340, 고성군,035003, 32세,2021,359,210,149,140.9,289,161,128,125.8
38340, 고성군,035004, 33세,2021,324,184,140,131.4,264,141,123,114.6
38340, 고성군,035005, 34세,2021,350,215,135,159.3,274,155,119,130.3
38340, 고성군,040,35~39세,2021,2251,1280,971,131.8,1953,1051,902,116.5
38340, 고성군,040001, 35세,2021,368,221,147,150.3,299,167,132,126.5
38340, 고성군,040002, 36세,2021,398,227,171,132.7,332,172,160,107.5
38340, 고성군,040003, 37세,2021,428,232,196,118.4,363,187,176,106.3
38340, 고성군,040004, 38세,2021,515,295,220,134.1,460,251,209,120.1
38340, 고성군,040005, 39세,2021,542,305,237,128.7,499,274,225,121.8
38340, 고성군,045,40~44세,2021,2738,1533,1205,127.2,2572,1412,1160,121.7
38340, 고성군,045001, 40세,2021,570,309,261,118.4,533,281,252,111.5
38340, 고성군,045002, 41세,2021,602,347,255,136.1,566,315,251,125.5
38340, 고성군,045003, 42세,2021,551,324,227,142.7,524,304,220,138.2
38340, 고성군,045004, 43세,2021,512,291,221,131.7,471,262,209,125.4
38340, 고성군,045005, 44세,2021,503,262,241,108.7,478,250,228,109.6
38340, 고성군,050,45~49세,2021,3146,1734,1412,122.8,3051,1672,1379,121.2
38340, 고성군,050001, 45세,2021,561,314,247,127.1,538,299,239,125.1
38340, 고성군,050002, 46세,2021,599,324,275,117.8,581,310,271,114.4
38340, 고성군,050003, 47세,2021,616,330,286,115.4,595,317,278,114
38340, 고성군,050004, 48세,2021,693,378,315,120,677,366,311,117.7
38340, 고성군,050005, 49세,2021,677,388,289,134.3,660,380,280,135.7
38340, 고성군,055,50~54세,2021,4153,2272,1881,120.8,4065,2229,1836,121.4
38340, 고성군,055001, 50세,2021,840,440,400,110,826,430,396,108.6
38340, 고성군,055002, 51세,2021,850,469,381,123.1,829,458,371,123.5
38340, 고성군,055003, 52세,2021,789,439,350,125.4,770,434,336,129.2
38340, 고성군,055004, 53세,2021,849,445,404,110.1,827,435,392,111
38340, 고성군,055005, 54세,2021,825,479,346,138.4,813,472,341,138.4
38340, 고성군,060,55~59세,2021,4316,2258,2058,109.7,4257,2228,2029,109.8
38340, 고성군,060001, 55세,2021,804,431,373,115.5,790,425,365,116.4
38340, 고성군,060002, 56세,2021,852,427,425,100.5,840,422,418,101
38340, 고성군,060003, 57세,2021,765,425,340,125,754,420,334,125.7
38340, 고성군,060004, 58세,2021,880,473,407,116.2,864,464,400,116
38340, 고성군,060005, 59세,2021,1015,502,513,97.9,1009,497,512,97.1
38340, 고성군,065,60~64세,2021,5194,2615,2579,101.4,5159,2596,2563,101.3
38340, 고성군,065001, 60세,2021,1119,555,564,98.4,1111,551,560,98.4
38340, 고성군,065002, 61세,2021,1119,551,568,97,1109,548,561,97.7
38340, 고성군,065003, 62세,2021,1006,510,496,102.8,1002,508,494,102.8
38340, 고성군,065004, 63세,2021,963,480,483,99.4,956,474,482,98.3
38340, 고성군,065005, 64세,2021,987,519,468,110.9,981,515,466,110.5
38340, 고성군,070,65~69세,2021,4450,2156,2294,94,4428,2146,2282,94
38340, 고성군,070001, 65세,2021,962,493,469,105.1,950,488,462,105.6
38340, 고성군,070002, 66세,2021,965,452,513,88.1,962,451,511,88.3
38340, 고성군,070003, 67세,2021,880,429,451,95.1,876,427,449,95.1
38340, 고성군,070004, 68세,2021,762,366,396,92.4,759,364,395,92.2
38340, 고성군,070005, 69세,2021,881,416,465,89.5,881,416,465,89.5
38340, 고성군,075,70~74세,2021,3618,1739,1879,92.5,3610,1736,1874,92.6
38340, 고성군,075001, 70세,2021,725,360,365,98.6,723,359,364,98.6
38340, 고성군,075002, 71세,2021,682,311,371,83.8,678,309,369,83.7
38340, 고성군,075003, 72세,2021,749,382,367,104.1,749,382,367,104.1
38340, 고성군,075004, 73세,2021,742,354,388,91.2,742,354,388,91.2
38340, 고성군,075005, 74세,2021,720,332,388,85.6,718,332,386,86
38340, 고성군,080,75~79세,2021,2884,1171,1713,68.4,2878,1167,1711,68.2
38340, 고성군,080001, 75세,2021,519,227,292,77.7,518,226,292,77.4
38340, 고성군,080002, 76세,2021,580,231,349,66.2,580,231,349,66.2
38340, 고성군,080003, 77세,2021,522,234,288,81.3,520,232,288,80.6
38340, 고성군,080004, 78세,2021,588,230,358,64.2,586,230,356,64.6
38340, 고성군,080005, 79세,2021,675,249,426,58.5,674,248,426,58.2
38340, 고성군,085,80~84세,2021,2581,877,1704,51.5,2578,875,1703,51.4
38340, 고성군,085001, 80세,2021,606,222,384,57.8,606,222,384,57.8
38340, 고성군,085002, 81세,2021,582,222,360,61.7,581,222,359,61.8
38340, 고성군,085003, 82세,2021,559,178,381,46.7,559,178,381,46.7
38340, 고성군,085004, 83세,2021,421,127,294,43.2,420,126,294,42.9
38340, 고성군,085005, 84세,2021,413,128,285,44.9,412,127,285,44.6
38340, 고성군,090,85~89세,2021,1579,428,1151,37.2,1577,428,1149,37.2
38340, 고성군,090001, 85세,2021,422,137,285,48.1,421,137,284,48.2
38340, 고성군,090002, 86세,2021,352,95,257,37,352,95,257,37
38340, 고성군,090003, 87세,2021,325,94,231,40.7,324,94,230,40.9
38340, 고성군,090004, 88세,2021,253,58,195,29.7,253,58,195,29.7
38340, 고성군,090005, 89세,2021,227,44,183,24,227,44,183,24
38340, 고성군,095,90~94세,2021,508,96,412,23.3,508,96,412,23.3
38340, 고성군,095001, 90세,2021,138,24,114,21.1,138,24,114,21.1
38340, 고성군,095002, 91세,2021,140,22,118,18.6,140,22,118,18.6
38340, 고성군,095003, 92세,2021,111,29,82,35.4,111,29,82,35.4
38340, 고성군,095004, 93세,2021,64,11,53,20.8,64,11,53,20.8
38340, 고성군,095005, 94세,2021,55,10,45,22.2,55,10,45,22.2
38340, 고성군,100,95~99세,2021,100,11,89,12.4,100,11,89,12.4
38340, 고성군,100001, 95세,2021,45,X,43,4.7,45,X,43,4.7
38340, 고성군,100002, 96세,2021,21,X,18,16.7,21,X,18,16.7
38340, 고성군,100003, 97세,2021,15,X,11,36.4,15,X,11,36.4
38340, 고성군,100004, 98세,2021,11,X,9,22.2,11,X,9,22.2
38340, 고성군,100005, 99세,2021,8,X,8,0,8,X,8,0
38340, 고성군,101,100세이상,2021,13,X,12,8.3,13,X,12,8.3
38340, 고성군,102,15세미만,2021,4136,2151,1985,108.4,4130,2147,1983,108.3
38340, 고성군,103,15~64세,2021,28934,15988,12946,123.5,27490,14983,12507,119.8
38340, 고성군,104,65세이상,2021,15733,6479,9254,70,15692,6460,9232,70
38340, 고성군,086,85세이상,2021,2200,536,1664,32.2,2198,536,1662,32.3
38340, 고성군,126,평균연령,2021,52.2,49.4,55.1,,52.7,49.9,55.4,
38340, 고성군,127,중위연령,2021,56,52.9,59.5,,56.8,53.9,59.9,
38350, 남해군,000,합계,2021,40870,20144,20726,97.2,39852,19314,20538,94
38350, 남해군,005,0~4세,2021,553,281,272,103.3,552,281,271,103.7
38350, 남해군,005001, 0세,2021,88,42,46,91.3,88,42,46,91.3
38350, 남해군,005002, 1세,2021,107,52,55,94.5,106,52,54,96.3
38350, 남해군,005003, 2세,2021,115,55,60,91.7,115,55,60,91.7
38350, 남해군,005004, 3세,2021,100,48,52,92.3,100,48,52,92.3
38350, 남해군,005005, 4세,2021,143,84,59,142.4,143,84,59,142.4
38350, 남해군,010,5~9세,2021,903,469,434,108.1,903,469,434,108.1
38350, 남해군,010001, 5세,2021,161,77,84,91.7,161,77,84,91.7
38350, 남해군,010002, 6세,2021,166,94,72,130.6,166,94,72,130.6
38350, 남해군,010003, 7세,2021,200,111,89,124.7,200,111,89,124.7
38350, 남해군,010004, 8세,2021,165,76,89,85.4,165,76,89,85.4
38350, 남해군,010005, 9세,2021,211,111,100,111,211,111,100,111
38350, 남해군,015,10~14세,2021,1248,699,549,127.3,1245,697,548,127.2
38350, 남해군,015001, 10세,2021,217,136,81,167.9,217,136,81,167.9
38350, 남해군,015002, 11세,2021,250,137,113,121.2,249,136,113,120.4
38350, 남해군,015003, 12세,2021,244,138,106,130.2,243,138,105,131.4
38350, 남해군,015004, 13세,2021,269,153,116,131.9,269,153,116,131.9
38350, 남해군,015005, 14세,2021,268,135,133,101.5,267,134,133,100.8
38350, 남해군,020,15~19세,2021,1519,798,721,110.7,1517,796,721,110.4
38350, 남해군,020001, 15세,2021,235,120,115,104.3,235,120,115,104.3
38350, 남해군,020002, 16세,2021,283,143,140,102.1,283,143,140,102.1
38350, 남해군,020003, 17세,2021,400,200,200,100,400,200,200,100
38350, 남해군,020004, 18세,2021,350,172,178,96.6,348,170,178,95.5
38350, 남해군,020005, 19세,2021,251,163,88,185.2,251,163,88,185.2
38350, 남해군,025,20~24세,2021,1418,988,430,229.8,1351,928,423,219.4
38350, 남해군,025001, 20세,2021,287,194,93,208.6,286,193,93,207.5
38350, 남해군,025002, 21세,2021,314,255,59,432.2,309,250,59,423.7
38350, 남해군,025003, 22세,2021,269,185,84,220.2,259,177,82,215.9
38350, 남해군,025004, 23세,2021,258,164,94,174.5,244,151,93,162.4
38350, 남해군,025005, 24세,2021,290,190,100,190,253,157,96,163.5
38350, 남해군,030,25~29세,2021,1475,965,510,189.2,1248,767,481,159.5
38350, 남해군,030001, 25세,2021,311,187,124,150.8,269,149,120,124.2
38350, 남해군,030002, 26세,2021,318,207,111,186.5,275,171,104,164.4
38350, 남해군,030003, 27세,2021,271,180,91,197.8,233,145,88,164.8
38350, 남해군,030004, 28세,2021,296,207,89,232.6,240,158,82,192.7
38350, 남해군,030005, 29세,2021,279,184,95,193.7,231,144,87,165.5
38350, 남해군,035,30~34세,2021,1223,734,489,150.1,988,529,459,115.3
38350, 남해군,035001, 30세,2021,240,155,85,182.4,197,114,83,137.3
38350, 남해군,035002, 31세,2021,252,157,95,165.3,201,112,89,125.8
38350, 남해군,035003, 32세,2021,235,143,92,155.4,198,110,88,125
38350, 남해군,035004, 33세,2021,224,128,96,133.3,171,81,90,90
38350, 남해군,035005, 34세,2021,272,151,121,124.8,221,112,109,102.8
38350, 남해군,040,35~39세,2021,1388,782,606,129,1199,620,579,107.1
38350, 남해군,040001, 35세,2021,248,147,101,145.5,212,115,97,118.6
38350, 남해군,040002, 36세,2021,262,150,112,133.9,213,108,105,102.9
38350, 남해군,040003, 37세,2021,266,143,123,116.3,233,119,114,104.4
38350, 남해군,040004, 38세,2021,289,166,123,135,255,134,121,110.7
38350, 남해군,040005, 39세,2021,323,176,147,119.7,286,144,142,101.4
38350, 남해군,045,40~44세,2021,1770,968,802,120.7,1655,871,784,111.1
38350, 남해군,045001, 40세,2021,371,198,173,114.5,337,169,168,100.6
38350, 남해군,045002, 41세,2021,386,208,178,116.9,356,182,174,104.6
38350, 남해군,045003, 42세,2021,338,183,155,118.1,313,162,151,107.3
38350, 남해군,045004, 43세,2021,333,189,144,131.3,316,175,141,124.1
38350, 남해군,045005, 44세,2021,342,190,152,125,333,183,150,122
38350, 남해군,050,45~49세,2021,2477,1346,1131,119,2412,1297,1115,116.3
38350, 남해군,050001, 45세,2021,402,222,180,123.3,386,210,176,119.3
38350, 남해군,050002, 46세,2021,466,249,217,114.7,451,236,215,109.8
38350, 남해군,050003, 47세,2021,488,266,222,119.8,475,257,218,117.9
38350, 남해군,050004, 48세,2021,556,291,265,109.8,544,283,261,108.4
38350, 남해군,050005, 49세,2021,565,318,247,128.7,556,311,245,126.9
38350, 남해군,055,50~54세,2021,3181,1770,1411,125.4,3146,1752,1394,125.7
38350, 남해군,055001, 50세,2021,630,365,265,137.7,625,362,263,137.6
38350, 남해군,055002, 51세,2021,608,340,268,126.9,604,337,267,126.2
38350, 남해군,055003, 52세,2021,683,378,305,123.9,675,372,303,122.8
38350, 남해군,055004, 53세,2021,639,346,293,118.1,632,342,290,117.9
38350, 남해군,055005, 54세,2021,621,341,280,121.8,610,339,271,125.1
38350, 남해군,060,55~59세,2021,3620,1877,1743,107.7,3599,1868,1731,107.9
38350, 남해군,060001, 55세,2021,655,366,289,126.6,653,365,288,126.7
38350, 남해군,060002, 56세,2021,673,345,328,105.2,670,344,326,105.5
38350, 남해군,060003, 57세,2021,658,328,330,99.4,652,324,328,98.8
38350, 남해군,060004, 58세,2021,723,376,347,108.4,716,373,343,108.7
38350, 남해군,060005, 59세,2021,911,462,449,102.9,908,462,446,103.6
38350, 남해군,065,60~64세,2021,4507,2226,2281,97.6,4485,2219,2266,97.9
38350, 남해군,065001, 60세,2021,996,473,523,90.4,992,472,520,90.8
38350, 남해군,065002, 61세,2021,962,493,469,105.1,954,488,466,104.7
38350, 남해군,065003, 62세,2021,823,386,437,88.3,817,385,432,89.1
38350, 남해군,065004, 63세,2021,819,433,386,112.2,816,433,383,113.1
38350, 남해군,065005, 64세,2021,907,441,466,94.6,906,441,465,94.8
38350, 남해군,070,65~69세,2021,3807,1822,1985,91.8,3784,1810,1974,91.7
38350, 남해군,070001, 65세,2021,808,416,392,106.1,797,410,387,105.9
38350, 남해군,070002, 66세,2021,861,400,461,86.8,855,396,459,86.3
38350, 남해군,070003, 67세,2021,679,338,341,99.1,679,338,341,99.1
38350, 남해군,070004, 68세,2021,677,326,351,92.9,676,326,350,93.1
38350, 남해군,070005, 69세,2021,782,342,440,77.7,777,340,437,77.8
38350, 남해군,075,70~74세,2021,3509,1656,1853,89.4,3503,1651,1852,89.1
38350, 남해군,075001, 70세,2021,730,345,385,89.6,730,345,385,89.6
38350, 남해군,075002, 71세,2021,624,319,305,104.6,623,318,305,104.3
38350, 남해군,075003, 72세,2021,781,359,422,85.1,779,357,422,84.6
38350, 남해군,075004, 73세,2021,674,307,367,83.7,672,305,367,83.1
38350, 남해군,075005, 74세,2021,700,326,374,87.2,699,326,373,87.4
38350, 남해군,080,75~79세,2021,2909,1177,1732,68,2906,1175,1731,67.9
38350, 남해군,080001, 75세,2021,566,260,306,85,566,260,306,85
38350, 남해군,080002, 76세,2021,548,244,304,80.3,548,244,304,80.3
38350, 남해군,080003, 77세,2021,513,213,300,71,511,211,300,70.3
38350, 남해군,080004, 78세,2021,552,200,352,56.8,552,200,352,56.8
38350, 남해군,080005, 79세,2021,730,260,470,55.3,729,260,469,55.4
38350, 남해군,085,80~84세,2021,2858,996,1862,53.5,2854,994,1860,53.4
38350, 남해군,085001, 80세,2021,652,239,413,57.9,650,238,412,57.8
38350, 남해군,085002, 81세,2021,644,230,414,55.6,642,229,413,55.4
38350, 남해군,085003, 82세,2021,588,199,389,51.2,588,199,389,51.2
38350, 남해군,085004, 83세,2021,480,171,309,55.3,480,171,309,55.3
38350, 남해군,085005, 84세,2021,494,157,337,46.6,494,157,337,46.6
38350, 남해군,090,85~89세,2021,1748,450,1298,34.7,1748,450,1298,34.7
38350, 남해군,090001, 85세,2021,424,119,305,39,424,119,305,39
38350, 남해군,090002, 86세,2021,422,95,327,29.1,422,95,327,29.1
38350, 남해군,090003, 87세,2021,367,100,267,37.5,367,100,267,37.5
38350, 남해군,090004, 88세,2021,277,69,208,33.2,277,69,208,33.2
38350, 남해군,090005, 89세,2021,258,67,191,35.1,258,67,191,35.1
38350, 남해군,095,90~94세,2021,614,123,491,25.1,614,123,491,25.1
38350, 남해군,095001, 90세,2021,193,33,160,20.6,193,33,160,20.6
38350, 남해군,095002, 91세,2021,160,41,119,34.5,160,41,119,34.5
38350, 남해군,095003, 92세,2021,117,22,95,23.2,117,22,95,23.2
38350, 남해군,095004, 93세,2021,83,18,65,27.7,83,18,65,27.7
38350, 남해군,095005, 94세,2021,61,9,52,17.3,61,9,52,17.3
38350, 남해군,100,95~99세,2021,132,15,117,12.8,132,15,117,12.8
38350, 남해군,100001, 95세,2021,53,9,44,20.5,53,9,44,20.5
38350, 남해군,100002, 96세,2021,39,X,35,11.4,39,X,35,11.4
38350, 남해군,100003, 97세,2021,20,X,20,0,20,X,20,0
38350, 남해군,100004, 98세,2021,13,X,11,18.2,13,X,11,18.2
38350, 남해군,100005, 99세,2021,7,X,7,0,7,X,7,0
38350, 남해군,101,100세이상,2021,11,X,9,22.2,11,X,9,22.2
38350, 남해군,102,15세미만,2021,2704,1449,1255,115.5,2700,1447,1253,115.5
38350, 남해군,103,15~64세,2021,22578,12454,10124,123,21600,11647,9953,117
38350, 남해군,104,65세이상,2021,15588,6241,9347,66.8,15552,6220,9332,66.7
38350, 남해군,086,85세이상,2021,2505,590,1915,30.8,2505,590,1915,30.8
38350, 남해군,126,평균연령,2021,55.3,51.7,58.8,,55.8,52.4,58.9,
38350, 남해군,127,중위연령,2021,59.6,55.7,62.6,,60.1,56.8,62.8,
38360, 하동군,000,합계,2021,40167,19848,20319,97.7,39533,19597,19936,98.3
38360, 하동군,005,0~4세,2021,680,355,325,109.2,680,355,325,109.2
38360, 하동군,005001, 0세,2021,111,64,47,136.2,111,64,47,136.2
38360, 하동군,005002, 1세,2021,132,69,63,109.5,132,69,63,109.5
38360, 하동군,005003, 2세,2021,149,78,71,109.9,149,78,71,109.9
38360, 하동군,005004, 3세,2021,138,68,70,97.1,138,68,70,97.1
38360, 하동군,005005, 4세,2021,150,76,74,102.7,150,76,74,102.7
38360, 하동군,010,5~9세,2021,911,482,429,112.4,911,482,429,112.4
38360, 하동군,010001, 5세,2021,160,62,98,63.3,160,62,98,63.3
38360, 하동군,010002, 6세,2021,180,99,81,122.2,180,99,81,122.2
38360, 하동군,010003, 7세,2021,183,106,77,137.7,183,106,77,137.7
38360, 하동군,010004, 8세,2021,173,97,76,127.6,173,97,76,127.6
38360, 하동군,010005, 9세,2021,215,118,97,121.6,215,118,97,121.6
38360, 하동군,015,10~14세,2021,1258,680,578,117.6,1257,680,577,117.9
38360, 하동군,015001, 10세,2021,248,143,105,136.2,248,143,105,136.2
38360, 하동군,015002, 11세,2021,255,137,118,116.1,254,137,117,117.1
38360, 하동군,015003, 12세,2021,235,106,129,82.2,235,106,129,82.2
38360, 하동군,015004, 13세,2021,273,149,124,120.2,273,149,124,120.2
38360, 하동군,015005, 14세,2021,247,145,102,142.2,247,145,102,142.2
38360, 하동군,020,15~19세,2021,1108,626,482,129.9,1106,626,480,130.4
38360, 하동군,020001, 15세,2021,260,145,115,126.1,260,145,115,126.1
38360, 하동군,020002, 16세,2021,242,130,112,116.1,242,130,112,116.1
38360, 하동군,020003, 17세,2021,257,144,113,127.4,257,144,113,127.4
38360, 하동군,020004, 18세,2021,216,119,97,122.7,216,119,97,122.7
38360, 하동군,020005, 19세,2021,133,88,45,195.6,131,88,43,204.7
38360, 하동군,025,20~24세,2021,1181,770,411,187.3,1126,754,372,202.7
38360, 하동군,025001, 20세,2021,203,143,60,238.3,202,143,59,242.4
38360, 하동군,025002, 21세,2021,254,198,56,353.6,246,195,51,382.4
38360, 하동군,025003, 22세,2021,228,149,79,188.6,220,149,71,209.9
38360, 하동군,025004, 23세,2021,263,149,114,130.7,245,144,101,142.6
38360, 하동군,025005, 24세,2021,233,131,102,128.4,213,123,90,136.7
38360, 하동군,030,25~29세,2021,1319,751,568,132.2,1198,697,501,139.1
38360, 하동군,030001, 25세,2021,293,177,116,152.6,274,172,102,168.6
38360, 하동군,030002, 26세,2021,259,143,116,123.3,231,127,104,122.1
38360, 하동군,030003, 27세,2021,239,138,101,136.6,219,132,87,151.7
38360, 하동군,030004, 28세,2021,269,154,115,133.9,237,139,98,141.8
38360, 하동군,030005, 29세,2021,259,139,120,115.8,237,127,110,115.5
38360, 하동군,035,30~34세,2021,1231,697,534,130.5,1094,627,467,134.3
38360, 하동군,035001, 30세,2021,248,131,117,112,220,119,101,117.8
38360, 하동군,035002, 31세,2021,232,128,104,123.1,198,111,87,127.6
38360, 하동군,035003, 32세,2021,247,137,110,124.5,221,122,99,123.2
38360, 하동군,035004, 33세,2021,261,160,101,158.4,232,144,88,163.6
38360, 하동군,035005, 34세,2021,243,141,102,138.2,223,131,92,142.4
38360, 하동군,040,35~39세,2021,1313,685,628,109.1,1233,653,580,112.6
38360, 하동군,040001, 35세,2021,219,117,102,114.7,201,109,92,118.5
38360, 하동군,040002, 36세,2021,201,102,99,103,188,99,89,111.2
38360, 하동군,040003, 37세,2021,301,164,137,119.7,289,157,132,118.9
38360, 하동군,040004, 38세,2021,272,142,130,109.2,250,133,117,113.7
38360, 하동군,040005, 39세,2021,320,160,160,100,305,155,150,103.3
38360, 하동군,045,40~44세,2021,1690,917,773,118.6,1639,895,744,120.3
38360, 하동군,045001, 40세,2021,301,160,141,113.5,292,156,136,114.7
38360, 하동군,045002, 41세,2021,307,175,132,132.6,296,171,125,136.8
38360, 하동군,045003, 42세,2021,353,198,155,127.7,341,191,150,127.3
38360, 하동군,045004, 43세,2021,370,186,184,101.1,365,183,182,100.5
38360, 하동군,045005, 44세,2021,359,198,161,123,345,194,151,128.5
38360, 하동군,050,45~49세,2021,2518,1375,1143,120.3,2471,1358,1113,122
38360, 하동군,050001, 45세,2021,410,235,175,134.3,402,231,171,135.1
38360, 하동군,050002, 46세,2021,456,242,214,113.1,446,241,205,117.6
38360, 하동군,050003, 47세,2021,518,279,239,116.7,506,274,232,118.1
38360, 하동군,050004, 48세,2021,589,320,269,119,581,319,262,121.8
38360, 하동군,050005, 49세,2021,545,299,246,121.5,536,293,243,120.6
38360, 하동군,055,50~54세,2021,3553,1975,1578,125.2,3508,1961,1547,126.8
38360, 하동군,055001, 50세,2021,640,338,302,111.9,625,336,289,116.3
38360, 하동군,055002, 51세,2021,709,396,313,126.5,702,392,310,126.5
38360, 하동군,055003, 52세,2021,718,423,295,143.4,711,421,290,145.2
38360, 하동군,055004, 53세,2021,724,402,322,124.8,714,399,315,126.7
38360, 하동군,055005, 54세,2021,762,416,346,120.2,756,413,343,120.4
38360, 하동군,060,55~59세,2021,3832,2006,1826,109.9,3789,1993,1796,111
38360, 하동군,060001, 55세,2021,718,390,328,118.9,711,388,323,120.1
38360, 하동군,060002, 56세,2021,747,379,368,103,740,376,364,103.3
38360, 하동군,060003, 57세,2021,656,324,332,97.6,646,321,325,98.8
38360, 하동군,060004, 58세,2021,800,432,368,117.4,788,429,359,119.5
38360, 하동군,060005, 59세,2021,911,481,430,111.9,904,479,425,112.7
38360, 하동군,065,60~64세,2021,4820,2496,2324,107.4,4797,2492,2305,108.1
38360, 하동군,065001, 60세,2021,1048,536,512,104.7,1046,536,510,105.1
38360, 하동군,065002, 61세,2021,1062,551,511,107.8,1058,551,507,108.7
38360, 하동군,065003, 62세,2021,888,452,436,103.7,881,452,429,105.4
38360, 하동군,065004, 63세,2021,923,495,428,115.7,917,492,425,115.8
38360, 하동군,065005, 64세,2021,899,462,437,105.7,895,461,434,106.2
38360, 하동군,070,65~69세,2021,3913,1956,1957,99.9,3893,1948,1945,100.2
38360, 하동군,070001, 65세,2021,847,460,387,118.9,839,456,383,119.1
38360, 하동군,070002, 66세,2021,892,435,457,95.2,889,433,456,95
38360, 하동군,070003, 67세,2021,782,398,384,103.6,778,398,380,104.7
38360, 하동군,070004, 68세,2021,647,300,347,86.5,646,300,346,86.7
38360, 하동군,070005, 69세,2021,745,363,382,95,741,361,380,95
38360, 하동군,075,70~74세,2021,3232,1516,1716,88.3,3224,1515,1709,88.6
38360, 하동군,075001, 70세,2021,643,306,337,90.8,642,306,336,91.1
38360, 하동군,075002, 71세,2021,641,312,329,94.8,638,311,327,95.1
38360, 하동군,075003, 72세,2021,641,294,347,84.7,639,294,345,85.2
38360, 하동군,075004, 73세,2021,660,316,344,91.9,658,316,342,92.4
38360, 하동군,075005, 74세,2021,647,288,359,80.2,647,288,359,80.2
38360, 하동군,080,75~79세,2021,2782,1113,1669,66.7,2781,1113,1668,66.7
38360, 하동군,080001, 75세,2021,481,215,266,80.8,480,215,265,81.1
38360, 하동군,080002, 76세,2021,486,190,296,64.2,486,190,296,64.2
38360, 하동군,080003, 77세,2021,554,233,321,72.6,554,233,321,72.6
38360, 하동군,080004, 78세,2021,557,228,329,69.3,557,228,329,69.3
38360, 하동군,080005, 79세,2021,704,247,457,54,704,247,457,54
38360, 하동군,085,80~84세,2021,2594,890,1704,52.2,2594,890,1704,52.2
38360, 하동군,085001, 80세,2021,548,200,348,57.5,548,200,348,57.5
38360, 하동군,085002, 81세,2021,559,193,366,52.7,559,193,366,52.7
38360, 하동군,085003, 82세,2021,589,206,383,53.8,589,206,383,53.8
38360, 하동군,085004, 83세,2021,432,139,293,47.4,432,139,293,47.4
38360, 하동군,085005, 84세,2021,466,152,314,48.4,466,152,314,48.4
38360, 하동군,090,85~89세,2021,1552,414,1138,36.4,1552,414,1138,36.4
38360, 하동군,090001, 85세,2021,430,117,313,37.4,430,117,313,37.4
38360, 하동군,090002, 86세,2021,369,106,263,40.3,369,106,263,40.3
38360, 하동군,090003, 87세,2021,315,88,227,38.8,315,88,227,38.8
38360, 하동군,090004, 88세,2021,217,55,162,34,217,55,162,34
38360, 하동군,090005, 89세,2021,221,48,173,27.7,221,48,173,27.7
38360, 하동군,095,90~94세,2021,558,130,428,30.4,558,130,428,30.4
38360, 하동군,095001, 90세,2021,161,45,116,38.8,161,45,116,38.8
38360, 하동군,095002, 91세,2021,146,31,115,27,146,31,115,27
38360, 하동군,095003, 92세,2021,104,24,80,30,104,24,80,30
38360, 하동군,095004, 93세,2021,82,13,69,18.8,82,13,69,18.8
38360, 하동군,095005, 94세,2021,65,17,48,35.4,65,17,48,35.4
38360, 하동군,100,95~99세,2021,106,11,95,11.6,106,11,95,11.6
38360, 하동군,100001, 95세,2021,49,9,40,22.5,49,9,40,22.5
38360, 하동군,100002, 96세,2021,25,X,25,0,25,X,25,0
38360, 하동군,100003, 97세,2021,13,X,11,18.2,13,X,11,18.2
38360, 하동군,100004, 98세,2021,14,X,14,0,14,X,14,0
38360, 하동군,100005, 99세,2021,5,X,5,0,5,X,5,0
38360, 하동군,101,100세이상,2021,16,X,13,23.1,16,X,13,23.1
38360, 하동군,102,15세미만,2021,2849,1517,1332,113.9,2848,1517,1331,114
38360, 하동군,103,15~64세,2021,22565,12298,10267,119.8,21961,12056,9905,121.7
38360, 하동군,104,65세이상,2021,14753,6033,8720,69.2,14724,6024,8700,69.2
38360, 하동군,086,85세이상,2021,2232,558,1674,33.3,2232,558,1674,33.3
38360, 하동군,126,평균연령,2021,55.3,52.4,58.2,,55.6,52.6,58.5,
38360, 하동군,127,중위연령,2021,59.4,56.6,61.7,,59.7,56.9,62,
38370, 산청군,000,합계,2021,33014,16035,16979,94.4,32258,15713,16545,95
38370, 산청군,005,0~4세,2021,510,245,265,92.5,508,244,264,92.4
38370, 산청군,005001, 0세,2021,95,39,56,69.6,95,39,56,69.6
38370, 산청군,005002, 1세,2021,82,42,40,105,80,41,39,105.1
38370, 산청군,005003, 2세,2021,118,54,64,84.4,118,54,64,84.4
38370, 산청군,005004, 3세,2021,93,47,46,102.2,93,47,46,102.2
38370, 산청군,005005, 4세,2021,122,63,59,106.8,122,63,59,106.8
38370, 산청군,010,5~9세,2021,664,355,309,114.9,663,354,309,114.6
38370, 산청군,010001, 5세,2021,117,50,67,74.6,117,50,67,74.6
38370, 산청군,010002, 6세,2021,141,81,60,135,141,81,60,135
38370, 산청군,010003, 7세,2021,116,63,53,118.9,115,62,53,117
38370, 산청군,010004, 8세,2021,146,78,68,114.7,146,78,68,114.7
38370, 산청군,010005, 9세,2021,144,83,61,136.1,144,83,61,136.1
38370, 산청군,015,10~14세,2021,943,524,419,125.1,941,522,419,124.6
38370, 산청군,015001, 10세,2021,167,99,68,145.6,167,99,68,145.6
38370, 산청군,015002, 11세,2021,183,101,82,123.2,183,101,82,123.2
38370, 산청군,015003, 12세,2021,173,91,82,111,173,91,82,111
38370, 산청군,015004, 13세,2021,186,108,78,138.5,186,108,78,138.5
38370, 산청군,015005, 14세,2021,234,125,109,114.7,232,123,109,112.8
38370, 산청군,020,15~19세,2021,1108,545,563,96.8,1107,545,562,97
38370, 산청군,020001, 15세,2021,194,95,99,96,193,95,98,96.9
38370, 산청군,020002, 16세,2021,222,113,109,103.7,222,113,109,103.7
38370, 산청군,020003, 17세,2021,289,137,152,90.1,289,137,152,90.1
38370, 산청군,020004, 18세,2021,270,122,148,82.4,270,122,148,82.4
38370, 산청군,020005, 19세,2021,133,78,55,141.8,133,78,55,141.8
38370, 산청군,025,20~24세,2021,931,583,348,167.5,872,562,310,181.3
38370, 산청군,025001, 20세,2021,158,116,42,276.2,157,116,41,282.9
38370, 산청군,025002, 21세,2021,185,125,60,208.3,181,124,57,217.5
38370, 산청군,025003, 22세,2021,164,105,59,178,153,100,53,188.7
38370, 산청군,025004, 23세,2021,210,124,86,144.2,186,116,70,165.7
38370, 산청군,025005, 24세,2021,214,113,101,111.9,195,106,89,119.1
38370, 산청군,030,25~29세,2021,1102,601,501,120,918,536,382,140.3
38370, 산청군,030001, 25세,2021,206,109,97,112.4,190,106,84,126.2
38370, 산청군,030002, 26세,2021,241,132,109,121.1,197,120,77,155.8
38370, 산청군,030003, 27세,2021,223,124,99,125.3,187,107,80,133.8
38370, 산청군,030004, 28세,2021,219,113,106,106.6,171,97,74,131.1
38370, 산청군,030005, 29세,2021,213,123,90,136.7,173,106,67,158.2
38370, 산청군,035,30~34세,2021,1001,535,466,114.8,829,452,377,119.9
38370, 산청군,035001, 30세,2021,199,107,92,116.3,153,88,65,135.4
38370, 산청군,035002, 31세,2021,201,103,98,105.1,169,90,79,113.9
38370, 산청군,035003, 32세,2021,189,97,92,105.4,162,82,80,102.5
38370, 산청군,035004, 33세,2021,212,124,88,140.9,174,103,71,145.1
38370, 산청군,035005, 34세,2021,200,104,96,108.3,171,89,82,108.5
38370, 산청군,040,35~39세,2021,1064,553,511,108.2,973,516,457,112.9
38370, 산청군,040001, 35세,2021,190,92,98,93.9,170,84,86,97.7
38370, 산청군,040002, 36세,2021,178,97,81,119.8,157,88,69,127.5
38370, 산청군,040003, 37세,2021,214,120,94,127.7,195,112,83,134.9
38370, 산청군,040004, 38세,2021,216,103,113,91.2,207,101,106,95.3
38370, 산청군,040005, 39세,2021,266,141,125,112.8,244,131,113,115.9
38370, 산청군,045,40~44세,2021,1380,751,629,119.4,1314,713,601,118.6
38370, 산청군,045001, 40세,2021,271,150,121,124,252,139,113,123
38370, 산청군,045002, 41세,2021,282,150,132,113.6,267,142,125,113.6
38370, 산청군,045003, 42세,2021,267,148,119,124.4,254,140,114,122.8
38370, 산청군,045004, 43세,2021,281,149,132,112.9,272,143,129,110.9
38370, 산청군,045005, 44세,2021,279,154,125,123.2,269,149,120,124.2
38370, 산청군,050,45~49세,2021,1809,983,826,119,1763,966,797,121.2
38370, 산청군,050001, 45세,2021,269,137,132,103.8,262,136,126,107.9
38370, 산청군,050002, 46세,2021,307,158,149,106,297,154,143,107.7
38370, 산청군,050003, 47세,2021,404,222,182,122,395,221,174,127
38370, 산청군,050004, 48세,2021,442,237,205,115.6,428,231,197,117.3
38370, 산청군,050005, 49세,2021,387,229,158,144.9,381,224,157,142.7
38370, 산청군,055,50~54세,2021,2766,1491,1275,116.9,2730,1475,1255,117.5
38370, 산청군,055001, 50세,2021,489,279,210,132.9,479,276,203,136
38370, 산청군,055002, 51세,2021,505,268,237,113.1,497,263,234,112.4
38370, 산청군,055003, 52세,2021,582,317,265,119.6,576,314,262,119.8
38370, 산청군,055004, 53세,2021,594,306,288,106.3,585,302,283,106.7
38370, 산청군,055005, 54세,2021,596,321,275,116.7,593,320,273,117.2
38370, 산청군,060,55~59세,2021,3135,1683,1452,115.9,3095,1663,1432,116.1
38370, 산청군,060001, 55세,2021,627,367,260,141.2,617,361,256,141
38370, 산청군,060002, 56세,2021,622,340,282,120.6,615,339,276,122.8
38370, 산청군,060003, 57세,2021,517,271,246,110.2,509,267,242,110.3
38370, 산청군,060004, 58세,2021,614,318,296,107.4,605,313,292,107.2
38370, 산청군,060005, 59세,2021,755,387,368,105.2,749,383,366,104.6
38370, 산청군,065,60~64세,2021,3928,2009,1919,104.7,3904,2002,1902,105.3
38370, 산청군,065001, 60세,2021,874,452,422,107.1,868,450,418,107.7
38370, 산청군,065002, 61세,2021,864,422,442,95.5,860,419,441,95
38370, 산청군,065003, 62세,2021,706,353,353,100,701,352,349,100.9
38370, 산청군,065004, 63세,2021,731,386,345,111.9,724,385,339,113.6
38370, 산청군,065005, 64세,2021,753,396,357,110.9,751,396,355,111.5
38370, 산청군,070,65~69세,2021,3422,1747,1675,104.3,3406,1743,1663,104.8
38370, 산청군,070001, 65세,2021,739,384,355,108.2,737,383,354,108.2
38370, 산청군,070002, 66세,2021,767,390,377,103.4,761,389,372,104.6
38370, 산청군,070003, 67세,2021,678,341,337,101.2,674,341,333,102.4
38370, 산청군,070004, 68세,2021,580,294,286,102.8,578,293,285,102.8
38370, 산청군,070005, 69세,2021,658,338,320,105.6,656,337,319,105.6
38370, 산청군,075,70~74세,2021,2635,1300,1335,97.4,2624,1293,1331,97.1
38370, 산청군,075001, 70세,2021,495,253,242,104.5,493,251,242,103.7
38370, 산청군,075002, 71세,2021,521,251,270,93,520,250,270,92.6
38370, 산청군,075003, 72세,2021,533,273,260,105,526,269,257,104.7
38370, 산청군,075004, 73세,2021,552,283,269,105.2,552,283,269,105.2
38370, 산청군,075005, 74세,2021,534,240,294,81.6,533,240,293,81.9
38370, 산청군,080,75~79세,2021,2366,906,1460,62.1,2362,904,1458,62
38370, 산청군,080001, 75세,2021,411,174,237,73.4,410,173,237,73
38370, 산청군,080002, 76세,2021,404,162,242,66.9,403,162,241,67.2
38370, 산청군,080003, 77세,2021,482,184,298,61.7,482,184,298,61.7
38370, 산청군,080004, 78세,2021,469,162,307,52.8,468,161,307,52.4
38370, 산청군,080005, 79세,2021,600,224,376,59.6,599,224,375,59.7
38370, 산청군,085,80~84세,2021,2326,764,1562,48.9,2325,763,1562,48.8
38370, 산청군,085001, 80세,2021,538,199,339,58.7,538,199,339,58.7
38370, 산청군,085002, 81세,2021,495,159,336,47.3,495,159,336,47.3
38370, 산청군,085003, 82세,2021,464,157,307,51.1,463,156,307,50.8
38370, 산청군,085004, 83세,2021,458,146,312,46.8,458,146,312,46.8
38370, 산청군,085005, 84세,2021,371,103,268,38.4,371,103,268,38.4
38370, 산청군,090,85~89세,2021,1355,348,1007,34.6,1355,348,1007,34.6
38370, 산청군,090001, 85세,2021,358,96,262,36.6,358,96,262,36.6
38370, 산청군,090002, 86세,2021,329,88,241,36.5,329,88,241,36.5
38370, 산청군,090003, 87세,2021,269,66,203,32.5,269,66,203,32.5
38370, 산청군,090004, 88세,2021,226,56,170,32.9,226,56,170,32.9
38370, 산청군,090005, 89세,2021,173,42,131,32.1,173,42,131,32.1
38370, 산청군,095,90~94세,2021,461,92,369,24.9,461,92,369,24.9
38370, 산청군,095001, 90세,2021,140,28,112,25,140,28,112,25
38370, 산청군,095002, 91세,2021,112,22,90,24.4,112,22,90,24.4
38370, 산청군,095003, 92세,2021,88,22,66,33.3,88,22,66,33.3
38370, 산청군,095004, 93세,2021,64,11,53,20.8,64,11,53,20.8
38370, 산청군,095005, 94세,2021,57,9,48,18.8,57,9,48,18.8
38370, 산청군,100,95~99세,2021,96,18,78,23.1,96,18,78,23.1
38370, 산청군,100001, 95세,2021,33,5,28,17.9,33,5,28,17.9
38370, 산청군,100002, 96세,2021,29,X,27,7.4,29,X,27,7.4
38370, 산청군,100003, 97세,2021,11,X,7,57.1,11,X,7,57.1
38370, 산청군,100004, 98세,2021,12,X,9,33.3,12,X,9,33.3
38370, 산청군,100005, 99세,2021,11,X,7,57.1,11,X,7,57.1
38370, 산청군,101,100세이상,2021,12,X,10,20,12,X,10,20
38370, 산청군,102,15세미만,2021,2117,1124,993,113.2,2112,1120,992,112.9
38370, 산청군,103,15~64세,2021,18224,9734,8490,114.7,17505,9430,8075,116.8
38370, 산청군,104,65세이상,2021,12673,5177,7496,69.1,12641,5163,7478,69
38370, 산청군,086,85세이상,2021,1924,460,1464,31.4,1924,460,1464,31.4
38370, 산청군,126,평균연령,2021,55.9,53.2,58.5,,56.3,53.5,59,
38370, 산청군,127,중위연령,2021,60.1,57.5,62.2,,60.5,58,62.7,
38380, 함양군,000,합계,2021,36541,17704,18837,94,36006,17442,18564,94
38380, 함양군,005,0~4세,2021,638,316,322,98.1,638,316,322,98.1
38380, 함양군,005001, 0세,2021,96,50,46,108.7,96,50,46,108.7
38380, 함양군,005002, 1세,2021,105,58,47,123.4,105,58,47,123.4
38380, 함양군,005003, 2세,2021,132,61,71,85.9,132,61,71,85.9
38380, 함양군,005004, 3세,2021,149,68,81,84,149,68,81,84
38380, 함양군,005005, 4세,2021,156,79,77,102.6,156,79,77,102.6
38380, 함양군,010,5~9세,2021,1025,529,496,106.7,1025,529,496,106.7
38380, 함양군,010001, 5세,2021,169,88,81,108.6,169,88,81,108.6
38380, 함양군,010002, 6세,2021,194,91,103,88.3,194,91,103,88.3
38380, 함양군,010003, 7세,2021,198,99,99,100,198,99,99,100
38380, 함양군,010004, 8세,2021,235,123,112,109.8,235,123,112,109.8
38380, 함양군,010005, 9세,2021,229,128,101,126.7,229,128,101,126.7
38380, 함양군,015,10~14세,2021,1300,672,628,107,1296,671,625,107.4
38380, 함양군,015001, 10세,2021,214,106,108,98.1,212,105,107,98.1
38380, 함양군,015002, 11세,2021,266,145,121,119.8,265,145,120,120.8
38380, 함양군,015003, 12세,2021,242,118,124,95.2,242,118,124,95.2
38380, 함양군,015004, 13세,2021,290,150,140,107.1,289,150,139,107.9
38380, 함양군,015005, 14세,2021,288,153,135,113.3,288,153,135,113.3
38380, 함양군,020,15~19세,2021,1259,681,578,117.8,1256,680,576,118.1
38380, 함양군,020001, 15세,2021,278,149,129,115.5,278,149,129,115.5
38380, 함양군,020002, 16세,2021,287,150,137,109.5,286,150,136,110.3
38380, 함양군,020003, 17세,2021,287,158,129,122.5,287,158,129,122.5
38380, 함양군,020004, 18세,2021,259,137,122,112.3,258,136,122,111.5
38380, 함양군,020005, 19세,2021,148,87,61,142.6,147,87,60,145
38380, 함양군,025,20~24세,2021,1109,701,408,171.8,1072,677,395,171.4
38380, 함양군,025001, 20세,2021,223,160,63,254,223,160,63,254
38380, 함양군,025002, 21세,2021,266,171,95,180,261,170,91,186.8
38380, 함양군,025003, 22세,2021,176,114,62,183.9,170,108,62,174.2
38380, 함양군,025004, 23세,2021,218,127,91,139.6,208,120,88,136.4
38380, 함양군,025005, 24세,2021,226,129,97,133,210,119,91,130.8
38380, 함양군,030,25~29세,2021,1290,731,559,130.8,1203,679,524,129.6
38380, 함양군,030001, 25세,2021,275,151,124,121.8,257,142,115,123.5
38380, 함양군,030002, 26세,2021,276,165,111,148.6,257,150,107,140.2
38380, 함양군,030003, 27세,2021,250,142,108,131.5,241,136,105,129.5
38380, 함양군,030004, 28세,2021,264,149,115,129.6,239,136,103,132
38380, 함양군,030005, 29세,2021,225,124,101,122.8,209,115,94,122.3
38380, 함양군,035,30~34세,2021,1091,593,498,119.1,993,543,450,120.7
38380, 함양군,035001, 30세,2021,227,131,96,136.5,200,115,85,135.3
38380, 함양군,035002, 31세,2021,215,122,93,131.2,197,117,80,146.3
38380, 함양군,035003, 32세,2021,204,111,93,119.4,187,100,87,114.9
38380, 함양군,035004, 33세,2021,221,110,111,99.1,204,101,103,98.1
38380, 함양군,035005, 34세,2021,224,119,105,113.3,205,110,95,115.8
38380, 함양군,040,35~39세,2021,1394,701,693,101.2,1304,649,655,99.1
38380, 함양군,040001, 35세,2021,214,124,90,137.8,196,114,82,139
38380, 함양군,040002, 36세,2021,279,139,140,99.3,262,128,134,95.5
38380, 함양군,040003, 37세,2021,264,127,137,92.7,240,116,124,93.5
38380, 함양군,040004, 38세,2021,295,147,148,99.3,284,140,144,97.2
38380, 함양군,040005, 39세,2021,342,164,178,92.1,322,151,171,88.3
38380, 함양군,045,40~44세,2021,1703,883,820,107.7,1653,863,790,109.2
38380, 함양군,045001, 40세,2021,338,186,152,122.4,332,182,150,121.3
38380, 함양군,045002, 41세,2021,337,172,165,104.2,326,168,158,106.3
38380, 함양군,045003, 42세,2021,335,174,161,108.1,325,170,155,109.7
38380, 함양군,045004, 43세,2021,342,176,166,106,333,173,160,108.1
38380, 함양군,045005, 44세,2021,351,175,176,99.4,337,170,167,101.8
38380, 함양군,050,45~49세,2021,2293,1281,1012,126.6,2248,1265,983,128.7
38380, 함양군,050001, 45세,2021,360,187,173,108.1,344,182,162,112.3
38380, 함양군,050002, 46세,2021,447,248,199,124.6,442,247,195,126.7
38380, 함양군,050003, 47세,2021,485,284,201,141.3,479,281,198,141.9
38380, 함양군,050004, 48세,2021,498,279,219,127.4,488,275,213,129.1
38380, 함양군,050005, 49세,2021,503,283,220,128.6,495,280,215,130.2
38380, 함양군,055,50~54세,2021,3190,1702,1488,114.4,3156,1693,1463,115.7
38380, 함양군,055001, 50세,2021,591,330,261,126.4,586,328,258,127.1
38380, 함양군,055002, 51세,2021,621,329,292,112.7,613,325,288,112.8
38380, 함양군,055003, 52세,2021,673,341,332,102.7,666,341,325,104.9
38380, 함양군,055004, 53세,2021,675,372,303,122.8,670,370,300,123.3
38380, 함양군,055005, 54세,2021,630,330,300,110,621,329,292,112.7
38380, 함양군,060,55~59세,2021,3327,1786,1541,115.9,3294,1775,1519,116.9
38380, 함양군,060001, 55세,2021,614,331,283,117,610,328,282,116.3
38380, 함양군,060002, 56세,2021,689,375,314,119.4,682,374,308,121.4
38380, 함양군,060003, 57세,2021,643,351,292,120.2,635,350,285,122.8
38380, 함양군,060004, 58세,2021,656,349,307,113.7,647,344,303,113.5
38380, 함양군,060005, 59세,2021,725,380,345,110.1,720,379,341,111.1
38380, 함양군,065,60~64세,2021,4026,2019,2007,100.6,3996,2005,1991,100.7
38380, 함양군,065001, 60세,2021,879,440,439,100.2,873,438,435,100.7
38380, 함양군,065002, 61세,2021,883,452,431,104.9,875,447,428,104.4
38380, 함양군,065003, 62세,2021,782,400,382,104.7,779,400,379,105.5
38380, 함양군,065004, 63세,2021,684,327,357,91.6,680,324,356,91
38380, 함양군,065005, 64세,2021,798,400,398,100.5,789,396,393,100.8
38380, 함양군,070,65~69세,2021,3404,1678,1726,97.2,3389,1670,1719,97.1
38380, 함양군,070001, 65세,2021,792,377,415,90.8,788,375,413,90.8
38380, 함양군,070002, 66세,2021,800,404,396,102,794,400,394,101.5
38380, 함양군,070003, 67세,2021,609,308,301,102.3,607,308,299,103
38380, 함양군,070004, 68세,2021,541,267,274,97.4,539,266,273,97.4
38380, 함양군,070005, 69세,2021,662,322,340,94.7,661,321,340,94.4
38380, 함양군,075,70~74세,2021,2789,1257,1532,82,2787,1257,1530,82.2
38380, 함양군,075001, 70세,2021,505,233,272,85.7,503,233,270,86.3
38380, 함양군,075002, 71세,2021,553,253,300,84.3,553,253,300,84.3
38380, 함양군,075003, 72세,2021,586,283,303,93.4,586,283,303,93.4
38380, 함양군,075004, 73세,2021,571,261,310,84.2,571,261,310,84.2
38380, 함양군,075005, 74세,2021,574,227,347,65.4,574,227,347,65.4
38380, 함양군,080,75~79세,2021,2457,929,1528,60.8,2454,926,1528,60.6
38380, 함양군,080001, 75세,2021,397,175,222,78.8,396,174,222,78.4
38380, 함양군,080002, 76세,2021,442,174,268,64.9,441,173,268,64.6
38380, 함양군,080003, 77세,2021,502,197,305,64.6,502,197,305,64.6
38380, 함양군,080004, 78세,2021,500,152,348,43.7,499,151,348,43.4
38380, 함양군,080005, 79세,2021,616,231,385,60,616,231,385,60
38380, 함양군,085,80~84세,2021,2444,844,1600,52.8,2440,843,1597,52.8
38380, 함양군,085001, 80세,2021,523,182,341,53.4,523,182,341,53.4
38380, 함양군,085002, 81세,2021,522,183,339,54,521,183,338,54.1
38380, 함양군,085003, 82세,2021,524,176,348,50.6,523,176,347,50.7
38380, 함양군,085004, 83세,2021,445,150,295,50.8,444,149,295,50.5
38380, 함양군,085005, 84세,2021,430,153,277,55.2,429,153,276,55.4
38380, 함양군,090,85~89세,2021,1252,290,962,30.1,1252,290,962,30.1
38380, 함양군,090001, 85세,2021,345,94,251,37.5,345,94,251,37.5
38380, 함양군,090002, 86세,2021,286,65,221,29.4,286,65,221,29.4
38380, 함양군,090003, 87세,2021,257,57,200,28.5,257,57,200,28.5
38380, 함양군,090004, 88세,2021,204,40,164,24.4,204,40,164,24.4
38380, 함양군,090005, 89세,2021,160,34,126,27,160,34,126,27
38380, 함양군,095,90~94세,2021,446,88,358,24.6,446,88,358,24.6
38380, 함양군,095001, 90세,2021,140,28,112,25,140,28,112,25
38380, 함양군,095002, 91세,2021,119,23,96,24,119,23,96,24
38380, 함양군,095003, 92세,2021,63,14,49,28.6,63,14,49,28.6
38380, 함양군,095004, 93세,2021,66,14,52,26.9,66,14,52,26.9
38380, 함양군,095005, 94세,2021,58,9,49,18.4,58,9,49,18.4
38380, 함양군,100,95~99세,2021,95,22,73,30.1,95,22,73,30.1
38380, 함양군,100001, 95세,2021,35,11,24,45.8,35,11,24,45.8
38380, 함양군,100002, 96세,2021,26,5,21,23.8,26,5,21,23.8
38380, 함양군,100003, 97세,2021,17,X,15,13.3,17,X,15,13.3
38380, 함양군,100004, 98세,2021,8,X,X,100,8,X,X,100
38380, 함양군,100005, 99세,2021,9,X,9,0,9,X,9,0
38380, 함양군,101,100세이상,2021,9,X,8,12.5,9,X,8,12.5
38380, 함양군,102,15세미만,2021,2963,1517,1446,104.9,2959,1516,1443,105.1
38380, 함양군,103,15~64세,2021,20682,11078,9604,115.3,20175,10829,9346,115.9
38380, 함양군,104,65세이상,2021,12896,5109,7787,65.6,12872,5097,7775,65.6
38380, 함양군,086,85세이상,2021,1802,401,1401,28.6,1802,401,1401,28.6
38380, 함양군,126,평균연령,2021,54,51.1,56.7,,54.2,51.3,56.9,
38380, 함양군,127,중위연령,2021,58,55.2,60.9,,58.4,55.5,61.1,
38390, 거창군,000,합계,2021,59238,29331,29907,98.1,58517,28990,29527,98.2
38390, 거창군,005,0~4세,2021,1338,710,628,113.1,1338,710,628,113.1
38390, 거창군,005001, 0세,2021,204,110,94,117,204,110,94,117
38390, 거창군,005002, 1세,2021,252,140,112,125,252,140,112,125
38390, 거창군,005003, 2세,2021,269,128,141,90.8,269,128,141,90.8
38390, 거창군,005004, 3세,2021,298,161,137,117.5,298,161,137,117.5
38390, 거창군,005005, 4세,2021,315,171,144,118.8,315,171,144,118.8
38390, 거창군,010,5~9세,2021,2144,1110,1034,107.4,2142,1108,1034,107.2
38390, 거창군,010001, 5세,2021,366,197,169,116.6,365,196,169,116
38390, 거창군,010002, 6세,2021,391,188,203,92.6,391,188,203,92.6
38390, 거창군,010003, 7세,2021,461,234,227,103.1,461,234,227,103.1
38390, 거창군,010004, 8세,2021,427,220,207,106.3,426,219,207,105.8
38390, 거창군,010005, 9세,2021,499,271,228,118.9,499,271,228,118.9
38390, 거창군,015,10~14세,2021,2581,1328,1253,106,2576,1327,1249,106.2
38390, 거창군,015001, 10세,2021,523,264,259,101.9,523,264,259,101.9
38390, 거창군,015002, 11세,2021,486,259,227,114.1,484,258,226,114.2
38390, 거창군,015003, 12세,2021,503,260,243,107,503,260,243,107
38390, 거창군,015004, 13세,2021,540,274,266,103,540,274,266,103
38390, 거창군,015005, 14세,2021,529,271,258,105,526,271,255,106.3
38390, 거창군,020,15~19세,2021,3090,1807,1283,140.8,3086,1805,1281,140.9
38390, 거창군,020001, 15세,2021,464,241,223,108.1,464,241,223,108.1
38390, 거창군,020002, 16세,2021,672,385,287,134.1,672,385,287,134.1
38390, 거창군,020003, 17세,2021,746,417,329,126.7,744,417,327,127.5
38390, 거창군,020004, 18세,2021,650,397,253,156.9,649,396,253,156.5
38390, 거창군,020005, 19세,2021,558,367,191,192.1,557,366,191,191.6
38390, 거창군,025,20~24세,2021,2961,2038,923,220.8,2899,2001,898,222.8
38390, 거창군,025001, 20세,2021,543,379,164,231.1,533,376,157,239.5
38390, 거창군,025002, 21세,2021,627,433,194,223.2,620,428,192,222.9
38390, 거창군,025003, 22세,2021,609,439,170,258.2,594,430,164,262.2
38390, 거창군,025004, 23세,2021,587,409,178,229.8,572,398,174,228.7
38390, 거창군,025005, 24세,2021,595,378,217,174.2,580,369,211,174.9
38390, 거창군,030,25~29세,2021,2499,1475,1024,144,2372,1410,962,146.6
38390, 거창군,030001, 25세,2021,516,325,191,170.2,493,314,179,175.4
38390, 거창군,030002, 26세,2021,560,327,233,140.3,537,313,224,139.7
38390, 거창군,030003, 27세,2021,506,301,205,146.8,469,281,188,149.5
38390, 거창군,030004, 28세,2021,480,278,202,137.6,449,264,185,142.7
38390, 거창군,030005, 29세,2021,437,244,193,126.4,424,238,186,128
38390, 거창군,035,30~34세,2021,2130,1165,965,120.7,1995,1092,903,120.9
38390, 거창군,035001, 30세,2021,403,233,170,137.1,377,216,161,134.2
38390, 거창군,035002, 31세,2021,456,250,206,121.4,420,229,191,119.9
38390, 거창군,035003, 32세,2021,388,225,163,138,364,213,151,141.1
38390, 거창군,035004, 33세,2021,404,224,180,124.4,381,211,170,124.1
38390, 거창군,035005, 34세,2021,479,233,246,94.7,453,223,230,97
38390, 거창군,040,35~39세,2021,2657,1326,1331,99.6,2538,1262,1276,98.9
38390, 거창군,040001, 35세,2021,498,263,235,111.9,464,244,220,110.9
38390, 거창군,040002, 36세,2021,454,230,224,102.7,434,219,215,101.9
38390, 거창군,040003, 37세,2021,489,244,245,99.6,467,230,237,97
38390, 거창군,040004, 38세,2021,589,294,295,99.7,565,284,281,101.1
38390, 거창군,040005, 39세,2021,627,295,332,88.9,608,285,323,88.2
38390, 거창군,045,40~44세,2021,3228,1623,1605,101.1,3153,1589,1564,101.6
38390, 거창군,045001, 40세,2021,648,331,317,104.4,635,324,311,104.2
38390, 거창군,045002, 41세,2021,687,326,361,90.3,668,318,350,90.9
38390, 거창군,045003, 42세,2021,673,354,319,111,658,349,309,112.9
38390, 거창군,045004, 43세,2021,568,285,283,100.7,560,281,279,100.7
38390, 거창군,045005, 44세,2021,652,327,325,100.6,632,317,315,100.6
38390, 거창군,050,45~49세,2021,3940,1986,1954,101.6,3886,1970,1916,102.8
38390, 거창군,050001, 45세,2021,691,328,363,90.4,679,326,353,92.4
38390, 거창군,050002, 46세,2021,730,375,355,105.6,722,373,349,106.9
38390, 거창군,050003, 47세,2021,809,419,390,107.4,801,418,383,109.1
38390, 거창군,050004, 48세,2021,879,427,452,94.5,866,421,445,94.6
38390, 거창군,050005, 49세,2021,831,437,394,110.9,818,432,386,111.9
38390, 거창군,055,50~54세,2021,5013,2572,2441,105.4,4972,2564,2408,106.5
38390, 거창군,055001, 50세,2021,957,499,458,109,952,499,453,110.2
38390, 거창군,055002, 51세,2021,983,511,472,108.3,976,511,465,109.9
38390, 거창군,055003, 52세,2021,1011,527,484,108.9,1000,523,477,109.6
38390, 거창군,055004, 53세,2021,1085,525,560,93.8,1075,523,552,94.7
38390, 거창군,055005, 54세,2021,977,510,467,109.2,969,508,461,110.2
38390, 거창군,060,55~59세,2021,4956,2580,2376,108.6,4913,2563,2350,109.1
38390, 거창군,060001, 55세,2021,969,527,442,119.2,963,526,437,120.4
38390, 거창군,060002, 56세,2021,1016,503,513,98.1,1007,498,509,97.8
38390, 거창군,060003, 57세,2021,870,451,419,107.6,861,448,413,108.5
38390, 거창군,060004, 58세,2021,966,517,449,115.1,955,513,442,116.1
38390, 거창군,060005, 59세,2021,1135,582,553,105.2,1127,578,549,105.3
38390, 거창군,065,60~64세,2021,5780,2864,2916,98.2,5748,2850,2898,98.3
38390, 거창군,065001, 60세,2021,1291,642,649,98.9,1286,641,645,99.4
38390, 거창군,065002, 61세,2021,1241,628,613,102.4,1237,626,611,102.5
38390, 거창군,065003, 62세,2021,1189,577,612,94.3,1182,572,610,93.8
38390, 거창군,065004, 63세,2021,982,483,499,96.8,975,481,494,97.4
38390, 거창군,065005, 64세,2021,1077,534,543,98.3,1068,530,538,98.5
38390, 거창군,070,65~69세,2021,4631,2245,2386,94.1,4616,2241,2375,94.4
38390, 거창군,070001, 65세,2021,1021,508,513,99,1016,506,510,99.2
38390, 거창군,070002, 66세,2021,1015,523,492,106.3,1012,522,490,106.5
38390, 거창군,070003, 67세,2021,870,406,464,87.5,868,406,462,87.9
38390, 거창군,070004, 68세,2021,810,388,422,91.9,807,387,420,92.1
38390, 거창군,070005, 69세,2021,915,420,495,84.8,913,420,493,85.2
38390, 거창군,075,70~74세,2021,3603,1622,1981,81.9,3600,1620,1980,81.8
38390, 거창군,075001, 70세,2021,657,301,356,84.6,656,300,356,84.3
38390, 거창군,075002, 71세,2021,672,299,373,80.2,670,298,372,80.1
38390, 거창군,075003, 72세,2021,785,360,425,84.7,785,360,425,84.7
38390, 거창군,075004, 73세,2021,809,344,465,74,809,344,465,74
38390, 거창군,075005, 74세,2021,680,318,362,87.8,680,318,362,87.8
38390, 거창군,080,75~79세,2021,3122,1180,1942,60.8,3120,1179,1941,60.7
38390, 거창군,080001, 75세,2021,561,242,319,75.9,560,241,319,75.5
38390, 거창군,080002, 76세,2021,521,204,317,64.4,521,204,317,64.4
38390, 거창군,080003, 77세,2021,650,233,417,55.9,649,233,416,56
38390, 거창군,080004, 78세,2021,632,238,394,60.4,632,238,394,60.4
38390, 거창군,080005, 79세,2021,758,263,495,53.1,758,263,495,53.1
38390, 거창군,085,80~84세,2021,3066,1024,2042,50.1,3065,1024,2041,50.2
38390, 거창군,085001, 80세,2021,680,252,428,58.9,680,252,428,58.9
38390, 거창군,085002, 81세,2021,641,216,425,50.8,641,216,425,50.8
38390, 거창군,085003, 82세,2021,670,229,441,51.9,670,229,441,51.9
38390, 거창군,085004, 83세,2021,562,185,377,49.1,561,185,376,49.2
38390, 거창군,085005, 84세,2021,513,142,371,38.3,513,142,371,38.3
38390, 거창군,090,85~89세,2021,1740,499,1241,40.2,1740,499,1241,40.2
38390, 거창군,090001, 85세,2021,490,156,334,46.7,490,156,334,46.7
38390, 거창군,090002, 86세,2021,402,106,296,35.8,402,106,296,35.8
38390, 거창군,090003, 87세,2021,330,100,230,43.5,330,100,230,43.5
38390, 거창군,090004, 88세,2021,304,91,213,42.7,304,91,213,42.7
38390, 거창군,090005, 89세,2021,214,46,168,27.4,214,46,168,27.4
38390, 거창군,095,90~94세,2021,617,144,473,30.4,617,144,473,30.4
38390, 거창군,095001, 90세,2021,188,51,137,37.2,188,51,137,37.2
38390, 거창군,095002, 91세,2021,145,27,118,22.9,145,27,118,22.9
38390, 거창군,095003, 92세,2021,135,31,104,29.8,135,31,104,29.8
38390, 거창군,095004, 93세,2021,87,18,69,26.1,87,18,69,26.1
38390, 거창군,095005, 94세,2021,62,17,45,37.8,62,17,45,37.8
38390, 거창군,100,95~99세,2021,121,28,93,30.1,121,28,93,30.1
38390, 거창군,100001, 95세,2021,41,10,31,32.3,41,10,31,32.3
38390, 거창군,100002, 96세,2021,35,X,31,12.9,35,X,31,12.9
38390, 거창군,100003, 97세,2021,21,7,14,50,21,7,14,50
38390, 거창군,100004, 98세,2021,16,6,10,60,16,6,10,60
38390, 거창군,100005, 99세,2021,8,X,7,14.3,8,X,7,14.3
38390, 거창군,101,100세이상,2021,21,5,16,31.3,20,X,16,25
38390, 거창군,102,15세미만,2021,6063,3148,2915,108,6056,3145,2911,108
38390, 거창군,103,15~64세,2021,36254,19436,16818,115.6,35562,19106,16456,116.1
38390, 거창군,104,65세이상,2021,16921,6747,10174,66.3,16899,6739,10160,66.3
38390, 거창군,086,85세이상,2021,2499,676,1823,37.1,2498,675,1823,37
38390, 거창군,126,평균연령,2021,49.6,46.5,52.6,,49.7,46.6,52.7,
38390, 거창군,127,중위연령,2021,53.1,50.2,56.1,,53.3,50.4,56.4,
38400, 합천군,000,합계,2021,40642,19661,20981,93.7,39874,19244,20630,93.3
38400, 합천군,005,0~4세,2021,562,284,278,102.2,560,284,276,102.9
38400, 합천군,005001, 0세,2021,95,59,36,163.9,93,59,34,173.5
38400, 합천군,005002, 1세,2021,101,47,54,87,101,47,54,87
38400, 합천군,005003, 2세,2021,134,62,72,86.1,134,62,72,86.1
38400, 합천군,005004, 3세,2021,119,56,63,88.9,119,56,63,88.9
38400, 합천군,005005, 4세,2021,113,60,53,113.2,113,60,53,113.2
38400, 합천군,010,5~9세,2021,847,443,404,109.7,845,443,402,110.2
38400, 합천군,010001, 5세,2021,151,94,57,164.9,150,94,56,167.9
38400, 합천군,010002, 6세,2021,141,65,76,85.5,141,65,76,85.5
38400, 합천군,010003, 7세,2021,169,77,92,83.7,169,77,92,83.7
38400, 합천군,010004, 8세,2021,195,102,93,109.7,194,102,92,110.9
38400, 합천군,010005, 9세,2021,191,105,86,122.1,191,105,86,122.1
38400, 합천군,015,10~14세,2021,1079,575,504,114.1,1079,575,504,114.1
38400, 합천군,015001, 10세,2021,218,119,99,120.2,218,119,99,120.2
38400, 합천군,015002, 11세,2021,171,93,78,119.2,171,93,78,119.2
38400, 합천군,015003, 12세,2021,212,103,109,94.5,212,103,109,94.5
38400, 합천군,015004, 13세,2021,225,122,103,118.4,225,122,103,118.4
38400, 합천군,015005, 14세,2021,253,138,115,120,253,138,115,120
38400, 합천군,020,15~19세,2021,989,550,439,125.3,988,549,439,125.1
38400, 합천군,020001, 15세,2021,205,111,94,118.1,205,111,94,118.1
38400, 합천군,020002, 16세,2021,196,106,90,117.8,196,106,90,117.8
38400, 합천군,020003, 17세,2021,224,113,111,101.8,224,113,111,101.8
38400, 합천군,020004, 18세,2021,228,126,102,123.5,228,126,102,123.5
38400, 합천군,020005, 19세,2021,136,94,42,223.8,135,93,42,221.4
38400, 합천군,025,20~24세,2021,1164,717,447,160.4,1101,679,422,160.9
38400, 합천군,025001, 20세,2021,183,124,59,210.2,182,124,58,213.8
38400, 합천군,025002, 21세,2021,252,160,92,173.9,247,158,89,177.5
38400, 합천군,025003, 22세,2021,235,147,88,167,227,144,83,173.5
38400, 합천군,025004, 23세,2021,240,133,107,124.3,220,121,99,122.2
38400, 합천군,025005, 24세,2021,254,153,101,151.5,225,132,93,141.9
38400, 합천군,030,25~29세,2021,1394,851,543,156.7,1210,730,480,152.1
38400, 합천군,030001, 25세,2021,265,159,106,150,234,140,94,148.9
38400, 합천군,030002, 26세,2021,310,187,123,152,267,155,112,138.4
38400, 합천군,030003, 27세,2021,272,178,94,189.4,236,154,82,187.8
38400, 합천군,030004, 28세,2021,289,168,121,138.8,250,144,106,135.8
38400, 합천군,030005, 29세,2021,258,159,99,160.6,223,137,86,159.3
38400, 합천군,035,30~34세,2021,1109,630,479,131.5,947,530,417,127.1
38400, 합천군,035001, 30세,2021,227,131,96,136.5,190,110,80,137.5
38400, 합천군,035002, 31세,2021,215,123,92,133.7,178,101,77,131.2
38400, 합천군,035003, 32세,2021,216,126,90,140,181,103,78,132.1
38400, 합천군,035004, 33세,2021,214,123,91,135.2,188,107,81,132.1
38400, 합천군,035005, 34세,2021,237,127,110,115.5,210,109,101,107.9
38400, 합천군,040,35~39세,2021,1290,719,571,125.9,1181,659,522,126.2
38400, 합천군,040001, 35세,2021,220,131,89,147.2,192,115,77,149.4
38400, 합천군,040002, 36세,2021,238,135,103,131.1,209,120,89,134.8
38400, 합천군,040003, 37세,2021,242,132,110,120,219,118,101,116.8
38400, 합천군,040004, 38세,2021,279,158,121,130.6,264,149,115,129.6
38400, 합천군,040005, 39세,2021,311,163,148,110.1,297,157,140,112.1
38400, 합천군,045,40~44세,2021,1678,922,756,122,1600,886,714,124.1
38400, 합천군,045001, 40세,2021,312,165,147,112.2,292,153,139,110.1
38400, 합천군,045002, 41세,2021,361,206,155,132.9,350,198,152,130.3
38400, 합천군,045003, 42세,2021,341,192,149,128.9,324,186,138,134.8
38400, 합천군,045004, 43세,2021,318,168,150,112,305,163,142,114.8
38400, 합천군,045005, 44세,2021,346,191,155,123.2,329,186,143,130.1
38400, 합천군,050,45~49세,2021,2124,1193,931,128.1,2081,1176,905,129.9
38400, 합천군,050001, 45세,2021,340,179,161,111.2,332,175,157,111.5
38400, 합천군,050002, 46세,2021,368,205,163,125.8,358,199,159,125.2
38400, 합천군,050003, 47세,2021,420,237,183,129.5,409,233,176,132.4
38400, 합천군,050004, 48세,2021,485,269,216,124.5,476,268,208,128.8
38400, 합천군,050005, 49세,2021,511,303,208,145.7,506,301,205,146.8
38400, 합천군,055,50~54세,2021,3126,1719,1407,122.2,3080,1709,1371,124.7
38400, 합천군,055001, 50세,2021,560,317,243,130.5,552,314,238,131.9
38400, 합천군,055002, 51세,2021,592,333,259,128.6,582,330,252,131
38400, 합천군,055003, 52세,2021,621,338,283,119.4,607,334,273,122.3
38400, 합천군,055004, 53세,2021,697,388,309,125.6,688,388,300,129.3
38400, 합천군,055005, 54세,2021,656,343,313,109.6,651,343,308,111.4
38400, 합천군,060,55~59세,2021,3653,1988,1665,119.4,3615,1970,1645,119.8
38400, 합천군,060001, 55세,2021,686,372,314,118.5,676,367,309,118.8
38400, 합천군,060002, 56세,2021,694,382,312,122.4,690,382,308,124
38400, 합천군,060003, 57세,2021,695,391,304,128.6,689,389,300,129.7
38400, 합천군,060004, 58세,2021,727,379,348,108.9,717,376,341,110.3
38400, 합천군,060005, 59세,2021,851,464,387,119.9,843,456,387,117.8
38400, 합천군,065,60~64세,2021,4989,2555,2434,105,4969,2548,2421,105.2
38400, 합천군,065001, 60세,2021,1134,590,544,108.5,1130,590,540,109.3
38400, 합천군,065002, 61세,2021,1032,497,535,92.9,1025,495,530,93.4
38400, 합천군,065003, 62세,2021,1047,531,516,102.9,1044,529,515,102.7
38400, 합천군,065004, 63세,2021,900,482,418,115.3,898,481,417,115.3
38400, 합천군,065005, 64세,2021,876,455,421,108.1,872,453,419,108.1
38400, 합천군,070,65~69세,2021,4096,2036,2060,98.8,4089,2031,2058,98.7
38400, 합천군,070001, 65세,2021,907,475,432,110,905,473,432,109.5
38400, 합천군,070002, 66세,2021,860,409,451,90.7,860,409,451,90.7
38400, 합천군,070003, 67세,2021,786,395,391,101,784,393,391,100.5
38400, 합천군,070004, 68세,2021,728,357,371,96.2,726,356,370,96.2
38400, 합천군,070005, 69세,2021,815,400,415,96.4,814,400,414,96.6
38400, 합천군,075,70~74세,2021,3553,1621,1932,83.9,3544,1617,1927,83.9
38400, 합천군,075001, 70세,2021,698,332,366,90.7,694,331,363,91.2
38400, 합천군,075002, 71세,2021,696,340,356,95.5,695,339,356,95.2
38400, 합천군,075003, 72세,2021,750,350,400,87.5,747,348,399,87.2
38400, 합천군,075004, 73세,2021,708,307,401,76.6,708,307,401,76.6
38400, 합천군,075005, 74세,2021,701,292,409,71.4,700,292,408,71.6
38400, 합천군,080,75~79세,2021,3195,1178,2017,58.4,3192,1178,2014,58.5
38400, 합천군,080001, 75세,2021,509,206,303,68,509,206,303,68
38400, 합천군,080002, 76세,2021,538,217,321,67.6,537,217,320,67.8
38400, 합천군,080003, 77세,2021,649,229,420,54.5,649,229,420,54.5
38400, 합천군,080004, 78세,2021,658,237,421,56.3,656,237,419,56.6
38400, 합천군,080005, 79세,2021,841,289,552,52.4,841,289,552,52.4
38400, 합천군,085,80~84세,2021,3272,1054,2218,47.5,3271,1054,2217,47.5
38400, 합천군,085001, 80세,2021,716,255,461,55.3,715,255,460,55.4
38400, 합천군,085002, 81세,2021,713,234,479,48.9,713,234,479,48.9
38400, 합천군,085003, 82세,2021,708,215,493,43.6,708,215,493,43.6
38400, 합천군,085004, 83세,2021,536,171,365,46.8,536,171,365,46.8
38400, 합천군,085005, 84세,2021,599,179,420,42.6,599,179,420,42.6
38400, 합천군,090,85~89세,2021,1870,498,1372,36.3,1870,498,1372,36.3
38400, 합천군,090001, 85세,2021,482,151,331,45.6,482,151,331,45.6
38400, 합천군,090002, 86세,2021,439,127,312,40.7,439,127,312,40.7
38400, 합천군,090003, 87세,2021,410,97,313,31,410,97,313,31
38400, 합천군,090004, 88세,2021,315,76,239,31.8,315,76,239,31.8
38400, 합천군,090005, 89세,2021,224,47,177,26.6,224,47,177,26.6
38400, 합천군,095,90~94세,2021,524,113,411,27.5,524,113,411,27.5
38400, 합천군,095001, 90세,2021,150,28,122,23,150,28,122,23
38400, 합천군,095002, 91세,2021,138,23,115,20,138,23,115,20
38400, 합천군,095003, 92세,2021,109,34,75,45.3,109,34,75,45.3
38400, 합천군,095004, 93세,2021,67,15,52,28.8,67,15,52,28.8
38400, 합천군,095005, 94세,2021,60,13,47,27.7,60,13,47,27.7
38400, 합천군,100,95~99세,2021,108,14,94,14.9,108,14,94,14.9
38400, 합천군,100001, 95세,2021,38,5,33,15.2,38,5,33,15.2
38400, 합천군,100002, 96세,2021,23,X,20,15,23,X,20,15
38400, 합천군,100003, 97세,2021,17,X,14,21.4,17,X,14,21.4
38400, 합천군,100004, 98세,2021,19,X,18,5.6,19,X,18,5.6
38400, 합천군,100005, 99세,2021,11,X,9,22.2,11,X,9,22.2
38400, 합천군,101,100세이상,2021,20,X,19,5.3,20,X,19,5.3
38400, 합천군,102,15세미만,2021,2488,1302,1186,109.8,2484,1302,1182,110.2
38400, 합천군,103,15~64세,2021,21516,11844,9672,122.5,20772,11436,9336,122.5
38400, 합천군,104,65세이상,2021,16638,6515,10123,64.4,16618,6506,10112,64.3
38400, 합천군,086,85세이상,2021,2522,626,1896,33,2522,626,1896,33
38400, 합천군,126,평균연령,2021,57.1,53.7,60.3,,57.5,54.1,60.7,
38400, 합천군,127,중위연령,2021,61.2,58.2,64.1,,61.5,58.7,64.5,
39,제주특별자치도,000,합계,2021,673107,338809,334298,101.3,647897,324521,323376,100.4
39,제주특별자치도,005,0~4세,2021,23856,12277,11579,106,23298,11996,11302,106.1
39,제주특별자치도,005001, 0세,2021,3898,2024,1874,108,3830,1992,1838,108.4
39,제주특별자치도,005002, 1세,2021,4206,2180,2026,107.6,4127,2137,1990,107.4
39,제주특별자치도,005003, 2세,2021,4742,2416,2326,103.9,4642,2360,2282,103.4
39,제주특별자치도,005004, 3세,2021,5239,2696,2543,106,5101,2633,2468,106.7
39,제주특별자치도,005005, 4세,2021,5771,2961,2810,105.4,5598,2874,2724,105.5
39,제주특별자치도,010,5~9세,2021,35130,18062,17068,105.8,34533,17744,16789,105.7
39,제주특별자치도,010001, 5세,2021,6453,3337,3116,107.1,6300,3257,3043,107
39,제주특별자치도,010002, 6세,2021,6804,3520,3284,107.2,6651,3450,3201,107.8
39,제주특별자치도,010003, 7세,2021,7035,3592,3443,104.3,6919,3522,3397,103.7
39,제주특별자치도,010004, 8세,2021,7125,3664,3461,105.9,7022,3597,3425,105
39,제주특별자치도,010005, 9세,2021,7713,3949,3764,104.9,7641,3918,3723,105.2
39,제주특별자치도,015,10~14세,2021,35844,18536,17308,107.1,35507,18375,17132,107.3
39,제주특별자치도,015001, 10세,2021,7480,3880,3600,107.8,7411,3843,3568,107.7
39,제주특별자치도,015002, 11세,2021,7154,3738,3416,109.4,7089,3703,3386,109.4
39,제주특별자치도,015003, 12세,2021,6847,3548,3299,107.5,6771,3517,3254,108.1
39,제주특별자치도,015004, 13세,2021,7038,3626,3412,106.3,6968,3597,3371,106.7
39,제주특별자치도,015005, 14세,2021,7325,3744,3581,104.6,7268,3715,3553,104.6
39,제주특별자치도,020,15~19세,2021,31909,16866,15043,112.1,31585,16695,14890,112.1
39,제주특별자치도,020001, 15세,2021,6603,3446,3157,109.2,6538,3411,3127,109.1
39,제주특별자치도,020002, 16세,2021,6370,3399,2971,114.4,6303,3371,2932,115
39,제주특별자치도,020003, 17세,2021,6786,3571,3215,111.1,6741,3546,3195,111
39,제주특별자치도,020004, 18세,2021,6689,3473,3216,108,6631,3439,3192,107.7
39,제주특별자치도,020005, 19세,2021,5461,2977,2484,119.8,5372,2928,2444,119.8
39,제주특별자치도,025,20~24세,2021,37303,20293,17010,119.3,34893,18884,16009,118
39,제주특별자치도,025001, 20세,2021,6635,3764,2871,131.1,6475,3692,2783,132.7
39,제주특별자치도,025002, 21세,2021,7829,4382,3447,127.1,7416,4165,3251,128.1
39,제주특별자치도,025003, 22세,2021,7245,3932,3313,118.7,6767,3671,3096,118.6
39,제주특별자치도,025004, 23세,2021,7556,3952,3604,109.7,6904,3556,3348,106.2
39,제주특별자치도,025005, 24세,2021,8038,4263,3775,112.9,7331,3800,3531,107.6
39,제주특별자치도,030,25~29세,2021,43738,23598,20140,117.2,39493,20728,18765,110.5
39,제주특별자치도,030001, 25세,2021,8418,4523,3895,116.1,7593,3956,3637,108.8
39,제주특별자치도,030002, 26세,2021,8670,4671,3999,116.8,7836,4122,3714,111
39,제주특별자치도,030003, 27세,2021,8867,4831,4036,119.7,8010,4241,3769,112.5
39,제주특별자치도,030004, 28세,2021,8966,4798,4168,115.1,8088,4195,3893,107.8
39,제주특별자치도,030005, 29세,2021,8817,4775,4042,118.1,7966,4214,3752,112.3
39,제주특별자치도,035,30~34세,2021,39245,20353,18892,107.7,34757,17669,17088,103.4
39,제주특별자치도,035001, 30세,2021,8181,4300,3881,110.8,7330,3765,3565,105.6
39,제주특별자치도,035002, 31세,2021,8042,4231,3811,111,7118,3662,3456,106
39,제주특별자치도,035003, 32세,2021,7568,3899,3669,106.3,6687,3377,3310,102
39,제주특별자치도,035004, 33세,2021,7516,3875,3641,106.4,6607,3349,3258,102.8
39,제주특별자치도,035005, 34세,2021,7938,4048,3890,104.1,7015,3516,3499,100.5
39,제주특별자치도,040,35~39세,2021,47315,23959,23356,102.6,43494,21759,21735,100.1
39,제주특별자치도,040001, 35세,2021,8026,4116,3910,105.3,7206,3655,3551,102.9
39,제주특별자치도,040002, 36세,2021,8560,4390,4170,105.3,7803,3933,3870,101.6
39,제주특별자치도,040003, 37세,2021,9072,4553,4519,100.8,8316,4102,4214,97.3
39,제주특별자치도,040004, 38세,2021,10200,5124,5076,100.9,9505,4736,4769,99.3
39,제주특별자치도,040005, 39세,2021,11457,5776,5681,101.7,10664,5333,5331,100
39,제주특별자치도,045,40~44세,2021,54451,27548,26903,102.4,51568,26060,25508,102.2
39,제주특별자치도,045001, 40세,2021,11465,5823,5642,103.2,10776,5444,5332,102.1
39,제주특별자치도,045002, 41세,2021,11504,5793,5711,101.4,10878,5463,5415,100.9
39,제주특별자치도,045003, 42세,2021,11344,5693,5651,100.7,10739,5387,5352,100.7
39,제주특별자치도,045004, 43세,2021,9783,4922,4861,101.3,9259,4667,4592,101.6
39,제주특별자치도,045005, 44세,2021,10355,5317,5038,105.5,9916,5099,4817,105.9
39,제주특별자치도,050,45~49세,2021,56970,29465,27505,107.1,55104,28545,26559,107.5
39,제주특별자치도,050001, 45세,2021,10217,5368,4849,110.7,9781,5153,4628,111.3
39,제주특별자치도,050002, 46세,2021,10637,5526,5111,108.1,10253,5349,4904,109.1
39,제주특별자치도,050003, 47세,2021,11963,6242,5721,109.1,11586,6061,5525,109.7
39,제주특별자치도,050004, 48세,2021,11910,6062,5848,103.7,11557,5881,5676,103.6
39,제주특별자치도,050005, 49세,2021,12243,6267,5976,104.9,11927,6101,5826,104.7
39,제주특별자치도,055,50~54세,2021,59330,30681,28649,107.1,58024,29984,28040,106.9
39,제주특별자치도,055001, 50세,2021,12950,6712,6238,107.6,12638,6528,6110,106.8
39,제주특별자치도,055002, 51세,2021,12099,6234,5865,106.3,11801,6076,5725,106.1
39,제주특별자치도,055003, 52세,2021,11806,6122,5684,107.7,11559,5985,5574,107.4
39,제주특별자치도,055004, 53세,2021,11748,6046,5702,106,11503,5928,5575,106.3
39,제주특별자치도,055005, 54세,2021,10727,5567,5160,107.9,10523,5467,5056,108.1
39,제주특별자치도,060,55~59세,2021,52278,27011,25267,106.9,51342,26573,24769,107.3
39,제주특별자치도,060001, 55세,2021,10930,5745,5185,110.8,10744,5659,5085,111.3
39,제주특별자치도,060002, 56세,2021,10324,5366,4958,108.2,10116,5262,4854,108.4
39,제주특별자치도,060003, 57세,2021,10026,5161,4865,106.1,9841,5082,4759,106.8
39,제주특별자치도,060004, 58세,2021,10931,5625,5306,106,10726,5531,5195,106.5
39,제주특별자치도,060005, 59세,2021,10067,5114,4953,103.3,9915,5039,4876,103.3
39,제주특별자치도,065,60~64세,2021,47821,23988,23833,100.7,47173,23700,23473,101
39,제주특별자치도,065001, 60세,2021,10305,5161,5144,100.3,10182,5103,5079,100.5
39,제주특별자치도,065002, 61세,2021,10506,5258,5248,100.2,10340,5184,5156,100.5
39,제주특별자치도,065003, 62세,2021,9503,4744,4759,99.7,9378,4686,4692,99.9
39,제주특별자치도,065004, 63세,2021,8834,4461,4373,102,8707,4411,4296,102.7
39,제주특별자치도,065005, 64세,2021,8673,4364,4309,101.3,8566,4316,4250,101.6
39,제주특별자치도,070,65~69세,2021,34031,16575,17456,95,33601,16375,17226,95.1
39,제주특별자치도,070001, 65세,2021,7991,3951,4040,97.8,7872,3897,3975,98
39,제주특별자치도,070002, 66세,2021,8247,4037,4210,95.9,8155,3994,4161,96
39,제주특별자치도,070003, 67세,2021,6521,3197,3324,96.2,6423,3149,3274,96.2
39,제주특별자치도,070004, 68세,2021,5443,2563,2880,89,5385,2530,2855,88.6
39,제주특별자치도,070005, 69세,2021,5829,2827,3002,94.2,5766,2805,2961,94.7
39,제주특별자치도,075,70~74세,2021,25121,11822,13299,88.9,24909,11727,13182,89
39,제주특별자치도,075001, 70세,2021,4991,2412,2579,93.5,4937,2394,2543,94.1
39,제주특별자치도,075002, 71세,2021,4923,2261,2662,84.9,4888,2241,2647,84.7
39,제주특별자치도,075003, 72세,2021,5002,2354,2648,88.9,4950,2332,2618,89.1
39,제주특별자치도,075004, 73세,2021,5207,2496,2711,92.1,5174,2481,2693,92.1
39,제주특별자치도,075005, 74세,2021,4998,2299,2699,85.2,4960,2279,2681,85
39,제주특별자치도,080,75~79세,2021,19882,8726,11156,78.2,19802,8686,11116,78.1
39,제주특별자치도,080001, 75세,2021,4325,1964,2361,83.2,4304,1954,2350,83.1
39,제주특별자치도,080002, 76세,2021,3950,1805,2145,84.1,3931,1793,2138,83.9
39,제주특별자치도,080003, 77세,2021,3936,1731,2205,78.5,3921,1724,2197,78.5
39,제주특별자치도,080004, 78세,2021,3709,1571,2138,73.5,3692,1561,2131,73.3
39,제주특별자치도,080005, 79세,2021,3962,1655,2307,71.7,3954,1654,2300,71.9
39,제주특별자치도,085,80~84세,2021,15504,5800,9704,59.8,15464,5783,9681,59.7
39,제주특별자치도,085001, 80세,2021,3704,1509,2195,68.7,3689,1502,2187,68.7
39,제주특별자치도,085002, 81세,2021,3239,1225,2014,60.8,3235,1224,2011,60.9
39,제주특별자치도,085003, 82세,2021,3142,1166,1976,59,3133,1161,1972,58.9
39,제주특별자치도,085004, 83세,2021,2859,1032,1827,56.5,2857,1032,1825,56.5
39,제주특별자치도,085005, 84세,2021,2560,868,1692,51.3,2550,864,1686,51.2
39,제주특별자치도,090,85~89세,2021,9177,2613,6564,39.8,9155,2603,6552,39.7
39,제주특별자치도,090001, 85세,2021,2243,727,1516,48,2237,724,1513,47.9
39,제주특별자치도,090002, 86세,2021,2093,648,1445,44.8,2085,645,1440,44.8
39,제주특별자치도,090003, 87세,2021,1913,544,1369,39.7,1908,540,1368,39.5
39,제주특별자치도,090004, 88세,2021,1659,411,1248,32.9,1658,411,1247,33
39,제주특별자치도,090005, 89세,2021,1269,283,986,28.7,1267,283,984,28.8
39,제주특별자치도,095,90~94세,2021,3164,547,2617,20.9,3163,547,2616,20.9
39,제주특별자치도,095001, 90세,2021,920,199,721,27.6,919,199,720,27.6
39,제주특별자치도,095002, 91세,2021,869,152,717,21.2,869,152,717,21.2
39,제주특별자치도,095003, 92세,2021,640,114,526,21.7,640,114,526,21.7
39,제주특별자치도,095004, 93세,2021,426,53,373,14.2,426,53,373,14.2
39,제주특별자치도,095005, 94세,2021,309,29,280,10.4,309,29,280,10.4
39,제주특별자치도,100,95~99세,2021,870,78,792,9.8,865,78,787,9.9
39,제주특별자치도,100001, 95세,2021,197,24,173,13.9,196,24,172,14
39,제주특별자치도,100002, 96세,2021,176,18,158,11.4,173,18,155,11.6
39,제주특별자치도,100003, 97세,2021,102,13,89,14.6,102,13,89,14.6
39,제주특별자치도,100004, 98세,2021,259,12,247,4.9,259,12,247,4.9
39,제주특별자치도,100005, 99세,2021,136,11,125,8.8,135,11,124,8.9
39,제주특별자치도,101,100세이상,2021,168,11,157,7,167,10,157,6.4
39,제주특별자치도,102,15세미만,2021,94830,48875,45955,106.4,93338,48115,45223,106.4
39,제주특별자치도,103,15~64세,2021,470360,243762,226598,107.6,447433,230597,216836,106.3
39,제주특별자치도,104,65세이상,2021,107917,46172,61745,74.8,107126,45809,61317,74.7
39,제주특별자치도,086,85세이상,2021,13379,3249,10130,32.1,13350,3238,10112,32
39,제주특별자치도,126,평균연령,2021,42.6,41.3,43.9,,42.9,41.6,44.1,
39,제주특별자치도,127,중위연령,2021,43.8,42.7,45,,44.5,43.5,45.5,
39004, 읍부,000,합계,2021,153891,79077,74814,105.7,144272,72886,71386,102.1
39004, 읍부,005,0~4세,2021,4593,2347,2246,104.5,4263,2186,2077,105.2
39004, 읍부,005001, 0세,2021,699,360,339,106.2,666,347,319,108.8
39004, 읍부,005002, 1세,2021,837,447,390,114.6,794,423,371,114
39004, 읍부,005003, 2세,2021,852,420,432,97.2,797,389,408,95.3
39004, 읍부,005004, 3세,2021,1021,496,525,94.5,935,460,475,96.8
39004, 읍부,005005, 4세,2021,1184,624,560,111.4,1071,567,504,112.5
39004, 읍부,010,5~9세,2021,7685,4073,3612,112.8,7308,3876,3432,112.9
39004, 읍부,010001, 5세,2021,1376,732,644,113.7,1268,671,597,112.4
39004, 읍부,010002, 6세,2021,1469,777,692,112.3,1369,729,640,113.9
39004, 읍부,010003, 7세,2021,1513,799,714,111.9,1442,762,680,112.1
39004, 읍부,010004, 8세,2021,1603,836,767,109,1548,800,748,107
39004, 읍부,010005, 9세,2021,1724,929,795,116.9,1681,914,767,119.2
39004, 읍부,015,10~14세,2021,7376,3820,3556,107.4,7208,3742,3466,108
39004, 읍부,015001, 10세,2021,1642,883,759,116.3,1608,865,743,116.4
39004, 읍부,015002, 11세,2021,1484,765,719,106.4,1449,747,702,106.4
39004, 읍부,015003, 12세,2021,1431,754,677,111.4,1395,741,654,113.3
39004, 읍부,015004, 13세,2021,1438,718,720,99.7,1408,706,702,100.6
39004, 읍부,015005, 14세,2021,1381,700,681,102.8,1348,683,665,102.7
39004, 읍부,020,15~19세,2021,6074,3242,2832,114.5,5934,3171,2763,114.8
39004, 읍부,020001, 15세,2021,1260,668,592,112.8,1231,651,580,112.2
39004, 읍부,020002, 16세,2021,1220,666,554,120.2,1187,655,532,123.1
39004, 읍부,020003, 17세,2021,1352,709,643,110.3,1330,697,633,110.1
39004, 읍부,020004, 18세,2021,1236,631,605,104.3,1206,614,592,103.7
39004, 읍부,020005, 19세,2021,1006,568,438,129.7,980,554,426,130
39004, 읍부,025,20~24세,2021,6736,3979,2757,144.3,6046,3504,2542,137.8
39004, 읍부,025001, 20세,2021,1181,706,475,148.6,1149,694,455,152.5
39004, 읍부,025002, 21세,2021,1346,820,526,155.9,1248,757,491,154.2
39004, 읍부,025003, 22세,2021,1308,773,535,144.5,1172,691,481,143.7
39004, 읍부,025004, 23세,2021,1373,767,606,126.6,1181,628,553,113.6
39004, 읍부,025005, 24세,2021,1528,913,615,148.5,1296,734,562,130.6
39004, 읍부,030,25~29세,2021,8470,5016,3454,145.2,6697,3620,3077,117.6
39004, 읍부,030001, 25세,2021,1654,971,683,142.2,1338,724,614,117.9
39004, 읍부,030002, 26세,2021,1609,968,641,151,1281,712,569,125.1
39004, 읍부,030003, 27세,2021,1725,1062,663,160.2,1347,753,594,126.8
39004, 읍부,030004, 28세,2021,1769,1013,756,134,1387,713,674,105.8
39004, 읍부,030005, 29세,2021,1713,1002,711,140.9,1344,718,626,114.7
39004, 읍부,035,30~34세,2021,8063,4510,3553,126.9,6240,3226,3014,107
39004, 읍부,035001, 30세,2021,1643,931,712,130.8,1281,669,612,109.3
39004, 읍부,035002, 31세,2021,1674,966,708,136.4,1301,692,609,113.6
39004, 읍부,035003, 32세,2021,1531,870,661,131.6,1180,621,559,111.1
39004, 읍부,035004, 33세,2021,1552,818,734,111.4,1186,573,613,93.5
39004, 읍부,035005, 34세,2021,1663,925,738,125.3,1292,671,621,108.1
39004, 읍부,040,35~39세,2021,10150,5283,4867,108.5,8660,4283,4377,97.9
39004, 읍부,040001, 35세,2021,1667,856,811,105.5,1346,650,696,93.4
39004, 읍부,040002, 36세,2021,1809,959,850,112.8,1514,752,762,98.7
39004, 읍부,040003, 37세,2021,1997,1033,964,107.2,1699,822,877,93.7
39004, 읍부,040004, 38세,2021,2187,1139,1048,108.7,1913,956,957,99.9
39004, 읍부,040005, 39세,2021,2490,1296,1194,108.5,2188,1103,1085,101.7
39004, 읍부,045,40~44세,2021,12171,6299,5872,107.3,11117,5692,5425,104.9
39004, 읍부,045001, 40세,2021,2507,1270,1237,102.7,2233,1110,1123,98.8
39004, 읍부,045002, 41세,2021,2624,1317,1307,100.8,2386,1179,1207,97.7
39004, 읍부,045003, 42세,2021,2540,1304,1236,105.5,2334,1187,1147,103.5
39004, 읍부,045004, 43세,2021,2201,1156,1045,110.6,2008,1044,964,108.3
39004, 읍부,045005, 44세,2021,2299,1252,1047,119.6,2156,1172,984,119.1
39004, 읍부,050,45~49세,2021,12560,6838,5722,119.5,11909,6487,5422,119.6
39004, 읍부,050001, 45세,2021,2267,1243,1024,121.4,2101,1146,955,120
39004, 읍부,050002, 46세,2021,2421,1290,1131,114.1,2288,1226,1062,115.4
39004, 읍부,050003, 47세,2021,2677,1481,1196,123.8,2536,1408,1128,124.8
39004, 읍부,050004, 48세,2021,2575,1400,1175,119.1,2463,1336,1127,118.5
39004, 읍부,050005, 49세,2021,2620,1424,1196,119.1,2521,1371,1150,119.2
39004, 읍부,055,50~54세,2021,13341,7214,6127,117.7,12916,6980,5936,117.6
39004, 읍부,055001, 50세,2021,2936,1627,1309,124.3,2827,1560,1267,123.1
39004, 읍부,055002, 51세,2021,2611,1425,1186,120.2,2522,1371,1151,119.1
39004, 읍부,055003, 52세,2021,2614,1391,1223,113.7,2529,1347,1182,114
39004, 읍부,055004, 53세,2021,2749,1446,1303,111,2671,1407,1264,111.3
39004, 읍부,055005, 54세,2021,2431,1325,1106,119.8,2367,1295,1072,120.8
39004, 읍부,060,55~59세,2021,12795,6797,5998,113.3,12504,6655,5849,113.8
39004, 읍부,060001, 55세,2021,2592,1415,1177,120.2,2536,1387,1149,120.7
39004, 읍부,060002, 56세,2021,2471,1323,1148,115.2,2402,1287,1115,115.4
39004, 읍부,060003, 57세,2021,2517,1365,1152,118.5,2450,1337,1113,120.1
39004, 읍부,060004, 58세,2021,2664,1389,1275,108.9,2613,1363,1250,109
39004, 읍부,060005, 59세,2021,2551,1305,1246,104.7,2503,1281,1222,104.8
39004, 읍부,065,60~64세,2021,12246,6321,5925,106.7,12046,6236,5810,107.3
39004, 읍부,065001, 60세,2021,2486,1273,1213,104.9,2454,1259,1195,105.4
39004, 읍부,065002, 61세,2021,2744,1391,1353,102.8,2691,1364,1327,102.8
39004, 읍부,065003, 62세,2021,2438,1268,1170,108.4,2395,1247,1148,108.6
39004, 읍부,065004, 63세,2021,2321,1219,1102,110.6,2279,1206,1073,112.4
39004, 읍부,065005, 64세,2021,2257,1170,1087,107.6,2227,1160,1067,108.7
39004, 읍부,070,65~69세,2021,8932,4470,4462,100.2,8815,4407,4408,100
39004, 읍부,070001, 65세,2021,2007,1018,989,102.9,1979,1004,975,103
39004, 읍부,070002, 66세,2021,2176,1103,1073,102.8,2145,1085,1060,102.4
39004, 읍부,070003, 67세,2021,1724,872,852,102.3,1698,857,841,101.9
39004, 읍부,070004, 68세,2021,1437,696,741,93.9,1420,687,733,93.7
39004, 읍부,070005, 69세,2021,1588,781,807,96.8,1573,774,799,96.9
39004, 읍부,075,70~74세,2021,6929,3332,3597,92.6,6872,3302,3570,92.5
39004, 읍부,075001, 70세,2021,1376,684,692,98.8,1365,681,684,99.6
39004, 읍부,075002, 71세,2021,1273,578,695,83.2,1263,570,693,82.3
39004, 읍부,075003, 72세,2021,1430,689,741,93,1418,684,734,93.2
39004, 읍부,075004, 73세,2021,1427,694,733,94.7,1415,689,726,94.9
39004, 읍부,075005, 74세,2021,1423,687,736,93.3,1411,678,733,92.5
39004, 읍부,080,75~79세,2021,5971,2584,3387,76.3,5957,2576,3381,76.2
39004, 읍부,080001, 75세,2021,1316,594,722,82.3,1312,592,720,82.2
39004, 읍부,080002, 76세,2021,1172,523,649,80.6,1168,520,648,80.2
39004, 읍부,080003, 77세,2021,1142,478,664,72,1139,475,664,71.5
39004, 읍부,080004, 78세,2021,1131,474,657,72.1,1131,474,657,72.1
39004, 읍부,080005, 79세,2021,1210,515,695,74.1,1207,515,692,74.4
39004, 읍부,085,80~84세,2021,5225,1899,3326,57.1,5216,1896,3320,57.1
39004, 읍부,085001, 80세,2021,1196,483,713,67.7,1194,482,712,67.7
39004, 읍부,085002, 81세,2021,1105,395,710,55.6,1104,395,709,55.7
39004, 읍부,085003, 82세,2021,1073,397,676,58.7,1071,396,675,58.7
39004, 읍부,085004, 83세,2021,990,339,651,52.1,990,339,651,52.1
39004, 읍부,085005, 84세,2021,861,285,576,49.5,857,284,573,49.6
39004, 읍부,090,85~89세,2021,3167,850,2317,36.7,3159,844,2315,36.5
39004, 읍부,090001, 85세,2021,754,230,524,43.9,752,228,524,43.5
39004, 읍부,090002, 86세,2021,688,202,486,41.6,686,202,484,41.7
39004, 읍부,090003, 87세,2021,659,182,477,38.2,655,178,477,37.3
39004, 읍부,090004, 88세,2021,585,138,447,30.9,585,138,447,30.9
39004, 읍부,090005, 89세,2021,481,98,383,25.6,481,98,383,25.6
39004, 읍부,095,90~94세,2021,1064,169,895,18.9,1064,169,895,18.9
39004, 읍부,095001, 90세,2021,300,58,242,24,300,58,242,24
39004, 읍부,095002, 91세,2021,304,55,249,22.1,304,55,249,22.1
39004, 읍부,095003, 92세,2021,214,32,182,17.6,214,32,182,17.6
39004, 읍부,095004, 93세,2021,144,18,126,14.3,144,18,126,14.3
39004, 읍부,095005, 94세,2021,102,6,96,6.3,102,6,96,6.3
39004, 읍부,100,95~99세,2021,275,30,245,12.2,273,30,243,12.3
39004, 읍부,100001, 95세,2021,60,12,48,25,59,12,47,25.5
39004, 읍부,100002, 96세,2021,59,6,53,11.3,58,6,52,11.5
39004, 읍부,100003, 97세,2021,28,X,24,16.7,28,X,24,16.7
39004, 읍부,100004, 98세,2021,79,X,75,5.3,79,X,75,5.3
39004, 읍부,100005, 99세,2021,49,X,45,8.9,49,X,45,8.9
39004, 읍부,101,100세이상,2021,68,X,64,6.3,68,X,64,6.3
39004, 읍부,102,15세미만,2021,19654,10240,9414,108.8,18779,9804,8975,109.2
39004, 읍부,103,15~64세,2021,102606,55499,47107,117.8,94069,49854,44215,112.8
39004, 읍부,104,65세이상,2021,31631,13338,18293,72.9,31424,13228,18196,72.7
39004, 읍부,086,85세이상,2021,4574,1053,3521,29.9,4564,1047,3517,29.8
39004, 읍부,126,평균연령,2021,45.6,43.8,47.5,,46.4,44.6,48.1,
39004, 읍부,127,중위연령,2021,47.4,45.8,49.1,,48.7,47.5,50.1,
39005, 면부,000,합계,2021,35587,18380,17207,106.8,33766,17185,16581,103.6
39005, 면부,005,0~4세,2021,884,439,445,98.7,868,431,437,98.6
39005, 면부,005001, 0세,2021,140,70,70,100,138,69,69,100
39005, 면부,005002, 1세,2021,139,63,76,82.9,138,62,76,81.6
39005, 면부,005003, 2세,2021,177,86,91,94.5,172,84,88,95.5
39005, 면부,005004, 3세,2021,197,98,99,99,194,96,98,98
39005, 면부,005005, 4세,2021,231,122,109,111.9,226,120,106,113.2
39005, 면부,010,5~9세,2021,1425,743,682,108.9,1409,736,673,109.4
39005, 면부,010001, 5세,2021,242,111,131,84.7,237,111,126,88.1
39005, 면부,010002, 6세,2021,270,138,132,104.5,266,137,129,106.2
39005, 면부,010003, 7세,2021,285,161,124,129.8,282,158,124,127.4
39005, 면부,010004, 8세,2021,297,166,131,126.7,295,165,130,126.9
39005, 면부,010005, 9세,2021,331,167,164,101.8,329,165,164,100.6
39005, 면부,015,10~14세,2021,1467,787,680,115.7,1447,780,667,116.9
39005, 면부,015001, 10세,2021,325,178,147,121.1,321,176,145,121.4
39005, 면부,015002, 11세,2021,303,157,146,107.5,301,156,145,107.6
39005, 면부,015003, 12세,2021,285,147,138,106.5,279,144,135,106.7
39005, 면부,015004, 13세,2021,283,151,132,114.4,275,150,125,120
39005, 면부,015005, 14세,2021,271,154,117,131.6,271,154,117,131.6
39005, 면부,020,15~19세,2021,1022,554,468,118.4,1010,548,462,118.6
39005, 면부,020001, 15세,2021,223,130,93,139.8,222,129,93,138.7
39005, 면부,020002, 16세,2021,216,102,114,89.5,215,102,113,90.3
39005, 면부,020003, 17세,2021,196,107,89,120.2,192,107,85,125.9
39005, 면부,020004, 18세,2021,207,104,103,101,205,102,103,99
39005, 면부,020005, 19세,2021,180,111,69,160.9,176,108,68,158.8
39005, 면부,025,20~24세,2021,1455,807,648,124.5,1340,730,610,119.7
39005, 면부,025001, 20세,2021,252,153,99,154.5,248,150,98,153.1
39005, 면부,025002, 21세,2021,284,156,128,121.9,275,151,124,121.8
39005, 면부,025003, 22세,2021,267,148,119,124.4,249,137,112,122.3
39005, 면부,025004, 23세,2021,318,178,140,127.1,281,154,127,121.3
39005, 면부,025005, 24세,2021,334,172,162,106.2,287,138,149,92.6
39005, 면부,030,25~29세,2021,1984,1199,785,152.7,1655,947,708,133.8
39005, 면부,030001, 25세,2021,420,252,168,150,352,195,157,124.2
39005, 면부,030002, 26세,2021,396,238,158,150.6,335,191,144,132.6
39005, 면부,030003, 27세,2021,383,235,148,158.8,326,189,137,138
39005, 면부,030004, 28세,2021,401,244,157,155.4,328,188,140,134.3
39005, 면부,030005, 29세,2021,384,230,154,149.4,314,184,130,141.5
39005, 면부,035,30~34세,2021,1698,938,760,123.4,1338,685,653,104.9
39005, 면부,035001, 30세,2021,351,197,154,127.9,271,138,133,103.8
39005, 면부,035002, 31세,2021,354,194,160,121.3,292,153,139,110.1
39005, 면부,035003, 32세,2021,322,177,145,122.1,252,130,122,106.6
39005, 면부,035004, 33세,2021,327,173,154,112.3,250,121,129,93.8
39005, 면부,035005, 34세,2021,344,197,147,134,273,143,130,110
39005, 면부,040,35~39세,2021,2135,1137,998,113.9,1812,930,882,105.4
39005, 면부,040001, 35세,2021,371,196,175,112,297,151,146,103.4
39005, 면부,040002, 36세,2021,418,226,192,117.7,342,176,166,106
39005, 면부,040003, 37세,2021,389,206,183,112.6,324,166,158,105.1
39005, 면부,040004, 38세,2021,466,246,220,111.8,413,212,201,105.5
39005, 면부,040005, 39세,2021,491,263,228,115.4,436,225,211,106.6
39005, 면부,045,40~44세,2021,2690,1433,1257,114,2462,1285,1177,109.2
39005, 면부,045001, 40세,2021,535,276,259,106.6,489,245,244,100.4
39005, 면부,045002, 41세,2021,552,281,271,103.7,496,247,249,99.2
39005, 면부,045003, 42세,2021,568,303,265,114.3,529,271,258,105
39005, 면부,045004, 43세,2021,498,277,221,125.3,455,252,203,124.1
39005, 면부,045005, 44세,2021,537,296,241,122.8,493,270,223,121.1
39005, 면부,050,45~49세,2021,2812,1646,1166,141.2,2661,1557,1104,141
39005, 면부,050001, 45세,2021,541,311,230,135.2,505,290,215,134.9
39005, 면부,050002, 46세,2021,506,302,204,148,471,282,189,149.2
39005, 면부,050003, 47세,2021,583,346,237,146,559,333,226,147.3
39005, 면부,050004, 48세,2021,589,336,253,132.8,563,319,244,130.7
39005, 면부,050005, 49세,2021,593,351,242,145,563,333,230,144.8
39005, 면부,055,50~54세,2021,3208,1755,1453,120.8,3090,1686,1404,120.1
39005, 면부,055001, 50세,2021,659,370,289,128,634,352,282,124.8
39005, 면부,055002, 51세,2021,637,356,281,126.7,612,344,268,128.4
39005, 면부,055003, 52세,2021,614,335,279,120.1,593,325,268,121.3
39005, 면부,055004, 53세,2021,695,381,314,121.3,669,366,303,120.8
39005, 면부,055005, 54세,2021,603,313,290,107.9,582,299,283,105.7
39005, 면부,060,55~59세,2021,3179,1750,1429,122.5,3109,1717,1392,123.3
39005, 면부,060001, 55세,2021,611,343,268,128,599,338,261,129.5
39005, 면부,060002, 56세,2021,638,358,280,127.9,623,351,272,129
39005, 면부,060003, 57세,2021,592,318,274,116.1,581,314,267,117.6
39005, 면부,060004, 58세,2021,713,397,316,125.6,692,386,306,126.1
39005, 면부,060005, 59세,2021,625,334,291,114.8,614,328,286,114.7
39005, 면부,065,60~64세,2021,3177,1643,1534,107.1,3135,1617,1518,106.5
39005, 면부,065001, 60세,2021,647,343,304,112.8,639,337,302,111.6
39005, 면부,065002, 61세,2021,635,335,300,111.7,623,327,296,110.5
39005, 면부,065003, 62세,2021,639,319,320,99.7,633,317,316,100.3
39005, 면부,065004, 63세,2021,633,329,304,108.2,625,323,302,107
39005, 면부,065005, 64세,2021,623,317,306,103.6,615,313,302,103.6
39005, 면부,070,65~69세,2021,2383,1160,1223,94.8,2370,1152,1218,94.6
39005, 면부,070001, 65세,2021,576,282,294,95.9,572,280,292,95.9
39005, 면부,070002, 66세,2021,556,275,281,97.9,554,273,281,97.2
39005, 면부,070003, 67세,2021,470,223,247,90.3,467,221,246,89.8
39005, 면부,070004, 68세,2021,372,180,192,93.8,371,179,192,93.2
39005, 면부,070005, 69세,2021,409,200,209,95.7,406,199,207,96.1
39005, 면부,075,70~74세,2021,1924,954,970,98.4,1922,954,968,98.6
39005, 면부,075001, 70세,2021,389,215,174,123.6,388,215,173,124.3
39005, 면부,075002, 71세,2021,377,175,202,86.6,377,175,202,86.6
39005, 면부,075003, 72세,2021,385,185,200,92.5,385,185,200,92.5
39005, 면부,075004, 73세,2021,423,213,210,101.4,423,213,210,101.4
39005, 면부,075005, 74세,2021,350,166,184,90.2,349,166,183,90.7
39005, 면부,080,75~79세,2021,1565,690,875,78.9,1563,688,875,78.6
39005, 면부,080001, 75세,2021,328,160,168,95.2,327,159,168,94.6
39005, 면부,080002, 76세,2021,283,135,148,91.2,282,134,148,90.5
39005, 면부,080003, 77세,2021,320,132,188,70.2,320,132,188,70.2
39005, 면부,080004, 78세,2021,300,116,184,63,300,116,184,63
39005, 면부,080005, 79세,2021,334,147,187,78.6,334,147,187,78.6
39005, 면부,085,80~84세,2021,1386,462,924,50,1382,459,923,49.7
39005, 면부,085001, 80세,2021,332,128,204,62.7,330,127,203,62.6
39005, 면부,085002, 81세,2021,266,92,174,52.9,265,91,174,52.3
39005, 면부,085003, 82세,2021,290,98,192,51,289,97,192,50.5
39005, 면부,085004, 83세,2021,282,84,198,42.4,282,84,198,42.4
39005, 면부,085005, 84세,2021,216,60,156,38.5,216,60,156,38.5
39005, 면부,090,85~89세,2021,841,233,608,38.3,841,233,608,38.3
39005, 면부,090001, 85세,2021,218,72,146,49.3,218,72,146,49.3
39005, 면부,090002, 86세,2021,207,64,143,44.8,207,64,143,44.8
39005, 면부,090003, 87세,2021,160,33,127,26,160,33,127,26
39005, 면부,090004, 88세,2021,150,37,113,32.7,150,37,113,32.7
39005, 면부,090005, 89세,2021,106,27,79,34.2,106,27,79,34.2
39005, 면부,095,90~94세,2021,273,46,227,20.3,273,46,227,20.3
39005, 면부,095001, 90세,2021,88,14,74,18.9,88,14,74,18.9
39005, 면부,095002, 91세,2021,72,10,62,16.1,72,10,62,16.1
39005, 면부,095003, 92세,2021,61,14,47,29.8,61,14,47,29.8
39005, 면부,095004, 93세,2021,27,X,23,17.4,27,X,23,17.4
39005, 면부,095005, 94세,2021,25,X,21,19,25,X,21,19
39005, 면부,100,95~99세,2021,72,X,69,4.3,72,X,69,4.3
39005, 면부,100001, 95세,2021,12,X,12,0,12,X,12,0
39005, 면부,100002, 96세,2021,14,X,13,7.7,14,X,13,7.7
39005, 면부,100003, 97세,2021,7,X,7,0,7,X,7,0
39005, 면부,100004, 98세,2021,30,X,29,3.4,30,X,29,3.4
39005, 면부,100005, 99세,2021,9,X,8,12.5,9,X,8,12.5
39005, 면부,101,100세이상,2021,7,X,6,16.7,7,X,6,16.7
39005, 면부,102,15세미만,2021,3776,1969,1807,109,3724,1947,1777,109.6
39005, 면부,103,15~64세,2021,23360,12862,10498,122.5,21612,11702,9910,118.1
39005, 면부,104,65세이상,2021,8451,3549,4902,72.4,8430,3536,4894,72.3
39005, 면부,086,85세이상,2021,1193,283,910,31.1,1193,283,910,31.1
39005, 면부,126,평균연령,2021,48.1,46.2,50.1,,48.7,46.9,50.6,
39005, 면부,127,중위연령,2021,50.3,48.6,52.5,,51.4,49.9,53.3,
39003, 동부,000,합계,2021,483629,241352,242277,99.6,469859,234450,235409,99.6
39003, 동부,005,0~4세,2021,18379,9491,8888,106.8,18167,9379,8788,106.7
39003, 동부,005001, 0세,2021,3059,1594,1465,108.8,3026,1576,1450,108.7
39003, 동부,005002, 1세,2021,3230,1670,1560,107.1,3195,1652,1543,107.1
39003, 동부,005003, 2세,2021,3713,1910,1803,105.9,3673,1887,1786,105.7
39003, 동부,005004, 3세,2021,4021,2102,1919,109.5,3972,2077,1895,109.6
39003, 동부,005005, 4세,2021,4356,2215,2141,103.5,4301,2187,2114,103.5
39003, 동부,010,5~9세,2021,26020,13246,12774,103.7,25816,13132,12684,103.5
39003, 동부,010001, 5세,2021,4835,2494,2341,106.5,4795,2475,2320,106.7
39003, 동부,010002, 6세,2021,5065,2605,2460,105.9,5016,2584,2432,106.3
39003, 동부,010003, 7세,2021,5237,2632,2605,101,5195,2602,2593,100.3
39003, 동부,010004, 8세,2021,5225,2662,2563,103.9,5179,2632,2547,103.3
39003, 동부,010005, 9세,2021,5658,2853,2805,101.7,5631,2839,2792,101.7
39003, 동부,015,10~14세,2021,27001,13929,13072,106.6,26852,13853,12999,106.6
39003, 동부,015001, 10세,2021,5513,2819,2694,104.6,5482,2802,2680,104.6
39003, 동부,015002, 11세,2021,5367,2816,2551,110.4,5339,2800,2539,110.3
39003, 동부,015003, 12세,2021,5131,2647,2484,106.6,5097,2632,2465,106.8
39003, 동부,015004, 13세,2021,5317,2757,2560,107.7,5285,2741,2544,107.7
39003, 동부,015005, 14세,2021,5673,2890,2783,103.8,5649,2878,2771,103.9
39003, 동부,020,15~19세,2021,24813,13070,11743,111.3,24641,12976,11665,111.2
39003, 동부,020001, 15세,2021,5120,2648,2472,107.1,5085,2631,2454,107.2
39003, 동부,020002, 16세,2021,4934,2631,2303,114.2,4901,2614,2287,114.3
39003, 동부,020003, 17세,2021,5238,2755,2483,111,5219,2742,2477,110.7
39003, 동부,020004, 18세,2021,5246,2738,2508,109.2,5220,2723,2497,109.1
39003, 동부,020005, 19세,2021,4275,2298,1977,116.2,4216,2266,1950,116.2
39003, 동부,025,20~24세,2021,29112,15507,13605,114,27507,14650,12857,113.9
39003, 동부,025001, 20세,2021,5202,2905,2297,126.5,5078,2848,2230,127.7
39003, 동부,025002, 21세,2021,6199,3406,2793,121.9,5893,3257,2636,123.6
39003, 동부,025003, 22세,2021,5670,3011,2659,113.2,5346,2843,2503,113.6
39003, 동부,025004, 23세,2021,5865,3007,2858,105.2,5442,2774,2668,104
39003, 동부,025005, 24세,2021,6176,3178,2998,106,5748,2928,2820,103.8
39003, 동부,030,25~29세,2021,33284,17383,15901,109.3,31141,16161,14980,107.9
39003, 동부,030001, 25세,2021,6344,3300,3044,108.4,5903,3037,2866,106
39003, 동부,030002, 26세,2021,6665,3465,3200,108.3,6220,3219,3001,107.3
39003, 동부,030003, 27세,2021,6759,3534,3225,109.6,6337,3299,3038,108.6
39003, 동부,030004, 28세,2021,6796,3541,3255,108.8,6373,3294,3079,107
39003, 동부,030005, 29세,2021,6720,3543,3177,111.5,6308,3312,2996,110.5
39003, 동부,035,30~34세,2021,29484,14905,14579,102.2,27179,13758,13421,102.5
39003, 동부,035001, 30세,2021,6187,3172,3015,105.2,5778,2958,2820,104.9
39003, 동부,035002, 31세,2021,6014,3071,2943,104.3,5525,2817,2708,104
39003, 동부,035003, 32세,2021,5715,2852,2863,99.6,5255,2626,2629,99.9
39003, 동부,035004, 33세,2021,5637,2884,2753,104.8,5171,2655,2516,105.5
39003, 동부,035005, 34세,2021,5931,2926,3005,97.4,5450,2702,2748,98.3
39003, 동부,040,35~39세,2021,35030,17539,17491,100.3,33022,16546,16476,100.4
39003, 동부,040001, 35세,2021,5988,3064,2924,104.8,5563,2854,2709,105.4
39003, 동부,040002, 36세,2021,6333,3205,3128,102.5,5947,3005,2942,102.1
39003, 동부,040003, 37세,2021,6686,3314,3372,98.3,6293,3114,3179,98
39003, 동부,040004, 38세,2021,7547,3739,3808,98.2,7179,3568,3611,98.8
39003, 동부,040005, 39세,2021,8476,4217,4259,99,8040,4005,4035,99.3
39003, 동부,045,40~44세,2021,39590,19816,19774,100.2,37989,19083,18906,100.9
39003, 동부,045001, 40세,2021,8423,4277,4146,103.2,8054,4089,3965,103.1
39003, 동부,045002, 41세,2021,8328,4195,4133,101.5,7996,4037,3959,102
39003, 동부,045003, 42세,2021,8236,4086,4150,98.5,7876,3929,3947,99.5
39003, 동부,045004, 43세,2021,7084,3489,3595,97.1,6796,3371,3425,98.4
39003, 동부,045005, 44세,2021,7519,3769,3750,100.5,7267,3657,3610,101.3
39003, 동부,050,45~49세,2021,41598,20981,20617,101.8,40534,20501,20033,102.3
39003, 동부,050001, 45세,2021,7409,3814,3595,106.1,7175,3717,3458,107.5
39003, 동부,050002, 46세,2021,7710,3934,3776,104.2,7494,3841,3653,105.1
39003, 동부,050003, 47세,2021,8703,4415,4288,103,8491,4320,4171,103.6
39003, 동부,050004, 48세,2021,8746,4326,4420,97.9,8531,4226,4305,98.2
39003, 동부,050005, 49세,2021,9030,4492,4538,99,8843,4397,4446,98.9
39003, 동부,055,50~54세,2021,42781,21712,21069,103.1,42018,21318,20700,103
39003, 동부,055001, 50세,2021,9355,4715,4640,101.6,9177,4616,4561,101.2
39003, 동부,055002, 51세,2021,8851,4453,4398,101.3,8667,4361,4306,101.3
39003, 동부,055003, 52세,2021,8578,4396,4182,105.1,8437,4313,4124,104.6
39003, 동부,055004, 53세,2021,8304,4219,4085,103.3,8163,4155,4008,103.7
39003, 동부,055005, 54세,2021,7693,3929,3764,104.4,7574,3873,3701,104.6
39003, 동부,060,55~59세,2021,36304,18464,17840,103.5,35729,18201,17528,103.8
39003, 동부,060001, 55세,2021,7727,3987,3740,106.6,7609,3934,3675,107
39003, 동부,060002, 56세,2021,7215,3685,3530,104.4,7091,3624,3467,104.5
39003, 동부,060003, 57세,2021,6917,3478,3439,101.1,6810,3431,3379,101.5
39003, 동부,060004, 58세,2021,7554,3839,3715,103.3,7421,3782,3639,103.9
39003, 동부,060005, 59세,2021,6891,3475,3416,101.7,6798,3430,3368,101.8
39003, 동부,065,60~64세,2021,32398,16024,16374,97.9,31992,15847,16145,98.2
39003, 동부,065001, 60세,2021,7172,3545,3627,97.7,7089,3507,3582,97.9
39003, 동부,065002, 61세,2021,7127,3532,3595,98.2,7026,3493,3533,98.9
39003, 동부,065003, 62세,2021,6426,3157,3269,96.6,6350,3122,3228,96.7
39003, 동부,065004, 63세,2021,5880,2913,2967,98.2,5803,2882,2921,98.7
39003, 동부,065005, 64세,2021,5793,2877,2916,98.7,5724,2843,2881,98.7
39003, 동부,070,65~69세,2021,22716,10945,11771,93,22416,10816,11600,93.2
39003, 동부,070001, 65세,2021,5408,2651,2757,96.2,5321,2613,2708,96.5
39003, 동부,070002, 66세,2021,5515,2659,2856,93.1,5456,2636,2820,93.5
39003, 동부,070003, 67세,2021,4327,2102,2225,94.5,4258,2071,2187,94.7
39003, 동부,070004, 68세,2021,3634,1687,1947,86.6,3594,1664,1930,86.2
39003, 동부,070005, 69세,2021,3832,1846,1986,93,3787,1832,1955,93.7
39003, 동부,075,70~74세,2021,16268,7536,8732,86.3,16115,7471,8644,86.4
39003, 동부,075001, 70세,2021,3226,1513,1713,88.3,3184,1498,1686,88.8
39003, 동부,075002, 71세,2021,3273,1508,1765,85.4,3248,1496,1752,85.4
39003, 동부,075003, 72세,2021,3187,1480,1707,86.7,3147,1463,1684,86.9
39003, 동부,075004, 73세,2021,3357,1589,1768,89.9,3336,1579,1757,89.9
39003, 동부,075005, 74세,2021,3225,1446,1779,81.3,3200,1435,1765,81.3
39003, 동부,080,75~79세,2021,12346,5452,6894,79.1,12282,5422,6860,79
39003, 동부,080001, 75세,2021,2681,1210,1471,82.3,2665,1203,1462,82.3
39003, 동부,080002, 76세,2021,2495,1147,1348,85.1,2481,1139,1342,84.9
39003, 동부,080003, 77세,2021,2474,1121,1353,82.9,2462,1117,1345,83
39003, 동부,080004, 78세,2021,2278,981,1297,75.6,2261,971,1290,75.3
39003, 동부,080005, 79세,2021,2418,993,1425,69.7,2413,992,1421,69.8
39003, 동부,085,80~84세,2021,8893,3439,5454,63.1,8866,3428,5438,63
39003, 동부,085001, 80세,2021,2176,898,1278,70.3,2165,893,1272,70.2
39003, 동부,085002, 81세,2021,1868,738,1130,65.3,1866,738,1128,65.4
39003, 동부,085003, 82세,2021,1779,671,1108,60.6,1773,668,1105,60.5
39003, 동부,085004, 83세,2021,1587,609,978,62.3,1585,609,976,62.4
39003, 동부,085005, 84세,2021,1483,523,960,54.5,1477,520,957,54.3
39003, 동부,090,85~89세,2021,5169,1530,3639,42,5155,1526,3629,42.1
39003, 동부,090001, 85세,2021,1271,425,846,50.2,1267,424,843,50.3
39003, 동부,090002, 86세,2021,1198,382,816,46.8,1192,379,813,46.6
39003, 동부,090003, 87세,2021,1094,329,765,43,1093,329,764,43.1
39003, 동부,090004, 88세,2021,924,236,688,34.3,923,236,687,34.4
39003, 동부,090005, 89세,2021,682,158,524,30.2,680,158,522,30.3
39003, 동부,095,90~94세,2021,1827,332,1495,22.2,1826,332,1494,22.2
39003, 동부,095001, 90세,2021,532,127,405,31.4,531,127,404,31.4
39003, 동부,095002, 91세,2021,493,87,406,21.4,493,87,406,21.4
39003, 동부,095003, 92세,2021,365,68,297,22.9,365,68,297,22.9
39003, 동부,095004, 93세,2021,255,31,224,13.8,255,31,224,13.8
39003, 동부,095005, 94세,2021,182,19,163,11.7,182,19,163,11.7
39003, 동부,100,95~99세,2021,523,45,478,9.4,520,45,475,9.5
39003, 동부,100001, 95세,2021,125,12,113,10.6,125,12,113,10.6
39003, 동부,100002, 96세,2021,103,11,92,12,101,11,90,12.2
39003, 동부,100003, 97세,2021,67,9,58,15.5,67,9,58,15.5
39003, 동부,100004, 98세,2021,150,7,143,4.9,150,7,143,4.9
39003, 동부,100005, 99세,2021,78,6,72,8.3,77,6,71,8.5
39003, 동부,101,100세이상,2021,93,6,87,6.9,92,5,87,5.7
39003, 동부,102,15세미만,2021,71400,36666,34734,105.6,70835,36364,34471,105.5
39003, 동부,103,15~64세,2021,344394,175401,168993,103.8,331752,169041,162711,103.9
39003, 동부,104,65세이상,2021,67835,29285,38550,76,67272,29045,38227,76
39003, 동부,086,85세이상,2021,7612,1913,5699,33.6,7593,1908,5685,33.6
39003, 동부,126,평균연령,2021,41.3,40.2,42.3,,41.4,40.3,42.5,
39003, 동부,127,중위연령,2021,42.2,41.3,43.2,,42.6,41.7,43.6,
39010, 제주시,000,합계,2021,493869,247944,245925,100.8,476970,238636,238334,100.1
39010, 제주시,005,0~4세,2021,18032,9254,8778,105.4,17782,9114,8668,105.1
39010, 제주시,005001, 0세,2021,3005,1546,1459,106,2965,1526,1439,106
39010, 제주시,005002, 1세,2021,3181,1629,1552,105,3138,1603,1535,104.4
39010, 제주시,005003, 2세,2021,3606,1822,1784,102.1,3555,1793,1762,101.8
39010, 제주시,005004, 3세,2021,3979,2062,1917,107.6,3923,2030,1893,107.2
39010, 제주시,005005, 4세,2021,4261,2195,2066,106.2,4201,2162,2039,106
39010, 제주시,010,5~9세,2021,26261,13537,12724,106.4,25999,13389,12610,106.2
39010, 제주시,010001, 5세,2021,4799,2495,2304,108.3,4739,2465,2274,108.4
39010, 제주시,010002, 6세,2021,5041,2629,2412,109,4978,2596,2382,109
39010, 제주시,010003, 7세,2021,5306,2732,2574,106.1,5255,2700,2555,105.7
39010, 제주시,010004, 8세,2021,5337,2764,2573,107.4,5284,2727,2557,106.6
39010, 제주시,010005, 9세,2021,5778,2917,2861,102,5743,2901,2842,102.1
39010, 제주시,015,10~14세,2021,26630,13790,12840,107.4,26466,13709,12757,107.5
39010, 제주시,015001, 10세,2021,5534,2842,2692,105.6,5505,2828,2677,105.6
39010, 제주시,015002, 11세,2021,5315,2790,2525,110.5,5283,2772,2511,110.4
39010, 제주시,015003, 12세,2021,5091,2661,2430,109.5,5053,2644,2409,109.8
39010, 제주시,015004, 13세,2021,5188,2689,2499,107.6,5151,2670,2481,107.6
39010, 제주시,015005, 14세,2021,5502,2808,2694,104.2,5474,2795,2679,104.3
39010, 제주시,020,15~19세,2021,24549,12938,11611,111.4,24339,12819,11520,111.3
39010, 제주시,020001, 15세,2021,4964,2561,2403,106.6,4927,2541,2386,106.5
39010, 제주시,020002, 16세,2021,4812,2564,2248,114.1,4780,2548,2232,114.2
39010, 제주시,020003, 17세,2021,5183,2730,2453,111.3,5154,2707,2447,110.6
39010, 제주시,020004, 18세,2021,5213,2695,2518,107,5173,2675,2498,107.1
39010, 제주시,020005, 19세,2021,4377,2388,1989,120.1,4305,2348,1957,120
39010, 제주시,025,20~24세,2021,29655,15985,13670,116.9,27683,14851,12832,115.7
39010, 제주시,025001, 20세,2021,5278,2912,2366,123.1,5140,2849,2291,124.4
39010, 제주시,025002, 21세,2021,6220,3474,2746,126.5,5862,3278,2584,126.9
39010, 제주시,025003, 22세,2021,5804,3121,2683,116.3,5409,2908,2501,116.3
39010, 제주시,025004, 23세,2021,6031,3148,2883,109.2,5510,2836,2674,106.1
39010, 제주시,025005, 24세,2021,6322,3330,2992,111.3,5762,2980,2782,107.1
39010, 제주시,030,25~29세,2021,33817,18067,15750,114.7,30860,16130,14730,109.5
39010, 제주시,030001, 25세,2021,6496,3435,3061,112.2,5904,3038,2866,106
39010, 제주시,030002, 26세,2021,6708,3582,3126,114.6,6095,3192,2903,110
39010, 제주시,030003, 27세,2021,6840,3683,3157,116.7,6245,3282,2963,110.8
39010, 제주시,030004, 28세,2021,6926,3658,3268,111.9,6341,3275,3066,106.8
39010, 제주시,030005, 29세,2021,6847,3709,3138,118.2,6275,3343,2932,114
39010, 제주시,035,30~34세,2021,29804,15365,14439,106.4,26844,13681,13163,103.9
39010, 제주시,035001, 30세,2021,6262,3286,2976,110.4,5696,2948,2748,107.3
39010, 제주시,035002, 31세,2021,6084,3171,2913,108.9,5476,2810,2666,105.4
39010, 제주시,035003, 32세,2021,5732,2930,2802,104.6,5154,2604,2550,102.1
39010, 제주시,035004, 33세,2021,5704,2927,2777,105.4,5101,2592,2509,103.3
39010, 제주시,035005, 34세,2021,6022,3051,2971,102.7,5417,2727,2690,101.4
39010, 제주시,040,35~39세,2021,35542,17970,17572,102.3,33074,16612,16462,100.9
39010, 제주시,040001, 35세,2021,6111,3149,2962,106.3,5554,2846,2708,105.1
39010, 제주시,040002, 36세,2021,6467,3305,3162,104.5,5990,3025,2965,102
39010, 제주시,040003, 37세,2021,6817,3427,3390,101.1,6332,3144,3188,98.6
39010, 제주시,040004, 38세,2021,7611,3814,3797,100.4,7160,3584,3576,100.2
39010, 제주시,040005, 39세,2021,8536,4275,4261,100.3,8038,4013,4025,99.7
39010, 제주시,045,40~44세,2021,40329,20289,20040,101.2,38439,19386,19053,101.7
39010, 제주시,045001, 40세,2021,8518,4306,4212,102.2,8075,4084,3991,102.3
39010, 제주시,045002, 41세,2021,8533,4294,4239,101.3,8138,4094,4044,101.2
39010, 제주시,045003, 42세,2021,8423,4208,4215,99.8,8002,4018,3984,100.9
39010, 제주시,045004, 43세,2021,7229,3607,3622,99.6,6878,3447,3431,100.5
39010, 제주시,045005, 44세,2021,7626,3874,3752,103.3,7346,3743,3603,103.9
39010, 제주시,050,45~49세,2021,41996,21411,20585,104,40743,20804,19939,104.3
39010, 제주시,050001, 45세,2021,7441,3904,3537,110.4,7145,3765,3380,111.4
39010, 제주시,050002, 46세,2021,7825,4003,3822,104.7,7558,3877,3681,105.3
39010, 제주시,050003, 47세,2021,8802,4520,4282,105.6,8554,4406,4148,106.2
39010, 제주시,050004, 48세,2021,8861,4429,4432,99.9,8621,4306,4315,99.8
39010, 제주시,050005, 49세,2021,9067,4555,4512,101,8865,4450,4415,100.8
39010, 제주시,055,50~54세,2021,43459,22191,21268,104.3,42594,21733,20861,104.2
39010, 제주시,055001, 50세,2021,9445,4776,4669,102.3,9238,4656,4582,101.6
39010, 제주시,055002, 51세,2021,8909,4511,4398,102.6,8705,4405,4300,102.4
39010, 제주시,055003, 52세,2021,8732,4481,4251,105.4,8559,4383,4176,105
39010, 제주시,055004, 53세,2021,8512,4369,4143,105.5,8367,4302,4065,105.8
39010, 제주시,055005, 54세,2021,7861,4054,3807,106.5,7725,3987,3738,106.7
39010, 제주시,060,55~59세,2021,37602,19312,18290,105.6,36974,19027,17947,106
39010, 제주시,060001, 55세,2021,7968,4176,3792,110.1,7846,4118,3728,110.5
39010, 제주시,060002, 56세,2021,7425,3817,3608,105.8,7305,3763,3542,106.2
39010, 제주시,060003, 57세,2021,7196,3684,3512,104.9,7066,3626,3440,105.4
39010, 제주시,060004, 58세,2021,7848,4037,3811,105.9,7702,3971,3731,106.4
39010, 제주시,060005, 59세,2021,7165,3598,3567,100.9,7055,3549,3506,101.2
39010, 제주시,065,60~64세,2021,33511,16802,16709,100.6,33071,16611,16460,100.9
39010, 제주시,065001, 60세,2021,7296,3656,3640,100.4,7211,3618,3593,100.7
39010, 제주시,065002, 61세,2021,7323,3653,3670,99.5,7218,3609,3609,100
39010, 제주시,065003, 62세,2021,6661,3327,3334,99.8,6576,3284,3292,99.8
39010, 제주시,065004, 63세,2021,6169,3105,3064,101.3,6082,3074,3008,102.2
39010, 제주시,065005, 64세,2021,6062,3061,3001,102,5984,3026,2958,102.3
39010, 제주시,070,65~69세,2021,23393,11386,12007,94.8,23086,11247,11839,95
39010, 제주시,070001, 65세,2021,5470,2694,2776,97,5386,2656,2730,97.3
39010, 제주시,070002, 66세,2021,5754,2812,2942,95.6,5687,2783,2904,95.8
39010, 제주시,070003, 67세,2021,4465,2188,2277,96.1,4391,2153,2238,96.2
39010, 제주시,070004, 68세,2021,3725,1762,1963,89.8,3685,1738,1947,89.3
39010, 제주시,070005, 69세,2021,3979,1930,2049,94.2,3937,1917,2020,94.9
39010, 제주시,075,70~74세,2021,16821,7877,8944,88.1,16656,7801,8855,88.1
39010, 제주시,075001, 70세,2021,3388,1617,1771,91.3,3341,1602,1739,92.1
39010, 제주시,075002, 71세,2021,3339,1550,1789,86.6,3310,1533,1777,86.3
39010, 제주시,075003, 72세,2021,3284,1545,1739,88.8,3246,1528,1718,88.9
39010, 제주시,075004, 73세,2021,3469,1657,1812,91.4,3446,1645,1801,91.3
39010, 제주시,075005, 74세,2021,3341,1508,1833,82.3,3313,1493,1820,82
39010, 제주시,080,75~79세,2021,13246,5810,7436,78.1,13186,5782,7404,78.1
39010, 제주시,080001, 75세,2021,2945,1334,1611,82.8,2929,1327,1602,82.8
39010, 제주시,080002, 76세,2021,2578,1202,1376,87.4,2565,1193,1372,87
39010, 제주시,080003, 77세,2021,2690,1186,1504,78.9,2679,1182,1497,79
39010, 제주시,080004, 78세,2021,2505,1040,1465,71,2491,1033,1458,70.9
39010, 제주시,080005, 79세,2021,2528,1048,1480,70.8,2522,1047,1475,71
39010, 제주시,085,80~84세,2021,10210,3807,6403,59.5,10183,3796,6387,59.4
39010, 제주시,085001, 80세,2021,2412,990,1422,69.6,2403,985,1418,69.5
39010, 제주시,085002, 81세,2021,2128,805,1323,60.8,2126,805,1321,60.9
39010, 제주시,085003, 82세,2021,2089,766,1323,57.9,2080,761,1319,57.7
39010, 제주시,085004, 83세,2021,1896,682,1214,56.2,1895,682,1213,56.2
39010, 제주시,085005, 84세,2021,1685,564,1121,50.3,1679,563,1116,50.4
39010, 제주시,090,85~89세,2021,6072,1710,4362,39.2,6055,1701,4354,39.1
39010, 제주시,090001, 85세,2021,1524,483,1041,46.4,1518,480,1038,46.2
39010, 제주시,090002, 86세,2021,1342,427,915,46.7,1337,424,913,46.4
39010, 제주시,090003, 87세,2021,1252,355,897,39.6,1248,352,896,39.3
39010, 제주시,090004, 88세,2021,1115,255,860,29.7,1114,255,859,29.7
39010, 제주시,090005, 89세,2021,839,190,649,29.3,838,190,648,29.3
39010, 제주시,095,90~94세,2021,2202,388,1814,21.4,2201,388,1813,21.4
39010, 제주시,095001, 90세,2021,643,149,494,30.2,642,149,493,30.2
39010, 제주시,095002, 91세,2021,596,101,495,20.4,596,101,495,20.4
39010, 제주시,095003, 92세,2021,464,82,382,21.5,464,82,382,21.5
39010, 제주시,095004, 93세,2021,286,32,254,12.6,286,32,254,12.6
39010, 제주시,095005, 94세,2021,213,24,189,12.7,213,24,189,12.7
39010, 제주시,100,95~99세,2021,627,49,578,8.5,624,49,575,8.5
39010, 제주시,100001, 95세,2021,142,15,127,11.8,141,15,126,11.9
39010, 제주시,100002, 96세,2021,128,12,116,10.3,126,12,114,10.5
39010, 제주시,100003, 97세,2021,75,8,67,11.9,75,8,67,11.9
39010, 제주시,100004, 98세,2021,190,11,179,6.1,190,11,179,6.1
39010, 제주시,100005, 99세,2021,92,X,89,3.4,92,X,89,3.4
39010, 제주시,101,100세이상,2021,111,6,105,5.7,111,6,105,5.7
39010, 제주시,102,15세미만,2021,70923,36581,34342,106.5,70247,36212,34035,106.4
39010, 제주시,103,15~64세,2021,350264,180330,169934,106.1,334621,171654,162967,105.3
39010, 제주시,104,65세이상,2021,72682,31033,41649,74.5,72102,30770,41332,74.4
39010, 제주시,086,85세이상,2021,9012,2153,6859,31.4,8991,2144,6847,31.3
39010, 제주시,126,평균연령,2021,41.8,40.5,43,,41.9,40.7,43.2,
39010, 제주시,127,중위연령,2021,42.7,41.6,43.8,,43.2,42.2,44.3,
39020, 서귀포시,000,합계,2021,179238,90865,88373,102.8,170927,85885,85042,101
39020, 서귀포시,005,0~4세,2021,5824,3023,2801,107.9,5516,2882,2634,109.4
39020, 서귀포시,005001, 0세,2021,893,478,415,115.2,865,466,399,116.8
39020, 서귀포시,005002, 1세,2021,1025,551,474,116.2,989,534,455,117.4
39020, 서귀포시,005003, 2세,2021,1136,594,542,109.6,1087,567,520,109
39020, 서귀포시,005004, 3세,2021,1260,634,626,101.3,1178,603,575,104.9
39020, 서귀포시,005005, 4세,2021,1510,766,744,103,1397,712,685,103.9
39020, 서귀포시,010,5~9세,2021,8869,4525,4344,104.2,8534,4355,4179,104.2
39020, 서귀포시,010001, 5세,2021,1654,842,812,103.7,1561,792,769,103
39020, 서귀포시,010002, 6세,2021,1763,891,872,102.2,1673,854,819,104.3
39020, 서귀포시,010003, 7세,2021,1729,860,869,99,1664,822,842,97.6
39020, 서귀포시,010004, 8세,2021,1788,900,888,101.4,1738,870,868,100.2
39020, 서귀포시,010005, 9세,2021,1935,1032,903,114.3,1898,1017,881,115.4
39020, 서귀포시,015,10~14세,2021,9214,4746,4468,106.2,9041,4666,4375,106.7
39020, 서귀포시,015001, 10세,2021,1946,1038,908,114.3,1906,1015,891,113.9
39020, 서귀포시,015002, 11세,2021,1839,948,891,106.4,1806,931,875,106.4
39020, 서귀포시,015003, 12세,2021,1756,887,869,102.1,1718,873,845,103.3
39020, 서귀포시,015004, 13세,2021,1850,937,913,102.6,1817,927,890,104.2
39020, 서귀포시,015005, 14세,2021,1823,936,887,105.5,1794,920,874,105.3
39020, 서귀포시,020,15~19세,2021,7360,3928,3432,114.5,7246,3876,3370,115
39020, 서귀포시,020001, 15세,2021,1639,885,754,117.4,1611,870,741,117.4
39020, 서귀포시,020002, 16세,2021,1558,835,723,115.5,1523,823,700,117.6
39020, 서귀포시,020003, 17세,2021,1603,841,762,110.4,1587,839,748,112.2
39020, 서귀포시,020004, 18세,2021,1476,778,698,111.5,1458,764,694,110.1
39020, 서귀포시,020005, 19세,2021,1084,589,495,119,1067,580,487,119.1
39020, 서귀포시,025,20~24세,2021,7648,4308,3340,129,7210,4033,3177,126.9
39020, 서귀포시,025001, 20세,2021,1357,852,505,168.7,1335,843,492,171.3
39020, 서귀포시,025002, 21세,2021,1609,908,701,129.5,1554,887,667,133
39020, 서귀포시,025003, 22세,2021,1441,811,630,128.7,1358,763,595,128.2
39020, 서귀포시,025004, 23세,2021,1525,804,721,111.5,1394,720,674,106.8
39020, 서귀포시,025005, 24세,2021,1716,933,783,119.2,1569,820,749,109.5
39020, 서귀포시,030,25~29세,2021,9921,5531,4390,126,8633,4598,4035,114
39020, 서귀포시,030001, 25세,2021,1922,1088,834,130.5,1689,918,771,119.1
39020, 서귀포시,030002, 26세,2021,1962,1089,873,124.7,1741,930,811,114.7
39020, 서귀포시,030003, 27세,2021,2027,1148,879,130.6,1765,959,806,119
39020, 서귀포시,030004, 28세,2021,2040,1140,900,126.7,1747,920,827,111.2
39020, 서귀포시,030005, 29세,2021,1970,1066,904,117.9,1691,871,820,106.2
39020, 서귀포시,035,30~34세,2021,9441,4988,4453,112,7913,3988,3925,101.6
39020, 서귀포시,035001, 30세,2021,1919,1014,905,112,1634,817,817,100
39020, 서귀포시,035002, 31세,2021,1958,1060,898,118,1642,852,790,107.8
39020, 서귀포시,035003, 32세,2021,1836,969,867,111.8,1533,773,760,101.7
39020, 서귀포시,035004, 33세,2021,1812,948,864,109.7,1506,757,749,101.1
39020, 서귀포시,035005, 34세,2021,1916,997,919,108.5,1598,789,809,97.5
39020, 서귀포시,040,35~39세,2021,11773,5989,5784,103.5,10420,5147,5273,97.6
39020, 서귀포시,040001, 35세,2021,1915,967,948,102,1652,809,843,96
39020, 서귀포시,040002, 36세,2021,2093,1085,1008,107.6,1813,908,905,100.3
39020, 서귀포시,040003, 37세,2021,2255,1126,1129,99.7,1984,958,1026,93.4
39020, 서귀포시,040004, 38세,2021,2589,1310,1279,102.4,2345,1152,1193,96.6
39020, 서귀포시,040005, 39세,2021,2921,1501,1420,105.7,2626,1320,1306,101.1
39020, 서귀포시,045,40~44세,2021,14122,7259,6863,105.8,13129,6674,6455,103.4
39020, 서귀포시,045001, 40세,2021,2947,1517,1430,106.1,2701,1360,1341,101.4
39020, 서귀포시,045002, 41세,2021,2971,1499,1472,101.8,2740,1369,1371,99.9
39020, 서귀포시,045003, 42세,2021,2921,1485,1436,103.4,2737,1369,1368,100.1
39020, 서귀포시,045004, 43세,2021,2554,1315,1239,106.1,2381,1220,1161,105.1
39020, 서귀포시,045005, 44세,2021,2729,1443,1286,112.2,2570,1356,1214,111.7
39020, 서귀포시,050,45~49세,2021,14974,8054,6920,116.4,14361,7741,6620,116.9
39020, 서귀포시,050001, 45세,2021,2776,1464,1312,111.6,2636,1388,1248,111.2
39020, 서귀포시,050002, 46세,2021,2812,1523,1289,118.2,2695,1472,1223,120.4
39020, 서귀포시,050003, 47세,2021,3161,1722,1439,119.7,3032,1655,1377,120.2
39020, 서귀포시,050004, 48세,2021,3049,1633,1416,115.3,2936,1575,1361,115.7
39020, 서귀포시,050005, 49세,2021,3176,1712,1464,116.9,3062,1651,1411,117
39020, 서귀포시,055,50~54세,2021,15871,8490,7381,115,15430,8251,7179,114.9
39020, 서귀포시,055001, 50세,2021,3505,1936,1569,123.4,3400,1872,1528,122.5
39020, 서귀포시,055002, 51세,2021,3190,1723,1467,117.5,3096,1671,1425,117.3
39020, 서귀포시,055003, 52세,2021,3074,1641,1433,114.5,3000,1602,1398,114.6
39020, 서귀포시,055004, 53세,2021,3236,1677,1559,107.6,3136,1626,1510,107.7
39020, 서귀포시,055005, 54세,2021,2866,1513,1353,111.8,2798,1480,1318,112.3
39020, 서귀포시,060,55~59세,2021,14676,7699,6977,110.3,14368,7546,6822,110.6
39020, 서귀포시,060001, 55세,2021,2962,1569,1393,112.6,2898,1541,1357,113.6
39020, 서귀포시,060002, 56세,2021,2899,1549,1350,114.7,2811,1499,1312,114.3
39020, 서귀포시,060003, 57세,2021,2830,1477,1353,109.2,2775,1456,1319,110.4
39020, 서귀포시,060004, 58세,2021,3083,1588,1495,106.2,3024,1560,1464,106.6
39020, 서귀포시,060005, 59세,2021,2902,1516,1386,109.4,2860,1490,1370,108.8
39020, 서귀포시,065,60~64세,2021,14310,7186,7124,100.9,14102,7089,7013,101.1
39020, 서귀포시,065001, 60세,2021,3009,1505,1504,100.1,2971,1485,1486,99.9
39020, 서귀포시,065002, 61세,2021,3183,1605,1578,101.7,3122,1575,1547,101.8
39020, 서귀포시,065003, 62세,2021,2842,1417,1425,99.4,2802,1402,1400,100.1
39020, 서귀포시,065004, 63세,2021,2665,1356,1309,103.6,2625,1337,1288,103.8
39020, 서귀포시,065005, 64세,2021,2611,1303,1308,99.6,2582,1290,1292,99.8
39020, 서귀포시,070,65~69세,2021,10638,5189,5449,95.2,10515,5128,5387,95.2
39020, 서귀포시,070001, 65세,2021,2521,1257,1264,99.4,2486,1241,1245,99.7
39020, 서귀포시,070002, 66세,2021,2493,1225,1268,96.6,2468,1211,1257,96.3
39020, 서귀포시,070003, 67세,2021,2056,1009,1047,96.4,2032,996,1036,96.1
39020, 서귀포시,070004, 68세,2021,1718,801,917,87.4,1700,792,908,87.2
39020, 서귀포시,070005, 69세,2021,1850,897,953,94.1,1829,888,941,94.4
39020, 서귀포시,075,70~74세,2021,8300,3945,4355,90.6,8253,3926,4327,90.7
39020, 서귀포시,075001, 70세,2021,1603,795,808,98.4,1596,792,804,98.5
39020, 서귀포시,075002, 71세,2021,1584,711,873,81.4,1578,708,870,81.4
39020, 서귀포시,075003, 72세,2021,1718,809,909,89,1704,804,900,89.3
39020, 서귀포시,075004, 73세,2021,1738,839,899,93.3,1728,836,892,93.7
39020, 서귀포시,075005, 74세,2021,1657,791,866,91.3,1647,786,861,91.3
39020, 서귀포시,080,75~79세,2021,6636,2916,3720,78.4,6616,2904,3712,78.2
39020, 서귀포시,080001, 75세,2021,1380,630,750,84,1375,627,748,83.8
39020, 서귀포시,080002, 76세,2021,1372,603,769,78.4,1366,600,766,78.3
39020, 서귀포시,080003, 77세,2021,1246,545,701,77.7,1242,542,700,77.4
39020, 서귀포시,080004, 78세,2021,1204,531,673,78.9,1201,528,673,78.5
39020, 서귀포시,080005, 79세,2021,1434,607,827,73.4,1432,607,825,73.6
39020, 서귀포시,085,80~84세,2021,5294,1993,3301,60.4,5281,1987,3294,60.3
39020, 서귀포시,085001, 80세,2021,1292,519,773,67.1,1286,517,769,67.2
39020, 서귀포시,085002, 81세,2021,1111,420,691,60.8,1109,419,690,60.7
39020, 서귀포시,085003, 82세,2021,1053,400,653,61.3,1053,400,653,61.3
39020, 서귀포시,085004, 83세,2021,963,350,613,57.1,962,350,612,57.2
39020, 서귀포시,085005, 84세,2021,875,304,571,53.2,871,301,570,52.8
39020, 서귀포시,090,85~89세,2021,3105,903,2202,41,3100,902,2198,41
39020, 서귀포시,090001, 85세,2021,719,244,475,51.4,719,244,475,51.4
39020, 서귀포시,090002, 86세,2021,751,221,530,41.7,748,221,527,41.9
39020, 서귀포시,090003, 87세,2021,661,189,472,40,660,188,472,39.8
39020, 서귀포시,090004, 88세,2021,544,156,388,40.2,544,156,388,40.2
39020, 서귀포시,090005, 89세,2021,430,93,337,27.6,429,93,336,27.7
39020, 서귀포시,095,90~94세,2021,962,159,803,19.8,962,159,803,19.8
39020, 서귀포시,095001, 90세,2021,277,50,227,22,277,50,227,22
39020, 서귀포시,095002, 91세,2021,273,51,222,23,273,51,222,23
39020, 서귀포시,095003, 92세,2021,176,32,144,22.2,176,32,144,22.2
39020, 서귀포시,095004, 93세,2021,140,21,119,17.6,140,21,119,17.6
39020, 서귀포시,095005, 94세,2021,96,5,91,5.5,96,5,91,5.5
39020, 서귀포시,100,95~99세,2021,243,29,214,13.6,241,29,212,13.7
39020, 서귀포시,100001, 95세,2021,55,9,46,19.6,55,9,46,19.6
39020, 서귀포시,100002, 96세,2021,48,6,42,14.3,47,6,41,14.6
39020, 서귀포시,100003, 97세,2021,27,5,22,22.7,27,5,22,22.7
39020, 서귀포시,100004, 98세,2021,69,X,68,1.5,69,X,68,1.5
39020, 서귀포시,100005, 99세,2021,44,8,36,22.2,43,8,35,22.9
39020, 서귀포시,101,100세이상,2021,57,5,52,9.6,56,X,52,7.7
39020, 서귀포시,102,15세미만,2021,23907,12294,11613,105.9,23091,11903,11188,106.4
39020, 서귀포시,103,15~64세,2021,120096,63432,56664,111.9,112812,58943,53869,109.4
39020, 서귀포시,104,65세이상,2021,35235,15139,20096,75.3,35024,15039,19985,75.3
39020, 서귀포시,086,85세이상,2021,4367,1096,3271,33.5,4359,1094,3265,33.5
39020, 서귀포시,126,평균연령,2021,45,43.5,46.4,,45.4,44,46.9,
39020, 서귀포시,127,중위연령,2021,46.9,45.8,48.2,,47.8,46.9,48.9,
