C행정구역별(읍면동),행정구역별(읍면동),C연령별,연령별,시점,총인구(명),총인구_남자(명),총인구_여자(명),총인구_성비,내국인(명),내국인_남자(명),내국인_여자(명),내국인_성비
00,전국,000,합계,2016,51269554,25696987,25572567,100.5,49855796,24881520,24974276,99.6
00,전국,005,0~4세,2016,2218378,1137155,1081223,105.2,2192603,1124012,1068591,105.2
00,전국,005001, 0세,2016,416784,213459,203325,105,411089,210518,200571,105
00,전국,005002, 1세,2016,440251,225750,214501,105.2,435097,223107,211990,105.2
00,전국,005003, 2세,2016,436822,223597,213225,104.9,431594,221000,210594,104.9
00,전국,005004, 3세,2016,443390,227180,216210,105.1,438394,224642,213752,105.1
00,전국,005005, 4세,2016,481131,247169,233962,105.6,476429,244745,231684,105.6
00,전국,010,5~9세,2016,2304689,1187031,1117658,106.2,2287123,1177879,1109244,106.2
00,전국,010001, 5세,2016,473707,243505,230202,105.8,469329,241216,228113,105.7
00,전국,010002, 6세,2016,454278,234350,219928,106.6,450309,232305,218004,106.6
00,전국,010003, 7세,2016,439411,226637,212774,106.5,436023,224873,211150,106.5
00,전국,010004, 8세,2016,463355,238449,224906,106,460205,236791,223414,106
00,전국,010005, 9세,2016,473938,244090,229848,106.2,471257,242694,228563,106.2
00,전국,015,10~14세,2016,2299146,1193915,1105231,108,2288612,1188475,1100137,108
00,전국,015001, 10세,2016,434534,224939,209595,107.3,432275,223770,208505,107.3
00,전국,015002, 11세,2016,428359,221761,206598,107.3,426227,220642,205585,107.3
00,전국,015003, 12세,2016,467431,242596,224835,107.9,465254,241474,223780,107.9
00,전국,015004, 13세,2016,476418,247711,228707,108.3,474608,246763,227845,108.3
00,전국,015005, 14세,2016,492404,256908,235496,109.1,490248,255826,234422,109.1
00,전국,020,15~19세,2016,3084039,1606802,1477237,108.8,3056728,1594229,1462499,109
00,전국,020001, 15세,2016,563245,293746,269499,109,561090,292595,268495,109
00,전국,020002, 16세,2016,619945,323498,296447,109.1,617413,322164,295249,109.1
00,전국,020003, 17세,2016,603787,315761,288026,109.6,600605,314139,286466,109.7
00,전국,020004, 18세,2016,633627,329870,303757,108.6,627134,326918,300216,108.9
00,전국,020005, 19세,2016,663435,343927,319508,107.6,650486,338413,312073,108.4
00,전국,025,20~24세,2016,3552780,1898134,1654646,114.7,3400634,1816165,1584469,114.6
00,전국,025001, 20세,2016,689067,364345,324722,112.2,668404,355380,313024,113.5
00,전국,025002, 21세,2016,700351,375840,324511,115.8,674881,363499,311382,116.7
00,전국,025003, 22세,2016,712380,383932,328448,116.9,682729,368007,314722,116.9
00,전국,025004, 23세,2016,719874,385557,334317,115.3,683943,365006,318937,114.4
00,전국,025005, 24세,2016,731108,388460,342648,113.4,690677,364273,326404,111.6
00,전국,030,25~29세,2016,3308184,1756218,1551966,113.2,3068970,1607473,1461497,110
00,전국,030001, 25세,2016,693978,368791,325187,113.4,651092,342555,308537,111
00,전국,030002, 26세,2016,670404,358455,311949,114.9,621314,328263,293051,112
00,전국,030003, 27세,2016,653071,348953,304118,114.7,605245,318952,286293,111.4
00,전국,030004, 28세,2016,642710,340217,302493,112.5,593201,309358,283843,109
00,전국,030005, 29세,2016,648021,339802,308219,110.2,598118,308345,289773,106.4
00,전국,035,30~34세,2016,3629317,1894497,1734820,109.2,3415599,1756053,1659546,105.8
00,전국,035001, 30세,2016,658526,347470,311056,111.7,610920,317329,293591,108.1
00,전국,035002, 31세,2016,667255,350575,316680,110.7,622398,321622,300776,106.9
00,전국,035003, 32세,2016,699773,365663,334110,109.4,657551,338070,319481,105.8
00,전국,035004, 33세,2016,768424,398962,369462,108,728644,372903,355741,104.8
00,전국,035005, 34세,2016,835339,431827,403512,107,796086,406129,389957,104.1
00,전국,040,35~39세,2016,4002467,2062739,1939728,106.3,3852007,1963865,1888142,104
00,전국,040001, 35세,2016,836000,435236,400764,108.6,802347,412948,389399,106
00,전국,040002, 36세,2016,852323,438022,414301,105.7,820357,416981,403376,103.4
00,전국,040003, 37세,2016,808390,415531,392859,105.8,776971,394915,382056,103.4
00,전국,040004, 38세,2016,741509,382433,359076,106.5,713342,364019,349323,104.2
00,전국,040005, 39세,2016,764245,391517,372728,105,738990,375002,363988,103
00,전국,045,40~44세,2016,4152420,2124144,2028276,104.7,4031799,2049032,1982767,103.3
00,전국,045001, 40세,2016,752919,388722,364197,106.7,727930,372489,355441,104.8
00,전국,045002, 41세,2016,789735,402507,387228,103.9,766561,387811,378750,102.4
00,전국,045003, 42세,2016,861009,440707,420302,104.9,837974,426343,411631,103.6
00,전국,045004, 43세,2016,873064,442003,431061,102.5,848890,427299,421591,101.4
00,전국,045005, 44세,2016,875693,450205,425488,105.8,850444,435090,415354,104.8
00,전국,050,45~49세,2016,4492909,2264120,2228789,101.6,4369603,2196126,2173477,101
00,전국,050001, 45세,2016,932436,475521,456915,104.1,906302,460497,445805,103.3
00,전국,050002, 46세,2016,901907,457669,444238,103,875408,442773,432635,102.3
00,전국,050003, 47세,2016,913292,460383,452909,101.7,888357,446723,441634,101.2
00,전국,050004, 48세,2016,911116,455239,455877,99.9,886109,441774,444335,99.4
00,전국,050005, 49세,2016,834158,415308,418850,99.2,813427,404359,409068,98.8
00,전국,055,50~54세,2016,4153936,2108614,2045322,103.1,4030564,2045888,1984676,103.1
00,전국,055001, 50세,2016,820712,421345,399367,105.5,797783,409442,388341,105.4
00,전국,055002, 51세,2016,843445,423216,420229,100.7,818517,410418,408099,100.6
00,전국,055003, 52세,2016,793055,401874,391181,102.7,768463,389436,379027,102.7
00,전국,055004, 53세,2016,837077,425780,411297,103.5,808561,411459,397102,103.6
00,전국,055005, 54세,2016,859647,436399,423248,103.1,837240,425133,412107,103.2
00,전국,060,55~59세,2016,4165508,2069976,2095532,98.8,4076050,2025701,2050349,98.8
00,전국,060001, 55세,2016,917833,456244,461589,98.8,902996,449047,453949,98.9
00,전국,060002, 56세,2016,911172,449275,461897,97.3,889333,438512,450821,97.3
00,전국,060003, 57세,2016,814875,404264,410611,98.5,797473,395604,401869,98.4
00,전국,060004, 58세,2016,769790,385604,384186,100.4,751771,376698,375073,100.4
00,전국,060005, 59세,2016,751838,374589,377249,99.3,734477,365840,368637,99.2
00,전국,065,60~64세,2016,3079213,1508112,1571101,96,3010386,1473557,1536829,95.9
00,전국,065001, 60세,2016,692995,343428,349567,98.2,677011,335409,341602,98.2
00,전국,065002, 61세,2016,704785,343071,361714,94.8,688651,334880,353771,94.7
00,전국,065003, 62세,2016,596022,293496,302526,97,581525,286221,295304,96.9
00,전국,065004, 63세,2016,520645,253133,267512,94.6,508744,247160,261584,94.5
00,전국,065005, 64세,2016,564766,274984,289782,94.9,554455,269887,284568,94.8
00,전국,070,65~69세,2016,2208535,1058989,1149546,92.1,2179524,1044970,1134554,92.1
00,전국,070001, 65세,2016,419417,203094,216323,93.9,411138,198991,212147,93.8
00,전국,070002, 66세,2016,450957,217605,233352,93.3,443962,214199,229763,93.2
00,전국,070003, 67세,2016,456864,219628,237236,92.6,450728,216642,234086,92.5
00,전국,070004, 68세,2016,442963,212342,230621,92.1,438903,210447,228456,92.1
00,전국,070005, 69세,2016,438334,206320,232014,88.9,434793,204691,230102,89
00,전국,075,70~74세,2016,1746223,790608,955615,82.7,1736294,786401,949893,82.8
00,전국,075001, 70세,2016,332606,157082,175524,89.5,329832,155809,174023,89.5
00,전국,075002, 71세,2016,328876,151409,177467,85.3,326774,150465,176309,85.3
00,전국,075003, 72세,2016,335203,150330,184873,81.3,333374,149555,183819,81.4
00,전국,075004, 73세,2016,346341,153958,192383,80,344726,153337,191389,80.1
00,전국,075005, 74세,2016,403197,177829,225368,78.9,401588,177235,224353,79
00,전국,080,75~79세,2016,1425031,585602,839429,69.8,1418480,583304,835176,69.8
00,전국,080001, 75세,2016,325638,140072,185566,75.5,324161,139541,184620,75.6
00,전국,080002, 76세,2016,297664,124389,173275,71.8,296267,123868,172399,71.8
00,전국,080003, 77세,2016,295636,121433,174203,69.7,294346,120972,173374,69.8
00,전국,080004, 78세,2016,264298,105485,158813,66.4,262995,105057,157938,66.5
00,전국,080005, 79세,2016,241795,94223,147572,63.8,240711,93866,146845,63.9
00,전국,085,80~84세,2016,884261,307499,576762,53.3,880699,306320,574379,53.3
00,전국,085001, 80세,2016,219554,82424,137130,60.1,218580,82084,136496,60.1
00,전국,085002, 81세,2016,207359,74149,133210,55.7,206564,73884,132680,55.7
00,전국,085003, 82세,2016,176326,60914,115412,52.8,175637,60687,114950,52.8
00,전국,085004, 83세,2016,148995,48882,100113,48.8,148380,48695,99685,48.8
00,전국,085005, 84세,2016,132027,41130,90897,45.2,131538,40970,90568,45.2
00,전국,090,85~89세,2016,400337,107281,293056,36.6,398827,106818,292009,36.6
00,전국,090001, 85세,2016,102736,29851,72885,41,102324,29721,72603,40.9
00,전국,090002, 86세,2016,96139,25587,70552,36.3,95767,25475,70292,36.2
00,전국,090003, 87세,2016,81385,22239,59146,37.6,81094,22149,58945,37.6
00,전국,090004, 88세,2016,66662,16684,49978,33.4,66418,16610,49808,33.3
00,전국,090005, 89세,2016,53415,12920,40495,31.9,53224,12863,40361,31.9
00,전국,095,90~94세,2016,130627,29532,101095,29.2,130010,29346,100664,29.2
00,전국,095001, 90세,2016,37467,8675,28792,30.1,37297,8619,28678,30.1
00,전국,095002, 91세,2016,31809,7042,24767,28.4,31676,7004,24672,28.4
00,전국,095003, 92세,2016,22785,5418,17367,31.2,22681,5388,17293,31.2
00,전국,095004, 93세,2016,22524,4980,17544,28.4,22411,4948,17463,28.3
00,전국,095005, 94세,2016,16042,3417,12625,27.1,15945,3387,12558,27
00,전국,100,95~99세,2016,28007,5550,22457,24.7,27798,5461,22337,24.4
00,전국,100001, 95세,2016,10427,2131,8296,25.7,10371,2108,8263,25.5
00,전국,100002, 96세,2016,7307,1464,5843,25.1,7261,1446,5815,24.9
00,전국,100003, 97세,2016,4844,1042,3802,27.4,4802,1024,3778,27.1
00,전국,100004, 98세,2016,3236,536,2700,19.9,3196,515,2681,19.2
00,전국,100005, 99세,2016,2193,377,1816,20.8,2168,368,1800,20.4
00,전국,101,100세이상,2016,3547,469,3078,15.2,3486,445,3041,14.6
00,전국,102,15세미만,2016,6822213,3518101,3304112,106.5,6768338,3490366,3277972,106.5
00,전국,103,15~64세,2016,37620773,19293356,18327417,105.3,36312340,18528089,17784251,104.2
00,전국,104,65세이상,2016,6826568,2885530,3941038,73.2,6775118,2863065,3912053,73.2
00,전국,086,85세이상,2016,562518,142832,419686,34,560121,142070,418051,34
00,전국,126,평균연령,2016,40.8,39.6,42,,40.9,39.7,42.1,
00,전국,127,중위연령,2016,41.6,40.3,42.9,,41.8,40.6,43,
04,읍부,000,합계,2016,4707855,2410964,2296891,105,4548051,2305977,2242074,102.9
04,읍부,005,0~4세,2016,231080,118454,112626,105.2,229170,117486,111684,105.2
04,읍부,005001, 0세,2016,42204,21658,20546,105.4,41808,21455,20353,105.4
04,읍부,005002, 1세,2016,45587,23394,22193,105.4,45192,23177,22015,105.3
04,읍부,005003, 2세,2016,45427,23191,22236,104.3,45052,23014,22038,104.4
04,읍부,005004, 3세,2016,46888,24060,22828,105.4,46502,23866,22636,105.4
04,읍부,005005, 4세,2016,50974,26151,24823,105.3,50616,25974,24642,105.4
04,읍부,010,5~9세,2016,242073,124716,117357,106.3,240812,124092,116720,106.3
04,읍부,010001, 5세,2016,50584,26006,24578,105.8,50277,25842,24435,105.8
04,읍부,010002, 6세,2016,47810,24781,23029,107.6,47525,24640,22885,107.7
04,읍부,010003, 7세,2016,46213,23763,22450,105.8,45969,23651,22318,106
04,읍부,010004, 8세,2016,48500,24969,23531,106.1,48274,24852,23422,106.1
04,읍부,010005, 9세,2016,48966,25197,23769,106,48767,25107,23660,106.1
04,읍부,015,10~14세,2016,228463,119090,109373,108.9,227743,118702,109041,108.9
04,읍부,015001, 10세,2016,44846,23298,21548,108.1,44673,23202,21471,108.1
04,읍부,015002, 11세,2016,43959,22888,21071,108.6,43798,22801,20997,108.6
04,읍부,015003, 12세,2016,46047,24037,22010,109.2,45891,23945,21946,109.1
04,읍부,015004, 13세,2016,45873,23932,21941,109.1,45768,23881,21887,109.1
04,읍부,015005, 14세,2016,47738,24935,22803,109.3,47613,24873,22740,109.4
04,읍부,020,15~19세,2016,292438,153211,139227,110,290304,152114,138190,110.1
04,읍부,020001, 15세,2016,54722,28513,26209,108.8,54566,28433,26133,108.8
04,읍부,020002, 16세,2016,61380,31730,29650,107,61203,31637,29566,107
04,읍부,020003, 17세,2016,58622,30471,28151,108.2,58376,30341,28035,108.2
04,읍부,020004, 18세,2016,58781,30763,28018,109.8,58311,30520,27791,109.8
04,읍부,020005, 19세,2016,58933,31734,27199,116.7,57848,31183,26665,116.9
04,읍부,025,20~24세,2016,294795,167499,127296,131.6,276354,155134,121220,128
04,읍부,025001, 20세,2016,60203,33150,27053,122.5,58444,32184,26260,122.6
04,읍부,025002, 21세,2016,59397,33410,25987,128.6,56703,31752,24951,127.3
04,읍부,025003, 22세,2016,58891,33747,25144,134.2,55305,31318,23987,130.6
04,읍부,025004, 23세,2016,58151,33492,24659,135.8,53376,30184,23192,130.1
04,읍부,025005, 24세,2016,58153,33700,24453,137.8,52526,29696,22830,130.1
04,읍부,030,25~29세,2016,262385,148528,113857,130.5,230096,125669,104427,120.3
04,읍부,030001, 25세,2016,53813,30826,22987,134.1,47961,26668,21293,125.2
04,읍부,030002, 26세,2016,52375,30072,22303,134.8,45704,25395,20309,125
04,읍부,030003, 27세,2016,51519,29428,22091,133.2,45112,24859,20253,122.7
04,읍부,030004, 28세,2016,51414,28838,22576,127.7,44853,24150,20703,116.6
04,읍부,030005, 29세,2016,53264,29364,23900,122.9,46466,24597,21869,112.5
04,읍부,035,30~34세,2016,316296,170075,146221,116.3,287223,149019,138204,107.8
04,읍부,035001, 30세,2016,54823,30035,24788,121.2,48511,25562,22949,111.4
04,읍부,035002, 31세,2016,56679,31048,25631,121.1,50432,26557,23875,111.2
04,읍부,035003, 32세,2016,61041,32752,28289,115.8,55253,28547,26706,106.9
04,읍부,035004, 33세,2016,67716,35942,31774,113.1,62287,31956,30331,105.4
04,읍부,035005, 34세,2016,76037,40298,35739,112.8,70740,36397,34343,106
04,읍부,040,35~39세,2016,376217,198220,177997,111.4,355974,183681,172293,106.6
04,읍부,040001, 35세,2016,76905,41174,35731,115.2,72108,37646,34462,109.2
04,읍부,040002, 36세,2016,79975,41908,38067,110.1,75580,38769,36811,105.3
04,읍부,040003, 37세,2016,75472,39477,35995,109.7,71421,36582,34839,105
04,읍부,040004, 38세,2016,70850,37163,33687,110.3,67150,34556,32594,106
04,읍부,040005, 39세,2016,73015,38498,34517,111.5,69715,36128,33587,107.6
04,읍부,045,40~44세,2016,387692,206146,181546,113.6,373179,196488,176691,111.2
04,읍부,045001, 40세,2016,71489,37974,33515,113.3,68232,35681,32551,109.6
04,읍부,045002, 41세,2016,74627,39294,35333,111.2,71686,37312,34374,108.5
04,읍부,045003, 42세,2016,80894,43082,37812,113.9,78155,41274,36881,111.9
04,읍부,045004, 43세,2016,81064,42930,38134,112.6,78303,41156,37147,110.8
04,읍부,045005, 44세,2016,79618,42866,36752,116.6,76803,41065,35738,114.9
04,읍부,050,45~49세,2016,398257,212049,186208,113.9,385592,204648,180944,113.1
04,읍부,050001, 45세,2016,84368,45376,38992,116.4,81514,43614,37900,115.1
04,읍부,050002, 46세,2016,79920,42713,37207,114.8,77166,41085,36081,113.9
04,읍부,050003, 47세,2016,80763,43059,37704,114.2,78217,41570,36647,113.4
04,읍부,050004, 48세,2016,80484,42683,37801,112.9,77976,41278,36698,112.5
04,읍부,050005, 49세,2016,72722,38218,34504,110.8,70719,37101,33618,110.4
04,읍부,055,50~54세,2016,362043,192220,169823,113.2,351015,186185,164830,113
04,읍부,055001, 50세,2016,72963,39327,33636,116.9,70721,38101,32620,116.8
04,읍부,055002, 51세,2016,72930,38398,34532,111.2,70625,37115,33510,110.8
04,읍부,055003, 52세,2016,68990,36669,32321,113.5,66759,35441,31318,113.2
04,읍부,055004, 53세,2016,71840,37999,33841,112.3,69521,36747,32774,112.1
04,읍부,055005, 54세,2016,75320,39827,35493,112.2,73389,38781,34608,112.1
04,읍부,060,55~59세,2016,360848,184595,176253,104.7,353712,180815,172897,104.6
04,읍부,060001, 55세,2016,80106,41228,38878,106,78810,40564,38246,106.1
04,읍부,060002, 56세,2016,78167,39882,38285,104.2,76391,38943,37448,104
04,읍부,060003, 57세,2016,70367,35857,34510,103.9,68995,35152,33843,103.9
04,읍부,060004, 58세,2016,66877,34330,32547,105.5,65464,33567,31897,105.2
04,읍부,060005, 59세,2016,65331,33298,32033,103.9,64052,32589,31463,103.6
04,읍부,065,60~64세,2016,270939,133964,136975,97.8,266168,131438,134730,97.6
04,읍부,065001, 60세,2016,60620,30580,30040,101.8,59450,29975,29475,101.7
04,읍부,065002, 61세,2016,61028,30095,30933,97.3,59956,29498,30458,96.8
04,읍부,065003, 62세,2016,52896,26022,26874,96.8,51862,25492,26370,96.7
04,읍부,065004, 63세,2016,45760,22539,23221,97.1,44951,22097,22854,96.7
04,읍부,065005, 64세,2016,50635,24728,25907,95.4,49949,24376,25573,95.3
04,읍부,070,65~69세,2016,203685,97744,105941,92.3,201640,96711,104929,92.2
04,읍부,070001, 65세,2016,38540,18623,19917,93.5,37989,18328,19661,93.2
04,읍부,070002, 66세,2016,40748,19493,21255,91.7,40254,19245,21009,91.6
04,읍부,070003, 67세,2016,42351,20342,22009,92.4,41927,20133,21794,92.4
04,읍부,070004, 68세,2016,41064,19711,21353,92.3,40758,19557,21201,92.2
04,읍부,070005, 69세,2016,40982,19575,21407,91.4,40712,19448,21264,91.5
04,읍부,075,70~74세,2016,170077,75542,94535,79.9,169352,75210,94142,79.9
04,읍부,075001, 70세,2016,31254,14823,16431,90.2,31062,14732,16330,90.2
04,읍부,075002, 71세,2016,31624,14491,17133,84.6,31465,14419,17046,84.6
04,읍부,075003, 72세,2016,32302,14143,18159,77.9,32164,14070,18094,77.8
04,읍부,075004, 73세,2016,34450,14852,19598,75.8,34330,14798,19532,75.8
04,읍부,075005, 74세,2016,40447,17233,23214,74.2,40331,17191,23140,74.3
04,읍부,080,75~79세,2016,150728,60189,90539,66.5,150254,60010,90244,66.5
04,읍부,080001, 75세,2016,33448,13879,19569,70.9,33338,13832,19506,70.9
04,읍부,080002, 76세,2016,31220,12733,18487,68.9,31116,12696,18420,68.9
04,읍부,080003, 77세,2016,31699,12594,19105,65.9,31618,12564,19054,65.9
04,읍부,080004, 78세,2016,28485,11123,17362,64.1,28390,11093,17297,64.1
04,읍부,080005, 79세,2016,25876,9860,16016,61.6,25792,9825,15967,61.5
04,읍부,085,80~84세,2016,97677,33267,64410,51.6,97463,33186,64277,51.6
04,읍부,085001, 80세,2016,24109,8917,15192,58.7,24058,8897,15161,58.7
04,읍부,085002, 81세,2016,22649,7940,14709,54,22599,7923,14676,54
04,읍부,085003, 82세,2016,19525,6645,12880,51.6,19484,6628,12856,51.6
04,읍부,085004, 83세,2016,16590,5369,11221,47.8,16544,5350,11194,47.8
04,읍부,085005, 84세,2016,14804,4396,10408,42.2,14778,4388,10390,42.2
04,읍부,090,85~89세,2016,44135,11555,32580,35.5,44030,11512,32518,35.4
04,읍부,090001, 85세,2016,11396,3261,8135,40.1,11364,3248,8116,40
04,읍부,090002, 86세,2016,10761,2826,7935,35.6,10741,2816,7925,35.5
04,읍부,090003, 87세,2016,8899,2343,6556,35.7,8876,2332,6544,35.6
04,읍부,090004, 88세,2016,7221,1764,5457,32.3,7206,1758,5448,32.3
04,읍부,090005, 89세,2016,5858,1361,4497,30.3,5843,1358,4485,30.3
04,읍부,095,90~94세,2016,14481,3224,11257,28.6,14439,3209,11230,28.6
04,읍부,095001, 90세,2016,4057,919,3138,29.3,4044,913,3131,29.2
04,읍부,095002, 91세,2016,3545,806,2739,29.4,3533,802,2731,29.4
04,읍부,095003, 92세,2016,2488,610,1878,32.5,2485,609,1876,32.5
04,읍부,095004, 93세,2016,2535,496,2039,24.3,2528,495,2033,24.3
04,읍부,095005, 94세,2016,1856,393,1463,26.9,1849,390,1459,26.7
04,읍부,100,95~99세,2016,3153,627,2526,24.8,3141,621,2520,24.6
04,읍부,100001, 95세,2016,1175,252,923,27.3,1173,252,921,27.4
04,읍부,100002, 96세,2016,765,160,605,26.4,758,155,603,25.7
04,읍부,100003, 97세,2016,576,120,456,26.3,573,119,454,26.2
04,읍부,100004, 98세,2016,397,57,340,16.8,397,57,340,16.8
04,읍부,100005, 99세,2016,240,38,202,18.8,240,38,202,18.8
04,읍부,101,100세이상,2016,393,49,344,14.2,390,47,343,13.7
04,읍부,102,15세미만,2016,701616,362260,339356,106.7,697725,360280,337445,106.8
04,읍부,103,15~64세,2016,3321910,1766507,1555403,113.6,3169617,1665191,1504426,110.7
04,읍부,104,65세이상,2016,684329,282197,402132,70.2,680709,280506,400203,70.1
04,읍부,086,85세이상,2016,62162,15455,46707,33.1,62000,15389,46611,33
04,읍부,126,평균연령,2016,40.8,39.4,42.3,,40.9,39.6,42.4,
04,읍부,127,중위연령,2016,41.5,40.1,42.9,,42,40.8,43.1,
05,면부,000,합계,2016,4793569,2472341,2321228,106.5,4556905,2301931,2254974,102.1
05,면부,005,0~4세,2016,140514,72107,68407,105.4,139422,71531,67891,105.4
05,면부,005001, 0세,2016,26647,13590,13057,104.1,26412,13461,12951,103.9
05,면부,005002, 1세,2016,27948,14384,13564,106,27755,14280,13475,106
05,면부,005003, 2세,2016,27568,14042,13526,103.8,27352,13931,13421,103.8
05,면부,005004, 3세,2016,28007,14478,13529,107,27809,14373,13436,107
05,면부,005005, 4세,2016,30344,15613,14731,106,30094,15486,14608,106
05,면부,010,5~9세,2016,142214,73799,68415,107.9,141316,73352,67964,107.9
05,면부,010001, 5세,2016,29533,15401,14132,109,29315,15298,14017,109.1
05,면부,010002, 6세,2016,27877,14514,13363,108.6,27702,14431,13271,108.7
05,면부,010003, 7세,2016,27211,14161,13050,108.5,27042,14075,12967,108.5
05,면부,010004, 8세,2016,28760,14826,13934,106.4,28576,14731,13845,106.4
05,면부,010005, 9세,2016,28833,14897,13936,106.9,28681,14817,13864,106.9
05,면부,015,10~14세,2016,138329,72841,65488,111.2,137831,72606,65225,111.3
05,면부,015001, 10세,2016,26439,13771,12668,108.7,26322,13715,12607,108.8
05,면부,015002, 11세,2016,25769,13439,12330,109,25669,13389,12280,109
05,면부,015003, 12세,2016,27307,14469,12838,112.7,27212,14424,12788,112.8
05,면부,015004, 13세,2016,28251,14921,13330,111.9,28171,14885,13286,112
05,면부,015005, 14세,2016,30563,16241,14322,113.4,30457,16193,14264,113.5
05,면부,020,15~19세,2016,211365,113594,97771,116.2,209222,112501,96721,116.3
05,면부,020001, 15세,2016,36194,19157,17037,112.4,36086,19100,16986,112.4
05,면부,020002, 16세,2016,40948,21620,19328,111.9,40793,21529,19264,111.8
05,면부,020003, 17세,2016,39178,20715,18463,112.2,38965,20600,18365,112.2
05,면부,020004, 18세,2016,43029,23138,19891,116.3,42571,22912,19659,116.5
05,면부,020005, 19세,2016,52016,28964,23052,125.6,50807,28360,22447,126.3
05,면부,025,20~24세,2016,270249,160572,109677,146.4,237562,137530,100032,137.5
05,면부,025001, 20세,2016,52616,29580,23036,128.4,49713,27909,21804,128
05,면부,025002, 21세,2016,52366,30393,21973,138.3,47604,27295,20309,134.4
05,면부,025003, 22세,2016,53653,31762,21891,145.1,47225,27268,19957,136.6
05,면부,025004, 23세,2016,55088,33935,21153,160.4,46537,27689,18848,146.9
05,면부,025005, 24세,2016,56526,34902,21624,161.4,46483,27369,19114,143.2
05,면부,030,25~29세,2016,257530,160402,97128,165.1,201025,117273,83752,140
05,면부,030001, 25세,2016,53381,32821,20560,159.6,42869,24847,18022,137.9
05,면부,030002, 26세,2016,52948,32931,20017,164.5,41069,23992,17077,140.5
05,면부,030003, 27세,2016,50646,31863,18783,169.6,39324,23132,16192,142.9
05,면부,030004, 28세,2016,50344,31586,18758,168.4,38821,22785,16036,142.1
05,면부,030005, 29세,2016,50211,31201,19010,164.1,38942,22517,16425,137.1
05,면부,035,30~34세,2016,258993,157297,101696,154.7,210868,119732,91136,131.4
05,면부,035001, 30세,2016,49906,31095,18811,165.3,39215,22869,16346,139.9
05,면부,035002, 31세,2016,49130,30417,18713,162.5,38698,22237,16461,135.1
05,면부,035003, 32세,2016,50147,30548,19599,155.9,40609,23017,17592,130.8
05,면부,035004, 33세,2016,53485,31889,21596,147.7,44434,24805,19629,126.4
05,면부,035005, 34세,2016,56325,33348,22977,145.1,47912,26804,21108,127
05,면부,040,35~39세,2016,262426,155495,106931,145.4,231323,131220,100103,131.1
05,면부,040001, 35세,2016,54969,32757,22212,147.5,47695,27050,20645,131
05,면부,040002, 36세,2016,55558,32667,22891,142.7,48733,27327,21406,127.7
05,면부,040003, 37세,2016,52581,31177,21404,145.7,46223,26225,19998,131.1
05,면부,040004, 38세,2016,49208,29318,19890,147.4,43507,24869,18638,133.4
05,면부,040005, 39세,2016,50110,29576,20534,144,45165,25749,19416,132.6
05,면부,045,40~44세,2016,274750,162433,112317,144.6,254598,147915,106683,138.6
05,면부,045001, 40세,2016,50151,30047,20104,149.5,45412,26471,18941,139.8
05,면부,045002, 41세,2016,51761,30591,21170,144.5,47652,27566,20086,137.2
05,면부,045003, 42세,2016,56708,33618,23090,145.6,52772,30800,21972,140.2
05,면부,045004, 43세,2016,58452,34135,24317,140.4,54770,31518,23252,135.5
05,면부,045005, 44세,2016,57678,34042,23636,144,53992,31560,22432,140.7
05,면부,050,45~49세,2016,328287,184652,143635,128.6,312795,174769,138026,126.6
05,면부,050001, 45세,2016,63114,36809,26305,139.9,59611,34454,25157,137
05,면부,050002, 46세,2016,62552,35871,26681,134.4,59091,33624,25467,132
05,면부,050003, 47세,2016,66496,37432,29064,128.8,63429,35502,27927,127.1
05,면부,050004, 48세,2016,69548,38420,31128,123.4,66579,36552,30027,121.7
05,면부,050005, 49세,2016,66577,36120,30457,118.6,64085,34637,29448,117.6
05,면부,055,50~54세,2016,375132,202786,172346,117.7,362915,195752,167163,117.1
05,면부,055001, 50세,2016,69049,38324,30725,124.7,66516,36829,29687,124.1
05,면부,055002, 51세,2016,73769,39959,33810,118.2,71155,38442,32713,117.5
05,면부,055003, 52세,2016,71031,38437,32594,117.9,68614,37045,31569,117.3
05,면부,055004, 53세,2016,76678,41114,35564,115.6,73997,39592,34405,115.1
05,면부,055005, 54세,2016,84605,44952,39653,113.4,82633,43844,38789,113
05,면부,060,55~59세,2016,458430,235833,222597,105.9,450811,231551,219260,105.6
05,면부,060001, 55세,2016,95958,49701,46257,107.4,94524,48932,45592,107.3
05,면부,060002, 56세,2016,97599,49698,47901,103.8,95673,48608,47065,103.3
05,면부,060003, 57세,2016,89813,45939,43874,104.7,88361,45154,43207,104.5
05,면부,060004, 58세,2016,87413,45268,42145,107.4,85955,44417,41538,106.9
05,면부,060005, 59세,2016,87647,45227,42420,106.6,86298,44440,41858,106.2
05,면부,065,60~64세,2016,393657,197898,195759,101.1,388994,195277,193717,100.8
05,면부,065001, 60세,2016,84440,43228,41212,104.9,83320,42575,40745,104.5
05,면부,065002, 61세,2016,86649,43591,43058,101.2,85548,42966,42582,100.9
05,면부,065003, 62세,2016,77071,38771,38300,101.2,76091,38216,37875,100.9
05,면부,065004, 63세,2016,67950,33830,34120,99.2,67178,33406,33772,98.9
05,면부,065005, 64세,2016,77547,38478,39069,98.5,76857,38114,38743,98.4
05,면부,070,65~69세,2016,326376,160406,165970,96.6,324395,159348,165047,96.5
05,면부,070001, 65세,2016,59978,29434,30544,96.4,59470,29159,30311,96.2
05,면부,070002, 66세,2016,65263,31930,33333,95.8,64786,31684,33102,95.7
05,면부,070003, 67세,2016,67402,33487,33915,98.7,66958,33234,33724,98.5
05,면부,070004, 68세,2016,66509,33006,33503,98.5,66206,32847,33359,98.5
05,면부,070005, 69세,2016,67224,32549,34675,93.9,66975,32424,34551,93.8
05,면부,075,70~74세,2016,303261,133571,169690,78.7,302539,133225,169314,78.7
05,면부,075001, 70세,2016,50938,24396,26542,91.9,50743,24299,26444,91.9
05,면부,075002, 71세,2016,53821,24329,29492,82.5,53664,24248,29416,82.4
05,면부,075003, 72세,2016,56970,24538,32432,75.7,56835,24478,32357,75.6
05,면부,075004, 73세,2016,62642,26870,35772,75.1,62524,26807,35717,75.1
05,면부,075005, 74세,2016,78890,33438,45452,73.6,78773,33393,45380,73.6
05,면부,080,75~79세,2016,305123,121185,183938,65.9,304682,121009,183673,65.9
05,면부,080001, 75세,2016,65006,27075,37931,71.4,64907,27030,37877,71.4
05,면부,080002, 76세,2016,61555,24790,36765,67.4,61452,24743,36709,67.4
05,면부,080003, 77세,2016,64565,25524,39041,65.4,64477,25484,38993,65.4
05,면부,080004, 78세,2016,58675,22656,36019,62.9,58582,22628,35954,62.9
05,면부,080005, 79세,2016,55322,21140,34182,61.8,55264,21124,34140,61.9
05,면부,085,80~84세,2016,212703,73033,139670,52.3,212522,72962,139560,52.3
05,면부,085001, 80세,2016,51346,19152,32194,59.5,51290,19129,32161,59.5
05,면부,085002, 81세,2016,49688,17323,32365,53.5,49646,17309,32337,53.5
05,면부,085003, 82세,2016,43135,14778,28357,52.1,43101,14761,28340,52.1
05,면부,085004, 83세,2016,36417,11783,24634,47.8,36389,11772,24617,47.8
05,면부,085005, 84세,2016,32117,9997,22120,45.2,32096,9991,22105,45.2
05,면부,090,85~89세,2016,95948,25910,70038,37,95859,25876,69983,37
05,면부,090001, 85세,2016,25030,7235,17795,40.7,25007,7227,17780,40.6
05,면부,090002, 86세,2016,23311,6215,17096,36.4,23288,6206,17082,36.3
05,면부,090003, 87세,2016,19273,5268,14005,37.6,19257,5262,13995,37.6
05,면부,090004, 88세,2016,15854,4074,11780,34.6,15840,4068,11772,34.6
05,면부,090005, 89세,2016,12480,3118,9362,33.3,12467,3113,9354,33.3
05,면부,095,90~94세,2016,30890,7211,23679,30.5,30854,7199,23655,30.4
05,면부,095001, 90세,2016,8907,2179,6728,32.4,8894,2173,6721,32.3
05,면부,095002, 91세,2016,7527,1803,5724,31.5,7522,1803,5719,31.5
05,면부,095003, 92세,2016,5277,1305,3972,32.9,5274,1304,3970,32.8
05,면부,095004, 93세,2016,5367,1157,4210,27.5,5358,1154,4204,27.5
05,면부,095005, 94세,2016,3812,767,3045,25.2,3806,765,3041,25.2
05,면부,100,95~99세,2016,6581,1209,5372,22.5,6566,1199,5367,22.3
05,면부,100001, 95세,2016,2432,461,1971,23.4,2428,458,1970,23.2
05,면부,100002, 96세,2016,1760,307,1453,21.1,1757,305,1452,21
05,면부,100003, 97세,2016,1116,229,887,25.8,1113,228,885,25.8
05,면부,100004, 98세,2016,787,129,658,19.6,782,125,657,19
05,면부,100005, 99세,2016,486,83,403,20.6,486,83,403,20.6
05,면부,101,100세이상,2016,811,107,704,15.2,806,104,702,14.8
05,면부,102,15세미만,2016,421057,218747,202310,108.1,418569,217489,201080,108.2
05,면부,103,15~64세,2016,3090819,1730962,1359857,127.3,2860113,1563520,1296593,120.6
05,면부,104,65세이상,2016,1281693,522632,759061,68.9,1278223,520922,757301,68.8
05,면부,086,85세이상,2016,134230,34437,99793,34.5,134085,34378,99707,34.5
05,면부,126,평균연령,2016,48.7,46,51.5,,49.4,46.9,51.9,
05,면부,127,중위연령,2016,51.6,47.9,55.4,,52.9,49.8,55.9,
03,동부,000,합계,2016,41768130,20813682,20954448,99.3,40750840,20273612,20477228,99
03,동부,005,0~4세,2016,1846784,946594,900190,105.2,1824011,934995,889016,105.2
03,동부,005001, 0세,2016,347933,178211,169722,105,342869,175602,167267,105
03,동부,005002, 1세,2016,366716,187972,178744,105.2,362150,185650,176500,105.2
03,동부,005003, 2세,2016,363827,186364,177463,105,359190,184055,175135,105.1
03,동부,005004, 3세,2016,368495,188642,179853,104.9,364083,186403,177680,104.9
03,동부,005005, 4세,2016,399813,205405,194408,105.7,395719,203285,192434,105.6
03,동부,010,5~9세,2016,1920402,988516,931886,106.1,1904995,980435,924560,106
03,동부,010001, 5세,2016,393590,202098,191492,105.5,389737,200076,189661,105.5
03,동부,010002, 6세,2016,378591,195055,183536,106.3,375082,193234,181848,106.3
03,동부,010003, 7세,2016,365987,188713,177274,106.5,363012,187147,175865,106.4
03,동부,010004, 8세,2016,386095,198654,187441,106,383355,197208,186147,105.9
03,동부,010005, 9세,2016,396139,203996,192143,106.2,393809,202770,191039,106.1
03,동부,015,10~14세,2016,1932354,1001984,930370,107.7,1923038,997167,925871,107.7
03,동부,015001, 10세,2016,363249,187870,175379,107.1,361280,186853,174427,107.1
03,동부,015002, 11세,2016,358631,185434,173197,107.1,356760,184452,172308,107
03,동부,015003, 12세,2016,394077,204090,189987,107.4,392151,203105,189046,107.4
03,동부,015004, 13세,2016,402294,208858,193436,108,400669,207997,192672,108
03,동부,015005, 14세,2016,414103,215732,198371,108.8,412178,214760,197418,108.8
03,동부,020,15~19세,2016,2580236,1339997,1240239,108,2557202,1329614,1227588,108.3
03,동부,020001, 15세,2016,472329,246076,226253,108.8,470438,245062,225376,108.7
03,동부,020002, 16세,2016,517617,270148,247469,109.2,515417,268998,246419,109.2
03,동부,020003, 17세,2016,505987,264575,241412,109.6,503264,263198,240066,109.6
03,동부,020004, 18세,2016,531817,275969,255848,107.9,526252,273486,252766,108.2
03,동부,020005, 19세,2016,552486,283229,269257,105.2,541831,278870,262961,106
03,동부,025,20~24세,2016,2987736,1570063,1417673,110.7,2886718,1523501,1363217,111.8
03,동부,025001, 20세,2016,576248,301615,274633,109.8,560247,295287,264960,111.4
03,동부,025002, 21세,2016,588588,312037,276551,112.8,570574,304452,266122,114.4
03,동부,025003, 22세,2016,599836,318423,281413,113.2,580199,309421,270778,114.3
03,동부,025004, 23세,2016,606635,318130,288505,110.3,584030,307133,276897,110.9
03,동부,025005, 24세,2016,616429,319858,296571,107.9,591668,307208,284460,108
03,동부,030,25~29세,2016,2788269,1447288,1340981,107.9,2637849,1364531,1273318,107.2
03,동부,030001, 25세,2016,586784,305144,281640,108.3,560262,291040,269222,108.1
03,동부,030002, 26세,2016,565081,295452,269629,109.6,534541,278876,255665,109.1
03,동부,030003, 27세,2016,550906,287662,263244,109.3,520809,270961,249848,108.5
03,동부,030004, 28세,2016,540952,279793,261159,107.1,509527,262423,247104,106.2
03,동부,030005, 29세,2016,544546,279237,265309,105.2,512710,261231,251479,103.9
03,동부,035,30~34세,2016,3054028,1567125,1486903,105.4,2917508,1487302,1430206,104
03,동부,035001, 30세,2016,553797,286340,267457,107.1,523194,268898,254296,105.7
03,동부,035002, 31세,2016,561446,289110,272336,106.2,533268,272828,260440,104.8
03,동부,035003, 32세,2016,588585,302363,286222,105.6,561689,286506,275183,104.1
03,동부,035004, 33세,2016,647223,331131,316092,104.8,621923,316142,305781,103.4
03,동부,035005, 34세,2016,702977,358181,344796,103.9,677434,342928,334506,102.5
03,동부,040,35~39세,2016,3363824,1709024,1654800,103.3,3264710,1648964,1615746,102.1
03,동부,040001, 35세,2016,704126,361305,342821,105.4,682544,348252,334292,104.2
03,동부,040002, 36세,2016,716790,363447,353343,102.9,696044,350885,345159,101.7
03,동부,040003, 37세,2016,680337,344877,335460,102.8,659327,332108,327219,101.5
03,동부,040004, 38세,2016,621451,315952,305499,103.4,602685,304594,298091,102.2
03,동부,040005, 39세,2016,641120,323443,317677,101.8,624110,313125,310985,100.7
03,동부,045,40~44세,2016,3489978,1755565,1734413,101.2,3404022,1704629,1699393,100.3
03,동부,045001, 40세,2016,631279,320701,310578,103.3,614286,310337,303949,102.1
03,동부,045002, 41세,2016,663347,332622,330725,100.6,647223,322933,324290,99.6
03,동부,045003, 42세,2016,723407,364007,359400,101.3,707047,354269,352778,100.4
03,동부,045004, 43세,2016,733548,364938,368610,99,715817,354625,361192,98.2
03,동부,045005, 44세,2016,738397,373297,365100,102.2,719649,362465,357184,101.5
03,동부,050,45~49세,2016,3766365,1867419,1898946,98.3,3671216,1816709,1854507,98
03,동부,050001, 45세,2016,784954,393336,391618,100.4,765177,382429,382748,99.9
03,동부,050002, 46세,2016,759435,379085,380350,99.7,739151,368064,371087,99.2
03,동부,050003, 47세,2016,766033,379892,386141,98.4,746711,369651,377060,98
03,동부,050004, 48세,2016,761084,374136,386948,96.7,741554,363944,377610,96.4
03,동부,050005, 49세,2016,694859,340970,353889,96.3,678623,332621,346002,96.1
03,동부,055,50~54세,2016,3416761,1713608,1703153,100.6,3316634,1663951,1652683,100.7
03,동부,055001, 50세,2016,678700,343694,335006,102.6,660546,334512,326034,102.6
03,동부,055002, 51세,2016,696746,344859,351887,98,676737,334861,341876,97.9
03,동부,055003, 52세,2016,653034,326768,326266,100.2,633090,316950,316140,100.3
03,동부,055004, 53세,2016,688559,346667,341892,101.4,665043,335120,329923,101.6
03,동부,055005, 54세,2016,699722,351620,348102,101,681218,342508,338710,101.1
03,동부,060,55~59세,2016,3346230,1649548,1696682,97.2,3271527,1613335,1658192,97.3
03,동부,060001, 55세,2016,741769,365315,376454,97,729662,359551,370111,97.1
03,동부,060002, 56세,2016,735406,359695,375711,95.7,717269,350961,366308,95.8
03,동부,060003, 57세,2016,654695,322468,332227,97.1,640117,315298,324819,97.1
03,동부,060004, 58세,2016,615500,306006,309494,98.9,600352,298714,301638,99
03,동부,060005, 59세,2016,598860,296064,302796,97.8,584127,288811,295316,97.8
03,동부,065,60~64세,2016,2414617,1176250,1238367,95,2355224,1146842,1208382,94.9
03,동부,065001, 60세,2016,547935,269620,278315,96.9,534241,262859,271382,96.9
03,동부,065002, 61세,2016,557108,269385,287723,93.6,543147,262416,280731,93.5
03,동부,065003, 62세,2016,466055,228703,237352,96.4,453572,222513,231059,96.3
03,동부,065004, 63세,2016,406935,196764,210171,93.6,396615,191657,204958,93.5
03,동부,065005, 64세,2016,436584,211778,224806,94.2,427649,207397,220252,94.2
03,동부,070,65~69세,2016,1678474,800839,877635,91.2,1653489,788911,864578,91.2
03,동부,070001, 65세,2016,320899,155037,165862,93.5,313679,151504,162175,93.4
03,동부,070002, 66세,2016,344946,166182,178764,93,338922,163270,175652,93
03,동부,070003, 67세,2016,347111,165799,181312,91.4,341843,163275,178568,91.4
03,동부,070004, 68세,2016,335390,159625,175765,90.8,331939,158043,173896,90.9
03,동부,070005, 69세,2016,330128,154196,175932,87.6,327106,152819,174287,87.7
03,동부,075,70~74세,2016,1272885,581495,691390,84.1,1264403,577966,686437,84.2
03,동부,075001, 70세,2016,250414,117863,132551,88.9,248027,116778,131249,89
03,동부,075002, 71세,2016,243431,112589,130842,86,241645,111798,129847,86.1
03,동부,075003, 72세,2016,245931,111649,134282,83.1,244375,111007,133368,83.2
03,동부,075004, 73세,2016,249249,112236,137013,81.9,247872,111732,136140,82.1
03,동부,075005, 74세,2016,283860,127158,156702,81.1,282484,126651,155833,81.3
03,동부,080,75~79세,2016,969180,404228,564952,71.6,963544,402285,561259,71.7
03,동부,080001, 75세,2016,227184,99118,128066,77.4,225916,98679,127237,77.6
03,동부,080002, 76세,2016,204889,86866,118023,73.6,203699,86429,117270,73.7
03,동부,080003, 77세,2016,199372,83315,116057,71.8,198251,82924,115327,71.9
03,동부,080004, 78세,2016,177138,71706,105432,68,176023,71336,104687,68.1
03,동부,080005, 79세,2016,160597,63223,97374,64.9,159655,62917,96738,65
03,동부,085,80~84세,2016,573881,201199,372682,54,570714,200172,370542,54
03,동부,085001, 80세,2016,144099,54355,89744,60.6,143232,54058,89174,60.6
03,동부,085002, 81세,2016,135022,48886,86136,56.8,134319,48652,85667,56.8
03,동부,085003, 82세,2016,113666,39491,74175,53.2,113052,39298,73754,53.3
03,동부,085004, 83세,2016,95988,31730,64258,49.4,95447,31573,63874,49.4
03,동부,085005, 84세,2016,85106,26737,58369,45.8,84664,26591,58073,45.8
03,동부,090,85~89세,2016,260254,69816,190438,36.7,258938,69430,189508,36.6
03,동부,090001, 85세,2016,66310,19355,46955,41.2,65953,19246,46707,41.2
03,동부,090002, 86세,2016,62067,16546,45521,36.3,61738,16453,45285,36.3
03,동부,090003, 87세,2016,53213,14628,38585,37.9,52961,14555,38406,37.9
03,동부,090004, 88세,2016,43587,10846,32741,33.1,43372,10784,32588,33.1
03,동부,090005, 89세,2016,35077,8441,26636,31.7,34914,8392,26522,31.6
03,동부,095,90~94세,2016,85256,19097,66159,28.9,84717,18938,65779,28.8
03,동부,095001, 90세,2016,24503,5577,18926,29.5,24359,5533,18826,29.4
03,동부,095002, 91세,2016,20737,4433,16304,27.2,20621,4399,16222,27.1
03,동부,095003, 92세,2016,15020,3503,11517,30.4,14922,3475,11447,30.4
03,동부,095004, 93세,2016,14622,3327,11295,29.5,14525,3299,11226,29.4
03,동부,095005, 94세,2016,10374,2257,8117,27.8,10290,2232,8058,27.7
03,동부,100,95~99세,2016,18273,3714,14559,25.5,18091,3641,14450,25.2
03,동부,100001, 95세,2016,6820,1418,5402,26.2,6770,1398,5372,26
03,동부,100002, 96세,2016,4782,997,3785,26.3,4746,986,3760,26.2
03,동부,100003, 97세,2016,3152,693,2459,28.2,3116,677,2439,27.8
03,동부,100004, 98세,2016,2052,350,1702,20.6,2017,333,1684,19.8
03,동부,100005, 99세,2016,1467,256,1211,21.1,1442,247,1195,20.7
03,동부,101,100세이상,2016,2343,313,2030,15.4,2290,294,1996,14.7
03,동부,102,15세미만,2016,5699540,2937094,2762446,106.3,5652044,2912597,2739447,106.3
03,동부,103,15~64세,2016,31208044,15795887,15412157,102.5,30282610,15299378,14983232,102.1
03,동부,104,65세이상,2016,4860546,2080701,2779845,74.8,4816186,2061637,2754549,74.8
03,동부,086,85세이상,2016,366126,92940,273186,34,364036,92303,271733,34
03,동부,126,평균연령,2016,39.9,38.9,41,,39.9,38.9,41,
03,동부,127,중위연령,2016,40.7,39.5,41.8,,40.7,39.6,41.9,
11,서울특별시,000,합계,2016,9805506,4799115,5006391,95.9,9470339,4636374,4833965,95.9
11,서울특별시,005,0~4세,2016,378946,194318,184628,105.2,371239,190370,180869,105.3
11,서울특별시,005001, 0세,2016,76051,38995,37056,105.2,74408,38147,36261,105.2
11,서울특별시,005002, 1세,2016,76803,39392,37411,105.3,75254,38603,36651,105.3
11,서울특별시,005003, 2세,2016,74314,38014,36300,104.7,72780,37237,35543,104.8
11,서울특별시,005004, 3세,2016,73424,37636,35788,105.2,71886,36859,35027,105.2
11,서울특별시,005005, 4세,2016,78354,40281,38073,105.8,76911,39524,37387,105.7
11,서울특별시,010,5~9세,2016,371005,190385,180620,105.4,365059,187265,177794,105.3
11,서울특별시,010001, 5세,2016,76007,38928,37079,105,74541,38169,36372,104.9
11,서울특별시,010002, 6세,2016,73200,37653,35547,105.9,71876,36971,34905,105.9
11,서울특별시,010003, 7세,2016,70215,35963,34252,105,69047,35342,33705,104.9
11,서울특별시,010004, 8세,2016,74863,38463,36400,105.7,73816,37899,35917,105.5
11,서울특별시,010005, 9세,2016,76720,39378,37342,105.5,75779,38884,36895,105.4
11,서울특별시,015,10~14세,2016,380447,196525,183922,106.9,376506,194431,182075,106.8
11,서울특별시,015001, 10세,2016,70923,36589,34334,106.6,70106,36150,33956,106.5
11,서울특별시,015002, 11세,2016,70326,36395,33931,107.3,69541,35979,33562,107.2
11,서울특별시,015003, 12세,2016,78226,40370,37856,106.6,77401,39947,37454,106.7
11,서울특별시,015004, 13세,2016,79056,40783,38273,106.6,78360,40411,37949,106.5
11,서울특별시,015005, 14세,2016,81916,42388,39528,107.2,81098,41944,39154,107.1
11,서울특별시,020,15~19세,2016,526432,267296,259136,103.1,516892,263408,253484,103.9
11,서울특별시,020001, 15세,2016,92522,48021,44501,107.9,91749,47615,44134,107.9
11,서울특별시,020002, 16세,2016,102106,52712,49394,106.7,101215,52234,48981,106.6
11,서울특별시,020003, 17세,2016,101047,52420,48627,107.8,99971,51889,48082,107.9
11,서울특별시,020004, 18세,2016,109225,55460,53765,103.2,106904,54569,52335,104.3
11,서울특별시,020005, 19세,2016,121532,58683,62849,93.4,117053,57101,59952,95.2
11,서울특별시,025,20~24세,2016,707555,346503,361052,96,673957,334376,339581,98.5
11,서울특별시,025001, 20세,2016,128871,62461,66410,94.1,122595,60431,62164,97.2
11,서울특별시,025002, 21세,2016,133375,66131,67244,98.3,127012,63925,63087,101.3
11,서울특별시,025003, 22세,2016,140098,69393,70705,98.1,133635,67103,66532,100.9
11,서울특별시,025004, 23세,2016,148765,72945,75820,96.2,141653,70263,71390,98.4
11,서울특별시,025005, 24세,2016,156446,75573,80873,93.4,149062,72654,76408,95.1
11,서울특별시,030,25~29세,2016,761584,375184,386400,97.1,720334,356094,364240,97.8
11,서울특별시,030001, 25세,2016,155212,75721,79491,95.3,147644,72476,75168,96.4
11,서울특별시,030002, 26세,2016,153267,75663,77604,97.5,144699,71850,72849,98.6
11,서울특별시,030003, 27세,2016,151339,75186,76153,98.7,143178,71358,71820,99.4
11,서울특별시,030004, 28세,2016,150992,74558,76434,97.5,142487,70486,72001,97.9
11,서울특별시,030005, 29세,2016,150774,74056,76718,96.5,142326,69924,72402,96.6
11,서울특별시,035,30~34세,2016,807246,405165,402081,100.8,772614,387306,385308,100.5
11,서울특별시,035001, 30세,2016,152940,76328,76612,99.6,144890,72246,72644,99.5
11,서울특별시,035002, 31세,2016,152878,76275,76603,99.6,145844,72765,73079,99.6
11,서울특별시,035003, 32세,2016,156848,78914,77934,101.3,150150,75432,74718,101
11,서울특별시,035004, 33세,2016,167937,84672,83265,101.7,161530,81355,80175,101.5
11,서울특별시,035005, 34세,2016,176643,88976,87667,101.5,170200,85508,84692,101
11,서울특별시,040,35~39세,2016,798944,403974,394970,102.3,773379,389706,383673,101.6
11,서울특별시,040001, 35세,2016,173352,88663,84689,104.7,168035,85803,82232,104.3
11,서울특별시,040002, 36세,2016,172333,86989,85344,101.9,167081,84094,82987,101.3
11,서울특별시,040003, 37세,2016,161685,81555,80130,101.8,156282,78494,77788,100.9
11,서울특별시,040004, 38세,2016,143716,72606,71110,102.1,138624,69740,68884,101.2
11,서울특별시,040005, 39세,2016,147858,74161,73697,100.6,143357,71575,71782,99.7
11,서울특별시,045,40~44세,2016,789416,396847,392569,101.1,764037,382466,381571,100.2
11,서울특별시,045001, 40세,2016,144575,73298,71277,102.8,139919,70660,69259,102
11,서울특별시,045002, 41세,2016,149441,74876,74565,100.4,145112,72420,72692,99.6
11,서울특별시,045003, 42세,2016,162066,81577,80489,101.4,157168,78764,78404,100.5
11,서울특별시,045004, 43세,2016,164781,82102,82679,99.3,159248,78929,80319,98.3
11,서울특별시,045005, 44세,2016,168553,84994,83559,101.7,162590,81693,80897,101
11,서울특별시,050,45~49세,2016,842448,414847,427601,97,809914,398078,411836,96.7
11,서울특별시,050001, 45세,2016,178580,89259,89321,99.9,172157,85858,86299,99.5
11,서울특별시,050002, 46세,2016,171826,85069,86757,98.1,165053,81544,83509,97.6
11,서울특별시,050003, 47세,2016,171426,84658,86768,97.6,164758,81224,83534,97.2
11,서울특별시,050004, 48세,2016,167521,81755,85766,95.3,160618,78235,82383,95
11,서울특별시,050005, 49세,2016,153095,74106,78989,93.8,147328,71217,76111,93.6
11,서울특별시,055,50~54세,2016,773918,380832,393086,96.9,734368,361428,372940,96.9
11,서울특별시,055001, 50세,2016,148661,74455,74206,100.3,141860,71049,70811,100.3
11,서울특별시,055002, 51세,2016,156352,75984,80368,94.5,148683,72215,76468,94.4
11,서울특별시,055003, 52세,2016,150833,74018,76815,96.4,142915,70187,72728,96.5
11,서울특별시,055004, 53세,2016,158574,77718,80856,96.1,149070,73113,75957,96.3
11,서울특별시,055005, 54세,2016,159498,78657,80841,97.3,151840,74864,76976,97.3
11,서울특별시,060,55~59세,2016,795249,379327,415922,91.2,763943,364202,399741,91.1
11,서울특별시,060001, 55세,2016,166918,79622,87296,91.2,162096,77357,84739,91.3
11,서울특별시,060002, 56세,2016,171940,81153,90787,89.4,164342,77476,86866,89.2
11,서울특별시,060003, 57세,2016,156433,74752,81681,91.5,150395,71777,78618,91.3
11,서울특별시,060004, 58세,2016,151044,72671,78373,92.7,144621,69624,74997,92.8
11,서울특별시,060005, 59세,2016,148914,71129,77785,91.4,142489,67968,74521,91.2
11,서울특별시,065,60~64세,2016,624370,296875,327495,90.7,598732,284156,314576,90.3
11,서울특별시,065001, 60세,2016,138525,66094,72431,91.3,132646,63202,69444,91
11,서울특별시,065002, 61세,2016,143751,67610,76141,88.8,137672,64559,73113,88.3
11,서울특별시,065003, 62세,2016,121228,57926,63302,91.5,115785,55263,60522,91.3
11,서울특별시,065004, 63세,2016,107226,50949,56277,90.5,102791,48741,54050,90.2
11,서울특별시,065005, 64세,2016,113640,54296,59344,91.5,109838,52391,57447,91.2
11,서울특별시,070,65~69세,2016,445759,210655,235104,89.6,435313,205629,229684,89.5
11,서울특별시,070001, 65세,2016,82667,39378,43289,91,79617,37856,41761,90.6
11,서울특별시,070002, 66세,2016,91861,43792,48069,91.1,89353,42553,46800,90.9
11,서울특별시,070003, 67세,2016,92597,43621,48976,89.1,90353,42529,47824,88.9
11,서울특별시,070004, 68세,2016,89086,42201,46885,90,87668,41581,46087,90.2
11,서울특별시,070005, 69세,2016,89548,41663,47885,87,88322,41110,47212,87.1
11,서울특별시,075,70~74세,2016,340467,159146,181321,87.8,336992,157699,179293,88
11,서울특별시,075001, 70세,2016,69555,32454,37101,87.5,68585,31996,36589,87.4
11,서울특별시,075002, 71세,2016,66331,31107,35224,88.3,65618,30797,34821,88.4
11,서울특별시,075003, 72세,2016,65258,30334,34924,86.9,64629,30073,34556,87
11,서울특별시,075004, 73세,2016,65214,30455,34759,87.6,64629,30239,34390,87.9
11,서울특별시,075005, 74세,2016,74109,34796,39313,88.5,73531,34594,38937,88.8
11,서울특별시,080,75~79세,2016,242974,107446,135528,79.3,240627,106687,133940,79.7
11,서울특별시,080001, 75세,2016,58753,27098,31655,85.6,58236,26935,31301,86.1
11,서울특별시,080002, 76세,2016,51973,23367,28606,81.7,51468,23193,28275,82
11,서울특별시,080003, 77세,2016,49798,22077,27721,79.6,49298,21911,27387,80
11,서울특별시,080004, 78세,2016,43470,18691,24779,75.4,43026,18552,24474,75.8
11,서울특별시,080005, 79세,2016,38980,16213,22767,71.2,38599,16096,22503,71.5
11,서울특별시,085,80~84세,2016,133706,50285,83421,60.3,132351,49862,82489,60.4
11,서울특별시,085001, 80세,2016,34221,13831,20390,67.8,33855,13713,20142,68.1
11,서울특별시,085002, 81세,2016,31967,12326,19641,62.8,31676,12223,19453,62.8
11,서울특별시,085003, 82세,2016,26164,9655,16509,58.5,25914,9584,16330,58.7
11,서울특별시,085004, 83세,2016,21951,7818,14133,55.3,21713,7755,13958,55.6
11,서울특별시,085005, 84세,2016,19403,6655,12748,52.2,19193,6587,12606,52.3
11,서울특별시,090,85~89세,2016,59914,17431,42483,41,59317,17258,42059,41
11,서울특별시,090001, 85세,2016,15148,4789,10359,46.2,14983,4744,10239,46.3
11,서울특별시,090002, 86세,2016,14185,4101,10084,40.7,14023,4060,9963,40.8
11,서울특별시,090003, 87세,2016,12325,3712,8613,43.1,12220,3678,8542,43.1
11,서울특별시,090004, 88세,2016,10164,2743,7421,37,10073,2713,7360,36.9
11,서울특별시,090005, 89세,2016,8092,2086,6006,34.7,8018,2063,5955,34.6
11,서울특별시,095,90~94세,2016,20085,4909,15176,32.3,19842,4833,15009,32.2
11,서울특별시,095001, 90세,2016,5832,1391,4441,31.3,5770,1371,4399,31.2
11,서울특별시,095002, 91세,2016,4700,1099,3601,30.5,4649,1083,3566,30.4
11,서울특별시,095003, 92세,2016,3677,945,2732,34.6,3630,932,2698,34.5
11,서울특별시,095004, 93세,2016,3408,902,2506,36,3360,886,2474,35.8
11,서울특별시,095005, 94세,2016,2468,572,1896,30.2,2433,561,1872,30
11,서울특별시,100,95~99세,2016,4448,1074,3374,31.8,4358,1037,3321,31.2
11,서울특별시,100001, 95세,2016,1658,411,1247,33,1634,400,1234,32.4
11,서울특별시,100002, 96세,2016,1190,298,892,33.4,1174,294,880,33.4
11,서울특별시,100003, 97세,2016,752,190,562,33.8,732,180,552,32.6
11,서울특별시,100004, 98세,2016,480,89,391,22.8,467,82,385,21.3
11,서울특별시,100005, 99세,2016,368,86,282,30.5,351,81,270,30
11,서울특별시,101,100세이상,2016,593,91,502,18.1,565,83,482,17.2
11,서울특별시,102,15세미만,2016,1130398,581228,549170,105.8,1112804,572066,540738,105.8
11,서울특별시,103,15~64세,2016,7427162,3666850,3760312,97.5,7128170,3521220,3606950,97.6
11,서울특별시,104,65세이상,2016,1247946,551037,696909,79.1,1229365,543088,686277,79.1
11,서울특별시,086,85세이상,2016,85040,23505,61535,38.2,84082,23211,60871,38.1
11,서울특별시,126,평균연령,2016,41,40.2,41.8,,41,40.1,41.8,
11,서울특별시,127,중위연령,2016,41.2,40.3,42.1,,41.2,40.2,42.1,
11010, 종로구,000,합계,2016,154398,75620,78778,96,144049,70844,73205,96.8
11010, 종로구,005,0~4세,2016,4285,2208,2077,106.3,4137,2130,2007,106.1
11010, 종로구,005001, 0세,2016,838,434,404,107.4,809,420,389,108
11010, 종로구,005002, 1세,2016,819,426,393,108.4,794,415,379,109.5
11010, 종로구,005003, 2세,2016,858,417,441,94.6,825,397,428,92.8
11010, 종로구,005004, 3세,2016,818,423,395,107.1,792,412,380,108.4
11010, 종로구,005005, 4세,2016,952,508,444,114.4,917,486,431,112.8
11010, 종로구,010,5~9세,2016,4537,2338,2199,106.3,4392,2261,2131,106.1
11010, 종로구,010001, 5세,2016,869,443,426,104,827,421,406,103.7
11010, 종로구,010002, 6세,2016,897,460,437,105.3,865,441,424,104
11010, 종로구,010003, 7세,2016,863,444,419,106,839,433,406,106.7
11010, 종로구,010004, 8세,2016,914,480,434,110.6,891,467,424,110.1
11010, 종로구,010005, 9세,2016,994,511,483,105.8,970,499,471,105.9
11010, 종로구,015,10~14세,2016,5125,2638,2487,106.1,5001,2573,2428,106
11010, 종로구,015001, 10세,2016,911,488,423,115.4,887,474,413,114.8
11010, 종로구,015002, 11세,2016,909,462,447,103.4,880,450,430,104.7
11010, 종로구,015003, 12세,2016,1044,528,516,102.3,1014,512,502,102
11010, 종로구,015004, 13세,2016,1125,579,546,106,1107,571,536,106.5
11010, 종로구,015005, 14세,2016,1136,581,555,104.7,1113,566,547,103.5
11010, 종로구,020,15~19세,2016,10374,5352,5022,106.6,9654,5098,4556,111.9
11010, 종로구,020001, 15세,2016,1501,835,666,125.4,1478,825,653,126.3
11010, 종로구,020002, 16세,2016,2220,1278,942,135.7,2186,1262,924,136.6
11010, 종로구,020003, 17세,2016,1731,922,809,114,1688,904,784,115.3
11010, 종로구,020004, 18세,2016,2144,1071,1073,99.8,1948,1011,937,107.9
11010, 종로구,020005, 19세,2016,2778,1246,1532,81.3,2354,1096,1258,87.1
11010, 종로구,025,20~24세,2016,14209,6698,7511,89.2,12024,5931,6093,97.3
11010, 종로구,025001, 20세,2016,2841,1245,1596,78,2332,1089,1243,87.6
11010, 종로구,025002, 21세,2016,2704,1217,1487,81.8,2212,1053,1159,90.9
11010, 종로구,025003, 22세,2016,2750,1265,1485,85.2,2323,1120,1203,93.1
11010, 종로구,025004, 23세,2016,2963,1444,1519,95.1,2563,1285,1278,100.5
11010, 종로구,025005, 24세,2016,2951,1527,1424,107.2,2594,1384,1210,114.4
11010, 종로구,030,25~29세,2016,13185,6881,6304,109.2,11887,6262,5625,111.3
11010, 종로구,030001, 25세,2016,2893,1497,1396,107.2,2632,1379,1253,110.1
11010, 종로구,030002, 26세,2016,2770,1456,1314,110.8,2496,1335,1161,115
11010, 종로구,030003, 27세,2016,2580,1360,1220,111.5,2339,1248,1091,114.4
11010, 종로구,030004, 28세,2016,2551,1361,1190,114.4,2272,1219,1053,115.8
11010, 종로구,030005, 29세,2016,2391,1207,1184,101.9,2148,1081,1067,101.3
11010, 종로구,035,30~34세,2016,11082,5672,5410,104.8,10070,5145,4925,104.5
11010, 종로구,035001, 30세,2016,2301,1200,1101,109,2056,1065,991,107.5
11010, 종로구,035002, 31세,2016,2221,1141,1080,105.6,2007,1039,968,107.3
11010, 종로구,035003, 32세,2016,2206,1132,1074,105.4,2003,1027,976,105.2
11010, 종로구,035004, 33세,2016,2106,1059,1047,101.1,1946,980,966,101.4
11010, 종로구,035005, 34세,2016,2248,1140,1108,102.9,2058,1034,1024,101
11010, 종로구,040,35~39세,2016,10226,5067,5159,98.2,9527,4654,4873,95.5
11010, 종로구,040001, 35세,2016,2219,1120,1099,101.9,2066,1027,1039,98.8
11010, 종로구,040002, 36세,2016,2181,1090,1091,99.9,2029,1005,1024,98.1
11010, 종로구,040003, 37세,2016,2059,1019,1040,98,1924,938,986,95.1
11010, 종로구,040004, 38세,2016,1838,910,928,98.1,1697,819,878,93.3
11010, 종로구,040005, 39세,2016,1929,928,1001,92.7,1811,865,946,91.4
11010, 종로구,045,40~44세,2016,11374,5651,5723,98.7,10648,5231,5417,96.6
11010, 종로구,045001, 40세,2016,2006,1028,978,105.1,1869,937,932,100.5
11010, 종로구,045002, 41세,2016,2055,1008,1047,96.3,1925,934,991,94.2
11010, 종로구,045003, 42세,2016,2307,1126,1181,95.3,2166,1050,1116,94.1
11010, 종로구,045004, 43세,2016,2390,1139,1251,91,2255,1063,1192,89.2
11010, 종로구,045005, 44세,2016,2616,1350,1266,106.6,2433,1247,1186,105.1
11010, 종로구,050,45~49세,2016,13005,6356,6649,95.6,12215,5937,6278,94.6
11010, 종로구,050001, 45세,2016,2761,1401,1360,103,2605,1317,1288,102.3
11010, 종로구,050002, 46세,2016,2641,1286,1355,94.9,2472,1188,1284,92.5
11010, 종로구,050003, 47세,2016,2583,1243,1340,92.8,2427,1161,1266,91.7
11010, 종로구,050004, 48세,2016,2613,1258,1355,92.8,2440,1178,1262,93.3
11010, 종로구,050005, 49세,2016,2407,1168,1239,94.3,2271,1093,1178,92.8
11010, 종로구,055,50~54세,2016,12342,6188,6154,100.6,11481,5786,5695,101.6
11010, 종로구,055001, 50세,2016,2349,1140,1209,94.3,2190,1068,1122,95.2
11010, 종로구,055002, 51세,2016,2450,1181,1269,93.1,2281,1109,1172,94.6
11010, 종로구,055003, 52세,2016,2499,1257,1242,101.2,2309,1171,1138,102.9
11010, 종로구,055004, 53세,2016,2501,1278,1223,104.5,2341,1204,1137,105.9
11010, 종로구,055005, 54세,2016,2543,1332,1211,110,2360,1234,1126,109.6
11010, 종로구,060,55~59세,2016,12334,6028,6306,95.6,11636,5726,5910,96.9
11010, 종로구,060001, 55세,2016,2634,1253,1381,90.7,2545,1215,1330,91.4
11010, 종로구,060002, 56세,2016,2652,1232,1420,86.8,2489,1160,1329,87.3
11010, 종로구,060003, 57세,2016,2450,1265,1185,106.8,2301,1201,1100,109.2
11010, 종로구,060004, 58세,2016,2372,1186,1186,100,2213,1119,1094,102.3
11010, 종로구,060005, 59세,2016,2226,1092,1134,96.3,2088,1031,1057,97.5
11010, 종로구,065,60~64세,2016,9673,4746,4927,96.3,9159,4498,4661,96.5
11010, 종로구,065001, 60세,2016,2168,1081,1087,99.4,2045,1020,1025,99.5
11010, 종로구,065002, 61세,2016,2199,1055,1144,92.2,2070,989,1081,91.5
11010, 종로구,065003, 62세,2016,1909,946,963,98.2,1805,904,901,100.3
11010, 종로구,065004, 63세,2016,1654,794,860,92.3,1566,756,810,93.3
11010, 종로구,065005, 64세,2016,1743,870,873,99.7,1673,829,844,98.2
11010, 종로구,070,65~69세,2016,6991,3226,3765,85.7,6760,3117,3643,85.6
11010, 종로구,070001, 65세,2016,1245,572,673,85,1178,543,635,85.5
11010, 종로구,070002, 66세,2016,1412,658,754,87.3,1349,633,716,88.4
11010, 종로구,070003, 67세,2016,1433,672,761,88.3,1394,650,744,87.4
11010, 종로구,070004, 68세,2016,1449,671,778,86.2,1418,653,765,85.4
11010, 종로구,070005, 69세,2016,1452,653,799,81.7,1421,638,783,81.5
11010, 종로구,075,70~74세,2016,6136,2735,3401,80.4,6057,2708,3349,80.9
11010, 종로구,075001, 70세,2016,1157,523,634,82.5,1142,519,623,83.3
11010, 종로구,075002, 71세,2016,1174,513,661,77.6,1152,507,645,78.6
11010, 종로구,075003, 72세,2016,1176,490,686,71.4,1160,482,678,71.1
11010, 종로구,075004, 73세,2016,1228,573,655,87.5,1216,570,646,88.2
11010, 종로구,075005, 74세,2016,1401,636,765,83.1,1387,630,757,83.2
11010, 종로구,080,75~79세,2016,4847,2132,2715,78.5,4786,2108,2678,78.7
11010, 종로구,080001, 75세,2016,1163,528,635,83.1,1145,520,625,83.2
11010, 종로구,080002, 76세,2016,1029,466,563,82.8,1019,462,557,82.9
11010, 종로구,080003, 77세,2016,1028,447,581,76.9,1020,443,577,76.8
11010, 종로구,080004, 78세,2016,854,356,498,71.5,839,354,485,73
11010, 종로구,080005, 79세,2016,773,335,438,76.5,763,329,434,75.8
11010, 종로구,085,80~84세,2016,2792,1108,1684,65.8,2760,1094,1666,65.7
11010, 종로구,085001, 80세,2016,706,300,406,73.9,701,299,402,74.4
11010, 종로구,085002, 81세,2016,669,277,392,70.7,659,269,390,69
11010, 종로구,085003, 82세,2016,572,211,361,58.4,566,210,356,59
11010, 종로구,085004, 83세,2016,453,161,292,55.1,446,160,286,55.9
11010, 종로구,085005, 84세,2016,392,159,233,68.2,388,156,232,67.2
11010, 종로구,090,85~89세,2016,1284,428,856,50,1267,422,845,49.9
11010, 종로구,090001, 85세,2016,349,119,230,51.7,345,118,227,52
11010, 종로구,090002, 86세,2016,306,93,213,43.7,298,90,208,43.3
11010, 종로구,090003, 87세,2016,262,99,163,60.7,258,97,161,60.2
11010, 종로구,090004, 88세,2016,205,62,143,43.4,204,62,142,43.7
11010, 종로구,090005, 89세,2016,162,55,107,51.4,162,55,107,51.4
11010, 종로구,095,90~94세,2016,458,133,325,40.9,454,132,322,41
11010, 종로구,095001, 90세,2016,142,41,101,40.6,141,40,101,39.6
11010, 종로구,095002, 91세,2016,110,33,77,42.9,109,33,76,43.4
11010, 종로구,095003, 92세,2016,75,18,57,31.6,73,18,55,32.7
11010, 종로구,095004, 93세,2016,67,19,48,39.6,67,19,48,39.6
11010, 종로구,095005, 94세,2016,64,22,42,52.4,64,22,42,52.4
11010, 종로구,100,95~99세,2016,116,29,87,33.3,114,28,86,32.6
11010, 종로구,100001, 95세,2016,40,12,28,42.9,39,11,28,39.3
11010, 종로구,100002, 96세,2016,31,6,25,24,31,6,25,24
11010, 종로구,100003, 97세,2016,19,5,14,35.7,18,5,13,38.5
11010, 종로구,100004, 98세,2016,14,X,11,27.3,14,X,11,27.3
11010, 종로구,100005, 99세,2016,12,X,9,33.3,12,X,9,33.3
11010, 종로구,101,100세이상,2016,23,6,17,35.3,20,X,17,17.6
11010, 종로구,102,15세미만,2016,13947,7184,6763,106.2,13530,6964,6566,106.1
11010, 종로구,103,15~64세,2016,117804,58639,59165,99.1,108301,54268,54033,100.4
11010, 종로구,104,65세이상,2016,22647,9797,12850,76.2,22218,9612,12606,76.2
11010, 종로구,086,85세이상,2016,1881,596,1285,46.4,1855,585,1270,46.1
11010, 종로구,126,평균연령,2016,41.9,41,42.8,,42.3,41.2,43.3,
11010, 종로구,127,중위연령,2016,42,40.9,43,,42.7,41.5,43.8,
11020, 중구,000,합계,2016,128160,62514,65646,95.2,117960,57677,60283,95.7
11020, 중구,005,0~4세,2016,4431,2309,2122,108.8,4166,2151,2015,106.7
11020, 중구,005001, 0세,2016,931,484,447,108.3,873,451,422,106.9
11020, 중구,005002, 1세,2016,873,437,436,100.2,821,407,414,98.3
11020, 중구,005003, 2세,2016,884,453,431,105.1,833,425,408,104.2
11020, 중구,005004, 3세,2016,854,454,400,113.5,799,416,383,108.6
11020, 중구,005005, 4세,2016,889,481,408,117.9,840,452,388,116.5
11020, 중구,010,5~9세,2016,3864,1932,1932,100,3642,1807,1835,98.5
11020, 중구,010001, 5세,2016,862,425,437,97.3,803,391,412,94.9
11020, 중구,010002, 6세,2016,786,410,376,109,741,385,356,108.1
11020, 중구,010003, 7세,2016,669,335,334,100.3,633,313,320,97.8
11020, 중구,010004, 8세,2016,757,363,394,92.1,720,347,373,93
11020, 중구,010005, 9세,2016,790,399,391,102,745,371,374,99.2
11020, 중구,015,10~14세,2016,3282,1648,1634,100.9,3131,1567,1564,100.2
11020, 중구,015001, 10세,2016,637,315,322,97.8,609,296,313,94.6
11020, 중구,015002, 11세,2016,628,311,317,98.1,592,298,294,101.4
11020, 중구,015003, 12세,2016,700,354,346,102.3,662,333,329,101.2
11020, 중구,015004, 13세,2016,629,318,311,102.3,610,308,302,102
11020, 중구,015005, 14세,2016,688,350,338,103.6,658,332,326,101.8
11020, 중구,020,15~19세,2016,6317,2762,3555,77.7,5930,2611,3319,78.7
11020, 중구,020001, 15세,2016,885,432,453,95.4,857,421,436,96.6
11020, 중구,020002, 16세,2016,1219,501,718,69.8,1180,483,697,69.3
11020, 중구,020003, 17세,2016,1039,484,555,87.2,1001,461,540,85.4
11020, 중구,020004, 18세,2016,1292,545,747,73,1188,505,683,73.9
11020, 중구,020005, 19세,2016,1882,800,1082,73.9,1704,741,963,76.9
11020, 중구,025,20~24세,2016,10165,4910,5255,93.4,8877,4438,4439,100
11020, 중구,025001, 20세,2016,1874,816,1058,77.1,1618,720,898,80.2
11020, 중구,025002, 21세,2016,1772,825,947,87.1,1528,731,797,91.7
11020, 중구,025003, 22세,2016,1976,960,1016,94.5,1735,880,855,102.9
11020, 중구,025004, 23세,2016,2197,1105,1092,101.2,1924,1014,910,111.4
11020, 중구,025005, 24세,2016,2346,1204,1142,105.4,2072,1093,979,111.6
11020, 중구,030,25~29세,2016,10762,5500,5262,104.5,9349,4782,4567,104.7
11020, 중구,030001, 25세,2016,2264,1142,1122,101.8,2006,1014,992,102.2
11020, 중구,030002, 26세,2016,2187,1124,1063,105.7,1879,972,907,107.2
11020, 중구,030003, 27세,2016,2104,1108,996,111.2,1816,951,865,109.9
11020, 중구,030004, 28세,2016,2112,1045,1067,97.9,1830,900,930,96.8
11020, 중구,030005, 29세,2016,2095,1081,1014,106.6,1818,945,873,108.2
11020, 중구,035,30~34세,2016,10900,5491,5409,101.5,9834,4929,4905,100.5
11020, 중구,035001, 30세,2016,2092,1065,1027,103.7,1860,941,919,102.4
11020, 중구,035002, 31세,2016,2070,1042,1028,101.4,1845,929,916,101.4
11020, 중구,035003, 32세,2016,2202,1102,1100,100.2,1983,978,1005,97.3
11020, 중구,035004, 33세,2016,2253,1143,1110,103,2072,1052,1020,103.1
11020, 중구,035005, 34세,2016,2283,1139,1144,99.6,2074,1029,1045,98.5
11020, 중구,040,35~39세,2016,10187,5269,4918,107.1,9379,4821,4558,105.8
11020, 중구,040001, 35세,2016,2283,1175,1108,106,2097,1079,1018,106
11020, 중구,040002, 36세,2016,2202,1129,1073,105.2,2029,1027,1002,102.5
11020, 중구,040003, 37세,2016,2037,1040,997,104.3,1898,964,934,103.2
11020, 중구,040004, 38세,2016,1829,974,855,113.9,1652,872,780,111.8
11020, 중구,040005, 39세,2016,1836,951,885,107.5,1703,879,824,106.7
11020, 중구,045,40~44세,2016,9641,5006,4635,108,8873,4583,4290,106.8
11020, 중구,045001, 40세,2016,1802,937,865,108.3,1644,843,801,105.2
11020, 중구,045002, 41세,2016,1884,978,906,107.9,1739,898,841,106.8
11020, 중구,045003, 42세,2016,1950,1020,930,109.7,1799,942,857,109.9
11020, 중구,045004, 43세,2016,1952,993,959,103.5,1800,917,883,103.9
11020, 중구,045005, 44세,2016,2053,1078,975,110.6,1891,983,908,108.3
11020, 중구,050,45~49세,2016,10299,5224,5075,102.9,9412,4808,4604,104.4
11020, 중구,050001, 45세,2016,2123,1108,1015,109.2,1951,1019,932,109.3
11020, 중구,050002, 46세,2016,2073,1036,1037,99.9,1893,946,947,99.9
11020, 중구,050003, 47세,2016,2106,1115,991,112.5,1910,1025,885,115.8
11020, 중구,050004, 48세,2016,2093,1021,1072,95.2,1899,927,972,95.4
11020, 중구,050005, 49세,2016,1904,944,960,98.3,1759,891,868,102.6
11020, 중구,055,50~54세,2016,10141,4957,5184,95.6,9144,4517,4627,97.6
11020, 중구,055001, 50세,2016,1839,934,905,103.2,1673,853,820,104
11020, 중구,055002, 51세,2016,1969,912,1057,86.3,1793,831,962,86.4
11020, 중구,055003, 52세,2016,2043,996,1047,95.1,1817,893,924,96.6
11020, 중구,055004, 53세,2016,2127,1032,1095,94.2,1877,931,946,98.4
11020, 중구,055005, 54세,2016,2163,1083,1080,100.3,1984,1009,975,103.5
11020, 중구,060,55~59세,2016,10944,5377,5567,96.6,10142,5035,5107,98.6
11020, 중구,060001, 55세,2016,2253,1142,1111,102.8,2127,1080,1047,103.2
11020, 중구,060002, 56세,2016,2356,1132,1224,92.5,2187,1064,1123,94.7
11020, 중구,060003, 57세,2016,2128,1039,1089,95.4,1963,972,991,98.1
11020, 중구,060004, 58세,2016,2133,1030,1103,93.4,1959,955,1004,95.1
11020, 중구,060005, 59세,2016,2074,1034,1040,99.4,1906,964,942,102.3
11020, 중구,065,60~64세,2016,8619,4143,4476,92.6,7976,3864,4112,94
11020, 중구,065001, 60세,2016,1973,967,1006,96.1,1851,923,928,99.5
11020, 중구,065002, 61세,2016,1982,926,1056,87.7,1825,858,967,88.7
11020, 중구,065003, 62세,2016,1652,816,836,97.6,1503,752,751,100.1
11020, 중구,065004, 63세,2016,1460,701,759,92.4,1352,649,703,92.3
11020, 중구,065005, 64세,2016,1552,733,819,89.5,1445,682,763,89.4
11020, 중구,070,65~69세,2016,6221,2966,3255,91.1,5938,2831,3107,91.1
11020, 중구,070001, 65세,2016,1144,563,581,96.9,1060,524,536,97.8
11020, 중구,070002, 66세,2016,1303,651,652,99.8,1239,619,620,99.8
11020, 중구,070003, 67세,2016,1279,600,679,88.4,1211,570,641,88.9
11020, 중구,070004, 68세,2016,1244,585,659,88.8,1217,576,641,89.9
11020, 중구,070005, 69세,2016,1251,567,684,82.9,1211,542,669,81
11020, 중구,075,70~74세,2016,4950,2208,2742,80.5,4857,2164,2693,80.4
11020, 중구,075001, 70세,2016,925,395,530,74.5,904,386,518,74.5
11020, 중구,075002, 71세,2016,961,449,512,87.7,948,442,506,87.4
11020, 중구,075003, 72세,2016,954,446,508,87.8,931,429,502,85.5
11020, 중구,075004, 73세,2016,959,415,544,76.3,942,411,531,77.4
11020, 중구,075005, 74세,2016,1151,503,648,77.6,1132,496,636,78
11020, 중구,080,75~79세,2016,3775,1574,2201,71.5,3708,1550,2158,71.8
11020, 중구,080001, 75세,2016,932,394,538,73.2,915,391,524,74.6
11020, 중구,080002, 76세,2016,796,344,452,76.1,784,336,448,75
11020, 중구,080003, 77세,2016,781,346,435,79.5,767,343,424,80.9
11020, 중구,080004, 78세,2016,685,275,410,67.1,674,268,406,66
11020, 중구,080005, 79세,2016,581,215,366,58.7,568,212,356,59.6
11020, 중구,085,80~84세,2016,2206,785,1421,55.2,2178,779,1399,55.7
11020, 중구,085001, 80세,2016,584,230,354,65,577,230,347,66.3
11020, 중구,085002, 81세,2016,498,189,309,61.2,493,188,305,61.6
11020, 중구,085003, 82세,2016,421,147,274,53.6,414,144,270,53.3
11020, 중구,085004, 83세,2016,392,129,263,49,387,127,260,48.8
11020, 중구,085005, 84세,2016,311,90,221,40.7,307,90,217,41.5
11020, 중구,090,85~89세,2016,1039,331,708,46.8,1020,323,697,46.3
11020, 중구,090001, 85세,2016,252,77,175,44,249,77,172,44.8
11020, 중구,090002, 86세,2016,248,86,162,53.1,240,83,157,52.9
11020, 중구,090003, 87세,2016,209,73,136,53.7,206,71,135,52.6
11020, 중구,090004, 88세,2016,183,53,130,40.8,181,52,129,40.3
11020, 중구,090005, 89세,2016,147,42,105,40,144,40,104,38.5
11020, 중구,095,90~94세,2016,338,100,238,42,330,96,234,41
11020, 중구,095001, 90세,2016,101,27,74,36.5,99,26,73,35.6
11020, 중구,095002, 91세,2016,70,18,52,34.6,70,18,52,34.6
11020, 중구,095003, 92세,2016,71,29,42,69,69,28,41,68.3
11020, 중구,095004, 93세,2016,52,13,39,33.3,50,12,38,31.6
11020, 중구,095005, 94세,2016,44,13,31,41.9,42,12,30,40
11020, 중구,100,95~99세,2016,66,21,45,46.7,64,21,43,48.8
11020, 중구,100001, 95세,2016,22,6,16,37.5,22,6,16,37.5
11020, 중구,100002, 96세,2016,14,X,10,40,14,X,10,40
11020, 중구,100003, 97세,2016,11,X,7,57.1,11,X,7,57.1
11020, 중구,100004, 98세,2016,13,5,8,62.5,12,5,7,71.4
11020, 중구,100005, 99세,2016,6,X,X,50,5,X,X,66.7
11020, 중구,101,100세이상,2016,13,X,12,8.3,10,X,10,0
11020, 중구,102,15세미만,2016,11577,5889,5688,103.5,10939,5525,5414,102.1
11020, 중구,103,15~64세,2016,97975,48639,49336,98.6,88916,44388,44528,99.7
11020, 중구,104,65세이상,2016,18608,7986,10622,75.2,18105,7764,10341,75.1
11020, 중구,086,85세이상,2016,1456,453,1003,45.2,1424,440,984,44.7
11020, 중구,126,평균연령,2016,42.4,41.6,43.1,,42.7,41.9,43.5,
11020, 중구,127,중위연령,2016,42.2,41.5,43,,42.7,42,43.5,
11030, 용산구,000,합계,2016,224993,108520,116473,93.2,209710,100642,109068,92.3
11030, 용산구,005,0~4세,2016,8603,4434,4169,106.4,7957,4136,3821,108.2
11030, 용산구,005001, 0세,2016,1751,904,847,106.7,1648,861,787,109.4
11030, 용산구,005002, 1세,2016,1732,925,807,114.6,1602,863,739,116.8
11030, 용산구,005003, 2세,2016,1680,852,828,102.9,1538,788,750,105.1
11030, 용산구,005004, 3세,2016,1698,859,839,102.4,1559,794,765,103.8
11030, 용산구,005005, 4세,2016,1742,894,848,105.4,1610,830,780,106.4
11030, 용산구,010,5~9세,2016,8145,4130,4015,102.9,7381,3735,3646,102.4
11030, 용산구,010001, 5세,2016,1715,898,817,109.9,1551,812,739,109.9
11030, 용산구,010002, 6세,2016,1579,815,764,106.7,1417,735,682,107.8
11030, 용산구,010003, 7세,2016,1567,757,810,93.5,1410,676,734,92.1
11030, 용산구,010004, 8세,2016,1610,796,814,97.8,1468,727,741,98.1
11030, 용산구,010005, 9세,2016,1674,864,810,106.7,1535,785,750,104.7
11030, 용산구,015,10~14세,2016,7784,3992,3792,105.3,7163,3661,3502,104.5
11030, 용산구,015001, 10세,2016,1483,755,728,103.7,1335,671,664,101.1
11030, 용산구,015002, 11세,2016,1477,766,711,107.7,1353,700,653,107.2
11030, 용산구,015003, 12세,2016,1603,840,763,110.1,1469,770,699,110.2
11030, 용산구,015004, 13세,2016,1577,791,786,100.6,1464,731,733,99.7
11030, 용산구,015005, 14세,2016,1644,840,804,104.5,1542,789,753,104.8
11030, 용산구,020,15~19세,2016,10183,5112,5071,100.8,9686,4858,4828,100.6
11030, 용산구,020001, 15세,2016,1823,934,889,105.1,1727,888,839,105.8
11030, 용산구,020002, 16세,2016,1976,1046,930,112.5,1883,993,890,111.6
11030, 용산구,020003, 17세,2016,1958,1047,911,114.9,1855,980,875,112
11030, 용산구,020004, 18세,2016,2077,1064,1013,105,2003,1028,975,105.4
11030, 용산구,020005, 19세,2016,2349,1021,1328,76.9,2218,969,1249,77.6
11030, 용산구,025,20~24세,2016,14918,6480,8438,76.8,13786,6024,7762,77.6
11030, 용산구,025001, 20세,2016,2547,1094,1453,75.3,2339,1022,1317,77.6
11030, 용산구,025002, 21세,2016,2939,1245,1694,73.5,2726,1169,1557,75.1
11030, 용산구,025003, 22세,2016,2943,1310,1633,80.2,2738,1213,1525,79.5
11030, 용산구,025004, 23세,2016,3105,1325,1780,74.4,2869,1221,1648,74.1
11030, 용산구,025005, 24세,2016,3384,1506,1878,80.2,3114,1399,1715,81.6
11030, 용산구,030,25~29세,2016,17334,8474,8860,95.6,15720,7634,8086,94.4
11030, 용산구,030001, 25세,2016,3404,1590,1814,87.7,3125,1453,1672,86.9
11030, 용산구,030002, 26세,2016,3363,1597,1766,90.4,3060,1454,1606,90.5
11030, 용산구,030003, 27세,2016,3396,1691,1705,99.2,3097,1529,1568,97.5
11030, 용산구,030004, 28세,2016,3560,1797,1763,101.9,3184,1592,1592,100
11030, 용산구,030005, 29세,2016,3611,1799,1812,99.3,3254,1606,1648,97.5
11030, 용산구,035,30~34세,2016,19774,9945,9829,101.2,17800,8800,9000,97.8
11030, 용산구,035001, 30세,2016,3760,1883,1877,100.3,3378,1664,1714,97.1
11030, 용산구,035002, 31세,2016,3629,1832,1797,101.9,3249,1603,1646,97.4
11030, 용산구,035003, 32세,2016,3935,1991,1944,102.4,3513,1743,1770,98.5
11030, 용산구,035004, 33세,2016,4200,2115,2085,101.4,3804,1898,1906,99.6
11030, 용산구,035005, 34세,2016,4250,2124,2126,99.9,3856,1892,1964,96.3
11030, 용산구,040,35~39세,2016,19438,9741,9697,100.5,17560,8705,8855,98.3
11030, 용산구,040001, 35세,2016,4350,2201,2149,102.4,3965,1996,1969,101.4
11030, 용산구,040002, 36세,2016,4262,2126,2136,99.5,3830,1891,1939,97.5
11030, 용산구,040003, 37세,2016,3877,1965,1912,102.8,3478,1737,1741,99.8
11030, 용산구,040004, 38세,2016,3477,1754,1723,101.8,3138,1567,1571,99.7
11030, 용산구,040005, 39세,2016,3472,1695,1777,95.4,3149,1514,1635,92.6
11030, 용산구,045,40~44세,2016,18800,9453,9347,101.1,17275,8604,8671,99.2
11030, 용산구,045001, 40세,2016,3411,1704,1707,99.8,3096,1532,1564,98
11030, 용산구,045002, 41세,2016,3592,1787,1805,99,3295,1626,1669,97.4
11030, 용산구,045003, 42세,2016,3865,1946,1919,101.4,3557,1767,1790,98.7
11030, 용산구,045004, 43세,2016,3833,1931,1902,101.5,3526,1756,1770,99.2
11030, 용산구,045005, 44세,2016,4099,2085,2014,103.5,3801,1923,1878,102.4
11030, 용산구,050,45~49세,2016,19461,9704,9757,99.5,18115,8941,9174,97.5
11030, 용산구,050001, 45세,2016,4165,2135,2030,105.2,3894,1981,1913,103.6
11030, 용산구,050002, 46세,2016,4028,2003,2025,98.9,3765,1855,1910,97.1
11030, 용산구,050003, 47세,2016,3998,1993,2005,99.4,3711,1832,1879,97.5
11030, 용산구,050004, 48세,2016,3838,1909,1929,99,3549,1740,1809,96.2
11030, 용산구,050005, 49세,2016,3432,1664,1768,94.1,3196,1533,1663,92.2
11030, 용산구,055,50~54세,2016,17381,8594,8787,97.8,16250,8064,8186,98.5
11030, 용산구,055001, 50세,2016,3239,1640,1599,102.6,3046,1546,1500,103.1
11030, 용산구,055002, 51세,2016,3518,1698,1820,93.3,3275,1591,1684,94.5
11030, 용산구,055003, 52세,2016,3431,1708,1723,99.1,3201,1606,1595,100.7
11030, 용산구,055004, 53세,2016,3600,1745,1855,94.1,3322,1615,1707,94.6
11030, 용산구,055005, 54세,2016,3593,1803,1790,100.7,3406,1706,1700,100.4
11030, 용산구,060,55~59세,2016,17374,8324,9050,92,16535,7953,8582,92.7
11030, 용산구,060001, 55세,2016,3591,1740,1851,94,3437,1662,1775,93.6
11030, 용산구,060002, 56세,2016,3731,1752,1979,88.5,3548,1679,1869,89.8
11030, 용산구,060003, 57세,2016,3467,1654,1813,91.2,3304,1581,1723,91.8
11030, 용산구,060004, 58세,2016,3308,1632,1676,97.4,3141,1558,1583,98.4
11030, 용산구,060005, 59세,2016,3277,1546,1731,89.3,3105,1473,1632,90.3
11030, 용산구,065,60~64세,2016,13928,6621,7307,90.6,13249,6323,6926,91.3
11030, 용산구,065001, 60세,2016,3225,1591,1634,97.4,3068,1524,1544,98.7
11030, 용산구,065002, 61세,2016,3163,1468,1695,86.6,3011,1401,1610,87
11030, 용산구,065003, 62세,2016,2728,1328,1400,94.9,2604,1266,1338,94.6
11030, 용산구,065004, 63세,2016,2361,1140,1221,93.4,2226,1080,1146,94.2
11030, 용산구,065005, 64세,2016,2451,1094,1357,80.6,2340,1052,1288,81.7
11030, 용산구,070,65~69세,2016,10004,4608,5396,85.4,9709,4462,5247,85
11030, 용산구,070001, 65세,2016,1775,828,947,87.4,1701,797,904,88.2
11030, 용산구,070002, 66세,2016,2092,974,1118,87.1,2020,935,1085,86.2
11030, 용산구,070003, 67세,2016,2066,973,1093,89,2002,940,1062,88.5
11030, 용산구,070004, 68세,2016,2080,972,1108,87.7,2035,946,1089,86.9
11030, 용산구,070005, 69세,2016,1991,861,1130,76.2,1951,844,1107,76.2
11030, 용산구,075,70~74세,2016,8392,3734,4658,80.2,8269,3665,4604,79.6
11030, 용산구,075001, 70세,2016,1593,694,899,77.2,1561,676,885,76.4
11030, 용산구,075002, 71세,2016,1591,716,875,81.8,1575,704,871,80.8
11030, 용산구,075003, 72세,2016,1615,688,927,74.2,1588,675,913,73.9
11030, 용산구,075004, 73세,2016,1645,760,885,85.9,1617,745,872,85.4
11030, 용산구,075005, 74세,2016,1948,876,1072,81.7,1928,865,1063,81.4
11030, 용산구,080,75~79세,2016,6886,2828,4058,69.7,6783,2790,3993,69.9
11030, 용산구,080001, 75세,2016,1571,676,895,75.5,1546,667,879,75.9
11030, 용산구,080002, 76세,2016,1422,590,832,70.9,1399,579,820,70.6
11030, 용산구,080003, 77세,2016,1407,583,824,70.8,1379,572,807,70.9
11030, 용산구,080004, 78세,2016,1310,499,811,61.5,1297,495,802,61.7
11030, 용산구,080005, 79세,2016,1176,480,696,69,1162,477,685,69.6
11030, 용산구,085,80~84세,2016,4014,1525,2489,61.3,3951,1490,2461,60.5
11030, 용산구,085001, 80세,2016,1060,396,664,59.6,1043,387,656,59
11030, 용산구,085002, 81세,2016,939,374,565,66.2,922,364,558,65.2
11030, 용산구,085003, 82세,2016,789,284,505,56.2,775,277,498,55.6
11030, 용산구,085004, 83세,2016,648,246,402,61.2,639,240,399,60.2
11030, 용산구,085005, 84세,2016,578,225,353,63.7,572,222,350,63.4
11030, 용산구,090,85~89세,2016,1812,592,1220,48.5,1780,577,1203,48
11030, 용산구,090001, 85세,2016,460,174,286,60.8,454,172,282,61
11030, 용산구,090002, 86세,2016,440,159,281,56.6,429,154,275,56
11030, 용산구,090003, 87세,2016,379,108,271,39.9,374,107,267,40.1
11030, 용산구,090004, 88세,2016,296,87,209,41.6,289,82,207,39.6
11030, 용산구,090005, 89세,2016,237,64,173,37,234,62,172,36
11030, 용산구,095,90~94세,2016,615,177,438,40.4,601,171,430,39.8
11030, 용산구,095001, 90세,2016,177,50,127,39.4,173,47,126,37.3
11030, 용산구,095002, 91세,2016,145,44,101,43.6,140,41,99,41.4
11030, 용산구,095003, 92세,2016,119,36,83,43.4,118,36,82,43.9
11030, 용산구,095004, 93세,2016,94,30,64,46.9,91,30,61,49.2
11030, 용산구,095005, 94세,2016,80,17,63,27,79,17,62,27.4
11030, 용산구,100,95~99세,2016,125,47,78,60.3,120,44,76,57.9
11030, 용산구,100001, 95세,2016,46,18,28,64.3,45,17,28,60.7
11030, 용산구,100002, 96세,2016,33,11,22,50,33,11,22,50
11030, 용산구,100003, 97세,2016,21,9,12,75,20,9,11,81.8
11030, 용산구,100004, 98세,2016,15,X,12,25,15,X,12,25
11030, 용산구,100005, 99세,2016,10,6,X,150,7,X,X,133.3
11030, 용산구,101,100세이상,2016,22,5,17,29.4,20,5,15,33.3
11030, 용산구,102,15세미만,2016,24532,12556,11976,104.8,22501,11532,10969,105.1
11030, 용산구,103,15~64세,2016,168591,82448,86143,95.7,155976,75906,80070,94.8
11030, 용산구,104,65세이상,2016,31870,13516,18354,73.6,31233,13204,18029,73.2
11030, 용산구,086,85세이상,2016,2574,821,1753,46.8,2521,797,1724,46.2
11030, 용산구,126,평균연령,2016,41.9,41,42.7,,42.3,41.4,43.1,
11030, 용산구,127,중위연령,2016,41.8,41.1,42.4,,42.4,41.8,43,
11040, 성동구,000,합계,2016,294744,145935,148809,98.1,284735,141022,143713,98.1
11040, 성동구,005,0~4세,2016,12424,6315,6109,103.4,12225,6206,6019,103.1
11040, 성동구,005001, 0세,2016,2569,1295,1274,101.6,2532,1274,1258,101.3
11040, 성동구,005002, 1세,2016,2611,1310,1301,100.7,2574,1292,1282,100.8
11040, 성동구,005003, 2세,2016,2484,1250,1234,101.3,2439,1223,1216,100.6
11040, 성동구,005004, 3세,2016,2400,1244,1156,107.6,2357,1222,1135,107.7
11040, 성동구,005005, 4세,2016,2360,1216,1144,106.3,2323,1195,1128,105.9
11040, 성동구,010,5~9세,2016,10511,5381,5130,104.9,10345,5284,5061,104.4
11040, 성동구,010001, 5세,2016,2219,1152,1067,108,2187,1133,1054,107.5
11040, 성동구,010002, 6세,2016,2118,1073,1045,102.7,2074,1053,1021,103.1
11040, 성동구,010003, 7세,2016,1908,983,925,106.3,1878,965,913,105.7
11040, 성동구,010004, 8세,2016,2128,1091,1037,105.2,2093,1067,1026,104
11040, 성동구,010005, 9세,2016,2138,1082,1056,102.5,2113,1066,1047,101.8
11040, 성동구,015,10~14세,2016,9793,4886,4907,99.6,9667,4816,4851,99.3
11040, 성동구,015001, 10세,2016,1858,973,885,109.9,1833,961,872,110.2
11040, 성동구,015002, 11세,2016,1890,977,913,107,1862,956,906,105.5
11040, 성동구,015003, 12세,2016,1994,1005,989,101.6,1966,993,973,102.1
11040, 성동구,015004, 13세,2016,1929,902,1027,87.8,1907,891,1016,87.7
11040, 성동구,015005, 14세,2016,2122,1029,1093,94.1,2099,1015,1084,93.6
11040, 성동구,020,15~19세,2016,14126,7134,6992,102,13807,7004,6803,103
11040, 성동구,020001, 15세,2016,2290,1180,1110,106.3,2272,1171,1101,106.4
11040, 성동구,020002, 16세,2016,2536,1261,1275,98.9,2512,1249,1263,98.9
11040, 성동구,020003, 17세,2016,2565,1292,1273,101.5,2535,1275,1260,101.2
11040, 성동구,020004, 18세,2016,2961,1492,1469,101.6,2887,1465,1422,103
11040, 성동구,020005, 19세,2016,3774,1909,1865,102.4,3601,1844,1757,105
11040, 성동구,025,20~24세,2016,23027,11714,11313,103.5,21412,11061,10351,106.9
11040, 성동구,025001, 20세,2016,4151,2000,2151,93,3854,1891,1963,96.3
11040, 성동구,025002, 21세,2016,4220,2104,2116,99.4,3887,1968,1919,102.6
11040, 성동구,025003, 22세,2016,4522,2273,2249,101.1,4214,2161,2053,105.3
11040, 성동구,025004, 23세,2016,4927,2608,2319,112.5,4577,2458,2119,116
11040, 성동구,025005, 24세,2016,5207,2729,2478,110.1,4880,2583,2297,112.5
11040, 성동구,030,25~29세,2016,24311,12494,11817,105.7,22955,11788,11167,105.6
11040, 성동구,030001, 25세,2016,5033,2725,2308,118.1,4773,2605,2168,120.2
11040, 성동구,030002, 26세,2016,5072,2631,2441,107.8,4781,2479,2302,107.7
11040, 성동구,030003, 27세,2016,4799,2481,2318,107,4539,2341,2198,106.5
11040, 성동구,030004, 28세,2016,4789,2389,2400,99.5,4511,2238,2273,98.5
11040, 성동구,030005, 29세,2016,4618,2268,2350,96.5,4351,2125,2226,95.5
11040, 성동구,035,30~34세,2016,25258,12586,12672,99.3,24185,12013,12172,98.7
11040, 성동구,035001, 30세,2016,4663,2329,2334,99.8,4444,2224,2220,100.2
11040, 성동구,035002, 31세,2016,4882,2386,2496,95.6,4661,2274,2387,95.3
11040, 성동구,035003, 32세,2016,4927,2440,2487,98.1,4705,2319,2386,97.2
11040, 성동구,035004, 33세,2016,5177,2592,2585,100.3,4990,2481,2509,98.9
11040, 성동구,035005, 34세,2016,5609,2839,2770,102.5,5385,2715,2670,101.7
11040, 성동구,040,35~39세,2016,25118,12844,12274,104.6,24355,12405,11950,103.8
11040, 성동구,040001, 35세,2016,5429,2741,2688,102,5264,2637,2627,100.4
11040, 성동구,040002, 36세,2016,5555,2848,2707,105.2,5401,2764,2637,104.8
11040, 성동구,040003, 37세,2016,5064,2580,2484,103.9,4898,2482,2416,102.7
11040, 성동구,040004, 38세,2016,4493,2317,2176,106.5,4341,2231,2110,105.7
11040, 성동구,040005, 39세,2016,4577,2358,2219,106.3,4451,2291,2160,106.1
11040, 성동구,045,40~44세,2016,23562,12146,11416,106.4,22814,11747,11067,106.1
11040, 성동구,045001, 40세,2016,4427,2328,2099,110.9,4293,2256,2037,110.8
11040, 성동구,045002, 41세,2016,4466,2263,2203,102.7,4320,2178,2142,101.7
11040, 성동구,045003, 42세,2016,4865,2515,2350,107,4739,2447,2292,106.8
11040, 성동구,045004, 43세,2016,4948,2553,2395,106.6,4783,2470,2313,106.8
11040, 성동구,045005, 44세,2016,4856,2487,2369,105,4679,2396,2283,104.9
11040, 성동구,050,45~49세,2016,24445,12224,12221,100,23634,11809,11825,99.9
11040, 성동구,050001, 45세,2016,5149,2620,2529,103.6,5000,2546,2454,103.7
11040, 성동구,050002, 46세,2016,5086,2576,2510,102.6,4893,2480,2413,102.8
11040, 성동구,050003, 47세,2016,4938,2453,2485,98.7,4768,2366,2402,98.5
11040, 성동구,050004, 48세,2016,4867,2418,2449,98.7,4708,2333,2375,98.2
11040, 성동구,050005, 49세,2016,4405,2157,2248,96,4265,2084,2181,95.6
11040, 성동구,055,50~54세,2016,23303,11617,11686,99.4,22318,11154,11164,99.9
11040, 성동구,055001, 50세,2016,4391,2217,2174,102,4213,2126,2087,101.9
11040, 성동구,055002, 51세,2016,4654,2281,2373,96.1,4440,2174,2266,95.9
11040, 성동구,055003, 52세,2016,4527,2247,2280,98.6,4355,2167,2188,99
11040, 성동구,055004, 53세,2016,4804,2372,2432,97.5,4581,2274,2307,98.6
11040, 성동구,055005, 54세,2016,4927,2500,2427,103,4729,2413,2316,104.2
11040, 성동구,060,55~59세,2016,23733,11774,11959,98.5,22969,11413,11556,98.8
11040, 성동구,060001, 55세,2016,5024,2542,2482,102.4,4895,2487,2408,103.3
11040, 성동구,060002, 56세,2016,5175,2518,2657,94.8,5004,2449,2555,95.9
11040, 성동구,060003, 57세,2016,4692,2300,2392,96.2,4560,2230,2330,95.7
11040, 성동구,060004, 58세,2016,4433,2239,2194,102.1,4251,2152,2099,102.5
11040, 성동구,060005, 59세,2016,4409,2175,2234,97.4,4259,2095,2164,96.8
11040, 성동구,065,60~64세,2016,17761,8644,9117,94.8,17119,8333,8786,94.8
11040, 성동구,065001, 60세,2016,3997,1951,2046,95.4,3851,1886,1965,96
11040, 성동구,065002, 61세,2016,4138,1965,2173,90.4,4010,1901,2109,90.1
11040, 성동구,065003, 62세,2016,3521,1712,1809,94.6,3361,1638,1723,95.1
11040, 성동구,065004, 63세,2016,2956,1486,1470,101.1,2841,1430,1411,101.3
11040, 성동구,065005, 64세,2016,3149,1530,1619,94.5,3056,1478,1578,93.7
11040, 성동구,070,65~69세,2016,12711,5940,6771,87.7,12447,5818,6629,87.8
11040, 성동구,070001, 65세,2016,2364,1129,1235,91.4,2293,1095,1198,91.4
11040, 성동구,070002, 66세,2016,2609,1230,1379,89.2,2539,1195,1344,88.9
11040, 성동구,070003, 67세,2016,2632,1202,1430,84.1,2575,1175,1400,83.9
11040, 성동구,070004, 68세,2016,2505,1193,1312,90.9,2465,1180,1285,91.8
11040, 성동구,070005, 69세,2016,2601,1186,1415,83.8,2575,1173,1402,83.7
11040, 성동구,075,70~74세,2016,10327,4675,5652,82.7,10252,4645,5607,82.8
11040, 성동구,075001, 70세,2016,2057,948,1109,85.5,2034,937,1097,85.4
11040, 성동구,075002, 71세,2016,1952,861,1091,78.9,1941,857,1084,79.1
11040, 성동구,075003, 72세,2016,1978,896,1082,82.8,1964,889,1075,82.7
11040, 성동구,075004, 73세,2016,1997,894,1103,81.1,1981,889,1092,81.4
11040, 성동구,075005, 74세,2016,2343,1076,1267,84.9,2332,1073,1259,85.2
11040, 성동구,080,75~79세,2016,7667,3307,4360,75.8,7612,3290,4322,76.1
11040, 성동구,080001, 75세,2016,1893,854,1039,82.2,1876,849,1027,82.7
11040, 성동구,080002, 76세,2016,1623,686,937,73.2,1607,682,925,73.7
11040, 성동구,080003, 77세,2016,1561,711,850,83.6,1553,709,844,84
11040, 성동구,080004, 78세,2016,1366,550,816,67.4,1358,547,811,67.4
11040, 성동구,080005, 79세,2016,1224,506,718,70.5,1218,503,715,70.3
11040, 성동구,085,80~84세,2016,4181,1564,2617,59.8,4159,1555,2604,59.7
11040, 성동구,085001, 80세,2016,1093,414,679,61,1085,413,672,61.5
11040, 성동구,085002, 81세,2016,950,373,577,64.6,945,370,575,64.3
11040, 성동구,085003, 82세,2016,881,346,535,64.7,879,345,534,64.6
11040, 성동구,085004, 83세,2016,657,233,424,55,652,231,421,54.9
11040, 성동구,085005, 84세,2016,600,198,402,49.3,598,196,402,48.8
11040, 성동구,090,85~89세,2016,1754,510,1244,41,1741,508,1233,41.2
11040, 성동구,090001, 85세,2016,453,143,310,46.1,448,142,306,46.4
11040, 성동구,090002, 86세,2016,411,112,299,37.5,409,112,297,37.7
11040, 성동구,090003, 87세,2016,358,109,249,43.8,357,109,248,44
11040, 성동구,090004, 88세,2016,298,78,220,35.5,296,78,218,35.8
11040, 성동구,090005, 89세,2016,234,68,166,41,231,67,164,40.9
11040, 성동구,095,90~94세,2016,581,143,438,32.6,573,139,434,32
11040, 성동구,095001, 90세,2016,165,38,127,29.9,165,38,127,29.9
11040, 성동구,095002, 91세,2016,131,31,100,31,130,31,99,31.3
11040, 성동구,095003, 92세,2016,99,22,77,28.6,99,22,77,28.6
11040, 성동구,095004, 93세,2016,109,33,76,43.4,103,29,74,39.2
11040, 성동구,095005, 94세,2016,77,19,58,32.8,76,19,57,33.3
11040, 성동구,100,95~99세,2016,135,36,99,36.4,131,33,98,33.7
11040, 성동구,100001, 95세,2016,57,15,42,35.7,57,15,42,35.7
11040, 성동구,100002, 96세,2016,32,9,23,39.1,31,9,22,40.9
11040, 성동구,100003, 97세,2016,24,5,19,26.3,23,X,19,21.1
11040, 성동구,100004, 98세,2016,10,X,7,42.9,10,X,7,42.9
11040, 성동구,100005, 99세,2016,12,X,8,50,10,X,8,25
11040, 성동구,101,100세이상,2016,16,X,15,6.7,15,X,14,7.1
11040, 성동구,102,15세미만,2016,32728,16582,16146,102.7,32237,16306,15931,102.4
11040, 성동구,103,15~64세,2016,224644,113177,111467,101.5,215568,108727,106841,101.8
11040, 성동구,104,65세이상,2016,37372,16176,21196,76.3,36930,15989,20941,76.4
11040, 성동구,086,85세이상,2016,2486,690,1796,38.4,2460,681,1779,38.3
11040, 성동구,126,평균연령,2016,40.9,40.1,41.7,,41,40.1,41.8,
11040, 성동구,127,중위연령,2016,40.6,39.8,41.5,,40.8,40,41.7,
11050, 광진구,000,합계,2016,363979,177858,186121,95.6,346476,169766,176710,96.1
11050, 광진구,005,0~4세,2016,12838,6636,6202,107,12485,6454,6031,107
11050, 광진구,005001, 0세,2016,2771,1434,1337,107.3,2687,1395,1292,108
11050, 광진구,005002, 1세,2016,2671,1354,1317,102.8,2602,1318,1284,102.6
11050, 광진구,005003, 2세,2016,2421,1261,1160,108.7,2349,1220,1129,108.1
11050, 광진구,005004, 3세,2016,2465,1284,1181,108.7,2397,1249,1148,108.8
11050, 광진구,005005, 4세,2016,2510,1303,1207,108,2450,1272,1178,108
11050, 광진구,010,5~9세,2016,12196,6258,5938,105.4,11975,6143,5832,105.3
11050, 광진구,010001, 5세,2016,2482,1235,1247,99,2424,1204,1220,98.7
11050, 광진구,010002, 6세,2016,2425,1274,1151,110.7,2377,1250,1127,110.9
11050, 광진구,010003, 7세,2016,2250,1177,1073,109.7,2200,1153,1047,110.1
11050, 광진구,010004, 8세,2016,2448,1269,1179,107.6,2416,1251,1165,107.4
11050, 광진구,010005, 9세,2016,2591,1303,1288,101.2,2558,1285,1273,100.9
11050, 광진구,015,10~14세,2016,12729,6541,6188,105.7,12608,6468,6140,105.3
11050, 광진구,015001, 10세,2016,2360,1191,1169,101.9,2336,1178,1158,101.7
11050, 광진구,015002, 11세,2016,2328,1173,1155,101.6,2304,1154,1150,100.3
11050, 광진구,015003, 12세,2016,2626,1364,1262,108.1,2597,1350,1247,108.3
11050, 광진구,015004, 13세,2016,2640,1374,1266,108.5,2622,1361,1261,107.9
11050, 광진구,015005, 14세,2016,2775,1439,1336,107.7,2749,1425,1324,107.6
11050, 광진구,020,15~19세,2016,19465,9785,9680,101.1,18845,9555,9290,102.9
11050, 광진구,020001, 15세,2016,3083,1652,1431,115.4,3045,1635,1410,116
11050, 광진구,020002, 16세,2016,3487,1806,1681,107.4,3455,1789,1666,107.4
11050, 광진구,020003, 17세,2016,3623,1829,1794,102,3571,1815,1756,103.4
11050, 광진구,020004, 18세,2016,4161,2054,2107,97.5,4003,1999,2004,99.8
11050, 광진구,020005, 19세,2016,5111,2444,2667,91.6,4771,2317,2454,94.4
11050, 광진구,025,20~24세,2016,31374,14937,16437,90.9,28817,14020,14797,94.7
11050, 광진구,025001, 20세,2016,5598,2593,3005,86.3,5072,2408,2664,90.4
11050, 광진구,025002, 21세,2016,5805,2755,3050,90.3,5273,2542,2731,93.1
11050, 광진구,025003, 22세,2016,6158,2923,3235,90.4,5683,2762,2921,94.6
11050, 광진구,025004, 23세,2016,6731,3288,3443,95.5,6209,3108,3101,100.2
11050, 광진구,025005, 24세,2016,7082,3378,3704,91.2,6580,3200,3380,94.7
11050, 광진구,030,25~29세,2016,34103,16728,17375,96.3,31743,15640,16103,97.1
11050, 광진구,030001, 25세,2016,6978,3513,3465,101.4,6520,3319,3201,103.7
11050, 광진구,030002, 26세,2016,6811,3369,3442,97.9,6255,3128,3127,100
11050, 광진구,030003, 27세,2016,6803,3239,3564,90.9,6344,3021,3323,90.9
11050, 광진구,030004, 28세,2016,6809,3364,3445,97.6,6357,3147,3210,98
11050, 광진구,030005, 29세,2016,6702,3243,3459,93.8,6267,3025,3242,93.3
11050, 광진구,035,30~34세,2016,33264,16580,16684,99.4,31665,15762,15903,99.1
11050, 광진구,035001, 30세,2016,6540,3246,3294,98.5,6150,3043,3107,97.9
11050, 광진구,035002, 31세,2016,6437,3163,3274,96.6,6100,3002,3098,96.9
11050, 광진구,035003, 32세,2016,6443,3211,3232,99.4,6158,3059,3099,98.7
11050, 광진구,035004, 33세,2016,6873,3528,3345,105.5,6566,3376,3190,105.8
11050, 광진구,035005, 34세,2016,6971,3432,3539,97,6691,3282,3409,96.3
11050, 광진구,040,35~39세,2016,29279,14968,14311,104.6,28208,14366,13842,103.8
11050, 광진구,040001, 35세,2016,6558,3370,3188,105.7,6322,3246,3076,105.5
11050, 광진구,040002, 36세,2016,6290,3173,3117,101.8,6081,3068,3013,101.8
11050, 광진구,040003, 37세,2016,5858,2995,2863,104.6,5650,2879,2771,103.9
11050, 광진구,040004, 38세,2016,5122,2670,2452,108.9,4905,2539,2366,107.3
11050, 광진구,040005, 39세,2016,5451,2760,2691,102.6,5250,2634,2616,100.7
11050, 광진구,045,40~44세,2016,27941,14026,13915,100.8,26855,13431,13424,100.1
11050, 광진구,045001, 40세,2016,5103,2604,2499,104.2,4919,2497,2422,103.1
11050, 광진구,045002, 41세,2016,5295,2650,2645,100.2,5119,2546,2573,99
11050, 광진구,045003, 42세,2016,5676,2859,2817,101.5,5472,2746,2726,100.7
11050, 광진구,045004, 43세,2016,5788,2821,2967,95.1,5550,2697,2853,94.5
11050, 광진구,045005, 44세,2016,6079,3092,2987,103.5,5795,2945,2850,103.3
11050, 광진구,050,45~49세,2016,30809,14928,15881,94,29206,14178,15028,94.3
11050, 광진구,050001, 45세,2016,6489,3186,3303,96.5,6172,3033,3139,96.6
11050, 광진구,050002, 46세,2016,6254,3029,3225,93.9,5927,2871,3056,93.9
11050, 광진구,050003, 47세,2016,6118,2896,3222,89.9,5784,2747,3037,90.5
11050, 광진구,050004, 48세,2016,6319,3076,3243,94.9,5966,2914,3052,95.5
11050, 광진구,050005, 49세,2016,5629,2741,2888,94.9,5357,2613,2744,95.2
11050, 광진구,055,50~54세,2016,29071,14234,14837,95.9,26883,13228,13655,96.9
11050, 광진구,055001, 50세,2016,5592,2689,2903,92.6,5229,2528,2701,93.6
11050, 광진구,055002, 51세,2016,5849,2844,3005,94.6,5440,2655,2785,95.3
11050, 광진구,055003, 52세,2016,5579,2788,2791,99.9,5147,2578,2569,100.4
11050, 광진구,055004, 53세,2016,6031,2960,3071,96.4,5478,2704,2774,97.5
11050, 광진구,055005, 54세,2016,6020,2953,3067,96.3,5589,2763,2826,97.8
11050, 광진구,060,55~59세,2016,28905,13785,15120,91.2,27213,13006,14207,91.5
11050, 광진구,060001, 55세,2016,6122,2880,3242,88.8,5857,2765,3092,89.4
11050, 광진구,060002, 56세,2016,6358,3045,3313,91.9,5931,2844,3087,92.1
11050, 광진구,060003, 57세,2016,5621,2618,3003,87.2,5281,2450,2831,86.5
11050, 광진구,060004, 58세,2016,5554,2681,2873,93.3,5210,2529,2681,94.3
11050, 광진구,060005, 59세,2016,5250,2561,2689,95.2,4934,2418,2516,96.1
11050, 광진구,065,60~64세,2016,21605,10396,11209,92.7,20383,9801,10582,92.6
11050, 광진구,065001, 60세,2016,4874,2330,2544,91.6,4608,2213,2395,92.4
11050, 광진구,065002, 61세,2016,5045,2391,2654,90.1,4738,2241,2497,89.7
11050, 광진구,065003, 62세,2016,4137,2030,2107,96.3,3867,1897,1970,96.3
11050, 광진구,065004, 63세,2016,3656,1744,1912,91.2,3457,1644,1813,90.7
11050, 광진구,065005, 64세,2016,3893,1901,1992,95.4,3713,1806,1907,94.7
11050, 광진구,070,65~69세,2016,14483,6821,7662,89,14020,6606,7414,89.1
11050, 광진구,070001, 65세,2016,2734,1271,1463,86.9,2601,1215,1386,87.7
11050, 광진구,070002, 66세,2016,2935,1408,1527,92.2,2820,1348,1472,91.6
11050, 광진구,070003, 67세,2016,2992,1435,1557,92.2,2889,1390,1499,92.7
11050, 광진구,070004, 68세,2016,2941,1401,1540,91,2876,1367,1509,90.6
11050, 광진구,070005, 69세,2016,2881,1306,1575,82.9,2834,1286,1548,83.1
11050, 광진구,075,70~74세,2016,11144,5324,5820,91.5,10997,5256,5741,91.6
11050, 광진구,075001, 70세,2016,2327,1135,1192,95.2,2288,1115,1173,95.1
11050, 광진구,075002, 71세,2016,2143,1047,1096,95.5,2114,1034,1080,95.7
11050, 광진구,075003, 72세,2016,2209,1019,1190,85.6,2184,1005,1179,85.2
11050, 광진구,075004, 73세,2016,2112,1002,1110,90.3,2089,993,1096,90.6
11050, 광진구,075005, 74세,2016,2353,1121,1232,91,2322,1109,1213,91.4
11050, 광진구,080,75~79세,2016,7938,3623,4315,84,7842,3594,4248,84.6
11050, 광진구,080001, 75세,2016,1911,898,1013,88.6,1896,892,1004,88.8
11050, 광진구,080002, 76세,2016,1694,801,893,89.7,1673,794,879,90.3
11050, 광진구,080003, 77세,2016,1588,729,859,84.9,1566,724,842,86
11050, 광진구,080004, 78세,2016,1493,666,827,80.5,1468,659,809,81.5
11050, 광진구,080005, 79세,2016,1252,529,723,73.2,1239,525,714,73.5
11050, 광진구,085,80~84세,2016,4172,1528,2644,57.8,4101,1510,2591,58.3
11050, 광진구,085001, 80세,2016,1029,387,642,60.3,1009,381,628,60.7
11050, 광진구,085002, 81세,2016,1004,366,638,57.4,992,363,629,57.7
11050, 광진구,085003, 82세,2016,823,320,503,63.6,807,314,493,63.7
11050, 광진구,085004, 83세,2016,689,244,445,54.8,674,242,432,56
11050, 광진구,085005, 84세,2016,627,211,416,50.7,619,210,409,51.3
11050, 광진구,090,85~89세,2016,1857,562,1295,43.4,1835,554,1281,43.2
11050, 광진구,090001, 85세,2016,468,140,328,42.7,463,138,325,42.5
11050, 광진구,090002, 86세,2016,427,127,300,42.3,422,125,297,42.1
11050, 광진구,090003, 87세,2016,383,130,253,51.4,378,128,250,51.2
11050, 광진구,090004, 88세,2016,332,93,239,38.9,330,93,237,39.2
11050, 광진구,090005, 89세,2016,247,72,175,41.1,242,70,172,40.7
11050, 광진구,095,90~94세,2016,619,156,463,33.7,612,154,458,33.6
11050, 광진구,095001, 90세,2016,181,43,138,31.2,179,43,136,31.6
11050, 광진구,095002, 91세,2016,134,40,94,42.6,130,38,92,41.3
11050, 광진구,095003, 92세,2016,115,34,81,42,115,34,81,42
11050, 광진구,095004, 93세,2016,99,19,80,23.8,99,19,80,23.8
11050, 광진구,095005, 94세,2016,90,20,70,28.6,89,20,69,29
11050, 광진구,100,95~99세,2016,163,40,123,32.5,160,38,122,31.1
11050, 광진구,100001, 95세,2016,59,16,43,37.2,58,15,43,34.9
11050, 광진구,100002, 96세,2016,40,7,33,21.2,39,7,32,21.9
11050, 광진구,100003, 97세,2016,26,11,15,73.3,25,10,15,66.7
11050, 광진구,100004, 98세,2016,20,X,17,17.6,20,X,17,17.6
11050, 광진구,100005, 99세,2016,18,X,15,20,18,X,15,20
11050, 광진구,101,100세이상,2016,24,X,22,9.1,23,X,21,9.5
11050, 광진구,102,15세미만,2016,37763,19435,18328,106,37068,19065,18003,105.9
11050, 광진구,103,15~64세,2016,285816,140367,145449,96.5,269818,132987,136831,97.2
11050, 광진구,104,65세이상,2016,40400,18056,22344,80.8,39590,17714,21876,81
11050, 광진구,086,85세이상,2016,2663,760,1903,39.9,2630,748,1882,39.7
11050, 광진구,126,평균연령,2016,40.2,39.5,40.8,,40.2,39.5,40.8,
11050, 광진구,127,중위연령,2016,39.4,38.7,40.1,,39.4,38.6,40.2,
11060, 동대문구,000,합계,2016,359935,178285,181650,98.1,343744,171397,172347,99.4
11060, 동대문구,005,0~4세,2016,12678,6524,6154,106,12433,6412,6021,106.5
11060, 동대문구,005001, 0세,2016,2442,1236,1206,102.5,2378,1207,1171,103.1
11060, 동대문구,005002, 1세,2016,2580,1336,1244,107.4,2521,1316,1205,109.2
11060, 동대문구,005003, 2세,2016,2504,1310,1194,109.7,2463,1288,1175,109.6
11060, 동대문구,005004, 3세,2016,2517,1311,1206,108.7,2474,1291,1183,109.1
11060, 동대문구,005005, 4세,2016,2635,1331,1304,102.1,2597,1310,1287,101.8
11060, 동대문구,010,5~9세,2016,12238,6273,5965,105.2,12052,6166,5886,104.8
11060, 동대문구,010001, 5세,2016,2572,1310,1262,103.8,2524,1283,1241,103.4
11060, 동대문구,010002, 6세,2016,2414,1244,1170,106.3,2378,1219,1159,105.2
11060, 동대문구,010003, 7세,2016,2296,1182,1114,106.1,2258,1159,1099,105.5
11060, 동대문구,010004, 8세,2016,2495,1263,1232,102.5,2459,1242,1217,102.1
11060, 동대문구,010005, 9세,2016,2461,1274,1187,107.3,2433,1263,1170,107.9
11060, 동대문구,015,10~14세,2016,11875,6045,5830,103.7,11758,5987,5771,103.7
11060, 동대문구,015001, 10세,2016,2347,1201,1146,104.8,2315,1187,1128,105.2
11060, 동대문구,015002, 11세,2016,2199,1106,1093,101.2,2175,1097,1078,101.8
11060, 동대문구,015003, 12세,2016,2374,1209,1165,103.8,2352,1198,1154,103.8
11060, 동대문구,015004, 13세,2016,2450,1259,1191,105.7,2432,1245,1187,104.9
11060, 동대문구,015005, 14세,2016,2505,1270,1235,102.8,2484,1260,1224,102.9
11060, 동대문구,020,15~19세,2016,19029,9268,9761,94.9,17762,8845,8917,99.2
11060, 동대문구,020001, 15세,2016,2816,1461,1355,107.8,2795,1448,1347,107.5
11060, 동대문구,020002, 16세,2016,3091,1549,1542,100.5,3063,1532,1531,100.1
11060, 동대문구,020003, 17세,2016,3137,1621,1516,106.9,3072,1602,1470,109
11060, 동대문구,020004, 18세,2016,4112,1942,2170,89.5,3740,1822,1918,95
11060, 동대문구,020005, 19세,2016,5873,2695,3178,84.8,5092,2441,2651,92.1
11060, 동대문구,025,20~24세,2016,33460,15905,17555,90.6,29093,14485,14608,99.2
11060, 동대문구,025001, 20세,2016,6227,2637,3590,73.5,5218,2348,2870,81.8
11060, 동대문구,025002, 21세,2016,6166,2758,3408,80.9,5257,2474,2783,88.9
11060, 동대문구,025003, 22세,2016,6712,3215,3497,91.9,5860,2942,2918,100.8
11060, 동대문구,025004, 23세,2016,6982,3502,3480,100.6,6157,3206,2951,108.6
11060, 동대문구,025005, 24세,2016,7373,3793,3580,105.9,6601,3515,3086,113.9
11060, 동대문구,030,25~29세,2016,30663,16327,14336,113.9,28085,15297,12788,119.6
11060, 동대문구,030001, 25세,2016,6926,3736,3190,117.1,6291,3512,2779,126.4
11060, 동대문구,030002, 26세,2016,6486,3458,3028,114.2,5906,3233,2673,121
11060, 동대문구,030003, 27세,2016,5978,3248,2730,119,5499,3047,2452,124.3
11060, 동대문구,030004, 28세,2016,5782,2980,2802,106.4,5329,2808,2521,111.4
11060, 동대문구,030005, 29세,2016,5491,2905,2586,112.3,5060,2697,2363,114.1
11060, 동대문구,035,30~34세,2016,27660,14339,13321,107.6,26346,13658,12688,107.6
11060, 동대문구,035001, 30세,2016,5395,2847,2548,111.7,5053,2669,2384,112
11060, 동대문구,035002, 31세,2016,5284,2740,2544,107.7,5009,2597,2412,107.7
11060, 동대문구,035003, 32세,2016,5307,2750,2557,107.5,5063,2615,2448,106.8
11060, 동대문구,035004, 33세,2016,5697,2951,2746,107.5,5465,2836,2629,107.9
11060, 동대문구,035005, 34세,2016,5977,3051,2926,104.3,5756,2941,2815,104.5
11060, 동대문구,040,35~39세,2016,27628,14326,13302,107.7,26673,13818,12855,107.5
11060, 동대문구,040001, 35세,2016,6018,3124,2894,107.9,5820,3023,2797,108.1
11060, 동대문구,040002, 36세,2016,5884,3068,2816,108.9,5694,2971,2723,109.1
11060, 동대문구,040003, 37세,2016,5526,2852,2674,106.7,5315,2736,2579,106.1
11060, 동대문구,040004, 38세,2016,4990,2578,2412,106.9,4809,2475,2334,106
11060, 동대문구,040005, 39세,2016,5210,2704,2506,107.9,5035,2613,2422,107.9
11060, 동대문구,045,40~44세,2016,26800,14051,12749,110.2,25970,13580,12390,109.6
11060, 동대문구,045001, 40세,2016,4973,2581,2392,107.9,4799,2495,2304,108.3
11060, 동대문구,045002, 41세,2016,5143,2684,2459,109.2,5013,2602,2411,107.9
11060, 동대문구,045003, 42세,2016,5421,2871,2550,112.6,5253,2777,2476,112.2
11060, 동대문구,045004, 43세,2016,5539,2845,2694,105.6,5372,2755,2617,105.3
11060, 동대문구,045005, 44세,2016,5724,3070,2654,115.7,5533,2951,2582,114.3
11060, 동대문구,050,45~49세,2016,28073,14144,13929,101.5,27059,13632,13427,101.5
11060, 동대문구,050001, 45세,2016,5967,3111,2856,108.9,5765,3007,2758,109
11060, 동대문구,050002, 46세,2016,5692,2888,2804,103,5483,2768,2715,102
11060, 동대문구,050003, 47세,2016,5693,2843,2850,99.8,5465,2730,2735,99.8
11060, 동대문구,050004, 48세,2016,5575,2808,2767,101.5,5379,2710,2669,101.5
11060, 동대문구,050005, 49세,2016,5146,2494,2652,94,4967,2417,2550,94.8
11060, 동대문구,055,50~54세,2016,26802,13449,13353,100.7,25620,12868,12752,100.9
11060, 동대문구,055001, 50세,2016,5145,2675,2470,108.3,4921,2570,2351,109.3
11060, 동대문구,055002, 51세,2016,5431,2702,2729,99,5196,2586,2610,99.1
11060, 동대문구,055003, 52세,2016,5163,2578,2585,99.7,4925,2460,2465,99.8
11060, 동대문구,055004, 53세,2016,5477,2725,2752,99,5212,2592,2620,98.9
11060, 동대문구,055005, 54세,2016,5586,2769,2817,98.3,5366,2660,2706,98.3
11060, 동대문구,060,55~59세,2016,28680,13856,14824,93.5,27816,13453,14363,93.7
11060, 동대문구,060001, 55세,2016,5925,2873,3052,94.1,5801,2809,2992,93.9
11060, 동대문구,060002, 56세,2016,6140,2937,3203,91.7,5936,2834,3102,91.4
11060, 동대문구,060003, 57세,2016,5622,2726,2896,94.1,5471,2653,2818,94.1
11060, 동대문구,060004, 58세,2016,5557,2710,2847,95.2,5373,2637,2736,96.4
11060, 동대문구,060005, 59세,2016,5436,2610,2826,92.4,5235,2520,2715,92.8
11060, 동대문구,065,60~64세,2016,23320,11227,12093,92.8,22644,10906,11738,92.9
11060, 동대문구,065001, 60세,2016,5146,2530,2616,96.7,5014,2462,2552,96.5
11060, 동대문구,065002, 61세,2016,5272,2544,2728,93.3,5109,2467,2642,93.4
11060, 동대문구,065003, 62세,2016,4563,2199,2364,93,4433,2137,2296,93.1
11060, 동대문구,065004, 63세,2016,4077,1968,2109,93.3,3941,1913,2028,94.3
11060, 동대문구,065005, 64세,2016,4262,1986,2276,87.3,4147,1927,2220,86.8
11060, 동대문구,070,65~69세,2016,17340,8153,9187,88.7,16995,7987,9008,88.7
11060, 동대문구,070001, 65세,2016,3224,1520,1704,89.2,3123,1475,1648,89.5
11060, 동대문구,070002, 66세,2016,3532,1748,1784,98,3454,1708,1746,97.8
11060, 동대문구,070003, 67세,2016,3512,1678,1834,91.5,3436,1638,1798,91.1
11060, 동대문구,070004, 68세,2016,3498,1576,1922,82,3456,1557,1899,82
11060, 동대문구,070005, 69세,2016,3574,1631,1943,83.9,3526,1609,1917,83.9
11060, 동대문구,075,70~74세,2016,14398,6607,7791,84.8,14293,6565,7728,85
11060, 동대문구,075001, 70세,2016,2789,1301,1488,87.4,2762,1288,1474,87.4
11060, 동대문구,075002, 71세,2016,2821,1288,1533,84,2801,1281,1520,84.3
11060, 동대문구,075003, 72세,2016,2737,1217,1520,80.1,2715,1208,1507,80.2
11060, 동대문구,075004, 73세,2016,2840,1343,1497,89.7,2822,1333,1489,89.5
11060, 동대문구,075005, 74세,2016,3211,1458,1753,83.2,3193,1455,1738,83.7
11060, 동대문구,080,75~79세,2016,10433,4642,5791,80.2,10361,4618,5743,80.4
11060, 동대문구,080001, 75세,2016,2479,1164,1315,88.5,2464,1157,1307,88.5
11060, 동대문구,080002, 76세,2016,2235,977,1258,77.7,2212,968,1244,77.8
11060, 동대문구,080003, 77세,2016,2180,975,1205,80.9,2173,973,1200,81.1
11060, 동대문구,080004, 78세,2016,1907,832,1075,77.4,1897,830,1067,77.8
11060, 동대문구,080005, 79세,2016,1632,694,938,74,1615,690,925,74.6
11060, 동대문구,085,80~84세,2016,5639,2212,3427,64.5,5595,2191,3404,64.4
11060, 동대문구,085001, 80세,2016,1465,615,850,72.4,1454,611,843,72.5
11060, 동대문구,085002, 81세,2016,1333,532,801,66.4,1321,529,792,66.8
11060, 동대문구,085003, 82세,2016,1106,420,686,61.2,1099,414,685,60.4
11060, 동대문구,085004, 83세,2016,916,332,584,56.8,907,327,580,56.4
11060, 동대문구,085005, 84세,2016,819,313,506,61.9,814,310,504,61.5
11060, 동대문구,090,85~89세,2016,2298,708,1590,44.5,2281,705,1576,44.7
11060, 동대문구,090001, 85세,2016,580,187,393,47.6,572,186,386,48.2
11060, 동대문구,090002, 86세,2016,559,177,382,46.3,554,175,379,46.2
11060, 동대문구,090003, 87세,2016,463,148,315,47,462,148,314,47.1
11060, 동대문구,090004, 88세,2016,375,105,270,38.9,373,105,268,39.2
11060, 동대문구,090005, 89세,2016,321,91,230,39.6,320,91,229,39.7
11060, 동대문구,095,90~94세,2016,722,179,543,33,716,176,540,32.6
11060, 동대문구,095001, 90세,2016,221,50,171,29.2,219,48,171,28.1
11060, 동대문구,095002, 91세,2016,158,42,116,36.2,155,41,114,36
11060, 동대문구,095003, 92세,2016,123,30,93,32.3,123,30,93,32.3
11060, 동대문구,095004, 93세,2016,135,38,97,39.2,134,38,96,39.6
11060, 동대문구,095005, 94세,2016,85,19,66,28.8,85,19,66,28.8
11060, 동대문구,100,95~99세,2016,172,43,129,33.3,167,41,126,32.5
11060, 동대문구,100001, 95세,2016,65,11,54,20.4,64,11,53,20.8
11060, 동대문구,100002, 96세,2016,51,16,35,45.7,48,14,34,41.2
11060, 동대문구,100003, 97세,2016,24,9,15,60,23,9,14,64.3
11060, 동대문구,100004, 98세,2016,18,X,14,28.6,18,X,14,28.6
11060, 동대문구,100005, 99세,2016,14,X,11,27.3,14,X,11,27.3
11060, 동대문구,101,100세이상,2016,27,7,20,35,25,7,18,38.9
11060, 동대문구,102,15세미만,2016,36791,18842,17949,105,36243,18565,17678,105
11060, 동대문구,103,15~64세,2016,272115,136892,135223,101.2,257068,130542,126526,103.2
11060, 동대문구,104,65세이상,2016,51029,22551,28478,79.2,50433,22290,28143,79.2
11060, 동대문구,086,85세이상,2016,3219,937,2282,41.1,3189,929,2260,41.1
11060, 동대문구,126,평균연령,2016,41.4,40.6,42.2,,41.7,40.8,42.7,
11060, 동대문구,127,중위연령,2016,41,40.1,41.9,,41.6,40.4,42.8,
11070, 중랑구,000,합계,2016,399317,197875,201442,98.2,393547,195451,198096,98.7
11070, 중랑구,005,0~4세,2016,15149,7766,7383,105.2,14999,7681,7318,105
11070, 중랑구,005001, 0세,2016,2992,1505,1487,101.2,2961,1486,1475,100.7
11070, 중랑구,005002, 1세,2016,3124,1641,1483,110.7,3098,1628,1470,110.7
11070, 중랑구,005003, 2세,2016,2965,1488,1477,100.7,2933,1470,1463,100.5
11070, 중랑구,005004, 3세,2016,2926,1504,1422,105.8,2895,1486,1409,105.5
11070, 중랑구,005005, 4세,2016,3142,1628,1514,107.5,3112,1611,1501,107.3
11070, 중랑구,010,5~9세,2016,13707,6959,6748,103.1,13594,6909,6685,103.4
11070, 중랑구,010001, 5세,2016,2924,1489,1435,103.8,2899,1477,1422,103.9
11070, 중랑구,010002, 6세,2016,2725,1399,1326,105.5,2695,1388,1307,106.2
11070, 중랑구,010003, 7세,2016,2532,1265,1267,99.8,2510,1258,1252,100.5
11070, 중랑구,010004, 8세,2016,2725,1379,1346,102.5,2704,1367,1337,102.2
11070, 중랑구,010005, 9세,2016,2801,1427,1374,103.9,2786,1419,1367,103.8
11070, 중랑구,015,10~14세,2016,13687,7041,6646,105.9,13626,7015,6611,106.1
11070, 중랑구,015001, 10세,2016,2581,1374,1207,113.8,2568,1367,1201,113.8
11070, 중랑구,015002, 11세,2016,2551,1337,1214,110.1,2541,1333,1208,110.3
11070, 중랑구,015003, 12세,2016,2709,1339,1370,97.7,2696,1334,1362,97.9
11070, 중랑구,015004, 13세,2016,2907,1462,1445,101.2,2898,1459,1439,101.4
11070, 중랑구,015005, 14세,2016,2939,1529,1410,108.4,2923,1522,1401,108.6
11070, 중랑구,020,15~19세,2016,19756,10239,9517,107.6,19675,10201,9474,107.7
11070, 중랑구,020001, 15세,2016,3405,1806,1599,112.9,3396,1801,1595,112.9
11070, 중랑구,020002, 16세,2016,3890,1950,1940,100.5,3872,1946,1926,101
11070, 중랑구,020003, 17세,2016,3911,2005,1906,105.2,3900,1998,1902,105
11070, 중랑구,020004, 18세,2016,4177,2251,1926,116.9,4159,2241,1918,116.8
11070, 중랑구,020005, 19세,2016,4373,2227,2146,103.8,4348,2215,2133,103.8
11070, 중랑구,025,20~24세,2016,27473,13996,13477,103.9,27115,13859,13256,104.5
11070, 중랑구,025001, 20세,2016,4868,2575,2293,112.3,4831,2564,2267,113.1
11070, 중랑구,025002, 21세,2016,5252,2796,2456,113.8,5195,2769,2426,114.1
11070, 중랑구,025003, 22세,2016,5453,2750,2703,101.7,5404,2729,2675,102
11070, 중랑구,025004, 23세,2016,5665,2838,2827,100.4,5569,2805,2764,101.5
11070, 중랑구,025005, 24세,2016,6235,3037,3198,95,6116,2992,3124,95.8
11070, 중랑구,030,25~29세,2016,29191,14327,14864,96.4,28392,14002,14390,97.3
11070, 중랑구,030001, 25세,2016,5958,2876,3082,93.3,5833,2829,3004,94.2
11070, 중랑구,030002, 26세,2016,5874,2884,2990,96.5,5705,2819,2886,97.7
11070, 중랑구,030003, 27세,2016,5777,2839,2938,96.6,5601,2770,2831,97.8
11070, 중랑구,030004, 28세,2016,5840,2851,2989,95.4,5694,2794,2900,96.3
11070, 중랑구,030005, 29세,2016,5742,2877,2865,100.4,5559,2790,2769,100.8
11070, 중랑구,035,30~34세,2016,32065,16496,15569,106,31356,16207,15149,107
11070, 중랑구,035001, 30세,2016,6023,3091,2932,105.4,5860,3025,2835,106.7
11070, 중랑구,035002, 31세,2016,6073,3089,2984,103.5,5933,3031,2902,104.4
11070, 중랑구,035003, 32세,2016,6175,3146,3029,103.9,6044,3084,2960,104.2
11070, 중랑구,035004, 33세,2016,6722,3515,3207,109.6,6577,3467,3110,111.5
11070, 중랑구,035005, 34세,2016,7072,3655,3417,107,6942,3600,3342,107.7
11070, 중랑구,040,35~39세,2016,31753,16792,14961,112.2,31240,16563,14677,112.9
11070, 중랑구,040001, 35세,2016,7005,3718,3287,113.1,6881,3666,3215,114
11070, 중랑구,040002, 36세,2016,7108,3748,3360,111.5,6997,3695,3302,111.9
11070, 중랑구,040003, 37세,2016,6408,3378,3030,111.5,6295,3329,2966,112.2
11070, 중랑구,040004, 38세,2016,5562,2981,2581,115.5,5471,2938,2533,116
11070, 중랑구,040005, 39세,2016,5670,2967,2703,109.8,5596,2935,2661,110.3
11070, 중랑구,045,40~44세,2016,29648,15188,14460,105,29160,14990,14170,105.8
11070, 중랑구,045001, 40세,2016,5445,2883,2562,112.5,5340,2840,2500,113.6
11070, 중랑구,045002, 41세,2016,5594,2872,2722,105.5,5510,2835,2675,106
11070, 중랑구,045003, 42세,2016,6007,3083,2924,105.4,5920,3047,2873,106.1
11070, 중랑구,045004, 43세,2016,6257,3171,3086,102.8,6156,3132,3024,103.6
11070, 중랑구,045005, 44세,2016,6345,3179,3166,100.4,6234,3136,3098,101.2
11070, 중랑구,050,45~49세,2016,34169,16830,17339,97.1,33547,16560,16987,97.5
11070, 중랑구,050001, 45세,2016,6939,3551,3388,104.8,6807,3493,3314,105.4
11070, 중랑구,050002, 46세,2016,6667,3322,3345,99.3,6538,3267,3271,99.9
11070, 중랑구,050003, 47세,2016,6947,3468,3479,99.7,6823,3414,3409,100.1
11070, 중랑구,050004, 48세,2016,7058,3368,3690,91.3,6926,3309,3617,91.5
11070, 중랑구,050005, 49세,2016,6558,3121,3437,90.8,6453,3077,3376,91.1
11070, 중랑구,055,50~54세,2016,34387,16948,17439,97.2,33705,16669,17036,97.8
11070, 중랑구,055001, 50세,2016,6512,3218,3294,97.7,6375,3157,3218,98.1
11070, 중랑구,055002, 51세,2016,6853,3313,3540,93.6,6725,3269,3456,94.6
11070, 중랑구,055003, 52세,2016,6692,3288,3404,96.6,6552,3229,3323,97.2
11070, 중랑구,055004, 53세,2016,6895,3375,3520,95.9,6744,3309,3435,96.3
11070, 중랑구,055005, 54세,2016,7435,3754,3681,102,7309,3705,3604,102.8
11070, 중랑구,060,55~59세,2016,36444,17737,18707,94.8,35961,17540,18421,95.2
11070, 중랑구,060001, 55세,2016,7970,3828,4142,92.4,7899,3800,4099,92.7
11070, 중랑구,060002, 56세,2016,7939,3872,4067,95.2,7819,3821,3998,95.6
11070, 중랑구,060003, 57세,2016,7047,3448,3599,95.8,6942,3405,3537,96.3
11070, 중랑구,060004, 58세,2016,6840,3356,3484,96.3,6748,3324,3424,97.1
11070, 중랑구,060005, 59세,2016,6648,3233,3415,94.7,6553,3190,3363,94.9
11070, 중랑구,065,60~64세,2016,27778,13529,14249,94.9,27374,13345,14029,95.1
11070, 중랑구,065001, 60세,2016,6176,3043,3133,97.1,6093,3006,3087,97.4
11070, 중랑구,065002, 61세,2016,6422,3067,3355,91.4,6329,3023,3306,91.4
11070, 중랑구,065003, 62세,2016,5432,2684,2748,97.7,5346,2645,2701,97.9
11070, 중랑구,065004, 63세,2016,4681,2258,2423,93.2,4617,2230,2387,93.4
11070, 중랑구,065005, 64세,2016,5067,2477,2590,95.6,4989,2441,2548,95.8
11070, 중랑구,070,65~69세,2016,19731,9414,10317,91.2,19551,9337,10214,91.4
11070, 중랑구,070001, 65세,2016,3700,1762,1938,90.9,3651,1740,1911,91.1
11070, 중랑구,070002, 66세,2016,3994,1962,2032,96.6,3961,1951,2010,97.1
11070, 중랑구,070003, 67세,2016,4110,1970,2140,92.1,4063,1945,2118,91.8
11070, 중랑구,070004, 68세,2016,3955,1877,2078,90.3,3925,1864,2061,90.4
11070, 중랑구,070005, 69세,2016,3972,1843,2129,86.6,3951,1837,2114,86.9
11070, 중랑구,075,70~74세,2016,15171,7053,8118,86.9,15110,7031,8079,87
11070, 중랑구,075001, 70세,2016,3063,1435,1628,88.1,3039,1427,1612,88.5
11070, 중랑구,075002, 71세,2016,2907,1345,1562,86.1,2893,1339,1554,86.2
11070, 중랑구,075003, 72세,2016,2909,1338,1571,85.2,2898,1334,1564,85.3
11070, 중랑구,075004, 73세,2016,2927,1378,1549,89,2919,1376,1543,89.2
11070, 중랑구,075005, 74세,2016,3365,1557,1808,86.1,3361,1555,1806,86.1
11070, 중랑구,080,75~79세,2016,10386,4701,5685,82.7,10357,4693,5664,82.9
11070, 중랑구,080001, 75세,2016,2589,1214,1375,88.3,2584,1214,1370,88.6
11070, 중랑구,080002, 76세,2016,2234,1013,1221,83,2225,1009,1216,83
11070, 중랑구,080003, 77세,2016,2141,982,1159,84.7,2135,980,1155,84.8
11070, 중랑구,080004, 78세,2016,1823,795,1028,77.3,1820,794,1026,77.4
11070, 중랑구,080005, 79세,2016,1599,697,902,77.3,1593,696,897,77.6
11070, 중랑구,085,80~84세,2016,5464,2066,3398,60.8,5445,2061,3384,60.9
11070, 중랑구,085001, 80세,2016,1445,607,838,72.4,1444,607,837,72.5
11070, 중랑구,085002, 81세,2016,1326,492,834,59,1322,490,832,58.9
11070, 중랑구,085003, 82세,2016,1074,405,669,60.5,1069,404,665,60.8
11070, 중랑구,085004, 83세,2016,853,285,568,50.2,848,285,563,50.6
11070, 중랑구,085005, 84세,2016,766,277,489,56.6,762,275,487,56.5
11070, 중랑구,090,85~89세,2016,2377,585,1792,32.6,2365,582,1783,32.6
11070, 중랑구,090001, 85세,2016,619,169,450,37.6,611,167,444,37.6
11070, 중랑구,090002, 86세,2016,565,139,426,32.6,564,139,425,32.7
11070, 중랑구,090003, 87세,2016,470,118,352,33.5,470,118,352,33.5
11070, 중랑구,090004, 88세,2016,420,86,334,25.7,419,86,333,25.8
11070, 중랑구,090005, 89세,2016,303,73,230,31.7,301,72,229,31.4
11070, 중랑구,095,90~94세,2016,782,171,611,28,777,170,607,28
11070, 중랑구,095001, 90세,2016,213,50,163,30.7,212,50,162,30.9
11070, 중랑구,095002, 91세,2016,197,38,159,23.9,196,38,158,24.1
11070, 중랑구,095003, 92세,2016,136,34,102,33.3,134,33,101,32.7
11070, 중랑구,095004, 93세,2016,141,35,106,33,141,35,106,33
11070, 중랑구,095005, 94세,2016,95,14,81,17.3,94,14,80,17.5
11070, 중랑구,100,95~99세,2016,171,33,138,23.9,170,32,138,23.2
11070, 중랑구,100001, 95세,2016,60,15,45,33.3,60,15,45,33.3
11070, 중랑구,100002, 96세,2016,51,11,40,27.5,50,10,40,25
11070, 중랑구,100003, 97세,2016,31,X,27,14.8,31,X,27,14.8
11070, 중랑구,100004, 98세,2016,18,X,17,5.9,18,X,17,5.9
11070, 중랑구,100005, 99세,2016,11,X,9,22.2,11,X,9,22.2
11070, 중랑구,101,100세이상,2016,28,X,24,16.7,28,X,24,16.7
11070, 중랑구,102,15세미만,2016,42543,21766,20777,104.8,42219,21605,20614,104.8
11070, 중랑구,103,15~64세,2016,302664,152082,150582,101,297525,149936,147589,101.6
11070, 중랑구,104,65세이상,2016,54110,24027,30083,79.9,53803,23910,29893,80
11070, 중랑구,086,85세이상,2016,3358,793,2565,30.9,3340,788,2552,30.9
11070, 중랑구,126,평균연령,2016,42.1,41.3,42.9,,42.1,41.3,43,
11070, 중랑구,127,중위연령,2016,43,41.8,44.1,,43,41.9,44.1,
11080, 성북구,000,합계,2016,451800,218606,233194,93.7,439623,213250,226373,94.2
11080, 성북구,005,0~4세,2016,16821,8597,8224,104.5,16621,8504,8117,104.8
11080, 성북구,005001, 0세,2016,3142,1585,1557,101.8,3094,1567,1527,102.6
11080, 성북구,005002, 1세,2016,3354,1723,1631,105.6,3320,1708,1612,106
11080, 성북구,005003, 2세,2016,3305,1699,1606,105.8,3263,1679,1584,106
11080, 성북구,005004, 3세,2016,3334,1664,1670,99.6,3285,1638,1647,99.5
11080, 성북구,005005, 4세,2016,3686,1926,1760,109.4,3659,1912,1747,109.4
11080, 성북구,010,5~9세,2016,18207,9369,8838,106,18019,9268,8751,105.9
11080, 성북구,010001, 5세,2016,3643,1870,1773,105.5,3605,1854,1751,105.9
11080, 성북구,010002, 6세,2016,3599,1816,1783,101.9,3556,1796,1760,102
11080, 성북구,010003, 7세,2016,3459,1775,1684,105.4,3427,1756,1671,105.1
11080, 성북구,010004, 8세,2016,3622,1900,1722,110.3,3588,1879,1709,109.9
11080, 성북구,010005, 9세,2016,3884,2008,1876,107,3843,1983,1860,106.6
11080, 성북구,015,10~14세,2016,18180,9395,8785,106.9,18071,9332,8739,106.8
11080, 성북구,015001, 10세,2016,3488,1783,1705,104.6,3467,1770,1697,104.3
11080, 성북구,015002, 11세,2016,3409,1786,1623,110,3398,1779,1619,109.9
11080, 성북구,015003, 12세,2016,3779,1978,1801,109.8,3754,1964,1790,109.7
11080, 성북구,015004, 13세,2016,3714,1936,1778,108.9,3691,1923,1768,108.8
11080, 성북구,015005, 14세,2016,3790,1912,1878,101.8,3761,1896,1865,101.7
11080, 성북구,020,15~19세,2016,26634,12779,13855,92.2,25614,12425,13189,94.2
11080, 성북구,020001, 15세,2016,4183,2105,2078,101.3,4162,2093,2069,101.2
11080, 성북구,020002, 16세,2016,4472,2289,2183,104.9,4444,2272,2172,104.6
11080, 성북구,020003, 17세,2016,4495,2299,2196,104.7,4430,2274,2156,105.5
11080, 성북구,020004, 18세,2016,5589,2672,2917,91.6,5312,2568,2744,93.6
11080, 성북구,020005, 19세,2016,7895,3414,4481,76.2,7266,3218,4048,79.5
11080, 성북구,025,20~24세,2016,40923,18668,22255,83.9,37456,17349,20107,86.3
11080, 성북구,025001, 20세,2016,8096,3394,4702,72.2,7223,3096,4127,75
11080, 성북구,025002, 21세,2016,7883,3375,4508,74.9,7079,3099,3980,77.9
11080, 성북구,025003, 22세,2016,8070,3718,4352,85.4,7437,3468,3969,87.4
11080, 성북구,025004, 23세,2016,8431,4066,4365,93.2,7833,3821,4012,95.2
11080, 성북구,025005, 24세,2016,8443,4115,4328,95.1,7884,3865,4019,96.2
11080, 성북구,030,25~29세,2016,34280,17459,16821,103.8,32336,16585,15751,105.3
11080, 성북구,030001, 25세,2016,7823,4020,3803,105.7,7358,3816,3542,107.7
11080, 성북구,030002, 26세,2016,7097,3593,3504,102.5,6641,3393,3248,104.5
11080, 성북구,030003, 27세,2016,6642,3439,3203,107.4,6300,3285,3015,109
11080, 성북구,030004, 28세,2016,6433,3241,3192,101.5,6066,3080,2986,103.1
11080, 성북구,030005, 29세,2016,6285,3166,3119,101.5,5971,3011,2960,101.7
11080, 성북구,035,30~34세,2016,32269,16108,16161,99.7,31076,15523,15553,99.8
11080, 성북구,035001, 30세,2016,6290,3180,3110,102.3,5978,3030,2948,102.8
11080, 성북구,035002, 31세,2016,5951,2940,3011,97.6,5708,2823,2885,97.9
11080, 성북구,035003, 32세,2016,6207,3131,3076,101.8,5981,3013,2968,101.5
11080, 성북구,035004, 33세,2016,6723,3324,3399,97.8,6514,3228,3286,98.2
11080, 성북구,035005, 34세,2016,7098,3533,3565,99.1,6895,3429,3466,98.9
11080, 성북구,040,35~39세,2016,34062,17062,17000,100.4,33273,16657,16616,100.2
11080, 성북구,040001, 35세,2016,7269,3737,3532,105.8,7104,3651,3453,105.7
11080, 성북구,040002, 36세,2016,7210,3524,3686,95.6,7051,3449,3602,95.8
11080, 성북구,040003, 37세,2016,7021,3524,3497,100.8,6860,3434,3426,100.2
11080, 성북구,040004, 38세,2016,6117,3053,3064,99.6,5938,2967,2971,99.9
11080, 성북구,040005, 39세,2016,6445,3224,3221,100.1,6320,3156,3164,99.7
11080, 성북구,045,40~44세,2016,37150,18641,18509,100.7,36433,18271,18162,100.6
11080, 성북구,045001, 40세,2016,6666,3331,3335,99.9,6521,3258,3263,99.8
11080, 성북구,045002, 41세,2016,7078,3539,3539,100,6947,3470,3477,99.8
11080, 성북구,045003, 42세,2016,7676,3841,3835,100.2,7548,3772,3776,99.9
11080, 성북구,045004, 43세,2016,7798,3896,3902,99.8,7631,3803,3828,99.3
11080, 성북구,045005, 44세,2016,7932,4034,3898,103.5,7786,3968,3818,103.9
11080, 성북구,050,45~49세,2016,37979,19061,18918,100.8,37255,18707,18548,100.9
11080, 성북구,050001, 45세,2016,8228,4169,4059,102.7,8077,4093,3984,102.7
11080, 성북구,050002, 46세,2016,7834,3921,3913,100.2,7679,3839,3840,100
11080, 성북구,050003, 47세,2016,7752,3905,3847,101.5,7603,3838,3765,101.9
11080, 성북구,050004, 48세,2016,7446,3771,3675,102.6,7299,3698,3601,102.7
11080, 성북구,050005, 49세,2016,6719,3295,3424,96.2,6597,3239,3358,96.5
11080, 성북구,055,50~54세,2016,32981,15989,16992,94.1,32331,15696,16635,94.4
11080, 성북구,055001, 50세,2016,6393,3186,3207,99.3,6278,3131,3147,99.5
11080, 성북구,055002, 51세,2016,6672,3218,3454,93.2,6539,3162,3377,93.6
11080, 성북구,055003, 52세,2016,6538,3152,3386,93.1,6416,3094,3322,93.1
11080, 성북구,055004, 53세,2016,6615,3185,3430,92.9,6458,3109,3349,92.8
11080, 성북구,055005, 54세,2016,6763,3248,3515,92.4,6640,3200,3440,93
11080, 성북구,060,55~59세,2016,34146,16274,17872,91.1,33687,16058,17629,91.1
11080, 성북구,060001, 55세,2016,7158,3450,3708,93,7072,3408,3664,93
11080, 성북구,060002, 56세,2016,7357,3426,3931,87.2,7244,3369,3875,86.9
11080, 성북구,060003, 57세,2016,6675,3232,3443,93.9,6585,3187,3398,93.8
11080, 성북구,060004, 58세,2016,6492,3139,3353,93.6,6411,3102,3309,93.7
11080, 성북구,060005, 59세,2016,6464,3027,3437,88.1,6375,2992,3383,88.4
11080, 성북구,065,60~64세,2016,27166,12876,14290,90.1,26814,12710,14104,90.1
11080, 성북구,065001, 60세,2016,6086,2907,3179,91.4,5997,2860,3137,91.2
11080, 성북구,065002, 61세,2016,6205,2916,3289,88.7,6125,2881,3244,88.8
11080, 성북구,065003, 62세,2016,5223,2520,2703,93.2,5149,2486,2663,93.4
11080, 성북구,065004, 63세,2016,4655,2179,2476,88,4597,2153,2444,88.1
11080, 성북구,065005, 64세,2016,4997,2354,2643,89.1,4946,2330,2616,89.1
11080, 성북구,070,65~69세,2016,20227,9237,10990,84,20049,9151,10898,84
11080, 성북구,070001, 65세,2016,3549,1666,1883,88.5,3511,1644,1867,88.1
11080, 성북구,070002, 66세,2016,4163,1937,2226,87,4109,1913,2196,87.1
11080, 성북구,070003, 67세,2016,4242,1935,2307,83.9,4206,1919,2287,83.9
11080, 성북구,070004, 68세,2016,4031,1800,2231,80.7,4002,1786,2216,80.6
11080, 성북구,070005, 69세,2016,4242,1899,2343,81,4221,1889,2332,81
11080, 성북구,075,70~74세,2016,17023,7689,9334,82.4,16958,7658,9300,82.3
11080, 성북구,075001, 70세,2016,3371,1494,1877,79.6,3353,1482,1871,79.2
11080, 성북구,075002, 71세,2016,3180,1439,1741,82.7,3168,1434,1734,82.7
11080, 성북구,075003, 72세,2016,3295,1473,1822,80.8,3275,1463,1812,80.7
11080, 성북구,075004, 73세,2016,3337,1526,1811,84.3,3330,1524,1806,84.4
11080, 성북구,075005, 74세,2016,3840,1757,2083,84.3,3832,1755,2077,84.5
11080, 성북구,080,75~79세,2016,12833,5578,7255,76.9,12781,5555,7226,76.9
11080, 성북구,080001, 75세,2016,3084,1426,1658,86,3073,1423,1650,86.2
11080, 성북구,080002, 76세,2016,2753,1183,1570,75.4,2744,1177,1567,75.1
11080, 성북구,080003, 77세,2016,2651,1158,1493,77.6,2635,1151,1484,77.6
11080, 성북구,080004, 78세,2016,2313,992,1321,75.1,2306,989,1317,75.1
11080, 성북구,080005, 79세,2016,2032,819,1213,67.5,2023,815,1208,67.5
11080, 성북구,085,80~84세,2016,6815,2672,4143,64.5,6775,2659,4116,64.6
11080, 성북구,085001, 80세,2016,1785,742,1043,71.1,1772,737,1035,71.2
11080, 성북구,085002, 81세,2016,1717,685,1032,66.4,1715,685,1030,66.5
11080, 성북구,085003, 82세,2016,1312,508,804,63.2,1302,503,799,63
11080, 성북구,085004, 83세,2016,1082,420,662,63.4,1073,418,655,63.8
11080, 성북구,085005, 84세,2016,919,317,602,52.7,913,316,597,52.9
11080, 성북구,090,85~89세,2016,2960,869,2091,41.6,2947,865,2082,41.5
11080, 성북구,090001, 85세,2016,775,250,525,47.6,773,248,525,47.2
11080, 성북구,090002, 86세,2016,686,206,480,42.9,683,206,477,43.2
11080, 성북구,090003, 87세,2016,587,172,415,41.4,584,171,413,41.4
11080, 성북구,090004, 88세,2016,514,137,377,36.3,510,136,374,36.4
11080, 성북구,090005, 89세,2016,398,104,294,35.4,397,104,293,35.5
11080, 성북구,095,90~94세,2016,919,229,690,33.2,907,225,682,33
11080, 성북구,095001, 90세,2016,288,66,222,29.7,284,64,220,29.1
11080, 성북구,095002, 91세,2016,197,45,152,29.6,195,44,151,29.1
11080, 성북구,095003, 92세,2016,159,44,115,38.3,159,44,115,38.3
11080, 성북구,095004, 93세,2016,156,42,114,36.8,152,41,111,36.9
11080, 성북구,095005, 94세,2016,119,32,87,36.8,117,32,85,37.6
11080, 성북구,100,95~99세,2016,205,50,155,32.3,201,48,153,31.4
11080, 성북구,100001, 95세,2016,71,20,51,39.2,70,19,51,37.3
11080, 성북구,100002, 96세,2016,53,8,45,17.8,52,8,44,18.2
11080, 성북구,100003, 97세,2016,46,12,34,35.3,46,12,34,35.3
11080, 성북구,100004, 98세,2016,15,X,11,36.4,14,X,11,27.3
11080, 성북구,100005, 99세,2016,20,6,14,42.9,19,6,13,46.2
11080, 성북구,101,100세이상,2016,20,X,16,25,19,X,15,26.7
11080, 성북구,102,15세미만,2016,53208,27361,25847,105.9,52711,27104,25607,105.8
11080, 성북구,103,15~64세,2016,337590,164917,172673,95.5,326275,159981,166294,96.2
11080, 성북구,104,65세이상,2016,61002,26328,34674,75.9,60637,26165,34472,75.9
11080, 성북구,086,85세이상,2016,4104,1152,2952,39,4074,1142,2932,38.9
11080, 성북구,126,평균연령,2016,40.6,39.8,41.4,,40.9,40,41.7,
11080, 성북구,127,중위연령,2016,40.7,40,41.4,,41.1,40.3,41.9,
11090, 강북구,000,합계,2016,316212,154407,161805,95.4,311917,152689,159228,95.9
11090, 강북구,005,0~4세,2016,10520,5442,5078,107.2,10439,5398,5041,107.1
11090, 강북구,005001, 0세,2016,1951,991,960,103.2,1939,983,956,102.8
11090, 강북구,005002, 1세,2016,2035,1047,988,106,2023,1040,983,105.8
11090, 강북구,005003, 2세,2016,2077,1061,1016,104.4,2063,1055,1008,104.7
11090, 강북구,005004, 3세,2016,2141,1125,1016,110.7,2119,1111,1008,110.2
11090, 강북구,005005, 4세,2016,2316,1218,1098,110.9,2295,1209,1086,111.3
11090, 강북구,010,5~9세,2016,10759,5493,5266,104.3,10711,5468,5243,104.3
11090, 강북구,010001, 5세,2016,2253,1130,1123,100.6,2243,1125,1118,100.6
11090, 강북구,010002, 6세,2016,2153,1104,1049,105.2,2140,1099,1041,105.6
11090, 강북구,010003, 7세,2016,2066,1064,1002,106.2,2058,1057,1001,105.6
11090, 강북구,010004, 8세,2016,2145,1075,1070,100.5,2137,1070,1067,100.3
11090, 강북구,010005, 9세,2016,2142,1120,1022,109.6,2133,1117,1016,109.9
11090, 강북구,015,10~14세,2016,11241,5828,5413,107.7,11213,5814,5399,107.7
11090, 강북구,015001, 10세,2016,2098,1091,1007,108.3,2093,1088,1005,108.3
11090, 강북구,015002, 11세,2016,2117,1079,1038,103.9,2113,1078,1035,104.2
11090, 강북구,015003, 12세,2016,2210,1112,1098,101.3,2204,1110,1094,101.5
11090, 강북구,015004, 13세,2016,2409,1264,1145,110.4,2403,1261,1142,110.4
11090, 강북구,015005, 14세,2016,2407,1282,1125,114,2400,1277,1123,113.7
11090, 강북구,020,15~19세,2016,15827,8103,7724,104.9,15751,8072,7679,105.1
11090, 강북구,020001, 15세,2016,2821,1478,1343,110.1,2817,1476,1341,110.1
11090, 강북구,020002, 16세,2016,3123,1687,1436,117.5,3107,1678,1429,117.4
11090, 강북구,020003, 17세,2016,3070,1549,1521,101.8,3060,1545,1515,102
11090, 강북구,020004, 18세,2016,3311,1672,1639,102,3295,1667,1628,102.4
11090, 강북구,020005, 19세,2016,3502,1717,1785,96.2,3472,1706,1766,96.6
11090, 강북구,025,20~24세,2016,21334,10636,10698,99.4,20974,10515,10459,100.5
11090, 강북구,025001, 20세,2016,3923,1973,1950,101.2,3878,1954,1924,101.6
11090, 강북구,025002, 21세,2016,4093,2059,2034,101.2,4037,2044,1993,102.6
11090, 강북구,025003, 22세,2016,4260,2140,2120,100.9,4189,2120,2069,102.5
11090, 강북구,025004, 23세,2016,4407,2224,2183,101.9,4319,2189,2130,102.8
11090, 강북구,025005, 24세,2016,4651,2240,2411,92.9,4551,2208,2343,94.2
11090, 강북구,030,25~29세,2016,20966,10385,10581,98.1,20310,10153,10157,100
11090, 강북구,030001, 25세,2016,4513,2128,2385,89.2,4398,2079,2319,89.7
11090, 강북구,030002, 26세,2016,4198,2078,2120,98,4060,2030,2030,100
11090, 강북구,030003, 27세,2016,4230,2127,2103,101.1,4090,2085,2005,104
11090, 강북구,030004, 28세,2016,4062,2020,2042,98.9,3922,1968,1954,100.7
11090, 강북구,030005, 29세,2016,3963,2032,1931,105.2,3840,1991,1849,107.7
11090, 강북구,035,30~34세,2016,22597,11764,10833,108.6,22042,11544,10498,110
11090, 강북구,035001, 30세,2016,4160,2179,1981,110,4034,2130,1904,111.9
11090, 강북구,035002, 31세,2016,4248,2203,2045,107.7,4144,2168,1976,109.7
11090, 강북구,035003, 32세,2016,4335,2288,2047,111.8,4214,2243,1971,113.8
11090, 강북구,035004, 33세,2016,4689,2427,2262,107.3,4594,2385,2209,108
11090, 강북구,035005, 34세,2016,5165,2667,2498,106.8,5056,2618,2438,107.4
11090, 강북구,040,35~39세,2016,23938,12547,11391,110.1,23597,12404,11193,110.8
11090, 강북구,040001, 35세,2016,5027,2743,2284,120.1,4960,2714,2246,120.8
11090, 강북구,040002, 36세,2016,5195,2750,2445,112.5,5106,2713,2393,113.4
11090, 강북구,040003, 37세,2016,4893,2535,2358,107.5,4840,2513,2327,108
11090, 강북구,040004, 38세,2016,4262,2163,2099,103,4194,2135,2059,103.7
11090, 강북구,040005, 39세,2016,4561,2356,2205,106.8,4497,2329,2168,107.4
11090, 강북구,045,40~44세,2016,24797,12812,11985,106.9,24467,12667,11800,107.3
11090, 강북구,045001, 40세,2016,4349,2271,2078,109.3,4285,2246,2039,110.2
11090, 강북구,045002, 41세,2016,4660,2408,2252,106.9,4603,2384,2219,107.4
11090, 강북구,045003, 42세,2016,5116,2631,2485,105.9,5052,2600,2452,106
11090, 강북구,045004, 43세,2016,5267,2680,2587,103.6,5196,2644,2552,103.6
11090, 강북구,045005, 44세,2016,5405,2822,2583,109.3,5331,2793,2538,110
11090, 강북구,050,45~49세,2016,27032,13287,13745,96.7,26650,13131,13519,97.1
11090, 강북구,050001, 45세,2016,5678,2882,2796,103.1,5605,2849,2756,103.4
11090, 강북구,050002, 46세,2016,5446,2719,2727,99.7,5361,2688,2673,100.6
11090, 강북구,050003, 47세,2016,5503,2680,2823,94.9,5432,2649,2783,95.2
11090, 강북구,050004, 48세,2016,5431,2593,2838,91.4,5347,2559,2788,91.8
11090, 강북구,050005, 49세,2016,4974,2413,2561,94.2,4905,2386,2519,94.7
11090, 강북구,055,50~54세,2016,25455,12498,12957,96.5,25009,12325,12684,97.2
11090, 강북구,055001, 50세,2016,4794,2391,2403,99.5,4713,2358,2355,100.1
11090, 강북구,055002, 51세,2016,5148,2442,2706,90.2,5057,2397,2660,90.1
11090, 강북구,055003, 52세,2016,4898,2410,2488,96.9,4803,2381,2422,98.3
11090, 강북구,055004, 53세,2016,5312,2667,2645,100.8,5221,2632,2589,101.7
11090, 강북구,055005, 54세,2016,5303,2588,2715,95.3,5215,2557,2658,96.2
11090, 강북구,060,55~59세,2016,27559,12926,14633,88.3,27170,12761,14409,88.6
11090, 강북구,060001, 55세,2016,5757,2669,3088,86.4,5691,2641,3050,86.6
11090, 강북구,060002, 56세,2016,5989,2746,3243,84.7,5893,2703,3190,84.7
11090, 강북구,060003, 57세,2016,5385,2539,2846,89.2,5307,2506,2801,89.5
11090, 강북구,060004, 58세,2016,5278,2477,2801,88.4,5213,2449,2764,88.6
11090, 강북구,060005, 59세,2016,5150,2495,2655,94,5066,2462,2604,94.5
11090, 강북구,065,60~64세,2016,22321,10337,11984,86.3,21995,10202,11793,86.5
11090, 강북구,065001, 60세,2016,4868,2300,2568,89.6,4804,2273,2531,89.8
11090, 강북구,065002, 61세,2016,5067,2359,2708,87.1,4982,2322,2660,87.3
11090, 강북구,065003, 62세,2016,4333,1999,2334,85.6,4268,1972,2296,85.9
11090, 강북구,065004, 63세,2016,3786,1723,2063,83.5,3731,1701,2030,83.8
11090, 강북구,065005, 64세,2016,4267,1956,2311,84.6,4210,1934,2276,85
11090, 강북구,070,65~69세,2016,17771,7914,9857,80.3,17615,7842,9773,80.2
11090, 강북구,070001, 65세,2016,3199,1454,1745,83.3,3152,1431,1721,83.1
11090, 강북구,070002, 66세,2016,3459,1510,1949,77.5,3416,1493,1923,77.6
11090, 강북구,070003, 67세,2016,3711,1649,2062,80,3686,1636,2050,79.8
11090, 강북구,070004, 68세,2016,3655,1634,2021,80.9,3630,1622,2008,80.8
11090, 강북구,070005, 69세,2016,3747,1667,2080,80.1,3731,1660,2071,80.2
11090, 강북구,075,70~74세,2016,14891,6670,8221,81.1,14838,6648,8190,81.2
11090, 강북구,075001, 70세,2016,2850,1251,1599,78.2,2829,1243,1586,78.4
11090, 강북구,075002, 71세,2016,2858,1225,1633,75,2849,1223,1626,75.2
11090, 강북구,075003, 72세,2016,2850,1319,1531,86.2,2840,1313,1527,86
11090, 강북구,075004, 73세,2016,2928,1292,1636,79,2921,1290,1631,79.1
11090, 강북구,075005, 74세,2016,3405,1583,1822,86.9,3399,1579,1820,86.8
11090, 강북구,080,75~79세,2016,10690,4745,5945,79.8,10659,4734,5925,79.9
11090, 강북구,080001, 75세,2016,2718,1250,1468,85.1,2711,1248,1463,85.3
11090, 강북구,080002, 76세,2016,2275,1039,1236,84.1,2268,1036,1232,84.1
11090, 강북구,080003, 77세,2016,2178,921,1257,73.3,2173,919,1254,73.3
11090, 강북구,080004, 78세,2016,1894,820,1074,76.4,1888,818,1070,76.4
11090, 강북구,080005, 79세,2016,1625,715,910,78.6,1619,713,906,78.7
11090, 강북구,085,80~84세,2016,5399,2155,3244,66.4,5386,2151,3235,66.5
11090, 강북구,085001, 80세,2016,1523,639,884,72.3,1521,639,882,72.4
11090, 강북구,085002, 81세,2016,1266,523,743,70.4,1262,522,740,70.5
11090, 강북구,085003, 82세,2016,1039,413,626,66,1038,412,626,65.8
11090, 강북구,085004, 83세,2016,834,318,516,61.6,832,317,515,61.6
11090, 강북구,085005, 84세,2016,737,262,475,55.2,733,261,472,55.3
11090, 강북구,090,85~89세,2016,2197,655,1542,42.5,2181,652,1529,42.6
11090, 강북구,090001, 85세,2016,532,178,354,50.3,529,177,352,50.3
11090, 강북구,090002, 86세,2016,530,144,386,37.3,526,143,383,37.3
11090, 강북구,090003, 87세,2016,476,146,330,44.2,472,145,327,44.3
11090, 강북구,090004, 88세,2016,387,110,277,39.7,383,110,273,40.3
11090, 강북구,090005, 89세,2016,272,77,195,39.5,271,77,194,39.7
11090, 강북구,095,90~94세,2016,730,167,563,29.7,726,165,561,29.4
11090, 강북구,095001, 90세,2016,209,50,159,31.4,208,49,159,30.8
11090, 강북구,095002, 91세,2016,175,38,137,27.7,173,37,136,27.2
11090, 강북구,095003, 92세,2016,136,24,112,21.4,135,24,111,21.6
11090, 강북구,095004, 93세,2016,114,34,80,42.5,114,34,80,42.5
11090, 강북구,095005, 94세,2016,96,21,75,28,96,21,75,28
11090, 강북구,100,95~99세,2016,160,37,123,30.1,157,37,120,30.8
11090, 강북구,100001, 95세,2016,60,15,45,33.3,59,15,44,34.1
11090, 강북구,100002, 96세,2016,43,10,33,30.3,43,10,33,30.3
11090, 강북구,100003, 97세,2016,30,8,22,36.4,29,8,21,38.1
11090, 강북구,100004, 98세,2016,17,X,15,13.3,17,X,15,13.3
11090, 강북구,100005, 99세,2016,10,X,8,25,9,X,7,28.6
11090, 강북구,101,100세이상,2016,28,6,22,27.3,27,6,21,28.6
11090, 강북구,102,15세미만,2016,32520,16763,15757,106.4,32363,16680,15683,106.4
11090, 강북구,103,15~64세,2016,231826,115295,116531,98.9,227965,113774,114191,99.6
11090, 강북구,104,65세이상,2016,51866,22349,29517,75.7,51589,22235,29354,75.7
11090, 강북구,086,85세이상,2016,3115,865,2250,38.4,3091,860,2231,38.5
11090, 강북구,126,평균연령,2016,43.3,42.1,44.4,,43.3,42.2,44.5,
11090, 강북구,127,중위연령,2016,44.3,42.9,45.7,,44.3,42.9,45.8,
11100, 도봉구,000,합계,2016,336745,164407,172338,95.4,334165,163364,170801,95.6
11100, 도봉구,005,0~4세,2016,12126,6294,5832,107.9,12077,6265,5812,107.8
11100, 도봉구,005001, 0세,2016,2279,1159,1120,103.5,2268,1153,1115,103.4
11100, 도봉구,005002, 1세,2016,2491,1290,1201,107.4,2481,1281,1200,106.8
11100, 도봉구,005003, 2세,2016,2419,1250,1169,106.9,2410,1245,1165,106.9
11100, 도봉구,005004, 3세,2016,2346,1247,1099,113.5,2333,1241,1092,113.6
11100, 도봉구,005005, 4세,2016,2591,1348,1243,108.4,2585,1345,1240,108.5
11100, 도봉구,010,5~9세,2016,12580,6505,6075,107.1,12533,6479,6054,107
11100, 도봉구,010001, 5세,2016,2572,1327,1245,106.6,2561,1321,1240,106.5
11100, 도봉구,010002, 6세,2016,2481,1272,1209,105.2,2472,1267,1205,105.1
11100, 도봉구,010003, 7세,2016,2359,1225,1134,108,2349,1217,1132,107.5
11100, 도봉구,010004, 8세,2016,2453,1289,1164,110.7,2441,1284,1157,111
11100, 도봉구,010005, 9세,2016,2715,1392,1323,105.2,2710,1390,1320,105.3
11100, 도봉구,015,10~14세,2016,13279,6770,6509,104,13247,6759,6488,104.2
11100, 도봉구,015001, 10세,2016,2432,1260,1172,107.5,2426,1258,1168,107.7
11100, 도봉구,015002, 11세,2016,2346,1182,1164,101.5,2334,1177,1157,101.7
11100, 도봉구,015003, 12세,2016,2795,1426,1369,104.2,2790,1425,1365,104.4
11100, 도봉구,015004, 13세,2016,2727,1386,1341,103.4,2725,1385,1340,103.4
11100, 도봉구,015005, 14세,2016,2979,1516,1463,103.6,2972,1514,1458,103.8
11100, 도봉구,020,15~19세,2016,18961,9642,9319,103.5,18891,9609,9282,103.5
11100, 도봉구,020001, 15세,2016,3363,1780,1583,112.4,3358,1778,1580,112.5
11100, 도봉구,020002, 16세,2016,3685,1882,1803,104.4,3674,1877,1797,104.5
11100, 도봉구,020003, 17세,2016,3731,1956,1775,110.2,3724,1952,1772,110.2
11100, 도봉구,020004, 18세,2016,3886,1949,1937,100.6,3870,1941,1929,100.6
11100, 도봉구,020005, 19세,2016,4296,2075,2221,93.4,4265,2061,2204,93.5
11100, 도봉구,025,20~24세,2016,23294,11607,11687,99.3,23007,11520,11487,100.3
11100, 도봉구,025001, 20세,2016,4414,2198,2216,99.2,4362,2185,2177,100.4
11100, 도봉구,025002, 21세,2016,4526,2361,2165,109.1,4481,2349,2132,110.2
11100, 도봉구,025003, 22세,2016,4581,2324,2257,103,4530,2305,2225,103.6
11100, 도봉구,025004, 23세,2016,4894,2430,2464,98.6,4822,2407,2415,99.7
11100, 도봉구,025005, 24세,2016,4879,2294,2585,88.7,4812,2274,2538,89.6
11100, 도봉구,030,25~29세,2016,22028,11058,10970,100.8,21684,10943,10741,101.9
11100, 도봉구,030001, 25세,2016,4645,2320,2325,99.8,4579,2298,2281,100.7
11100, 도봉구,030002, 26세,2016,4523,2264,2259,100.2,4448,2235,2213,101
11100, 도봉구,030003, 27세,2016,4365,2160,2205,98,4295,2136,2159,98.9
11100, 도봉구,030004, 28세,2016,4298,2165,2133,101.5,4220,2138,2082,102.7
11100, 도봉구,030005, 29세,2016,4197,2149,2048,104.9,4142,2136,2006,106.5
11100, 도봉구,035,30~34세,2016,23153,11968,11185,107,22839,11842,10997,107.7
11100, 도봉구,035001, 30세,2016,4232,2201,2031,108.4,4170,2171,1999,108.6
11100, 도봉구,035002, 31세,2016,4354,2218,2136,103.8,4292,2199,2093,105.1
11100, 도봉구,035003, 32세,2016,4431,2290,2141,107,4360,2265,2095,108.1
11100, 도봉구,035004, 33세,2016,4930,2613,2317,112.8,4867,2589,2278,113.7
11100, 도봉구,035005, 34세,2016,5206,2646,2560,103.4,5150,2618,2532,103.4
11100, 도봉구,040,35~39세,2016,24312,12275,12037,102,24067,12162,11905,102.2
11100, 도봉구,040001, 35세,2016,5235,2613,2622,99.7,5177,2591,2586,100.2
11100, 도봉구,040002, 36세,2016,5188,2617,2571,101.8,5146,2601,2545,102.2
11100, 도봉구,040003, 37세,2016,4896,2500,2396,104.3,4846,2474,2372,104.3
11100, 도봉구,040004, 38세,2016,4418,2236,2182,102.5,4363,2209,2154,102.6
11100, 도봉구,040005, 39세,2016,4575,2309,2266,101.9,4535,2287,2248,101.7
11100, 도봉구,045,40~44세,2016,25742,12774,12968,98.5,25523,12676,12847,98.7
11100, 도봉구,045001, 40세,2016,4528,2309,2219,104.1,4489,2295,2194,104.6
11100, 도봉구,045002, 41세,2016,4761,2312,2449,94.4,4723,2299,2424,94.8
11100, 도봉구,045003, 42세,2016,5229,2637,2592,101.7,5186,2620,2566,102.1
11100, 도봉구,045004, 43세,2016,5589,2697,2892,93.3,5545,2672,2873,93
11100, 도봉구,045005, 44세,2016,5635,2819,2816,100.1,5580,2790,2790,100
11100, 도봉구,050,45~49세,2016,29605,14177,15428,91.9,29377,14083,15294,92.1
11100, 도봉구,050001, 45세,2016,6055,2914,3141,92.8,6003,2895,3108,93.1
11100, 도봉구,050002, 46세,2016,5973,2935,3038,96.6,5924,2913,3011,96.7
11100, 도봉구,050003, 47세,2016,5977,2841,3136,90.6,5942,2822,3120,90.4
11100, 도봉구,050004, 48세,2016,6083,2896,3187,90.9,6038,2882,3156,91.3
11100, 도봉구,050005, 49세,2016,5517,2591,2926,88.6,5470,2571,2899,88.7
11100, 도봉구,055,50~54세,2016,28183,13581,14602,93,27956,13485,14471,93.2
11100, 도봉구,055001, 50세,2016,5463,2676,2787,96,5421,2664,2757,96.6
11100, 도봉구,055002, 51세,2016,5553,2595,2958,87.7,5502,2573,2929,87.8
11100, 도봉구,055003, 52세,2016,5416,2608,2808,92.9,5368,2582,2786,92.7
11100, 도봉구,055004, 53세,2016,5762,2828,2934,96.4,5718,2811,2907,96.7
11100, 도봉구,055005, 54세,2016,5989,2874,3115,92.3,5947,2855,3092,92.3
11100, 도봉구,060,55~59세,2016,30861,14570,16291,89.4,30671,14494,16177,89.6
11100, 도봉구,060001, 55세,2016,6395,2948,3447,85.5,6361,2934,3427,85.6
11100, 도봉구,060002, 56세,2016,6628,3086,3542,87.1,6589,3071,3518,87.3
11100, 도봉구,060003, 57세,2016,6052,2855,3197,89.3,6019,2845,3174,89.6
11100, 도봉구,060004, 58세,2016,5866,2791,3075,90.8,5830,2775,3055,90.8
11100, 도봉구,060005, 59세,2016,5920,2890,3030,95.4,5872,2869,3003,95.5
11100, 도봉구,065,60~64세,2016,23620,11500,12120,94.9,23446,11424,12022,95
11100, 도봉구,065001, 60세,2016,5347,2566,2781,92.3,5305,2546,2759,92.3
11100, 도봉구,065002, 61세,2016,5561,2644,2917,90.6,5527,2628,2899,90.7
11100, 도봉구,065003, 62세,2016,4543,2253,2290,98.4,4508,2243,2265,99
11100, 도봉구,065004, 63세,2016,3883,1958,1925,101.7,3855,1944,1911,101.7
11100, 도봉구,065005, 64세,2016,4286,2079,2207,94.2,4251,2063,2188,94.3
11100, 도봉구,070,65~69세,2016,16483,7929,8554,92.7,16401,7891,8510,92.7
11100, 도봉구,070001, 65세,2016,3055,1462,1593,91.8,3029,1457,1572,92.7
11100, 도봉구,070002, 66세,2016,3378,1640,1738,94.4,3354,1625,1729,94
11100, 도봉구,070003, 67세,2016,3321,1627,1694,96,3311,1619,1692,95.7
11100, 도봉구,070004, 68세,2016,3347,1619,1728,93.7,3335,1613,1722,93.7
11100, 도봉구,070005, 69세,2016,3382,1581,1801,87.8,3372,1577,1795,87.9
11100, 도봉구,075,70~74세,2016,13318,6228,7090,87.8,13285,6215,7070,87.9
11100, 도봉구,075001, 70세,2016,2587,1223,1364,89.7,2580,1220,1360,89.7
11100, 도봉구,075002, 71세,2016,2569,1198,1371,87.4,2557,1193,1364,87.5
11100, 도봉구,075003, 72세,2016,2524,1175,1349,87.1,2519,1174,1345,87.3
11100, 도봉구,075004, 73세,2016,2622,1197,1425,84,2618,1195,1423,84
11100, 도봉구,075005, 74세,2016,3016,1435,1581,90.8,3011,1433,1578,90.8
11100, 도봉구,080,75~79세,2016,10009,4406,5603,78.6,9988,4398,5590,78.7
11100, 도봉구,080001, 75세,2016,2436,1134,1302,87.1,2428,1130,1298,87.1
11100, 도봉구,080002, 76세,2016,2118,944,1174,80.4,2115,942,1173,80.3
11100, 도봉구,080003, 77세,2016,2083,903,1180,76.5,2077,901,1176,76.6
11100, 도봉구,080004, 78세,2016,1782,768,1014,75.7,1780,768,1012,75.9
11100, 도봉구,080005, 79세,2016,1590,657,933,70.4,1588,657,931,70.6
11100, 도봉구,085,80~84세,2016,5584,2067,3517,58.8,5577,2066,3511,58.8
11100, 도봉구,085001, 80세,2016,1394,563,831,67.7,1391,562,829,67.8
11100, 도봉구,085002, 81세,2016,1301,508,793,64.1,1299,508,791,64.2
11100, 도봉구,085003, 82세,2016,1080,388,692,56.1,1079,388,691,56.2
11100, 도봉구,085004, 83세,2016,956,327,629,52,955,327,628,52.1
11100, 도봉구,085005, 84세,2016,853,281,572,49.1,853,281,572,49.1
11100, 도봉구,090,85~89세,2016,2560,803,1757,45.7,2557,803,1754,45.8
11100, 도봉구,090001, 85세,2016,645,213,432,49.3,644,213,431,49.4
11100, 도봉구,090002, 86세,2016,579,172,407,42.3,578,172,406,42.4
11100, 도봉구,090003, 87세,2016,552,176,376,46.8,551,176,375,46.9
11100, 도봉구,090004, 88세,2016,439,130,309,42.1,439,130,309,42.1
11100, 도봉구,090005, 89세,2016,345,112,233,48.1,345,112,233,48.1
11100, 도봉구,095,90~94세,2016,858,206,652,31.6,853,205,648,31.6
11100, 도봉구,095001, 90세,2016,248,66,182,36.3,246,66,180,36.7
11100, 도봉구,095002, 91세,2016,200,36,164,22,199,36,163,22.1
11100, 도봉구,095003, 92세,2016,159,38,121,31.4,159,38,121,31.4
11100, 도봉구,095004, 93세,2016,159,45,114,39.5,158,44,114,38.6
11100, 도봉구,095005, 94세,2016,92,21,71,29.6,91,21,70,30
11100, 도봉구,100,95~99세,2016,168,44,124,35.5,166,43,123,35
11100, 도봉구,100001, 95세,2016,66,18,48,37.5,65,18,47,38.3
11100, 도봉구,100002, 96세,2016,40,7,33,21.2,40,7,33,21.2
11100, 도봉구,100003, 97세,2016,28,9,19,47.4,28,9,19,47.4
11100, 도봉구,100004, 98세,2016,19,6,13,46.2,18,5,13,38.5
11100, 도봉구,100005, 99세,2016,15,X,11,36.4,15,X,11,36.4
11100, 도봉구,101,100세이상,2016,21,X,18,16.7,20,X,18,11.1
11100, 도봉구,102,15세미만,2016,37985,19569,18416,106.3,37857,19503,18354,106.3
11100, 도봉구,103,15~64세,2016,249759,123152,126607,97.3,247461,122238,125223,97.6
11100, 도봉구,104,65세이상,2016,49001,21686,27315,79.4,48847,21623,27224,79.4
11100, 도봉구,086,85세이상,2016,3607,1056,2551,41.4,3596,1053,2543,41.4
11100, 도봉구,126,평균연령,2016,42.4,41.4,43.4,,42.4,41.4,43.4,
11100, 도봉구,127,중위연령,2016,43.7,42.6,44.9,,43.8,42.6,44.9,
11110, 노원구,000,합계,2016,555420,270058,285362,94.6,550729,267903,282826,94.7
11110, 노원구,005,0~4세,2016,20931,10700,10231,104.6,20843,10652,10191,104.5
11110, 노원구,005001, 0세,2016,4143,2165,1978,109.5,4130,2155,1975,109.1
11110, 노원구,005002, 1세,2016,4298,2184,2114,103.3,4273,2172,2101,103.4
11110, 노원구,005003, 2세,2016,4099,2076,2023,102.6,4079,2065,2014,102.5
11110, 노원구,005004, 3세,2016,4004,2034,1970,103.2,3987,2025,1962,103.2
11110, 노원구,005005, 4세,2016,4387,2241,2146,104.4,4374,2235,2139,104.5
11110, 노원구,010,5~9세,2016,22437,11493,10944,105,22347,11442,10905,104.9
11110, 노원구,010001, 5세,2016,4256,2157,2099,102.8,4230,2145,2085,102.9
11110, 노원구,010002, 6세,2016,4251,2184,2067,105.7,4231,2172,2059,105.5
11110, 노원구,010003, 7세,2016,4196,2147,2049,104.8,4180,2139,2041,104.8
11110, 노원구,010004, 8세,2016,4743,2433,2310,105.3,4729,2422,2307,105
11110, 노원구,010005, 9세,2016,4991,2572,2419,106.3,4977,2564,2413,106.3
11110, 노원구,015,10~14세,2016,27467,14249,13218,107.8,27398,14218,13180,107.9
11110, 노원구,015001, 10세,2016,4745,2470,2275,108.6,4736,2466,2270,108.6
11110, 노원구,015002, 11세,2016,4998,2567,2431,105.6,4988,2563,2425,105.7
11110, 노원구,015003, 12세,2016,5698,2945,2753,107,5680,2939,2741,107.2
11110, 노원구,015004, 13세,2016,5836,3065,2771,110.6,5819,3057,2762,110.7
11110, 노원구,015005, 14세,2016,6190,3202,2988,107.2,6175,3193,2982,107.1
11110, 노원구,020,15~19세,2016,38780,20148,18632,108.1,38514,19990,18524,107.9
11110, 노원구,020001, 15세,2016,7062,3729,3333,111.9,7045,3716,3329,111.6
11110, 노원구,020002, 16세,2016,7663,4081,3582,113.9,7644,4070,3574,113.9
11110, 노원구,020003, 17세,2016,7489,3907,3582,109.1,7435,3875,3560,108.8
11110, 노원구,020004, 18세,2016,7892,4156,3736,111.2,7826,4111,3715,110.7
11110, 노원구,020005, 19세,2016,8674,4275,4399,97.2,8564,4218,4346,97.1
11110, 노원구,025,20~24세,2016,43067,22167,20900,106.1,42287,21828,20459,106.7
11110, 노원구,025001, 20세,2016,8521,4178,4343,96.2,8343,4103,4240,96.8
11110, 노원구,025002, 21세,2016,8590,4289,4301,99.7,8449,4238,4211,100.6
11110, 노원구,025003, 22세,2016,8706,4533,4173,108.6,8532,4467,4065,109.9
11110, 노원구,025004, 23세,2016,8768,4635,4133,112.1,8638,4568,4070,112.2
11110, 노원구,025005, 24세,2016,8482,4532,3950,114.7,8325,4452,3873,114.9
11110, 노원구,030,25~29세,2016,34566,17639,16927,104.2,33863,17343,16520,105
11110, 노원구,030001, 25세,2016,7838,4081,3757,108.6,7674,4018,3656,109.9
11110, 노원구,030002, 26세,2016,7210,3758,3452,108.9,7056,3687,3369,109.4
11110, 노원구,030003, 27세,2016,6697,3435,3262,105.3,6561,3371,3190,105.7
11110, 노원구,030004, 28세,2016,6435,3195,3240,98.6,6324,3153,3171,99.4
11110, 노원구,030005, 29세,2016,6386,3170,3216,98.6,6248,3114,3134,99.4
11110, 노원구,035,30~34세,2016,36891,18252,18639,97.9,36349,18024,18325,98.4
11110, 노원구,035001, 30세,2016,6717,3258,3459,94.2,6586,3204,3382,94.7
11110, 노원구,035002, 31세,2016,6728,3305,3423,96.6,6622,3265,3357,97.3
11110, 노원구,035003, 32세,2016,7074,3521,3553,99.1,6975,3472,3503,99.1
11110, 노원구,035004, 33세,2016,7964,3956,4008,98.7,7859,3912,3947,99.1
11110, 노원구,035005, 34세,2016,8408,4212,4196,100.4,8307,4171,4136,100.8
11110, 노원구,040,35~39세,2016,40885,20339,20546,99,40481,20146,20335,99.1
11110, 노원구,040001, 35세,2016,8464,4329,4135,104.7,8377,4283,4094,104.6
11110, 노원구,040002, 36세,2016,8667,4296,4371,98.3,8580,4264,4316,98.8
11110, 노원구,040003, 37세,2016,8345,4194,4151,101,8264,4156,4108,101.2
11110, 노원구,040004, 38세,2016,7535,3755,3780,99.3,7447,3708,3739,99.2
11110, 노원구,040005, 39세,2016,7874,3765,4109,91.6,7813,3735,4078,91.6
11110, 노원구,045,40~44세,2016,46106,21990,24116,91.2,45757,21808,23949,91.1
11110, 노원구,045001, 40세,2016,7788,3787,4001,94.7,7729,3757,3972,94.6
11110, 노원구,045002, 41세,2016,8612,4034,4578,88.1,8528,3990,4538,87.9
11110, 노원구,045003, 42세,2016,9516,4566,4950,92.2,9449,4532,4917,92.2
11110, 노원구,045004, 43세,2016,9892,4716,5176,91.1,9821,4683,5138,91.1
11110, 노원구,045005, 44세,2016,10298,4887,5411,90.3,10230,4846,5384,90
11110, 노원구,050,45~49세,2016,53193,25592,27601,92.7,52795,25397,27398,92.7
11110, 노원구,050001, 45세,2016,11287,5382,5905,91.1,11216,5345,5871,91
11110, 노원구,050002, 46세,2016,10934,5222,5712,91.4,10837,5175,5662,91.4
11110, 노원구,050003, 47세,2016,10846,5249,5597,93.8,10767,5211,5556,93.8
11110, 노원구,050004, 48세,2016,10514,5056,5458,92.6,10436,5019,5417,92.7
11110, 노원구,050005, 49세,2016,9612,4683,4929,95,9539,4647,4892,95
11110, 노원구,055,50~54세,2016,45022,22161,22861,96.9,44656,22004,22652,97.1
11110, 노원구,055001, 50세,2016,9052,4548,4504,101,8974,4506,4468,100.9
11110, 노원구,055002, 51세,2016,9201,4458,4743,94,9128,4425,4703,94.1
11110, 노원구,055003, 52세,2016,8644,4324,4320,100.1,8567,4293,4274,100.4
11110, 노원구,055004, 53세,2016,9064,4353,4711,92.4,8983,4326,4657,92.9
11110, 노원구,055005, 54세,2016,9061,4478,4583,97.7,9004,4454,4550,97.9
11110, 노원구,060,55~59세,2016,44441,21200,23241,91.2,44176,21081,23095,91.3
11110, 노원구,060001, 55세,2016,9582,4643,4939,94,9538,4628,4910,94.3
11110, 노원구,060002, 56세,2016,9610,4521,5089,88.8,9538,4493,5045,89.1
11110, 노원구,060003, 57세,2016,8675,4097,4578,89.5,8636,4081,4555,89.6
11110, 노원구,060004, 58세,2016,8367,4027,4340,92.8,8315,3998,4317,92.6
11110, 노원구,060005, 59세,2016,8207,3912,4295,91.1,8149,3881,4268,90.9
11110, 노원구,065,60~64세,2016,33288,15852,17436,90.9,33097,15775,17322,91.1
11110, 노원구,065001, 60세,2016,7489,3552,3937,90.2,7448,3538,3910,90.5
11110, 노원구,065002, 61세,2016,7715,3580,4135,86.6,7667,3560,4107,86.7
11110, 노원구,065003, 62세,2016,6437,3089,3348,92.3,6400,3073,3327,92.4
11110, 노원구,065004, 63세,2016,5546,2699,2847,94.8,5519,2689,2830,95
11110, 노원구,065005, 64세,2016,6101,2932,3169,92.5,6063,2915,3148,92.6
11110, 노원구,070,65~69세,2016,22888,10556,12332,85.6,22818,10522,12296,85.6
11110, 노원구,070001, 65세,2016,4247,1997,2250,88.8,4228,1990,2238,88.9
11110, 노원구,070002, 66세,2016,4759,2242,2517,89.1,4746,2235,2511,89
11110, 노원구,070003, 67세,2016,4769,2196,2573,85.3,4750,2185,2565,85.2
11110, 노원구,070004, 68세,2016,4531,2081,2450,84.9,4523,2078,2445,85
11110, 노원구,070005, 69세,2016,4582,2040,2542,80.3,4571,2034,2537,80.2
11110, 노원구,075,70~74세,2016,17891,7863,10028,78.4,17832,7836,9996,78.4
11110, 노원구,075001, 70세,2016,3567,1561,2006,77.8,3552,1552,2000,77.6
11110, 노원구,075002, 71세,2016,3358,1531,1827,83.8,3352,1531,1821,84.1
11110, 노원구,075003, 72세,2016,3382,1455,1927,75.5,3366,1447,1919,75.4
11110, 노원구,075004, 73세,2016,3538,1532,2006,76.4,3528,1529,1999,76.5
11110, 노원구,075005, 74세,2016,4046,1784,2262,78.9,4034,1777,2257,78.7
11110, 노원구,080,75~79세,2016,13954,5623,8331,67.5,13936,5616,8320,67.5
11110, 노원구,080001, 75세,2016,3215,1313,1902,69,3212,1312,1900,69.1
11110, 노원구,080002, 76세,2016,2997,1302,1695,76.8,2991,1300,1691,76.9
11110, 노원구,080003, 77세,2016,2825,1138,1687,67.5,2822,1137,1685,67.5
11110, 노원구,080004, 78세,2016,2581,984,1597,61.6,2577,982,1595,61.6
11110, 노원구,080005, 79세,2016,2336,886,1450,61.1,2334,885,1449,61.1
11110, 노원구,085,80~84세,2016,8209,2768,5441,50.9,8190,2760,5430,50.8
11110, 노원구,085001, 80세,2016,1971,713,1258,56.7,1968,713,1255,56.8
11110, 노원구,085002, 81세,2016,1969,644,1325,48.6,1965,643,1322,48.6
11110, 노원구,085003, 82세,2016,1660,556,1104,50.4,1657,554,1103,50.2
11110, 노원구,085004, 83세,2016,1367,458,909,50.4,1364,456,908,50.2
11110, 노원구,085005, 84세,2016,1242,397,845,47,1236,394,842,46.8
11110, 노원구,090,85~89세,2016,3843,1118,2725,41,3835,1114,2721,40.9
11110, 노원구,090001, 85세,2016,1002,304,698,43.6,1001,304,697,43.6
11110, 노원구,090002, 86세,2016,938,282,656,43,937,282,655,43.1
11110, 노원구,090003, 87세,2016,765,245,520,47.1,762,242,520,46.5
11110, 노원구,090004, 88세,2016,637,168,469,35.8,635,167,468,35.7
11110, 노원구,090005, 89세,2016,501,119,382,31.2,500,119,381,31.2
11110, 노원구,095,90~94세,2016,1250,280,970,28.9,1248,280,968,28.9
11110, 노원구,095001, 90세,2016,372,77,295,26.1,372,77,295,26.1
11110, 노원구,095002, 91세,2016,288,61,227,26.9,288,61,227,26.9
11110, 노원구,095003, 92세,2016,238,57,181,31.5,237,57,180,31.7
11110, 노원구,095004, 93세,2016,197,50,147,34,197,50,147,34
11110, 노원구,095005, 94세,2016,155,35,120,29.2,154,35,119,29.4
11110, 노원구,100,95~99세,2016,280,66,214,30.8,277,65,212,30.7
11110, 노원구,100001, 95세,2016,113,26,87,29.9,112,25,87,28.7
11110, 노원구,100002, 96세,2016,75,22,53,41.5,75,22,53,41.5
11110, 노원구,100003, 97세,2016,51,13,38,34.2,51,13,38,34.2
11110, 노원구,100004, 98세,2016,22,X,20,10,22,X,20,10
11110, 노원구,100005, 99세,2016,19,X,16,18.8,17,X,14,21.4
11110, 노원구,101,100세이상,2016,31,X,29,6.9,30,X,28,7.1
11110, 노원구,102,15세미만,2016,70835,36442,34393,106,70588,36312,34276,105.9
11110, 노원구,103,15~64세,2016,416239,205340,210899,97.4,411975,203396,208579,97.5
11110, 노원구,104,65세이상,2016,68346,28276,40070,70.6,68166,28195,39971,70.5
11110, 노원구,086,85세이상,2016,5404,1466,3938,37.2,5390,1461,3929,37.2
11110, 노원구,126,평균연령,2016,40.4,39.2,41.6,,40.5,39.2,41.7,
11110, 노원구,127,중위연령,2016,41.6,40,42.8,,41.7,40.1,42.9,
11120, 은평구,000,합계,2016,472242,229215,243027,94.3,466813,226844,239969,94.5
11120, 은평구,005,0~4세,2016,18331,9418,8913,105.7,18198,9350,8848,105.7
11120, 은평구,005001, 0세,2016,3551,1816,1735,104.7,3535,1808,1727,104.7
11120, 은평구,005002, 1세,2016,3696,1846,1850,99.8,3670,1833,1837,99.8
11120, 은평구,005003, 2세,2016,3530,1817,1713,106.1,3507,1805,1702,106.1
11120, 은평구,005004, 3세,2016,3595,1886,1709,110.4,3563,1871,1692,110.6
11120, 은평구,005005, 4세,2016,3959,2053,1906,107.7,3923,2033,1890,107.6
11120, 은평구,010,5~9세,2016,18918,9780,9138,107,18817,9721,9096,106.9
11120, 은평구,010001, 5세,2016,3805,1963,1842,106.6,3782,1951,1831,106.6
11120, 은평구,010002, 6세,2016,3706,1893,1813,104.4,3681,1878,1803,104.2
11120, 은평구,010003, 7세,2016,3657,1888,1769,106.7,3636,1874,1762,106.4
11120, 은평구,010004, 8세,2016,3796,1965,1831,107.3,3779,1955,1824,107.2
11120, 은평구,010005, 9세,2016,3954,2071,1883,110,3939,2063,1876,110
11120, 은평구,015,10~14세,2016,19344,9992,9352,106.8,19256,9949,9307,106.9
11120, 은평구,015001, 10세,2016,3660,1873,1787,104.8,3647,1867,1780,104.9
11120, 은평구,015002, 11세,2016,3418,1797,1621,110.9,3408,1792,1616,110.9
11120, 은평구,015003, 12세,2016,3956,2028,1928,105.2,3940,2018,1922,105
11120, 은평구,015004, 13세,2016,4069,2113,1956,108,4057,2109,1948,108.3
11120, 은평구,015005, 14세,2016,4241,2181,2060,105.9,4204,2163,2041,106
11120, 은평구,020,15~19세,2016,25973,13107,12866,101.9,25774,13018,12756,102.1
11120, 은평구,020001, 15세,2016,4706,2372,2334,101.6,4671,2357,2314,101.9
11120, 은평구,020002, 16세,2016,5520,2810,2710,103.7,5474,2783,2691,103.4
11120, 은평구,020003, 17세,2016,5327,2762,2565,107.7,5287,2741,2546,107.7
11120, 은평구,020004, 18세,2016,5257,2648,2609,101.5,5213,2633,2580,102.1
11120, 은평구,020005, 19세,2016,5163,2515,2648,95,5129,2504,2625,95.4
11120, 은평구,025,20~24세,2016,29749,14989,14760,101.6,29339,14834,14505,102.3
11120, 은평구,025001, 20세,2016,5516,2846,2670,106.6,5469,2836,2633,107.7
11120, 은평구,025002, 21세,2016,5728,3060,2668,114.7,5658,3029,2629,115.2
11120, 은평구,025003, 22세,2016,5907,3019,2888,104.5,5814,2979,2835,105.1
11120, 은평구,025004, 23세,2016,6195,3009,3186,94.4,6100,2974,3126,95.1
11120, 은평구,025005, 24세,2016,6403,3055,3348,91.2,6298,3016,3282,91.9
11120, 은평구,030,25~29세,2016,31340,15087,16253,92.8,30647,14832,15815,93.8
11120, 은평구,030001, 25세,2016,6446,3109,3337,93.2,6330,3068,3262,94.1
11120, 은평구,030002, 26세,2016,6364,3038,3326,91.3,6218,2991,3227,92.7
11120, 은평구,030003, 27세,2016,6167,2961,3206,92.4,6038,2914,3124,93.3
11120, 은평구,030004, 28세,2016,6154,3010,3144,95.7,6009,2956,3053,96.8
11120, 은평구,030005, 29세,2016,6209,2969,3240,91.6,6052,2903,3149,92.2
11120, 은평구,035,30~34세,2016,35422,17492,17930,97.6,34773,17220,17553,98.1
11120, 은평구,035001, 30세,2016,6345,3069,3276,93.7,6192,3003,3189,94.2
11120, 은평구,035002, 31세,2016,6513,3168,3345,94.7,6384,3118,3266,95.5
11120, 은평구,035003, 32세,2016,6829,3330,3499,95.2,6722,3288,3434,95.7
11120, 은평구,035004, 33세,2016,7553,3786,3767,100.5,7430,3732,3698,100.9
11120, 은평구,035005, 34세,2016,8182,4139,4043,102.4,8045,4079,3966,102.8
11120, 은평구,040,35~39세,2016,38929,19617,19312,101.6,38422,19383,19039,101.8
11120, 은평구,040001, 35세,2016,8336,4179,4157,100.5,8222,4125,4097,100.7
11120, 은평구,040002, 36세,2016,8560,4377,4183,104.6,8451,4325,4126,104.8
11120, 은평구,040003, 37세,2016,7888,3971,3917,101.4,7756,3910,3846,101.7
11120, 은평구,040004, 38세,2016,6858,3412,3446,99,6781,3381,3400,99.4
11120, 은평구,040005, 39세,2016,7287,3678,3609,101.9,7212,3642,3570,102
11120, 은평구,045,40~44세,2016,39441,19834,19607,101.2,38998,19604,19394,101.1
11120, 은평구,045001, 40세,2016,7187,3629,3558,102,7101,3589,3512,102.2
11120, 은평구,045002, 41세,2016,7386,3693,3693,100,7304,3654,3650,100.1
11120, 은평구,045003, 42세,2016,8133,4087,4046,101,8042,4040,4002,100.9
11120, 은평구,045004, 43세,2016,8324,4206,4118,102.1,8237,4159,4078,102
11120, 은평구,045005, 44세,2016,8411,4219,4192,100.6,8314,4162,4152,100.2
11120, 은평구,050,45~49세,2016,40838,19983,20855,95.8,40329,19768,20561,96.1
11120, 은평구,050001, 45세,2016,8842,4425,4417,100.2,8739,4382,4357,100.6
11120, 은평구,050002, 46세,2016,8184,3988,4196,95,8085,3943,4142,95.2
11120, 은평구,050003, 47세,2016,8297,4095,4202,97.5,8195,4051,4144,97.8
11120, 은평구,050004, 48세,2016,8143,3940,4203,93.7,8023,3894,4129,94.3
11120, 은평구,050005, 49세,2016,7372,3535,3837,92.1,7287,3498,3789,92.3
11120, 은평구,055,50~54세,2016,36596,17735,18861,94,36076,17497,18579,94.2
11120, 은평구,055001, 50세,2016,7102,3495,3607,96.9,7027,3465,3562,97.3
11120, 은평구,055002, 51세,2016,7314,3478,3836,90.7,7214,3430,3784,90.6
11120, 은평구,055003, 52세,2016,7078,3451,3627,95.1,6965,3400,3565,95.4
11120, 은평구,055004, 53세,2016,7443,3565,3878,91.9,7311,3502,3809,91.9
11120, 은평구,055005, 54세,2016,7659,3746,3913,95.7,7559,3700,3859,95.9
11120, 은평구,060,55~59세,2016,38705,18180,20525,88.6,38263,17994,20269,88.8
11120, 은평구,060001, 55세,2016,8170,3862,4308,89.6,8093,3832,4261,89.9
11120, 은평구,060002, 56세,2016,8326,3824,4502,84.9,8239,3787,4452,85.1
11120, 은평구,060003, 57세,2016,7750,3660,4090,89.5,7644,3614,4030,89.7
11120, 은평구,060004, 58세,2016,7279,3466,3813,90.9,7194,3431,3763,91.2
11120, 은평구,060005, 59세,2016,7180,3368,3812,88.4,7093,3330,3763,88.5
11120, 은평구,065,60~64세,2016,30587,14344,16243,88.3,30198,14168,16030,88.4
11120, 은평구,065001, 60세,2016,6828,3241,3587,90.4,6748,3209,3539,90.7
11120, 은평구,065002, 61세,2016,6952,3294,3658,90,6870,3252,3618,89.9
11120, 은평구,065003, 62세,2016,5990,2745,3245,84.6,5909,2710,3199,84.7
11120, 은평구,065004, 63세,2016,5300,2445,2855,85.6,5236,2411,2825,85.3
11120, 은평구,065005, 64세,2016,5517,2619,2898,90.4,5435,2586,2849,90.8
11120, 은평구,070,65~69세,2016,23238,10621,12617,84.2,23070,10542,12528,84.1
11120, 은평구,070001, 65세,2016,4178,1899,2279,83.3,4132,1874,2258,83
11120, 은평구,070002, 66세,2016,4640,2146,2494,86,4604,2133,2471,86.3
11120, 은평구,070003, 67세,2016,4808,2184,2624,83.2,4774,2168,2606,83.2
11120, 은평구,070004, 68세,2016,4783,2193,2590,84.7,4751,2177,2574,84.6
11120, 은평구,070005, 69세,2016,4829,2199,2630,83.6,4809,2190,2619,83.6
11120, 은평구,075,70~74세,2016,18990,8568,10422,82.2,18917,8537,10380,82.2
11120, 은평구,075001, 70세,2016,3738,1694,2044,82.9,3724,1684,2040,82.5
11120, 은평구,075002, 71세,2016,3636,1635,2001,81.7,3618,1626,1992,81.6
11120, 은평구,075003, 72세,2016,3620,1641,1979,82.9,3608,1638,1970,83.1
11120, 은평구,075004, 73세,2016,3697,1616,2081,77.7,3683,1610,2073,77.7
11120, 은평구,075005, 74세,2016,4299,1982,2317,85.5,4284,1979,2305,85.9
11120, 은평구,080,75~79세,2016,14023,6274,7749,81,13966,6251,7715,81
11120, 은평구,080001, 75세,2016,3376,1562,1814,86.1,3367,1557,1810,86
11120, 은평구,080002, 76세,2016,3008,1399,1609,86.9,2998,1394,1604,86.9
11120, 은평구,080003, 77세,2016,2855,1247,1608,77.5,2841,1243,1598,77.8
11120, 은평구,080004, 78세,2016,2493,1081,1412,76.6,2481,1077,1404,76.7
11120, 은평구,080005, 79세,2016,2291,985,1306,75.4,2279,980,1299,75.4
11120, 은평구,085,80~84세,2016,7403,2924,4479,65.3,7376,2913,4463,65.3
11120, 은평구,085001, 80세,2016,1971,803,1168,68.8,1967,801,1166,68.7
11120, 은평구,085002, 81세,2016,1782,721,1061,68,1777,719,1058,68
11120, 은평구,085003, 82세,2016,1410,572,838,68.3,1407,570,837,68.1
11120, 은평구,085004, 83세,2016,1171,442,729,60.6,1167,442,725,61
11120, 은평구,085005, 84세,2016,1069,386,683,56.5,1058,381,677,56.3
11120, 은평구,090,85~89세,2016,3152,957,2195,43.6,3138,952,2186,43.5
11120, 은평구,090001, 85세,2016,840,266,574,46.3,837,265,572,46.3
11120, 은평구,090002, 86세,2016,707,209,498,42,705,207,498,41.6
11120, 은평구,090003, 87세,2016,655,213,442,48.2,652,212,440,48.2
11120, 은평구,090004, 88세,2016,529,164,365,44.9,527,164,363,45.2
11120, 은평구,090005, 89세,2016,421,105,316,33.2,417,104,313,33.2
11120, 은평구,095,90~94세,2016,1049,275,774,35.5,1046,274,772,35.5
11120, 은평구,095001, 90세,2016,284,79,205,38.5,283,78,205,38
11120, 은평구,095002, 91세,2016,256,59,197,29.9,256,59,197,29.9
11120, 은평구,095003, 92세,2016,223,62,161,38.5,223,62,161,38.5
11120, 은평구,095004, 93세,2016,165,47,118,39.8,164,47,117,40.2
11120, 은평구,095005, 94세,2016,121,28,93,30.1,120,28,92,30.4
11120, 은평구,100,95~99세,2016,193,37,156,23.7,189,36,153,23.5
11120, 은평구,100001, 95세,2016,75,15,60,25,73,15,58,25.9
11120, 은평구,100002, 96세,2016,45,9,36,25,45,9,36,25
11120, 은평구,100003, 97세,2016,37,9,28,32.1,37,9,28,32.1
11120, 은평구,100004, 98세,2016,20,X,18,11.1,19,X,17,11.8
11120, 은평구,100005, 99세,2016,16,X,14,14.3,15,X,14,7.1
11120, 은평구,101,100세이상,2016,21,X,20,5,21,X,20,5
11120, 은평구,102,15세미만,2016,56593,29190,27403,106.5,56271,29020,27251,106.5
11120, 은평구,103,15~64세,2016,347580,170368,177212,96.1,342819,168318,174501,96.5
11120, 은평구,104,65세이상,2016,68069,29657,38412,77.2,67723,29506,38217,77.2
11120, 은평구,086,85세이상,2016,4415,1270,3145,40.4,4394,1263,3131,40.3
11120, 은평구,126,평균연령,2016,41.8,40.8,42.7,,41.8,40.8,42.8,
11120, 은평구,127,중위연령,2016,42.4,41.4,43.4,,42.5,41.4,43.5,
11130, 서대문구,000,합계,2016,320258,151756,168502,90.1,308419,147301,161118,91.4
11130, 서대문구,005,0~4세,2016,11292,5801,5491,105.6,11120,5714,5406,105.7
11130, 서대문구,005001, 0세,2016,2308,1177,1131,104.1,2271,1162,1109,104.8
11130, 서대문구,005002, 1세,2016,2271,1197,1074,111.5,2238,1177,1061,110.9
11130, 서대문구,005003, 2세,2016,2319,1184,1135,104.3,2287,1170,1117,104.7
11130, 서대문구,005004, 3세,2016,2136,1101,1035,106.4,2107,1081,1026,105.4
11130, 서대문구,005005, 4세,2016,2258,1142,1116,102.3,2217,1124,1093,102.8
11130, 서대문구,010,5~9세,2016,10619,5380,5239,102.7,10418,5277,5141,102.6
11130, 서대문구,010001, 5세,2016,2197,1086,1111,97.7,2146,1059,1087,97.4
11130, 서대문구,010002, 6세,2016,2097,1105,992,111.4,2053,1085,968,112.1
11130, 서대문구,010003, 7세,2016,2143,1075,1068,100.7,2105,1052,1053,99.9
11130, 서대문구,010004, 8세,2016,2030,1035,995,104,1995,1019,976,104.4
11130, 서대문구,010005, 9세,2016,2152,1079,1073,100.6,2119,1062,1057,100.5
11130, 서대문구,015,10~14세,2016,11437,5784,5653,102.3,11257,5692,5565,102.3
11130, 서대문구,015001, 10세,2016,2184,1096,1088,100.7,2149,1080,1069,101
11130, 서대문구,015002, 11세,2016,2057,1033,1024,100.9,2028,1018,1010,100.8
11130, 서대문구,015003, 12세,2016,2328,1178,1150,102.4,2287,1159,1128,102.7
11130, 서대문구,015004, 13세,2016,2422,1218,1204,101.2,2387,1200,1187,101.1
11130, 서대문구,015005, 14세,2016,2446,1259,1187,106.1,2406,1235,1171,105.5
11130, 서대문구,020,15~19세,2016,18091,8444,9647,87.5,17324,8217,9107,90.2
11130, 서대문구,020001, 15세,2016,2896,1503,1393,107.9,2836,1470,1366,107.6
11130, 서대문구,020002, 16세,2016,3244,1719,1525,112.7,3190,1687,1503,112.2
11130, 서대문구,020003, 17세,2016,3099,1665,1434,116.1,3040,1634,1406,116.2
11130, 서대문구,020004, 18세,2016,3638,1693,1945,87,3454,1654,1800,91.9
11130, 서대문구,020005, 19세,2016,5214,1864,3350,55.6,4804,1772,3032,58.4
11130, 서대문구,025,20~24세,2016,32533,13650,18883,72.3,29157,12790,16367,78.1
11130, 서대문구,025001, 20세,2016,6245,2301,3944,58.3,5552,2150,3402,63.2
11130, 서대문구,025002, 21세,2016,6305,2520,3785,66.6,5606,2353,3253,72.3
11130, 서대문구,025003, 22세,2016,6352,2656,3696,71.9,5709,2497,3212,77.7
11130, 서대문구,025004, 23세,2016,6902,3071,3831,80.2,6183,2872,3311,86.7
11130, 서대문구,025005, 24세,2016,6729,3102,3627,85.5,6107,2918,3189,91.5
11130, 서대문구,030,25~29세,2016,27402,13295,14107,94.2,25427,12608,12819,98.4
11130, 서대문구,030001, 25세,2016,6361,2984,3377,88.4,5870,2826,3044,92.8
11130, 서대문구,030002, 26세,2016,5870,2832,3038,93.2,5409,2701,2708,99.7
11130, 서대문구,030003, 27세,2016,5437,2738,2699,101.4,5061,2605,2456,106.1
11130, 서대문구,030004, 28세,2016,4960,2437,2523,96.6,4619,2291,2328,98.4
11130, 서대문구,030005, 29세,2016,4774,2304,2470,93.3,4468,2185,2283,95.7
11130, 서대문구,035,30~34세,2016,23806,11757,12049,97.6,22739,11289,11450,98.6
11130, 서대문구,035001, 30세,2016,4588,2294,2294,100,4335,2183,2152,101.4
11130, 서대문구,035002, 31세,2016,4530,2194,2336,93.9,4275,2101,2174,96.6
11130, 서대문구,035003, 32세,2016,4615,2248,2367,95,4427,2165,2262,95.7
11130, 서대문구,035004, 33세,2016,4889,2461,2428,101.4,4700,2368,2332,101.5
11130, 서대문구,035005, 34세,2016,5184,2560,2624,97.6,5002,2472,2530,97.7
11130, 서대문구,040,35~39세,2016,23281,11779,11502,102.4,22568,11448,11120,102.9
11130, 서대문구,040001, 35세,2016,5119,2603,2516,103.5,4956,2532,2424,104.5
11130, 서대문구,040002, 36세,2016,4985,2490,2495,99.8,4859,2432,2427,100.2
11130, 서대문구,040003, 37세,2016,4573,2340,2233,104.8,4433,2282,2151,106.1
11130, 서대문구,040004, 38세,2016,4252,2157,2095,103,4097,2085,2012,103.6
11130, 서대문구,040005, 39세,2016,4352,2189,2163,101.2,4223,2117,2106,100.5
11130, 서대문구,045,40~44세,2016,24009,12002,12007,100,23388,11694,11694,100
11130, 서대문구,045001, 40세,2016,4343,2205,2138,103.1,4222,2150,2072,103.8
11130, 서대문구,045002, 41세,2016,4474,2248,2226,101,4365,2199,2166,101.5
11130, 서대문구,045003, 42세,2016,4972,2452,2520,97.3,4858,2393,2465,97.1
11130, 서대문구,045004, 43세,2016,4941,2404,2537,94.8,4815,2338,2477,94.4
11130, 서대문구,045005, 44세,2016,5279,2693,2586,104.1,5128,2614,2514,104
11130, 서대문구,050,45~49세,2016,26162,12797,13365,95.8,25543,12489,13054,95.7
11130, 서대문구,050001, 45세,2016,5651,2844,2807,101.3,5494,2770,2724,101.7
11130, 서대문구,050002, 46세,2016,5307,2610,2697,96.8,5193,2550,2643,96.5
11130, 서대문구,050003, 47세,2016,5315,2607,2708,96.3,5182,2539,2643,96.1
11130, 서대문구,050004, 48세,2016,5117,2478,2639,93.9,5004,2422,2582,93.8
11130, 서대문구,050005, 49세,2016,4772,2258,2514,89.8,4670,2208,2462,89.7
11130, 서대문구,055,50~54세,2016,23719,11645,12074,96.4,23044,11324,11720,96.6
11130, 서대문구,055001, 50세,2016,4547,2350,2197,107,4422,2296,2126,108
11130, 서대문구,055002, 51세,2016,4791,2282,2509,91,4661,2216,2445,90.6
11130, 서대문구,055003, 52세,2016,4635,2226,2409,92.4,4503,2162,2341,92.4
11130, 서대문구,055004, 53세,2016,4858,2388,2470,96.7,4710,2320,2390,97.1
11130, 서대문구,055005, 54세,2016,4888,2399,2489,96.4,4748,2330,2418,96.4
11130, 서대문구,060,55~59세,2016,24146,11551,12595,91.7,23593,11293,12300,91.8
11130, 서대문구,060001, 55세,2016,5148,2477,2671,92.7,5039,2427,2612,92.9
11130, 서대문구,060002, 56세,2016,5136,2398,2738,87.6,5017,2343,2674,87.6
11130, 서대문구,060003, 57세,2016,4755,2292,2463,93.1,4655,2246,2409,93.2
11130, 서대문구,060004, 58세,2016,4666,2278,2388,95.4,4546,2227,2319,96
11130, 서대문구,060005, 59세,2016,4441,2106,2335,90.2,4336,2050,2286,89.7
11130, 서대문구,065,60~64세,2016,18656,8734,9922,88,18202,8539,9663,88.4
11130, 서대문구,065001, 60세,2016,4162,1980,2182,90.7,4072,1944,2128,91.4
11130, 서대문구,065002, 61세,2016,4281,1992,2289,87,4161,1935,2226,86.9
11130, 서대문구,065003, 62세,2016,3587,1675,1912,87.6,3488,1632,1856,87.9
11130, 서대문구,065004, 63세,2016,3275,1539,1736,88.7,3187,1495,1692,88.4
11130, 서대문구,065005, 64세,2016,3351,1548,1803,85.9,3294,1533,1761,87.1
11130, 서대문구,070,65~69세,2016,14306,6422,7884,81.5,14096,6313,7783,81.1
11130, 서대문구,070001, 65세,2016,2561,1213,1348,90,2510,1180,1330,88.7
11130, 서대문구,070002, 66세,2016,2905,1278,1627,78.5,2868,1259,1609,78.2
11130, 서대문구,070003, 67세,2016,2919,1286,1633,78.8,2870,1263,1607,78.6
11130, 서대문구,070004, 68세,2016,2828,1280,1548,82.7,2792,1262,1530,82.5
11130, 서대문구,070005, 69세,2016,3093,1365,1728,79,3056,1349,1707,79
11130, 서대문구,075,70~74세,2016,12316,5411,6905,78.4,12233,5376,6857,78.4
11130, 서대문구,075001, 70세,2016,2369,1068,1301,82.1,2349,1057,1292,81.8
11130, 서대문구,075002, 71세,2016,2384,1032,1352,76.3,2361,1022,1339,76.3
11130, 서대문구,075003, 72세,2016,2297,997,1300,76.7,2282,993,1289,77
11130, 서대문구,075004, 73세,2016,2405,1032,1373,75.2,2389,1025,1364,75.1
11130, 서대문구,075005, 74세,2016,2861,1282,1579,81.2,2852,1279,1573,81.3
11130, 서대문구,080,75~79세,2016,9862,4257,5605,76,9781,4230,5551,76.2
11130, 서대문구,080001, 75세,2016,2265,1006,1259,79.9,2244,1001,1243,80.5
11130, 서대문구,080002, 76세,2016,2119,931,1188,78.4,2104,925,1179,78.5
11130, 서대문구,080003, 77세,2016,2111,896,1215,73.7,2094,892,1202,74.2
11130, 서대문구,080004, 78세,2016,1770,748,1022,73.2,1755,739,1016,72.7
11130, 서대문구,080005, 79세,2016,1597,676,921,73.4,1584,673,911,73.9
11130, 서대문구,085,80~84세,2016,5447,2105,3342,63,5406,2085,3321,62.8
11130, 서대문구,085001, 80세,2016,1462,610,852,71.6,1445,601,844,71.2
11130, 서대문구,085002, 81세,2016,1361,544,817,66.6,1355,540,815,66.3
11130, 서대문구,085003, 82세,2016,1069,400,669,59.8,1060,397,663,59.9
11130, 서대문구,085004, 83세,2016,853,304,549,55.4,847,302,545,55.4
11130, 서대문구,085005, 84세,2016,702,247,455,54.3,699,245,454,54
11130, 서대문구,090,85~89세,2016,2275,706,1569,45,2245,695,1550,44.8
11130, 서대문구,090001, 85세,2016,551,175,376,46.5,542,174,368,47.3
11130, 서대문구,090002, 86세,2016,578,183,395,46.3,574,182,392,46.4
11130, 서대문구,090003, 87세,2016,472,159,313,50.8,463,155,308,50.3
11130, 서대문구,090004, 88세,2016,371,111,260,42.7,366,108,258,41.9
11130, 서대문구,090005, 89세,2016,303,78,225,34.7,300,76,224,33.9
11130, 서대문구,095,90~94세,2016,733,195,538,36.2,721,193,528,36.6
11130, 서대문구,095001, 90세,2016,204,56,148,37.8,203,56,147,38.1
11130, 서대문구,095002, 91세,2016,171,48,123,39,167,48,119,40.3
11130, 서대문구,095003, 92세,2016,138,35,103,34,135,35,100,35
11130, 서대문구,095004, 93세,2016,125,37,88,42,122,35,87,40.2
11130, 서대문구,095005, 94세,2016,95,19,76,25,94,19,75,25.3
11130, 서대문구,100,95~99세,2016,144,37,107,34.6,137,32,105,30.5
11130, 서대문구,100001, 95세,2016,52,12,40,30,50,10,40,25
11130, 서대문구,100002, 96세,2016,41,12,29,41.4,41,12,29,41.4
11130, 서대문구,100003, 97세,2016,26,6,20,30,23,X,19,21.1
11130, 서대문구,100004, 98세,2016,10,X,9,11.1,9,X,9,0
11130, 서대문구,100005, 99세,2016,15,6,9,66.7,14,6,8,75
11130, 서대문구,101,100세이상,2016,22,X,18,22.2,20,X,17,17.6
11130, 서대문구,102,15세미만,2016,33348,16965,16383,103.6,32795,16683,16112,103.5
11130, 서대문구,103,15~64세,2016,241805,115654,126151,91.7,230985,111691,119294,93.6
11130, 서대문구,104,65세이상,2016,45105,19137,25968,73.7,44639,18927,25712,73.6
11130, 서대문구,086,85세이상,2016,3174,942,2232,42.2,3123,923,2200,42
11130, 서대문구,126,평균연령,2016,40.9,40.3,41.5,,41.2,40.5,41.9,
11130, 서대문구,127,중위연령,2016,40.4,40,40.8,,41,40.3,41.7,
11140, 마포구,000,합계,2016,375142,179193,195949,91.4,363741,174215,189526,91.9
11140, 마포구,005,0~4세,2016,15545,7921,7624,103.9,15321,7804,7517,103.8
11140, 마포구,005001, 0세,2016,3467,1761,1706,103.2,3421,1735,1686,102.9
11140, 마포구,005002, 1세,2016,3215,1657,1558,106.4,3173,1632,1541,105.9
11140, 마포구,005003, 2세,2016,2961,1527,1434,106.5,2916,1508,1408,107.1
11140, 마포구,005004, 3세,2016,2868,1439,1429,100.7,2822,1412,1410,100.1
11140, 마포구,005005, 4세,2016,3034,1537,1497,102.7,2989,1517,1472,103.1
11140, 마포구,010,5~9세,2016,14570,7432,7138,104.1,14325,7311,7014,104.2
11140, 마포구,010001, 5세,2016,2961,1506,1455,103.5,2904,1479,1425,103.8
11140, 마포구,010002, 6세,2016,2872,1443,1429,101,2810,1414,1396,101.3
11140, 마포구,010003, 7세,2016,2774,1460,1314,111.1,2733,1436,1297,110.7
11140, 마포구,010004, 8세,2016,3004,1528,1476,103.5,2945,1500,1445,103.8
11140, 마포구,010005, 9세,2016,2959,1495,1464,102.1,2933,1482,1451,102.1
11140, 마포구,015,10~14세,2016,13916,7066,6850,103.2,13749,6979,6770,103.1
11140, 마포구,015001, 10세,2016,2696,1348,1348,100,2662,1327,1335,99.4
11140, 마포구,015002, 11세,2016,2683,1381,1302,106.1,2649,1366,1283,106.5
11140, 마포구,015003, 12세,2016,2843,1421,1422,99.9,2806,1405,1401,100.3
11140, 마포구,015004, 13세,2016,2840,1501,1339,112.1,2801,1479,1322,111.9
11140, 마포구,015005, 14세,2016,2854,1415,1439,98.3,2831,1402,1429,98.1
11140, 마포구,020,15~19세,2016,17808,8868,8940,99.2,17365,8714,8651,100.7
11140, 마포구,020001, 15세,2016,3134,1630,1504,108.4,3105,1616,1489,108.5
11140, 마포구,020002, 16세,2016,3335,1669,1666,100.2,3305,1658,1647,100.7
11140, 마포구,020003, 17세,2016,3290,1679,1611,104.2,3246,1664,1582,105.2
11140, 마포구,020004, 18세,2016,3560,1785,1775,100.6,3458,1748,1710,102.2
11140, 마포구,020005, 19세,2016,4489,2105,2384,88.3,4251,2028,2223,91.2
11140, 마포구,025,20~24세,2016,28809,13357,15452,86.4,26826,12779,14047,91
11140, 마포구,025001, 20세,2016,5016,2319,2697,86,4707,2242,2465,91
11140, 마포구,025002, 21세,2016,5215,2338,2877,81.3,4863,2248,2615,86
11140, 마포구,025003, 22세,2016,5680,2679,3001,89.3,5234,2540,2694,94.3
11140, 마포구,025004, 23세,2016,6231,2964,3267,90.7,5782,2831,2951,95.9
11140, 마포구,025005, 24세,2016,6667,3057,3610,84.7,6240,2918,3322,87.8
11140, 마포구,030,25~29세,2016,32871,15177,17694,85.8,30969,14487,16482,87.9
11140, 마포구,030001, 25세,2016,6677,3099,3578,86.6,6253,2964,3289,90.1
11140, 마포구,030002, 26세,2016,6597,3048,3549,85.9,6166,2900,3266,88.8
11140, 마포구,030003, 27세,2016,6472,3010,3462,86.9,6114,2874,3240,88.7
11140, 마포구,030004, 28세,2016,6498,2978,3520,84.6,6140,2842,3298,86.2
11140, 마포구,030005, 29세,2016,6627,3042,3585,84.9,6296,2907,3389,85.8
11140, 마포구,035,30~34세,2016,36140,17283,18857,91.7,34689,16579,18110,91.5
11140, 마포구,035001, 30세,2016,6856,3136,3720,84.3,6519,2993,3526,84.9
11140, 마포구,035002, 31세,2016,6877,3243,3634,89.2,6567,3102,3465,89.5
11140, 마포구,035003, 32세,2016,7163,3481,3682,94.5,6842,3319,3523,94.2
11140, 마포구,035004, 33세,2016,7425,3575,3850,92.9,7183,3453,3730,92.6
11140, 마포구,035005, 34세,2016,7819,3848,3971,96.9,7578,3712,3866,96
11140, 마포구,040,35~39세,2016,33701,16581,17120,96.9,32720,16022,16698,96
11140, 마포구,040001, 35세,2016,7435,3728,3707,100.6,7238,3616,3622,99.8
11140, 마포구,040002, 36세,2016,7174,3551,3623,98,6960,3431,3529,97.2
11140, 마포구,040003, 37세,2016,6787,3313,3474,95.4,6561,3181,3380,94.1
11140, 마포구,040004, 38세,2016,6032,2973,3059,97.2,5858,2871,2987,96.1
11140, 마포구,040005, 39세,2016,6273,3016,3257,92.6,6103,2923,3180,91.9
11140, 마포구,045,40~44세,2016,32593,16311,16282,100.2,31837,15877,15960,99.5
11140, 마포구,045001, 40세,2016,6182,3070,3112,98.7,6029,2981,3048,97.8
11140, 마포구,045002, 41세,2016,6335,3193,3142,101.6,6196,3115,3081,101.1
11140, 마포구,045003, 42세,2016,6609,3339,3270,102.1,6476,3264,3212,101.6
11140, 마포구,045004, 43세,2016,6732,3266,3466,94.2,6546,3157,3389,93.2
11140, 마포구,045005, 44세,2016,6735,3443,3292,104.6,6590,3360,3230,104
11140, 마포구,050,45~49세,2016,30980,15347,15633,98.2,30216,14958,15258,98
11140, 마포구,050001, 45세,2016,6981,3510,3471,101.1,6813,3422,3391,100.9
11140, 마포구,050002, 46세,2016,6471,3247,3224,100.7,6312,3166,3146,100.6
11140, 마포구,050003, 47세,2016,6263,3154,3109,101.4,6114,3073,3041,101.1
11140, 마포구,050004, 48세,2016,5937,2861,3076,93,5789,2797,2992,93.5
11140, 마포구,050005, 49세,2016,5328,2575,2753,93.5,5188,2500,2688,93
11140, 마포구,055,50~54세,2016,26373,12857,13516,95.1,25573,12491,13082,95.5
11140, 마포구,055001, 50세,2016,5081,2557,2524,101.3,4928,2479,2449,101.2
11140, 마포구,055002, 51세,2016,5487,2631,2856,92.1,5329,2559,2770,92.4
11140, 마포구,055003, 52세,2016,5134,2501,2633,95,4977,2432,2545,95.6
11140, 마포구,055004, 53세,2016,5360,2600,2760,94.2,5186,2528,2658,95.1
11140, 마포구,055005, 54세,2016,5311,2568,2743,93.6,5153,2493,2660,93.7
11140, 마포구,060,55~59세,2016,26179,12468,13711,90.9,25545,12177,13368,91.1
11140, 마포구,060001, 55세,2016,5608,2717,2891,94,5511,2674,2837,94.3
11140, 마포구,060002, 56세,2016,5799,2762,3037,90.9,5642,2697,2945,91.6
11140, 마포구,060003, 57세,2016,5180,2464,2716,90.7,5051,2405,2646,90.9
11140, 마포구,060004, 58세,2016,4813,2284,2529,90.3,4675,2223,2452,90.7
11140, 마포구,060005, 59세,2016,4779,2241,2538,88.3,4666,2178,2488,87.5
11140, 마포구,065,60~64세,2016,19885,9223,10662,86.5,19345,8959,10386,86.3
11140, 마포구,065001, 60세,2016,4443,2081,2362,88.1,4325,2021,2304,87.7
11140, 마포구,065002, 61세,2016,4620,2161,2459,87.9,4508,2115,2393,88.4
11140, 마포구,065003, 62세,2016,3821,1773,2048,86.6,3710,1720,1990,86.4
11140, 마포구,065004, 63세,2016,3325,1516,1809,83.8,3227,1463,1764,82.9
11140, 마포구,065005, 64세,2016,3676,1692,1984,85.3,3575,1640,1935,84.8
11140, 마포구,070,65~69세,2016,14769,6486,8283,78.3,14540,6373,8167,78
11140, 마포구,070001, 65세,2016,2585,1166,1419,82.2,2533,1140,1393,81.8
11140, 마포구,070002, 66세,2016,2999,1343,1656,81.1,2940,1310,1630,80.4
11140, 마포구,070003, 67세,2016,3066,1322,1744,75.8,3018,1296,1722,75.3
11140, 마포구,070004, 68세,2016,3042,1320,1722,76.7,3012,1309,1703,76.9
11140, 마포구,070005, 69세,2016,3077,1335,1742,76.6,3037,1318,1719,76.7
11140, 마포구,075,70~74세,2016,12603,5506,7097,77.6,12501,5465,7036,77.7
11140, 마포구,075001, 70세,2016,2394,1008,1386,72.7,2364,995,1369,72.7
11140, 마포구,075002, 71세,2016,2469,1062,1407,75.5,2449,1053,1396,75.4
11140, 마포구,075003, 72세,2016,2448,1058,1390,76.1,2427,1049,1378,76.1
11140, 마포구,075004, 73세,2016,2444,1086,1358,80,2431,1083,1348,80.3
11140, 마포구,075005, 74세,2016,2848,1292,1556,83,2830,1285,1545,83.2
11140, 마포구,080,75~79세,2016,9652,4182,5470,76.5,9578,4153,5425,76.6
11140, 마포구,080001, 75세,2016,2244,998,1246,80.1,2225,990,1235,80.2
11140, 마포구,080002, 76세,2016,2090,911,1179,77.3,2071,901,1170,77
11140, 마포구,080003, 77세,2016,1943,852,1091,78.1,1935,848,1087,78
11140, 마포구,080004, 78세,2016,1695,721,974,74,1680,718,962,74.6
11140, 마포구,080005, 79세,2016,1680,700,980,71.4,1667,696,971,71.7
11140, 마포구,085,80~84세,2016,5468,2098,3370,62.3,5413,2076,3337,62.2
11140, 마포구,085001, 80세,2016,1432,577,855,67.5,1415,570,845,67.5
11140, 마포구,085002, 81세,2016,1326,509,817,62.3,1319,504,815,61.8
11140, 마포구,085003, 82세,2016,1029,359,670,53.6,1017,355,662,53.6
11140, 마포구,085004, 83세,2016,912,378,534,70.8,903,374,529,70.7
11140, 마포구,085005, 84세,2016,769,275,494,55.7,759,273,486,56.2
11140, 마포구,090,85~89세,2016,2360,782,1578,49.6,2334,772,1562,49.4
11140, 마포구,090001, 85세,2016,606,216,390,55.4,600,214,386,55.4
11140, 마포구,090002, 86세,2016,552,189,363,52.1,543,186,357,52.1
11140, 마포구,090003, 87세,2016,496,172,324,53.1,490,170,320,53.1
11140, 마포구,090004, 88세,2016,396,120,276,43.5,395,119,276,43.1
11140, 마포구,090005, 89세,2016,310,85,225,37.8,306,83,223,37.2
11140, 마포구,095,90~94세,2016,731,195,536,36.4,715,189,526,35.9
11140, 마포구,095001, 90세,2016,208,56,152,36.8,206,55,151,36.4
11140, 마포구,095002, 91세,2016,164,44,120,36.7,161,43,118,36.4
11140, 마포구,095003, 92세,2016,139,39,100,39,136,38,98,38.8
11140, 마포구,095004, 93세,2016,123,33,90,36.7,120,33,87,37.9
11140, 마포구,095005, 94세,2016,97,23,74,31.1,92,20,72,27.8
11140, 마포구,100,95~99세,2016,171,49,122,40.2,163,46,117,39.3
11140, 마포구,100001, 95세,2016,62,20,42,47.6,58,19,39,48.7
11140, 마포구,100002, 96세,2016,40,14,26,53.8,40,14,26,53.8
11140, 마포구,100003, 97세,2016,27,7,20,35,24,6,18,33.3
11140, 마포구,100004, 98세,2016,25,X,21,19,24,X,21,14.3
11140, 마포구,100005, 99세,2016,17,X,13,30.8,17,X,13,30.8
11140, 마포구,101,100세이상,2016,18,X,14,28.6,17,X,13,30.8
11140, 마포구,102,15세미만,2016,44031,22419,21612,103.7,43395,22094,21301,103.7
11140, 마포구,103,15~64세,2016,285339,137472,147867,93,275085,133043,142042,93.7
11140, 마포구,104,65세이상,2016,45772,19302,26470,72.9,45261,19078,26183,72.9
11140, 마포구,086,85세이상,2016,3280,1030,2250,45.8,3229,1011,2218,45.6
11140, 마포구,126,평균연령,2016,40,39.3,40.7,,40.1,39.3,40.9,
11140, 마포구,127,중위연령,2016,39.1,38.6,39.5,,39.3,38.8,39.8,
11150, 양천구,000,합계,2016,460267,226927,233340,97.3,454621,224290,230331,97.4
11150, 양천구,005,0~4세,2016,17111,8741,8370,104.4,17002,8683,8319,104.4
11150, 양천구,005001, 0세,2016,3356,1686,1670,101,3339,1675,1664,100.7
11150, 양천구,005002, 1세,2016,3354,1741,1613,107.9,3330,1727,1603,107.7
11150, 양천구,005003, 2세,2016,3314,1681,1633,102.9,3289,1668,1621,102.9
11150, 양천구,005004, 3세,2016,3394,1756,1638,107.2,3371,1744,1627,107.2
11150, 양천구,005005, 4세,2016,3693,1877,1816,103.4,3673,1869,1804,103.6
11150, 양천구,010,5~9세,2016,20509,10605,9904,107.1,20380,10541,9839,107.1
11150, 양천구,010001, 5세,2016,3785,1972,1813,108.8,3750,1962,1788,109.7
11150, 양천구,010002, 6세,2016,3879,1997,1882,106.1,3850,1980,1870,105.9
11150, 양천구,010003, 7세,2016,3913,2032,1881,108,3892,2021,1871,108
11150, 양천구,010004, 8세,2016,4393,2275,2118,107.4,4366,2258,2108,107.1
11150, 양천구,010005, 9세,2016,4539,2329,2210,105.4,4522,2320,2202,105.4
11150, 양천구,015,10~14세,2016,24920,13035,11885,109.7,24842,12992,11850,109.6
11150, 양천구,015001, 10세,2016,4240,2176,2064,105.4,4228,2169,2059,105.3
11150, 양천구,015002, 11세,2016,4584,2412,2172,111,4574,2409,2165,111.3
11150, 양천구,015003, 12세,2016,5202,2787,2415,115.4,5188,2776,2412,115.1
11150, 양천구,015004, 13세,2016,5335,2772,2563,108.2,5311,2759,2552,108.1
11150, 양천구,015005, 14세,2016,5559,2888,2671,108.1,5541,2879,2662,108.2
11150, 양천구,020,15~19세,2016,31535,16594,14941,111.1,31458,16557,14901,111.1
11150, 양천구,020001, 15세,2016,6185,3263,2922,111.7,6174,3256,2918,111.6
11150, 양천구,020002, 16세,2016,6361,3343,3018,110.8,6351,3339,3012,110.9
11150, 양천구,020003, 17세,2016,6667,3526,3141,112.3,6649,3517,3132,112.3
11150, 양천구,020004, 18세,2016,6399,3363,3036,110.8,6390,3359,3031,110.8
11150, 양천구,020005, 19세,2016,5923,3099,2824,109.7,5894,3086,2808,109.9
11150, 양천구,025,20~24세,2016,30523,15991,14532,110,30266,15887,14379,110.5
11150, 양천구,025001, 20세,2016,5991,3218,2773,116,5967,3206,2761,116.1
11150, 양천구,025002, 21세,2016,6164,3415,2749,124.2,6129,3400,2729,124.6
11150, 양천구,025003, 22세,2016,6164,3264,2900,112.6,6114,3248,2866,113.3
11150, 양천구,025004, 23세,2016,6117,3106,3011,103.2,6048,3077,2971,103.6
11150, 양천구,025005, 24세,2016,6087,2988,3099,96.4,6008,2956,3052,96.9
11150, 양천구,030,25~29세,2016,28362,13898,14464,96.1,27746,13637,14109,96.7
11150, 양천구,030001, 25세,2016,6034,2949,3085,95.6,5929,2907,3022,96.2
11150, 양천구,030002, 26세,2016,5696,2852,2844,100.3,5586,2807,2779,101
11150, 양천구,030003, 27세,2016,5537,2703,2834,95.4,5410,2645,2765,95.7
11150, 양천구,030004, 28세,2016,5579,2729,2850,95.8,5446,2681,2765,97
11150, 양천구,030005, 29세,2016,5516,2665,2851,93.5,5375,2597,2778,93.5
11150, 양천구,035,30~34세,2016,31452,15853,15599,101.6,30818,15552,15266,101.9
11150, 양천구,035001, 30세,2016,5722,2863,2859,100.1,5601,2807,2794,100.5
11150, 양천구,035002, 31세,2016,5850,2932,2918,100.5,5726,2875,2851,100.8
11150, 양천구,035003, 32세,2016,6156,3112,3044,102.2,6024,3053,2971,102.8
11150, 양천구,035004, 33세,2016,6596,3352,3244,103.3,6467,3287,3180,103.4
11150, 양천구,035005, 34세,2016,7128,3594,3534,101.7,7000,3530,3470,101.7
11150, 양천구,040,35~39세,2016,34014,16605,17409,95.4,33466,16338,17128,95.4
11150, 양천구,040001, 35세,2016,7089,3550,3539,100.3,6980,3490,3490,100
11150, 양천구,040002, 36세,2016,7153,3551,3602,98.6,7042,3491,3551,98.3
11150, 양천구,040003, 37세,2016,6861,3376,3485,96.9,6748,3327,3421,97.3
11150, 양천구,040004, 38세,2016,6434,3046,3388,89.9,6320,2991,3329,89.8
11150, 양천구,040005, 39세,2016,6477,3082,3395,90.8,6376,3039,3337,91.1
11150, 양천구,045,40~44세,2016,39321,18435,20886,88.3,38844,18192,20652,88.1
11150, 양천구,045001, 40세,2016,6771,3223,3548,90.8,6676,3183,3493,91.1
11150, 양천구,045002, 41세,2016,7250,3387,3863,87.7,7179,3346,3833,87.3
11150, 양천구,045003, 42세,2016,8097,3835,4262,90,8006,3785,4221,89.7
11150, 양천구,045004, 43세,2016,8405,3888,4517,86.1,8310,3835,4475,85.7
11150, 양천구,045005, 44세,2016,8798,4102,4696,87.4,8673,4043,4630,87.3
11150, 양천구,050,45~49세,2016,46402,22525,23877,94.3,45799,22235,23564,94.4
11150, 양천구,050001, 45세,2016,9765,4726,5039,93.8,9631,4660,4971,93.7
11150, 양천구,050002, 46세,2016,9429,4513,4916,91.8,9312,4464,4848,92.1
11150, 양천구,050003, 47세,2016,9587,4655,4932,94.4,9481,4599,4882,94.2
11150, 양천구,050004, 48세,2016,9137,4491,4646,96.7,9012,4434,4578,96.9
11150, 양천구,050005, 49세,2016,8484,4140,4344,95.3,8363,4078,4285,95.2
11150, 양천구,055,50~54세,2016,40123,20210,19913,101.5,39423,19895,19528,101.9
11150, 양천구,055001, 50세,2016,8136,4104,4032,101.8,8027,4057,3970,102.2
11150, 양천구,055002, 51세,2016,8254,4105,4149,98.9,8118,4041,4077,99.1
11150, 양천구,055003, 52세,2016,7743,3904,3839,101.7,7598,3848,3750,102.6
11150, 양천구,055004, 53세,2016,8040,4093,3947,103.7,7856,4006,3850,104.1
11150, 양천구,055005, 54세,2016,7950,4004,3946,101.5,7824,3943,3881,101.6
11150, 양천구,060,55~59세,2016,37596,18359,19237,95.4,37075,18130,18945,95.7
11150, 양천구,060001, 55세,2016,8191,4041,4150,97.4,8119,4011,4108,97.6
11150, 양천구,060002, 56세,2016,8180,4023,4157,96.8,8054,3965,4089,97
11150, 양천구,060003, 57세,2016,7410,3614,3796,95.2,7306,3563,3743,95.2
11150, 양천구,060004, 58세,2016,7040,3420,3620,94.5,6931,3373,3558,94.8
11150, 양천구,060005, 59세,2016,6775,3261,3514,92.8,6665,3218,3447,93.4
11150, 양천구,065,60~64세,2016,28178,13713,14465,94.8,27688,13481,14207,94.9
11150, 양천구,065001, 60세,2016,6270,3018,3252,92.8,6154,2962,3192,92.8
11150, 양천구,065002, 61세,2016,6589,3164,3425,92.4,6480,3115,3365,92.6
11150, 양천구,065003, 62세,2016,5370,2668,2702,98.7,5265,2627,2638,99.6
11150, 양천구,065004, 63세,2016,4818,2344,2474,94.7,4734,2302,2432,94.7
11150, 양천구,065005, 64세,2016,5131,2519,2612,96.4,5055,2475,2580,95.9
11150, 양천구,070,65~69세,2016,18896,9455,9441,100.1,18659,9340,9319,100.2
11150, 양천구,070001, 65세,2016,3639,1816,1823,99.6,3574,1785,1789,99.8
11150, 양천구,070002, 66세,2016,4033,2038,1995,102.2,3980,2011,1969,102.1
11150, 양천구,070003, 67세,2016,3860,1920,1940,99,3807,1895,1912,99.1
11150, 양천구,070004, 68세,2016,3730,1864,1866,99.9,3696,1853,1843,100.5
11150, 양천구,070005, 69세,2016,3634,1817,1817,100,3602,1796,1806,99.4
11150, 양천구,075,70~74세,2016,13090,6253,6837,91.5,13023,6218,6805,91.4
11150, 양천구,075001, 70세,2016,2776,1352,1424,94.9,2755,1340,1415,94.7
11150, 양천구,075002, 71세,2016,2570,1239,1331,93.1,2557,1233,1324,93.1
11150, 양천구,075003, 72세,2016,2522,1196,1326,90.2,2504,1186,1318,90
11150, 양천구,075004, 73세,2016,2485,1203,1282,93.8,2476,1198,1278,93.7
11150, 양천구,075005, 74세,2016,2737,1263,1474,85.7,2731,1261,1470,85.8
11150, 양천구,080,75~79세,2016,9264,3895,5369,72.5,9217,3875,5342,72.5
11150, 양천구,080001, 75세,2016,2227,1016,1211,83.9,2218,1013,1205,84.1
11150, 양천구,080002, 76세,2016,1918,819,1099,74.5,1904,814,1090,74.7
11150, 양천구,080003, 77세,2016,1886,781,1105,70.7,1874,775,1099,70.5
11150, 양천구,080004, 78세,2016,1643,692,951,72.8,1637,688,949,72.5
11150, 양천구,080005, 79세,2016,1590,587,1003,58.5,1584,585,999,58.6
11150, 양천구,085,80~84세,2016,5363,1839,3524,52.2,5326,1824,3502,52.1
11150, 양천구,085001, 80세,2016,1337,490,847,57.9,1326,487,839,58
11150, 양천구,085002, 81세,2016,1236,436,800,54.5,1227,430,797,54
11150, 양천구,085003, 82세,2016,1051,359,692,51.9,1045,358,687,52.1
11150, 양천구,085004, 83세,2016,920,308,612,50.3,914,306,608,50.3
11150, 양천구,085005, 84세,2016,819,246,573,42.9,814,243,571,42.6
11150, 양천구,090,85~89세,2016,2565,686,1879,36.5,2554,682,1872,36.4
11150, 양천구,090001, 85세,2016,655,180,475,37.9,650,177,473,37.4
11150, 양천구,090002, 86세,2016,618,153,465,32.9,616,153,463,33
11150, 양천구,090003, 87세,2016,548,154,394,39.1,548,154,394,39.1
11150, 양천구,090004, 88세,2016,442,118,324,36.4,439,117,322,36.3
11150, 양천구,090005, 89세,2016,302,81,221,36.7,301,81,220,36.8
11150, 양천구,095,90~94세,2016,843,187,656,28.5,837,185,652,28.4
11150, 양천구,095001, 90세,2016,233,50,183,27.3,229,49,180,27.2
11150, 양천구,095002, 91세,2016,207,44,163,27,206,43,163,26.4
11150, 양천구,095003, 92세,2016,142,31,111,27.9,142,31,111,27.9
11150, 양천구,095004, 93세,2016,162,44,118,37.3,161,44,117,37.6
11150, 양천구,095005, 94세,2016,99,18,81,22.2,99,18,81,22.2
11150, 양천구,100,95~99세,2016,178,46,132,34.8,177,45,132,34.1
11150, 양천구,100001, 95세,2016,72,17,55,30.9,72,17,55,30.9
11150, 양천구,100002, 96세,2016,46,14,32,43.8,46,14,32,43.8
11150, 양천구,100003, 97세,2016,32,9,23,39.1,31,8,23,34.8
11150, 양천구,100004, 98세,2016,14,X,11,27.3,14,X,11,27.3
11150, 양천구,100005, 99세,2016,14,X,11,27.3,14,X,11,27.3
11150, 양천구,101,100세이상,2016,22,X,20,10,21,X,20,5
11150, 양천구,102,15세미만,2016,62540,32381,30159,107.4,62224,32216,30008,107.4
11150, 양천구,103,15~64세,2016,347506,172183,175323,98.2,342583,169904,172679,98.4
11150, 양천구,104,65세이상,2016,50221,22363,27858,80.3,49814,22170,27644,80.2
11150, 양천구,086,85세이상,2016,3608,921,2687,34.3,3589,913,2676,34.1
11150, 양천구,126,평균연령,2016,40,39.2,40.9,,40,39.1,40.9,
11150, 양천구,127,중위연령,2016,41.7,40.7,42.5,,41.6,40.6,42.5,
11160, 강서구,000,합계,2016,574287,279521,294766,94.8,565968,275482,290486,94.8
11160, 강서구,005,0~4세,2016,26704,13625,13079,104.2,26502,13520,12982,104.1
11160, 강서구,005001, 0세,2016,5638,2928,2710,108,5584,2903,2681,108.3
11160, 강서구,005002, 1세,2016,5408,2742,2666,102.9,5371,2720,2651,102.6
11160, 강서구,005003, 2세,2016,5253,2642,2611,101.2,5210,2620,2590,101.2
11160, 강서구,005004, 3세,2016,5034,2549,2485,102.6,5001,2534,2467,102.7
11160, 강서구,005005, 4세,2016,5371,2764,2607,106,5336,2743,2593,105.8
11160, 강서구,010,5~9세,2016,22972,11752,11220,104.7,22833,11674,11159,104.6
11160, 강서구,010001, 5세,2016,4950,2531,2419,104.6,4907,2507,2400,104.5
11160, 강서구,010002, 6세,2016,4496,2348,2148,109.3,4471,2333,2138,109.1
11160, 강서구,010003, 7세,2016,4294,2228,2066,107.8,4261,2211,2050,107.9
11160, 강서구,010004, 8세,2016,4644,2312,2332,99.1,4622,2301,2321,99.1
11160, 강서구,010005, 9세,2016,4588,2333,2255,103.5,4572,2322,2250,103.2
11160, 강서구,015,10~14세,2016,22218,11392,10826,105.2,22152,11358,10794,105.2
11160, 강서구,015001, 10세,2016,4224,2176,2048,106.3,4211,2169,2042,106.2
11160, 강서구,015002, 11세,2016,4108,2073,2035,101.9,4095,2070,2025,102.2
11160, 강서구,015003, 12세,2016,4562,2349,2213,106.1,4553,2344,2209,106.1
11160, 강서구,015004, 13세,2016,4593,2351,2242,104.9,4577,2341,2236,104.7
11160, 강서구,015005, 14세,2016,4731,2443,2288,106.8,4716,2434,2282,106.7
11160, 강서구,020,15~19세,2016,28300,14312,13988,102.3,28185,14267,13918,102.5
11160, 강서구,020001, 15세,2016,5223,2640,2583,102.2,5208,2634,2574,102.3
11160, 강서구,020002, 16세,2016,5767,2898,2869,101,5750,2887,2863,100.8
11160, 강서구,020003, 17세,2016,5563,2844,2719,104.6,5534,2835,2699,105
11160, 강서구,020004, 18세,2016,5838,3009,2829,106.4,5811,3000,2811,106.7
11160, 강서구,020005, 19세,2016,5909,2921,2988,97.8,5882,2911,2971,98
11160, 강서구,025,20~24세,2016,36116,18035,18081,99.7,35686,17838,17848,99.9
11160, 강서구,025001, 20세,2016,6315,3336,2979,112,6269,3314,2955,112.1
11160, 강서구,025002, 21세,2016,6862,3622,3240,111.8,6821,3605,3216,112.1
11160, 강서구,025003, 22세,2016,7043,3555,3488,101.9,6952,3511,3441,102
11160, 강서구,025004, 23세,2016,7619,3675,3944,93.2,7510,3622,3888,93.2
11160, 강서구,025005, 24세,2016,8277,3847,4430,86.8,8134,3786,4348,87.1
11160, 강서구,030,25~29세,2016,43850,20571,23279,88.4,42818,20094,22724,88.4
11160, 강서구,030001, 25세,2016,8530,3913,4617,84.8,8368,3838,4530,84.7
11160, 강서구,030002, 26세,2016,8624,4051,4573,88.6,8411,3944,4467,88.3
11160, 강서구,030003, 27세,2016,8646,4116,4530,90.9,8436,4025,4411,91.2
11160, 강서구,030004, 28세,2016,8966,4197,4769,88,8745,4096,4649,88.1
11160, 강서구,030005, 29세,2016,9084,4294,4790,89.6,8858,4191,4667,89.8
11160, 강서구,035,30~34세,2016,52715,26356,26359,100,51619,25843,25776,100.3
11160, 강서구,035001, 30세,2016,9544,4663,4881,95.5,9334,4570,4764,95.9
11160, 강서구,035002, 31세,2016,9907,4991,4916,101.5,9670,4873,4797,101.6
11160, 강서구,035003, 32세,2016,10231,5085,5146,98.8,10004,4989,5015,99.5
11160, 강서구,035004, 33세,2016,11203,5669,5534,102.4,10995,5569,5426,102.6
11160, 강서구,035005, 34세,2016,11830,5948,5882,101.1,11616,5842,5774,101.2
11160, 강서구,040,35~39세,2016,51916,26738,25178,106.2,51152,26346,24806,106.2
11160, 강서구,040001, 35세,2016,11407,6043,5364,112.7,11239,5964,5275,113.1
11160, 강서구,040002, 36세,2016,11389,5815,5574,104.3,11218,5731,5487,104.4
11160, 강서구,040003, 37세,2016,10629,5425,5204,104.2,10478,5348,5130,104.2
11160, 강서구,040004, 38세,2016,9216,4716,4500,104.8,9075,4642,4433,104.7
11160, 강서구,040005, 39세,2016,9275,4739,4536,104.5,9142,4661,4481,104
11160, 강서구,045,40~44세,2016,46732,23685,23047,102.8,46073,23338,22735,102.7
11160, 강서구,045001, 40세,2016,8787,4436,4351,102,8653,4356,4297,101.4
11160, 강서구,045002, 41세,2016,9059,4581,4478,102.3,8945,4525,4420,102.4
11160, 강서구,045003, 42세,2016,9784,4903,4881,100.5,9658,4832,4826,100.1
11160, 강서구,045004, 43세,2016,9683,4997,4686,106.6,9530,4917,4613,106.6
11160, 강서구,045005, 44세,2016,9419,4768,4651,102.5,9287,4708,4579,102.8
11160, 강서구,050,45~49세,2016,45395,22222,23173,95.9,44612,21820,22792,95.7
11160, 강서구,050001, 45세,2016,9697,4868,4829,100.8,9533,4773,4760,100.3
11160, 강서구,050002, 46세,2016,9203,4546,4657,97.6,9037,4463,4574,97.6
11160, 강서구,050003, 47세,2016,9164,4538,4626,98.1,9032,4479,4553,98.4
11160, 강서구,050004, 48세,2016,9057,4357,4700,92.7,8885,4274,4611,92.7
11160, 강서구,050005, 49세,2016,8274,3913,4361,89.7,8125,3831,4294,89.2
11160, 강서구,055,50~54세,2016,43410,20623,22787,90.5,42445,20143,22302,90.3
11160, 강서구,055001, 50세,2016,8190,3900,4290,90.9,8025,3819,4206,90.8
11160, 강서구,055002, 51세,2016,8635,4099,4536,90.4,8447,3993,4454,89.6
11160, 강서구,055003, 52세,2016,8309,3885,4424,87.8,8107,3790,4317,87.8
11160, 강서구,055004, 53세,2016,9059,4325,4734,91.4,8838,4222,4616,91.5
11160, 강서구,055005, 54세,2016,9217,4414,4803,91.9,9028,4319,4709,91.7
11160, 강서구,060,55~59세,2016,48207,22603,25604,88.3,47423,22213,25210,88.1
11160, 강서구,060001, 55세,2016,10157,4712,5445,86.5,10027,4653,5374,86.6
11160, 강서구,060002, 56세,2016,10235,4767,5468,87.2,10067,4674,5393,86.7
11160, 강서구,060003, 57세,2016,9552,4564,4988,91.5,9402,4489,4913,91.4
11160, 강서구,060004, 58세,2016,9020,4217,4803,87.8,8861,4141,4720,87.7
11160, 강서구,060005, 59세,2016,9243,4343,4900,88.6,9066,4256,4810,88.5
11160, 강서구,065,60~64세,2016,37329,17478,19851,88,36580,17104,19476,87.8
11160, 강서구,065001, 60세,2016,8175,3769,4406,85.5,8016,3687,4329,85.2
11160, 강서구,065002, 61세,2016,8729,3980,4749,83.8,8542,3891,4651,83.7
11160, 강서구,065003, 62세,2016,7174,3357,3817,87.9,7025,3287,3738,87.9
11160, 강서구,065004, 63세,2016,6448,3102,3346,92.7,6308,3025,3283,92.1
11160, 강서구,065005, 64세,2016,6803,3270,3533,92.6,6689,3214,3475,92.5
11160, 강서구,070,65~69세,2016,25969,12542,13427,93.4,25703,12428,13275,93.6
11160, 강서구,070001, 65세,2016,4812,2312,2500,92.5,4736,2276,2460,92.5
11160, 강서구,070002, 66세,2016,5435,2608,2827,92.3,5367,2575,2792,92.2
11160, 강서구,070003, 67세,2016,5481,2614,2867,91.2,5424,2592,2832,91.5
11160, 강서구,070004, 68세,2016,5079,2492,2587,96.3,5049,2484,2565,96.8
11160, 강서구,070005, 69세,2016,5162,2516,2646,95.1,5127,2501,2626,95.2
11160, 강서구,075,70~74세,2016,17813,8641,9172,94.2,17688,8594,9094,94.5
11160, 강서구,075001, 70세,2016,3820,1903,1917,99.3,3800,1895,1905,99.5
11160, 강서구,075002, 71세,2016,3562,1754,1808,97,3529,1741,1788,97.4
11160, 강서구,075003, 72세,2016,3424,1679,1745,96.2,3399,1671,1728,96.7
11160, 강서구,075004, 73세,2016,3296,1548,1748,88.6,3271,1538,1733,88.7
11160, 강서구,075005, 74세,2016,3711,1757,1954,89.9,3689,1749,1940,90.2
11160, 강서구,080,75~79세,2016,12316,5142,7174,71.7,12241,5121,7120,71.9
11160, 강서구,080001, 75세,2016,2938,1305,1633,79.9,2926,1300,1626,80
11160, 강서구,080002, 76세,2016,2708,1194,1514,78.9,2690,1187,1503,79
11160, 강서구,080003, 77세,2016,2569,1036,1533,67.6,2552,1032,1520,67.9
11160, 강서구,080004, 78세,2016,2169,890,1279,69.6,2151,889,1262,70.4
11160, 강서구,080005, 79세,2016,1932,717,1215,59,1922,713,1209,59
11160, 강서구,085,80~84세,2016,7208,2474,4734,52.3,7165,2459,4706,52.3
11160, 강서구,085001, 80세,2016,1712,623,1089,57.2,1702,619,1083,57.2
11160, 강서구,085002, 81세,2016,1750,631,1119,56.4,1742,626,1116,56.1
11160, 강서구,085003, 82세,2016,1398,470,928,50.6,1386,467,919,50.8
11160, 강서구,085004, 83세,2016,1232,409,823,49.7,1225,406,819,49.6
11160, 강서구,085005, 84세,2016,1116,341,775,44,1110,341,769,44.3
11160, 강서구,090,85~89세,2016,3579,953,2626,36.3,3563,949,2614,36.3
11160, 강서구,090001, 85세,2016,870,261,609,42.9,864,258,606,42.6
11160, 강서구,090002, 86세,2016,882,230,652,35.3,878,229,649,35.3
11160, 강서구,090003, 87세,2016,730,198,532,37.2,726,198,528,37.5
11160, 강서구,090004, 88세,2016,594,145,449,32.3,594,145,449,32.3
11160, 강서구,090005, 89세,2016,503,119,384,31,501,119,382,31.2
11160, 강서구,095,90~94세,2016,1227,299,928,32.2,1217,295,922,32
11160, 강서구,095001, 90세,2016,347,77,270,28.5,344,76,268,28.4
11160, 강서구,095002, 91세,2016,303,72,231,31.2,303,72,231,31.2
11160, 강서구,095003, 92세,2016,233,71,162,43.8,230,70,160,43.8
11160, 강서구,095004, 93세,2016,179,42,137,30.7,179,42,137,30.7
11160, 강서구,095005, 94세,2016,165,37,128,28.9,161,35,126,27.8
11160, 강서구,100,95~99세,2016,274,72,202,35.6,274,72,202,35.6
11160, 강서구,100001, 95세,2016,97,21,76,27.6,97,21,76,27.6
11160, 강서구,100002, 96세,2016,73,22,51,43.1,73,22,51,43.1
11160, 강서구,100003, 97세,2016,54,12,42,28.6,54,12,42,28.6
11160, 강서구,100004, 98세,2016,30,9,21,42.9,30,9,21,42.9
11160, 강서구,100005, 99세,2016,20,8,12,66.7,20,8,12,66.7
11160, 강서구,101,100세이상,2016,37,6,31,19.4,37,6,31,19.4
11160, 강서구,102,15세미만,2016,71894,36769,35125,104.7,71487,36552,34935,104.6
11160, 강서구,103,15~64세,2016,433970,212623,221347,96.1,426593,209006,217587,96.1
11160, 강서구,104,65세이상,2016,68423,30129,38294,78.7,67888,29924,37964,78.8
11160, 강서구,086,85세이상,2016,5117,1330,3787,35.1,5091,1322,3769,35.1
11160, 강서구,126,평균연령,2016,40.5,39.6,41.4,,40.5,39.6,41.3,
11160, 강서구,127,중위연령,2016,40.3,39.4,41.2,,40.2,39.3,41.2,
11170, 구로구,000,합계,2016,442165,221227,220938,100.1,401635,199362,202273,98.6
11170, 구로구,005,0~4세,2016,19802,10057,9745,103.2,18836,9551,9285,102.9
11170, 구로구,005001, 0세,2016,3883,2014,1869,107.8,3678,1905,1773,107.4
11170, 구로구,005002, 1세,2016,4024,2000,2024,98.8,3834,1900,1934,98.2
11170, 구로구,005003, 2세,2016,3892,2001,1891,105.8,3706,1905,1801,105.8
11170, 구로구,005004, 3세,2016,4003,2020,1983,101.9,3789,1907,1882,101.3
11170, 구로구,005005, 4세,2016,4000,2022,1978,102.2,3829,1934,1895,102.1
11170, 구로구,010,5~9세,2016,17605,8899,8706,102.2,17064,8622,8442,102.1
11170, 구로구,010001, 5세,2016,3811,1938,1873,103.5,3681,1868,1813,103
11170, 구로구,010002, 6세,2016,3665,1860,1805,103,3548,1802,1746,103.2
11170, 구로구,010003, 7세,2016,3320,1674,1646,101.7,3220,1627,1593,102.1
11170, 구로구,010004, 8세,2016,3418,1736,1682,103.2,3325,1681,1644,102.3
11170, 구로구,010005, 9세,2016,3391,1691,1700,99.5,3290,1644,1646,99.9
11170, 구로구,015,10~14세,2016,14977,7804,7173,108.8,14735,7679,7056,108.8
11170, 구로구,015001, 10세,2016,3084,1623,1461,111.1,3018,1596,1422,112.2
11170, 구로구,015002, 11세,2016,2805,1498,1307,114.6,2757,1469,1288,114.1
11170, 구로구,015003, 12세,2016,2984,1548,1436,107.8,2937,1525,1412,108
11170, 구로구,015004, 13세,2016,2953,1494,1459,102.4,2912,1474,1438,102.5
11170, 구로구,015005, 14세,2016,3151,1641,1510,108.7,3111,1615,1496,108
11170, 구로구,020,15~19세,2016,19887,10487,9400,111.6,19536,10305,9231,111.6
11170, 구로구,020001, 15세,2016,3593,1949,1644,118.6,3546,1920,1626,118.1
11170, 구로구,020002, 16세,2016,4106,2201,1905,115.5,4040,2163,1877,115.2
11170, 구로구,020003, 17세,2016,3865,2032,1833,110.9,3810,2002,1808,110.7
11170, 구로구,020004, 18세,2016,4137,2189,1948,112.4,4049,2143,1906,112.4
11170, 구로구,020005, 19세,2016,4186,2116,2070,102.2,4091,2077,2014,103.1
11170, 구로구,025,20~24세,2016,25987,12973,13014,99.7,24762,12439,12323,100.9
11170, 구로구,025001, 20세,2016,4496,2308,2188,105.5,4355,2246,2109,106.5
11170, 구로구,025002, 21세,2016,4798,2464,2334,105.6,4626,2395,2231,107.4
11170, 구로구,025003, 22세,2016,5260,2721,2539,107.2,5037,2625,2412,108.8
11170, 구로구,025004, 23세,2016,5479,2662,2817,94.5,5196,2543,2653,95.9
11170, 구로구,025005, 24세,2016,5954,2818,3136,89.9,5548,2630,2918,90.1
11170, 구로구,030,25~29세,2016,32312,15784,16528,95.5,28497,13809,14688,94
11170, 구로구,030001, 25세,2016,6027,2894,3133,92.4,5485,2607,2878,90.6
11170, 구로구,030002, 26세,2016,6363,3108,3255,95.5,5629,2725,2904,93.8
11170, 구로구,030003, 27세,2016,6378,3144,3234,97.2,5613,2741,2872,95.4
11170, 구로구,030004, 28세,2016,6574,3233,3341,96.8,5715,2778,2937,94.6
11170, 구로구,030005, 29세,2016,6970,3405,3565,95.5,6055,2958,3097,95.5
11170, 구로구,035,30~34세,2016,37970,19347,18623,103.9,34180,17304,16876,102.5
11170, 구로구,035001, 30세,2016,6939,3488,3451,101.1,6055,3023,3032,99.7
11170, 구로구,035002, 31세,2016,7080,3569,3511,101.7,6340,3179,3161,100.6
11170, 구로구,035003, 32세,2016,7299,3691,3608,102.3,6622,3333,3289,101.3
11170, 구로구,035004, 33세,2016,8056,4129,3927,105.1,7334,3742,3592,104.2
11170, 구로구,035005, 34세,2016,8596,4470,4126,108.3,7829,4027,3802,105.9
11170, 구로구,040,35~39세,2016,38933,20366,18567,109.7,36096,18634,17462,106.7
11170, 구로구,040001, 35세,2016,8353,4296,4057,105.9,7836,3998,3838,104.2
11170, 구로구,040002, 36세,2016,8380,4378,4002,109.4,7784,4013,3771,106.4
11170, 구로구,040003, 37세,2016,7944,4142,3802,108.9,7352,3759,3593,104.6
11170, 구로구,040004, 38세,2016,7058,3725,3333,111.8,6459,3381,3078,109.8
11170, 구로구,040005, 39세,2016,7198,3825,3373,113.4,6665,3483,3182,109.5
11170, 구로구,045,40~44세,2016,36214,19360,16854,114.9,32824,17234,15590,110.5
11170, 구로구,045001, 40세,2016,6957,3713,3244,114.5,6387,3341,3046,109.7
11170, 구로구,045002, 41세,2016,6827,3627,3200,113.3,6275,3276,2999,109.2
11170, 구로구,045003, 42세,2016,7490,3993,3497,114.2,6835,3577,3258,109.8
11170, 구로구,045004, 43세,2016,7589,4062,3527,115.2,6805,3571,3234,110.4
11170, 구로구,045005, 44세,2016,7351,3965,3386,117.1,6522,3469,3053,113.6
11170, 구로구,050,45~49세,2016,36434,18590,17844,104.2,31656,15880,15776,100.7
11170, 구로구,050001, 45세,2016,7631,3974,3657,108.7,6742,3483,3259,106.9
11170, 구로구,050002, 46세,2016,7454,3828,3626,105.6,6428,3259,3169,102.8
11170, 구로구,050003, 47세,2016,7435,3833,3602,106.4,6418,3224,3194,100.9
11170, 구로구,050004, 48세,2016,7171,3526,3645,96.7,6164,2962,3202,92.5
11170, 구로구,050005, 49세,2016,6743,3429,3314,103.5,5904,2952,2952,100
11170, 구로구,055,50~54세,2016,36477,18307,18170,100.8,30096,14881,15215,97.8
11170, 구로구,055001, 50세,2016,6804,3466,3338,103.8,5730,2845,2885,98.6
11170, 구로구,055002, 51세,2016,7361,3719,3642,102.1,6099,3047,3052,99.8
11170, 구로구,055003, 52세,2016,7054,3536,3518,100.5,5786,2867,2919,98.2
11170, 구로구,055004, 53세,2016,7595,3758,3837,97.9,6054,2956,3098,95.4
11170, 구로구,055005, 54세,2016,7663,3828,3835,99.8,6427,3166,3261,97.1
11170, 구로구,060,55~59세,2016,38136,18420,19716,93.4,33015,15701,17314,90.7
11170, 구로구,060001, 55세,2016,7685,3721,3964,93.9,6925,3341,3584,93.2
11170, 구로구,060002, 56세,2016,8337,3977,4360,91.2,7101,3316,3785,87.6
11170, 구로구,060003, 57세,2016,7423,3571,3852,92.7,6478,3047,3431,88.8
11170, 구로구,060004, 58세,2016,7319,3607,3712,97.2,6246,3044,3202,95.1
11170, 구로구,060005, 59세,2016,7372,3544,3828,92.6,6265,2953,3312,89.2
11170, 구로구,065,60~64세,2016,31158,15014,16144,93,26907,12740,14167,89.9
11170, 구로구,065001, 60세,2016,6839,3254,3585,90.8,5875,2747,3128,87.8
11170, 구로구,065002, 61세,2016,7125,3488,3637,95.9,6118,2929,3189,91.8
11170, 구로구,065003, 62세,2016,6141,2916,3225,90.4,5206,2441,2765,88.3
11170, 구로구,065004, 63세,2016,5569,2696,2873,93.8,4805,2274,2531,89.8
11170, 구로구,065005, 64세,2016,5484,2660,2824,94.2,4903,2349,2554,92
11170, 구로구,070,65~69세,2016,21942,10834,11108,97.5,20211,9957,10254,97.1
11170, 구로구,070001, 65세,2016,4220,2073,2147,96.6,3702,1802,1900,94.8
11170, 구로구,070002, 66세,2016,4658,2272,2386,95.2,4229,2044,2185,93.5
11170, 구로구,070003, 67세,2016,4574,2232,2342,95.3,4208,2056,2152,95.5
11170, 구로구,070004, 68세,2016,4196,2102,2094,100.4,3968,1995,1973,101.1
11170, 구로구,070005, 69세,2016,4294,2155,2139,100.7,4104,2060,2044,100.8
11170, 구로구,075,70~74세,2016,15305,7414,7891,94,14787,7208,7579,95.1
11170, 구로구,075001, 70세,2016,3180,1552,1628,95.3,3035,1479,1556,95.1
11170, 구로구,075002, 71세,2016,3020,1485,1535,96.7,2912,1445,1467,98.5
11170, 구로구,075003, 72세,2016,2904,1416,1488,95.2,2814,1378,1436,96
11170, 구로구,075004, 73세,2016,2903,1395,1508,92.5,2817,1371,1446,94.8
11170, 구로구,075005, 74세,2016,3298,1566,1732,90.4,3209,1535,1674,91.7
11170, 구로구,080,75~79세,2016,10393,4698,5695,82.5,10078,4610,5468,84.3
11170, 구로구,080001, 75세,2016,2496,1213,1283,94.5,2432,1196,1236,96.8
11170, 구로구,080002, 76세,2016,2233,988,1245,79.4,2151,970,1181,82.1
11170, 구로구,080003, 77세,2016,2141,958,1183,81,2079,934,1145,81.6
11170, 구로구,080004, 78세,2016,1927,846,1081,78.3,1867,827,1040,79.5
11170, 구로구,080005, 79세,2016,1596,693,903,76.7,1549,683,866,78.9
11170, 구로구,085,80~84세,2016,5452,2047,3405,60.1,5284,2006,3278,61.2
11170, 구로구,085001, 80세,2016,1415,583,832,70.1,1364,568,796,71.4
11170, 구로구,085002, 81세,2016,1337,505,832,60.7,1300,495,805,61.5
11170, 구로구,085003, 82세,2016,1071,375,696,53.9,1043,370,673,55
11170, 구로구,085004, 83세,2016,907,335,572,58.6,882,329,553,59.5
11170, 구로구,085005, 84세,2016,722,249,473,52.6,695,244,451,54.1
11170, 구로구,090,85~89세,2016,2275,642,1633,39.3,2196,627,1569,40
11170, 구로구,090001, 85세,2016,580,186,394,47.2,559,181,378,47.9
11170, 구로구,090002, 86세,2016,574,163,411,39.7,554,161,393,41
11170, 구로구,090003, 87세,2016,458,134,324,41.4,443,132,311,42.4
11170, 구로구,090004, 88세,2016,367,92,275,33.5,353,87,266,32.7
11170, 구로구,090005, 89세,2016,296,67,229,29.3,287,66,221,29.9
11170, 구로구,095,90~94세,2016,723,151,572,26.4,696,143,553,25.9
11170, 구로구,095001, 90세,2016,235,50,185,27,225,47,178,26.4
11170, 구로구,095002, 91세,2016,163,24,139,17.3,160,23,137,16.8
11170, 구로구,095003, 92세,2016,121,29,92,31.5,115,28,87,32.2
11170, 구로구,095004, 93세,2016,116,29,87,33.3,111,27,84,32.1
11170, 구로구,095005, 94세,2016,88,19,69,27.5,85,18,67,26.9
11170, 구로구,100,95~99세,2016,163,32,131,24.4,159,31,128,24.2
11170, 구로구,100001, 95세,2016,63,11,52,21.2,60,10,50,20
11170, 구로구,100002, 96세,2016,50,13,37,35.1,49,13,36,36.1
11170, 구로구,100003, 97세,2016,23,X,19,21.1,23,X,19,21.1
11170, 구로구,100004, 98세,2016,20,X,18,11.1,20,X,18,11.1
11170, 구로구,100005, 99세,2016,7,X,5,40,7,X,5,40
11170, 구로구,101,100세이상,2016,20,X,19,5.3,20,X,19,5.3
11170, 구로구,102,15세미만,2016,52384,26760,25624,104.4,50635,25852,24783,104.3
11170, 구로구,103,15~64세,2016,333508,168648,164860,102.3,297569,148927,148642,100.2
11170, 구로구,104,65세이상,2016,56273,25819,30454,84.8,53431,24583,28848,85.2
11170, 구로구,086,85세이상,2016,3181,826,2355,35.1,3071,802,2269,35.3
11170, 구로구,126,평균연령,2016,41.5,40.8,42.1,,41.1,40.3,41.8,
11170, 구로구,127,중위연령,2016,42,41.3,42.6,,41.1,40.4,41.9,
11180, 금천구,000,합계,2016,247819,126271,121548,103.9,222790,112892,109898,102.7
11180, 금천구,005,0~4세,2016,8682,4422,4260,103.8,8048,4096,3952,103.6
11180, 금천구,005001, 0세,2016,1718,880,838,105,1578,801,777,103.1
11180, 금천구,005002, 1세,2016,1875,954,921,103.6,1741,881,860,102.4
11180, 금천구,005003, 2세,2016,1686,871,815,106.9,1565,810,755,107.3
11180, 금천구,005004, 3세,2016,1599,798,801,99.6,1483,743,740,100.4
11180, 금천구,005005, 4세,2016,1804,919,885,103.8,1681,861,820,105
11180, 금천구,010,5~9세,2016,7546,3848,3698,104.1,7232,3690,3542,104.2
11180, 금천구,010001, 5세,2016,1611,808,803,100.6,1511,764,747,102.3
11180, 금천구,010002, 6세,2016,1528,809,719,112.5,1449,767,682,112.5
11180, 금천구,010003, 7세,2016,1430,725,705,102.8,1371,695,676,102.8
11180, 금천구,010004, 8세,2016,1450,752,698,107.7,1409,731,678,107.8
11180, 금천구,010005, 9세,2016,1527,754,773,97.5,1492,733,759,96.6
11180, 금천구,015,10~14세,2016,7686,3916,3770,103.9,7582,3858,3724,103.6
11180, 금천구,015001, 10세,2016,1444,712,732,97.3,1414,697,717,97.2
11180, 금천구,015002, 11세,2016,1458,743,715,103.9,1429,724,705,102.7
11180, 금천구,015003, 12세,2016,1509,772,737,104.7,1490,763,727,105
11180, 금천구,015004, 13세,2016,1583,803,780,102.9,1572,797,775,102.8
11180, 금천구,015005, 14세,2016,1692,886,806,109.9,1677,877,800,109.6
11180, 금천구,020,15~19세,2016,11237,5661,5576,101.5,11070,5580,5490,101.6
11180, 금천구,020001, 15세,2016,1953,956,997,95.9,1933,946,987,95.8
11180, 금천구,020002, 16세,2016,2184,1075,1109,96.9,2155,1061,1094,97
11180, 금천구,020003, 17세,2016,2295,1192,1103,108.1,2261,1173,1088,107.8
11180, 금천구,020004, 18세,2016,2404,1225,1179,103.9,2367,1210,1157,104.6
11180, 금천구,020005, 19세,2016,2401,1213,1188,102.1,2354,1190,1164,102.2
11180, 금천구,025,20~24세,2016,15606,8058,7548,106.8,14907,7727,7180,107.6
11180, 금천구,025001, 20세,2016,2667,1415,1252,113,2602,1382,1220,113.3
11180, 금천구,025002, 21세,2016,2792,1518,1274,119.2,2719,1490,1229,121.2
11180, 금천구,025003, 22세,2016,3181,1635,1546,105.8,3038,1564,1474,106.1
11180, 금천구,025004, 23세,2016,3358,1696,1662,102,3183,1612,1571,102.6
11180, 금천구,025005, 24세,2016,3608,1794,1814,98.9,3365,1679,1686,99.6
11180, 금천구,030,25~29세,2016,19851,10505,9346,112.4,17560,9328,8232,113.3
11180, 금천구,030001, 25세,2016,3875,1970,1905,103.4,3567,1802,1765,102.1
11180, 금천구,030002, 26세,2016,3989,2068,1921,107.7,3514,1822,1692,107.7
11180, 금천구,030003, 27세,2016,3971,2096,1875,111.8,3501,1866,1635,114.1
11180, 금천구,030004, 28세,2016,3917,2164,1753,123.4,3390,1891,1499,126.2
11180, 금천구,030005, 29세,2016,4099,2207,1892,116.6,3588,1947,1641,118.6
11180, 금천구,035,30~34세,2016,20382,11240,9142,122.9,18043,9951,8092,123
11180, 금천구,035001, 30세,2016,4060,2264,1796,126.1,3509,1974,1535,128.6
11180, 금천구,035002, 31세,2016,3869,2131,1738,122.6,3418,1876,1542,121.7
11180, 금천구,035003, 32세,2016,4062,2262,1800,125.7,3583,1996,1587,125.8
11180, 금천구,035004, 33세,2016,4120,2242,1878,119.4,3689,2006,1683,119.2
11180, 금천구,035005, 34세,2016,4271,2341,1930,121.3,3844,2099,1745,120.3
11180, 금천구,040,35~39세,2016,18749,10292,8457,121.7,16929,9204,7725,119.1
11180, 금천구,040001, 35세,2016,4061,2223,1838,120.9,3701,2024,1677,120.7
11180, 금천구,040002, 36세,2016,4024,2224,1800,123.6,3657,1996,1661,120.2
11180, 금천구,040003, 37세,2016,3789,2046,1743,117.4,3416,1822,1594,114.3
11180, 금천구,040004, 38세,2016,3438,1860,1578,117.9,3045,1629,1416,115
11180, 금천구,040005, 39세,2016,3437,1939,1498,129.4,3110,1733,1377,125.9
11180, 금천구,045,40~44세,2016,18973,10091,8882,113.6,16813,8775,8038,109.2
11180, 금천구,045001, 40세,2016,3398,1800,1598,112.6,3036,1571,1465,107.2
11180, 금천구,045002, 41세,2016,3544,1870,1674,111.7,3172,1646,1526,107.9
11180, 금천구,045003, 42세,2016,3895,2102,1793,117.2,3482,1849,1633,113.2
11180, 금천구,045004, 43세,2016,4075,2179,1896,114.9,3560,1854,1706,108.7
11180, 금천구,045005, 44세,2016,4061,2140,1921,111.4,3563,1855,1708,108.6
11180, 금천구,050,45~49세,2016,22212,11302,10910,103.6,19028,9547,9481,100.7
11180, 금천구,050001, 45세,2016,4436,2326,2110,110.2,3802,1960,1842,106.4
11180, 금천구,050002, 46세,2016,4426,2289,2137,107.1,3801,1937,1864,103.9
11180, 금천구,050003, 47세,2016,4476,2296,2180,105.3,3824,1951,1873,104.2
11180, 금천구,050004, 48세,2016,4659,2355,2304,102.2,3955,1961,1994,98.3
11180, 금천구,050005, 49세,2016,4215,2036,2179,93.4,3646,1738,1908,91.1
11180, 금천구,055,50~54세,2016,23649,12060,11589,104.1,19632,9908,9724,101.9
11180, 금천구,055001, 50세,2016,4499,2328,2171,107.2,3818,1950,1868,104.4
11180, 금천구,055002, 51세,2016,4739,2353,2386,98.6,3965,1937,2028,95.5
11180, 금천구,055003, 52세,2016,4600,2356,2244,105,3809,1932,1877,102.9
11180, 금천구,055004, 53세,2016,4941,2525,2416,104.5,3963,2022,1941,104.2
11180, 금천구,055005, 54세,2016,4870,2498,2372,105.3,4077,2067,2010,102.8
11180, 금천구,060,55~59세,2016,23131,11496,11635,98.8,20076,9922,10154,97.7
11180, 금천구,060001, 55세,2016,4831,2361,2470,95.6,4388,2136,2252,94.8
11180, 금천구,060002, 56세,2016,5173,2610,2563,101.8,4395,2197,2198,100
11180, 금천구,060003, 57세,2016,4604,2275,2329,97.7,4041,1965,2076,94.7
11180, 금천구,060004, 58세,2016,4362,2169,2193,98.9,3755,1883,1872,100.6
11180, 금천구,060005, 59세,2016,4161,2081,2080,100,3497,1741,1756,99.1
11180, 금천구,065,60~64세,2016,18080,8920,9160,97.4,15480,7536,7944,94.9
11180, 금천구,065001, 60세,2016,4126,2090,2036,102.7,3522,1764,1758,100.3
11180, 금천구,065002, 61세,2016,4151,2014,2137,94.2,3515,1669,1846,90.4
11180, 금천구,065003, 62세,2016,3628,1786,1842,97,3049,1470,1579,93.1
11180, 금천구,065004, 63세,2016,2992,1448,1544,93.8,2563,1234,1329,92.9
11180, 금천구,065005, 64세,2016,3183,1582,1601,98.8,2831,1399,1432,97.7
11180, 금천구,070,65~69세,2016,12320,6014,6306,95.4,11310,5527,5783,95.6
11180, 금천구,070001, 65세,2016,2455,1244,1211,102.7,2161,1089,1072,101.6
11180, 금천구,070002, 66세,2016,2651,1294,1357,95.4,2415,1186,1229,96.5
11180, 금천구,070003, 67세,2016,2557,1218,1339,91,2322,1098,1224,89.7
11180, 금천구,070004, 68세,2016,2261,1107,1154,95.9,2130,1052,1078,97.6
11180, 금천구,070005, 69세,2016,2396,1151,1245,92.4,2282,1102,1180,93.4
11180, 금천구,075,70~74세,2016,8809,4202,4607,91.2,8517,4079,4438,91.9
11180, 금천구,075001, 70세,2016,1779,847,932,90.9,1702,808,894,90.4
11180, 금천구,075002, 71세,2016,1795,858,937,91.6,1732,831,901,92.2
11180, 금천구,075003, 72세,2016,1670,773,897,86.2,1628,759,869,87.3
11180, 금천구,075004, 73세,2016,1678,831,847,98.1,1618,810,808,100.2
11180, 금천구,075005, 74세,2016,1887,893,994,89.8,1837,871,966,90.2
11180, 금천구,080,75~79세,2016,5958,2644,3314,79.8,5751,2590,3161,81.9
11180, 금천구,080001, 75세,2016,1481,674,807,83.5,1436,664,772,86
11180, 금천구,080002, 76세,2016,1285,575,710,81,1239,564,675,83.6
11180, 금천구,080003, 77세,2016,1255,570,685,83.2,1205,554,651,85.1
11180, 금천구,080004, 78세,2016,1057,459,598,76.8,1019,449,570,78.8
11180, 금천구,080005, 79세,2016,880,366,514,71.2,852,359,493,72.8
11180, 금천구,085,80~84세,2016,3094,1146,1948,58.8,3002,1125,1877,59.9
11180, 금천구,085001, 80세,2016,797,329,468,70.3,775,323,452,71.5
11180, 금천구,085002, 81세,2016,743,267,476,56.1,722,261,461,56.6
11180, 금천구,085003, 82세,2016,596,219,377,58.1,575,215,360,59.7
11180, 금천구,085004, 83세,2016,500,172,328,52.4,484,168,316,53.2
11180, 금천구,085005, 84세,2016,458,159,299,53.2,446,158,288,54.9
11180, 금천구,090,85~89세,2016,1320,341,979,34.8,1290,337,953,35.4
11180, 금천구,090001, 85세,2016,347,119,228,52.2,340,117,223,52.5
11180, 금천구,090002, 86세,2016,309,83,226,36.7,299,82,217,37.8
11180, 금천구,090003, 87세,2016,245,55,190,28.9,240,55,185,29.7
11180, 금천구,090004, 88세,2016,231,51,180,28.3,227,51,176,29
11180, 금천구,090005, 89세,2016,188,33,155,21.3,184,32,152,21.1
11180, 금천구,095,90~94세,2016,421,93,328,28.4,409,92,317,29
11180, 금천구,095001, 90세,2016,108,21,87,24.1,103,21,82,25.6
11180, 금천구,095002, 91세,2016,104,19,85,22.4,102,19,83,22.9
11180, 금천구,095003, 92세,2016,80,18,62,29,77,17,60,28.3
11180, 금천구,095004, 93세,2016,72,24,48,50,72,24,48,50
11180, 금천구,095005, 94세,2016,57,11,46,23.9,55,11,44,25
11180, 금천구,100,95~99세,2016,98,18,80,22.5,97,18,79,22.8
11180, 금천구,100001, 95세,2016,31,5,26,19.2,30,5,25,20
11180, 금천구,100002, 96세,2016,32,7,25,28,32,7,25,28
11180, 금천구,100003, 97세,2016,17,X,14,21.4,17,X,14,21.4
11180, 금천구,100004, 98세,2016,11,X,9,22.2,11,X,9,22.2
11180, 금천구,100005, 99세,2016,7,X,6,16.7,7,X,6,16.7
11180, 금천구,101,100세이상,2016,15,X,13,15.4,14,X,12,16.7
11180, 금천구,102,15세미만,2016,23914,12186,11728,103.9,22862,11644,11218,103.8
11180, 금천구,103,15~64세,2016,191870,99625,92245,108,169538,87478,82060,106.6
11180, 금천구,104,65세이상,2016,32035,14460,17575,82.3,30390,13770,16620,82.9
11180, 금천구,086,85세이상,2016,1854,454,1400,32.4,1810,449,1361,33
11180, 금천구,126,평균연령,2016,42.6,41.8,43.4,,42.2,41.4,43.1,
11180, 금천구,127,중위연령,2016,43.8,42.7,45,,43.1,41.9,44.4,
11190, 영등포구,000,합계,2016,398120,199142,198978,100.1,350363,173997,176366,98.7
11190, 영등포구,005,0~4세,2016,16156,8254,7902,104.5,14948,7628,7320,104.2
11190, 영등포구,005001, 0세,2016,3461,1782,1679,106.1,3163,1614,1549,104.2
11190, 영등포구,005002, 1세,2016,3392,1759,1633,107.7,3155,1632,1523,107.2
11190, 영등포구,005003, 2세,2016,3192,1603,1589,100.9,2963,1495,1468,101.8
11190, 영등포구,005004, 3세,2016,2990,1561,1429,109.2,2765,1448,1317,109.9
11190, 영등포구,005005, 4세,2016,3121,1549,1572,98.5,2902,1439,1463,98.4
11190, 영등포구,010,5~9세,2016,13302,6791,6511,104.3,12643,6469,6174,104.8
11190, 영등포구,010001, 5세,2016,2898,1435,1463,98.1,2731,1352,1379,98
11190, 영등포구,010002, 6세,2016,2635,1317,1318,99.9,2496,1252,1244,100.6
11190, 영등포구,010003, 7세,2016,2482,1282,1200,106.8,2344,1216,1128,107.8
11190, 영등포구,010004, 8세,2016,2637,1356,1281,105.9,2520,1296,1224,105.9
11190, 영등포구,010005, 9세,2016,2650,1401,1249,112.2,2552,1353,1199,112.8
11190, 영등포구,015,10~14세,2016,12028,6412,5616,114.2,11668,6203,5465,113.5
11190, 영등포구,015001, 10세,2016,2438,1281,1157,110.7,2349,1232,1117,110.3
11190, 영등포구,015002, 11세,2016,2290,1198,1092,109.7,2200,1148,1052,109.1
11190, 영등포구,015003, 12세,2016,2461,1332,1129,118,2384,1284,1100,116.7
11190, 영등포구,015004, 13세,2016,2361,1286,1075,119.6,2310,1255,1055,119
11190, 영등포구,015005, 14세,2016,2478,1315,1163,113.1,2425,1284,1141,112.5
11190, 영등포구,020,15~19세,2016,15713,8130,7583,107.2,15318,7935,7383,107.5
11190, 영등포구,020001, 15세,2016,2829,1442,1387,104,2769,1408,1361,103.5
11190, 영등포구,020002, 16세,2016,2998,1541,1457,105.8,2930,1506,1424,105.8
11190, 영등포구,020003, 17세,2016,3135,1698,1437,118.2,3056,1658,1398,118.6
11190, 영등포구,020004, 18세,2016,3310,1678,1632,102.8,3228,1639,1589,103.1
11190, 영등포구,020005, 19세,2016,3441,1771,1670,106,3335,1724,1611,107
11190, 영등포구,025,20~24세,2016,22939,11097,11842,93.7,21669,10525,11144,94.4
11190, 영등포구,025001, 20세,2016,3728,1884,1844,102.2,3594,1825,1769,103.2
11190, 영등포구,025002, 21세,2016,4230,2133,2097,101.7,4067,2070,1997,103.7
11190, 영등포구,025003, 22세,2016,4419,2204,2215,99.5,4173,2099,2074,101.2
11190, 영등포구,025004, 23세,2016,5032,2357,2675,88.1,4709,2210,2499,88.4
11190, 영등포구,025005, 24세,2016,5530,2519,3011,83.7,5126,2321,2805,82.7
11190, 영등포구,030,25~29세,2016,33492,16165,17327,93.3,28865,13776,15089,91.3
11190, 영등포구,030001, 25세,2016,6189,2781,3408,81.6,5489,2456,3033,81
11190, 영등포구,030002, 26세,2016,6267,2983,3284,90.8,5416,2568,2848,90.2
11190, 영등포구,030003, 27세,2016,6834,3425,3409,100.5,5885,2907,2978,97.6
11190, 영등포구,030004, 28세,2016,6982,3439,3543,97.1,5953,2893,3060,94.5
11190, 영등포구,030005, 29세,2016,7220,3537,3683,96,6122,2952,3170,93.1
11190, 영등포구,035,30~34세,2016,37263,19298,17965,107.4,32943,16920,16023,105.6
11190, 영등포구,035001, 30세,2016,7246,3644,3602,101.2,6228,3104,3124,99.4
11190, 영등포구,035002, 31세,2016,7277,3740,3537,105.7,6433,3288,3145,104.5
11190, 영등포구,035003, 32세,2016,7321,3878,3443,112.6,6511,3432,3079,111.5
11190, 영등포구,035004, 33세,2016,7509,3863,3646,106,6678,3390,3288,103.1
11190, 영등포구,035005, 34세,2016,7910,4173,3737,111.7,7093,3706,3387,109.4
11190, 영등포구,040,35~39세,2016,33991,17882,16109,111,30561,15822,14739,107.3
11190, 영등포구,040001, 35세,2016,7450,3970,3480,114.1,6760,3587,3173,113
11190, 영등포구,040002, 36세,2016,7286,3787,3499,108.2,6624,3389,3235,104.8
11190, 영등포구,040003, 37세,2016,6921,3611,3310,109.1,6155,3144,3011,104.4
11190, 영등포구,040004, 38세,2016,6069,3225,2844,113.4,5369,2801,2568,109.1
11190, 영등포구,040005, 39세,2016,6265,3289,2976,110.5,5653,2901,2752,105.4
11190, 영등포구,045,40~44세,2016,31486,16754,14732,113.7,27675,14439,13236,109.1
11190, 영등포구,045001, 40세,2016,5989,3134,2855,109.8,5349,2762,2587,106.8
11190, 영등포구,045002, 41세,2016,5888,3126,2762,113.2,5304,2769,2535,109.2
11190, 영등포구,045003, 42세,2016,6411,3463,2948,117.5,5651,2983,2668,111.8
11190, 영등포구,045004, 43세,2016,6573,3500,3073,113.9,5706,2954,2752,107.3
11190, 영등포구,045005, 44세,2016,6625,3531,3094,114.1,5665,2971,2694,110.3
11190, 영등포구,050,45~49세,2016,33813,17350,16463,105.4,28055,14267,13788,103.5
11190, 영등포구,050001, 45세,2016,7044,3654,3390,107.8,5970,3044,2926,104
11190, 영등포구,050002, 46세,2016,6915,3618,3297,109.7,5678,2964,2714,109.2
11190, 영등포구,050003, 47세,2016,6905,3509,3396,103.3,5728,2891,2837,101.9
11190, 영등포구,050004, 48세,2016,6766,3473,3293,105.5,5511,2805,2706,103.7
11190, 영등포구,050005, 49세,2016,6183,3096,3087,100.3,5168,2563,2605,98.4
11190, 영등포구,055,50~54세,2016,34334,17442,16892,103.3,26663,13523,13140,102.9
11190, 영등포구,055001, 50세,2016,6335,3242,3093,104.8,5075,2580,2495,103.4
11190, 영등포구,055002, 51세,2016,6803,3400,3403,99.9,5324,2659,2665,99.8
11190, 영등포구,055003, 52세,2016,6866,3482,3384,102.9,5290,2678,2612,102.5
11190, 영등포구,055004, 53세,2016,7230,3723,3507,106.2,5350,2757,2593,106.3
11190, 영등포구,055005, 54세,2016,7100,3595,3505,102.6,5624,2849,2775,102.7
11190, 영등포구,060,55~59세,2016,34695,16945,17750,95.5,28585,13856,14729,94.1
11190, 영등포구,060001, 55세,2016,6995,3378,3617,93.4,6043,2901,3142,92.3
11190, 영등포구,060002, 56세,2016,7637,3679,3958,93,6148,2922,3226,90.6
11190, 영등포구,060003, 57세,2016,6785,3324,3461,96,5597,2712,2885,94
11190, 영등포구,060004, 58세,2016,6699,3330,3369,98.8,5420,2688,2732,98.4
11190, 영등포구,060005, 59세,2016,6579,3234,3345,96.7,5377,2633,2744,96
11190, 영등포구,065,60~64세,2016,27558,13576,13982,97.1,22553,10940,11613,94.2
11190, 영등포구,065001, 60세,2016,6217,3105,3112,99.8,5027,2475,2552,97
11190, 영등포구,065002, 61세,2016,6336,3077,3259,94.4,5158,2458,2700,91
11190, 영등포구,065003, 62세,2016,5398,2676,2722,98.3,4371,2150,2221,96.8
11190, 영등포구,065004, 63세,2016,4674,2268,2406,94.3,3795,1815,1980,91.7
11190, 영등포구,065005, 64세,2016,4933,2450,2483,98.7,4202,2042,2160,94.5
11190, 영등포구,070,65~69세,2016,18856,9116,9740,93.6,17006,8177,8829,92.6
11190, 영등포구,070001, 65세,2016,3695,1799,1896,94.9,3119,1494,1625,91.9
11190, 영등포구,070002, 66세,2016,3989,1903,2086,91.2,3534,1664,1870,89
11190, 영등포구,070003, 67세,2016,3927,1920,2007,95.7,3530,1713,1817,94.3
11190, 영등포구,070004, 68세,2016,3684,1797,1887,95.2,3462,1698,1764,96.3
11190, 영등포구,070005, 69세,2016,3561,1697,1864,91,3361,1608,1753,91.7
11190, 영등포구,075,70~74세,2016,13658,6376,7282,87.6,13137,6169,6968,88.5
11190, 영등포구,075001, 70세,2016,2843,1378,1465,94.1,2683,1309,1374,95.3
11190, 영등포구,075002, 71세,2016,2649,1291,1358,95.1,2546,1241,1305,95.1
11190, 영등포구,075003, 72세,2016,2569,1178,1391,84.7,2480,1146,1334,85.9
11190, 영등포구,075004, 73세,2016,2560,1154,1406,82.1,2479,1120,1359,82.4
11190, 영등포구,075005, 74세,2016,3037,1375,1662,82.7,2949,1353,1596,84.8
11190, 영등포구,080,75~79세,2016,9897,4384,5513,79.5,9499,4260,5239,81.3
11190, 영등포구,080001, 75세,2016,2331,1030,1301,79.2,2233,1005,1228,81.8
11190, 영등포구,080002, 76세,2016,2076,912,1164,78.4,2001,883,1118,79
11190, 영등포구,080003, 77세,2016,2053,953,1100,86.6,1960,922,1038,88.8
11190, 영등포구,080004, 78세,2016,1801,806,995,81,1731,786,945,83.2
11190, 영등포구,080005, 79세,2016,1636,683,953,71.7,1574,664,910,73
11190, 영등포구,085,80~84세,2016,5691,2236,3455,64.7,5456,2182,3274,66.6
11190, 영등포구,085001, 80세,2016,1480,628,852,73.7,1416,613,803,76.3
11190, 영등포구,085002, 81세,2016,1384,594,790,75.2,1325,581,744,78.1
11190, 영등포구,085003, 82세,2016,1079,394,685,57.5,1044,388,656,59.1
11190, 영등포구,085004, 83세,2016,966,334,632,52.8,928,329,599,54.9
11190, 영등포구,085005, 84세,2016,782,286,496,57.7,743,271,472,57.4
11190, 영등포구,090,85~89세,2016,2292,680,1612,42.2,2193,661,1532,43.1
11190, 영등포구,090001, 85세,2016,606,197,409,48.2,571,191,380,50.3
11190, 영등포구,090002, 86세,2016,525,164,361,45.4,497,158,339,46.6
11190, 영등포구,090003, 87세,2016,476,125,351,35.6,463,122,341,35.8
11190, 영등포구,090004, 88세,2016,374,113,261,43.3,361,111,250,44.4
11190, 영등포구,090005, 89세,2016,311,81,230,35.2,301,79,222,35.6
11190, 영등포구,095,90~94세,2016,774,211,563,37.5,747,202,545,37.1
11190, 영등포구,095001, 90세,2016,215,53,162,32.7,208,51,157,32.5
11190, 영등포구,095002, 91세,2016,180,45,135,33.3,176,43,133,32.3
11190, 영등포구,095003, 92세,2016,153,46,107,43,148,45,103,43.7
11190, 영등포구,095004, 93세,2016,143,40,103,38.8,136,37,99,37.4
11190, 영등포구,095005, 94세,2016,83,27,56,48.2,79,26,53,49.1
11190, 영등포구,100,95~99세,2016,167,38,129,29.5,165,38,127,29.9
11190, 영등포구,100001, 95세,2016,68,18,50,36,68,18,50,36
11190, 영등포구,100002, 96세,2016,50,12,38,31.6,48,12,36,33.3
11190, 영등포구,100003, 97세,2016,22,X,18,22.2,22,X,18,22.2
11190, 영등포구,100004, 98세,2016,15,X,11,36.4,15,X,11,36.4
11190, 영등포구,100005, 99세,2016,12,X,12,0,12,X,12,0
11190, 영등포구,101,100세이상,2016,15,5,10,50,14,5,9,55.6
11190, 영등포구,102,15세미만,2016,41486,21457,20029,107.1,39259,20300,18959,107.1
11190, 영등포구,103,15~64세,2016,305284,154639,150645,102.7,262887,132003,130884,100.9
11190, 영등포구,104,65세이상,2016,51350,23046,28304,81.4,48217,21694,26523,81.8
11190, 영등포구,086,85세이상,2016,3248,934,2314,40.4,3119,906,2213,40.9
11190, 영등포구,126,평균연령,2016,42,41.4,42.7,,41.6,40.9,42.3,
11190, 영등포구,127,중위연령,2016,42.4,41.8,43,,41.2,40.6,41.9,
11200, 동작구,000,합계,2016,404076,197854,206222,95.9,388664,190563,198101,96.2
11200, 동작구,005,0~4세,2016,15787,8161,7626,107,15528,8040,7488,107.4
11200, 동작구,005001, 0세,2016,3232,1681,1551,108.4,3173,1655,1518,109
11200, 동작구,005002, 1세,2016,3355,1713,1642,104.3,3311,1697,1614,105.1
11200, 동작구,005003, 2세,2016,3017,1566,1451,107.9,2965,1540,1425,108.1
11200, 동작구,005004, 3세,2016,3030,1545,1485,104,2969,1519,1450,104.8
11200, 동작구,005005, 4세,2016,3153,1656,1497,110.6,3110,1629,1481,110
11200, 동작구,010,5~9세,2016,14477,7517,6960,108,14316,7430,6886,107.9
11200, 동작구,010001, 5세,2016,3077,1574,1503,104.7,3022,1544,1478,104.5
11200, 동작구,010002, 6세,2016,2920,1551,1369,113.3,2891,1535,1356,113.2
11200, 동작구,010003, 7세,2016,2788,1400,1388,100.9,2756,1384,1372,100.9
11200, 동작구,010004, 8세,2016,2791,1443,1348,107,2771,1432,1339,106.9
11200, 동작구,010005, 9세,2016,2901,1549,1352,114.6,2876,1535,1341,114.5
11200, 동작구,015,10~14세,2016,13549,7028,6521,107.8,13461,6986,6475,107.9
11200, 동작구,015001, 10세,2016,2627,1362,1265,107.7,2610,1353,1257,107.6
11200, 동작구,015002, 11세,2016,2594,1350,1244,108.5,2572,1340,1232,108.8
11200, 동작구,015003, 12세,2016,2756,1425,1331,107.1,2740,1418,1322,107.3
11200, 동작구,015004, 13세,2016,2768,1461,1307,111.8,2758,1456,1302,111.8
11200, 동작구,015005, 14세,2016,2804,1430,1374,104.1,2781,1419,1362,104.2
11200, 동작구,020,15~19세,2016,19485,9842,9643,102.1,19020,9658,9362,103.2
11200, 동작구,020001, 15세,2016,3081,1616,1465,110.3,3065,1607,1458,110.2
11200, 동작구,020002, 16세,2016,3255,1674,1581,105.9,3234,1659,1575,105.3
11200, 동작구,020003, 17세,2016,3409,1742,1667,104.5,3371,1720,1651,104.2
11200, 동작구,020004, 18세,2016,4190,2106,2084,101.1,4075,2061,2014,102.3
11200, 동작구,020005, 19세,2016,5550,2704,2846,95,5275,2611,2664,98
11200, 동작구,025,20~24세,2016,33006,16318,16688,97.8,30932,15600,15332,101.7
11200, 동작구,025001, 20세,2016,5833,2723,3110,87.6,5429,2607,2822,92.4
11200, 동작구,025002, 21세,2016,5967,2889,3078,93.9,5530,2731,2799,97.6
11200, 동작구,025003, 22세,2016,6577,3301,3276,100.8,6206,3179,3027,105
11200, 동작구,025004, 23세,2016,7154,3611,3543,101.9,6724,3461,3263,106.1
11200, 동작구,025005, 24세,2016,7475,3794,3681,103.1,7043,3622,3421,105.9
11200, 동작구,030,25~29세,2016,35980,18060,17920,100.8,33966,17119,16847,101.6
11200, 동작구,030001, 25세,2016,7378,3693,3685,100.2,6984,3514,3470,101.3
11200, 동작구,030002, 26세,2016,7371,3727,3644,102.3,6926,3535,3391,104.2
11200, 동작구,030003, 27세,2016,7112,3547,3565,99.5,6726,3368,3358,100.3
11200, 동작구,030004, 28세,2016,7087,3592,3495,102.8,6688,3388,3300,102.7
11200, 동작구,030005, 29세,2016,7032,3501,3531,99.2,6642,3314,3328,99.6
11200, 동작구,035,30~34세,2016,36106,18206,17900,101.7,34713,17447,17266,101
11200, 동작구,035001, 30세,2016,7162,3573,3589,99.6,6791,3364,3427,98.2
11200, 동작구,035002, 31세,2016,7044,3500,3544,98.8,6743,3352,3391,98.8
11200, 동작구,035003, 32세,2016,6870,3507,3363,104.3,6614,3361,3253,103.3
11200, 동작구,035004, 33세,2016,7391,3697,3694,100.1,7148,3569,3579,99.7
11200, 동작구,035005, 34세,2016,7639,3929,3710,105.9,7417,3801,3616,105.1
11200, 동작구,040,35~39세,2016,33657,17173,16484,104.2,32705,16618,16087,103.3
11200, 동작구,040001, 35세,2016,7318,3855,3463,111.3,7146,3750,3396,110.4
11200, 동작구,040002, 36세,2016,7337,3731,3606,103.5,7161,3632,3529,102.9
11200, 동작구,040003, 37세,2016,6867,3528,3339,105.7,6653,3409,3244,105.1
11200, 동작구,040004, 38세,2016,6055,3024,3031,99.8,5830,2889,2941,98.2
11200, 동작구,040005, 39세,2016,6080,3035,3045,99.7,5915,2938,2977,98.7
11200, 동작구,045,40~44세,2016,31133,16127,15006,107.5,30168,15577,14591,106.8
11200, 동작구,045001, 40세,2016,5984,3096,2888,107.2,5800,2988,2812,106.3
11200, 동작구,045002, 41세,2016,6081,3129,2952,106,5921,3034,2887,105.1
11200, 동작구,045003, 42세,2016,6511,3421,3090,110.7,6331,3317,3014,110.1
11200, 동작구,045004, 43세,2016,6247,3173,3074,103.2,6030,3062,2968,103.2
11200, 동작구,045005, 44세,2016,6310,3308,3002,110.2,6086,3176,2910,109.1
11200, 동작구,050,45~49세,2016,31205,15323,15882,96.5,29760,14611,15149,96.4
11200, 동작구,050001, 45세,2016,6661,3332,3329,100.1,6391,3200,3191,100.3
11200, 동작구,050002, 46세,2016,6319,3228,3091,104.4,6035,3090,2945,104.9
11200, 동작구,050003, 47세,2016,6389,3142,3247,96.8,6088,2988,3100,96.4
11200, 동작구,050004, 48세,2016,6154,2939,3215,91.4,5829,2770,3059,90.6
11200, 동작구,050005, 49세,2016,5682,2682,3000,89.4,5417,2563,2854,89.8
11200, 동작구,055,50~54세,2016,29693,14249,15444,92.3,27740,13303,14437,92.1
11200, 동작구,055001, 50세,2016,5538,2688,2850,94.3,5198,2529,2669,94.8
11200, 동작구,055002, 51세,2016,5871,2798,3073,91.1,5499,2615,2884,90.7
11200, 동작구,055003, 52세,2016,5883,2823,3060,92.3,5506,2652,2854,92.9
11200, 동작구,055004, 53세,2016,6165,2915,3250,89.7,5682,2678,3004,89.1
11200, 동작구,055005, 54세,2016,6236,3025,3211,94.2,5855,2829,3026,93.5
11200, 동작구,060,55~59세,2016,31595,14627,16968,86.2,29999,13875,16124,86.1
11200, 동작구,060001, 55세,2016,6450,2993,3457,86.6,6244,2900,3344,86.7
11200, 동작구,060002, 56세,2016,6873,3154,3719,84.8,6460,2967,3493,84.9
11200, 동작구,060003, 57세,2016,6239,2882,3357,85.9,5904,2736,3168,86.4
11200, 동작구,060004, 58세,2016,5973,2722,3251,83.7,5681,2577,3104,83
11200, 동작구,060005, 59세,2016,6060,2876,3184,90.3,5710,2695,3015,89.4
11200, 동작구,065,60~64세,2016,25150,11739,13411,87.5,23918,11146,12772,87.3
11200, 동작구,065001, 60세,2016,5493,2528,2965,85.3,5185,2379,2806,84.8
11200, 동작구,065002, 61세,2016,5870,2775,3095,89.7,5580,2626,2954,88.9
11200, 동작구,065003, 62세,2016,4844,2259,2585,87.4,4588,2133,2455,86.9
11200, 동작구,065004, 63세,2016,4375,2071,2304,89.9,4163,1972,2191,90
11200, 동작구,065005, 64세,2016,4568,2106,2462,85.5,4402,2036,2366,86.1
11200, 동작구,070,65~69세,2016,18875,8620,10255,84.1,18392,8398,9994,84
11200, 동작구,070001, 65세,2016,3531,1601,1930,83,3376,1524,1852,82.3
11200, 동작구,070002, 66세,2016,3853,1812,2041,88.8,3738,1760,1978,89
11200, 동작구,070003, 67세,2016,3908,1745,2163,80.7,3805,1692,2113,80.1
11200, 동작구,070004, 68세,2016,3799,1760,2039,86.3,3740,1737,2003,86.7
11200, 동작구,070005, 69세,2016,3784,1702,2082,81.7,3733,1685,2048,82.3
11200, 동작구,075,70~74세,2016,14709,6930,7779,89.1,14573,6870,7703,89.2
11200, 동작구,075001, 70세,2016,3048,1350,1698,79.5,3012,1330,1682,79.1
11200, 동작구,075002, 71세,2016,2890,1321,1569,84.2,2858,1302,1556,83.7
11200, 동작구,075003, 72세,2016,2775,1299,1476,88,2751,1293,1458,88.7
11200, 동작구,075004, 73세,2016,2790,1389,1401,99.1,2769,1379,1390,99.2
11200, 동작구,075005, 74세,2016,3206,1571,1635,96.1,3183,1566,1617,96.8
11200, 동작구,080,75~79세,2016,10473,4678,5795,80.7,10375,4657,5718,81.4
11200, 동작구,080001, 75세,2016,2531,1189,1342,88.6,2508,1184,1324,89.4
11200, 동작구,080002, 76세,2016,2279,1033,1246,82.9,2261,1031,1230,83.8
11200, 동작구,080003, 77세,2016,2140,963,1177,81.8,2125,959,1166,82.2
11200, 동작구,080004, 78세,2016,1835,795,1040,76.4,1814,790,1024,77.1
11200, 동작구,080005, 79세,2016,1688,698,990,70.5,1667,693,974,71.1
11200, 동작구,085,80~84세,2016,5740,2235,3505,63.8,5675,2220,3455,64.3
11200, 동작구,085001, 80세,2016,1472,605,867,69.8,1451,597,854,69.9
11200, 동작구,085002, 81세,2016,1346,541,805,67.2,1332,538,794,67.8
11200, 동작구,085003, 82세,2016,1171,471,700,67.3,1158,469,689,68.1
11200, 동작구,085004, 83세,2016,930,354,576,61.5,922,353,569,62
11200, 동작구,085005, 84세,2016,821,264,557,47.4,812,263,549,47.9
11200, 동작구,090,85~89세,2016,2426,758,1668,45.4,2411,751,1660,45.2
11200, 동작구,090001, 85세,2016,608,215,393,54.7,606,214,392,54.6
11200, 동작구,090002, 86세,2016,575,175,400,43.8,569,173,396,43.7
11200, 동작구,090003, 87세,2016,508,175,333,52.6,506,173,333,52
11200, 동작구,090004, 88세,2016,412,112,300,37.3,408,110,298,36.9
11200, 동작구,090005, 89세,2016,323,81,242,33.5,322,81,241,33.6
11200, 동작구,095,90~94세,2016,811,210,601,34.9,801,208,593,35.1
11200, 동작구,095001, 90세,2016,242,64,178,36,240,64,176,36.4
11200, 동작구,095002, 91세,2016,183,47,136,34.6,181,47,134,35.1
11200, 동작구,095003, 92세,2016,150,34,116,29.3,146,32,114,28.1
11200, 동작구,095004, 93세,2016,128,39,89,43.8,126,39,87,44.8
11200, 동작구,095005, 94세,2016,108,26,82,31.7,108,26,82,31.7
11200, 동작구,100,95~99세,2016,191,49,142,34.5,184,46,138,33.3
11200, 동작구,100001, 95세,2016,68,15,53,28.3,65,14,51,27.5
11200, 동작구,100002, 96세,2016,54,18,36,50,54,18,36,50
11200, 동작구,100003, 97세,2016,29,5,24,20.8,28,5,23,21.7
11200, 동작구,100004, 98세,2016,26,7,19,36.8,24,5,19,26.3
11200, 동작구,100005, 99세,2016,14,X,10,40,13,X,9,44.4
11200, 동작구,101,100세이상,2016,28,X,24,16.7,27,X,24,12.5
11200, 동작구,102,15세미만,2016,43813,22706,21107,107.6,43305,22456,20849,107.7
11200, 동작구,103,15~64세,2016,307010,151664,155346,97.6,292921,144954,147967,98
11200, 동작구,104,65세이상,2016,53253,23484,29769,78.9,52438,23153,29285,79.1
11200, 동작구,086,85세이상,2016,3456,1021,2435,41.9,3423,1008,2415,41.7
11200, 동작구,126,평균연령,2016,40.9,39.9,41.8,,40.9,39.8,41.8,
11200, 동작구,127,중위연령,2016,40,38.9,41.2,,39.9,38.8,41.2,
11210, 관악구,000,합계,2016,515648,259824,255824,101.6,491182,248149,243033,102.1
11210, 관악구,005,0~4세,2016,16937,8658,8279,104.6,16323,8358,7965,104.9
11210, 관악구,005001, 0세,2016,3575,1815,1760,103.1,3438,1750,1688,103.7
11210, 관악구,005002, 1세,2016,3493,1805,1688,106.9,3359,1742,1617,107.7
11210, 관악구,005003, 2세,2016,3359,1705,1654,103.1,3227,1637,1590,103
11210, 관악구,005004, 3세,2016,3197,1621,1576,102.9,3092,1577,1515,104.1
11210, 관악구,005005, 4세,2016,3313,1712,1601,106.9,3207,1652,1555,106.2
11210, 관악구,010,5~9세,2016,14882,7670,7212,106.4,14565,7503,7062,106.2
11210, 관악구,010001, 5세,2016,3289,1678,1611,104.2,3209,1637,1572,104.1
11210, 관악구,010002, 6세,2016,2932,1488,1444,103,2851,1436,1415,101.5
11210, 관악구,010003, 7세,2016,2793,1470,1323,111.1,2724,1435,1289,111.3
11210, 관악구,010004, 8세,2016,2931,1535,1396,110,2882,1511,1371,110.2
11210, 관악구,010005, 9세,2016,2937,1499,1438,104.2,2899,1484,1415,104.9
11210, 관악구,015,10~14세,2016,14454,7452,7002,106.4,14295,7375,6920,106.6
11210, 관악구,015001, 10세,2016,2784,1451,1333,108.9,2753,1439,1314,109.5
11210, 관악구,015002, 11세,2016,2765,1390,1375,101.1,2719,1369,1350,101.4
11210, 관악구,015003, 12세,2016,2882,1482,1400,105.9,2846,1462,1384,105.6
11210, 관악구,015004, 13세,2016,2902,1494,1408,106.1,2881,1481,1400,105.8
11210, 관악구,015005, 14세,2016,3121,1635,1486,110,3096,1624,1472,110.3
11210, 관악구,020,15~19세,2016,21802,11094,10708,103.6,21415,10914,10501,103.9
11210, 관악구,020001, 15세,2016,3410,1721,1689,101.9,3389,1707,1682,101.5
11210, 관악구,020002, 16세,2016,3904,1987,1917,103.7,3871,1976,1895,104.3
11210, 관악구,020003, 17세,2016,3925,1993,1932,103.2,3874,1970,1904,103.5
11210, 관악구,020004, 18세,2016,4697,2420,2277,106.3,4602,2373,2229,106.5
11210, 관악구,020005, 19세,2016,5866,2973,2893,102.8,5679,2888,2791,103.5
11210, 관악구,025,20~24세,2016,42327,20545,21782,94.3,40552,19920,20632,96.5
11210, 관악구,025001, 20세,2016,6467,3235,3232,100.1,6269,3168,3101,102.2
11210, 관악구,025002, 21세,2016,6812,3319,3493,95,6569,3225,3344,96.4
11210, 관악구,025003, 22세,2016,8314,4021,4293,93.7,7973,3912,4061,96.3
11210, 관악구,025004, 23세,2016,9619,4635,4984,93,9171,4477,4694,95.4
11210, 관악구,025005, 24세,2016,11115,5335,5780,92.3,10570,5138,5432,94.6
11210, 관악구,030,25~29세,2016,60070,31178,28892,107.9,56613,29636,26977,109.9
11210, 관악구,030001, 25세,2016,11902,5874,6028,97.4,11273,5634,5639,99.9
11210, 관악구,030002, 26세,2016,12200,6307,5893,107,11500,5995,5505,108.9
11210, 관악구,030003, 27세,2016,12351,6512,5839,111.5,11630,6196,5434,114
11210, 관악구,030004, 28세,2016,12014,6364,5650,112.6,11300,6018,5282,113.9
11210, 관악구,030005, 29세,2016,11603,6121,5482,111.7,10910,5793,5117,113.2
11210, 관악구,035,30~34세,2016,53459,29124,24335,119.7,50832,27816,23016,120.9
11210, 관악구,035001, 30세,2016,11222,6133,5089,120.5,10567,5810,4757,122.1
11210, 관악구,035002, 31세,2016,10454,5699,4755,119.9,9903,5433,4470,121.5
11210, 관악구,035003, 32세,2016,10478,5644,4834,116.8,9988,5407,4581,118
11210, 관악구,035004, 33세,2016,10558,5853,4705,124.4,10090,5613,4477,125.4
11210, 관악구,035005, 34세,2016,10747,5795,4952,117,10284,5553,4731,117.4
11210, 관악구,040,35~39세,2016,43567,23733,19834,119.7,41895,22789,19106,119.3
11210, 관악구,040001, 35세,2016,10040,5561,4479,124.2,9686,5370,4316,124.4
11210, 관악구,040002, 36세,2016,9677,5208,4469,116.5,9357,5035,4322,116.5
11210, 관악구,040003, 37세,2016,8646,4786,3860,124,8261,4563,3698,123.4
11210, 관악구,040004, 38세,2016,7634,4094,3540,115.6,7334,3924,3410,115.1
11210, 관악구,040005, 39세,2016,7570,4084,3486,117.2,7257,3897,3360,116
11210, 관악구,045,40~44세,2016,38569,21174,17395,121.7,36817,20199,16618,121.5
11210, 관악구,045001, 40세,2016,7414,4108,3306,124.3,7114,3939,3175,124.1
11210, 관악구,045002, 41세,2016,7505,4129,3376,122.3,7218,3966,3252,122
11210, 관악구,045003, 42세,2016,7907,4275,3632,117.7,7556,4080,3476,117.4
11210, 관악구,045004, 43세,2016,7825,4343,3482,124.7,7458,4137,3321,124.6
11210, 관악구,045005, 44세,2016,7918,4319,3599,120,7471,4077,3394,120.1
11210, 관악구,050,45~49세,2016,37977,19343,18634,103.8,35510,18141,17369,104.4
11210, 관악구,050001, 45세,2016,8329,4458,3871,115.2,7834,4208,3626,116.1
11210, 관악구,050002, 46세,2016,7697,4010,3687,108.8,7206,3769,3437,109.7
11210, 관악구,050003, 47세,2016,7574,3870,3704,104.5,7059,3621,3438,105.3
11210, 관악구,050004, 48세,2016,7507,3691,3816,96.7,6985,3436,3549,96.8
11210, 관악구,050005, 49세,2016,6870,3314,3556,93.2,6426,3107,3319,93.6
11210, 관악구,055,50~54세,2016,36326,17911,18415,97.3,33132,16387,16745,97.9
11210, 관악구,055001, 50세,2016,6860,3534,3326,106.3,6331,3264,3067,106.4
11210, 관악구,055002, 51세,2016,7357,3595,3762,95.6,6765,3322,3443,96.5
11210, 관악구,055003, 52세,2016,6938,3395,3543,95.8,6302,3110,3192,97.4
11210, 관악구,055004, 53세,2016,7507,3670,3837,95.6,6715,3287,3428,95.9
11210, 관악구,055005, 54세,2016,7664,3717,3947,94.2,7019,3404,3615,94.2
11210, 관악구,060,55~59세,2016,38291,17929,20362,88.1,35719,16677,19042,87.6
11210, 관악구,060001, 55세,2016,7888,3737,4151,90,7490,3552,3938,90.2
11210, 관악구,060002, 56세,2016,8371,3869,4502,85.9,7734,3578,4156,86.1
11210, 관악구,060003, 57세,2016,7590,3523,4067,86.6,7087,3272,3815,85.8
11210, 관악구,060004, 58세,2016,7307,3508,3799,92.3,6792,3250,3542,91.8
11210, 관악구,060005, 59세,2016,7135,3292,3843,85.7,6616,3025,3591,84.2
11210, 관악구,065,60~64세,2016,31916,14629,17287,84.6,29864,13631,16233,84
11210, 관악구,065001, 60세,2016,7003,3244,3759,86.3,6495,3001,3494,85.9
11210, 관악구,065002, 61세,2016,7155,3257,3898,83.6,6658,3014,3644,82.7
11210, 관악구,065003, 62세,2016,6257,2877,3380,85.1,5798,2637,3161,83.4
11210, 관악구,065004, 63세,2016,5463,2420,3043,79.5,5151,2280,2871,79.4
11210, 관악구,065005, 64세,2016,6038,2831,3207,88.3,5762,2699,3063,88.1
11210, 관악구,070,65~69세,2016,24462,11426,13036,87.6,23659,11042,12617,87.5
11210, 관악구,070001, 65세,2016,4580,2136,2444,87.4,4330,2008,2322,86.5
11210, 관악구,070002, 66세,2016,5022,2404,2618,91.8,4846,2318,2528,91.7
11210, 관악구,070003, 67세,2016,5114,2381,2733,87.1,4933,2299,2634,87.3
11210, 관악구,070004, 68세,2016,4895,2257,2638,85.6,4776,2206,2570,85.8
11210, 관악구,070005, 69세,2016,4851,2248,2603,86.4,4774,2211,2563,86.3
11210, 관악구,075,70~74세,2016,18662,8836,9826,89.9,18377,8724,9653,90.4
11210, 관악구,075001, 70세,2016,3775,1727,2048,84.3,3689,1688,2001,84.4
11210, 관악구,075002, 71세,2016,3610,1703,1907,89.3,3555,1680,1875,89.6
11210, 관악구,075003, 72세,2016,3600,1706,1894,90.1,3553,1689,1864,90.6
11210, 관악구,075004, 73세,2016,3599,1718,1881,91.3,3545,1699,1846,92
11210, 관악구,075005, 74세,2016,4078,1982,2096,94.6,4035,1968,2067,95.2
11210, 관악구,080,75~79세,2016,12521,5853,6668,87.8,12349,5806,6543,88.7
11210, 관악구,080001, 75세,2016,3139,1528,1611,94.8,3110,1519,1591,95.5
11210, 관악구,080002, 76세,2016,2676,1233,1443,85.4,2646,1229,1417,86.7
11210, 관악구,080003, 77세,2016,2636,1262,1374,91.8,2587,1250,1337,93.5
11210, 관악구,080004, 78세,2016,2223,1025,1198,85.6,2188,1013,1175,86.2
11210, 관악구,080005, 79세,2016,1847,805,1042,77.3,1818,795,1023,77.7
11210, 관악구,085,80~84세,2016,5921,2357,3564,66.1,5820,2329,3491,66.7
11210, 관악구,085001, 80세,2016,1582,678,904,75,1553,668,885,75.5
11210, 관악구,085002, 81세,2016,1449,578,871,66.4,1428,573,855,67
11210, 관악구,085003, 82세,2016,1131,444,687,64.6,1113,440,673,65.4
11210, 관악구,085004, 83세,2016,936,359,577,62.2,918,355,563,63.1
11210, 관악구,085005, 84세,2016,823,298,525,56.8,808,293,515,56.9
11210, 관악구,090,85~89세,2016,2523,718,1805,39.8,2476,710,1766,40.2
11210, 관악구,090001, 85세,2016,655,212,443,47.9,641,209,432,48.4
11210, 관악구,090002, 86세,2016,630,178,452,39.4,618,178,440,40.5
11210, 관악구,090003, 87세,2016,501,135,366,36.9,495,134,361,37.1
11210, 관악구,090004, 88세,2016,401,106,295,35.9,392,103,289,35.6
11210, 관악구,090005, 89세,2016,336,87,249,34.9,330,86,244,35.2
11210, 관악구,095,90~94세,2016,797,167,630,26.5,786,166,620,26.8
11210, 관악구,095001, 90세,2016,254,51,203,25.1,251,51,200,25.5
11210, 관악구,095002, 91세,2016,169,40,129,31,165,39,126,31
11210, 관악구,095003, 92세,2016,133,30,103,29.1,130,30,100,30
11210, 관악구,095004, 93세,2016,146,27,119,22.7,145,27,118,22.9
11210, 관악구,095005, 94세,2016,95,19,76,25,95,19,76,25
11210, 관악구,100,95~99세,2016,162,26,136,19.1,160,25,135,18.5
11210, 관악구,100001, 95세,2016,63,11,52,21.2,63,11,52,21.2
11210, 관악구,100002, 96세,2016,35,6,29,20.7,34,6,28,21.4
11210, 관악구,100003, 97세,2016,26,5,21,23.8,25,X,21,19
11210, 관악구,100004, 98세,2016,22,X,20,10,22,X,20,10
11210, 관악구,100005, 99세,2016,16,X,14,14.3,16,X,14,14.3
11210, 관악구,101,100세이상,2016,23,X,22,4.5,23,X,22,4.5
11210, 관악구,102,15세미만,2016,46273,23780,22493,105.7,45183,23236,21947,105.9
11210, 관악구,103,15~64세,2016,404304,206660,197644,104.6,382349,196110,186239,105.3
11210, 관악구,104,65세이상,2016,65071,29384,35687,82.3,63650,28803,34847,82.7
11210, 관악구,086,85세이상,2016,3505,912,2593,35.2,3445,902,2543,35.5
11210, 관악구,126,평균연령,2016,40.7,39.9,41.6,,40.7,39.8,41.6,
11210, 관악구,127,중위연령,2016,38.7,37.7,40,,38.5,37.5,39.8,
11220, 서초구,000,합계,2016,419682,201062,218620,92,413015,197771,215244,91.9
11220, 서초구,005,0~4세,2016,18658,9540,9118,104.6,18442,9427,9015,104.6
11220, 서초구,005001, 0세,2016,3504,1758,1746,100.7,3474,1743,1731,100.7
11220, 서초구,005002, 1세,2016,3579,1808,1771,102.1,3534,1786,1748,102.2
11220, 서초구,005003, 2세,2016,3666,1889,1777,106.3,3629,1867,1762,106
11220, 서초구,005004, 3세,2016,3796,1941,1855,104.6,3747,1922,1825,105.3
11220, 서초구,005005, 4세,2016,4113,2144,1969,108.9,4058,2109,1949,108.2
11220, 서초구,010,5~9세,2016,20821,10616,10205,104,20482,10439,10043,103.9
11220, 서초구,010001, 5세,2016,4236,2220,2016,110.1,4168,2181,1987,109.8
11220, 서초구,010002, 6세,2016,4109,2086,2023,103.1,4033,2049,1984,103.3
11220, 서초구,010003, 7세,2016,3982,2028,1954,103.8,3908,1988,1920,103.5
11220, 서초구,010004, 8세,2016,4216,2125,2091,101.6,4157,2094,2063,101.5
11220, 서초구,010005, 9세,2016,4278,2157,2121,101.7,4216,2127,2089,101.8
11220, 서초구,015,10~14세,2016,20860,10669,10191,104.7,20560,10511,10049,104.6
11220, 서초구,015001, 10세,2016,3832,1968,1864,105.6,3779,1942,1837,105.7
11220, 서초구,015002, 11세,2016,3835,2016,1819,110.8,3787,1988,1799,110.5
11220, 서초구,015003, 12세,2016,4565,2314,2251,102.8,4501,2279,2222,102.6
11220, 서초구,015004, 13세,2016,4268,2160,2108,102.5,4207,2130,2077,102.6
11220, 서초구,015005, 14세,2016,4360,2211,2149,102.9,4286,2172,2114,102.7
11220, 서초구,020,15~19세,2016,23846,12021,11825,101.7,23589,11873,11716,101.3
11220, 서초구,020001, 15세,2016,4764,2391,2373,100.8,4703,2353,2350,100.1
11220, 서초구,020002, 16세,2016,4881,2491,2390,104.2,4817,2458,2359,104.2
11220, 서초구,020003, 17세,2016,4725,2413,2312,104.4,4672,2384,2288,104.2
11220, 서초구,020004, 18세,2016,4793,2456,2337,105.1,4750,2432,2318,104.9
11220, 서초구,020005, 19세,2016,4683,2270,2413,94.1,4647,2246,2401,93.5
11220, 서초구,025,20~24세,2016,25256,12219,13037,93.7,24921,12044,12877,93.5
11220, 서초구,025001, 20세,2016,4716,2313,2403,96.3,4676,2291,2385,96.1
11220, 서초구,025002, 21세,2016,4892,2460,2432,101.2,4834,2425,2409,100.7
11220, 서초구,025003, 22세,2016,5030,2518,2512,100.2,4960,2483,2477,100.2
11220, 서초구,025004, 23세,2016,5135,2413,2722,88.6,5051,2367,2684,88.2
11220, 서초구,025005, 24세,2016,5483,2515,2968,84.7,5400,2478,2922,84.8
11220, 서초구,030,25~29세,2016,29088,13387,15701,85.3,28300,12993,15307,84.9
11220, 서초구,030001, 25세,2016,5557,2552,3005,84.9,5450,2508,2942,85.2
11220, 서초구,030002, 26세,2016,5548,2583,2965,87.1,5421,2511,2910,86.3
11220, 서초구,030003, 27세,2016,5899,2724,3175,85.8,5717,2638,3079,85.7
11220, 서초구,030004, 28세,2016,5989,2795,3194,87.5,5805,2712,3093,87.7
11220, 서초구,030005, 29세,2016,6095,2733,3362,81.3,5907,2624,3283,79.9
11220, 서초구,035,30~34세,2016,34090,15829,18261,86.7,33197,15328,17869,85.8
11220, 서초구,035001, 30세,2016,6272,2858,3414,83.7,6088,2760,3328,82.9
11220, 서초구,035002, 31세,2016,6360,2934,3426,85.6,6187,2843,3344,85
11220, 서초구,035003, 32세,2016,6494,3048,3446,88.5,6308,2938,3370,87.2
11220, 서초구,035004, 33세,2016,7326,3428,3898,87.9,7145,3322,3823,86.9
11220, 서초구,035005, 34세,2016,7638,3561,4077,87.3,7469,3465,4004,86.5
11220, 서초구,040,35~39세,2016,36564,17014,19550,87,35832,16610,19222,86.4
11220, 서초구,040001, 35세,2016,7597,3550,4047,87.7,7437,3459,3978,87
11220, 서초구,040002, 36세,2016,7753,3595,4158,86.5,7600,3504,4096,85.5
11220, 서초구,040003, 37세,2016,7344,3455,3889,88.8,7196,3374,3822,88.3
11220, 서초구,040004, 38세,2016,6749,3125,3624,86.2,6617,3061,3556,86.1
11220, 서초구,040005, 39세,2016,7121,3289,3832,85.8,6982,3212,3770,85.2
11220, 서초구,045,40~44세,2016,38074,18072,20002,90.4,37481,17757,19724,90
11220, 서초구,045001, 40세,2016,7009,3202,3807,84.1,6889,3142,3747,83.9
11220, 서초구,045002, 41세,2016,7103,3431,3672,93.4,6994,3374,3620,93.2
11220, 서초구,045003, 42세,2016,7780,3673,4107,89.4,7665,3612,4053,89.1
11220, 서초구,045004, 43세,2016,7938,3777,4161,90.8,7833,3713,4120,90.1
11220, 서초구,045005, 44세,2016,8244,3989,4255,93.7,8100,3916,4184,93.6
11220, 서초구,050,45~49세,2016,38915,19008,19907,95.5,38329,18738,19591,95.6
11220, 서초구,050001, 45세,2016,8416,4043,4373,92.5,8287,3978,4309,92.3
11220, 서초구,050002, 46세,2016,8307,4048,4259,95,8175,3981,4194,94.9
11220, 서초구,050003, 47세,2016,7959,3956,4003,98.8,7855,3912,3943,99.2
11220, 서초구,050004, 48세,2016,7470,3661,3809,96.1,7365,3618,3747,96.6
11220, 서초구,050005, 49세,2016,6763,3300,3463,95.3,6647,3249,3398,95.6
11220, 서초구,055,50~54세,2016,30819,15183,15636,97.1,30276,14949,15327,97.5
11220, 서초구,055001, 50세,2016,5988,3041,2947,103.2,5898,3001,2897,103.6
11220, 서초구,055002, 51세,2016,6440,3209,3231,99.3,6339,3172,3167,100.2
11220, 서초구,055003, 52세,2016,6127,2948,3179,92.7,6025,2905,3120,93.1
11220, 서초구,055004, 53세,2016,6255,3044,3211,94.8,6120,2983,3137,95.1
11220, 서초구,055005, 54세,2016,6009,2941,3068,95.9,5894,2888,3006,96.1
11220, 서초구,060,55~59세,2016,30266,14146,16120,87.8,29855,13985,15870,88.1
11220, 서초구,060001, 55세,2016,6240,2922,3318,88.1,6169,2893,3276,88.3
11220, 서초구,060002, 56세,2016,6332,2980,3352,88.9,6236,2934,3302,88.9
11220, 서초구,060003, 57세,2016,5988,2774,3214,86.3,5913,2739,3174,86.3
11220, 서초구,060004, 58세,2016,5909,2809,3100,90.6,5822,2785,3037,91.7
11220, 서초구,060005, 59세,2016,5797,2661,3136,84.9,5715,2634,3081,85.5
11220, 서초구,065,60~64세,2016,24580,11400,13180,86.5,24235,11277,12958,87
11220, 서초구,065001, 60세,2016,5292,2500,2792,89.5,5209,2469,2740,90.1
11220, 서초구,065002, 61세,2016,5692,2621,3071,85.3,5614,2599,3015,86.2
11220, 서초구,065003, 62세,2016,4696,2207,2489,88.7,4625,2177,2448,88.9
11220, 서초구,065004, 63세,2016,4424,1993,2431,82,4367,1972,2395,82.3
11220, 서초구,065005, 64세,2016,4476,2079,2397,86.7,4420,2060,2360,87.3
11220, 서초구,070,65~69세,2016,18013,8435,9578,88.1,17852,8376,9476,88.4
11220, 서초구,070001, 65세,2016,3258,1565,1693,92.4,3229,1555,1674,92.9
11220, 서초구,070002, 66세,2016,3629,1684,1945,86.6,3577,1664,1913,87
11220, 서초구,070003, 67세,2016,3804,1753,2051,85.5,3771,1738,2033,85.5
11220, 서초구,070004, 68세,2016,3742,1747,1995,87.6,3716,1738,1978,87.9
11220, 서초구,070005, 69세,2016,3580,1686,1894,89,3559,1681,1878,89.5
11220, 서초구,075,70~74세,2016,13194,6519,6675,97.7,13125,6496,6629,98
11220, 서초구,075001, 70세,2016,3008,1419,1589,89.3,2987,1413,1574,89.8
11220, 서초구,075002, 71세,2016,2631,1290,1341,96.2,2614,1283,1331,96.4
11220, 서초구,075003, 72세,2016,2561,1269,1292,98.2,2548,1267,1281,98.9
11220, 서초구,075004, 73세,2016,2444,1216,1228,99,2435,1213,1222,99.3
11220, 서초구,075005, 74세,2016,2550,1325,1225,108.2,2541,1320,1221,108.1
11220, 서초구,080,75~79세,2016,8454,4104,4350,94.3,8411,4087,4324,94.5
11220, 서초구,080001, 75세,2016,2090,1058,1032,102.5,2078,1052,1026,102.5
11220, 서초구,080002, 76세,2016,1836,900,936,96.2,1830,897,933,96.1
11220, 서초구,080003, 77세,2016,1653,811,842,96.3,1645,809,836,96.8
11220, 서초구,080004, 78세,2016,1492,726,766,94.8,1484,724,760,95.3
11220, 서초구,080005, 79세,2016,1383,609,774,78.7,1374,605,769,78.7
11220, 서초구,085,80~84세,2016,4708,1934,2774,69.7,4690,1927,2763,69.7
11220, 서초구,085001, 80세,2016,1148,522,626,83.4,1143,519,624,83.2
11220, 서초구,085002, 81세,2016,1151,495,656,75.5,1144,492,652,75.5
11220, 서초구,085003, 82세,2016,923,350,573,61.1,922,350,572,61.2
11220, 서초구,085004, 83세,2016,753,282,471,59.9,752,282,470,60
11220, 서초구,085005, 84세,2016,733,285,448,63.6,729,284,445,63.8
11220, 서초구,090,85~89세,2016,2349,680,1669,40.7,2331,674,1657,40.7
11220, 서초구,090001, 85세,2016,536,169,367,46,532,168,364,46.2
11220, 서초구,090002, 86세,2016,516,139,377,36.9,512,138,374,36.9
11220, 서초구,090003, 87세,2016,513,161,352,45.7,508,159,349,45.6
11220, 서초구,090004, 88세,2016,428,106,322,32.9,426,106,320,33.1
11220, 서초구,090005, 89세,2016,356,105,251,41.8,353,103,250,41.2
11220, 서초구,095,90~94세,2016,871,229,642,35.7,863,228,635,35.9
11220, 서초구,095001, 90세,2016,239,70,169,41.4,238,70,168,41.7
11220, 서초구,095002, 91세,2016,207,56,151,37.1,207,56,151,37.1
11220, 서초구,095003, 92세,2016,170,38,132,28.8,167,37,130,28.5
11220, 서초구,095004, 93세,2016,154,42,112,37.5,151,42,109,38.5
11220, 서초구,095005, 94세,2016,101,23,78,29.5,100,23,77,29.9
11220, 서초구,100,95~99세,2016,224,51,173,29.5,213,46,167,27.5
11220, 서초구,100001, 95세,2016,76,13,63,20.6,76,13,63,20.6
11220, 서초구,100002, 96세,2016,59,14,45,31.1,56,13,43,30.2
11220, 서초구,100003, 97세,2016,42,11,31,35.5,38,8,30,26.7
11220, 서초구,100004, 98세,2016,29,9,20,45,26,8,18,44.4
11220, 서초구,100005, 99세,2016,18,X,14,28.6,17,X,13,30.8
11220, 서초구,101,100세이상,2016,32,6,26,23.1,31,6,25,24
11220, 서초구,102,15세미만,2016,60339,30825,29514,104.4,59484,30377,29107,104.4
11220, 서초구,103,15~64세,2016,311498,148279,163219,90.8,306015,145554,160461,90.7
11220, 서초구,104,65세이상,2016,47845,21958,25887,84.8,47516,21840,25676,85.1
11220, 서초구,086,85세이상,2016,3476,966,2510,38.5,3438,954,2484,38.4
11220, 서초구,126,평균연령,2016,39.6,39,40.1,,39.6,39.1,40.2,
11220, 서초구,127,중위연령,2016,40.1,39.8,40.4,,40.2,39.9,40.4,
11230, 강남구,000,합계,2016,532469,254645,277824,91.7,524484,250594,273890,91.5
11230, 강남구,005,0~4세,2016,19441,9978,9463,105.4,19282,9896,9386,105.4
11230, 강남구,005001, 0세,2016,3845,1930,1915,100.8,3815,1916,1899,100.9
11230, 강남구,005002, 1세,2016,3794,1957,1837,106.5,3756,1940,1816,106.8
11230, 강남구,005003, 2세,2016,3802,1996,1806,110.5,3769,1978,1791,110.4
11230, 강남구,005004, 3세,2016,3909,1985,1924,103.2,3874,1965,1909,102.9
11230, 강남구,005005, 4세,2016,4091,2110,1981,106.5,4068,2097,1971,106.4
11230, 강남구,010,5~9세,2016,21455,11095,10360,107.1,21173,10929,10244,106.7
11230, 강남구,010001, 5세,2016,4230,2183,2047,106.6,4182,2156,2026,106.4
11230, 강남구,010002, 6세,2016,4102,2122,1980,107.2,4047,2089,1958,106.7
11230, 강남구,010003, 7세,2016,4057,2112,1945,108.6,3993,2071,1922,107.8
11230, 강남구,010004, 8세,2016,4523,2376,2147,110.7,4464,2340,2124,110.2
11230, 강남구,010005, 9세,2016,4543,2302,2241,102.7,4487,2273,2214,102.7
11230, 강남구,015,10~14세,2016,25067,13248,11819,112.1,24733,13058,11675,111.8
11230, 강남구,015001, 10세,2016,4262,2232,2030,110,4212,2198,2014,109.1
11230, 강남구,015002, 11세,2016,4490,2376,2114,112.4,4437,2342,2095,111.8
11230, 강남구,015003, 12세,2016,5315,2841,2474,114.8,5258,2815,2443,115.2
11230, 강남구,015004, 13세,2016,5477,2847,2630,108.3,5408,2810,2598,108.2
11230, 강남구,015005, 14세,2016,5523,2952,2571,114.8,5418,2893,2525,114.6
11230, 강남구,020,15~19세,2016,34256,17787,16469,108,33921,17617,16304,108.1
11230, 강남구,020001, 15세,2016,6456,3373,3083,109.4,6377,3330,3047,109.3
11230, 강남구,020002, 16세,2016,7038,3687,3351,110,6973,3643,3330,109.4
11230, 강남구,020003, 17세,2016,7010,3687,3323,111,6951,3656,3295,111
11230, 강남구,020004, 18세,2016,7301,3808,3493,109,7226,3779,3447,109.6
11230, 강남구,020005, 19세,2016,6451,3232,3219,100.4,6394,3209,3185,100.8
11230, 강남구,025,20~24세,2016,33575,16709,16866,99.1,33014,16469,16545,99.5
11230, 강남구,025001, 20세,2016,6361,3308,3053,108.4,6278,3276,3002,109.1
11230, 강남구,025002, 21세,2016,6409,3381,3028,111.7,6327,3342,2985,112
11230, 강남구,025003, 22세,2016,6592,3384,3208,105.5,6489,3346,3143,106.5
11230, 강남구,025004, 23세,2016,6897,3355,3542,94.7,6761,3295,3466,95.1
11230, 강남구,025005, 24세,2016,7316,3281,4035,81.3,7159,3210,3949,81.3
11230, 강남구,030,25~29세,2016,39623,17967,21656,83,38482,17393,21089,82.5
11230, 강남구,030001, 25세,2016,7301,3250,4051,80.2,7086,3137,3949,79.4
11230, 강남구,030002, 26세,2016,7781,3560,4221,84.3,7572,3471,4101,84.6
11230, 강남구,030003, 27세,2016,8084,3722,4362,85.3,7850,3609,4241,85.1
11230, 강남구,030004, 28세,2016,8130,3655,4475,81.7,7896,3536,4360,81.1
11230, 강남구,030005, 29세,2016,8327,3780,4547,83.1,8078,3640,4438,82
11230, 강남구,035,30~34세,2016,45957,21234,24723,85.9,44717,20548,24169,85
11230, 강남구,035001, 30세,2016,8616,4010,4606,87.1,8331,3852,4479,86
11230, 강남구,035002, 31세,2016,8729,4117,4612,89.3,8473,3965,4508,88
11230, 강남구,035003, 32세,2016,9123,4151,4972,83.5,8889,4022,4867,82.6
11230, 강남구,035004, 33세,2016,9461,4378,5083,86.1,9226,4247,4979,85.3
11230, 강남구,035005, 34세,2016,10028,4578,5450,84,9798,4462,5336,83.6
11230, 강남구,040,35~39세,2016,45627,21190,24437,86.7,44781,20704,24077,86
11230, 강남구,040001, 35세,2016,9917,4607,5310,86.8,9728,4507,5221,86.3
11230, 강남구,040002, 36세,2016,9590,4458,5132,86.9,9402,4351,5051,86.1
11230, 강남구,040003, 37세,2016,9329,4229,5100,82.9,9144,4123,5021,82.1
11230, 강남구,040004, 38세,2016,8297,3960,4337,91.3,8152,3868,4284,90.3
11230, 강남구,040005, 39세,2016,8494,3936,4558,86.4,8355,3855,4500,85.7
11230, 강남구,045,40~44세,2016,45224,20811,24413,85.2,44578,20432,24146,84.6
11230, 강남구,045001, 40세,2016,8132,3836,4296,89.3,7997,3749,4248,88.3
11230, 강남구,045002, 41세,2016,8522,3929,4593,85.5,8405,3865,4540,85.1
11230, 강남구,045003, 42세,2016,9262,4237,5025,84.3,9127,4156,4971,83.6
11230, 강남구,045004, 43세,2016,9367,4244,5123,82.8,9241,4168,5073,82.2
11230, 강남구,045005, 44세,2016,9941,4565,5376,84.9,9808,4494,5314,84.6
11230, 강남구,050,45~49세,2016,51877,24668,27209,90.7,51272,24346,26926,90.4
11230, 강남구,050001, 45세,2016,10862,5124,5738,89.3,10729,5046,5683,88.8
11230, 강남구,050002, 46세,2016,10853,5041,5812,86.7,10713,4967,5746,86.4
11230, 강남구,050003, 47세,2016,10767,5157,5610,91.9,10653,5098,5555,91.8
11230, 강남구,050004, 48세,2016,10119,4905,5214,94.1,10015,4851,5164,93.9
11230, 강남구,050005, 49세,2016,9276,4441,4835,91.9,9162,4384,4778,91.8
11230, 강남구,055,50~54세,2016,41805,20863,20942,99.6,41267,20631,20636,100
11230, 강남구,055001, 50세,2016,8406,4267,4139,103.1,8299,4222,4077,103.6
11230, 강남구,055002, 51세,2016,8870,4408,4462,98.8,8765,4366,4399,99.2
11230, 강남구,055003, 52세,2016,8313,4108,4205,97.7,8218,4066,4152,97.9
11230, 강남구,055004, 53세,2016,8429,4154,4275,97.2,8314,4114,4200,98
11230, 강남구,055005, 54세,2016,7787,3926,3861,101.7,7671,3863,3808,101.4
11230, 강남구,060,55~59세,2016,38405,18068,20337,88.8,37941,17890,20051,89.2
11230, 강남구,060001, 55세,2016,8171,3882,4289,90.5,8087,3848,4239,90.8
11230, 강남구,060002, 56세,2016,8153,3818,4335,88.1,8038,3777,4261,88.6
11230, 강남구,060003, 57세,2016,7430,3506,3924,89.3,7347,3476,3871,89.8
11230, 강남구,060004, 58세,2016,7322,3405,3917,86.9,7233,3371,3862,87.3
11230, 강남구,060005, 59세,2016,7329,3457,3872,89.3,7236,3418,3818,89.5
11230, 강남구,065,60~64세,2016,31412,14289,17123,83.4,31021,14126,16895,83.6
11230, 강남구,065001, 60세,2016,6748,3126,3622,86.3,6662,3090,3572,86.5
11230, 강남구,065002, 61세,2016,7100,3135,3965,79.1,7017,3100,3917,79.1
11230, 강남구,065003, 62세,2016,6132,2828,3304,85.6,6052,2803,3249,86.3
11230, 강남구,065004, 63세,2016,5608,2529,3079,82.1,5538,2491,3047,81.8
11230, 강남구,065005, 64세,2016,5824,2671,3153,84.7,5752,2642,3110,85
11230, 강남구,070,65~69세,2016,22390,10551,11839,89.1,22202,10486,11716,89.5
11230, 강남구,070001, 65세,2016,4000,1920,2080,92.3,3948,1903,2045,93.1
11230, 강남구,070002, 66세,2016,4650,2147,2503,85.8,4614,2133,2481,86
11230, 강남구,070003, 67세,2016,4714,2234,2480,90.1,4672,2221,2451,90.6
11230, 강남구,070004, 68세,2016,4594,2236,2358,94.8,4564,2226,2338,95.2
11230, 강남구,070005, 69세,2016,4432,2014,2418,83.3,4404,2003,2401,83.4
11230, 강남구,075,70~74세,2016,16036,7956,8080,98.5,15932,7915,8017,98.7
11230, 강남구,075001, 70세,2016,3678,1758,1920,91.6,3650,1746,1904,91.7
11230, 강남구,075002, 71세,2016,3263,1617,1646,98.2,3240,1609,1631,98.7
11230, 강남구,075003, 72세,2016,3092,1550,1542,100.5,3078,1544,1534,100.7
11230, 강남구,075004, 73세,2016,2921,1454,1467,99.1,2905,1450,1455,99.7
11230, 강남구,075005, 74세,2016,3082,1577,1505,104.8,3059,1566,1493,104.9
11230, 강남구,080,75~79세,2016,10242,4881,5361,91,10181,4850,5331,91
11230, 강남구,080001, 75세,2016,2553,1242,1311,94.7,2542,1236,1306,94.6
11230, 강남구,080002, 76세,2016,2257,1096,1161,94.4,2248,1091,1157,94.3
11230, 강남구,080003, 77세,2016,1977,979,998,98.1,1962,971,991,98
11230, 강남구,080004, 78세,2016,1778,795,983,80.9,1765,789,976,80.8
11230, 강남구,080005, 79세,2016,1677,769,908,84.7,1664,763,901,84.7
11230, 강남구,085,80~84세,2016,5743,2197,3546,62,5696,2173,3523,61.7
11230, 강남구,085001, 80세,2016,1403,613,790,77.6,1396,611,785,77.8
11230, 강남구,085002, 81세,2016,1334,520,814,63.9,1322,512,810,63.2
11230, 강남구,085003, 82세,2016,1112,410,702,58.4,1106,407,699,58.2
11230, 강남구,085004, 83세,2016,976,325,651,49.9,963,321,642,50
11230, 강남구,085005, 84세,2016,918,329,589,55.9,909,322,587,54.9
11230, 강남구,090,85~89세,2016,2901,797,2104,37.9,2882,784,2098,37.4
11230, 강남구,090001, 85세,2016,698,199,499,39.9,696,198,498,39.8
11230, 강남구,090002, 86세,2016,664,172,492,35,659,168,491,34.2
11230, 강남구,090003, 87세,2016,604,188,416,45.2,601,185,416,44.5
11230, 강남구,090004, 88세,2016,493,129,364,35.4,486,124,362,34.3
11230, 강남구,090005, 89세,2016,442,109,333,32.7,440,109,331,32.9
11230, 강남구,095,90~94세,2016,1129,283,846,33.5,1113,275,838,32.8
11230, 강남구,095001, 90세,2016,305,69,236,29.2,302,68,234,29.1
11230, 강남구,095002, 91세,2016,297,85,212,40.1,292,83,209,39.7
11230, 강남구,095003, 92세,2016,205,44,161,27.3,202,42,160,26.3
11230, 강남구,095004, 93세,2016,187,49,138,35.5,185,48,137,35
11230, 강남구,095005, 94세,2016,135,36,99,36.4,132,34,98,34.7
11230, 강남구,100,95~99세,2016,272,68,204,33.3,266,67,199,33.7
11230, 강남구,100001, 95세,2016,101,31,70,44.3,100,30,70,42.9
11230, 강남구,100002, 96세,2016,83,21,62,33.9,82,21,61,34.4
11230, 강남구,100003, 97세,2016,35,8,27,29.6,35,8,27,29.6
11230, 강남구,100004, 98세,2016,29,X,26,11.5,28,X,25,12
11230, 강남구,100005, 99세,2016,24,5,19,26.3,21,5,16,31.3
11230, 강남구,101,100세이상,2016,32,5,27,18.5,30,5,25,20
11230, 강남구,102,15세미만,2016,65963,34321,31642,108.5,65188,33883,31305,108.2
11230, 강남구,103,15~64세,2016,407761,193586,214175,90.4,400994,190156,210838,90.2
11230, 강남구,104,65세이상,2016,58745,26738,32007,83.5,58302,26555,31747,83.6
11230, 강남구,086,85세이상,2016,4334,1153,3181,36.2,4291,1131,3160,35.8
11230, 강남구,126,평균연령,2016,39.9,39.2,40.6,,40,39.2,40.6,
11230, 강남구,127,중위연령,2016,40.2,39.5,40.7,,40.3,39.7,40.8,
11240, 송파구,000,합계,2016,628212,305494,322718,94.7,618466,300796,317670,94.7
11240, 송파구,005,0~4세,2016,26726,13789,12937,106.6,26460,13648,12812,106.5
11240, 송파구,005001, 0세,2016,5400,2862,2538,112.8,5338,2826,2512,112.5
11240, 송파구,005002, 1세,2016,5381,2812,2569,109.5,5329,2787,2542,109.6
11240, 송파구,005003, 2세,2016,5155,2629,2526,104.1,5103,2604,2499,104.2
11240, 송파구,005004, 3세,2016,5141,2624,2517,104.3,5097,2601,2496,104.2
11240, 송파구,005005, 4세,2016,5649,2862,2787,102.7,5593,2830,2763,102.4
11240, 송파구,010,5~9세,2016,26903,13843,13060,106,26679,13732,12947,106.1
11240, 송파구,010001, 5세,2016,5369,2817,2552,110.4,5304,2781,2523,110.2
11240, 송파구,010002, 6세,2016,5344,2735,2609,104.8,5292,2713,2579,105.2
11240, 송파구,010003, 7세,2016,5196,2619,2577,101.6,5158,2602,2556,101.8
11240, 송파구,010004, 8세,2016,5447,2810,2637,106.6,5410,2792,2618,106.6
11240, 송파구,010005, 9세,2016,5547,2862,2685,106.6,5515,2844,2671,106.5
11240, 송파구,015,10~14세,2016,27930,14423,13507,106.8,27766,14336,13430,106.7
11240, 송파구,015001, 10세,2016,5234,2667,2567,103.9,5203,2647,2556,103.6
11240, 송파구,015002, 11세,2016,5235,2721,2514,108.2,5209,2705,2504,108
11240, 송파구,015003, 12세,2016,5709,2934,2775,105.7,5672,2916,2756,105.8
11240, 송파구,015004, 13세,2016,5820,3015,2805,107.5,5787,2999,2788,107.6
11240, 송파구,015005, 14세,2016,5932,3086,2846,108.4,5895,3069,2826,108.6
11240, 송파구,020,15~19세,2016,35424,18092,17332,104.4,35233,17987,17246,104.3
11240, 송파구,020001, 15세,2016,6704,3435,3269,105.1,6671,3424,3247,105.5
11240, 송파구,020002, 16세,2016,7391,3780,3611,104.7,7361,3766,3595,104.8
11240, 송파구,020003, 17세,2016,7082,3661,3421,107,7054,3644,3410,106.9
11240, 송파구,020004, 18세,2016,7160,3630,3530,102.8,7124,3606,3518,102.5
11240, 송파구,020005, 19세,2016,7087,3586,3501,102.4,7023,3547,3476,102
11240, 송파구,025,20~24세,2016,40219,20340,19879,102.3,39693,20108,19585,102.7
11240, 송파구,025001, 20세,2016,7425,3817,3608,105.8,7358,3790,3568,106.2
11240, 송파구,025002, 21세,2016,7753,4173,3580,116.6,7682,4139,3543,116.8
11240, 송파구,025003, 22세,2016,8082,4206,3876,108.5,7974,4157,3817,108.9
11240, 송파구,025004, 23세,2016,8235,4029,4206,95.8,8102,3973,4129,96.2
11240, 송파구,025005, 24세,2016,8724,4115,4609,89.3,8577,4049,4528,89.4
11240, 송파구,030,25~29세,2016,45619,21653,23966,90.3,44448,21082,23366,90.2
11240, 송파구,030001, 25세,2016,8665,4045,4620,87.6,8488,3963,4525,87.6
11240, 송파구,030002, 26세,2016,8963,4263,4700,90.7,8722,4133,4589,90.1
11240, 송파구,030003, 27세,2016,9079,4338,4741,91.5,8845,4226,4619,91.5
11240, 송파구,030004, 28세,2016,9303,4448,4855,91.6,9048,4332,4716,91.9
11240, 송파구,030005, 29세,2016,9609,4559,5050,90.3,9345,4428,4917,90.1
11240, 송파구,035,30~34세,2016,53544,25747,27797,92.6,52370,25147,27223,92.4
11240, 송파구,035001, 30세,2016,10027,4770,5257,90.7,9768,4635,5133,90.3
11240, 송파구,035002, 31세,2016,10063,4732,5331,88.8,9833,4624,5209,88.8
11240, 송파구,035003, 32세,2016,10315,5052,5263,96,10073,4940,5133,96.2
11240, 송파구,035004, 33세,2016,11379,5418,5961,90.9,11148,5295,5853,90.5
11240, 송파구,035005, 34세,2016,11760,5775,5985,96.5,11548,5653,5895,95.9
11240, 송파구,040,35~39세,2016,54014,25970,28044,92.6,53216,25542,27674,92.3
11240, 송파구,040001, 35세,2016,11801,5748,6053,95,11596,5634,5962,94.5
11240, 송파구,040002, 36세,2016,11645,5542,6103,90.8,11499,5465,6034,90.6
11240, 송파구,040003, 37세,2016,10969,5198,5771,90.1,10807,5110,5697,89.7
11240, 송파구,040004, 38세,2016,9619,4684,4935,94.9,9469,4600,4869,94.5
11240, 송파구,040005, 39세,2016,9980,4798,5182,92.6,9845,4733,5112,92.6
11240, 송파구,045,40~44세,2016,52355,25471,26884,94.7,51510,25016,26494,94.4
11240, 송파구,045001, 40세,2016,9654,4850,4804,101,9506,4768,4738,100.6
11240, 송파구,045002, 41세,2016,10008,4838,5170,93.6,9865,4765,5100,93.4
11240, 송파구,045003, 42세,2016,10690,5208,5482,95,10527,5122,5405,94.8
11240, 송파구,045004, 43세,2016,10811,5146,5665,90.8,10634,5052,5582,90.5
11240, 송파구,045005, 44세,2016,11192,5429,5763,94.2,10978,5309,5669,93.6
11240, 송파구,050,45~49세,2016,55297,26811,28486,94.1,54309,26344,27965,94.2
11240, 송파구,050001, 45세,2016,11918,5761,6157,93.6,11723,5660,6063,93.4
11240, 송파구,050002, 46세,2016,11160,5505,5655,97.3,10969,5408,5561,97.2
11240, 송파구,050003, 47세,2016,11352,5515,5837,94.5,11161,5433,5728,94.8
11240, 송파구,050004, 48세,2016,10855,5188,5667,91.5,10628,5085,5543,91.7
11240, 송파구,050005, 49세,2016,10012,4842,5170,93.7,9828,4758,5070,93.8
11240, 송파구,055,50~54세,2016,49871,24213,25658,94.4,48752,23719,25033,94.8
11240, 송파구,055001, 50세,2016,9680,4813,4867,98.9,9466,4727,4739,99.7
11240, 송파구,055002, 51세,2016,10118,4909,5209,94.2,9904,4802,5102,94.1
11240, 송파구,055003, 52세,2016,9755,4714,5041,93.5,9548,4621,4927,93.8
11240, 송파구,055004, 53세,2016,10230,4917,5313,92.5,9950,4797,5153,93.1
11240, 송파구,055005, 54세,2016,10088,4860,5228,93,9884,4772,5112,93.3
11240, 송파구,060,55~59세,2016,51658,24298,27360,88.8,50750,23892,26858,89
11240, 송파구,060001, 55세,2016,10774,5020,5754,87.2,10639,4964,5675,87.5
11240, 송파구,060002, 56세,2016,11111,5110,6001,85.2,10867,5009,5858,85.5
11240, 송파구,060003, 57세,2016,10196,4911,5285,92.9,10017,4834,5183,93.3
11240, 송파구,060004, 58세,2016,9820,4666,5154,90.5,9645,4584,5061,90.6
11240, 송파구,060005, 59세,2016,9757,4591,5166,88.9,9582,4501,5081,88.6
11240, 송파구,065,60~64세,2016,40518,19438,21080,92.2,39772,19098,20674,92.4
11240, 송파구,065001, 60세,2016,8772,4156,4616,90,8592,4077,4515,90.3
11240, 송파구,065002, 61세,2016,9455,4439,5016,88.5,9269,4357,4912,88.7
11240, 송파구,065003, 62세,2016,7841,3758,4083,92,7690,3687,4003,92.1
11240, 송파구,065004, 63세,2016,7065,3406,3659,93.1,6949,3352,3597,93.2
11240, 송파구,065005, 64세,2016,7385,3679,3706,99.3,7272,3625,3647,99.4
11240, 송파구,070,65~69세,2016,26738,13360,13378,99.9,26397,13212,13185,100.2
11240, 송파구,070001, 65세,2016,5148,2555,2593,98.5,5043,2506,2537,98.8
11240, 송파구,070002, 66세,2016,5592,2819,2773,101.7,5518,2782,2736,101.7
11240, 송파구,070003, 67세,2016,5564,2775,2789,99.5,5498,2749,2749,100
11240, 송파구,070004, 68세,2016,5131,2552,2579,99,5076,2533,2543,99.6
11240, 송파구,070005, 69세,2016,5303,2659,2644,100.6,5262,2642,2620,100.8
11240, 송파구,075,70~74세,2016,18085,8969,9116,98.4,17943,8906,9037,98.6
11240, 송파구,075001, 70세,2016,3958,1976,1982,99.7,3909,1957,1952,100.3
11240, 송파구,075002, 71세,2016,3632,1821,1811,100.6,3601,1803,1798,100.3
11240, 송파구,075003, 72세,2016,3473,1730,1743,99.3,3457,1721,1736,99.1
11240, 송파구,075004, 73세,2016,3337,1658,1679,98.7,3318,1649,1669,98.8
11240, 송파구,075005, 74세,2016,3685,1784,1901,93.8,3658,1776,1882,94.4
11240, 송파구,080,75~79세,2016,11718,5333,6385,83.5,11646,5305,6341,83.7
11240, 송파구,080001, 75세,2016,2878,1356,1522,89.1,2857,1346,1511,89.1
11240, 송파구,080002, 76세,2016,2489,1186,1303,91,2473,1180,1293,91.3
11240, 송파구,080003, 77세,2016,2354,1068,1286,83,2345,1065,1280,83.2
11240, 송파구,080004, 78세,2016,2052,895,1157,77.4,2037,889,1148,77.4
11240, 송파구,080005, 79세,2016,1945,828,1117,74.1,1934,825,1109,74.4
11240, 송파구,085,80~84세,2016,6868,2495,4373,57.1,6825,2483,4342,57.2
11240, 송파구,085001, 80세,2016,1694,672,1022,65.8,1681,666,1015,65.6
11240, 송파구,085002, 81세,2016,1573,615,958,64.2,1570,614,956,64.2
11240, 송파구,085003, 82세,2016,1336,501,835,60,1328,501,827,60.6
11240, 송파구,085004, 83세,2016,1219,381,838,45.5,1207,378,829,45.6
11240, 송파구,085005, 84세,2016,1046,326,720,45.3,1039,324,715,45.3
11240, 송파구,090,85~89세,2016,3264,907,2357,38.5,3247,898,2349,38.2
11240, 송파구,090001, 85세,2016,817,267,550,48.5,814,264,550,48
11240, 송파구,090002, 86세,2016,730,196,534,36.7,723,194,529,36.7
11240, 송파구,090003, 87세,2016,676,178,498,35.7,673,177,496,35.7
11240, 송파구,090004, 88세,2016,571,163,408,40,571,163,408,40
11240, 송파구,090005, 89세,2016,470,103,367,28.1,466,100,366,27.3
11240, 송파구,095,90~94세,2016,1185,276,909,30.4,1178,275,903,30.5
11240, 송파구,095001, 90세,2016,349,74,275,26.9,348,74,274,27
11240, 송파구,095002, 91세,2016,278,57,221,25.8,276,57,219,26
11240, 송파구,095003, 92세,2016,210,61,149,40.9,209,61,148,41.2
11240, 송파구,095004, 93세,2016,223,53,170,31.2,221,53,168,31.5
11240, 송파구,095005, 94세,2016,125,31,94,33,124,30,94,31.9
11240, 송파구,100,95~99세,2016,246,61,185,33,243,61,182,33.5
11240, 송파구,100001, 95세,2016,99,28,71,39.4,99,28,71,39.4
11240, 송파구,100002, 96세,2016,64,13,51,25.5,63,13,50,26
11240, 송파구,100003, 97세,2016,37,11,26,42.3,36,11,25,44
11240, 송파구,100004, 98세,2016,26,X,22,18.2,25,X,21,19
11240, 송파구,100005, 99세,2016,20,5,15,33.3,20,5,15,33.3
11240, 송파구,101,100세이상,2016,30,5,25,20,29,5,24,20.8
11240, 송파구,102,15세미만,2016,81559,42055,39504,106.5,80905,41716,39189,106.4
11240, 송파구,103,15~64세,2016,478519,232033,246486,94.1,470053,227935,242118,94.1
11240, 송파구,104,65세이상,2016,68134,31406,36728,85.5,67508,31145,36363,85.7
11240, 송파구,086,85세이상,2016,4725,1249,3476,35.9,4697,1239,3458,35.8
11240, 송파구,126,평균연령,2016,40,39.3,40.7,,40,39.3,40.6,
11240, 송파구,127,중위연령,2016,40.4,39.8,41,,40.4,39.7,41,
11250, 강동구,000,합계,2016,429416,212899,216517,98.3,423523,210113,213410,98.5
11250, 강동구,005,0~4세,2016,16968,8728,8240,105.9,16847,8666,8181,105.9
11250, 강동구,005001, 0세,2016,3304,1713,1591,107.7,3282,1702,1580,107.7
11250, 강동구,005002, 1세,2016,3378,1728,1650,104.7,3344,1709,1635,104.5
11250, 강동구,005003, 2세,2016,3472,1786,1686,105.9,3449,1775,1674,106
11250, 강동구,005004, 3세,2016,3229,1661,1568,105.9,3209,1650,1559,105.8
11250, 강동구,005005, 4세,2016,3585,1840,1745,105.4,3563,1830,1733,105.6
11250, 강동구,010,5~9세,2016,17245,9026,8219,109.8,17141,8965,8176,109.7
11250, 강동구,010001, 5세,2016,3421,1781,1640,108.6,3390,1762,1628,108.2
11250, 강동구,010002, 6세,2016,3487,1848,1639,112.8,3458,1833,1625,112.8
11250, 강동구,010003, 7세,2016,3221,1616,1605,100.7,3204,1604,1600,100.3
11250, 강동구,010004, 8세,2016,3543,1877,1666,112.7,3525,1866,1659,112.5
11250, 강동구,010005, 9세,2016,3573,1904,1669,114.1,3564,1900,1664,114.2
11250, 강동구,015,10~14세,2016,17619,9271,8348,111.1,17567,9245,8322,111.1
11250, 강동구,015001, 10세,2016,3274,1723,1551,111.1,3266,1718,1548,111
11250, 강동구,015002, 11세,2016,3152,1661,1491,111.4,3137,1654,1483,111.5
11250, 강동구,015003, 12세,2016,3622,1859,1763,105.4,3615,1855,1760,105.4
11250, 강동구,015004, 13세,2016,3722,1932,1790,107.9,3714,1929,1785,108.1
11250, 강동구,015005, 14세,2016,3849,2096,1753,119.6,3835,2089,1746,119.6
11250, 강동구,020,15~19세,2016,23623,12533,11090,113,23555,12498,11057,113
11250, 강동구,020001, 15세,2016,4356,2338,2018,115.9,4350,2335,2015,115.9
11250, 강동구,020002, 16세,2016,4760,2507,2253,111.3,4744,2497,2247,111.1
11250, 강동구,020003, 17세,2016,4906,2615,2291,114.1,4895,2610,2285,114.2
11250, 강동구,020004, 18세,2016,4939,2582,2357,109.5,4926,2574,2352,109.4
11250, 강동구,020005, 19세,2016,4662,2491,2171,114.7,4640,2482,2158,115
11250, 강동구,025,20~24세,2016,27666,14504,13162,110.2,27385,14386,12999,110.7
11250, 강동구,025001, 20세,2016,5035,2735,2300,118.9,5000,2718,2282,119.1
11250, 강동구,025002, 21세,2016,5498,3055,2443,125.1,5457,3037,2420,125.5
11250, 강동구,025003, 22세,2016,5366,2819,2547,110.7,5317,2796,2521,110.9
11250, 강동구,025004, 23세,2016,5722,2897,2825,102.5,5653,2867,2786,102.9
11250, 강동구,025005, 24세,2016,6045,2998,3047,98.4,5958,2968,2990,99.3
11250, 강동구,030,25~29세,2016,30335,15185,15150,100.2,29672,14871,14801,100.5
11250, 강동구,030001, 25세,2016,5995,2980,3015,98.8,5883,2930,2953,99.2
11250, 강동구,030002, 26세,2016,6043,3031,3012,100.6,5922,2982,2940,101.4
11250, 강동구,030003, 27세,2016,6001,3023,2978,101.5,5871,2960,2911,101.7
11250, 강동구,030004, 28세,2016,6168,3109,3059,101.6,6024,3035,2989,101.5
11250, 강동구,030005, 29세,2016,6128,3042,3086,98.6,5972,2964,3008,98.5
11250, 강동구,035,30~34세,2016,34027,17198,16829,102.2,33419,16915,16504,102.5
11250, 강동구,035001, 30세,2016,6168,3084,3084,100,6003,3002,3001,100
11250, 강동구,035002, 31세,2016,6448,3266,3182,102.6,6322,3206,3116,102.9
11250, 강동구,035003, 32세,2016,6650,3423,3227,106.1,6544,3371,3173,106.2
11250, 강동구,035004, 33세,2016,7137,3598,3539,101.7,7043,3558,3485,102.1
11250, 강동구,035005, 34세,2016,7624,3827,3797,100.8,7507,3778,3729,101.3
11250, 강동구,040,35~39세,2016,35175,17804,17371,102.5,34676,17545,17131,102.4
11250, 강동구,040001, 35세,2016,7572,3879,3693,105,7477,3834,3643,105.2
11250, 강동구,040002, 36세,2016,7638,3913,3725,105,7523,3851,3672,104.9
11250, 강동구,040003, 37세,2016,7154,3553,3601,98.7,7054,3500,3554,98.5
11250, 강동구,040004, 38세,2016,6362,3214,3148,102.1,6263,3157,3106,101.6
11250, 강동구,040005, 39세,2016,6449,3245,3204,101.3,6359,3203,3156,101.5
11250, 강동구,045,40~44세,2016,33731,16982,16749,101.4,33256,16744,16512,101.4
11250, 강동구,045001, 40세,2016,6270,3233,3037,106.5,6176,3185,2991,106.5
11250, 강동구,045002, 41세,2016,6319,3160,3159,100,6247,3124,3123,100
11250, 강동구,045003, 42세,2016,6897,3494,3403,102.7,6813,3454,3359,102.8
11250, 강동구,045004, 43세,2016,7018,3475,3543,98.1,6908,3420,3488,98.1
11250, 강동구,045005, 44세,2016,7227,3620,3607,100.4,7112,3561,3551,100.3
11250, 강동구,050,45~49세,2016,36871,18051,18820,95.9,36231,17751,18480,96.1
11250, 강동구,050001, 45세,2016,7506,3755,3751,100.1,7374,3694,3680,100.4
11250, 강동구,050002, 46세,2016,7473,3661,3812,96,7337,3593,3744,96
11250, 강동구,050003, 47세,2016,7482,3645,3837,95,7336,3570,3766,94.8
11250, 강동구,050004, 48세,2016,7592,3716,3876,95.9,7466,3657,3809,96
11250, 강동구,050005, 49세,2016,6818,3274,3544,92.4,6718,3237,3481,93
11250, 강동구,055,50~54세,2016,35655,17318,18337,94.4,34896,16981,17915,94.8
11250, 강동구,055001, 50세,2016,6726,3356,3370,99.6,6583,3308,3275,101
11250, 강동구,055002, 51세,2016,7014,3354,3660,91.6,6878,3284,3594,91.4
11250, 강동구,055003, 52세,2016,6968,3333,3635,91.7,6821,3270,3551,92.1
11250, 강동구,055004, 53세,2016,7274,3521,3753,93.8,7086,3434,3652,94
11250, 강동구,055005, 54세,2016,7673,3754,3919,95.8,7528,3685,3843,95.9
11250, 강동구,060,55~59세,2016,38818,18386,20432,90,38128,18077,20051,90.2
11250, 강동구,060001, 55세,2016,8199,3831,4368,87.7,8099,3796,4303,88.2
11250, 강동구,060002, 56세,2016,8342,3915,4427,88.4,8166,3823,4343,88
11250, 강동구,060003, 57세,2016,7717,3619,4098,88.3,7584,3568,4016,88.8
11250, 강동구,060004, 58세,2016,7315,3522,3793,92.9,7156,3449,3707,93
11250, 강동구,060005, 59세,2016,7245,3499,3746,93.4,7123,3441,3682,93.5
11250, 강동구,065,60~64세,2016,30284,14507,15777,92,29713,14230,15483,91.9
11250, 강동구,065001, 60세,2016,6808,3184,3624,87.9,6680,3126,3554,88
11250, 강동구,065002, 61세,2016,6927,3298,3629,90.9,6789,3228,3561,90.6
11250, 강동구,065003, 62세,2016,5871,2825,3046,92.7,5765,2776,2989,92.9
11250, 강동구,065004, 63세,2016,5175,2522,2653,95.1,5066,2466,2600,94.8
11250, 강동구,065005, 64세,2016,5503,2678,2825,94.8,5413,2634,2779,94.8
11250, 강동구,070,65~69세,2016,20135,10009,10126,98.8,19913,9894,10019,98.8
11250, 강동구,070001, 65세,2016,3769,1855,1914,96.9,3697,1809,1888,95.8
11250, 강동구,070002, 66세,2016,4169,2084,2085,100,4116,2059,2057,100.1
11250, 강동구,070003, 67세,2016,4234,2100,2134,98.4,4198,2082,2116,98.4
11250, 강동구,070004, 68세,2016,4086,2085,2001,104.2,4054,2069,1985,104.2
11250, 강동구,070005, 69세,2016,3877,1885,1992,94.6,3848,1875,1973,95
11250, 강동구,075,70~74세,2016,13556,6779,6777,100,13491,6751,6740,100.2
11250, 강동구,075001, 70세,2016,2903,1462,1441,101.5,2882,1450,1432,101.3
11250, 강동구,075002, 71세,2016,2706,1387,1319,105.2,2696,1383,1313,105.3
11250, 강동구,075003, 72세,2016,2674,1326,1348,98.4,2660,1320,1340,98.5
11250, 강동구,075004, 73세,2016,2522,1243,1279,97.2,2510,1239,1271,97.5
11250, 강동구,075005, 74세,2016,2751,1361,1390,97.9,2743,1359,1384,98.2
11250, 강동구,080,75~79세,2016,8783,3962,4821,82.2,8741,3946,4795,82.3
11250, 강동구,080001, 75세,2016,2213,1070,1143,93.6,2210,1069,1141,93.7
11250, 강동구,080002, 76세,2016,1823,845,978,86.4,1815,842,973,86.5
11250, 강동구,080003, 77세,2016,1802,808,994,81.3,1794,805,989,81.4
11250, 강동구,080004, 78세,2016,1527,675,852,79.2,1513,670,843,79.5
11250, 강동구,080005, 79세,2016,1418,564,854,66,1409,560,849,66
11250, 강동구,085,80~84세,2016,5125,1748,3377,51.8,5100,1744,3356,52
11250, 강동구,085001, 80세,2016,1261,492,769,64,1256,491,765,64.2
11250, 강동구,085002, 81세,2016,1223,407,816,49.9,1218,407,811,50.2
11250, 강동구,085003, 82세,2016,1031,333,698,47.7,1025,332,693,47.9
11250, 강동구,085004, 83세,2016,829,282,547,51.6,824,280,544,51.5
11250, 강동구,085005, 84세,2016,781,234,547,42.8,777,234,543,43.1
11250, 강동구,090,85~89세,2016,2652,663,1989,33.3,2648,661,1987,33.3
11250, 강동구,090001, 85세,2016,644,173,471,36.7,642,172,470,36.6
11250, 강동구,090002, 86세,2016,636,170,466,36.5,636,170,466,36.5
11250, 강동구,090003, 87세,2016,539,141,398,35.4,538,140,398,35.2
11250, 강동구,090004, 88세,2016,469,104,365,28.5,469,104,365,28.5
11250, 강동구,090005, 89세,2016,364,75,289,26,363,75,288,26
11250, 강동구,095,90~94세,2016,919,197,722,27.3,916,195,721,27
11250, 강동구,095001, 90세,2016,292,63,229,27.5,292,63,229,27.5
11250, 강동구,095002, 91세,2016,213,33,180,18.3,212,33,179,18.4
11250, 강동구,095003, 92세,2016,150,41,109,37.6,149,40,109,36.7
11250, 강동구,095004, 93세,2016,162,38,124,30.6,161,37,124,29.8
11250, 강동구,095005, 94세,2016,102,22,80,27.5,102,22,80,27.5
11250, 강동구,100,95~99세,2016,204,44,160,27.5,204,44,160,27.5
11250, 강동구,100001, 95세,2016,72,22,50,44,72,22,50,44
11250, 강동구,100002, 96세,2016,55,12,43,27.9,55,12,43,27.9
11250, 강동구,100003, 97세,2016,34,7,27,25.9,34,7,27,25.9
11250, 강동구,100004, 98세,2016,22,X,21,4.8,22,X,21,4.8
11250, 강동구,100005, 99세,2016,21,X,19,10.5,21,X,19,10.5
11250, 강동구,101,100세이상,2016,25,X,21,19,24,X,20,20
11250, 강동구,102,15세미만,2016,51832,27025,24807,108.9,51555,26876,24679,108.9
11250, 강동구,103,15~64세,2016,326185,162468,163717,99.2,320931,159998,160933,99.4
11250, 강동구,104,65세이상,2016,51399,23406,27993,83.6,51037,23239,27798,83.6
11250, 강동구,086,85세이상,2016,3800,908,2892,31.4,3792,904,2888,31.3
11250, 강동구,126,평균연령,2016,41.1,40.1,42.1,,41.1,40.1,42,
11250, 강동구,127,중위연령,2016,41.9,40.7,43.1,,41.9,40.6,43,
21,부산광역시,000,합계,2016,3440484,1694026,1746458,97,3394316,1667106,1727210,96.5
21,부산광역시,005,0~4세,2016,131709,67732,63977,105.9,131194,67473,63721,105.9
21,부산광역시,005001, 0세,2016,25172,12911,12261,105.3,25070,12861,12209,105.3
21,부산광역시,005002, 1세,2016,26288,13503,12785,105.6,26196,13456,12740,105.6
21,부산광역시,005003, 2세,2016,26043,13457,12586,106.9,25939,13406,12533,107
21,부산광역시,005004, 3세,2016,26051,13295,12756,104.2,25943,13238,12705,104.2
21,부산광역시,005005, 4세,2016,28155,14566,13589,107.2,28046,14512,13534,107.2
21,부산광역시,010,5~9세,2016,131323,67440,63883,105.6,130823,67179,63644,105.6
21,부산광역시,010001, 5세,2016,27684,14115,13569,104,27583,14057,13526,103.9
21,부산광역시,010002, 6세,2016,26062,13475,12587,107.1,25939,13418,12521,107.2
21,부산광역시,010003, 7세,2016,24935,12815,12120,105.7,24833,12765,12068,105.8
21,부산광역시,010004, 8세,2016,25971,13328,12643,105.4,25875,13274,12601,105.3
21,부산광역시,010005, 9세,2016,26671,13707,12964,105.7,26593,13665,12928,105.7
21,부산광역시,015,10~14세,2016,132615,68828,63787,107.9,132205,68629,63576,107.9
21,부산광역시,015001, 10세,2016,24363,12635,11728,107.7,24291,12603,11688,107.8
21,부산광역시,015002, 11세,2016,24488,12691,11797,107.6,24413,12655,11758,107.6
21,부산광역시,015003, 12세,2016,26928,13931,12997,107.2,26849,13889,12960,107.2
21,부산광역시,015004, 13세,2016,27946,14598,13348,109.4,27866,14556,13310,109.4
21,부산광역시,015005, 14세,2016,28890,14973,13917,107.6,28786,14926,13860,107.7
21,부산광역시,020,15~19세,2016,194712,101759,92953,109.5,192942,100929,92013,109.7
21,부산광역시,020001, 15세,2016,33525,17652,15873,111.2,33418,17586,15832,111.1
21,부산광역시,020002, 16세,2016,37222,19587,17635,111.1,37098,19519,17579,111
21,부산광역시,020003, 17세,2016,36593,19405,17188,112.9,36395,19309,17086,113
21,부산광역시,020004, 18세,2016,41198,21591,19607,110.1,40744,21378,19366,110.4
21,부산광역시,020005, 19세,2016,46174,23524,22650,103.9,45287,23137,22150,104.5
21,부산광역시,025,20~24세,2016,245825,130739,115086,113.6,237733,126904,110829,114.5
21,부산광역시,025001, 20세,2016,47455,24373,23082,105.6,46014,23809,22205,107.2
21,부산광역시,025002, 21세,2016,48176,25334,22842,110.9,46582,24693,21889,112.8
21,부산광역시,025003, 22세,2016,50054,27027,23027,117.4,48476,26275,22201,118.4
21,부산광역시,025004, 23세,2016,49861,26989,22872,118,48139,26117,22022,118.6
21,부산광역시,025005, 24세,2016,50279,27016,23263,116.1,48522,26010,22512,115.5
21,부산광역시,030,25~29세,2016,213370,111928,101442,110.3,204407,106383,98024,108.5
21,부산광역시,030001, 25세,2016,46457,24874,21583,115.2,44711,23828,20883,114.1
21,부산광역시,030002, 26세,2016,43768,23243,20525,113.2,41834,22085,19749,111.8
21,부산광역시,030003, 27세,2016,42525,22215,20310,109.4,40789,21119,19670,107.4
21,부산광역시,030004, 28세,2016,40268,20905,19363,108,38500,19804,18696,105.9
21,부산광역시,030005, 29세,2016,40352,20691,19661,105.2,38573,19547,19026,102.7
21,부산광역시,035,30~34세,2016,224194,115989,108205,107.2,216764,110921,105843,104.8
21,부산광역시,035001, 30세,2016,40387,21116,19271,109.6,38679,19993,18686,107
21,부산광역시,035002, 31세,2016,40957,21192,19765,107.2,39374,20101,19273,104.3
21,부산광역시,035003, 32세,2016,43000,22278,20722,107.5,41533,21258,20275,104.8
21,부산광역시,035004, 33세,2016,47628,24504,23124,106,46298,23606,22692,104
21,부산광역시,035005, 34세,2016,52222,26899,25323,106.2,50880,25963,24917,104.2
21,부산광역시,040,35~39세,2016,253126,130038,123088,105.6,248134,126590,121544,104.2
21,부산광역시,040001, 35세,2016,53673,27663,26010,106.4,52575,26908,25667,104.8
21,부산광역시,040002, 36세,2016,54890,28249,26641,106,53817,27499,26318,104.5
21,부산광역시,040003, 37세,2016,51433,26136,25297,103.3,50383,25409,24974,101.7
21,부산광역시,040004, 38세,2016,46594,24087,22507,107,45697,23468,22229,105.6
21,부산광역시,040005, 39세,2016,46536,23903,22633,105.6,45662,23306,22356,104.2
21,부산광역시,045,40~44세,2016,254784,128753,126031,102.2,250986,126276,124710,101.3
21,부산광역시,045001, 40세,2016,45238,23226,22012,105.5,44406,22662,21744,104.2
21,부산광역시,045002, 41세,2016,48697,24596,24101,102.1,47891,24042,23849,100.8
21,부산광역시,045003, 42세,2016,52621,26583,26038,102.1,51889,26117,25772,101.3
21,부산광역시,045004, 43세,2016,53781,26843,26938,99.6,53045,26389,26656,99
21,부산광역시,045005, 44세,2016,54447,27505,26942,102.1,53755,27066,26689,101.4
21,부산광역시,050,45~49세,2016,284928,138850,146078,95.1,281834,137103,144731,94.7
21,부산광역시,050001, 45세,2016,57604,28481,29123,97.8,56907,28058,28849,97.3
21,부산광역시,050002, 46세,2016,56900,28074,28826,97.4,56209,27695,28514,97.1
21,부산광역시,050003, 47세,2016,57299,27931,29368,95.1,56635,27559,29076,94.8
21,부산광역시,050004, 48세,2016,58192,28202,29990,94,57631,27898,29733,93.8
21,부산광역시,050005, 49세,2016,54933,26162,28771,90.9,54452,25893,28559,90.7
21,부산광역시,055,50~54세,2016,279576,135609,143967,94.2,277088,134359,142729,94.1
21,부산광역시,055001, 50세,2016,53754,26552,27202,97.6,53238,26280,26958,97.5
21,부산광역시,055002, 51세,2016,54438,26004,28434,91.5,53938,25751,28187,91.4
21,부산광역시,055003, 52세,2016,52287,25439,26848,94.8,51806,25204,26602,94.7
21,부산광역시,055004, 53세,2016,57601,27967,29634,94.4,57068,27697,29371,94.3
21,부산광역시,055005, 54세,2016,61496,29647,31849,93.1,61038,29427,31611,93.1
21,부산광역시,060,55~59세,2016,315908,150135,165773,90.6,314199,149308,164891,90.5
21,부산광역시,060001, 55세,2016,66975,31523,35452,88.9,66664,31370,35294,88.9
21,부산광역시,060002, 56세,2016,67528,31753,35775,88.8,67136,31573,35563,88.8
21,부산광역시,060003, 57세,2016,61487,29267,32220,90.8,61164,29112,32052,90.8
21,부산광역시,060004, 58세,2016,59825,28842,30983,93.1,59480,28682,30798,93.1
21,부산광역시,060005, 59세,2016,60093,28750,31343,91.7,59755,28571,31184,91.6
21,부산광역시,065,60~64세,2016,254676,121730,132946,91.6,253414,121093,132321,91.5
21,부산광역시,065001, 60세,2016,56300,26998,29302,92.1,56015,26853,29162,92.1
21,부산광역시,065002, 61세,2016,58601,27517,31084,88.5,58308,27365,30943,88.4
21,부산광역시,065003, 62세,2016,49252,24243,25009,96.9,48989,24100,24889,96.8
21,부산광역시,065004, 63세,2016,43829,20673,23156,89.3,43600,20566,23034,89.3
21,부산광역시,065005, 64세,2016,46694,22299,24395,91.4,46502,22209,24293,91.4
21,부산광역시,070,65~69세,2016,187551,88778,98773,89.9,186987,88491,98496,89.8
21,부산광역시,070001, 65세,2016,37612,17948,19664,91.3,37466,17876,19590,91.3
21,부산광역시,070002, 66세,2016,37984,18174,19810,91.7,37839,18108,19731,91.8
21,부산광역시,070003, 67세,2016,38886,18355,20531,89.4,38775,18295,20480,89.3
21,부산광역시,070004, 68세,2016,37624,17762,19862,89.4,37540,17718,19822,89.4
21,부산광역시,070005, 69세,2016,35445,16539,18906,87.5,35367,16494,18873,87.4
21,부산광역시,075,70~74세,2016,137409,63598,73811,86.2,137198,63487,73711,86.1
21,부산광역시,075001, 70세,2016,26485,12635,13850,91.2,26423,12596,13827,91.1
21,부산광역시,075002, 71세,2016,25971,12150,13821,87.9,25928,12128,13800,87.9
21,부산광역시,075003, 72세,2016,27185,12561,14624,85.9,27145,12544,14601,85.9
21,부산광역시,075004, 73세,2016,27844,12692,15152,83.8,27812,12677,15135,83.8
21,부산광역시,075005, 74세,2016,29924,13560,16364,82.9,29890,13542,16348,82.8
21,부산광역시,080,75~79세,2016,104388,43432,60956,71.3,104222,43369,60853,71.3
21,부산광역시,080001, 75세,2016,25054,10853,14201,76.4,25012,10835,14177,76.4
21,부산광역시,080002, 76세,2016,22646,9628,13018,74,22611,9619,12992,74
21,부산광역시,080003, 77세,2016,21568,8928,12640,70.6,21541,8913,12628,70.6
21,부산광역시,080004, 78세,2016,18187,7385,10802,68.4,18151,7376,10775,68.5
21,부산광역시,080005, 79세,2016,16933,6638,10295,64.5,16907,6626,10281,64.4
21,부산광역시,085,80~84세,2016,58478,20230,38248,52.9,58373,20189,38184,52.9
21,부산광역시,085001, 80세,2016,14812,5579,9233,60.4,14784,5566,9218,60.4
21,부산광역시,085002, 81세,2016,13694,4867,8827,55.1,13682,4862,8820,55.1
21,부산광역시,085003, 82세,2016,11596,3955,7641,51.8,11583,3949,7634,51.7
21,부산광역시,085004, 83세,2016,9656,3180,6476,49.1,9626,3171,6455,49.1
21,부산광역시,085005, 84세,2016,8720,2649,6071,43.6,8698,2641,6057,43.6
21,부산광역시,090,85~89세,2016,26094,6581,19513,33.7,26041,6561,19480,33.7
21,부산광역시,090001, 85세,2016,6846,1935,4911,39.4,6835,1929,4906,39.3
21,부산광역시,090002, 86세,2016,5941,1521,4420,34.4,5928,1515,4413,34.3
21,부산광역시,090003, 87세,2016,5309,1380,3929,35.1,5298,1376,3922,35.1
21,부산광역시,090004, 88세,2016,4456,995,3461,28.7,4444,994,3450,28.8
21,부산광역시,090005, 89세,2016,3542,750,2792,26.9,3536,747,2789,26.8
21,부산광역시,095,90~94세,2016,8080,1588,6492,24.5,8052,1582,6470,24.5
21,부산광역시,095001, 90세,2016,2401,484,1917,25.2,2395,482,1913,25.2
21,부산광역시,095002, 91세,2016,2095,383,1712,22.4,2088,382,1706,22.4
21,부산광역시,095003, 92세,2016,1394,283,1111,25.5,1392,283,1109,25.5
21,부산광역시,095004, 93세,2016,1320,264,1056,25,1311,263,1048,25.1
21,부산광역시,095005, 94세,2016,870,174,696,25,866,172,694,24.8
21,부산광역시,100,95~99세,2016,1560,274,1286,21.3,1548,268,1280,20.9
21,부산광역시,100001, 95세,2016,612,102,510,20,607,100,507,19.7
21,부산광역시,100002, 96세,2016,409,73,336,21.7,407,71,336,21.1
21,부산광역시,100003, 97세,2016,257,60,197,30.5,256,60,196,30.6
21,부산광역시,100004, 98세,2016,167,21,146,14.4,164,20,144,13.9
21,부산광역시,100005, 99세,2016,115,18,97,18.6,114,17,97,17.5
21,부산광역시,101,100세이상,2016,178,15,163,9.2,172,12,160,7.5
21,부산광역시,102,15세미만,2016,395647,204000,191647,106.4,394222,203281,190941,106.5
21,부산광역시,103,15~64세,2016,2521099,1265530,1255569,100.8,2477501,1239866,1237635,100.2
21,부산광역시,104,65세이상,2016,523738,224496,299242,75,522593,223959,298634,75
21,부산광역시,086,85세이상,2016,35912,8458,27454,30.8,35813,8423,27390,30.8
21,부산광역시,126,평균연령,2016,42.6,41.2,43.9,,42.7,41.3,44,
21,부산광역시,127,중위연령,2016,43.9,42.2,45.5,,44.1,42.5,45.7,
21004, 읍부,000,합계,2016,137257,67692,69565,97.3,135134,66171,68963,96
21004, 읍부,005,0~4세,2016,10278,5204,5074,102.6,10251,5193,5058,102.7
21004, 읍부,005001, 0세,2016,1858,914,944,96.8,1855,912,943,96.7
21004, 읍부,005002, 1세,2016,2064,1046,1018,102.8,2058,1043,1015,102.8
21004, 읍부,005003, 2세,2016,2089,1057,1032,102.4,2079,1053,1026,102.6
21004, 읍부,005004, 3세,2016,2106,1071,1035,103.5,2103,1071,1032,103.8
21004, 읍부,005005, 4세,2016,2161,1116,1045,106.8,2156,1114,1042,106.9
21004, 읍부,010,5~9세,2016,9171,4715,4456,105.8,9152,4704,4448,105.8
21004, 읍부,010001, 5세,2016,2098,1075,1023,105.1,2092,1071,1021,104.9
21004, 읍부,010002, 6세,2016,1881,953,928,102.7,1876,951,925,102.8
21004, 읍부,010003, 7세,2016,1712,858,854,100.5,1708,856,852,100.5
21004, 읍부,010004, 8세,2016,1726,907,819,110.7,1724,906,818,110.8
21004, 읍부,010005, 9세,2016,1754,922,832,110.8,1752,920,832,110.6
21004, 읍부,015,10~14세,2016,7261,3832,3429,111.8,7246,3823,3423,111.7
21004, 읍부,015001, 10세,2016,1436,743,693,107.2,1429,740,689,107.4
21004, 읍부,015002, 11세,2016,1440,771,669,115.2,1439,771,668,115.4
21004, 읍부,015003, 12세,2016,1515,809,706,114.6,1510,804,706,113.9
21004, 읍부,015004, 13세,2016,1434,754,680,110.9,1432,753,679,110.9
21004, 읍부,015005, 14세,2016,1436,755,681,110.9,1436,755,681,110.9
21004, 읍부,020,15~19세,2016,7078,3582,3496,102.5,7052,3566,3486,102.3
21004, 읍부,020001, 15세,2016,1465,768,697,110.2,1459,762,697,109.3
21004, 읍부,020002, 16세,2016,1607,755,852,88.6,1606,754,852,88.5
21004, 읍부,020003, 17세,2016,1464,700,764,91.6,1456,695,761,91.3
21004, 읍부,020004, 18세,2016,1400,693,707,98,1396,691,705,98
21004, 읍부,020005, 19세,2016,1142,666,476,139.9,1135,664,471,141
21004, 읍부,025,20~24세,2016,6067,3366,2701,124.6,5803,3170,2633,120.4
21004, 읍부,025001, 20세,2016,1182,685,497,137.8,1166,673,493,136.5
21004, 읍부,025002, 21세,2016,1225,701,524,133.8,1187,674,513,131.4
21004, 읍부,025003, 22세,2016,1209,663,546,121.4,1153,625,528,118.4
21004, 읍부,025004, 23세,2016,1213,651,562,115.8,1151,605,546,110.8
21004, 읍부,025005, 24세,2016,1238,666,572,116.4,1146,593,553,107.2
21004, 읍부,030,25~29세,2016,6620,3395,3225,105.3,6112,3002,3110,96.5
21004, 읍부,030001, 25세,2016,1289,669,620,107.9,1200,597,603,99
21004, 읍부,030002, 26세,2016,1248,679,569,119.3,1138,603,535,112.7
21004, 읍부,030003, 27세,2016,1253,648,605,107.1,1171,579,592,97.8
21004, 읍부,030004, 28세,2016,1397,721,676,106.7,1272,621,651,95.4
21004, 읍부,030005, 29세,2016,1433,678,755,89.8,1331,602,729,82.6
21004, 읍부,035,30~34세,2016,11144,5433,5711,95.1,10684,5080,5604,90.6
21004, 읍부,035001, 30세,2016,1638,763,875,87.2,1540,687,853,80.5
21004, 읍부,035002, 31세,2016,1818,909,909,100,1720,834,886,94.1
21004, 읍부,035003, 32세,2016,2182,1080,1102,98,2084,1005,1079,93.1
21004, 읍부,035004, 33세,2016,2484,1187,1297,91.5,2404,1121,1283,87.4
21004, 읍부,035005, 34세,2016,3022,1494,1528,97.8,2936,1433,1503,95.3
21004, 읍부,040,35~39세,2016,15199,7648,7551,101.3,14916,7430,7486,99.3
21004, 읍부,040001, 35세,2016,3125,1548,1577,98.2,3052,1492,1560,95.6
21004, 읍부,040002, 36세,2016,3369,1662,1707,97.4,3310,1615,1695,95.3
21004, 읍부,040003, 37세,2016,3113,1583,1530,103.5,3052,1533,1519,100.9
21004, 읍부,040004, 38세,2016,2832,1415,1417,99.9,2781,1379,1402,98.4
21004, 읍부,040005, 39세,2016,2760,1440,1320,109.1,2721,1411,1310,107.7
21004, 읍부,045,40~44세,2016,13197,6726,6471,103.9,13021,6606,6415,103
21004, 읍부,045001, 40세,2016,2636,1334,1302,102.5,2604,1308,1296,100.9
21004, 읍부,045002, 41세,2016,2666,1356,1310,103.5,2633,1335,1298,102.9
21004, 읍부,045003, 42세,2016,2716,1371,1345,101.9,2674,1346,1328,101.4
21004, 읍부,045004, 43세,2016,2638,1328,1310,101.4,2595,1297,1298,99.9
21004, 읍부,045005, 44세,2016,2541,1337,1204,111,2515,1320,1195,110.5
21004, 읍부,050,45~49세,2016,10708,5580,5128,108.8,10572,5503,5069,108.6
21004, 읍부,050001, 45세,2016,2469,1321,1148,115.1,2430,1297,1133,114.5
21004, 읍부,050002, 46세,2016,2269,1199,1070,112.1,2233,1184,1049,112.9
21004, 읍부,050003, 47세,2016,2186,1115,1071,104.1,2156,1097,1059,103.6
21004, 읍부,050004, 48세,2016,1976,1010,966,104.6,1958,998,960,104
21004, 읍부,050005, 49세,2016,1808,935,873,107.1,1795,927,868,106.8
21004, 읍부,055,50~54세,2016,8193,4103,4090,100.3,8126,4065,4061,100.1
21004, 읍부,055001, 50세,2016,1675,900,775,116.1,1653,887,766,115.8
21004, 읍부,055002, 51세,2016,1620,790,830,95.2,1607,782,825,94.8
21004, 읍부,055003, 52세,2016,1566,824,742,111.1,1560,821,739,111.1
21004, 읍부,055004, 53세,2016,1614,772,842,91.7,1597,762,835,91.3
21004, 읍부,055005, 54세,2016,1718,817,901,90.7,1709,813,896,90.7
21004, 읍부,060,55~59세,2016,8689,4031,4658,86.5,8640,4009,4631,86.6
21004, 읍부,060001, 55세,2016,1777,834,943,88.4,1768,828,940,88.1
21004, 읍부,060002, 56세,2016,1836,865,971,89.1,1825,860,965,89.1
21004, 읍부,060003, 57세,2016,1764,824,940,87.7,1756,823,933,88.2
21004, 읍부,060004, 58세,2016,1595,747,848,88.1,1583,741,842,88
21004, 읍부,060005, 59세,2016,1717,761,956,79.6,1708,757,951,79.6
21004, 읍부,065,60~64세,2016,7294,3345,3949,84.7,7243,3312,3931,84.3
21004, 읍부,065001, 60세,2016,1556,717,839,85.5,1542,709,833,85.1
21004, 읍부,065002, 61세,2016,1635,743,892,83.3,1629,739,890,83
21004, 읍부,065003, 62세,2016,1424,664,760,87.4,1409,653,756,86.4
21004, 읍부,065004, 63세,2016,1301,584,717,81.5,1296,581,715,81.3
21004, 읍부,065005, 64세,2016,1378,637,741,86,1367,630,737,85.5
21004, 읍부,070,65~69세,2016,5531,2603,2928,88.9,5511,2591,2920,88.7
21004, 읍부,070001, 65세,2016,1077,507,570,88.9,1075,506,569,88.9
21004, 읍부,070002, 66세,2016,1099,498,601,82.9,1093,495,598,82.8
21004, 읍부,070003, 67세,2016,1150,541,609,88.8,1144,537,607,88.5
21004, 읍부,070004, 68세,2016,1141,545,596,91.4,1138,543,595,91.3
21004, 읍부,070005, 69세,2016,1064,512,552,92.8,1061,510,551,92.6
21004, 읍부,075,70~74세,2016,4192,1865,2327,80.1,4180,1857,2323,79.9
21004, 읍부,075001, 70세,2016,803,364,439,82.9,796,359,437,82.2
21004, 읍부,075002, 71세,2016,788,344,444,77.5,787,343,444,77.3
21004, 읍부,075003, 72세,2016,891,393,498,78.9,888,392,496,79
21004, 읍부,075004, 73세,2016,827,378,449,84.2,826,377,449,84
21004, 읍부,075005, 74세,2016,883,386,497,77.7,883,386,497,77.7
21004, 읍부,080,75~79세,2016,3237,1276,1961,65.1,3236,1276,1960,65.1
21004, 읍부,080001, 75세,2016,729,300,429,69.9,728,300,428,70.1
21004, 읍부,080002, 76세,2016,699,285,414,68.8,699,285,414,68.8
21004, 읍부,080003, 77세,2016,703,278,425,65.4,703,278,425,65.4
21004, 읍부,080004, 78세,2016,574,223,351,63.5,574,223,351,63.5
21004, 읍부,080005, 79세,2016,532,190,342,55.6,532,190,342,55.6
21004, 읍부,085,80~84세,2016,2000,689,1311,52.6,1997,688,1309,52.6
21004, 읍부,085001, 80세,2016,474,173,301,57.5,473,173,300,57.7
21004, 읍부,085002, 81세,2016,451,170,281,60.5,451,170,281,60.5
21004, 읍부,085003, 82세,2016,415,130,285,45.6,415,130,285,45.6
21004, 읍부,085004, 83세,2016,348,112,236,47.5,347,112,235,47.7
21004, 읍부,085005, 84세,2016,312,104,208,50,311,103,208,49.5
21004, 읍부,090,85~89세,2016,975,232,743,31.2,973,230,743,31
21004, 읍부,090001, 85세,2016,272,82,190,43.2,270,80,190,42.1
21004, 읍부,090002, 86세,2016,221,55,166,33.1,221,55,166,33.1
21004, 읍부,090003, 87세,2016,190,41,149,27.5,190,41,149,27.5
21004, 읍부,090004, 88세,2016,156,35,121,28.9,156,35,121,28.9
21004, 읍부,090005, 89세,2016,136,19,117,16.2,136,19,117,16.2
21004, 읍부,095,90~94세,2016,333,56,277,20.2,331,56,275,20.4
21004, 읍부,095001, 90세,2016,88,14,74,18.9,88,14,74,18.9
21004, 읍부,095002, 91세,2016,96,15,81,18.5,95,15,80,18.8
21004, 읍부,095003, 92세,2016,45,7,38,18.4,44,7,37,18.9
21004, 읍부,095004, 93세,2016,58,9,49,18.4,58,9,49,18.4
21004, 읍부,095005, 94세,2016,46,11,35,31.4,46,11,35,31.4
21004, 읍부,100,95~99세,2016,79,11,68,16.2,78,10,68,14.7
21004, 읍부,100001, 95세,2016,32,X,29,10.3,32,X,29,10.3
21004, 읍부,100002, 96세,2016,18,X,15,20,17,X,15,13.3
21004, 읍부,100003, 97세,2016,14,X,10,40,14,X,10,40
21004, 읍부,100004, 98세,2016,12,X,11,9.1,12,X,11,9.1
21004, 읍부,100005, 99세,2016,X,X,X,0,X,X,X,0
21004, 읍부,101,100세이상,2016,11,X,11,0,10,X,10,0
21004, 읍부,102,15세미만,2016,26710,13751,12959,106.1,26649,13720,12929,106.1
21004, 읍부,103,15~64세,2016,94189,47209,46980,100.5,92169,45743,46426,98.5
21004, 읍부,104,65세이상,2016,16358,6732,9626,69.9,16316,6708,9608,69.8
21004, 읍부,086,85세이상,2016,1398,299,1099,27.2,1392,296,1096,27
21004, 읍부,126,평균연령,2016,38.1,36.8,39.4,,38.2,36.9,39.4,
21004, 읍부,127,중위연령,2016,38.5,37.7,39.3,,38.7,37.9,39.4,
21005, 면부,000,합계,2016,16834,8466,8368,101.2,16558,8284,8274,100.1
21005, 면부,005,0~4세,2016,589,324,265,122.3,589,324,265,122.3
21005, 면부,005001, 0세,2016,129,66,63,104.8,129,66,63,104.8
21005, 면부,005002, 1세,2016,114,68,46,147.8,114,68,46,147.8
21005, 면부,005003, 2세,2016,131,73,58,125.9,131,73,58,125.9
21005, 면부,005004, 3세,2016,112,61,51,119.6,112,61,51,119.6
21005, 면부,005005, 4세,2016,103,56,47,119.1,103,56,47,119.1
21005, 면부,010,5~9세,2016,461,225,236,95.3,461,225,236,95.3
21005, 면부,010001, 5세,2016,113,55,58,94.8,113,55,58,94.8
21005, 면부,010002, 6세,2016,104,57,47,121.3,104,57,47,121.3
21005, 면부,010003, 7세,2016,82,44,38,115.8,82,44,38,115.8
21005, 면부,010004, 8세,2016,92,36,56,64.3,92,36,56,64.3
21005, 면부,010005, 9세,2016,70,33,37,89.2,70,33,37,89.2
21005, 면부,015,10~14세,2016,411,227,184,123.4,410,227,183,124
21005, 면부,015001, 10세,2016,89,45,44,102.3,89,45,44,102.3
21005, 면부,015002, 11세,2016,75,40,35,114.3,74,40,34,117.6
21005, 면부,015003, 12세,2016,82,50,32,156.3,82,50,32,156.3
21005, 면부,015004, 13세,2016,77,38,39,97.4,77,38,39,97.4
21005, 면부,015005, 14세,2016,88,54,34,158.8,88,54,34,158.8
21005, 면부,020,15~19세,2016,578,347,231,150.2,577,346,231,149.8
21005, 면부,020001, 15세,2016,89,57,32,178.1,89,57,32,178.1
21005, 면부,020002, 16세,2016,99,64,35,182.9,99,64,35,182.9
21005, 면부,020003, 17세,2016,125,74,51,145.1,124,73,51,143.1
21005, 면부,020004, 18세,2016,146,88,58,151.7,146,88,58,151.7
21005, 면부,020005, 19세,2016,119,64,55,116.4,119,64,55,116.4
21005, 면부,025,20~24세,2016,922,554,368,150.5,885,536,349,153.6
21005, 면부,025001, 20세,2016,155,96,59,162.7,151,93,58,160.3
21005, 면부,025002, 21세,2016,167,107,60,178.3,163,104,59,176.3
21005, 면부,025003, 22세,2016,205,121,84,144,199,117,82,142.7
21005, 면부,025004, 23세,2016,197,119,78,152.6,189,117,72,162.5
21005, 면부,025005, 24세,2016,198,111,87,127.6,183,105,78,134.6
21005, 면부,030,25~29세,2016,917,511,406,125.9,867,476,391,121.7
21005, 면부,030001, 25세,2016,197,110,87,126.4,187,104,83,125.3
21005, 면부,030002, 26세,2016,181,103,78,132.1,172,98,74,132.4
21005, 면부,030003, 27세,2016,180,105,75,140,170,98,72,136.1
21005, 면부,030004, 28세,2016,194,106,88,120.5,184,97,87,111.5
21005, 면부,030005, 29세,2016,165,87,78,111.5,154,79,75,105.3
21005, 면부,035,30~34세,2016,1004,562,442,127.1,936,514,422,121.8
21005, 면부,035001, 30세,2016,195,95,100,95,180,90,90,100
21005, 면부,035002, 31세,2016,191,103,88,117,179,92,87,105.7
21005, 면부,035003, 32세,2016,198,113,85,132.9,180,99,81,122.2
21005, 면부,035004, 33세,2016,223,135,88,153.4,210,125,85,147.1
21005, 면부,035005, 34세,2016,197,116,81,143.2,187,108,79,136.7
21005, 면부,040,35~39세,2016,1017,554,463,119.7,972,516,456,113.2
21005, 면부,040001, 35세,2016,235,122,113,108,220,108,112,96.4
21005, 면부,040002, 36세,2016,231,132,99,133.3,216,120,96,125
21005, 면부,040003, 37세,2016,198,98,100,98,191,93,98,94.9
21005, 면부,040004, 38세,2016,169,94,75,125.3,163,89,74,120.3
21005, 면부,040005, 39세,2016,184,108,76,142.1,182,106,76,139.5
21005, 면부,045,40~44세,2016,997,583,414,140.8,984,573,411,139.4
21005, 면부,045001, 40세,2016,197,129,68,189.7,194,127,67,189.6
21005, 면부,045002, 41세,2016,200,123,77,159.7,195,119,76,156.6
21005, 면부,045003, 42세,2016,194,111,83,133.7,192,109,83,131.3
21005, 면부,045004, 43세,2016,205,117,88,133,203,116,87,133.3
21005, 면부,045005, 44세,2016,201,103,98,105.1,200,102,98,104.1
21005, 면부,050,45~49세,2016,1148,599,549,109.1,1130,587,543,108.1
21005, 면부,050001, 45세,2016,219,123,96,128.1,212,120,92,130.4
21005, 면부,050002, 46세,2016,235,107,128,83.6,232,104,128,81.3
21005, 면부,050003, 47세,2016,217,121,96,126,214,118,96,122.9
21005, 면부,050004, 48세,2016,233,133,100,133,230,131,99,132.3
21005, 면부,050005, 49세,2016,244,115,129,89.1,242,114,128,89.1
21005, 면부,055,50~54세,2016,1380,664,716,92.7,1359,654,705,92.8
21005, 면부,055001, 50세,2016,251,123,128,96.1,248,122,126,96.8
21005, 면부,055002, 51세,2016,245,120,125,96,241,117,124,94.4
21005, 면부,055003, 52세,2016,251,117,134,87.3,246,116,130,89.2
21005, 면부,055004, 53세,2016,306,142,164,86.6,301,140,161,87
21005, 면부,055005, 54세,2016,327,162,165,98.2,323,159,164,97
21005, 면부,060,55~59세,2016,1769,826,943,87.6,1758,820,938,87.4
21005, 면부,060001, 55세,2016,352,167,185,90.3,351,166,185,89.7
21005, 면부,060002, 56세,2016,363,182,181,100.6,360,181,179,101.1
21005, 면부,060003, 57세,2016,325,132,193,68.4,321,130,191,68.1
21005, 면부,060004, 58세,2016,354,166,188,88.3,352,164,188,87.2
21005, 면부,060005, 59세,2016,375,179,196,91.3,374,179,195,91.8
21005, 면부,065,60~64세,2016,1593,753,840,89.6,1588,751,837,89.7
21005, 면부,065001, 60세,2016,353,159,194,82,353,159,194,82
21005, 면부,065002, 61세,2016,354,179,175,102.3,352,178,174,102.3
21005, 면부,065003, 62세,2016,322,156,166,94,322,156,166,94
21005, 면부,065004, 63세,2016,259,116,143,81.1,257,116,141,82.3
21005, 면부,065005, 64세,2016,305,143,162,88.3,304,142,162,87.7
21005, 면부,070,65~69세,2016,1389,677,712,95.1,1385,675,710,95.1
21005, 면부,070001, 65세,2016,301,147,154,95.5,298,146,152,96.1
21005, 면부,070002, 66세,2016,249,124,125,99.2,249,124,125,99.2
21005, 면부,070003, 67세,2016,293,151,142,106.3,292,150,142,105.6
21005, 면부,070004, 68세,2016,272,127,145,87.6,272,127,145,87.6
21005, 면부,070005, 69세,2016,274,128,146,87.7,274,128,146,87.7
21005, 면부,075,70~74세,2016,1024,492,532,92.5,1022,492,530,92.8
21005, 면부,075001, 70세,2016,192,92,100,92,192,92,100,92
21005, 면부,075002, 71세,2016,195,98,97,101,194,98,96,102.1
21005, 면부,075003, 72세,2016,204,108,96,112.5,203,108,95,113.7
21005, 면부,075004, 73세,2016,216,104,112,92.9,216,104,112,92.9
21005, 면부,075005, 74세,2016,217,90,127,70.9,217,90,127,70.9
21005, 면부,080,75~79세,2016,824,339,485,69.9,824,339,485,69.9
21005, 면부,080001, 75세,2016,180,77,103,74.8,180,77,103,74.8
21005, 면부,080002, 76세,2016,175,65,110,59.1,175,65,110,59.1
21005, 면부,080003, 77세,2016,162,67,95,70.5,162,67,95,70.5
21005, 면부,080004, 78세,2016,160,68,92,73.9,160,68,92,73.9
21005, 면부,080005, 79세,2016,147,62,85,72.9,147,62,85,72.9
21005, 면부,085,80~84세,2016,488,155,333,46.5,488,155,333,46.5
21005, 면부,085001, 80세,2016,122,50,72,69.4,122,50,72,69.4
21005, 면부,085002, 81세,2016,101,27,74,36.5,101,27,74,36.5
21005, 면부,085003, 82세,2016,104,21,83,25.3,104,21,83,25.3
21005, 면부,085004, 83세,2016,76,26,50,52,76,26,50,52
21005, 면부,085005, 84세,2016,85,31,54,57.4,85,31,54,57.4
21005, 면부,090,85~89세,2016,227,62,165,37.6,227,62,165,37.6
21005, 면부,090001, 85세,2016,59,18,41,43.9,59,18,41,43.9
21005, 면부,090002, 86세,2016,50,7,43,16.3,50,7,43,16.3
21005, 면부,090003, 87세,2016,42,10,32,31.3,42,10,32,31.3
21005, 면부,090004, 88세,2016,54,20,34,58.8,54,20,34,58.8
21005, 면부,090005, 89세,2016,22,7,15,46.7,22,7,15,46.7
21005, 면부,095,90~94세,2016,75,9,66,13.6,75,9,66,13.6
21005, 면부,095001, 90세,2016,18,X,17,5.9,18,X,17,5.9
21005, 면부,095002, 91세,2016,17,X,16,6.3,17,X,16,6.3
21005, 면부,095003, 92세,2016,15,X,13,15.4,15,X,13,15.4
21005, 면부,095004, 93세,2016,16,X,12,33.3,16,X,12,33.3
21005, 면부,095005, 94세,2016,9,X,8,12.5,9,X,8,12.5
21005, 면부,100,95~99세,2016,20,X,17,17.6,20,X,17,17.6
21005, 면부,100001, 95세,2016,8,X,6,33.3,8,X,6,33.3
21005, 면부,100002, 96세,2016,X,X,X,0,X,X,X,0
21005, 면부,100003, 97세,2016,X,X,X,0,X,X,X,0
21005, 면부,100004, 98세,2016,6,X,6,0,6,X,6,0
21005, 면부,100005, 99세,2016,X,X,X,,X,X,X,
21005, 면부,101,100세이상,2016,X,X,X,0,X,X,X,0
21005, 면부,102,15세미만,2016,1461,776,685,113.3,1460,776,684,113.5
21005, 면부,103,15~64세,2016,11325,5953,5372,110.8,11056,5773,5283,109.3
21005, 면부,104,65세이상,2016,4048,1737,2311,75.2,4042,1735,2307,75.2
21005, 면부,086,85세이상,2016,323,74,249,29.7,323,74,249,29.7
21005, 면부,126,평균연령,2016,48,45.6,50.4,,48.2,45.9,50.6,
21005, 면부,127,중위연령,2016,51.5,48,54.5,,51.9,48.5,54.7,
21003, 동부,000,합계,2016,3286393,1617868,1668525,97,3242624,1592651,1649973,96.5
21003, 동부,005,0~4세,2016,120842,62204,58638,106.1,120354,61956,58398,106.1
21003, 동부,005001, 0세,2016,23185,11931,11254,106,23086,11883,11203,106.1
21003, 동부,005002, 1세,2016,24110,12389,11721,105.7,24024,12345,11679,105.7
21003, 동부,005003, 2세,2016,23823,12327,11496,107.2,23729,12280,11449,107.3
21003, 동부,005004, 3세,2016,23833,12163,11670,104.2,23728,12106,11622,104.2
21003, 동부,005005, 4세,2016,25891,13394,12497,107.2,25787,13342,12445,107.2
21003, 동부,010,5~9세,2016,121691,62500,59191,105.6,121210,62250,58960,105.6
21003, 동부,010001, 5세,2016,25473,12985,12488,104,25378,12931,12447,103.9
21003, 동부,010002, 6세,2016,24077,12465,11612,107.3,23959,12410,11549,107.5
21003, 동부,010003, 7세,2016,23141,11913,11228,106.1,23043,11865,11178,106.1
21003, 동부,010004, 8세,2016,24153,12385,11768,105.2,24059,12332,11727,105.2
21003, 동부,010005, 9세,2016,24847,12752,12095,105.4,24771,12712,12059,105.4
21003, 동부,015,10~14세,2016,124943,64769,60174,107.6,124549,64579,59970,107.7
21003, 동부,015001, 10세,2016,22838,11847,10991,107.8,22773,11818,10955,107.9
21003, 동부,015002, 11세,2016,22973,11880,11093,107.1,22900,11844,11056,107.1
21003, 동부,015003, 12세,2016,25331,13072,12259,106.6,25257,13035,12222,106.7
21003, 동부,015004, 13세,2016,26435,13806,12629,109.3,26357,13765,12592,109.3
21003, 동부,015005, 14세,2016,27366,14164,13202,107.3,27262,14117,13145,107.4
21003, 동부,020,15~19세,2016,187056,97830,89226,109.6,185313,97017,88296,109.9
21003, 동부,020001, 15세,2016,31971,16827,15144,111.1,31870,16767,15103,111
21003, 동부,020002, 16세,2016,35516,18768,16748,112.1,35393,18701,16692,112
21003, 동부,020003, 17세,2016,35004,18631,16373,113.8,34815,18541,16274,113.9
21003, 동부,020004, 18세,2016,39652,20810,18842,110.4,39202,20599,18603,110.7
21003, 동부,020005, 19세,2016,44913,22794,22119,103.1,44033,22409,21624,103.6
21003, 동부,025,20~24세,2016,238836,126819,112017,113.2,231045,123198,107847,114.2
21003, 동부,025001, 20세,2016,46118,23592,22526,104.7,44697,23043,21654,106.4
21003, 동부,025002, 21세,2016,46784,24526,22258,110.2,45232,23915,21317,112.2
21003, 동부,025003, 22세,2016,48640,26243,22397,117.2,47124,25533,21591,118.3
21003, 동부,025004, 23세,2016,48451,26219,22232,117.9,46799,25395,21404,118.6
21003, 동부,025005, 24세,2016,48843,26239,22604,116.1,47193,25312,21881,115.7
21003, 동부,030,25~29세,2016,205833,108022,97811,110.4,197428,102905,94523,108.9
21003, 동부,030001, 25세,2016,44971,24095,20876,115.4,43324,23127,20197,114.5
21003, 동부,030002, 26세,2016,42339,22461,19878,113,40524,21384,19140,111.7
21003, 동부,030003, 27세,2016,41092,21462,19630,109.3,39448,20442,19006,107.6
21003, 동부,030004, 28세,2016,38677,20078,18599,108,37044,19086,17958,106.3
21003, 동부,030005, 29세,2016,38754,19926,18828,105.8,37088,18866,18222,103.5
21003, 동부,035,30~34세,2016,212046,109994,102052,107.8,205144,105327,99817,105.5
21003, 동부,035001, 30세,2016,38554,20258,18296,110.7,36959,19216,17743,108.3
21003, 동부,035002, 31세,2016,38948,20180,18768,107.5,37475,19175,18300,104.8
21003, 동부,035003, 32세,2016,40620,21085,19535,107.9,39269,20154,19115,105.4
21003, 동부,035004, 33세,2016,44921,23182,21739,106.6,43684,22360,21324,104.9
21003, 동부,035005, 34세,2016,49003,25289,23714,106.6,47757,24422,23335,104.7
21003, 동부,040,35~39세,2016,236910,121836,115074,105.9,232246,118644,113602,104.4
21003, 동부,040001, 35세,2016,50313,25993,24320,106.9,49303,25308,23995,105.5
21003, 동부,040002, 36세,2016,51290,26455,24835,106.5,50291,25764,24527,105
21003, 동부,040003, 37세,2016,48122,24455,23667,103.3,47140,23783,23357,101.8
21003, 동부,040004, 38세,2016,43593,22578,21015,107.4,42753,22000,20753,106
21003, 동부,040005, 39세,2016,43592,22355,21237,105.3,42759,21789,20970,103.9
21003, 동부,045,40~44세,2016,240590,121444,119146,101.9,236981,119097,117884,101
21003, 동부,045001, 40세,2016,42405,21763,20642,105.4,41608,21227,20381,104.2
21003, 동부,045002, 41세,2016,45831,23117,22714,101.8,45063,22588,22475,100.5
21003, 동부,045003, 42세,2016,49711,25101,24610,102,49023,24662,24361,101.2
21003, 동부,045004, 43세,2016,50938,25398,25540,99.4,50247,24976,25271,98.8
21003, 동부,045005, 44세,2016,51705,26065,25640,101.7,51040,25644,25396,101
21003, 동부,050,45~49세,2016,273072,132671,140401,94.5,270132,131013,139119,94.2
21003, 동부,050001, 45세,2016,54916,27037,27879,97,54265,26641,27624,96.4
21003, 동부,050002, 46세,2016,54396,26768,27628,96.9,53744,26407,27337,96.6
21003, 동부,050003, 47세,2016,54896,26695,28201,94.7,54265,26344,27921,94.4
21003, 동부,050004, 48세,2016,55983,27059,28924,93.6,55443,26769,28674,93.4
21003, 동부,050005, 49세,2016,52881,25112,27769,90.4,52415,24852,27563,90.2
21003, 동부,055,50~54세,2016,270003,130842,139161,94,267603,129640,137963,94
21003, 동부,055001, 50세,2016,51828,25529,26299,97.1,51337,25271,26066,97
21003, 동부,055002, 51세,2016,52573,25094,27479,91.3,52090,24852,27238,91.2
21003, 동부,055003, 52세,2016,50470,24498,25972,94.3,50000,24267,25733,94.3
21003, 동부,055004, 53세,2016,55681,27053,28628,94.5,55170,26795,28375,94.4
21003, 동부,055005, 54세,2016,59451,28668,30783,93.1,59006,28455,30551,93.1
21003, 동부,060,55~59세,2016,305450,145278,160172,90.7,303801,144479,159322,90.7
21003, 동부,060001, 55세,2016,64846,30522,34324,88.9,64545,30376,34169,88.9
21003, 동부,060002, 56세,2016,65329,30706,34623,88.7,64951,30532,34419,88.7
21003, 동부,060003, 57세,2016,59398,28311,31087,91.1,59087,28159,30928,91
21003, 동부,060004, 58세,2016,57876,27929,29947,93.3,57545,27777,29768,93.3
21003, 동부,060005, 59세,2016,58001,27810,30191,92.1,57673,27635,30038,92
21003, 동부,065,60~64세,2016,245789,117632,128157,91.8,244583,117030,127553,91.8
21003, 동부,065001, 60세,2016,54391,26122,28269,92.4,54120,25985,28135,92.4
21003, 동부,065002, 61세,2016,56612,26595,30017,88.6,56327,26448,29879,88.5
21003, 동부,065003, 62세,2016,47506,23423,24083,97.3,47258,23291,23967,97.2
21003, 동부,065004, 63세,2016,42269,19973,22296,89.6,42047,19869,22178,89.6
21003, 동부,065005, 64세,2016,45011,21519,23492,91.6,44831,21437,23394,91.6
21003, 동부,070,65~69세,2016,180631,85498,95133,89.9,180091,85225,94866,89.8
21003, 동부,070001, 65세,2016,36234,17294,18940,91.3,36093,17224,18869,91.3
21003, 동부,070002, 66세,2016,36636,17552,19084,92,36497,17489,19008,92
21003, 동부,070003, 67세,2016,37443,17663,19780,89.3,37339,17608,19731,89.2
21003, 동부,070004, 68세,2016,36211,17090,19121,89.4,36130,17048,19082,89.3
21003, 동부,070005, 69세,2016,34107,15899,18208,87.3,34032,15856,18176,87.2
21003, 동부,075,70~74세,2016,132193,61241,70952,86.3,131996,61138,70858,86.3
21003, 동부,075001, 70세,2016,25490,12179,13311,91.5,25435,12145,13290,91.4
21003, 동부,075002, 71세,2016,24988,11708,13280,88.2,24947,11687,13260,88.1
21003, 동부,075003, 72세,2016,26090,12060,14030,86,26054,12044,14010,86
21003, 동부,075004, 73세,2016,26801,12210,14591,83.7,26770,12196,14574,83.7
21003, 동부,075005, 74세,2016,28824,13084,15740,83.1,28790,13066,15724,83.1
21003, 동부,080,75~79세,2016,100327,41817,58510,71.5,100162,41754,58408,71.5
21003, 동부,080001, 75세,2016,24145,10476,13669,76.6,24104,10458,13646,76.6
21003, 동부,080002, 76세,2016,21772,9278,12494,74.3,21737,9269,12468,74.3
21003, 동부,080003, 77세,2016,20703,8583,12120,70.8,20676,8568,12108,70.8
21003, 동부,080004, 78세,2016,17453,7094,10359,68.5,17417,7085,10332,68.6
21003, 동부,080005, 79세,2016,16254,6386,9868,64.7,16228,6374,9854,64.7
21003, 동부,085,80~84세,2016,55990,19386,36604,53,55888,19346,36542,52.9
21003, 동부,085001, 80세,2016,14216,5356,8860,60.5,14189,5343,8846,60.4
21003, 동부,085002, 81세,2016,13142,4670,8472,55.1,13130,4665,8465,55.1
21003, 동부,085003, 82세,2016,11077,3804,7273,52.3,11064,3798,7266,52.3
21003, 동부,085004, 83세,2016,9232,3042,6190,49.1,9203,3033,6170,49.2
21003, 동부,085005, 84세,2016,8323,2514,5809,43.3,8302,2507,5795,43.3
21003, 동부,090,85~89세,2016,24892,6287,18605,33.8,24841,6269,18572,33.8
21003, 동부,090001, 85세,2016,6515,1835,4680,39.2,6506,1831,4675,39.2
21003, 동부,090002, 86세,2016,5670,1459,4211,34.6,5657,1453,4204,34.6
21003, 동부,090003, 87세,2016,5077,1329,3748,35.5,5066,1325,3741,35.4
21003, 동부,090004, 88세,2016,4246,940,3306,28.4,4234,939,3295,28.5
21003, 동부,090005, 89세,2016,3384,724,2660,27.2,3378,721,2657,27.1
21003, 동부,095,90~94세,2016,7672,1523,6149,24.8,7646,1517,6129,24.8
21003, 동부,095001, 90세,2016,2295,469,1826,25.7,2289,467,1822,25.6
21003, 동부,095002, 91세,2016,1982,367,1615,22.7,1976,366,1610,22.7
21003, 동부,095003, 92세,2016,1334,274,1060,25.8,1333,274,1059,25.9
21003, 동부,095004, 93세,2016,1246,251,995,25.2,1237,250,987,25.3
21003, 동부,095005, 94세,2016,815,162,653,24.8,811,160,651,24.6
21003, 동부,100,95~99세,2016,1461,260,1201,21.6,1450,255,1195,21.3
21003, 동부,100001, 95세,2016,572,97,475,20.4,567,95,472,20.1
21003, 동부,100002, 96세,2016,387,70,317,22.1,386,69,317,21.8
21003, 동부,100003, 97세,2016,242,56,186,30.1,241,56,185,30.3
21003, 동부,100004, 98세,2016,149,20,129,15.5,146,19,127,15
21003, 동부,100005, 99세,2016,111,17,94,18.1,110,16,94,17
21003, 동부,101,100세이상,2016,166,15,151,9.9,161,12,149,8.1
21003, 동부,102,15세미만,2016,367476,189473,178003,106.4,366113,188785,177328,106.5
21003, 동부,103,15~64세,2016,2415585,1212368,1203217,100.8,2374276,1188350,1185926,100.2
21003, 동부,104,65세이상,2016,503332,216027,287305,75.2,502235,215516,286719,75.2
21003, 동부,086,85세이상,2016,34191,8085,26106,31,34098,8053,26045,30.9
21003, 동부,126,평균연령,2016,42.7,41.4,44,,42.8,41.5,44.1,
21003, 동부,127,중위연령,2016,44.1,42.4,45.8,,44.4,42.7,45.9,
21010, 중구,000,합계,2016,44514,22055,22459,98.2,42732,20817,21915,95
21010, 중구,005,0~4세,2016,1036,546,490,111.4,1020,537,483,111.2
21010, 중구,005001, 0세,2016,192,107,85,125.9,189,105,84,125
21010, 중구,005002, 1세,2016,221,120,101,118.8,217,117,100,117
21010, 중구,005003, 2세,2016,198,106,92,115.2,198,106,92,115.2
21010, 중구,005004, 3세,2016,211,101,110,91.8,206,98,108,90.7
21010, 중구,005005, 4세,2016,214,112,102,109.8,210,111,99,112.1
21010, 중구,010,5~9세,2016,1017,515,502,102.6,1004,509,495,102.8
21010, 중구,010001, 5세,2016,226,128,98,130.6,221,125,96,130.2
21010, 중구,010002, 6세,2016,216,105,111,94.6,212,104,108,96.3
21010, 중구,010003, 7세,2016,190,107,83,128.9,187,105,82,128
21010, 중구,010004, 8세,2016,195,101,94,107.4,195,101,94,107.4
21010, 중구,010005, 9세,2016,190,74,116,63.8,189,74,115,64.3
21010, 중구,015,10~14세,2016,1133,560,573,97.7,1113,552,561,98.4
21010, 중구,015001, 10세,2016,202,99,103,96.1,199,98,101,97
21010, 중구,015002, 11세,2016,201,101,100,101,196,99,97,102.1
21010, 중구,015003, 12세,2016,217,95,122,77.9,216,94,122,77
21010, 중구,015004, 13세,2016,244,119,125,95.2,238,117,121,96.7
21010, 중구,015005, 14세,2016,269,146,123,118.7,264,144,120,120
21010, 중구,020,15~19세,2016,1843,965,878,109.9,1775,924,851,108.6
21010, 중구,020001, 15세,2016,310,180,130,138.5,306,177,129,137.2
21010, 중구,020002, 16세,2016,351,161,190,84.7,348,159,189,84.1
21010, 중구,020003, 17세,2016,353,185,168,110.1,347,180,167,107.8
21010, 중구,020004, 18세,2016,390,202,188,107.4,376,195,181,107.7
21010, 중구,020005, 19세,2016,439,237,202,117.3,398,213,185,115.1
21010, 중구,025,20~24세,2016,2734,1416,1318,107.4,2529,1310,1219,107.5
21010, 중구,025001, 20세,2016,448,227,221,102.7,419,215,204,105.4
21010, 중구,025002, 21세,2016,488,276,212,130.2,459,263,196,134.2
21010, 중구,025003, 22세,2016,558,285,273,104.4,509,266,243,109.5
21010, 중구,025004, 23세,2016,560,270,290,93.1,513,245,268,91.4
21010, 중구,025005, 24세,2016,680,358,322,111.2,629,321,308,104.2
21010, 중구,030,25~29세,2016,3009,1633,1376,118.7,2722,1424,1298,109.7
21010, 중구,030001, 25세,2016,628,339,289,117.3,570,300,270,111.1
21010, 중구,030002, 26세,2016,627,341,286,119.2,568,296,272,108.8
21010, 중구,030003, 27세,2016,587,320,267,119.9,534,284,250,113.6
21010, 중구,030004, 28세,2016,596,315,281,112.1,540,271,269,100.7
21010, 중구,030005, 29세,2016,571,318,253,125.7,510,273,237,115.2
21010, 중구,035,30~34세,2016,2934,1663,1271,130.8,2647,1435,1212,118.4
21010, 중구,035001, 30세,2016,553,300,253,118.6,485,243,242,100.4
21010, 중구,035002, 31세,2016,557,326,231,141.1,503,282,221,127.6
21010, 중구,035003, 32세,2016,558,322,236,136.4,498,274,224,122.3
21010, 중구,035004, 33세,2016,596,338,258,131,547,303,244,124.2
21010, 중구,035005, 34세,2016,670,377,293,128.7,614,333,281,118.5
21010, 중구,040,35~39세,2016,2866,1605,1261,127.3,2631,1408,1223,115.1
21010, 중구,040001, 35세,2016,635,353,282,125.2,589,318,271,117.3
21010, 중구,040002, 36세,2016,632,361,271,133.2,579,315,264,119.3
21010, 중구,040003, 37세,2016,566,304,262,116,510,257,253,101.6
21010, 중구,040004, 38세,2016,542,304,238,127.7,501,270,231,116.9
21010, 중구,040005, 39세,2016,491,283,208,136.1,452,248,204,121.6
21010, 중구,045,40~44세,2016,3195,1798,1397,128.7,2979,1621,1358,119.4
21010, 중구,045001, 40세,2016,549,320,229,139.7,497,276,221,124.9
21010, 중구,045002, 41세,2016,645,358,287,124.7,599,317,282,112.4
21010, 중구,045003, 42세,2016,653,351,302,116.2,610,316,294,107.5
21010, 중구,045004, 43세,2016,649,360,289,124.6,612,335,277,120.9
21010, 중구,045005, 44세,2016,699,409,290,141,661,377,284,132.7
21010, 중구,050,45~49세,2016,3536,1792,1744,102.8,3389,1695,1694,100.1
21010, 중구,050001, 45세,2016,752,369,383,96.3,710,336,374,89.8
21010, 중구,050002, 46세,2016,685,329,356,92.4,657,313,344,91
21010, 중구,050003, 47세,2016,731,395,336,117.6,702,377,325,116
21010, 중구,050004, 48세,2016,715,359,356,100.8,690,344,346,99.4
21010, 중구,050005, 49세,2016,653,340,313,108.6,630,325,305,106.6
21010, 중구,055,50~54세,2016,3628,1795,1833,97.9,3527,1738,1789,97.1
21010, 중구,055001, 50세,2016,695,368,327,112.5,670,352,318,110.7
21010, 중구,055002, 51세,2016,698,328,370,88.6,681,317,364,87.1
21010, 중구,055003, 52세,2016,636,320,316,101.3,614,307,307,100
21010, 중구,055004, 53세,2016,757,370,387,95.6,739,364,375,97.1
21010, 중구,055005, 54세,2016,842,409,433,94.5,823,398,425,93.6
21010, 중구,060,55~59세,2016,4445,2085,2360,88.3,4374,2047,2327,88
21010, 중구,060001, 55세,2016,829,373,456,81.8,818,368,450,81.8
21010, 중구,060002, 56세,2016,930,455,475,95.8,915,448,467,95.9
21010, 중구,060003, 57세,2016,873,422,451,93.6,853,409,444,92.1
21010, 중구,060004, 58세,2016,908,439,469,93.6,893,432,461,93.7
21010, 중구,060005, 59세,2016,905,396,509,77.8,895,390,505,77.2
21010, 중구,065,60~64세,2016,3908,1876,2032,92.3,3844,1838,2006,91.6
21010, 중구,065001, 60세,2016,802,387,415,93.3,790,381,409,93.2
21010, 중구,065002, 61세,2016,909,430,479,89.8,896,422,474,89
21010, 중구,065003, 62세,2016,791,417,374,111.5,771,404,367,110.1
21010, 중구,065004, 63세,2016,699,309,390,79.2,690,305,385,79.2
21010, 중구,065005, 64세,2016,707,333,374,89,697,326,371,87.9
21010, 중구,070,65~69세,2016,3084,1358,1726,78.7,3065,1346,1719,78.3
21010, 중구,070001, 65세,2016,570,251,319,78.7,565,247,318,77.7
21010, 중구,070002, 66세,2016,642,290,352,82.4,636,286,350,81.7
21010, 중구,070003, 67세,2016,645,282,363,77.7,641,280,361,77.6
21010, 중구,070004, 68세,2016,648,278,370,75.1,645,277,368,75.3
21010, 중구,070005, 69세,2016,579,257,322,79.8,578,256,322,79.5
21010, 중구,075,70~74세,2016,2545,1138,1407,80.9,2537,1133,1404,80.7
21010, 중구,075001, 70세,2016,520,229,291,78.7,519,228,291,78.4
21010, 중구,075002, 71세,2016,471,203,268,75.7,468,201,267,75.3
21010, 중구,075003, 72세,2016,502,233,269,86.6,499,232,267,86.9
21010, 중구,075004, 73세,2016,498,230,268,85.8,498,230,268,85.8
21010, 중구,075005, 74세,2016,554,243,311,78.1,553,242,311,77.8
21010, 중구,080,75~79세,2016,1915,787,1128,69.8,1905,783,1122,69.8
21010, 중구,080001, 75세,2016,468,197,271,72.7,468,197,271,72.7
21010, 중구,080002, 76세,2016,413,181,232,78,410,180,230,78.3
21010, 중구,080003, 77세,2016,411,173,238,72.7,409,171,238,71.8
21010, 중구,080004, 78세,2016,333,132,201,65.7,330,132,198,66.7
21010, 중구,080005, 79세,2016,290,104,186,55.9,288,103,185,55.7
21010, 중구,085,80~84세,2016,1013,357,656,54.4,1007,354,653,54.2
21010, 중구,085001, 80세,2016,257,99,158,62.7,256,98,158,62
21010, 중구,085002, 81세,2016,238,87,151,57.6,237,86,151,57
21010, 중구,085003, 82세,2016,189,66,123,53.7,189,66,123,53.7
21010, 중구,085004, 83세,2016,154,53,101,52.5,151,52,99,52.5
21010, 중구,085005, 84세,2016,175,52,123,42.3,174,52,122,42.6
21010, 중구,090,85~89세,2016,476,125,351,35.6,471,123,348,35.3
21010, 중구,090001, 85세,2016,106,42,64,65.6,106,42,64,65.6
21010, 중구,090002, 86세,2016,115,29,86,33.7,114,28,86,32.6
21010, 중구,090003, 87세,2016,104,27,77,35.1,102,27,75,36
21010, 중구,090004, 88세,2016,85,16,69,23.2,85,16,69,23.2
21010, 중구,090005, 89세,2016,66,11,55,20,64,10,54,18.5
21010, 중구,095,90~94세,2016,165,30,135,22.2,163,30,133,22.6
21010, 중구,095001, 90세,2016,48,7,41,17.1,47,7,40,17.5
21010, 중구,095002, 91세,2016,41,9,32,28.1,41,9,32,28.1
21010, 중구,095003, 92세,2016,28,8,20,40,28,8,20,40
21010, 중구,095004, 93세,2016,31,X,28,10.7,30,X,27,11.1
21010, 중구,095005, 94세,2016,17,X,14,21.4,17,X,14,21.4
21010, 중구,100,95~99세,2016,29,10,19,52.6,28,10,18,55.6
21010, 중구,100001, 95세,2016,7,X,5,40,7,X,5,40
21010, 중구,100002, 96세,2016,11,X,8,37.5,11,X,8,37.5
21010, 중구,100003, 97세,2016,5,X,X,150,5,X,X,150
21010, 중구,100004, 98세,2016,X,X,X,0,X,X,X,
21010, 중구,100005, 99세,2016,5,X,X,66.7,5,X,X,66.7
21010, 중구,101,100세이상,2016,X,X,X,50,X,X,X,0
21010, 중구,102,15세미만,2016,3186,1621,1565,103.6,3137,1598,1539,103.8
21010, 중구,103,15~64세,2016,32098,16628,15470,107.5,30417,15440,14977,103.1
21010, 중구,104,65세이상,2016,9230,3806,5424,70.2,9178,3779,5399,70
21010, 중구,086,85세이상,2016,673,166,507,32.7,664,163,501,32.5
21010, 중구,126,평균연령,2016,46.8,45,48.5,,47.2,45.5,48.8,
21010, 중구,127,중위연령,2016,48.4,45.9,51.2,,49.3,47.1,51.7,
21020, 서구,000,합계,2016,109916,53943,55973,96.4,108197,52789,55408,95.3
21020, 서구,005,0~4세,2016,2892,1518,1374,110.5,2877,1514,1363,111.1
21020, 서구,005001, 0세,2016,556,300,256,117.2,553,299,254,117.7
21020, 서구,005002, 1세,2016,590,309,281,110,589,309,280,110.4
21020, 서구,005003, 2세,2016,553,277,276,100.4,552,276,276,100
21020, 서구,005004, 3세,2016,567,316,251,125.9,563,316,247,127.9
21020, 서구,005005, 4세,2016,626,316,310,101.9,620,314,306,102.6
21020, 서구,010,5~9세,2016,3153,1618,1535,105.4,3138,1610,1528,105.4
21020, 서구,010001, 5세,2016,646,348,298,116.8,643,346,297,116.5
21020, 서구,010002, 6세,2016,631,308,323,95.4,629,308,321,96
21020, 서구,010003, 7세,2016,592,320,272,117.6,589,319,270,118.1
21020, 서구,010004, 8세,2016,600,287,313,91.7,596,285,311,91.6
21020, 서구,010005, 9세,2016,684,355,329,107.9,681,352,329,107
21020, 서구,015,10~14세,2016,3504,1798,1706,105.4,3493,1796,1697,105.8
21020, 서구,015001, 10세,2016,611,304,307,99,609,303,306,99
21020, 서구,015002, 11세,2016,621,310,311,99.7,617,309,308,100.3
21020, 서구,015003, 12세,2016,743,374,369,101.4,742,374,368,101.6
21020, 서구,015004, 13세,2016,764,417,347,120.2,763,417,346,120.5
21020, 서구,015005, 14세,2016,765,393,372,105.6,762,393,369,106.5
21020, 서구,020,15~19세,2016,5528,2852,2676,106.6,5494,2831,2663,106.3
21020, 서구,020001, 15세,2016,925,469,456,102.9,922,467,455,102.6
21020, 서구,020002, 16세,2016,977,516,461,111.9,974,514,460,111.7
21020, 서구,020003, 17세,2016,1098,591,507,116.6,1096,590,506,116.6
21020, 서구,020004, 18세,2016,1208,593,615,96.4,1200,587,613,95.8
21020, 서구,020005, 19세,2016,1320,683,637,107.2,1302,673,629,107
21020, 서구,025,20~24세,2016,7465,3846,3619,106.3,7254,3722,3532,105.4
21020, 서구,025001, 20세,2016,1354,699,655,106.7,1320,681,639,106.6
21020, 서구,025002, 21세,2016,1404,739,665,111.1,1368,721,647,111.4
21020, 서구,025003, 22세,2016,1474,770,704,109.4,1436,748,688,108.7
21020, 서구,025004, 23세,2016,1629,833,796,104.6,1583,804,779,103.2
21020, 서구,025005, 24세,2016,1604,805,799,100.8,1547,768,779,98.6
21020, 서구,030,25~29세,2016,6515,3444,3071,112.1,6222,3244,2978,108.9
21020, 서구,030001, 25세,2016,1455,756,699,108.2,1406,724,682,106.2
21020, 서구,030002, 26세,2016,1333,706,627,112.6,1272,661,611,108.2
21020, 서구,030003, 27세,2016,1293,701,592,118.4,1228,655,573,114.3
21020, 서구,030004, 28세,2016,1304,712,592,120.3,1241,672,569,118.1
21020, 서구,030005, 29세,2016,1130,569,561,101.4,1075,532,543,98
21020, 서구,035,30~34세,2016,6309,3343,2966,112.7,5998,3122,2876,108.6
21020, 서구,035001, 30세,2016,1171,640,531,120.5,1105,596,509,117.1
21020, 서구,035002, 31세,2016,1165,634,531,119.4,1097,585,512,114.3
21020, 서구,035003, 32세,2016,1175,585,590,99.2,1110,538,572,94.1
21020, 서구,035004, 33세,2016,1359,726,633,114.7,1306,689,617,111.7
21020, 서구,035005, 34세,2016,1439,758,681,111.3,1380,714,666,107.2
21020, 서구,040,35~39세,2016,6887,3717,3170,117.3,6627,3503,3124,112.1
21020, 서구,040001, 35세,2016,1478,790,688,114.8,1437,758,679,111.6
21020, 서구,040002, 36세,2016,1468,805,663,121.4,1411,762,649,117.4
21020, 서구,040003, 37세,2016,1432,793,639,124.1,1368,738,630,117.1
21020, 서구,040004, 38세,2016,1276,662,614,107.8,1223,616,607,101.5
21020, 서구,040005, 39세,2016,1233,667,566,117.8,1188,629,559,112.5
21020, 서구,045,40~44세,2016,7406,3997,3409,117.2,7191,3823,3368,113.5
21020, 서구,045001, 40세,2016,1222,678,544,124.6,1172,637,535,119.1
21020, 서구,045002, 41세,2016,1364,738,626,117.9,1320,701,619,113.2
21020, 서구,045003, 42세,2016,1535,822,713,115.3,1498,791,707,111.9
21020, 서구,045004, 43세,2016,1652,878,774,113.4,1611,849,762,111.4
21020, 서구,045005, 44세,2016,1633,881,752,117.2,1590,845,745,113.4
21020, 서구,050,45~49세,2016,8420,4405,4015,109.7,8291,4318,3973,108.7
21020, 서구,050001, 45세,2016,1660,859,801,107.2,1629,834,795,104.9
21020, 서구,050002, 46세,2016,1675,906,769,117.8,1643,878,765,114.8
21020, 서구,050003, 47세,2016,1705,884,821,107.7,1676,868,808,107.4
21020, 서구,050004, 48세,2016,1724,886,838,105.7,1708,877,831,105.5
21020, 서구,050005, 49세,2016,1656,870,786,110.7,1635,861,774,111.2
21020, 서구,055,50~54세,2016,8663,4365,4298,101.6,8582,4327,4255,101.7
21020, 서구,055001, 50세,2016,1608,799,809,98.8,1591,795,796,99.9
21020, 서구,055002, 51세,2016,1666,821,845,97.2,1650,811,839,96.7
21020, 서구,055003, 52세,2016,1624,811,813,99.8,1608,807,801,100.7
21020, 서구,055004, 53세,2016,1852,956,896,106.7,1830,943,887,106.3
21020, 서구,055005, 54세,2016,1913,978,935,104.6,1903,971,932,104.2
21020, 서구,060,55~59세,2016,10873,5154,5719,90.1,10813,5134,5679,90.4
21020, 서구,060001, 55세,2016,2219,1030,1189,86.6,2209,1027,1182,86.9
21020, 서구,060002, 56세,2016,2366,1142,1224,93.3,2347,1136,1211,93.8
21020, 서구,060003, 57세,2016,2130,995,1135,87.7,2121,990,1131,87.5
21020, 서구,060004, 58세,2016,2069,1003,1066,94.1,2057,998,1059,94.2
21020, 서구,060005, 59세,2016,2089,984,1105,89,2079,983,1096,89.7
21020, 서구,065,60~64세,2016,9219,4315,4904,88,9182,4297,4885,88
21020, 서구,065001, 60세,2016,1944,956,988,96.8,1940,954,986,96.8
21020, 서구,065002, 61세,2016,2066,908,1158,78.4,2057,905,1152,78.6
21020, 서구,065003, 62세,2016,1856,895,961,93.1,1850,893,957,93.3
21020, 서구,065004, 63세,2016,1560,717,843,85.1,1552,710,842,84.3
21020, 서구,065005, 64세,2016,1793,839,954,87.9,1783,835,948,88.1
21020, 서구,070,65~69세,2016,7666,3556,4110,86.5,7642,3544,4098,86.5
21020, 서구,070001, 65세,2016,1508,713,795,89.7,1499,709,790,89.7
21020, 서구,070002, 66세,2016,1540,717,823,87.1,1534,712,822,86.6
21020, 서구,070003, 67세,2016,1594,735,859,85.6,1589,733,856,85.6
21020, 서구,070004, 68세,2016,1493,701,792,88.5,1492,701,791,88.6
21020, 서구,070005, 69세,2016,1531,690,841,82,1528,689,839,82.1
21020, 서구,075,70~74세,2016,5983,2681,3302,81.2,5974,2677,3297,81.2
21020, 서구,075001, 70세,2016,1125,527,598,88.1,1124,526,598,88
21020, 서구,075002, 71세,2016,1097,494,603,81.9,1095,493,602,81.9
21020, 서구,075003, 72세,2016,1166,532,634,83.9,1163,531,632,84
21020, 서구,075004, 73세,2016,1270,528,742,71.2,1268,528,740,71.4
21020, 서구,075005, 74세,2016,1325,600,725,82.8,1324,599,725,82.6
21020, 서구,080,75~79세,2016,4857,1956,2901,67.4,4847,1951,2896,67.4
21020, 서구,080001, 75세,2016,1160,477,683,69.8,1158,476,682,69.8
21020, 서구,080002, 76세,2016,1041,420,621,67.6,1041,420,621,67.6
21020, 서구,080003, 77세,2016,1032,411,621,66.2,1030,409,621,65.9
21020, 서구,080004, 78세,2016,863,346,517,66.9,859,345,514,67.1
21020, 서구,080005, 79세,2016,761,302,459,65.8,759,301,458,65.7
21020, 서구,085,80~84세,2016,2809,978,1831,53.4,2807,977,1830,53.4
21020, 서구,085001, 80세,2016,723,281,442,63.6,723,281,442,63.6
21020, 서구,085002, 81세,2016,666,223,443,50.3,666,223,443,50.3
21020, 서구,085003, 82세,2016,530,198,332,59.6,529,197,332,59.3
21020, 서구,085004, 83세,2016,479,143,336,42.6,479,143,336,42.6
21020, 서구,085005, 84세,2016,411,133,278,47.8,410,133,277,48
21020, 서구,090,85~89세,2016,1259,292,967,30.2,1258,292,966,30.2
21020, 서구,090001, 85세,2016,327,89,238,37.4,326,89,237,37.6
21020, 서구,090002, 86세,2016,260,63,197,32,260,63,197,32
21020, 서구,090003, 87세,2016,260,69,191,36.1,260,69,191,36.1
21020, 서구,090004, 88세,2016,234,44,190,23.2,234,44,190,23.2
21020, 서구,090005, 89세,2016,178,27,151,17.9,178,27,151,17.9
21020, 서구,095,90~94세,2016,413,86,327,26.3,413,86,327,26.3
21020, 서구,095001, 90세,2016,102,18,84,21.4,102,18,84,21.4
21020, 서구,095002, 91세,2016,103,28,75,37.3,103,28,75,37.3
21020, 서구,095003, 92세,2016,80,12,68,17.6,80,12,68,17.6
21020, 서구,095004, 93세,2016,73,17,56,30.4,73,17,56,30.4
21020, 서구,095005, 94세,2016,55,11,44,25,55,11,44,25
21020, 서구,100,95~99세,2016,90,21,69,30.4,89,20,69,29
21020, 서구,100001, 95세,2016,30,7,23,30.4,29,6,23,26.1
21020, 서구,100002, 96세,2016,31,8,23,34.8,31,8,23,34.8
21020, 서구,100003, 97세,2016,13,X,10,30,13,X,10,30
21020, 서구,100004, 98세,2016,11,X,9,22.2,11,X,9,22.2
21020, 서구,100005, 99세,2016,5,X,X,25,5,X,X,25
21020, 서구,101,100세이상,2016,5,X,X,25,5,X,X,25
21020, 서구,102,15세미만,2016,9549,4934,4615,106.9,9508,4920,4588,107.2
21020, 서구,103,15~64세,2016,77285,39438,37847,104.2,75654,38321,37333,102.6
21020, 서구,104,65세이상,2016,23082,9571,13511,70.8,23035,9548,13487,70.8
21020, 서구,086,85세이상,2016,1767,400,1367,29.3,1765,399,1366,29.2
21020, 서구,126,평균연령,2016,46.1,44.4,47.8,,46.3,44.6,47.9,
21020, 서구,127,중위연령,2016,48.1,46,50.6,,48.5,46.4,50.8,
21030, 동구,000,합계,2016,87065,42594,44471,95.8,85290,41810,43480,96.2
21030, 동구,005,0~4세,2016,2228,1163,1065,109.2,2205,1149,1056,108.8
21030, 동구,005001, 0세,2016,418,223,195,114.4,412,220,192,114.6
21030, 동구,005002, 1세,2016,424,229,195,117.4,422,228,194,117.5
21030, 동구,005003, 2세,2016,430,211,219,96.3,427,208,219,95
21030, 동구,005004, 3세,2016,441,230,211,109,434,225,209,107.7
21030, 동구,005005, 4세,2016,515,270,245,110.2,510,268,242,110.7
21030, 동구,010,5~9세,2016,2257,1131,1126,100.4,2223,1115,1108,100.6
21030, 동구,010001, 5세,2016,461,239,222,107.7,456,236,220,107.3
21030, 동구,010002, 6세,2016,443,218,225,96.9,434,213,221,96.4
21030, 동구,010003, 7세,2016,414,202,212,95.3,404,196,208,94.2
21030, 동구,010004, 8세,2016,433,216,217,99.5,425,215,210,102.4
21030, 동구,010005, 9세,2016,506,256,250,102.4,504,255,249,102.4
21030, 동구,015,10~14세,2016,2375,1251,1124,111.3,2344,1236,1108,111.6
21030, 동구,015001, 10세,2016,419,202,217,93.1,414,199,215,92.6
21030, 동구,015002, 11세,2016,402,207,195,106.2,397,205,192,106.8
21030, 동구,015003, 12세,2016,481,257,224,114.7,476,255,221,115.4
21030, 동구,015004, 13세,2016,517,277,240,115.4,509,272,237,114.8
21030, 동구,015005, 14세,2016,556,308,248,124.2,548,305,243,125.5
21030, 동구,020,15~19세,2016,3981,2015,1966,102.5,3942,1994,1948,102.4
21030, 동구,020001, 15세,2016,726,363,363,100,723,361,362,99.7
21030, 동구,020002, 16세,2016,800,380,420,90.5,788,374,414,90.3
21030, 동구,020003, 17세,2016,788,382,406,94.1,783,378,405,93.3
21030, 동구,020004, 18세,2016,867,478,389,122.9,859,472,387,122
21030, 동구,020005, 19세,2016,800,412,388,106.2,789,409,380,107.6
21030, 동구,025,20~24세,2016,5092,2720,2372,114.7,4940,2675,2265,118.1
21030, 동구,025001, 20세,2016,943,513,430,119.3,924,510,414,123.2
21030, 동구,025002, 21세,2016,929,514,415,123.9,910,508,402,126.4
21030, 동구,025003, 22세,2016,1056,555,501,110.8,1023,547,476,114.9
21030, 동구,025004, 23세,2016,1024,540,484,111.6,983,528,455,116
21030, 동구,025005, 24세,2016,1140,598,542,110.3,1100,582,518,112.4
21030, 동구,030,25~29세,2016,5009,2603,2406,108.2,4749,2489,2260,110.1
21030, 동구,030001, 25세,2016,1031,507,524,96.8,989,490,499,98.2
21030, 동구,030002, 26세,2016,1045,534,511,104.5,982,503,479,105
21030, 동구,030003, 27세,2016,982,490,492,99.6,925,471,454,103.7
21030, 동구,030004, 28세,2016,955,520,435,119.5,901,492,409,120.3
21030, 동구,030005, 29세,2016,996,552,444,124.3,952,533,419,127.2
21030, 동구,035,30~34세,2016,5050,2722,2328,116.9,4804,2614,2190,119.4
21030, 동구,035001, 30세,2016,916,481,435,110.6,860,460,400,115
21030, 동구,035002, 31세,2016,940,503,437,115.1,882,472,410,115.1
21030, 동구,035003, 32세,2016,1000,529,471,112.3,952,512,440,116.4
21030, 동구,035004, 33세,2016,1051,585,466,125.5,1009,569,440,129.3
21030, 동구,035005, 34세,2016,1143,624,519,120.2,1101,601,500,120.2
21030, 동구,040,35~39세,2016,5575,3048,2527,120.6,5375,2957,2418,122.3
21030, 동구,040001, 35세,2016,1164,654,510,128.2,1127,636,491,129.5
21030, 동구,040002, 36세,2016,1191,654,537,121.8,1148,635,513,123.8
21030, 동구,040003, 37세,2016,1157,627,530,118.3,1113,605,508,119.1
21030, 동구,040004, 38세,2016,1042,563,479,117.5,1007,542,465,116.6
21030, 동구,040005, 39세,2016,1021,550,471,116.8,980,539,441,122.2
21030, 동구,045,40~44세,2016,5829,3150,2679,117.6,5663,3067,2596,118.1
21030, 동구,045001, 40세,2016,995,539,456,118.2,954,520,434,119.8
21030, 동구,045002, 41세,2016,1102,637,465,137,1070,620,450,137.8
21030, 동구,045003, 42세,2016,1207,611,596,102.5,1176,592,584,101.4
21030, 동구,045004, 43세,2016,1225,652,573,113.8,1196,638,558,114.3
21030, 동구,045005, 44세,2016,1300,711,589,120.7,1267,697,570,122.3
21030, 동구,050,45~49세,2016,6715,3488,3227,108.1,6562,3422,3140,109
21030, 동구,050001, 45세,2016,1360,719,641,112.2,1322,699,623,112.2
21030, 동구,050002, 46세,2016,1298,734,564,130.1,1270,722,548,131.8
21030, 동구,050003, 47세,2016,1422,728,694,104.9,1387,718,669,107.3
21030, 동구,050004, 48세,2016,1333,668,665,100.5,1309,661,648,102
21030, 동구,050005, 49세,2016,1302,639,663,96.4,1274,622,652,95.4
21030, 동구,055,50~54세,2016,6804,3439,3365,102.2,6677,3385,3292,102.8
21030, 동구,055001, 50세,2016,1258,640,618,103.6,1237,632,605,104.5
21030, 동구,055002, 51세,2016,1307,665,642,103.6,1282,654,628,104.1
21030, 동구,055003, 52세,2016,1241,659,582,113.2,1217,645,572,112.8
21030, 동구,055004, 53세,2016,1404,705,699,100.9,1367,689,678,101.6
21030, 동구,055005, 54세,2016,1594,770,824,93.4,1574,765,809,94.6
21030, 동구,060,55~59세,2016,8632,4100,4532,90.5,8508,4041,4467,90.5
21030, 동구,060001, 55세,2016,1716,786,930,84.5,1692,775,917,84.5
21030, 동구,060002, 56세,2016,1846,862,984,87.6,1818,850,968,87.8
21030, 동구,060003, 57세,2016,1664,772,892,86.5,1638,761,877,86.8
21030, 동구,060004, 58세,2016,1667,836,831,100.6,1643,823,820,100.4
21030, 동구,060005, 59세,2016,1739,844,895,94.3,1717,832,885,94
21030, 동구,065,60~64세,2016,7765,3606,4159,86.7,7651,3556,4095,86.8
21030, 동구,065001, 60세,2016,1694,806,888,90.8,1674,799,875,91.3
21030, 동구,065002, 61세,2016,1697,762,935,81.5,1669,748,921,81.2
21030, 동구,065003, 62세,2016,1519,733,786,93.3,1489,719,770,93.4
21030, 동구,065004, 63세,2016,1341,620,721,86,1326,613,713,86
21030, 동구,065005, 64세,2016,1514,685,829,82.6,1493,677,816,83
21030, 동구,070,65~69세,2016,6487,2974,3513,84.7,6425,2940,3485,84.4
21030, 동구,070001, 65세,2016,1274,597,677,88.2,1261,591,670,88.2
21030, 동구,070002, 66세,2016,1281,601,680,88.4,1261,592,669,88.5
21030, 동구,070003, 67세,2016,1366,625,741,84.3,1349,616,733,84
21030, 동구,070004, 68세,2016,1313,615,698,88.1,1310,612,698,87.7
21030, 동구,070005, 69세,2016,1253,536,717,74.8,1244,529,715,74
21030, 동구,075,70~74세,2016,5213,2290,2923,78.3,5199,2284,2915,78.4
21030, 동구,075001, 70세,2016,928,437,491,89,922,434,488,88.9
21030, 동구,075002, 71세,2016,974,419,555,75.5,972,418,554,75.5
21030, 동구,075003, 72세,2016,1027,432,595,72.6,1026,432,594,72.7
21030, 동구,075004, 73세,2016,1053,462,591,78.2,1050,461,589,78.3
21030, 동구,075005, 74세,2016,1231,540,691,78.1,1229,539,690,78.1
21030, 동구,080,75~79세,2016,4307,1710,2597,65.8,4294,1706,2588,65.9
21030, 동구,080001, 75세,2016,1028,406,622,65.3,1025,403,622,64.8
21030, 동구,080002, 76세,2016,899,351,548,64.1,896,351,545,64.4
21030, 동구,080003, 77세,2016,886,351,535,65.6,883,351,532,66
21030, 동구,080004, 78세,2016,755,302,453,66.7,752,301,451,66.7
21030, 동구,080005, 79세,2016,739,300,439,68.3,738,300,438,68.5
21030, 동구,085,80~84세,2016,2400,821,1579,52,2393,820,1573,52.1
21030, 동구,085001, 80세,2016,651,264,387,68.2,650,263,387,68
21030, 동구,085002, 81세,2016,539,177,362,48.9,539,177,362,48.9
21030, 동구,085003, 82세,2016,441,134,307,43.6,440,134,306,43.8
21030, 동구,085004, 83세,2016,409,145,264,54.9,407,145,262,55.3
21030, 동구,085005, 84세,2016,360,101,259,39,357,101,256,39.5
21030, 동구,090,85~89세,2016,977,267,710,37.6,973,265,708,37.4
21030, 동구,090001, 85세,2016,246,71,175,40.6,245,70,175,40
21030, 동구,090002, 86세,2016,212,62,150,41.3,210,61,149,40.9
21030, 동구,090003, 87세,2016,202,53,149,35.6,202,53,149,35.6
21030, 동구,090004, 88세,2016,173,44,129,34.1,172,44,128,34.4
21030, 동구,090005, 89세,2016,144,37,107,34.6,144,37,107,34.6
21030, 동구,095,90~94세,2016,299,84,215,39.1,296,84,212,39.6
21030, 동구,095001, 90세,2016,106,22,84,26.2,105,22,83,26.5
21030, 동구,095002, 91세,2016,74,27,47,57.4,73,27,46,58.7
21030, 동구,095003, 92세,2016,55,11,44,25,55,11,44,25
21030, 동구,095004, 93세,2016,31,10,21,47.6,30,10,20,50
21030, 동구,095005, 94세,2016,33,14,19,73.7,33,14,19,73.7
21030, 동구,100,95~99세,2016,59,11,48,22.9,57,10,47,21.3
21030, 동구,100001, 95세,2016,21,X,17,23.5,20,X,16,25
21030, 동구,100002, 96세,2016,14,X,11,27.3,13,X,11,18.2
21030, 동구,100003, 97세,2016,13,X,9,44.4,13,X,9,44.4
21030, 동구,100004, 98세,2016,5,X,5,0,5,X,5,0
21030, 동구,100005, 99세,2016,6,X,6,0,6,X,6,0
21030, 동구,101,100세이상,2016,11,X,10,10,10,X,9,11.1
21030, 동구,102,15세미만,2016,6860,3545,3315,106.9,6772,3500,3272,107
21030, 동구,103,15~64세,2016,60452,30891,29561,104.5,58871,30200,28671,105.3
21030, 동구,104,65세이상,2016,19753,8158,11595,70.4,19647,8110,11537,70.3
21030, 동구,086,85세이상,2016,1346,363,983,36.9,1336,360,976,36.9
21030, 동구,126,평균연령,2016,47.3,45.5,49.1,,47.5,45.6,49.3,
21030, 동구,127,중위연령,2016,49.6,47.1,52.3,,49.9,47.3,52.7,
21040, 영도구,000,합계,2016,126638,63698,62940,101.2,124869,62573,62296,100.4
21040, 영도구,005,0~4세,2016,3189,1647,1542,106.8,3166,1635,1531,106.8
21040, 영도구,005001, 0세,2016,612,306,306,100,610,306,304,100.7
21040, 영도구,005002, 1세,2016,594,310,284,109.2,590,306,284,107.7
21040, 영도구,005003, 2세,2016,647,326,321,101.6,639,323,316,102.2
21040, 영도구,005004, 3세,2016,640,326,314,103.8,636,324,312,103.8
21040, 영도구,005005, 4세,2016,696,379,317,119.6,691,376,315,119.4
21040, 영도구,010,5~9세,2016,3575,1831,1744,105,3566,1823,1743,104.6
21040, 영도구,010001, 5세,2016,750,365,385,94.8,748,363,385,94.3
21040, 영도구,010002, 6세,2016,733,386,347,111.2,730,383,347,110.4
21040, 영도구,010003, 7세,2016,637,315,322,97.8,635,313,322,97.2
21040, 영도구,010004, 8세,2016,716,368,348,105.7,714,367,347,105.8
21040, 영도구,010005, 9세,2016,739,397,342,116.1,739,397,342,116.1
21040, 영도구,015,10~14세,2016,3895,1981,1914,103.5,3882,1974,1908,103.5
21040, 영도구,015001, 10세,2016,697,342,355,96.3,696,341,355,96.1
21040, 영도구,015002, 11세,2016,676,338,338,100,673,336,337,99.7
21040, 영도구,015003, 12세,2016,790,395,395,100,787,394,393,100.3
21040, 영도구,015004, 13세,2016,823,444,379,117.2,820,443,377,117.5
21040, 영도구,015005, 14세,2016,909,462,447,103.4,906,460,446,103.1
21040, 영도구,020,15~19세,2016,7123,3956,3167,124.9,7095,3944,3151,125.2
21040, 영도구,020001, 15세,2016,1037,540,497,108.7,1032,537,495,108.5
21040, 영도구,020002, 16세,2016,1119,594,525,113.1,1115,592,523,113.2
21040, 영도구,020003, 17세,2016,1227,690,537,128.5,1225,689,536,128.5
21040, 영도구,020004, 18세,2016,1593,895,698,128.2,1586,892,694,128.5
21040, 영도구,020005, 19세,2016,2147,1237,910,135.9,2137,1234,903,136.7
21040, 영도구,025,20~24세,2016,10295,6181,4114,150.2,10118,6091,4027,151.3
21040, 영도구,025001, 20세,2016,2117,1213,904,134.2,2101,1205,896,134.5
21040, 영도구,025002, 21세,2016,2090,1174,916,128.2,2056,1158,898,129
21040, 영도구,025003, 22세,2016,2197,1369,828,165.3,2162,1354,808,167.6
21040, 영도구,025004, 23세,2016,1955,1211,744,162.8,1924,1191,733,162.5
21040, 영도구,025005, 24세,2016,1936,1214,722,168.1,1875,1183,692,171
21040, 영도구,030,25~29세,2016,7049,4042,3007,134.4,6713,3827,2886,132.6
21040, 영도구,030001, 25세,2016,1633,964,669,144.1,1577,929,648,143.4
21040, 영도구,030002, 26세,2016,1462,869,593,146.5,1395,829,566,146.5
21040, 영도구,030003, 27세,2016,1368,749,619,121,1303,705,598,117.9
21040, 영도구,030004, 28세,2016,1321,726,595,122,1245,678,567,119.6
21040, 영도구,030005, 29세,2016,1265,734,531,138.2,1193,686,507,135.3
21040, 영도구,035,30~34세,2016,6692,3783,2909,130,6371,3544,2827,125.4
21040, 영도구,035001, 30세,2016,1263,758,505,150.1,1193,708,485,146
21040, 영도구,035002, 31세,2016,1285,706,579,121.9,1216,656,560,117.1
21040, 영도구,035003, 32세,2016,1288,733,555,132.1,1225,685,540,126.9
21040, 영도구,035004, 33세,2016,1408,782,626,124.9,1337,727,610,119.2
21040, 영도구,035005, 34세,2016,1448,804,644,124.8,1400,768,632,121.5
21040, 영도구,040,35~39세,2016,7587,4080,3507,116.3,7359,3911,3448,113.4
21040, 영도구,040001, 35세,2016,1594,862,732,117.8,1556,833,723,115.2
21040, 영도구,040002, 36세,2016,1692,897,795,112.8,1640,858,782,109.7
21040, 영도구,040003, 37세,2016,1521,809,712,113.6,1469,769,700,109.9
21040, 영도구,040004, 38세,2016,1406,766,640,119.7,1366,736,630,116.8
21040, 영도구,040005, 39세,2016,1374,746,628,118.8,1328,715,613,116.6
21040, 영도구,045,40~44세,2016,8381,4478,3903,114.7,8173,4323,3850,112.3
21040, 영도구,045001, 40세,2016,1424,766,658,116.4,1373,725,648,111.9
21040, 영도구,045002, 41세,2016,1615,876,739,118.5,1568,842,726,116
21040, 영도구,045003, 42세,2016,1721,909,812,111.9,1685,881,804,109.6
21040, 영도구,045004, 43세,2016,1809,957,852,112.3,1770,927,843,110
21040, 영도구,045005, 44세,2016,1812,970,842,115.2,1777,948,829,114.4
21040, 영도구,050,45~49세,2016,9522,4933,4589,107.5,9356,4834,4522,106.9
21040, 영도구,050001, 45세,2016,1890,1009,881,114.5,1856,989,867,114.1
21040, 영도구,050002, 46세,2016,1922,1027,895,114.7,1877,999,878,113.8
21040, 영도구,050003, 47세,2016,1849,942,907,103.9,1810,915,895,102.2
21040, 영도구,050004, 48세,2016,1957,982,975,100.7,1935,970,965,100.5
21040, 영도구,050005, 49세,2016,1904,973,931,104.5,1878,961,917,104.8
21040, 영도구,055,50~54세,2016,9827,4895,4932,99.2,9720,4844,4876,99.3
21040, 영도구,055001, 50세,2016,1884,1039,845,123,1869,1031,838,123
21040, 영도구,055002, 51세,2016,1889,907,982,92.4,1866,901,965,93.4
21040, 영도구,055003, 52세,2016,1771,859,912,94.2,1745,846,899,94.1
21040, 영도구,055004, 53세,2016,2024,1025,999,102.6,2004,1013,991,102.2
21040, 영도구,055005, 54세,2016,2259,1065,1194,89.2,2236,1053,1183,89
21040, 영도구,060,55~59세,2016,12311,5917,6394,92.5,12253,5891,6362,92.6
21040, 영도구,060001, 55세,2016,2500,1209,1291,93.6,2490,1203,1287,93.5
21040, 영도구,060002, 56세,2016,2573,1234,1339,92.2,2558,1230,1328,92.6
21040, 영도구,060003, 57세,2016,2413,1131,1282,88.2,2408,1128,1280,88.1
21040, 영도구,060004, 58세,2016,2392,1175,1217,96.5,2379,1172,1207,97.1
21040, 영도구,060005, 59세,2016,2433,1168,1265,92.3,2418,1158,1260,91.9
21040, 영도구,065,60~64세,2016,11005,5183,5822,89,10961,5163,5798,89
21040, 영도구,065001, 60세,2016,2396,1145,1251,91.5,2388,1141,1247,91.5
21040, 영도구,065002, 61세,2016,2569,1155,1414,81.7,2557,1150,1407,81.7
21040, 영도구,065003, 62세,2016,2149,1049,1100,95.4,2142,1044,1098,95.1
21040, 영도구,065004, 63세,2016,1846,864,982,88,1838,861,977,88.1
21040, 영도구,065005, 64세,2016,2045,970,1075,90.2,2036,967,1069,90.5
21040, 영도구,070,65~69세,2016,8886,4087,4799,85.2,8862,4075,4787,85.1
21040, 영도구,070001, 65세,2016,1743,793,950,83.5,1737,790,947,83.4
21040, 영도구,070002, 66세,2016,1721,801,920,87.1,1714,798,916,87.1
21040, 영도구,070003, 67세,2016,1885,870,1015,85.7,1883,869,1014,85.7
21040, 영도구,070004, 68세,2016,1735,805,930,86.6,1730,802,928,86.4
21040, 영도구,070005, 69세,2016,1802,818,984,83.1,1798,816,982,83.1
21040, 영도구,075,70~74세,2016,7118,3105,4013,77.4,7108,3101,4007,77.4
21040, 영도구,075001, 70세,2016,1338,611,727,84,1336,610,726,84
21040, 영도구,075002, 71세,2016,1329,571,758,75.3,1327,570,757,75.3
21040, 영도구,075003, 72세,2016,1355,569,786,72.4,1353,569,784,72.6
21040, 영도구,075004, 73세,2016,1503,656,847,77.4,1502,655,847,77.3
21040, 영도구,075005, 74세,2016,1593,698,895,78,1590,697,893,78.1
21040, 영도구,080,75~79세,2016,5571,2198,3373,65.2,5565,2197,3368,65.2
21040, 영도구,080001, 75세,2016,1354,564,790,71.4,1352,564,788,71.6
21040, 영도구,080002, 76세,2016,1239,474,765,62,1238,474,764,62
21040, 영도구,080003, 77세,2016,1201,462,739,62.5,1200,462,738,62.6
21040, 영도구,080004, 78세,2016,912,391,521,75,910,390,520,75
21040, 영도구,080005, 79세,2016,865,307,558,55,865,307,558,55
21040, 영도구,085,80~84세,2016,2922,1027,1895,54.2,2914,1022,1892,54
21040, 영도구,085001, 80세,2016,780,298,482,61.8,778,296,482,61.4
21040, 영도구,085002, 81세,2016,690,263,427,61.6,688,262,426,61.5
21040, 영도구,085003, 82세,2016,586,213,373,57.1,586,213,373,57.1
21040, 영도구,085004, 83세,2016,444,128,316,40.5,441,127,314,40.4
21040, 영도구,085005, 84세,2016,422,125,297,42.1,421,124,297,41.8
21040, 영도구,090,85~89세,2016,1266,294,972,30.2,1263,294,969,30.3
21040, 영도구,090001, 85세,2016,329,103,226,45.6,329,103,226,45.6
21040, 영도구,090002, 86세,2016,281,62,219,28.3,280,62,218,28.4
21040, 영도구,090003, 87세,2016,276,66,210,31.4,276,66,210,31.4
21040, 영도구,090004, 88세,2016,200,30,170,17.6,199,30,169,17.8
21040, 영도구,090005, 89세,2016,180,33,147,22.4,179,33,146,22.6
21040, 영도구,095,90~94세,2016,356,62,294,21.1,356,62,294,21.1
21040, 영도구,095001, 90세,2016,102,15,87,17.2,102,15,87,17.2
21040, 영도구,095002, 91세,2016,89,12,77,15.6,89,12,77,15.6
21040, 영도구,095003, 92세,2016,61,13,48,27.1,61,13,48,27.1
21040, 영도구,095004, 93세,2016,73,15,58,25.9,73,15,58,25.9
21040, 영도구,095005, 94세,2016,31,7,24,29.2,31,7,24,29.2
21040, 영도구,100,95~99세,2016,61,16,45,35.6,61,16,45,35.6
21040, 영도구,100001, 95세,2016,22,7,15,46.7,22,7,15,46.7
21040, 영도구,100002, 96세,2016,12,X,9,33.3,12,X,9,33.3
21040, 영도구,100003, 97세,2016,15,X,11,36.4,15,X,11,36.4
21040, 영도구,100004, 98세,2016,6,X,5,20,6,X,5,20
21040, 영도구,100005, 99세,2016,6,X,5,20,6,X,5,20
21040, 영도구,101,100세이상,2016,7,X,5,40,7,X,5,40
21040, 영도구,102,15세미만,2016,10659,5459,5200,105,10614,5432,5182,104.8
21040, 영도구,103,15~64세,2016,89792,47448,42344,112.1,88119,46372,41747,111.1
21040, 영도구,104,65세이상,2016,26187,10791,15396,70.1,26136,10769,15367,70.1
21040, 영도구,086,85세이상,2016,1690,374,1316,28.4,1687,374,1313,28.5
21040, 영도구,126,평균연령,2016,45.8,43.5,48,,45.9,43.7,48.1,
21040, 영도구,127,중위연령,2016,47.9,44.9,51.2,,48.2,45.2,51.4,
21050, 부산진구,000,합계,2016,370250,179407,190843,94,367813,178448,189365,94.2
21050, 부산진구,005,0~4세,2016,13314,6783,6531,103.9,13274,6762,6512,103.8
21050, 부산진구,005001, 0세,2016,2676,1406,1270,110.7,2669,1402,1267,110.7
21050, 부산진구,005002, 1세,2016,2654,1336,1318,101.4,2649,1334,1315,101.4
21050, 부산진구,005003, 2세,2016,2666,1391,1275,109.1,2656,1386,1270,109.1
21050, 부산진구,005004, 3세,2016,2538,1267,1271,99.7,2530,1261,1269,99.4
21050, 부산진구,005005, 4세,2016,2780,1383,1397,99,2770,1379,1391,99.1
21050, 부산진구,010,5~9세,2016,12683,6432,6251,102.9,12645,6420,6225,103.1
21050, 부산진구,010001, 5세,2016,2759,1373,1386,99.1,2747,1369,1378,99.3
21050, 부산진구,010002, 6세,2016,2502,1293,1209,106.9,2495,1290,1205,107.1
21050, 부산진구,010003, 7세,2016,2394,1212,1182,102.5,2387,1210,1177,102.8
21050, 부산진구,010004, 8세,2016,2472,1268,1204,105.3,2468,1265,1203,105.2
21050, 부산진구,010005, 9세,2016,2556,1286,1270,101.3,2548,1286,1262,101.9
21050, 부산진구,015,10~14세,2016,12471,6383,6088,104.8,12449,6371,6078,104.8
21050, 부산진구,015001, 10세,2016,2341,1181,1160,101.8,2337,1179,1158,101.8
21050, 부산진구,015002, 11세,2016,2243,1116,1127,99,2241,1114,1127,98.8
21050, 부산진구,015003, 12세,2016,2554,1349,1205,112,2550,1348,1202,112.1
21050, 부산진구,015004, 13세,2016,2610,1347,1263,106.7,2607,1345,1262,106.6
21050, 부산진구,015005, 14세,2016,2723,1390,1333,104.3,2714,1385,1329,104.2
21050, 부산진구,020,15~19세,2016,19801,9919,9882,100.4,19678,9865,9813,100.5
21050, 부산진구,020001, 15세,2016,3154,1639,1515,108.2,3138,1631,1507,108.2
21050, 부산진구,020002, 16세,2016,3633,1876,1757,106.8,3617,1870,1747,107
21050, 부산진구,020003, 17세,2016,3521,1836,1685,109,3498,1828,1670,109.5
21050, 부산진구,020004, 18세,2016,4153,2057,2096,98.1,4117,2037,2080,97.9
21050, 부산진구,020005, 19세,2016,5340,2511,2829,88.8,5308,2499,2809,89
21050, 부산진구,025,20~24세,2016,27866,13942,13924,100.1,27510,13851,13659,101.4
21050, 부산진구,025001, 20세,2016,5146,2419,2727,88.7,5089,2402,2687,89.4
21050, 부산진구,025002, 21세,2016,5436,2686,2750,97.7,5347,2670,2677,99.7
21050, 부산진구,025003, 22세,2016,5665,2895,2770,104.5,5602,2878,2724,105.7
21050, 부산진구,025004, 23세,2016,5774,2967,2807,105.7,5705,2947,2758,106.9
21050, 부산진구,025005, 24세,2016,5845,2975,2870,103.7,5767,2954,2813,105
21050, 부산진구,030,25~29세,2016,26017,12813,13204,97,25582,12674,12908,98.2
21050, 부산진구,030001, 25세,2016,5620,2804,2816,99.6,5527,2774,2753,100.8
21050, 부산진구,030002, 26세,2016,5306,2645,2661,99.4,5219,2620,2599,100.8
21050, 부산진구,030003, 27세,2016,5155,2503,2652,94.4,5067,2476,2591,95.6
21050, 부산진구,030004, 28세,2016,4901,2423,2478,97.8,4826,2396,2430,98.6
21050, 부산진구,030005, 29세,2016,5035,2438,2597,93.9,4943,2408,2535,95
21050, 부산진구,035,30~34세,2016,26236,13405,12831,104.5,25914,13284,12630,105.2
21050, 부산진구,035001, 30세,2016,4832,2444,2388,102.3,4764,2424,2340,103.6
21050, 부산진구,035002, 31세,2016,4946,2514,2432,103.4,4877,2484,2393,103.8
21050, 부산진구,035003, 32세,2016,5036,2647,2389,110.8,4973,2620,2353,111.3
21050, 부산진구,035004, 33세,2016,5582,2804,2778,100.9,5502,2783,2719,102.4
21050, 부산진구,035005, 34세,2016,5840,2996,2844,105.3,5798,2973,2825,105.2
21050, 부산진구,040,35~39세,2016,27204,14078,13126,107.3,26993,13989,13004,107.6
21050, 부산진구,040001, 35세,2016,5882,3062,2820,108.6,5838,3045,2793,109
21050, 부산진구,040002, 36세,2016,5956,3098,2858,108.4,5919,3082,2837,108.6
21050, 부산진구,040003, 37세,2016,5557,2799,2758,101.5,5515,2778,2737,101.5
21050, 부산진구,040004, 38세,2016,4916,2595,2321,111.8,4866,2576,2290,112.5
21050, 부산진구,040005, 39세,2016,4893,2524,2369,106.5,4855,2508,2347,106.9
21050, 부산진구,045,40~44세,2016,26793,13643,13150,103.7,26594,13542,13052,103.8
21050, 부산진구,045001, 40세,2016,4834,2422,2412,100.4,4783,2397,2386,100.5
21050, 부산진구,045002, 41세,2016,5028,2552,2476,103.1,4987,2534,2453,103.3
21050, 부산진구,045003, 42세,2016,5673,2937,2736,107.3,5636,2919,2717,107.4
21050, 부산진구,045004, 43세,2016,5532,2820,2712,104,5497,2800,2697,103.8
21050, 부산진구,045005, 44세,2016,5726,2912,2814,103.5,5691,2892,2799,103.3
21050, 부산진구,050,45~49세,2016,28815,14062,14753,95.3,28620,13961,14659,95.2
21050, 부산진구,050001, 45세,2016,5875,2873,3002,95.7,5843,2858,2985,95.7
21050, 부산진구,050002, 46세,2016,5750,2892,2858,101.2,5703,2869,2834,101.2
21050, 부산진구,050003, 47세,2016,5726,2865,2861,100.1,5683,2840,2843,99.9
21050, 부산진구,050004, 48세,2016,5949,2849,3100,91.9,5906,2828,3078,91.9
21050, 부산진구,050005, 49세,2016,5515,2583,2932,88.1,5485,2566,2919,87.9
21050, 부산진구,055,50~54세,2016,29030,14034,14996,93.6,28868,13964,14904,93.7
21050, 부산진구,055001, 50세,2016,5526,2679,2847,94.1,5494,2665,2829,94.2
21050, 부산진구,055002, 51세,2016,5633,2700,2933,92.1,5603,2685,2918,92
21050, 부산진구,055003, 52세,2016,5421,2672,2749,97.2,5398,2665,2733,97.5
21050, 부산진구,055004, 53세,2016,5987,2872,3115,92.2,5948,2855,3093,92.3
21050, 부산진구,055005, 54세,2016,6463,3111,3352,92.8,6425,3094,3331,92.9
21050, 부산진구,060,55~59세,2016,33673,15722,17951,87.6,33541,15667,17874,87.7
21050, 부산진구,060001, 55세,2016,7128,3296,3832,86,7103,3286,3817,86.1
21050, 부산진구,060002, 56세,2016,7084,3232,3852,83.9,7060,3222,3838,83.9
21050, 부산진구,060003, 57세,2016,6575,3074,3501,87.8,6554,3067,3487,88
21050, 부산진구,060004, 58세,2016,6411,3053,3358,90.9,6380,3040,3340,91
21050, 부산진구,060005, 59세,2016,6475,3067,3408,90,6444,3052,3392,90
21050, 부산진구,065,60~64세,2016,27655,13142,14513,90.6,27537,13091,14446,90.6
21050, 부산진구,065001, 60세,2016,6142,2959,3183,93,6110,2943,3167,92.9
21050, 부산진구,065002, 61세,2016,6330,2970,3360,88.4,6311,2961,3350,88.4
21050, 부산진구,065003, 62세,2016,5304,2621,2683,97.7,5283,2610,2673,97.6
21050, 부산진구,065004, 63세,2016,4787,2167,2620,82.7,4755,2157,2598,83
21050, 부산진구,065005, 64세,2016,5092,2425,2667,90.9,5078,2420,2658,91
21050, 부산진구,070,65~69세,2016,20662,9767,10895,89.6,20623,9742,10881,89.5
21050, 부산진구,070001, 65세,2016,4151,1995,2156,92.5,4143,1991,2152,92.5
21050, 부산진구,070002, 66세,2016,4077,2005,2072,96.8,4066,1998,2068,96.6
21050, 부산진구,070003, 67세,2016,4329,2002,2327,86,4323,1998,2325,85.9
21050, 부산진구,070004, 68세,2016,4213,1959,2254,86.9,4208,1954,2254,86.7
21050, 부산진구,070005, 69세,2016,3892,1806,2086,86.6,3883,1801,2082,86.5
21050, 부산진구,075,70~74세,2016,15564,7015,8549,82.1,15543,7004,8539,82
21050, 부산진구,075001, 70세,2016,2929,1307,1622,80.6,2921,1302,1619,80.4
21050, 부산진구,075002, 71세,2016,2871,1294,1577,82.1,2867,1292,1575,82
21050, 부산진구,075003, 72세,2016,3082,1426,1656,86.1,3079,1424,1655,86
21050, 부산진구,075004, 73세,2016,3178,1448,1730,83.7,3174,1446,1728,83.7
21050, 부산진구,075005, 74세,2016,3504,1540,1964,78.4,3502,1540,1962,78.5
21050, 부산진구,080,75~79세,2016,12255,5022,7233,69.4,12245,5019,7226,69.5
21050, 부산진구,080001, 75세,2016,2927,1267,1660,76.3,2926,1266,1660,76.3
21050, 부산진구,080002, 76세,2016,2667,1108,1559,71.1,2664,1108,1556,71.2
21050, 부산진구,080003, 77세,2016,2607,1057,1550,68.2,2605,1056,1549,68.2
21050, 부산진구,080004, 78세,2016,2070,818,1252,65.3,2066,817,1249,65.4
21050, 부산진구,080005, 79세,2016,1984,772,1212,63.7,1984,772,1212,63.7
21050, 부산진구,085,80~84세,2016,6543,2341,4202,55.7,6537,2340,4197,55.8
21050, 부산진구,085001, 80세,2016,1671,627,1044,60.1,1669,627,1042,60.2
21050, 부산진구,085002, 81세,2016,1535,548,987,55.5,1535,548,987,55.5
21050, 부산진구,085003, 82세,2016,1286,493,793,62.2,1286,493,793,62.2
21050, 부산진구,085004, 83세,2016,1108,377,731,51.6,1104,376,728,51.6
21050, 부산진구,085005, 84세,2016,943,296,647,45.7,943,296,647,45.7
21050, 부산진구,090,85~89세,2016,2715,716,1999,35.8,2711,714,1997,35.8
21050, 부산진구,090001, 85세,2016,725,204,521,39.2,725,204,521,39.2
21050, 부산진구,090002, 86세,2016,638,175,463,37.8,638,175,463,37.8
21050, 부산진구,090003, 87세,2016,542,154,388,39.7,541,153,388,39.4
21050, 부산진구,090004, 88세,2016,453,102,351,29.1,452,102,350,29.1
21050, 부산진구,090005, 89세,2016,357,81,276,29.3,355,80,275,29.1
21050, 부산진구,095,90~94세,2016,781,160,621,25.8,778,160,618,25.9
21050, 부산진구,095001, 90세,2016,244,49,195,25.1,243,49,194,25.3
21050, 부산진구,095002, 91세,2016,185,36,149,24.2,185,36,149,24.2
21050, 부산진구,095003, 92세,2016,135,32,103,31.1,135,32,103,31.1
21050, 부산진구,095004, 93세,2016,137,29,108,26.9,135,29,106,27.4
21050, 부산진구,095005, 94세,2016,80,14,66,21.2,80,14,66,21.2
21050, 부산진구,100,95~99세,2016,143,28,115,24.3,142,28,114,24.6
21050, 부산진구,100001, 95세,2016,67,12,55,21.8,67,12,55,21.8
21050, 부산진구,100002, 96세,2016,38,6,32,18.8,38,6,32,18.8
21050, 부산진구,100003, 97세,2016,19,X,15,26.7,18,X,14,28.6
21050, 부산진구,100004, 98세,2016,11,X,8,37.5,11,X,8,37.5
21050, 부산진구,100005, 99세,2016,8,X,5,60,8,X,5,60
21050, 부산진구,101,100세이상,2016,29,X,29,0,29,X,29,0
21050, 부산진구,102,15세미만,2016,38468,19598,18870,103.9,38368,19553,18815,103.9
21050, 부산진구,103,15~64세,2016,273090,134760,138330,97.4,270837,133888,136949,97.8
21050, 부산진구,104,65세이상,2016,58692,25049,33643,74.5,58608,25007,33601,74.4
21050, 부산진구,086,85세이상,2016,3668,904,2764,32.7,3660,902,2758,32.7
21050, 부산진구,126,평균연령,2016,42.9,41.7,44,,42.9,41.8,44,
21050, 부산진구,127,중위연령,2016,43.7,42.3,45.1,,43.8,42.4,45.3,
21060, 동래구,000,합계,2016,262054,128023,134031,95.5,260967,127561,133406,95.6
21060, 동래구,005,0~4세,2016,9305,4835,4470,108.2,9287,4825,4462,108.1
21060, 동래구,005001, 0세,2016,1745,880,865,101.7,1739,878,861,102
21060, 동래구,005002, 1세,2016,1792,924,868,106.5,1791,924,867,106.6
21060, 동래구,005003, 2세,2016,1798,956,842,113.5,1794,953,841,113.3
21060, 동래구,005004, 3세,2016,1885,984,901,109.2,1880,981,899,109.1
21060, 동래구,005005, 4세,2016,2085,1091,994,109.8,2083,1089,994,109.6
21060, 동래구,010,5~9세,2016,10517,5503,5014,109.8,10496,5490,5006,109.7
21060, 동래구,010001, 5세,2016,2015,1046,969,107.9,2010,1042,968,107.6
21060, 동래구,010002, 6세,2016,2147,1148,999,114.9,2138,1144,994,115.1
21060, 동래구,010003, 7세,2016,1971,1026,945,108.6,1969,1025,944,108.6
21060, 동래구,010004, 8세,2016,2131,1116,1015,110,2128,1114,1014,109.9
21060, 동래구,010005, 9세,2016,2253,1167,1086,107.5,2251,1165,1086,107.3
21060, 동래구,015,10~14세,2016,11391,5929,5462,108.5,11374,5919,5455,108.5
21060, 동래구,015001, 10세,2016,2051,1049,1002,104.7,2048,1047,1001,104.6
21060, 동래구,015002, 11세,2016,2052,1121,931,120.4,2051,1121,930,120.5
21060, 동래구,015003, 12세,2016,2343,1204,1139,105.7,2340,1202,1138,105.6
21060, 동래구,015004, 13세,2016,2458,1274,1184,107.6,2453,1271,1182,107.5
21060, 동래구,015005, 14세,2016,2487,1281,1206,106.2,2482,1278,1204,106.1
21060, 동래구,020,15~19세,2016,15005,8027,6978,115,14990,8020,6970,115.1
21060, 동래구,020001, 15세,2016,2851,1531,1320,116,2848,1529,1319,115.9
21060, 동래구,020002, 16세,2016,3029,1597,1432,111.5,3028,1597,1431,111.6
21060, 동래구,020003, 17세,2016,3093,1658,1435,115.5,3088,1657,1431,115.8
21060, 동래구,020004, 18세,2016,3059,1628,1431,113.8,3057,1627,1430,113.8
21060, 동래구,020005, 19세,2016,2973,1613,1360,118.6,2969,1610,1359,118.5
21060, 동래구,025,20~24세,2016,16700,9053,7647,118.4,16615,9023,7592,118.8
21060, 동래구,025001, 20세,2016,3232,1777,1455,122.1,3225,1774,1451,122.3
21060, 동래구,025002, 21세,2016,3347,1849,1498,123.4,3334,1846,1488,124.1
21060, 동래구,025003, 22세,2016,3305,1824,1481,123.2,3291,1819,1472,123.6
21060, 동래구,025004, 23세,2016,3394,1817,1577,115.2,3374,1810,1564,115.7
21060, 동래구,025005, 24세,2016,3422,1786,1636,109.2,3391,1774,1617,109.7
21060, 동래구,030,25~29세,2016,15298,7809,7489,104.3,15114,7744,7370,105.1
21060, 동래구,030001, 25세,2016,3185,1650,1535,107.5,3157,1641,1516,108.2
21060, 동래구,030002, 26세,2016,3183,1651,1532,107.8,3142,1634,1508,108.4
21060, 동래구,030003, 27세,2016,3076,1565,1511,103.6,3032,1546,1486,104
21060, 동래구,030004, 28세,2016,2940,1466,1474,99.5,2904,1455,1449,100.4
21060, 동래구,030005, 29세,2016,2914,1477,1437,102.8,2879,1468,1411,104
21060, 동래구,035,30~34세,2016,16008,8152,7856,103.8,15822,8061,7761,103.9
21060, 동래구,035001, 30세,2016,2937,1519,1418,107.1,2888,1503,1385,108.5
21060, 동래구,035002, 31세,2016,2837,1458,1379,105.7,2803,1439,1364,105.5
21060, 동래구,035003, 32세,2016,3016,1524,1492,102.1,2982,1505,1477,101.9
21060, 동래구,035004, 33세,2016,3422,1770,1652,107.1,3391,1754,1637,107.1
21060, 동래구,035005, 34세,2016,3796,1881,1915,98.2,3758,1860,1898,98
21060, 동래구,040,35~39세,2016,18721,9287,9434,98.4,18592,9226,9366,98.5
21060, 동래구,040001, 35세,2016,3756,1900,1856,102.4,3728,1885,1843,102.3
21060, 동래구,040002, 36세,2016,4107,2067,2040,101.3,4080,2053,2027,101.3
21060, 동래구,040003, 37세,2016,3788,1838,1950,94.3,3763,1830,1933,94.7
21060, 동래구,040004, 38세,2016,3540,1755,1785,98.3,3516,1742,1774,98.2
21060, 동래구,040005, 39세,2016,3530,1727,1803,95.8,3505,1716,1789,95.9
21060, 동래구,045,40~44세,2016,20276,9773,10503,93,20166,9733,10433,93.3
21060, 동래구,045001, 40세,2016,3529,1666,1863,89.4,3509,1660,1849,89.8
21060, 동래구,045002, 41세,2016,3938,1878,2060,91.2,3919,1874,2045,91.6
21060, 동래구,045003, 42세,2016,4169,2008,2161,92.9,4146,1998,2148,93
21060, 동래구,045004, 43세,2016,4276,2046,2230,91.7,4254,2038,2216,92
21060, 동래구,045005, 44세,2016,4364,2175,2189,99.4,4338,2163,2175,99.4
21060, 동래구,050,45~49세,2016,22935,11007,11928,92.3,22846,10969,11877,92.4
21060, 동래구,050001, 45세,2016,4654,2232,2422,92.2,4637,2225,2412,92.2
21060, 동래구,050002, 46세,2016,4578,2240,2338,95.8,4557,2231,2326,95.9
21060, 동래구,050003, 47세,2016,4612,2198,2414,91.1,4592,2189,2403,91.1
21060, 동래구,050004, 48세,2016,4590,2256,2334,96.7,4576,2251,2325,96.8
21060, 동래구,050005, 49세,2016,4501,2081,2420,86,4484,2073,2411,86
21060, 동래구,055,50~54세,2016,21612,10147,11465,88.5,21539,10115,11424,88.5
21060, 동래구,055001, 50세,2016,4167,2014,2153,93.5,4151,2005,2146,93.4
21060, 동래구,055002, 51세,2016,4252,1965,2287,85.9,4239,1958,2281,85.8
21060, 동래구,055003, 52세,2016,4055,1886,2169,87,4038,1881,2157,87.2
21060, 동래구,055004, 53세,2016,4357,2049,2308,88.8,4339,2042,2297,88.9
21060, 동래구,055005, 54세,2016,4781,2233,2548,87.6,4772,2229,2543,87.7
21060, 동래구,060,55~59세,2016,24588,11591,12997,89.2,24525,11566,12959,89.3
21060, 동래구,060001, 55세,2016,5238,2441,2797,87.3,5226,2436,2790,87.3
21060, 동래구,060002, 56세,2016,5257,2401,2856,84.1,5244,2396,2848,84.1
21060, 동래구,060003, 57세,2016,4765,2266,2499,90.7,4747,2259,2488,90.8
21060, 동래구,060004, 58세,2016,4656,2250,2406,93.5,4646,2246,2400,93.6
21060, 동래구,060005, 59세,2016,4672,2233,2439,91.6,4662,2229,2433,91.6
21060, 동래구,065,60~64세,2016,20068,9406,10662,88.2,20021,9386,10635,88.3
21060, 동래구,065001, 60세,2016,4376,2037,2339,87.1,4369,2033,2336,87
21060, 동래구,065002, 61세,2016,4636,2114,2522,83.8,4625,2112,2513,84
21060, 동래구,065003, 62세,2016,3824,1877,1947,96.4,3817,1874,1943,96.4
21060, 동래구,065004, 63세,2016,3523,1635,1888,86.6,3508,1628,1880,86.6
21060, 동래구,065005, 64세,2016,3709,1743,1966,88.7,3702,1739,1963,88.6
21060, 동래구,070,65~69세,2016,14669,7003,7666,91.4,14646,6994,7652,91.4
21060, 동래구,070001, 65세,2016,3037,1441,1596,90.3,3031,1438,1593,90.3
21060, 동래구,070002, 66세,2016,3006,1431,1575,90.9,2997,1428,1569,91
21060, 동래구,070003, 67세,2016,3011,1427,1584,90.1,3006,1425,1581,90.1
21060, 동래구,070004, 68세,2016,2957,1418,1539,92.1,2956,1417,1539,92.1
21060, 동래구,070005, 69세,2016,2658,1286,1372,93.7,2656,1286,1370,93.9
21060, 동래구,075,70~74세,2016,10405,5003,5402,92.6,10396,4997,5399,92.6
21060, 동래구,075001, 70세,2016,2048,1036,1012,102.4,2045,1033,1012,102.1
21060, 동래구,075002, 71세,2016,1981,996,985,101.1,1981,996,985,101.1
21060, 동래구,075003, 72세,2016,2112,1004,1108,90.6,2110,1003,1107,90.6
21060, 동래구,075004, 73세,2016,2043,968,1075,90,2041,966,1075,89.9
21060, 동래구,075005, 74세,2016,2221,999,1222,81.8,2219,999,1220,81.9
21060, 동래구,080,75~79세,2016,7531,3270,4261,76.7,7526,3269,4257,76.8
21060, 동래구,080001, 75세,2016,1856,830,1026,80.9,1852,829,1023,81
21060, 동래구,080002, 76세,2016,1665,729,936,77.9,1665,729,936,77.9
21060, 동래구,080003, 77세,2016,1541,658,883,74.5,1541,658,883,74.5
21060, 동래구,080004, 78세,2016,1277,554,723,76.6,1277,554,723,76.6
21060, 동래구,080005, 79세,2016,1192,499,693,72,1191,499,692,72.1
21060, 동래구,085,80~84세,2016,4292,1580,2712,58.3,4288,1579,2709,58.3
21060, 동래구,085001, 80세,2016,1113,482,631,76.4,1112,482,630,76.5
21060, 동래구,085002, 81세,2016,1013,383,630,60.8,1013,383,630,60.8
21060, 동래구,085003, 82세,2016,829,288,541,53.2,829,288,541,53.2
21060, 동래구,085004, 83세,2016,711,235,476,49.4,710,235,475,49.5
21060, 동래구,085005, 84세,2016,626,192,434,44.2,624,191,433,44.1
21060, 동래구,090,85~89세,2016,1962,499,1463,34.1,1959,497,1462,34
21060, 동래구,090001, 85세,2016,534,154,380,40.5,533,154,379,40.6
21060, 동래구,090002, 86세,2016,463,119,344,34.6,462,118,344,34.3
21060, 동래구,090003, 87세,2016,391,94,297,31.6,390,93,297,31.3
21060, 동래구,090004, 88세,2016,316,70,246,28.5,316,70,246,28.5
21060, 동래구,090005, 89세,2016,258,62,196,31.6,258,62,196,31.6
21060, 동래구,095,90~94세,2016,626,128,498,25.7,622,128,494,25.9
21060, 동래구,095001, 90세,2016,204,45,159,28.3,204,45,159,28.3
21060, 동래구,095002, 91세,2016,147,24,123,19.5,145,24,121,19.8
21060, 동래구,095003, 92세,2016,96,19,77,24.7,95,19,76,25
21060, 동래구,095004, 93세,2016,118,24,94,25.5,118,24,94,25.5
21060, 동래구,095005, 94세,2016,61,16,45,35.6,60,16,44,36.4
21060, 동래구,100,95~99세,2016,124,18,106,17,124,18,106,17
21060, 동래구,100001, 95세,2016,49,10,39,25.6,49,10,39,25.6
21060, 동래구,100002, 96세,2016,41,5,36,13.9,41,5,36,13.9
21060, 동래구,100003, 97세,2016,12,X,10,20,12,X,10,20
21060, 동래구,100004, 98세,2016,13,X,12,8.3,13,X,12,8.3
21060, 동래구,100005, 99세,2016,9,X,9,0,9,X,9,0
21060, 동래구,101,100세이상,2016,21,X,18,16.7,19,X,17,11.8
21060, 동래구,102,15세미만,2016,31213,16267,14946,108.8,31157,16234,14923,108.8
21060, 동래구,103,15~64세,2016,191211,94252,96959,97.2,190230,93843,96387,97.4
21060, 동래구,104,65세이상,2016,39630,17504,22126,79.1,39580,17484,22096,79.1
21060, 동래구,086,85세이상,2016,2733,648,2085,31.1,2724,645,2079,31
21060, 동래구,126,평균연령,2016,42.8,41.4,44,,42.8,41.4,44.1,
21060, 동래구,127,중위연령,2016,44.5,42.9,45.9,,44.5,43,45.9,
21070, 남구,000,합계,2016,279802,137636,142166,96.8,275666,135641,140025,96.9
21070, 남구,005,0~4세,2016,9554,4930,4624,106.6,9503,4905,4598,106.7
21070, 남구,005001, 0세,2016,1775,903,872,103.6,1764,899,865,103.9
21070, 남구,005002, 1세,2016,1868,990,878,112.8,1858,985,873,112.8
21070, 남구,005003, 2세,2016,1850,955,895,106.7,1837,947,890,106.4
21070, 남구,005004, 3세,2016,1933,998,935,106.7,1923,993,930,106.8
21070, 남구,005005, 4세,2016,2128,1084,1044,103.8,2121,1081,1040,103.9
21070, 남구,010,5~9세,2016,10854,5536,5318,104.1,10808,5504,5304,103.8
21070, 남구,010001, 5세,2016,2213,1087,1126,96.5,2207,1084,1123,96.5
21070, 남구,010002, 6세,2016,2203,1145,1058,108.2,2193,1138,1055,107.9
21070, 남구,010003, 7세,2016,2012,1000,1012,98.8,2005,994,1011,98.3
21070, 남구,010004, 8세,2016,2150,1085,1065,101.9,2137,1078,1059,101.8
21070, 남구,010005, 9세,2016,2276,1219,1057,115.3,2266,1210,1056,114.6
21070, 남구,015,10~14세,2016,11094,5751,5343,107.6,11059,5735,5324,107.7
21070, 남구,015001, 10세,2016,2050,1067,983,108.5,2046,1066,980,108.8
21070, 남구,015002, 11세,2016,2087,1103,984,112.1,2082,1100,982,112
21070, 남구,015003, 12세,2016,2232,1157,1075,107.6,2224,1154,1070,107.9
21070, 남구,015004, 13세,2016,2324,1168,1156,101,2317,1164,1153,101
21070, 남구,015005, 14세,2016,2401,1256,1145,109.7,2390,1251,1139,109.8
21070, 남구,020,15~19세,2016,17723,9290,8433,110.2,17346,9117,8229,110.8
21070, 남구,020001, 15세,2016,2742,1452,1290,112.6,2735,1446,1289,112.2
21070, 남구,020002, 16세,2016,3088,1626,1462,111.2,3075,1617,1458,110.9
21070, 남구,020003, 17세,2016,3003,1612,1391,115.9,2972,1596,1376,116
21070, 남구,020004, 18세,2016,3767,2030,1737,116.9,3642,1977,1665,118.7
21070, 남구,020005, 19세,2016,5123,2570,2553,100.7,4922,2481,2441,101.6
21070, 남구,025,20~24세,2016,23297,12125,11172,108.5,22080,11636,10444,111.4
21070, 남구,025001, 20세,2016,4598,2061,2537,81.2,4341,1966,2375,82.8
21070, 남구,025002, 21세,2016,4588,2210,2378,92.9,4312,2116,2196,96.4
21070, 남구,025003, 22세,2016,4718,2499,2219,112.6,4467,2390,2077,115.1
21070, 남구,025004, 23세,2016,4721,2698,2023,133.4,4481,2601,1880,138.4
21070, 남구,025005, 24세,2016,4672,2657,2015,131.9,4479,2563,1916,133.8
21070, 남구,030,25~29세,2016,16903,9130,7773,117.5,16122,8772,7350,119.3
21070, 남구,030001, 25세,2016,3958,2280,1678,135.9,3787,2199,1588,138.5
21070, 남구,030002, 26세,2016,3525,1910,1615,118.3,3336,1809,1527,118.5
21070, 남구,030003, 27세,2016,3307,1800,1507,119.4,3153,1732,1421,121.9
21070, 남구,030004, 28세,2016,3099,1623,1476,110,2958,1560,1398,111.6
21070, 남구,030005, 29세,2016,3014,1517,1497,101.3,2888,1472,1416,104
21070, 남구,035,30~34세,2016,16306,8483,7823,108.4,15913,8260,7653,107.9
21070, 남구,035001, 30세,2016,3016,1575,1441,109.3,2909,1513,1396,108.4
21070, 남구,035002, 31세,2016,2920,1519,1401,108.4,2830,1470,1360,108.1
21070, 남구,035003, 32세,2016,3083,1612,1471,109.6,3011,1576,1435,109.8
21070, 남구,035004, 33세,2016,3420,1776,1644,108,3360,1740,1620,107.4
21070, 남구,035005, 34세,2016,3867,2001,1866,107.2,3803,1961,1842,106.5
21070, 남구,040,35~39세,2016,19450,9742,9708,100.4,19168,9575,9593,99.8
21070, 남구,040001, 35세,2016,3911,2013,1898,106.1,3844,1975,1869,105.7
21070, 남구,040002, 36세,2016,4119,2066,2053,100.6,4056,2031,2025,100.3
21070, 남구,040003, 37세,2016,4022,1983,2039,97.3,3965,1948,2017,96.6
21070, 남구,040004, 38세,2016,3655,1846,1809,102,3606,1814,1792,101.2
21070, 남구,040005, 39세,2016,3743,1834,1909,96.1,3697,1807,1890,95.6
21070, 남구,045,40~44세,2016,21266,10822,10444,103.6,21017,10679,10338,103.3
21070, 남구,045001, 40세,2016,3653,1827,1826,100.1,3594,1789,1805,99.1
21070, 남구,045002, 41세,2016,4061,2103,1958,107.4,4018,2076,1942,106.9
21070, 남구,045003, 42세,2016,4365,2220,2145,103.5,4321,2195,2126,103.2
21070, 남구,045004, 43세,2016,4639,2337,2302,101.5,4583,2307,2276,101.4
21070, 남구,045005, 44세,2016,4548,2335,2213,105.5,4501,2312,2189,105.6
21070, 남구,050,45~49세,2016,22991,11443,11548,99.1,22778,11322,11456,98.8
21070, 남구,050001, 45세,2016,4811,2409,2402,100.3,4761,2377,2384,99.7
21070, 남구,050002, 46세,2016,4603,2287,2316,98.7,4561,2260,2301,98.2
21070, 남구,050003, 47세,2016,4708,2365,2343,100.9,4662,2341,2321,100.9
21070, 남구,050004, 48세,2016,4676,2306,2370,97.3,4636,2284,2352,97.1
21070, 남구,050005, 49세,2016,4193,2076,2117,98.1,4158,2060,2098,98.2
21070, 남구,055,50~54세,2016,21019,10215,10804,94.5,20847,10129,10718,94.5
21070, 남구,055001, 50세,2016,4163,2053,2110,97.3,4125,2031,2094,97
21070, 남구,055002, 51세,2016,4010,1940,2070,93.7,3968,1918,2050,93.6
21070, 남구,055003, 52세,2016,4019,1999,2020,99,3989,1985,2004,99.1
21070, 남구,055004, 53세,2016,4303,2049,2254,90.9,4275,2037,2238,91
21070, 남구,055005, 54세,2016,4524,2174,2350,92.5,4490,2158,2332,92.5
21070, 남구,060,55~59세,2016,24216,11285,12931,87.3,24078,11212,12866,87.1
21070, 남구,060001, 55세,2016,4881,2255,2626,85.9,4848,2234,2614,85.5
21070, 남구,060002, 56세,2016,5246,2399,2847,84.3,5215,2383,2832,84.1
21070, 남구,060003, 57세,2016,4699,2186,2513,87,4672,2174,2498,87
21070, 남구,060004, 58세,2016,4649,2190,2459,89.1,4625,2176,2449,88.9
21070, 남구,060005, 59세,2016,4741,2255,2486,90.7,4718,2245,2473,90.8
21070, 남구,065,60~64세,2016,20476,9547,10929,87.4,20378,9494,10884,87.2
21070, 남구,065001, 60세,2016,4508,2044,2464,83,4486,2033,2453,82.9
21070, 남구,065002, 61세,2016,4654,2154,2500,86.2,4630,2141,2489,86
21070, 남구,065003, 62세,2016,3978,1917,2061,93,3955,1904,2051,92.8
21070, 남구,065004, 63세,2016,3476,1629,1847,88.2,3458,1619,1839,88
21070, 남구,065005, 64세,2016,3860,1803,2057,87.7,3849,1797,2052,87.6
21070, 남구,070,65~69세,2016,16045,7443,8602,86.5,16005,7423,8582,86.5
21070, 남구,070001, 65세,2016,3176,1493,1683,88.7,3168,1487,1681,88.5
21070, 남구,070002, 66세,2016,3299,1533,1766,86.8,3290,1531,1759,87
21070, 남구,070003, 67세,2016,3358,1563,1795,87.1,3352,1559,1793,86.9
21070, 남구,070004, 68세,2016,3174,1439,1735,82.9,3162,1434,1728,83
21070, 남구,070005, 69세,2016,3038,1415,1623,87.2,3033,1412,1621,87.1
21070, 남구,075,70~74세,2016,12321,5653,6668,84.8,12308,5650,6658,84.9
21070, 남구,075001, 70세,2016,2308,1060,1248,84.9,2305,1059,1246,85
21070, 남구,075002, 71세,2016,2336,1084,1252,86.6,2332,1083,1249,86.7
21070, 남구,075003, 72세,2016,2480,1131,1349,83.8,2478,1131,1347,84
21070, 남구,075004, 73세,2016,2582,1145,1437,79.7,2580,1145,1435,79.8
21070, 남구,075005, 74세,2016,2615,1233,1382,89.2,2613,1232,1381,89.2
21070, 남구,080,75~79세,2016,8876,3886,4990,77.9,8864,3882,4982,77.9
21070, 남구,080001, 75세,2016,2082,944,1138,83,2080,944,1136,83.1
21070, 남구,080002, 76세,2016,2018,884,1134,78,2016,884,1132,78.1
21070, 남구,080003, 77세,2016,1824,811,1013,80.1,1823,810,1013,80
21070, 남구,080004, 78세,2016,1561,662,899,73.6,1558,662,896,73.9
21070, 남구,080005, 79세,2016,1391,585,806,72.6,1387,582,805,72.3
21070, 남구,085,80~84세,2016,4703,1709,2994,57.1,4695,1703,2992,56.9
21070, 남구,085001, 80세,2016,1234,471,763,61.7,1232,469,763,61.5
21070, 남구,085002, 81세,2016,1117,441,676,65.2,1117,441,676,65.2
21070, 남구,085003, 82세,2016,936,322,614,52.4,934,321,613,52.4
21070, 남구,085004, 83세,2016,719,252,467,54,717,250,467,53.5
21070, 남구,085005, 84세,2016,697,223,474,47,695,222,473,46.9
21070, 남구,090,85~89세,2016,1978,504,1474,34.2,1973,503,1470,34.2
21070, 남구,090001, 85세,2016,503,156,347,45,502,156,346,45.1
21070, 남구,090002, 86세,2016,449,125,324,38.6,448,124,324,38.3
21070, 남구,090003, 87세,2016,383,101,282,35.8,381,101,280,36.1
21070, 남구,090004, 88세,2016,369,78,291,26.8,368,78,290,26.9
21070, 남구,090005, 89세,2016,274,44,230,19.1,274,44,230,19.1
21070, 남구,095,90~94세,2016,603,119,484,24.6,598,117,481,24.3
21070, 남구,095001, 90세,2016,193,40,153,26.1,191,39,152,25.7
21070, 남구,095002, 91세,2016,177,35,142,24.6,176,35,141,24.8
21070, 남구,095003, 92세,2016,87,18,69,26.1,87,18,69,26.1
21070, 남구,095004, 93세,2016,76,14,62,22.6,75,14,61,23
21070, 남구,095005, 94세,2016,70,12,58,20.7,69,11,58,19
21070, 남구,100,95~99세,2016,118,22,96,22.9,117,22,95,23.2
21070, 남구,100001, 95세,2016,49,7,42,16.7,48,7,41,17.1
21070, 남구,100002, 96세,2016,23,X,19,21.1,23,X,19,21.1
21070, 남구,100003, 97세,2016,16,5,11,45.5,16,5,11,45.5
21070, 남구,100004, 98세,2016,20,5,15,33.3,20,5,15,33.3
21070, 남구,100005, 99세,2016,10,X,9,11.1,10,X,9,11.1
21070, 남구,101,100세이상,2016,9,X,8,12.5,9,X,8,12.5
21070, 남구,102,15세미만,2016,31502,16217,15285,106.1,31370,16144,15226,106
21070, 남구,103,15~64세,2016,203647,102082,101565,100.5,199727,100196,99531,100.7
21070, 남구,104,65세이상,2016,44653,19337,25316,76.4,44569,19301,25268,76.4
21070, 남구,086,85세이상,2016,2708,646,2062,31.3,2697,643,2054,31.3
21070, 남구,126,평균연령,2016,42.4,41.1,43.7,,42.6,41.2,43.9,
21070, 남구,127,중위연령,2016,43.6,42,45.2,,43.9,42.2,45.5,
21080, 북구,000,합계,2016,303445,150453,152992,98.3,301554,149623,151931,98.5
21080, 북구,005,0~4세,2016,12303,6336,5967,106.2,12286,6332,5954,106.3
21080, 북구,005001, 0세,2016,2437,1235,1202,102.7,2436,1235,1201,102.8
21080, 북구,005002, 1세,2016,2472,1294,1178,109.8,2468,1293,1175,110
21080, 북구,005003, 2세,2016,2468,1239,1229,100.8,2465,1239,1226,101.1
21080, 북구,005004, 3세,2016,2386,1219,1167,104.5,2383,1218,1165,104.5
21080, 북구,005005, 4세,2016,2540,1349,1191,113.3,2534,1347,1187,113.5
21080, 북구,010,5~9세,2016,11451,5842,5609,104.2,11438,5837,5601,104.2
21080, 북구,010001, 5세,2016,2364,1201,1163,103.3,2361,1200,1161,103.4
21080, 북구,010002, 6세,2016,2227,1164,1063,109.5,2222,1161,1061,109.4
21080, 북구,010003, 7세,2016,2301,1158,1143,101.3,2298,1157,1141,101.4
21080, 북구,010004, 8세,2016,2303,1177,1126,104.5,2302,1177,1125,104.6
21080, 북구,010005, 9세,2016,2256,1142,1114,102.5,2255,1142,1113,102.6
21080, 북구,015,10~14세,2016,12319,6458,5861,110.2,12308,6453,5855,110.2
21080, 북구,015001, 10세,2016,2259,1208,1051,114.9,2258,1207,1051,114.8
21080, 북구,015002, 11세,2016,2311,1225,1086,112.8,2309,1225,1084,113
21080, 북구,015003, 12세,2016,2436,1269,1167,108.7,2432,1267,1165,108.8
21080, 북구,015004, 13세,2016,2590,1357,1233,110.1,2587,1355,1232,110
21080, 북구,015005, 14세,2016,2723,1399,1324,105.7,2722,1399,1323,105.7
21080, 북구,020,15~19세,2016,18366,9785,8581,114,18161,9677,8484,114.1
21080, 북구,020001, 15세,2016,3195,1666,1529,109,3192,1664,1528,108.9
21080, 북구,020002, 16세,2016,3546,1875,1671,112.2,3539,1870,1669,112
21080, 북구,020003, 17세,2016,3515,1872,1643,113.9,3505,1867,1638,114
21080, 북구,020004, 18세,2016,3972,2164,1808,119.7,3930,2140,1790,119.6
21080, 북구,020005, 19세,2016,4138,2208,1930,114.4,3995,2136,1859,114.9
21080, 북구,025,20~24세,2016,22893,12534,10359,121,22417,12279,10138,121.1
21080, 북구,025001, 20세,2016,4414,2415,1999,120.8,4276,2334,1942,120.2
21080, 북구,025002, 21세,2016,4564,2558,2006,127.5,4472,2504,1968,127.2
21080, 북구,025003, 22세,2016,4674,2575,2099,122.7,4584,2523,2061,122.4
21080, 북구,025004, 23세,2016,4573,2490,2083,119.5,4479,2450,2029,120.7
21080, 북구,025005, 24세,2016,4668,2496,2172,114.9,4606,2468,2138,115.4
21080, 북구,030,25~29세,2016,19597,10183,9414,108.2,19323,10099,9224,109.5
21080, 북구,030001, 25세,2016,4306,2360,1946,121.3,4250,2341,1909,122.6
21080, 북구,030002, 26세,2016,4040,2115,1925,109.9,3976,2095,1881,111.4
21080, 북구,030003, 27세,2016,3915,2017,1898,106.3,3864,2003,1861,107.6
21080, 북구,030004, 28세,2016,3703,1841,1862,98.9,3647,1823,1824,99.9
21080, 북구,030005, 29세,2016,3633,1850,1783,103.8,3586,1837,1749,105
21080, 북구,035,30~34세,2016,19234,9818,9416,104.3,19057,9757,9300,104.9
21080, 북구,035001, 30세,2016,3497,1809,1688,107.2,3465,1799,1666,108
21080, 북구,035002, 31세,2016,3612,1808,1804,100.2,3576,1799,1777,101.2
21080, 북구,035003, 32세,2016,3684,1884,1800,104.7,3651,1873,1778,105.3
21080, 북구,035004, 33세,2016,4059,2084,1975,105.5,4021,2070,1951,106.1
21080, 북구,035005, 34세,2016,4382,2233,2149,103.9,4344,2216,2128,104.1
21080, 북구,040,35~39세,2016,21046,10862,10184,106.7,20922,10807,10115,106.8
21080, 북구,040001, 35세,2016,4490,2311,2179,106.1,4461,2299,2162,106.3
21080, 북구,040002, 36세,2016,4517,2391,2126,112.5,4497,2382,2115,112.6
21080, 북구,040003, 37세,2016,4321,2175,2146,101.4,4289,2163,2126,101.7
21080, 북구,040004, 38세,2016,3814,1976,1838,107.5,3792,1963,1829,107.3
21080, 북구,040005, 39세,2016,3904,2009,1895,106,3883,2000,1883,106.2
21080, 북구,045,40~44세,2016,21591,10573,11018,96,21481,10530,10951,96.2
21080, 북구,045001, 40세,2016,3730,1901,1829,103.9,3707,1894,1813,104.5
21080, 북구,045002, 41세,2016,4176,2077,2099,99,4155,2068,2087,99.1
21080, 북구,045003, 42세,2016,4338,2143,2195,97.6,4315,2136,2179,98
21080, 북구,045004, 43세,2016,4665,2194,2471,88.8,4644,2185,2459,88.9
21080, 북구,045005, 44세,2016,4682,2258,2424,93.2,4660,2247,2413,93.1
21080, 북구,050,45~49세,2016,27071,12507,14564,85.9,26935,12455,14480,86
21080, 북구,050001, 45세,2016,5062,2376,2686,88.5,5037,2365,2672,88.5
21080, 북구,050002, 46세,2016,5221,2419,2802,86.3,5184,2407,2777,86.7
21080, 북구,050003, 47세,2016,5492,2548,2944,86.5,5465,2540,2925,86.8
21080, 북구,050004, 48세,2016,5766,2635,3131,84.2,5739,2622,3117,84.1
21080, 북구,050005, 49세,2016,5530,2529,3001,84.3,5510,2521,2989,84.3
21080, 북구,055,50~54세,2016,28327,13682,14645,93.4,28188,13617,14571,93.5
21080, 북구,055001, 50세,2016,5484,2606,2878,90.5,5452,2591,2861,90.6
21080, 북구,055002, 51세,2016,5548,2610,2938,88.8,5525,2600,2925,88.9
21080, 북구,055003, 52세,2016,5272,2527,2745,92.1,5243,2513,2730,92.1
21080, 북구,055004, 53세,2016,5890,2911,2979,97.7,5859,2897,2962,97.8
21080, 북구,055005, 54세,2016,6133,3028,3105,97.5,6109,3016,3093,97.5
21080, 북구,060,55~59세,2016,29933,14943,14990,99.7,29843,14903,14940,99.8
21080, 북구,060001, 55세,2016,6818,3374,3444,98,6800,3368,3432,98.1
21080, 북구,060002, 56세,2016,6546,3250,3296,98.6,6525,3242,3283,98.8
21080, 북구,060003, 57세,2016,5814,2922,2892,101,5800,2914,2886,101
21080, 북구,060004, 58세,2016,5424,2706,2718,99.6,5402,2697,2705,99.7
21080, 북구,060005, 59세,2016,5331,2691,2640,101.9,5316,2682,2634,101.8
21080, 북구,065,60~64세,2016,21177,10588,10589,100,21115,10561,10554,100.1
21080, 북구,065001, 60세,2016,4812,2418,2394,101,4798,2410,2388,100.9
21080, 북구,065002, 61세,2016,5052,2458,2594,94.8,5034,2449,2585,94.7
21080, 북구,065003, 62세,2016,4085,2060,2025,101.7,4072,2056,2016,102
21080, 북구,065004, 63세,2016,3495,1743,1752,99.5,3486,1740,1746,99.7
21080, 북구,065005, 64세,2016,3733,1909,1824,104.7,3725,1906,1819,104.8
21080, 북구,070,65~69세,2016,14184,6946,7238,96,14153,6934,7219,96.1
21080, 북구,070001, 65세,2016,2899,1434,1465,97.9,2889,1430,1459,98
21080, 북구,070002, 66세,2016,3035,1537,1498,102.6,3028,1534,1494,102.7
21080, 북구,070003, 67세,2016,2856,1387,1469,94.4,2852,1385,1467,94.4
21080, 북구,070004, 68세,2016,2784,1341,1443,92.9,2779,1341,1438,93.3
21080, 북구,070005, 69세,2016,2610,1247,1363,91.5,2605,1244,1361,91.4
21080, 북구,075,70~74세,2016,9788,4576,5212,87.8,9780,4572,5208,87.8
21080, 북구,075001, 70세,2016,1926,942,984,95.7,1923,941,982,95.8
21080, 북구,075002, 71세,2016,1816,874,942,92.8,1816,874,942,92.8
21080, 북구,075003, 72세,2016,1893,864,1029,84,1890,863,1027,84
21080, 북구,075004, 73세,2016,2018,942,1076,87.5,2018,942,1076,87.5
21080, 북구,075005, 74세,2016,2135,954,1181,80.8,2133,952,1181,80.6
21080, 북구,080,75~79세,2016,7308,2956,4352,67.9,7297,2950,4347,67.9
21080, 북구,080001, 75세,2016,1728,738,990,74.5,1726,738,988,74.7
21080, 북구,080002, 76세,2016,1599,668,931,71.8,1597,667,930,71.7
21080, 북구,080003, 77세,2016,1502,599,903,66.3,1499,597,902,66.2
21080, 북구,080004, 78세,2016,1331,507,824,61.5,1329,506,823,61.5
21080, 북구,080005, 79세,2016,1148,444,704,63.1,1146,442,704,62.8
21080, 북구,085,80~84세,2016,4280,1320,2960,44.6,4276,1319,2957,44.6
21080, 북구,085001, 80세,2016,1050,360,690,52.2,1049,360,689,52.2
21080, 북구,085002, 81세,2016,1022,327,695,47.1,1021,327,694,47.1
21080, 북구,085003, 82세,2016,839,259,580,44.7,837,258,579,44.6
21080, 북구,085004, 83세,2016,717,228,489,46.6,717,228,489,46.6
21080, 북구,085005, 84세,2016,652,146,506,28.9,652,146,506,28.9
21080, 북구,090,85~89세,2016,1857,419,1438,29.1,1856,418,1438,29.1
21080, 북구,090001, 85세,2016,494,107,387,27.6,494,107,387,27.6
21080, 북구,090002, 86세,2016,414,97,317,30.6,414,97,317,30.6
21080, 북구,090003, 87세,2016,374,87,287,30.3,373,86,287,30
21080, 북구,090004, 88세,2016,328,73,255,28.6,328,73,255,28.6
21080, 북구,090005, 89세,2016,247,55,192,28.6,247,55,192,28.6
21080, 북구,095,90~94세,2016,591,107,484,22.1,591,107,484,22.1
21080, 북구,095001, 90세,2016,174,38,136,27.9,174,38,136,27.9
21080, 북구,095002, 91세,2016,151,22,129,17.1,151,22,129,17.1
21080, 북구,095003, 92세,2016,110,25,85,29.4,110,25,85,29.4
21080, 북구,095004, 93세,2016,104,16,88,18.2,104,16,88,18.2
21080, 북구,095005, 94세,2016,52,6,46,13,52,6,46,13
21080, 북구,100,95~99세,2016,118,16,102,15.7,117,15,102,14.7
21080, 북구,100001, 95세,2016,41,X,38,7.9,41,X,38,7.9
21080, 북구,100002, 96세,2016,31,8,23,34.8,31,8,23,34.8
21080, 북구,100003, 97세,2016,25,X,22,13.6,25,X,22,13.6
21080, 북구,100004, 98세,2016,10,X,10,0,10,X,10,0
21080, 북구,100005, 99세,2016,11,X,9,22.2,10,X,9,11.1
21080, 북구,101,100세이상,2016,11,X,9,22.2,10,X,9,11.1
21080, 북구,102,15세미만,2016,36073,18636,17437,106.9,36032,18622,17410,107
21080, 북구,103,15~64세,2016,229235,115475,113760,101.5,227442,114685,112757,101.7
21080, 북구,104,65세이상,2016,38137,16342,21795,75,38080,16316,21764,75
21080, 북구,086,85세이상,2016,2577,544,2033,26.8,2574,541,2033,26.6
21080, 북구,126,평균연령,2016,41.6,40.3,42.8,,41.6,40.4,42.8,
21080, 북구,127,중위연령,2016,43.5,41.7,45,,43.6,41.8,45.1,
21090, 해운대구,000,합계,2016,408042,198346,209696,94.6,404100,196283,207817,94.4
21090, 해운대구,005,0~4세,2016,15891,8318,7573,109.8,15781,8259,7522,109.8
21090, 해운대구,005001, 0세,2016,2899,1483,1416,104.7,2879,1472,1407,104.6
21090, 해운대구,005002, 1세,2016,3103,1619,1484,109.1,3076,1603,1473,108.8
21090, 해운대구,005003, 2세,2016,3084,1640,1444,113.6,3063,1630,1433,113.7
21090, 해운대구,005004, 3세,2016,3271,1715,1556,110.2,3252,1705,1547,110.2
21090, 해운대구,005005, 4세,2016,3534,1861,1673,111.2,3511,1849,1662,111.3
21090, 해운대구,010,5~9세,2016,17753,9163,8590,106.7,17636,9102,8534,106.7
21090, 해운대구,010001, 5세,2016,3562,1863,1699,109.7,3544,1853,1691,109.6
21090, 해운대구,010002, 6세,2016,3439,1784,1655,107.8,3409,1771,1638,108.1
21090, 해운대구,010003, 7세,2016,3370,1735,1635,106.1,3342,1722,1620,106.3
21090, 해운대구,010004, 8세,2016,3625,1865,1760,106,3603,1849,1754,105.4
21090, 해운대구,010005, 9세,2016,3757,1916,1841,104.1,3738,1907,1831,104.2
21090, 해운대구,015,10~14세,2016,19297,9969,9328,106.9,19188,9910,9278,106.8
21090, 해운대구,015001, 10세,2016,3559,1835,1724,106.4,3540,1827,1713,106.7
21090, 해운대구,015002, 11세,2016,3582,1830,1752,104.5,3556,1812,1744,103.9
21090, 해운대구,015003, 12세,2016,3888,1990,1898,104.8,3868,1981,1887,105
21090, 해운대구,015004, 13세,2016,4071,2126,1945,109.3,4049,2116,1933,109.5
21090, 해운대구,015005, 14세,2016,4197,2188,2009,108.9,4175,2174,2001,108.6
21090, 해운대구,020,15~19세,2016,26582,14354,12228,117.4,26413,14262,12151,117.4
21090, 해운대구,020001, 15세,2016,5041,2642,2399,110.1,5007,2622,2385,109.9
21090, 해운대구,020002, 16세,2016,5710,3179,2531,125.6,5683,3166,2517,125.8
21090, 해운대구,020003, 17세,2016,5477,2994,2483,120.6,5446,2979,2467,120.8
21090, 해운대구,020004, 18세,2016,5410,2946,2464,119.6,5380,2931,2449,119.7
21090, 해운대구,020005, 19세,2016,4944,2593,2351,110.3,4897,2564,2333,109.9
21090, 해운대구,025,20~24세,2016,25867,14061,11806,119.1,25320,13798,11522,119.8
21090, 해운대구,025001, 20세,2016,5249,2916,2333,125,5183,2890,2293,126
21090, 해운대구,025002, 21세,2016,5160,2915,2245,129.8,5051,2872,2179,131.8
21090, 해운대구,025003, 22세,2016,5197,2872,2325,123.5,5084,2809,2275,123.5
21090, 해운대구,025004, 23세,2016,5058,2652,2406,110.2,4932,2592,2340,110.8
21090, 해운대구,025005, 24세,2016,5203,2706,2497,108.4,5070,2635,2435,108.2
21090, 해운대구,030,25~29세,2016,22294,11276,11018,102.3,21703,10969,10734,102.2
21090, 해운대구,030001, 25세,2016,4900,2494,2406,103.7,4793,2441,2352,103.8
21090, 해운대구,030002, 26세,2016,4541,2357,2184,107.9,4403,2288,2115,108.2
21090, 해운대구,030003, 27세,2016,4493,2282,2211,103.2,4390,2238,2152,104
21090, 해운대구,030004, 28세,2016,4166,2116,2050,103.2,4042,2041,2001,102
21090, 해운대구,030005, 29세,2016,4194,2027,2167,93.5,4075,1961,2114,92.8
21090, 해운대구,035,30~34세,2016,23981,11589,12392,93.5,23501,11336,12165,93.2
21090, 해운대구,035001, 30세,2016,4299,2077,2222,93.5,4180,2018,2162,93.3
21090, 해운대구,035002, 31세,2016,4347,2138,2209,96.8,4257,2084,2173,95.9
21090, 해운대구,035003, 32세,2016,4540,2199,2341,93.9,4446,2152,2294,93.8
21090, 해운대구,035004, 33세,2016,5073,2393,2680,89.3,5001,2365,2636,89.7
21090, 해운대구,035005, 34세,2016,5722,2782,2940,94.6,5617,2717,2900,93.7
21090, 해운대구,040,35~39세,2016,30271,14443,15828,91.2,29885,14233,15652,90.9
21090, 해운대구,040001, 35세,2016,6109,2896,3213,90.1,6032,2856,3176,89.9
21090, 해운대구,040002, 36세,2016,6351,2967,3384,87.7,6267,2928,3339,87.7
21090, 해운대구,040003, 37세,2016,6085,2850,3235,88.1,6010,2806,3204,87.6
21090, 해운대구,040004, 38세,2016,5718,2789,2929,95.2,5644,2744,2900,94.6
21090, 해운대구,040005, 39세,2016,6008,2941,3067,95.9,5932,2899,3033,95.6
21090, 해운대구,045,40~44세,2016,33788,16024,17764,90.2,33419,15812,17607,89.8
21090, 해운대구,045001, 40세,2016,5880,2890,2990,96.7,5803,2841,2962,95.9
21090, 해운대구,045002, 41세,2016,6274,2908,3366,86.4,6199,2859,3340,85.6
21090, 해운대구,045003, 42세,2016,6965,3248,3717,87.4,6887,3213,3674,87.5
21090, 해운대구,045004, 43세,2016,7082,3376,3706,91.1,7004,3339,3665,91.1
21090, 해운대구,045005, 44세,2016,7587,3602,3985,90.4,7526,3560,3966,89.8
21090, 해운대구,050,45~49세,2016,38451,18246,20205,90.3,38147,18081,20066,90.1
21090, 해운대구,050001, 45세,2016,7912,3722,4190,88.8,7849,3695,4154,89
21090, 해운대구,050002, 46세,2016,7873,3739,4134,90.4,7814,3708,4106,90.3
21090, 해운대구,050003, 47세,2016,7673,3681,3992,92.2,7608,3644,3964,91.9
21090, 해운대구,050004, 48세,2016,7787,3708,4079,90.9,7725,3672,4053,90.6
21090, 해운대구,050005, 49세,2016,7206,3396,3810,89.1,7151,3362,3789,88.7
21090, 해운대구,055,50~54세,2016,34901,16908,17993,94,34628,16780,17848,94
21090, 해운대구,055001, 50세,2016,6866,3338,3528,94.6,6818,3317,3501,94.7
21090, 해운대구,055002, 51세,2016,6893,3300,3593,91.8,6834,3279,3555,92.2
21090, 해운대구,055003, 52세,2016,6616,3166,3450,91.8,6559,3137,3422,91.7
21090, 해운대구,055004, 53세,2016,7272,3556,3716,95.7,7213,3525,3688,95.6
21090, 해운대구,055005, 54세,2016,7254,3548,3706,95.7,7204,3522,3682,95.7
21090, 해운대구,060,55~59세,2016,35614,17009,18605,91.4,35423,16915,18508,91.4
21090, 해운대구,060001, 55세,2016,7765,3700,4065,91,7725,3683,4042,91.1
21090, 해운대구,060002, 56세,2016,7637,3603,4034,89.3,7598,3586,4012,89.4
21090, 해운대구,060003, 57세,2016,6867,3319,3548,93.5,6833,3299,3534,93.4
21090, 해운대구,060004, 58세,2016,6743,3243,3500,92.7,6706,3228,3478,92.8
21090, 해운대구,060005, 59세,2016,6602,3144,3458,90.9,6561,3119,3442,90.6
21090, 해운대구,065,60~64세,2016,27744,13392,14352,93.3,27597,13312,14285,93.2
21090, 해운대구,065001, 60세,2016,6291,3132,3159,99.1,6258,3118,3140,99.3
21090, 해운대구,065002, 61세,2016,6406,3025,3381,89.5,6371,3001,3370,89.1
21090, 해운대구,065003, 62세,2016,5205,2609,2596,100.5,5176,2593,2583,100.4
21090, 해운대구,065004, 63세,2016,4750,2248,2502,89.8,4729,2239,2490,89.9
21090, 해운대구,065005, 64세,2016,5092,2378,2714,87.6,5063,2361,2702,87.4
21090, 해운대구,070,65~69세,2016,19571,9170,10401,88.2,19514,9142,10372,88.1
21090, 해운대구,070001, 65세,2016,3843,1828,2015,90.7,3828,1823,2005,90.9
21090, 해운대구,070002, 66세,2016,3923,1829,2094,87.3,3906,1820,2086,87.2
21090, 해운대구,070003, 67세,2016,4077,1873,2204,85,4067,1866,2201,84.8
21090, 해운대구,070004, 68세,2016,3976,1885,2091,90.1,3969,1882,2087,90.2
21090, 해운대구,070005, 69세,2016,3752,1755,1997,87.9,3744,1751,1993,87.9
21090, 해운대구,075,70~74세,2016,14334,6499,7835,82.9,14304,6477,7827,82.8
21090, 해운대구,075001, 70세,2016,2664,1250,1414,88.4,2656,1243,1413,88
21090, 해운대구,075002, 71세,2016,2778,1319,1459,90.4,2772,1314,1458,90.1
21090, 해운대구,075003, 72세,2016,2893,1351,1542,87.6,2886,1347,1539,87.5
21090, 해운대구,075004, 73세,2016,2881,1233,1648,74.8,2879,1231,1648,74.7
21090, 해운대구,075005, 74세,2016,3118,1346,1772,76,3111,1342,1769,75.9
21090, 해운대구,080,75~79세,2016,11257,4629,6628,69.8,11228,4616,6612,69.8
21090, 해운대구,080001, 75세,2016,2671,1120,1551,72.2,2663,1117,1546,72.3
21090, 해운대구,080002, 76세,2016,2405,1039,1366,76.1,2399,1035,1364,75.9
21090, 해운대구,080003, 77세,2016,2332,954,1378,69.2,2323,950,1373,69.2
21090, 해운대구,080004, 78세,2016,1987,794,1193,66.6,1986,794,1192,66.6
21090, 해운대구,080005, 79세,2016,1862,722,1140,63.3,1857,720,1137,63.3
21090, 해운대구,085,80~84세,2016,6555,2296,4259,53.9,6534,2285,4249,53.8
21090, 해운대구,085001, 80세,2016,1688,618,1070,57.8,1683,613,1070,57.3
21090, 해운대구,085002, 81세,2016,1522,528,994,53.1,1520,528,992,53.2
21090, 해운대구,085003, 82세,2016,1294,476,818,58.2,1290,473,817,57.9
21090, 해운대구,085004, 83세,2016,1105,369,736,50.1,1099,368,731,50.3
21090, 해운대구,085005, 84세,2016,946,305,641,47.6,942,303,639,47.4
21090, 해운대구,090,85~89세,2016,2943,781,2162,36.1,2935,778,2157,36.1
21090, 해운대구,090001, 85세,2016,799,227,572,39.7,798,227,571,39.8
21090, 해운대구,090002, 86세,2016,660,174,486,35.8,659,173,486,35.6
21090, 해운대구,090003, 87세,2016,601,177,424,41.7,598,176,422,41.7
21090, 해운대구,090004, 88세,2016,483,105,378,27.8,480,104,376,27.7
21090, 해운대구,090005, 89세,2016,400,98,302,32.5,400,98,302,32.5
21090, 해운대구,095,90~94세,2016,797,184,613,30,795,182,613,29.7
21090, 해운대구,095001, 90세,2016,249,54,195,27.7,248,53,195,27.2
21090, 해운대구,095002, 91세,2016,200,40,160,25,200,40,160,25
21090, 해운대구,095003, 92세,2016,139,35,104,33.7,139,35,104,33.7
21090, 해운대구,095004, 93세,2016,123,31,92,33.7,122,30,92,32.6
21090, 해운대구,095005, 94세,2016,86,24,62,38.7,86,24,62,38.7
21090, 해운대구,100,95~99세,2016,141,33,108,30.6,139,32,107,29.9
21090, 해운대구,100001, 95세,2016,67,12,55,21.8,66,12,54,22.2
21090, 해운대구,100002, 96세,2016,26,6,20,30,26,6,20,30
21090, 해운대구,100003, 97세,2016,28,10,18,55.6,28,10,18,55.6
21090, 해운대구,100004, 98세,2016,13,X,11,18.2,12,X,11,9.1
21090, 해운대구,100005, 99세,2016,7,X,X,75,7,X,X,75
21090, 해운대구,101,100세이상,2016,10,X,8,25,10,X,8,25
21090, 해운대구,102,15세미만,2016,52941,27450,25491,107.7,52605,27271,25334,107.6
21090, 해운대구,103,15~64세,2016,299493,147302,152191,96.8,296036,145498,150538,96.7
21090, 해운대구,104,65세이상,2016,55608,23594,32014,73.7,55459,23514,31945,73.6
21090, 해운대구,086,85세이상,2016,3891,1000,2891,34.6,3879,994,2885,34.5
21090, 해운대구,126,평균연령,2016,41.6,40.3,42.9,,41.7,40.3,43,
21090, 해운대구,127,중위연령,2016,43.4,42.1,44.6,,43.5,42.2,44.7,
21100, 사하구,000,합계,2016,331881,165601,166280,99.6,326817,162358,164459,98.7
21100, 사하구,005,0~4세,2016,12836,6570,6266,104.9,12802,6552,6250,104.8
21100, 사하구,005001, 0세,2016,2444,1230,1214,101.3,2433,1227,1206,101.7
21100, 사하구,005002, 1세,2016,2521,1328,1193,111.3,2516,1325,1191,111.3
21100, 사하구,005003, 2세,2016,2552,1303,1249,104.3,2548,1301,1247,104.3
21100, 사하구,005004, 3세,2016,2505,1258,1247,100.9,2497,1252,1245,100.6
21100, 사하구,005005, 4세,2016,2814,1451,1363,106.5,2808,1447,1361,106.3
21100, 사하구,010,5~9세,2016,12810,6553,6257,104.7,12777,6538,6239,104.8
21100, 사하구,010001, 5세,2016,2762,1382,1380,100.1,2753,1377,1376,100.1
21100, 사하구,010002, 6세,2016,2469,1243,1226,101.4,2462,1243,1219,102
21100, 사하구,010003, 7세,2016,2464,1286,1178,109.2,2458,1283,1175,109.2
21100, 사하구,010004, 8세,2016,2545,1308,1237,105.7,2540,1305,1235,105.7
21100, 사하구,010005, 9세,2016,2570,1334,1236,107.9,2564,1330,1234,107.8
21100, 사하구,015,10~14세,2016,12978,6732,6246,107.8,12950,6722,6228,107.9
21100, 사하구,015001, 10세,2016,2280,1173,1107,106,2275,1171,1104,106.1
21100, 사하구,015002, 11세,2016,2383,1201,1182,101.6,2380,1200,1180,101.7
21100, 사하구,015003, 12세,2016,2605,1316,1289,102.1,2599,1314,1285,102.3
21100, 사하구,015004, 13세,2016,2773,1474,1299,113.5,2767,1472,1295,113.7
21100, 사하구,015005, 14세,2016,2937,1568,1369,114.5,2929,1565,1364,114.7
21100, 사하구,020,15~19세,2016,20383,10567,9816,107.7,20317,10538,9779,107.8
21100, 사하구,020001, 15세,2016,3479,1862,1617,115.2,3473,1858,1615,115
21100, 사하구,020002, 16세,2016,4058,2164,1894,114.3,4049,2160,1889,114.3
21100, 사하구,020003, 17세,2016,3800,2033,1767,115.1,3794,2030,1764,115.1
21100, 사하구,020004, 18세,2016,4356,2205,2151,102.5,4346,2200,2146,102.5
21100, 사하구,020005, 19세,2016,4690,2303,2387,96.5,4655,2290,2365,96.8
21100, 사하구,025,20~24세,2016,23943,12718,11225,113.3,23313,12362,10951,112.9
21100, 사하구,025001, 20세,2016,4742,2451,2291,107,4664,2418,2246,107.7
21100, 사하구,025002, 21세,2016,4736,2495,2241,111.3,4630,2444,2186,111.8
21100, 사하구,025003, 22세,2016,4862,2636,2226,118.4,4748,2568,2180,117.8
21100, 사하구,025004, 23세,2016,4791,2569,2222,115.6,4635,2477,2158,114.8
21100, 사하구,025005, 24세,2016,4812,2567,2245,114.3,4636,2455,2181,112.6
21100, 사하구,030,25~29세,2016,20446,11110,9336,119,19421,10404,9017,115.4
21100, 사하구,030001, 25세,2016,4479,2477,2002,123.7,4262,2336,1926,121.3
21100, 사하구,030002, 26세,2016,4180,2320,1860,124.7,3978,2184,1794,121.7
21100, 사하구,030003, 27세,2016,4079,2178,1901,114.6,3888,2041,1847,110.5
21100, 사하구,030004, 28세,2016,3854,2084,1770,117.7,3661,1953,1708,114.3
21100, 사하구,030005, 29세,2016,3854,2051,1803,113.8,3632,1890,1742,108.5
21100, 사하구,035,30~34세,2016,22065,11742,10323,113.7,21087,11038,10049,109.8
21100, 사하구,035001, 30세,2016,3867,2103,1764,119.2,3656,1956,1700,115.1
21100, 사하구,035002, 31세,2016,4059,2155,1904,113.2,3860,2014,1846,109.1
21100, 사하구,035003, 32세,2016,4273,2266,2007,112.9,4068,2116,1952,108.4
21100, 사하구,035004, 33세,2016,4723,2477,2246,110.3,4550,2354,2196,107.2
21100, 사하구,035005, 34세,2016,5143,2741,2402,114.1,4953,2598,2355,110.3
21100, 사하구,040,35~39세,2016,24610,13167,11443,115.1,23919,12655,11264,112.3
21100, 사하구,040001, 35세,2016,5411,2894,2517,115,5254,2773,2481,111.8
21100, 사하구,040002, 36세,2016,5412,2896,2516,115.1,5265,2784,2481,112.2
21100, 사하구,040003, 37세,2016,4874,2618,2256,116,4727,2518,2209,114
21100, 사하구,040004, 38세,2016,4452,2387,2065,115.6,4335,2301,2034,113.1
21100, 사하구,040005, 39세,2016,4461,2372,2089,113.5,4338,2279,2059,110.7
21100, 사하구,045,40~44세,2016,24129,12258,11871,103.3,23644,11920,11724,101.7
21100, 사하구,045001, 40세,2016,4282,2213,2069,107,4178,2134,2044,104.4
21100, 사하구,045002, 41세,2016,4595,2332,2263,103,4485,2261,2224,101.7
21100, 사하구,045003, 42세,2016,5005,2538,2467,102.9,4916,2469,2447,100.9
21100, 사하구,045004, 43세,2016,5158,2611,2547,102.5,5067,2553,2514,101.6
21100, 사하구,045005, 44세,2016,5089,2564,2525,101.5,4998,2503,2495,100.3
21100, 사하구,050,45~49세,2016,27872,13643,14229,95.9,27498,13437,14061,95.6
21100, 사하구,050001, 45세,2016,5643,2845,2798,101.7,5565,2792,2773,100.7
21100, 사하구,050002, 46세,2016,5557,2712,2845,95.3,5478,2666,2812,94.8
21100, 사하구,050003, 47세,2016,5621,2695,2926,92.1,5537,2652,2885,91.9
21100, 사하구,050004, 48세,2016,5710,2811,2899,97,5637,2773,2864,96.8
21100, 사하구,050005, 49세,2016,5341,2580,2761,93.4,5281,2554,2727,93.7
21100, 사하구,055,50~54세,2016,27896,13569,14327,94.7,27603,13419,14184,94.6
21100, 사하구,055001, 50세,2016,5324,2649,2675,99,5274,2626,2648,99.2
21100, 사하구,055002, 51세,2016,5445,2568,2877,89.3,5378,2529,2849,88.8
21100, 사하구,055003, 52세,2016,5182,2544,2638,96.4,5116,2515,2601,96.7
21100, 사하구,055004, 53세,2016,5713,2788,2925,95.3,5653,2751,2902,94.8
21100, 사하구,055005, 54세,2016,6232,3020,3212,94,6182,2998,3184,94.2
21100, 사하구,060,55~59세,2016,31448,15153,16295,93,31243,15050,16193,92.9
21100, 사하구,060001, 55세,2016,6691,3189,3502,91.1,6657,3171,3486,91
21100, 사하구,060002, 56세,2016,6788,3250,3538,91.9,6738,3232,3506,92.2
21100, 사하구,060003, 57세,2016,6004,2884,3120,92.4,5971,2866,3105,92.3
21100, 사하구,060004, 58세,2016,5948,2936,3012,97.5,5907,2914,2993,97.4
21100, 사하구,060005, 59세,2016,6017,2894,3123,92.7,5970,2867,3103,92.4
21100, 사하구,065,60~64세,2016,24352,11951,12401,96.4,24243,11903,12340,96.5
21100, 사하구,065001, 60세,2016,5416,2614,2802,93.3,5393,2601,2792,93.2
21100, 사하구,065002, 61세,2016,5589,2711,2878,94.2,5564,2701,2863,94.3
21100, 사하구,065003, 62세,2016,4785,2414,2371,101.8,4761,2404,2357,102
21100, 사하구,065004, 63세,2016,4260,2070,2190,94.5,4235,2061,2174,94.8
21100, 사하구,065005, 64세,2016,4302,2142,2160,99.2,4290,2136,2154,99.2
21100, 사하구,070,65~69세,2016,17020,8163,8857,92.2,16959,8138,8821,92.3
21100, 사하구,070001, 65세,2016,3451,1674,1777,94.2,3434,1667,1767,94.3
21100, 사하구,070002, 66세,2016,3478,1681,1797,93.5,3461,1676,1785,93.9
21100, 사하구,070003, 67세,2016,3502,1719,1783,96.4,3491,1714,1777,96.5
21100, 사하구,070004, 68세,2016,3425,1631,1794,90.9,3417,1627,1790,90.9
21100, 사하구,070005, 69세,2016,3164,1458,1706,85.5,3156,1454,1702,85.4
21100, 사하구,075,70~74세,2016,12044,5708,6336,90.1,12021,5697,6324,90.1
21100, 사하구,075001, 70세,2016,2432,1189,1243,95.7,2427,1186,1241,95.6
21100, 사하구,075002, 71세,2016,2392,1178,1214,97,2385,1174,1211,96.9
21100, 사하구,075003, 72세,2016,2270,1051,1219,86.2,2266,1049,1217,86.2
21100, 사하구,075004, 73세,2016,2327,1079,1248,86.5,2323,1079,1244,86.7
21100, 사하구,075005, 74세,2016,2623,1211,1412,85.8,2620,1209,1411,85.7
21100, 사하구,080,75~79세,2016,8960,3682,5278,69.8,8946,3676,5270,69.8
21100, 사하구,080001, 75세,2016,2139,945,1194,79.1,2135,944,1191,79.3
21100, 사하구,080002, 76세,2016,1884,799,1085,73.6,1881,799,1082,73.8
21100, 사하구,080003, 77세,2016,1833,752,1081,69.6,1830,750,1080,69.4
21100, 사하구,080004, 78세,2016,1582,607,975,62.3,1579,605,974,62.1
21100, 사하구,080005, 79세,2016,1522,579,943,61.4,1521,578,943,61.3
21100, 사하구,085,80~84세,2016,4834,1585,3249,48.8,4827,1583,3244,48.8
21100, 사하구,085001, 80세,2016,1195,403,792,50.9,1194,403,791,50.9
21100, 사하구,085002, 81세,2016,1131,400,731,54.7,1130,399,731,54.6
21100, 사하구,085003, 82세,2016,980,312,668,46.7,979,312,667,46.8
21100, 사하구,085004, 83세,2016,810,251,559,44.9,808,251,557,45.1
21100, 사하구,085005, 84세,2016,718,219,499,43.9,716,218,498,43.8
21100, 사하구,090,85~89세,2016,2323,574,1749,32.8,2317,571,1746,32.7
21100, 사하구,090001, 85세,2016,563,154,409,37.7,562,153,409,37.4
21100, 사하구,090002, 86세,2016,542,120,422,28.4,539,119,420,28.3
21100, 사하구,090003, 87세,2016,493,121,372,32.5,493,121,372,32.5
21100, 사하구,090004, 88세,2016,391,110,281,39.1,390,110,280,39.3
21100, 사하구,090005, 89세,2016,334,69,265,26,333,68,265,25.7
21100, 사하구,095,90~94세,2016,774,136,638,21.3,772,135,637,21.2
21100, 사하구,095001, 90세,2016,198,44,154,28.6,198,44,154,28.6
21100, 사하구,095002, 91세,2016,203,25,178,14,201,24,177,13.6
21100, 사하구,095003, 92세,2016,160,26,134,19.4,160,26,134,19.4
21100, 사하구,095004, 93세,2016,137,28,109,25.7,137,28,109,25.7
21100, 사하구,095005, 94세,2016,76,13,63,20.6,76,13,63,20.6
21100, 사하구,100,95~99세,2016,141,19,122,15.6,141,19,122,15.6
21100, 사하구,100001, 95세,2016,54,6,48,12.5,54,6,48,12.5
21100, 사하구,100002, 96세,2016,40,7,33,21.2,40,7,33,21.2
21100, 사하구,100003, 97세,2016,21,X,17,23.5,21,X,17,23.5
21100, 사하구,100004, 98세,2016,13,X,13,0,13,X,13,0
21100, 사하구,100005, 99세,2016,13,X,11,18.2,13,X,11,18.2
21100, 사하구,101,100세이상,2016,17,X,16,6.3,17,X,16,6.3
21100, 사하구,102,15세미만,2016,38624,19855,18769,105.8,38529,19812,18717,105.9
21100, 사하구,103,15~64세,2016,247144,125878,121266,103.8,242288,122726,119562,102.6
21100, 사하구,104,65세이상,2016,46113,19868,26245,75.7,46000,19820,26180,75.7
21100, 사하구,086,85세이상,2016,3255,730,2525,28.9,3247,726,2521,28.8
21100, 사하구,126,평균연령,2016,42,40.7,43.2,,42.1,40.8,43.3,
21100, 사하구,127,중위연령,2016,43.4,41.6,45.1,,43.6,42,45.3,
21110, 금정구,000,합계,2016,247752,121321,126431,96,243472,119423,124049,96.3
21110, 금정구,005,0~4세,2016,7146,3726,3420,108.9,7108,3706,3402,108.9
21110, 금정구,005001, 0세,2016,1271,703,568,123.8,1263,700,563,124.3
21110, 금정구,005002, 1세,2016,1473,732,741,98.8,1464,729,735,99.2
21110, 금정구,005003, 2세,2016,1427,760,667,113.9,1420,755,665,113.5
21110, 금정구,005004, 3세,2016,1435,731,704,103.8,1427,726,701,103.6
21110, 금정구,005005, 4세,2016,1540,800,740,108.1,1534,796,738,107.9
21110, 금정구,010,5~9세,2016,8000,4209,3791,111,7967,4195,3772,111.2
21110, 금정구,010001, 5세,2016,1667,868,799,108.6,1661,865,796,108.7
21110, 금정구,010002, 6세,2016,1537,817,720,113.5,1527,813,714,113.9
21110, 금정구,010003, 7세,2016,1540,832,708,117.5,1532,828,704,117.6
21110, 금정구,010004, 8세,2016,1561,828,733,113,1554,825,729,113.2
21110, 금정구,010005, 9세,2016,1695,864,831,104,1693,864,829,104.2
21110, 금정구,015,10~14세,2016,8723,4535,4188,108.3,8699,4524,4175,108.4
21110, 금정구,015001, 10세,2016,1578,863,715,120.7,1573,860,713,120.6
21110, 금정구,015002, 11세,2016,1546,802,744,107.8,1539,800,739,108.3
21110, 금정구,015003, 12세,2016,1727,883,844,104.6,1723,880,843,104.4
21110, 금정구,015004, 13세,2016,1894,1004,890,112.8,1892,1002,890,112.6
21110, 금정구,015005, 14세,2016,1978,983,995,98.8,1972,982,990,99.2
21110, 금정구,020,15~19세,2016,15667,7978,7689,103.8,15352,7845,7507,104.5
21110, 금정구,020001, 15세,2016,2321,1151,1170,98.4,2316,1149,1167,98.5
21110, 금정구,020002, 16세,2016,2746,1480,1266,116.9,2737,1474,1263,116.7
21110, 금정구,020003, 17세,2016,2621,1374,1247,110.2,2576,1355,1221,111
21110, 금정구,020004, 18세,2016,3340,1702,1638,103.9,3239,1656,1583,104.6
21110, 금정구,020005, 19세,2016,4639,2271,2368,95.9,4484,2211,2273,97.3
21110, 금정구,025,20~24세,2016,23933,12298,11635,105.7,22325,11772,10553,111.6
21110, 금정구,025001, 20세,2016,4627,2097,2530,82.9,4301,2015,2286,88.1
21110, 금정구,025002, 21세,2016,4604,2146,2458,87.3,4231,2033,2198,92.5
21110, 금정구,025003, 22세,2016,5022,2674,2348,113.9,4677,2562,2115,121.1
21110, 금정구,025004, 23세,2016,4958,2693,2265,118.9,4646,2576,2070,124.4
21110, 금정구,025005, 24세,2016,4722,2688,2034,132.2,4470,2586,1884,137.3
21110, 금정구,030,25~29세,2016,16943,9381,7562,124.1,16140,8958,7182,124.7
21110, 금정구,030001, 25세,2016,4154,2386,1768,135,3948,2279,1669,136.5
21110, 금정구,030002, 26세,2016,3624,2034,1590,127.9,3415,1950,1465,133.1
21110, 금정구,030003, 27세,2016,3287,1786,1501,119,3141,1699,1442,117.8
21110, 금정구,030004, 28세,2016,2982,1636,1346,121.5,2857,1562,1295,120.6
21110, 금정구,030005, 29세,2016,2896,1539,1357,113.4,2779,1468,1311,112
21110, 금정구,035,30~34세,2016,14057,7431,6626,112.1,13634,7198,6436,111.8
21110, 금정구,035001, 30세,2016,2714,1514,1200,126.2,2612,1461,1151,126.9
21110, 금정구,035002, 31세,2016,2621,1422,1199,118.6,2523,1366,1157,118.1
21110, 금정구,035003, 32세,2016,2650,1393,1257,110.8,2562,1347,1215,110.9
21110, 금정구,035004, 33세,2016,2934,1498,1436,104.3,2864,1456,1408,103.4
21110, 금정구,035005, 34세,2016,3138,1604,1534,104.6,3073,1568,1505,104.2
21110, 금정구,040,35~39세,2016,15584,7981,7603,105,15345,7844,7501,104.6
21110, 금정구,040001, 35세,2016,3337,1742,1595,109.2,3275,1704,1571,108.5
21110, 금정구,040002, 36세,2016,3343,1695,1648,102.9,3296,1670,1626,102.7
21110, 금정구,040003, 37세,2016,3121,1587,1534,103.5,3072,1560,1512,103.2
21110, 금정구,040004, 38세,2016,2916,1507,1409,107,2872,1483,1389,106.8
21110, 금정구,040005, 39세,2016,2867,1450,1417,102.3,2830,1427,1403,101.7
21110, 금정구,045,40~44세,2016,16022,7973,8049,99.1,15831,7871,7960,98.9
21110, 금정구,045001, 40세,2016,2713,1398,1315,106.3,2679,1383,1296,106.7
21110, 금정구,045002, 41세,2016,2985,1472,1513,97.3,2949,1449,1500,96.6
21110, 금정구,045003, 42세,2016,3314,1694,1620,104.6,3275,1674,1601,104.6
21110, 금정구,045004, 43세,2016,3498,1691,1807,93.6,3459,1668,1791,93.1
21110, 금정구,045005, 44세,2016,3512,1718,1794,95.8,3469,1697,1772,95.8
21110, 금정구,050,45~49세,2016,19678,9221,10457,88.2,19498,9136,10362,88.2
21110, 금정구,050001, 45세,2016,3891,1866,2025,92.1,3846,1843,2003,92
21110, 금정구,050002, 46세,2016,3808,1809,1999,90.5,3769,1793,1976,90.7
21110, 금정구,050003, 47세,2016,4016,1851,2165,85.5,3977,1832,2145,85.4
21110, 금정구,050004, 48세,2016,4099,1972,2127,92.7,4067,1961,2106,93.1
21110, 금정구,050005, 49세,2016,3864,1723,2141,80.5,3839,1707,2132,80.1
21110, 금정구,055,50~54세,2016,20788,9854,10934,90.1,20603,9761,10842,90
21110, 금정구,055001, 50세,2016,3909,1872,2037,91.9,3867,1854,2013,92.1
21110, 금정구,055002, 51세,2016,3983,1888,2095,90.1,3944,1865,2079,89.7
21110, 금정구,055003, 52세,2016,3876,1842,2034,90.6,3840,1822,2018,90.3
21110, 금정구,055004, 53세,2016,4381,2073,2308,89.8,4338,2056,2282,90.1
21110, 금정구,055005, 54세,2016,4639,2179,2460,88.6,4614,2164,2450,88.3
21110, 금정구,060,55~59세,2016,23239,10925,12314,88.7,23128,10866,12262,88.6
21110, 금정구,060001, 55세,2016,4975,2324,2651,87.7,4958,2315,2643,87.6
21110, 금정구,060002, 56세,2016,4870,2209,2661,83,4840,2192,2648,82.8
21110, 금정구,060003, 57세,2016,4616,2183,2433,89.7,4594,2173,2421,89.8
21110, 금정구,060004, 58세,2016,4354,2054,2300,89.3,4334,2042,2292,89.1
21110, 금정구,060005, 59세,2016,4424,2155,2269,95,4402,2144,2258,95
21110, 금정구,065,60~64세,2016,18946,8953,9993,89.6,18872,8913,9959,89.5
21110, 금정구,065001, 60세,2016,4113,1977,2136,92.6,4097,1968,2129,92.4
21110, 금정구,065002, 61세,2016,4418,2059,2359,87.3,4395,2047,2348,87.2
21110, 금정구,065003, 62세,2016,3548,1695,1853,91.5,3534,1685,1849,91.1
21110, 금정구,065004, 63세,2016,3356,1550,1806,85.8,3343,1543,1800,85.7
21110, 금정구,065005, 64세,2016,3511,1672,1839,90.9,3503,1670,1833,91.1
21110, 금정구,070,65~69세,2016,13831,6557,7274,90.1,13804,6545,7259,90.2
21110, 금정구,070001, 65세,2016,2786,1331,1455,91.5,2776,1327,1449,91.6
21110, 금정구,070002, 66세,2016,2824,1358,1466,92.6,2822,1358,1464,92.8
21110, 금정구,070003, 67세,2016,2892,1336,1556,85.9,2885,1332,1553,85.8
21110, 금정구,070004, 68세,2016,2785,1342,1443,93,2781,1339,1442,92.9
21110, 금정구,070005, 69세,2016,2544,1190,1354,87.9,2540,1189,1351,88
21110, 금정구,075,70~74세,2016,10143,4790,5353,89.5,10134,4787,5347,89.5
21110, 금정구,075001, 70세,2016,1954,927,1027,90.3,1951,927,1024,90.5
21110, 금정구,075002, 71세,2016,1932,922,1010,91.3,1931,922,1009,91.4
21110, 금정구,075003, 72세,2016,1985,946,1039,91,1983,945,1038,91
21110, 금정구,075004, 73세,2016,2076,994,1082,91.9,2074,992,1082,91.7
21110, 금정구,075005, 74세,2016,2196,1001,1195,83.8,2195,1001,1194,83.8
21110, 금정구,080,75~79세,2016,7614,3249,4365,74.4,7605,3247,4358,74.5
21110, 금정구,080001, 75세,2016,1848,844,1004,84.1,1847,843,1004,84
21110, 금정구,080002, 76세,2016,1643,698,945,73.9,1640,698,942,74.1
21110, 금정구,080003, 77세,2016,1513,625,888,70.4,1513,625,888,70.4
21110, 금정구,080004, 78세,2016,1374,579,795,72.8,1370,578,792,73
21110, 금정구,080005, 79세,2016,1236,503,733,68.6,1235,503,732,68.7
21110, 금정구,085,80~84세,2016,4553,1595,2958,53.9,4545,1591,2954,53.9
21110, 금정구,085001, 80세,2016,1094,400,694,57.6,1090,398,692,57.5
21110, 금정구,085002, 81세,2016,1088,391,697,56.1,1087,391,696,56.2
21110, 금정구,085003, 82세,2016,972,346,626,55.3,972,346,626,55.3
21110, 금정구,085004, 83세,2016,736,255,481,53,734,254,480,52.9
21110, 금정구,085005, 84세,2016,663,203,460,44.1,662,202,460,43.9
21110, 금정구,090,85~89세,2016,2061,523,1538,34,2058,522,1536,34
21110, 금정구,090001, 85세,2016,583,153,430,35.6,582,152,430,35.3
21110, 금정구,090002, 86세,2016,465,124,341,36.4,465,124,341,36.4
21110, 금정구,090003, 87세,2016,384,94,290,32.4,384,94,290,32.4
21110, 금정구,090004, 88세,2016,368,92,276,33.3,366,92,274,33.6
21110, 금정구,090005, 89세,2016,261,60,201,29.9,261,60,201,29.9
21110, 금정구,095,90~94세,2016,677,122,555,22,677,122,555,22
21110, 금정구,095001, 90세,2016,185,39,146,26.7,185,39,146,26.7
21110, 금정구,095002, 91세,2016,196,32,164,19.5,196,32,164,19.5
21110, 금정구,095003, 92세,2016,111,20,91,22,111,20,91,22
21110, 금정구,095004, 93세,2016,100,22,78,28.2,100,22,78,28.2
21110, 금정구,095005, 94세,2016,85,9,76,11.8,85,9,76,11.8
21110, 금정구,100,95~99세,2016,129,19,110,17.3,129,19,110,17.3
21110, 금정구,100001, 95세,2016,51,7,44,15.9,51,7,44,15.9
21110, 금정구,100002, 96세,2016,30,6,24,25,30,6,24,25
21110, 금정구,100003, 97세,2016,22,X,19,15.8,22,X,19,15.8
21110, 금정구,100004, 98세,2016,18,X,15,20,18,X,15,20
21110, 금정구,100005, 99세,2016,8,X,8,0,8,X,8,0
21110, 금정구,101,100세이상,2016,18,X,17,5.9,18,X,17,5.9
21110, 금정구,102,15세미만,2016,23869,12470,11399,109.4,23774,12425,11349,109.5
21110, 금정구,103,15~64세,2016,184857,91995,92862,99.1,180728,90164,90564,99.6
21110, 금정구,104,65세이상,2016,39026,16856,22170,76,38970,16834,22136,76
21110, 금정구,086,85세이상,2016,2885,665,2220,30,2882,664,2218,29.9
21110, 금정구,126,평균연령,2016,42.9,41.4,44.3,,43.1,41.6,44.6,
21110, 금정구,127,중위연령,2016,44.4,42.1,46.3,,44.8,42.5,46.8,
21120, 강서구,000,합계,2016,106106,56436,49670,113.6,99957,51104,48853,104.6
21120, 강서구,005,0~4세,2016,8658,4426,4232,104.6,8630,4412,4218,104.6
21120, 강서구,005001, 0세,2016,1699,862,837,103,1696,861,835,103.1
21120, 강서구,005002, 1세,2016,1826,910,916,99.3,1819,909,910,99.9
21120, 강서구,005003, 2세,2016,1754,910,844,107.8,1751,909,842,108
21120, 강서구,005004, 3세,2016,1644,832,812,102.5,1636,828,808,102.5
21120, 강서구,005005, 4세,2016,1735,912,823,110.8,1728,905,823,110
21120, 강서구,010,5~9세,2016,6475,3277,3198,102.5,6454,3263,3191,102.3
21120, 강서구,010001, 5세,2016,1546,778,768,101.3,1545,777,768,101.2
21120, 강서구,010002, 6세,2016,1404,722,682,105.9,1401,720,681,105.7
21120, 강서구,010003, 7세,2016,1277,663,614,108,1272,659,613,107.5
21120, 강서구,010004, 8세,2016,1196,609,587,103.7,1187,603,584,103.3
21120, 강서구,010005, 9세,2016,1052,505,547,92.3,1049,504,545,92.5
21120, 강서구,015,10~14세,2016,4044,2089,1955,106.9,4034,2082,1952,106.7
21120, 강서구,015001, 10세,2016,853,441,412,107,851,440,411,107.1
21120, 강서구,015002, 11세,2016,839,437,402,108.7,837,437,400,109.3
21120, 강서구,015003, 12세,2016,860,448,412,108.7,857,445,412,108
21120, 강서구,015004, 13세,2016,757,409,348,117.5,756,408,348,117.2
21120, 강서구,015005, 14세,2016,735,354,381,92.9,733,352,381,92.4
21120, 강서구,020,15~19세,2016,3646,1921,1725,111.4,3625,1910,1715,111.4
21120, 강서구,020001, 15세,2016,787,392,395,99.2,784,391,393,99.5
21120, 강서구,020002, 16세,2016,745,395,350,112.9,744,394,350,112.6
21120, 강서구,020003, 17세,2016,710,376,334,112.6,706,374,332,112.7
21120, 강서구,020004, 18세,2016,746,376,370,101.6,743,376,367,102.5
21120, 강서구,020005, 19세,2016,658,382,276,138.4,648,375,273,137.4
21120, 강서구,025,20~24세,2016,4957,2986,1971,151.5,4255,2373,1882,126.1
21120, 강서구,025001, 20세,2016,822,481,341,141.1,772,446,326,136.8
21120, 강서구,025002, 21세,2016,896,568,328,173.2,809,490,319,153.6
21120, 강서구,025003, 22세,2016,961,597,364,164,841,489,352,138.9
21120, 강서구,025004, 23세,2016,1083,642,441,145.6,890,469,421,111.4
21120, 강서구,025005, 24세,2016,1195,698,497,140.4,943,479,464,103.2
21120, 강서구,030,25~29세,2016,7322,4354,2968,146.7,5603,2797,2806,99.7
21120, 강서구,030001, 25세,2016,1199,719,480,149.8,907,456,451,101.1
21120, 강서구,030002, 26세,2016,1397,852,545,156.3,1043,530,513,103.3
21120, 강서구,030003, 27세,2016,1528,910,618,147.2,1172,583,589,99
21120, 강서구,030004, 28세,2016,1506,880,626,140.6,1170,587,583,100.7
21120, 강서구,030005, 29세,2016,1692,993,699,142.1,1311,641,670,95.7
21120, 강서구,035,30~34세,2016,11701,6539,5162,126.7,10097,5075,5022,101.1
21120, 강서구,035001, 30세,2016,1837,1049,788,133.1,1465,713,752,94.8
21120, 강서구,035002, 31세,2016,2006,1142,864,132.2,1639,807,832,97
21120, 강서구,035003, 32세,2016,2329,1305,1024,127.4,2015,1013,1002,101.1
21120, 강서구,035004, 33세,2016,2663,1462,1201,121.7,2379,1206,1173,102.8
21120, 강서구,035005, 34세,2016,2866,1581,1285,123,2599,1336,1263,105.8
21120, 강서구,040,35~39세,2016,12357,6916,5441,127.1,11439,6102,5337,114.3
21120, 강서구,040001, 35세,2016,2870,1535,1335,115,2661,1351,1310,103.1
21120, 강서구,040002, 36세,2016,2745,1536,1209,127,2524,1338,1186,112.8
21120, 강서구,040003, 37세,2016,2548,1427,1121,127.3,2357,1254,1103,113.7
21120, 강서구,040004, 38세,2016,2189,1261,928,135.9,2041,1134,907,125
21120, 강서구,040005, 39세,2016,2005,1157,848,136.4,1856,1025,831,123.3
21120, 강서구,045,40~44세,2016,8373,4889,3484,140.3,7888,4484,3404,131.7
21120, 강서구,045001, 40세,2016,1755,1058,697,151.8,1630,948,682,139
21120, 강서구,045002, 41세,2016,1839,1058,781,135.5,1710,946,764,123.8
21120, 강서구,045003, 42세,2016,1731,1021,710,143.8,1653,955,698,136.8
21120, 강서구,045004, 43세,2016,1599,908,691,131.4,1516,846,670,126.3
21120, 강서구,045005, 44세,2016,1449,844,605,139.5,1379,789,590,133.7
21120, 강서구,050,45~49세,2016,6821,3692,3129,118,6558,3487,3071,113.5
21120, 강서구,050001, 45세,2016,1510,862,648,133,1440,805,635,126.8
21120, 강서구,050002, 46세,2016,1413,773,640,120.8,1354,733,621,118
21120, 강서구,050003, 47세,2016,1333,742,591,125.5,1279,697,582,119.8
21120, 강서구,050004, 48세,2016,1317,693,624,111.1,1271,655,616,106.3
21120, 강서구,050005, 49세,2016,1248,622,626,99.4,1214,597,617,96.8
21120, 강서구,055,50~54세,2016,6657,3422,3235,105.8,6476,3311,3165,104.6
21120, 강서구,055001, 50세,2016,1238,679,559,121.5,1193,647,546,118.5
21120, 강서구,055002, 51세,2016,1264,655,609,107.6,1233,637,596,106.9
21120, 강서구,055003, 52세,2016,1251,616,635,97,1215,594,621,95.7
21120, 강서구,055004, 53세,2016,1403,731,672,108.8,1366,708,658,107.6
21120, 강서구,055005, 54세,2016,1501,741,760,97.5,1469,725,744,97.4
21120, 강서구,060,55~59세,2016,7890,3858,4032,95.7,7788,3797,3991,95.1
21120, 강서구,060001, 55세,2016,1613,770,843,91.3,1591,756,835,90.5
21120, 강서구,060002, 56세,2016,1679,821,858,95.7,1654,804,850,94.6
21120, 강서구,060003, 57세,2016,1529,731,798,91.6,1507,723,784,92.2
21120, 강서구,060004, 58세,2016,1557,791,766,103.3,1539,780,759,102.8
21120, 강서구,060005, 59세,2016,1512,745,767,97.1,1497,734,763,96.2
21120, 강서구,065,60~64세,2016,6128,3102,3026,102.5,6070,3065,3005,102
21120, 강서구,065001, 60세,2016,1379,684,695,98.4,1363,672,691,97.3
21120, 강서구,065002, 61세,2016,1444,734,710,103.4,1429,727,702,103.6
21120, 강서구,065003, 62세,2016,1185,598,587,101.9,1175,590,585,100.9
21120, 강서구,065004, 63세,2016,1077,543,534,101.7,1067,537,530,101.3
21120, 강서구,065005, 64세,2016,1043,543,500,108.6,1036,539,497,108.5
21120, 강서구,070,65~69세,2016,4070,2113,1957,108,4048,2100,1948,107.8
21120, 강서구,070001, 65세,2016,914,476,438,108.7,906,472,434,108.8
21120, 강서구,070002, 66세,2016,826,453,373,121.4,823,451,372,121.2
21120, 강서구,070003, 67세,2016,839,410,429,95.6,832,406,426,95.3
21120, 강서구,070004, 68세,2016,758,381,377,101.1,756,380,376,101.1
21120, 강서구,070005, 69세,2016,733,393,340,115.6,731,391,340,115
21120, 강서구,075,70~74세,2016,2788,1358,1430,95,2781,1355,1426,95
21120, 강서구,075001, 70세,2016,579,296,283,104.6,577,295,282,104.6
21120, 강서구,075002, 71세,2016,510,246,264,93.2,509,246,263,93.5
21120, 강서구,075003, 72세,2016,566,290,276,105.1,565,289,276,104.7
21120, 강서구,075004, 73세,2016,532,242,290,83.4,529,241,288,83.7
21120, 강서구,075005, 74세,2016,601,284,317,89.6,601,284,317,89.6
21120, 강서구,080,75~79세,2016,2127,905,1222,74.1,2122,903,1219,74.1
21120, 강서구,080001, 75세,2016,518,236,282,83.7,516,235,281,83.6
21120, 강서구,080002, 76세,2016,458,204,254,80.3,458,204,254,80.3
21120, 강서구,080003, 77세,2016,444,188,256,73.4,443,187,256,73
21120, 강서구,080004, 78세,2016,376,141,235,60,375,141,234,60.3
21120, 강서구,080005, 79세,2016,331,136,195,69.7,330,136,194,70.1
21120, 강서구,085,80~84세,2016,1244,404,840,48.1,1242,403,839,48
21120, 강서구,085001, 80세,2016,289,82,207,39.6,289,82,207,39.6
21120, 강서구,085002, 81세,2016,281,97,184,52.7,280,96,184,52.2
21120, 강서구,085003, 82세,2016,261,91,170,53.5,261,91,170,53.5
21120, 강서구,085004, 83세,2016,209,74,135,54.8,208,74,134,55.2
21120, 강서구,085005, 84세,2016,204,60,144,41.7,204,60,144,41.7
21120, 강서구,090,85~89세,2016,625,143,482,29.7,624,143,481,29.7
21120, 강서구,090001, 85세,2016,152,42,110,38.2,151,42,109,38.5
21120, 강서구,090002, 86세,2016,162,36,126,28.6,162,36,126,28.6
21120, 강서구,090003, 87세,2016,142,33,109,30.3,142,33,109,30.3
21120, 강서구,090004, 88세,2016,90,16,74,21.6,90,16,74,21.6
21120, 강서구,090005, 89세,2016,79,16,63,25.4,79,16,63,25.4
21120, 강서구,095,90~94세,2016,186,35,151,23.2,186,35,151,23.2
21120, 강서구,095001, 90세,2016,47,7,40,17.5,47,7,40,17.5
21120, 강서구,095002, 91세,2016,55,11,44,25,55,11,44,25
21120, 강서구,095003, 92세,2016,30,5,25,20,30,5,25,20
21120, 강서구,095004, 93세,2016,28,5,23,21.7,28,5,23,21.7
21120, 강서구,095005, 94세,2016,26,7,19,36.8,26,7,19,36.8
21120, 강서구,100,95~99세,2016,33,7,26,26.9,33,7,26,26.9
21120, 강서구,100001, 95세,2016,11,X,8,37.5,11,X,8,37.5
21120, 강서구,100002, 96세,2016,9,X,9,0,9,X,9,0
21120, 강서구,100003, 97세,2016,X,X,X,100,X,X,X,100
21120, 강서구,100004, 98세,2016,X,X,X,50,X,X,X,50
21120, 강서구,100005, 99세,2016,6,X,5,20,6,X,5,20
21120, 강서구,101,100세이상,2016,X,X,X,0,X,X,X,0
21120, 강서구,102,15세미만,2016,19177,9792,9385,104.3,19118,9757,9361,104.2
21120, 강서구,103,15~64세,2016,75852,41679,34173,122,69799,36401,33398,109
21120, 강서구,104,65세이상,2016,11077,4965,6112,81.2,11040,4946,6094,81.2
21120, 강서구,086,85세이상,2016,848,185,663,27.9,847,185,662,27.9
21120, 강서구,126,평균연령,2016,37.9,37.1,38.9,,38.2,37.5,38.9,
21120, 강서구,127,중위연령,2016,37.2,36.7,38,,37.9,37.8,38,
21130, 연제구,000,합계,2016,201181,97645,103536,94.3,200295,97271,103024,94.4
21130, 연제구,005,0~4세,2016,7722,3904,3818,102.3,7711,3900,3811,102.3
21130, 연제구,005001, 0세,2016,1486,755,731,103.3,1485,755,730,103.4
21130, 연제구,005002, 1세,2016,1527,766,761,100.7,1526,766,760,100.8
21130, 연제구,005003, 2세,2016,1530,795,735,108.2,1528,794,734,108.2
21130, 연제구,005004, 3세,2016,1504,744,760,97.9,1500,742,758,97.9
21130, 연제구,005005, 4세,2016,1675,844,831,101.6,1672,843,829,101.7
21130, 연제구,010,5~9세,2016,7831,4067,3764,108,7815,4059,3756,108.1
21130, 연제구,010001, 5세,2016,1607,840,767,109.5,1605,839,766,109.5
21130, 연제구,010002, 6세,2016,1567,789,778,101.4,1561,787,774,101.7
21130, 연제구,010003, 7세,2016,1468,782,686,114,1465,781,684,114.2
21130, 연제구,010004, 8세,2016,1519,770,749,102.8,1516,767,749,102.4
21130, 연제구,010005, 9세,2016,1670,886,784,113,1668,885,783,113
21130, 연제구,015,10~14세,2016,8041,4147,3894,106.5,8029,4146,3883,106.8
21130, 연제구,015001, 10세,2016,1497,778,719,108.2,1495,778,717,108.5
21130, 연제구,015002, 11세,2016,1523,790,733,107.8,1521,790,731,108.1
21130, 연제구,015003, 12세,2016,1598,818,780,104.9,1596,818,778,105.1
21130, 연제구,015004, 13세,2016,1718,883,835,105.7,1717,883,834,105.9
21130, 연제구,015005, 14세,2016,1705,878,827,106.2,1700,877,823,106.6
21130, 연제구,020,15~19세,2016,10625,5587,5038,110.9,10615,5581,5034,110.9
21130, 연제구,020001, 15세,2016,1935,1055,880,119.9,1934,1054,880,119.8
21130, 연제구,020002, 16세,2016,2066,1065,1001,106.4,2065,1064,1001,106.3
21130, 연제구,020003, 17세,2016,2008,1062,946,112.3,2004,1060,944,112.3
21130, 연제구,020004, 18세,2016,2313,1234,1079,114.4,2311,1232,1079,114.2
21130, 연제구,020005, 19세,2016,2303,1171,1132,103.4,2301,1171,1130,103.6
21130, 연제구,025,20~24세,2016,13299,7020,6279,111.8,13223,6996,6227,112.3
21130, 연제구,025001, 20세,2016,2657,1404,1253,112.1,2645,1399,1246,112.3
21130, 연제구,025002, 21세,2016,2573,1339,1234,108.5,2565,1337,1228,108.9
21130, 연제구,025003, 22세,2016,2750,1471,1279,115,2738,1466,1272,115.3
21130, 연제구,025004, 23세,2016,2635,1411,1224,115.3,2614,1407,1207,116.6
21130, 연제구,025005, 24세,2016,2684,1395,1289,108.2,2661,1387,1274,108.9
21130, 연제구,030,25~29세,2016,11804,5972,5832,102.4,11648,5918,5730,103.3
21130, 연제구,030001, 25세,2016,2551,1281,1270,100.9,2524,1274,1250,101.9
21130, 연제구,030002, 26세,2016,2418,1215,1203,101,2389,1204,1185,101.6
21130, 연제구,030003, 27세,2016,2461,1256,1205,104.2,2435,1247,1188,105
21130, 연제구,030004, 28세,2016,2162,1068,1094,97.6,2126,1060,1066,99.4
21130, 연제구,030005, 29세,2016,2212,1152,1060,108.7,2174,1133,1041,108.8
21130, 연제구,035,30~34세,2016,12901,6461,6440,100.3,12768,6406,6362,100.7
21130, 연제구,035001, 30세,2016,2301,1164,1137,102.4,2266,1147,1119,102.5
21130, 연제구,035002, 31세,2016,2333,1153,1180,97.7,2310,1146,1164,98.5
21130, 연제구,035003, 32세,2016,2495,1251,1244,100.6,2475,1245,1230,101.2
21130, 연제구,035004, 33세,2016,2699,1352,1347,100.4,2676,1337,1339,99.9
21130, 연제구,035005, 34세,2016,3073,1541,1532,100.6,3041,1531,1510,101.4
21130, 연제구,040,35~39세,2016,15033,7363,7670,96,14939,7324,7615,96.2
21130, 연제구,040001, 35세,2016,3157,1561,1596,97.8,3138,1556,1582,98.4
21130, 연제구,040002, 36세,2016,3246,1609,1637,98.3,3235,1604,1631,98.3
21130, 연제구,040003, 37세,2016,3086,1510,1576,95.8,3065,1499,1566,95.7
21130, 연제구,040004, 38세,2016,2789,1336,1453,91.9,2766,1326,1440,92.1
21130, 연제구,040005, 39세,2016,2755,1347,1408,95.7,2735,1339,1396,95.9
21130, 연제구,045,40~44세,2016,15364,7627,7737,98.6,15281,7584,7697,98.5
21130, 연제구,045001, 40세,2016,2764,1386,1378,100.6,2749,1381,1368,101
21130, 연제구,045002, 41세,2016,2846,1417,1429,99.2,2830,1407,1423,98.9
21130, 연제구,045003, 42세,2016,3226,1616,1610,100.4,3208,1606,1602,100.2
21130, 연제구,045004, 43세,2016,3220,1563,1657,94.3,3196,1552,1644,94.4
21130, 연제구,045005, 44세,2016,3308,1645,1663,98.9,3298,1638,1660,98.7
21130, 연제구,050,45~49세,2016,16986,8158,8828,92.4,16897,8113,8784,92.4
21130, 연제구,050001, 45세,2016,3464,1694,1770,95.7,3449,1685,1764,95.5
21130, 연제구,050002, 46세,2016,3376,1641,1735,94.6,3359,1637,1722,95.1
21130, 연제구,050003, 47세,2016,3308,1573,1735,90.7,3288,1559,1729,90.2
21130, 연제구,050004, 48세,2016,3478,1657,1821,91,3460,1649,1811,91.1
21130, 연제구,050005, 49세,2016,3360,1593,1767,90.2,3341,1583,1758,90
21130, 연제구,055,50~54세,2016,16051,7654,8397,91.2,15983,7625,8358,91.2
21130, 연제구,055001, 50세,2016,3131,1549,1582,97.9,3119,1542,1577,97.8
21130, 연제구,055002, 51세,2016,3177,1487,1690,88,3156,1478,1678,88.1
21130, 연제구,055003, 52세,2016,2947,1433,1514,94.6,2938,1430,1508,94.8
21130, 연제구,055004, 53세,2016,3225,1509,1716,87.9,3213,1503,1710,87.9
21130, 연제구,055005, 54세,2016,3571,1676,1895,88.4,3557,1672,1885,88.7
21130, 연제구,060,55~59세,2016,18680,8606,10074,85.4,18619,8579,10040,85.4
21130, 연제구,060001, 55세,2016,3897,1768,2129,83,3886,1765,2121,83.2
21130, 연제구,060002, 56세,2016,3944,1807,2137,84.6,3931,1801,2130,84.6
21130, 연제구,060003, 57세,2016,3626,1663,1963,84.7,3612,1655,1957,84.6
21130, 연제구,060004, 58세,2016,3594,1680,1914,87.8,3582,1676,1906,87.9
21130, 연제구,060005, 59세,2016,3619,1688,1931,87.4,3608,1682,1926,87.3
21130, 연제구,065,60~64세,2016,15593,7335,8258,88.8,15546,7314,8232,88.8
21130, 연제구,065001, 60세,2016,3497,1642,1855,88.5,3483,1635,1848,88.5
21130, 연제구,065002, 61세,2016,3549,1642,1907,86.1,3545,1641,1904,86.2
21130, 연제구,065003, 62세,2016,3015,1464,1551,94.4,3000,1458,1542,94.6
21130, 연제구,065004, 63세,2016,2698,1287,1411,91.2,2691,1283,1408,91.1
21130, 연제구,065005, 64세,2016,2834,1300,1534,84.7,2827,1297,1530,84.8
21130, 연제구,070,65~69세,2016,11410,5384,6026,89.3,11396,5373,6023,89.2
21130, 연제구,070001, 65세,2016,2243,1040,1203,86.5,2240,1039,1201,86.5
21130, 연제구,070002, 66세,2016,2308,1149,1159,99.1,2307,1148,1159,99.1
21130, 연제구,070003, 67세,2016,2352,1115,1237,90.1,2349,1113,1236,90
21130, 연제구,070004, 68세,2016,2313,1065,1248,85.3,2308,1060,1248,84.9
21130, 연제구,070005, 69세,2016,2194,1015,1179,86.1,2192,1013,1179,85.9
21130, 연제구,075,70~74세,2016,8208,3937,4271,92.2,8199,3933,4266,92.2
21130, 연제구,075001, 70세,2016,1584,800,784,102,1580,798,782,102
21130, 연제구,075002, 71세,2016,1554,734,820,89.5,1553,734,819,89.6
21130, 연제구,075003, 72세,2016,1600,727,873,83.3,1600,727,873,83.3
21130, 연제구,075004, 73세,2016,1709,813,896,90.7,1709,813,896,90.7
21130, 연제구,075005, 74세,2016,1761,863,898,96.1,1757,861,896,96.1
21130, 연제구,080,75~79세,2016,6177,2705,3472,77.9,6173,2702,3471,77.8
21130, 연제구,080001, 75세,2016,1554,686,868,79,1552,684,868,78.8
21130, 연제구,080002, 76세,2016,1314,599,715,83.8,1312,598,714,83.8
21130, 연제구,080003, 77세,2016,1270,566,704,80.4,1270,566,704,80.4
21130, 연제구,080004, 78세,2016,1013,446,567,78.7,1013,446,567,78.7
21130, 연제구,080005, 79세,2016,1026,408,618,66,1026,408,618,66
21130, 연제구,085,80~84세,2016,3388,1208,2180,55.4,3386,1208,2178,55.5
21130, 연제구,085001, 80세,2016,882,356,526,67.7,881,356,525,67.8
21130, 연제구,085002, 81세,2016,790,296,494,59.9,790,296,494,59.9
21130, 연제구,085003, 82세,2016,668,225,443,50.8,667,225,442,50.9
21130, 연제구,085004, 83세,2016,525,179,346,51.7,525,179,346,51.7
21130, 연제구,085005, 84세,2016,523,152,371,41,523,152,371,41
21130, 연제구,090,85~89세,2016,1500,402,1098,36.6,1499,402,1097,36.6
21130, 연제구,090001, 85세,2016,385,109,276,39.5,385,109,276,39.5
21130, 연제구,090002, 86세,2016,344,101,243,41.6,343,101,242,41.7
21130, 연제구,090003, 87세,2016,315,92,223,41.3,315,92,223,41.3
21130, 연제구,090004, 88세,2016,244,53,191,27.7,244,53,191,27.7
21130, 연제구,090005, 89세,2016,212,47,165,28.5,212,47,165,28.5
21130, 연제구,095,90~94세,2016,462,94,368,25.5,462,94,368,25.5
21130, 연제구,095001, 90세,2016,140,31,109,28.4,140,31,109,28.4
21130, 연제구,095002, 91세,2016,106,22,84,26.2,106,22,84,26.2
21130, 연제구,095003, 92세,2016,82,16,66,24.2,82,16,66,24.2
21130, 연제구,095004, 93세,2016,84,18,66,27.3,84,18,66,27.3
21130, 연제구,095005, 94세,2016,50,7,43,16.3,50,7,43,16.3
21130, 연제구,100,95~99세,2016,95,14,81,17.3,95,14,81,17.3
21130, 연제구,100001, 95세,2016,43,7,36,19.4,43,7,36,19.4
21130, 연제구,100002, 96세,2016,26,X,22,18.2,26,X,22,18.2
21130, 연제구,100003, 97세,2016,12,X,11,9.1,12,X,11,9.1
21130, 연제구,100004, 98세,2016,7,X,6,16.7,7,X,6,16.7
21130, 연제구,100005, 99세,2016,7,X,6,16.7,7,X,6,16.7
21130, 연제구,101,100세이상,2016,11,X,11,0,11,X,11,0
21130, 연제구,102,15세미만,2016,23594,12118,11476,105.6,23555,12105,11450,105.7
21130, 연제구,103,15~64세,2016,146336,71783,74553,96.3,145519,71440,74079,96.4
21130, 연제구,104,65세이상,2016,31251,13744,17507,78.5,31221,13726,17495,78.5
21130, 연제구,086,85세이상,2016,2068,510,1558,32.7,2067,510,1557,32.8
21130, 연제구,126,평균연령,2016,42.9,41.7,44.1,,42.9,41.7,44.1,
21130, 연제구,127,중위연령,2016,44.4,42.9,45.7,,44.4,42.9,45.8,
21140, 수영구,000,합계,2016,172667,82208,90459,90.9,171242,81524,89718,90.9
21140, 수영구,005,0~4세,2016,5959,3029,2930,103.4,5937,3019,2918,103.5
21140, 수영구,005001, 0세,2016,1235,631,604,104.5,1231,628,603,104.1
21140, 수영구,005002, 1세,2016,1265,632,633,99.8,1262,629,633,99.4
21140, 수영구,005003, 2세,2016,1144,582,562,103.6,1138,581,557,104.3
21140, 수영구,005004, 3세,2016,1120,566,554,102.2,1116,565,551,102.5
21140, 수영구,005005, 4세,2016,1195,618,577,107.1,1190,616,574,107.3
21140, 수영구,010,5~9세,2016,5427,2761,2666,103.6,5386,2738,2648,103.4
21140, 수영구,010001, 5세,2016,1156,587,569,103.2,1141,576,565,101.9
21140, 수영구,010002, 6세,2016,1012,538,474,113.5,1005,534,471,113.4
21140, 수영구,010003, 7세,2016,1042,523,519,100.8,1037,522,515,101.4
21140, 수영구,010004, 8세,2016,1104,565,539,104.8,1098,563,535,105.2
21140, 수영구,010005, 9세,2016,1113,548,565,97,1105,543,562,96.6
21140, 수영구,015,10~14세,2016,5708,3014,2694,111.9,5694,3005,2689,111.8
21140, 수영구,015001, 10세,2016,972,520,452,115,971,520,451,115.3
21140, 수영구,015002, 11세,2016,1099,589,510,115.5,1096,587,509,115.3
21140, 수영구,015003, 12세,2016,1201,657,544,120.8,1199,655,544,120.4
21140, 수영구,015004, 13세,2016,1187,614,573,107.2,1181,610,571,106.8
21140, 수영구,015005, 14세,2016,1249,634,615,103.1,1247,633,614,103.1
21140, 수영구,020,15~19세,2016,7801,4056,3745,108.3,7773,4042,3731,108.3
21140, 수영구,020001, 15세,2016,1419,757,662,114.4,1418,757,661,114.5
21140, 수영구,020002, 16세,2016,1494,758,736,103,1487,754,733,102.9
21140, 수영구,020003, 17세,2016,1562,802,760,105.5,1557,800,757,105.7
21140, 수영구,020004, 18세,2016,1660,881,779,113.1,1655,878,777,113
21140, 수영구,020005, 19세,2016,1666,858,808,106.2,1656,853,803,106.2
21140, 수영구,025,20~24세,2016,10692,5528,5164,107,10576,5482,5094,107.6
21140, 수영구,025001, 20세,2016,1899,1084,815,133,1889,1080,809,133.5
21140, 수영구,025002, 21세,2016,1997,1062,935,113.6,1980,1058,922,114.8
21140, 수영구,025003, 22세,2016,2095,1083,1012,107,2078,1073,1005,106.8
21140, 수영구,025004, 23세,2016,2285,1145,1140,100.4,2249,1136,1113,102.1
21140, 수영구,025005, 24세,2016,2416,1154,1262,91.4,2380,1135,1245,91.2
21140, 수영구,030,25~29세,2016,11476,5605,5871,95.5,11205,5492,5713,96.1
21140, 수영구,030001, 25세,2016,2355,1144,1211,94.5,2300,1119,1181,94.8
21140, 수영구,030002, 26세,2016,2355,1138,1217,93.5,2309,1123,1186,94.7
21140, 수영구,030003, 27세,2016,2357,1192,1165,102.3,2309,1167,1142,102.2
21140, 수영구,030004, 28세,2016,2144,1035,1109,93.3,2088,1018,1070,95.1
21140, 수영구,030005, 29세,2016,2265,1096,1169,93.8,2199,1065,1134,93.9
21140, 수영구,035,30~34세,2016,12427,6153,6274,98.1,12189,6030,6159,97.9
21140, 수영구,035001, 30세,2016,2323,1134,1189,95.4,2268,1104,1164,94.8
21140, 수영구,035002, 31세,2016,2300,1106,1194,92.6,2250,1083,1167,92.8
21140, 수영구,035003, 32세,2016,2411,1184,1227,96.5,2371,1160,1211,95.8
21140, 수영구,035004, 33세,2016,2600,1330,1270,104.7,2548,1299,1249,104
21140, 수영구,035005, 34세,2016,2793,1399,1394,100.4,2752,1384,1368,101.2
21140, 수영구,040,35~39세,2016,13062,6574,6488,101.3,12900,6485,6415,101.1
21140, 수영구,040001, 35세,2016,2807,1436,1371,104.7,2776,1419,1357,104.6
21140, 수영구,040002, 36세,2016,2872,1450,1422,102,2835,1431,1404,101.9
21140, 수영구,040003, 37세,2016,2687,1337,1350,99,2660,1323,1337,99
21140, 수영구,040004, 38세,2016,2381,1206,1175,102.6,2348,1187,1161,102.2
21140, 수영구,040005, 39세,2016,2315,1145,1170,97.9,2281,1125,1156,97.3
21140, 수영구,045,40~44세,2016,12220,6010,6210,96.8,12085,5938,6147,96.6
21140, 수영구,045001, 40세,2016,2176,1112,1064,104.5,2152,1100,1052,104.6
21140, 수영구,045002, 41세,2016,2304,1121,1183,94.8,2277,1106,1171,94.4
21140, 수영구,045003, 42세,2016,2560,1246,1314,94.8,2528,1228,1300,94.5
21140, 수영구,045004, 43세,2016,2559,1227,1332,92.1,2529,1210,1319,91.7
21140, 수영구,045005, 44세,2016,2621,1304,1317,99,2599,1294,1305,99.2
21140, 수영구,050,45~49세,2016,13600,6425,7175,89.5,13494,6372,7122,89.5
21140, 수영구,050001, 45세,2016,2839,1369,1470,93.1,2814,1356,1458,93
21140, 수영구,050002, 46세,2016,2798,1342,1456,92.2,2781,1332,1449,91.9
21140, 수영구,050003, 47세,2016,2698,1260,1438,87.6,2673,1249,1424,87.7
21140, 수영구,050004, 48세,2016,2702,1267,1435,88.3,2680,1259,1421,88.6
21140, 수영구,050005, 49세,2016,2563,1187,1376,86.3,2546,1176,1370,85.8
21140, 수영구,055,50~54세,2016,13239,6044,7195,84,13135,5991,7144,83.9
21140, 수영구,055001, 50세,2016,2463,1172,1291,90.8,2446,1161,1285,90.4
21140, 수영구,055002, 51세,2016,2554,1183,1371,86.3,2535,1174,1361,86.3
21140, 수영구,055003, 52세,2016,2471,1111,1360,81.7,2456,1103,1353,81.5
21140, 수영구,055004, 53세,2016,2802,1268,1534,82.7,2774,1254,1520,82.5
21140, 수영구,055005, 54세,2016,2949,1310,1639,79.9,2924,1299,1625,79.9
21140, 수영구,060,55~59세,2016,16202,7141,9061,78.8,16129,7112,9017,78.9
21140, 수영구,060001, 55세,2016,3307,1440,1867,77.1,3298,1433,1865,76.8
21140, 수영구,060002, 56세,2016,3362,1463,1899,77,3349,1459,1890,77.2
21140, 수영구,060003, 57세,2016,3175,1411,1764,80,3161,1405,1756,80
21140, 수영구,060004, 58세,2016,3139,1394,1745,79.9,3120,1388,1732,80.1
21140, 수영구,060005, 59세,2016,3219,1433,1786,80.2,3201,1427,1774,80.4
21140, 수영구,065,60~64세,2016,14366,6585,7781,84.6,14306,6558,7748,84.6
21140, 수영구,065001, 60세,2016,3053,1378,1675,82.3,3036,1371,1665,82.3
21140, 수영구,065002, 61세,2016,3277,1471,1806,81.5,3261,1462,1799,81.3
21140, 수영구,065003, 62세,2016,2847,1345,1502,89.5,2841,1343,1498,89.7
21140, 수영구,065004, 63세,2016,2488,1135,1353,83.9,2476,1129,1347,83.8
21140, 수영구,065005, 64세,2016,2701,1256,1445,86.9,2692,1253,1439,87.1
21140, 수영구,070,65~69세,2016,10996,5078,5918,85.8,10969,5066,5903,85.8
21140, 수영구,070001, 65세,2016,2068,962,1106,87,2057,955,1102,86.7
21140, 수영구,070002, 66세,2016,2210,972,1238,78.5,2205,971,1234,78.7
21140, 수영구,070003, 67세,2016,2271,1101,1170,94.1,2265,1098,1167,94.1
21140, 수영구,070004, 68세,2016,2267,1049,1218,86.1,2263,1048,1215,86.3
21140, 수영구,070005, 69세,2016,2180,994,1186,83.8,2179,994,1185,83.9
21140, 수영구,075,70~74세,2016,7939,3782,4157,91,7933,3777,4156,90.9
21140, 수영구,075001, 70세,2016,1628,803,825,97.3,1626,801,825,97.1
21140, 수영구,075002, 71세,2016,1458,696,762,91.3,1457,696,761,91.5
21140, 수영구,075003, 72세,2016,1572,741,831,89.2,1572,741,831,89.2
21140, 수영구,075004, 73세,2016,1562,751,811,92.6,1560,749,811,92.4
21140, 수영구,075005, 74세,2016,1719,791,928,85.2,1718,790,928,85.1
21140, 수영구,080,75~79세,2016,5855,2570,3285,78.2,5843,2567,3276,78.4
21140, 수영구,080001, 75세,2016,1388,615,773,79.6,1384,614,770,79.7
21140, 수영구,080002, 76세,2016,1295,589,706,83.4,1291,587,704,83.4
21140, 수영구,080003, 77세,2016,1184,534,650,82.2,1184,534,650,82.2
21140, 수영구,080004, 78세,2016,1020,447,573,78,1018,447,571,78.3
21140, 수영구,080005, 79세,2016,968,385,583,66,966,385,581,66.3
21140, 수영구,085,80~84세,2016,3412,1250,2162,57.8,3406,1248,2158,57.8
21140, 수영구,085001, 80세,2016,837,356,481,74,836,356,480,74.2
21140, 수영구,085002, 81세,2016,773,282,491,57.4,772,282,490,57.6
21140, 수영구,085003, 82세,2016,677,224,453,49.4,677,224,453,49.4
21140, 수영구,085004, 83세,2016,582,207,375,55.2,579,205,374,54.8
21140, 수영구,085005, 84세,2016,543,181,362,50,542,181,361,50.1
21140, 수영구,090,85~89세,2016,1683,473,1210,39.1,1683,473,1210,39.1
21140, 수영구,090001, 85세,2016,445,142,303,46.9,445,142,303,46.9
21140, 수영구,090002, 86세,2016,357,99,258,38.4,357,99,258,38.4
21140, 수영구,090003, 87세,2016,347,108,239,45.2,347,108,239,45.2
21140, 수영구,090004, 88세,2016,312,67,245,27.3,312,67,245,27.3
21140, 수영구,090005, 89세,2016,222,57,165,34.5,222,57,165,34.5
21140, 수영구,095,90~94세,2016,514,110,404,27.2,512,110,402,27.4
21140, 수영구,095001, 90세,2016,175,40,135,29.6,175,40,135,29.6
21140, 수영구,095002, 91세,2016,136,25,111,22.5,136,25,111,22.5
21140, 수영구,095003, 92세,2016,88,22,66,33.3,88,22,66,33.3
21140, 수영구,095004, 93세,2016,73,14,59,23.7,71,14,57,24.6
21140, 수영구,095005, 94세,2016,42,9,33,27.3,42,9,33,27.3
21140, 수영구,100,95~99세,2016,83,20,63,31.7,81,19,62,30.6
21140, 수영구,100001, 95세,2016,25,7,18,38.9,24,6,18,33.3
21140, 수영구,100002, 96세,2016,32,7,25,28,32,7,25,28
21140, 수영구,100003, 97세,2016,13,5,8,62.5,13,5,8,62.5
21140, 수영구,100004, 98세,2016,9,X,8,12.5,8,X,7,14.3
21140, 수영구,100005, 99세,2016,X,X,X,0,X,X,X,0
21140, 수영구,101,100세이상,2016,6,X,6,0,6,X,6,0
21140, 수영구,102,15세미만,2016,17094,8804,8290,106.2,17017,8762,8255,106.1
21140, 수영구,103,15~64세,2016,125085,60121,64964,92.5,123792,59502,64290,92.6
21140, 수영구,104,65세이상,2016,30488,13283,17205,77.2,30433,13260,17173,77.2
21140, 수영구,086,85세이상,2016,2286,603,1683,35.8,2282,602,1680,35.8
21140, 수영구,126,평균연령,2016,44.4,43,45.6,,44.4,43,45.7,
21140, 수영구,127,중위연령,2016,45.5,43.7,47.2,,45.7,43.9,47.3,
21150, 사상구,000,합계,2016,235080,118502,116578,101.7,229653,115426,114227,101
21150, 사상구,005,0~4세,2016,8809,4473,4336,103.2,8767,4449,4318,103
21150, 사상구,005001, 0세,2016,1740,907,833,108.9,1727,896,831,107.8
21150, 사상구,005002, 1세,2016,1780,890,890,100,1777,888,889,99.9
21150, 사상구,005003, 2세,2016,1722,876,846,103.5,1713,872,841,103.7
21150, 사상구,005004, 3세,2016,1753,876,877,99.9,1745,872,873,99.9
21150, 사상구,005005, 4세,2016,1814,924,890,103.8,1805,921,884,104.2
21150, 사상구,010,5~9세,2016,7888,4062,3826,106.2,7857,4047,3810,106.2
21150, 사상구,010001, 5세,2016,1739,880,859,102.4,1736,879,857,102.6
21150, 사상구,010002, 6세,2016,1547,805,742,108.5,1541,801,740,108.2
21150, 사상구,010003, 7세,2016,1469,752,717,104.9,1463,751,712,105.5
21150, 사상구,010004, 8세,2016,1603,822,781,105.2,1596,818,778,105.1
21150, 사상구,010005, 9세,2016,1530,803,727,110.5,1521,798,723,110.4
21150, 사상구,015,10~14세,2016,7970,4172,3798,109.8,7933,4154,3779,109.9
21150, 사상구,015001, 10세,2016,1469,785,684,114.8,1461,782,679,115.2
21150, 사상구,015002, 11세,2016,1408,710,698,101.7,1405,709,696,101.9
21150, 사상구,015003, 12세,2016,1656,860,796,108,1648,854,794,107.6
21150, 사상구,015004, 13세,2016,1705,893,812,110,1701,890,811,109.7
21150, 사상구,015005, 14세,2016,1732,924,808,114.4,1718,919,799,115
21150, 사상구,020,15~19세,2016,12982,6558,6424,102.1,12737,6467,6270,103.1
21150, 사상구,020001, 15세,2016,2049,1128,921,122.5,2042,1124,918,122.4
21150, 사상구,020002, 16세,2016,2154,1102,1052,104.8,2144,1096,1048,104.6
21150, 사상구,020003, 17세,2016,2228,1164,1064,109.4,2218,1158,1060,109.2
21150, 사상구,020004, 18세,2016,2818,1419,1399,101.4,2761,1399,1362,102.7
21150, 사상구,020005, 19세,2016,3733,1745,1988,87.8,3572,1690,1882,89.8
21150, 사상구,025,20~24세,2016,19803,10391,9412,110.4,18570,9828,8742,112.4
21150, 사상구,025001, 20세,2016,3870,1835,2035,90.2,3548,1708,1840,92.8
21150, 사상구,025002, 21세,2016,3972,1995,1977,100.9,3708,1895,1813,104.5
21150, 사상구,025003, 22세,2016,4106,2138,1968,108.6,3884,2041,1843,110.7
21150, 사상구,025004, 23세,2016,4011,2281,1730,131.8,3791,2162,1629,132.7
21150, 사상구,025005, 24세,2016,3844,2142,1702,125.9,3639,2022,1617,125
21150, 사상구,030,25~29세,2016,16151,8667,7484,115.8,15161,8094,7067,114.5
21150, 사상구,030001, 25세,2016,3517,1934,1583,122.2,3327,1824,1503,121.4
21150, 사상구,030002, 26세,2016,3303,1774,1529,116,3097,1658,1439,115.2
21150, 사상구,030003, 27세,2016,3204,1713,1491,114.9,3007,1595,1412,113
21150, 사상구,030004, 28세,2016,3044,1633,1411,115.7,2838,1518,1320,115
21150, 사상구,030005, 29세,2016,3083,1613,1470,109.7,2892,1499,1393,107.6
21150, 사상구,035,30~34세,2016,16145,8710,7435,117.1,15342,8167,7175,113.8
21150, 사상구,035001, 30세,2016,3028,1691,1337,126.5,2843,1571,1272,123.5
21150, 사상구,035002, 31세,2016,3020,1596,1424,112.1,2852,1488,1364,109.1
21150, 사상구,035003, 32세,2016,3082,1651,1431,115.4,2930,1538,1392,110.5
21150, 사상구,035004, 33세,2016,3332,1805,1527,118.2,3193,1708,1485,115
21150, 사상구,035005, 34세,2016,3683,1967,1716,114.6,3524,1862,1662,112
21150, 사상구,040,35~39세,2016,16657,8973,7684,116.8,16152,8625,7527,114.6
21150, 사상구,040001, 35세,2016,3712,1984,1728,114.8,3587,1900,1687,112.6
21150, 사상구,040002, 36세,2016,3639,1963,1676,117.1,3539,1891,1648,114.7
21150, 사상구,040003, 37세,2016,3357,1798,1559,115.3,3257,1735,1522,114
21150, 사상구,040004, 38세,2016,2957,1625,1332,122,2870,1566,1304,120.1
21150, 사상구,040005, 39세,2016,2992,1603,1389,115.4,2899,1533,1366,112.2
21150, 사상구,045,40~44세,2016,15957,8429,7528,112,15569,8170,7399,110.4
21150, 사상구,045001, 40세,2016,2899,1587,1312,121,2828,1542,1286,119.9
21150, 사상구,045002, 41세,2016,3059,1590,1469,108.2,2977,1528,1449,105.5
21150, 사상구,045003, 42세,2016,3249,1737,1512,114.9,3169,1689,1480,114.1
21150, 사상구,045004, 43세,2016,3375,1778,1597,111.3,3309,1729,1580,109.4
21150, 사상구,045005, 44세,2016,3375,1737,1638,106,3286,1682,1604,104.9
21150, 사상구,050,45~49세,2016,19659,9649,10010,96.4,19263,9411,9852,95.5
21150, 사상구,050001, 45세,2016,3593,1833,1760,104.1,3507,1782,1725,103.3
21150, 사상구,050002, 46세,2016,3839,1918,1921,99.8,3737,1859,1878,99
21150, 사상구,050003, 47세,2016,4002,1968,2034,96.8,3926,1923,2003,96
21150, 사상구,050004, 48세,2016,4180,2010,2170,92.6,4104,1963,2141,91.7
21150, 사상구,050005, 49세,2016,4045,1920,2125,90.4,3989,1884,2105,89.5
21150, 사상구,055,50~54세,2016,21561,10819,10742,100.7,21227,10634,10593,100.4
21150, 사상구,055001, 50세,2016,4112,2072,2040,101.6,4031,2022,2009,100.6
21150, 사상구,055002, 51세,2016,4254,2077,2177,95.4,4196,2046,2150,95.2
21150, 사상구,055003, 52세,2016,4088,2053,2035,100.9,4024,2017,2007,100.5
21150, 사상구,055004, 53세,2016,4311,2191,2120,103.3,4252,2158,2094,103.1
21150, 사상구,055005, 54세,2016,4796,2426,2370,102.4,4724,2391,2333,102.5
21150, 사상구,060,55~59세,2016,23706,11789,11917,98.9,23536,11699,11837,98.8
21150, 사상구,060001, 55세,2016,5269,2567,2702,95,5244,2556,2688,95.1
21150, 사상구,060002, 56세,2016,5201,2578,2623,98.3,5159,2551,2608,97.8
21150, 사상구,060003, 57세,2016,4648,2352,2296,102.4,4616,2336,2280,102.5
21150, 사상구,060004, 58세,2016,4365,2179,2186,99.7,4332,2165,2167,99.9
21150, 사상구,060005, 59세,2016,4223,2113,2110,100.1,4185,2091,2094,99.9
21150, 사상구,065,60~64세,2016,17387,8651,8736,99,17260,8579,8681,98.8
21150, 사상구,065001, 60세,2016,3968,1943,2025,96,3935,1926,2009,95.9
21150, 사상구,065002, 61세,2016,4016,2002,2014,99.4,3983,1981,2002,99
21150, 사상구,065003, 62세,2016,3415,1729,1686,102.6,3392,1714,1678,102.1
21150, 사상구,065004, 63세,2016,2913,1456,1457,99.9,2893,1444,1449,99.7
21150, 사상구,065005, 64세,2016,3075,1521,1554,97.9,3057,1514,1543,98.1
21150, 사상구,070,65~69세,2016,12050,5899,6151,95.9,11980,5863,6117,95.8
21150, 사상구,070001, 65세,2016,2571,1266,1305,97,2559,1258,1301,96.7
21150, 사상구,070002, 66세,2016,2466,1195,1271,94,2447,1186,1261,94.1
21150, 사상구,070003, 67세,2016,2466,1218,1248,97.6,2455,1214,1241,97.8
21150, 사상구,070004, 68세,2016,2370,1181,1189,99.3,2354,1174,1180,99.5
21150, 사상구,070005, 69세,2016,2177,1039,1138,91.3,2165,1031,1134,90.9
21150, 사상구,075,70~74세,2016,7800,3706,4094,90.5,7779,3694,4085,90.4
21150, 사상구,075001, 70세,2016,1527,765,762,100.4,1523,762,761,100.1
21150, 사상구,075002, 71세,2016,1489,678,811,83.6,1482,674,808,83.4
21150, 사상구,075003, 72세,2016,1587,763,824,92.6,1584,761,823,92.5
21150, 사상구,075004, 73세,2016,1569,719,850,84.6,1565,718,847,84.8
21150, 사상구,075005, 74세,2016,1628,781,847,92.2,1625,779,846,92.1
21150, 사상구,080,75~79세,2016,5717,2292,3425,66.9,5702,2286,3416,66.9
21150, 사상구,080001, 75세,2016,1424,607,817,74.3,1420,604,816,74
21150, 사상구,080002, 76세,2016,1232,535,697,76.8,1229,535,694,77.1
21150, 사상구,080003, 77세,2016,1123,442,681,64.9,1123,442,681,64.9
21150, 사상구,080004, 78세,2016,999,368,631,58.3,995,367,628,58.4
21150, 사상구,080005, 79세,2016,939,340,599,56.8,935,338,597,56.6
21150, 사상구,085,80~84세,2016,3042,915,2127,43,3031,914,2117,43.2
21150, 사상구,085001, 80세,2016,752,259,493,52.5,747,259,488,53.1
21150, 사상구,085002, 81세,2016,737,227,510,44.5,735,226,509,44.4
21150, 사상구,085003, 82세,2016,589,157,432,36.3,588,157,431,36.4
21150, 사상구,085004, 83세,2016,524,146,378,38.6,524,146,378,38.6
21150, 사상구,085005, 84세,2016,440,126,314,40.1,437,126,311,40.5
21150, 사상구,090,85~89세,2016,1267,275,992,27.7,1261,274,987,27.8
21150, 사상구,090001, 85세,2016,324,82,242,33.9,323,81,242,33.5
21150, 사상구,090002, 86세,2016,308,73,235,31.1,306,73,233,31.3
21150, 사상구,090003, 87세,2016,263,53,210,25.2,262,53,209,25.4
21150, 사상구,090004, 88세,2016,200,40,160,25,198,40,158,25.3
21150, 사상구,090005, 89세,2016,172,27,145,18.6,172,27,145,18.6
21150, 사상구,095,90~94세,2016,428,66,362,18.2,425,65,360,18.1
21150, 사상구,095001, 90세,2016,128,20,108,18.5,128,20,108,18.5
21150, 사상구,095002, 91세,2016,119,19,100,19,119,19,100,19
21150, 사상구,095003, 92세,2016,72,12,60,20,72,12,60,20
21150, 사상구,095004, 93세,2016,58,5,53,9.4,57,5,52,9.6
21150, 사상구,095005, 94세,2016,51,10,41,24.4,49,9,40,22.5
21150, 사상구,100,95~99세,2016,97,6,91,6.6,97,6,91,6.6
21150, 사상구,100001, 95세,2016,35,X,32,9.4,35,X,32,9.4
21150, 사상구,100002, 96세,2016,23,X,23,0,23,X,23,0
21150, 사상구,100003, 97세,2016,24,X,21,14.3,24,X,21,14.3
21150, 사상구,100004, 98세,2016,9,X,9,0,9,X,9,0
21150, 사상구,100005, 99세,2016,6,X,6,0,6,X,6,0
21150, 사상구,101,100세이상,2016,X,X,X,0,X,X,X,0
21150, 사상구,102,15세미만,2016,24667,12707,11960,106.2,24557,12650,11907,106.2
21150, 사상구,103,15~64세,2016,180008,92636,87372,106,174817,89674,85143,105.3
21150, 사상구,104,65세이상,2016,30405,13159,17246,76.3,30279,13102,17177,76.3
21150, 사상구,086,85세이상,2016,1796,347,1449,23.9,1787,345,1442,23.9
21150, 사상구,126,평균연령,2016,42,41,43,,42.2,41.1,43.3,
21150, 사상구,127,중위연령,2016,43.6,42,45.2,,44,42.5,45.6,
21310, 기장군,000,합계,2016,154091,76158,77933,97.7,151692,74455,77237,96.4
21310, 기장군,005,0~4세,2016,10867,5528,5339,103.5,10840,5517,5323,103.6
21310, 기장군,005001, 0세,2016,1987,980,1007,97.3,1984,978,1006,97.2
21310, 기장군,005002, 1세,2016,2178,1114,1064,104.7,2172,1111,1061,104.7
21310, 기장군,005003, 2세,2016,2220,1130,1090,103.7,2210,1126,1084,103.9
21310, 기장군,005004, 3세,2016,2218,1132,1086,104.2,2215,1132,1083,104.5
21310, 기장군,005005, 4세,2016,2264,1172,1092,107.3,2259,1170,1089,107.4
21310, 기장군,010,5~9세,2016,9632,4940,4692,105.3,9613,4929,4684,105.2
21310, 기장군,010001, 5세,2016,2211,1130,1081,104.5,2205,1126,1079,104.4
21310, 기장군,010002, 6세,2016,1985,1010,975,103.6,1980,1008,972,103.7
21310, 기장군,010003, 7세,2016,1794,902,892,101.1,1790,900,890,101.1
21310, 기장군,010004, 8세,2016,1818,943,875,107.8,1816,942,874,107.8
21310, 기장군,010005, 9세,2016,1824,955,869,109.9,1822,953,869,109.7
21310, 기장군,015,10~14세,2016,7672,4059,3613,112.3,7656,4050,3606,112.3
21310, 기장군,015001, 10세,2016,1525,788,737,106.9,1518,785,733,107.1
21310, 기장군,015002, 11세,2016,1515,811,704,115.2,1513,811,702,115.5
21310, 기장군,015003, 12세,2016,1597,859,738,116.4,1592,854,738,115.7
21310, 기장군,015004, 13세,2016,1511,792,719,110.2,1509,791,718,110.2
21310, 기장군,015005, 14세,2016,1524,809,715,113.1,1524,809,715,113.1
21310, 기장군,020,15~19세,2016,7656,3929,3727,105.4,7629,3912,3717,105.2
21310, 기장군,020001, 15세,2016,1554,825,729,113.2,1548,819,729,112.3
21310, 기장군,020002, 16세,2016,1706,819,887,92.3,1705,818,887,92.2
21310, 기장군,020003, 17세,2016,1589,774,815,95,1580,768,812,94.6
21310, 기장군,020004, 18세,2016,1546,781,765,102.1,1542,779,763,102.1
21310, 기장군,020005, 19세,2016,1261,730,531,137.5,1254,728,526,138.4
21310, 기장군,025,20~24세,2016,6989,3920,3069,127.7,6688,3706,2982,124.3
21310, 기장군,025001, 20세,2016,1337,781,556,140.5,1317,766,551,139
21310, 기장군,025002, 21세,2016,1392,808,584,138.4,1350,778,572,136
21310, 기장군,025003, 22세,2016,1414,784,630,124.4,1352,742,610,121.6
21310, 기장군,025004, 23세,2016,1410,770,640,120.3,1340,722,618,116.8
21310, 기장군,025005, 24세,2016,1436,777,659,117.9,1329,698,631,110.6
21310, 기장군,030,25~29세,2016,7537,3906,3631,107.6,6979,3478,3501,99.3
21310, 기장군,030001, 25세,2016,1486,779,707,110.2,1387,701,686,102.2
21310, 기장군,030002, 26세,2016,1429,782,647,120.9,1310,701,609,115.1
21310, 기장군,030003, 27세,2016,1433,753,680,110.7,1341,677,664,102
21310, 기장군,030004, 28세,2016,1591,827,764,108.2,1456,718,738,97.3
21310, 기장군,030005, 29세,2016,1598,765,833,91.8,1485,681,804,84.7
21310, 기장군,035,30~34세,2016,12148,5995,6153,97.4,11620,5594,6026,92.8
21310, 기장군,035001, 30세,2016,1833,858,975,88,1720,777,943,82.4
21310, 기장군,035002, 31세,2016,2009,1012,997,101.5,1899,926,973,95.2
21310, 기장군,035003, 32세,2016,2380,1193,1187,100.5,2264,1104,1160,95.2
21310, 기장군,035004, 33세,2016,2707,1322,1385,95.5,2614,1246,1368,91.1
21310, 기장군,035005, 34세,2016,3219,1610,1609,100.1,3123,1541,1582,97.4
21310, 기장군,040,35~39세,2016,16216,8202,8014,102.3,15888,7946,7942,100.1
21310, 기장군,040001, 35세,2016,3360,1670,1690,98.8,3272,1600,1672,95.7
21310, 기장군,040002, 36세,2016,3600,1794,1806,99.3,3526,1735,1791,96.9
21310, 기장군,040003, 37세,2016,3311,1681,1630,103.1,3243,1626,1617,100.6
21310, 기장군,040004, 38세,2016,3001,1509,1492,101.1,2944,1468,1476,99.5
21310, 기장군,040005, 39세,2016,2944,1548,1396,110.9,2903,1517,1386,109.5
21310, 기장군,045,40~44세,2016,14194,7309,6885,106.2,14005,7179,6826,105.2
21310, 기장군,045001, 40세,2016,2833,1463,1370,106.8,2798,1435,1363,105.3
21310, 기장군,045002, 41세,2016,2866,1479,1387,106.6,2828,1454,1374,105.8
21310, 기장군,045003, 42세,2016,2910,1482,1428,103.8,2866,1455,1411,103.1
21310, 기장군,045004, 43세,2016,2843,1445,1398,103.4,2798,1413,1385,102
21310, 기장군,045005, 44세,2016,2742,1440,1302,110.6,2715,1422,1293,110
21310, 기장군,050,45~49세,2016,11856,6179,5677,108.8,11702,6090,5612,108.5
21310, 기장군,050001, 45세,2016,2688,1444,1244,116.1,2642,1417,1225,115.7
21310, 기장군,050002, 46세,2016,2504,1306,1198,109,2465,1288,1177,109.4
21310, 기장군,050003, 47세,2016,2403,1236,1167,105.9,2370,1215,1155,105.2
21310, 기장군,050004, 48세,2016,2209,1143,1066,107.2,2188,1129,1059,106.6
21310, 기장군,050005, 49세,2016,2052,1050,1002,104.8,2037,1041,996,104.5
21310, 기장군,055,50~54세,2016,9573,4767,4806,99.2,9485,4719,4766,99
21310, 기장군,055001, 50세,2016,1926,1023,903,113.3,1901,1009,892,113.1
21310, 기장군,055002, 51세,2016,1865,910,955,95.3,1848,899,949,94.7
21310, 기장군,055003, 52세,2016,1817,941,876,107.4,1806,937,869,107.8
21310, 기장군,055004, 53세,2016,1920,914,1006,90.9,1898,902,996,90.6
21310, 기장군,055005, 54세,2016,2045,979,1066,91.8,2032,972,1060,91.7
21310, 기장군,060,55~59세,2016,10458,4857,5601,86.7,10398,4829,5569,86.7
21310, 기장군,060001, 55세,2016,2129,1001,1128,88.7,2119,994,1125,88.4
21310, 기장군,060002, 56세,2016,2199,1047,1152,90.9,2185,1041,1144,91
21310, 기장군,060003, 57세,2016,2089,956,1133,84.4,2077,953,1124,84.8
21310, 기장군,060004, 58세,2016,1949,913,1036,88.1,1935,905,1030,87.9
21310, 기장군,060005, 59세,2016,2092,940,1152,81.6,2082,936,1146,81.7
21310, 기장군,065,60~64세,2016,8887,4098,4789,85.6,8831,4063,4768,85.2
21310, 기장군,065001, 60세,2016,1909,876,1033,84.8,1895,868,1027,84.5
21310, 기장군,065002, 61세,2016,1989,922,1067,86.4,1981,917,1064,86.2
21310, 기장군,065003, 62세,2016,1746,820,926,88.6,1731,809,922,87.7
21310, 기장군,065004, 63세,2016,1560,700,860,81.4,1553,697,856,81.4
21310, 기장군,065005, 64세,2016,1683,780,903,86.4,1671,772,899,85.9
21310, 기장군,070,65~69세,2016,6920,3280,3640,90.1,6896,3266,3630,90
21310, 기장군,070001, 65세,2016,1378,654,724,90.3,1373,652,721,90.4
21310, 기장군,070002, 66세,2016,1348,622,726,85.7,1342,619,723,85.6
21310, 기장군,070003, 67세,2016,1443,692,751,92.1,1436,687,749,91.7
21310, 기장군,070004, 68세,2016,1413,672,741,90.7,1410,670,740,90.5
21310, 기장군,070005, 69세,2016,1338,640,698,91.7,1335,638,697,91.5
21310, 기장군,075,70~74세,2016,5216,2357,2859,82.4,5202,2349,2853,82.3
21310, 기장군,075001, 70세,2016,995,456,539,84.6,988,451,537,84
21310, 기장군,075002, 71세,2016,983,442,541,81.7,981,441,540,81.7
21310, 기장군,075003, 72세,2016,1095,501,594,84.3,1091,500,591,84.6
21310, 기장군,075004, 73세,2016,1043,482,561,85.9,1042,481,561,85.7
21310, 기장군,075005, 74세,2016,1100,476,624,76.3,1100,476,624,76.3
21310, 기장군,080,75~79세,2016,4061,1615,2446,66,4060,1615,2445,66.1
21310, 기장군,080001, 75세,2016,909,377,532,70.9,908,377,531,71
21310, 기장군,080002, 76세,2016,874,350,524,66.8,874,350,524,66.8
21310, 기장군,080003, 77세,2016,865,345,520,66.3,865,345,520,66.3
21310, 기장군,080004, 78세,2016,734,291,443,65.7,734,291,443,65.7
21310, 기장군,080005, 79세,2016,679,252,427,59,679,252,427,59
21310, 기장군,085,80~84세,2016,2488,844,1644,51.3,2485,843,1642,51.3
21310, 기장군,085001, 80세,2016,596,223,373,59.8,595,223,372,59.9
21310, 기장군,085002, 81세,2016,552,197,355,55.5,552,197,355,55.5
21310, 기장군,085003, 82세,2016,519,151,368,41,519,151,368,41
21310, 기장군,085004, 83세,2016,424,138,286,48.3,423,138,285,48.4
21310, 기장군,085005, 84세,2016,397,135,262,51.5,396,134,262,51.1
21310, 기장군,090,85~89세,2016,1202,294,908,32.4,1200,292,908,32.2
21310, 기장군,090001, 85세,2016,331,100,231,43.3,329,98,231,42.4
21310, 기장군,090002, 86세,2016,271,62,209,29.7,271,62,209,29.7
21310, 기장군,090003, 87세,2016,232,51,181,28.2,232,51,181,28.2
21310, 기장군,090004, 88세,2016,210,55,155,35.5,210,55,155,35.5
21310, 기장군,090005, 89세,2016,158,26,132,19.7,158,26,132,19.7
21310, 기장군,095,90~94세,2016,408,65,343,19,406,65,341,19.1
21310, 기장군,095001, 90세,2016,106,15,91,16.5,106,15,91,16.5
21310, 기장군,095002, 91세,2016,113,16,97,16.5,112,16,96,16.7
21310, 기장군,095003, 92세,2016,60,9,51,17.6,59,9,50,18
21310, 기장군,095004, 93세,2016,74,13,61,21.3,74,13,61,21.3
21310, 기장군,095005, 94세,2016,55,12,43,27.9,55,12,43,27.9
21310, 기장군,100,95~99세,2016,99,14,85,16.5,98,13,85,15.3
21310, 기장군,100001, 95세,2016,40,5,35,14.3,40,5,35,14.3
21310, 기장군,100002, 96세,2016,22,X,19,15.8,21,X,19,10.5
21310, 기장군,100003, 97세,2016,15,X,11,36.4,15,X,11,36.4
21310, 기장군,100004, 98세,2016,18,X,17,5.9,18,X,17,5.9
21310, 기장군,100005, 99세,2016,X,X,X,33.3,X,X,X,33.3
21310, 기장군,101,100세이상,2016,12,X,12,0,11,X,11,0
21310, 기장군,102,15세미만,2016,28171,14527,13644,106.5,28109,14496,13613,106.5
21310, 기장군,103,15~64세,2016,105514,53162,52352,101.5,103225,51516,51709,99.6
21310, 기장군,104,65세이상,2016,20406,8469,11937,70.9,20358,8443,11915,70.9
21310, 기장군,086,85세이상,2016,1721,373,1348,27.7,1715,370,1345,27.5
21310, 기장군,126,평균연령,2016,39.2,37.8,40.6,,39.3,37.9,40.6,
21310, 기장군,127,중위연령,2016,39.4,38.4,40.5,,39.6,38.7,40.6,
22,대구광역시,000,합계,2016,2461002,1223733,1237269,98.9,2430510,1205785,1224725,98.5
22,대구광역시,005,0~4세,2016,99600,50877,48723,104.4,99198,50692,48506,104.5
22,대구광역시,005001, 0세,2016,18750,9583,9167,104.5,18660,9543,9117,104.7
22,대구광역시,005002, 1세,2016,19561,10040,9521,105.5,19482,9999,9483,105.4
22,대구광역시,005003, 2세,2016,19513,9910,9603,103.2,19432,9878,9554,103.4
22,대구광역시,005004, 3세,2016,19888,10138,9750,104,19814,10106,9708,104.1
22,대구광역시,005005, 4세,2016,21888,11206,10682,104.9,21810,11166,10644,104.9
22,대구광역시,010,5~9세,2016,105819,54610,51209,106.6,105478,54451,51027,106.7
22,대구광역시,010001, 5세,2016,21321,10971,10350,106,21238,10931,10307,106.1
22,대구광역시,010002, 6세,2016,20776,10680,10096,105.8,20691,10640,10051,105.9
22,대구광역시,010003, 7세,2016,20125,10456,9669,108.1,20064,10428,9636,108.2
22,대구광역시,010004, 8세,2016,21441,11148,10293,108.3,21374,11117,10257,108.4
22,대구광역시,010005, 9세,2016,22156,11355,10801,105.1,22111,11335,10776,105.2
22,대구광역시,015,10~14세,2016,113031,59651,53380,111.7,112807,59533,53274,111.7
22,대구광역시,015001, 10세,2016,20513,10748,9765,110.1,20474,10724,9750,110
22,대구광역시,015002, 11세,2016,20857,10917,9940,109.8,20807,10897,9910,110
22,대구광역시,015003, 12세,2016,22884,12012,10872,110.5,22834,11981,10853,110.4
22,대구광역시,015004, 13세,2016,24170,12846,11324,113.4,24142,12829,11313,113.4
22,대구광역시,015005, 14세,2016,24607,13128,11479,114.4,24550,13102,11448,114.4
22,대구광역시,020,15~19세,2016,157832,83207,74625,111.5,157226,82907,74319,111.6
22,대구광역시,020001, 15세,2016,28814,15139,13675,110.7,28777,15115,13662,110.6
22,대구광역시,020002, 16세,2016,31926,16991,14935,113.8,31873,16965,14908,113.8
22,대구광역시,020003, 17세,2016,30807,16303,14504,112.4,30741,16273,14468,112.5
22,대구광역시,020004, 18세,2016,32328,17253,15075,114.4,32188,17182,15006,114.5
22,대구광역시,020005, 19세,2016,33957,17521,16436,106.6,33647,17372,16275,106.7
22,대구광역시,025,20~24세,2016,178227,97665,80562,121.2,174130,95438,78692,121.3
22,대구광역시,025001, 20세,2016,35240,18944,16296,116.2,34660,18673,15987,116.8
22,대구광역시,025002, 21세,2016,36190,19685,16505,119.3,35458,19313,16145,119.6
22,대구광역시,025003, 22세,2016,36088,19978,16110,124,35321,19567,15754,124.2
22,대구광역시,025004, 23세,2016,35430,19633,15797,124.3,34503,19112,15391,124.2
22,대구광역시,025005, 24세,2016,35279,19425,15854,122.5,34188,18773,15415,121.8
22,대구광역시,030,25~29세,2016,149598,82378,67220,122.5,143280,78547,64733,121.3
22,대구광역시,030001, 25세,2016,32646,18199,14447,126,31473,17501,13972,125.3
22,대구광역시,030002, 26세,2016,31319,17439,13880,125.6,30021,16657,13364,124.6
22,대구광역시,030003, 27세,2016,29835,16480,13355,123.4,28599,15725,12874,122.1
22,대구광역시,030004, 28세,2016,27715,15211,12504,121.6,26407,14426,11981,120.4
22,대구광역시,030005, 29세,2016,28083,15049,13034,115.5,26780,14238,12542,113.5
22,대구광역시,035,30~34세,2016,155362,80524,74838,107.6,150002,77046,72956,105.6
22,대구광역시,035001, 30세,2016,28154,15119,13035,116,26951,14372,12579,114.3
22,대구광역시,035002, 31세,2016,28013,14895,13118,113.5,26885,14178,12707,111.6
22,대구광역시,035003, 32세,2016,29456,15326,14130,108.5,28429,14636,13793,106.1
22,대구광역시,035004, 33세,2016,33199,16872,16327,103.3,32160,16174,15986,101.2
22,대구광역시,035005, 34세,2016,36540,18312,18228,100.5,35577,17686,17891,98.9
22,대구광역시,040,35~39세,2016,179830,90213,89617,100.7,176247,87870,88377,99.4
22,대구광역시,040001, 35세,2016,36965,18634,18331,101.7,36182,18125,18057,100.4
22,대구광역시,040002, 36세,2016,38185,19159,19026,100.7,37427,18653,18774,99.4
22,대구광역시,040003, 37세,2016,36118,18022,18096,99.6,35360,17539,17821,98.4
22,대구광역시,040004, 38세,2016,33408,16848,16560,101.7,32732,16399,16333,100.4
22,대구광역시,040005, 39세,2016,35154,17550,17604,99.7,34546,17154,17392,98.6
22,대구광역시,045,40~44세,2016,199464,98620,100844,97.8,196854,96946,99908,97
22,대구광역시,045001, 40세,2016,35448,17935,17513,102.4,34871,17547,17324,101.3
22,대구광역시,045002, 41세,2016,37601,18471,19130,96.6,37092,18144,18948,95.8
22,대구광역시,045003, 42세,2016,41369,20485,20884,98.1,40855,20178,20677,97.6
22,대구광역시,045004, 43세,2016,42037,20543,21494,95.6,41533,20217,21316,94.8
22,대구광역시,045005, 44세,2016,43009,21186,21823,97.1,42503,20860,21643,96.4
22,대구광역시,050,45~49세,2016,225880,110673,115207,96.1,223499,109313,114186,95.7
22,대구광역시,050001, 45세,2016,45458,22453,23005,97.6,44923,22137,22786,97.2
22,대구광역시,050002, 46세,2016,44926,21969,22957,95.7,44392,21666,22726,95.3
22,대구광역시,050003, 47세,2016,45428,22212,23216,95.7,44965,21931,23034,95.2
22,대구광역시,050004, 48세,2016,46607,22968,23639,97.2,46140,22716,23424,97
22,대구광역시,050005, 49세,2016,43461,21071,22390,94.1,43079,20863,22216,93.9
22,대구광역시,055,50~54세,2016,210583,104161,106422,97.9,208701,103182,105519,97.8
22,대구광역시,055001, 50세,2016,41793,20936,20857,100.4,41412,20753,20659,100.5
22,대구광역시,055002, 51세,2016,42457,20606,21851,94.3,42070,20382,21688,94
22,대구광역시,055003, 52세,2016,40356,19910,20446,97.4,39960,19704,20256,97.3
22,대구광역시,055004, 53세,2016,42112,20928,21184,98.8,41723,20731,20992,98.8
22,대구광역시,055005, 54세,2016,43865,21781,22084,98.6,43536,21612,21924,98.6
22,대구광역시,060,55~59세,2016,206933,101399,105534,96.1,205773,100831,104942,96.1
22,대구광역시,060001, 55세,2016,47069,22992,24077,95.5,46884,22903,23981,95.5
22,대구광역시,060002, 56세,2016,45372,21949,23423,93.7,45073,21807,23266,93.7
22,대구광역시,060003, 57세,2016,41321,20107,21214,94.8,41073,19989,21084,94.8
22,대구광역시,060004, 58세,2016,36042,17977,18065,99.5,35813,17858,17955,99.5
22,대구광역시,060005, 59세,2016,37129,18374,18755,98,36930,18274,18656,98
22,대구광역시,065,60~64세,2016,154574,74135,80439,92.2,153802,73758,80044,92.1
22,대구광역시,065001, 60세,2016,34572,16938,17634,96.1,34394,16854,17540,96.1
22,대구광역시,065002, 61세,2016,34512,16414,18098,90.7,34350,16336,18014,90.7
22,대구광역시,065003, 62세,2016,28773,14069,14704,95.7,28596,13978,14618,95.6
22,대구광역시,065004, 63세,2016,27594,12950,14644,88.4,27453,12878,14575,88.4
22,대구광역시,065005, 64세,2016,29123,13764,15359,89.6,29009,13712,15297,89.6
22,대구광역시,070,65~69세,2016,112059,52486,59573,88.1,111690,52302,59388,88.1
22,대구광역시,070001, 65세,2016,22177,10512,11665,90.1,22069,10455,11614,90
22,대구광역시,070002, 66세,2016,22404,10752,11652,92.3,22315,10715,11600,92.4
22,대구광역시,070003, 67세,2016,24015,11217,12798,87.6,23932,11171,12761,87.5
22,대구광역시,070004, 68세,2016,22537,10485,12052,87,22489,10461,12028,87
22,대구광역시,070005, 69세,2016,20926,9520,11406,83.5,20885,9500,11385,83.4
22,대구광역시,075,70~74세,2016,82156,36415,45741,79.6,81996,36343,45653,79.6
22,대구광역시,075001, 70세,2016,14184,6621,7563,87.5,14135,6596,7539,87.5
22,대구광역시,075002, 71세,2016,14673,6526,8147,80.1,14643,6511,8132,80.1
22,대구광역시,075003, 72세,2016,16761,7250,9511,76.2,16725,7235,9490,76.2
22,대구광역시,075004, 73세,2016,17494,7702,9792,78.7,17474,7696,9778,78.7
22,대구광역시,075005, 74세,2016,19044,8316,10728,77.5,19019,8305,10714,77.5
22,대구광역시,080,75~79세,2016,66903,26871,40032,67.1,66802,26831,39971,67.1
22,대구광역시,080001, 75세,2016,15527,6503,9024,72.1,15499,6490,9009,72
22,대구광역시,080002, 76세,2016,14145,5664,8481,66.8,14125,5657,8468,66.8
22,대구광역시,080003, 77세,2016,13939,5680,8259,68.8,13920,5671,8249,68.7
22,대구광역시,080004, 78세,2016,12172,4762,7410,64.3,12156,4758,7398,64.3
22,대구광역시,080005, 79세,2016,11120,4262,6858,62.1,11102,4255,6847,62.1
22,대구광역시,085,80~84세,2016,40428,14159,26269,53.9,40347,14121,26226,53.8
22,대구광역시,085001, 80세,2016,10143,3733,6410,58.2,10122,3723,6399,58.2
22,대구광역시,085002, 81세,2016,9489,3478,6011,57.9,9473,3473,6000,57.9
22,대구광역시,085003, 82세,2016,8182,2867,5315,53.9,8169,2859,5310,53.8
22,대구광역시,085004, 83세,2016,6604,2158,4446,48.5,6584,2150,4434,48.5
22,대구광역시,085005, 84세,2016,6010,1923,4087,47.1,5999,1916,4083,46.9
22,대구광역시,090,85~89세,2016,16689,4432,12257,36.2,16666,4420,12246,36.1
22,대구광역시,090001, 85세,2016,4572,1316,3256,40.4,4566,1312,3254,40.3
22,대구광역시,090002, 86세,2016,3842,978,2864,34.1,3837,975,2862,34.1
22,대구광역시,090003, 87세,2016,3246,844,2402,35.1,3241,842,2399,35.1
22,대구광역시,090004, 88세,2016,2776,731,2045,35.7,2773,729,2044,35.7
22,대구광역시,090005, 89세,2016,2253,563,1690,33.3,2249,562,1687,33.3
22,대구광역시,095,90~94세,2016,4942,1074,3868,27.8,4926,1072,3854,27.8
22,대구광역시,095001, 90세,2016,1445,326,1119,29.1,1440,326,1114,29.3
22,대구광역시,095002, 91세,2016,1319,304,1015,30,1315,304,1011,30.1
22,대구광역시,095003, 92세,2016,862,175,687,25.5,859,174,685,25.4
22,대구광역시,095004, 93세,2016,731,148,583,25.4,729,148,581,25.5
22,대구광역시,095005, 94세,2016,585,121,464,26.1,583,120,463,25.9
22,대구광역시,100,95~99세,2016,965,170,795,21.4,961,169,792,21.3
22,대구광역시,100001, 95세,2016,353,66,287,23,353,66,287,23
22,대구광역시,100002, 96세,2016,261,47,214,22,261,47,214,22
22,대구광역시,100003, 97세,2016,166,29,137,21.2,166,29,137,21.2
22,대구광역시,100004, 98세,2016,101,13,88,14.8,97,12,85,14.1
22,대구광역시,100005, 99세,2016,84,15,69,21.7,84,15,69,21.7
22,대구광역시,101,100세이상,2016,127,13,114,11.4,125,13,112,11.6
22,대구광역시,102,15세미만,2016,318450,165138,153312,107.7,317483,164676,152807,107.8
22,대구광역시,103,15~64세,2016,1818283,922975,895308,103.1,1789514,905838,883676,102.5
22,대구광역시,104,65세이상,2016,324269,135620,188649,71.9,323513,135271,188242,71.9
22,대구광역시,086,85세이상,2016,22723,5689,17034,33.4,22678,5674,17004,33.4
22,대구광역시,126,평균연령,2016,41,39.6,42.4,,41.1,39.7,42.5,
22,대구광역시,127,중위연령,2016,42.4,40.7,44,,42.6,40.9,44.1,
22004, 읍부,000,합계,2016,143546,73341,70205,104.5,139340,70440,68900,102.2
22004, 읍부,005,0~4세,2016,8303,4241,4062,104.4,8251,4223,4028,104.8
22004, 읍부,005001, 0세,2016,1575,810,765,105.9,1562,806,756,106.6
22004, 읍부,005002, 1세,2016,1632,810,822,98.5,1618,804,814,98.8
22004, 읍부,005003, 2세,2016,1603,828,775,106.8,1593,827,766,108
22004, 읍부,005004, 3세,2016,1690,876,814,107.6,1681,871,810,107.5
22004, 읍부,005005, 4세,2016,1803,917,886,103.5,1797,915,882,103.7
22004, 읍부,010,5~9세,2016,8176,4159,4017,103.5,8138,4142,3996,103.7
22004, 읍부,010001, 5세,2016,1806,925,881,105,1796,920,876,105
22004, 읍부,010002, 6세,2016,1637,829,808,102.6,1629,825,804,102.6
22004, 읍부,010003, 7세,2016,1544,790,754,104.8,1536,785,751,104.5
22004, 읍부,010004, 8세,2016,1624,840,784,107.1,1618,837,781,107.2
22004, 읍부,010005, 9세,2016,1565,775,790,98.1,1559,775,784,98.9
22004, 읍부,015,10~14세,2016,7391,3938,3453,114,7372,3924,3448,113.8
22004, 읍부,015001, 10세,2016,1427,749,678,110.5,1423,746,677,110.2
22004, 읍부,015002, 11세,2016,1490,790,700,112.9,1485,788,697,113.1
22004, 읍부,015003, 12세,2016,1473,760,713,106.6,1468,756,712,106.2
22004, 읍부,015004, 13세,2016,1511,812,699,116.2,1509,810,699,115.9
22004, 읍부,015005, 14세,2016,1490,827,663,124.7,1487,824,663,124.3
22004, 읍부,020,15~19세,2016,8676,4551,4125,110.3,8643,4536,4107,110.4
22004, 읍부,020001, 15세,2016,1759,927,832,111.4,1757,926,831,111.4
22004, 읍부,020002, 16세,2016,1849,944,905,104.3,1845,942,903,104.3
22004, 읍부,020003, 17세,2016,1757,926,831,111.4,1750,924,826,111.9
22004, 읍부,020004, 18세,2016,1750,928,822,112.9,1744,924,820,112.7
22004, 읍부,020005, 19세,2016,1561,826,735,112.4,1547,820,727,112.8
22004, 읍부,025,20~24세,2016,9032,5145,3887,132.4,8690,4908,3782,129.8
22004, 읍부,025001, 20세,2016,1727,1009,718,140.5,1708,998,710,140.6
22004, 읍부,025002, 21세,2016,1809,1069,740,144.5,1777,1047,730,143.4
22004, 읍부,025003, 22세,2016,1811,1000,811,123.3,1738,950,788,120.6
22004, 읍부,025004, 23세,2016,1848,1044,804,129.9,1755,979,776,126.2
22004, 읍부,025005, 24세,2016,1837,1023,814,125.7,1712,934,778,120.1
22004, 읍부,030,25~29세,2016,8573,4789,3784,126.6,7682,4127,3555,116.1
22004, 읍부,030001, 25세,2016,1774,1026,748,137.2,1611,906,705,128.5
22004, 읍부,030002, 26세,2016,1724,963,761,126.5,1556,843,713,118.2
22004, 읍부,030003, 27세,2016,1700,946,754,125.5,1530,820,710,115.5
22004, 읍부,030004, 28세,2016,1652,936,716,130.7,1458,788,670,117.6
22004, 읍부,030005, 29세,2016,1723,918,805,114,1527,770,757,101.7
22004, 읍부,035,30~34세,2016,10668,5547,5121,108.3,9745,4835,4910,98.5
22004, 읍부,035001, 30세,2016,1828,987,841,117.4,1628,835,793,105.3
22004, 읍부,035002, 31세,2016,1884,1006,878,114.6,1688,858,830,103.4
22004, 읍부,035003, 32세,2016,1972,1020,952,107.1,1809,887,922,96.2
22004, 읍부,035004, 33세,2016,2330,1165,1165,100,2147,1025,1122,91.4
22004, 읍부,035005, 34세,2016,2654,1369,1285,106.5,2473,1230,1243,99
22004, 읍부,040,35~39세,2016,13071,6700,6371,105.2,12471,6255,6216,100.6
22004, 읍부,040001, 35세,2016,2672,1349,1323,102,2536,1246,1290,96.6
22004, 읍부,040002, 36세,2016,2843,1427,1416,100.8,2720,1336,1384,96.5
22004, 읍부,040003, 37세,2016,2625,1360,1265,107.5,2500,1265,1235,102.4
22004, 읍부,040004, 38세,2016,2428,1254,1174,106.8,2303,1164,1139,102.2
22004, 읍부,040005, 39세,2016,2503,1310,1193,109.8,2412,1244,1168,106.5
22004, 읍부,045,40~44세,2016,13111,6825,6286,108.6,12690,6539,6151,106.3
22004, 읍부,045001, 40세,2016,2499,1292,1207,107,2404,1224,1180,103.7
22004, 읍부,045002, 41세,2016,2574,1327,1247,106.4,2493,1270,1223,103.8
22004, 읍부,045003, 42세,2016,2742,1437,1305,110.1,2667,1392,1275,109.2
22004, 읍부,045004, 43세,2016,2646,1379,1267,108.8,2565,1325,1240,106.9
22004, 읍부,045005, 44세,2016,2650,1390,1260,110.3,2561,1328,1233,107.7
22004, 읍부,050,45~49세,2016,13220,6566,6654,98.7,12860,6355,6505,97.7
22004, 읍부,050001, 45세,2016,2706,1393,1313,106.1,2629,1342,1287,104.3
22004, 읍부,050002, 46세,2016,2680,1359,1321,102.9,2606,1319,1287,102.5
22004, 읍부,050003, 47세,2016,2664,1297,1367,94.9,2590,1251,1339,93.4
22004, 읍부,050004, 48세,2016,2664,1316,1348,97.6,2586,1273,1313,97
22004, 읍부,050005, 49세,2016,2506,1201,1305,92,2449,1170,1279,91.5
22004, 읍부,055,50~54세,2016,12250,6142,6108,100.6,12002,6001,6001,100
22004, 읍부,055001, 50세,2016,2518,1281,1237,103.6,2465,1251,1214,103
22004, 읍부,055002, 51세,2016,2494,1211,1283,94.4,2443,1177,1266,93
22004, 읍부,055003, 52세,2016,2316,1163,1153,100.9,2264,1136,1128,100.7
22004, 읍부,055004, 53세,2016,2356,1170,1186,98.7,2308,1145,1163,98.5
22004, 읍부,055005, 54세,2016,2566,1317,1249,105.4,2522,1292,1230,105
22004, 읍부,060,55~59세,2016,10942,5685,5257,108.1,10783,5594,5189,107.8
22004, 읍부,060001, 55세,2016,2649,1395,1254,111.2,2618,1377,1241,111
22004, 읍부,060002, 56세,2016,2404,1223,1181,103.6,2371,1207,1164,103.7
22004, 읍부,060003, 57세,2016,2187,1147,1040,110.3,2154,1129,1025,110.1
22004, 읍부,060004, 58세,2016,1856,956,900,106.2,1820,932,888,105
22004, 읍부,060005, 59세,2016,1846,964,882,109.3,1820,949,871,109
22004, 읍부,065,60~64세,2016,7072,3553,3519,101,7012,3524,3488,101
22004, 읍부,065001, 60세,2016,1629,862,767,112.4,1616,858,758,113.2
22004, 읍부,065002, 61세,2016,1582,752,830,90.6,1568,745,823,90.5
22004, 읍부,065003, 62세,2016,1287,663,624,106.3,1269,654,615,106.3
22004, 읍부,065004, 63세,2016,1266,629,637,98.7,1261,626,635,98.6
22004, 읍부,065005, 64세,2016,1308,647,661,97.9,1298,641,657,97.6
22004, 읍부,070,65~69세,2016,4763,2331,2432,95.8,4729,2317,2412,96.1
22004, 읍부,070001, 65세,2016,980,494,486,101.6,970,490,480,102.1
22004, 읍부,070002, 66세,2016,984,493,491,100.4,972,489,483,101.2
22004, 읍부,070003, 67세,2016,1032,503,529,95.1,1023,499,524,95.2
22004, 읍부,070004, 68세,2016,928,442,486,90.9,926,440,486,90.5
22004, 읍부,070005, 69세,2016,839,399,440,90.7,838,399,439,90.9
22004, 읍부,075,70~74세,2016,3293,1495,1798,83.1,3283,1492,1791,83.3
22004, 읍부,075001, 70세,2016,601,285,316,90.2,598,284,314,90.4
22004, 읍부,075002, 71세,2016,584,285,299,95.3,580,284,296,95.9
22004, 읍부,075003, 72세,2016,686,319,367,86.9,685,318,367,86.6
22004, 읍부,075004, 73세,2016,685,295,390,75.6,683,295,388,76
22004, 읍부,075005, 74세,2016,737,311,426,73,737,311,426,73
22004, 읍부,080,75~79세,2016,2556,981,1575,62.3,2552,980,1572,62.3
22004, 읍부,080001, 75세,2016,604,228,376,60.6,603,228,375,60.8
22004, 읍부,080002, 76세,2016,539,196,343,57.1,539,196,343,57.1
22004, 읍부,080003, 77세,2016,510,196,314,62.4,510,196,314,62.4
22004, 읍부,080004, 78세,2016,484,195,289,67.5,481,194,287,67.6
22004, 읍부,080005, 79세,2016,419,166,253,65.6,419,166,253,65.6
22004, 읍부,085,80~84세,2016,1528,507,1021,49.7,1519,503,1016,49.5
22004, 읍부,085001, 80세,2016,358,128,230,55.7,355,126,229,55
22004, 읍부,085002, 81세,2016,337,121,216,56,336,121,215,56.3
22004, 읍부,085003, 82세,2016,326,103,223,46.2,324,102,222,45.9
22004, 읍부,085004, 83세,2016,276,93,183,50.8,273,92,181,50.8
22004, 읍부,085005, 84세,2016,231,62,169,36.7,231,62,169,36.7
22004, 읍부,090,85~89세,2016,676,153,523,29.3,675,153,522,29.3
22004, 읍부,090001, 85세,2016,166,47,119,39.5,166,47,119,39.5
22004, 읍부,090002, 86세,2016,164,41,123,33.3,164,41,123,33.3
22004, 읍부,090003, 87세,2016,126,23,103,22.3,125,23,102,22.5
22004, 읍부,090004, 88세,2016,117,26,91,28.6,117,26,91,28.6
22004, 읍부,090005, 89세,2016,103,16,87,18.4,103,16,87,18.4
22004, 읍부,095,90~94세,2016,202,28,174,16.1,200,27,173,15.6
22004, 읍부,095001, 90세,2016,58,6,52,11.5,58,6,52,11.5
22004, 읍부,095002, 91세,2016,49,6,43,14,48,6,42,14.3
22004, 읍부,095003, 92세,2016,35,X,31,12.9,35,X,31,12.9
22004, 읍부,095004, 93세,2016,33,X,30,10,33,X,30,10
22004, 읍부,095005, 94세,2016,27,9,18,50,26,8,18,44.4
22004, 읍부,100,95~99세,2016,35,X,32,9.4,35,X,32,9.4
22004, 읍부,100001, 95세,2016,11,X,11,0,11,X,11,0
22004, 읍부,100002, 96세,2016,7,X,7,0,7,X,7,0
22004, 읍부,100003, 97세,2016,6,X,6,0,6,X,6,0
22004, 읍부,100004, 98세,2016,6,X,5,20,6,X,5,20
22004, 읍부,100005, 99세,2016,5,X,X,66.7,5,X,X,66.7
22004, 읍부,101,100세이상,2016,8,X,6,33.3,8,X,6,33.3
22004, 읍부,102,15세미만,2016,23870,12338,11532,107,23761,12289,11472,107.1
22004, 읍부,103,15~64세,2016,106615,55503,51112,108.6,102578,52674,49904,105.6
22004, 읍부,104,65세이상,2016,13061,5500,7561,72.7,13001,5477,7524,72.8
22004, 읍부,086,85세이상,2016,921,186,735,25.3,918,185,733,25.2
22004, 읍부,126,평균연령,2016,38.1,37.1,39.1,,38.1,37.2,39.1,
22004, 읍부,127,중위연령,2016,39.2,38.1,40.2,,39.5,38.6,40.3,
22005, 면부,000,합계,2016,69349,35955,33394,107.7,67212,34377,32835,104.7
22005, 면부,005,0~4세,2016,4559,2272,2287,99.3,4547,2268,2279,99.5
22005, 면부,005001, 0세,2016,975,497,478,104,969,494,475,104
22005, 면부,005002, 1세,2016,936,497,439,113.2,936,497,439,113.2
22005, 면부,005003, 2세,2016,931,434,497,87.3,927,433,494,87.7
22005, 면부,005004, 3세,2016,816,416,400,104,814,416,398,104.5
22005, 면부,005005, 4세,2016,901,428,473,90.5,901,428,473,90.5
22005, 면부,010,5~9세,2016,3422,1795,1627,110.3,3413,1791,1622,110.4
22005, 면부,010001, 5세,2016,798,416,382,108.9,796,414,382,108.4
22005, 면부,010002, 6세,2016,774,414,360,115,773,413,360,114.7
22005, 면부,010003, 7세,2016,618,324,294,110.2,616,324,292,111
22005, 면부,010004, 8세,2016,627,328,299,109.7,625,327,298,109.7
22005, 면부,010005, 9세,2016,605,313,292,107.2,603,313,290,107.9
22005, 면부,015,10~14세,2016,2446,1298,1148,113.1,2444,1297,1147,113.1
22005, 면부,015001, 10세,2016,509,283,226,125.2,507,282,225,125.3
22005, 면부,015002, 11세,2016,504,256,248,103.2,504,256,248,103.2
22005, 면부,015003, 12세,2016,498,244,254,96.1,498,244,254,96.1
22005, 면부,015004, 13세,2016,503,280,223,125.6,503,280,223,125.6
22005, 면부,015005, 14세,2016,432,235,197,119.3,432,235,197,119.3
22005, 면부,020,15~19세,2016,3005,1605,1400,114.6,2993,1599,1394,114.7
22005, 면부,020001, 15세,2016,551,286,265,107.9,550,285,265,107.5
22005, 면부,020002, 16세,2016,553,279,274,101.8,551,278,273,101.8
22005, 면부,020003, 17세,2016,582,292,290,100.7,580,291,289,100.7
22005, 면부,020004, 18세,2016,622,339,283,119.8,620,338,282,119.9
22005, 면부,020005, 19세,2016,697,409,288,142,692,407,285,142.8
22005, 면부,025,20~24세,2016,3643,2272,1371,165.7,3404,2078,1326,156.7
22005, 면부,025001, 20세,2016,759,509,250,203.6,734,489,245,199.6
22005, 면부,025002, 21세,2016,730,476,254,187.4,693,444,249,178.3
22005, 면부,025003, 22세,2016,628,386,242,159.5,587,356,231,154.1
22005, 면부,025004, 23세,2016,719,436,283,154.1,647,377,270,139.6
22005, 면부,025005, 24세,2016,807,465,342,136,743,412,331,124.5
22005, 면부,030,25~29세,2016,4619,2789,1830,152.4,4022,2321,1701,136.4
22005, 면부,030001, 25세,2016,838,499,339,147.2,718,399,319,125.1
22005, 면부,030002, 26세,2016,919,582,337,172.7,800,489,311,157.2
22005, 면부,030003, 27세,2016,942,596,346,172.3,809,491,318,154.4
22005, 면부,030004, 28세,2016,934,553,381,145.1,819,461,358,128.8
22005, 면부,030005, 29세,2016,986,559,427,130.9,876,481,395,121.8
22005, 면부,035,30~34세,2016,6446,3523,2923,120.5,5984,3170,2814,112.7
22005, 면부,035001, 30세,2016,1121,629,492,127.8,1009,546,463,117.9
22005, 면부,035002, 31세,2016,1127,636,491,129.5,1037,567,470,120.6
22005, 면부,035003, 32세,2016,1246,721,525,137.3,1147,645,502,128.5
22005, 면부,035004, 33세,2016,1416,743,673,110.4,1334,683,651,104.9
22005, 면부,035005, 34세,2016,1536,794,742,107,1457,729,728,100.1
22005, 면부,040,35~39세,2016,6624,3648,2976,122.6,6344,3433,2911,117.9
22005, 면부,040001, 35세,2016,1488,838,650,128.9,1415,782,633,123.5
22005, 면부,040002, 36세,2016,1473,799,674,118.5,1421,760,661,115
22005, 면부,040003, 37세,2016,1358,715,643,111.2,1297,668,629,106.2
22005, 면부,040004, 38세,2016,1156,641,515,124.5,1097,596,501,119
22005, 면부,040005, 39세,2016,1149,655,494,132.6,1114,627,487,128.7
22005, 면부,045,40~44세,2016,4877,2753,2124,129.6,4706,2630,2076,126.7
22005, 면부,045001, 40세,2016,965,550,415,132.5,929,523,406,128.8
22005, 면부,045002, 41세,2016,997,558,439,127.1,954,526,428,122.9
22005, 면부,045003, 42세,2016,1021,589,432,136.3,986,564,422,133.6
22005, 면부,045004, 43세,2016,959,548,411,133.3,920,519,401,129.4
22005, 면부,045005, 44세,2016,935,508,427,119,917,498,419,118.9
22005, 면부,050,45~49세,2016,4867,2561,2306,111.1,4723,2463,2260,109
22005, 면부,050001, 45세,2016,976,517,459,112.6,943,492,451,109.1
22005, 면부,050002, 46세,2016,968,539,429,125.6,936,518,418,123.9
22005, 면부,050003, 47세,2016,954,487,467,104.3,929,467,462,101.1
22005, 면부,050004, 48세,2016,1029,537,492,109.1,1004,522,482,108.3
22005, 면부,050005, 49세,2016,940,481,459,104.8,911,464,447,103.8
22005, 면부,055,50~54세,2016,4906,2568,2338,109.8,4810,2516,2294,109.7
22005, 면부,055001, 50세,2016,962,488,474,103,943,479,464,103.2
22005, 면부,055002, 51세,2016,933,500,433,115.5,908,487,421,115.7
22005, 면부,055003, 52세,2016,917,507,410,123.7,901,499,402,124.1
22005, 면부,055004, 53세,2016,1001,504,497,101.4,976,489,487,100.4
22005, 면부,055005, 54세,2016,1093,569,524,108.6,1082,562,520,108.1
22005, 면부,060,55~59세,2016,5329,2597,2732,95.1,5271,2568,2703,95
22005, 면부,060001, 55세,2016,1142,556,586,94.9,1133,552,581,95
22005, 면부,060002, 56세,2016,1090,533,557,95.7,1080,530,550,96.4
22005, 면부,060003, 57세,2016,1113,520,593,87.7,1103,514,589,87.3
22005, 면부,060004, 58세,2016,1006,496,510,97.3,996,489,507,96.4
22005, 면부,060005, 59세,2016,978,492,486,101.2,959,483,476,101.5
22005, 면부,065,60~64세,2016,4234,2083,2151,96.8,4205,2064,2141,96.4
22005, 면부,065001, 60세,2016,984,483,501,96.4,975,477,498,95.8
22005, 면부,065002, 61세,2016,919,452,467,96.8,917,450,467,96.4
22005, 면부,065003, 62세,2016,783,388,395,98.2,777,384,393,97.7
22005, 면부,065004, 63세,2016,715,345,370,93.2,709,342,367,93.2
22005, 면부,065005, 64세,2016,833,415,418,99.3,827,411,416,98.8
22005, 면부,070,65~69세,2016,3172,1554,1618,96,3154,1545,1609,96
22005, 면부,070001, 65세,2016,590,291,299,97.3,582,286,296,96.6
22005, 면부,070002, 66세,2016,657,320,337,95,656,320,336,95.2
22005, 면부,070003, 67세,2016,681,346,335,103.3,678,344,334,103
22005, 면부,070004, 68세,2016,657,322,335,96.1,653,320,333,96.1
22005, 면부,070005, 69세,2016,587,275,312,88.1,585,275,310,88.7
22005, 면부,075,70~74세,2016,2318,1015,1303,77.9,2313,1012,1301,77.8
22005, 면부,075001, 70세,2016,378,185,193,95.9,377,184,193,95.3
22005, 면부,075002, 71세,2016,430,194,236,82.2,429,193,236,81.8
22005, 면부,075003, 72세,2016,476,216,260,83.1,474,215,259,83
22005, 면부,075004, 73세,2016,453,195,258,75.6,453,195,258,75.6
22005, 면부,075005, 74세,2016,581,225,356,63.2,580,225,355,63.4
22005, 면부,080,75~79세,2016,2275,813,1462,55.6,2272,813,1459,55.7
22005, 면부,080001, 75세,2016,489,192,297,64.6,488,192,296,64.9
22005, 면부,080002, 76세,2016,462,153,309,49.5,462,153,309,49.5
22005, 면부,080003, 77세,2016,486,169,317,53.3,485,169,316,53.5
22005, 면부,080004, 78세,2016,429,162,267,60.7,428,162,266,60.9
22005, 면부,080005, 79세,2016,409,137,272,50.4,409,137,272,50.4
22005, 면부,085,80~84세,2016,1589,532,1057,50.3,1589,532,1057,50.3
22005, 면부,085001, 80세,2016,357,131,226,58,357,131,226,58
22005, 면부,085002, 81세,2016,385,118,267,44.2,385,118,267,44.2
22005, 면부,085003, 82세,2016,334,101,233,43.3,334,101,233,43.3
22005, 면부,085004, 83세,2016,249,87,162,53.7,249,87,162,53.7
22005, 면부,085005, 84세,2016,264,95,169,56.2,264,95,169,56.2
22005, 면부,090,85~89세,2016,734,205,529,38.8,734,205,529,38.8
22005, 면부,090001, 85세,2016,207,57,150,38,207,57,150,38
22005, 면부,090002, 86세,2016,168,52,116,44.8,168,52,116,44.8
22005, 면부,090003, 87세,2016,134,32,102,31.4,134,32,102,31.4
22005, 면부,090004, 88세,2016,123,38,85,44.7,123,38,85,44.7
22005, 면부,090005, 89세,2016,102,26,76,34.2,102,26,76,34.2
22005, 면부,095,90~94세,2016,232,57,175,32.6,232,57,175,32.6
22005, 면부,095001, 90세,2016,77,17,60,28.3,77,17,60,28.3
22005, 면부,095002, 91세,2016,61,18,43,41.9,61,18,43,41.9
22005, 면부,095003, 92세,2016,36,8,28,28.6,36,8,28,28.6
22005, 면부,095004, 93세,2016,30,10,20,50,30,10,20,50
22005, 면부,095005, 94세,2016,28,X,24,16.7,28,X,24,16.7
22005, 면부,100,95~99세,2016,48,15,33,45.5,48,15,33,45.5
22005, 면부,100001, 95세,2016,19,7,12,58.3,19,7,12,58.3
22005, 면부,100002, 96세,2016,14,6,8,75,14,6,8,75
22005, 면부,100003, 97세,2016,7,X,5,40,7,X,5,40
22005, 면부,100004, 98세,2016,6,X,6,0,6,X,6,0
22005, 면부,100005, 99세,2016,X,X,X,0,X,X,X,0
22005, 면부,101,100세이상,2016,X,X,X,0,X,X,X,0
22005, 면부,102,15세미만,2016,10427,5365,5062,106,10404,5356,5048,106.1
22005, 면부,103,15~64세,2016,48550,26399,22151,119.2,46462,24842,21620,114.9
22005, 면부,104,65세이상,2016,10372,4191,6181,67.8,10346,4179,6167,67.8
22005, 면부,086,85세이상,2016,1018,277,741,37.4,1018,277,741,37.4
22005, 면부,126,평균연령,2016,40.9,39.1,42.8,,41.1,39.3,42.9,
22005, 면부,127,중위연령,2016,39.9,38.1,42.6,,40.5,38.8,42.9,
22003, 동부,000,합계,2016,2248107,1114437,1133670,98.3,2223958,1100968,1122990,98
22003, 동부,005,0~4세,2016,86738,44364,42374,104.7,86400,44201,42199,104.7
22003, 동부,005001, 0세,2016,16200,8276,7924,104.4,16129,8243,7886,104.5
22003, 동부,005002, 1세,2016,16993,8733,8260,105.7,16928,8698,8230,105.7
22003, 동부,005003, 2세,2016,16979,8648,8331,103.8,16912,8618,8294,103.9
22003, 동부,005004, 3세,2016,17382,8846,8536,103.6,17319,8819,8500,103.8
22003, 동부,005005, 4세,2016,19184,9861,9323,105.8,19112,9823,9289,105.7
22003, 동부,010,5~9세,2016,94221,48656,45565,106.8,93927,48518,45409,106.8
22003, 동부,010001, 5세,2016,18717,9630,9087,106,18646,9597,9049,106.1
22003, 동부,010002, 6세,2016,18365,9437,8928,105.7,18289,9402,8887,105.8
22003, 동부,010003, 7세,2016,17963,9342,8621,108.4,17912,9319,8593,108.4
22003, 동부,010004, 8세,2016,19190,9980,9210,108.4,19131,9953,9178,108.4
22003, 동부,010005, 9세,2016,19986,10267,9719,105.6,19949,10247,9702,105.6
22003, 동부,015,10~14세,2016,103194,54415,48779,111.6,102991,54312,48679,111.6
22003, 동부,015001, 10세,2016,18577,9716,8861,109.6,18544,9696,8848,109.6
22003, 동부,015002, 11세,2016,18863,9871,8992,109.8,18818,9853,8965,109.9
22003, 동부,015003, 12세,2016,20913,11008,9905,111.1,20868,10981,9887,111.1
22003, 동부,015004, 13세,2016,22156,11754,10402,113,22130,11739,10391,113
22003, 동부,015005, 14세,2016,22685,12066,10619,113.6,22631,12043,10588,113.7
22003, 동부,020,15~19세,2016,146151,77051,69100,111.5,145590,76772,68818,111.6
22003, 동부,020001, 15세,2016,26504,13926,12578,110.7,26470,13904,12566,110.6
22003, 동부,020002, 16세,2016,29524,15768,13756,114.6,29477,15745,13732,114.7
22003, 동부,020003, 17세,2016,28468,15085,13383,112.7,28411,15058,13353,112.8
22003, 동부,020004, 18세,2016,29956,15986,13970,114.4,29824,15920,13904,114.5
22003, 동부,020005, 19세,2016,31699,16286,15413,105.7,31408,16145,15263,105.8
22003, 동부,025,20~24세,2016,165552,90248,75304,119.8,162036,88452,73584,120.2
22003, 동부,025001, 20세,2016,32754,17426,15328,113.7,32218,17186,15032,114.3
22003, 동부,025002, 21세,2016,33651,18140,15511,116.9,32988,17822,15166,117.5
22003, 동부,025003, 22세,2016,33649,18592,15057,123.5,32996,18261,14735,123.9
22003, 동부,025004, 23세,2016,32863,18153,14710,123.4,32101,17756,14345,123.8
22003, 동부,025005, 24세,2016,32635,17937,14698,122,31733,17427,14306,121.8
22003, 동부,030,25~29세,2016,136406,74800,61606,121.4,131576,72099,59477,121.2
22003, 동부,030001, 25세,2016,30034,16674,13360,124.8,29144,16196,12948,125.1
22003, 동부,030002, 26세,2016,28676,15894,12782,124.3,27665,15325,12340,124.2
22003, 동부,030003, 27세,2016,27193,14938,12255,121.9,26260,14414,11846,121.7
22003, 동부,030004, 28세,2016,25129,13722,11407,120.3,24130,13177,10953,120.3
22003, 동부,030005, 29세,2016,25374,13572,11802,115,24377,12987,11390,114
22003, 동부,035,30~34세,2016,138248,71454,66794,107,134273,69041,65232,105.8
22003, 동부,035001, 30세,2016,25205,13503,11702,115.4,24314,12991,11323,114.7
22003, 동부,035002, 31세,2016,25002,13253,11749,112.8,24160,12753,11407,111.8
22003, 동부,035003, 32세,2016,26238,13585,12653,107.4,25473,13104,12369,105.9
22003, 동부,035004, 33세,2016,29453,14964,14489,103.3,28679,14466,14213,101.8
22003, 동부,035005, 34세,2016,32350,16149,16201,99.7,31647,15727,15920,98.8
22003, 동부,040,35~39세,2016,160135,79865,80270,99.5,157432,78182,79250,98.7
22003, 동부,040001, 35세,2016,32805,16447,16358,100.5,32231,16097,16134,99.8
22003, 동부,040002, 36세,2016,33869,16933,16936,100,33286,16557,16729,99
22003, 동부,040003, 37세,2016,32135,15947,16188,98.5,31563,15606,15957,97.8
22003, 동부,040004, 38세,2016,29824,14953,14871,100.6,29332,14639,14693,99.6
22003, 동부,040005, 39세,2016,31502,15585,15917,97.9,31020,15283,15737,97.1
22003, 동부,045,40~44세,2016,181476,89042,92434,96.3,179458,87777,91681,95.7
22003, 동부,045001, 40세,2016,31984,16093,15891,101.3,31538,15800,15738,100.4
22003, 동부,045002, 41세,2016,34030,16586,17444,95.1,33645,16348,17297,94.5
22003, 동부,045003, 42세,2016,37606,18459,19147,96.4,37202,18222,18980,96
22003, 동부,045004, 43세,2016,38432,18616,19816,93.9,38048,18373,19675,93.4
22003, 동부,045005, 44세,2016,39424,19288,20136,95.8,39025,19034,19991,95.2
22003, 동부,050,45~49세,2016,207793,101546,106247,95.6,205916,100495,105421,95.3
22003, 동부,050001, 45세,2016,41776,20543,21233,96.8,41351,20303,21048,96.5
22003, 동부,050002, 46세,2016,41278,20071,21207,94.6,40850,19829,21021,94.3
22003, 동부,050003, 47세,2016,41810,20428,21382,95.5,41446,20213,21233,95.2
22003, 동부,050004, 48세,2016,42914,21115,21799,96.9,42550,20921,21629,96.7
22003, 동부,050005, 49세,2016,40015,19389,20626,94,39719,19229,20490,93.8
22003, 동부,055,50~54세,2016,193427,95451,97976,97.4,191889,94665,97224,97.4
22003, 동부,055001, 50세,2016,38313,19167,19146,100.1,38004,19023,18981,100.2
22003, 동부,055002, 51세,2016,39030,18895,20135,93.8,38719,18718,20001,93.6
22003, 동부,055003, 52세,2016,37123,18240,18883,96.6,36795,18069,18726,96.5
22003, 동부,055004, 53세,2016,38755,19254,19501,98.7,38439,19097,19342,98.7
22003, 동부,055005, 54세,2016,40206,19895,20311,98,39932,19758,20174,97.9
22003, 동부,060,55~59세,2016,190662,93117,97545,95.5,189719,92669,97050,95.5
22003, 동부,060001, 55세,2016,43278,21041,22237,94.6,43133,20974,22159,94.7
22003, 동부,060002, 56세,2016,41878,20193,21685,93.1,41622,20070,21552,93.1
22003, 동부,060003, 57세,2016,38021,18440,19581,94.2,37816,18346,19470,94.2
22003, 동부,060004, 58세,2016,33180,16525,16655,99.2,32997,16437,16560,99.3
22003, 동부,060005, 59세,2016,34305,16918,17387,97.3,34151,16842,17309,97.3
22003, 동부,065,60~64세,2016,143268,68499,74769,91.6,142585,68170,74415,91.6
22003, 동부,065001, 60세,2016,31959,15593,16366,95.3,31803,15519,16284,95.3
22003, 동부,065002, 61세,2016,32011,15210,16801,90.5,31865,15141,16724,90.5
22003, 동부,065003, 62세,2016,26703,13018,13685,95.1,26550,12940,13610,95.1
22003, 동부,065004, 63세,2016,25613,11976,13637,87.8,25483,11910,13573,87.7
22003, 동부,065005, 64세,2016,26982,12702,14280,88.9,26884,12660,14224,89
22003, 동부,070,65~69세,2016,104124,48601,55523,87.5,103807,48440,55367,87.5
22003, 동부,070001, 65세,2016,20607,9727,10880,89.4,20517,9679,10838,89.3
22003, 동부,070002, 66세,2016,20763,9939,10824,91.8,20687,9906,10781,91.9
22003, 동부,070003, 67세,2016,22302,10368,11934,86.9,22231,10328,11903,86.8
22003, 동부,070004, 68세,2016,20952,9721,11231,86.6,20910,9701,11209,86.5
22003, 동부,070005, 69세,2016,19500,8846,10654,83,19462,8826,10636,83
22003, 동부,075,70~74세,2016,76545,33905,42640,79.5,76400,33839,42561,79.5
22003, 동부,075001, 70세,2016,13205,6151,7054,87.2,13160,6128,7032,87.1
22003, 동부,075002, 71세,2016,13659,6047,7612,79.4,13634,6034,7600,79.4
22003, 동부,075003, 72세,2016,15599,6715,8884,75.6,15566,6702,8864,75.6
22003, 동부,075004, 73세,2016,16356,7212,9144,78.9,16338,7206,9132,78.9
22003, 동부,075005, 74세,2016,17726,7780,9946,78.2,17702,7769,9933,78.2
22003, 동부,080,75~79세,2016,62072,25077,36995,67.8,61978,25038,36940,67.8
22003, 동부,080001, 75세,2016,14434,6083,8351,72.8,14408,6070,8338,72.8
22003, 동부,080002, 76세,2016,13144,5315,7829,67.9,13124,5308,7816,67.9
22003, 동부,080003, 77세,2016,12943,5315,7628,69.7,12925,5306,7619,69.6
22003, 동부,080004, 78세,2016,11259,4405,6854,64.3,11247,4402,6845,64.3
22003, 동부,080005, 79세,2016,10292,3959,6333,62.5,10274,3952,6322,62.5
22003, 동부,085,80~84세,2016,37311,13120,24191,54.2,37239,13086,24153,54.2
22003, 동부,085001, 80세,2016,9428,3474,5954,58.3,9410,3466,5944,58.3
22003, 동부,085002, 81세,2016,8767,3239,5528,58.6,8752,3234,5518,58.6
22003, 동부,085003, 82세,2016,7522,2663,4859,54.8,7511,2656,4855,54.7
22003, 동부,085004, 83세,2016,6079,1978,4101,48.2,6062,1971,4091,48.2
22003, 동부,085005, 84세,2016,5515,1766,3749,47.1,5504,1759,3745,47
22003, 동부,090,85~89세,2016,15279,4074,11205,36.4,15257,4062,11195,36.3
22003, 동부,090001, 85세,2016,4199,1212,2987,40.6,4193,1208,2985,40.5
22003, 동부,090002, 86세,2016,3510,885,2625,33.7,3505,882,2623,33.6
22003, 동부,090003, 87세,2016,2986,789,2197,35.9,2982,787,2195,35.9
22003, 동부,090004, 88세,2016,2536,667,1869,35.7,2533,665,1868,35.6
22003, 동부,090005, 89세,2016,2048,521,1527,34.1,2044,520,1524,34.1
22003, 동부,095,90~94세,2016,4508,989,3519,28.1,4494,988,3506,28.2
22003, 동부,095001, 90세,2016,1310,303,1007,30.1,1305,303,1002,30.2
22003, 동부,095002, 91세,2016,1209,280,929,30.1,1206,280,926,30.2
22003, 동부,095003, 92세,2016,791,163,628,26,788,162,626,25.9
22003, 동부,095004, 93세,2016,668,135,533,25.3,666,135,531,25.4
22003, 동부,095005, 94세,2016,530,108,422,25.6,529,108,421,25.7
22003, 동부,100,95~99세,2016,882,152,730,20.8,878,151,727,20.8
22003, 동부,100001, 95세,2016,323,59,264,22.3,323,59,264,22.3
22003, 동부,100002, 96세,2016,240,41,199,20.6,240,41,199,20.6
22003, 동부,100003, 97세,2016,153,27,126,21.4,153,27,126,21.4
22003, 동부,100004, 98세,2016,89,12,77,15.6,85,11,74,14.9
22003, 동부,100005, 99세,2016,77,13,64,20.3,77,13,64,20.3
22003, 동부,101,100세이상,2016,115,11,104,10.6,113,11,102,10.8
22003, 동부,102,15세미만,2016,284153,147435,136718,107.8,283318,147031,136287,107.9
22003, 동부,103,15~64세,2016,1663118,841073,822045,102.3,1640474,828322,812152,102
22003, 동부,104,65세이상,2016,300836,125929,174907,72,300166,125615,174551,72
22003, 동부,086,85세이상,2016,20784,5226,15558,33.6,20742,5212,15530,33.6
22003, 동부,126,평균연령,2016,41.2,39.8,42.6,,41.3,39.9,42.7,
22003, 동부,127,중위연령,2016,42.7,41,44.2,,42.9,41.2,44.4,
22010, 중구,000,합계,2016,77234,37361,39873,93.7,76435,36979,39456,93.7
22010, 중구,005,0~4세,2016,2995,1559,1436,108.6,2980,1554,1426,109
22010, 중구,005001, 0세,2016,655,345,310,111.3,652,344,308,111.7
22010, 중구,005002, 1세,2016,586,294,292,100.7,585,294,291,101
22010, 중구,005003, 2세,2016,569,302,267,113.1,566,302,264,114.4
22010, 중구,005004, 3세,2016,577,291,286,101.7,572,289,283,102.1
22010, 중구,005005, 4세,2016,608,327,281,116.4,605,325,280,116.1
22010, 중구,010,5~9세,2016,2521,1311,1210,108.3,2511,1302,1209,107.7
22010, 중구,010001, 5세,2016,578,280,298,94,576,278,298,93.3
22010, 중구,010002, 6세,2016,505,253,252,100.4,501,249,252,98.8
22010, 중구,010003, 7세,2016,483,264,219,120.5,483,264,219,120.5
22010, 중구,010004, 8세,2016,470,233,237,98.3,468,232,236,98.3
22010, 중구,010005, 9세,2016,485,281,204,137.7,483,279,204,136.8
22010, 중구,015,10~14세,2016,2287,1175,1112,105.7,2278,1169,1109,105.4
22010, 중구,015001, 10세,2016,461,233,228,102.2,459,232,227,102.2
22010, 중구,015002, 11세,2016,406,216,190,113.7,404,214,190,112.6
22010, 중구,015003, 12세,2016,449,215,234,91.9,448,214,234,91.5
22010, 중구,015004, 13세,2016,459,245,214,114.5,458,245,213,115
22010, 중구,015005, 14세,2016,512,266,246,108.1,509,264,245,107.8
22010, 중구,020,15~19세,2016,3451,1694,1757,96.4,3435,1683,1752,96.1
22010, 중구,020001, 15세,2016,617,308,309,99.7,615,307,308,99.7
22010, 중구,020002, 16세,2016,651,297,354,83.9,648,295,353,83.6
22010, 중구,020003, 17세,2016,751,369,382,96.6,748,368,380,96.8
22010, 중구,020004, 18세,2016,734,360,374,96.3,731,357,374,95.5
22010, 중구,020005, 19세,2016,698,360,338,106.5,693,356,337,105.6
22010, 중구,025,20~24세,2016,5045,2547,2498,102,4990,2518,2472,101.9
22010, 중구,025001, 20세,2016,790,417,373,111.8,786,415,371,111.9
22010, 중구,025002, 21세,2016,911,460,451,102,900,452,448,100.9
22010, 중구,025003, 22세,2016,1018,511,507,100.8,1011,507,504,100.6
22010, 중구,025004, 23세,2016,1080,539,541,99.6,1069,534,535,99.8
22010, 중구,025005, 24세,2016,1246,620,626,99,1224,610,614,99.3
22010, 중구,030,25~29세,2016,5760,3011,2749,109.5,5632,2958,2674,110.6
22010, 중구,030001, 25세,2016,1219,646,573,112.7,1200,638,562,113.5
22010, 중구,030002, 26세,2016,1237,657,580,113.3,1207,642,565,113.6
22010, 중구,030003, 27세,2016,1138,588,550,106.9,1118,581,537,108.2
22010, 중구,030004, 28세,2016,1077,571,506,112.8,1047,558,489,114.1
22010, 중구,030005, 29세,2016,1089,549,540,101.7,1060,539,521,103.5
22010, 중구,035,30~34세,2016,5929,2952,2977,99.2,5800,2886,2914,99
22010, 중구,035001, 30세,2016,1088,545,543,100.4,1063,533,530,100.6
22010, 중구,035002, 31세,2016,1143,596,547,109,1112,577,535,107.9
22010, 중구,035003, 32세,2016,1077,528,549,96.2,1046,509,537,94.8
22010, 중구,035004, 33세,2016,1278,608,670,90.7,1263,601,662,90.8
22010, 중구,035005, 34세,2016,1343,675,668,101,1316,666,650,102.5
22010, 중구,040,35~39세,2016,5647,2925,2722,107.5,5573,2887,2686,107.5
22010, 중구,040001, 35세,2016,1289,675,614,109.9,1277,668,609,109.7
22010, 중구,040002, 36세,2016,1256,652,604,107.9,1235,638,597,106.9
22010, 중구,040003, 37세,2016,1118,558,560,99.6,1109,554,555,99.8
22010, 중구,040004, 38세,2016,959,503,456,110.3,943,495,448,110.5
22010, 중구,040005, 39세,2016,1025,537,488,110,1009,532,477,111.5
22010, 중구,045,40~44세,2016,5512,2920,2592,112.7,5451,2891,2560,112.9
22010, 중구,045001, 40세,2016,1050,560,490,114.3,1036,556,480,115.8
22010, 중구,045002, 41세,2016,1042,558,484,115.3,1024,552,472,116.9
22010, 중구,045003, 42세,2016,1158,626,532,117.7,1145,621,524,118.5
22010, 중구,045004, 43세,2016,1100,561,539,104.1,1094,556,538,103.3
22010, 중구,045005, 44세,2016,1162,615,547,112.4,1152,606,546,111
22010, 중구,050,45~49세,2016,5865,2929,2936,99.8,5794,2893,2901,99.7
22010, 중구,050001, 45세,2016,1235,629,606,103.8,1214,621,593,104.7
22010, 중구,050002, 46세,2016,1211,592,619,95.6,1196,584,612,95.4
22010, 중구,050003, 47세,2016,1096,541,555,97.5,1083,535,548,97.6
22010, 중구,050004, 48세,2016,1198,620,578,107.3,1182,611,571,107
22010, 중구,050005, 49세,2016,1125,547,578,94.6,1119,542,577,93.9
22010, 중구,055,50~54세,2016,5710,2783,2927,95.1,5636,2743,2893,94.8
22010, 중구,055001, 50세,2016,1045,501,544,92.1,1036,498,538,92.6
22010, 중구,055002, 51세,2016,1149,552,597,92.5,1132,542,590,91.9
22010, 중구,055003, 52세,2016,1138,564,574,98.3,1125,558,567,98.4
22010, 중구,055004, 53세,2016,1117,544,573,94.9,1103,534,569,93.8
22010, 중구,055005, 54세,2016,1261,622,639,97.3,1240,611,629,97.1
22010, 중구,060,55~59세,2016,6395,3029,3366,90,6337,3007,3330,90.3
22010, 중구,060001, 55세,2016,1344,627,717,87.4,1335,626,709,88.3
22010, 중구,060002, 56세,2016,1387,667,720,92.6,1365,656,709,92.5
22010, 중구,060003, 57세,2016,1281,589,692,85.1,1274,586,688,85.2
22010, 중구,060004, 58세,2016,1158,577,581,99.3,1146,574,572,100.3
22010, 중구,060005, 59세,2016,1225,569,656,86.7,1217,565,652,86.7
22010, 중구,065,60~64세,2016,5485,2537,2948,86.1,5449,2522,2927,86.2
22010, 중구,065001, 60세,2016,1234,592,642,92.2,1224,587,637,92.2
22010, 중구,065002, 61세,2016,1185,545,640,85.2,1179,543,636,85.4
22010, 중구,065003, 62세,2016,1032,493,539,91.5,1022,488,534,91.4
22010, 중구,065004, 63세,2016,955,426,529,80.5,949,425,524,81.1
22010, 중구,065005, 64세,2016,1079,481,598,80.4,1075,479,596,80.4
22010, 중구,070,65~69세,2016,4583,1989,2594,76.7,4560,1980,2580,76.7
22010, 중구,070001, 65세,2016,829,362,467,77.5,823,359,464,77.4
22010, 중구,070002, 66세,2016,922,414,508,81.5,918,414,504,82.1
22010, 중구,070003, 67세,2016,970,409,561,72.9,964,407,557,73.1
22010, 중구,070004, 68세,2016,982,436,546,79.9,977,433,544,79.6
22010, 중구,070005, 69세,2016,880,368,512,71.9,878,367,511,71.8
22010, 중구,075,70~74세,2016,3937,1724,2213,77.9,3928,1721,2207,78
22010, 중구,075001, 70세,2016,673,293,380,77.1,671,292,379,77
22010, 중구,075002, 71세,2016,681,296,385,76.9,681,296,385,76.9
22010, 중구,075003, 72세,2016,832,351,481,73,828,349,479,72.9
22010, 중구,075004, 73세,2016,851,388,463,83.8,849,388,461,84.2
22010, 중구,075005, 74세,2016,900,396,504,78.6,899,396,503,78.7
22010, 중구,080,75~79세,2016,3096,1277,1819,70.2,3085,1275,1810,70.4
22010, 중구,080001, 75세,2016,682,297,385,77.1,681,297,384,77.3
22010, 중구,080002, 76세,2016,670,275,395,69.6,669,274,395,69.4
22010, 중구,080003, 77세,2016,646,266,380,70,646,266,380,70
22010, 중구,080004, 78세,2016,585,231,354,65.3,580,231,349,66.2
22010, 중구,080005, 79세,2016,513,208,305,68.2,509,207,302,68.5
22010, 중구,085,80~84세,2016,1842,693,1149,60.3,1827,687,1140,60.3
22010, 중구,085001, 80세,2016,473,190,283,67.1,471,190,281,67.6
22010, 중구,085002, 81세,2016,426,175,251,69.7,424,175,249,70.3
22010, 중구,085003, 82세,2016,366,137,229,59.8,362,135,227,59.5
22010, 중구,085004, 83세,2016,298,97,201,48.3,292,94,198,47.5
22010, 중구,085005, 84세,2016,279,94,185,50.8,278,93,185,50.3
22010, 중구,090,85~89세,2016,851,241,610,39.5,847,238,609,39.1
22010, 중구,090001, 85세,2016,221,71,150,47.3,220,71,149,47.7
22010, 중구,090002, 86세,2016,193,46,147,31.3,191,44,147,29.9
22010, 중구,090003, 87세,2016,157,47,110,42.7,156,46,110,41.8
22010, 중구,090004, 88세,2016,147,45,102,44.1,147,45,102,44.1
22010, 중구,090005, 89세,2016,133,32,101,31.7,133,32,101,31.7
22010, 중구,095,90~94세,2016,253,48,205,23.4,252,48,204,23.5
22010, 중구,095001, 90세,2016,78,15,63,23.8,77,15,62,24.2
22010, 중구,095002, 91세,2016,58,11,47,23.4,58,11,47,23.4
22010, 중구,095003, 92세,2016,43,11,32,34.4,43,11,32,34.4
22010, 중구,095004, 93세,2016,38,8,30,26.7,38,8,30,26.7
22010, 중구,095005, 94세,2016,36,X,33,9.1,36,X,33,9.1
22010, 중구,100,95~99세,2016,64,17,47,36.2,64,17,47,36.2
22010, 중구,100001, 95세,2016,30,5,25,20,30,5,25,20
22010, 중구,100002, 96세,2016,16,9,7,128.6,16,9,7,128.6
22010, 중구,100003, 97세,2016,9,X,7,28.6,9,X,7,28.6
22010, 중구,100004, 98세,2016,6,X,6,0,6,X,6,0
22010, 중구,100005, 99세,2016,X,X,X,50,X,X,X,50
22010, 중구,101,100세이상,2016,6,X,6,0,6,X,6,0
22010, 중구,102,15세미만,2016,7803,4045,3758,107.6,7769,4025,3744,107.5
22010, 중구,103,15~64세,2016,54799,27327,27472,99.5,54097,26988,27109,99.6
22010, 중구,104,65세이상,2016,14632,5989,8643,69.3,14569,5966,8603,69.3
22010, 중구,086,85세이상,2016,1174,306,868,35.3,1169,303,866,35
22010, 중구,126,평균연령,2016,44.1,42.5,45.6,,44.1,42.5,45.6,
22010, 중구,127,중위연령,2016,44.5,42.6,46.4,,44.6,42.7,46.5,
22020, 동구,000,합계,2016,341583,168800,172783,97.7,339623,168033,171590,97.9
22020, 동구,005,0~4세,2016,15412,7808,7604,102.7,15384,7795,7589,102.7
22020, 동구,005001, 0세,2016,2844,1405,1439,97.6,2841,1404,1437,97.7
22020, 동구,005002, 1세,2016,3081,1587,1494,106.2,3073,1583,1490,106.2
22020, 동구,005003, 2세,2016,3045,1546,1499,103.1,3037,1543,1494,103.3
22020, 동구,005004, 3세,2016,3092,1544,1548,99.7,3087,1543,1544,99.9
22020, 동구,005005, 4세,2016,3350,1726,1624,106.3,3346,1722,1624,106
22020, 동구,010,5~9세,2016,14693,7601,7092,107.2,14664,7589,7075,107.3
22020, 동구,010001, 5세,2016,3110,1623,1487,109.1,3103,1620,1483,109.2
22020, 동구,010002, 6세,2016,3009,1562,1447,107.9,3006,1561,1445,108
22020, 동구,010003, 7세,2016,2802,1465,1337,109.6,2798,1463,1335,109.6
22020, 동구,010004, 8세,2016,2901,1470,1431,102.7,2890,1465,1425,102.8
22020, 동구,010005, 9세,2016,2871,1481,1390,106.5,2867,1480,1387,106.7
22020, 동구,015,10~14세,2016,13333,7019,6314,111.2,13304,7006,6298,111.2
22020, 동구,015001, 10세,2016,2525,1321,1204,109.7,2521,1318,1203,109.6
22020, 동구,015002, 11세,2016,2540,1360,1180,115.3,2531,1357,1174,115.6
22020, 동구,015003, 12세,2016,2678,1403,1275,110,2670,1400,1270,110.2
22020, 동구,015004, 13세,2016,2811,1451,1360,106.7,2807,1448,1359,106.5
22020, 동구,015005, 14세,2016,2779,1484,1295,114.6,2775,1483,1292,114.8
22020, 동구,020,15~19세,2016,17014,9079,7935,114.4,16988,9069,7919,114.5
22020, 동구,020001, 15세,2016,3068,1598,1470,108.7,3065,1596,1469,108.6
22020, 동구,020002, 16세,2016,3481,1915,1566,122.3,3475,1914,1561,122.6
22020, 동구,020003, 17세,2016,3383,1811,1572,115.2,3378,1810,1568,115.4
22020, 동구,020004, 18세,2016,3499,1908,1591,119.9,3495,1905,1590,119.8
22020, 동구,020005, 19세,2016,3583,1847,1736,106.4,3575,1844,1731,106.5
22020, 동구,025,20~24세,2016,21002,11572,9430,122.7,20797,11512,9285,124
22020, 동구,025001, 20세,2016,3954,2172,1782,121.9,3933,2167,1766,122.7
22020, 동구,025002, 21세,2016,4221,2381,1840,129.4,4197,2378,1819,130.7
22020, 동구,025003, 22세,2016,4275,2384,1891,126.1,4234,2372,1862,127.4
22020, 동구,025004, 23세,2016,4247,2323,1924,120.7,4197,2311,1886,122.5
22020, 동구,025005, 24세,2016,4305,2312,1993,116,4236,2284,1952,117
22020, 동구,030,25~29세,2016,19983,10763,9220,116.7,19644,10646,8998,118.3
22020, 동구,030001, 25세,2016,4137,2268,1869,121.3,4081,2250,1831,122.9
22020, 동구,030002, 26세,2016,4057,2248,1809,124.3,3986,2224,1762,126.2
22020, 동구,030003, 27세,2016,3960,2146,1814,118.3,3890,2122,1768,120
22020, 동구,030004, 28세,2016,3790,2008,1782,112.7,3713,1983,1730,114.6
22020, 동구,030005, 29세,2016,4039,2093,1946,107.6,3974,2067,1907,108.4
22020, 동구,035,30~34세,2016,22765,11662,11103,105,22507,11575,10932,105.9
22020, 동구,035001, 30세,2016,4000,2125,1875,113.3,3941,2108,1833,115
22020, 동구,035002, 31세,2016,4034,2093,1941,107.8,3984,2080,1904,109.2
22020, 동구,035003, 32세,2016,4353,2250,2103,107,4305,2226,2079,107.1
22020, 동구,035004, 33세,2016,4857,2446,2411,101.5,4816,2431,2385,101.9
22020, 동구,035005, 34세,2016,5521,2748,2773,99.1,5461,2730,2731,100
22020, 동구,040,35~39세,2016,27139,13842,13297,104.1,26928,13757,13171,104.4
22020, 동구,040001, 35세,2016,5795,2933,2862,102.5,5751,2919,2832,103.1
22020, 동구,040002, 36세,2016,5854,2953,2901,101.8,5815,2938,2877,102.1
22020, 동구,040003, 37세,2016,5409,2716,2693,100.9,5360,2695,2665,101.1
22020, 동구,040004, 38세,2016,5027,2662,2365,112.6,4983,2642,2341,112.9
22020, 동구,040005, 39세,2016,5054,2578,2476,104.1,5019,2563,2456,104.4
22020, 동구,045,40~44세,2016,26283,13828,12455,111,26124,13757,12367,111.2
22020, 동구,045001, 40세,2016,4960,2661,2299,115.7,4930,2644,2286,115.7
22020, 동구,045002, 41세,2016,5154,2727,2427,112.4,5120,2710,2410,112.4
22020, 동구,045003, 42세,2016,5449,2838,2611,108.7,5410,2826,2584,109.4
22020, 동구,045004, 43세,2016,5365,2786,2579,108,5340,2776,2564,108.3
22020, 동구,045005, 44세,2016,5355,2816,2539,110.9,5324,2801,2523,111
22020, 동구,050,45~49세,2016,27375,13636,13739,99.3,27187,13559,13628,99.5
22020, 동구,050001, 45세,2016,5547,2925,2622,111.6,5509,2908,2601,111.8
22020, 동구,050002, 46세,2016,5390,2725,2665,102.3,5351,2714,2637,102.9
22020, 동구,050003, 47세,2016,5473,2702,2771,97.5,5433,2679,2754,97.3
22020, 동구,050004, 48세,2016,5681,2770,2911,95.2,5642,2757,2885,95.6
22020, 동구,050005, 49세,2016,5284,2514,2770,90.8,5252,2501,2751,90.9
22020, 동구,055,50~54세,2016,27325,13231,14094,93.9,27129,13140,13989,93.9
22020, 동구,055001, 50세,2016,5244,2566,2678,95.8,5198,2544,2654,95.9
22020, 동구,055002, 51세,2016,5414,2588,2826,91.6,5378,2570,2808,91.5
22020, 동구,055003, 52세,2016,5285,2591,2694,96.2,5239,2569,2670,96.2
22020, 동구,055004, 53세,2016,5532,2683,2849,94.2,5487,2663,2824,94.3
22020, 동구,055005, 54세,2016,5850,2803,3047,92,5827,2794,3033,92.1
22020, 동구,060,55~59세,2016,29977,14136,15841,89.2,29859,14085,15774,89.3
22020, 동구,060001, 55세,2016,6564,3096,3468,89.3,6548,3088,3460,89.2
22020, 동구,060002, 56세,2016,6468,2998,3470,86.4,6444,2988,3456,86.5
22020, 동구,060003, 57세,2016,5923,2741,3182,86.1,5900,2731,3169,86.2
22020, 동구,060004, 58세,2016,5403,2629,2774,94.8,5369,2615,2754,95
22020, 동구,060005, 59세,2016,5619,2672,2947,90.7,5598,2663,2935,90.7
22020, 동구,065,60~64세,2016,24668,11589,13079,88.6,24574,11547,13027,88.6
22020, 동구,065001, 60세,2016,5397,2554,2843,89.8,5373,2544,2829,89.9
22020, 동구,065002, 61세,2016,5513,2563,2950,86.9,5493,2557,2936,87.1
22020, 동구,065003, 62세,2016,4608,2171,2437,89.1,4593,2162,2431,88.9
22020, 동구,065004, 63세,2016,4379,2035,2344,86.8,4355,2021,2334,86.6
22020, 동구,065005, 64세,2016,4771,2266,2505,90.5,4760,2263,2497,90.6
22020, 동구,070,65~69세,2016,18977,8862,10115,87.6,18936,8842,10094,87.6
22020, 동구,070001, 65세,2016,3701,1732,1969,88,3693,1729,1964,88
22020, 동구,070002, 66세,2016,3759,1785,1974,90.4,3747,1779,1968,90.4
22020, 동구,070003, 67세,2016,4162,1926,2236,86.1,4152,1919,2233,85.9
22020, 동구,070004, 68세,2016,3802,1768,2034,86.9,3798,1767,2031,87
22020, 동구,070005, 69세,2016,3553,1651,1902,86.8,3546,1648,1898,86.8
22020, 동구,075,70~74세,2016,14036,6203,7833,79.2,14016,6192,7824,79.1
22020, 동구,075001, 70세,2016,2417,1110,1307,84.9,2408,1103,1305,84.5
22020, 동구,075002, 71세,2016,2554,1117,1437,77.7,2551,1114,1437,77.5
22020, 동구,075003, 72세,2016,2855,1227,1628,75.4,2850,1227,1623,75.6
22020, 동구,075004, 73세,2016,3014,1354,1660,81.6,3012,1354,1658,81.7
22020, 동구,075005, 74세,2016,3196,1395,1801,77.5,3195,1394,1801,77.4
22020, 동구,080,75~79세,2016,11411,4676,6735,69.4,11404,4675,6729,69.5
22020, 동구,080001, 75세,2016,2699,1157,1542,75,2697,1157,1540,75.1
22020, 동구,080002, 76세,2016,2438,1016,1422,71.4,2437,1016,1421,71.5
22020, 동구,080003, 77세,2016,2380,985,1395,70.6,2378,985,1393,70.7
22020, 동구,080004, 78세,2016,2014,761,1253,60.7,2013,760,1253,60.7
22020, 동구,080005, 79세,2016,1880,757,1123,67.4,1879,757,1122,67.5
22020, 동구,085,80~84세,2016,6590,2354,4236,55.6,6581,2350,4231,55.5
22020, 동구,085001, 80세,2016,1699,634,1065,59.5,1698,633,1065,59.4
22020, 동구,085002, 81세,2016,1555,598,957,62.5,1553,598,955,62.6
22020, 동구,085003, 82세,2016,1332,483,849,56.9,1330,481,849,56.7
22020, 동구,085004, 83세,2016,1064,338,726,46.6,1062,338,724,46.7
22020, 동구,085005, 84세,2016,940,301,639,47.1,938,300,638,47
22020, 동구,090,85~89세,2016,2653,753,1900,39.6,2651,751,1900,39.5
22020, 동구,090001, 85세,2016,722,229,493,46.5,722,229,493,46.5
22020, 동구,090002, 86세,2016,581,161,420,38.3,581,161,420,38.3
22020, 동구,090003, 87세,2016,514,139,375,37.1,513,138,375,36.8
22020, 동구,090004, 88세,2016,461,126,335,37.6,460,125,335,37.3
22020, 동구,090005, 89세,2016,375,98,277,35.4,375,98,277,35.4
22020, 동구,095,90~94세,2016,763,155,608,25.5,762,155,607,25.5
22020, 동구,095001, 90세,2016,218,43,175,24.6,218,43,175,24.6
22020, 동구,095002, 91세,2016,215,46,169,27.2,215,46,169,27.2
22020, 동구,095003, 92세,2016,141,27,114,23.7,141,27,114,23.7
22020, 동구,095004, 93세,2016,103,19,84,22.6,103,19,84,22.6
22020, 동구,095005, 94세,2016,86,20,66,30.3,85,20,65,30.8
22020, 동구,100,95~99세,2016,156,29,127,22.8,156,29,127,22.8
22020, 동구,100001, 95세,2016,51,13,38,34.2,51,13,38,34.2
22020, 동구,100002, 96세,2016,44,X,41,7.3,44,X,41,7.3
22020, 동구,100003, 97세,2016,29,7,22,31.8,29,7,22,31.8
22020, 동구,100004, 98세,2016,19,X,16,18.8,19,X,16,18.8
22020, 동구,100005, 99세,2016,13,X,10,30,13,X,10,30
22020, 동구,101,100세이상,2016,28,X,26,7.7,28,X,26,7.7
22020, 동구,102,15세미만,2016,43438,22428,21010,106.7,43352,22390,20962,106.8
22020, 동구,103,15~64세,2016,243531,123338,120193,102.6,241737,122647,119090,103
22020, 동구,104,65세이상,2016,54614,23034,31580,72.9,54534,22996,31538,72.9
22020, 동구,086,85세이상,2016,3600,939,2661,35.3,3597,937,2660,35.2
22020, 동구,126,평균연령,2016,42.6,41.1,44.1,,42.6,41.1,44.2,
22020, 동구,127,중위연령,2016,43.7,41.9,45.7,,43.8,41.9,45.8,
22030, 서구,000,합계,2016,197210,99299,97911,101.4,194389,97672,96717,101
22030, 서구,005,0~4세,2016,5720,2919,2801,104.2,5685,2904,2781,104.4
22030, 서구,005001, 0세,2016,1119,578,541,106.8,1112,575,537,107.1
22030, 서구,005002, 1세,2016,1102,563,539,104.5,1095,561,534,105.1
22030, 서구,005003, 2세,2016,1104,569,535,106.4,1098,566,532,106.4
22030, 서구,005004, 3세,2016,1169,581,588,98.8,1164,577,587,98.3
22030, 서구,005005, 4세,2016,1226,628,598,105,1216,625,591,105.8
22030, 서구,010,5~9세,2016,5434,2743,2691,101.9,5412,2732,2680,101.9
22030, 서구,010001, 5세,2016,1160,591,569,103.9,1155,589,566,104.1
22030, 서구,010002, 6세,2016,1039,528,511,103.3,1032,525,507,103.6
22030, 서구,010003, 7세,2016,1035,513,522,98.3,1032,512,520,98.5
22030, 서구,010004, 8세,2016,1084,568,516,110.1,1081,566,515,109.9
22030, 서구,010005, 9세,2016,1116,543,573,94.8,1112,540,572,94.4
22030, 서구,015,10~14세,2016,6109,3250,2859,113.7,6093,3240,2853,113.6
22030, 서구,015001, 10세,2016,1079,548,531,103.2,1078,547,531,103
22030, 서구,015002, 11세,2016,1082,568,514,110.5,1079,568,511,111.2
22030, 서구,015003, 12세,2016,1169,642,527,121.8,1168,641,527,121.6
22030, 서구,015004, 13세,2016,1336,708,628,112.7,1334,706,628,112.4
22030, 서구,015005, 14세,2016,1443,784,659,119,1434,778,656,118.6
22030, 서구,020,15~19세,2016,9973,5367,4606,116.5,9946,5349,4597,116.4
22030, 서구,020001, 15세,2016,1697,913,784,116.5,1693,909,784,115.9
22030, 서구,020002, 16세,2016,1953,1058,895,118.2,1949,1055,894,118
22030, 서구,020003, 17세,2016,1923,1008,915,110.2,1917,1004,913,110
22030, 서구,020004, 18세,2016,2143,1174,969,121.2,2136,1171,965,121.3
22030, 서구,020005, 19세,2016,2257,1214,1043,116.4,2251,1210,1041,116.2
22030, 서구,025,20~24세,2016,14032,7925,6107,129.8,13783,7797,5986,130.3
22030, 서구,025001, 20세,2016,2484,1398,1086,128.7,2466,1389,1077,129
22030, 서구,025002, 21세,2016,2802,1591,1211,131.4,2770,1577,1193,132.2
22030, 서구,025003, 22세,2016,2802,1581,1221,129.5,2757,1562,1195,130.7
22030, 서구,025004, 23세,2016,2902,1647,1255,131.2,2832,1606,1226,131
22030, 서구,025005, 24세,2016,3042,1708,1334,128,2958,1663,1295,128.4
22030, 서구,030,25~29세,2016,12809,7234,5575,129.8,12289,6953,5336,130.3
22030, 서구,030001, 25세,2016,2785,1528,1257,121.6,2708,1483,1225,121.1
22030, 서구,030002, 26세,2016,2703,1550,1153,134.4,2599,1504,1095,137.4
22030, 서구,030003, 27세,2016,2577,1461,1116,130.9,2474,1397,1077,129.7
22030, 서구,030004, 28세,2016,2390,1377,1013,135.9,2279,1320,959,137.6
22030, 서구,030005, 29세,2016,2354,1318,1036,127.2,2229,1249,980,127.4
22030, 서구,035,30~34세,2016,12142,6702,5440,123.2,11681,6420,5261,122
22030, 서구,035001, 30세,2016,2387,1334,1053,126.7,2279,1269,1010,125.6
22030, 서구,035002, 31세,2016,2204,1228,976,125.8,2108,1174,934,125.7
22030, 서구,035003, 32세,2016,2311,1291,1020,126.6,2216,1233,983,125.4
22030, 서구,035004, 33세,2016,2567,1414,1153,122.6,2476,1356,1120,121.1
22030, 서구,035005, 34세,2016,2673,1435,1238,115.9,2602,1388,1214,114.3
22030, 서구,040,35~39세,2016,12536,6869,5667,121.2,12144,6613,5531,119.6
22030, 서구,040001, 35세,2016,2693,1499,1194,125.5,2623,1450,1173,123.6
22030, 서구,040002, 36세,2016,2711,1475,1236,119.3,2633,1421,1212,117.2
22030, 서구,040003, 37세,2016,2543,1390,1153,120.6,2447,1336,1111,120.3
22030, 서구,040004, 38세,2016,2230,1199,1031,116.3,2154,1152,1002,115
22030, 서구,040005, 39세,2016,2359,1306,1053,124,2287,1254,1033,121.4
22030, 서구,045,40~44세,2016,13514,7346,6168,119.1,13226,7159,6067,118
22030, 서구,045001, 40세,2016,2349,1312,1037,126.5,2289,1267,1022,124
22030, 서구,045002, 41세,2016,2594,1422,1172,121.3,2537,1384,1153,120
22030, 서구,045003, 42세,2016,2721,1504,1217,123.6,2669,1470,1199,122.6
22030, 서구,045004, 43세,2016,2911,1555,1356,114.7,2861,1530,1331,115
22030, 서구,045005, 44세,2016,2939,1553,1386,112,2870,1508,1362,110.7
22030, 서구,050,45~49세,2016,16913,8542,8371,102,16642,8372,8270,101.2
22030, 서구,050001, 45세,2016,3157,1640,1517,108.1,3094,1603,1491,107.5
22030, 서구,050002, 46세,2016,3266,1669,1597,104.5,3206,1628,1578,103.2
22030, 서구,050003, 47세,2016,3429,1702,1727,98.6,3366,1658,1708,97.1
22030, 서구,050004, 48세,2016,3603,1830,1773,103.2,3561,1803,1758,102.6
22030, 서구,050005, 49세,2016,3458,1701,1757,96.8,3415,1680,1735,96.8
22030, 서구,055,50~54세,2016,18957,9433,9524,99,18735,9321,9414,99
22030, 서구,055001, 50세,2016,3604,1822,1782,102.2,3555,1796,1759,102.1
22030, 서구,055002, 51세,2016,3777,1882,1895,99.3,3737,1857,1880,98.8
22030, 서구,055003, 52세,2016,3679,1828,1851,98.8,3635,1807,1828,98.9
22030, 서구,055004, 53세,2016,3716,1849,1867,99,3664,1825,1839,99.2
22030, 서구,055005, 54세,2016,4181,2052,2129,96.4,4144,2036,2108,96.6
22030, 서구,060,55~59세,2016,19914,9632,10282,93.7,19778,9562,10216,93.6
22030, 서구,060001, 55세,2016,4498,2187,2311,94.6,4477,2175,2302,94.5
22030, 서구,060002, 56세,2016,4325,2079,2246,92.6,4284,2059,2225,92.5
22030, 서구,060003, 57세,2016,3993,1908,2085,91.5,3960,1893,2067,91.6
22030, 서구,060004, 58세,2016,3434,1687,1747,96.6,3415,1677,1738,96.5
22030, 서구,060005, 59세,2016,3664,1771,1893,93.6,3642,1758,1884,93.3
22030, 서구,065,60~64세,2016,16203,7488,8715,85.9,16098,7436,8662,85.8
22030, 서구,065001, 60세,2016,3500,1627,1873,86.9,3473,1614,1859,86.8
22030, 서구,065002, 61세,2016,3514,1597,1917,83.3,3493,1588,1905,83.4
22030, 서구,065003, 62세,2016,2999,1435,1564,91.8,2976,1422,1554,91.5
22030, 서구,065004, 63세,2016,2978,1393,1585,87.9,2959,1383,1576,87.8
22030, 서구,065005, 64세,2016,3212,1436,1776,80.9,3197,1429,1768,80.8
22030, 서구,070,65~69세,2016,11946,5636,6310,89.3,11899,5616,6283,89.4
22030, 서구,070001, 65세,2016,2384,1123,1261,89.1,2368,1116,1252,89.1
22030, 서구,070002, 66세,2016,2318,1161,1157,100.3,2307,1157,1150,100.6
22030, 서구,070003, 67세,2016,2598,1246,1352,92.2,2591,1241,1350,91.9
22030, 서구,070004, 68세,2016,2439,1105,1334,82.8,2432,1104,1328,83.1
22030, 서구,070005, 69세,2016,2207,1001,1206,83,2201,998,1203,83
22030, 서구,075,70~74세,2016,8605,3838,4767,80.5,8592,3832,4760,80.5
22030, 서구,075001, 70세,2016,1457,653,804,81.2,1451,651,800,81.4
22030, 서구,075002, 71세,2016,1507,721,786,91.7,1504,720,784,91.8
22030, 서구,075003, 72세,2016,1804,764,1040,73.5,1803,763,1040,73.4
22030, 서구,075004, 73세,2016,1852,833,1019,81.7,1851,833,1018,81.8
22030, 서구,075005, 74세,2016,1985,867,1118,77.5,1983,865,1118,77.4
22030, 서구,080,75~79세,2016,6629,2675,3954,67.7,6623,2672,3951,67.6
22030, 서구,080001, 75세,2016,1571,680,891,76.3,1568,677,891,76
22030, 서구,080002, 76세,2016,1379,549,830,66.1,1377,549,828,66.3
22030, 서구,080003, 77세,2016,1423,583,840,69.4,1423,583,840,69.4
22030, 서구,080004, 78세,2016,1180,468,712,65.7,1180,468,712,65.7
22030, 서구,080005, 79세,2016,1076,395,681,58,1075,395,680,58.1
22030, 서구,085,80~84세,2016,3710,1252,2458,50.9,3704,1248,2456,50.8
22030, 서구,085001, 80세,2016,997,372,625,59.5,996,372,624,59.6
22030, 서구,085002, 81세,2016,836,305,531,57.4,835,304,531,57.3
22030, 서구,085003, 82세,2016,766,269,497,54.1,766,269,497,54.1
22030, 서구,085004, 83세,2016,577,166,411,40.4,575,165,410,40.2
22030, 서구,085005, 84세,2016,534,140,394,35.5,532,138,394,35
22030, 서구,090,85~89세,2016,1487,355,1132,31.4,1484,353,1131,31.2
22030, 서구,090001, 85세,2016,419,116,303,38.3,419,116,303,38.3
22030, 서구,090002, 86세,2016,337,68,269,25.3,336,67,269,24.9
22030, 서구,090003, 87세,2016,269,64,205,31.2,269,64,205,31.2
22030, 서구,090004, 88세,2016,262,63,199,31.7,260,62,198,31.3
22030, 서구,090005, 89세,2016,200,44,156,28.2,200,44,156,28.2
22030, 서구,095,90~94세,2016,474,81,393,20.6,474,81,393,20.6
22030, 서구,095001, 90세,2016,139,27,112,24.1,139,27,112,24.1
22030, 서구,095002, 91세,2016,112,23,89,25.8,112,23,89,25.8
22030, 서구,095003, 92세,2016,94,13,81,16,94,13,81,16
22030, 서구,095004, 93세,2016,81,10,71,14.1,81,10,71,14.1
22030, 서구,095005, 94세,2016,48,8,40,20,48,8,40,20
22030, 서구,100,95~99세,2016,89,11,78,14.1,87,11,76,14.5
22030, 서구,100001, 95세,2016,37,5,32,15.6,37,5,32,15.6
22030, 서구,100002, 96세,2016,17,X,15,13.3,17,X,15,13.3
22030, 서구,100003, 97세,2016,14,X,11,27.3,14,X,11,27.3
22030, 서구,100004, 98세,2016,10,X,10,0,8,X,8,0
22030, 서구,100005, 99세,2016,11,X,10,10,11,X,10,10
22030, 서구,101,100세이상,2016,14,X,13,7.7,14,X,13,7.7
22030, 서구,102,15세미만,2016,17263,8912,8351,106.7,17190,8876,8314,106.8
22030, 서구,103,15~64세,2016,146993,76538,70455,108.6,144322,74982,69340,108.1
22030, 서구,104,65세이상,2016,32954,13849,19105,72.5,32877,13814,19063,72.5
22030, 서구,086,85세이상,2016,2064,448,1616,27.7,2059,446,1613,27.7
22030, 서구,126,평균연령,2016,44.6,42.9,46.4,,44.7,43,46.5,
22030, 서구,127,중위연령,2016,47,44.5,49.2,,47.2,44.8,49.4,
22040, 남구,000,합계,2016,155833,75199,80634,93.3,154584,74722,79862,93.6
22040, 남구,005,0~4세,2016,4408,2244,2164,103.7,4390,2237,2153,103.9
22040, 남구,005001, 0세,2016,880,437,443,98.6,873,436,437,99.8
22040, 남구,005002, 1세,2016,868,443,425,104.2,866,441,425,103.8
22040, 남구,005003, 2세,2016,872,426,446,95.5,868,424,444,95.5
22040, 남구,005004, 3세,2016,886,472,414,114,884,471,413,114
22040, 남구,005005, 4세,2016,902,466,436,106.9,899,465,434,107.1
22040, 남구,010,5~9세,2016,4302,2248,2054,109.4,4283,2239,2044,109.5
22040, 남구,010001, 5세,2016,863,452,411,110,860,451,409,110.3
22040, 남구,010002, 6세,2016,828,429,399,107.5,821,426,395,107.8
22040, 남구,010003, 7세,2016,829,419,410,102.2,824,416,408,102
22040, 남구,010004, 8세,2016,863,466,397,117.4,860,465,395,117.7
22040, 남구,010005, 9세,2016,919,482,437,110.3,918,481,437,110.1
22040, 남구,015,10~14세,2016,4825,2579,2246,114.8,4810,2572,2238,114.9
22040, 남구,015001, 10세,2016,864,481,383,125.6,861,478,383,124.8
22040, 남구,015002, 11세,2016,895,481,414,116.2,892,481,411,117
22040, 남구,015003, 12세,2016,970,487,483,100.8,966,484,482,100.4
22040, 남구,015004, 13세,2016,1050,564,486,116,1049,564,485,116.3
22040, 남구,015005, 14세,2016,1046,566,480,117.9,1042,565,477,118.4
22040, 남구,020,15~19세,2016,7874,3886,3988,97.4,7852,3875,3977,97.4
22040, 남구,020001, 15세,2016,1263,628,635,98.9,1261,627,634,98.9
22040, 남구,020002, 16세,2016,1441,710,731,97.1,1437,708,729,97.1
22040, 남구,020003, 17세,2016,1546,754,792,95.2,1542,752,790,95.2
22040, 남구,020004, 18세,2016,1641,813,828,98.2,1637,811,826,98.2
22040, 남구,020005, 19세,2016,1983,981,1002,97.9,1975,977,998,97.9
22040, 남구,025,20~24세,2016,11403,5925,5478,108.2,11269,5883,5386,109.2
22040, 남구,025001, 20세,2016,2229,1143,1086,105.2,2204,1135,1069,106.2
22040, 남구,025002, 21세,2016,2233,1110,1123,98.8,2211,1100,1111,99
22040, 남구,025003, 22세,2016,2399,1288,1111,115.9,2365,1281,1084,118.2
22040, 남구,025004, 23세,2016,2262,1195,1067,112,2235,1185,1050,112.9
22040, 남구,025005, 24세,2016,2280,1189,1091,109,2254,1182,1072,110.3
22040, 남구,030,25~29세,2016,9953,5261,4692,112.1,9735,5186,4549,114
22040, 남구,030001, 25세,2016,2091,1092,999,109.3,2052,1082,970,111.5
22040, 남구,030002, 26세,2016,2061,1064,997,106.7,2024,1046,978,107
22040, 남구,030003, 27세,2016,2008,1110,898,123.6,1955,1091,864,126.3
22040, 남구,030004, 28세,2016,1898,973,925,105.2,1854,962,892,107.8
22040, 남구,030005, 29세,2016,1895,1022,873,117.1,1850,1005,845,118.9
22040, 남구,035,30~34세,2016,10201,5268,4933,106.8,10050,5226,4824,108.3
22040, 남구,035001, 30세,2016,1875,983,892,110.2,1841,973,868,112.1
22040, 남구,035002, 31세,2016,1974,1027,947,108.4,1934,1020,914,111.6
22040, 남구,035003, 32세,2016,1952,994,958,103.8,1928,990,938,105.5
22040, 남구,035004, 33세,2016,2102,1111,991,112.1,2069,1097,972,112.9
22040, 남구,035005, 34세,2016,2298,1153,1145,100.7,2278,1146,1132,101.2
22040, 남구,040,35~39세,2016,10439,5328,5111,104.2,10337,5299,5038,105.2
22040, 남구,040001, 35세,2016,2297,1168,1129,103.5,2280,1164,1116,104.3
22040, 남구,040002, 36세,2016,2215,1115,1100,101.4,2184,1106,1078,102.6
22040, 남구,040003, 37세,2016,2016,1006,1010,99.6,2004,1003,1001,100.2
22040, 남구,040004, 38세,2016,1943,1029,914,112.6,1922,1023,899,113.8
22040, 남구,040005, 39세,2016,1968,1010,958,105.4,1947,1003,944,106.3
22040, 남구,045,40~44세,2016,10879,5525,5354,103.2,10775,5476,5299,103.3
22040, 남구,045001, 40세,2016,1927,992,935,106.1,1906,981,925,106.1
22040, 남구,045002, 41세,2016,2042,992,1050,94.5,2026,987,1039,95
22040, 남구,045003, 42세,2016,2200,1147,1053,108.9,2175,1133,1042,108.7
22040, 남구,045004, 43세,2016,2376,1208,1168,103.4,2352,1198,1154,103.8
22040, 남구,045005, 44세,2016,2334,1186,1148,103.3,2316,1177,1139,103.3
22040, 남구,050,45~49세,2016,12463,6238,6225,100.2,12363,6200,6163,100.6
22040, 남구,050001, 45세,2016,2437,1243,1194,104.1,2424,1236,1188,104
22040, 남구,050002, 46세,2016,2490,1225,1265,96.8,2461,1214,1247,97.4
22040, 남구,050003, 47세,2016,2475,1271,1204,105.6,2456,1267,1189,106.6
22040, 남구,050004, 48세,2016,2565,1304,1261,103.4,2542,1293,1249,103.5
22040, 남구,050005, 49세,2016,2496,1195,1301,91.9,2480,1190,1290,92.2
22040, 남구,055,50~54세,2016,12370,5963,6407,93.1,12269,5918,6351,93.2
22040, 남구,055001, 50세,2016,2311,1175,1136,103.4,2283,1164,1119,104
22040, 남구,055002, 51세,2016,2401,1147,1254,91.5,2385,1135,1250,90.8
22040, 남구,055003, 52세,2016,2339,1074,1265,84.9,2317,1068,1249,85.5
22040, 남구,055004, 53세,2016,2501,1199,1302,92.1,2485,1192,1293,92.2
22040, 남구,055005, 54세,2016,2818,1368,1450,94.3,2799,1359,1440,94.4
22040, 남구,060,55~59세,2016,14358,6689,7669,87.2,14259,6649,7610,87.4
22040, 남구,060001, 55세,2016,3011,1422,1589,89.5,2999,1416,1583,89.5
22040, 남구,060002, 56세,2016,3019,1357,1662,81.6,2992,1350,1642,82.2
22040, 남구,060003, 57세,2016,2916,1316,1600,82.3,2896,1311,1585,82.7
22040, 남구,060004, 58세,2016,2643,1275,1368,93.2,2616,1260,1356,92.9
22040, 남구,060005, 59세,2016,2769,1319,1450,91,2756,1312,1444,90.9
22040, 남구,065,60~64세,2016,12407,5723,6684,85.6,12334,5684,6650,85.5
22040, 남구,065001, 60세,2016,2629,1234,1395,88.5,2611,1226,1385,88.5
22040, 남구,065002, 61세,2016,2826,1308,1518,86.2,2812,1301,1511,86.1
22040, 남구,065003, 62세,2016,2317,1088,1229,88.5,2303,1077,1226,87.8
22040, 남구,065004, 63세,2016,2233,976,1257,77.6,2218,972,1246,78
22040, 남구,065005, 64세,2016,2402,1117,1285,86.9,2390,1108,1282,86.4
22040, 남구,070,65~69세,2016,9700,4400,5300,83,9665,4378,5287,82.8
22040, 남구,070001, 65세,2016,1901,838,1063,78.8,1889,830,1059,78.4
22040, 남구,070002, 66세,2016,1854,887,967,91.7,1848,883,965,91.5
22040, 남구,070003, 67세,2016,2072,933,1139,81.9,2062,926,1136,81.5
22040, 남구,070004, 68세,2016,1980,896,1084,82.7,1977,896,1081,82.9
22040, 남구,070005, 69세,2016,1893,846,1047,80.8,1889,843,1046,80.6
22040, 남구,075,70~74세,2016,7552,3282,4270,76.9,7529,3275,4254,77
22040, 남구,075001, 70세,2016,1339,595,744,80,1330,592,738,80.2
22040, 남구,075002, 71세,2016,1312,550,762,72.2,1307,547,760,72
22040, 남구,075003, 72세,2016,1512,660,852,77.5,1508,660,848,77.8
22040, 남구,075004, 73세,2016,1662,701,961,72.9,1662,701,961,72.9
22040, 남구,075005, 74세,2016,1727,776,951,81.6,1722,775,947,81.8
22040, 남구,080,75~79세,2016,6385,2570,3815,67.4,6369,2563,3806,67.3
22040, 남구,080001, 75세,2016,1504,613,891,68.8,1501,612,889,68.8
22040, 남구,080002, 76세,2016,1329,526,803,65.5,1324,525,799,65.7
22040, 남구,080003, 77세,2016,1320,559,761,73.5,1314,555,759,73.1
22040, 남구,080004, 78세,2016,1146,446,700,63.7,1145,446,699,63.8
22040, 남구,080005, 79세,2016,1086,426,660,64.5,1085,425,660,64.4
22040, 남구,085,80~84세,2016,3964,1467,2497,58.8,3952,1462,2490,58.7
22040, 남구,085001, 80세,2016,969,360,609,59.1,965,358,607,59
22040, 남구,085002, 81세,2016,930,347,583,59.5,926,345,581,59.4
22040, 남구,085003, 82세,2016,812,306,506,60.5,810,305,505,60.4
22040, 남구,085004, 83세,2016,656,236,420,56.2,656,236,420,56.2
22040, 남구,085005, 84세,2016,597,218,379,57.5,595,218,377,57.8
22040, 남구,090,85~89세,2016,1759,483,1276,37.9,1755,480,1275,37.6
22040, 남구,090001, 85세,2016,482,133,349,38.1,479,130,349,37.2
22040, 남구,090002, 86세,2016,406,118,288,41,406,118,288,41
22040, 남구,090003, 87세,2016,348,83,265,31.3,347,83,264,31.4
22040, 남구,090004, 88세,2016,295,95,200,47.5,295,95,200,47.5
22040, 남구,090005, 89세,2016,228,54,174,31,228,54,174,31
22040, 남구,095,90~94세,2016,485,99,386,25.6,483,99,384,25.8
22040, 남구,095001, 90세,2016,140,31,109,28.4,139,31,108,28.7
22040, 남구,095002, 91세,2016,125,29,96,30.2,124,29,95,30.5
22040, 남구,095003, 92세,2016,90,14,76,18.4,90,14,76,18.4
22040, 남구,095004, 93세,2016,75,14,61,23,75,14,61,23
22040, 남구,095005, 94세,2016,55,11,44,25,55,11,44,25
22040, 남구,100,95~99세,2016,97,20,77,26,96,20,76,26.3
22040, 남구,100001, 95세,2016,32,7,25,28,32,7,25,28
22040, 남구,100002, 96세,2016,27,5,22,22.7,27,5,22,22.7
22040, 남구,100003, 97세,2016,15,X,12,25,15,X,12,25
22040, 남구,100004, 98세,2016,13,X,12,8.3,12,X,11,9.1
22040, 남구,100005, 99세,2016,10,X,6,66.7,10,X,6,66.7
22040, 남구,101,100세이상,2016,9,X,8,12.5,9,X,8,12.5
22040, 남구,102,15세미만,2016,13535,7071,6464,109.4,13483,7048,6435,109.5
22040, 남구,103,15~64세,2016,112347,55806,56541,98.7,111243,55396,55847,99.2
22040, 남구,104,65세이상,2016,29951,12322,17629,69.9,29858,12278,17580,69.8
22040, 남구,086,85세이상,2016,2350,603,1747,34.5,2343,600,1743,34.4
22040, 남구,126,평균연령,2016,45.1,43.5,46.7,,45.2,43.5,46.8,
22040, 남구,127,중위연령,2016,46.5,44.4,48.5,,46.6,44.5,48.6,
22050, 북구,000,합계,2016,446632,223896,222736,100.5,441236,221011,220225,100.4
22050, 북구,005,0~4세,2016,19422,9987,9435,105.9,19329,9935,9394,105.8
22050, 북구,005001, 0세,2016,3666,1863,1803,103.3,3647,1850,1797,102.9
22050, 북구,005002, 1세,2016,3869,2005,1864,107.6,3849,1993,1856,107.4
22050, 북구,005003, 2세,2016,3762,1914,1848,103.6,3743,1904,1839,103.5
22050, 북구,005004, 3세,2016,3899,2019,1880,107.4,3877,2009,1868,107.5
22050, 북구,005005, 4세,2016,4226,2186,2040,107.2,4213,2179,2034,107.1
22050, 북구,010,5~9세,2016,20493,10611,9882,107.4,20438,10586,9852,107.5
22050, 북구,010001, 5세,2016,4115,2126,1989,106.9,4099,2119,1980,107
22050, 북구,010002, 6세,2016,4001,2089,1912,109.3,3987,2083,1904,109.4
22050, 북구,010003, 7세,2016,3842,1968,1874,105,3833,1964,1869,105.1
22050, 북구,010004, 8세,2016,4156,2172,1984,109.5,4148,2170,1978,109.7
22050, 북구,010005, 9세,2016,4379,2256,2123,106.3,4371,2250,2121,106.1
22050, 북구,015,10~14세,2016,22067,11609,10458,111,22031,11594,10437,111.1
22050, 북구,015001, 10세,2016,3993,2075,1918,108.2,3987,2073,1914,108.3
22050, 북구,015002, 11세,2016,4040,2084,1956,106.5,4031,2081,1950,106.7
22050, 북구,015003, 12세,2016,4481,2383,2098,113.6,4471,2377,2094,113.5
22050, 북구,015004, 13세,2016,4724,2493,2231,111.7,4719,2491,2228,111.8
22050, 북구,015005, 14세,2016,4829,2574,2255,114.1,4823,2572,2251,114.3
22050, 북구,020,15~19세,2016,31406,16398,15008,109.3,31204,16302,14902,109.4
22050, 북구,020001, 15세,2016,5516,2898,2618,110.7,5513,2896,2617,110.7
22050, 북구,020002, 16세,2016,6031,3217,2814,114.3,6023,3212,2811,114.3
22050, 북구,020003, 17세,2016,5642,2999,2643,113.5,5623,2989,2634,113.5
22050, 북구,020004, 18세,2016,6348,3367,2981,112.9,6299,3343,2956,113.1
22050, 북구,020005, 19세,2016,7869,3917,3952,99.1,7746,3862,3884,99.4
22050, 북구,025,20~24세,2016,37356,20347,17009,119.6,36172,19777,16395,120.6
22050, 북구,025001, 20세,2016,7612,3804,3808,99.9,7391,3696,3695,100
22050, 북구,025002, 21세,2016,7595,3834,3761,101.9,7348,3725,3623,102.8
22050, 북구,025003, 22세,2016,7674,4281,3393,126.2,7443,4166,3277,127.1
22050, 북구,025004, 23세,2016,7504,4356,3148,138.4,7266,4237,3029,139.9
22050, 북구,025005, 24세,2016,6971,4072,2899,140.5,6724,3953,2771,142.7
22050, 북구,030,25~29세,2016,27551,15311,12240,125.1,26481,14749,11732,125.7
22050, 북구,030001, 25세,2016,6275,3541,2734,129.5,6063,3443,2620,131.4
22050, 북구,030002, 26세,2016,5780,3300,2480,133.1,5534,3163,2371,133.4
22050, 북구,030003, 27세,2016,5437,2997,2440,122.8,5246,2897,2349,123.3
22050, 북구,030004, 28세,2016,5025,2784,2241,124.2,4810,2679,2131,125.7
22050, 북구,030005, 29세,2016,5034,2689,2345,114.7,4828,2567,2261,113.5
22050, 북구,035,30~34세,2016,27806,14357,13449,106.8,26988,13869,13119,105.7
22050, 북구,035001, 30세,2016,4989,2674,2315,115.5,4808,2582,2226,116
22050, 북구,035002, 31세,2016,4960,2665,2295,116.1,4786,2556,2230,114.6
22050, 북구,035003, 32세,2016,5304,2756,2548,108.2,5141,2645,2496,106
22050, 북구,035004, 33세,2016,6025,3004,3021,99.4,5861,2911,2950,98.7
22050, 북구,035005, 34세,2016,6528,3258,3270,99.6,6392,3175,3217,98.7
22050, 북구,040,35~39세,2016,32997,16365,16632,98.4,32506,16068,16438,97.7
22050, 북구,040001, 35세,2016,6706,3310,3396,97.5,6595,3244,3351,96.8
22050, 북구,040002, 36세,2016,6942,3465,3477,99.7,6828,3396,3432,99
22050, 북구,040003, 37세,2016,6560,3283,3277,100.2,6457,3229,3228,100
22050, 북구,040004, 38세,2016,6176,3068,3108,98.7,6091,3008,3083,97.6
22050, 북구,040005, 39세,2016,6613,3239,3374,96,6535,3191,3344,95.4
22050, 북구,045,40~44세,2016,38499,18935,19564,96.8,38108,18698,19410,96.3
22050, 북구,045001, 40세,2016,6733,3352,3381,99.1,6638,3292,3346,98.4
22050, 북구,045002, 41세,2016,7310,3568,3742,95.4,7240,3529,3711,95.1
22050, 북구,045003, 42세,2016,8064,3954,4110,96.2,7978,3906,4072,95.9
22050, 북구,045004, 43세,2016,8072,3949,4123,95.8,8005,3905,4100,95.2
22050, 북구,045005, 44세,2016,8320,4112,4208,97.7,8247,4066,4181,97.2
22050, 북구,050,45~49세,2016,42086,20947,21139,99.1,41733,20764,20969,99
22050, 북구,050001, 45세,2016,8596,4265,4331,98.5,8508,4220,4288,98.4
22050, 북구,050002, 46세,2016,8512,4183,4329,96.6,8436,4146,4290,96.6
22050, 북구,050003, 47세,2016,8446,4182,4264,98.1,8383,4148,4235,97.9
22050, 북구,050004, 48세,2016,8626,4395,4231,103.9,8559,4361,4198,103.9
22050, 북구,050005, 49세,2016,7906,3922,3984,98.4,7847,3889,3958,98.3
22050, 북구,055,50~54세,2016,37139,18671,18468,101.1,36834,18511,18323,101
22050, 북구,055001, 50세,2016,7625,3910,3715,105.2,7566,3880,3686,105.3
22050, 북구,055002, 51세,2016,7562,3725,3837,97.1,7495,3686,3809,96.8
22050, 북구,055003, 52세,2016,6955,3469,3486,99.5,6896,3437,3459,99.4
22050, 북구,055004, 53세,2016,7364,3687,3677,100.3,7297,3657,3640,100.5
22050, 북구,055005, 54세,2016,7633,3880,3753,103.4,7580,3851,3729,103.3
22050, 북구,060,55~59세,2016,34783,17517,17266,101.5,34612,17431,17181,101.5
22050, 북구,060001, 55세,2016,8168,4045,4123,98.1,8139,4035,4104,98.3
22050, 북구,060002, 56세,2016,7751,3843,3908,98.3,7708,3821,3887,98.3
22050, 북구,060003, 57세,2016,6836,3470,3366,103.1,6794,3445,3349,102.9
22050, 북구,060004, 58세,2016,6055,3092,2963,104.4,6026,3078,2948,104.4
22050, 북구,060005, 59세,2016,5973,3067,2906,105.5,5945,3052,2893,105.5
22050, 북구,065,60~64세,2016,24289,11881,12408,95.8,24176,11823,12353,95.7
22050, 북구,065001, 60세,2016,5529,2747,2782,98.7,5506,2738,2768,98.9
22050, 북구,065002, 61세,2016,5388,2624,2764,94.9,5364,2612,2752,94.9
22050, 북구,065003, 62세,2016,4604,2290,2314,99,4578,2277,2301,99
22050, 북구,065004, 63세,2016,4280,2027,2253,90,4257,2012,2245,89.6
22050, 북구,065005, 64세,2016,4488,2193,2295,95.6,4471,2184,2287,95.5
22050, 북구,070,65~69세,2016,17590,8129,9461,85.9,17535,8099,9436,85.8
22050, 북구,070001, 65세,2016,3484,1645,1839,89.5,3471,1638,1833,89.4
22050, 북구,070002, 66세,2016,3487,1649,1838,89.7,3471,1641,1830,89.7
22050, 북구,070003, 67세,2016,3809,1741,2068,84.2,3796,1733,2063,84
22050, 북구,070004, 68세,2016,3597,1640,1957,83.8,3589,1635,1954,83.7
22050, 북구,070005, 69세,2016,3213,1454,1759,82.7,3208,1452,1756,82.7
22050, 북구,075,70~74세,2016,13099,5732,7367,77.8,13072,5719,7353,77.8
22050, 북구,075001, 70세,2016,2231,1034,1197,86.4,2221,1031,1190,86.6
22050, 북구,075002, 71세,2016,2318,1016,1302,78,2316,1014,1302,77.9
22050, 북구,075003, 72세,2016,2660,1070,1590,67.3,2656,1068,1588,67.3
22050, 북구,075004, 73세,2016,2762,1210,1552,78,2755,1206,1549,77.9
22050, 북구,075005, 74세,2016,3128,1402,1726,81.2,3124,1400,1724,81.2
22050, 북구,080,75~79세,2016,10651,4252,6399,66.4,10633,4244,6389,66.4
22050, 북구,080001, 75세,2016,2509,1026,1483,69.2,2503,1023,1480,69.1
22050, 북구,080002, 76세,2016,2316,917,1399,65.5,2311,916,1395,65.7
22050, 북구,080003, 77세,2016,2259,924,1335,69.2,2257,923,1334,69.2
22050, 북구,080004, 78세,2016,1886,756,1130,66.9,1885,756,1129,67
22050, 북구,080005, 79세,2016,1681,629,1052,59.8,1677,626,1051,59.6
22050, 북구,085,80~84세,2016,6147,2109,4038,52.2,6138,2104,4034,52.2
22050, 북구,085001, 80세,2016,1523,563,960,58.6,1518,559,959,58.3
22050, 북구,085002, 81세,2016,1485,510,975,52.3,1484,509,975,52.2
22050, 북구,085003, 82세,2016,1238,406,832,48.8,1238,406,832,48.8
22050, 북구,085004, 83세,2016,1014,342,672,50.9,1012,342,670,51
22050, 북구,085005, 84세,2016,887,288,599,48.1,886,288,598,48.2
22050, 북구,090,85~89세,2016,2391,584,1807,32.3,2389,584,1805,32.4
22050, 북구,090001, 85세,2016,640,164,476,34.5,639,164,475,34.5
22050, 북구,090002, 86세,2016,581,127,454,28,581,127,454,28
22050, 북구,090003, 87세,2016,466,120,346,34.7,466,120,346,34.7
22050, 북구,090004, 88세,2016,379,92,287,32.1,379,92,287,32.1
22050, 북구,090005, 89세,2016,325,81,244,33.2,324,81,243,33.3
22050, 북구,095,90~94세,2016,697,132,565,23.4,696,132,564,23.4
22050, 북구,095001, 90세,2016,190,37,153,24.2,190,37,153,24.2
22050, 북구,095002, 91세,2016,187,38,149,25.5,187,38,149,25.5
22050, 북구,095003, 92세,2016,116,23,93,24.7,116,23,93,24.7
22050, 북구,095004, 93세,2016,114,13,101,12.9,113,13,100,13
22050, 북구,095005, 94세,2016,90,21,69,30.4,90,21,69,30.4
22050, 북구,100,95~99세,2016,142,20,122,16.4,142,20,122,16.4
22050, 북구,100001, 95세,2016,45,8,37,21.6,45,8,37,21.6
22050, 북구,100002, 96세,2016,44,5,39,12.8,44,5,39,12.8
22050, 북구,100003, 97세,2016,28,X,24,16.7,28,X,24,16.7
22050, 북구,100004, 98세,2016,14,X,12,16.7,14,X,12,16.7
22050, 북구,100005, 99세,2016,11,X,10,10,11,X,10,10
22050, 북구,101,100세이상,2016,21,X,19,10.5,19,X,17,11.8
22050, 북구,102,15세미만,2016,61982,32207,29775,108.2,61798,32115,29683,108.2
22050, 북구,103,15~64세,2016,333912,170729,163183,104.6,328814,167992,160822,104.5
22050, 북구,104,65세이상,2016,50738,20960,29778,70.4,50624,20904,29720,70.3
22050, 북구,086,85세이상,2016,3251,738,2513,29.4,3246,738,2508,29.4
22050, 북구,126,평균연령,2016,39.5,38.2,40.7,,39.5,38.3,40.8,
22050, 북구,127,중위연령,2016,40.6,39.1,42,,40.8,39.3,42.2,
22060, 수성구,000,합계,2016,432714,211632,221082,95.7,430791,210775,220016,95.8
22060, 수성구,005,0~4세,2016,14245,7337,6908,106.2,14211,7323,6888,106.3
22060, 수성구,005001, 0세,2016,2458,1301,1157,112.4,2452,1300,1152,112.8
22060, 수성구,005002, 1세,2016,2605,1351,1254,107.7,2600,1348,1252,107.7
22060, 수성구,005003, 2세,2016,2821,1447,1374,105.3,2810,1441,1369,105.3
22060, 수성구,005004, 3세,2016,2937,1501,1436,104.5,2934,1500,1434,104.6
22060, 수성구,005005, 4세,2016,3424,1737,1687,103,3415,1734,1681,103.2
22060, 수성구,010,5~9세,2016,20173,10431,9742,107.1,20117,10405,9712,107.1
22060, 수성구,010001, 5세,2016,3592,1837,1755,104.7,3575,1829,1746,104.8
22060, 수성구,010002, 6세,2016,3684,1876,1808,103.8,3670,1870,1800,103.9
22060, 수성구,010003, 7세,2016,3890,2045,1845,110.8,3880,2041,1839,111
22060, 수성구,010004, 8세,2016,4366,2266,2100,107.9,4355,2260,2095,107.9
22060, 수성구,010005, 9세,2016,4641,2407,2234,107.7,4637,2405,2232,107.8
22060, 수성구,015,10~14세,2016,26159,13932,12227,113.9,26109,13907,12202,114
22060, 수성구,015001, 10세,2016,4500,2386,2114,112.9,4490,2379,2111,112.7
22060, 수성구,015002, 11세,2016,4676,2458,2218,110.8,4667,2453,2214,110.8
22060, 수성구,015003, 12세,2016,5403,2858,2545,112.3,5392,2852,2540,112.3
22060, 수성구,015004, 13세,2016,5774,3140,2634,119.2,5768,3138,2630,119.3
22060, 수성구,015005, 14세,2016,5806,3090,2716,113.8,5792,3085,2707,114
22060, 수성구,020,15~19세,2016,34205,18479,15726,117.5,34156,18459,15697,117.6
22060, 수성구,020001, 15세,2016,6808,3674,3134,117.2,6794,3667,3127,117.3
22060, 수성구,020002, 16세,2016,7299,3964,3335,118.9,7293,3961,3332,118.9
22060, 수성구,020003, 17세,2016,7019,3791,3228,117.4,7013,3789,3224,117.5
22060, 수성구,020004, 18세,2016,6897,3719,3178,117,6891,3717,3174,117.1
22060, 수성구,020005, 19세,2016,6182,3331,2851,116.8,6165,3325,2840,117.1
22060, 수성구,025,20~24세,2016,29920,16599,13321,124.6,29721,16530,13191,125.3
22060, 수성구,025001, 20세,2016,6280,3508,2772,126.6,6259,3501,2758,126.9
22060, 수성구,025002, 21세,2016,6395,3595,2800,128.4,6368,3580,2788,128.4
22060, 수성구,025003, 22세,2016,6119,3424,2695,127.1,6087,3411,2676,127.5
22060, 수성구,025004, 23세,2016,5581,3072,2509,122.4,5526,3058,2468,123.9
22060, 수성구,025005, 24세,2016,5545,3000,2545,117.9,5481,2980,2501,119.2
22060, 수성구,030,25~29세,2016,22104,11882,10222,116.2,21763,11754,10009,117.4
22060, 수성구,030001, 25세,2016,5123,2802,2321,120.7,5064,2783,2281,122
22060, 수성구,030002, 26세,2016,4730,2489,2241,111.1,4660,2462,2198,112
22060, 수성구,030003, 27세,2016,4439,2411,2028,118.9,4365,2385,1980,120.5
22060, 수성구,030004, 28세,2016,3913,2123,1790,118.6,3845,2095,1750,119.7
22060, 수성구,030005, 29세,2016,3899,2057,1842,111.7,3829,2029,1800,112.7
22060, 수성구,035,30~34세,2016,21009,10452,10557,99,20728,10315,10413,99.1
22060, 수성구,035001, 30세,2016,3829,2009,1820,110.4,3771,1981,1790,110.7
22060, 수성구,035002, 31세,2016,3723,1913,1810,105.7,3668,1881,1787,105.3
22060, 수성구,035003, 32세,2016,4028,2026,2002,101.2,3976,2004,1972,101.6
22060, 수성구,035004, 33세,2016,4432,2146,2286,93.9,4373,2116,2257,93.8
22060, 수성구,035005, 34세,2016,4997,2358,2639,89.4,4940,2333,2607,89.5
22060, 수성구,040,35~39세,2016,27318,12444,14874,83.7,27130,12357,14773,83.6
22060, 수성구,040001, 35세,2016,5168,2376,2792,85.1,5123,2356,2767,85.1
22060, 수성구,040002, 36세,2016,5511,2572,2939,87.5,5475,2554,2921,87.4
22060, 수성구,040003, 37세,2016,5546,2526,3020,83.6,5506,2507,2999,83.6
22060, 수성구,040004, 38세,2016,5253,2347,2906,80.8,5223,2333,2890,80.7
22060, 수성구,040005, 39세,2016,5840,2623,3217,81.5,5803,2607,3196,81.6
22060, 수성구,045,40~44세,2016,37834,16741,21093,79.4,37701,16660,21041,79.2
22060, 수성구,045001, 40세,2016,6251,2814,3437,81.9,6226,2798,3428,81.6
22060, 수성구,045002, 41세,2016,6924,3019,3905,77.3,6893,3000,3893,77.1
22060, 수성구,045003, 42세,2016,7795,3405,4390,77.6,7777,3391,4386,77.3
22060, 수성구,045004, 43세,2016,8177,3565,4612,77.3,8150,3547,4603,77.1
22060, 수성구,045005, 44세,2016,8687,3938,4749,82.9,8655,3924,4731,82.9
22060, 수성구,050,45~49세,2016,45752,21667,24085,90,45586,21593,23993,90
22060, 수성구,050001, 45세,2016,9373,4353,5020,86.7,9343,4340,5003,86.7
22060, 수성구,050002, 46세,2016,9241,4240,5001,84.8,9207,4224,4983,84.8
22060, 수성구,050003, 47세,2016,9227,4406,4821,91.4,9190,4390,4800,91.5
22060, 수성구,050004, 48세,2016,9304,4483,4821,93,9278,4472,4806,93.1
22060, 수성구,050005, 49세,2016,8607,4185,4422,94.6,8568,4167,4401,94.7
22060, 수성구,055,50~54세,2016,38422,19076,19346,98.6,38265,19005,19260,98.7
22060, 수성구,055001, 50세,2016,7809,3949,3860,102.3,7782,3940,3842,102.6
22060, 수성구,055002, 51세,2016,7915,3868,4047,95.6,7879,3853,4026,95.7
22060, 수성구,055003, 52세,2016,7544,3758,3786,99.3,7509,3740,3769,99.2
22060, 수성구,055004, 53세,2016,7682,3800,3882,97.9,7653,3788,3865,98
22060, 수성구,055005, 54세,2016,7472,3701,3771,98.1,7442,3684,3758,98
22060, 수성구,060,55~59세,2016,34765,17108,17657,96.9,34648,17058,17590,97
22060, 수성구,060001, 55세,2016,7781,3821,3960,96.5,7761,3810,3951,96.4
22060, 수성구,060002, 56세,2016,7675,3772,3903,96.6,7651,3759,3892,96.6
22060, 수성구,060003, 57세,2016,6961,3433,3528,97.3,6929,3421,3508,97.5
22060, 수성구,060004, 58세,2016,6000,2956,3044,97.1,5985,2952,3033,97.3
22060, 수성구,060005, 59세,2016,6348,3126,3222,97,6322,3116,3206,97.2
22060, 수성구,065,60~64세,2016,25499,12245,13254,92.4,25423,12207,13216,92.4
22060, 수성구,065001, 60세,2016,5765,2781,2984,93.2,5747,2774,2973,93.3
22060, 수성구,065002, 61세,2016,5692,2749,2943,93.4,5679,2739,2940,93.2
22060, 수성구,065003, 62세,2016,4742,2337,2405,97.2,4721,2327,2394,97.2
22060, 수성구,065004, 63세,2016,4649,2169,2480,87.5,4633,2160,2473,87.3
22060, 수성구,065005, 64세,2016,4651,2209,2442,90.5,4643,2207,2436,90.6
22060, 수성구,070,65~69세,2016,18399,8471,9928,85.3,18362,8455,9907,85.3
22060, 수성구,070001, 65세,2016,3588,1687,1901,88.7,3581,1683,1898,88.7
22060, 수성구,070002, 66세,2016,3740,1756,1984,88.5,3727,1752,1975,88.7
22060, 수성구,070003, 67세,2016,3874,1773,2101,84.4,3869,1772,2097,84.5
22060, 수성구,070004, 68세,2016,3663,1673,1990,84.1,3659,1670,1989,84
22060, 수성구,070005, 69세,2016,3534,1582,1952,81,3526,1578,1948,81
22060, 수성구,075,70~74세,2016,13783,6165,7618,80.9,13766,6155,7611,80.9
22060, 수성구,075001, 70세,2016,2337,1100,1237,88.9,2335,1098,1237,88.8
22060, 수성구,075002, 71세,2016,2459,1080,1379,78.3,2456,1079,1377,78.4
22060, 수성구,075003, 72세,2016,2794,1256,1538,81.7,2788,1251,1537,81.4
22060, 수성구,075004, 73세,2016,3021,1315,1706,77.1,3018,1314,1704,77.1
22060, 수성구,075005, 74세,2016,3172,1414,1758,80.4,3169,1413,1756,80.5
22060, 수성구,080,75~79세,2016,11468,4731,6737,70.2,11460,4726,6734,70.2
22060, 수성구,080001, 75세,2016,2655,1140,1515,75.2,2651,1138,1513,75.2
22060, 수성구,080002, 76세,2016,2378,978,1400,69.9,2377,977,1400,69.8
22060, 수성구,080003, 77세,2016,2334,993,1341,74,2334,993,1341,74
22060, 수성구,080004, 78세,2016,2164,863,1301,66.3,2162,861,1301,66.2
22060, 수성구,080005, 79세,2016,1937,757,1180,64.2,1936,757,1179,64.2
22060, 수성구,085,80~84세,2016,7454,2709,4745,57.1,7446,2705,4741,57.1
22060, 수성구,085001, 80세,2016,1811,675,1136,59.4,1807,674,1133,59.5
22060, 수성구,085002, 81세,2016,1762,674,1088,61.9,1762,674,1088,61.9
22060, 수성구,085003, 82세,2016,1482,541,941,57.5,1481,540,941,57.4
22060, 수성구,085004, 83세,2016,1255,436,819,53.2,1252,434,818,53.1
22060, 수성구,085005, 84세,2016,1144,383,761,50.3,1144,383,761,50.3
22060, 수성구,090,85~89세,2016,3072,874,2198,39.8,3067,873,2194,39.8
22060, 수성구,090001, 85세,2016,880,264,616,42.9,880,264,616,42.9
22060, 수성구,090002, 86세,2016,662,182,480,37.9,661,182,479,38
22060, 수성구,090003, 87세,2016,615,176,439,40.1,614,176,438,40.2
22060, 수성구,090004, 88세,2016,506,135,371,36.4,506,135,371,36.4
22060, 수성구,090005, 89세,2016,409,117,292,40.1,406,116,290,40
22060, 수성구,095,90~94세,2016,935,254,681,37.3,935,254,681,37.3
22060, 수성구,095001, 90세,2016,294,89,205,43.4,294,89,205,43.4
22060, 수성구,095002, 91세,2016,263,76,187,40.6,263,76,187,40.6
22060, 수성구,095003, 92세,2016,140,30,110,27.3,140,30,110,27.3
22060, 수성구,095004, 93세,2016,136,38,98,38.8,136,38,98,38.8
22060, 수성구,095005, 94세,2016,102,21,81,25.9,102,21,81,25.9
22060, 수성구,100,95~99세,2016,176,32,144,22.2,175,31,144,21.5
22060, 수성구,100001, 95세,2016,64,11,53,20.8,64,11,53,20.8
22060, 수성구,100002, 96세,2016,52,11,41,26.8,52,11,41,26.8
22060, 수성구,100003, 97세,2016,28,6,22,27.3,28,6,22,27.3
22060, 수성구,100004, 98세,2016,16,X,14,14.3,15,X,14,7.1
22060, 수성구,100005, 99세,2016,16,X,14,14.3,16,X,14,14.3
22060, 수성구,101,100세이상,2016,22,X,19,15.8,22,X,19,15.8
22060, 수성구,102,15세미만,2016,60577,31700,28877,109.8,60437,31635,28802,109.8
22060, 수성구,103,15~64세,2016,316828,156693,160135,97.9,315121,155938,159183,98
22060, 수성구,104,65세이상,2016,55309,23239,32070,72.5,55233,23202,32031,72.4
22060, 수성구,086,85세이상,2016,4205,1163,3042,38.2,4199,1161,3038,38.2
22060, 수성구,126,평균연령,2016,40.7,39.2,42.1,,40.7,39.2,42.1,
22060, 수성구,127,중위연령,2016,43,41.5,44.1,,43.1,41.5,44.2,
22070, 달서구,000,합계,2016,596901,298250,298651,99.9,586900,291776,295124,98.9
22070, 달서구,005,0~4세,2016,24536,12510,12026,104,24421,12453,11968,104.1
22070, 달서구,005001, 0세,2016,4578,2347,2231,105.2,4552,2334,2218,105.2
22070, 달서구,005002, 1세,2016,4882,2490,2392,104.1,4860,2478,2382,104
22070, 달서구,005003, 2세,2016,4806,2444,2362,103.5,4790,2438,2352,103.7
22070, 달서구,005004, 3세,2016,4822,2438,2384,102.3,4801,2430,2371,102.5
22070, 달서구,005005, 4세,2016,5448,2791,2657,105,5418,2773,2645,104.8
22070, 달서구,010,5~9세,2016,26605,13711,12894,106.3,26502,13665,12837,106.5
22070, 달서구,010001, 5세,2016,5299,2721,2578,105.5,5278,2711,2567,105.6
22070, 달서구,010002, 6세,2016,5299,2700,2599,103.9,5272,2688,2584,104
22070, 달서구,010003, 7세,2016,5082,2668,2414,110.5,5062,2659,2403,110.7
22070, 달서구,010004, 8세,2016,5350,2805,2545,110.2,5329,2795,2534,110.3
22070, 달서구,010005, 9세,2016,5575,2817,2758,102.1,5561,2812,2749,102.3
22070, 달서구,015,10~14세,2016,28414,14851,13563,109.5,28366,14824,13542,109.5
22070, 달서구,015001, 10세,2016,5155,2672,2483,107.6,5148,2669,2479,107.7
22070, 달서구,015002, 11세,2016,5224,2704,2520,107.3,5214,2699,2515,107.3
22070, 달서구,015003, 12세,2016,5763,3020,2743,110.1,5753,3013,2740,110
22070, 달서구,015004, 13세,2016,6002,3153,2849,110.7,5995,3147,2848,110.5
22070, 달서구,015005, 14세,2016,6270,3302,2968,111.3,6256,3296,2960,111.4
22070, 달서구,020,15~19세,2016,42228,22148,20080,110.3,42009,22035,19974,110.3
22070, 달서구,020001, 15세,2016,7535,3907,3628,107.7,7529,3902,3627,107.6
22070, 달서구,020002, 16세,2016,8668,4607,4061,113.4,8652,4600,4052,113.5
22070, 달서구,020003, 17세,2016,8204,4353,3851,113,8190,4346,3844,113.1
22070, 달서구,020004, 18세,2016,8694,4645,4049,114.7,8635,4616,4019,114.9
22070, 달서구,020005, 19세,2016,9127,4636,4491,103.2,9003,4571,4432,103.1
22070, 달서구,025,20~24세,2016,46794,25333,21461,118,45304,24435,20869,117.1
22070, 달서구,025001, 20세,2016,9405,4984,4421,112.7,9179,4883,4296,113.7
22070, 달서구,025002, 21세,2016,9494,5169,4325,119.5,9194,5010,4184,119.7
22070, 달서구,025003, 22세,2016,9362,5123,4239,120.9,9099,4962,4137,119.9
22070, 달서구,025004, 23세,2016,9287,5021,4266,117.7,8976,4825,4151,116.2
22070, 달서구,025005, 24세,2016,9246,5036,4210,119.6,8856,4755,4101,115.9
22070, 달서구,030,25~29세,2016,38246,21338,16908,126.2,36032,19853,16179,122.7
22070, 달서구,030001, 25세,2016,8404,4797,3607,133,7976,4517,3459,130.6
22070, 달서구,030002, 26세,2016,8108,4586,3522,130.2,7655,4284,3371,127.1
22070, 달서구,030003, 27세,2016,7634,4225,3409,123.9,7212,3941,3271,120.5
22070, 달서구,030004, 28세,2016,7036,3886,3150,123.4,6582,3580,3002,119.3
22070, 달서구,030005, 29세,2016,7064,3844,3220,119.4,6607,3531,3076,114.8
22070, 달서구,035,30~34세,2016,38396,20061,18335,109.4,36519,18750,17769,105.5
22070, 달서구,035001, 30세,2016,7037,3833,3204,119.6,6611,3545,3066,115.6
22070, 달서구,035002, 31세,2016,6964,3731,3233,115.4,6568,3465,3103,111.7
22070, 달서구,035003, 32세,2016,7213,3740,3473,107.7,6861,3497,3364,104
22070, 달서구,035004, 33세,2016,8192,4235,3957,107,7821,3954,3867,102.2
22070, 달서구,035005, 34세,2016,8990,4522,4468,101.2,8658,4289,4369,98.2
22070, 달서구,040,35~39세,2016,44059,22092,21967,100.6,42814,21201,21613,98.1
22070, 달서구,040001, 35세,2016,8857,4486,4371,102.6,8582,4296,4286,100.2
22070, 달서구,040002, 36세,2016,9380,4701,4679,100.5,9116,4504,4612,97.7
22070, 달서구,040003, 37세,2016,8943,4468,4475,99.8,8680,4282,4398,97.4
22070, 달서구,040004, 38세,2016,8236,4145,4091,101.3,8016,3986,4030,98.9
22070, 달서구,040005, 39세,2016,8643,4292,4351,98.6,8420,4133,4287,96.4
22070, 달서구,045,40~44세,2016,48955,23747,25208,94.2,48073,23136,24937,92.8
22070, 달서구,045001, 40세,2016,8714,4402,4312,102.1,8513,4262,4251,100.3
22070, 달서구,045002, 41세,2016,8964,4300,4664,92.2,8805,4186,4619,90.6
22070, 달서구,045003, 42세,2016,10219,4985,5234,95.2,10048,4875,5173,94.2
22070, 달서구,045004, 43세,2016,10431,4992,5439,91.8,10246,4861,5385,90.3
22070, 달서구,045005, 44세,2016,10627,5068,5559,91.2,10461,4952,5509,89.9
22070, 달서구,050,45~49세,2016,57339,27587,29752,92.7,56611,27114,29497,91.9
22070, 달서구,050001, 45세,2016,11431,5488,5943,92.3,11259,5375,5884,91.3
22070, 달서구,050002, 46세,2016,11168,5437,5731,94.9,10993,5319,5674,93.7
22070, 달서구,050003, 47세,2016,11664,5624,6040,93.1,11535,5536,5999,92.3
22070, 달서구,050004, 48세,2016,11937,5713,6224,91.8,11786,5624,6162,91.3
22070, 달서구,050005, 49세,2016,11139,5325,5814,91.6,11038,5260,5778,91
22070, 달서구,055,50~54세,2016,53504,26294,27210,96.6,53021,26027,26994,96.4
22070, 달서구,055001, 50세,2016,10675,5244,5431,96.6,10584,5201,5383,96.6
22070, 달서구,055002, 51세,2016,10812,5133,5679,90.4,10713,5075,5638,90
22070, 달서구,055003, 52세,2016,10183,4956,5227,94.8,10074,4890,5184,94.3
22070, 달서구,055004, 53세,2016,10843,5492,5351,102.6,10750,5438,5312,102.4
22070, 달서구,055005, 54세,2016,10991,5469,5522,99,10900,5423,5477,99
22070, 달서구,060,55~59세,2016,50470,25006,25464,98.2,50226,24877,25349,98.1
22070, 달서구,060001, 55세,2016,11912,5843,6069,96.3,11874,5824,6050,96.3
22070, 달서구,060002, 56세,2016,11253,5477,5776,94.8,11178,5437,5741,94.7
22070, 달서구,060003, 57세,2016,10111,4983,5128,97.2,10063,4959,5104,97.2
22070, 달서구,060004, 58세,2016,8487,4309,4178,103.1,8440,4281,4159,102.9
22070, 달서구,060005, 59세,2016,8707,4394,4313,101.9,8671,4376,4295,101.9
22070, 달서구,065,60~64세,2016,34717,17036,17681,96.4,34531,16951,17580,96.4
22070, 달서구,065001, 60세,2016,7905,4058,3847,105.5,7869,4036,3833,105.3
22070, 달서구,065002, 61세,2016,7893,3824,4069,94,7845,3801,4044,94
22070, 달서구,065003, 62세,2016,6401,3204,3197,100.2,6357,3187,3170,100.5
22070, 달서구,065004, 63세,2016,6139,2950,3189,92.5,6112,2937,3175,92.5
22070, 달서구,065005, 64세,2016,6379,3000,3379,88.8,6348,2990,3358,89
22070, 달서구,070,65~69세,2016,22929,11114,11815,94.1,22850,11070,11780,94
22070, 달서구,070001, 65세,2016,4720,2340,2380,98.3,4692,2324,2368,98.1
22070, 달서구,070002, 66세,2016,4683,2287,2396,95.5,4669,2280,2389,95.4
22070, 달서구,070003, 67세,2016,4817,2340,2477,94.5,4797,2330,2467,94.4
22070, 달서구,070004, 68세,2016,4489,2203,2286,96.4,4478,2196,2282,96.2
22070, 달서구,070005, 69세,2016,4220,1944,2276,85.4,4214,1940,2274,85.3
22070, 달서구,075,70~74세,2016,15533,6961,8572,81.2,15497,6945,8552,81.2
22070, 달서구,075001, 70세,2016,2751,1366,1385,98.6,2744,1361,1383,98.4
22070, 달서구,075002, 71세,2016,2828,1267,1561,81.2,2819,1264,1555,81.3
22070, 달서구,075003, 72세,2016,3142,1387,1755,79,3133,1384,1749,79.1
22070, 달서구,075004, 73세,2016,3194,1411,1783,79.1,3191,1410,1781,79.2
22070, 달서구,075005, 74세,2016,3618,1530,2088,73.3,3610,1526,2084,73.2
22070, 달서구,080,75~79세,2016,12432,4896,7536,65,12404,4883,7521,64.9
22070, 달서구,080001, 75세,2016,2814,1170,1644,71.2,2807,1166,1641,71.1
22070, 달서구,080002, 76세,2016,2634,1054,1580,66.7,2629,1051,1578,66.6
22070, 달서구,080003, 77세,2016,2581,1005,1576,63.8,2573,1001,1572,63.7
22070, 달서구,080004, 78세,2016,2284,880,1404,62.7,2282,880,1402,62.8
22070, 달서구,080005, 79세,2016,2119,787,1332,59.1,2113,785,1328,59.1
22070, 달서구,085,80~84세,2016,7604,2536,5068,50,7591,2530,5061,50
22070, 달서구,085001, 80세,2016,1956,680,1276,53.3,1955,680,1275,53.3
22070, 달서구,085002, 81세,2016,1773,630,1143,55.1,1768,629,1139,55.2
22070, 달서구,085003, 82세,2016,1526,521,1005,51.8,1524,520,1004,51.8
22070, 달서구,085004, 83세,2016,1215,363,852,42.6,1213,362,851,42.5
22070, 달서구,085005, 84세,2016,1134,342,792,43.2,1131,339,792,42.8
22070, 달서구,090,85~89세,2016,3066,784,2282,34.4,3064,783,2281,34.3
22070, 달서구,090001, 85세,2016,835,235,600,39.2,834,234,600,39
22070, 달서구,090002, 86세,2016,750,183,567,32.3,749,183,566,32.3
22070, 달서구,090003, 87세,2016,617,160,457,35,617,160,457,35
22070, 달서구,090004, 88세,2016,486,111,375,29.6,486,111,375,29.6
22070, 달서구,090005, 89세,2016,378,95,283,33.6,378,95,283,33.6
22070, 달서구,095,90~94세,2016,901,220,681,32.3,892,219,673,32.5
22070, 달서구,095001, 90세,2016,251,61,190,32.1,248,61,187,32.6
22070, 달서구,095002, 91세,2016,249,57,192,29.7,247,57,190,30
22070, 달서구,095003, 92세,2016,167,45,122,36.9,164,44,120,36.7
22070, 달서구,095004, 93세,2016,121,33,88,37.5,120,33,87,37.9
22070, 달서구,095005, 94세,2016,113,24,89,27,113,24,89,27
22070, 달서구,100,95~99세,2016,158,23,135,17,158,23,135,17
22070, 달서구,100001, 95세,2016,64,10,54,18.5,64,10,54,18.5
22070, 달서구,100002, 96세,2016,40,6,34,17.6,40,6,34,17.6
22070, 달서구,100003, 97세,2016,30,X,28,7.1,30,X,28,7.1
22070, 달서구,100004, 98세,2016,11,X,7,57.1,11,X,7,57.1
22070, 달서구,100005, 99세,2016,13,X,12,8.3,13,X,12,8.3
22070, 달서구,101,100세이상,2016,15,X,13,15.4,15,X,13,15.4
22070, 달서구,102,15세미만,2016,79555,41072,38483,106.7,79289,40942,38347,106.8
22070, 달서구,103,15~64세,2016,454708,230642,224066,102.9,445140,224379,220761,101.6
22070, 달서구,104,65세이상,2016,62638,26536,36102,73.5,62471,26455,36016,73.5
22070, 달서구,086,85세이상,2016,4140,1029,3111,33.1,4129,1027,3102,33.1
22070, 달서구,126,평균연령,2016,39.7,38.5,40.8,,39.8,38.6,40.9,
22070, 달서구,127,중위연령,2016,41.1,39.3,42.6,,41.3,39.7,42.8,
22310, 달성군,000,합계,2016,212895,109296,103599,105.5,206552,104817,101735,103
22310, 달성군,005,0~4세,2016,12862,6513,6349,102.6,12798,6491,6307,102.9
22310, 달성군,005001, 0세,2016,2550,1307,1243,105.1,2531,1300,1231,105.6
22310, 달성군,005002, 1세,2016,2568,1307,1261,103.6,2554,1301,1253,103.8
22310, 달성군,005003, 2세,2016,2534,1262,1272,99.2,2520,1260,1260,100
22310, 달성군,005004, 3세,2016,2506,1292,1214,106.4,2495,1287,1208,106.5
22310, 달성군,005005, 4세,2016,2704,1345,1359,99,2698,1343,1355,99.1
22310, 달성군,010,5~9세,2016,11598,5954,5644,105.5,11551,5933,5618,105.6
22310, 달성군,010001, 5세,2016,2604,1341,1263,106.2,2592,1334,1258,106
22310, 달성군,010002, 6세,2016,2411,1243,1168,106.4,2402,1238,1164,106.4
22310, 달성군,010003, 7세,2016,2162,1114,1048,106.3,2152,1109,1043,106.3
22310, 달성군,010004, 8세,2016,2251,1168,1083,107.8,2243,1164,1079,107.9
22310, 달성군,010005, 9세,2016,2170,1088,1082,100.6,2162,1088,1074,101.3
22310, 달성군,015,10~14세,2016,9837,5236,4601,113.8,9816,5221,4595,113.6
22310, 달성군,015001, 10세,2016,1936,1032,904,114.2,1930,1028,902,114
22310, 달성군,015002, 11세,2016,1994,1046,948,110.3,1989,1044,945,110.5
22310, 달성군,015003, 12세,2016,1971,1004,967,103.8,1966,1000,966,103.5
22310, 달성군,015004, 13세,2016,2014,1092,922,118.4,2012,1090,922,118.2
22310, 달성군,015005, 14세,2016,1922,1062,860,123.5,1919,1059,860,123.1
22310, 달성군,020,15~19세,2016,11681,6156,5525,111.4,11636,6135,5501,111.5
22310, 달성군,020001, 15세,2016,2310,1213,1097,110.6,2307,1211,1096,110.5
22310, 달성군,020002, 16세,2016,2402,1223,1179,103.7,2396,1220,1176,103.7
22310, 달성군,020003, 17세,2016,2339,1218,1121,108.7,2330,1215,1115,109
22310, 달성군,020004, 18세,2016,2372,1267,1105,114.7,2364,1262,1102,114.5
22310, 달성군,020005, 19세,2016,2258,1235,1023,120.7,2239,1227,1012,121.2
22310, 달성군,025,20~24세,2016,12675,7417,5258,141.1,12094,6986,5108,136.8
22310, 달성군,025001, 20세,2016,2486,1518,968,156.8,2442,1487,955,155.7
22310, 달성군,025002, 21세,2016,2539,1545,994,155.4,2470,1491,979,152.3
22310, 달성군,025003, 22세,2016,2439,1386,1053,131.6,2325,1306,1019,128.2
22310, 달성군,025004, 23세,2016,2567,1480,1087,136.2,2402,1356,1046,129.6
22310, 달성군,025005, 24세,2016,2644,1488,1156,128.7,2455,1346,1109,121.4
22310, 달성군,030,25~29세,2016,13192,7578,5614,135,11704,6448,5256,122.7
22310, 달성군,030001, 25세,2016,2612,1525,1087,140.3,2329,1305,1024,127.4
22310, 달성군,030002, 26세,2016,2643,1545,1098,140.7,2356,1332,1024,130.1
22310, 달성군,030003, 27세,2016,2642,1542,1100,140.2,2339,1311,1028,127.5
22310, 달성군,030004, 28세,2016,2586,1489,1097,135.7,2277,1249,1028,121.5
22310, 달성군,030005, 29세,2016,2709,1477,1232,119.9,2403,1251,1152,108.6
22310, 달성군,035,30~34세,2016,17114,9070,8044,112.8,15729,8005,7724,103.6
22310, 달성군,035001, 30세,2016,2949,1616,1333,121.2,2637,1381,1256,110
22310, 달성군,035002, 31세,2016,3011,1642,1369,119.9,2725,1425,1300,109.6
22310, 달성군,035003, 32세,2016,3218,1741,1477,117.9,2956,1532,1424,107.6
22310, 달성군,035004, 33세,2016,3746,1908,1838,103.8,3481,1708,1773,96.3
22310, 달성군,035005, 34세,2016,4190,2163,2027,106.7,3930,1959,1971,99.4
22310, 달성군,040,35~39세,2016,19695,10348,9347,110.7,18815,9688,9127,106.1
22310, 달성군,040001, 35세,2016,4160,2187,1973,110.8,3951,2028,1923,105.5
22310, 달성군,040002, 36세,2016,4316,2226,2090,106.5,4141,2096,2045,102.5
22310, 달성군,040003, 37세,2016,3983,2075,1908,108.8,3797,1933,1864,103.7
22310, 달성군,040004, 38세,2016,3584,1895,1689,112.2,3400,1760,1640,107.3
22310, 달성군,040005, 39세,2016,3652,1965,1687,116.5,3526,1871,1655,113.1
22310, 달성군,045,40~44세,2016,17988,9578,8410,113.9,17396,9169,8227,111.5
22310, 달성군,045001, 40세,2016,3464,1842,1622,113.6,3333,1747,1586,110.2
22310, 달성군,045002, 41세,2016,3571,1885,1686,111.8,3447,1796,1651,108.8
22310, 달성군,045003, 42세,2016,3763,2026,1737,116.6,3653,1956,1697,115.3
22310, 달성군,045004, 43세,2016,3605,1927,1678,114.8,3485,1844,1641,112.4
22310, 달성군,045005, 44세,2016,3585,1898,1687,112.5,3478,1826,1652,110.5
22310, 달성군,050,45~49세,2016,18087,9127,8960,101.9,17583,8818,8765,100.6
22310, 달성군,050001, 45세,2016,3682,1910,1772,107.8,3572,1834,1738,105.5
22310, 달성군,050002, 46세,2016,3648,1898,1750,108.5,3542,1837,1705,107.7
22310, 달성군,050003, 47세,2016,3618,1784,1834,97.3,3519,1718,1801,95.4
22310, 달성군,050004, 48세,2016,3693,1853,1840,100.7,3590,1795,1795,100
22310, 달성군,050005, 49세,2016,3446,1682,1764,95.4,3360,1634,1726,94.7
22310, 달성군,055,50~54세,2016,17156,8710,8446,103.1,16812,8517,8295,102.7
22310, 달성군,055001, 50세,2016,3480,1769,1711,103.4,3408,1730,1678,103.1
22310, 달성군,055002, 51세,2016,3427,1711,1716,99.7,3351,1664,1687,98.6
22310, 달성군,055003, 52세,2016,3233,1670,1563,106.8,3165,1635,1530,106.9
22310, 달성군,055004, 53세,2016,3357,1674,1683,99.5,3284,1634,1650,99
22310, 달성군,055005, 54세,2016,3659,1886,1773,106.4,3604,1854,1750,105.9
22310, 달성군,060,55~59세,2016,16271,8282,7989,103.7,16054,8162,7892,103.4
22310, 달성군,060001, 55세,2016,3791,1951,1840,106,3751,1929,1822,105.9
22310, 달성군,060002, 56세,2016,3494,1756,1738,101,3451,1737,1714,101.3
22310, 달성군,060003, 57세,2016,3300,1667,1633,102.1,3257,1643,1614,101.8
22310, 달성군,060004, 58세,2016,2862,1452,1410,103,2816,1421,1395,101.9
22310, 달성군,060005, 59세,2016,2824,1456,1368,106.4,2779,1432,1347,106.3
22310, 달성군,065,60~64세,2016,11306,5636,5670,99.4,11217,5588,5629,99.3
22310, 달성군,065001, 60세,2016,2613,1345,1268,106.1,2591,1335,1256,106.3
22310, 달성군,065002, 61세,2016,2501,1204,1297,92.8,2485,1195,1290,92.6
22310, 달성군,065003, 62세,2016,2070,1051,1019,103.1,2046,1038,1008,103
22310, 달성군,065004, 63세,2016,1981,974,1007,96.7,1970,968,1002,96.6
22310, 달성군,065005, 64세,2016,2141,1062,1079,98.4,2125,1052,1073,98
22310, 달성군,070,65~69세,2016,7935,3885,4050,95.9,7883,3862,4021,96
22310, 달성군,070001, 65세,2016,1570,785,785,100,1552,776,776,100
22310, 달성군,070002, 66세,2016,1641,813,828,98.2,1628,809,819,98.8
22310, 달성군,070003, 67세,2016,1713,849,864,98.3,1701,843,858,98.3
22310, 달성군,070004, 68세,2016,1585,764,821,93.1,1579,760,819,92.8
22310, 달성군,070005, 69세,2016,1426,674,752,89.6,1423,674,749,90
22310, 달성군,075,70~74세,2016,5611,2510,3101,80.9,5596,2504,3092,81
22310, 달성군,075001, 70세,2016,979,470,509,92.3,975,468,507,92.3
22310, 달성군,075002, 71세,2016,1014,479,535,89.5,1009,477,532,89.7
22310, 달성군,075003, 72세,2016,1162,535,627,85.3,1159,533,626,85.1
22310, 달성군,075004, 73세,2016,1138,490,648,75.6,1136,490,646,75.9
22310, 달성군,075005, 74세,2016,1318,536,782,68.5,1317,536,781,68.6
22310, 달성군,080,75~79세,2016,4831,1794,3037,59.1,4824,1793,3031,59.2
22310, 달성군,080001, 75세,2016,1093,420,673,62.4,1091,420,671,62.6
22310, 달성군,080002, 76세,2016,1001,349,652,53.5,1001,349,652,53.5
22310, 달성군,080003, 77세,2016,996,365,631,57.8,995,365,630,57.9
22310, 달성군,080004, 78세,2016,913,357,556,64.2,909,356,553,64.4
22310, 달성군,080005, 79세,2016,828,303,525,57.7,828,303,525,57.7
22310, 달성군,085,80~84세,2016,3117,1039,2078,50,3108,1035,2073,49.9
22310, 달성군,085001, 80세,2016,715,259,456,56.8,712,257,455,56.5
22310, 달성군,085002, 81세,2016,722,239,483,49.5,721,239,482,49.6
22310, 달성군,085003, 82세,2016,660,204,456,44.7,658,203,455,44.6
22310, 달성군,085004, 83세,2016,525,180,345,52.2,522,179,343,52.2
22310, 달성군,085005, 84세,2016,495,157,338,46.4,495,157,338,46.4
22310, 달성군,090,85~89세,2016,1410,358,1052,34,1409,358,1051,34.1
22310, 달성군,090001, 85세,2016,373,104,269,38.7,373,104,269,38.7
22310, 달성군,090002, 86세,2016,332,93,239,38.9,332,93,239,38.9
22310, 달성군,090003, 87세,2016,260,55,205,26.8,259,55,204,27
22310, 달성군,090004, 88세,2016,240,64,176,36.4,240,64,176,36.4
22310, 달성군,090005, 89세,2016,205,42,163,25.8,205,42,163,25.8
22310, 달성군,095,90~94세,2016,434,85,349,24.4,432,84,348,24.1
22310, 달성군,095001, 90세,2016,135,23,112,20.5,135,23,112,20.5
22310, 달성군,095002, 91세,2016,110,24,86,27.9,109,24,85,28.2
22310, 달성군,095003, 92세,2016,71,12,59,20.3,71,12,59,20.3
22310, 달성군,095004, 93세,2016,63,13,50,26,63,13,50,26
22310, 달성군,095005, 94세,2016,55,13,42,31,54,12,42,28.6
22310, 달성군,100,95~99세,2016,83,18,65,27.7,83,18,65,27.7
22310, 달성군,100001, 95세,2016,30,7,23,30.4,30,7,23,30.4
22310, 달성군,100002, 96세,2016,21,6,15,40,21,6,15,40
22310, 달성군,100003, 97세,2016,13,X,11,18.2,13,X,11,18.2
22310, 달성군,100004, 98세,2016,12,X,11,9.1,12,X,11,9.1
22310, 달성군,100005, 99세,2016,7,X,5,40,7,X,5,40
22310, 달성군,101,100세이상,2016,12,X,10,20,12,X,10,20
22310, 달성군,102,15세미만,2016,34297,17703,16594,106.7,34165,17645,16520,106.8
22310, 달성군,103,15~64세,2016,155165,81902,73263,111.8,149040,77516,71524,108.4
22310, 달성군,104,65세이상,2016,23433,9691,13742,70.5,23347,9656,13691,70.5
22310, 달성군,086,85세이상,2016,1939,463,1476,31.4,1936,462,1474,31.3
22310, 달성군,126,평균연령,2016,39,37.7,40.3,,39.1,37.9,40.3,
22310, 달성군,127,중위연령,2016,39.4,38.1,40.9,,39.8,38.6,41,
23,인천광역시,000,합계,2016,2913024,1465699,1447325,101.3,2841151,1423740,1417411,100.4
23,인천광역시,005,0~4세,2016,131892,67568,64324,105,130189,66687,63502,105
23,인천광역시,005001, 0세,2016,24501,12491,12010,104,24088,12270,11818,103.8
23,인천광역시,005002, 1세,2016,26223,13487,12736,105.9,25885,13319,12566,106
23,인천광역시,005003, 2세,2016,26097,13435,12662,106.1,25732,13254,12478,106.2
23,인천광역시,005004, 3세,2016,26460,13479,12981,103.8,26148,13316,12832,103.8
23,인천광역시,005005, 4세,2016,28611,14676,13935,105.3,28336,14528,13808,105.2
23,인천광역시,010,5~9세,2016,136847,70326,66521,105.7,135745,69732,66013,105.6
23,인천광역시,010001, 5세,2016,28341,14658,13683,107.1,28071,14513,13558,107
23,인천광역시,010002, 6세,2016,27006,13859,13147,105.4,26773,13743,13030,105.5
23,인천광역시,010003, 7세,2016,26181,13436,12745,105.4,25961,13315,12646,105.3
23,인천광역시,010004, 8세,2016,27254,13883,13371,103.8,27047,13764,13283,103.6
23,인천광역시,010005, 9세,2016,28065,14490,13575,106.7,27893,14397,13496,106.7
23,인천광역시,015,10~14세,2016,132026,68048,63978,106.4,131286,67663,63623,106.3
23,인천광역시,015001, 10세,2016,25201,13041,12160,107.2,25051,12964,12087,107.3
23,인천광역시,015002, 11세,2016,24584,12601,11983,105.2,24439,12520,11919,105
23,인천광역시,015003, 12세,2016,26673,13691,12982,105.5,26516,13611,12905,105.5
23,인천광역시,015004, 13세,2016,27502,14144,13358,105.9,27374,14077,13297,105.9
23,인천광역시,015005, 14세,2016,28066,14571,13495,108,27906,14491,13415,108
23,인천광역시,020,15~19세,2016,172119,88867,83252,106.7,170796,88238,82558,106.9
23,인천광역시,020001, 15세,2016,31870,16473,15397,107,31712,16396,15316,107.1
23,인천광역시,020002, 16세,2016,34848,17957,16891,106.3,34672,17858,16814,106.2
23,인천광역시,020003, 17세,2016,34233,17858,16375,109.1,34038,17748,16290,109
23,인천광역시,020004, 18세,2016,35362,18241,17121,106.5,35079,18107,16972,106.7
23,인천광역시,020005, 19세,2016,35806,18338,17468,105,35295,18129,17166,105.6
23,인천광역시,025,20~24세,2016,200319,106207,94112,112.9,194664,103050,91614,112.5
23,인천광역시,025001, 20세,2016,37575,20158,17417,115.7,36849,19857,16992,116.9
23,인천광역시,025002, 21세,2016,38992,21408,17584,121.7,38129,20975,17154,122.3
23,인천광역시,025003, 22세,2016,39594,21370,18224,117.3,38547,20774,17773,116.9
23,인천광역시,025004, 23세,2016,41289,21441,19848,108,39928,20628,19300,106.9
23,인천광역시,025005, 24세,2016,42869,21830,21039,103.8,41211,20816,20395,102.1
23,인천광역시,030,25~29세,2016,196261,102669,93592,109.7,184813,95397,89416,106.7
23,인천광역시,030001, 25세,2016,41625,21649,19976,108.4,39746,20492,19254,106.4
23,인천광역시,030002, 26세,2016,39926,20918,19008,110,37729,19542,18187,107.5
23,인천광역시,030003, 27세,2016,38891,20484,18407,111.3,36651,19045,17606,108.2
23,인천광역시,030004, 28세,2016,37735,19756,17979,109.9,35244,18149,17095,106.2
23,인천광역시,030005, 29세,2016,38084,19862,18222,109,35443,18169,17274,105.2
23,인천광역시,035,30~34세,2016,215786,112731,103055,109.4,203756,104770,98986,105.8
23,인천광역시,035001, 30세,2016,38743,20406,18337,111.3,36247,18787,17460,107.6
23,인천광역시,035002, 31세,2016,39512,20744,18768,110.5,37043,19129,17914,106.8
23,인천광역시,035003, 32세,2016,41489,21681,19808,109.5,39045,20065,18980,105.7
23,인천광역시,035004, 33세,2016,45930,23761,22169,107.2,43601,22200,21401,103.7
23,인천광역시,035005, 34세,2016,50112,26139,23973,109,47820,24589,23231,105.8
23,인천광역시,040,35~39세,2016,241311,125265,116046,107.9,232443,119436,113007,105.7
23,인천광역시,040001, 35세,2016,50864,26591,24273,109.5,48840,25257,23583,107.1
23,인천광역시,040002, 36세,2016,51391,26527,24864,106.7,49492,25258,24234,104.2
23,인천광역시,040003, 37세,2016,48971,25528,23443,108.9,47080,24291,22789,106.6
23,인천광역시,040004, 38세,2016,44719,23113,21606,107,43110,22070,21040,104.9
23,인천광역시,040005, 39세,2016,45366,23506,21860,107.5,43921,22560,21361,105.6
23,인천광역시,045,40~44세,2016,243144,125017,118127,105.8,236486,120922,115564,104.6
23,인천광역시,045001, 40세,2016,43874,22796,21078,108.2,42471,21903,20568,106.5
23,인천광역시,045002, 41세,2016,46652,24152,22500,107.3,45353,23328,22025,105.9
23,인천광역시,045003, 42세,2016,50241,26026,24215,107.5,48958,25210,23748,106.2
23,인천광역시,045004, 43세,2016,51080,25755,25325,101.7,49751,24980,24771,100.8
23,인천광역시,045005, 44세,2016,51297,26288,25009,105.1,49953,25501,24452,104.3
23,인천광역시,050,45~49세,2016,262988,130951,132037,99.2,256690,127454,129236,98.6
23,인천광역시,050001, 45세,2016,53841,27315,26526,103,52473,26551,25922,102.4
23,인천광역시,050002, 46세,2016,52565,26524,26041,101.9,51150,25708,25442,101
23,인천광역시,050003, 47세,2016,53755,26638,27117,98.2,52513,25946,26567,97.7
23,인천광역시,050004, 48세,2016,53814,26370,27444,96.1,52513,25695,26818,95.8
23,인천광역시,050005, 49세,2016,49013,24104,24909,96.8,48041,23554,24487,96.2
23,인천광역시,055,50~54세,2016,252565,127011,125554,101.2,246810,124088,122722,101.1
23,인천광역시,055001, 50세,2016,48732,24426,24306,100.5,47653,23872,23781,100.4
23,인천광역시,055002, 51세,2016,51808,25755,26053,98.9,50583,25122,25461,98.7
23,인천광역시,055003, 52세,2016,48628,24376,24252,100.5,47427,23767,23660,100.5
23,인천광역시,055004, 53세,2016,51239,26027,25212,103.2,49953,25385,24568,103.3
23,인천광역시,055005, 54세,2016,52158,26427,25731,102.7,51194,25942,25252,102.7
23,인천광역시,060,55~59세,2016,244514,123563,120951,102.2,240439,121586,118853,102.3
23,인천광역시,060001, 55세,2016,55119,27937,27182,102.8,54420,27601,26819,102.9
23,인천광역시,060002, 56세,2016,54258,27387,26871,101.9,53293,26916,26377,102
23,인천광역시,060003, 57세,2016,47672,23956,23716,101,46873,23572,23301,101.2
23,인천광역시,060004, 58세,2016,45018,22841,22177,103,44191,22434,21757,103.1
23,인천광역시,060005, 59세,2016,42447,21442,21005,102.1,41662,21063,20599,102.3
23,인천광역시,065,60~64세,2016,163424,81238,82186,98.8,160142,79697,80445,99.1
23,인천광역시,065001, 60세,2016,37890,18970,18920,100.3,37228,18660,18568,100.5
23,인천광역시,065002, 61세,2016,38343,18928,19415,97.5,37555,18560,18995,97.7
23,인천광역시,065003, 62세,2016,31363,15556,15807,98.4,30671,15253,15418,98.9
23,인천광역시,065004, 63세,2016,26825,13365,13460,99.3,26253,13075,13178,99.2
23,인천광역시,065005, 64세,2016,29003,14419,14584,98.9,28435,14149,14286,99
23,인천광역시,070,65~69세,2016,107994,52804,55190,95.7,106421,52077,54344,95.8
23,인천광역시,070001, 65세,2016,19466,9584,9882,97,19016,9359,9657,96.9
23,인천광역시,070002, 66세,2016,22261,11075,11186,99,21883,10917,10966,99.6
23,인천광역시,070003, 67세,2016,22638,11115,11523,96.5,22286,10947,11339,96.5
23,인천광역시,070004, 68세,2016,21768,10687,11081,96.4,21563,10599,10964,96.7
23,인천광역시,070005, 69세,2016,21861,10343,11518,89.8,21673,10255,11418,89.8
23,인천광역시,075,70~74세,2016,82453,37771,44682,84.5,81859,37543,44316,84.7
23,인천광역시,075001, 70세,2016,16731,7897,8834,89.4,16580,7842,8738,89.7
23,인천광역시,075002, 71세,2016,15764,7368,8396,87.8,15616,7303,8313,87.9
23,인천광역시,075003, 72세,2016,15605,7234,8371,86.4,15501,7201,8300,86.8
23,인천광역시,075004, 73세,2016,16127,7251,8876,81.7,16035,7225,8810,82
23,인천광역시,075005, 74세,2016,18226,8021,10205,78.6,18127,7972,10155,78.5
23,인천광역시,080,75~79세,2016,63104,25641,37463,68.4,62698,25487,37211,68.5
23,인천광역시,080001, 75세,2016,14504,6245,8259,75.6,14413,6211,8202,75.7
23,인천광역시,080002, 76세,2016,13027,5396,7631,70.7,12937,5357,7580,70.7
23,인천광역시,080003, 77세,2016,13069,5234,7835,66.8,12991,5202,7789,66.8
23,인천광역시,080004, 78세,2016,12014,4778,7236,66,11933,4752,7181,66.2
23,인천광역시,080005, 79세,2016,10490,3988,6502,61.3,10424,3965,6459,61.4
23,인천광역시,085,80~84세,2016,39532,13348,26184,51,39320,13288,26032,51
23,인천광역시,085001, 80세,2016,9922,3625,6297,57.6,9872,3611,6261,57.7
23,인천광역시,085002, 81세,2016,9271,3269,6002,54.5,9207,3247,5960,54.5
23,인천광역시,085003, 82세,2016,7656,2546,5110,49.8,7616,2537,5079,50
23,인천광역시,085004, 83세,2016,6783,2171,4612,47.1,6755,2165,4590,47.2
23,인천광역시,085005, 84세,2016,5900,1737,4163,41.7,5870,1728,4142,41.7
23,인천광역시,090,85~89세,2016,18710,4848,13862,35,18610,4820,13790,35
23,인천광역시,090001, 85세,2016,4669,1324,3345,39.6,4636,1315,3321,39.6
23,인천광역시,090002, 86세,2016,4441,1112,3329,33.4,4420,1107,3313,33.4
23,인천광역시,090003, 87세,2016,3932,1048,2884,36.3,3921,1042,2879,36.2
23,인천광역시,090004, 88세,2016,3176,782,2394,32.7,3156,777,2379,32.7
23,인천광역시,090005, 89세,2016,2492,582,1910,30.5,2477,579,1898,30.5
23,인천광역시,095,90~94세,2016,6398,1466,4932,29.7,6363,1455,4908,29.6
23,인천광역시,095001, 90세,2016,1785,395,1390,28.4,1772,391,1381,28.3
23,인천광역시,095002, 91세,2016,1585,326,1259,25.9,1579,323,1256,25.7
23,인천광역시,095003, 92세,2016,1173,273,900,30.3,1165,272,893,30.5
23,인천광역시,095004, 93세,2016,1105,307,798,38.5,1102,306,796,38.4
23,인천광역시,095005, 94세,2016,750,165,585,28.2,745,163,582,28
23,인천광역시,100,95~99세,2016,1456,325,1131,28.7,1442,317,1125,28.2
23,인천광역시,100001, 95세,2016,522,122,400,30.5,519,120,399,30.1
23,인천광역시,100002, 96세,2016,369,90,279,32.3,367,90,277,32.5
23,인천광역시,100003, 97세,2016,276,69,207,33.3,271,66,205,32.2
23,인천광역시,100004, 98세,2016,174,29,145,20,170,26,144,18.1
23,인천광역시,100005, 99세,2016,115,15,100,15,115,15,100,15
23,인천광역시,101,100세이상,2016,181,35,146,24,179,33,146,22.6
23,인천광역시,102,15세미만,2016,400765,205942,194823,105.7,397220,204082,193138,105.7
23,인천광역시,103,15~64세,2016,2192431,1123519,1068912,105.1,2127039,1084638,1042401,104.1
23,인천광역시,104,65세이상,2016,319828,136238,183590,74.2,316892,135020,181872,74.2
23,인천광역시,086,85세이상,2016,26745,6674,20071,33.3,26594,6625,19969,33.2
23,인천광역시,126,평균연령,2016,39.9,38.9,40.8,,39.9,39,40.9,
23,인천광역시,127,중위연령,2016,40.7,39.6,41.8,,40.9,39.9,41.9,
23004, 읍부,000,합계,2016,21310,10638,10672,99.7,21056,10537,10519,100.2
23004, 읍부,005,0~4세,2016,673,318,355,89.6,669,316,353,89.5
23004, 읍부,005001, 0세,2016,127,70,57,122.8,127,70,57,122.8
23004, 읍부,005002, 1세,2016,135,65,70,92.9,135,65,70,92.9
23004, 읍부,005003, 2세,2016,132,51,81,63,131,50,81,61.7
23004, 읍부,005004, 3세,2016,141,66,75,88,139,66,73,90.4
23004, 읍부,005005, 4세,2016,138,66,72,91.7,137,65,72,90.3
23004, 읍부,010,5~9세,2016,841,410,431,95.1,838,409,429,95.3
23004, 읍부,010001, 5세,2016,156,74,82,90.2,156,74,82,90.2
23004, 읍부,010002, 6세,2016,177,93,84,110.7,176,93,83,112
23004, 읍부,010003, 7세,2016,145,72,73,98.6,144,72,72,100
23004, 읍부,010004, 8세,2016,185,78,107,72.9,184,77,107,72
23004, 읍부,010005, 9세,2016,178,93,85,109.4,178,93,85,109.4
23004, 읍부,015,10~14세,2016,1068,544,524,103.8,1063,541,522,103.6
23004, 읍부,015001, 10세,2016,205,101,104,97.1,205,101,104,97.1
23004, 읍부,015002, 11세,2016,190,87,103,84.5,189,87,102,85.3
23004, 읍부,015003, 12세,2016,205,105,100,105,204,104,100,104
23004, 읍부,015004, 13세,2016,255,142,113,125.7,255,142,113,125.7
23004, 읍부,015005, 14세,2016,213,109,104,104.8,210,107,103,103.9
23004, 읍부,020,15~19세,2016,1635,882,753,117.1,1633,882,751,117.4
23004, 읍부,020001, 15세,2016,280,143,137,104.4,280,143,137,104.4
23004, 읍부,020002, 16세,2016,484,266,218,122,484,266,218,122
23004, 읍부,020003, 17세,2016,364,192,172,111.6,362,192,170,112.9
23004, 읍부,020004, 18세,2016,336,188,148,127,336,188,148,127
23004, 읍부,020005, 19세,2016,171,93,78,119.2,171,93,78,119.2
23004, 읍부,025,20~24세,2016,1016,608,408,149,993,599,394,152
23004, 읍부,025001, 20세,2016,197,129,68,189.7,196,129,67,192.5
23004, 읍부,025002, 21세,2016,231,153,78,196.2,229,152,77,197.4
23004, 읍부,025003, 22세,2016,216,129,87,148.3,213,127,86,147.7
23004, 읍부,025004, 23세,2016,193,98,95,103.2,186,94,92,102.2
23004, 읍부,025005, 24세,2016,179,99,80,123.8,169,97,72,134.7
23004, 읍부,030,25~29세,2016,997,542,455,119.1,961,526,435,120.9
23004, 읍부,030001, 25세,2016,241,126,115,109.6,232,121,111,109
23004, 읍부,030002, 26세,2016,186,105,81,129.6,174,100,74,135.1
23004, 읍부,030003, 27세,2016,208,113,95,118.9,205,113,92,122.8
23004, 읍부,030004, 28세,2016,177,98,79,124.1,172,96,76,126.3
23004, 읍부,030005, 29세,2016,185,100,85,117.6,178,96,82,117.1
23004, 읍부,035,30~34세,2016,993,533,460,115.9,953,513,440,116.6
23004, 읍부,035001, 30세,2016,142,84,58,144.8,135,82,53,154.7
23004, 읍부,035002, 31세,2016,189,105,84,125,182,101,81,124.7
23004, 읍부,035003, 32세,2016,200,93,107,86.9,189,88,101,87.1
23004, 읍부,035004, 33세,2016,223,123,100,123,215,119,96,124
23004, 읍부,035005, 34세,2016,239,128,111,115.3,232,123,109,112.8
23004, 읍부,040,35~39세,2016,1217,611,606,100.8,1188,601,587,102.4
23004, 읍부,040001, 35세,2016,241,121,120,100.8,237,121,116,104.3
23004, 읍부,040002, 36세,2016,244,128,116,110.3,237,124,113,109.7
23004, 읍부,040003, 37세,2016,231,116,115,100.9,225,112,113,99.1
23004, 읍부,040004, 38세,2016,227,108,119,90.8,220,107,113,94.7
23004, 읍부,040005, 39세,2016,274,138,136,101.5,269,137,132,103.8
23004, 읍부,045,40~44세,2016,1512,759,753,100.8,1498,751,747,100.5
23004, 읍부,045001, 40세,2016,229,112,117,95.7,227,111,116,95.7
23004, 읍부,045002, 41세,2016,290,143,147,97.3,289,143,146,97.9
23004, 읍부,045003, 42세,2016,320,166,154,107.8,316,165,151,109.3
23004, 읍부,045004, 43세,2016,340,171,169,101.2,338,169,169,100
23004, 읍부,045005, 44세,2016,333,167,166,100.6,328,163,165,98.8
23004, 읍부,050,45~49세,2016,1751,919,832,110.5,1726,913,813,112.3
23004, 읍부,050001, 45세,2016,370,200,170,117.6,363,198,165,120
23004, 읍부,050002, 46세,2016,372,215,157,136.9,367,214,153,139.9
23004, 읍부,050003, 47세,2016,349,176,173,101.7,344,175,169,103.6
23004, 읍부,050004, 48세,2016,342,176,166,106,337,174,163,106.7
23004, 읍부,050005, 49세,2016,318,152,166,91.6,315,152,163,93.3
23004, 읍부,055,50~54세,2016,1742,889,853,104.2,1711,878,833,105.4
23004, 읍부,055001, 50세,2016,323,178,145,122.8,320,177,143,123.8
23004, 읍부,055002, 51세,2016,361,176,185,95.1,353,173,180,96.1
23004, 읍부,055003, 52세,2016,333,161,172,93.6,323,157,166,94.6
23004, 읍부,055004, 53세,2016,336,168,168,100,330,166,164,101.2
23004, 읍부,055005, 54세,2016,389,206,183,112.6,385,205,180,113.9
23004, 읍부,060,55~59세,2016,1966,996,970,102.7,1949,989,960,103
23004, 읍부,060001, 55세,2016,425,208,217,95.9,423,208,215,96.7
23004, 읍부,060002, 56세,2016,391,208,183,113.7,389,206,183,112.6
23004, 읍부,060003, 57세,2016,377,193,184,104.9,372,190,182,104.4
23004, 읍부,060004, 58세,2016,414,200,214,93.5,408,199,209,95.2
23004, 읍부,060005, 59세,2016,359,187,172,108.7,357,186,171,108.8
23004, 읍부,065,60~64세,2016,1595,786,809,97.2,1586,783,803,97.5
23004, 읍부,065001, 60세,2016,319,159,160,99.4,317,159,158,100.6
23004, 읍부,065002, 61세,2016,350,170,180,94.4,348,170,178,95.5
23004, 읍부,065003, 62세,2016,316,152,164,92.7,314,151,163,92.6
23004, 읍부,065004, 63세,2016,308,155,153,101.3,306,153,153,100
23004, 읍부,065005, 64세,2016,302,150,152,98.7,301,150,151,99.3
23004, 읍부,070,65~69세,2016,1245,577,668,86.4,1237,573,664,86.3
23004, 읍부,070001, 65세,2016,186,85,101,84.2,185,85,100,85
23004, 읍부,070002, 66세,2016,220,106,114,93,219,106,113,93.8
23004, 읍부,070003, 67세,2016,261,116,145,80,258,114,144,79.2
23004, 읍부,070004, 68세,2016,266,129,137,94.2,266,129,137,94.2
23004, 읍부,070005, 69세,2016,312,141,171,82.5,309,139,170,81.8
23004, 읍부,075,70~74세,2016,1115,503,612,82.2,1112,503,609,82.6
23004, 읍부,075001, 70세,2016,207,94,113,83.2,207,94,113,83.2
23004, 읍부,075002, 71세,2016,217,96,121,79.3,215,96,119,80.7
23004, 읍부,075003, 72세,2016,216,104,112,92.9,215,104,111,93.7
23004, 읍부,075004, 73세,2016,230,109,121,90.1,230,109,121,90.1
23004, 읍부,075005, 74세,2016,245,100,145,69,245,100,145,69
23004, 읍부,080,75~79세,2016,939,413,526,78.5,937,413,524,78.8
23004, 읍부,080001, 75세,2016,220,99,121,81.8,220,99,121,81.8
23004, 읍부,080002, 76세,2016,177,69,108,63.9,176,69,107,64.5
23004, 읍부,080003, 77세,2016,188,81,107,75.7,187,81,106,76.4
23004, 읍부,080004, 78세,2016,194,87,107,81.3,194,87,107,81.3
23004, 읍부,080005, 79세,2016,160,77,83,92.8,160,77,83,92.8
23004, 읍부,085,80~84세,2016,640,230,410,56.1,639,229,410,55.9
23004, 읍부,085001, 80세,2016,152,60,92,65.2,152,60,92,65.2
23004, 읍부,085002, 81세,2016,163,60,103,58.3,162,59,103,57.3
23004, 읍부,085003, 82세,2016,127,46,81,56.8,127,46,81,56.8
23004, 읍부,085004, 83세,2016,108,35,73,47.9,108,35,73,47.9
23004, 읍부,085005, 84세,2016,90,29,61,47.5,90,29,61,47.5
23004, 읍부,090,85~89세,2016,270,85,185,45.9,270,85,185,45.9
23004, 읍부,090001, 85세,2016,72,26,46,56.5,72,26,46,56.5
23004, 읍부,090002, 86세,2016,69,23,46,50,69,23,46,50
23004, 읍부,090003, 87세,2016,54,16,38,42.1,54,16,38,42.1
23004, 읍부,090004, 88세,2016,50,14,36,38.9,50,14,36,38.9
23004, 읍부,090005, 89세,2016,25,6,19,31.6,25,6,19,31.6
23004, 읍부,095,90~94세,2016,78,25,53,47.2,77,25,52,48.1
23004, 읍부,095001, 90세,2016,23,8,15,53.3,22,8,14,57.1
23004, 읍부,095002, 91세,2016,26,8,18,44.4,26,8,18,44.4
23004, 읍부,095003, 92세,2016,12,X,10,20,12,X,10,20
23004, 읍부,095004, 93세,2016,11,X,8,37.5,11,X,8,37.5
23004, 읍부,095005, 94세,2016,6,X,X,200,6,X,X,200
23004, 읍부,100,95~99세,2016,15,7,8,87.5,14,7,7,100
23004, 읍부,100001, 95세,2016,6,X,X,50,6,X,X,50
23004, 읍부,100002, 96세,2016,5,X,X,66.7,X,X,X,100
23004, 읍부,100003, 97세,2016,X,X,X,200,X,X,X,200
23004, 읍부,100004, 98세,2016,X,X,X,,X,X,X,
23004, 읍부,100005, 99세,2016,X,X,X,,X,X,X,
23004, 읍부,101,100세이상,2016,X,X,X,100,X,X,X,100
23004, 읍부,102,15세미만,2016,2582,1272,1310,97.1,2570,1266,1304,97.1
23004, 읍부,103,15~64세,2016,14424,7525,6899,109.1,14198,7435,6763,109.9
23004, 읍부,104,65세이상,2016,4304,1841,2463,74.7,4288,1836,2452,74.9
23004, 읍부,086,85세이상,2016,365,118,247,47.8,363,118,245,48.2
23004, 읍부,126,평균연령,2016,44.7,43.3,46.1,,44.8,43.3,46.2,
23004, 읍부,127,중위연령,2016,46.9,45.6,48.5,,47,45.7,48.7,
23005, 면부,000,합계,2016,60336,31781,28555,111.3,59389,31121,28268,110.1
23005, 면부,005,0~4세,2016,1428,718,710,101.1,1425,717,708,101.3
23005, 면부,005001, 0세,2016,269,136,133,102.3,269,136,133,102.3
23005, 면부,005002, 1세,2016,263,138,125,110.4,263,138,125,110.4
23005, 면부,005003, 2세,2016,298,146,152,96.1,297,146,151,96.7
23005, 면부,005004, 3세,2016,274,134,140,95.7,274,134,140,95.7
23005, 면부,005005, 4세,2016,324,164,160,102.5,322,163,159,102.5
23005, 면부,010,5~9세,2016,1672,898,774,116,1668,895,773,115.8
23005, 면부,010001, 5세,2016,351,198,153,129.4,350,198,152,130.3
23005, 면부,010002, 6세,2016,303,165,138,119.6,301,163,138,118.1
23005, 면부,010003, 7세,2016,324,184,140,131.4,323,183,140,130.7
23005, 면부,010004, 8세,2016,341,162,179,90.5,341,162,179,90.5
23005, 면부,010005, 9세,2016,353,189,164,115.2,353,189,164,115.2
23005, 면부,015,10~14세,2016,1534,783,751,104.3,1532,782,750,104.3
23005, 면부,015001, 10세,2016,304,158,146,108.2,303,157,146,107.5
23005, 면부,015002, 11세,2016,287,154,133,115.8,287,154,133,115.8
23005, 면부,015003, 12세,2016,312,152,160,95,312,152,160,95
23005, 면부,015004, 13세,2016,317,152,165,92.1,316,152,164,92.7
23005, 면부,015005, 14세,2016,314,167,147,113.6,314,167,147,113.6
23005, 면부,020,15~19세,2016,1854,1029,825,124.7,1849,1027,822,124.9
23005, 면부,020001, 15세,2016,383,200,183,109.3,382,199,183,108.7
23005, 면부,020002, 16세,2016,385,200,185,108.1,384,200,184,108.7
23005, 면부,020003, 17세,2016,415,220,195,112.8,415,220,195,112.8
23005, 면부,020004, 18세,2016,348,211,137,154,347,211,136,155.1
23005, 면부,020005, 19세,2016,323,198,125,158.4,321,197,124,158.9
23005, 면부,025,20~24세,2016,2740,1922,818,235,2627,1842,785,234.6
23005, 면부,025001, 20세,2016,417,283,134,211.2,409,280,129,217.1
23005, 면부,025002, 21세,2016,513,387,126,307.1,503,381,122,312.3
23005, 면부,025003, 22세,2016,573,405,168,241.1,552,392,160,245
23005, 면부,025004, 23세,2016,621,431,190,226.8,581,401,180,222.8
23005, 면부,025005, 24세,2016,616,416,200,208,582,388,194,200
23005, 면부,030,25~29세,2016,2840,1885,955,197.4,2598,1699,899,189
23005, 면부,030001, 25세,2016,624,406,218,186.2,583,379,204,185.8
23005, 면부,030002, 26세,2016,619,418,201,208,573,385,188,204.8
23005, 면부,030003, 27세,2016,562,393,169,232.5,509,350,159,220.1
23005, 면부,030004, 28세,2016,523,344,179,192.2,464,293,171,171.3
23005, 면부,030005, 29세,2016,512,324,188,172.3,469,292,177,165
23005, 면부,035,30~34세,2016,2566,1515,1051,144.1,2355,1337,1018,131.3
23005, 면부,035001, 30세,2016,502,319,183,174.3,445,271,174,155.7
23005, 면부,035002, 31세,2016,480,288,192,150,437,248,189,131.2
23005, 면부,035003, 32세,2016,451,259,192,134.9,417,230,187,123
23005, 면부,035004, 33세,2016,536,317,219,144.7,493,281,212,132.5
23005, 면부,035005, 34세,2016,597,332,265,125.3,563,307,256,119.9
23005, 면부,040,35~39세,2016,2811,1621,1190,136.2,2722,1552,1170,132.6
23005, 면부,040001, 35세,2016,555,324,231,140.3,536,309,227,136.1
23005, 면부,040002, 36세,2016,582,324,258,125.6,561,308,253,121.7
23005, 면부,040003, 37세,2016,580,328,252,130.2,566,318,248,128.2
23005, 면부,040004, 38세,2016,555,328,227,144.5,534,313,221,141.6
23005, 면부,040005, 39세,2016,539,317,222,142.8,525,304,221,137.6
23005, 면부,045,40~44세,2016,3200,1964,1236,158.9,3130,1920,1210,158.7
23005, 면부,045001, 40세,2016,591,353,238,148.3,574,343,231,148.5
23005, 면부,045002, 41세,2016,598,367,231,158.9,585,359,226,158.8
23005, 면부,045003, 42세,2016,639,402,237,169.6,621,390,231,168.8
23005, 면부,045004, 43세,2016,703,418,285,146.7,692,412,280,147.1
23005, 면부,045005, 44세,2016,669,424,245,173.1,658,416,242,171.9
23005, 면부,050,45~49세,2016,3844,2160,1684,128.3,3780,2123,1657,128.1
23005, 면부,050001, 45세,2016,714,422,292,144.5,703,413,290,142.4
23005, 면부,050002, 46세,2016,705,420,285,147.4,691,413,278,148.6
23005, 면부,050003, 47세,2016,773,432,341,126.7,763,425,338,125.7
23005, 면부,050004, 48세,2016,853,453,400,113.3,838,446,392,113.8
23005, 면부,050005, 49세,2016,799,433,366,118.3,785,426,359,118.7
23005, 면부,055,50~54세,2016,5020,2719,2301,118.2,4969,2700,2269,119
23005, 면부,055001, 50세,2016,863,475,388,122.4,852,471,381,123.6
23005, 면부,055002, 51세,2016,950,521,429,121.4,942,516,426,121.1
23005, 면부,055003, 52세,2016,952,530,422,125.6,942,524,418,125.4
23005, 면부,055004, 53세,2016,1036,554,482,114.9,1023,552,471,117.2
23005, 면부,055005, 54세,2016,1219,639,580,110.2,1210,637,573,111.2
23005, 면부,060,55~59세,2016,6699,3435,3264,105.2,6672,3425,3247,105.5
23005, 면부,060001, 55세,2016,1358,720,638,112.9,1354,717,637,112.6
23005, 면부,060002, 56세,2016,1386,697,689,101.2,1380,695,685,101.5
23005, 면부,060003, 57세,2016,1398,702,696,100.9,1388,699,689,101.5
23005, 면부,060004, 58세,2016,1265,641,624,102.7,1260,640,620,103.2
23005, 면부,060005, 59세,2016,1292,675,617,109.4,1290,674,616,109.4
23005, 면부,065,60~64세,2016,5902,2969,2933,101.2,5872,2960,2912,101.6
23005, 면부,065001, 60세,2016,1267,638,629,101.4,1262,637,625,101.9
23005, 면부,065002, 61세,2016,1356,679,677,100.3,1344,675,669,100.9
23005, 면부,065003, 62세,2016,1097,546,551,99.1,1092,545,547,99.6
23005, 면부,065004, 63세,2016,1061,545,516,105.6,1059,544,515,105.6
23005, 면부,065005, 64세,2016,1121,561,560,100.2,1115,559,556,100.5
23005, 면부,070,65~69세,2016,4819,2452,2367,103.6,4805,2445,2360,103.6
23005, 면부,070001, 65세,2016,703,336,367,91.6,701,335,366,91.5
23005, 면부,070002, 66세,2016,990,508,482,105.4,987,507,480,105.6
23005, 면부,070003, 67세,2016,1002,535,467,114.6,997,532,465,114.4
23005, 면부,070004, 68세,2016,977,492,485,101.4,974,491,483,101.7
23005, 면부,070005, 69세,2016,1147,581,566,102.7,1146,580,566,102.5
23005, 면부,075,70~74세,2016,4483,2173,2310,94.1,4473,2168,2305,94.1
23005, 면부,075001, 70세,2016,916,436,480,90.8,913,435,478,91
23005, 면부,075002, 71세,2016,835,414,421,98.3,833,413,420,98.3
23005, 면부,075003, 72세,2016,808,382,426,89.7,807,381,426,89.4
23005, 면부,075004, 73세,2016,942,469,473,99.2,940,468,472,99.2
23005, 면부,075005, 74세,2016,982,472,510,92.5,980,471,509,92.5
23005, 면부,080,75~79세,2016,3904,1819,2085,87.2,3898,1813,2085,87
23005, 면부,080001, 75세,2016,873,419,454,92.3,871,417,454,91.9
23005, 면부,080002, 76세,2016,778,372,406,91.6,776,370,406,91.1
23005, 면부,080003, 77세,2016,781,351,430,81.6,781,351,430,81.6
23005, 면부,080004, 78세,2016,758,360,398,90.5,756,358,398,89.9
23005, 면부,080005, 79세,2016,714,317,397,79.8,714,317,397,79.8
23005, 면부,085,80~84세,2016,2958,1170,1788,65.4,2954,1169,1785,65.5
23005, 면부,085001, 80세,2016,761,321,440,73,759,321,438,73.3
23005, 면부,085002, 81세,2016,637,274,363,75.5,636,273,363,75.2
23005, 면부,085003, 82세,2016,567,224,343,65.3,567,224,343,65.3
23005, 면부,085004, 83세,2016,523,209,314,66.6,522,209,313,66.8
23005, 면부,085005, 84세,2016,470,142,328,43.3,470,142,328,43.3
23005, 면부,090,85~89세,2016,1426,405,1021,39.7,1424,403,1021,39.5
23005, 면부,090001, 85세,2016,379,119,260,45.8,378,118,260,45.4
23005, 면부,090002, 86세,2016,330,92,238,38.7,330,92,238,38.7
23005, 면부,090003, 87세,2016,268,77,191,40.3,268,77,191,40.3
23005, 면부,090004, 88세,2016,251,66,185,35.7,251,66,185,35.7
23005, 면부,090005, 89세,2016,198,51,147,34.7,197,50,147,34
23005, 면부,095,90~94세,2016,502,115,387,29.7,502,115,387,29.7
23005, 면부,095001, 90세,2016,143,33,110,30,143,33,110,30
23005, 면부,095002, 91세,2016,130,28,102,27.5,130,28,102,27.5
23005, 면부,095003, 92세,2016,96,22,74,29.7,96,22,74,29.7
23005, 면부,095004, 93세,2016,77,21,56,37.5,77,21,56,37.5
23005, 면부,095005, 94세,2016,56,11,45,24.4,56,11,45,24.4
23005, 면부,100,95~99세,2016,122,25,97,25.8,122,25,97,25.8
23005, 면부,100001, 95세,2016,44,11,33,33.3,44,11,33,33.3
23005, 면부,100002, 96세,2016,34,8,26,30.8,34,8,26,30.8
23005, 면부,100003, 97세,2016,19,X,17,11.8,19,X,17,11.8
23005, 면부,100004, 98세,2016,14,X,11,27.3,14,X,11,27.3
23005, 면부,100005, 99세,2016,11,X,10,10,11,X,10,10
23005, 면부,101,100세이상,2016,12,X,8,50,12,X,8,50
23005, 면부,102,15세미만,2016,4634,2399,2235,107.3,4625,2394,2231,107.3
23005, 면부,103,15~64세,2016,37476,21219,16257,130.5,36574,20585,15989,128.7
23005, 면부,104,65세이상,2016,18226,8163,10063,81.1,18190,8142,10048,81
23005, 면부,086,85세이상,2016,2062,549,1513,36.3,2060,547,1513,36.2
23005, 면부,126,평균연령,2016,51.6,49.2,54.3,,51.9,49.5,54.5,
23005, 면부,127,중위연령,2016,55.5,52.8,57.9,,55.8,53.3,58.1,
23003, 동부,000,합계,2016,2831378,1423280,1408098,101.1,2760706,1382082,1378624,100.3
23003, 동부,005,0~4세,2016,129791,66532,63259,105.2,128095,65654,62441,105.1
23003, 동부,005001, 0세,2016,24105,12285,11820,103.9,23692,12064,11628,103.7
23003, 동부,005002, 1세,2016,25825,13284,12541,105.9,25487,13116,12371,106
23003, 동부,005003, 2세,2016,25667,13238,12429,106.5,25304,13058,12246,106.6
23003, 동부,005004, 3세,2016,26045,13279,12766,104,25735,13116,12619,103.9
23003, 동부,005005, 4세,2016,28149,14446,13703,105.4,27877,14300,13577,105.3
23003, 동부,010,5~9세,2016,134334,69018,65316,105.7,133239,68428,64811,105.6
23003, 동부,010001, 5세,2016,27834,14386,13448,107,27565,14241,13324,106.9
23003, 동부,010002, 6세,2016,26526,13601,12925,105.2,26296,13487,12809,105.3
23003, 동부,010003, 7세,2016,25712,13180,12532,105.2,25494,13060,12434,105
23003, 동부,010004, 8세,2016,26728,13643,13085,104.3,26522,13525,12997,104.1
23003, 동부,010005, 9세,2016,27534,14208,13326,106.6,27362,14115,13247,106.6
23003, 동부,015,10~14세,2016,129424,66721,62703,106.4,128691,66340,62351,106.4
23003, 동부,015001, 10세,2016,24692,12782,11910,107.3,24543,12706,11837,107.3
23003, 동부,015002, 11세,2016,24107,12360,11747,105.2,23963,12279,11684,105.1
23003, 동부,015003, 12세,2016,26156,13434,12722,105.6,26000,13355,12645,105.6
23003, 동부,015004, 13세,2016,26930,13850,13080,105.9,26803,13783,13020,105.9
23003, 동부,015005, 14세,2016,27539,14295,13244,107.9,27382,14217,13165,108
23003, 동부,020,15~19세,2016,168630,86956,81674,106.5,167314,86329,80985,106.6
23003, 동부,020001, 15세,2016,31207,16130,15077,107,31050,16054,14996,107.1
23003, 동부,020002, 16세,2016,33979,17491,16488,106.1,33804,17392,16412,106
23003, 동부,020003, 17세,2016,33454,17446,16008,109,33261,17336,15925,108.9
23003, 동부,020004, 18세,2016,34678,17842,16836,106,34396,17708,16688,106.1
23003, 동부,020005, 19세,2016,35312,18047,17265,104.5,34803,17839,16964,105.2
23003, 동부,025,20~24세,2016,196563,103677,92886,111.6,191044,100609,90435,111.3
23003, 동부,025001, 20세,2016,36961,19746,17215,114.7,36244,19448,16796,115.8
23003, 동부,025002, 21세,2016,38248,20868,17380,120.1,37397,20442,16955,120.6
23003, 동부,025003, 22세,2016,38805,20836,17969,116,37782,20255,17527,115.6
23003, 동부,025004, 23세,2016,40475,20912,19563,106.9,39161,20133,19028,105.8
23003, 동부,025005, 24세,2016,42074,21315,20759,102.7,40460,20331,20129,101
23003, 동부,030,25~29세,2016,192424,100242,92182,108.7,181254,93172,88082,105.8
23003, 동부,030001, 25세,2016,40760,21117,19643,107.5,38931,19992,18939,105.6
23003, 동부,030002, 26세,2016,39121,20395,18726,108.9,36982,19057,17925,106.3
23003, 동부,030003, 27세,2016,38121,19978,18143,110.1,35937,18582,17355,107.1
23003, 동부,030004, 28세,2016,37035,19314,17721,109,34608,17760,16848,105.4
23003, 동부,030005, 29세,2016,37387,19438,17949,108.3,34796,17781,17015,104.5
23003, 동부,035,30~34세,2016,212227,110683,101544,109,200448,102920,97528,105.5
23003, 동부,035001, 30세,2016,38099,20003,18096,110.5,35667,18434,17233,107
23003, 동부,035002, 31세,2016,38843,20351,18492,110.1,36424,18780,17644,106.4
23003, 동부,035003, 32세,2016,40838,21329,19509,109.3,38439,19747,18692,105.6
23003, 동부,035004, 33세,2016,45171,23321,21850,106.7,42893,21800,21093,103.4
23003, 동부,035005, 34세,2016,49276,25679,23597,108.8,47025,24159,22866,105.7
23003, 동부,040,35~39세,2016,237283,123033,114250,107.7,228533,117283,111250,105.4
23003, 동부,040001, 35세,2016,50068,26146,23922,109.3,48067,24827,23240,106.8
23003, 동부,040002, 36세,2016,50565,26075,24490,106.5,48694,24826,23868,104
23003, 동부,040003, 37세,2016,48160,25084,23076,108.7,46289,23861,22428,106.4
23003, 동부,040004, 38세,2016,43937,22677,21260,106.7,42356,21650,20706,104.6
23003, 동부,040005, 39세,2016,44553,23051,21502,107.2,43127,22119,21008,105.3
23003, 동부,045,40~44세,2016,238432,122294,116138,105.3,231858,118251,113607,104.1
23003, 동부,045001, 40세,2016,43054,22331,20723,107.8,41670,21449,20221,106.1
23003, 동부,045002, 41세,2016,45764,23642,22122,106.9,44479,22826,21653,105.4
23003, 동부,045003, 42세,2016,49282,25458,23824,106.9,48021,24655,23366,105.5
23003, 동부,045004, 43세,2016,50037,25166,24871,101.2,48721,24399,24322,100.3
23003, 동부,045005, 44세,2016,50295,25697,24598,104.5,48967,24922,24045,103.6
23003, 동부,050,45~49세,2016,257393,127872,129521,98.7,251184,124418,126766,98.1
23003, 동부,050001, 45세,2016,52757,26693,26064,102.4,51407,25940,25467,101.9
23003, 동부,050002, 46세,2016,51488,25889,25599,101.1,50092,25081,25011,100.3
23003, 동부,050003, 47세,2016,52633,26030,26603,97.8,51406,25346,26060,97.3
23003, 동부,050004, 48세,2016,52619,25741,26878,95.8,51338,25075,26263,95.5
23003, 동부,050005, 49세,2016,47896,23519,24377,96.5,46941,22976,23965,95.9
23003, 동부,055,50~54세,2016,245803,123403,122400,100.8,240130,120510,119620,100.7
23003, 동부,055001, 50세,2016,47546,23773,23773,100,46481,23224,23257,99.9
23003, 동부,055002, 51세,2016,50497,25058,25439,98.5,49288,24433,24855,98.3
23003, 동부,055003, 52세,2016,47343,23685,23658,100.1,46162,23086,23076,100
23003, 동부,055004, 53세,2016,49867,25305,24562,103,48600,24667,23933,103.1
23003, 동부,055005, 54세,2016,50550,25582,24968,102.5,49599,25100,24499,102.5
23003, 동부,060,55~59세,2016,235849,119132,116717,102.1,231818,117172,114646,102.2
23003, 동부,060001, 55세,2016,53336,27009,26327,102.6,52643,26676,25967,102.7
23003, 동부,060002, 56세,2016,52481,26482,25999,101.9,51524,26015,25509,102
23003, 동부,060003, 57세,2016,45897,23061,22836,101,45113,22683,22430,101.1
23003, 동부,060004, 58세,2016,43339,22000,21339,103.1,42523,21595,20928,103.2
23003, 동부,060005, 59세,2016,40796,20580,20216,101.8,40015,20203,19812,102
23003, 동부,065,60~64세,2016,155927,77483,78444,98.8,152684,75954,76730,99
23003, 동부,065001, 60세,2016,36304,18173,18131,100.2,35649,17864,17785,100.4
23003, 동부,065002, 61세,2016,36637,18079,18558,97.4,35863,17715,18148,97.6
23003, 동부,065003, 62세,2016,29950,14858,15092,98.4,29265,14557,14708,99
23003, 동부,065004, 63세,2016,25456,12665,12791,99,24888,12378,12510,98.9
23003, 동부,065005, 64세,2016,27580,13708,13872,98.8,27019,13440,13579,99
23003, 동부,070,65~69세,2016,101930,49775,52155,95.4,100379,49059,51320,95.6
23003, 동부,070001, 65세,2016,18577,9163,9414,97.3,18130,8939,9191,97.3
23003, 동부,070002, 66세,2016,21051,10461,10590,98.8,20677,10304,10373,99.3
23003, 동부,070003, 67세,2016,21375,10464,10911,95.9,21031,10301,10730,96
23003, 동부,070004, 68세,2016,20525,10066,10459,96.2,20323,9979,10344,96.5
23003, 동부,070005, 69세,2016,20402,9621,10781,89.2,20218,9536,10682,89.3
23003, 동부,075,70~74세,2016,76855,35095,41760,84,76274,34872,41402,84.2
23003, 동부,075001, 70세,2016,15608,7367,8241,89.4,15460,7313,8147,89.8
23003, 동부,075002, 71세,2016,14712,6858,7854,87.3,14568,6794,7774,87.4
23003, 동부,075003, 72세,2016,14581,6748,7833,86.1,14479,6716,7763,86.5
23003, 동부,075004, 73세,2016,14955,6673,8282,80.6,14865,6648,8217,80.9
23003, 동부,075005, 74세,2016,16999,7449,9550,78,16902,7401,9501,77.9
23003, 동부,080,75~79세,2016,58261,23409,34852,67.2,57863,23261,34602,67.2
23003, 동부,080001, 75세,2016,13411,5727,7684,74.5,13322,5695,7627,74.7
23003, 동부,080002, 76세,2016,12072,4955,7117,69.6,11985,4918,7067,69.6
23003, 동부,080003, 77세,2016,12100,4802,7298,65.8,12023,4770,7253,65.8
23003, 동부,080004, 78세,2016,11062,4331,6731,64.3,10983,4307,6676,64.5
23003, 동부,080005, 79세,2016,9616,3594,6022,59.7,9550,3571,5979,59.7
23003, 동부,085,80~84세,2016,35934,11948,23986,49.8,35727,11890,23837,49.9
23003, 동부,085001, 80세,2016,9009,3244,5765,56.3,8961,3230,5731,56.4
23003, 동부,085002, 81세,2016,8471,2935,5536,53,8409,2915,5494,53.1
23003, 동부,085003, 82세,2016,6962,2276,4686,48.6,6922,2267,4655,48.7
23003, 동부,085004, 83세,2016,6152,1927,4225,45.6,6125,1921,4204,45.7
23003, 동부,085005, 84세,2016,5340,1566,3774,41.5,5310,1557,3753,41.5
23003, 동부,090,85~89세,2016,17014,4358,12656,34.4,16916,4332,12584,34.4
23003, 동부,090001, 85세,2016,4218,1179,3039,38.8,4186,1171,3015,38.8
23003, 동부,090002, 86세,2016,4042,997,3045,32.7,4021,992,3029,32.8
23003, 동부,090003, 87세,2016,3610,955,2655,36,3599,949,2650,35.8
23003, 동부,090004, 88세,2016,2875,702,2173,32.3,2855,697,2158,32.3
23003, 동부,090005, 89세,2016,2269,525,1744,30.1,2255,523,1732,30.2
23003, 동부,095,90~94세,2016,5818,1326,4492,29.5,5784,1315,4469,29.4
23003, 동부,095001, 90세,2016,1619,354,1265,28,1607,350,1257,27.8
23003, 동부,095002, 91세,2016,1429,290,1139,25.5,1423,287,1136,25.3
23003, 동부,095003, 92세,2016,1065,249,816,30.5,1057,248,809,30.7
23003, 동부,095004, 93세,2016,1017,283,734,38.6,1014,282,732,38.5
23003, 동부,095005, 94세,2016,688,150,538,27.9,683,148,535,27.7
23003, 동부,100,95~99세,2016,1319,293,1026,28.6,1306,285,1021,27.9
23003, 동부,100001, 95세,2016,472,109,363,30,469,107,362,29.6
23003, 동부,100002, 96세,2016,330,80,250,32,329,80,249,32.1
23003, 동부,100003, 97세,2016,254,65,189,34.4,249,62,187,33.2
23003, 동부,100004, 98세,2016,159,25,134,18.7,155,22,133,16.5
23003, 동부,100005, 99세,2016,104,14,90,15.6,104,14,90,15.6
23003, 동부,101,100세이상,2016,167,30,137,21.9,165,28,137,20.4
23003, 동부,102,15세미만,2016,393549,202271,191278,105.7,390025,200422,189603,105.7
23003, 동부,103,15~64세,2016,2140531,1094775,1045756,104.7,2076267,1056618,1019649,103.6
23003, 동부,104,65세이상,2016,297298,126234,171064,73.8,294414,125042,169372,73.8
23003, 동부,086,85세이상,2016,24318,6007,18311,32.8,24171,5960,18211,32.7
23003, 동부,126,평균연령,2016,39.6,38.6,40.5,,39.6,38.7,40.5,
23003, 동부,127,중위연령,2016,40.3,39.3,41.4,,40.5,39.6,41.5,
23010, 중구,000,합계,2016,113135,58364,54771,106.6,108701,55956,52745,106.1
23010, 중구,005,0~4세,2016,5477,2783,2694,103.3,5375,2730,2645,103.2
23010, 중구,005001, 0세,2016,967,498,469,106.2,947,484,463,104.5
23010, 중구,005002, 1세,2016,1078,567,511,111,1058,561,497,112.9
23010, 중구,005003, 2세,2016,1073,534,539,99.1,1053,526,527,99.8
23010, 중구,005004, 3세,2016,1117,574,543,105.7,1094,558,536,104.1
23010, 중구,005005, 4세,2016,1242,610,632,96.5,1223,601,622,96.6
23010, 중구,010,5~9세,2016,5764,2949,2815,104.8,5687,2908,2779,104.6
23010, 중구,010001, 5세,2016,1196,627,569,110.2,1176,617,559,110.4
23010, 중구,010002, 6세,2016,1146,590,556,106.1,1134,584,550,106.2
23010, 중구,010003, 7세,2016,1052,532,520,102.3,1035,522,513,101.8
23010, 중구,010004, 8세,2016,1157,574,583,98.5,1142,565,577,97.9
23010, 중구,010005, 9세,2016,1213,626,587,106.6,1200,620,580,106.9
23010, 중구,015,10~14세,2016,5429,2825,2604,108.5,5343,2786,2557,109
23010, 중구,015001, 10세,2016,1067,550,517,106.4,1046,539,507,106.3
23010, 중구,015002, 11세,2016,1026,539,487,110.7,1010,529,481,110
23010, 중구,015003, 12세,2016,1130,576,554,104,1116,569,547,104
23010, 중구,015004, 13세,2016,1105,581,524,110.9,1089,576,513,112.3
23010, 중구,015005, 14세,2016,1101,579,522,110.9,1082,573,509,112.6
23010, 중구,020,15~19세,2016,6826,3663,3163,115.8,6745,3619,3126,115.8
23010, 중구,020001, 15세,2016,1301,712,589,120.9,1288,708,580,122.1
23010, 중구,020002, 16세,2016,1884,1036,848,122.2,1863,1021,842,121.3
23010, 중구,020003, 17세,2016,1440,763,677,112.7,1427,755,672,112.4
23010, 중구,020004, 18세,2016,1282,669,613,109.1,1270,662,608,108.9
23010, 중구,020005, 19세,2016,919,483,436,110.8,897,473,424,111.6
23010, 중구,025,20~24세,2016,5551,2913,2638,110.4,5258,2743,2515,109.1
23010, 중구,025001, 20세,2016,945,518,427,121.3,915,504,411,122.6
23010, 중구,025002, 21세,2016,1028,547,481,113.7,992,530,462,114.7
23010, 중구,025003, 22세,2016,1077,594,483,123,1022,560,462,121.2
23010, 중구,025004, 23세,2016,1194,606,588,103.1,1125,566,559,101.3
23010, 중구,025005, 24세,2016,1307,648,659,98.3,1204,583,621,93.9
23010, 중구,030,25~29세,2016,6671,3638,3033,119.9,6069,3256,2813,115.7
23010, 중구,030001, 25세,2016,1327,692,635,109,1229,624,605,103.1
23010, 중구,030002, 26세,2016,1338,755,583,129.5,1213,673,540,124.6
23010, 중구,030003, 27세,2016,1296,700,596,117.4,1177,630,547,115.2
23010, 중구,030004, 28세,2016,1292,693,599,115.7,1178,624,554,112.6
23010, 중구,030005, 29세,2016,1418,798,620,128.7,1272,705,567,124.3
23010, 중구,035,30~34세,2016,8433,4461,3972,112.3,7809,4106,3703,110.9
23010, 중구,035001, 30세,2016,1419,744,675,110.2,1285,674,611,110.3
23010, 중구,035002, 31세,2016,1411,724,687,105.4,1304,662,642,103.1
23010, 중구,035003, 32세,2016,1590,871,719,121.1,1468,803,665,120.8
23010, 중구,035004, 33세,2016,1892,1022,870,117.5,1774,954,820,116.3
23010, 중구,035005, 34세,2016,2121,1100,1021,107.7,1978,1013,965,105
23010, 중구,040,35~39세,2016,10215,5430,4785,113.5,9706,5137,4569,112.4
23010, 중구,040001, 35세,2016,2083,1109,974,113.9,1968,1043,925,112.8
23010, 중구,040002, 36세,2016,2154,1150,1004,114.5,2052,1088,964,112.9
23010, 중구,040003, 37세,2016,2008,1069,939,113.8,1895,1004,891,112.7
23010, 중구,040004, 38세,2016,2015,1052,963,109.2,1915,1000,915,109.3
23010, 중구,040005, 39세,2016,1955,1050,905,116,1876,1002,874,114.6
23010, 중구,045,40~44세,2016,10332,5671,4661,121.7,9924,5427,4497,120.7
23010, 중구,045001, 40세,2016,1933,1045,888,117.7,1865,1003,862,116.4
23010, 중구,045002, 41세,2016,1956,1074,882,121.8,1884,1026,858,119.6
23010, 중구,045003, 42세,2016,2180,1247,933,133.7,2084,1189,895,132.8
23010, 중구,045004, 43세,2016,2148,1153,995,115.9,2059,1105,954,115.8
23010, 중구,045005, 44세,2016,2115,1152,963,119.6,2032,1104,928,119
23010, 중구,050,45~49세,2016,9719,5398,4321,124.9,9308,5176,4132,125.3
23010, 중구,050001, 45세,2016,2186,1224,962,127.2,2093,1172,921,127.3
23010, 중구,050002, 46세,2016,2067,1154,913,126.4,1971,1098,873,125.8
23010, 중구,050003, 47세,2016,1884,1018,866,117.6,1811,979,832,117.7
23010, 중구,050004, 48세,2016,1932,1051,881,119.3,1837,1006,831,121.1
23010, 중구,050005, 49세,2016,1650,951,699,136.1,1596,921,675,136.4
23010, 중구,055,50~54세,2016,8235,4465,3770,118.4,7847,4292,3555,120.7
23010, 중구,055001, 50세,2016,1656,925,731,126.5,1581,894,687,130.1
23010, 중구,055002, 51세,2016,1653,926,727,127.4,1586,895,691,129.5
23010, 중구,055003, 52세,2016,1578,866,712,121.6,1506,826,680,121.5
23010, 중구,055004, 53세,2016,1659,864,795,108.7,1572,829,743,111.6
23010, 중구,055005, 54세,2016,1689,884,805,109.8,1602,848,754,112.5
23010, 중구,060,55~59세,2016,8442,4237,4205,100.8,8132,4090,4042,101.2
23010, 중구,060001, 55세,2016,1755,879,876,100.3,1695,847,848,99.9
23010, 중구,060002, 56세,2016,1759,904,855,105.7,1692,872,820,106.3
23010, 중구,060003, 57세,2016,1657,798,859,92.9,1582,764,818,93.4
23010, 중구,060004, 58세,2016,1708,875,833,105,1648,850,798,106.5
23010, 중구,060005, 59세,2016,1563,781,782,99.9,1515,757,758,99.9
23010, 중구,065,60~64세,2016,6949,3409,3540,96.3,6683,3283,3400,96.6
23010, 중구,065001, 60세,2016,1533,778,755,103,1469,748,721,103.7
23010, 중구,065002, 61세,2016,1640,778,862,90.3,1575,747,828,90.2
23010, 중구,065003, 62세,2016,1394,686,708,96.9,1343,666,677,98.4
23010, 중구,065004, 63세,2016,1108,540,568,95.1,1071,521,550,94.7
23010, 중구,065005, 64세,2016,1274,627,647,96.9,1225,601,624,96.3
23010, 중구,070,65~69세,2016,5074,2395,2679,89.4,4938,2334,2604,89.6
23010, 중구,070001, 65세,2016,805,379,426,89,767,359,408,88
23010, 중구,070002, 66세,2016,1025,489,536,91.2,989,476,513,92.8
23010, 중구,070003, 67세,2016,1097,476,621,76.7,1067,464,603,76.9
23010, 중구,070004, 68세,2016,1060,520,540,96.3,1049,515,534,96.4
23010, 중구,070005, 69세,2016,1087,531,556,95.5,1066,520,546,95.2
23010, 중구,075,70~74세,2016,4077,1911,2166,88.2,4024,1889,2135,88.5
23010, 중구,075001, 70세,2016,834,394,440,89.5,822,389,433,89.8
23010, 중구,075002, 71세,2016,775,377,398,94.7,759,372,387,96.1
23010, 중구,075003, 72세,2016,816,408,408,100,806,403,403,100
23010, 중구,075004, 73세,2016,754,353,401,88,746,348,398,87.4
23010, 중구,075005, 74세,2016,898,379,519,73,891,377,514,73.3
23010, 중구,080,75~79세,2016,2952,1251,1701,73.5,2903,1229,1674,73.4
23010, 중구,080001, 75세,2016,676,315,361,87.3,662,310,352,88.1
23010, 중구,080002, 76세,2016,617,260,357,72.8,603,252,351,71.8
23010, 중구,080003, 77세,2016,630,253,377,67.1,621,249,372,66.9
23010, 중구,080004, 78세,2016,568,226,342,66.1,560,223,337,66.2
23010, 중구,080005, 79세,2016,461,197,264,74.6,457,195,262,74.4
23010, 중구,085,80~84세,2016,1740,624,1116,55.9,1722,621,1101,56.4
23010, 중구,085001, 80세,2016,430,189,241,78.4,427,189,238,79.4
23010, 중구,085002, 81세,2016,410,144,266,54.1,402,142,260,54.6
23010, 중구,085003, 82세,2016,341,113,228,49.6,338,113,225,50.2
23010, 중구,085004, 83세,2016,259,89,170,52.4,258,89,169,52.7
23010, 중구,085005, 84세,2016,300,89,211,42.2,297,88,209,42.1
23010, 중구,090,85~89세,2016,825,217,608,35.7,812,211,601,35.1
23010, 중구,090001, 85세,2016,226,65,161,40.4,220,64,156,41
23010, 중구,090002, 86세,2016,172,39,133,29.3,170,38,132,28.8
23010, 중구,090003, 87세,2016,177,48,129,37.2,175,46,129,35.7
23010, 중구,090004, 88세,2016,137,38,99,38.4,134,36,98,36.7
23010, 중구,090005, 89세,2016,113,27,86,31.4,113,27,86,31.4
23010, 중구,095,90~94세,2016,335,94,241,39,331,93,238,39.1
23010, 중구,095001, 90세,2016,91,27,64,42.2,90,27,63,42.9
23010, 중구,095002, 91세,2016,77,16,61,26.2,76,15,61,24.6
23010, 중구,095003, 92세,2016,74,22,52,42.3,73,22,51,43.1
23010, 중구,095004, 93세,2016,50,20,30,66.7,50,20,30,66.7
23010, 중구,095005, 94세,2016,43,9,34,26.5,42,9,33,27.3
23010, 중구,100,95~99세,2016,80,26,54,48.1,76,22,54,40.7
23010, 중구,100001, 95세,2016,24,7,17,41.2,23,6,17,35.3
23010, 중구,100002, 96세,2016,20,6,14,42.9,20,6,14,42.9
23010, 중구,100003, 97세,2016,18,7,11,63.6,17,6,11,54.5
23010, 중구,100004, 98세,2016,12,X,8,50,10,X,8,25
23010, 중구,100005, 99세,2016,6,X,X,50,6,X,X,50
23010, 중구,101,100세이상,2016,9,X,5,80,9,X,5,80
23010, 중구,102,15세미만,2016,16670,8557,8113,105.5,16405,8424,7981,105.6
23010, 중구,103,15~64세,2016,81373,43285,38088,113.6,77481,41129,36352,113.1
23010, 중구,104,65세이상,2016,15092,6522,8570,76.1,14815,6403,8412,76.1
23010, 중구,086,85세이상,2016,1249,341,908,37.6,1228,330,898,36.7
23010, 중구,126,평균연령,2016,40.5,39.6,41.5,,40.5,39.6,41.5,
23010, 중구,127,중위연령,2016,41.1,40.5,41.9,,41.3,40.7,41.9,
23020, 동구,000,합계,2016,69449,34899,34550,101,68369,34305,34064,100.7
23020, 동구,005,0~4세,2016,2873,1507,1366,110.3,2859,1497,1362,109.9
23020, 동구,005001, 0세,2016,553,292,261,111.9,547,287,260,110.4
23020, 동구,005002, 1세,2016,563,305,258,118.2,561,303,258,117.4
23020, 동구,005003, 2세,2016,548,291,257,113.2,546,290,256,113.3
23020, 동구,005004, 3세,2016,571,288,283,101.8,567,286,281,101.8
23020, 동구,005005, 4세,2016,638,331,307,107.8,638,331,307,107.8
23020, 동구,010,5~9세,2016,2986,1511,1475,102.4,2967,1503,1464,102.7
23020, 동구,010001, 5세,2016,608,323,285,113.3,606,321,285,112.6
23020, 동구,010002, 6세,2016,615,303,312,97.1,609,301,308,97.7
23020, 동구,010003, 7세,2016,540,262,278,94.2,538,262,276,94.9
23020, 동구,010004, 8세,2016,570,297,273,108.8,567,294,273,107.7
23020, 동구,010005, 9세,2016,653,326,327,99.7,647,325,322,100.9
23020, 동구,015,10~14세,2016,2732,1434,1298,110.5,2720,1429,1291,110.7
23020, 동구,015001, 10세,2016,500,276,224,123.2,498,276,222,124.3
23020, 동구,015002, 11세,2016,521,269,252,106.7,520,269,251,107.2
23020, 동구,015003, 12세,2016,570,297,273,108.8,567,295,272,108.5
23020, 동구,015004, 13세,2016,553,280,273,102.6,552,280,272,102.9
23020, 동구,015005, 14세,2016,588,312,276,113,583,309,274,112.8
23020, 동구,020,15~19세,2016,3376,1735,1641,105.7,3364,1727,1637,105.5
23020, 동구,020001, 15세,2016,605,329,276,119.2,599,324,275,117.8
23020, 동구,020002, 16세,2016,671,340,331,102.7,670,340,330,103
23020, 동구,020003, 17세,2016,662,353,309,114.2,660,351,309,113.6
23020, 동구,020004, 18세,2016,696,351,345,101.7,695,351,344,102
23020, 동구,020005, 19세,2016,742,362,380,95.3,740,361,379,95.3
23020, 동구,025,20~24세,2016,3687,1959,1728,113.4,3619,1924,1695,113.5
23020, 동구,025001, 20세,2016,740,390,350,111.4,732,386,346,111.6
23020, 동구,025002, 21세,2016,747,408,339,120.4,736,402,334,120.4
23020, 동구,025003, 22세,2016,693,393,300,131,685,389,296,131.4
23020, 동구,025004, 23세,2016,734,381,353,107.9,718,373,345,108.1
23020, 동구,025005, 24세,2016,773,387,386,100.3,748,374,374,100
23020, 동구,030,25~29세,2016,3703,1978,1725,114.7,3567,1901,1666,114.1
23020, 동구,030001, 25세,2016,775,409,366,111.7,754,397,357,111.2
23020, 동구,030002, 26세,2016,743,389,354,109.9,724,381,343,111.1
23020, 동구,030003, 27세,2016,673,369,304,121.4,651,351,300,117
23020, 동구,030004, 28세,2016,693,363,330,110,656,343,313,109.6
23020, 동구,030005, 29세,2016,819,448,371,120.8,782,429,353,121.5
23020, 동구,035,30~34세,2016,4673,2500,2173,115,4499,2379,2120,112.2
23020, 동구,035001, 30세,2016,824,444,380,116.8,795,425,370,114.9
23020, 동구,035002, 31세,2016,848,444,404,109.9,814,421,393,107.1
23020, 동구,035003, 32세,2016,853,496,357,138.9,814,464,350,132.6
23020, 동구,035004, 33세,2016,1081,568,513,110.7,1041,541,500,108.2
23020, 동구,035005, 34세,2016,1067,548,519,105.6,1035,528,507,104.1
23020, 동구,040,35~39세,2016,5758,3090,2668,115.8,5626,3010,2616,115.1
23020, 동구,040001, 35세,2016,1201,637,564,112.9,1175,618,557,111
23020, 동구,040002, 36세,2016,1225,653,572,114.2,1199,641,558,114.9
23020, 동구,040003, 37세,2016,1213,655,558,117.4,1181,635,546,116.3
23020, 동구,040004, 38세,2016,1085,578,507,114,1062,563,499,112.8
23020, 동구,040005, 39세,2016,1034,567,467,121.4,1009,553,456,121.3
23020, 동구,045,40~44세,2016,5591,3027,2564,118.1,5497,2977,2520,118.1
23020, 동구,045001, 40세,2016,985,533,452,117.9,970,525,445,118
23020, 동구,045002, 41세,2016,1112,612,500,122.4,1094,600,494,121.5
23020, 동구,045003, 42세,2016,1154,592,562,105.3,1134,583,551,105.8
23020, 동구,045004, 43세,2016,1164,641,523,122.6,1143,629,514,122.4
23020, 동구,045005, 44세,2016,1176,649,527,123.1,1156,640,516,124
23020, 동구,050,45~49세,2016,5406,2886,2520,114.5,5314,2833,2481,114.2
23020, 동구,050001, 45세,2016,1153,627,526,119.2,1139,619,520,119
23020, 동구,050002, 46세,2016,1102,609,493,123.5,1075,591,484,122.1
23020, 동구,050003, 47세,2016,1070,557,513,108.6,1058,552,506,109.1
23020, 동구,050004, 48세,2016,1115,599,516,116.1,1096,589,507,116.2
23020, 동구,050005, 49세,2016,966,494,472,104.7,946,482,464,103.9
23020, 동구,055,50~54세,2016,5246,2731,2515,108.6,5127,2677,2450,109.3
23020, 동구,055001, 50세,2016,964,510,454,112.3,938,497,441,112.7
23020, 동구,055002, 51세,2016,1091,555,536,103.5,1061,542,519,104.4
23020, 동구,055003, 52세,2016,987,515,472,109.1,969,508,461,110.2
23020, 동구,055004, 53세,2016,1057,560,497,112.7,1031,545,486,112.1
23020, 동구,055005, 54세,2016,1147,591,556,106.3,1128,585,543,107.7
23020, 동구,060,55~59세,2016,6086,2988,3098,96.4,6007,2949,3058,96.4
23020, 동구,060001, 55세,2016,1207,603,604,99.8,1192,594,598,99.3
23020, 동구,060002, 56세,2016,1302,640,662,96.7,1280,632,648,97.5
23020, 동구,060003, 57세,2016,1199,585,614,95.3,1185,579,606,95.5
23020, 동구,060004, 58세,2016,1206,593,613,96.7,1193,586,607,96.5
23020, 동구,060005, 59세,2016,1172,567,605,93.7,1157,558,599,93.2
23020, 동구,065,60~64세,2016,5058,2462,2596,94.8,4986,2434,2552,95.4
23020, 동구,065001, 60세,2016,1126,552,574,96.2,1110,549,561,97.9
23020, 동구,065002, 61세,2016,1151,555,596,93.1,1138,546,592,92.2
23020, 동구,065003, 62세,2016,965,490,475,103.2,950,485,465,104.3
23020, 동구,065004, 63세,2016,831,400,431,92.8,818,394,424,92.9
23020, 동구,065005, 64세,2016,985,465,520,89.4,970,460,510,90.2
23020, 동구,070,65~69세,2016,3886,1776,2110,84.2,3853,1761,2092,84.2
23020, 동구,070001, 65세,2016,655,277,378,73.3,648,274,374,73.3
23020, 동구,070002, 66세,2016,806,393,413,95.2,802,393,409,96.1
23020, 동구,070003, 67세,2016,795,359,436,82.3,783,351,432,81.3
23020, 동구,070004, 68세,2016,818,378,440,85.9,813,377,436,86.5
23020, 동구,070005, 69세,2016,812,369,443,83.3,807,366,441,83
23020, 동구,075,70~74세,2016,3365,1519,1846,82.3,3356,1515,1841,82.3
23020, 동구,075001, 70세,2016,684,307,377,81.4,682,307,375,81.9
23020, 동구,075002, 71세,2016,649,314,335,93.7,647,313,334,93.7
23020, 동구,075003, 72세,2016,643,281,362,77.6,641,280,361,77.6
23020, 동구,075004, 73세,2016,640,279,361,77.3,638,278,360,77.2
23020, 동구,075005, 74세,2016,749,338,411,82.2,748,337,411,82
23020, 동구,080,75~79세,2016,2509,1045,1464,71.4,2501,1041,1460,71.3
23020, 동구,080001, 75세,2016,593,256,337,76,589,255,334,76.3
23020, 동구,080002, 76세,2016,498,230,268,85.8,498,230,268,85.8
23020, 동구,080003, 77세,2016,569,227,342,66.4,568,226,342,66.1
23020, 동구,080004, 78세,2016,452,181,271,66.8,450,180,270,66.7
23020, 동구,080005, 79세,2016,397,151,246,61.4,396,150,246,61
23020, 동구,085,80~84세,2016,1518,479,1039,46.1,1512,476,1036,45.9
23020, 동구,085001, 80세,2016,385,151,234,64.5,385,151,234,64.5
23020, 동구,085002, 81세,2016,353,108,245,44.1,350,106,244,43.4
23020, 동구,085003, 82세,2016,287,83,204,40.7,287,83,204,40.7
23020, 동구,085004, 83세,2016,249,66,183,36.1,248,66,182,36.3
23020, 동구,085005, 84세,2016,244,71,173,41,242,70,172,40.7
23020, 동구,090,85~89세,2016,712,203,509,39.9,711,203,508,40
23020, 동구,090001, 85세,2016,168,54,114,47.4,168,54,114,47.4
23020, 동구,090002, 86세,2016,179,50,129,38.8,178,50,128,39.1
23020, 동구,090003, 87세,2016,133,40,93,43,133,40,93,43
23020, 동구,090004, 88세,2016,132,30,102,29.4,132,30,102,29.4
23020, 동구,090005, 89세,2016,100,29,71,40.8,100,29,71,40.8
23020, 동구,095,90~94세,2016,220,53,167,31.7,220,53,167,31.7
23020, 동구,095001, 90세,2016,55,14,41,34.1,55,14,41,34.1
23020, 동구,095002, 91세,2016,38,6,32,18.8,38,6,32,18.8
23020, 동구,095003, 92세,2016,55,11,44,25,55,11,44,25
23020, 동구,095004, 93세,2016,50,17,33,51.5,50,17,33,51.5
23020, 동구,095005, 94세,2016,22,5,17,29.4,22,5,17,29.4
23020, 동구,100,95~99세,2016,59,15,44,34.1,59,15,44,34.1
23020, 동구,100001, 95세,2016,24,6,18,33.3,24,6,18,33.3
23020, 동구,100002, 96세,2016,17,X,13,30.8,17,X,13,30.8
23020, 동구,100003, 97세,2016,6,X,5,20,6,X,5,20
23020, 동구,100004, 98세,2016,5,X,X,66.7,5,X,X,66.7
23020, 동구,100005, 99세,2016,7,X,5,40,7,X,5,40
23020, 동구,101,100세이상,2016,5,X,X,25,5,X,X,25
23020, 동구,102,15세미만,2016,8591,4452,4139,107.6,8546,4429,4117,107.6
23020, 동구,103,15~64세,2016,48584,25356,23228,109.2,47606,24811,22795,108.8
23020, 동구,104,65세이상,2016,12274,5091,7183,70.9,12217,5065,7152,70.8
23020, 동구,086,85세이상,2016,996,272,724,37.6,995,272,723,37.6
23020, 동구,126,평균연령,2016,43.6,42.1,45.1,,43.6,42.1,45.1,
23020, 동구,127,중위연령,2016,44.4,43,46.2,,44.5,43.1,46.3,
23030, 남구,000,합계,2016,416414,210957,205457,102.7,407404,206387,201017,102.7
23030, 남구,005,0~4세,2016,16919,8650,8269,104.6,16694,8537,8157,104.7
23030, 남구,005001, 0세,2016,3226,1634,1592,102.6,3157,1600,1557,102.8
23030, 남구,005002, 1세,2016,3473,1804,1669,108.1,3441,1789,1652,108.3
23030, 남구,005003, 2세,2016,3285,1652,1633,101.2,3239,1626,1613,100.8
23030, 남구,005004, 3세,2016,3378,1729,1649,104.9,3338,1710,1628,105
23030, 남구,005005, 4세,2016,3557,1831,1726,106.1,3519,1812,1707,106.2
23030, 남구,010,5~9세,2016,16404,8493,7911,107.4,16275,8418,7857,107.1
23030, 남구,010001, 5세,2016,3542,1871,1671,112,3510,1856,1654,112.2
23030, 남구,010002, 6세,2016,3235,1638,1597,102.6,3199,1618,1581,102.3
23030, 남구,010003, 7세,2016,3103,1577,1526,103.3,3082,1563,1519,102.9
23030, 남구,010004, 8세,2016,3249,1673,1576,106.2,3231,1661,1570,105.8
23030, 남구,010005, 9세,2016,3275,1734,1541,112.5,3253,1720,1533,112.2
23030, 남구,015,10~14세,2016,15457,8010,7447,107.6,15384,7964,7420,107.3
23030, 남구,015001, 10세,2016,2886,1500,1386,108.2,2872,1489,1383,107.7
23030, 남구,015002, 11세,2016,2898,1475,1423,103.7,2884,1468,1416,103.7
23030, 남구,015003, 12세,2016,3083,1625,1458,111.5,3067,1615,1452,111.2
23030, 남구,015004, 13세,2016,3268,1686,1582,106.6,3257,1678,1579,106.3
23030, 남구,015005, 14세,2016,3322,1724,1598,107.9,3304,1714,1590,107.8
23030, 남구,020,15~19세,2016,22506,11704,10802,108.4,22201,11561,10640,108.7
23030, 남구,020001, 15세,2016,3770,1892,1878,100.7,3750,1878,1872,100.3
23030, 남구,020002, 16세,2016,4088,2150,1938,110.9,4063,2134,1929,110.6
23030, 남구,020003, 17세,2016,4234,2191,2043,107.2,4205,2176,2029,107.2
23030, 남구,020004, 18세,2016,4729,2476,2253,109.9,4657,2438,2219,109.9
23030, 남구,020005, 19세,2016,5685,2995,2690,111.3,5526,2935,2591,113.3
23030, 남구,025,20~24세,2016,31672,17202,14470,118.9,30524,16697,13827,120.8
23030, 남구,025001, 20세,2016,5938,3070,2868,107,5689,2970,2719,109.2
23030, 남구,025002, 21세,2016,5877,3120,2757,113.2,5651,3024,2627,115.1
23030, 남구,025003, 22세,2016,6365,3527,2838,124.3,6137,3431,2706,126.8
23030, 남구,025004, 23세,2016,6629,3713,2916,127.3,6420,3616,2804,129
23030, 남구,025005, 24세,2016,6863,3772,3091,122,6627,3656,2971,123.1
23030, 남구,030,25~29세,2016,29541,16211,13330,121.6,28211,15501,12710,122
23030, 남구,030001, 25세,2016,6434,3600,2834,127,6197,3480,2717,128.1
23030, 남구,030002, 26세,2016,5977,3298,2679,123.1,5714,3163,2551,124
23030, 남구,030003, 27세,2016,5906,3250,2656,122.4,5639,3119,2520,123.8
23030, 남구,030004, 28세,2016,5537,2977,2560,116.3,5276,2831,2445,115.8
23030, 남구,030005, 29세,2016,5687,3086,2601,118.6,5385,2908,2477,117.4
23030, 남구,035,30~34세,2016,31011,16570,14441,114.7,29750,15848,13902,114
23030, 남구,035001, 30세,2016,5618,3033,2585,117.3,5357,2897,2460,117.8
23030, 남구,035002, 31세,2016,5742,3079,2663,115.6,5458,2926,2532,115.6
23030, 남구,035003, 32세,2016,6055,3236,2819,114.8,5818,3093,2725,113.5
23030, 남구,035004, 33세,2016,6572,3435,3137,109.5,6343,3294,3049,108
23030, 남구,035005, 34세,2016,7024,3787,3237,117,6774,3638,3136,116
23030, 남구,040,35~39세,2016,33346,17892,15454,115.8,32432,17378,15054,115.4
23030, 남구,040001, 35세,2016,7260,3881,3379,114.9,7042,3751,3291,114
23030, 남구,040002, 36세,2016,7143,3826,3317,115.3,6935,3709,3226,115
23030, 남구,040003, 37세,2016,6859,3736,3123,119.6,6681,3631,3050,119
23030, 남구,040004, 38세,2016,6163,3268,2895,112.9,5983,3175,2808,113.1
23030, 남구,040005, 39세,2016,5921,3181,2740,116.1,5791,3112,2679,116.2
23030, 남구,045,40~44세,2016,32486,17231,15255,113,31744,16832,14912,112.9
23030, 남구,045001, 40세,2016,5757,3035,2722,111.5,5615,2960,2655,111.5
23030, 남구,045002, 41세,2016,6287,3383,2904,116.5,6144,3304,2840,116.3
23030, 남구,045003, 42세,2016,6615,3508,3107,112.9,6473,3440,3033,113.4
23030, 남구,045004, 43세,2016,6814,3569,3245,110,6652,3475,3177,109.4
23030, 남구,045005, 44세,2016,7013,3736,3277,114,6860,3653,3207,113.9
23030, 남구,050,45~49세,2016,34412,17528,16884,103.8,33623,17115,16508,103.7
23030, 남구,050001, 45세,2016,7052,3648,3404,107.2,6883,3559,3324,107.1
23030, 남구,050002, 46세,2016,6971,3547,3424,103.6,6781,3438,3343,102.8
23030, 남구,050003, 47세,2016,7095,3678,3417,107.6,6940,3605,3335,108.1
23030, 남구,050004, 48세,2016,6949,3507,3442,101.9,6789,3432,3357,102.2
23030, 남구,050005, 49세,2016,6345,3148,3197,98.5,6230,3081,3149,97.8
23030, 남구,055,50~54세,2016,33530,16736,16794,99.7,32837,16419,16418,100
23030, 남구,055001, 50세,2016,6260,3150,3110,101.3,6136,3089,3047,101.4
23030, 남구,055002, 51세,2016,6833,3347,3486,96,6691,3278,3413,96
23030, 남구,055003, 52세,2016,6434,3227,3207,100.6,6305,3164,3141,100.7
23030, 남구,055004, 53세,2016,6900,3466,3434,100.9,6726,3396,3330,102
23030, 남구,055005, 54세,2016,7103,3546,3557,99.7,6979,3492,3487,100.1
23030, 남구,060,55~59세,2016,35740,17373,18367,94.6,35216,17131,18085,94.7
23030, 남구,060001, 55세,2016,7589,3676,3913,93.9,7501,3639,3862,94.2
23030, 남구,060002, 56세,2016,7707,3750,3957,94.8,7595,3696,3899,94.8
23030, 남구,060003, 57세,2016,7088,3476,3612,96.2,6995,3430,3565,96.2
23030, 남구,060004, 58세,2016,6745,3255,3490,93.3,6625,3201,3424,93.5
23030, 남구,060005, 59세,2016,6611,3216,3395,94.7,6500,3165,3335,94.9
23030, 남구,065,60~64세,2016,26755,12796,13959,91.7,26315,12593,13722,91.8
23030, 남구,065001, 60세,2016,6122,2934,3188,92,6028,2891,3137,92.2
23030, 남구,065002, 61세,2016,6151,2920,3231,90.4,6041,2870,3171,90.5
23030, 남구,065003, 62세,2016,5122,2427,2695,90.1,5026,2387,2639,90.5
23030, 남구,065004, 63세,2016,4413,2133,2280,93.6,4339,2090,2249,92.9
23030, 남구,065005, 64세,2016,4947,2382,2565,92.9,4881,2355,2526,93.2
23030, 남구,070,65~69세,2016,19416,9320,10096,92.3,19202,9230,9972,92.6
23030, 남구,070001, 65세,2016,3354,1614,1740,92.8,3292,1585,1707,92.9
23030, 남구,070002, 66세,2016,3964,1934,2030,95.3,3918,1916,2002,95.7
23030, 남구,070003, 67세,2016,4120,1983,2137,92.8,4075,1959,2116,92.6
23030, 남구,070004, 68세,2016,3934,1886,2048,92.1,3900,1877,2023,92.8
23030, 남구,070005, 69세,2016,4044,1903,2141,88.9,4017,1893,2124,89.1
23030, 남구,075,70~74세,2016,15244,7050,8194,86,15152,7016,8136,86.2
23030, 남구,075001, 70세,2016,3041,1429,1612,88.6,3017,1422,1595,89.2
23030, 남구,075002, 71세,2016,2960,1387,1573,88.2,2937,1377,1560,88.3
23030, 남구,075003, 72세,2016,2897,1323,1574,84.1,2879,1317,1562,84.3
23030, 남구,075004, 73세,2016,2935,1343,1592,84.4,2921,1340,1581,84.8
23030, 남구,075005, 74세,2016,3411,1568,1843,85.1,3398,1560,1838,84.9
23030, 남구,080,75~79세,2016,11326,4798,6528,73.5,11260,4778,6482,73.7
23030, 남구,080001, 75세,2016,2612,1144,1468,77.9,2600,1140,1460,78.1
23030, 남구,080002, 76세,2016,2378,1024,1354,75.6,2364,1022,1342,76.2
23030, 남구,080003, 77세,2016,2338,1001,1337,74.9,2323,995,1328,74.9
23030, 남구,080004, 78세,2016,2147,891,1256,70.9,2134,886,1248,71
23030, 남구,080005, 79세,2016,1851,738,1113,66.3,1839,735,1104,66.6
23030, 남구,085,80~84세,2016,6414,2262,4152,54.5,6380,2247,4133,54.4
23030, 남구,085001, 80세,2016,1628,638,990,64.4,1620,633,987,64.1
23030, 남구,085002, 81세,2016,1550,591,959,61.6,1538,585,953,61.4
23030, 남구,085003, 82세,2016,1247,421,826,51,1238,418,820,51
23030, 남구,085004, 83세,2016,1039,320,719,44.5,1036,319,717,44.5
23030, 남구,085005, 84세,2016,950,292,658,44.4,948,292,656,44.5
23030, 남구,090,85~89세,2016,2977,831,2146,38.7,2957,827,2130,38.8
23030, 남구,090001, 85세,2016,723,226,497,45.5,717,226,491,46
23030, 남구,090002, 86세,2016,701,184,517,35.6,697,184,513,35.9
23030, 남구,090003, 87세,2016,660,190,470,40.4,656,189,467,40.5
23030, 남구,090004, 88세,2016,505,135,370,36.5,502,133,369,36
23030, 남구,090005, 89세,2016,388,96,292,32.9,385,95,290,32.8
23030, 남구,095,90~94세,2016,991,233,758,30.7,983,231,752,30.7
23030, 남구,095001, 90세,2016,285,63,222,28.4,283,63,220,28.6
23030, 남구,095002, 91세,2016,265,61,204,29.9,262,60,202,29.7
23030, 남구,095003, 92세,2016,167,40,127,31.5,167,40,127,31.5
23030, 남구,095004, 93세,2016,152,42,110,38.2,152,42,110,38.2
23030, 남구,095005, 94세,2016,122,27,95,28.4,119,26,93,28
23030, 남구,100,95~99세,2016,227,56,171,32.7,225,54,171,31.6
23030, 남구,100001, 95세,2016,81,23,58,39.7,80,22,58,37.9
23030, 남구,100002, 96세,2016,56,11,45,24.4,56,11,45,24.4
23030, 남구,100003, 97세,2016,49,17,32,53.1,49,17,32,53.1
23030, 남구,100004, 98세,2016,19,X,16,18.8,18,X,16,12.5
23030, 남구,100005, 99세,2016,22,X,20,10,22,X,20,10
23030, 남구,101,100세이상,2016,40,11,29,37.9,39,10,29,34.5
23030, 남구,102,15세미만,2016,48780,25153,23627,106.5,48353,24919,23434,106.3
23030, 남구,103,15~64세,2016,310999,161243,149756,107.7,302853,157075,145778,107.7
23030, 남구,104,65세이상,2016,56635,24561,32074,76.6,56198,24393,31805,76.7
23030, 남구,086,85세이상,2016,4235,1131,3104,36.4,4204,1122,3082,36.4
23030, 남구,126,평균연령,2016,41.4,40.2,42.7,,41.5,40.2,42.8,
23030, 남구,127,중위연령,2016,41.9,40.2,43.6,,42.1,40.4,43.8,
23040, 연수구,000,합계,2016,329886,164549,165337,99.5,320536,159732,160804,99.3
23040, 연수구,005,0~4세,2016,15508,7904,7604,103.9,15084,7677,7407,103.6
23040, 연수구,005001, 0세,2016,2698,1337,1361,98.2,2626,1299,1327,97.9
23040, 연수구,005002, 1세,2016,3027,1536,1491,103,2944,1491,1453,102.6
23040, 연수구,005003, 2세,2016,3087,1577,1510,104.4,2989,1535,1454,105.6
23040, 연수구,005004, 3세,2016,3247,1667,1580,105.5,3162,1615,1547,104.4
23040, 연수구,005005, 4세,2016,3449,1787,1662,107.5,3363,1737,1626,106.8
23040, 연수구,010,5~9세,2016,17727,9131,8596,106.2,17364,8932,8432,105.9
23040, 연수구,010001, 5세,2016,3530,1807,1723,104.9,3441,1763,1678,105.1
23040, 연수구,010002, 6세,2016,3407,1762,1645,107.1,3340,1729,1611,107.3
23040, 연수구,010003, 7세,2016,3474,1823,1651,110.4,3396,1776,1620,109.6
23040, 연수구,010004, 8세,2016,3625,1833,1792,102.3,3549,1789,1760,101.6
23040, 연수구,010005, 9세,2016,3691,1906,1785,106.8,3638,1875,1763,106.4
23040, 연수구,015,10~14세,2016,17902,9172,8730,105.1,17653,9044,8609,105.1
23040, 연수구,015001, 10세,2016,3371,1725,1646,104.8,3323,1702,1621,105
23040, 연수구,015002, 11세,2016,3352,1706,1646,103.6,3308,1680,1628,103.2
23040, 연수구,015003, 12세,2016,3713,1901,1812,104.9,3658,1873,1785,104.9
23040, 연수구,015004, 13세,2016,3678,1852,1826,101.4,3627,1828,1799,101.6
23040, 연수구,015005, 14세,2016,3788,1988,1800,110.4,3737,1961,1776,110.4
23040, 연수구,020,15~19세,2016,24139,12466,11673,106.8,23680,12260,11420,107.4
23040, 연수구,020001, 15세,2016,4154,2180,1974,110.4,4107,2158,1949,110.7
23040, 연수구,020002, 16세,2016,4346,2233,2113,105.7,4294,2199,2095,105
23040, 연수구,020003, 17세,2016,4254,2237,2017,110.9,4183,2202,1981,111.2
23040, 연수구,020004, 18세,2016,5081,2645,2436,108.6,4965,2593,2372,109.3
23040, 연수구,020005, 19세,2016,6304,3171,3133,101.2,6131,3108,3023,102.8
23040, 연수구,025,20~24세,2016,25079,13017,12062,107.9,24162,12652,11510,109.9
23040, 연수구,025001, 20세,2016,5484,2877,2607,110.4,5282,2815,2467,114.1
23040, 연수구,025002, 21세,2016,5010,2647,2363,112,4833,2584,2249,114.9
23040, 연수구,025003, 22세,2016,4682,2434,2248,108.3,4512,2366,2146,110.3
23040, 연수구,025004, 23세,2016,4903,2547,2356,108.1,4723,2460,2263,108.7
23040, 연수구,025005, 24세,2016,5000,2512,2488,101,4812,2427,2385,101.8
23040, 연수구,030,25~29세,2016,22271,11484,10787,106.5,20964,10819,10145,106.6
23040, 연수구,030001, 25세,2016,4817,2475,2342,105.7,4620,2377,2243,106
23040, 연수구,030002, 26세,2016,4595,2397,2198,109.1,4353,2268,2085,108.8
23040, 연수구,030003, 27세,2016,4519,2318,2201,105.3,4240,2175,2065,105.3
23040, 연수구,030004, 28세,2016,4256,2249,2007,112.1,3961,2097,1864,112.5
23040, 연수구,030005, 29세,2016,4084,2045,2039,100.3,3790,1902,1888,100.7
23040, 연수구,035,30~34세,2016,22472,11304,11168,101.2,21099,10533,10566,99.7
23040, 연수구,035001, 30세,2016,4080,2078,2002,103.8,3793,1928,1865,103.4
23040, 연수구,035002, 31세,2016,4141,2136,2005,106.5,3868,1984,1884,105.3
23040, 연수구,035003, 32세,2016,4298,2168,2130,101.8,4020,2010,2010,100
23040, 연수구,035004, 33세,2016,4767,2326,2441,95.3,4479,2164,2315,93.5
23040, 연수구,035005, 34세,2016,5186,2596,2590,100.2,4939,2447,2492,98.2
23040, 연수구,040,35~39세,2016,26252,12909,13343,96.7,25123,12281,12842,95.6
23040, 연수구,040001, 35세,2016,5385,2614,2771,94.3,5143,2482,2661,93.3
23040, 연수구,040002, 36세,2016,5416,2689,2727,98.6,5185,2552,2633,96.9
23040, 연수구,040003, 37세,2016,5351,2628,2723,96.5,5114,2504,2610,95.9
23040, 연수구,040004, 38세,2016,5003,2458,2545,96.6,4787,2337,2450,95.4
23040, 연수구,040005, 39세,2016,5097,2520,2577,97.8,4894,2406,2488,96.7
23040, 연수구,045,40~44세,2016,29222,14161,15061,94,28363,13680,14683,93.2
23040, 연수구,045001, 40세,2016,5090,2520,2570,98.1,4915,2414,2501,96.5
23040, 연수구,045002, 41세,2016,5563,2714,2849,95.3,5393,2615,2778,94.1
23040, 연수구,045003, 42세,2016,6047,2926,3121,93.8,5887,2831,3056,92.6
23040, 연수구,045004, 43세,2016,6213,2922,3291,88.8,6037,2838,3199,88.7
23040, 연수구,045005, 44세,2016,6309,3079,3230,95.3,6131,2982,3149,94.7
23040, 연수구,050,45~49세,2016,32003,15559,16444,94.6,31228,15148,16080,94.2
23040, 연수구,050001, 45세,2016,6715,3275,3440,95.2,6552,3192,3360,95
23040, 연수구,050002, 46세,2016,6474,3178,3296,96.4,6313,3084,3229,95.5
23040, 연수구,050003, 47세,2016,6610,3196,3414,93.6,6450,3107,3343,92.9
23040, 연수구,050004, 48세,2016,6373,3069,3304,92.9,6193,2987,3206,93.2
23040, 연수구,050005, 49세,2016,5831,2841,2990,95,5720,2778,2942,94.4
23040, 연수구,055,50~54세,2016,29638,14797,14841,99.7,29026,14469,14557,99.4
23040, 연수구,055001, 50세,2016,5751,2791,2960,94.3,5630,2734,2896,94.4
23040, 연수구,055002, 51세,2016,6026,2966,3060,96.9,5888,2886,3002,96.1
23040, 연수구,055003, 52세,2016,5754,2848,2906,98,5634,2787,2847,97.9
23040, 연수구,055004, 53세,2016,6129,3147,2982,105.5,5988,3071,2917,105.3
23040, 연수구,055005, 54세,2016,5978,3045,2933,103.8,5886,2991,2895,103.3
23040, 연수구,060,55~59세,2016,26030,13699,12331,111.1,25648,13515,12133,111.4
23040, 연수구,060001, 55세,2016,6116,3181,2935,108.4,6041,3147,2894,108.7
23040, 연수구,060002, 56세,2016,5978,3141,2837,110.7,5874,3079,2795,110.2
23040, 연수구,060003, 57세,2016,5048,2647,2401,110.2,4991,2622,2369,110.7
23040, 연수구,060004, 58세,2016,4623,2487,2136,116.4,4539,2452,2087,117.5
23040, 연수구,060005, 59세,2016,4265,2243,2022,110.9,4203,2215,1988,111.4
23040, 연수구,065,60~64세,2016,15032,7885,7147,110.3,14780,7778,7002,111.1
23040, 연수구,065001, 60세,2016,3691,1921,1770,108.5,3635,1896,1739,109
23040, 연수구,065002, 61세,2016,3584,1866,1718,108.6,3522,1840,1682,109.4
23040, 연수구,065003, 62세,2016,2893,1579,1314,120.2,2840,1555,1285,121
23040, 연수구,065004, 63세,2016,2342,1191,1151,103.5,2304,1178,1126,104.6
23040, 연수구,065005, 64세,2016,2522,1328,1194,111.2,2479,1309,1170,111.9
23040, 연수구,070,65~69세,2016,8688,4213,4475,94.1,8572,4156,4416,94.1
23040, 연수구,070001, 65세,2016,1555,783,772,101.4,1522,767,755,101.6
23040, 연수구,070002, 66세,2016,1768,880,888,99.1,1745,870,875,99.4
23040, 연수구,070003, 67세,2016,1851,928,923,100.5,1825,913,912,100.1
23040, 연수구,070004, 68세,2016,1768,835,933,89.5,1746,825,921,89.6
23040, 연수구,070005, 69세,2016,1746,787,959,82.1,1734,781,953,82
23040, 연수구,075,70~74세,2016,6609,3002,3607,83.2,6550,2975,3575,83.2
23040, 연수구,075001, 70세,2016,1375,661,714,92.6,1355,654,701,93.3
23040, 연수구,075002, 71세,2016,1202,576,626,92,1190,567,623,91
23040, 연수구,075003, 72세,2016,1216,563,653,86.2,1208,561,647,86.7
23040, 연수구,075004, 73세,2016,1353,586,767,76.4,1346,584,762,76.6
23040, 연수구,075005, 74세,2016,1463,616,847,72.7,1451,609,842,72.3
23040, 연수구,080,75~79세,2016,5305,2105,3200,65.8,5267,2083,3184,65.4
23040, 연수구,080001, 75세,2016,1204,532,672,79.2,1195,527,668,78.9
23040, 연수구,080002, 76세,2016,1069,425,644,66,1060,419,641,65.4
23040, 연수구,080003, 77세,2016,1096,408,688,59.3,1092,405,687,59
23040, 연수구,080004, 78세,2016,1015,399,616,64.8,1008,395,613,64.4
23040, 연수구,080005, 79세,2016,921,341,580,58.8,912,337,575,58.6
23040, 연수구,085,80~84세,2016,3480,1108,2372,46.7,3466,1103,2363,46.7
23040, 연수구,085001, 80세,2016,808,282,526,53.6,803,280,523,53.5
23040, 연수구,085002, 81세,2016,827,270,557,48.5,824,268,556,48.2
23040, 연수구,085003, 82세,2016,687,219,468,46.8,685,219,466,47
23040, 연수구,085004, 83세,2016,608,180,428,42.1,606,179,427,41.9
23040, 연수구,085005, 84세,2016,550,157,393,39.9,548,157,391,40.2
23040, 연수구,090,85~89세,2016,1781,462,1319,35,1768,458,1310,35
23040, 연수구,090001, 85세,2016,452,112,340,32.9,448,110,338,32.5
23040, 연수구,090002, 86세,2016,423,113,310,36.5,421,112,309,36.2
23040, 연수구,090003, 87세,2016,353,97,256,37.9,352,96,256,37.5
23040, 연수구,090004, 88세,2016,307,73,234,31.2,303,73,230,31.7
23040, 연수구,090005, 89세,2016,246,67,179,37.4,244,67,177,37.9
23040, 연수구,095,90~94세,2016,595,137,458,29.9,589,135,454,29.7
23040, 연수구,095001, 90세,2016,161,30,131,22.9,158,29,129,22.5
23040, 연수구,095002, 91세,2016,158,31,127,24.4,158,31,127,24.4
23040, 연수구,095003, 92세,2016,111,31,80,38.8,109,30,79,38
23040, 연수구,095004, 93세,2016,99,30,69,43.5,98,30,68,44.1
23040, 연수구,095005, 94세,2016,66,15,51,29.4,66,15,51,29.4
23040, 연수구,100,95~99세,2016,143,33,110,30,140,33,107,30.8
23040, 연수구,100001, 95세,2016,53,11,42,26.2,52,11,41,26.8
23040, 연수구,100002, 96세,2016,31,9,22,40.9,30,9,21,42.9
23040, 연수구,100003, 97세,2016,37,11,26,42.3,36,11,25,44
23040, 연수구,100004, 98세,2016,10,X,10,0,10,X,10,0
23040, 연수구,100005, 99세,2016,12,X,10,20,12,X,10,20
23040, 연수구,101,100세이상,2016,10,X,9,11.1,10,X,9,11.1
23040, 연수구,102,15세미만,2016,51137,26207,24930,105.1,50101,25653,24448,104.9
23040, 연수구,103,15~64세,2016,252138,127281,124857,101.9,244073,123135,120938,101.8
23040, 연수구,104,65세이상,2016,26611,11061,15550,71.1,26362,10944,15418,71
23040, 연수구,086,85세이상,2016,2529,633,1896,33.4,2507,627,1880,33.4
23040, 연수구,126,평균연령,2016,37.7,37,38.5,,37.9,37.1,38.6,
23040, 연수구,127,중위연령,2016,38.7,37.9,39.5,,39,38.2,39.8,
23050, 남동구,000,합계,2016,528939,265857,263082,101.1,514309,255798,258511,99
23050, 남동구,005,0~4세,2016,25379,13020,12359,105.3,25193,12924,12269,105.3
23050, 남동구,005001, 0세,2016,4609,2380,2229,106.8,4571,2360,2211,106.7
23050, 남동구,005002, 1세,2016,4941,2531,2410,105,4902,2512,2390,105.1
23050, 남동구,005003, 2세,2016,5005,2613,2392,109.2,4975,2596,2379,109.1
23050, 남동구,005004, 3세,2016,5182,2612,2570,101.6,5138,2590,2548,101.6
23050, 남동구,005005, 4세,2016,5642,2884,2758,104.6,5607,2866,2741,104.6
23050, 남동구,010,5~9세,2016,26466,13565,12901,105.1,26336,13498,12838,105.1
23050, 남동구,010001, 5세,2016,5508,2851,2657,107.3,5476,2835,2641,107.3
23050, 남동구,010002, 6세,2016,5325,2712,2613,103.8,5296,2697,2599,103.8
23050, 남동구,010003, 7세,2016,5205,2663,2542,104.8,5177,2648,2529,104.7
23050, 남동구,010004, 8세,2016,5204,2637,2567,102.7,5181,2625,2556,102.7
23050, 남동구,010005, 9세,2016,5224,2702,2522,107.1,5206,2693,2513,107.2
23050, 남동구,015,10~14세,2016,24240,12450,11790,105.6,24147,12402,11745,105.6
23050, 남동구,015001, 10세,2016,4781,2489,2292,108.6,4762,2480,2282,108.7
23050, 남동구,015002, 11세,2016,4546,2307,2239,103,4529,2299,2230,103.1
23050, 남동구,015003, 12세,2016,4829,2466,2363,104.4,4806,2454,2352,104.3
23050, 남동구,015004, 13세,2016,5044,2610,2434,107.2,5028,2599,2429,107
23050, 남동구,015005, 14세,2016,5040,2578,2462,104.7,5022,2570,2452,104.8
23050, 남동구,020,15~19세,2016,29831,15264,14567,104.8,29733,15211,14522,104.7
23050, 남동구,020001, 15세,2016,5930,3057,2873,106.4,5913,3048,2865,106.4
23050, 남동구,020002, 16세,2016,6268,3102,3166,98,6249,3090,3159,97.8
23050, 남동구,020003, 17세,2016,6118,3162,2956,107,6100,3151,2949,106.8
23050, 남동구,020004, 18세,2016,6039,3088,2951,104.6,6024,3082,2942,104.8
23050, 남동구,020005, 19세,2016,5476,2855,2621,108.9,5447,2840,2607,108.9
23050, 남동구,025,20~24세,2016,34646,18363,16283,112.8,33622,17621,16001,110.1
23050, 남동구,025001, 20세,2016,6094,3334,2760,120.8,6051,3310,2741,120.8
23050, 남동구,025002, 21세,2016,6738,3706,3032,122.2,6594,3612,2982,121.1
23050, 남동구,025003, 22세,2016,6792,3620,3172,114.1,6591,3469,3122,111.1
23050, 남동구,025004, 23세,2016,7366,3836,3530,108.7,7089,3630,3459,104.9
23050, 남동구,025005, 24세,2016,7656,3867,3789,102.1,7297,3600,3697,97.4
23050, 남동구,030,25~29세,2016,35676,18674,17002,109.8,33005,16679,16326,102.2
23050, 남동구,030001, 25세,2016,7449,3880,3569,108.7,7000,3551,3449,103
23050, 남동구,030002, 26세,2016,7304,3799,3505,108.4,6768,3400,3368,101
23050, 남동구,030003, 27세,2016,6954,3627,3327,109,6440,3241,3199,101.3
23050, 남동구,030004, 28세,2016,7008,3675,3333,110.3,6426,3231,3195,101.1
23050, 남동구,030005, 29세,2016,6961,3693,3268,113,6371,3256,3115,104.5
23050, 남동구,035,30~34세,2016,41314,21896,19418,112.8,38328,19599,18729,104.6
23050, 남동구,035001, 30세,2016,7324,3868,3456,111.9,6723,3408,3315,102.8
23050, 남동구,035002, 31세,2016,7505,4021,3484,115.4,6896,3556,3340,106.5
23050, 남동구,035003, 32세,2016,7875,4220,3655,115.5,7263,3759,3504,107.3
23050, 남동구,035004, 33세,2016,8861,4651,4210,110.5,8264,4188,4076,102.7
23050, 남동구,035005, 34세,2016,9749,5136,4613,111.3,9182,4688,4494,104.3
23050, 남동구,040,35~39세,2016,47075,24510,22565,108.6,44860,22800,22060,103.4
23050, 남동구,040001, 35세,2016,9846,5166,4680,110.4,9330,4763,4567,104.3
23050, 남동구,040002, 36세,2016,10077,5216,4861,107.3,9577,4826,4751,101.6
23050, 남동구,040003, 37세,2016,9514,4961,4553,109,9041,4597,4444,103.4
23050, 남동구,040004, 38세,2016,8783,4557,4226,107.8,8402,4257,4145,102.7
23050, 남동구,040005, 39세,2016,8855,4610,4245,108.6,8510,4357,4153,104.9
23050, 남동구,045,40~44세,2016,45346,23545,21801,108,43856,22496,21360,105.3
23050, 남동구,045001, 40세,2016,8394,4459,3935,113.3,8048,4205,3843,109.4
23050, 남동구,045002, 41세,2016,8853,4644,4209,110.3,8539,4421,4118,107.4
23050, 남동구,045003, 42세,2016,9405,4913,4492,109.4,9115,4688,4427,105.9
23050, 남동구,045004, 43세,2016,9386,4724,4662,101.3,9112,4541,4571,99.3
23050, 남동구,045005, 44세,2016,9308,4805,4503,106.7,9042,4641,4401,105.5
23050, 남동구,050,45~49세,2016,47645,23661,23984,98.7,46477,22939,23538,97.5
23050, 남동구,050001, 45세,2016,9793,4996,4797,104.1,9532,4828,4704,102.6
23050, 남동구,050002, 46세,2016,9634,4876,4758,102.5,9380,4705,4675,100.6
23050, 남동구,050003, 47세,2016,9771,4772,4999,95.5,9524,4628,4896,94.5
23050, 남동구,050004, 48세,2016,9764,4772,4992,95.6,9542,4641,4901,94.7
23050, 남동구,050005, 49세,2016,8683,4245,4438,95.7,8499,4137,4362,94.8
23050, 남동구,055,50~54세,2016,44570,22078,22492,98.2,43549,21510,22039,97.6
23050, 남동구,055001, 50세,2016,8558,4210,4348,96.8,8361,4093,4268,95.9
23050, 남동구,055002, 51세,2016,9254,4544,4710,96.5,9017,4406,4611,95.6
23050, 남동구,055003, 52세,2016,8516,4241,4275,99.2,8298,4129,4169,99
23050, 남동구,055004, 53세,2016,8930,4421,4509,98,8721,4312,4409,97.8
23050, 남동구,055005, 54세,2016,9312,4662,4650,100.3,9152,4570,4582,99.7
23050, 남동구,060,55~59세,2016,43667,21655,22012,98.4,43027,21325,21702,98.3
23050, 남동구,060001, 55세,2016,9943,4943,5000,98.9,9814,4876,4938,98.7
23050, 남동구,060002, 56세,2016,9628,4821,4807,100.3,9469,4736,4733,100.1
23050, 남동구,060003, 57세,2016,8525,4175,4350,96,8419,4117,4302,95.7
23050, 남동구,060004, 58세,2016,8127,4010,4117,97.4,8003,3946,4057,97.3
23050, 남동구,060005, 59세,2016,7444,3706,3738,99.1,7322,3650,3672,99.4
23050, 남동구,065,60~64세,2016,29140,14261,14879,95.8,28666,14052,14614,96.2
23050, 남동구,065001, 60세,2016,6516,3201,3315,96.6,6423,3157,3266,96.7
23050, 남동구,065002, 61세,2016,6852,3370,3482,96.8,6742,3323,3419,97.2
23050, 남동구,065003, 62세,2016,5687,2742,2945,93.1,5584,2697,2887,93.4
23050, 남동구,065004, 63세,2016,4847,2382,2465,96.6,4769,2345,2424,96.7
23050, 남동구,065005, 64세,2016,5238,2566,2672,96,5148,2530,2618,96.6
23050, 남동구,070,65~69세,2016,18977,9317,9660,96.4,18741,9204,9537,96.5
23050, 남동구,070001, 65세,2016,3486,1731,1755,98.6,3415,1694,1721,98.4
23050, 남동구,070002, 66세,2016,3983,1961,2022,97,3920,1937,1983,97.7
23050, 남동구,070003, 67세,2016,3944,1948,1996,97.6,3901,1927,1974,97.6
23050, 남동구,070004, 68세,2016,3780,1847,1933,95.6,3747,1831,1916,95.6
23050, 남동구,070005, 69세,2016,3784,1830,1954,93.7,3758,1815,1943,93.4
23050, 남동구,075,70~74세,2016,14057,6390,7667,83.3,13966,6362,7604,83.7
23050, 남동구,075001, 70세,2016,2946,1391,1555,89.5,2922,1385,1537,90.1
23050, 남동구,075002, 71세,2016,2670,1235,1435,86.1,2650,1228,1422,86.4
23050, 남동구,075003, 72세,2016,2689,1266,1423,89,2669,1259,1410,89.3
23050, 남동구,075004, 73세,2016,2674,1155,1519,76,2663,1153,1510,76.4
23050, 남동구,075005, 74세,2016,3078,1343,1735,77.4,3062,1337,1725,77.5
23050, 남동구,080,75~79세,2016,10230,4130,6100,67.7,10178,4112,6066,67.8
23050, 남동구,080001, 75세,2016,2364,992,1372,72.3,2344,985,1359,72.5
23050, 남동구,080002, 76세,2016,2171,895,1276,70.1,2161,892,1269,70.3
23050, 남동구,080003, 77세,2016,2109,836,1273,65.7,2105,834,1271,65.6
23050, 남동구,080004, 78세,2016,1910,755,1155,65.4,1900,752,1148,65.5
23050, 남동구,080005, 79세,2016,1676,652,1024,63.7,1668,649,1019,63.7
23050, 남동구,085,80~84세,2016,6255,2055,4200,48.9,6219,2045,4174,49
23050, 남동구,085001, 80세,2016,1593,554,1039,53.3,1580,551,1029,53.5
23050, 남동구,085002, 81세,2016,1459,514,945,54.4,1452,512,940,54.5
23050, 남동구,085003, 82세,2016,1192,383,809,47.3,1187,383,804,47.6
23050, 남동구,085004, 83세,2016,1058,340,718,47.4,1055,339,716,47.3
23050, 남동구,085005, 84세,2016,953,264,689,38.3,945,260,685,38
23050, 남동구,090,85~89세,2016,3121,758,2363,32.1,3107,756,2351,32.2
23050, 남동구,090001, 85세,2016,749,184,565,32.6,745,183,562,32.6
23050, 남동구,090002, 86세,2016,747,173,574,30.1,742,172,570,30.2
23050, 남동구,090003, 87세,2016,694,183,511,35.8,693,183,510,35.9
23050, 남동구,090004, 88세,2016,522,132,390,33.8,520,132,388,34
23050, 남동구,090005, 89세,2016,409,86,323,26.6,407,86,321,26.8
23050, 남동구,095,90~94세,2016,1044,213,831,25.6,1041,212,829,25.6
23050, 남동구,095001, 90세,2016,278,61,217,28.1,277,61,216,28.2
23050, 남동구,095002, 91세,2016,259,48,211,22.7,259,48,211,22.7
23050, 남동구,095003, 92세,2016,184,41,143,28.7,183,41,142,28.9
23050, 남동구,095004, 93세,2016,194,44,150,29.3,193,43,150,28.7
23050, 남동구,095005, 94세,2016,129,19,110,17.3,129,19,110,17.3
23050, 남동구,100,95~99세,2016,235,48,187,25.7,233,47,186,25.3
23050, 남동구,100001, 95세,2016,80,17,63,27,80,17,63,27
23050, 남동구,100002, 96세,2016,64,13,51,25.5,64,13,51,25.5
23050, 남동구,100003, 97세,2016,45,10,35,28.6,44,9,35,25.7
23050, 남동구,100004, 98세,2016,26,5,21,23.8,25,5,20,25
23050, 남동구,100005, 99세,2016,20,X,17,17.6,20,X,17,17.6
23050, 남동구,101,100세이상,2016,25,X,21,19,25,X,21,19
23050, 남동구,102,15세미만,2016,76085,39035,37050,105.4,75676,38824,36852,105.4
23050, 남동구,103,15~64세,2016,398910,203907,195003,104.6,385123,194232,190891,101.8
23050, 남동구,104,65세이상,2016,53944,22915,31029,73.9,53510,22742,30768,73.9
23050, 남동구,086,85세이상,2016,4425,1023,3402,30.1,4406,1019,3387,30.1
23050, 남동구,126,평균연령,2016,39.4,38.4,40.3,,39.4,38.5,40.3,
23050, 남동구,127,중위연령,2016,40,39,41.2,,40.2,39.3,41.2,
23060, 부평구,000,합계,2016,544319,270273,274046,98.6,530744,263272,267472,98.4
23060, 부평구,005,0~4세,2016,23430,11924,11506,103.6,22973,11691,11282,103.6
23060, 부평구,005001, 0세,2016,4656,2359,2297,102.7,4516,2284,2232,102.3
23060, 부평구,005002, 1세,2016,4821,2448,2373,103.2,4719,2400,2319,103.5
23060, 부평구,005003, 2세,2016,4753,2481,2272,109.2,4651,2426,2225,109
23060, 부평구,005004, 3세,2016,4421,2231,2190,101.9,4368,2208,2160,102.2
23060, 부평구,005005, 4세,2016,4779,2405,2374,101.3,4719,2373,2346,101.2
23060, 부평구,010,5~9세,2016,22740,11728,11012,106.5,22550,11632,10918,106.5
23060, 부평구,010001, 5세,2016,4674,2409,2265,106.4,4621,2378,2243,106
23060, 부평구,010002, 6세,2016,4394,2283,2111,108.1,4355,2263,2092,108.2
23060, 부평구,010003, 7세,2016,4383,2190,2193,99.9,4347,2176,2171,100.2
23060, 부평구,010004, 8세,2016,4505,2344,2161,108.5,4470,2328,2142,108.7
23060, 부평구,010005, 9세,2016,4784,2502,2282,109.6,4757,2487,2270,109.6
23060, 부평구,015,10~14세,2016,22921,11817,11104,106.4,22811,11766,11045,106.5
23060, 부평구,015001, 10세,2016,4238,2195,2043,107.4,4213,2186,2027,107.8
23060, 부평구,015002, 11세,2016,4228,2170,2058,105.4,4204,2155,2049,105.2
23060, 부평구,015003, 12세,2016,4545,2343,2202,106.4,4524,2333,2191,106.5
23060, 부평구,015004, 13세,2016,4818,2508,2310,108.6,4801,2500,2301,108.6
23060, 부평구,015005, 14세,2016,5092,2601,2491,104.4,5069,2592,2477,104.6
23060, 부평구,020,15~19세,2016,30965,15972,14993,106.5,30810,15898,14912,106.6
23060, 부평구,020001, 15세,2016,5635,2914,2721,107.1,5606,2904,2702,107.5
23060, 부평구,020002, 16세,2016,6317,3224,3093,104.2,6294,3210,3084,104.1
23060, 부평구,020003, 17세,2016,6340,3349,2991,112,6312,3334,2978,112
23060, 부평구,020004, 18세,2016,6436,3282,3154,104.1,6406,3266,3140,104
23060, 부평구,020005, 19세,2016,6237,3203,3034,105.6,6192,3184,3008,105.9
23060, 부평구,025,20~24세,2016,37926,19703,18223,108.1,37343,19417,17926,108.3
23060, 부평구,025001, 20세,2016,6719,3605,3114,115.8,6664,3576,3088,115.8
23060, 부평구,025002, 21세,2016,7338,4077,3261,125,7267,4041,3226,125.3
23060, 부평구,025003, 22세,2016,7634,4024,3610,111.5,7538,3975,3563,111.6
23060, 부평구,025004, 23세,2016,7957,3903,4054,96.3,7809,3834,3975,96.5
23060, 부평구,025005, 24세,2016,8278,4094,4184,97.8,8065,3991,4074,98
23060, 부평구,030,25~29세,2016,39008,19564,19444,100.6,37222,18651,18571,100.4
23060, 부평구,030001, 25세,2016,7969,3953,4016,98.4,7725,3850,3875,99.4
23060, 부평구,030002, 26세,2016,7882,3931,3951,99.5,7545,3752,3793,98.9
23060, 부평구,030003, 27세,2016,7819,3992,3827,104.3,7481,3810,3671,103.8
23060, 부평구,030004, 28세,2016,7605,3805,3800,100.1,7183,3585,3598,99.6
23060, 부평구,030005, 29세,2016,7733,3883,3850,100.9,7288,3654,3634,100.6
23060, 부평구,035,30~34세,2016,42258,21710,20548,105.7,40370,20677,19693,105
23060, 부평구,035001, 30세,2016,7805,4013,3792,105.8,7382,3784,3598,105.2
23060, 부평구,035002, 31세,2016,7802,4014,3788,106,7412,3814,3598,106
23060, 부평구,035003, 32세,2016,8313,4264,4049,105.3,7932,4048,3884,104.2
23060, 부평구,035004, 33세,2016,8680,4467,4213,106,8329,4277,4052,105.6
23060, 부평구,035005, 34세,2016,9658,4952,4706,105.2,9315,4754,4561,104.2
23060, 부평구,040,35~39세,2016,43844,22838,21006,108.7,42557,22105,20452,108.1
23060, 부평구,040001, 35세,2016,9577,5081,4496,113,9260,4914,4346,113.1
23060, 부평구,040002, 36세,2016,9506,4904,4602,106.6,9236,4750,4486,105.9
23060, 부평구,040003, 37세,2016,8735,4564,4171,109.4,8467,4417,4050,109.1
23060, 부평구,040004, 38세,2016,7912,4084,3828,106.7,7680,3946,3734,105.7
23060, 부평구,040005, 39세,2016,8114,4205,3909,107.6,7914,4078,3836,106.3
23060, 부평구,045,40~44세,2016,43138,21927,21211,103.4,42006,21285,20721,102.7
23060, 부평구,045001, 40세,2016,7785,4044,3741,108.1,7560,3915,3645,107.4
23060, 부평구,045002, 41세,2016,8149,4084,4065,100.5,7941,3965,3976,99.7
23060, 부평구,045003, 42세,2016,8893,4555,4338,105,8695,4433,4262,104
23060, 부평구,045004, 43세,2016,9053,4609,4444,103.7,8812,4486,4326,103.7
23060, 부평구,045005, 44세,2016,9258,4635,4623,100.3,8998,4486,4512,99.4
23060, 부평구,050,45~49세,2016,48774,23602,25172,93.8,47365,22877,24488,93.4
23060, 부평구,050001, 45세,2016,9644,4766,4878,97.7,9340,4607,4733,97.3
23060, 부평구,050002, 46세,2016,9640,4752,4888,97.2,9328,4601,4727,97.3
23060, 부평구,050003, 47세,2016,10048,4858,5190,93.6,9773,4705,5068,92.8
23060, 부평구,050004, 48세,2016,10116,4746,5370,88.4,9829,4606,5223,88.2
23060, 부평구,050005, 49세,2016,9326,4480,4846,92.4,9095,4358,4737,92
23060, 부평구,055,50~54세,2016,48949,24309,24640,98.7,47443,23545,23898,98.5
23060, 부평구,055001, 50세,2016,9485,4713,4772,98.8,9230,4588,4642,98.8
23060, 부평구,055002, 51세,2016,9959,4856,5103,95.2,9650,4708,4942,95.3
23060, 부평구,055003, 52세,2016,9610,4781,4829,99,9274,4611,4663,98.9
23060, 부평구,055004, 53세,2016,9845,4972,4873,102,9490,4780,4710,101.5
23060, 부평구,055005, 54세,2016,10050,4987,5063,98.5,9799,4858,4941,98.3
23060, 부평구,060,55~59세,2016,47895,23934,23961,99.9,46679,23333,23346,99.9
23060, 부평구,060001, 55세,2016,10734,5435,5299,102.6,10556,5352,5204,102.8
23060, 부평구,060002, 56세,2016,10629,5306,5323,99.7,10360,5176,5184,99.8
23060, 부평구,060003, 57세,2016,9280,4612,4668,98.8,9024,4485,4539,98.8
23060, 부평구,060004, 58세,2016,8805,4426,4379,101.1,8543,4285,4258,100.6
23060, 부평구,060005, 59세,2016,8447,4155,4292,96.8,8196,4035,4161,97
23060, 부평구,065,60~64세,2016,31941,15652,16289,96.1,30870,15131,15739,96.1
23060, 부평구,065001, 60세,2016,7360,3638,3722,97.7,7160,3539,3621,97.7
23060, 부평구,065002, 61세,2016,7561,3687,3874,95.2,7286,3551,3735,95.1
23060, 부평구,065003, 62세,2016,6128,2926,3202,91.4,5900,2828,3072,92.1
23060, 부평구,065004, 63세,2016,5273,2631,2642,99.6,5086,2535,2551,99.4
23060, 부평구,065005, 64세,2016,5619,2770,2849,97.2,5438,2678,2760,97
23060, 부평구,070,65~69세,2016,20891,10229,10662,95.9,20435,10008,10427,96
23060, 부평구,070001, 65세,2016,3998,1991,2007,99.2,3854,1912,1942,98.5
23060, 부평구,070002, 66세,2016,4290,2174,2116,102.7,4181,2121,2060,103
23060, 부평구,070003, 67세,2016,4333,2096,2237,93.7,4226,2048,2178,94
23060, 부평구,070004, 68세,2016,4190,2078,2112,98.4,4140,2054,2086,98.5
23060, 부평구,070005, 69세,2016,4080,1890,2190,86.3,4034,1873,2161,86.7
23060, 부평구,075,70~74세,2016,15373,6963,8410,82.8,15224,6910,8314,83.1
23060, 부평구,075001, 70세,2016,3116,1466,1650,88.8,3082,1453,1629,89.2
23060, 부평구,075002, 71세,2016,2935,1339,1596,83.9,2895,1323,1572,84.2
23060, 부평구,075003, 72세,2016,2895,1325,1570,84.4,2873,1321,1552,85.1
23060, 부평구,075004, 73세,2016,3042,1361,1681,81,3018,1355,1663,81.5
23060, 부평구,075005, 74세,2016,3385,1472,1913,76.9,3356,1458,1898,76.8
23060, 부평구,080,75~79세,2016,11901,4641,7260,63.9,11806,4609,7197,64
23060, 부평구,080001, 75세,2016,2721,1147,1574,72.9,2708,1142,1566,72.9
23060, 부평구,080002, 76세,2016,2448,994,1454,68.4,2419,981,1438,68.2
23060, 부평구,080003, 77세,2016,2472,951,1521,62.5,2451,946,1505,62.9
23060, 부평구,080004, 78세,2016,2286,853,1433,59.5,2270,851,1419,60
23060, 부평구,080005, 79세,2016,1974,696,1278,54.5,1958,689,1269,54.3
23060, 부평구,085,80~84세,2016,7520,2555,4965,51.5,7464,2542,4922,51.6
23060, 부평구,085001, 80세,2016,1883,674,1209,55.7,1874,673,1201,56
23060, 부평구,085002, 81세,2016,1802,627,1175,53.4,1787,624,1163,53.7
23060, 부평구,085003, 82세,2016,1420,481,939,51.2,1407,476,931,51.1
23060, 부평구,085004, 83세,2016,1358,446,912,48.9,1346,444,902,49.2
23060, 부평구,085005, 84세,2016,1057,327,730,44.8,1050,325,725,44.8
23060, 부평구,090,85~89세,2016,3379,869,2510,34.6,3360,863,2497,34.6
23060, 부평구,090001, 85세,2016,862,269,593,45.4,856,266,590,45.1
23060, 부평구,090002, 86세,2016,804,194,610,31.8,801,193,608,31.7
23060, 부평구,090003, 87세,2016,697,175,522,33.5,696,174,522,33.3
23060, 부평구,090004, 88세,2016,573,134,439,30.5,567,133,434,30.6
23060, 부평구,090005, 89세,2016,443,97,346,28,440,97,343,28.3
23060, 부평구,095,90~94세,2016,1183,289,894,32.3,1175,286,889,32.2
23060, 부평구,095001, 90세,2016,343,77,266,28.9,340,75,265,28.3
23060, 부평구,095002, 91세,2016,277,61,216,28.2,275,60,215,27.9
23060, 부평구,095003, 92세,2016,206,46,160,28.8,203,46,157,29.3
23060, 부평구,095004, 93세,2016,206,59,147,40.1,206,59,147,40.1
23060, 부평구,095005, 94세,2016,151,46,105,43.8,151,46,105,43.8
23060, 부평구,100,95~99세,2016,253,45,208,21.6,251,44,207,21.3
23060, 부평구,100001, 95세,2016,92,21,71,29.6,92,21,71,29.6
23060, 부평구,100002, 96세,2016,59,10,49,20.4,59,10,49,20.4
23060, 부평구,100003, 97세,2016,41,9,32,28.1,39,8,31,25.8
23060, 부평구,100004, 98세,2016,47,X,44,6.8,47,X,44,6.8
23060, 부평구,100005, 99세,2016,14,X,12,16.7,14,X,12,16.7
23060, 부평구,101,100세이상,2016,30,X,28,7.1,30,X,28,7.1
23060, 부평구,102,15세미만,2016,69091,35469,33622,105.5,68334,35089,33245,105.5
23060, 부평구,103,15~64세,2016,414698,209211,205487,101.8,402665,202919,199746,101.6
23060, 부평구,104,65세이상,2016,60530,25593,34937,73.3,59745,25264,34481,73.3
23060, 부평구,086,85세이상,2016,4845,1205,3640,33.1,4816,1195,3621,33
23060, 부평구,126,평균연령,2016,40.4,39.4,41.3,,40.3,39.3,41.3,
23060, 부평구,127,중위연령,2016,41.2,40,42.3,,41.1,40,42.3,
23070, 계양구,000,합계,2016,323196,160863,162333,99.1,319456,159185,160271,99.3
23070, 계양구,005,0~4세,2016,13117,6716,6401,104.9,13059,6691,6368,105.1
23070, 계양구,005001, 0세,2016,2496,1244,1252,99.4,2484,1239,1245,99.5
23070, 계양구,005002, 1세,2016,2571,1310,1261,103.9,2554,1303,1251,104.2
23070, 계양구,005003, 2세,2016,2611,1355,1256,107.9,2594,1346,1248,107.9
23070, 계양구,005004, 3세,2016,2577,1346,1231,109.3,2568,1344,1224,109.8
23070, 계양구,005005, 4세,2016,2862,1461,1401,104.3,2859,1459,1400,104.2
23070, 계양구,010,5~9세,2016,14173,7236,6937,104.3,14135,7216,6919,104.3
23070, 계양구,010001, 5세,2016,2913,1471,1442,102,2904,1467,1437,102.1
23070, 계양구,010002, 6세,2016,2787,1404,1383,101.5,2778,1402,1376,101.9
23070, 계양구,010003, 7세,2016,2666,1375,1291,106.5,2660,1370,1290,106.2
23070, 계양구,010004, 8세,2016,2825,1449,1376,105.3,2817,1444,1373,105.2
23070, 계양구,010005, 9세,2016,2982,1537,1445,106.4,2976,1533,1443,106.2
23070, 계양구,015,10~14세,2016,14218,7317,6901,106,14196,7304,6892,106
23070, 계양구,015001, 10세,2016,2641,1357,1284,105.7,2636,1354,1282,105.6
23070, 계양구,015002, 11세,2016,2513,1273,1240,102.7,2507,1270,1237,102.7
23070, 계양구,015003, 12세,2016,2895,1487,1408,105.6,2891,1485,1406,105.6
23070, 계양구,015004, 13세,2016,3044,1532,1512,101.3,3042,1530,1512,101.2
23070, 계양구,015005, 14세,2016,3125,1668,1457,114.5,3120,1665,1455,114.4
23070, 계양구,020,15~19세,2016,20435,10479,9956,105.3,20370,10456,9914,105.5
23070, 계양구,020001, 15세,2016,3664,1908,1756,108.7,3654,1904,1750,108.8
23070, 계양구,020002, 16세,2016,3978,2065,1913,107.9,3969,2062,1907,108.1
23070, 계양구,020003, 17세,2016,4177,2159,2018,107,4173,2156,2017,106.9
23070, 계양구,020004, 18세,2016,4236,2153,2083,103.4,4225,2149,2076,103.5
23070, 계양구,020005, 19세,2016,4380,2194,2186,100.4,4349,2185,2164,101
23070, 계양구,025,20~24세,2016,25303,13045,12258,106.4,24982,12927,12055,107.2
23070, 계양구,025001, 20세,2016,4889,2600,2289,113.6,4839,2584,2255,114.6
23070, 계양구,025002, 21세,2016,5037,2725,2312,117.9,4980,2704,2276,118.8
23070, 계양구,025003, 22세,2016,5022,2671,2351,113.6,4974,2649,2325,113.9
23070, 계양구,025004, 23세,2016,5095,2490,2605,95.6,5016,2464,2552,96.6
23070, 계양구,025005, 24세,2016,5260,2559,2701,94.7,5173,2526,2647,95.4
23070, 계양구,030,25~29세,2016,23107,11701,11406,102.6,22565,11436,11129,102.8
23070, 계양구,030001, 25세,2016,5076,2519,2557,98.5,4981,2475,2506,98.8
23070, 계양구,030002, 26세,2016,4832,2460,2372,103.7,4729,2414,2315,104.3
23070, 계양구,030003, 27세,2016,4635,2331,2304,101.2,4525,2272,2253,100.8
23070, 계양구,030004, 28세,2016,4323,2219,2104,105.5,4207,2170,2037,106.5
23070, 계양구,030005, 29세,2016,4241,2172,2069,105,4123,2105,2018,104.3
23070, 계양구,035,30~34세,2016,22822,11669,11153,104.6,22253,11418,10835,105.4
23070, 계양구,035001, 30세,2016,4243,2212,2031,108.9,4124,2150,1974,108.9
23070, 계양구,035002, 31세,2016,4312,2206,2106,104.7,4194,2162,2032,106.4
23070, 계양구,035003, 32세,2016,4275,2178,2097,103.9,4152,2126,2026,104.9
23070, 계양구,035004, 33세,2016,4902,2475,2427,102,4793,2433,2360,103.1
23070, 계양구,035005, 34세,2016,5090,2598,2492,104.3,4990,2547,2443,104.3
23070, 계양구,040,35~39세,2016,24476,12488,11988,104.2,24068,12279,11789,104.2
23070, 계양구,040001, 35세,2016,5128,2651,2477,107,5045,2603,2442,106.6
23070, 계양구,040002, 36세,2016,5220,2601,2619,99.3,5128,2558,2570,99.5
23070, 계양구,040003, 37세,2016,4980,2567,2413,106.4,4890,2523,2367,106.6
23070, 계양구,040004, 38세,2016,4430,2263,2167,104.4,4355,2222,2133,104.2
23070, 계양구,040005, 39세,2016,4718,2406,2312,104.1,4650,2373,2277,104.2
23070, 계양구,045,40~44세,2016,25845,12949,12896,100.4,25518,12802,12716,100.7
23070, 계양구,045001, 40세,2016,4545,2320,2225,104.3,4481,2293,2188,104.8
23070, 계양구,045002, 41세,2016,4820,2433,2387,101.9,4768,2412,2356,102.4
23070, 계양구,045003, 42세,2016,5322,2755,2567,107.3,5265,2730,2535,107.7
23070, 계양구,045004, 43세,2016,5634,2696,2938,91.8,5548,2654,2894,91.7
23070, 계양구,045005, 44세,2016,5524,2745,2779,98.8,5456,2713,2743,98.9
23070, 계양구,050,45~49세,2016,31268,14869,16399,90.7,30896,14695,16201,90.7
23070, 계양구,050001, 45세,2016,6083,2954,3129,94.4,5998,2914,3084,94.5
23070, 계양구,050002, 46세,2016,6047,2932,3115,94.1,5972,2895,3077,94.1
23070, 계양구,050003, 47세,2016,6346,2994,3352,89.3,6262,2956,3306,89.4
23070, 계양구,050004, 48세,2016,6592,3103,3489,88.9,6514,3066,3448,88.9
23070, 계양구,050005, 49세,2016,6200,2886,3314,87.1,6150,2864,3286,87.2
23070, 계양구,055,50~54세,2016,32405,16008,16397,97.6,32064,15861,16203,97.9
23070, 계양구,055001, 50세,2016,6136,2958,3178,93.1,6070,2932,3138,93.4
23070, 계양구,055002, 51세,2016,6585,3245,3340,97.2,6509,3211,3298,97.4
23070, 계양구,055003, 52세,2016,6119,2934,3185,92.1,6047,2905,3142,92.5
23070, 계양구,055004, 53세,2016,6760,3448,3312,104.1,6690,3414,3276,104.2
23070, 계양구,055005, 54세,2016,6805,3423,3382,101.2,6748,3399,3349,101.5
23070, 계양구,060,55~59세,2016,29518,15323,14195,107.9,29253,15219,14034,108.4
23070, 계양구,060001, 55세,2016,7110,3594,3516,102.2,7075,3582,3493,102.5
23070, 계양구,060002, 56세,2016,6788,3472,3316,104.7,6712,3444,3268,105.4
23070, 계양구,060003, 57세,2016,5693,2964,2729,108.6,5634,2938,2696,109
23070, 계양구,060004, 58세,2016,5193,2737,2456,111.4,5148,2719,2429,111.9
23070, 계양구,060005, 59세,2016,4734,2556,2178,117.4,4684,2536,2148,118.1
23070, 계양구,065,60~64세,2016,16854,8692,8162,106.5,16640,8594,8046,106.8
23070, 계양구,065001, 60세,2016,4143,2136,2007,106.4,4092,2112,1980,106.7
23070, 계양구,065002, 61세,2016,4060,2053,2007,102.3,4024,2042,1982,103
23070, 계양구,065003, 62세,2016,3158,1682,1476,114,3114,1659,1455,114
23070, 계양구,065004, 63세,2016,2664,1385,1279,108.3,2616,1361,1255,108.4
23070, 계양구,065005, 64세,2016,2829,1436,1393,103.1,2794,1420,1374,103.3
23070, 계양구,070,65~69세,2016,9890,4995,4895,102,9775,4943,4832,102.3
23070, 계양구,070001, 65세,2016,1862,963,899,107.1,1838,952,886,107.4
23070, 계양구,070002, 66세,2016,2044,1046,998,104.8,2014,1034,980,105.5
23070, 계양구,070003, 67세,2016,2053,1047,1006,104.1,2023,1035,988,104.8
23070, 계양구,070004, 68세,2016,2000,1034,966,107,1982,1025,957,107.1
23070, 계양구,070005, 69세,2016,1931,905,1026,88.2,1918,897,1021,87.9
23070, 계양구,075,70~74세,2016,7343,3238,4105,78.9,7305,3218,4087,78.7
23070, 계양구,075001, 70세,2016,1447,686,761,90.1,1434,678,756,89.7
23070, 계양구,075002, 71세,2016,1422,642,780,82.3,1416,639,777,82.2
23070, 계양구,075003, 72세,2016,1401,621,780,79.6,1396,618,778,79.4
23070, 계양구,075004, 73세,2016,1426,608,818,74.3,1418,606,812,74.6
23070, 계양구,075005, 74세,2016,1647,681,966,70.5,1641,677,964,70.2
23070, 계양구,080,75~79세,2016,5993,2290,3703,61.8,5965,2282,3683,62
23070, 계양구,080001, 75세,2016,1407,561,846,66.3,1402,560,842,66.5
23070, 계양구,080002, 76세,2016,1255,496,759,65.3,1252,494,758,65.2
23070, 계양구,080003, 77세,2016,1248,467,781,59.8,1239,464,775,59.9
23070, 계양구,080004, 78세,2016,1100,421,679,62,1095,421,674,62.5
23070, 계양구,080005, 79세,2016,983,345,638,54.1,977,343,634,54.1
23070, 계양구,085,80~84세,2016,3891,1226,2665,46,3882,1225,2657,46.1
23070, 계양구,085001, 80세,2016,991,312,679,45.9,988,311,677,45.9
23070, 계양구,085002, 81세,2016,909,311,598,52,907,311,596,52.2
23070, 계양구,085003, 82세,2016,779,244,535,45.6,778,244,534,45.7
23070, 계양구,085004, 83세,2016,667,205,462,44.4,665,205,460,44.6
23070, 계양구,085005, 84세,2016,545,154,391,39.4,544,154,390,39.5
23070, 계양구,090,85~89세,2016,1773,446,1327,33.6,1767,445,1322,33.7
23070, 계양구,090001, 85세,2016,449,117,332,35.2,447,117,330,35.5
23070, 계양구,090002, 86세,2016,439,106,333,31.8,438,106,332,31.9
23070, 계양구,090003, 87세,2016,351,96,255,37.6,350,95,255,37.3
23070, 계양구,090004, 88세,2016,291,68,223,30.5,290,68,222,30.6
23070, 계양구,090005, 89세,2016,243,59,184,32.1,242,59,183,32.2
23070, 계양구,095,90~94세,2016,610,144,466,30.9,608,142,466,30.5
23070, 계양구,095001, 90세,2016,195,43,152,28.3,194,42,152,27.6
23070, 계양구,095002, 91세,2016,130,26,104,25,130,26,104,25
23070, 계양구,095003, 92세,2016,116,32,84,38.1,116,32,84,38.1
23070, 계양구,095004, 93세,2016,107,32,75,42.7,107,32,75,42.7
23070, 계양구,095005, 94세,2016,62,11,51,21.6,61,10,51,19.6
23070, 계양구,100,95~99세,2016,135,29,106,27.4,135,29,106,27.4
23070, 계양구,100001, 95세,2016,56,15,41,36.6,56,15,41,36.6
23070, 계양구,100002, 96세,2016,40,11,29,37.9,40,11,29,37.9
23070, 계양구,100003, 97세,2016,20,X,18,11.1,20,X,18,11.1
23070, 계양구,100004, 98세,2016,12,X,12,0,12,X,12,0
23070, 계양구,100005, 99세,2016,7,X,6,16.7,7,X,6,16.7
23070, 계양구,101,100세이상,2016,20,X,17,17.6,20,X,17,17.6
23070, 계양구,102,15세미만,2016,41508,21269,20239,105.1,41390,21211,20179,105.1
23070, 계양구,103,15~64세,2016,252033,127223,124810,101.9,248609,125687,122922,102.2
23070, 계양구,104,65세이상,2016,29655,12371,17284,71.6,29457,12287,17170,71.6
23070, 계양구,086,85세이상,2016,2538,622,1916,32.5,2530,619,1911,32.4
23070, 계양구,126,평균연령,2016,39.5,38.7,40.3,,39.5,38.7,40.3,
23070, 계양구,127,중위연령,2016,40.9,39.9,41.8,,40.9,39.9,41.9,
23080, 서구,000,합계,2016,506040,257518,248522,103.6,491187,247447,243740,101.5
23080, 서구,005,0~4세,2016,27088,14028,13060,107.4,26858,13907,12951,107.4
23080, 서구,005001, 0세,2016,4900,2541,2359,107.7,4844,2511,2333,107.6
23080, 서구,005002, 1세,2016,5351,2783,2568,108.4,5308,2757,2551,108.1
23080, 서구,005003, 2세,2016,5305,2735,2570,106.4,5257,2713,2544,106.6
23080, 서구,005004, 3세,2016,5552,2832,2720,104.1,5500,2805,2695,104.1
23080, 서구,005005, 4세,2016,5980,3137,2843,110.3,5949,3121,2828,110.4
23080, 서구,010,5~9세,2016,28074,14405,13669,105.4,27925,14321,13604,105.3
23080, 서구,010001, 5세,2016,5863,3027,2836,106.7,5831,3004,2827,106.3
23080, 서구,010002, 6세,2016,5617,2909,2708,107.4,5585,2893,2692,107.5
23080, 서구,010003, 7세,2016,5289,2758,2531,109,5259,2743,2516,109
23080, 서구,010004, 8세,2016,5593,2836,2757,102.9,5565,2819,2746,102.7
23080, 서구,010005, 9세,2016,5712,2875,2837,101.3,5685,2862,2823,101.4
23080, 서구,015,10~14세,2016,26525,13696,12829,106.8,26437,13645,12792,106.7
23080, 서구,015001, 10세,2016,5208,2690,2518,106.8,5193,2680,2513,106.6
23080, 서구,015002, 11세,2016,5023,2621,2402,109.1,5001,2609,2392,109.1
23080, 서구,015003, 12세,2016,5391,2739,2652,103.3,5371,2731,2640,103.4
23080, 서구,015004, 13세,2016,5420,2801,2619,106.9,5407,2792,2615,106.8
23080, 서구,015005, 14세,2016,5483,2845,2638,107.8,5465,2833,2632,107.6
23080, 서구,020,15~19세,2016,30552,15673,14879,105.3,30411,15597,14814,105.3
23080, 서구,020001, 15세,2016,6148,3138,3010,104.3,6133,3130,3003,104.2
23080, 서구,020002, 16세,2016,6427,3341,3086,108.3,6402,3336,3066,108.8
23080, 서구,020003, 17세,2016,6229,3232,2997,107.8,6201,3211,2990,107.4
23080, 서구,020004, 18세,2016,6179,3178,3001,105.9,6154,3167,2987,106
23080, 서구,020005, 19세,2016,5569,2784,2785,100,5521,2753,2768,99.5
23080, 서구,025,20~24세,2016,32699,17475,15224,114.8,31534,16628,14906,111.6
23080, 서구,025001, 20세,2016,6152,3352,2800,119.7,6072,3303,2769,119.3
23080, 서구,025002, 21세,2016,6473,3638,2835,128.3,6344,3545,2799,126.7
23080, 서구,025003, 22세,2016,6540,3573,2967,120.4,6323,3416,2907,117.5
23080, 서구,025004, 23세,2016,6597,3436,3161,108.7,6261,3190,3071,103.9
23080, 서구,025005, 24세,2016,6937,3476,3461,100.4,6534,3174,3360,94.5
23080, 서구,030,25~29세,2016,32447,16992,15455,109.9,29651,14929,14722,101.4
23080, 서구,030001, 25세,2016,6913,3589,3324,108,6425,3238,3187,101.6
23080, 서구,030002, 26세,2016,6450,3366,3084,109.1,5936,3006,2930,102.6
23080, 서구,030003, 27세,2016,6319,3391,2928,115.8,5784,2984,2800,106.6
23080, 서구,030004, 28세,2016,6321,3333,2988,111.5,5721,2879,2842,101.3
23080, 서구,030005, 29세,2016,6444,3313,3131,105.8,5785,2822,2963,95.2
23080, 서구,035,30~34세,2016,39244,20573,18671,110.2,36340,18360,17980,102.1
23080, 서구,035001, 30세,2016,6786,3611,3175,113.7,6208,3168,3040,104.2
23080, 서구,035002, 31세,2016,7082,3727,3355,111.1,6478,3255,3223,101
23080, 서구,035003, 32세,2016,7579,3896,3683,105.8,6972,3444,3528,97.6
23080, 서구,035004, 33세,2016,8416,4377,4039,108.4,7870,3949,3921,100.7
23080, 서구,035005, 34세,2016,9381,4962,4419,112.3,8812,4544,4268,106.5
23080, 서구,040,35~39세,2016,46317,23876,22441,106.4,44161,22293,21868,101.9
23080, 서구,040001, 35세,2016,9588,5007,4581,109.3,9104,4653,4451,104.5
23080, 서구,040002, 36세,2016,9824,5036,4788,105.2,9382,4702,4680,100.5
23080, 서구,040003, 37세,2016,9500,4904,4596,106.7,9020,4550,4470,101.8
23080, 서구,040004, 38세,2016,8546,4417,4129,107,8172,4150,4022,103.2
23080, 서구,040005, 39세,2016,8859,4512,4347,103.8,8483,4238,4245,99.8
23080, 서구,045,40~44세,2016,46472,23783,22689,104.8,44950,22752,22198,102.5
23080, 서구,045001, 40세,2016,8565,4375,4190,104.4,8216,4134,4082,101.3
23080, 서구,045002, 41세,2016,9024,4698,4326,108.6,8716,4483,4233,105.9
23080, 서구,045003, 42세,2016,9666,4962,4704,105.5,9368,4761,4607,103.3
23080, 서구,045004, 43세,2016,9625,4852,4773,101.7,9358,4671,4687,99.7
23080, 서구,045005, 44세,2016,9592,4896,4696,104.3,9292,4703,4589,102.5
23080, 서구,050,45~49세,2016,48166,24369,23797,102.4,46973,23635,23338,101.3
23080, 서구,050001, 45세,2016,10131,5203,4928,105.6,9870,5049,4821,104.7
23080, 서구,050002, 46세,2016,9553,4841,4712,102.7,9272,4669,4603,101.4
23080, 서구,050003, 47세,2016,9809,4957,4852,102.2,9588,4814,4774,100.8
23080, 서구,050004, 48세,2016,9778,4894,4884,100.2,9538,4748,4790,99.1
23080, 서구,050005, 49세,2016,8895,4474,4421,101.2,8705,4355,4350,100.1
23080, 서구,055,50~54세,2016,43230,22279,20951,106.3,42237,21737,20500,106
23080, 서구,055001, 50세,2016,8736,4516,4220,107,8535,4397,4138,106.3
23080, 서구,055002, 51세,2016,9096,4619,4477,103.2,8886,4507,4379,102.9
23080, 서구,055003, 52세,2016,8345,4273,4072,104.9,8129,4156,3973,104.6
23080, 서구,055004, 53세,2016,8587,4427,4160,106.4,8382,4320,4062,106.4
23080, 서구,055005, 54세,2016,8466,4444,4022,110.5,8305,4357,3948,110.4
23080, 서구,060,55~59세,2016,38471,19923,18548,107.4,37856,19610,18246,107.5
23080, 서구,060001, 55세,2016,8882,4698,4184,112.3,8769,4639,4130,112.3
23080, 서구,060002, 56세,2016,8690,4448,4242,104.9,8542,4380,4162,105.2
23080, 서구,060003, 57세,2016,7407,3804,3603,105.6,7283,3748,3535,106
23080, 서구,060004, 58세,2016,6932,3617,3315,109.1,6824,3556,3268,108.8
23080, 서구,060005, 59세,2016,6560,3356,3204,104.7,6438,3287,3151,104.3
23080, 서구,065,60~64세,2016,24198,12326,11872,103.8,23744,12089,11655,103.7
23080, 서구,065001, 60세,2016,5813,3013,2800,107.6,5732,2972,2760,107.7
23080, 서구,065002, 61세,2016,5638,2850,2788,102.2,5535,2796,2739,102.1
23080, 서구,065003, 62세,2016,4603,2326,2277,102.2,4508,2280,2228,102.3
23080, 서구,065004, 63세,2016,3978,2003,1975,101.4,3885,1954,1931,101.2
23080, 서구,065005, 64세,2016,4166,2134,2032,105,4084,2087,1997,104.5
23080, 서구,070,65~69세,2016,15108,7530,7578,99.4,14863,7423,7440,99.8
23080, 서구,070001, 65세,2016,2862,1425,1437,99.2,2794,1396,1398,99.9
23080, 서구,070002, 66세,2016,3171,1584,1587,99.8,3108,1557,1551,100.4
23080, 서구,070003, 67세,2016,3182,1627,1555,104.6,3131,1604,1527,105
23080, 서구,070004, 68세,2016,2975,1488,1487,100.1,2946,1475,1471,100.3
23080, 서구,070005, 69세,2016,2918,1406,1512,93,2884,1391,1493,93.2
23080, 서구,075,70~74세,2016,10787,5022,5765,87.1,10697,4987,5710,87.3
23080, 서구,075001, 70세,2016,2165,1033,1132,91.3,2146,1025,1121,91.4
23080, 서구,075002, 71세,2016,2099,988,1111,88.9,2074,975,1099,88.7
23080, 서구,075003, 72세,2016,2024,961,1063,90.4,2007,957,1050,91.1
23080, 서구,075004, 73세,2016,2131,988,1143,86.4,2115,984,1131,87
23080, 서구,075005, 74세,2016,2368,1052,1316,79.9,2355,1046,1309,79.9
23080, 서구,080,75~79세,2016,8045,3149,4896,64.3,7983,3127,4856,64.4
23080, 서구,080001, 75세,2016,1834,780,1054,74,1822,776,1046,74.2
23080, 서구,080002, 76세,2016,1636,631,1005,62.8,1628,628,1000,62.8
23080, 서구,080003, 77세,2016,1638,659,979,67.3,1624,651,973,66.9
23080, 서구,080004, 78세,2016,1584,605,979,61.8,1566,599,967,61.9
23080, 서구,080005, 79세,2016,1353,474,879,53.9,1343,473,870,54.4
23080, 서구,085,80~84세,2016,5116,1639,3477,47.1,5082,1631,3451,47.3
23080, 서구,085001, 80세,2016,1291,444,847,52.4,1284,442,842,52.5
23080, 서구,085002, 81세,2016,1161,370,791,46.8,1149,367,782,46.9
23080, 서구,085003, 82세,2016,1009,332,677,49,1002,331,671,49.3
23080, 서구,085004, 83세,2016,914,281,633,44.4,911,280,631,44.4
23080, 서구,085005, 84세,2016,741,212,529,40.1,736,211,525,40.2
23080, 서구,090,85~89세,2016,2446,572,1874,30.5,2434,569,1865,30.5
23080, 서구,090001, 85세,2016,589,152,437,34.8,585,151,434,34.8
23080, 서구,090002, 86세,2016,577,138,439,31.4,574,137,437,31.4
23080, 서구,090003, 87세,2016,545,126,419,30.1,544,126,418,30.1
23080, 서구,090004, 88세,2016,408,92,316,29.1,407,92,315,29.2
23080, 서구,090005, 89세,2016,327,64,263,24.3,324,63,261,24.1
23080, 서구,095,90~94세,2016,840,163,677,24.1,837,163,674,24.2
23080, 서구,095001, 90세,2016,211,39,172,22.7,210,39,171,22.8
23080, 서구,095002, 91세,2016,225,41,184,22.3,225,41,184,22.3
23080, 서구,095003, 92세,2016,152,26,126,20.6,151,26,125,20.8
23080, 서구,095004, 93세,2016,159,39,120,32.5,158,39,119,32.8
23080, 서구,095005, 94세,2016,93,18,75,24,93,18,75,24
23080, 서구,100,95~99세,2016,187,41,146,28.1,187,41,146,28.1
23080, 서구,100001, 95세,2016,62,9,53,17,62,9,53,17
23080, 서구,100002, 96세,2016,43,16,27,59.3,43,16,27,59.3
23080, 서구,100003, 97세,2016,38,8,30,26.7,38,8,30,26.7
23080, 서구,100004, 98세,2016,28,8,20,40,28,8,20,40
23080, 서구,100005, 99세,2016,16,X,16,0,16,X,16,0
23080, 서구,101,100세이상,2016,28,X,24,16.7,27,X,24,12.5
23080, 서구,102,15세미만,2016,81687,42129,39558,106.5,81220,41873,39347,106.4
23080, 서구,103,15~64세,2016,381796,197269,184527,106.9,367857,187630,180227,104.1
23080, 서구,104,65세이상,2016,42557,18120,24437,74.1,42110,17944,24166,74.3
23080, 서구,086,85세이상,2016,3501,780,2721,28.7,3485,776,2709,28.6
23080, 서구,126,평균연령,2016,37.9,37.2,38.7,,37.9,37.3,38.7,
23080, 서구,127,중위연령,2016,38.9,38.2,39.5,,39.1,38.6,39.6,
23310, 강화군,000,합계,2016,62741,31592,31149,101.4,61758,30983,30775,100.7
23310, 강화군,005,0~4세,2016,1505,740,765,96.7,1499,737,762,96.7
23310, 강화군,005001, 0세,2016,274,145,129,112.4,274,145,129,112.4
23310, 강화군,005002, 1세,2016,288,141,147,95.9,288,141,147,95.9
23310, 강화군,005003, 2세,2016,296,137,159,86.2,294,136,158,86.1
23310, 강화군,005004, 3세,2016,296,139,157,88.5,294,139,155,89.7
23310, 강화군,005005, 4세,2016,351,178,173,102.9,349,176,173,101.7
23310, 강화군,010,5~9세,2016,1903,988,915,108,1896,984,912,107.9
23310, 강화군,010001, 5세,2016,362,187,175,106.9,361,187,174,107.5
23310, 강화군,010002, 6세,2016,372,201,171,117.5,369,199,170,117.1
23310, 강화군,010003, 7세,2016,363,196,167,117.4,361,195,166,117.5
23310, 강화군,010004, 8세,2016,410,187,223,83.9,409,186,223,83.4
23310, 강화군,010005, 9세,2016,396,217,179,121.2,396,217,179,121.2
23310, 강화군,015,10~14세,2016,2083,1053,1030,102.2,2076,1049,1027,102.1
23310, 강화군,015001, 10세,2016,412,210,202,104,411,209,202,103.5
23310, 강화군,015002, 11세,2016,382,184,198,92.9,381,184,197,93.4
23310, 강화군,015003, 12세,2016,404,201,203,99,403,200,203,98.5
23310, 강화군,015004, 13세,2016,465,242,223,108.5,464,242,222,109
23310, 강화군,015005, 14세,2016,420,216,204,105.9,417,214,203,105.4
23310, 강화군,020,15~19세,2016,2919,1583,1336,118.5,2913,1582,1331,118.9
23310, 강화군,020001, 15세,2016,538,269,269,100,538,269,269,100
23310, 강화군,020002, 16세,2016,735,390,345,113,734,390,344,113.4
23310, 강화군,020003, 17세,2016,638,340,298,114.1,636,340,296,114.9
23310, 강화군,020004, 18세,2016,579,336,243,138.3,578,336,242,138.8
23310, 강화군,020005, 19세,2016,429,248,181,137,427,247,180,137.2
23310, 강화군,025,20~24세,2016,2508,1518,990,153.3,2407,1459,948,153.9
23310, 강화군,025001, 20세,2016,476,296,180,164.4,469,294,175,168
23310, 강화군,025002, 21세,2016,532,356,176,202.3,522,351,171,205.3
23310, 강화군,025003, 22세,2016,501,301,200,150.5,485,294,191,153.9
23310, 강화군,025004, 23세,2016,506,277,229,121,473,255,218,117
23310, 강화군,025005, 24세,2016,493,288,205,140.5,458,265,193,137.3
23310, 강화군,030,25~29세,2016,2601,1533,1068,143.5,2364,1364,1000,136.4
23310, 강화군,030001, 25세,2016,581,323,258,125.2,536,294,242,121.5
23310, 강화군,030002, 26세,2016,534,326,208,156.7,488,297,191,155.5
23310, 강화군,030003, 27세,2016,523,318,205,155.1,474,280,194,144.3
23310, 강화군,030004, 28세,2016,500,300,200,150,441,252,189,133.3
23310, 강화군,030005, 29세,2016,463,266,197,135,425,241,184,131
23310, 강화군,035,30~34세,2016,2519,1404,1115,125.9,2308,1241,1067,116.3
23310, 강화군,035001, 30세,2016,435,266,169,157.4,378,223,155,143.9
23310, 강화군,035002, 31세,2016,478,271,207,130.9,438,237,201,117.9
23310, 강화군,035003, 32세,2016,463,240,223,107.6,426,212,214,99.1
23310, 강화군,035004, 33세,2016,550,313,237,132.1,504,278,226,123
23310, 강화군,035005, 34세,2016,593,314,279,112.5,562,291,271,107.4
23310, 강화군,040,35~39세,2016,2854,1530,1324,115.6,2755,1466,1289,113.7
23310, 강화군,040001, 35세,2016,566,303,263,115.2,548,292,256,114.1
23310, 강화군,040002, 36세,2016,568,308,260,118.5,545,292,253,115.4
23310, 강화군,040003, 37세,2016,551,291,260,111.9,532,278,254,109.4
23310, 강화군,040004, 38세,2016,564,305,259,117.8,539,291,248,117.3
23310, 강화군,040005, 39세,2016,605,323,282,114.5,591,313,278,112.6
23310, 강화군,045,40~44세,2016,3527,1943,1584,122.7,3459,1900,1559,121.9
23310, 강화군,045001, 40세,2016,613,326,287,113.6,597,316,281,112.5
23310, 강화군,045002, 41세,2016,637,343,294,116.7,625,336,289,116.3
23310, 강화군,045003, 42세,2016,713,407,306,133,696,398,298,133.6
23310, 강화군,045004, 43세,2016,796,435,361,120.5,786,429,357,120.2
23310, 강화군,045005, 44세,2016,768,432,336,128.6,755,421,334,126
23310, 강화군,050,45~49세,2016,4272,2259,2013,112.2,4203,2229,1974,112.9
23310, 강화군,050001, 45세,2016,830,466,364,128,816,458,358,127.9
23310, 강화군,050002, 46세,2016,817,462,355,130.1,804,457,347,131.7
23310, 강화군,050003, 47세,2016,881,458,423,108.3,870,454,416,109.1
23310, 강화군,050004, 48세,2016,917,460,457,100.7,900,452,448,100.9
23310, 강화군,050005, 49세,2016,827,413,414,99.8,813,408,405,100.7
23310, 강화군,055,50~54세,2016,5099,2632,2467,106.7,5035,2609,2426,107.5
23310, 강화군,055001, 50세,2016,892,473,419,112.9,882,470,412,114.1
23310, 강화군,055002, 51세,2016,994,519,475,109.3,980,512,468,109.4
23310, 강화군,055003, 52세,2016,986,517,469,110.2,968,509,459,110.9
23310, 강화군,055004, 53세,2016,1007,509,498,102.2,993,506,487,103.9
23310, 강화군,055005, 54세,2016,1220,614,606,101.3,1212,612,600,102
23310, 강화군,060,55~59세,2016,6692,3330,3362,99,6659,3316,3343,99.2
23310, 강화군,060001, 55세,2016,1342,673,669,100.6,1337,670,667,100.4
23310, 강화군,060002, 56세,2016,1385,687,698,98.4,1380,684,696,98.3
23310, 강화군,060003, 57세,2016,1379,685,694,98.7,1366,680,686,99.1
23310, 강화군,060004, 58세,2016,1317,638,679,94,1310,637,673,94.7
23310, 강화군,060005, 59세,2016,1269,647,622,104,1266,645,621,103.9
23310, 강화군,065,60~64세,2016,5847,2886,2961,97.5,5813,2875,2938,97.9
23310, 강화군,065001, 60세,2016,1205,596,609,97.9,1199,595,604,98.5
23310, 강화군,065002, 61세,2016,1306,647,659,98.2,1295,644,651,98.9
23310, 강화군,065003, 62세,2016,1108,537,571,94,1101,535,566,94.5
23310, 강화군,065004, 63세,2016,1108,554,554,100,1104,551,553,99.6
23310, 강화군,065005, 64세,2016,1120,552,568,97.2,1114,550,564,97.5
23310, 강화군,070,65~69세,2016,4849,2411,2438,98.9,4833,2402,2431,98.8
23310, 강화군,070001, 65세,2016,714,341,373,91.4,712,340,372,91.4
23310, 강화군,070002, 66세,2016,938,459,479,95.8,935,458,477,96
23310, 강화군,070003, 67세,2016,1013,520,493,105.5,1006,515,491,104.9
23310, 강화군,070004, 68세,2016,1034,518,516,100.4,1033,518,515,100.6
23310, 강화군,070005, 69세,2016,1150,573,577,99.3,1147,571,576,99.1
23310, 강화군,075,70~74세,2016,4559,2173,2386,91.1,4549,2170,2379,91.2
23310, 강화군,075001, 70세,2016,897,424,473,89.6,895,423,472,89.6
23310, 강화군,075002, 71세,2016,831,399,432,92.4,828,399,429,93
23310, 강화군,075003, 72세,2016,855,399,456,87.5,853,398,455,87.5
23310, 강화군,075004, 73세,2016,971,482,489,98.6,970,482,488,98.8
23310, 강화군,075005, 74세,2016,1005,469,536,87.5,1003,468,535,87.5
23310, 강화군,080,75~79세,2016,4037,1872,2165,86.5,4030,1867,2163,86.3
23310, 강화군,080001, 75세,2016,913,429,484,88.6,911,427,484,88.2
23310, 강화군,080002, 76세,2016,790,358,432,82.9,788,357,431,82.8
23310, 강화군,080003, 77세,2016,815,371,444,83.6,814,371,443,83.7
23310, 강화군,080004, 78세,2016,797,384,413,93,795,382,413,92.5
23310, 강화군,080005, 79세,2016,722,330,392,84.2,722,330,392,84.2
23310, 강화군,085,80~84세,2016,3014,1185,1829,64.8,3010,1183,1827,64.8
23310, 강화군,085001, 80세,2016,764,329,435,75.6,763,329,434,75.8
23310, 강화군,085002, 81세,2016,684,289,395,73.2,682,287,395,72.7
23310, 강화군,085003, 82세,2016,578,226,352,64.2,578,226,352,64.2
23310, 강화군,085004, 83세,2016,525,198,327,60.6,524,198,326,60.7
23310, 강화군,085005, 84세,2016,463,143,320,44.7,463,143,320,44.7
23310, 강화군,090,85~89세,2016,1374,411,963,42.7,1372,409,963,42.5
23310, 강화군,090001, 85세,2016,363,123,240,51.3,362,122,240,50.8
23310, 강화군,090002, 86세,2016,327,103,224,46,327,103,224,46
23310, 강화군,090003, 87세,2016,260,71,189,37.6,260,71,189,37.6
23310, 강화군,090004, 88세,2016,249,68,181,37.6,249,68,181,37.6
23310, 강화군,090005, 89세,2016,175,46,129,35.7,174,45,129,34.9
23310, 강화군,095,90~94세,2016,463,115,348,33,462,115,347,33.1
23310, 강화군,095001, 90세,2016,138,35,103,34,137,35,102,34.3
23310, 강화군,095002, 91세,2016,119,28,91,30.8,119,28,91,30.8
23310, 강화군,095003, 92세,2016,87,19,68,27.9,87,19,68,27.9
23310, 강화군,095004, 93세,2016,73,21,52,40.4,73,21,52,40.4
23310, 강화군,095005, 94세,2016,46,12,34,35.3,46,12,34,35.3
23310, 강화군,100,95~99세,2016,105,23,82,28,104,23,81,28.4
23310, 강화군,100001, 95세,2016,39,9,30,30,39,9,30,30
23310, 강화군,100002, 96세,2016,28,7,21,33.3,27,7,20,35
23310, 강화군,100003, 97세,2016,20,X,16,25,20,X,16,25
23310, 강화군,100004, 98세,2016,12,X,9,33.3,12,X,9,33.3
23310, 강화군,100005, 99세,2016,6,X,6,0,6,X,6,0
23310, 강화군,101,100세이상,2016,11,X,8,37.5,11,X,8,37.5
23310, 강화군,102,15세미만,2016,5491,2781,2710,102.6,5471,2770,2701,102.6
23310, 강화군,103,15~64세,2016,38838,20618,18220,113.2,37916,20041,17875,112.1
23310, 강화군,104,65세이상,2016,18412,8193,10219,80.2,18371,8172,10199,80.1
23310, 강화군,086,85세이상,2016,1953,552,1401,39.4,1949,550,1399,39.3
23310, 강화군,126,평균연령,2016,50.6,48.8,52.5,,50.9,49.1,52.6,
23310, 강화군,127,중위연령,2016,54.7,52.5,56.4,,55,53,56.6,
23320, 옹진군,000,합계,2016,18905,10827,8078,134,18687,10675,8012,133.2
23320, 옹진군,005,0~4세,2016,596,296,300,98.7,595,296,299,99
23320, 옹진군,005001, 0세,2016,122,61,61,100,122,61,61,100
23320, 옹진군,005002, 1세,2016,110,62,48,129.2,110,62,48,129.2
23320, 옹진군,005003, 2세,2016,134,60,74,81.1,134,60,74,81.1
23320, 옹진군,005004, 3세,2016,119,61,58,105.2,119,61,58,105.2
23320, 옹진군,005005, 4세,2016,111,52,59,88.1,110,52,58,89.7
23320, 옹진군,010,5~9세,2016,610,320,290,110.3,610,320,290,110.3
23320, 옹진군,010001, 5세,2016,145,85,60,141.7,145,85,60,141.7
23320, 옹진군,010002, 6세,2016,108,57,51,111.8,108,57,51,111.8
23320, 옹진군,010003, 7세,2016,106,60,46,130.4,106,60,46,130.4
23320, 옹진군,010004, 8세,2016,116,53,63,84.1,116,53,63,84.1
23320, 옹진군,010005, 9세,2016,135,65,70,92.9,135,65,70,92.9
23320, 옹진군,015,10~14세,2016,519,274,245,111.8,519,274,245,111.8
23320, 옹진군,015001, 10세,2016,97,49,48,102.1,97,49,48,102.1
23320, 옹진군,015002, 11세,2016,95,57,38,150,95,57,38,150
23320, 옹진군,015003, 12세,2016,113,56,57,98.2,113,56,57,98.2
23320, 옹진군,015004, 13세,2016,107,52,55,94.5,107,52,55,94.5
23320, 옹진군,015005, 14세,2016,107,60,47,127.7,107,60,47,127.7
23320, 옹진군,020,15~19세,2016,570,328,242,135.5,569,327,242,135.1
23320, 옹진군,020001, 15세,2016,125,74,51,145.1,124,73,51,143.1
23320, 옹진군,020002, 16세,2016,134,76,58,131,134,76,58,131
23320, 옹진군,020003, 17세,2016,141,72,69,104.3,141,72,69,104.3
23320, 옹진군,020004, 18세,2016,105,63,42,150,105,63,42,150
23320, 옹진군,020005, 19세,2016,65,43,22,195.5,65,43,22,195.5
23320, 옹진군,025,20~24세,2016,1248,1012,236,428.8,1213,982,231,425.1
23320, 옹진군,025001, 20세,2016,138,116,22,527.3,136,115,21,547.6
23320, 옹진군,025002, 21세,2016,212,184,28,657.1,210,182,28,650
23320, 옹진군,025003, 22세,2016,288,233,55,423.6,280,225,55,409.1
23320, 옹진군,025004, 23세,2016,308,252,56,450,294,240,54,444.4
23320, 옹진군,025005, 24세,2016,302,227,75,302.7,293,220,73,301.4
23320, 옹진군,030,25~29세,2016,1236,894,342,261.4,1195,861,334,257.8
23320, 옹진군,030001, 25세,2016,284,209,75,278.7,279,206,73,282.2
23320, 옹진군,030002, 26세,2016,271,197,74,266.2,259,188,71,264.8
23320, 옹진군,030003, 27세,2016,247,188,59,318.6,240,183,57,321.1
23320, 옹진군,030004, 28세,2016,200,142,58,244.8,195,137,58,236.2
23320, 옹진군,030005, 29세,2016,234,158,76,207.9,222,147,75,196
23320, 옹진군,035,30~34세,2016,1040,644,396,162.6,1000,609,391,155.8
23320, 옹진군,035001, 30세,2016,209,137,72,190.3,202,130,72,180.6
23320, 옹진군,035002, 31세,2016,191,122,69,176.8,181,112,69,162.3
23320, 옹진군,035003, 32세,2016,188,112,76,147.4,180,106,74,143.2
23320, 옹진군,035004, 33세,2016,209,127,82,154.9,204,122,82,148.8
23320, 옹진군,035005, 34세,2016,243,146,97,150.5,233,139,94,147.9
23320, 옹진군,040,35~39세,2016,1174,702,472,148.7,1155,687,468,146.8
23320, 옹진군,040001, 35세,2016,230,142,88,161.4,225,138,87,158.6
23320, 옹진군,040002, 36세,2016,258,144,114,126.3,253,140,113,123.9
23320, 옹진군,040003, 37세,2016,260,153,107,143,259,152,107,142.1
23320, 옹진군,040004, 38세,2016,218,131,87,150.6,215,129,86,150
23320, 옹진군,040005, 39세,2016,208,132,76,173.7,203,128,75,170.7
23320, 옹진군,045,40~44세,2016,1185,780,405,192.6,1169,771,398,193.7
23320, 옹진군,045001, 40세,2016,207,139,68,204.4,204,138,66,209.1
23320, 옹진군,045002, 41세,2016,251,167,84,198.8,249,166,83,200
23320, 옹진군,045003, 42세,2016,246,161,85,189.4,241,157,84,186.9
23320, 옹진군,045004, 43세,2016,247,154,93,165.6,244,152,92,165.2
23320, 옹진군,045005, 44세,2016,234,159,75,212,231,158,73,216.4
23320, 옹진군,050,45~49세,2016,1323,820,503,163,1303,807,496,162.7
23320, 옹진군,050001, 45세,2016,254,156,98,159.2,250,153,97,157.7
23320, 옹진군,050002, 46세,2016,260,173,87,198.9,254,170,84,202.4
23320, 옹진군,050003, 47세,2016,241,150,91,164.8,237,146,91,160.4
23320, 옹진군,050004, 48세,2016,278,169,109,155,275,168,107,157
23320, 옹진군,050005, 49세,2016,290,172,118,145.8,287,170,117,145.3
23320, 옹진군,055,50~54세,2016,1663,976,687,142.1,1645,969,676,143.3
23320, 옹진군,055001, 50세,2016,294,180,114,157.9,290,178,112,158.9
23320, 옹진군,055002, 51세,2016,317,178,139,128.1,315,177,138,128.3
23320, 옹진군,055003, 52세,2016,299,174,125,139.2,297,172,125,137.6
23320, 옹진군,055004, 53세,2016,365,213,152,140.1,360,212,148,143.2
23320, 옹진군,055005, 54세,2016,388,231,157,147.1,383,230,153,150.3
23320, 옹진군,060,55~59세,2016,1973,1101,872,126.3,1962,1098,864,127.1
23320, 옹진군,060001, 55세,2016,441,255,186,137.1,440,255,185,137.8
23320, 옹진군,060002, 56세,2016,392,218,174,125.3,389,217,172,126.2
23320, 옹진군,060003, 57세,2016,396,210,186,112.9,394,209,185,113
23320, 옹진군,060004, 58세,2016,362,203,159,127.7,358,202,156,129.5
23320, 옹진군,060005, 59세,2016,382,215,167,128.7,381,215,166,129.5
23320, 옹진군,065,60~64세,2016,1650,869,781,111.3,1645,868,777,111.7
23320, 옹진군,065001, 60세,2016,381,201,180,111.7,380,201,179,112.3
23320, 옹진군,065002, 61세,2016,400,202,198,102,397,201,196,102.6
23320, 옹진군,065003, 62세,2016,305,161,144,111.8,305,161,144,111.8
23320, 옹진군,065004, 63세,2016,261,146,115,127,261,146,115,127
23320, 옹진군,065005, 64세,2016,303,159,144,110.4,302,159,143,111.2
23320, 옹진군,070,65~69세,2016,1215,618,597,103.5,1209,616,593,103.9
23320, 옹진군,070001, 65세,2016,175,80,95,84.2,174,80,94,85.1
23320, 옹진군,070002, 66세,2016,272,155,117,132.5,271,155,116,133.6
23320, 옹진군,070003, 67세,2016,250,131,119,110.1,249,131,118,111
23320, 옹진군,070004, 68세,2016,209,103,106,97.2,207,102,105,97.1
23320, 옹진군,070005, 69세,2016,309,149,160,93.1,308,148,160,92.5
23320, 옹진군,075,70~74세,2016,1039,503,536,93.8,1036,501,535,93.6
23320, 옹진군,075001, 70세,2016,226,106,120,88.3,225,106,119,89.1
23320, 옹진군,075002, 71세,2016,221,111,110,100.9,220,110,110,100
23320, 옹진군,075003, 72세,2016,169,87,82,106.1,169,87,82,106.1
23320, 옹진군,075004, 73세,2016,201,96,105,91.4,200,95,105,90.5
23320, 옹진군,075005, 74세,2016,222,103,119,86.6,222,103,119,86.6
23320, 옹진군,080,75~79세,2016,806,360,446,80.7,805,359,446,80.5
23320, 옹진군,080001, 75세,2016,180,89,91,97.8,180,89,91,97.8
23320, 옹진군,080002, 76세,2016,165,83,82,101.2,164,82,82,100
23320, 옹진군,080003, 77세,2016,154,61,93,65.6,154,61,93,65.6
23320, 옹진군,080004, 78세,2016,155,63,92,68.5,155,63,92,68.5
23320, 옹진군,080005, 79세,2016,152,64,88,72.7,152,64,88,72.7
23320, 옹진군,085,80~84세,2016,584,215,369,58.3,583,215,368,58.4
23320, 옹진군,085001, 80세,2016,149,52,97,53.6,148,52,96,54.2
23320, 옹진군,085002, 81세,2016,116,45,71,63.4,116,45,71,63.4
23320, 옹진군,085003, 82세,2016,116,44,72,61.1,116,44,72,61.1
23320, 옹진군,085004, 83세,2016,106,46,60,76.7,106,46,60,76.7
23320, 옹진군,085005, 84세,2016,97,28,69,40.6,97,28,69,40.6
23320, 옹진군,090,85~89세,2016,322,79,243,32.5,322,79,243,32.5
23320, 옹진군,090001, 85세,2016,88,22,66,33.3,88,22,66,33.3
23320, 옹진군,090002, 86세,2016,72,12,60,20,72,12,60,20
23320, 옹진군,090003, 87세,2016,62,22,40,55,62,22,40,55
23320, 옹진군,090004, 88세,2016,52,12,40,30,52,12,40,30
23320, 옹진군,090005, 89세,2016,48,11,37,29.7,48,11,37,29.7
23320, 옹진군,095,90~94세,2016,117,25,92,27.2,117,25,92,27.2
23320, 옹진군,095001, 90세,2016,28,6,22,27.3,28,6,22,27.3
23320, 옹진군,095002, 91세,2016,37,8,29,27.6,37,8,29,27.6
23320, 옹진군,095003, 92세,2016,21,5,16,31.3,21,5,16,31.3
23320, 옹진군,095004, 93세,2016,15,X,12,25,15,X,12,25
23320, 옹진군,095005, 94세,2016,16,X,13,23.1,16,X,13,23.1
23320, 옹진군,100,95~99세,2016,32,9,23,39.1,32,9,23,39.1
23320, 옹진군,100001, 95세,2016,11,X,7,57.1,11,X,7,57.1
23320, 옹진군,100002, 96세,2016,11,X,8,37.5,11,X,8,37.5
23320, 옹진군,100003, 97세,2016,X,X,X,0,X,X,X,0
23320, 옹진군,100004, 98세,2016,X,X,X,50,X,X,X,50
23320, 옹진군,100005, 99세,2016,5,X,X,25,5,X,X,25
23320, 옹진군,101,100세이상,2016,X,X,X,200,X,X,X,200
23320, 옹진군,102,15세미만,2016,1725,890,835,106.6,1724,890,834,106.7
23320, 옹진군,103,15~64세,2016,13062,8126,4936,164.6,12856,7979,4877,163.6
23320, 옹진군,104,65세이상,2016,4118,1811,2307,78.5,4107,1806,2301,78.5
23320, 옹진군,086,85세이상,2016,474,115,359,32,474,115,359,32
23320, 옹진군,126,평균연령,2016,47.1,44.5,50.5,,47.2,44.6,50.5,
23320, 옹진군,127,중위연령,2016,49.8,46,54.5,,50.1,46.3,54.6,
24,광주광역시,000,합계,2016,1501557,747303,754254,99.1,1477856,734092,743764,98.7
24,광주광역시,005,0~4세,2016,66628,34232,32396,105.7,66264,34048,32216,105.7
24,광주광역시,005001, 0세,2016,11984,6062,5922,102.4,11917,6031,5886,102.5
24,광주광역시,005002, 1세,2016,12788,6601,6187,106.7,12720,6566,6154,106.7
24,광주광역시,005003, 2세,2016,13303,6747,6556,102.9,13223,6707,6516,102.9
24,광주광역시,005004, 3세,2016,13440,6956,6484,107.3,13363,6916,6447,107.3
24,광주광역시,005005, 4세,2016,15113,7866,7247,108.5,15041,7828,7213,108.5
24,광주광역시,010,5~9세,2016,74728,38669,36059,107.2,74465,38540,35925,107.3
24,광주광역시,010001, 5세,2016,14896,7712,7184,107.3,14827,7678,7149,107.4
24,광주광역시,010002, 6세,2016,14634,7547,7087,106.5,14571,7514,7057,106.5
24,광주광역시,010003, 7세,2016,14352,7374,6978,105.7,14305,7353,6952,105.8
24,광주광역시,010004, 8세,2016,14997,7785,7212,107.9,14950,7760,7190,107.9
24,광주광역시,010005, 9세,2016,15849,8251,7598,108.6,15812,8235,7577,108.7
24,광주광역시,015,10~14세,2016,78398,40840,37558,108.7,78207,40741,37466,108.7
24,광주광역시,015001, 10세,2016,14525,7558,6967,108.5,14476,7533,6943,108.5
24,광주광역시,015002, 11세,2016,14356,7447,6909,107.8,14319,7427,6892,107.8
24,광주광역시,015003, 12세,2016,15814,8203,7611,107.8,15792,8191,7601,107.8
24,광주광역시,015004, 13세,2016,16648,8780,7868,111.6,16611,8763,7848,111.7
24,광주광역시,015005, 14세,2016,17055,8852,8203,107.9,17009,8827,8182,107.9
24,광주광역시,020,15~19세,2016,108159,55626,52533,105.9,107517,55309,52208,105.9
24,광주광역시,020001, 15세,2016,19620,10148,9472,107.1,19579,10127,9452,107.1
24,광주광역시,020002, 16세,2016,21410,11188,10222,109.5,21367,11170,10197,109.5
24,광주광역시,020003, 17세,2016,21147,11003,10144,108.5,21081,10969,10112,108.5
24,광주광역시,020004, 18세,2016,22621,11558,11063,104.5,22457,11456,11001,104.1
24,광주광역시,020005, 19세,2016,23361,11729,11632,100.8,23033,11587,11446,101.2
24,광주광역시,025,20~24세,2016,119181,61847,57334,107.9,114951,59666,55285,107.9
24,광주광역시,025001, 20세,2016,24183,12472,11711,106.5,23592,12204,11388,107.2
24,광주광역시,025002, 21세,2016,24476,12390,12086,102.5,23724,12039,11685,103
24,광주광역시,025003, 22세,2016,24448,12766,11682,109.3,23527,12304,11223,109.6
24,광주광역시,025004, 23세,2016,23433,12339,11094,111.2,22440,11797,10643,110.8
24,광주광역시,025005, 24세,2016,22641,11880,10761,110.4,21668,11322,10346,109.4
24,광주광역시,030,25~29세,2016,93810,48861,44949,108.7,88844,45932,42912,107
24,광주광역시,030001, 25세,2016,20520,10746,9774,109.9,19528,10165,9363,108.6
24,광주광역시,030002, 26세,2016,19319,10198,9121,111.8,18249,9576,8673,110.4
24,광주광역시,030003, 27세,2016,18299,9492,8807,107.8,17305,8914,8391,106.2
24,광주광역시,030004, 28세,2016,17627,9146,8481,107.8,16686,8591,8095,106.1
24,광주광역시,030005, 29세,2016,18045,9279,8766,105.9,17076,8686,8390,103.5
24,광주광역시,035,30~34세,2016,103257,53030,50227,105.6,99729,50888,48841,104.2
24,광주광역시,035001, 30세,2016,18199,9316,8883,104.9,17385,8838,8547,103.4
24,광주광역시,035002, 31세,2016,18318,9458,8860,106.7,17559,9004,8555,105.2
24,광주광역시,035003, 32세,2016,20058,10370,9688,107,19368,9961,9407,105.9
24,광주광역시,035004, 33세,2016,22201,11424,10777,106,21562,11016,10546,104.5
24,광주광역시,035005, 34세,2016,24481,12462,12019,103.7,23855,12069,11786,102.4
24,광주광역시,040,35~39세,2016,117658,58976,58682,100.5,115222,57448,57774,99.4
24,광주광역시,040001, 35세,2016,23595,11921,11674,102.1,23029,11554,11475,100.7
24,광주광역시,040002, 36세,2016,24672,12254,12418,98.7,24169,11941,12228,97.7
24,광주광역시,040003, 37세,2016,24225,12097,12128,99.7,23723,11776,11947,98.6
24,광주광역시,040004, 38세,2016,22017,11078,10939,101.3,21562,10807,10755,100.5
24,광주광역시,040005, 39세,2016,23149,11626,11523,100.9,22739,11370,11369,100
24,광주광역시,045,40~44세,2016,126485,63576,62909,101.1,124493,62410,62083,100.5
24,광주광역시,045001, 40세,2016,23139,11755,11384,103.3,22688,11492,11196,102.6
24,광주광역시,045002, 41세,2016,23646,11913,11733,101.5,23237,11666,11571,100.8
24,광주광역시,045003, 42세,2016,26709,13540,13169,102.8,26354,13336,13018,102.4
24,광주광역시,045004, 43세,2016,26360,13035,13325,97.8,25968,12801,13167,97.2
24,광주광역시,045005, 44세,2016,26631,13333,13298,100.3,26246,13115,13131,99.9
24,광주광역시,050,45~49세,2016,134150,67154,66996,100.2,132463,66241,66222,100
24,광주광역시,050001, 45세,2016,28172,14087,14085,100,27805,13875,13930,99.6
24,광주광역시,050002, 46세,2016,27184,13687,13497,101.4,26810,13489,13321,101.3
24,광주광역시,050003, 47세,2016,26598,13408,13190,101.7,26254,13210,13044,101.3
24,광주광역시,050004, 48세,2016,27494,13668,13826,98.9,27166,13493,13673,98.7
24,광주광역시,050005, 49세,2016,24702,12304,12398,99.2,24428,12174,12254,99.3
24,광주광역시,055,50~54세,2016,117447,59303,58144,102,116006,58621,57385,102.2
24,광주광역시,055001, 50세,2016,24843,12680,12163,104.3,24547,12537,12010,104.4
24,광주광역시,055002, 51세,2016,24110,12008,12102,99.2,23806,11862,11944,99.3
24,광주광역시,055003, 52세,2016,22262,11234,11028,101.9,21937,11078,10859,102
24,광주광역시,055004, 53세,2016,23782,12065,11717,103,23483,11936,11547,103.4
24,광주광역시,055005, 54세,2016,22450,11316,11134,101.6,22233,11208,11025,101.7
24,광주광역시,060,55~59세,2016,111120,54780,56340,97.2,110190,54325,55865,97.2
24,광주광역시,060001, 55세,2016,24115,12035,12080,99.6,23924,11951,11973,99.8
24,광주광역시,060002, 56세,2016,25167,12394,12773,97,24945,12283,12662,97
24,광주광역시,060003, 57세,2016,22323,10952,11371,96.3,22135,10858,11277,96.3
24,광주광역시,060004, 58세,2016,20037,9793,10244,95.6,19857,9703,10154,95.6
24,광주광역시,060005, 59세,2016,19478,9606,9872,97.3,19329,9530,9799,97.3
24,광주광역시,065,60~64세,2016,75538,36728,38810,94.6,74989,36450,38539,94.6
24,광주광역시,065001, 60세,2016,16797,8391,8406,99.8,16655,8315,8340,99.7
24,광주광역시,065002, 61세,2016,17719,8544,9175,93.1,17590,8475,9115,93
24,광주광역시,065003, 62세,2016,14301,6964,7337,94.9,14198,6913,7285,94.9
24,광주광역시,065004, 63세,2016,12726,6080,6646,91.5,12643,6040,6603,91.5
24,광주광역시,065005, 64세,2016,13995,6749,7246,93.1,13903,6707,7196,93.2
24,광주광역시,070,65~69세,2016,59291,28020,31271,89.6,59030,27903,31127,89.6
24,광주광역시,070001, 65세,2016,11551,5525,6026,91.7,11473,5493,5980,91.9
24,광주광역시,070002, 66세,2016,11970,5718,6252,91.5,11915,5694,6221,91.5
24,광주광역시,070003, 67세,2016,12468,5867,6601,88.9,12426,5843,6583,88.8
24,광주광역시,070004, 68세,2016,11452,5420,6032,89.9,11411,5402,6009,89.9
24,광주광역시,070005, 69세,2016,11850,5490,6360,86.3,11805,5471,6334,86.4
24,광주광역시,075,70~74세,2016,45355,20774,24581,84.5,45256,20733,24523,84.5
24,광주광역시,075001, 70세,2016,9061,4321,4740,91.2,9032,4306,4726,91.1
24,광주광역시,075002, 71세,2016,8760,4007,4753,84.3,8745,4003,4742,84.4
24,광주광역시,075003, 72세,2016,8309,3774,4535,83.2,8287,3764,4523,83.2
24,광주광역시,075004, 73세,2016,8371,3796,4575,83,8355,3790,4565,83
24,광주광역시,075005, 74세,2016,10854,4876,5978,81.6,10837,4870,5967,81.6
24,광주광역시,080,75~79세,2016,34776,14244,20532,69.4,34711,14215,20496,69.4
24,광주광역시,080001, 75세,2016,8216,3509,4707,74.5,8202,3505,4697,74.6
24,광주광역시,080002, 76세,2016,7278,2984,4294,69.5,7261,2975,4286,69.4
24,광주광역시,080003, 77세,2016,7020,2916,4104,71.1,7009,2911,4098,71
24,광주광역시,080004, 78세,2016,6392,2568,3824,67.2,6376,2560,3816,67.1
24,광주광역시,080005, 79세,2016,5870,2267,3603,62.9,5863,2264,3599,62.9
24,광주광역시,085,80~84세,2016,21087,7177,13910,51.6,21054,7162,13892,51.6
24,광주광역시,085001, 80세,2016,5052,1832,3220,56.9,5044,1828,3216,56.8
24,광주광역시,085002, 81세,2016,4958,1751,3207,54.6,4951,1749,3202,54.6
24,광주광역시,085003, 82세,2016,4398,1508,2890,52.2,4390,1506,2884,52.2
24,광주광역시,085004, 83세,2016,3538,1124,2414,46.6,3535,1123,2412,46.6
24,광주광역시,085005, 84세,2016,3141,962,2179,44.1,3134,956,2178,43.9
24,광주광역시,090,85~89세,2016,10251,2660,7591,35,10238,2656,7582,35
24,광주광역시,090001, 85세,2016,2530,705,1825,38.6,2525,703,1822,38.6
24,광주광역시,090002, 86세,2016,2631,644,1987,32.4,2629,643,1986,32.4
24,광주광역시,090003, 87세,2016,2084,575,1509,38.1,2082,575,1507,38.2
24,광주광역시,090004, 88세,2016,1659,427,1232,34.7,1657,426,1231,34.6
24,광주광역시,090005, 89세,2016,1347,309,1038,29.8,1345,309,1036,29.8
24,광주광역시,095,90~94세,2016,3411,704,2707,26,3404,703,2701,26
24,광주광역시,095001, 90세,2016,1015,229,786,29.1,1013,228,785,29
24,광주광역시,095002, 91세,2016,823,171,652,26.2,822,171,651,26.3
24,광주광역시,095003, 92세,2016,501,116,385,30.1,500,116,384,30.2
24,광주광역시,095004, 93세,2016,662,120,542,22.1,659,120,539,22.3
24,광주광역시,095005, 94세,2016,410,68,342,19.9,410,68,342,19.9
24,광주광역시,100,95~99세,2016,734,96,638,15,730,95,635,15
24,광주광역시,100001, 95세,2016,278,34,244,13.9,277,34,243,14
24,광주광역시,100002, 96세,2016,198,22,176,12.5,196,21,175,12
24,광주광역시,100003, 97세,2016,128,23,105,21.9,127,23,104,22.1
24,광주광역시,100004, 98세,2016,83,9,74,12.2,83,9,74,12.2
24,광주광역시,100005, 99세,2016,47,8,39,20.5,47,8,39,20.5
24,광주광역시,101,100세이상,2016,93,6,87,6.9,93,6,87,6.9
24,광주광역시,102,15세미만,2016,219754,113741,106013,107.3,218936,113329,105607,107.3
24,광주광역시,103,15~64세,2016,1106805,559881,546924,102.4,1084404,547290,537114,101.9
24,광주광역시,104,65세이상,2016,174998,73681,101317,72.7,174516,73473,101043,72.7
24,광주광역시,086,85세이상,2016,14489,3466,11023,31.4,14465,3460,11005,31.4
24,광주광역시,126,평균연령,2016,39.1,38,40.2,,39.1,38,40.2,
24,광주광역시,127,중위연령,2016,39.5,38.4,40.6,,39.7,38.6,40.8,
24010, 동구,000,합계,2016,101293,50763,50530,100.5,99827,50024,49803,100.4
24010, 동구,005,0~4세,2016,3304,1713,1591,107.7,3290,1706,1584,107.7
24010, 동구,005001, 0세,2016,586,292,294,99.3,585,292,293,99.7
24010, 동구,005002, 1세,2016,680,359,321,111.8,677,357,320,111.6
24010, 동구,005003, 2세,2016,678,359,319,112.5,677,359,318,112.9
24010, 동구,005004, 3세,2016,687,356,331,107.6,681,354,327,108.3
24010, 동구,005005, 4세,2016,673,347,326,106.4,670,344,326,105.5
24010, 동구,010,5~9세,2016,2975,1538,1437,107,2957,1524,1433,106.4
24010, 동구,010001, 5세,2016,682,337,345,97.7,676,332,344,96.5
24010, 동구,010002, 6세,2016,603,312,291,107.2,599,309,290,106.6
24010, 동구,010003, 7세,2016,534,283,251,112.7,531,281,250,112.4
24010, 동구,010004, 8세,2016,570,296,274,108,567,293,274,106.9
24010, 동구,010005, 9세,2016,586,310,276,112.3,584,309,275,112.4
24010, 동구,015,10~14세,2016,3123,1672,1451,115.2,3109,1665,1444,115.3
24010, 동구,015001, 10세,2016,560,292,268,109,557,292,265,110.2
24010, 동구,015002, 11세,2016,555,300,255,117.6,552,297,255,116.5
24010, 동구,015003, 12세,2016,639,334,305,109.5,639,334,305,109.5
24010, 동구,015004, 13세,2016,657,377,280,134.6,654,374,280,133.6
24010, 동구,015005, 14세,2016,712,369,343,107.6,707,368,339,108.6
24010, 동구,020,15~19세,2016,6045,3248,2797,116.1,5978,3201,2777,115.3
24010, 동구,020001, 15세,2016,841,448,393,114,837,447,390,114.6
24010, 동구,020002, 16세,2016,1004,558,446,125.1,1000,554,446,124.2
24010, 동구,020003, 17세,2016,1008,541,467,115.8,1005,539,466,115.7
24010, 동구,020004, 18세,2016,1328,710,618,114.9,1311,695,616,112.8
24010, 동구,020005, 19세,2016,1864,991,873,113.5,1825,966,859,112.5
24010, 동구,025,20~24세,2016,9354,4719,4635,101.8,8957,4571,4386,104.2
24010, 동구,025001, 20세,2016,1755,799,956,83.6,1680,771,909,84.8
24010, 동구,025002, 21세,2016,1834,844,990,85.3,1741,816,925,88.2
24010, 동구,025003, 22세,2016,1986,1023,963,106.2,1906,993,913,108.8
24010, 동구,025004, 23세,2016,1952,1048,904,115.9,1890,1027,863,119
24010, 동구,025005, 24세,2016,1827,1005,822,122.3,1740,964,776,124.2
24010, 동구,030,25~29세,2016,7145,3792,3353,113.1,6885,3660,3225,113.5
24010, 동구,030001, 25세,2016,1559,858,701,122.4,1505,834,671,124.3
24010, 동구,030002, 26세,2016,1459,809,650,124.5,1399,781,618,126.4
24010, 동구,030003, 27세,2016,1473,767,706,108.6,1411,732,679,107.8
24010, 동구,030004, 28세,2016,1297,672,625,107.5,1258,653,605,107.9
24010, 동구,030005, 29세,2016,1357,686,671,102.2,1312,660,652,101.2
24010, 동구,035,30~34세,2016,6843,3694,3149,117.3,6642,3587,3055,117.4
24010, 동구,035001, 30세,2016,1332,724,608,119.1,1280,699,581,120.3
24010, 동구,035002, 31세,2016,1300,690,610,113.1,1257,668,589,113.4
24010, 동구,035003, 32세,2016,1348,751,597,125.8,1308,728,580,125.5
24010, 동구,035004, 33세,2016,1422,756,666,113.5,1386,737,649,113.6
24010, 동구,035005, 34세,2016,1441,773,668,115.7,1411,755,656,115.1
24010, 동구,040,35~39세,2016,6477,3545,2932,120.9,6359,3469,2890,120
24010, 동구,040001, 35세,2016,1405,786,619,127,1368,759,609,124.6
24010, 동구,040002, 36세,2016,1358,703,655,107.3,1338,691,647,106.8
24010, 동구,040003, 37세,2016,1318,724,594,121.9,1295,711,584,121.7
24010, 동구,040004, 38세,2016,1175,668,507,131.8,1154,652,502,129.9
24010, 동구,040005, 39세,2016,1221,664,557,119.2,1204,656,548,119.7
24010, 동구,045,40~44세,2016,6255,3407,2848,119.6,6167,3352,2815,119.1
24010, 동구,045001, 40세,2016,1180,652,528,123.5,1164,644,520,123.8
24010, 동구,045002, 41세,2016,1143,638,505,126.3,1123,626,497,126
24010, 동구,045003, 42세,2016,1258,694,564,123,1249,688,561,122.6
24010, 동구,045004, 43세,2016,1338,698,640,109.1,1316,683,633,107.9
24010, 동구,045005, 44세,2016,1336,725,611,118.7,1315,711,604,117.7
24010, 동구,050,45~49세,2016,7080,3709,3371,110,6993,3663,3330,110
24010, 동구,050001, 45세,2016,1465,788,677,116.4,1447,778,669,116.3
24010, 동구,050002, 46세,2016,1402,735,667,110.2,1387,724,663,109.2
24010, 동구,050003, 47세,2016,1392,738,654,112.8,1377,732,645,113.5
24010, 동구,050004, 48세,2016,1473,744,729,102.1,1452,730,722,101.1
24010, 동구,050005, 49세,2016,1348,704,644,109.3,1330,699,631,110.8
24010, 동구,055,50~54세,2016,7317,3646,3671,99.3,7234,3609,3625,99.6
24010, 동구,055001, 50세,2016,1436,733,703,104.3,1425,729,696,104.7
24010, 동구,055002, 51세,2016,1426,698,728,95.9,1406,690,716,96.4
24010, 동구,055003, 52세,2016,1361,675,686,98.4,1341,666,675,98.7
24010, 동구,055004, 53세,2016,1580,789,791,99.7,1561,780,781,99.9
24010, 동구,055005, 54세,2016,1514,751,763,98.4,1501,744,757,98.3
24010, 동구,060,55~59세,2016,8669,4240,4429,95.7,8611,4209,4402,95.6
24010, 동구,060001, 55세,2016,1751,867,884,98.1,1741,861,880,97.8
24010, 동구,060002, 56세,2016,1869,891,978,91.1,1856,885,971,91.1
24010, 동구,060003, 57세,2016,1726,837,889,94.2,1714,831,883,94.1
24010, 동구,060004, 58세,2016,1687,830,857,96.8,1672,823,849,96.9
24010, 동구,060005, 59세,2016,1636,815,821,99.3,1628,809,819,98.8
24010, 동구,065,60~64세,2016,7130,3363,3767,89.3,7105,3351,3754,89.3
24010, 동구,065001, 60세,2016,1477,712,765,93.1,1472,710,762,93.2
24010, 동구,065002, 61세,2016,1614,756,858,88.1,1609,753,856,88
24010, 동구,065003, 62세,2016,1442,701,741,94.6,1438,699,739,94.6
24010, 동구,065004, 63세,2016,1232,570,662,86.1,1226,568,658,86.3
24010, 동구,065005, 64세,2016,1365,624,741,84.2,1360,621,739,84
24010, 동구,070,65~69세,2016,6123,2788,3335,83.6,6111,2780,3331,83.5
24010, 동구,070001, 65세,2016,1139,527,612,86.1,1137,526,611,86.1
24010, 동구,070002, 66세,2016,1192,558,634,88,1190,557,633,88
24010, 동구,070003, 67세,2016,1315,604,711,85,1314,603,711,84.8
24010, 동구,070004, 68세,2016,1175,538,637,84.5,1171,534,637,83.8
24010, 동구,070005, 69세,2016,1302,561,741,75.7,1299,560,739,75.8
24010, 동구,075,70~74세,2016,5111,2338,2773,84.3,5104,2334,2770,84.3
24010, 동구,075001, 70세,2016,987,438,549,79.8,986,437,549,79.6
24010, 동구,075002, 71세,2016,980,434,546,79.5,977,432,545,79.3
24010, 동구,075003, 72세,2016,922,450,472,95.3,921,449,472,95.1
24010, 동구,075004, 73세,2016,923,418,505,82.8,923,418,505,82.8
24010, 동구,075005, 74세,2016,1299,598,701,85.3,1297,598,699,85.6
24010, 동구,080,75~79세,2016,4143,1889,2254,83.8,4140,1888,2252,83.8
24010, 동구,080001, 75세,2016,1007,472,535,88.2,1006,472,534,88.4
24010, 동구,080002, 76세,2016,891,410,481,85.2,890,409,481,85
24010, 동구,080003, 77세,2016,800,359,441,81.4,800,359,441,81.4
24010, 동구,080004, 78세,2016,778,369,409,90.2,778,369,409,90.2
24010, 동구,080005, 79세,2016,667,279,388,71.9,666,279,387,72.1
24010, 동구,085,80~84세,2016,2470,972,1498,64.9,2461,968,1493,64.8
24010, 동구,085001, 80세,2016,628,272,356,76.4,624,271,353,76.8
24010, 동구,085002, 81세,2016,546,215,331,65,546,215,331,65
24010, 동구,085003, 82세,2016,510,203,307,66.1,508,203,305,66.6
24010, 동구,085004, 83세,2016,426,160,266,60.2,426,160,266,60.2
24010, 동구,085005, 84세,2016,360,122,238,51.3,357,119,238,50
24010, 동구,090,85~89세,2016,1207,362,845,42.8,1203,359,844,42.5
24010, 동구,090001, 85세,2016,291,102,189,54,289,100,189,52.9
24010, 동구,090002, 86세,2016,309,89,220,40.5,308,88,220,40
24010, 동구,090003, 87세,2016,231,66,165,40,231,66,165,40
24010, 동구,090004, 88세,2016,209,67,142,47.2,208,67,141,47.5
24010, 동구,090005, 89세,2016,167,38,129,29.5,167,38,129,29.5
24010, 동구,095,90~94세,2016,412,108,304,35.5,412,108,304,35.5
24010, 동구,095001, 90세,2016,120,42,78,53.8,120,42,78,53.8
24010, 동구,095002, 91세,2016,89,23,66,34.8,89,23,66,34.8
24010, 동구,095003, 92세,2016,83,22,61,36.1,83,22,61,36.1
24010, 동구,095004, 93세,2016,76,16,60,26.7,76,16,60,26.7
24010, 동구,095005, 94세,2016,44,5,39,12.8,44,5,39,12.8
24010, 동구,100,95~99세,2016,99,20,79,25.3,98,20,78,25.6
24010, 동구,100001, 95세,2016,36,6,30,20,35,6,29,20.7
24010, 동구,100002, 96세,2016,26,5,21,23.8,26,5,21,23.8
24010, 동구,100003, 97세,2016,24,7,17,41.2,24,7,17,41.2
24010, 동구,100004, 98세,2016,10,X,9,11.1,10,X,9,11.1
24010, 동구,100005, 99세,2016,X,X,X,50,X,X,X,50
24010, 동구,101,100세이상,2016,11,X,11,0,11,X,11,0
24010, 동구,102,15세미만,2016,9402,4923,4479,109.9,9356,4895,4461,109.7
24010, 동구,103,15~64세,2016,72315,37363,34952,106.9,70931,36672,34259,107
24010, 동구,104,65세이상,2016,19576,8477,11099,76.4,19540,8457,11083,76.3
24010, 동구,086,85세이상,2016,1729,490,1239,39.5,1724,487,1237,39.4
24010, 동구,126,평균연령,2016,43.9,42.4,45.3,,44,42.5,45.5,
24010, 동구,127,중위연령,2016,44.3,42.2,46.6,,44.7,42.5,46.9,
24020, 서구,000,합계,2016,309176,152661,156515,97.5,307155,151698,155457,97.6
24020, 서구,005,0~4세,2016,12554,6421,6133,104.7,12522,6401,6121,104.6
24020, 서구,005001, 0세,2016,2277,1151,1126,102.2,2267,1144,1123,101.9
24020, 서구,005002, 1세,2016,2338,1197,1141,104.9,2334,1195,1139,104.9
24020, 서구,005003, 2세,2016,2515,1255,1260,99.6,2508,1253,1255,99.8
24020, 서구,005004, 3세,2016,2579,1327,1252,106,2572,1322,1250,105.8
24020, 서구,005005, 4세,2016,2845,1491,1354,110.1,2841,1487,1354,109.8
24020, 서구,010,5~9세,2016,14678,7583,7095,106.9,14655,7569,7086,106.8
24020, 서구,010001, 5세,2016,2861,1483,1378,107.6,2856,1481,1375,107.7
24020, 서구,010002, 6세,2016,2773,1442,1331,108.3,2765,1435,1330,107.9
24020, 서구,010003, 7세,2016,2841,1462,1379,106,2838,1461,1377,106.1
24020, 서구,010004, 8세,2016,2957,1521,1436,105.9,2953,1518,1435,105.8
24020, 서구,010005, 9세,2016,3246,1675,1571,106.6,3243,1674,1569,106.7
24020, 서구,015,10~14세,2016,16616,8750,7866,111.2,16606,8745,7861,111.2
24020, 서구,015001, 10세,2016,3005,1602,1403,114.2,3003,1600,1403,114
24020, 서구,015002, 11세,2016,3019,1531,1488,102.9,3018,1530,1488,102.8
24020, 서구,015003, 12세,2016,3309,1736,1573,110.4,3307,1735,1572,110.4
24020, 서구,015004, 13세,2016,3500,1846,1654,111.6,3497,1845,1652,111.7
24020, 서구,015005, 14세,2016,3783,2035,1748,116.4,3781,2035,1746,116.6
24020, 서구,020,15~19세,2016,22070,11512,10558,109,22051,11500,10551,109
24020, 서구,020001, 15세,2016,4282,2173,2109,103,4279,2171,2108,103
24020, 서구,020002, 16세,2016,4558,2401,2157,111.3,4557,2400,2157,111.3
24020, 서구,020003, 17세,2016,4616,2457,2159,113.8,4611,2453,2158,113.7
24020, 서구,020004, 18세,2016,4551,2350,2201,106.8,4547,2347,2200,106.7
24020, 서구,020005, 19세,2016,4063,2131,1932,110.3,4057,2129,1928,110.4
24020, 서구,025,20~24세,2016,22381,11727,10654,110.1,22126,11631,10495,110.8
24020, 서구,025001, 20세,2016,4449,2472,1977,125,4432,2468,1964,125.7
24020, 서구,025002, 21세,2016,4553,2476,2077,119.2,4524,2463,2061,119.5
24020, 서구,025003, 22세,2016,4543,2391,2152,111.1,4492,2371,2121,111.8
24020, 서구,025004, 23세,2016,4378,2199,2179,100.9,4300,2168,2132,101.7
24020, 서구,025005, 24세,2016,4458,2189,2269,96.5,4378,2161,2217,97.5
24020, 서구,030,25~29세,2016,19345,9741,9604,101.4,18948,9568,9380,102
24020, 서구,030001, 25세,2016,4160,2082,2078,100.2,4080,2053,2027,101.3
24020, 서구,030002, 26세,2016,3940,2039,1901,107.3,3863,2001,1862,107.5
24020, 서구,030003, 27세,2016,3824,1896,1928,98.3,3745,1863,1882,99
24020, 서구,030004, 28세,2016,3684,1871,1813,103.2,3600,1835,1765,104
24020, 서구,030005, 29세,2016,3737,1853,1884,98.4,3660,1816,1844,98.5
24020, 서구,035,30~34세,2016,21152,10666,10486,101.7,20875,10522,10353,101.6
24020, 서구,035001, 30세,2016,3871,1919,1952,98.3,3800,1884,1916,98.3
24020, 서구,035002, 31세,2016,3757,1897,1860,102,3704,1871,1833,102.1
24020, 서구,035003, 32세,2016,4113,2083,2030,102.6,4054,2053,2001,102.6
24020, 서구,035004, 33세,2016,4485,2258,2227,101.4,4443,2230,2213,100.8
24020, 서구,035005, 34세,2016,4926,2509,2417,103.8,4874,2484,2390,103.9
24020, 서구,040,35~39세,2016,23586,11503,12083,95.2,23371,11378,11993,94.9
24020, 서구,040001, 35세,2016,4673,2335,2338,99.9,4623,2306,2317,99.5
24020, 서구,040002, 36세,2016,4862,2299,2563,89.7,4819,2275,2544,89.4
24020, 서구,040003, 37세,2016,4805,2316,2489,93,4757,2288,2469,92.7
24020, 서구,040004, 38세,2016,4460,2176,2284,95.3,4424,2154,2270,94.9
24020, 서구,040005, 39세,2016,4786,2377,2409,98.7,4748,2355,2393,98.4
24020, 서구,045,40~44세,2016,26807,12970,13837,93.7,26647,12896,13751,93.8
24020, 서구,045001, 40세,2016,4784,2350,2434,96.5,4751,2335,2416,96.6
24020, 서구,045002, 41세,2016,4921,2408,2513,95.8,4893,2393,2500,95.7
24020, 서구,045003, 42세,2016,5758,2828,2930,96.5,5735,2818,2917,96.6
24020, 서구,045004, 43세,2016,5601,2679,2922,91.7,5568,2658,2910,91.3
24020, 서구,045005, 44세,2016,5743,2705,3038,89,5700,2692,3008,89.5
24020, 서구,050,45~49세,2016,29538,14639,14899,98.3,29332,14535,14797,98.2
24020, 서구,050001, 45세,2016,6150,2998,3152,95.1,6102,2973,3129,95
24020, 서구,050002, 46세,2016,5967,2975,2992,99.4,5925,2957,2968,99.6
24020, 서구,050003, 47세,2016,5963,2959,3004,98.5,5926,2936,2990,98.2
24020, 서구,050004, 48세,2016,6033,3021,3012,100.3,5994,3000,2994,100.2
24020, 서구,050005, 49세,2016,5425,2686,2739,98.1,5385,2669,2716,98.3
24020, 서구,055,50~54세,2016,25191,12581,12610,99.8,25022,12499,12523,99.8
24020, 서구,055001, 50세,2016,5257,2666,2591,102.9,5225,2649,2576,102.8
24020, 서구,055002, 51세,2016,5116,2557,2559,99.9,5079,2543,2536,100.3
24020, 서구,055003, 52세,2016,4865,2434,2431,100.1,4832,2416,2416,100
24020, 서구,055004, 53세,2016,5083,2532,2551,99.3,5047,2516,2531,99.4
24020, 서구,055005, 54세,2016,4870,2392,2478,96.5,4839,2375,2464,96.4
24020, 서구,060,55~59세,2016,23650,11546,12104,95.4,23531,11496,12035,95.5
24020, 서구,060001, 55세,2016,5069,2507,2562,97.9,5041,2497,2544,98.2
24020, 서구,060002, 56세,2016,5378,2637,2741,96.2,5355,2627,2728,96.3
24020, 서구,060003, 57세,2016,4765,2312,2453,94.3,4740,2302,2438,94.4
24020, 서구,060004, 58세,2016,4193,1991,2202,90.4,4169,1978,2191,90.3
24020, 서구,060005, 59세,2016,4245,2099,2146,97.8,4226,2092,2134,98
24020, 서구,065,60~64세,2016,16080,7838,8242,95.1,16016,7808,8208,95.1
24020, 서구,065001, 60세,2016,3591,1779,1812,98.2,3575,1769,1806,98
24020, 서구,065002, 61세,2016,3833,1870,1963,95.3,3819,1864,1955,95.3
24020, 서구,065003, 62세,2016,2966,1460,1506,96.9,2952,1454,1498,97.1
24020, 서구,065004, 63세,2016,2709,1282,1427,89.8,2701,1281,1420,90.2
24020, 서구,065005, 64세,2016,2981,1447,1534,94.3,2969,1440,1529,94.2
24020, 서구,070,65~69세,2016,12339,5882,6457,91.1,12292,5860,6432,91.1
24020, 서구,070001, 65세,2016,2392,1168,1224,95.4,2372,1157,1215,95.2
24020, 서구,070002, 66세,2016,2503,1202,1301,92.4,2498,1199,1299,92.3
24020, 서구,070003, 67세,2016,2609,1240,1369,90.6,2604,1236,1368,90.4
24020, 서구,070004, 68세,2016,2352,1107,1245,88.9,2343,1106,1237,89.4
24020, 서구,070005, 69세,2016,2483,1165,1318,88.4,2475,1162,1313,88.5
24020, 서구,075,70~74세,2016,9278,4264,5014,85,9267,4258,5009,85
24020, 서구,075001, 70세,2016,1860,872,988,88.3,1857,870,987,88.1
24020, 서구,075002, 71세,2016,1855,874,981,89.1,1854,874,980,89.2
24020, 서구,075003, 72세,2016,1687,755,932,81,1682,751,931,80.7
24020, 서구,075004, 73세,2016,1742,814,928,87.7,1740,814,926,87.9
24020, 서구,075005, 74세,2016,2134,949,1185,80.1,2134,949,1185,80.1
24020, 서구,080,75~79세,2016,6914,2886,4028,71.6,6906,2882,4024,71.6
24020, 서구,080001, 75세,2016,1621,731,890,82.1,1618,729,889,82
24020, 서구,080002, 76세,2016,1462,618,844,73.2,1461,617,844,73.1
24020, 서구,080003, 77세,2016,1441,577,864,66.8,1440,576,864,66.7
24020, 서구,080004, 78세,2016,1244,505,739,68.3,1241,505,736,68.6
24020, 서구,080005, 79세,2016,1146,455,691,65.8,1146,455,691,65.8
24020, 서구,085,80~84세,2016,4167,1474,2693,54.7,4161,1472,2689,54.7
24020, 서구,085001, 80세,2016,987,368,619,59.5,987,368,619,59.5
24020, 서구,085002, 81세,2016,970,391,579,67.5,968,390,578,67.5
24020, 서구,085003, 82세,2016,843,282,561,50.3,841,282,559,50.4
24020, 서구,085004, 83세,2016,721,232,489,47.4,720,232,488,47.5
24020, 서구,085005, 84세,2016,646,201,445,45.2,645,200,445,44.9
24020, 서구,090,85~89세,2016,1973,525,1448,36.3,1972,525,1447,36.3
24020, 서구,090001, 85세,2016,486,143,343,41.7,486,143,343,41.7
24020, 서구,090002, 86세,2016,461,103,358,28.8,460,103,357,28.9
24020, 서구,090003, 87세,2016,449,138,311,44.4,449,138,311,44.4
24020, 서구,090004, 88세,2016,318,80,238,33.6,318,80,238,33.6
24020, 서구,090005, 89세,2016,259,61,198,30.8,259,61,198,30.8
24020, 서구,095,90~94세,2016,694,137,557,24.6,692,137,555,24.7
24020, 서구,095001, 90세,2016,212,41,171,24,211,41,170,24.1
24020, 서구,095002, 91세,2016,168,34,134,25.4,168,34,134,25.4
24020, 서구,095003, 92세,2016,105,25,80,31.3,105,25,80,31.3
24020, 서구,095004, 93세,2016,130,26,104,25,129,26,103,25.2
24020, 서구,095005, 94세,2016,79,11,68,16.2,79,11,68,16.2
24020, 서구,100,95~99세,2016,144,15,129,11.6,144,15,129,11.6
24020, 서구,100001, 95세,2016,54,6,48,12.5,54,6,48,12.5
24020, 서구,100002, 96세,2016,30,X,28,7.1,30,X,28,7.1
24020, 서구,100003, 97세,2016,25,X,22,13.6,25,X,22,13.6
24020, 서구,100004, 98세,2016,19,X,16,18.8,19,X,16,18.8
24020, 서구,100005, 99세,2016,16,X,15,6.7,16,X,15,6.7
24020, 서구,101,100세이상,2016,19,X,18,5.6,19,X,18,5.6
24020, 서구,102,15세미만,2016,43848,22754,21094,107.9,43783,22715,21068,107.8
24020, 서구,103,15~64세,2016,229800,114723,115077,99.7,227919,113833,114086,99.8
24020, 서구,104,65세이상,2016,35528,15184,20344,74.6,35453,15150,20303,74.6
24020, 서구,086,85세이상,2016,2830,678,2152,31.5,2827,678,2149,31.5
24020, 서구,126,평균연령,2016,39.5,38.4,40.5,,39.5,38.4,40.6,
24020, 서구,127,중위연령,2016,40.5,39.3,41.5,,40.5,39.4,41.6,
24030, 남구,000,합계,2016,220733,106966,113767,94,219105,106297,112808,94.2
24030, 남구,005,0~4세,2016,8711,4451,4260,104.5,8694,4441,4253,104.4
24030, 남구,005001, 0세,2016,1466,735,731,100.5,1463,734,729,100.7
24030, 남구,005002, 1세,2016,1683,829,854,97.1,1681,828,853,97.1
24030, 남구,005003, 2세,2016,1771,926,845,109.6,1768,924,844,109.5
24030, 남구,005004, 3세,2016,1729,885,844,104.9,1723,880,843,104.4
24030, 남구,005005, 4세,2016,2062,1076,986,109.1,2059,1075,984,109.2
24030, 남구,010,5~9세,2016,10082,5186,4896,105.9,10070,5179,4891,105.9
24030, 남구,010001, 5세,2016,1989,1021,968,105.5,1982,1019,963,105.8
24030, 남구,010002, 6세,2016,2016,1042,974,107,2015,1041,974,106.9
24030, 남구,010003, 7세,2016,1942,999,943,105.9,1941,998,943,105.8
24030, 남구,010004, 8세,2016,2023,1051,972,108.1,2021,1049,972,107.9
24030, 남구,010005, 9세,2016,2112,1073,1039,103.3,2111,1072,1039,103.2
24030, 남구,015,10~14세,2016,10743,5482,5261,104.2,10725,5470,5255,104.1
24030, 남구,015001, 10세,2016,1975,983,992,99.1,1969,979,990,98.9
24030, 남구,015002, 11세,2016,1904,988,916,107.9,1901,986,915,107.8
24030, 남구,015003, 12세,2016,2210,1132,1078,105,2207,1130,1077,104.9
24030, 남구,015004, 13세,2016,2197,1139,1058,107.7,2195,1138,1057,107.7
24030, 남구,015005, 14세,2016,2457,1240,1217,101.9,2453,1237,1216,101.7
24030, 남구,020,15~19세,2016,15359,7711,7648,100.8,15292,7681,7611,100.9
24030, 남구,020001, 15세,2016,2757,1387,1370,101.2,2751,1383,1368,101.1
24030, 남구,020002, 16세,2016,2830,1402,1428,98.2,2826,1400,1426,98.2
24030, 남구,020003, 17세,2016,3078,1526,1552,98.3,3066,1520,1546,98.3
24030, 남구,020004, 18세,2016,3354,1696,1658,102.3,3335,1687,1648,102.4
24030, 남구,020005, 19세,2016,3340,1700,1640,103.7,3314,1691,1623,104.2
24030, 남구,025,20~24세,2016,16789,8574,8215,104.4,16425,8438,7987,105.6
24030, 남구,025001, 20세,2016,3400,1728,1672,103.3,3331,1702,1629,104.5
24030, 남구,025002, 21세,2016,3562,1738,1824,95.3,3497,1714,1783,96.1
24030, 남구,025003, 22세,2016,3480,1813,1667,108.8,3400,1780,1620,109.9
24030, 남구,025004, 23세,2016,3327,1744,1583,110.2,3245,1713,1532,111.8
24030, 남구,025005, 24세,2016,3020,1551,1469,105.6,2952,1529,1423,107.4
24030, 남구,030,25~29세,2016,12414,6240,6174,101.1,12149,6143,6006,102.3
24030, 남구,030001, 25세,2016,2796,1381,1415,97.6,2731,1360,1371,99.2
24030, 남구,030002, 26세,2016,2610,1285,1325,97,2548,1260,1288,97.8
24030, 남구,030003, 27세,2016,2418,1241,1177,105.4,2377,1225,1152,106.3
24030, 남구,030004, 28세,2016,2292,1185,1107,107,2241,1165,1076,108.3
24030, 남구,030005, 29세,2016,2298,1148,1150,99.8,2252,1133,1119,101.3
24030, 남구,035,30~34세,2016,13845,6916,6929,99.8,13661,6843,6818,100.4
24030, 남구,035001, 30세,2016,2343,1203,1140,105.5,2299,1184,1115,106.2
24030, 남구,035002, 31세,2016,2412,1205,1207,99.8,2370,1190,1180,100.8
24030, 남구,035003, 32세,2016,2687,1347,1340,100.5,2643,1333,1310,101.8
24030, 남구,035004, 33세,2016,3057,1537,1520,101.1,3025,1521,1504,101.1
24030, 남구,035005, 34세,2016,3346,1624,1722,94.3,3324,1615,1709,94.5
24030, 남구,040,35~39세,2016,15880,7911,7969,99.3,15761,7859,7902,99.5
24030, 남구,040001, 35세,2016,3324,1648,1676,98.3,3301,1640,1661,98.7
24030, 남구,040002, 36세,2016,3315,1658,1657,100.1,3290,1647,1643,100.2
24030, 남구,040003, 37세,2016,3199,1618,1581,102.3,3176,1608,1568,102.6
24030, 남구,040004, 38세,2016,2931,1446,1485,97.4,2903,1433,1470,97.5
24030, 남구,040005, 39세,2016,3111,1541,1570,98.2,3091,1531,1560,98.1
24030, 남구,045,40~44세,2016,16912,8431,8481,99.4,16781,8371,8410,99.5
24030, 남구,045001, 40세,2016,3107,1569,1538,102,3075,1557,1518,102.6
24030, 남구,045002, 41세,2016,3140,1559,1581,98.6,3114,1545,1569,98.5
24030, 남구,045003, 42세,2016,3484,1763,1721,102.4,3471,1757,1714,102.5
24030, 남구,045004, 43세,2016,3500,1706,1794,95.1,3475,1695,1780,95.2
24030, 남구,045005, 44세,2016,3681,1834,1847,99.3,3646,1817,1829,99.3
24030, 남구,050,45~49세,2016,18333,8804,9529,92.4,18202,8753,9449,92.6
24030, 남구,050001, 45세,2016,3811,1851,1960,94.4,3788,1842,1946,94.7
24030, 남구,050002, 46세,2016,3674,1726,1948,88.6,3656,1721,1935,88.9
24030, 남구,050003, 47세,2016,3580,1736,1844,94.1,3551,1722,1829,94.1
24030, 남구,050004, 48세,2016,3829,1827,2002,91.3,3797,1814,1983,91.5
24030, 남구,050005, 49세,2016,3439,1664,1775,93.7,3410,1654,1756,94.2
24030, 남구,055,50~54세,2016,17381,8347,9034,92.4,17247,8292,8955,92.6
24030, 남구,055001, 50세,2016,3532,1725,1807,95.5,3496,1711,1785,95.9
24030, 남구,055002, 51세,2016,3506,1667,1839,90.6,3480,1655,1825,90.7
24030, 남구,055003, 52세,2016,3232,1556,1676,92.8,3206,1543,1663,92.8
24030, 남구,055004, 53세,2016,3638,1777,1861,95.5,3609,1770,1839,96.2
24030, 남구,055005, 54세,2016,3473,1622,1851,87.6,3456,1613,1843,87.5
24030, 남구,060,55~59세,2016,18379,8621,9758,88.3,18281,8580,9701,88.4
24030, 남구,060001, 55세,2016,3835,1812,2023,89.6,3811,1804,2007,89.9
24030, 남구,060002, 56세,2016,4055,1878,2177,86.3,4038,1869,2169,86.2
24030, 남구,060003, 57세,2016,3640,1722,1918,89.8,3619,1714,1905,90
24030, 남구,060004, 58세,2016,3490,1655,1835,90.2,3470,1645,1825,90.1
24030, 남구,060005, 59세,2016,3359,1554,1805,86.1,3343,1548,1795,86.2
24030, 남구,065,60~64세,2016,13584,6493,7091,91.6,13528,6463,7065,91.5
24030, 남구,065001, 60세,2016,2967,1460,1507,96.9,2950,1451,1499,96.8
24030, 남구,065002, 61세,2016,3134,1452,1682,86.3,3124,1446,1678,86.2
24030, 남구,065003, 62세,2016,2530,1189,1341,88.7,2520,1184,1336,88.6
24030, 남구,065004, 63세,2016,2357,1142,1215,94,2345,1135,1210,93.8
24030, 남구,065005, 64세,2016,2596,1250,1346,92.9,2589,1247,1342,92.9
24030, 남구,070,65~69세,2016,11120,5171,5949,86.9,11102,5163,5939,86.9
24030, 남구,070001, 65세,2016,2135,990,1145,86.5,2129,987,1142,86.4
24030, 남구,070002, 66세,2016,2229,1039,1190,87.3,2223,1037,1186,87.4
24030, 남구,070003, 67세,2016,2367,1099,1268,86.7,2365,1098,1267,86.7
24030, 남구,070004, 68세,2016,2136,998,1138,87.7,2134,997,1137,87.7
24030, 남구,070005, 69세,2016,2253,1045,1208,86.5,2251,1044,1207,86.5
24030, 남구,075,70~74세,2016,8423,3980,4443,89.6,8415,3975,4440,89.5
24030, 남구,075001, 70세,2016,1656,797,859,92.8,1653,795,858,92.7
24030, 남구,075002, 71세,2016,1656,782,874,89.5,1655,781,874,89.4
24030, 남구,075003, 72세,2016,1602,751,851,88.2,1600,750,850,88.2
24030, 남구,075004, 73세,2016,1532,719,813,88.4,1531,718,813,88.3
24030, 남구,075005, 74세,2016,1977,931,1046,89,1976,931,1045,89.1
24030, 남구,080,75~79세,2016,6407,2675,3732,71.7,6404,2675,3729,71.7
24030, 남구,080001, 75세,2016,1530,652,878,74.3,1529,652,877,74.3
24030, 남구,080002, 76세,2016,1335,570,765,74.5,1333,570,763,74.7
24030, 남구,080003, 77세,2016,1302,579,723,80.1,1302,579,723,80.1
24030, 남구,080004, 78세,2016,1157,465,692,67.2,1157,465,692,67.2
24030, 남구,080005, 79세,2016,1083,409,674,60.7,1083,409,674,60.7
24030, 남구,085,80~84세,2016,3795,1319,2476,53.3,3793,1317,2476,53.2
24030, 남구,085001, 80세,2016,919,352,567,62.1,918,351,567,61.9
24030, 남구,085002, 81세,2016,879,295,584,50.5,879,295,584,50.5
24030, 남구,085003, 82세,2016,801,277,524,52.9,801,277,524,52.9
24030, 남구,085004, 83세,2016,637,213,424,50.2,636,212,424,50
24030, 남구,085005, 84세,2016,559,182,377,48.3,559,182,377,48.3
24030, 남구,090,85~89세,2016,1832,503,1329,37.8,1832,503,1329,37.8
24030, 남구,090001, 85세,2016,431,116,315,36.8,431,116,315,36.8
24030, 남구,090002, 86세,2016,495,146,349,41.8,495,146,349,41.8
24030, 남구,090003, 87세,2016,367,108,259,41.7,367,108,259,41.7
24030, 남구,090004, 88세,2016,281,72,209,34.4,281,72,209,34.4
24030, 남구,090005, 89세,2016,258,61,197,31,258,61,197,31
24030, 남구,095,90~94세,2016,603,134,469,28.6,603,134,469,28.6
24030, 남구,095001, 90세,2016,176,45,131,34.4,176,45,131,34.4
24030, 남구,095002, 91세,2016,149,29,120,24.2,149,29,120,24.2
24030, 남구,095003, 92세,2016,76,20,56,35.7,76,20,56,35.7
24030, 남구,095004, 93세,2016,124,23,101,22.8,124,23,101,22.8
24030, 남구,095005, 94세,2016,78,17,61,27.9,78,17,61,27.9
24030, 남구,100,95~99세,2016,125,15,110,13.6,124,15,109,13.8
24030, 남구,100001, 95세,2016,54,9,45,20,54,9,45,20
24030, 남구,100002, 96세,2016,31,X,29,6.9,30,X,28,7.1
24030, 남구,100003, 97세,2016,21,X,19,10.5,21,X,19,10.5
24030, 남구,100004, 98세,2016,13,X,13,0,13,X,13,0
24030, 남구,100005, 99세,2016,6,X,X,50,6,X,X,50
24030, 남구,101,100세이상,2016,16,X,14,14.3,16,X,14,14.3
24030, 남구,102,15세미만,2016,29536,15119,14417,104.9,29489,15090,14399,104.8
24030, 남구,103,15~64세,2016,158876,78048,80828,96.6,157327,77423,79904,96.9
24030, 남구,104,65세이상,2016,32321,13799,18522,74.5,32289,13784,18505,74.5
24030, 남구,086,85세이상,2016,2576,654,1922,34,2575,654,1921,34
24030, 남구,126,평균연령,2016,41.1,39.9,42.2,,41.1,39.9,42.3,
24030, 남구,127,중위연령,2016,42.1,40.6,43.4,,42.2,40.7,43.5,
24040, 북구,000,합계,2016,453155,226055,227100,99.5,447948,223576,224372,99.6
24040, 북구,005,0~4세,2016,18989,9784,9205,106.3,18900,9749,9151,106.5
24040, 북구,005001, 0세,2016,3575,1791,1784,100.4,3555,1784,1771,100.7
24040, 북구,005002, 1세,2016,3802,2006,1796,111.7,3786,2000,1786,112
24040, 북구,005003, 2세,2016,3780,1881,1899,99.1,3764,1873,1891,99
24040, 북구,005004, 3세,2016,3713,1968,1745,112.8,3695,1962,1733,113.2
24040, 북구,005005, 4세,2016,4119,2138,1981,107.9,4100,2130,1970,108.1
24040, 북구,010,5~9세,2016,20055,10496,9559,109.8,19996,10472,9524,110
24040, 북구,010001, 5세,2016,4003,2044,1959,104.3,3981,2033,1948,104.4
24040, 북구,010002, 6세,2016,3929,2034,1895,107.3,3921,2033,1888,107.7
24040, 북구,010003, 7세,2016,3883,2072,1811,114.4,3874,2069,1805,114.6
24040, 북구,010004, 8세,2016,4009,2098,1911,109.8,3995,2092,1903,109.9
24040, 북구,010005, 9세,2016,4231,2248,1983,113.4,4225,2245,1980,113.4
24040, 북구,015,10~14세,2016,21384,11280,10104,111.6,21354,11265,10089,111.7
24040, 북구,015001, 10세,2016,3858,2028,1830,110.8,3847,2023,1824,110.9
24040, 북구,015002, 11세,2016,3858,2049,1809,113.3,3853,2047,1806,113.3
24040, 북구,015003, 12세,2016,4287,2244,2043,109.8,4283,2243,2040,110
24040, 북구,015004, 13세,2016,4646,2488,2158,115.3,4644,2487,2157,115.3
24040, 북구,015005, 14세,2016,4735,2471,2264,109.1,4727,2465,2262,109
24040, 북구,020,15~19세,2016,31926,16555,15371,107.7,31700,16456,15244,108
24040, 북구,020001, 15세,2016,5494,2917,2577,113.2,5487,2914,2573,113.3
24040, 북구,020002, 16세,2016,6283,3345,2938,113.9,6270,3341,2929,114.1
24040, 북구,020003, 17세,2016,6097,3196,2901,110.2,6075,3185,2890,110.2
24040, 북구,020004, 18세,2016,6661,3393,3268,103.8,6610,3369,3241,103.9
24040, 북구,020005, 19세,2016,7391,3704,3687,100.5,7258,3647,3611,101
24040, 북구,025,20~24세,2016,38475,20141,18334,109.9,37393,19660,17733,110.9
24040, 북구,025001, 20세,2016,7742,4023,3719,108.2,7568,3948,3620,109.1
24040, 북구,025002, 21세,2016,7836,4000,3836,104.3,7666,3927,3739,105
24040, 북구,025003, 22세,2016,7814,4155,3659,113.6,7565,4048,3517,115.1
24040, 북구,025004, 23세,2016,7635,4036,3599,112.1,7379,3928,3451,113.8
24040, 북구,025005, 24세,2016,7448,3927,3521,111.5,7215,3809,3406,111.8
24040, 북구,030,25~29세,2016,30339,15948,14391,110.8,29192,15377,13815,111.3
24040, 북구,030001, 25세,2016,6723,3587,3136,114.4,6480,3463,3017,114.8
24040, 북구,030002, 26세,2016,6301,3381,2920,115.8,6058,3270,2788,117.3
24040, 북구,030003, 27세,2016,5918,3114,2804,111.1,5669,2988,2681,111.5
24040, 북구,030004, 28세,2016,5692,2958,2734,108.2,5488,2855,2633,108.4
24040, 북구,030005, 29세,2016,5705,2908,2797,104,5497,2801,2696,103.9
24040, 북구,035,30~34세,2016,31194,16264,14930,108.9,30513,15923,14590,109.1
24040, 북구,035001, 30세,2016,5686,2902,2784,104.2,5507,2818,2689,104.8
24040, 북구,035002, 31세,2016,5704,3007,2697,111.5,5551,2935,2616,112.2
24040, 북구,035003, 32세,2016,6120,3229,2891,111.7,5999,3168,2831,111.9
24040, 북구,035004, 33세,2016,6659,3477,3182,109.3,6534,3411,3123,109.2
24040, 북구,035005, 34세,2016,7025,3649,3376,108.1,6922,3591,3331,107.8
24040, 북구,040,35~39세,2016,33352,16899,16453,102.7,32937,16677,16260,102.6
24040, 북구,040001, 35세,2016,6769,3413,3356,101.7,6671,3357,3314,101.3
24040, 북구,040002, 36세,2016,7153,3652,3501,104.3,7068,3608,3460,104.3
24040, 북구,040003, 37세,2016,6956,3524,3432,102.7,6859,3467,3392,102.2
24040, 북구,040004, 38세,2016,6234,3192,3042,104.9,6164,3160,3004,105.2
24040, 북구,040005, 39세,2016,6240,3118,3122,99.9,6175,3085,3090,99.8
24040, 북구,045,40~44세,2016,35141,17817,17324,102.8,34796,17639,17157,102.8
24040, 북구,045001, 40세,2016,6332,3281,3051,107.5,6262,3249,3013,107.8
24040, 북구,045002, 41세,2016,6552,3354,3198,104.9,6488,3320,3168,104.8
24040, 북구,045003, 42세,2016,7485,3837,3648,105.2,7426,3806,3620,105.1
24040, 북구,045004, 43세,2016,7317,3643,3674,99.2,7238,3598,3640,98.8
24040, 북구,045005, 44세,2016,7455,3702,3753,98.6,7382,3666,3716,98.7
24040, 북구,050,45~49세,2016,39219,19278,19941,96.7,38902,19124,19778,96.7
24040, 북구,050001, 45세,2016,7931,3908,4023,97.1,7869,3874,3995,97
24040, 북구,050002, 46세,2016,7743,3805,3938,96.6,7665,3769,3896,96.7
24040, 북구,050003, 47세,2016,7796,3884,3912,99.3,7728,3846,3882,99.1
24040, 북구,050004, 48세,2016,8185,4039,4146,97.4,8127,4015,4112,97.6
24040, 북구,050005, 49세,2016,7564,3642,3922,92.9,7513,3620,3893,93
24040, 북구,055,50~54세,2016,37040,18327,18713,97.9,36692,18185,18507,98.3
24040, 북구,055001, 50세,2016,7646,3859,3787,101.9,7579,3830,3749,102.2
24040, 북구,055002, 51세,2016,7491,3657,3834,95.4,7421,3634,3787,96
24040, 북구,055003, 52세,2016,7093,3508,3585,97.9,7008,3471,3537,98.1
24040, 북구,055004, 53세,2016,7552,3697,3855,95.9,7480,3668,3812,96.2
24040, 북구,055005, 54세,2016,7258,3606,3652,98.7,7204,3582,3622,98.9
24040, 북구,060,55~59세,2016,36478,17755,18723,94.8,36283,17663,18620,94.9
24040, 북구,060001, 55세,2016,7892,3835,4057,94.5,7852,3823,4029,94.9
24040, 북구,060002, 56세,2016,8327,4047,4280,94.6,8284,4026,4258,94.6
24040, 북구,060003, 57세,2016,7441,3609,3832,94.2,7391,3581,3810,94
24040, 북구,060004, 58세,2016,6479,3145,3334,94.3,6440,3126,3314,94.3
24040, 북구,060005, 59세,2016,6339,3119,3220,96.9,6316,3107,3209,96.8
24040, 북구,065,60~64세,2016,24680,12098,12582,96.2,24541,12033,12508,96.2
24040, 북구,065001, 60세,2016,5473,2756,2717,101.4,5443,2743,2700,101.6
24040, 북구,065002, 61세,2016,5838,2830,3008,94.1,5802,2814,2988,94.2
24040, 북구,065003, 62세,2016,4723,2321,2402,96.6,4691,2305,2386,96.6
24040, 북구,065004, 63세,2016,4094,1984,2110,94,4079,1974,2105,93.8
24040, 북구,065005, 64세,2016,4552,2207,2345,94.1,4526,2197,2329,94.3
24040, 북구,070,65~69세,2016,19120,9286,9834,94.4,19054,9254,9800,94.4
24040, 북구,070001, 65세,2016,3790,1871,1919,97.5,3775,1863,1912,97.4
24040, 북구,070002, 66세,2016,3934,1940,1994,97.3,3921,1934,1987,97.3
24040, 북구,070003, 67세,2016,4004,1917,2087,91.9,3987,1908,2079,91.8
24040, 북구,070004, 68세,2016,3722,1805,1917,94.2,3714,1802,1912,94.2
24040, 북구,070005, 69세,2016,3670,1753,1917,91.4,3657,1747,1910,91.5
24040, 북구,075,70~74세,2016,14283,6572,7711,85.2,14255,6559,7696,85.2
24040, 북구,075001, 70세,2016,2884,1404,1480,94.9,2877,1399,1478,94.7
24040, 북구,075002, 71세,2016,2751,1239,1512,81.9,2748,1239,1509,82.1
24040, 북구,075003, 72세,2016,2608,1166,1442,80.9,2604,1166,1438,81.1
24040, 북구,075004, 73세,2016,2616,1187,1429,83.1,2609,1183,1426,83
24040, 북구,075005, 74세,2016,3424,1576,1848,85.3,3417,1572,1845,85.2
24040, 북구,080,75~79세,2016,10645,4369,6276,69.6,10620,4359,6261,69.6
24040, 북구,080001, 75세,2016,2512,1051,1461,71.9,2507,1050,1457,72.1
24040, 북구,080002, 76세,2016,2207,895,1312,68.2,2202,893,1309,68.2
24040, 북구,080003, 77세,2016,2152,905,1247,72.6,2147,904,1243,72.7
24040, 북구,080004, 78세,2016,1977,804,1173,68.5,1971,800,1171,68.3
24040, 북구,080005, 79세,2016,1797,714,1083,65.9,1793,712,1081,65.9
24040, 북구,085,80~84세,2016,6422,2150,4272,50.3,6414,2145,4269,50.2
24040, 북구,085001, 80세,2016,1520,545,975,55.9,1519,544,975,55.8
24040, 북구,085002, 81세,2016,1510,510,1000,51,1507,509,998,51
24040, 북구,085003, 82세,2016,1373,479,894,53.6,1371,478,893,53.5
24040, 북구,085004, 83세,2016,1073,333,740,45,1073,333,740,45
24040, 북구,085005, 84세,2016,946,283,663,42.7,944,281,663,42.4
24040, 북구,090,85~89세,2016,3173,802,2371,33.8,3169,802,2367,33.9
24040, 북구,090001, 85세,2016,798,217,581,37.3,797,217,580,37.4
24040, 북구,090002, 86세,2016,803,185,618,29.9,803,185,618,29.9
24040, 북구,090003, 87세,2016,634,173,461,37.5,633,173,460,37.6
24040, 북구,090004, 88세,2016,508,122,386,31.6,508,122,386,31.6
24040, 북구,090005, 89세,2016,430,105,325,32.3,428,105,323,32.5
24040, 북구,095,90~94세,2016,990,198,792,25,988,198,790,25.1
24040, 북구,095001, 90세,2016,325,70,255,27.5,325,70,255,27.5
24040, 북구,095002, 91세,2016,223,53,170,31.2,222,53,169,31.4
24040, 북구,095003, 92세,2016,135,22,113,19.5,135,22,113,19.5
24040, 북구,095004, 93세,2016,191,36,155,23.2,190,36,154,23.4
24040, 북구,095005, 94세,2016,116,17,99,17.2,116,17,99,17.2
24040, 북구,100,95~99세,2016,222,33,189,17.5,221,33,188,17.6
24040, 북구,100001, 95세,2016,79,8,71,11.3,79,8,71,11.3
24040, 북구,100002, 96세,2016,64,8,56,14.3,64,8,56,14.3
24040, 북구,100003, 97세,2016,41,10,31,32.3,40,10,30,33.3
24040, 북구,100004, 98세,2016,23,X,20,15,23,X,20,15
24040, 북구,100005, 99세,2016,15,X,11,36.4,15,X,11,36.4
24040, 북구,101,100세이상,2016,28,X,25,12,28,X,25,12
24040, 북구,102,15세미만,2016,60428,31560,28868,109.3,60250,31486,28764,109.5
24040, 북구,103,15~64세,2016,337844,171082,166762,102.6,332949,168737,164212,102.8
24040, 북구,104,65세이상,2016,54883,23413,31470,74.4,54749,23353,31396,74.4
24040, 북구,086,85세이상,2016,4413,1036,3377,30.7,4406,1036,3370,30.7
24040, 북구,126,평균연령,2016,39.7,38.5,40.9,,39.8,38.6,41,
24040, 북구,127,중위연령,2016,40.1,38.6,41.7,,40.3,38.8,41.9,
24050, 광산구,000,합계,2016,417200,210858,206342,102.2,403821,202497,201324,100.6
24050, 광산구,005,0~4세,2016,23070,11863,11207,105.9,22858,11751,11107,105.8
24050, 광산구,005001, 0세,2016,4080,2093,1987,105.3,4047,2077,1970,105.4
24050, 광산구,005002, 1세,2016,4285,2210,2075,106.5,4242,2186,2056,106.3
24050, 광산구,005003, 2세,2016,4559,2326,2233,104.2,4506,2298,2208,104.1
24050, 광산구,005004, 3세,2016,4732,2420,2312,104.7,4692,2398,2294,104.5
24050, 광산구,005005, 4세,2016,5414,2814,2600,108.2,5371,2792,2579,108.3
24050, 광산구,010,5~9세,2016,26938,13866,13072,106.1,26787,13796,12991,106.2
24050, 광산구,010001, 5세,2016,5361,2827,2534,111.6,5332,2813,2519,111.7
24050, 광산구,010002, 6세,2016,5313,2717,2596,104.7,5271,2696,2575,104.7
24050, 광산구,010003, 7세,2016,5152,2558,2594,98.6,5121,2544,2577,98.7
24050, 광산구,010004, 8세,2016,5438,2819,2619,107.6,5414,2808,2606,107.8
24050, 광산구,010005, 9세,2016,5674,2945,2729,107.9,5649,2935,2714,108.1
24050, 광산구,015,10~14세,2016,26532,13656,12876,106.1,26413,13596,12817,106.1
24050, 광산구,015001, 10세,2016,5127,2653,2474,107.2,5100,2639,2461,107.2
24050, 광산구,015002, 11세,2016,5020,2579,2441,105.7,4995,2567,2428,105.7
24050, 광산구,015003, 12세,2016,5369,2757,2612,105.6,5356,2749,2607,105.4
24050, 광산구,015004, 13세,2016,5648,2930,2718,107.8,5621,2919,2702,108
24050, 광산구,015005, 14세,2016,5368,2737,2631,104,5341,2722,2619,103.9
24050, 광산구,020,15~19세,2016,32759,16600,16159,102.7,32496,16471,16025,102.8
24050, 광산구,020001, 15세,2016,6246,3223,3023,106.6,6225,3212,3013,106.6
24050, 광산구,020002, 16세,2016,6735,3482,3253,107,6714,3475,3239,107.3
24050, 광산구,020003, 17세,2016,6348,3283,3065,107.1,6324,3272,3052,107.2
24050, 광산구,020004, 18세,2016,6727,3409,3318,102.7,6654,3358,3296,101.9
24050, 광산구,020005, 19세,2016,6703,3203,3500,91.5,6579,3154,3425,92.1
24050, 광산구,025,20~24세,2016,32182,16686,15496,107.7,30050,15366,14684,104.6
24050, 광산구,025001, 20세,2016,6837,3450,3387,101.9,6581,3315,3266,101.5
24050, 광산구,025002, 21세,2016,6691,3332,3359,99.2,6296,3119,3177,98.2
24050, 광산구,025003, 22세,2016,6625,3384,3241,104.4,6164,3112,3052,102
24050, 광산구,025004, 23세,2016,6141,3312,2829,117.1,5626,2961,2665,111.1
24050, 광산구,025005, 24세,2016,5888,3208,2680,119.7,5383,2859,2524,113.3
24050, 광산구,030,25~29세,2016,24567,13140,11427,115,21670,11184,10486,106.7
24050, 광산구,030001, 25세,2016,5282,2838,2444,116.1,4732,2455,2277,107.8
24050, 광산구,030002, 26세,2016,5009,2684,2325,115.4,4381,2264,2117,106.9
24050, 광산구,030003, 27세,2016,4666,2474,2192,112.9,4103,2106,1997,105.5
24050, 광산구,030004, 28세,2016,4662,2460,2202,111.7,4099,2083,2016,103.3
24050, 광산구,030005, 29세,2016,4948,2684,2264,118.6,4355,2276,2079,109.5
24050, 광산구,035,30~34세,2016,30223,15490,14733,105.1,28038,14013,14025,99.9
24050, 광산구,035001, 30세,2016,4967,2568,2399,107,4499,2253,2246,100.3
24050, 광산구,035002, 31세,2016,5145,2659,2486,107,4677,2340,2337,100.1
24050, 광산구,035003, 32세,2016,5790,2960,2830,104.6,5364,2679,2685,99.8
24050, 광산구,035004, 33세,2016,6578,3396,3182,106.7,6174,3117,3057,102
24050, 광산구,035005, 34세,2016,7743,3907,3836,101.9,7324,3624,3700,97.9
24050, 광산구,040,35~39세,2016,38363,19118,19245,99.3,36794,18065,18729,96.5
24050, 광산구,040001, 35세,2016,7424,3739,3685,101.5,7066,3492,3574,97.7
24050, 광산구,040002, 36세,2016,7984,3942,4042,97.5,7654,3720,3934,94.6
24050, 광산구,040003, 37세,2016,7947,3915,4032,97.1,7636,3702,3934,94.1
24050, 광산구,040004, 38세,2016,7217,3596,3621,99.3,6917,3408,3509,97.1
24050, 광산구,040005, 39세,2016,7791,3926,3865,101.6,7521,3743,3778,99.1
24050, 광산구,045,40~44세,2016,41370,20951,20419,102.6,40102,20152,19950,101
24050, 광산구,045001, 40세,2016,7736,3903,3833,101.8,7436,3707,3729,99.4
24050, 광산구,045002, 41세,2016,7890,3954,3936,100.5,7619,3782,3837,98.6
24050, 광산구,045003, 42세,2016,8724,4418,4306,102.6,8473,4267,4206,101.5
24050, 광산구,045004, 43세,2016,8604,4309,4295,100.3,8371,4167,4204,99.1
24050, 광산구,045005, 44세,2016,8416,4367,4049,107.9,8203,4229,3974,106.4
24050, 광산구,050,45~49세,2016,39980,20724,19256,107.6,39034,20166,18868,106.9
24050, 광산구,050001, 45세,2016,8815,4542,4273,106.3,8599,4408,4191,105.2
24050, 광산구,050002, 46세,2016,8398,4446,3952,112.5,8177,4318,3859,111.9
24050, 광산구,050003, 47세,2016,7867,4091,3776,108.3,7672,3974,3698,107.5
24050, 광산구,050004, 48세,2016,7974,4037,3937,102.5,7796,3934,3862,101.9
24050, 광산구,050005, 49세,2016,6926,3608,3318,108.7,6790,3532,3258,108.4
24050, 광산구,055,50~54세,2016,30518,16402,14116,116.2,29811,16036,13775,116.4
24050, 광산구,055001, 50세,2016,6972,3697,3275,112.9,6822,3618,3204,112.9
24050, 광산구,055002, 51세,2016,6571,3429,3142,109.1,6420,3340,3080,108.4
24050, 광산구,055003, 52세,2016,5711,3061,2650,115.5,5550,2982,2568,116.1
24050, 광산구,055004, 53세,2016,5929,3270,2659,123,5786,3202,2584,123.9
24050, 광산구,055005, 54세,2016,5335,2945,2390,123.2,5233,2894,2339,123.7
24050, 광산구,060,55~59세,2016,23944,12618,11326,111.4,23484,12377,11107,111.4
24050, 광산구,060001, 55세,2016,5568,3014,2554,118,5479,2966,2513,118
24050, 광산구,060002, 56세,2016,5538,2941,2597,113.2,5412,2876,2536,113.4
24050, 광산구,060003, 57세,2016,4751,2472,2279,108.5,4671,2430,2241,108.4
24050, 광산구,060004, 58세,2016,4188,2172,2016,107.7,4106,2131,1975,107.9
24050, 광산구,060005, 59세,2016,3899,2019,1880,107.4,3816,1974,1842,107.2
24050, 광산구,065,60~64세,2016,14064,6936,7128,97.3,13799,6795,7004,97
24050, 광산구,065001, 60세,2016,3289,1684,1605,104.9,3215,1642,1573,104.4
24050, 광산구,065002, 61세,2016,3300,1636,1664,98.3,3236,1598,1638,97.6
24050, 광산구,065003, 62세,2016,2640,1293,1347,96,2597,1271,1326,95.9
24050, 광산구,065004, 63세,2016,2334,1102,1232,89.4,2292,1082,1210,89.4
24050, 광산구,065005, 64세,2016,2501,1221,1280,95.4,2459,1202,1257,95.6
24050, 광산구,070,65~69세,2016,10589,4893,5696,85.9,10471,4846,5625,86.2
24050, 광산구,070001, 65세,2016,2095,969,1126,86.1,2060,960,1100,87.3
24050, 광산구,070002, 66세,2016,2112,979,1133,86.4,2083,967,1116,86.6
24050, 광산구,070003, 67세,2016,2173,1007,1166,86.4,2156,998,1158,86.2
24050, 광산구,070004, 68세,2016,2067,972,1095,88.8,2049,963,1086,88.7
24050, 광산구,070005, 69세,2016,2142,966,1176,82.1,2123,958,1165,82.2
24050, 광산구,075,70~74세,2016,8260,3620,4640,78,8215,3607,4608,78.3
24050, 광산구,075001, 70세,2016,1674,810,864,93.8,1659,805,854,94.3
24050, 광산구,075002, 71세,2016,1518,678,840,80.7,1511,677,834,81.2
24050, 광산구,075003, 72세,2016,1490,652,838,77.8,1480,648,832,77.9
24050, 광산구,075004, 73세,2016,1558,658,900,73.1,1552,657,895,73.4
24050, 광산구,075005, 74세,2016,2020,822,1198,68.6,2013,820,1193,68.7
24050, 광산구,080,75~79세,2016,6667,2425,4242,57.2,6641,2411,4230,57
24050, 광산구,080001, 75세,2016,1546,603,943,63.9,1542,602,940,64
24050, 광산구,080002, 76세,2016,1383,491,892,55,1375,486,889,54.7
24050, 광산구,080003, 77세,2016,1325,496,829,59.8,1320,493,827,59.6
24050, 광산구,080004, 78세,2016,1236,425,811,52.4,1229,421,808,52.1
24050, 광산구,080005, 79세,2016,1177,410,767,53.5,1175,409,766,53.4
24050, 광산구,085,80~84세,2016,4233,1262,2971,42.5,4225,1260,2965,42.5
24050, 광산구,085001, 80세,2016,998,295,703,42,996,294,702,41.9
24050, 광산구,085002, 81세,2016,1053,340,713,47.7,1051,340,711,47.8
24050, 광산구,085003, 82세,2016,871,267,604,44.2,869,266,603,44.1
24050, 광산구,085004, 83세,2016,681,186,495,37.6,680,186,494,37.7
24050, 광산구,085005, 84세,2016,630,174,456,38.2,629,174,455,38.2
24050, 광산구,090,85~89세,2016,2066,468,1598,29.3,2062,467,1595,29.3
24050, 광산구,090001, 85세,2016,524,127,397,32,522,127,395,32.2
24050, 광산구,090002, 86세,2016,563,121,442,27.4,563,121,442,27.4
24050, 광산구,090003, 87세,2016,403,90,313,28.8,402,90,312,28.8
24050, 광산구,090004, 88세,2016,343,86,257,33.5,342,85,257,33.1
24050, 광산구,090005, 89세,2016,233,44,189,23.3,233,44,189,23.3
24050, 광산구,095,90~94세,2016,712,127,585,21.7,709,126,583,21.6
24050, 광산구,095001, 90세,2016,182,31,151,20.5,181,30,151,19.9
24050, 광산구,095002, 91세,2016,194,32,162,19.8,194,32,162,19.8
24050, 광산구,095003, 92세,2016,102,27,75,36,101,27,74,36.5
24050, 광산구,095004, 93세,2016,141,19,122,15.6,140,19,121,15.7
24050, 광산구,095005, 94세,2016,93,18,75,24,93,18,75,24
24050, 광산구,100,95~99세,2016,144,13,131,9.9,143,12,131,9.2
24050, 광산구,100001, 95세,2016,55,5,50,10,55,5,50,10
24050, 광산구,100002, 96세,2016,47,5,42,11.9,46,X,42,9.5
24050, 광산구,100003, 97세,2016,17,X,16,6.3,17,X,16,6.3
24050, 광산구,100004, 98세,2016,18,X,16,12.5,18,X,16,12.5
24050, 광산구,100005, 99세,2016,7,X,7,0,7,X,7,0
24050, 광산구,101,100세이상,2016,19,X,19,0,19,X,19,0
24050, 광산구,102,15세미만,2016,76540,39385,37155,106,76058,39143,36915,106
24050, 광산구,103,15~64세,2016,307970,158665,149305,106.3,295278,150625,144653,104.1
24050, 광산구,104,65세이상,2016,32690,12808,19882,64.4,32485,12729,19756,64.4
24050, 광산구,086,85세이상,2016,2941,608,2333,26.1,2933,605,2328,26
24050, 광산구,126,평균연령,2016,35.8,35,36.6,,35.9,35.1,36.6,
24050, 광산구,127,중위연령,2016,36.6,36.1,37.1,,36.9,36.4,37.3,
25,대전광역시,000,합계,2016,1535445,770971,764474,100.8,1515758,761749,754009,101
25,대전광역시,005,0~4세,2016,68623,35442,33181,106.8,68220,35246,32974,106.9
25,대전광역시,005001, 0세,2016,12750,6678,6072,110,12677,6641,6036,110
25,대전광역시,005002, 1세,2016,13770,7108,6662,106.7,13689,7063,6626,106.6
25,대전광역시,005003, 2세,2016,13406,6907,6499,106.3,13321,6867,6454,106.4
25,대전광역시,005004, 3세,2016,14015,7120,6895,103.3,13934,7083,6851,103.4
25,대전광역시,005005, 4세,2016,14682,7629,7053,108.2,14599,7592,7007,108.3
25,대전광역시,010,5~9세,2016,72785,37439,35346,105.9,72474,37283,35191,105.9
25,대전광역시,010001, 5세,2016,14876,7709,7167,107.6,14787,7662,7125,107.5
25,대전광역시,010002, 6세,2016,14162,7227,6935,104.2,14099,7198,6901,104.3
25,대전광역시,010003, 7세,2016,13754,7134,6620,107.8,13691,7101,6590,107.8
25,대전광역시,010004, 8세,2016,14735,7574,7161,105.8,14677,7545,7132,105.8
25,대전광역시,010005, 9세,2016,15258,7795,7463,104.4,15220,7777,7443,104.5
25,대전광역시,015,10~14세,2016,74600,38839,35761,108.6,74416,38749,35667,108.6
25,대전광역시,015001, 10세,2016,14019,7243,6776,106.9,13972,7219,6753,106.9
25,대전광역시,015002, 11세,2016,13779,7218,6561,110,13746,7199,6547,110
25,대전광역시,015003, 12세,2016,15393,8011,7382,108.5,15364,7999,7365,108.6
25,대전광역시,015004, 13세,2016,15435,7941,7494,106,15398,7922,7476,106
25,대전광역시,015005, 14세,2016,15974,8426,7548,111.6,15936,8410,7526,111.7
25,대전광역시,020,15~19세,2016,107174,56028,51146,109.5,106199,55551,50648,109.7
25,대전광역시,020001, 15세,2016,18157,9502,8655,109.8,18110,9469,8641,109.6
25,대전광역시,020002, 16세,2016,19641,10320,9321,110.7,19592,10292,9300,110.7
25,대전광역시,020003, 17세,2016,19577,10296,9281,110.9,19504,10258,9246,110.9
25,대전광역시,020004, 18세,2016,22595,11879,10716,110.9,22354,11763,10591,111.1
25,대전광역시,020005, 19세,2016,27204,14031,13173,106.5,26639,13769,12870,107
25,대전광역시,025,20~24세,2016,130171,69372,60799,114.1,125729,67541,58188,116.1
25,대전광역시,025001, 20세,2016,26068,13072,12996,100.6,25184,12692,12492,101.6
25,대전광역시,025002, 21세,2016,25764,13093,12671,103.3,24794,12730,12064,105.5
25,대전광역시,025003, 22세,2016,26734,14423,12311,117.2,25785,14041,11744,119.6
25,대전광역시,025004, 23세,2016,25981,14501,11480,126.3,25147,14134,11013,128.3
25,대전광역시,025005, 24세,2016,25624,14283,11341,125.9,24819,13944,10875,128.2
25,대전광역시,030,25~29세,2016,104574,56827,47747,119,101112,55241,45871,120.4
25,대전광역시,030001, 25세,2016,23155,12818,10337,124,22420,12463,9957,125.2
25,대전광역시,030002, 26세,2016,21534,11916,9618,123.9,20805,11610,9195,126.3
25,대전광역시,030003, 27세,2016,20291,11113,9178,121.1,19556,10778,8778,122.8
25,대전광역시,030004, 28세,2016,20023,10732,9291,115.5,19356,10428,8928,116.8
25,대전광역시,030005, 29세,2016,19571,10248,9323,109.9,18975,9962,9013,110.5
25,대전광역시,035,30~34세,2016,106200,54786,51414,106.6,103764,53602,50162,106.9
25,대전광역시,035001, 30세,2016,19711,10317,9394,109.8,19114,10036,9078,110.6
25,대전광역시,035002, 31세,2016,19670,10288,9382,109.7,19168,10063,9105,110.5
25,대전광역시,035003, 32세,2016,20212,10435,9777,106.7,19744,10196,9548,106.8
25,대전광역시,035004, 33세,2016,22448,11539,10909,105.8,22015,11323,10692,105.9
25,대전광역시,035005, 34세,2016,24159,12207,11952,102.1,23723,11984,11739,102.1
25,대전광역시,040,35~39세,2016,117611,58980,58631,100.6,115923,58097,57826,100.5
25,대전광역시,040001, 35세,2016,24435,12385,12050,102.8,24041,12174,11867,102.6
25,대전광역시,040002, 36세,2016,24705,12447,12258,101.5,24322,12258,12064,101.6
25,대전광역시,040003, 37세,2016,23440,11760,11680,100.7,23107,11588,11519,100.6
25,대전광역시,040004, 38세,2016,22190,11052,11138,99.2,21880,10876,11004,98.8
25,대전광역시,040005, 39세,2016,22841,11336,11505,98.5,22573,11201,11372,98.5
25,대전광역시,045,40~44세,2016,124435,62183,62252,99.9,123095,61480,61615,99.8
25,대전광역시,045001, 40세,2016,22475,11185,11290,99.1,22214,11052,11162,99
25,대전광역시,045002, 41세,2016,23610,11837,11773,100.5,23347,11700,11647,100.5
25,대전광역시,045003, 42세,2016,26012,13043,12969,100.6,25748,12900,12848,100.4
25,대전광역시,045004, 43세,2016,26528,13116,13412,97.8,26256,12979,13277,97.8
25,대전광역시,045005, 44세,2016,25810,13002,12808,101.5,25530,12849,12681,101.3
25,대전광역시,050,45~49세,2016,136168,67626,68542,98.7,134867,66973,67894,98.6
25,대전광역시,050001, 45세,2016,28305,14147,14158,99.9,28011,14004,14007,100
25,대전광역시,050002, 46세,2016,26963,13509,13454,100.4,26674,13364,13310,100.4
25,대전광역시,050003, 47세,2016,28089,13923,14166,98.3,27826,13780,14046,98.1
25,대전광역시,050004, 48세,2016,28068,13808,14260,96.8,27840,13692,14148,96.8
25,대전광역시,050005, 49세,2016,24743,12239,12504,97.9,24516,12133,12383,98
25,대전광역시,055,50~54세,2016,118332,59524,58808,101.2,117174,58988,58186,101.4
25,대전광역시,055001, 50세,2016,23186,11805,11381,103.7,22948,11691,11257,103.9
25,대전광역시,055002, 51세,2016,24457,12120,12337,98.2,24241,12020,12221,98.4
25,대전광역시,055003, 52세,2016,22553,11260,11293,99.7,22311,11151,11160,99.9
25,대전광역시,055004, 53세,2016,23081,11688,11393,102.6,22832,11573,11259,102.8
25,대전광역시,055005, 54세,2016,25055,12651,12404,102,24842,12553,12289,102.1
25,대전광역시,060,55~59세,2016,119005,58831,60174,97.8,118164,58451,59713,97.9
25,대전광역시,060001, 55세,2016,27371,13485,13886,97.1,27200,13407,13793,97.2
25,대전광역시,060002, 56세,2016,26131,12724,13407,94.9,25927,12630,13297,95
25,대전광역시,060003, 57세,2016,22895,11262,11633,96.8,22745,11198,11547,97
25,대전광역시,060004, 58세,2016,21417,10648,10769,98.9,21228,10570,10658,99.2
25,대전광역시,060005, 59세,2016,21191,10712,10479,102.2,21064,10646,10418,102.2
25,대전광역시,065,60~64세,2016,84594,41679,42915,97.1,83973,41361,42612,97.1
25,대전광역시,065001, 60세,2016,19741,9839,9902,99.4,19590,9769,9821,99.5
25,대전광역시,065002, 61세,2016,19567,9566,10001,95.7,19432,9496,9936,95.6
25,대전광역시,065003, 62세,2016,16647,8095,8552,94.7,16502,8010,8492,94.3
25,대전광역시,065004, 63세,2016,13822,6884,6938,99.2,13713,6826,6887,99.1
25,대전광역시,065005, 64세,2016,14817,7295,7522,97,14736,7260,7476,97.1
25,대전광역시,070,65~69세,2016,57734,28014,29720,94.3,57464,27901,29563,94.4
25,대전광역시,070001, 65세,2016,11062,5460,5602,97.5,11001,5440,5561,97.8
25,대전광역시,070002, 66세,2016,12527,6104,6423,95,12468,6081,6387,95.2
25,대전광역시,070003, 67세,2016,12037,5893,6144,95.9,11970,5861,6109,95.9
25,대전광역시,070004, 68세,2016,11411,5517,5894,93.6,11375,5502,5873,93.7
25,대전광역시,070005, 69세,2016,10697,5040,5657,89.1,10650,5017,5633,89.1
25,대전광역시,075,70~74세,2016,43843,20176,23667,85.2,43738,20129,23609,85.3
25,대전광역시,075001, 70세,2016,8308,4021,4287,93.8,8277,4011,4266,94
25,대전광역시,075002, 71세,2016,8253,3866,4387,88.1,8228,3851,4377,88
25,대전광역시,075003, 72세,2016,8542,3860,4682,82.4,8524,3849,4675,82.3
25,대전광역시,075004, 73세,2016,8476,3786,4690,80.7,8459,3778,4681,80.7
25,대전광역시,075005, 74세,2016,10264,4643,5621,82.6,10250,4640,5610,82.7
25,대전광역시,080,75~79세,2016,33817,14061,19756,71.2,33729,14023,19706,71.2
25,대전광역시,080001, 75세,2016,7712,3305,4407,75,7692,3296,4396,75
25,대전광역시,080002, 76세,2016,6809,2896,3913,74,6790,2888,3902,74
25,대전광역시,080003, 77세,2016,7096,2919,4177,69.9,7070,2909,4161,69.9
25,대전광역시,080004, 78세,2016,6491,2658,3833,69.3,6482,2653,3829,69.3
25,대전광역시,080005, 79세,2016,5709,2283,3426,66.6,5695,2277,3418,66.6
25,대전광역시,085,80~84세,2016,21609,7501,14108,53.2,21571,7482,14089,53.1
25,대전광역시,085001, 80세,2016,5393,1961,3432,57.1,5384,1956,3428,57.1
25,대전광역시,085002, 81세,2016,4938,1795,3143,57.1,4928,1790,3138,57
25,대전광역시,085003, 82세,2016,4301,1504,2797,53.8,4293,1500,2793,53.7
25,대전광역시,085004, 83세,2016,3682,1212,2470,49.1,3675,1209,2466,49
25,대전광역시,085005, 84세,2016,3295,1029,2266,45.4,3291,1027,2264,45.4
25,대전광역시,090,85~89세,2016,10019,2719,7300,37.2,10001,2710,7291,37.2
25,대전광역시,090001, 85세,2016,2501,727,1774,41,2498,727,1771,41.1
25,대전광역시,090002, 86세,2016,2386,664,1722,38.6,2386,664,1722,38.6
25,대전광역시,090003, 87세,2016,1981,524,1457,36,1976,520,1456,35.7
25,대전광역시,090004, 88세,2016,1735,427,1308,32.6,1729,424,1305,32.5
25,대전광역시,090005, 89세,2016,1416,377,1039,36.3,1412,375,1037,36.2
25,대전광역시,095,90~94세,2016,3337,770,2567,30,3334,768,2566,29.9
25,대전광역시,095001, 90세,2016,910,251,659,38.1,910,251,659,38.1
25,대전광역시,095002, 91세,2016,808,173,635,27.2,807,172,635,27.1
25,대전광역시,095003, 92세,2016,620,142,478,29.7,618,141,477,29.6
25,대전광역시,095004, 93세,2016,601,108,493,21.9,601,108,493,21.9
25,대전광역시,095005, 94세,2016,398,96,302,31.8,398,96,302,31.8
25,대전광역시,100,95~99세,2016,701,159,542,29.3,698,158,540,29.3
25,대전광역시,100001, 95세,2016,261,60,201,29.9,261,60,201,29.9
25,대전광역시,100002, 96세,2016,187,46,141,32.6,185,45,140,32.1
25,대전광역시,100003, 97세,2016,120,26,94,27.7,120,26,94,27.7
25,대전광역시,100004, 98세,2016,80,10,70,14.3,80,10,70,14.3
25,대전광역시,100005, 99세,2016,53,17,36,47.2,52,17,35,48.6
25,대전광역시,101,100세이상,2016,113,15,98,15.3,113,15,98,15.3
25,대전광역시,102,15세미만,2016,216008,111720,104288,107.1,215110,111278,103832,107.2
25,대전광역시,103,15~64세,2016,1148264,585836,562428,104.2,1130000,577285,552715,104.4
25,대전광역시,104,65세이상,2016,171173,73415,97758,75.1,170648,73186,97462,75.1
25,대전광역시,086,85세이상,2016,14170,3663,10507,34.9,14146,3651,10495,34.8
25,대전광역시,126,평균연령,2016,39.1,38,40.2,,39.2,38.1,40.3,
25,대전광역시,127,중위연령,2016,39.4,38,40.7,,39.6,38.2,40.9,
25010, 동구,000,합계,2016,243612,122826,120786,101.7,239367,120993,118374,102.2
25010, 동구,005,0~4세,2016,9635,4998,4637,107.8,9598,4975,4623,107.6
25010, 동구,005001, 0세,2016,1677,901,776,116.1,1674,901,773,116.6
25010, 동구,005002, 1세,2016,1906,999,907,110.1,1900,995,905,109.9
25010, 동구,005003, 2세,2016,1919,992,927,107,1910,986,924,106.7
25010, 동구,005004, 3세,2016,2009,1008,1001,100.7,2000,1002,998,100.4
25010, 동구,005005, 4세,2016,2124,1098,1026,107,2114,1091,1023,106.6
25010, 동구,010,5~9세,2016,10367,5299,5068,104.6,10331,5277,5054,104.4
25010, 동구,010001, 5세,2016,2139,1064,1075,99,2129,1058,1071,98.8
25010, 동구,010002, 6세,2016,1989,1022,967,105.7,1983,1019,964,105.7
25010, 동구,010003, 7세,2016,1969,1047,922,113.6,1959,1038,921,112.7
25010, 동구,010004, 8세,2016,2142,1075,1067,100.7,2134,1073,1061,101.1
25010, 동구,010005, 9세,2016,2128,1091,1037,105.2,2126,1089,1037,105
25010, 동구,015,10~14세,2016,9965,5176,4789,108.1,9934,5161,4773,108.1
25010, 동구,015001, 10세,2016,1944,985,959,102.7,1931,980,951,103
25010, 동구,015002, 11세,2016,1864,999,865,115.5,1857,995,862,115.4
25010, 동구,015003, 12세,2016,2051,1051,1000,105.1,2048,1049,999,105
25010, 동구,015004, 13세,2016,2031,1035,996,103.9,2028,1033,995,103.8
25010, 동구,015005, 14세,2016,2075,1106,969,114.1,2070,1104,966,114.3
25010, 동구,020,15~19세,2016,17120,9030,8090,111.6,16716,8841,7875,112.3
25010, 동구,020001, 15세,2016,2440,1318,1122,117.5,2431,1311,1120,117.1
25010, 동구,020002, 16세,2016,2824,1599,1225,130.5,2816,1594,1222,130.4
25010, 동구,020003, 17세,2016,2613,1427,1186,120.3,2595,1424,1171,121.6
25010, 동구,020004, 18세,2016,3730,1950,1780,109.6,3623,1904,1719,110.8
25010, 동구,020005, 19세,2016,5513,2736,2777,98.5,5251,2608,2643,98.7
25010, 동구,025,20~24세,2016,23764,12431,11333,109.7,22240,11850,10390,114.1
25010, 동구,025001, 20세,2016,5067,2182,2885,75.6,4647,2015,2632,76.6
25010, 동구,025002, 21세,2016,4873,2232,2641,84.5,4469,2095,2374,88.2
25010, 동구,025003, 22세,2016,5069,2735,2334,117.2,4731,2605,2126,122.5
25010, 동구,025004, 23세,2016,4550,2766,1784,155,4338,2678,1660,161.3
25010, 동구,025005, 24세,2016,4205,2516,1689,149,4055,2457,1598,153.8
25010, 동구,030,25~29세,2016,14893,8394,6499,129.2,14425,8197,6228,131.6
25010, 동구,030001, 25세,2016,3569,2113,1456,145.1,3467,2063,1404,146.9
25010, 동구,030002, 26세,2016,3126,1786,1340,133.3,3011,1738,1273,136.5
25010, 동구,030003, 27세,2016,2790,1524,1266,120.4,2698,1485,1213,122.4
25010, 동구,030004, 28세,2016,2800,1545,1255,123.1,2721,1515,1206,125.6
25010, 동구,030005, 29세,2016,2608,1426,1182,120.6,2528,1396,1132,123.3
25010, 동구,035,30~34세,2016,15094,7893,7201,109.6,14755,7770,6985,111.2
25010, 동구,035001, 30세,2016,2794,1478,1316,112.3,2705,1447,1258,115
25010, 동구,035002, 31세,2016,2725,1463,1262,115.9,2658,1444,1214,118.9
25010, 동구,035003, 32세,2016,2822,1481,1341,110.4,2757,1456,1301,111.9
25010, 동구,035004, 33세,2016,3171,1619,1552,104.3,3112,1598,1514,105.5
25010, 동구,035005, 34세,2016,3582,1852,1730,107.1,3523,1825,1698,107.5
25010, 동구,040,35~39세,2016,17338,8972,8366,107.2,17050,8851,8199,108
25010, 동구,040001, 35세,2016,3587,1861,1726,107.8,3532,1840,1692,108.7
25010, 동구,040002, 36세,2016,3668,1932,1736,111.3,3590,1903,1687,112.8
25010, 동구,040003, 37세,2016,3441,1737,1704,101.9,3386,1716,1670,102.8
25010, 동구,040004, 38세,2016,3311,1727,1584,109,3257,1699,1558,109.1
25010, 동구,040005, 39세,2016,3331,1715,1616,106.1,3285,1693,1592,106.3
25010, 동구,045,40~44세,2016,18012,9552,8460,112.9,17752,9417,8335,113
25010, 동구,045001, 40세,2016,3300,1713,1587,107.9,3242,1683,1559,108
25010, 동구,045002, 41세,2016,3468,1852,1616,114.6,3419,1830,1589,115.2
25010, 동구,045003, 42세,2016,3820,2053,1767,116.2,3768,2029,1739,116.7
25010, 동구,045004, 43세,2016,3796,2017,1779,113.4,3742,1987,1755,113.2
25010, 동구,045005, 44세,2016,3628,1917,1711,112,3581,1888,1693,111.5
25010, 동구,050,45~49세,2016,18763,9692,9071,106.8,18532,9571,8961,106.8
25010, 동구,050001, 45세,2016,3928,2093,1835,114.1,3871,2057,1814,113.4
25010, 동구,050002, 46세,2016,3600,1914,1686,113.5,3554,1891,1663,113.7
25010, 동구,050003, 47세,2016,3878,1989,1889,105.3,3832,1973,1859,106.1
25010, 동구,050004, 48세,2016,3886,1930,1956,98.7,3849,1904,1945,97.9
25010, 동구,050005, 49세,2016,3471,1766,1705,103.6,3426,1746,1680,103.9
25010, 동구,055,50~54세,2016,17889,9127,8762,104.2,17651,9018,8633,104.5
25010, 동구,055001, 50세,2016,3422,1752,1670,104.9,3368,1730,1638,105.6
25010, 동구,055002, 51세,2016,3638,1818,1820,99.9,3600,1796,1804,99.6
25010, 동구,055003, 52세,2016,3370,1737,1633,106.4,3317,1714,1603,106.9
25010, 동구,055004, 53세,2016,3516,1794,1722,104.2,3470,1772,1698,104.4
25010, 동구,055005, 54세,2016,3943,2026,1917,105.7,3896,2006,1890,106.1
25010, 동구,060,55~59세,2016,19706,9589,10117,94.8,19532,9498,10034,94.7
25010, 동구,060001, 55세,2016,4359,2120,2239,94.7,4319,2097,2222,94.4
25010, 동구,060002, 56세,2016,4386,2095,2291,91.4,4343,2078,2265,91.7
25010, 동구,060003, 57세,2016,3779,1810,1969,91.9,3744,1788,1956,91.4
25010, 동구,060004, 58세,2016,3577,1761,1816,97,3538,1745,1793,97.3
25010, 동구,060005, 59세,2016,3605,1803,1802,100.1,3588,1790,1798,99.6
25010, 동구,065,60~64세,2016,15472,7540,7932,95.1,15354,7482,7872,95
25010, 동구,065001, 60세,2016,3526,1734,1792,96.8,3509,1728,1781,97
25010, 동구,065002, 61세,2016,3501,1687,1814,93,3462,1668,1794,93
25010, 동구,065003, 62세,2016,3058,1501,1557,96.4,3030,1484,1546,96
25010, 동구,065004, 63세,2016,2553,1235,1318,93.7,2536,1228,1308,93.9
25010, 동구,065005, 64세,2016,2834,1383,1451,95.3,2817,1374,1443,95.2
25010, 동구,070,65~69세,2016,11580,5459,6121,89.2,11532,5434,6098,89.1
25010, 동구,070001, 65세,2016,2197,1072,1125,95.3,2186,1067,1119,95.4
25010, 동구,070002, 66세,2016,2514,1171,1343,87.2,2503,1168,1335,87.5
25010, 동구,070003, 67세,2016,2390,1127,1263,89.2,2377,1116,1261,88.5
25010, 동구,070004, 68세,2016,2295,1105,1190,92.9,2289,1103,1186,93
25010, 동구,070005, 69세,2016,2184,984,1200,82,2177,980,1197,81.9
25010, 동구,075,70~74세,2016,9452,4345,5107,85.1,9433,4337,5096,85.1
25010, 동구,075001, 70세,2016,1696,800,896,89.3,1694,800,894,89.5
25010, 동구,075002, 71세,2016,1778,837,941,88.9,1773,836,937,89.2
25010, 동구,075003, 72세,2016,1842,846,996,84.9,1836,841,995,84.5
25010, 동구,075004, 73세,2016,1906,858,1048,81.9,1903,857,1046,81.9
25010, 동구,075005, 74세,2016,2230,1004,1226,81.9,2227,1003,1224,81.9
25010, 동구,080,75~79세,2016,7254,2974,4280,69.5,7239,2965,4274,69.4
25010, 동구,080001, 75세,2016,1709,722,987,73.2,1705,721,984,73.3
25010, 동구,080002, 76세,2016,1483,611,872,70.1,1480,609,871,69.9
25010, 동구,080003, 77세,2016,1492,618,874,70.7,1488,616,872,70.6
25010, 동구,080004, 78세,2016,1372,535,837,63.9,1370,533,837,63.7
25010, 동구,080005, 79세,2016,1198,488,710,68.7,1196,486,710,68.5
25010, 동구,085,80~84세,2016,4442,1584,2858,55.4,4436,1581,2855,55.4
25010, 동구,085001, 80세,2016,1122,417,705,59.1,1122,417,705,59.1
25010, 동구,085002, 81세,2016,1023,376,647,58.1,1021,375,646,58
25010, 동구,085003, 82세,2016,880,326,554,58.8,879,325,554,58.7
25010, 동구,085004, 83세,2016,757,250,507,49.3,755,249,506,49.2
25010, 동구,085005, 84세,2016,660,215,445,48.3,659,215,444,48.4
25010, 동구,090,85~89세,2016,2047,572,1475,38.8,2041,570,1471,38.7
25010, 동구,090001, 85세,2016,495,159,336,47.3,493,159,334,47.6
25010, 동구,090002, 86세,2016,491,145,346,41.9,491,145,346,41.9
25010, 동구,090003, 87세,2016,401,102,299,34.1,399,100,299,33.4
25010, 동구,090004, 88세,2016,375,97,278,34.9,374,97,277,35
25010, 동구,090005, 89세,2016,285,69,216,31.9,284,69,215,32.1
25010, 동구,095,90~94세,2016,657,163,494,33,656,163,493,33.1
25010, 동구,095001, 90세,2016,176,47,129,36.4,176,47,129,36.4
25010, 동구,095002, 91세,2016,169,44,125,35.2,169,44,125,35.2
25010, 동구,095003, 92세,2016,129,33,96,34.4,128,33,95,34.7
25010, 동구,095004, 93세,2016,110,19,91,20.9,110,19,91,20.9
25010, 동구,095005, 94세,2016,73,20,53,37.7,73,20,53,37.7
25010, 동구,100,95~99세,2016,141,33,108,30.6,139,32,107,29.9
25010, 동구,100001, 95세,2016,56,12,44,27.3,56,12,44,27.3
25010, 동구,100002, 96세,2016,34,8,26,30.8,32,7,25,28
25010, 동구,100003, 97세,2016,26,6,20,30,26,6,20,30
25010, 동구,100004, 98세,2016,13,X,11,18.2,13,X,11,18.2
25010, 동구,100005, 99세,2016,12,5,7,71.4,12,5,7,71.4
25010, 동구,101,100세이상,2016,21,X,18,16.7,21,X,18,16.7
25010, 동구,102,15세미만,2016,29967,15473,14494,106.8,29863,15413,14450,106.7
25010, 동구,103,15~64세,2016,178051,92220,85831,107.4,174007,90495,83512,108.4
25010, 동구,104,65세이상,2016,35594,15133,20461,74,35497,15085,20412,73.9
25010, 동구,086,85세이상,2016,2866,771,2095,36.8,2857,768,2089,36.8
25010, 동구,126,평균연령,2016,40.9,39.6,42.2,,41,39.7,42.4,
25010, 동구,127,중위연령,2016,41.1,39.5,42.7,,41.4,39.7,43.1,
25020, 중구,000,합계,2016,246904,122142,124762,97.9,245091,121452,123639,98.2
25020, 중구,005,0~4세,2016,9679,5004,4675,107,9658,4991,4667,106.9
25020, 중구,005001, 0세,2016,1718,879,839,104.8,1712,875,837,104.5
25020, 중구,005002, 1세,2016,1903,1017,886,114.8,1901,1015,886,114.6
25020, 중구,005003, 2세,2016,1904,970,934,103.9,1897,967,930,104
25020, 중구,005004, 3세,2016,2004,1054,950,110.9,2001,1051,950,110.6
25020, 중구,005005, 4세,2016,2150,1084,1066,101.7,2147,1083,1064,101.8
25020, 중구,010,5~9세,2016,10881,5644,5237,107.8,10862,5633,5229,107.7
25020, 중구,010001, 5세,2016,2185,1126,1059,106.3,2179,1122,1057,106.1
25020, 중구,010002, 6세,2016,2065,1043,1022,102.1,2062,1040,1022,101.8
25020, 중구,010003, 7세,2016,2045,1067,978,109.1,2041,1065,976,109.1
25020, 중구,010004, 8세,2016,2278,1189,1089,109.2,2273,1187,1086,109.3
25020, 중구,010005, 9세,2016,2308,1219,1089,111.9,2307,1219,1088,112
25020, 중구,015,10~14세,2016,11295,5854,5441,107.6,11282,5846,5436,107.5
25020, 중구,015001, 10세,2016,2051,1029,1022,100.7,2049,1028,1021,100.7
25020, 중구,015002, 11세,2016,2110,1072,1038,103.3,2107,1070,1037,103.2
25020, 중구,015003, 12세,2016,2263,1171,1092,107.2,2261,1170,1091,107.2
25020, 중구,015004, 13세,2016,2384,1253,1131,110.8,2382,1251,1131,110.6
25020, 중구,015005, 14세,2016,2487,1329,1158,114.8,2483,1327,1156,114.8
25020, 중구,020,15~19세,2016,15099,8069,7030,114.8,15068,8050,7018,114.7
25020, 중구,020001, 15세,2016,2842,1479,1363,108.5,2835,1474,1361,108.3
25020, 중구,020002, 16세,2016,3129,1686,1443,116.8,3123,1682,1441,116.7
25020, 중구,020003, 17세,2016,3144,1683,1461,115.2,3141,1682,1459,115.3
25020, 중구,020004, 18세,2016,3113,1680,1433,117.2,3107,1675,1432,117
25020, 중구,020005, 19세,2016,2871,1541,1330,115.9,2862,1537,1325,116
25020, 중구,025,20~24세,2016,16346,8546,7800,109.6,16180,8500,7680,110.7
25020, 중구,025001, 20세,2016,3133,1689,1444,117,3121,1682,1439,116.9
25020, 중구,025002, 21세,2016,3271,1736,1535,113.1,3251,1730,1521,113.7
25020, 중구,025003, 22세,2016,3336,1749,1587,110.2,3313,1744,1569,111.2
25020, 중구,025004, 23세,2016,3312,1703,1609,105.8,3259,1688,1571,107.4
25020, 중구,025005, 24세,2016,3294,1669,1625,102.7,3236,1656,1580,104.8
25020, 중구,030,25~29세,2016,14426,7447,6979,106.7,14109,7361,6748,109.1
25020, 중구,030001, 25세,2016,3161,1603,1558,102.9,3103,1585,1518,104.4
25020, 중구,030002, 26세,2016,2895,1508,1387,108.7,2832,1496,1336,112
25020, 중구,030003, 27세,2016,2790,1477,1313,112.5,2723,1462,1261,115.9
25020, 중구,030004, 28세,2016,2799,1455,1344,108.3,2729,1434,1295,110.7
25020, 중구,030005, 29세,2016,2781,1404,1377,102,2722,1384,1338,103.4
25020, 중구,035,30~34세,2016,14988,7613,7375,103.2,14759,7536,7223,104.3
25020, 중구,035001, 30세,2016,2758,1414,1344,105.2,2707,1396,1311,106.5
25020, 중구,035002, 31세,2016,2701,1336,1365,97.9,2650,1321,1329,99.4
25020, 중구,035003, 32세,2016,2865,1487,1378,107.9,2825,1471,1354,108.6
25020, 중구,035004, 33세,2016,3167,1626,1541,105.5,3123,1612,1511,106.7
25020, 중구,035005, 34세,2016,3497,1750,1747,100.2,3454,1736,1718,101
25020, 중구,040,35~39세,2016,18191,9076,9115,99.6,18042,9019,9023,100
25020, 중구,040001, 35세,2016,3614,1790,1824,98.1,3583,1778,1805,98.5
25020, 중구,040002, 36세,2016,3802,1915,1887,101.5,3767,1906,1861,102.4
25020, 중구,040003, 37세,2016,3748,1879,1869,100.5,3720,1867,1853,100.8
25020, 중구,040004, 38세,2016,3419,1720,1699,101.2,3398,1709,1689,101.2
25020, 중구,040005, 39세,2016,3608,1772,1836,96.5,3574,1759,1815,96.9
25020, 중구,045,40~44세,2016,19628,9977,9651,103.4,19474,9914,9560,103.7
25020, 중구,045001, 40세,2016,3500,1770,1730,102.3,3477,1759,1718,102.4
25020, 중구,045002, 41세,2016,3683,1874,1809,103.6,3657,1860,1797,103.5
25020, 중구,045003, 42세,2016,4080,2115,1965,107.6,4053,2105,1948,108.1
25020, 중구,045004, 43세,2016,4214,2096,2118,99,4182,2084,2098,99.3
25020, 중구,045005, 44세,2016,4151,2122,2029,104.6,4105,2106,1999,105.4
25020, 중구,050,45~49세,2016,21538,10833,10705,101.2,21352,10752,10600,101.4
25020, 중구,050001, 45세,2016,4379,2220,2159,102.8,4347,2207,2140,103.1
25020, 중구,050002, 46세,2016,4243,2152,2091,102.9,4196,2138,2058,103.9
25020, 중구,050003, 47세,2016,4540,2306,2234,103.2,4494,2281,2213,103.1
25020, 중구,050004, 48세,2016,4384,2158,2226,96.9,4357,2145,2212,97
25020, 중구,050005, 49세,2016,3992,1997,1995,100.1,3958,1981,1977,100.2
25020, 중구,055,50~54세,2016,19276,9756,9520,102.5,19100,9681,9419,102.8
25020, 중구,055001, 50세,2016,3729,1917,1812,105.8,3700,1901,1799,105.7
25020, 중구,055002, 51세,2016,3931,1980,1951,101.5,3898,1964,1934,101.6
25020, 중구,055003, 52세,2016,3719,1906,1813,105.1,3685,1891,1794,105.4
25020, 중구,055004, 53세,2016,3675,1830,1845,99.2,3636,1812,1824,99.3
25020, 중구,055005, 54세,2016,4222,2123,2099,101.1,4181,2113,2068,102.2
25020, 중구,060,55~59세,2016,20471,9878,10593,93.3,20326,9824,10502,93.5
25020, 중구,060001, 55세,2016,4497,2189,2308,94.8,4469,2180,2289,95.2
25020, 중구,060002, 56세,2016,4408,2086,2322,89.8,4377,2073,2304,90
25020, 중구,060003, 57세,2016,3942,1889,2053,92,3918,1883,2035,92.5
25020, 중구,060004, 58세,2016,3832,1848,1984,93.1,3801,1837,1964,93.5
25020, 중구,060005, 59세,2016,3792,1866,1926,96.9,3761,1851,1910,96.9
25020, 중구,065,60~64세,2016,16639,7847,8792,89.3,16516,7786,8730,89.2
25020, 중구,065001, 60세,2016,3706,1750,1956,89.5,3664,1731,1933,89.5
25020, 중구,065002, 61세,2016,3743,1777,1966,90.4,3720,1765,1955,90.3
25020, 중구,065003, 62세,2016,3361,1536,1825,84.2,3338,1524,1814,84
25020, 중구,065004, 63세,2016,2801,1345,1456,92.4,2779,1330,1449,91.8
25020, 중구,065005, 64세,2016,3028,1439,1589,90.6,3015,1436,1579,90.9
25020, 중구,070,65~69세,2016,12634,6000,6634,90.4,12587,5976,6611,90.4
25020, 중구,070001, 65세,2016,2280,1100,1180,93.2,2273,1097,1176,93.3
25020, 중구,070002, 66세,2016,2639,1218,1421,85.7,2629,1212,1417,85.5
25020, 중구,070003, 67세,2016,2738,1311,1427,91.9,2728,1306,1422,91.8
25020, 중구,070004, 68세,2016,2566,1249,1317,94.8,2556,1245,1311,95
25020, 중구,070005, 69세,2016,2411,1122,1289,87,2401,1116,1285,86.8
25020, 중구,075,70~74세,2016,10082,4621,5461,84.6,10068,4616,5452,84.7
25020, 중구,075001, 70세,2016,1991,953,1038,91.8,1983,951,1032,92.2
25020, 중구,075002, 71세,2016,1890,865,1025,84.4,1889,864,1025,84.3
25020, 중구,075003, 72세,2016,1963,904,1059,85.4,1962,904,1058,85.4
25020, 중구,075004, 73세,2016,1904,853,1051,81.2,1903,853,1050,81.2
25020, 중구,075005, 74세,2016,2334,1046,1288,81.2,2331,1044,1287,81.1
25020, 중구,080,75~79세,2016,7754,3347,4407,75.9,7741,3343,4398,76
25020, 중구,080001, 75세,2016,1729,761,968,78.6,1727,760,967,78.6
25020, 중구,080002, 76세,2016,1571,689,882,78.1,1569,689,880,78.3
25020, 중구,080003, 77세,2016,1632,718,914,78.6,1628,716,912,78.5
25020, 중구,080004, 78세,2016,1523,657,866,75.9,1522,657,865,76
25020, 중구,080005, 79세,2016,1299,522,777,67.2,1295,521,774,67.3
25020, 중구,085,80~84세,2016,4791,1780,3011,59.1,4783,1775,3008,59
25020, 중구,085001, 80세,2016,1222,476,746,63.8,1222,476,746,63.8
25020, 중구,085002, 81세,2016,1075,423,652,64.9,1074,422,652,64.7
25020, 중구,085003, 82세,2016,951,345,606,56.9,947,343,604,56.8
25020, 중구,085004, 83세,2016,833,303,530,57.2,831,302,529,57.1
25020, 중구,085005, 84세,2016,710,233,477,48.8,709,232,477,48.6
25020, 중구,090,85~89세,2016,2252,632,1620,39,2250,631,1619,39
25020, 중구,090001, 85세,2016,581,180,401,44.9,580,180,400,45
25020, 중구,090002, 86세,2016,556,146,410,35.6,556,146,410,35.6
25020, 중구,090003, 87세,2016,422,127,295,43.1,422,127,295,43.1
25020, 중구,090004, 88세,2016,355,88,267,33,354,87,267,32.6
25020, 중구,090005, 89세,2016,338,91,247,36.8,338,91,247,36.8
25020, 중구,095,90~94세,2016,760,180,580,31,760,180,580,31
25020, 중구,095001, 90세,2016,203,52,151,34.4,203,52,151,34.4
25020, 중구,095002, 91세,2016,196,49,147,33.3,196,49,147,33.3
25020, 중구,095003, 92세,2016,150,32,118,27.1,150,32,118,27.1
25020, 중구,095004, 93세,2016,118,21,97,21.6,118,21,97,21.6
25020, 중구,095005, 94세,2016,93,26,67,38.8,93,26,67,38.8
25020, 중구,100,95~99세,2016,154,38,116,32.8,154,38,116,32.8
25020, 중구,100001, 95세,2016,64,20,44,45.5,64,20,44,45.5
25020, 중구,100002, 96세,2016,43,9,34,26.5,43,9,34,26.5
25020, 중구,100003, 97세,2016,22,X,18,22.2,22,X,18,22.2
25020, 중구,100004, 98세,2016,14,X,11,27.3,14,X,11,27.3
25020, 중구,100005, 99세,2016,11,X,9,22.2,11,X,9,22.2
25020, 중구,101,100세이상,2016,20,X,20,0,20,X,20,0
25020, 중구,102,15세미만,2016,31855,16502,15353,107.5,31802,16470,15332,107.4
25020, 중구,103,15~64세,2016,176602,89042,87560,101.7,174926,88423,86503,102.2
25020, 중구,104,65세이상,2016,38447,16598,21849,76,38363,16559,21804,75.9
25020, 중구,086,85세이상,2016,3186,850,2336,36.4,3184,849,2335,36.4
25020, 중구,126,평균연령,2016,42.1,40.8,43.4,,42.1,40.8,43.4,
25020, 중구,127,중위연령,2016,43.3,42.1,44.5,,43.3,42.1,44.6,
25030, 서구,000,합계,2016,491430,242008,249422,97,487452,240326,247126,97.2
25030, 서구,005,0~4세,2016,21681,11239,10442,107.6,21615,11206,10409,107.7
25030, 서구,005001, 0세,2016,4162,2199,1963,112,4154,2195,1959,112
25030, 서구,005002, 1세,2016,4355,2255,2100,107.4,4340,2245,2095,107.2
25030, 서구,005003, 2세,2016,4134,2124,2010,105.7,4122,2116,2006,105.5
25030, 서구,005004, 3세,2016,4469,2266,2203,102.9,4455,2261,2194,103.1
25030, 서구,005005, 4세,2016,4561,2395,2166,110.6,4544,2389,2155,110.9
25030, 서구,010,5~9세,2016,22994,11762,11232,104.7,22929,11731,11198,104.8
25030, 서구,010001, 5세,2016,4657,2401,2256,106.4,4643,2397,2246,106.7
25030, 서구,010002, 6세,2016,4512,2283,2229,102.4,4491,2272,2219,102.4
25030, 서구,010003, 7세,2016,4347,2262,2085,108.5,4333,2257,2076,108.7
25030, 서구,010004, 8세,2016,4587,2337,2250,103.9,4579,2332,2247,103.8
25030, 서구,010005, 9세,2016,4891,2479,2412,102.8,4883,2473,2410,102.6
25030, 서구,015,10~14세,2016,25112,13036,12076,107.9,25073,13022,12051,108.1
25030, 서구,015001, 10세,2016,4587,2374,2213,107.3,4577,2368,2209,107.2
25030, 서구,015002, 11세,2016,4586,2401,2185,109.9,4581,2399,2182,109.9
25030, 서구,015003, 12세,2016,5221,2686,2535,106,5211,2684,2527,106.2
25030, 서구,015004, 13세,2016,5255,2665,2590,102.9,5250,2663,2587,102.9
25030, 서구,015005, 14세,2016,5463,2910,2553,114,5454,2908,2546,114.2
25030, 서구,020,15~19세,2016,35402,18010,17392,103.6,35270,17948,17322,103.6
25030, 서구,020001, 15세,2016,6085,3146,2939,107,6072,3139,2933,107
25030, 서구,020002, 16세,2016,6842,3467,3375,102.7,6831,3460,3371,102.6
25030, 서구,020003, 17세,2016,6752,3493,3259,107.2,6743,3486,3257,107
25030, 서구,020004, 18세,2016,7357,3722,3635,102.4,7330,3711,3619,102.5
25030, 서구,020005, 19세,2016,8366,4182,4184,100,8294,4152,4142,100.2
25030, 서구,025,20~24세,2016,41106,21364,19742,108.2,40303,21124,19179,110.1
25030, 서구,025001, 20세,2016,7854,3960,3894,101.7,7745,3929,3816,103
25030, 서구,025002, 21세,2016,8110,4158,3952,105.2,7958,4120,3838,107.3
25030, 서구,025003, 22세,2016,8506,4417,4089,108,8319,4363,3956,110.3
25030, 서구,025004, 23세,2016,8198,4328,3870,111.8,8027,4273,3754,113.8
25030, 서구,025005, 24세,2016,8438,4501,3937,114.3,8254,4439,3815,116.4
25030, 서구,030,25~29세,2016,34452,17562,16890,104,33669,17233,16436,104.8
25030, 서구,030001, 25세,2016,7526,3899,3627,107.5,7368,3835,3533,108.5
25030, 서구,030002, 26세,2016,7069,3624,3445,105.2,6908,3571,3337,107
25030, 서구,030003, 27세,2016,6774,3513,3261,107.7,6599,3430,3169,108.2
25030, 서구,030004, 28세,2016,6625,3349,3276,102.2,6468,3283,3185,103.1
25030, 서구,030005, 29세,2016,6458,3177,3281,96.8,6326,3114,3212,96.9
25030, 서구,035,30~34세,2016,34987,17542,17445,100.6,34511,17333,17178,100.9
25030, 서구,035001, 30세,2016,6544,3289,3255,101,6438,3252,3186,102.1
25030, 서구,035002, 31세,2016,6581,3351,3230,103.7,6486,3308,3178,104.1
25030, 서구,035003, 32세,2016,6686,3331,3355,99.3,6582,3280,3302,99.3
25030, 서구,035004, 33세,2016,7292,3663,3629,100.9,7220,3632,3588,101.2
25030, 서구,035005, 34세,2016,7884,3908,3976,98.3,7785,3861,3924,98.4
25030, 서구,040,35~39세,2016,37260,18252,19008,96,36912,18087,18825,96.1
25030, 서구,040001, 35세,2016,7705,3854,3851,100.1,7621,3813,3808,100.1
25030, 서구,040002, 36세,2016,7912,3871,4041,95.8,7846,3841,4005,95.9
25030, 서구,040003, 37세,2016,7439,3665,3774,97.1,7374,3638,3736,97.4
25030, 서구,040004, 38세,2016,6991,3396,3595,94.5,6921,3358,3563,94.2
25030, 서구,040005, 39세,2016,7213,3466,3747,92.5,7150,3437,3713,92.6
25030, 서구,045,40~44세,2016,40492,19452,21040,92.5,40195,19304,20891,92.4
25030, 서구,045001, 40세,2016,7199,3455,3744,92.3,7148,3435,3713,92.5
25030, 서구,045002, 41세,2016,7614,3709,3905,95,7552,3675,3877,94.8
25030, 서구,045003, 42세,2016,8480,4011,4469,89.8,8415,3976,4439,89.6
25030, 서구,045004, 43세,2016,8691,4146,4545,91.2,8631,4118,4513,91.2
25030, 서구,045005, 44세,2016,8508,4131,4377,94.4,8449,4100,4349,94.3
25030, 서구,050,45~49세,2016,45644,21900,23744,92.2,45363,21765,23598,92.2
25030, 서구,050001, 45세,2016,9563,4573,4990,91.6,9491,4535,4956,91.5
25030, 서구,050002, 46세,2016,8963,4372,4591,95.2,8907,4347,4560,95.3
25030, 서구,050003, 47세,2016,9404,4479,4925,90.9,9354,4451,4903,90.8
25030, 서구,050004, 48세,2016,9424,4535,4889,92.8,9368,4512,4856,92.9
25030, 서구,050005, 49세,2016,8290,3941,4349,90.6,8243,3920,4323,90.7
25030, 서구,055,50~54세,2016,38868,19015,19853,95.8,38599,18894,19705,95.9
25030, 서구,055001, 50세,2016,7645,3724,3921,95,7592,3701,3891,95.1
25030, 서구,055002, 51세,2016,8103,3937,4166,94.5,8043,3915,4128,94.8
25030, 서구,055003, 52세,2016,7376,3521,3855,91.3,7324,3495,3829,91.3
25030, 서구,055004, 53세,2016,7604,3784,3820,99.1,7542,3758,3784,99.3
25030, 서구,055005, 54세,2016,8140,4049,4091,99,8098,4025,4073,98.8
25030, 서구,060,55~59세,2016,38404,18852,19552,96.4,38235,18770,19465,96.4
25030, 서구,060001, 55세,2016,8976,4350,4626,94,8942,4336,4606,94.1
25030, 서구,060002, 56세,2016,8495,4128,4367,94.5,8449,4104,4345,94.5
25030, 서구,060003, 57세,2016,7333,3592,3741,96,7311,3585,3726,96.2
25030, 서구,060004, 58세,2016,6831,3398,3433,99,6784,3373,3411,98.9
25030, 서구,060005, 59세,2016,6769,3384,3385,100,6749,3372,3377,99.9
25030, 서구,065,60~64세,2016,26052,12878,13174,97.8,25926,12812,13114,97.7
25030, 서구,065001, 60세,2016,6173,3110,3063,101.5,6140,3093,3047,101.5
25030, 서구,065002, 61세,2016,6101,2965,3136,94.5,6072,2947,3125,94.3
25030, 서구,065003, 62세,2016,5101,2483,2618,94.8,5074,2467,2607,94.6
25030, 서구,065004, 63세,2016,4216,2119,2097,101,4196,2113,2083,101.4
25030, 서구,065005, 64세,2016,4461,2201,2260,97.4,4444,2192,2252,97.3
25030, 서구,070,65~69세,2016,17147,8415,8732,96.4,17075,8385,8690,96.5
25030, 서구,070001, 65세,2016,3368,1643,1725,95.2,3346,1634,1712,95.4
25030, 서구,070002, 66세,2016,3822,1918,1904,100.7,3804,1910,1894,100.8
25030, 서구,070003, 67세,2016,3515,1773,1742,101.8,3496,1767,1729,102.2
25030, 서구,070004, 68세,2016,3312,1561,1751,89.1,3307,1559,1748,89.2
25030, 서구,070005, 69세,2016,3130,1520,1610,94.4,3122,1515,1607,94.3
25030, 서구,075,70~74세,2016,12299,5711,6588,86.7,12277,5705,6572,86.8
25030, 서구,075001, 70세,2016,2438,1187,1251,94.9,2427,1185,1242,95.4
25030, 서구,075002, 71세,2016,2299,1086,1213,89.5,2295,1083,1212,89.4
25030, 서구,075003, 72세,2016,2395,1054,1341,78.6,2392,1054,1338,78.8
25030, 서구,075004, 73세,2016,2298,1043,1255,83.1,2297,1042,1255,83
25030, 서구,075005, 74세,2016,2869,1341,1528,87.8,2866,1341,1525,87.9
25030, 서구,080,75~79세,2016,9419,3931,5488,71.6,9402,3924,5478,71.6
25030, 서구,080001, 75세,2016,2147,952,1195,79.7,2140,948,1192,79.5
25030, 서구,080002, 76세,2016,1886,810,1076,75.3,1884,810,1074,75.4
25030, 서구,080003, 77세,2016,2017,802,1215,66,2013,799,1214,65.8
25030, 서구,080004, 78세,2016,1790,723,1067,67.8,1789,723,1066,67.8
25030, 서구,080005, 79세,2016,1579,644,935,68.9,1576,644,932,69.1
25030, 서구,085,80~84세,2016,6095,2103,3992,52.7,6087,2101,3986,52.7
25030, 서구,085001, 80세,2016,1505,541,964,56.1,1502,539,963,56
25030, 서구,085002, 81세,2016,1387,507,880,57.6,1384,507,877,57.8
25030, 서구,085003, 82세,2016,1219,415,804,51.6,1218,415,803,51.7
25030, 서구,085004, 83세,2016,1046,336,710,47.3,1045,336,709,47.4
25030, 서구,085005, 84세,2016,938,304,634,47.9,938,304,634,47.9
25030, 서구,090,85~89세,2016,2812,715,2097,34.1,2809,714,2095,34.1
25030, 서구,090001, 85세,2016,686,181,505,35.8,686,181,505,35.8
25030, 서구,090002, 86세,2016,687,187,500,37.4,687,187,500,37.4
25030, 서구,090003, 87세,2016,544,132,412,32,542,131,411,31.9
25030, 서구,090004, 88세,2016,496,109,387,28.2,496,109,387,28.2
25030, 서구,090005, 89세,2016,399,106,293,36.2,398,106,292,36.3
25030, 서구,095,90~94세,2016,963,218,745,29.3,962,217,745,29.1
25030, 서구,095001, 90세,2016,269,79,190,41.6,269,79,190,41.6
25030, 서구,095002, 91세,2016,230,37,193,19.2,229,36,193,18.7
25030, 서구,095003, 92세,2016,159,36,123,29.3,159,36,123,29.3
25030, 서구,095004, 93세,2016,181,37,144,25.7,181,37,144,25.7
25030, 서구,095005, 94세,2016,124,29,95,30.5,124,29,95,30.5
25030, 서구,100,95~99세,2016,194,43,151,28.5,193,43,150,28.7
25030, 서구,100001, 95세,2016,59,18,41,43.9,59,18,41,43.9
25030, 서구,100002, 96세,2016,53,11,42,26.2,53,11,42,26.2
25030, 서구,100003, 97세,2016,38,8,30,26.7,38,8,30,26.7
25030, 서구,100004, 98세,2016,31,X,29,6.9,31,X,29,6.9
25030, 서구,100005, 99세,2016,13,X,9,44.4,12,X,8,50
25030, 서구,101,100세이상,2016,47,8,39,20.5,47,8,39,20.5
25030, 서구,102,15세미만,2016,69787,36037,33750,106.8,69617,35959,33658,106.8
25030, 서구,103,15~64세,2016,372667,184827,187840,98.4,368983,183270,185713,98.7
25030, 서구,104,65세이상,2016,48976,21144,27832,76,48852,21097,27755,76
25030, 서구,086,85세이상,2016,4016,984,3032,32.5,4011,982,3029,32.4
25030, 서구,126,평균연령,2016,38.6,37.7,39.5,,38.6,37.7,39.6,
25030, 서구,127,중위연령,2016,39,37.8,40.1,,39.1,37.8,40.3,
25040, 유성구,000,합계,2016,359057,185416,173641,106.8,352245,181865,170380,106.7
25040, 유성구,005,0~4세,2016,20218,10414,9804,106.2,19963,10298,9665,106.5
25040, 유성구,005001, 0세,2016,3848,2028,1820,111.4,3797,2002,1795,111.5
25040, 유성구,005002, 1세,2016,4161,2093,2068,101.2,4106,2067,2039,101.4
25040, 유성구,005003, 2세,2016,3955,2047,1908,107.3,3905,2025,1880,107.7
25040, 유성구,005004, 3세,2016,4006,2026,1980,102.3,3955,2005,1950,102.8
25040, 유성구,005005, 4세,2016,4248,2220,2028,109.5,4200,2199,2001,109.9
25040, 유성구,010,5~9세,2016,20280,10445,9835,106.2,20119,10370,9749,106.4
25040, 유성구,010001, 5세,2016,4240,2252,1988,113.3,4186,2222,1964,113.1
25040, 유성구,010002, 6세,2016,4026,2049,1977,103.6,3997,2038,1959,104
25040, 유성구,010003, 7세,2016,3797,1929,1868,103.3,3769,1918,1851,103.6
25040, 유성구,010004, 8세,2016,4090,2141,1949,109.9,4059,2125,1934,109.9
25040, 유성구,010005, 9세,2016,4127,2074,2053,101,4108,2067,2041,101.3
25040, 유성구,015,10~14세,2016,19220,10127,9093,111.4,19136,10081,9055,111.3
25040, 유성구,015001, 10세,2016,3826,2018,1808,111.6,3807,2007,1800,111.5
25040, 유성구,015002, 11세,2016,3597,1919,1678,114.4,3585,1911,1674,114.2
25040, 유성구,015003, 12세,2016,3963,2081,1882,110.6,3951,2075,1876,110.6
25040, 유성구,015004, 13세,2016,3865,2022,1843,109.7,3841,2010,1831,109.8
25040, 유성구,015005, 14세,2016,3969,2087,1882,110.9,3952,2078,1874,110.9
25040, 유성구,020,15~19세,2016,26050,13911,12139,114.6,25734,13744,11990,114.6
25040, 유성구,020001, 15세,2016,4401,2317,2084,111.2,4385,2305,2080,110.8
25040, 유성구,020002, 16세,2016,4534,2359,2175,108.5,4518,2351,2167,108.5
25040, 유성구,020003, 17세,2016,4448,2295,2153,106.6,4409,2271,2138,106.2
25040, 유성구,020004, 18세,2016,5523,3025,2498,121.1,5439,2979,2460,121.1
25040, 유성구,020005, 19세,2016,7144,3915,3229,121.2,6983,3838,3145,122
25040, 유성구,025,20~24세,2016,32459,18228,14231,128.1,30941,17486,13455,130
25040, 유성구,025001, 20세,2016,6679,3519,3160,111.4,6405,3375,3030,111.4
25040, 유성구,025002, 21세,2016,6104,3264,2840,114.9,5783,3112,2671,116.5
25040, 유성구,025003, 22세,2016,6464,3745,2719,137.7,6154,3600,2554,141
25040, 유성구,025004, 23세,2016,6656,3866,2790,138.6,6350,3707,2643,140.3
25040, 유성구,025005, 24세,2016,6556,3834,2722,140.9,6249,3692,2557,144.4
25040, 유성구,030,25~29세,2016,28410,16451,11959,137.6,27035,15723,11312,139
25040, 유성구,030001, 25세,2016,6070,3570,2500,142.8,5751,3399,2352,144.5
25040, 유성구,030002, 26세,2016,5845,3490,2355,148.2,5557,3346,2211,151.3
25040, 유성구,030003, 27세,2016,5639,3334,2305,144.6,5354,3181,2173,146.4
25040, 유성구,030004, 28세,2016,5414,3084,2330,132.4,5165,2953,2212,133.5
25040, 유성구,030005, 29세,2016,5442,2973,2469,120.4,5208,2844,2364,120.3
25040, 유성구,035,30~34세,2016,29159,15356,13803,111.3,28197,14826,13371,110.9
25040, 유성구,035001, 30세,2016,5375,2916,2459,118.6,5126,2782,2344,118.7
25040, 유성구,035002, 31세,2016,5442,2959,2483,119.2,5242,2849,2393,119.1
25040, 유성구,035003, 32세,2016,5561,2917,2644,110.3,5381,2817,2564,109.9
25040, 유성구,035004, 33세,2016,6260,3261,2999,108.7,6086,3163,2923,108.2
25040, 유성구,035005, 34세,2016,6521,3303,3218,102.6,6362,3215,3147,102.2
25040, 유성구,040,35~39세,2016,31082,15550,15532,100.1,30481,15194,15287,99.4
25040, 유성구,040001, 35세,2016,6646,3370,3276,102.9,6504,3283,3221,101.9
25040, 유성구,040002, 36세,2016,6553,3322,3231,102.8,6410,3238,3172,102.1
25040, 유성구,040003, 37세,2016,6048,3003,3045,98.6,5921,2926,2995,97.7
25040, 유성구,040004, 38세,2016,5872,2872,3000,95.7,5765,2811,2954,95.2
25040, 유성구,040005, 39세,2016,5963,2983,2980,100.1,5881,2936,2945,99.7
25040, 유성구,045,40~44세,2016,31053,15481,15572,99.4,30666,15255,15411,99
25040, 유성구,045001, 40세,2016,5794,2892,2902,99.7,5720,2850,2870,99.3
25040, 유성구,045002, 41세,2016,6011,3012,2999,100.4,5928,2968,2960,100.3
25040, 유성구,045003, 42세,2016,6393,3147,3246,97,6315,3103,3212,96.6
25040, 유성구,045004, 43세,2016,6484,3186,3298,96.6,6410,3144,3266,96.3
25040, 유성구,045005, 44세,2016,6371,3244,3127,103.7,6293,3190,3103,102.8
25040, 유성구,050,45~49세,2016,31608,15833,15775,100.4,31240,15639,15601,100.2
25040, 유성구,050001, 45세,2016,6739,3444,3295,104.5,6653,3404,3249,104.8
25040, 유성구,050002, 46세,2016,6536,3219,3317,97,6449,3174,3275,96.9
25040, 유성구,050003, 47세,2016,6382,3175,3207,99,6315,3132,3183,98.4
25040, 유성구,050004, 48세,2016,6420,3217,3203,100.4,6353,3178,3175,100.1
25040, 유성구,050005, 49세,2016,5531,2778,2753,100.9,5470,2751,2719,101.2
25040, 유성구,055,50~54세,2016,25626,13122,12504,104.9,25335,12973,12362,104.9
25040, 유성구,055001, 50세,2016,5135,2734,2401,113.9,5068,2698,2370,113.8
25040, 유성구,055002, 51세,2016,5310,2608,2702,96.5,5263,2584,2679,96.5
25040, 유성구,055003, 52세,2016,4910,2482,2428,102.2,4847,2451,2396,102.3
25040, 유성구,055004, 53세,2016,5085,2645,2440,108.4,5023,2614,2409,108.5
25040, 유성구,055005, 54세,2016,5186,2653,2533,104.7,5134,2626,2508,104.7
25040, 유성구,060,55~59세,2016,23562,11990,11572,103.6,23356,11912,11444,104.1
25040, 유성구,060001, 55세,2016,5574,2827,2747,102.9,5540,2810,2730,102.9
25040, 유성구,060002, 56세,2016,5163,2574,2589,99.4,5120,2555,2565,99.6
25040, 유성구,060003, 57세,2016,4598,2374,2224,106.7,4554,2357,2197,107.3
25040, 유성구,060004, 58세,2016,4174,2075,2099,98.9,4129,2063,2066,99.9
25040, 유성구,060005, 59세,2016,4053,2140,1913,111.9,4013,2127,1886,112.8
25040, 유성구,065,60~64세,2016,14925,7747,7178,107.9,14770,7662,7108,107.8
25040, 유성구,065001, 60세,2016,3630,1875,1755,106.8,3595,1860,1735,107.2
25040, 유성구,065002, 61세,2016,3544,1819,1725,105.4,3516,1805,1711,105.5
25040, 유성구,065003, 62세,2016,2886,1490,1396,106.7,2843,1461,1382,105.7
25040, 유성구,065004, 63세,2016,2415,1302,1113,117,2389,1285,1104,116.4
25040, 유성구,065005, 64세,2016,2450,1261,1189,106.1,2427,1251,1176,106.4
25040, 유성구,070,65~69세,2016,8533,4301,4232,101.6,8480,4283,4197,102
25040, 유성구,070001, 65세,2016,1684,849,835,101.7,1672,848,824,102.9
25040, 유성구,070002, 66세,2016,1895,951,944,100.7,1884,947,937,101.1
25040, 유성구,070003, 67세,2016,1785,923,862,107.1,1772,916,856,107
25040, 유성구,070004, 68세,2016,1681,849,832,102,1674,846,828,102.2
25040, 유성구,070005, 69세,2016,1488,729,759,96,1478,726,752,96.5
25040, 유성구,075,70~74세,2016,6101,2796,3305,84.6,6071,2781,3290,84.5
25040, 유성구,075001, 70세,2016,1136,554,582,95.2,1129,550,579,95
25040, 유성구,075002, 71세,2016,1188,549,639,85.9,1182,546,636,85.8
25040, 유성구,075003, 72세,2016,1229,559,670,83.4,1224,556,668,83.2
25040, 유성구,075004, 73세,2016,1147,505,642,78.7,1139,500,639,78.2
25040, 유성구,075005, 74세,2016,1401,629,772,81.5,1397,629,768,81.9
25040, 유성구,080,75~79세,2016,4867,1948,2919,66.7,4838,1936,2902,66.7
25040, 유성구,080001, 75세,2016,1096,438,658,66.6,1092,437,655,66.7
25040, 유성구,080002, 76세,2016,972,411,561,73.3,963,407,556,73.2
25040, 유성구,080003, 77세,2016,1033,415,618,67.2,1026,414,612,67.6
25040, 유성구,080004, 78세,2016,931,361,570,63.3,926,358,568,63
25040, 유성구,080005, 79세,2016,835,323,512,63.1,831,320,511,62.6
25040, 유성구,085,80~84세,2016,3459,1073,2386,45,3444,1064,2380,44.7
25040, 유성구,085001, 80세,2016,858,281,577,48.7,853,278,575,48.3
25040, 유성구,085002, 81세,2016,757,227,530,42.8,753,224,529,42.3
25040, 유성구,085003, 82세,2016,693,234,459,51,691,233,458,50.9
25040, 유성구,085004, 83세,2016,581,173,408,42.4,579,172,407,42.3
25040, 유성구,085005, 84세,2016,570,158,412,38.3,568,157,411,38.2
25040, 유성구,090,85~89세,2016,1695,480,1215,39.5,1690,476,1214,39.2
25040, 유성구,090001, 85세,2016,425,118,307,38.4,425,118,307,38.4
25040, 유성구,090002, 86세,2016,386,111,275,40.4,386,111,275,40.4
25040, 유성구,090003, 87세,2016,347,99,248,39.9,346,98,248,39.5
25040, 유성구,090004, 88세,2016,311,86,225,38.2,308,84,224,37.5
25040, 유성구,090005, 89세,2016,226,66,160,41.3,225,65,160,40.6
25040, 유성구,095,90~94세,2016,608,133,475,28,607,132,475,27.8
25040, 유성구,095001, 90세,2016,150,40,110,36.4,150,40,110,36.4
25040, 유성구,095002, 91세,2016,148,33,115,28.7,148,33,115,28.7
25040, 유성구,095003, 92세,2016,126,31,95,32.6,125,30,95,31.6
25040, 유성구,095004, 93세,2016,122,19,103,18.4,122,19,103,18.4
25040, 유성구,095005, 94세,2016,62,10,52,19.2,62,10,52,19.2
25040, 유성구,100,95~99세,2016,128,26,102,25.5,128,26,102,25.5
25040, 유성구,100001, 95세,2016,41,X,37,10.8,41,X,37,10.8
25040, 유성구,100002, 96세,2016,37,11,26,42.3,37,11,26,42.3
25040, 유성구,100003, 97세,2016,25,7,18,38.9,25,7,18,38.9
25040, 유성구,100004, 98세,2016,17,X,14,21.4,17,X,14,21.4
25040, 유성구,100005, 99세,2016,8,X,7,14.3,8,X,7,14.3
25040, 유성구,101,100세이상,2016,14,X,10,40,14,X,10,40
25040, 유성구,102,15세미만,2016,59718,30986,28732,107.8,59218,30749,28469,108
25040, 유성구,103,15~64세,2016,273934,143669,130265,110.3,267755,140414,127341,110.3
25040, 유성구,104,65세이상,2016,25405,10761,14644,73.5,25272,10702,14570,73.5
25040, 유성구,086,85세이상,2016,2445,643,1802,35.7,2439,638,1801,35.4
25040, 유성구,126,평균연령,2016,35.9,34.9,36.8,,35.9,35,36.9,
25040, 유성구,127,중위연령,2016,35.6,34.3,36.8,,35.8,34.5,37.1,
25050, 대덕구,000,합계,2016,194442,98579,95863,102.8,191603,97113,94490,102.8
25050, 대덕구,005,0~4세,2016,7410,3787,3623,104.5,7386,3776,3610,104.6
25050, 대덕구,005001, 0세,2016,1345,671,674,99.6,1340,668,672,99.4
25050, 대덕구,005002, 1세,2016,1445,744,701,106.1,1442,741,701,105.7
25050, 대덕구,005003, 2세,2016,1494,774,720,107.5,1487,773,714,108.3
25050, 대덕구,005004, 3세,2016,1527,766,761,100.7,1523,764,759,100.7
25050, 대덕구,005005, 4세,2016,1599,832,767,108.5,1594,830,764,108.6
25050, 대덕구,010,5~9세,2016,8263,4289,3974,107.9,8233,4272,3961,107.9
25050, 대덕구,010001, 5세,2016,1655,866,789,109.8,1650,863,787,109.7
25050, 대덕구,010002, 6세,2016,1570,830,740,112.2,1566,829,737,112.5
25050, 대덕구,010003, 7세,2016,1596,829,767,108.1,1589,823,766,107.4
25050, 대덕구,010004, 8세,2016,1638,832,806,103.2,1632,828,804,103
25050, 대덕구,010005, 9세,2016,1804,932,872,106.9,1796,929,867,107.2
25050, 대덕구,015,10~14세,2016,9008,4646,4362,106.5,8991,4639,4352,106.6
25050, 대덕구,015001, 10세,2016,1611,837,774,108.1,1608,836,772,108.3
25050, 대덕구,015002, 11세,2016,1622,827,795,104,1616,824,792,104
25050, 대덕구,015003, 12세,2016,1895,1022,873,117.1,1893,1021,872,117.1
25050, 대덕구,015004, 13세,2016,1900,966,934,103.4,1897,965,932,103.5
25050, 대덕구,015005, 14세,2016,1980,994,986,100.8,1977,993,984,100.9
25050, 대덕구,020,15~19세,2016,13503,7008,6495,107.9,13411,6968,6443,108.1
25050, 대덕구,020001, 15세,2016,2389,1242,1147,108.3,2387,1240,1147,108.1
25050, 대덕구,020002, 16세,2016,2312,1209,1103,109.6,2304,1205,1099,109.6
25050, 대덕구,020003, 17세,2016,2620,1398,1222,114.4,2616,1395,1221,114.3
25050, 대덕구,020004, 18세,2016,2872,1502,1370,109.6,2855,1494,1361,109.8
25050, 대덕구,020005, 19세,2016,3310,1657,1653,100.2,3249,1634,1615,101.2
25050, 대덕구,025,20~24세,2016,16496,8803,7693,114.4,16065,8581,7484,114.7
25050, 대덕구,025001, 20세,2016,3335,1722,1613,106.8,3266,1691,1575,107.4
25050, 대덕구,025002, 21세,2016,3406,1703,1703,100,3333,1673,1660,100.8
25050, 대덕구,025003, 22세,2016,3359,1777,1582,112.3,3268,1729,1539,112.3
25050, 대덕구,025004, 23세,2016,3265,1838,1427,128.8,3173,1788,1385,129.1
25050, 대덕구,025005, 24세,2016,3131,1763,1368,128.9,3025,1700,1325,128.3
25050, 대덕구,030,25~29세,2016,12393,6973,5420,128.7,11874,6727,5147,130.7
25050, 대덕구,030001, 25세,2016,2829,1633,1196,136.5,2731,1581,1150,137.5
25050, 대덕구,030002, 26세,2016,2599,1508,1091,138.2,2497,1459,1038,140.6
25050, 대덕구,030003, 27세,2016,2298,1265,1033,122.5,2182,1220,962,126.8
25050, 대덕구,030004, 28세,2016,2385,1299,1086,119.6,2273,1243,1030,120.7
25050, 대덕구,030005, 29세,2016,2282,1268,1014,125,2191,1224,967,126.6
25050, 대덕구,035,30~34세,2016,11972,6382,5590,114.2,11542,6137,5405,113.5
25050, 대덕구,035001, 30세,2016,2240,1220,1020,119.6,2138,1159,979,118.4
25050, 대덕구,035002, 31세,2016,2221,1179,1042,113.1,2132,1141,991,115.1
25050, 대덕구,035003, 32세,2016,2278,1219,1059,115.1,2199,1172,1027,114.1
25050, 대덕구,035004, 33세,2016,2558,1370,1188,115.3,2474,1318,1156,114
25050, 대덕구,035005, 34세,2016,2675,1394,1281,108.8,2599,1347,1252,107.6
25050, 대덕구,040,35~39세,2016,13740,7130,6610,107.9,13438,6946,6492,107
25050, 대덕구,040001, 35세,2016,2883,1510,1373,110,2801,1460,1341,108.9
25050, 대덕구,040002, 36세,2016,2770,1407,1363,103.2,2709,1370,1339,102.3
25050, 대덕구,040003, 37세,2016,2764,1476,1288,114.6,2706,1441,1265,113.9
25050, 대덕구,040004, 38세,2016,2597,1337,1260,106.1,2539,1299,1240,104.8
25050, 대덕구,040005, 39세,2016,2726,1400,1326,105.6,2683,1376,1307,105.3
25050, 대덕구,045,40~44세,2016,15250,7721,7529,102.6,15008,7590,7418,102.3
25050, 대덕구,045001, 40세,2016,2682,1355,1327,102.1,2627,1325,1302,101.8
25050, 대덕구,045002, 41세,2016,2834,1390,1444,96.3,2791,1367,1424,96
25050, 대덕구,045003, 42세,2016,3239,1717,1522,112.8,3197,1687,1510,111.7
25050, 대덕구,045004, 43세,2016,3343,1671,1672,99.9,3291,1646,1645,100.1
25050, 대덕구,045005, 44세,2016,3152,1588,1564,101.5,3102,1565,1537,101.8
25050, 대덕구,050,45~49세,2016,18615,9368,9247,101.3,18380,9246,9134,101.2
25050, 대덕구,050001, 45세,2016,3696,1817,1879,96.7,3649,1801,1848,97.5
25050, 대덕구,050002, 46세,2016,3621,1852,1769,104.7,3568,1814,1754,103.4
25050, 대덕구,050003, 47세,2016,3885,1974,1911,103.3,3831,1943,1888,102.9
25050, 대덕구,050004, 48세,2016,3954,1968,1986,99.1,3913,1953,1960,99.6
25050, 대덕구,050005, 49세,2016,3459,1757,1702,103.2,3419,1735,1684,103
25050, 대덕구,055,50~54세,2016,16673,8504,8169,104.1,16489,8422,8067,104.4
25050, 대덕구,055001, 50세,2016,3255,1678,1577,106.4,3220,1661,1559,106.5
25050, 대덕구,055002, 51세,2016,3475,1777,1698,104.7,3437,1761,1676,105.1
25050, 대덕구,055003, 52세,2016,3178,1614,1564,103.2,3138,1600,1538,104
25050, 대덕구,055004, 53세,2016,3201,1635,1566,104.4,3161,1617,1544,104.7
25050, 대덕구,055005, 54세,2016,3564,1800,1764,102,3533,1783,1750,101.9
25050, 대덕구,060,55~59세,2016,16862,8522,8340,102.2,16715,8447,8268,102.2
25050, 대덕구,060001, 55세,2016,3965,1999,1966,101.7,3930,1984,1946,102
25050, 대덕구,060002, 56세,2016,3679,1841,1838,100.2,3638,1820,1818,100.1
25050, 대덕구,060003, 57세,2016,3243,1597,1646,97,3218,1585,1633,97.1
25050, 대덕구,060004, 58세,2016,3003,1566,1437,109,2976,1552,1424,109
25050, 대덕구,060005, 59세,2016,2972,1519,1453,104.5,2953,1506,1447,104.1
25050, 대덕구,065,60~64세,2016,11506,5667,5839,97.1,11407,5619,5788,97.1
25050, 대덕구,065001, 60세,2016,2706,1370,1336,102.5,2682,1357,1325,102.4
25050, 대덕구,065002, 61세,2016,2678,1318,1360,96.9,2662,1311,1351,97
25050, 대덕구,065003, 62세,2016,2241,1085,1156,93.9,2217,1074,1143,94
25050, 대덕구,065004, 63세,2016,1837,883,954,92.6,1813,870,943,92.3
25050, 대덕구,065005, 64세,2016,2044,1011,1033,97.9,2033,1007,1026,98.1
25050, 대덕구,070,65~69세,2016,7840,3839,4001,96,7790,3823,3967,96.4
25050, 대덕구,070001, 65세,2016,1533,796,737,108,1524,794,730,108.8
25050, 대덕구,070002, 66세,2016,1657,846,811,104.3,1648,844,804,105
25050, 대덕구,070003, 67세,2016,1609,759,850,89.3,1597,756,841,89.9
25050, 대덕구,070004, 68세,2016,1557,753,804,93.7,1549,749,800,93.6
25050, 대덕구,070005, 69세,2016,1484,685,799,85.7,1472,680,792,85.9
25050, 대덕구,075,70~74세,2016,5909,2703,3206,84.3,5889,2690,3199,84.1
25050, 대덕구,075001, 70세,2016,1047,527,520,101.3,1044,525,519,101.2
25050, 대덕구,075002, 71세,2016,1098,529,569,93,1089,522,567,92.1
25050, 대덕구,075003, 72세,2016,1113,497,616,80.7,1110,494,616,80.2
25050, 대덕구,075004, 73세,2016,1221,527,694,75.9,1217,526,691,76.1
25050, 대덕구,075005, 74세,2016,1430,623,807,77.2,1429,623,806,77.3
25050, 대덕구,080,75~79세,2016,4523,1861,2662,69.9,4509,1855,2654,69.9
25050, 대덕구,080001, 75세,2016,1031,432,599,72.1,1028,430,598,71.9
25050, 대덕구,080002, 76세,2016,897,375,522,71.8,894,373,521,71.6
25050, 대덕구,080003, 77세,2016,922,366,556,65.8,915,364,551,66.1
25050, 대덕구,080004, 78세,2016,875,382,493,77.5,875,382,493,77.5
25050, 대덕구,080005, 79세,2016,798,306,492,62.2,797,306,491,62.3
25050, 대덕구,085,80~84세,2016,2822,961,1861,51.6,2821,961,1860,51.7
25050, 대덕구,085001, 80세,2016,686,246,440,55.9,685,246,439,56
25050, 대덕구,085002, 81세,2016,696,262,434,60.4,696,262,434,60.4
25050, 대덕구,085003, 82세,2016,558,184,374,49.2,558,184,374,49.2
25050, 대덕구,085004, 83세,2016,465,150,315,47.6,465,150,315,47.6
25050, 대덕구,085005, 84세,2016,417,119,298,39.9,417,119,298,39.9
25050, 대덕구,090,85~89세,2016,1213,320,893,35.8,1211,319,892,35.8
25050, 대덕구,090001, 85세,2016,314,89,225,39.6,314,89,225,39.6
25050, 대덕구,090002, 86세,2016,266,75,191,39.3,266,75,191,39.3
25050, 대덕구,090003, 87세,2016,267,64,203,31.5,267,64,203,31.5
25050, 대덕구,090004, 88세,2016,198,47,151,31.1,197,47,150,31.3
25050, 대덕구,090005, 89세,2016,168,45,123,36.6,167,44,123,35.8
25050, 대덕구,095,90~94세,2016,349,76,273,27.8,349,76,273,27.8
25050, 대덕구,095001, 90세,2016,112,33,79,41.8,112,33,79,41.8
25050, 대덕구,095002, 91세,2016,65,10,55,18.2,65,10,55,18.2
25050, 대덕구,095003, 92세,2016,56,10,46,21.7,56,10,46,21.7
25050, 대덕구,095004, 93세,2016,70,12,58,20.7,70,12,58,20.7
25050, 대덕구,095005, 94세,2016,46,11,35,31.4,46,11,35,31.4
25050, 대덕구,100,95~99세,2016,84,19,65,29.2,84,19,65,29.2
25050, 대덕구,100001, 95세,2016,41,6,35,17.1,41,6,35,17.1
25050, 대덕구,100002, 96세,2016,20,7,13,53.8,20,7,13,53.8
25050, 대덕구,100003, 97세,2016,9,X,8,12.5,9,X,8,12.5
25050, 대덕구,100004, 98세,2016,5,X,5,0,5,X,5,0
25050, 대덕구,100005, 99세,2016,9,5,X,125,9,5,X,125
25050, 대덕구,101,100세이상,2016,11,X,11,0,11,X,11,0
25050, 대덕구,102,15세미만,2016,24681,12722,11959,106.4,24610,12687,11923,106.4
25050, 대덕구,103,15~64세,2016,147010,76078,70932,107.3,144329,74683,69646,107.2
25050, 대덕구,104,65세이상,2016,22751,9779,12972,75.4,22664,9743,12921,75.4
25050, 대덕구,086,85세이상,2016,1657,415,1242,33.4,1655,414,1241,33.4
25050, 대덕구,126,평균연령,2016,40.3,39.2,41.4,,40.3,39.3,41.4,
25050, 대덕구,127,중위연령,2016,41.6,40.2,42.9,,41.8,40.4,43.1,
26,울산광역시,000,합계,2016,1166033,605618,560415,108.1,1137241,587458,549783,106.9
26,울산광역시,005,0~4세,2016,58236,29866,28370,105.3,57642,29570,28072,105.3
26,울산광역시,005001, 0세,2016,11103,5693,5410,105.2,10987,5639,5348,105.4
26,울산광역시,005002, 1세,2016,11676,6038,5638,107.1,11555,5976,5579,107.1
26,울산광역시,005003, 2세,2016,11594,5909,5685,103.9,11467,5842,5625,103.9
26,울산광역시,005004, 3세,2016,11560,5872,5688,103.2,11437,5817,5620,103.5
26,울산광역시,005005, 4세,2016,12303,6354,5949,106.8,12196,6296,5900,106.7
26,울산광역시,010,5~9세,2016,57741,30044,27697,108.5,57376,29846,27530,108.4
26,울산광역시,010001, 5세,2016,11991,6214,5777,107.6,11895,6154,5741,107.2
26,울산광역시,010002, 6세,2016,11491,6015,5476,109.8,11412,5980,5432,110.1
26,울산광역시,010003, 7세,2016,11033,5736,5297,108.3,10965,5696,5269,108.1
26,울산광역시,010004, 8세,2016,11557,5961,5596,106.5,11498,5929,5569,106.5
26,울산광역시,010005, 9세,2016,11669,6118,5551,110.2,11606,6087,5519,110.3
26,울산광역시,015,10~14세,2016,55159,29030,26129,111.1,55009,28969,26040,111.2
26,울산광역시,015001, 10세,2016,10472,5444,5028,108.3,10439,5429,5010,108.4
26,울산광역시,015002, 11세,2016,10295,5423,4872,111.3,10262,5409,4853,111.5
26,울산광역시,015003, 12세,2016,11155,5901,5254,112.3,11130,5891,5239,112.4
26,울산광역시,015004, 13세,2016,11423,6069,5354,113.4,11402,6064,5338,113.6
26,울산광역시,015005, 14세,2016,11814,6193,5621,110.2,11776,6176,5600,110.3
26,울산광역시,020,15~19세,2016,73137,39835,33302,119.6,72705,39585,33120,119.5
26,울산광역시,020001, 15세,2016,13735,7322,6413,114.2,13703,7306,6397,114.2
26,울산광역시,020002, 16세,2016,15756,8319,7437,111.9,15717,8299,7418,111.9
26,울산광역시,020003, 17세,2016,15301,8130,7171,113.4,15242,8098,7144,113.4
26,울산광역시,020004, 18세,2016,15093,8211,6882,119.3,14986,8137,6849,118.8
26,울산광역시,020005, 19세,2016,13252,7853,5399,145.5,13057,7745,5312,145.8
26,울산광역시,025,20~24세,2016,78196,46055,32141,143.3,75870,44631,31239,142.9
26,울산광역시,025001, 20세,2016,14904,9271,5633,164.6,14637,9137,5500,166.1
26,울산광역시,025002, 21세,2016,15559,9415,6144,153.2,15256,9258,5998,154.4
26,울산광역시,025003, 22세,2016,15475,9054,6421,141,15065,8803,6262,140.6
26,울산광역시,025004, 23세,2016,15952,9023,6929,130.2,15339,8649,6690,129.3
26,울산광역시,025005, 24세,2016,16306,9292,7014,132.5,15573,8784,6789,129.4
26,울산광역시,030,25~29세,2016,76427,43427,33000,131.6,71351,40031,31320,127.8
26,울산광역시,030001, 25세,2016,15882,8856,7026,126,14975,8253,6722,122.8
26,울산광역시,030002, 26세,2016,15495,8933,6562,136.1,14465,8253,6212,132.9
26,울산광역시,030003, 27세,2016,15292,8830,6462,136.6,14270,8138,6132,132.7
26,울산광역시,030004, 28세,2016,14755,8438,6317,133.6,13730,7769,5961,130.3
26,울산광역시,030005, 29세,2016,15003,8370,6633,126.2,13911,7618,6293,121.1
26,울산광역시,035,30~34세,2016,85927,46315,39612,116.9,81222,43031,38191,112.7
26,울산광역시,035001, 30세,2016,15285,8485,6800,124.8,14263,7802,6461,120.8
26,울산광역시,035002, 31세,2016,15534,8507,7027,121.1,14532,7813,6719,116.3
26,울산광역시,035003, 32세,2016,16654,9015,7639,118,15662,8309,7353,113
26,울산광역시,035004, 33세,2016,18483,9801,8682,112.9,17586,9149,8437,108.4
26,울산광역시,035005, 34세,2016,19971,10507,9464,111,19179,9958,9221,108
26,울산광역시,040,35~39세,2016,96413,51058,45355,112.6,93186,48820,44366,110
26,울산광역시,040001, 35세,2016,20340,10934,9406,116.2,19590,10385,9205,112.8
26,울산광역시,040002, 36세,2016,20953,11053,9900,111.6,20269,10575,9694,109.1
26,울산광역시,040003, 37세,2016,19199,10132,9067,111.7,18568,9697,8871,109.3
26,울산광역시,040004, 38세,2016,17761,9467,8294,114.1,17134,9052,8082,112
26,울산광역시,040005, 39세,2016,18160,9472,8688,109,17625,9111,8514,107
26,울산광역시,045,40~44세,2016,95932,48662,47270,102.9,93265,46866,46399,101
26,울산광역시,045001, 40세,2016,17156,9020,8136,110.9,16625,8642,7983,108.3
26,울산광역시,045002, 41세,2016,18314,9338,8976,104,17801,8977,8824,101.7
26,울산광역시,045003, 42세,2016,19711,9922,9789,101.4,19210,9590,9620,99.7
26,울산광역시,045004, 43세,2016,20279,10145,10134,100.1,19739,9791,9948,98.4
26,울산광역시,045005, 44세,2016,20472,10237,10235,100,19890,9866,10024,98.4
26,울산광역시,050,45~49세,2016,111218,55095,56123,98.2,108245,53344,54901,97.2
26,울산광역시,050001, 45세,2016,22225,11103,11122,99.8,21557,10687,10870,98.3
26,울산광역시,050002, 46세,2016,21880,10833,11047,98.1,21275,10471,10804,96.9
26,울산광역시,050003, 47세,2016,22490,11159,11331,98.5,21893,10808,11085,97.5
26,울산광역시,050004, 48세,2016,22989,11338,11651,97.3,22382,10992,11390,96.5
26,울산광역시,050005, 49세,2016,21634,10662,10972,97.2,21138,10386,10752,96.6
26,울산광역시,055,50~54세,2016,105923,55295,50628,109.2,103171,53710,49461,108.6
26,울산광역시,055001, 50세,2016,21783,11418,10365,110.2,21223,11084,10139,109.3
26,울산광역시,055002, 51세,2016,21948,11399,10549,108.1,21366,11062,10304,107.4
26,울산광역시,055003, 52세,2016,19934,10371,9563,108.4,19409,10053,9356,107.4
26,울산광역시,055004, 53세,2016,20885,10898,9987,109.1,20234,10533,9701,108.6
26,울산광역시,055005, 54세,2016,21373,11209,10164,110.3,20939,10978,9961,110.2
26,울산광역시,060,55~59세,2016,98668,50553,48115,105.1,97004,49595,47409,104.6
26,울산광역시,060001, 55세,2016,22804,11729,11075,105.9,22489,11546,10943,105.5
26,울산광역시,060002, 56세,2016,21455,10865,10590,102.6,21045,10627,10418,102
26,울산광역시,060003, 57세,2016,19335,9954,9381,106.1,18996,9754,9242,105.5
26,울산광역시,060004, 58세,2016,18038,9305,8733,106.5,17707,9123,8584,106.3
26,울산광역시,060005, 59세,2016,17036,8700,8336,104.4,16767,8545,8222,103.9
26,울산광역시,065,60~64세,2016,65981,33528,32453,103.3,64918,32944,31974,103
26,울산광역시,065001, 60세,2016,15554,7935,7619,104.1,15305,7796,7509,103.8
26,울산광역시,065002, 61세,2016,15259,7650,7609,100.5,15016,7511,7505,100.1
26,울산광역시,065003, 62세,2016,12593,6456,6137,105.2,12347,6319,6028,104.8
26,울산광역시,065004, 63세,2016,11238,5684,5554,102.3,11058,5591,5467,102.3
26,울산광역시,065005, 64세,2016,11337,5803,5534,104.9,11192,5727,5465,104.8
26,울산광역시,070,65~69세,2016,41329,21084,20245,104.1,40885,20861,20024,104.2
26,울산광역시,070001, 65세,2016,8814,4535,4279,106,8686,4467,4219,105.9
26,울산광역시,070002, 66세,2016,8681,4435,4246,104.5,8571,4377,4194,104.4
26,울산광역시,070003, 67세,2016,8390,4314,4076,105.8,8298,4275,4023,106.3
26,울산광역시,070004, 68세,2016,8149,4132,4017,102.9,8092,4099,3993,102.7
26,울산광역시,070005, 69세,2016,7295,3668,3627,101.1,7238,3643,3595,101.3
26,울산광역시,075,70~74세,2016,27002,12710,14292,88.9,26842,12644,14198,89.1
26,울산광역시,075001, 70세,2016,5129,2572,2557,100.6,5093,2557,2536,100.8
26,울산광역시,075002, 71세,2016,5131,2491,2640,94.4,5092,2472,2620,94.4
26,울산광역시,075003, 72세,2016,5215,2389,2826,84.5,5189,2380,2809,84.7
26,울산광역시,075004, 73세,2016,5562,2555,3007,85,5539,2543,2996,84.9
26,울산광역시,075005, 74세,2016,5965,2703,3262,82.9,5929,2692,3237,83.2
26,울산광역시,080,75~79세,2016,19695,7936,11759,67.5,19596,7905,11691,67.6
26,울산광역시,080001, 75세,2016,4526,1981,2545,77.8,4498,1967,2531,77.7
26,울산광역시,080002, 76세,2016,4319,1780,2539,70.1,4300,1774,2526,70.2
26,울산광역시,080003, 77세,2016,4082,1721,2361,72.9,4060,1714,2346,73.1
26,울산광역시,080004, 78세,2016,3584,1340,2244,59.7,3571,1336,2235,59.8
26,울산광역시,080005, 79세,2016,3184,1114,2070,53.8,3167,1114,2053,54.3
26,울산광역시,085,80~84세,2016,11739,3660,8079,45.3,11685,3653,8032,45.5
26,울산광역시,085001, 80세,2016,2873,938,1935,48.5,2852,934,1918,48.7
26,울산광역시,085002, 81세,2016,2642,852,1790,47.6,2631,851,1780,47.8
26,울산광역시,085003, 82세,2016,2376,766,1610,47.6,2370,766,1604,47.8
26,울산광역시,085004, 83세,2016,2077,635,1442,44,2066,634,1432,44.3
26,울산광역시,085005, 84세,2016,1771,469,1302,36,1766,468,1298,36.1
26,울산광역시,090,85~89세,2016,5233,1147,4086,28.1,5202,1140,4062,28.1
26,울산광역시,090001, 85세,2016,1369,327,1042,31.4,1361,325,1036,31.4
26,울산광역시,090002, 86세,2016,1203,285,918,31,1194,285,909,31.4
26,울산광역시,090003, 87세,2016,1060,261,799,32.7,1055,259,796,32.5
26,울산광역시,090004, 88세,2016,885,157,728,21.6,880,155,725,21.4
26,울산광역시,090005, 89세,2016,716,117,599,19.5,712,116,596,19.5
26,울산광역시,095,90~94세,2016,1707,257,1450,17.7,1698,253,1445,17.5
26,울산광역시,095001, 90세,2016,503,79,424,18.6,502,78,424,18.4
26,울산광역시,095002, 91세,2016,447,67,380,17.6,443,66,377,17.5
26,울산광역시,095003, 92세,2016,285,36,249,14.5,283,34,249,13.7
26,울산광역시,095004, 93세,2016,275,43,232,18.5,274,43,231,18.6
26,울산광역시,095005, 94세,2016,197,32,165,19.4,196,32,164,19.5
26,울산광역시,100,95~99세,2016,336,59,277,21.3,335,58,277,20.9
26,울산광역시,100001, 95세,2016,132,25,107,23.4,132,25,107,23.4
26,울산광역시,100002, 96세,2016,95,15,80,18.8,95,15,80,18.8
26,울산광역시,100003, 97세,2016,54,10,44,22.7,54,10,44,22.7
26,울산광역시,100004, 98세,2016,33,5,28,17.9,32,X,28,14.3
26,울산광역시,100005, 99세,2016,22,X,18,22.2,22,X,18,22.2
26,울산광역시,101,100세이상,2016,34,X,32,6.3,34,X,32,6.3
26,울산광역시,102,15세미만,2016,171136,88940,82196,108.2,170027,88385,81642,108.3
26,울산광역시,103,15~64세,2016,887822,469823,417999,112.4,860937,452557,408380,110.8
26,울산광역시,104,65세이상,2016,107075,46855,60220,77.8,106277,46516,59761,77.8
26,울산광역시,086,85세이상,2016,7310,1465,5845,25.1,7269,1453,5816,25
26,울산광역시,126,평균연령,2016,38.9,37.9,40,,39,38,40,
26,울산광역시,127,중위연령,2016,40.1,38.6,41.7,,40.3,38.8,41.8,
26004, 읍부,000,합계,2016,153175,80504,72671,110.8,146182,75953,70229,108.2
26004, 읍부,005,0~4세,2016,7947,4035,3912,103.1,7769,3948,3821,103.3
26004, 읍부,005001, 0세,2016,1370,683,687,99.4,1340,667,673,99.1
26004, 읍부,005002, 1세,2016,1547,789,758,104.1,1501,764,737,103.7
26004, 읍부,005003, 2세,2016,1581,813,768,105.9,1541,796,745,106.8
26004, 읍부,005004, 3세,2016,1620,814,806,101,1584,798,786,101.5
26004, 읍부,005005, 4세,2016,1829,936,893,104.8,1803,923,880,104.9
26004, 읍부,010,5~9세,2016,8847,4548,4299,105.8,8759,4496,4263,105.5
26004, 읍부,010001, 5세,2016,1767,901,866,104,1748,889,859,103.5
26004, 읍부,010002, 6세,2016,1783,902,881,102.4,1765,895,870,102.9
26004, 읍부,010003, 7세,2016,1626,815,811,100.5,1607,803,804,99.9
26004, 읍부,010004, 8세,2016,1830,952,878,108.4,1811,939,872,107.7
26004, 읍부,010005, 9세,2016,1841,978,863,113.3,1828,970,858,113.1
26004, 읍부,015,10~14세,2016,8863,4610,4253,108.4,8819,4598,4221,108.9
26004, 읍부,015001, 10세,2016,1678,897,781,114.9,1668,894,774,115.5
26004, 읍부,015002, 11세,2016,1725,888,837,106.1,1717,886,831,106.6
26004, 읍부,015003, 12세,2016,1794,938,856,109.6,1788,935,853,109.6
26004, 읍부,015004, 13세,2016,1862,959,903,106.2,1854,958,896,106.9
26004, 읍부,015005, 14세,2016,1804,928,876,105.9,1792,925,867,106.7
26004, 읍부,020,15~19세,2016,10467,5764,4703,122.6,10306,5649,4657,121.3
26004, 읍부,020001, 15세,2016,2071,1088,983,110.7,2061,1082,979,110.5
26004, 읍부,020002, 16세,2016,2157,1154,1003,115.1,2145,1146,999,114.7
26004, 읍부,020003, 17세,2016,2186,1161,1025,113.3,2166,1145,1021,112.1
26004, 읍부,020004, 18세,2016,2050,1123,927,121.1,1996,1080,916,117.9
26004, 읍부,020005, 19세,2016,2003,1238,765,161.8,1938,1196,742,161.2
26004, 읍부,025,20~24세,2016,11189,6885,4304,160,10725,6567,4158,157.9
26004, 읍부,025001, 20세,2016,2223,1455,768,189.5,2143,1400,743,188.4
26004, 읍부,025002, 21세,2016,2276,1422,854,166.5,2210,1379,831,165.9
26004, 읍부,025003, 22세,2016,2208,1329,879,151.2,2136,1282,854,150.1
26004, 읍부,025004, 23세,2016,2261,1368,893,153.2,2156,1299,857,151.6
26004, 읍부,025005, 24세,2016,2221,1311,910,144.1,2080,1207,873,138.3
26004, 읍부,030,25~29세,2016,8746,5113,3633,140.7,7704,4380,3324,131.8
26004, 읍부,030001, 25세,2016,2037,1202,835,144,1869,1085,784,138.4
26004, 읍부,030002, 26세,2016,1781,1081,700,154.4,1581,935,646,144.7
26004, 읍부,030003, 27세,2016,1709,1002,707,141.7,1490,857,633,135.4
26004, 읍부,030004, 28세,2016,1554,885,669,132.3,1347,743,604,123
26004, 읍부,030005, 29세,2016,1665,943,722,130.6,1417,760,657,115.7
26004, 읍부,035,30~34세,2016,9808,5280,4528,116.6,8801,4549,4252,107
26004, 읍부,035001, 30세,2016,1667,922,745,123.8,1435,759,676,112.3
26004, 읍부,035002, 31세,2016,1704,926,778,119,1481,767,714,107.4
26004, 읍부,035003, 32세,2016,1897,1009,888,113.6,1715,880,835,105.4
26004, 읍부,035004, 33세,2016,2162,1166,996,117.1,1958,1006,952,105.7
26004, 읍부,035005, 34세,2016,2378,1257,1121,112.1,2212,1137,1075,105.8
26004, 읍부,040,35~39세,2016,12972,6630,6342,104.5,12222,6128,6094,100.6
26004, 읍부,040001, 35세,2016,2585,1401,1184,118.3,2422,1293,1129,114.5
26004, 읍부,040002, 36세,2016,2689,1326,1363,97.3,2535,1216,1319,92.2
26004, 읍부,040003, 37세,2016,2589,1305,1284,101.6,2439,1206,1233,97.8
26004, 읍부,040004, 38세,2016,2437,1283,1154,111.2,2279,1177,1102,106.8
26004, 읍부,040005, 39세,2016,2672,1315,1357,96.9,2547,1236,1311,94.3
26004, 읍부,045,40~44세,2016,14758,7510,7248,103.6,14010,6994,7016,99.7
26004, 읍부,045001, 40세,2016,2682,1388,1294,107.3,2538,1281,1257,101.9
26004, 읍부,045002, 41세,2016,2812,1384,1428,96.9,2672,1285,1387,92.6
26004, 읍부,045003, 42세,2016,3044,1536,1508,101.9,2912,1444,1468,98.4
26004, 읍부,045004, 43세,2016,3091,1569,1522,103.1,2915,1447,1468,98.6
26004, 읍부,045005, 44세,2016,3129,1633,1496,109.2,2973,1537,1436,107
26004, 읍부,050,45~49세,2016,15911,8260,7651,108,15043,7742,7301,106
26004, 읍부,050001, 45세,2016,3436,1774,1662,106.7,3242,1648,1594,103.4
26004, 읍부,050002, 46세,2016,3185,1625,1560,104.2,2998,1520,1478,102.8
26004, 읍부,050003, 47세,2016,3209,1675,1534,109.2,3034,1575,1459,108
26004, 읍부,050004, 48세,2016,3185,1677,1508,111.2,3024,1583,1441,109.9
26004, 읍부,050005, 49세,2016,2896,1509,1387,108.8,2745,1416,1329,106.5
26004, 읍부,055,50~54세,2016,13103,7210,5893,122.3,12292,6710,5582,120.2
26004, 읍부,055001, 50세,2016,2815,1518,1297,117,2653,1424,1229,115.9
26004, 읍부,055002, 51세,2016,2809,1566,1243,126,2627,1454,1173,124
26004, 읍부,055003, 52세,2016,2466,1356,1110,122.2,2309,1249,1060,117.8
26004, 읍부,055004, 53세,2016,2532,1402,1130,124.1,2343,1289,1054,122.3
26004, 읍부,055005, 54세,2016,2481,1368,1113,122.9,2360,1294,1066,121.4
26004, 읍부,060,55~59세,2016,10882,5788,5094,113.6,10468,5534,4934,112.2
26004, 읍부,060001, 55세,2016,2553,1353,1200,112.8,2472,1303,1169,111.5
26004, 읍부,060002, 56세,2016,2378,1308,1070,122.2,2264,1238,1026,120.7
26004, 읍부,060003, 57세,2016,2140,1144,996,114.9,2050,1090,960,113.5
26004, 읍부,060004, 58세,2016,1996,1026,970,105.8,1915,977,938,104.2
26004, 읍부,060005, 59세,2016,1815,957,858,111.5,1767,926,841,110.1
26004, 읍부,065,60~64세,2016,7063,3671,3392,108.2,6814,3527,3287,107.3
26004, 읍부,065001, 60세,2016,1688,884,804,110,1612,834,778,107.2
26004, 읍부,065002, 61세,2016,1680,864,816,105.9,1635,838,797,105.1
26004, 읍부,065003, 62세,2016,1337,699,638,109.6,1281,668,613,109
26004, 읍부,065004, 63세,2016,1176,611,565,108.1,1135,588,547,107.5
26004, 읍부,065005, 64세,2016,1182,613,569,107.7,1151,599,552,108.5
26004, 읍부,070,65~69세,2016,4437,2219,2218,100,4339,2168,2171,99.9
26004, 읍부,070001, 65세,2016,932,481,451,106.7,913,471,442,106.6
26004, 읍부,070002, 66세,2016,926,480,446,107.6,893,459,434,105.8
26004, 읍부,070003, 67세,2016,888,432,456,94.7,870,425,445,95.5
26004, 읍부,070004, 68세,2016,875,421,454,92.7,855,411,444,92.6
26004, 읍부,070005, 69세,2016,816,405,411,98.5,808,402,406,99
26004, 읍부,075,70~74세,2016,3089,1369,1720,79.6,3062,1360,1702,79.9
26004, 읍부,075001, 70세,2016,537,252,285,88.4,531,251,280,89.6
26004, 읍부,075002, 71세,2016,541,264,277,95.3,534,261,273,95.6
26004, 읍부,075003, 72세,2016,591,243,348,69.8,588,242,346,69.9
26004, 읍부,075004, 73세,2016,680,299,381,78.5,678,299,379,78.9
26004, 읍부,075005, 74세,2016,740,311,429,72.5,731,307,424,72.4
26004, 읍부,080,75~79세,2016,2525,935,1590,58.8,2503,931,1572,59.2
26004, 읍부,080001, 75세,2016,571,223,348,64.1,567,222,345,64.3
26004, 읍부,080002, 76세,2016,527,200,327,61.2,523,199,324,61.4
26004, 읍부,080003, 77세,2016,522,197,325,60.6,518,195,323,60.4
26004, 읍부,080004, 78세,2016,503,185,318,58.2,498,185,313,59.1
26004, 읍부,080005, 79세,2016,402,130,272,47.8,397,130,267,48.7
26004, 읍부,085,80~84세,2016,1572,483,1089,44.4,1560,481,1079,44.6
26004, 읍부,085001, 80세,2016,377,126,251,50.2,372,125,247,50.6
26004, 읍부,085002, 81세,2016,361,117,244,48,360,117,243,48.1
26004, 읍부,085003, 82세,2016,305,87,218,39.9,304,87,217,40.1
26004, 읍부,085004, 83세,2016,275,92,183,50.3,273,91,182,50
26004, 읍부,085005, 84세,2016,254,61,193,31.6,251,61,190,32.1
26004, 읍부,090,85~89세,2016,740,153,587,26.1,732,151,581,26
26004, 읍부,090001, 85세,2016,204,46,158,29.1,201,45,156,28.8
26004, 읍부,090002, 86세,2016,179,33,146,22.6,177,33,144,22.9
26004, 읍부,090003, 87세,2016,148,38,110,34.5,147,37,110,33.6
26004, 읍부,090004, 88세,2016,123,24,99,24.2,123,24,99,24.2
26004, 읍부,090005, 89세,2016,86,12,74,16.2,84,12,72,16.7
26004, 읍부,095,90~94세,2016,208,32,176,18.2,206,31,175,17.7
26004, 읍부,095001, 90세,2016,70,12,58,20.7,70,12,58,20.7
26004, 읍부,095002, 91세,2016,58,8,50,16,57,7,50,14
26004, 읍부,095003, 92세,2016,27,X,23,17.4,27,X,23,17.4
26004, 읍부,095004, 93세,2016,33,6,27,22.2,33,6,27,22.2
26004, 읍부,095005, 94세,2016,20,X,18,11.1,19,X,17,11.8
26004, 읍부,100,95~99세,2016,41,9,32,28.1,41,9,32,28.1
26004, 읍부,100001, 95세,2016,19,6,13,46.2,19,6,13,46.2
26004, 읍부,100002, 96세,2016,8,X,7,14.3,8,X,7,14.3
26004, 읍부,100003, 97세,2016,5,X,5,0,5,X,5,0
26004, 읍부,100004, 98세,2016,X,X,X,33.3,X,X,X,33.3
26004, 읍부,100005, 99세,2016,5,X,X,25,5,X,X,25
26004, 읍부,101,100세이상,2016,7,X,7,0,7,X,7,0
26004, 읍부,102,15세미만,2016,25657,13193,12464,105.8,25347,13042,12305,106
26004, 읍부,103,15~64세,2016,114899,62111,52788,117.7,108385,57780,50605,114.2
26004, 읍부,104,65세이상,2016,12619,5200,7419,70.1,12450,5131,7319,70.1
26004, 읍부,086,85세이상,2016,996,194,802,24.2,986,191,795,24
26004, 읍부,126,평균연령,2016,37.5,36.6,38.6,,37.5,36.5,38.5,
26004, 읍부,127,중위연령,2016,39.2,38,40.3,,39.2,38.1,40.3,
26005, 면부,000,합계,2016,68931,35921,33010,108.8,65409,33156,32253,102.8
26005, 면부,005,0~4세,2016,2335,1180,1155,102.2,2310,1169,1141,102.5
26005, 면부,005001, 0세,2016,469,253,216,117.1,465,252,213,118.3
26005, 면부,005002, 1세,2016,489,257,232,110.8,486,255,231,110.4
26005, 면부,005003, 2세,2016,469,252,217,116.1,461,247,214,115.4
26005, 면부,005004, 3세,2016,456,206,250,82.4,452,205,247,83
26005, 면부,005005, 4세,2016,452,212,240,88.3,446,210,236,89
26005, 면부,010,5~9세,2016,2187,1132,1055,107.3,2172,1128,1044,108
26005, 면부,010001, 5세,2016,466,239,227,105.3,463,238,225,105.8
26005, 면부,010002, 6세,2016,413,228,185,123.2,410,227,183,124
26005, 면부,010003, 7세,2016,413,210,203,103.4,410,209,201,104
26005, 면부,010004, 8세,2016,435,224,211,106.2,434,224,210,106.7
26005, 면부,010005, 9세,2016,460,231,229,100.9,455,230,225,102.2
26005, 면부,015,10~14세,2016,2239,1156,1083,106.7,2236,1154,1082,106.7
26005, 면부,015001, 10세,2016,411,204,207,98.6,411,204,207,98.6
26005, 면부,015002, 11세,2016,411,221,190,116.3,408,219,189,115.9
26005, 면부,015003, 12세,2016,469,246,223,110.3,469,246,223,110.3
26005, 면부,015004, 13세,2016,435,227,208,109.1,435,227,208,109.1
26005, 면부,015005, 14세,2016,513,258,255,101.2,513,258,255,101.2
26005, 면부,020,15~19세,2016,3290,1758,1532,114.8,3276,1748,1528,114.4
26005, 면부,020001, 15세,2016,578,311,267,116.5,575,309,266,116.2
26005, 면부,020002, 16세,2016,653,354,299,118.4,653,354,299,118.4
26005, 면부,020003, 17세,2016,702,381,321,118.7,699,380,319,119.1
26005, 면부,020004, 18세,2016,686,357,329,108.5,684,355,329,107.9
26005, 면부,020005, 19세,2016,671,355,316,112.3,665,350,315,111.1
26005, 면부,025,20~24세,2016,4120,2449,1671,146.6,3716,2102,1614,130.2
26005, 면부,025001, 20세,2016,765,457,308,148.4,749,445,304,146.4
26005, 면부,025002, 21세,2016,835,467,368,126.9,802,441,361,122.2
26005, 면부,025003, 22세,2016,826,491,335,146.6,744,420,324,129.6
26005, 면부,025004, 23세,2016,819,491,328,149.7,707,393,314,125.2
26005, 면부,025005, 24세,2016,875,543,332,163.6,714,403,311,129.6
26005, 면부,030,25~29세,2016,4242,2667,1575,169.3,3329,1892,1437,131.7
26005, 면부,030001, 25세,2016,861,516,345,149.6,700,378,322,117.4
26005, 면부,030002, 26세,2016,841,522,319,163.6,647,359,288,124.7
26005, 면부,030003, 27세,2016,857,561,296,189.5,678,411,267,153.9
26005, 면부,030004, 28세,2016,838,547,291,188,652,387,265,146
26005, 면부,030005, 29세,2016,845,521,324,160.8,652,357,295,121
26005, 면부,035,30~34세,2016,4482,2692,1790,150.4,3727,2050,1677,122.2
26005, 면부,035001, 30세,2016,831,505,326,154.9,678,381,297,128.3
26005, 면부,035002, 31세,2016,859,523,336,155.7,697,389,308,126.3
26005, 면부,035003, 32세,2016,900,553,347,159.4,724,394,330,119.4
26005, 면부,035004, 33세,2016,872,540,332,162.7,734,417,317,131.5
26005, 면부,035005, 34세,2016,1020,571,449,127.2,894,469,425,110.4
26005, 면부,040,35~39세,2016,4428,2601,1827,142.4,3986,2232,1754,127.3
26005, 면부,040001, 35세,2016,963,561,402,139.6,846,460,386,119.2
26005, 면부,040002, 36세,2016,957,581,376,154.5,858,498,360,138.3
26005, 면부,040003, 37세,2016,852,495,357,138.7,760,419,341,122.9
26005, 면부,040004, 38세,2016,830,479,351,136.5,753,417,336,124.1
26005, 면부,040005, 39세,2016,826,485,341,142.2,769,438,331,132.3
26005, 면부,045,40~44세,2016,4745,2561,2184,117.3,4468,2357,2111,111.7
26005, 면부,045001, 40세,2016,835,462,373,123.9,767,409,358,114.2
26005, 면부,045002, 41세,2016,923,502,421,119.2,864,455,409,111.2
26005, 면부,045003, 42세,2016,971,539,432,124.8,920,504,416,121.2
26005, 면부,045004, 43세,2016,1040,545,495,110.1,989,509,480,106
26005, 면부,045005, 44세,2016,976,513,463,110.8,928,480,448,107.1
26005, 면부,050,45~49세,2016,5669,2947,2722,108.3,5436,2807,2629,106.8
26005, 면부,050001, 45세,2016,1106,587,519,113.1,1051,551,500,110.2
26005, 면부,050002, 46세,2016,1101,592,509,116.3,1049,561,488,115
26005, 면부,050003, 47세,2016,1133,591,542,109,1097,572,525,109
26005, 면부,050004, 48세,2016,1189,595,594,100.2,1138,561,577,97.2
26005, 면부,050005, 49세,2016,1140,582,558,104.3,1101,562,539,104.3
26005, 면부,055,50~54세,2016,6132,3249,2883,112.7,5925,3126,2799,111.7
26005, 면부,055001, 50세,2016,1206,668,538,124.2,1155,634,521,121.7
26005, 면부,055002, 51세,2016,1191,640,551,116.2,1150,615,535,115
26005, 면부,055003, 52세,2016,1203,601,602,99.8,1165,581,584,99.5
26005, 면부,055004, 53세,2016,1250,653,597,109.4,1203,630,573,109.9
26005, 면부,055005, 54세,2016,1282,687,595,115.5,1252,666,586,113.7
26005, 면부,060,55~59세,2016,6721,3390,3331,101.8,6611,3323,3288,101.1
26005, 면부,060001, 55세,2016,1411,712,699,101.9,1395,702,693,101.3
26005, 면부,060002, 56세,2016,1386,674,712,94.7,1362,660,702,94
26005, 면부,060003, 57세,2016,1322,691,631,109.5,1292,675,617,109.4
26005, 면부,060004, 58세,2016,1322,674,648,104,1300,657,643,102.2
26005, 면부,060005, 59세,2016,1280,639,641,99.7,1262,629,633,99.4
26005, 면부,065,60~64세,2016,5511,2748,2763,99.5,5441,2701,2740,98.6
26005, 면부,065001, 60세,2016,1222,646,576,112.2,1205,638,567,112.5
26005, 면부,065002, 61세,2016,1223,603,620,97.3,1206,591,615,96.1
26005, 면부,065003, 62세,2016,1076,566,510,111,1059,552,507,108.9
26005, 면부,065004, 63세,2016,982,460,522,88.1,973,455,518,87.8
26005, 면부,065005, 64세,2016,1008,473,535,88.4,998,465,533,87.2
26005, 면부,070,65~69세,2016,3986,2045,1941,105.4,3958,2032,1926,105.5
26005, 면부,070001, 65세,2016,808,398,410,97.1,797,392,405,96.8
26005, 면부,070002, 66세,2016,841,431,410,105.1,834,428,406,105.4
26005, 면부,070003, 67세,2016,797,393,404,97.3,794,392,402,97.5
26005, 면부,070004, 68세,2016,804,432,372,116.1,800,430,370,116.2
26005, 면부,070005, 69세,2016,736,391,345,113.3,733,390,343,113.7
26005, 면부,075,70~74세,2016,3084,1380,1704,81,3072,1375,1697,81
26005, 면부,075001, 70세,2016,527,259,268,96.6,526,259,267,97
26005, 면부,075002, 71세,2016,605,285,320,89.1,602,282,320,88.1
26005, 면부,075003, 72세,2016,569,248,321,77.3,567,247,320,77.2
26005, 면부,075004, 73세,2016,657,289,368,78.5,655,289,366,79
26005, 면부,075005, 74세,2016,726,299,427,70,722,298,424,70.3
26005, 면부,080,75~79세,2016,2669,1080,1589,68,2663,1077,1586,67.9
26005, 면부,080001, 75세,2016,575,243,332,73.2,574,243,331,73.4
26005, 면부,080002, 76세,2016,583,241,342,70.5,582,240,342,70.2
26005, 면부,080003, 77세,2016,550,226,324,69.8,549,225,324,69.4
26005, 면부,080004, 78세,2016,501,195,306,63.7,499,194,305,63.6
26005, 면부,080005, 79세,2016,460,175,285,61.4,459,175,284,61.6
26005, 면부,085,80~84세,2016,1812,580,1232,47.1,1809,580,1229,47.2
26005, 면부,085001, 80세,2016,408,146,262,55.7,406,146,260,56.2
26005, 면부,085002, 81세,2016,401,135,266,50.8,401,135,266,50.8
26005, 면부,085003, 82세,2016,381,127,254,50,381,127,254,50
26005, 면부,085004, 83세,2016,319,84,235,35.7,318,84,234,35.9
26005, 면부,085005, 84세,2016,303,88,215,40.9,303,88,215,40.9
26005, 면부,090,85~89세,2016,911,244,667,36.6,909,243,666,36.5
26005, 면부,090001, 85세,2016,241,74,167,44.3,241,74,167,44.3
26005, 면부,090002, 86세,2016,194,48,146,32.9,193,48,145,33.1
26005, 면부,090003, 87세,2016,184,51,133,38.3,184,51,133,38.3
26005, 면부,090004, 88세,2016,166,41,125,32.8,165,40,125,32
26005, 면부,090005, 89세,2016,126,30,96,31.3,126,30,96,31.3
26005, 면부,095,90~94세,2016,309,55,254,21.7,307,54,253,21.3
26005, 면부,095001, 90세,2016,96,15,81,18.5,95,14,81,17.3
26005, 면부,095002, 91세,2016,76,12,64,18.8,75,12,63,19
26005, 면부,095003, 92세,2016,62,8,54,14.8,62,8,54,14.8
26005, 면부,095004, 93세,2016,43,11,32,34.4,43,11,32,34.4
26005, 면부,095005, 94세,2016,32,9,23,39.1,32,9,23,39.1
26005, 면부,100,95~99세,2016,53,7,46,15.2,52,6,46,13
26005, 면부,100001, 95세,2016,23,X,21,9.5,23,X,21,9.5
26005, 면부,100002, 96세,2016,13,X,11,18.2,13,X,11,18.2
26005, 면부,100003, 97세,2016,6,X,6,0,6,X,6,0
26005, 면부,100004, 98세,2016,8,X,6,33.3,7,X,6,16.7
26005, 면부,100005, 99세,2016,X,X,X,50,X,X,X,50
26005, 면부,101,100세이상,2016,6,X,6,0,6,X,6,0
26005, 면부,102,15세미만,2016,6761,3468,3293,105.3,6718,3451,3267,105.6
26005, 면부,103,15~64세,2016,49340,27062,22278,121.5,45915,24338,21577,112.8
26005, 면부,104,65세이상,2016,12830,5391,7439,72.5,12776,5367,7409,72.4
26005, 면부,086,85세이상,2016,1279,306,973,31.4,1274,303,971,31.2
26005, 면부,126,평균연령,2016,45.2,43.2,47.3,,45.7,44,47.5,
26005, 면부,127,중위연령,2016,47.2,44.5,49.8,,48.3,46.3,50.2,
26003, 동부,000,합계,2016,943927,489193,454734,107.6,925650,478349,447301,106.9
26003, 동부,005,0~4세,2016,47954,24651,23303,105.8,47563,24453,23110,105.8
26003, 동부,005001, 0세,2016,9264,4757,4507,105.5,9182,4720,4462,105.8
26003, 동부,005002, 1세,2016,9640,4992,4648,107.4,9568,4957,4611,107.5
26003, 동부,005003, 2세,2016,9544,4844,4700,103.1,9465,4799,4666,102.9
26003, 동부,005004, 3세,2016,9484,4852,4632,104.7,9401,4814,4587,104.9
26003, 동부,005005, 4세,2016,10022,5206,4816,108.1,9947,5163,4784,107.9
26003, 동부,010,5~9세,2016,46707,24364,22343,109,46445,24222,22223,109
26003, 동부,010001, 5세,2016,9758,5074,4684,108.3,9684,5027,4657,107.9
26003, 동부,010002, 6세,2016,9295,4885,4410,110.8,9237,4858,4379,110.9
26003, 동부,010003, 7세,2016,8994,4711,4283,110,8948,4684,4264,109.8
26003, 동부,010004, 8세,2016,9292,4785,4507,106.2,9253,4766,4487,106.2
26003, 동부,010005, 9세,2016,9368,4909,4459,110.1,9323,4887,4436,110.2
26003, 동부,015,10~14세,2016,44057,23264,20793,111.9,43954,23217,20737,112
26003, 동부,015001, 10세,2016,8383,4343,4040,107.5,8360,4331,4029,107.5
26003, 동부,015002, 11세,2016,8159,4314,3845,112.2,8137,4304,3833,112.3
26003, 동부,015003, 12세,2016,8892,4717,4175,113,8873,4710,4163,113.1
26003, 동부,015004, 13세,2016,9126,4883,4243,115.1,9113,4879,4234,115.2
26003, 동부,015005, 14세,2016,9497,5007,4490,111.5,9471,4993,4478,111.5
26003, 동부,020,15~19세,2016,59380,32313,27067,119.4,59123,32188,26935,119.5
26003, 동부,020001, 15세,2016,11086,5923,5163,114.7,11067,5915,5152,114.8
26003, 동부,020002, 16세,2016,12946,6811,6135,111,12919,6799,6120,111.1
26003, 동부,020003, 17세,2016,12413,6588,5825,113.1,12377,6573,5804,113.2
26003, 동부,020004, 18세,2016,12357,6731,5626,119.6,12306,6702,5604,119.6
26003, 동부,020005, 19세,2016,10578,6260,4318,145,10454,6199,4255,145.7
26003, 동부,025,20~24세,2016,62887,36721,26166,140.3,61429,35962,25467,141.2
26003, 동부,025001, 20세,2016,11916,7359,4557,161.5,11745,7292,4453,163.8
26003, 동부,025002, 21세,2016,12448,7526,4922,152.9,12244,7438,4806,154.8
26003, 동부,025003, 22세,2016,12441,7234,5207,138.9,12185,7101,5084,139.7
26003, 동부,025004, 23세,2016,12872,7164,5708,125.5,12476,6957,5519,126.1
26003, 동부,025005, 24세,2016,13210,7438,5772,128.9,12779,7174,5605,128
26003, 동부,030,25~29세,2016,63439,35647,27792,128.3,60318,33759,26559,127.1
26003, 동부,030001, 25세,2016,12984,7138,5846,122.1,12406,6790,5616,120.9
26003, 동부,030002, 26세,2016,12873,7330,5543,132.2,12237,6959,5278,131.8
26003, 동부,030003, 27세,2016,12726,7267,5459,133.1,12102,6870,5232,131.3
26003, 동부,030004, 28세,2016,12363,7006,5357,130.8,11731,6639,5092,130.4
26003, 동부,030005, 29세,2016,12493,6906,5587,123.6,11842,6501,5341,121.7
26003, 동부,035,30~34세,2016,71637,38343,33294,115.2,68694,36432,32262,112.9
26003, 동부,035001, 30세,2016,12787,7058,5729,123.2,12150,6662,5488,121.4
26003, 동부,035002, 31세,2016,12971,7058,5913,119.4,12354,6657,5697,116.9
26003, 동부,035003, 32세,2016,13857,7453,6404,116.4,13223,7035,6188,113.7
26003, 동부,035004, 33세,2016,15449,8095,7354,110.1,14894,7726,7168,107.8
26003, 동부,035005, 34세,2016,16573,8679,7894,109.9,16073,8352,7721,108.2
26003, 동부,040,35~39세,2016,79013,41827,37186,112.5,76978,40460,36518,110.8
26003, 동부,040001, 35세,2016,16792,8972,7820,114.7,16322,8632,7690,112.2
26003, 동부,040002, 36세,2016,17307,9146,8161,112.1,16876,8861,8015,110.6
26003, 동부,040003, 37세,2016,15758,8332,7426,112.2,15369,8072,7297,110.6
26003, 동부,040004, 38세,2016,14494,7705,6789,113.5,14102,7458,6644,112.3
26003, 동부,040005, 39세,2016,14662,7672,6990,109.8,14309,7437,6872,108.2
26003, 동부,045,40~44세,2016,76429,38591,37838,102,74787,37515,37272,100.7
26003, 동부,045001, 40세,2016,13639,7170,6469,110.8,13320,6952,6368,109.2
26003, 동부,045002, 41세,2016,14579,7452,7127,104.6,14265,7237,7028,103
26003, 동부,045003, 42세,2016,15696,7847,7849,100,15378,7642,7736,98.8
26003, 동부,045004, 43세,2016,16148,8031,8117,98.9,15835,7835,8000,97.9
26003, 동부,045005, 44세,2016,16367,8091,8276,97.8,15989,7849,8140,96.4
26003, 동부,050,45~49세,2016,89638,43888,45750,95.9,87766,42795,44971,95.2
26003, 동부,050001, 45세,2016,17683,8742,8941,97.8,17264,8488,8776,96.7
26003, 동부,050002, 46세,2016,17594,8616,8978,96,17228,8390,8838,94.9
26003, 동부,050003, 47세,2016,18148,8893,9255,96.1,17762,8661,9101,95.2
26003, 동부,050004, 48세,2016,18615,9066,9549,94.9,18220,8848,9372,94.4
26003, 동부,050005, 49세,2016,17598,8571,9027,94.9,17292,8408,8884,94.6
26003, 동부,055,50~54세,2016,86688,44836,41852,107.1,84954,43874,41080,106.8
26003, 동부,055001, 50세,2016,17762,9232,8530,108.2,17415,9026,8389,107.6
26003, 동부,055002, 51세,2016,17948,9193,8755,105,17589,8993,8596,104.6
26003, 동부,055003, 52세,2016,16265,8414,7851,107.2,15935,8223,7712,106.6
26003, 동부,055004, 53세,2016,17103,8843,8260,107.1,16688,8614,8074,106.7
26003, 동부,055005, 54세,2016,17610,9154,8456,108.3,17327,9018,8309,108.5
26003, 동부,060,55~59세,2016,81065,41375,39690,104.2,79925,40738,39187,104
26003, 동부,060001, 55세,2016,18840,9664,9176,105.3,18622,9541,9081,105.1
26003, 동부,060002, 56세,2016,17691,8883,8808,100.9,17419,8729,8690,100.4
26003, 동부,060003, 57세,2016,15873,8119,7754,104.7,15654,7989,7665,104.2
26003, 동부,060004, 58세,2016,14720,7605,7115,106.9,14492,7489,7003,106.9
26003, 동부,060005, 59세,2016,13941,7104,6837,103.9,13738,6990,6748,103.6
26003, 동부,065,60~64세,2016,53407,27109,26298,103.1,52663,26716,25947,103
26003, 동부,065001, 60세,2016,12644,6405,6239,102.7,12488,6324,6164,102.6
26003, 동부,065002, 61세,2016,12356,6183,6173,100.2,12175,6082,6093,99.8
26003, 동부,065003, 62세,2016,10180,5191,4989,104,10007,5099,4908,103.9
26003, 동부,065004, 63세,2016,9080,4613,4467,103.3,8950,4548,4402,103.3
26003, 동부,065005, 64세,2016,9147,4717,4430,106.5,9043,4663,4380,106.5
26003, 동부,070,65~69세,2016,32906,16820,16086,104.6,32588,16661,15927,104.6
26003, 동부,070001, 65세,2016,7074,3656,3418,107,6976,3604,3372,106.9
26003, 동부,070002, 66세,2016,6914,3524,3390,104,6844,3490,3354,104.1
26003, 동부,070003, 67세,2016,6705,3489,3216,108.5,6634,3458,3176,108.9
26003, 동부,070004, 68세,2016,6470,3279,3191,102.8,6437,3258,3179,102.5
26003, 동부,070005, 69세,2016,5743,2872,2871,100,5697,2851,2846,100.2
26003, 동부,075,70~74세,2016,20829,9961,10868,91.7,20708,9909,10799,91.8
26003, 동부,075001, 70세,2016,4065,2061,2004,102.8,4036,2047,1989,102.9
26003, 동부,075002, 71세,2016,3985,1942,2043,95.1,3956,1929,2027,95.2
26003, 동부,075003, 72세,2016,4055,1898,2157,88,4034,1891,2143,88.2
26003, 동부,075004, 73세,2016,4225,1967,2258,87.1,4206,1955,2251,86.9
26003, 동부,075005, 74세,2016,4499,2093,2406,87,4476,2087,2389,87.4
26003, 동부,080,75~79세,2016,14501,5921,8580,69,14430,5897,8533,69.1
26003, 동부,080001, 75세,2016,3380,1515,1865,81.2,3357,1502,1855,81
26003, 동부,080002, 76세,2016,3209,1339,1870,71.6,3195,1335,1860,71.8
26003, 동부,080003, 77세,2016,3010,1298,1712,75.8,2993,1294,1699,76.2
26003, 동부,080004, 78세,2016,2580,960,1620,59.3,2574,957,1617,59.2
26003, 동부,080005, 79세,2016,2322,809,1513,53.5,2311,809,1502,53.9
26003, 동부,085,80~84세,2016,8355,2597,5758,45.1,8316,2592,5724,45.3
26003, 동부,085001, 80세,2016,2088,666,1422,46.8,2074,663,1411,47
26003, 동부,085002, 81세,2016,1880,600,1280,46.9,1870,599,1271,47.1
26003, 동부,085003, 82세,2016,1690,552,1138,48.5,1685,552,1133,48.7
26003, 동부,085004, 83세,2016,1483,459,1024,44.8,1475,459,1016,45.2
26003, 동부,085005, 84세,2016,1214,320,894,35.8,1212,319,893,35.7
26003, 동부,090,85~89세,2016,3582,750,2832,26.5,3561,746,2815,26.5
26003, 동부,090001, 85세,2016,924,207,717,28.9,919,206,713,28.9
26003, 동부,090002, 86세,2016,830,204,626,32.6,824,204,620,32.9
26003, 동부,090003, 87세,2016,728,172,556,30.9,724,171,553,30.9
26003, 동부,090004, 88세,2016,596,92,504,18.3,592,91,501,18.2
26003, 동부,090005, 89세,2016,504,75,429,17.5,502,74,428,17.3
26003, 동부,095,90~94세,2016,1190,170,1020,16.7,1185,168,1017,16.5
26003, 동부,095001, 90세,2016,337,52,285,18.2,337,52,285,18.2
26003, 동부,095002, 91세,2016,313,47,266,17.7,311,47,264,17.8
26003, 동부,095003, 92세,2016,196,24,172,14,194,22,172,12.8
26003, 동부,095004, 93세,2016,199,26,173,15,198,26,172,15.1
26003, 동부,095005, 94세,2016,145,21,124,16.9,145,21,124,16.9
26003, 동부,100,95~99세,2016,242,43,199,21.6,242,43,199,21.6
26003, 동부,100001, 95세,2016,90,17,73,23.3,90,17,73,23.3
26003, 동부,100002, 96세,2016,74,12,62,19.4,74,12,62,19.4
26003, 동부,100003, 97세,2016,43,10,33,30.3,43,10,33,30.3
26003, 동부,100004, 98세,2016,21,X,19,10.5,21,X,19,10.5
26003, 동부,100005, 99세,2016,14,X,12,16.7,14,X,12,16.7
26003, 동부,101,100세이상,2016,21,X,19,10.5,21,X,19,10.5
26003, 동부,102,15세미만,2016,138718,72279,66439,108.8,137962,71892,66070,108.8
26003, 동부,103,15~64세,2016,723583,380650,342933,111,706637,370439,336198,110.2
26003, 동부,104,65세이상,2016,81626,36264,45362,79.9,81051,36018,45033,80
26003, 동부,086,85세이상,2016,5035,965,4070,23.7,5009,959,4050,23.7
26003, 동부,126,평균연령,2016,38.7,37.8,39.7,,38.7,37.8,39.7,
26003, 동부,127,중위연령,2016,39.8,38.4,41.4,,39.9,38.5,41.5,
26010, 중구,000,합계,2016,236954,120843,116111,104.1,233995,119459,114536,104.3
26010, 중구,005,0~4세,2016,10986,5711,5275,108.3,10925,5672,5253,108
26010, 중구,005001, 0세,2016,2113,1082,1031,104.9,2101,1078,1023,105.4
26010, 중구,005002, 1세,2016,2121,1110,1011,109.8,2110,1100,1010,108.9
26010, 중구,005003, 2세,2016,2198,1121,1077,104.1,2182,1111,1071,103.7
26010, 중구,005004, 3세,2016,2263,1165,1098,106.1,2250,1158,1092,106
26010, 중구,005005, 4세,2016,2291,1233,1058,116.5,2282,1225,1057,115.9
26010, 중구,010,5~9세,2016,10807,5663,5144,110.1,10775,5641,5134,109.9
26010, 중구,010001, 5세,2016,2327,1208,1119,108,2321,1204,1117,107.8
26010, 중구,010002, 6세,2016,2185,1165,1020,114.2,2182,1163,1019,114.1
26010, 중구,010003, 7세,2016,2055,1100,955,115.2,2045,1094,951,115
26010, 중구,010004, 8세,2016,2072,1063,1009,105.4,2069,1060,1009,105.1
26010, 중구,010005, 9세,2016,2168,1127,1041,108.3,2158,1120,1038,107.9
26010, 중구,015,10~14세,2016,10177,5408,4769,113.4,10161,5401,4760,113.5
26010, 중구,015001, 10세,2016,1887,998,889,112.3,1883,995,888,112
26010, 중구,015002, 11세,2016,1835,970,865,112.1,1833,970,863,112.4
26010, 중구,015003, 12세,2016,2038,1090,948,115,2035,1090,945,115.3
26010, 중구,015004, 13세,2016,2179,1176,1003,117.2,2178,1176,1002,117.4
26010, 중구,015005, 14세,2016,2238,1174,1064,110.3,2232,1170,1062,110.2
26010, 중구,020,15~19세,2016,14175,7741,6434,120.3,14138,7728,6410,120.6
26010, 중구,020001, 15세,2016,2660,1424,1236,115.2,2656,1424,1232,115.6
26010, 중구,020002, 16세,2016,3130,1624,1506,107.8,3125,1621,1504,107.8
26010, 중구,020003, 17세,2016,2937,1593,1344,118.5,2930,1590,1340,118.7
26010, 중구,020004, 18세,2016,3012,1625,1387,117.2,3006,1623,1383,117.4
26010, 중구,020005, 19세,2016,2436,1475,961,153.5,2421,1470,951,154.6
26010, 중구,025,20~24세,2016,15429,8981,6448,139.3,15264,8940,6324,141.4
26010, 중구,025001, 20세,2016,2912,1864,1048,177.9,2895,1860,1035,179.7
26010, 중구,025002, 21세,2016,3132,1899,1233,154,3104,1894,1210,156.5
26010, 중구,025003, 22세,2016,3119,1808,1311,137.9,3087,1802,1285,140.2
26010, 중구,025004, 23세,2016,3168,1730,1438,120.3,3126,1720,1406,122.3
26010, 중구,025005, 24세,2016,3098,1680,1418,118.5,3052,1664,1388,119.9
26010, 중구,030,25~29세,2016,14920,8033,6887,116.6,14561,7906,6655,118.8
26010, 중구,030001, 25세,2016,3122,1644,1478,111.2,3056,1620,1436,112.8
26010, 중구,030002, 26세,2016,3089,1684,1405,119.9,3009,1656,1353,122.4
26010, 중구,030003, 27세,2016,2991,1628,1363,119.4,2932,1612,1320,122.1
26010, 중구,030004, 28세,2016,2915,1576,1339,117.7,2842,1551,1291,120.1
26010, 중구,030005, 29세,2016,2803,1501,1302,115.3,2722,1467,1255,116.9
26010, 중구,035,30~34세,2016,16228,8411,7817,107.6,15864,8264,7600,108.7
26010, 중구,035001, 30세,2016,2901,1563,1338,116.8,2813,1527,1286,118.7
26010, 중구,035002, 31세,2016,2863,1459,1404,103.9,2794,1433,1361,105.3
26010, 중구,035003, 32세,2016,3155,1642,1513,108.5,3068,1609,1459,110.3
26010, 중구,035004, 33세,2016,3515,1823,1692,107.7,3454,1795,1659,108.2
26010, 중구,035005, 34세,2016,3794,1924,1870,102.9,3735,1900,1835,103.5
26010, 중구,040,35~39세,2016,18414,9698,8716,111.3,18128,9558,8570,111.5
26010, 중구,040001, 35세,2016,3798,2005,1793,111.8,3749,1979,1770,111.8
26010, 중구,040002, 36세,2016,4026,2085,1941,107.4,3970,2063,1907,108.2
26010, 중구,040003, 37세,2016,3724,1963,1761,111.5,3660,1925,1735,111
26010, 중구,040004, 38세,2016,3405,1799,1606,112,3342,1775,1567,113.3
26010, 중구,040005, 39세,2016,3461,1846,1615,114.3,3407,1816,1591,114.1
26010, 중구,045,40~44세,2016,18498,9314,9184,101.4,18230,9175,9055,101.3
26010, 중구,045001, 40세,2016,3171,1641,1530,107.3,3133,1624,1509,107.6
26010, 중구,045002, 41세,2016,3480,1772,1708,103.7,3438,1753,1685,104
26010, 중구,045003, 42세,2016,3770,1903,1867,101.9,3711,1868,1843,101.4
26010, 중구,045004, 43세,2016,3986,1998,1988,100.5,3933,1972,1961,100.6
26010, 중구,045005, 44세,2016,4091,2000,2091,95.6,4015,1958,2057,95.2
26010, 중구,050,45~49세,2016,22156,10700,11456,93.4,21791,10512,11279,93.2
26010, 중구,050001, 45세,2016,4334,2113,2221,95.1,4248,2070,2178,95
26010, 중구,050002, 46세,2016,4256,2026,2230,90.9,4189,1986,2203,90.1
26010, 중구,050003, 47세,2016,4452,2126,2326,91.4,4391,2098,2293,91.5
26010, 중구,050004, 48세,2016,4689,2265,2424,93.4,4599,2220,2379,93.3
26010, 중구,050005, 49세,2016,4425,2170,2255,96.2,4364,2138,2226,96
26010, 중구,055,50~54세,2016,22324,11375,10949,103.9,21945,11176,10769,103.8
26010, 중구,055001, 50세,2016,4440,2262,2178,103.9,4366,2226,2140,104
26010, 중구,055002, 51세,2016,4664,2338,2326,100.5,4582,2290,2292,99.9
26010, 중구,055003, 52세,2016,4273,2191,2082,105.2,4199,2152,2047,105.1
26010, 중구,055004, 53세,2016,4332,2178,2154,101.1,4248,2137,2111,101.2
26010, 중구,055005, 54세,2016,4615,2406,2209,108.9,4550,2371,2179,108.8
26010, 중구,060,55~59세,2016,21716,10904,10812,100.9,21437,10755,10682,100.7
26010, 중구,060001, 55세,2016,5032,2567,2465,104.1,4985,2542,2443,104.1
26010, 중구,060002, 56세,2016,4576,2243,2333,96.1,4518,2212,2306,95.9
26010, 중구,060003, 57세,2016,4285,2166,2119,102.2,4227,2127,2100,101.3
26010, 중구,060004, 58세,2016,3994,2001,1993,100.4,3929,1973,1956,100.9
26010, 중구,060005, 59세,2016,3829,1927,1902,101.3,3778,1901,1877,101.3
26010, 중구,065,60~64세,2016,15486,7566,7920,95.5,15284,7463,7821,95.4
26010, 중구,065001, 60세,2016,3606,1768,1838,96.2,3557,1742,1815,96
26010, 중구,065002, 61세,2016,3508,1646,1862,88.4,3462,1618,1844,87.7
26010, 중구,065003, 62세,2016,2924,1459,1465,99.6,2880,1438,1442,99.7
26010, 중구,065004, 63세,2016,2696,1310,1386,94.5,2666,1300,1366,95.2
26010, 중구,065005, 64세,2016,2752,1383,1369,101,2719,1365,1354,100.8
26010, 중구,070,65~69세,2016,10074,5034,5040,99.9,9979,4985,4994,99.8
26010, 중구,070001, 65세,2016,2157,1107,1050,105.4,2132,1095,1037,105.6
26010, 중구,070002, 66세,2016,2053,1026,1027,99.9,2035,1016,1019,99.7
26010, 중구,070003, 67세,2016,2121,1093,1028,106.3,2094,1083,1011,107.1
26010, 중구,070004, 68세,2016,1951,947,1004,94.3,1940,939,1001,93.8
26010, 중구,070005, 69세,2016,1792,861,931,92.5,1778,852,926,92
26010, 중구,075,70~74세,2016,6674,3147,3527,89.2,6652,3136,3516,89.2
26010, 중구,075001, 70세,2016,1207,625,582,107.4,1204,623,581,107.2
26010, 중구,075002, 71세,2016,1298,628,670,93.7,1291,623,668,93.3
26010, 중구,075003, 72세,2016,1349,566,783,72.3,1343,563,780,72.2
26010, 중구,075004, 73세,2016,1384,669,715,93.6,1381,668,713,93.7
26010, 중구,075005, 74세,2016,1436,659,777,84.8,1433,659,774,85.1
26010, 중구,080,75~79세,2016,4753,1969,2784,70.7,4743,1963,2780,70.6
26010, 중구,080001, 75세,2016,1101,488,613,79.6,1094,482,612,78.8
26010, 중구,080002, 76세,2016,1064,451,613,73.6,1063,451,612,73.7
26010, 중구,080003, 77세,2016,1004,425,579,73.4,1002,425,577,73.7
26010, 중구,080004, 78세,2016,836,335,501,66.9,836,335,501,66.9
26010, 중구,080005, 79세,2016,748,270,478,56.5,748,270,478,56.5
26010, 중구,085,80~84세,2016,2647,894,1753,51,2635,891,1744,51.1
26010, 중구,085001, 80세,2016,701,248,453,54.7,697,246,451,54.5
26010, 중구,085002, 81세,2016,576,201,375,53.6,573,201,372,54
26010, 중구,085003, 82세,2016,502,175,327,53.5,501,175,326,53.7
26010, 중구,085004, 83세,2016,483,161,322,50,481,161,320,50.3
26010, 중구,085005, 84세,2016,385,109,276,39.5,383,108,275,39.3
26010, 중구,090,85~89세,2016,1098,242,856,28.3,1094,241,853,28.3
26010, 중구,090001, 85세,2016,299,76,223,34.1,298,76,222,34.2
26010, 중구,090002, 86세,2016,229,66,163,40.5,228,66,162,40.7
26010, 중구,090003, 87세,2016,221,52,169,30.8,220,51,169,30.2
26010, 중구,090004, 88세,2016,194,26,168,15.5,193,26,167,15.6
26010, 중구,090005, 89세,2016,155,22,133,16.5,155,22,133,16.5
26010, 중구,095,90~94세,2016,315,39,276,14.1,312,39,273,14.3
26010, 중구,095001, 90세,2016,99,15,84,17.9,99,15,84,17.9
26010, 중구,095002, 91세,2016,85,16,69,23.2,83,16,67,23.9
26010, 중구,095003, 92세,2016,47,X,44,6.8,47,X,44,6.8
26010, 중구,095004, 93세,2016,49,X,46,6.5,48,X,45,6.7
26010, 중구,095005, 94세,2016,35,X,33,6.1,35,X,33,6.1
26010, 중구,100,95~99세,2016,72,12,60,20,72,12,60,20
26010, 중구,100001, 95세,2016,22,5,17,29.4,22,5,17,29.4
26010, 중구,100002, 96세,2016,26,X,22,18.2,26,X,22,18.2
26010, 중구,100003, 97세,2016,16,X,14,14.3,16,X,14,14.3
26010, 중구,100004, 98세,2016,5,X,5,0,5,X,5,0
26010, 중구,100005, 99세,2016,X,X,X,50,X,X,X,50
26010, 중구,101,100세이상,2016,5,X,X,25,5,X,X,25
26010, 중구,102,15세미만,2016,31970,16782,15188,110.5,31861,16714,15147,110.3
26010, 중구,103,15~64세,2016,179346,92723,86623,107,176642,91477,85165,107.4
26010, 중구,104,65세이상,2016,25638,11338,14300,79.3,25492,11268,14224,79.2
26010, 중구,086,85세이상,2016,1490,294,1196,24.6,1483,293,1190,24.6
26010, 중구,126,평균연령,2016,40.4,39.2,41.6,,40.3,39.2,41.6,
26010, 중구,127,중위연령,2016,42.2,40.5,43.7,,42.2,40.4,43.8,
26020, 남구,000,합계,2016,338196,173201,164995,105,331388,169491,161897,104.7
26020, 남구,005,0~4세,2016,14453,7470,6983,107,14320,7410,6910,107.2
26020, 남구,005001, 0세,2016,2829,1466,1363,107.6,2799,1453,1346,107.9
26020, 남구,005002, 1세,2016,3017,1583,1434,110.4,2997,1577,1420,111.1
26020, 남구,005003, 2세,2016,2815,1465,1350,108.5,2787,1447,1340,108
26020, 남구,005004, 3세,2016,2786,1419,1367,103.8,2756,1406,1350,104.1
26020, 남구,005005, 4세,2016,3006,1537,1469,104.6,2981,1527,1454,105
26020, 남구,010,5~9세,2016,14453,7590,6863,110.6,14350,7535,6815,110.6
26020, 남구,010001, 5세,2016,2905,1520,1385,109.7,2877,1502,1375,109.2
26020, 남구,010002, 6세,2016,2772,1467,1305,112.4,2743,1454,1289,112.8
26020, 남구,010003, 7세,2016,2807,1439,1368,105.2,2788,1426,1362,104.7
26020, 남구,010004, 8세,2016,2990,1546,1444,107.1,2976,1540,1436,107.2
26020, 남구,010005, 9세,2016,2979,1618,1361,118.9,2966,1613,1353,119.2
26020, 남구,015,10~14세,2016,15743,8322,7421,112.1,15700,8303,7397,112.2
26020, 남구,015001, 10세,2016,2786,1429,1357,105.3,2775,1424,1351,105.4
26020, 남구,015002, 11세,2016,2825,1513,1312,115.3,2815,1508,1307,115.4
26020, 남구,015003, 12세,2016,3280,1748,1532,114.1,3276,1747,1529,114.3
26020, 남구,015004, 13세,2016,3321,1766,1555,113.6,3312,1763,1549,113.8
26020, 남구,015005, 14세,2016,3531,1866,1665,112.1,3522,1861,1661,112
26020, 남구,020,15~19세,2016,22817,12384,10433,118.7,22669,12307,10362,118.8
26020, 남구,020001, 15세,2016,4212,2260,1952,115.8,4206,2256,1950,115.7
26020, 남구,020002, 16세,2016,4703,2492,2211,112.7,4692,2490,2202,113.1
26020, 남구,020003, 17세,2016,4605,2396,2209,108.5,4584,2389,2195,108.8
26020, 남구,020004, 18세,2016,4759,2599,2160,120.3,4723,2575,2148,119.9
26020, 남구,020005, 19세,2016,4538,2637,1901,138.7,4464,2597,1867,139.1
26020, 남구,025,20~24세,2016,25193,14509,10684,135.8,24534,14198,10336,137.4
26020, 남구,025001, 20세,2016,4822,2803,2019,138.8,4725,2760,1965,140.5
26020, 남구,025002, 21세,2016,4989,2944,2045,144,4877,2891,1986,145.6
26020, 남구,025003, 22세,2016,4976,2861,2115,135.3,4866,2817,2049,137.5
26020, 남구,025004, 23세,2016,5150,2865,2285,125.4,4988,2792,2196,127.1
26020, 남구,025005, 24세,2016,5256,3036,2220,136.8,5078,2938,2140,137.3
26020, 남구,030,25~29세,2016,22800,12538,10262,122.2,21711,11965,9746,122.8
26020, 남구,030001, 25세,2016,4845,2701,2144,126,4646,2602,2044,127.3
26020, 남구,030002, 26세,2016,4719,2625,2094,125.4,4489,2507,1982,126.5
26020, 남구,030003, 27세,2016,4549,2501,2048,122.1,4315,2364,1951,121.2
26020, 남구,030004, 28세,2016,4290,2360,1930,122.3,4081,2261,1820,124.2
26020, 남구,030005, 29세,2016,4397,2351,2046,114.9,4180,2231,1949,114.5
26020, 남구,035,30~34세,2016,23822,12520,11302,110.8,22998,12071,10927,110.5
26020, 남구,035001, 30세,2016,4397,2345,2052,114.3,4209,2249,1960,114.7
26020, 남구,035002, 31세,2016,4514,2401,2113,113.6,4333,2306,2027,113.8
26020, 남구,035003, 32세,2016,4597,2445,2152,113.6,4439,2348,2091,112.3
26020, 남구,035004, 33세,2016,4900,2526,2374,106.4,4749,2441,2308,105.8
26020, 남구,035005, 34세,2016,5414,2803,2611,107.4,5268,2727,2541,107.3
26020, 남구,040,35~39세,2016,25432,13036,12396,105.2,24781,12631,12150,104
26020, 남구,040001, 35세,2016,5445,2869,2576,111.4,5293,2770,2523,109.8
26020, 남구,040002, 36세,2016,5494,2809,2685,104.6,5354,2727,2627,103.8
26020, 남구,040003, 37세,2016,5019,2534,2485,102,4895,2454,2441,100.5
26020, 남구,040004, 38세,2016,4668,2421,2247,107.7,4543,2342,2201,106.4
26020, 남구,040005, 39세,2016,4806,2403,2403,100,4696,2338,2358,99.2
26020, 남구,045,40~44세,2016,27478,13108,14370,91.2,26907,12756,14151,90.1
26020, 남구,045001, 40세,2016,4590,2283,2307,99,4480,2217,2263,98
26020, 남구,045002, 41세,2016,5027,2432,2595,93.7,4917,2361,2556,92.4
26020, 남구,045003, 42세,2016,5717,2681,3036,88.3,5600,2604,2996,86.9
26020, 남구,045004, 43세,2016,5995,2810,3185,88.2,5887,2743,3144,87.2
26020, 남구,045005, 44세,2016,6149,2902,3247,89.4,6023,2831,3192,88.7
26020, 남구,050,45~49세,2016,34796,16819,17977,93.6,34043,16401,17642,93
26020, 남구,050001, 45세,2016,6900,3316,3584,92.5,6736,3224,3512,91.8
26020, 남구,050002, 46세,2016,6968,3389,3579,94.7,6827,3311,3516,94.2
26020, 남구,050003, 47세,2016,6985,3384,3601,94,6821,3287,3534,93
26020, 남구,050004, 48세,2016,7199,3507,3692,95,7048,3426,3622,94.6
26020, 남구,050005, 49세,2016,6744,3223,3521,91.5,6611,3153,3458,91.2
26020, 남구,055,50~54세,2016,32605,16775,15830,106,31834,16354,15480,105.6
26020, 남구,055001, 50세,2016,6700,3469,3231,107.4,6543,3375,3168,106.5
26020, 남구,055002, 51세,2016,6781,3513,3268,107.5,6616,3427,3189,107.5
26020, 남구,055003, 52세,2016,6068,3098,2970,104.3,5926,3018,2908,103.8
26020, 남구,055004, 53세,2016,6522,3349,3173,105.5,6337,3251,3086,105.3
26020, 남구,055005, 54세,2016,6534,3346,3188,105,6412,3283,3129,104.9
26020, 남구,060,55~59세,2016,29610,15039,14571,103.2,29130,14760,14370,102.7
26020, 남구,060001, 55세,2016,6868,3580,3288,108.9,6774,3521,3253,108.2
26020, 남구,060002, 56세,2016,6489,3269,3220,101.5,6377,3207,3170,101.2
26020, 남구,060003, 57세,2016,5822,2886,2936,98.3,5724,2828,2896,97.7
26020, 남구,060004, 58세,2016,5334,2713,2621,103.5,5244,2661,2583,103
26020, 남구,060005, 59세,2016,5097,2591,2506,103.4,5011,2543,2468,103
26020, 남구,065,60~64세,2016,19651,9984,9667,103.3,19321,9799,9522,102.9
26020, 남구,065001, 60세,2016,4600,2313,2287,101.1,4533,2283,2250,101.5
26020, 남구,065002, 61세,2016,4569,2321,2248,103.2,4495,2275,2220,102.5
26020, 남구,065003, 62세,2016,3839,1970,1869,105.4,3756,1921,1835,104.7
26020, 남구,065004, 63세,2016,3360,1712,1648,103.9,3301,1678,1623,103.4
26020, 남구,065005, 64세,2016,3283,1668,1615,103.3,3236,1642,1594,103
26020, 남구,070,65~69세,2016,12026,6152,5874,104.7,11893,6083,5810,104.7
26020, 남구,070001, 65세,2016,2588,1296,1292,100.3,2540,1268,1272,99.7
26020, 남구,070002, 66세,2016,2562,1315,1247,105.5,2540,1303,1237,105.3
26020, 남구,070003, 67세,2016,2401,1242,1159,107.2,2370,1227,1143,107.3
26020, 남구,070004, 68세,2016,2437,1253,1184,105.8,2425,1246,1179,105.7
26020, 남구,070005, 69세,2016,2038,1046,992,105.4,2018,1039,979,106.1
26020, 남구,075,70~74세,2016,7502,3538,3964,89.3,7445,3516,3929,89.5
26020, 남구,075001, 70세,2016,1504,713,791,90.1,1491,707,784,90.2
26020, 남구,075002, 71세,2016,1427,696,731,95.2,1416,693,723,95.9
26020, 남구,075003, 72세,2016,1480,693,787,88.1,1471,691,780,88.6
26020, 남구,075004, 73세,2016,1464,671,793,84.6,1456,666,790,84.3
26020, 남구,075005, 74세,2016,1627,765,862,88.7,1611,759,852,89.1
26020, 남구,080,75~79세,2016,5168,2160,3008,71.8,5131,2149,2982,72.1
26020, 남구,080001, 75세,2016,1229,563,666,84.5,1220,558,662,84.3
26020, 남구,080002, 76세,2016,1147,488,659,74.1,1139,485,654,74.2
26020, 남구,080003, 77세,2016,1081,487,594,82,1072,486,586,82.9
26020, 남구,080004, 78세,2016,877,320,557,57.5,874,318,556,57.2
26020, 남구,080005, 79세,2016,834,302,532,56.8,826,302,524,57.6
26020, 남구,085,80~84세,2016,2918,915,2003,45.7,2905,914,1991,45.9
26020, 남구,085001, 80세,2016,712,231,481,48,709,231,478,48.3
26020, 남구,085002, 81세,2016,703,222,481,46.2,699,221,478,46.2
26020, 남구,085003, 82세,2016,618,201,417,48.2,616,201,415,48.4
26020, 남구,085004, 83세,2016,489,139,350,39.7,485,139,346,40.2
26020, 남구,085005, 84세,2016,396,122,274,44.5,396,122,274,44.5
26020, 남구,090,85~89세,2016,1233,262,971,27,1221,260,961,27.1
26020, 남구,090001, 85세,2016,313,70,243,28.8,312,70,242,28.9
26020, 남구,090002, 86세,2016,289,67,222,30.2,285,67,218,30.7
26020, 남구,090003, 87세,2016,254,60,194,30.9,251,60,191,31.4
26020, 남구,090004, 88세,2016,207,36,171,21.1,205,35,170,20.6
26020, 남구,090005, 89세,2016,170,29,141,20.6,168,28,140,20
26020, 남구,095,90~94세,2016,416,66,350,18.9,415,65,350,18.6
26020, 남구,095001, 90세,2016,122,19,103,18.4,122,19,103,18.4
26020, 남구,095002, 91세,2016,116,15,101,14.9,116,15,101,14.9
26020, 남구,095003, 92세,2016,64,12,52,23.1,63,11,52,21.2
26020, 남구,095004, 93세,2016,70,12,58,20.7,70,12,58,20.7
26020, 남구,095005, 94세,2016,44,8,36,22.2,44,8,36,22.2
26020, 남구,100,95~99세,2016,73,13,60,21.7,73,13,60,21.7
26020, 남구,100001, 95세,2016,28,X,25,12,28,X,25,12
26020, 남구,100002, 96세,2016,18,X,14,28.6,18,X,14,28.6
26020, 남구,100003, 97세,2016,15,5,10,50,15,5,10,50
26020, 남구,100004, 98세,2016,8,X,7,14.3,8,X,7,14.3
26020, 남구,100005, 99세,2016,X,X,X,0,X,X,X,0
26020, 남구,101,100세이상,2016,7,X,6,16.7,7,X,6,16.7
26020, 남구,102,15세미만,2016,44649,23382,21267,109.9,44370,23248,21122,110.1
26020, 남구,103,15~64세,2016,264204,136712,127492,107.2,257928,133242,124686,106.9
26020, 남구,104,65세이상,2016,29343,13107,16236,80.7,29090,13001,16089,80.8
26020, 남구,086,85세이상,2016,1729,342,1387,24.7,1716,339,1377,24.6
26020, 남구,126,평균연령,2016,39.2,38.3,40.2,,39.2,38.3,40.3,
26020, 남구,127,중위연령,2016,41,39.3,42.4,,41,39.3,42.5,
26030, 동구,000,합계,2016,176574,94898,81676,116.2,171141,91141,80000,113.9
26030, 동구,005,0~4세,2016,10519,5320,5199,102.3,10349,5232,5117,102.2
26030, 동구,005001, 0세,2016,2077,1042,1035,100.7,2045,1026,1019,100.7
26030, 동구,005002, 1세,2016,2100,1076,1024,105.1,2064,1059,1005,105.4
26030, 동구,005003, 2세,2016,2186,1070,1116,95.9,2153,1054,1099,95.9
26030, 동구,005004, 3세,2016,2008,1024,984,104.1,1974,1008,966,104.3
26030, 동구,005005, 4세,2016,2148,1108,1040,106.5,2113,1085,1028,105.5
26030, 동구,010,5~9세,2016,9237,4819,4418,109.1,9126,4761,4365,109.1
26030, 동구,010001, 5세,2016,2046,1085,961,112.9,2009,1062,947,112.1
26030, 동구,010002, 6세,2016,1914,1012,902,112.2,1895,1003,892,112.4
26030, 동구,010003, 7세,2016,1764,909,855,106.3,1749,901,848,106.3
26030, 동구,010004, 8세,2016,1733,906,827,109.6,1714,898,816,110
26030, 동구,010005, 9세,2016,1780,907,873,103.9,1759,897,862,104.1
26030, 동구,015,10~14세,2016,7693,4095,3598,113.8,7658,4081,3577,114.1
26030, 동구,015001, 10세,2016,1563,845,718,117.7,1556,842,714,117.9
26030, 동구,015002, 11세,2016,1451,772,679,113.7,1442,768,674,113.9
26030, 동구,015003, 12세,2016,1539,823,716,114.9,1528,817,711,114.9
26030, 동구,015004, 13세,2016,1562,840,722,116.3,1559,839,720,116.5
26030, 동구,015005, 14세,2016,1578,815,763,106.8,1573,815,758,107.5
26030, 동구,020,15~19세,2016,9410,4965,4445,111.7,9366,4944,4422,111.8
26030, 동구,020001, 15세,2016,1750,891,859,103.7,1746,890,856,104
26030, 동구,020002, 16세,2016,2256,1128,1128,100,2250,1124,1126,99.8
26030, 동구,020003, 17세,2016,1987,1002,985,101.7,1983,1000,983,101.7
26030, 동구,020004, 18세,2016,1895,1027,868,118.3,1889,1025,864,118.6
26030, 동구,020005, 19세,2016,1522,917,605,151.6,1498,905,593,152.6
26030, 동구,025,20~24세,2016,10076,6015,4061,148.1,9734,5798,3936,147.3
26030, 동구,025001, 20세,2016,1821,1150,671,171.4,1786,1140,646,176.5
26030, 동구,025002, 21세,2016,1893,1207,686,175.9,1852,1188,664,178.9
26030, 동구,025003, 22세,2016,1909,1151,758,151.8,1859,1113,746,149.2
26030, 동구,025004, 23세,2016,2087,1175,912,128.8,1981,1106,875,126.4
26030, 동구,025005, 24세,2016,2366,1332,1034,128.8,2256,1251,1005,124.5
26030, 동구,030,25~29세,2016,13706,8309,5397,154,12738,7599,5139,147.9
26030, 동구,030001, 25세,2016,2520,1433,1087,131.8,2346,1297,1049,123.6
26030, 동구,030002, 26세,2016,2566,1572,994,158.1,2377,1438,939,153.1
26030, 동구,030003, 27세,2016,2825,1761,1064,165.5,2634,1622,1012,160.3
26030, 동구,030004, 28세,2016,2817,1750,1067,164,2610,1602,1008,158.9
26030, 동구,030005, 29세,2016,2978,1793,1185,151.3,2771,1640,1131,145
26030, 동구,035,30~34세,2016,17199,10027,7172,139.8,16028,9136,6892,132.6
26030, 동구,035001, 30세,2016,3145,1869,1276,146.5,2905,1689,1216,138.9
26030, 동구,035002, 31세,2016,3149,1890,1259,150.1,2914,1708,1206,141.6
26030, 동구,035003, 32세,2016,3300,1944,1356,143.4,3034,1743,1291,135
26030, 동구,035004, 33세,2016,3778,2134,1644,129.8,3562,1975,1587,124.4
26030, 동구,035005, 34세,2016,3827,2190,1637,133.8,3613,2021,1592,126.9
26030, 동구,040,35~39세,2016,16606,9473,7133,132.8,15888,8927,6961,128.2
26030, 동구,040001, 35세,2016,3725,2176,1549,140.5,3546,2031,1515,134.1
26030, 동구,040002, 36세,2016,3735,2176,1559,139.6,3576,2048,1528,134
26030, 동구,040003, 37세,2016,3249,1852,1397,132.6,3130,1770,1360,130.1
26030, 동구,040004, 38세,2016,3038,1692,1346,125.7,2911,1603,1308,122.6
26030, 동구,040005, 39세,2016,2859,1577,1282,123,2725,1475,1250,118
26030, 동구,045,40~44세,2016,13443,7504,5939,126.4,12912,7109,5803,122.5
26030, 동구,045001, 40세,2016,2649,1529,1120,136.5,2531,1433,1098,130.5
26030, 동구,045002, 41세,2016,2679,1490,1189,125.3,2573,1409,1164,121
26030, 동구,045003, 42세,2016,2736,1512,1224,123.5,2640,1456,1184,123
26030, 동구,045004, 43세,2016,2749,1491,1258,118.5,2649,1418,1231,115.2
26030, 동구,045005, 44세,2016,2630,1482,1148,129.1,2519,1393,1126,123.7
26030, 동구,050,45~49세,2016,13768,7102,6666,106.5,13274,6773,6501,104.2
26030, 동구,050001, 45세,2016,2824,1506,1318,114.3,2706,1418,1288,110.1
26030, 동구,050002, 46세,2016,2721,1431,1290,110.9,2607,1353,1254,107.9
26030, 동구,050003, 47세,2016,2786,1474,1312,112.3,2686,1405,1281,109.7
26030, 동구,050004, 48세,2016,2801,1402,1399,100.2,2705,1342,1363,98.5
26030, 동구,050005, 49세,2016,2636,1289,1347,95.7,2570,1255,1315,95.4
26030, 동구,055,50~54세,2016,14097,7019,7078,99.2,13722,6786,6936,97.8
26030, 동구,055001, 50세,2016,2750,1428,1322,108,2673,1378,1295,106.4
26030, 동구,055002, 51세,2016,2794,1362,1432,95.1,2715,1312,1403,93.5
26030, 동구,055003, 52세,2016,2573,1300,1273,102.1,2509,1258,1251,100.6
26030, 동구,055004, 53세,2016,2900,1415,1485,95.3,2802,1350,1452,93
26030, 동구,055005, 54세,2016,3080,1514,1566,96.7,3023,1488,1535,96.9
26030, 동구,060,55~59세,2016,16279,8178,8101,101,16028,8032,7996,100.5
26030, 동구,060001, 55세,2016,3482,1648,1834,89.9,3430,1621,1809,89.6
26030, 동구,060002, 56세,2016,3595,1726,1869,92.3,3527,1676,1851,90.5
26030, 동구,060003, 57세,2016,3224,1676,1548,108.3,3181,1654,1527,108.3
26030, 동구,060004, 58세,2016,3085,1664,1421,117.1,3036,1638,1398,117.2
26030, 동구,060005, 59세,2016,2893,1464,1429,102.4,2854,1443,1411,102.3
26030, 동구,065,60~64세,2016,10563,5534,5029,110,10452,5474,4978,110
26030, 동구,065001, 60세,2016,2552,1343,1209,111.1,2534,1330,1204,110.5
26030, 동구,065002, 61세,2016,2455,1259,1196,105.3,2421,1240,1181,105
26030, 동구,065003, 62세,2016,1921,991,930,106.6,1896,979,917,106.8
26030, 동구,065004, 63세,2016,1787,926,861,107.5,1762,915,847,108
26030, 동구,065005, 64세,2016,1848,1015,833,121.8,1839,1010,829,121.8
26030, 동구,070,65~69세,2016,6170,3378,2792,121,6111,3348,2763,121.2
26030, 동구,070001, 65세,2016,1362,743,619,120,1348,736,612,120.3
26030, 동구,070002, 66세,2016,1329,714,615,116.1,1308,703,605,116.2
26030, 동구,070003, 67세,2016,1250,691,559,123.6,1240,685,555,123.4
26030, 동구,070004, 68세,2016,1195,661,534,123.8,1189,658,531,123.9
26030, 동구,070005, 69세,2016,1034,569,465,122.4,1026,566,460,123
26030, 동구,075,70~74세,2016,3485,1772,1713,103.4,3460,1760,1700,103.5
26030, 동구,075001, 70세,2016,780,430,350,122.9,771,426,345,123.5
26030, 동구,075002, 71세,2016,660,331,329,100.6,654,328,326,100.6
26030, 동구,075003, 72세,2016,617,324,293,110.6,614,323,291,111
26030, 동구,075004, 73세,2016,717,352,365,96.4,713,348,365,95.3
26030, 동구,075005, 74세,2016,711,335,376,89.1,708,335,373,89.8
26030, 동구,080,75~79세,2016,2209,909,1300,69.9,2192,904,1288,70.2
26030, 동구,080001, 75세,2016,529,240,289,83,524,238,286,83.2
26030, 동구,080002, 76세,2016,487,207,280,73.9,484,206,278,74.1
26030, 동구,080003, 77세,2016,464,208,256,81.3,459,206,253,81.4
26030, 동구,080004, 78세,2016,402,142,260,54.6,400,142,258,55
26030, 동구,080005, 79세,2016,327,112,215,52.1,325,112,213,52.6
26030, 동구,085,80~84세,2016,1246,340,906,37.5,1238,340,898,37.9
26030, 동구,085001, 80세,2016,317,87,230,37.8,313,87,226,38.5
26030, 동구,085002, 81세,2016,275,73,202,36.1,273,73,200,36.5
26030, 동구,085003, 82세,2016,240,71,169,42,240,71,169,42
26030, 동구,085004, 83세,2016,224,71,153,46.4,222,71,151,47
26030, 동구,085005, 84세,2016,190,38,152,25,190,38,152,25
26030, 동구,090,85~89세,2016,590,105,485,21.6,588,104,484,21.5
26030, 동구,090001, 85세,2016,153,29,124,23.4,151,28,123,22.8
26030, 동구,090002, 86세,2016,147,32,115,27.8,147,32,115,27.8
26030, 동구,090003, 87세,2016,114,25,89,28.1,114,25,89,28.1
26030, 동구,090004, 88세,2016,88,9,79,11.4,88,9,79,11.4
26030, 동구,090005, 89세,2016,88,10,78,12.8,88,10,78,12.8
26030, 동구,095,90~94세,2016,231,28,203,13.8,230,27,203,13.3
26030, 동구,095001, 90세,2016,54,8,46,17.4,54,8,46,17.4
26030, 동구,095002, 91세,2016,68,8,60,13.3,68,8,60,13.3
26030, 동구,095003, 92세,2016,41,X,39,5.1,40,X,39,2.6
26030, 동구,095004, 93세,2016,37,6,31,19.4,37,6,31,19.4
26030, 동구,095005, 94세,2016,31,X,27,14.8,31,X,27,14.8
26030, 동구,100,95~99세,2016,41,6,35,17.1,41,6,35,17.1
26030, 동구,100001, 95세,2016,18,X,15,20,18,X,15,20
26030, 동구,100002, 96세,2016,14,X,12,16.7,14,X,12,16.7
26030, 동구,100003, 97세,2016,6,X,5,20,6,X,5,20
26030, 동구,100004, 98세,2016,X,X,X,0,X,X,X,0
26030, 동구,100005, 99세,2016,X,X,X,0,X,X,X,0
26030, 동구,101,100세이상,2016,6,X,6,0,6,X,6,0
26030, 동구,102,15세미만,2016,27449,14234,13215,107.7,27133,14074,13059,107.8
26030, 동구,103,15~64세,2016,135147,74126,61021,121.5,130142,70578,59564,118.5
26030, 동구,104,65세이상,2016,13978,6538,7440,87.9,13866,6489,7377,88
26030, 동구,086,85세이상,2016,868,139,729,19.1,865,137,728,18.8
26030, 동구,126,평균연령,2016,38.1,37.3,39,,38.1,37.3,39,
26030, 동구,127,중위연령,2016,37.9,36.8,39.5,,38.1,37,39.7,
26040, 북구,000,합계,2016,192203,100251,91952,109,189126,98258,90868,108.1
26040, 북구,005,0~4세,2016,11996,6150,5846,105.2,11969,6139,5830,105.3
26040, 북구,005001, 0세,2016,2245,1167,1078,108.3,2237,1163,1074,108.3
26040, 북구,005002, 1세,2016,2402,1223,1179,103.7,2397,1221,1176,103.8
26040, 북구,005003, 2세,2016,2345,1188,1157,102.7,2343,1187,1156,102.7
26040, 북구,005004, 3세,2016,2427,1244,1183,105.2,2421,1242,1179,105.3
26040, 북구,005005, 4세,2016,2577,1328,1249,106.3,2571,1326,1245,106.5
26040, 북구,010,5~9세,2016,12210,6292,5918,106.3,12194,6285,5909,106.4
26040, 북구,010001, 5세,2016,2480,1261,1219,103.4,2477,1259,1218,103.4
26040, 북구,010002, 6세,2016,2424,1241,1183,104.9,2417,1238,1179,105
26040, 북구,010003, 7세,2016,2368,1263,1105,114.3,2366,1263,1103,114.5
26040, 북구,010004, 8세,2016,2497,1270,1227,103.5,2494,1268,1226,103.4
26040, 북구,010005, 9세,2016,2441,1257,1184,106.2,2440,1257,1183,106.3
26040, 북구,015,10~14세,2016,10444,5439,5005,108.7,10435,5432,5003,108.6
26040, 북구,015001, 10세,2016,2147,1071,1076,99.5,2146,1070,1076,99.4
26040, 북구,015002, 11세,2016,2048,1059,989,107.1,2047,1058,989,107
26040, 북구,015003, 12세,2016,2035,1056,979,107.9,2034,1056,978,108
26040, 북구,015004, 13세,2016,2064,1101,963,114.3,2064,1101,963,114.3
26040, 북구,015005, 14세,2016,2150,1152,998,115.4,2144,1147,997,115
26040, 북구,020,15~19세,2016,12978,7223,5755,125.5,12950,7209,5741,125.6
26040, 북구,020001, 15세,2016,2464,1348,1116,120.8,2459,1345,1114,120.7
26040, 북구,020002, 16세,2016,2857,1567,1290,121.5,2852,1564,1288,121.4
26040, 북구,020003, 17세,2016,2884,1597,1287,124.1,2880,1594,1286,124
26040, 북구,020004, 18세,2016,2691,1480,1211,122.2,2688,1479,1209,122.3
26040, 북구,020005, 19세,2016,2082,1231,851,144.7,2071,1227,844,145.4
26040, 북구,025,20~24세,2016,12189,7216,4973,145.1,11897,7026,4871,144.2
26040, 북구,025001, 20세,2016,2361,1542,819,188.3,2339,1532,807,189.8
26040, 북구,025002, 21세,2016,2434,1476,958,154.1,2411,1465,946,154.9
26040, 북구,025003, 22세,2016,2437,1414,1023,138.2,2373,1369,1004,136.4
26040, 북구,025004, 23세,2016,2467,1394,1073,129.9,2381,1339,1042,128.5
26040, 북구,025005, 24세,2016,2490,1390,1100,126.4,2393,1321,1072,123.2
26040, 북구,030,25~29세,2016,12013,6767,5246,129,11308,6289,5019,125.3
26040, 북구,030001, 25세,2016,2497,1360,1137,119.6,2358,1271,1087,116.9
26040, 북구,030002, 26세,2016,2499,1449,1050,138,2362,1358,1004,135.3
26040, 북구,030003, 27세,2016,2361,1377,984,139.9,2221,1272,949,134
26040, 북구,030004, 28세,2016,2341,1320,1021,129.3,2198,1225,973,125.9
26040, 북구,030005, 29세,2016,2315,1261,1054,119.6,2169,1163,1006,115.6
26040, 북구,035,30~34세,2016,14388,7385,7003,105.5,13804,6961,6843,101.7
26040, 북구,035001, 30세,2016,2344,1281,1063,120.5,2223,1197,1026,116.7
26040, 북구,035002, 31세,2016,2445,1308,1137,115,2313,1210,1103,109.7
26040, 북구,035003, 32세,2016,2805,1422,1383,102.8,2682,1335,1347,99.1
26040, 북구,035004, 33세,2016,3256,1612,1644,98.1,3129,1515,1614,93.9
26040, 북구,035005, 34세,2016,3538,1762,1776,99.2,3457,1704,1753,97.2
26040, 북구,040,35~39세,2016,18561,9620,8941,107.6,18181,9344,8837,105.7
26040, 북구,040001, 35세,2016,3824,1922,1902,101.1,3734,1852,1882,98.4
26040, 북구,040002, 36세,2016,4052,2076,1976,105.1,3976,2023,1953,103.6
26040, 북구,040003, 37세,2016,3766,1983,1783,111.2,3684,1923,1761,109.2
26040, 북구,040004, 38세,2016,3383,1793,1590,112.8,3306,1738,1568,110.8
26040, 북구,040005, 39세,2016,3536,1846,1690,109.2,3481,1808,1673,108.1
26040, 북구,045,40~44세,2016,17010,8665,8345,103.8,16738,8475,8263,102.6
26040, 북구,045001, 40세,2016,3229,1717,1512,113.6,3176,1678,1498,112
26040, 북구,045002, 41세,2016,3393,1758,1635,107.5,3337,1714,1623,105.6
26040, 북구,045003, 42세,2016,3473,1751,1722,101.7,3427,1714,1713,100.1
26040, 북구,045004, 43세,2016,3418,1732,1686,102.7,3366,1702,1664,102.3
26040, 북구,045005, 44세,2016,3497,1707,1790,95.4,3432,1667,1765,94.4
26040, 북구,050,45~49세,2016,18918,9267,9651,96,18658,9109,9549,95.4
26040, 북구,050001, 45세,2016,3625,1807,1818,99.4,3574,1776,1798,98.8
26040, 북구,050002, 46세,2016,3649,1770,1879,94.2,3605,1740,1865,93.3
26040, 북구,050003, 47세,2016,3925,1909,2016,94.7,3864,1871,1993,93.9
26040, 북구,050004, 48세,2016,3926,1892,2034,93,3868,1860,2008,92.6
26040, 북구,050005, 49세,2016,3793,1889,1904,99.2,3747,1862,1885,98.8
26040, 북구,055,50~54세,2016,17662,9667,7995,120.9,17453,9558,7895,121.1
26040, 북구,055001, 50세,2016,3872,2073,1799,115.2,3833,2047,1786,114.6
26040, 북구,055002, 51세,2016,3709,1980,1729,114.5,3676,1964,1712,114.7
26040, 북구,055003, 52세,2016,3351,1825,1526,119.6,3301,1795,1506,119.2
26040, 북구,055004, 53세,2016,3349,1901,1448,131.3,3301,1876,1425,131.6
26040, 북구,055005, 54세,2016,3381,1888,1493,126.5,3342,1876,1466,128
26040, 북구,060,55~59세,2016,13460,7254,6206,116.9,13330,7191,6139,117.1
26040, 북구,060001, 55세,2016,3458,1869,1589,117.6,3433,1857,1576,117.8
26040, 북구,060002, 56세,2016,3031,1645,1386,118.7,2997,1634,1363,119.9
26040, 북구,060003, 57세,2016,2542,1391,1151,120.9,2522,1380,1142,120.8
26040, 북구,060004, 58세,2016,2307,1227,1080,113.6,2283,1217,1066,114.2
26040, 북구,060005, 59세,2016,2122,1122,1000,112.2,2095,1103,992,111.2
26040, 북구,065,60~64세,2016,7707,4025,3682,109.3,7606,3980,3626,109.8
26040, 북구,065001, 60세,2016,1886,981,905,108.4,1864,969,895,108.3
26040, 북구,065002, 61세,2016,1824,957,867,110.4,1797,949,848,111.9
26040, 북구,065003, 62세,2016,1496,771,725,106.3,1475,761,714,106.6
26040, 북구,065004, 63세,2016,1237,665,572,116.3,1221,655,566,115.7
26040, 북구,065005, 64세,2016,1264,651,613,106.2,1249,646,603,107.1
26040, 북구,070,65~69세,2016,4636,2256,2380,94.8,4605,2245,2360,95.1
26040, 북구,070001, 65세,2016,967,510,457,111.6,956,505,451,112
26040, 북구,070002, 66세,2016,970,469,501,93.6,961,468,493,94.9
26040, 북구,070003, 67세,2016,933,463,470,98.5,930,463,467,99.1
26040, 북구,070004, 68세,2016,887,418,469,89.1,883,415,468,88.7
26040, 북구,070005, 69세,2016,879,396,483,82,875,394,481,81.9
26040, 북구,075,70~74세,2016,3168,1504,1664,90.4,3151,1497,1654,90.5
26040, 북구,075001, 70세,2016,574,293,281,104.3,570,291,279,104.3
26040, 북구,075002, 71세,2016,600,287,313,91.7,595,285,310,91.9
26040, 북구,075003, 72세,2016,609,315,294,107.1,606,314,292,107.5
26040, 북구,075004, 73세,2016,660,275,385,71.4,656,273,383,71.3
26040, 북구,075005, 74세,2016,725,334,391,85.4,724,334,390,85.6
26040, 북구,080,75~79세,2016,2371,883,1488,59.3,2364,881,1483,59.4
26040, 북구,080001, 75세,2016,521,224,297,75.4,519,224,295,75.9
26040, 북구,080002, 76세,2016,511,193,318,60.7,509,193,316,61.1
26040, 북구,080003, 77세,2016,461,178,283,62.9,460,177,283,62.5
26040, 북구,080004, 78세,2016,465,163,302,54,464,162,302,53.6
26040, 북구,080005, 79세,2016,413,125,288,43.4,412,125,287,43.6
26040, 북구,085,80~84세,2016,1544,448,1096,40.9,1538,447,1091,41
26040, 북구,085001, 80세,2016,358,100,258,38.8,355,99,256,38.7
26040, 북구,085002, 81세,2016,326,104,222,46.8,325,104,221,47.1
26040, 북구,085003, 82세,2016,330,105,225,46.7,328,105,223,47.1
26040, 북구,085004, 83세,2016,287,88,199,44.2,287,88,199,44.2
26040, 북구,085005, 84세,2016,243,51,192,26.6,243,51,192,26.6
26040, 북구,090,85~89세,2016,661,141,520,27.1,658,141,517,27.3
26040, 북구,090001, 85세,2016,159,32,127,25.2,158,32,126,25.4
26040, 북구,090002, 86세,2016,165,39,126,31,164,39,125,31.2
26040, 북구,090003, 87세,2016,139,35,104,33.7,139,35,104,33.7
26040, 북구,090004, 88세,2016,107,21,86,24.4,106,21,85,24.7
26040, 북구,090005, 89세,2016,91,14,77,18.2,91,14,77,18.2
26040, 북구,095,90~94세,2016,228,37,191,19.4,228,37,191,19.4
26040, 북구,095001, 90세,2016,62,10,52,19.2,62,10,52,19.2
26040, 북구,095002, 91세,2016,44,8,36,22.2,44,8,36,22.2
26040, 북구,095003, 92세,2016,44,7,37,18.9,44,7,37,18.9
26040, 북구,095004, 93세,2016,43,5,38,13.2,43,5,38,13.2
26040, 북구,095005, 94세,2016,35,7,28,25,35,7,28,25
26040, 북구,100,95~99세,2016,56,12,44,27.3,56,12,44,27.3
26040, 북구,100001, 95세,2016,22,6,16,37.5,22,6,16,37.5
26040, 북구,100002, 96세,2016,16,X,14,14.3,16,X,14,14.3
26040, 북구,100003, 97세,2016,6,X,X,50,6,X,X,50
26040, 북구,100004, 98세,2016,6,X,5,20,6,X,5,20
26040, 북구,100005, 99세,2016,6,X,5,20,6,X,5,20
26040, 북구,101,100세이상,2016,X,X,X,0,X,X,X,0
26040, 북구,102,15세미만,2016,34650,17881,16769,106.6,34598,17856,16742,106.7
26040, 북구,103,15~64세,2016,144886,77089,67797,113.7,141925,75142,66783,112.5
26040, 북구,104,65세이상,2016,12667,5281,7386,71.5,12603,5260,7343,71.6
26040, 북구,086,85세이상,2016,948,190,758,25.1,945,190,755,25.2
26040, 북구,126,평균연령,2016,36.3,35.6,37.1,,36.3,35.6,37.1,
26040, 북구,127,중위연령,2016,37.5,36.8,38.4,,37.6,37,38.4,
26310, 울주군,000,합계,2016,222106,116425,105681,110.2,211591,109109,102482,106.5
26310, 울주군,005,0~4세,2016,10282,5215,5067,102.9,10079,5117,4962,103.1
26310, 울주군,005001, 0세,2016,1839,936,903,103.7,1805,919,886,103.7
26310, 울주군,005002, 1세,2016,2036,1046,990,105.7,1987,1019,968,105.3
26310, 울주군,005003, 2세,2016,2050,1065,985,108.1,2002,1043,959,108.8
26310, 울주군,005004, 3세,2016,2076,1020,1056,96.6,2036,1003,1033,97.1
26310, 울주군,005005, 4세,2016,2281,1148,1133,101.3,2249,1133,1116,101.5
26310, 울주군,010,5~9세,2016,11034,5680,5354,106.1,10931,5624,5307,106
26310, 울주군,010001, 5세,2016,2233,1140,1093,104.3,2211,1127,1084,104
26310, 울주군,010002, 6세,2016,2196,1130,1066,106,2175,1122,1053,106.6
26310, 울주군,010003, 7세,2016,2039,1025,1014,101.1,2017,1012,1005,100.7
26310, 울주군,010004, 8세,2016,2265,1176,1089,108,2245,1163,1082,107.5
26310, 울주군,010005, 9세,2016,2301,1209,1092,110.7,2283,1200,1083,110.8
26310, 울주군,015,10~14세,2016,11102,5766,5336,108.1,11055,5752,5303,108.5
26310, 울주군,015001, 10세,2016,2089,1101,988,111.4,2079,1098,981,111.9
26310, 울주군,015002, 11세,2016,2136,1109,1027,108,2125,1105,1020,108.3
26310, 울주군,015003, 12세,2016,2263,1184,1079,109.7,2257,1181,1076,109.8
26310, 울주군,015004, 13세,2016,2297,1186,1111,106.8,2289,1185,1104,107.3
26310, 울주군,015005, 14세,2016,2317,1186,1131,104.9,2305,1183,1122,105.4
26310, 울주군,020,15~19세,2016,13757,7522,6235,120.6,13582,7397,6185,119.6
26310, 울주군,020001, 15세,2016,2649,1399,1250,111.9,2636,1391,1245,111.7
26310, 울주군,020002, 16세,2016,2810,1508,1302,115.8,2798,1500,1298,115.6
26310, 울주군,020003, 17세,2016,2888,1542,1346,114.6,2865,1525,1340,113.8
26310, 울주군,020004, 18세,2016,2736,1480,1256,117.8,2680,1435,1245,115.3
26310, 울주군,020005, 19세,2016,2674,1593,1081,147.4,2603,1546,1057,146.3
26310, 울주군,025,20~24세,2016,15309,9334,5975,156.2,14441,8669,5772,150.2
26310, 울주군,025001, 20세,2016,2988,1912,1076,177.7,2892,1845,1047,176.2
26310, 울주군,025002, 21세,2016,3111,1889,1222,154.6,3012,1820,1192,152.7
26310, 울주군,025003, 22세,2016,3034,1820,1214,149.9,2880,1702,1178,144.5
26310, 울주군,025004, 23세,2016,3080,1859,1221,152.3,2863,1692,1171,144.5
26310, 울주군,025005, 24세,2016,3096,1854,1242,149.3,2794,1610,1184,136
26310, 울주군,030,25~29세,2016,12988,7780,5208,149.4,11033,6272,4761,131.7
26310, 울주군,030001, 25세,2016,2898,1718,1180,145.6,2569,1463,1106,132.3
26310, 울주군,030002, 26세,2016,2622,1603,1019,157.3,2228,1294,934,138.5
26310, 울주군,030003, 27세,2016,2566,1563,1003,155.8,2168,1268,900,140.9
26310, 울주군,030004, 28세,2016,2392,1432,960,149.2,1999,1130,869,130
26310, 울주군,030005, 29세,2016,2510,1464,1046,140,2069,1117,952,117.3
26310, 울주군,035,30~34세,2016,14290,7972,6318,126.2,12528,6599,5929,111.3
26310, 울주군,035001, 30세,2016,2498,1427,1071,133.2,2113,1140,973,117.2
26310, 울주군,035002, 31세,2016,2563,1449,1114,130.1,2178,1156,1022,113.1
26310, 울주군,035003, 32세,2016,2797,1562,1235,126.5,2439,1274,1165,109.4
26310, 울주군,035004, 33세,2016,3034,1706,1328,128.5,2692,1423,1269,112.1
26310, 울주군,035005, 34세,2016,3398,1828,1570,116.4,3106,1606,1500,107.1
26310, 울주군,040,35~39세,2016,17400,9231,8169,113,16208,8360,7848,106.5
26310, 울주군,040001, 35세,2016,3548,1962,1586,123.7,3268,1753,1515,115.7
26310, 울주군,040002, 36세,2016,3646,1907,1739,109.7,3393,1714,1679,102.1
26310, 울주군,040003, 37세,2016,3441,1800,1641,109.7,3199,1625,1574,103.2
26310, 울주군,040004, 38세,2016,3267,1762,1505,117.1,3032,1594,1438,110.8
26310, 울주군,040005, 39세,2016,3498,1800,1698,106,3316,1674,1642,101.9
26310, 울주군,045,40~44세,2016,19503,10071,9432,106.8,18478,9351,9127,102.5
26310, 울주군,045001, 40세,2016,3517,1850,1667,111,3305,1690,1615,104.6
26310, 울주군,045002, 41세,2016,3735,1886,1849,102,3536,1740,1796,96.9
26310, 울주군,045003, 42세,2016,4015,2075,1940,107,3832,1948,1884,103.4
26310, 울주군,045004, 43세,2016,4131,2114,2017,104.8,3904,1956,1948,100.4
26310, 울주군,045005, 44세,2016,4105,2146,1959,109.5,3901,2017,1884,107.1
26310, 울주군,050,45~49세,2016,21580,11207,10373,108,20479,10549,9930,106.2
26310, 울주군,050001, 45세,2016,4542,2361,2181,108.3,4293,2199,2094,105
26310, 울주군,050002, 46세,2016,4286,2217,2069,107.2,4047,2081,1966,105.8
26310, 울주군,050003, 47세,2016,4342,2266,2076,109.2,4131,2147,1984,108.2
26310, 울주군,050004, 48세,2016,4374,2272,2102,108.1,4162,2144,2018,106.2
26310, 울주군,050005, 49세,2016,4036,2091,1945,107.5,3846,1978,1868,105.9
26310, 울주군,055,50~54세,2016,19235,10459,8776,119.2,18217,9836,8381,117.4
26310, 울주군,055001, 50세,2016,4021,2186,1835,119.1,3808,2058,1750,117.6
26310, 울주군,055002, 51세,2016,4000,2206,1794,123,3777,2069,1708,121.1
26310, 울주군,055003, 52세,2016,3669,1957,1712,114.3,3474,1830,1644,111.3
26310, 울주군,055004, 53세,2016,3782,2055,1727,119,3546,1919,1627,117.9
26310, 울주군,055005, 54세,2016,3763,2055,1708,120.3,3612,1960,1652,118.6
26310, 울주군,060,55~59세,2016,17603,9178,8425,108.9,17079,8857,8222,107.7
26310, 울주군,060001, 55세,2016,3964,2065,1899,108.7,3867,2005,1862,107.7
26310, 울주군,060002, 56세,2016,3764,1982,1782,111.2,3626,1898,1728,109.8
26310, 울주군,060003, 57세,2016,3462,1835,1627,112.8,3342,1765,1577,111.9
26310, 울주군,060004, 58세,2016,3318,1700,1618,105.1,3215,1634,1581,103.4
26310, 울주군,060005, 59세,2016,3095,1596,1499,106.5,3029,1555,1474,105.5
26310, 울주군,065,60~64세,2016,12574,6419,6155,104.3,12255,6228,6027,103.3
26310, 울주군,065001, 60세,2016,2910,1530,1380,110.9,2817,1472,1345,109.4
26310, 울주군,065002, 61세,2016,2903,1467,1436,102.2,2841,1429,1412,101.2
26310, 울주군,065003, 62세,2016,2413,1265,1148,110.2,2340,1220,1120,108.9
26310, 울주군,065004, 63세,2016,2158,1071,1087,98.5,2108,1043,1065,97.9
26310, 울주군,065005, 64세,2016,2190,1086,1104,98.4,2149,1064,1085,98.1
26310, 울주군,070,65~69세,2016,8423,4264,4159,102.5,8297,4200,4097,102.5
26310, 울주군,070001, 65세,2016,1740,879,861,102.1,1710,863,847,101.9
26310, 울주군,070002, 66세,2016,1767,911,856,106.4,1727,887,840,105.6
26310, 울주군,070003, 67세,2016,1685,825,860,95.9,1664,817,847,96.5
26310, 울주군,070004, 68세,2016,1679,853,826,103.3,1655,841,814,103.3
26310, 울주군,070005, 69세,2016,1552,796,756,105.3,1541,792,749,105.7
26310, 울주군,075,70~74세,2016,6173,2749,3424,80.3,6134,2735,3399,80.5
26310, 울주군,075001, 70세,2016,1064,511,553,92.4,1057,510,547,93.2
26310, 울주군,075002, 71세,2016,1146,549,597,92,1136,543,593,91.6
26310, 울주군,075003, 72세,2016,1160,491,669,73.4,1155,489,666,73.4
26310, 울주군,075004, 73세,2016,1337,588,749,78.5,1333,588,745,78.9
26310, 울주군,075005, 74세,2016,1466,610,856,71.3,1453,605,848,71.3
26310, 울주군,080,75~79세,2016,5194,2015,3179,63.4,5166,2008,3158,63.6
26310, 울주군,080001, 75세,2016,1146,466,680,68.5,1141,465,676,68.8
26310, 울주군,080002, 76세,2016,1110,441,669,65.9,1105,439,666,65.9
26310, 울주군,080003, 77세,2016,1072,423,649,65.2,1067,420,647,64.9
26310, 울주군,080004, 78세,2016,1004,380,624,60.9,997,379,618,61.3
26310, 울주군,080005, 79세,2016,862,305,557,54.8,856,305,551,55.4
26310, 울주군,085,80~84세,2016,3384,1063,2321,45.8,3369,1061,2308,46
26310, 울주군,085001, 80세,2016,785,272,513,53,778,271,507,53.5
26310, 울주군,085002, 81세,2016,762,252,510,49.4,761,252,509,49.5
26310, 울주군,085003, 82세,2016,686,214,472,45.3,685,214,471,45.4
26310, 울주군,085004, 83세,2016,594,176,418,42.1,591,175,416,42.1
26310, 울주군,085005, 84세,2016,557,149,408,36.5,554,149,405,36.8
26310, 울주군,090,85~89세,2016,1651,397,1254,31.7,1641,394,1247,31.6
26310, 울주군,090001, 85세,2016,445,120,325,36.9,442,119,323,36.8
26310, 울주군,090002, 86세,2016,373,81,292,27.7,370,81,289,28
26310, 울주군,090003, 87세,2016,332,89,243,36.6,331,88,243,36.2
26310, 울주군,090004, 88세,2016,289,65,224,29,288,64,224,28.6
26310, 울주군,090005, 89세,2016,212,42,170,24.7,210,42,168,25
26310, 울주군,095,90~94세,2016,517,87,430,20.2,513,85,428,19.9
26310, 울주군,095001, 90세,2016,166,27,139,19.4,165,26,139,18.7
26310, 울주군,095002, 91세,2016,134,20,114,17.5,132,19,113,16.8
26310, 울주군,095003, 92세,2016,89,12,77,15.6,89,12,77,15.6
26310, 울주군,095004, 93세,2016,76,17,59,28.8,76,17,59,28.8
26310, 울주군,095005, 94세,2016,52,11,41,26.8,51,11,40,27.5
26310, 울주군,100,95~99세,2016,94,16,78,20.5,93,15,78,19.2
26310, 울주군,100001, 95세,2016,42,8,34,23.5,42,8,34,23.5
26310, 울주군,100002, 96세,2016,21,X,18,16.7,21,X,18,16.7
26310, 울주군,100003, 97세,2016,11,X,11,0,11,X,11,0
26310, 울주군,100004, 98세,2016,12,X,9,33.3,11,X,9,22.2
26310, 울주군,100005, 99세,2016,8,X,6,33.3,8,X,6,33.3
26310, 울주군,101,100세이상,2016,13,X,13,0,13,X,13,0
26310, 울주군,102,15세미만,2016,32418,16661,15757,105.7,32065,16493,15572,105.9
26310, 울주군,103,15~64세,2016,164239,89173,75066,118.8,154300,82118,72182,113.8
26310, 울주군,104,65세이상,2016,25449,10591,14858,71.3,25226,10498,14728,71.3
26310, 울주군,086,85세이상,2016,2275,500,1775,28.2,2260,494,1766,28
26310, 울주군,126,평균연령,2016,39.9,38.6,41.3,,40,38.8,41.4,
26310, 울주군,127,중위연령,2016,41.4,39.8,42.9,,41.7,40.5,42.9,
29,세종특별자치시,000,합계,2016,242507,122648,119859,102.3,237672,119765,117907,101.6
29,세종특별자치시,005,0~4세,2016,16725,8632,8093,106.7,16658,8592,8066,106.5
29,세종특별자치시,005001, 0세,2016,3300,1698,1602,106,3290,1692,1598,105.9
29,세종특별자치시,005002, 1세,2016,3255,1714,1541,111.2,3240,1707,1533,111.4
29,세종특별자치시,005003, 2세,2016,3235,1674,1561,107.2,3221,1662,1559,106.6
29,세종특별자치시,005004, 3세,2016,3366,1708,1658,103,3350,1700,1650,103
29,세종특별자치시,005005, 4세,2016,3569,1838,1731,106.2,3557,1831,1726,106.1
29,세종특별자치시,010,5~9세,2016,17134,8603,8531,100.8,17094,8585,8509,100.9
29,세종특별자치시,010001, 5세,2016,3591,1779,1812,98.2,3586,1776,1810,98.1
29,세종특별자치시,010002, 6세,2016,3423,1747,1676,104.2,3406,1739,1667,104.3
29,세종특별자치시,010003, 7세,2016,3421,1732,1689,102.5,3416,1729,1687,102.5
29,세종특별자치시,010004, 8세,2016,3446,1736,1710,101.5,3438,1734,1704,101.8
29,세종특별자치시,010005, 9세,2016,3253,1609,1644,97.9,3248,1607,1641,97.9
29,세종특별자치시,015,10~14세,2016,14118,7103,7015,101.3,14104,7099,7005,101.3
29,세종특별자치시,015001, 10세,2016,3034,1550,1484,104.4,3029,1549,1480,104.7
29,세종특별자치시,015002, 11세,2016,2766,1382,1384,99.9,2764,1381,1383,99.9
29,세종특별자치시,015003, 12세,2016,2950,1471,1479,99.5,2948,1470,1478,99.5
29,세종특별자치시,015004, 13세,2016,2791,1398,1393,100.4,2791,1398,1393,100.4
29,세종특별자치시,015005, 14세,2016,2577,1302,1275,102.1,2572,1301,1271,102.4
29,세종특별자치시,020,15~19세,2016,14111,7183,6928,103.7,13955,7100,6855,103.6
29,세종특별자치시,020001, 15세,2016,2656,1327,1329,99.8,2649,1321,1328,99.5
29,세종특별자치시,020002, 16세,2016,2847,1415,1432,98.8,2841,1410,1431,98.5
29,세종특별자치시,020003, 17세,2016,2418,1183,1235,95.8,2409,1179,1230,95.9
29,세종특별자치시,020004, 18세,2016,2490,1257,1233,101.9,2434,1235,1199,103
29,세종특별자치시,020005, 19세,2016,3700,2001,1699,117.8,3622,1955,1667,117.3
29,세종특별자치시,025,20~24세,2016,17254,9452,7802,121.1,16686,9137,7549,121
29,세종특별자치시,025001, 20세,2016,3589,1773,1816,97.6,3489,1731,1758,98.5
29,세종특별자치시,025002, 21세,2016,3204,1603,1601,100.1,3114,1560,1554,100.4
29,세종특별자치시,025003, 22세,2016,3363,1841,1522,121,3276,1790,1486,120.5
29,세종특별자치시,025004, 23세,2016,3620,2191,1429,153.3,3476,2097,1379,152.1
29,세종특별자치시,025005, 24세,2016,3478,2044,1434,142.5,3331,1959,1372,142.8
29,세종특별자치시,030,25~29세,2016,14806,7947,6859,115.9,13914,7374,6540,112.8
29,세종특별자치시,030001, 25세,2016,3157,1857,1300,142.8,2997,1757,1240,141.7
29,세종특별자치시,030002, 26세,2016,2925,1625,1300,125,2739,1511,1228,123
29,세종특별자치시,030003, 27세,2016,2837,1510,1327,113.8,2649,1388,1261,110.1
29,세종특별자치시,030004, 28세,2016,2835,1463,1372,106.6,2650,1343,1307,102.8
29,세종특별자치시,030005, 29세,2016,3052,1492,1560,95.6,2879,1375,1504,91.4
29,세종특별자치시,035,30~34세,2016,19952,9779,10173,96.1,19155,9278,9877,93.9
29,세종특별자치시,035001, 30세,2016,3193,1618,1575,102.7,3022,1512,1510,100.1
29,세종특별자치시,035002, 31세,2016,3536,1752,1784,98.2,3354,1641,1713,95.8
29,세종특별자치시,035003, 32세,2016,3829,1901,1928,98.6,3674,1797,1877,95.7
29,세종특별자치시,035004, 33세,2016,4311,2025,2286,88.6,4164,1937,2227,87
29,세종특별자치시,035005, 34세,2016,5083,2483,2600,95.5,4941,2391,2550,93.8
29,세종특별자치시,040,35~39세,2016,24898,12290,12608,97.5,24347,11940,12407,96.2
29,세종특별자치시,040001, 35세,2016,5079,2461,2618,94,4969,2388,2581,92.5
29,세종특별자치시,040002, 36세,2016,5213,2542,2671,95.2,5083,2466,2617,94.2
29,세종특별자치시,040003, 37세,2016,5127,2546,2581,98.6,5007,2466,2541,97
29,세종특별자치시,040004, 38세,2016,4667,2336,2331,100.2,4574,2274,2300,98.9
29,세종특별자치시,040005, 39세,2016,4812,2405,2407,99.9,4714,2346,2368,99.1
29,세종특별자치시,045,40~44세,2016,23274,12194,11080,110.1,22851,11925,10926,109.1
29,세종특별자치시,045001, 40세,2016,4594,2298,2296,100.1,4499,2242,2257,99.3
29,세종특별자치시,045002, 41세,2016,4676,2387,2289,104.3,4581,2330,2251,103.5
29,세종특별자치시,045003, 42세,2016,4958,2605,2353,110.7,4859,2535,2324,109.1
29,세종특별자치시,045004, 43세,2016,4649,2478,2171,114.1,4588,2436,2152,113.2
29,세종특별자치시,045005, 44세,2016,4397,2426,1971,123.1,4324,2382,1942,122.7
29,세종특별자치시,050,45~49세,2016,18891,10272,8619,119.2,18501,10045,8456,118.8
29,세종특별자치시,050001, 45세,2016,4583,2499,2084,119.9,4491,2444,2047,119.4
29,세종특별자치시,050002, 46세,2016,3822,2182,1640,133,3744,2133,1611,132.4
29,세종특별자치시,050003, 47세,2016,3844,2113,1731,122.1,3761,2059,1702,121
29,세종특별자치시,050004, 48세,2016,3560,1869,1691,110.5,3487,1834,1653,110.9
29,세종특별자치시,050005, 49세,2016,3082,1609,1473,109.2,3018,1575,1443,109.1
29,세종특별자치시,055,50~54세,2016,14335,7558,6777,111.5,13951,7344,6607,111.2
29,세종특별자치시,055001, 50세,2016,2839,1490,1349,110.5,2767,1447,1320,109.6
29,세종특별자치시,055002, 51세,2016,3042,1625,1417,114.7,2965,1575,1390,113.3
29,세종특별자치시,055003, 52세,2016,2749,1458,1291,112.9,2662,1406,1256,111.9
29,세종특별자치시,055004, 53세,2016,2794,1474,1320,111.7,2708,1429,1279,111.7
29,세종특별자치시,055005, 54세,2016,2911,1511,1400,107.9,2849,1487,1362,109.2
29,세종특별자치시,060,55~59세,2016,13770,6953,6817,102,13517,6819,6698,101.8
29,세종특별자치시,060001, 55세,2016,3152,1585,1567,101.1,3106,1563,1543,101.3
29,세종특별자치시,060002, 56세,2016,3047,1567,1480,105.9,2980,1527,1453,105.1
29,세종특별자치시,060003, 57세,2016,2640,1309,1331,98.3,2598,1291,1307,98.8
29,세종특별자치시,060004, 58세,2016,2476,1263,1213,104.1,2429,1235,1194,103.4
29,세종특별자치시,060005, 59세,2016,2455,1229,1226,100.2,2404,1203,1201,100.2
29,세종특별자치시,065,60~64세,2016,10247,5070,5177,97.9,10079,4977,5102,97.5
29,세종특별자치시,065001, 60세,2016,2343,1189,1154,103,2310,1169,1141,102.5
29,세종특별자치시,065002, 61세,2016,2440,1220,1220,100,2387,1197,1190,100.6
29,세종특별자치시,065003, 62세,2016,1996,976,1020,95.7,1965,960,1005,95.5
29,세종특별자치시,065004, 63세,2016,1678,809,869,93.1,1645,790,855,92.4
29,세종특별자치시,065005, 64세,2016,1790,876,914,95.8,1772,861,911,94.5
29,세종특별자치시,070,65~69세,2016,7153,3436,3717,92.4,7078,3396,3682,92.2
29,세종특별자치시,070001, 65세,2016,1366,630,736,85.6,1347,620,727,85.3
29,세종특별자치시,070002, 66세,2016,1582,790,792,99.7,1561,779,782,99.6
29,세종특별자치시,070003, 67세,2016,1511,720,791,91,1497,711,786,90.5
29,세종특별자치시,070004, 68세,2016,1391,675,716,94.3,1379,671,708,94.8
29,세종특별자치시,070005, 69세,2016,1303,621,682,91.1,1294,615,679,90.6
29,세종특별자치시,075,70~74세,2016,5584,2528,3056,82.7,5560,2517,3043,82.7
29,세종특별자치시,075001, 70세,2016,1044,503,541,93,1036,496,540,91.9
29,세종특별자치시,075002, 71세,2016,1023,479,544,88.1,1019,478,541,88.4
29,세종특별자치시,075003, 72세,2016,1088,474,614,77.2,1085,472,613,77
29,세종특별자치시,075004, 73세,2016,1064,468,596,78.5,1057,468,589,79.5
29,세종특별자치시,075005, 74세,2016,1365,604,761,79.4,1363,603,760,79.3
29,세종특별자치시,080,75~79세,2016,4833,1954,2879,67.9,4817,1950,2867,68
29,세종특별자치시,080001, 75세,2016,1092,451,641,70.4,1091,451,640,70.5
29,세종특별자치시,080002, 76세,2016,997,404,593,68.1,995,404,591,68.4
29,세종특별자치시,080003, 77세,2016,992,400,592,67.6,988,397,591,67.2
29,세종특별자치시,080004, 78세,2016,930,378,552,68.5,924,377,547,68.9
29,세종특별자치시,080005, 79세,2016,822,321,501,64.1,819,321,498,64.5
29,세종특별자치시,085,80~84세,2016,3287,1155,2132,54.2,3275,1151,2124,54.2
29,세종특별자치시,085001, 80세,2016,808,314,494,63.6,804,311,493,63.1
29,세종특별자치시,085002, 81세,2016,741,273,468,58.3,739,273,466,58.6
29,세종특별자치시,085003, 82세,2016,668,248,420,59,665,248,417,59.5
29,세종특별자치시,085004, 83세,2016,586,173,413,41.9,584,172,412,41.7
29,세종특별자치시,085005, 84세,2016,484,147,337,43.6,483,147,336,43.8
29,세종특별자치시,090,85~89세,2016,1559,422,1137,37.1,1554,419,1135,36.9
29,세종특별자치시,090001, 85세,2016,397,123,274,44.9,395,121,274,44.2
29,세종특별자치시,090002, 86세,2016,362,98,264,37.1,362,98,264,37.1
29,세종특별자치시,090003, 87세,2016,317,88,229,38.4,317,88,229,38.4
29,세종특별자치시,090004, 88세,2016,266,59,207,28.5,264,59,205,28.8
29,세종특별자치시,090005, 89세,2016,217,54,163,33.1,216,53,163,32.5
29,세종특별자치시,095,90~94세,2016,468,102,366,27.9,468,102,366,27.9
29,세종특별자치시,095001, 90세,2016,129,31,98,31.6,129,31,98,31.6
29,세종특별자치시,095002, 91세,2016,113,21,92,22.8,113,21,92,22.8
29,세종특별자치시,095003, 92세,2016,87,22,65,33.8,87,22,65,33.8
29,세종특별자치시,095004, 93세,2016,73,14,59,23.7,73,14,59,23.7
29,세종특별자치시,095005, 94세,2016,66,14,52,26.9,66,14,52,26.9
29,세종특별자치시,100,95~99세,2016,87,15,72,20.8,87,15,72,20.8
29,세종특별자치시,100001, 95세,2016,38,9,29,31,38,9,29,31
29,세종특별자치시,100002, 96세,2016,13,X,10,30,13,X,10,30
29,세종특별자치시,100003, 97세,2016,18,X,15,20,18,X,15,20
29,세종특별자치시,100004, 98세,2016,10,X,10,0,10,X,10,0
29,세종특별자치시,100005, 99세,2016,8,X,8,0,8,X,8,0
29,세종특별자치시,101,100세이상,2016,21,X,21,0,21,X,21,0
29,세종특별자치시,102,15세미만,2016,47977,24338,23639,103,47856,24276,23580,103
29,세종특별자치시,103,15~64세,2016,171538,88698,82840,107.1,166956,85939,81017,106.1
29,세종특별자치시,104,65세이상,2016,22992,9612,13380,71.8,22860,9550,13310,71.8
29,세종특별자치시,086,85세이상,2016,2135,539,1596,33.8,2130,536,1594,33.6
29,세종특별자치시,126,평균연령,2016,36.1,35.4,36.9,,36.1,35.3,36.9,
29,세종특별자치시,127,중위연령,2016,36.4,36.1,36.7,,36.5,36.1,36.8,
29004, 읍부,000,합계,2016,54123,28452,25671,110.8,52816,27792,25024,111.1
29004, 읍부,005,0~4세,2016,2382,1251,1131,110.6,2353,1232,1121,109.9
29004, 읍부,005001, 0세,2016,446,244,202,120.8,444,242,202,119.8
29004, 읍부,005002, 1세,2016,452,248,204,121.6,448,245,203,120.7
29004, 읍부,005003, 2세,2016,478,248,230,107.8,471,242,229,105.7
29004, 읍부,005004, 3세,2016,489,250,239,104.6,480,245,235,104.3
29004, 읍부,005005, 4세,2016,517,261,256,102,510,258,252,102.4
29004, 읍부,010,5~9세,2016,2552,1297,1255,103.3,2539,1293,1246,103.8
29004, 읍부,010001, 5세,2016,517,277,240,115.4,516,277,239,115.9
29004, 읍부,010002, 6세,2016,516,257,259,99.2,511,256,255,100.4
29004, 읍부,010003, 7세,2016,473,237,236,100.4,471,236,235,100.4
29004, 읍부,010004, 8세,2016,564,281,283,99.3,561,280,281,99.6
29004, 읍부,010005, 9세,2016,482,245,237,103.4,480,244,236,103.4
29004, 읍부,015,10~14세,2016,2204,1110,1094,101.5,2201,1109,1092,101.6
29004, 읍부,015001, 10세,2016,439,221,218,101.4,439,221,218,101.4
29004, 읍부,015002, 11세,2016,431,213,218,97.7,429,212,217,97.7
29004, 읍부,015003, 12세,2016,444,225,219,102.7,444,225,219,102.7
29004, 읍부,015004, 13세,2016,434,222,212,104.7,434,222,212,104.7
29004, 읍부,015005, 14세,2016,456,229,227,100.9,455,229,226,101.3
29004, 읍부,020,15~19세,2016,4475,2424,2051,118.2,4398,2383,2015,118.3
29004, 읍부,020001, 15세,2016,478,245,233,105.2,476,243,233,104.3
29004, 읍부,020002, 16세,2016,525,274,251,109.2,524,273,251,108.8
29004, 읍부,020003, 17세,2016,546,282,264,106.8,540,280,260,107.7
29004, 읍부,020004, 18세,2016,946,507,439,115.5,916,494,422,117.1
29004, 읍부,020005, 19세,2016,1980,1116,864,129.2,1942,1093,849,128.7
29004, 읍부,025,20~24세,2016,7992,4421,3571,123.8,7854,4361,3493,124.8
29004, 읍부,025001, 20세,2016,1787,841,946,88.9,1755,827,928,89.1
29004, 읍부,025002, 21세,2016,1456,640,816,78.4,1432,629,803,78.3
29004, 읍부,025003, 22세,2016,1545,845,700,120.7,1533,842,691,121.9
29004, 읍부,025004, 23세,2016,1717,1097,620,176.9,1680,1077,603,178.6
29004, 읍부,025005, 24세,2016,1487,998,489,204.1,1454,986,468,210.7
29004, 읍부,030,25~29세,2016,4238,2677,1561,171.5,4040,2582,1458,177.1
29004, 읍부,030001, 25세,2016,1180,815,365,223.3,1146,796,350,227.4
29004, 읍부,030002, 26세,2016,946,620,326,190.2,899,592,307,192.8
29004, 읍부,030003, 27세,2016,762,469,293,160.1,717,453,264,171.6
29004, 읍부,030004, 28세,2016,696,408,288,141.7,654,388,266,145.9
29004, 읍부,030005, 29세,2016,654,365,289,126.3,624,353,271,130.3
29004, 읍부,035,30~34세,2016,3451,1834,1617,113.4,3297,1760,1537,114.5
29004, 읍부,035001, 30세,2016,620,329,291,113.1,585,315,270,116.7
29004, 읍부,035002, 31세,2016,688,367,321,114.3,646,345,301,114.6
29004, 읍부,035003, 32세,2016,647,363,284,127.8,623,354,269,131.6
29004, 읍부,035004, 33세,2016,701,358,343,104.4,673,345,328,105.2
29004, 읍부,035005, 34세,2016,795,417,378,110.3,770,401,369,108.7
29004, 읍부,040,35~39세,2016,3824,1998,1826,109.4,3721,1948,1773,109.9
29004, 읍부,040001, 35세,2016,764,420,344,122.1,749,412,337,122.3
29004, 읍부,040002, 36세,2016,819,428,391,109.5,796,418,378,110.6
29004, 읍부,040003, 37세,2016,777,389,388,100.3,755,379,376,100.8
29004, 읍부,040004, 38세,2016,703,362,341,106.2,686,354,332,106.6
29004, 읍부,040005, 39세,2016,761,399,362,110.2,735,385,350,110
29004, 읍부,045,40~44세,2016,3931,2104,1827,115.2,3822,2039,1783,114.4
29004, 읍부,045001, 40세,2016,721,368,353,104.2,696,355,341,104.1
29004, 읍부,045002, 41세,2016,713,381,332,114.8,690,368,322,114.3
29004, 읍부,045003, 42세,2016,842,483,359,134.5,817,464,353,131.4
29004, 읍부,045004, 43세,2016,834,434,400,108.5,818,425,393,108.1
29004, 읍부,045005, 44세,2016,821,438,383,114.4,801,427,374,114.2
29004, 읍부,050,45~49세,2016,3860,2074,1786,116.1,3742,2017,1725,116.9
29004, 읍부,050001, 45세,2016,851,466,385,121,826,449,377,119.1
29004, 읍부,050002, 46세,2016,726,407,319,127.6,714,403,311,129.6
29004, 읍부,050003, 47세,2016,833,448,385,116.4,803,431,372,115.9
29004, 읍부,050004, 48세,2016,763,406,357,113.7,735,395,340,116.2
29004, 읍부,050005, 49세,2016,687,347,340,102.1,664,339,325,104.3
29004, 읍부,055,50~54세,2016,3398,1780,1618,110,3251,1699,1552,109.5
29004, 읍부,055001, 50세,2016,643,331,312,106.1,618,320,298,107.4
29004, 읍부,055002, 51세,2016,698,356,342,104.1,673,341,332,102.7
29004, 읍부,055003, 52세,2016,660,370,290,127.6,625,347,278,124.8
29004, 읍부,055004, 53세,2016,689,356,333,106.9,651,337,314,107.3
29004, 읍부,055005, 54세,2016,708,367,341,107.6,684,354,330,107.3
29004, 읍부,060,55~59세,2016,3362,1714,1648,104,3261,1662,1599,103.9
29004, 읍부,060001, 55세,2016,775,407,368,110.6,759,401,358,112
29004, 읍부,060002, 56세,2016,753,391,362,108,727,374,353,105.9
29004, 읍부,060003, 57세,2016,621,301,320,94.1,606,294,312,94.2
29004, 읍부,060004, 58세,2016,593,309,284,108.8,568,297,271,109.6
29004, 읍부,060005, 59세,2016,620,306,314,97.5,601,296,305,97
29004, 읍부,065,60~64세,2016,2572,1306,1266,103.2,2494,1264,1230,102.8
29004, 읍부,065001, 60세,2016,555,296,259,114.3,541,290,251,115.5
29004, 읍부,065002, 61세,2016,628,317,311,101.9,601,303,298,101.7
29004, 읍부,065003, 62세,2016,489,233,256,91,480,229,251,91.2
29004, 읍부,065004, 63세,2016,452,220,232,94.8,433,210,223,94.2
29004, 읍부,065005, 64세,2016,448,240,208,115.4,439,232,207,112.1
29004, 읍부,070,65~69세,2016,1822,853,969,88,1795,838,957,87.6
29004, 읍부,070001, 65세,2016,341,152,189,80.4,334,147,187,78.6
29004, 읍부,070002, 66세,2016,406,192,214,89.7,399,188,211,89.1
29004, 읍부,070003, 67세,2016,383,176,207,85,376,173,203,85.2
29004, 읍부,070004, 68세,2016,359,177,182,97.3,355,175,180,97.2
29004, 읍부,070005, 69세,2016,333,156,177,88.1,331,155,176,88.1
29004, 읍부,075,70~74세,2016,1487,657,830,79.2,1480,654,826,79.2
29004, 읍부,075001, 70세,2016,273,121,152,79.6,270,118,152,77.6
29004, 읍부,075002, 71세,2016,277,128,149,85.9,276,128,148,86.5
29004, 읍부,075003, 72세,2016,290,120,170,70.6,290,120,170,70.6
29004, 읍부,075004, 73세,2016,312,141,171,82.5,310,141,169,83.4
29004, 읍부,075005, 74세,2016,335,147,188,78.2,334,147,187,78.6
29004, 읍부,080,75~79세,2016,1266,542,724,74.9,1263,541,722,74.9
29004, 읍부,080001, 75세,2016,316,138,178,77.5,316,138,178,77.5
29004, 읍부,080002, 76세,2016,257,114,143,79.7,257,114,143,79.7
29004, 읍부,080003, 77세,2016,274,108,166,65.1,273,107,166,64.5
29004, 읍부,080004, 78세,2016,238,102,136,75,237,102,135,75.6
29004, 읍부,080005, 79세,2016,181,80,101,79.2,180,80,100,80
29004, 읍부,085,80~84세,2016,762,263,499,52.7,761,263,498,52.8
29004, 읍부,085001, 80세,2016,198,77,121,63.6,198,77,121,63.6
29004, 읍부,085002, 81세,2016,193,64,129,49.6,192,64,128,50
29004, 읍부,085003, 82세,2016,140,57,83,68.7,140,57,83,68.7
29004, 읍부,085004, 83세,2016,119,34,85,40,119,34,85,40
29004, 읍부,085005, 84세,2016,112,31,81,38.3,112,31,81,38.3
29004, 읍부,090,85~89세,2016,398,112,286,39.2,397,112,285,39.3
29004, 읍부,090001, 85세,2016,99,33,66,50,99,33,66,50
29004, 읍부,090002, 86세,2016,90,30,60,50,90,30,60,50
29004, 읍부,090003, 87세,2016,78,21,57,36.8,78,21,57,36.8
29004, 읍부,090004, 88세,2016,66,11,55,20,65,11,54,20.4
29004, 읍부,090005, 89세,2016,65,17,48,35.4,65,17,48,35.4
29004, 읍부,095,90~94세,2016,124,32,92,34.8,124,32,92,34.8
29004, 읍부,095001, 90세,2016,31,6,25,24,31,6,25,24
29004, 읍부,095002, 91세,2016,35,X,31,12.9,35,X,31,12.9
29004, 읍부,095003, 92세,2016,27,11,16,68.8,27,11,16,68.8
29004, 읍부,095004, 93세,2016,15,5,10,50,15,5,10,50
29004, 읍부,095005, 94세,2016,16,6,10,60,16,6,10,60
29004, 읍부,100,95~99세,2016,19,X,16,18.8,19,X,16,18.8
29004, 읍부,100001, 95세,2016,9,X,6,50,9,X,6,50
29004, 읍부,100002, 96세,2016,X,X,X,0,X,X,X,0
29004, 읍부,100003, 97세,2016,X,X,X,0,X,X,X,0
29004, 읍부,100004, 98세,2016,X,X,X,0,X,X,X,0
29004, 읍부,100005, 99세,2016,X,X,X,0,X,X,X,0
29004, 읍부,101,100세이상,2016,X,X,X,0,X,X,X,0
29004, 읍부,102,15세미만,2016,7138,3658,3480,105.1,7093,3634,3459,105.1
29004, 읍부,103,15~64세,2016,41103,22332,18771,119,39880,21715,18165,119.5
29004, 읍부,104,65세이상,2016,5882,2462,3420,72,5843,2443,3400,71.9
29004, 읍부,086,85세이상,2016,545,147,398,36.9,544,147,397,37
29004, 읍부,126,평균연령,2016,37.1,35.9,38.4,,37,35.8,38.4,
29004, 읍부,127,중위연령,2016,34.7,33,36.5,,34.6,32.8,36.6,
29005, 면부,000,합계,2016,52410,27978,24432,114.5,49776,26177,23599,110.9
29005, 면부,005,0~4세,2016,1337,689,648,106.3,1320,679,641,105.9
29005, 면부,005001, 0세,2016,309,159,150,106,306,156,150,104
29005, 면부,005002, 1세,2016,258,143,115,124.3,254,143,111,128.8
29005, 면부,005003, 2세,2016,241,114,127,89.8,238,111,127,87.4
29005, 면부,005004, 3세,2016,257,133,124,107.3,252,131,121,108.3
29005, 면부,005005, 4세,2016,272,140,132,106.1,270,138,132,104.5
29005, 면부,010,5~9세,2016,1301,631,670,94.2,1287,622,665,93.5
29005, 면부,010001, 5세,2016,251,107,144,74.3,249,105,144,72.9
29005, 면부,010002, 6세,2016,262,128,134,95.5,256,124,132,93.9
29005, 면부,010003, 7세,2016,241,111,130,85.4,239,109,130,83.8
29005, 면부,010004, 8세,2016,298,152,146,104.1,296,151,145,104.1
29005, 면부,010005, 9세,2016,249,133,116,114.7,247,133,114,116.7
29005, 면부,015,10~14세,2016,1351,702,649,108.2,1346,701,645,108.7
29005, 면부,015001, 10세,2016,255,126,129,97.7,252,125,127,98.4
29005, 면부,015002, 11세,2016,249,123,126,97.6,249,123,126,97.6
29005, 면부,015003, 12세,2016,282,137,145,94.5,282,137,145,94.5
29005, 면부,015004, 13세,2016,280,156,124,125.8,280,156,124,125.8
29005, 면부,015005, 14세,2016,285,160,125,128,283,160,123,130.1
29005, 면부,020,15~19세,2016,2543,1320,1223,107.9,2473,1284,1189,108
29005, 면부,020001, 15세,2016,369,225,144,156.3,368,224,144,155.6
29005, 면부,020002, 16세,2016,344,204,140,145.7,340,201,139,144.6
29005, 면부,020003, 17세,2016,357,189,168,112.5,354,187,167,112
29005, 면부,020004, 18세,2016,522,256,266,96.2,497,248,249,99.6
29005, 면부,020005, 19세,2016,951,446,505,88.3,914,424,490,86.5
29005, 면부,025,20~24세,2016,4661,2613,2048,127.6,4300,2379,1921,123.8
29005, 면부,025001, 20세,2016,935,411,524,78.4,872,383,489,78.3
29005, 면부,025002, 21세,2016,838,402,436,92.2,777,371,406,91.4
29005, 면부,025003, 22세,2016,909,511,398,128.4,849,467,382,122.3
29005, 면부,025004, 23세,2016,1024,673,351,191.7,936,605,331,182.8
29005, 면부,025005, 24세,2016,955,616,339,181.7,866,553,313,176.7
29005, 면부,030,25~29세,2016,3977,2566,1411,181.9,3452,2168,1284,168.8
29005, 면부,030001, 25세,2016,940,619,321,192.8,837,546,291,187.6
29005, 면부,030002, 26세,2016,835,546,289,188.9,731,473,258,183.3
29005, 면부,030003, 27세,2016,783,498,285,174.7,677,414,263,157.4
29005, 면부,030004, 28세,2016,711,455,256,177.7,604,373,231,161.5
29005, 면부,030005, 29세,2016,708,448,260,172.3,603,362,241,150.2
29005, 면부,035,30~34세,2016,3117,1917,1200,159.8,2651,1577,1074,146.8
29005, 면부,035001, 30세,2016,651,414,237,174.7,555,345,210,164.3
29005, 면부,035002, 31세,2016,600,387,213,181.7,497,315,182,173.1
29005, 면부,035003, 32세,2016,607,379,228,166.2,512,302,210,143.8
29005, 면부,035004, 33세,2016,599,343,256,134,510,282,228,123.7
29005, 면부,035005, 34세,2016,660,394,266,148.1,577,333,244,136.5
29005, 면부,040,35~39세,2016,3023,1868,1155,161.7,2698,1635,1063,153.8
29005, 면부,040001, 35세,2016,638,381,257,148.2,568,328,240,136.7
29005, 면부,040002, 36세,2016,637,385,252,152.8,557,332,225,147.6
29005, 면부,040003, 37세,2016,595,375,220,170.5,525,322,203,158.6
29005, 면부,040004, 38세,2016,577,375,202,185.6,522,334,188,177.7
29005, 면부,040005, 39세,2016,576,352,224,157.1,526,319,207,154.1
29005, 면부,045,40~44세,2016,3125,1922,1203,159.8,2885,1756,1129,155.5
29005, 면부,045001, 40세,2016,581,337,244,138.1,535,306,229,133.6
29005, 면부,045002, 41세,2016,593,362,231,156.7,538,326,212,153.8
29005, 면부,045003, 42세,2016,674,432,242,178.5,612,386,226,170.8
29005, 면부,045004, 43세,2016,655,398,257,154.9,622,373,249,149.8
29005, 면부,045005, 44세,2016,622,393,229,171.6,578,365,213,171.4
29005, 면부,050,45~49세,2016,3736,2163,1573,137.5,3527,2027,1500,135.1
29005, 면부,050001, 45세,2016,757,465,292,159.2,706,435,271,160.5
29005, 면부,050002, 46세,2016,704,434,270,160.7,655,400,255,156.9
29005, 면부,050003, 47세,2016,769,465,304,153,726,432,294,146.9
29005, 면부,050004, 48세,2016,770,403,367,109.8,737,386,351,110
29005, 면부,050005, 49세,2016,736,396,340,116.5,703,374,329,113.7
29005, 면부,055,50~54세,2016,4157,2313,1844,125.4,3974,2196,1778,123.5
29005, 면부,055001, 50세,2016,729,413,316,130.7,689,385,304,126.6
29005, 면부,055002, 51세,2016,884,526,358,146.9,843,495,348,142.2
29005, 면부,055003, 52세,2016,798,440,358,122.9,759,414,345,120
29005, 면부,055004, 53세,2016,824,451,373,120.9,788,427,361,118.3
29005, 면부,055005, 54세,2016,922,483,439,110,895,475,420,113.1
29005, 면부,060,55~59세,2016,4689,2464,2225,110.7,4593,2412,2181,110.6
29005, 면부,060001, 55세,2016,1034,533,501,106.4,1013,521,492,105.9
29005, 면부,060002, 56세,2016,1012,557,455,122.4,987,542,445,121.8
29005, 면부,060003, 57세,2016,926,475,451,105.3,910,469,441,106.3
29005, 면부,060004, 58세,2016,851,461,390,118.2,837,450,387,116.3
29005, 면부,060005, 59세,2016,866,438,428,102.3,846,430,416,103.4
29005, 면부,065,60~64세,2016,3996,2046,1950,104.9,3936,2008,1928,104.1
29005, 면부,065001, 60세,2016,906,465,441,105.4,892,454,438,103.7
29005, 면부,065002, 61세,2016,915,474,441,107.5,901,467,434,107.6
29005, 면부,065003, 62세,2016,814,424,390,108.7,796,413,383,107.8
29005, 면부,065004, 63세,2016,638,327,311,105.1,630,322,308,104.5
29005, 면부,065005, 64세,2016,723,356,367,97,717,352,365,96.4
29005, 면부,070,65~69세,2016,3011,1514,1497,101.1,2976,1495,1481,100.9
29005, 면부,070001, 65세,2016,564,298,266,112,556,295,261,113
29005, 면부,070002, 66세,2016,666,359,307,116.9,656,353,303,116.5
29005, 면부,070003, 67세,2016,656,317,339,93.5,651,312,339,92
29005, 면부,070004, 68세,2016,584,278,306,90.8,578,277,301,92
29005, 면부,070005, 69세,2016,541,262,279,93.9,535,258,277,93.1
29005, 면부,075,70~74세,2016,2621,1193,1428,83.5,2611,1187,1424,83.4
29005, 면부,075001, 70세,2016,457,220,237,92.8,453,217,236,91.9
29005, 면부,075002, 71세,2016,446,213,233,91.4,443,212,231,91.8
29005, 면부,075003, 72세,2016,523,222,301,73.8,522,221,301,73.4
29005, 면부,075004, 73세,2016,487,217,270,80.4,486,217,269,80.7
29005, 면부,075005, 74세,2016,708,321,387,82.9,707,320,387,82.7
29005, 면부,080,75~79세,2016,2619,1037,1582,65.5,2610,1034,1576,65.6
29005, 면부,080001, 75세,2016,545,214,331,64.7,545,214,331,64.7
29005, 면부,080002, 76세,2016,536,208,328,63.4,535,208,327,63.6
29005, 면부,080003, 77세,2016,531,217,314,69.1,528,215,313,68.7
29005, 면부,080004, 78세,2016,522,211,311,67.8,518,210,308,68.2
29005, 면부,080005, 79세,2016,485,187,298,62.8,484,187,297,63
29005, 면부,085,80~84세,2016,1943,714,1229,58.1,1936,712,1224,58.2
29005, 면부,085001, 80세,2016,468,187,281,66.5,466,186,280,66.4
29005, 면부,085002, 81세,2016,428,175,253,69.2,428,175,253,69.2
29005, 면부,085003, 82세,2016,404,153,251,61,402,153,249,61.4
29005, 면부,085004, 83세,2016,362,113,249,45.4,360,112,248,45.2
29005, 면부,085005, 84세,2016,281,86,195,44.1,280,86,194,44.3
29005, 면부,090,85~89세,2016,876,248,628,39.5,874,247,627,39.4
29005, 면부,090001, 85세,2016,227,74,153,48.4,227,74,153,48.4
29005, 면부,090002, 86세,2016,198,53,145,36.6,198,53,145,36.6
29005, 면부,090003, 87세,2016,178,49,129,38,178,49,129,38
29005, 면부,090004, 88세,2016,153,40,113,35.4,152,40,112,35.7
29005, 면부,090005, 89세,2016,120,32,88,36.4,119,31,88,35.2
29005, 면부,095,90~94세,2016,258,49,209,23.4,258,49,209,23.4
29005, 면부,095001, 90세,2016,76,20,56,35.7,76,20,56,35.7
29005, 면부,095002, 91세,2016,61,12,49,24.5,61,12,49,24.5
29005, 면부,095003, 92세,2016,44,6,38,15.8,44,6,38,15.8
29005, 면부,095004, 93세,2016,38,6,32,18.8,38,6,32,18.8
29005, 면부,095005, 94세,2016,39,5,34,14.7,39,5,34,14.7
29005, 면부,100,95~99세,2016,55,9,46,19.6,55,9,46,19.6
29005, 면부,100001, 95세,2016,26,5,21,23.8,26,5,21,23.8
29005, 면부,100002, 96세,2016,7,X,5,40,7,X,5,40
29005, 면부,100003, 97세,2016,13,X,11,18.2,13,X,11,18.2
29005, 면부,100004, 98세,2016,6,X,6,0,6,X,6,0
29005, 면부,100005, 99세,2016,X,X,X,0,X,X,X,0
29005, 면부,101,100세이상,2016,14,X,14,0,14,X,14,0
29005, 면부,102,15세미만,2016,3989,2022,1967,102.8,3953,2002,1951,102.6
29005, 면부,103,15~64세,2016,37024,21192,15832,133.9,34489,19442,15047,129.2
29005, 면부,104,65세이상,2016,11397,4764,6633,71.8,11334,4733,6601,71.7
29005, 면부,086,85세이상,2016,1203,306,897,34.1,1201,305,896,34
29005, 면부,126,평균연령,2016,46.1,44,48.5,,46.6,44.6,48.9,
29005, 면부,127,중위연령,2016,47.4,44.4,51.3,,48.5,45.7,52.1,
29003, 동부,000,합계,2016,135974,66218,69756,94.9,135080,65796,69284,95
29003, 동부,005,0~4세,2016,13006,6692,6314,106,12985,6681,6304,106
29003, 동부,005001, 0세,2016,2545,1295,1250,103.6,2540,1294,1246,103.9
29003, 동부,005002, 1세,2016,2545,1323,1222,108.3,2538,1319,1219,108.2
29003, 동부,005003, 2세,2016,2516,1312,1204,109,2512,1309,1203,108.8
29003, 동부,005004, 3세,2016,2620,1325,1295,102.3,2618,1324,1294,102.3
29003, 동부,005005, 4세,2016,2780,1437,1343,107,2777,1435,1342,106.9
29003, 동부,010,5~9세,2016,13281,6675,6606,101,13268,6670,6598,101.1
29003, 동부,010001, 5세,2016,2823,1395,1428,97.7,2821,1394,1427,97.7
29003, 동부,010002, 6세,2016,2645,1362,1283,106.2,2639,1359,1280,106.2
29003, 동부,010003, 7세,2016,2707,1384,1323,104.6,2706,1384,1322,104.7
29003, 동부,010004, 8세,2016,2584,1303,1281,101.7,2581,1303,1278,102
29003, 동부,010005, 9세,2016,2522,1231,1291,95.4,2521,1230,1291,95.3
29003, 동부,015,10~14세,2016,10563,5291,5272,100.4,10557,5289,5268,100.4
29003, 동부,015001, 10세,2016,2340,1203,1137,105.8,2338,1203,1135,106
29003, 동부,015002, 11세,2016,2086,1046,1040,100.6,2086,1046,1040,100.6
29003, 동부,015003, 12세,2016,2224,1109,1115,99.5,2222,1108,1114,99.5
29003, 동부,015004, 13세,2016,2077,1020,1057,96.5,2077,1020,1057,96.5
29003, 동부,015005, 14세,2016,1836,913,923,98.9,1834,912,922,98.9
29003, 동부,020,15~19세,2016,7093,3439,3654,94.1,7084,3433,3651,94
29003, 동부,020001, 15세,2016,1809,857,952,90,1805,854,951,89.8
29003, 동부,020002, 16세,2016,1978,937,1041,90,1977,936,1041,89.9
29003, 동부,020003, 17세,2016,1515,712,803,88.7,1515,712,803,88.7
29003, 동부,020004, 18세,2016,1022,494,528,93.6,1021,493,528,93.4
29003, 동부,020005, 19세,2016,769,439,330,133,766,438,328,133.5
29003, 동부,025,20~24세,2016,4601,2418,2183,110.8,4532,2397,2135,112.3
29003, 동부,025001, 20세,2016,867,521,346,150.6,862,521,341,152.8
29003, 동부,025002, 21세,2016,910,561,349,160.7,905,560,345,162.3
29003, 동부,025003, 22세,2016,909,485,424,114.4,894,481,413,116.5
29003, 동부,025004, 23세,2016,879,421,458,91.9,860,415,445,93.3
29003, 동부,025005, 24세,2016,1036,430,606,71,1011,420,591,71.1
29003, 동부,030,25~29세,2016,6591,2704,3887,69.6,6422,2624,3798,69.1
29003, 동부,030001, 25세,2016,1037,423,614,68.9,1014,415,599,69.3
29003, 동부,030002, 26세,2016,1144,459,685,67,1109,446,663,67.3
29003, 동부,030003, 27세,2016,1292,543,749,72.5,1255,521,734,71
29003, 동부,030004, 28세,2016,1428,600,828,72.5,1392,582,810,71.9
29003, 동부,030005, 29세,2016,1690,679,1011,67.2,1652,660,992,66.5
29003, 동부,035,30~34세,2016,13384,6028,7356,81.9,13207,5941,7266,81.8
29003, 동부,035001, 30세,2016,1922,875,1047,83.6,1882,852,1030,82.7
29003, 동부,035002, 31세,2016,2248,998,1250,79.8,2211,981,1230,79.8
29003, 동부,035003, 32세,2016,2575,1159,1416,81.9,2539,1141,1398,81.6
29003, 동부,035004, 33세,2016,3011,1324,1687,78.5,2981,1310,1671,78.4
29003, 동부,035005, 34세,2016,3628,1672,1956,85.5,3594,1657,1937,85.5
29003, 동부,040,35~39세,2016,18051,8424,9627,87.5,17928,8357,9571,87.3
29003, 동부,040001, 35세,2016,3677,1660,2017,82.3,3652,1648,2004,82.2
29003, 동부,040002, 36세,2016,3757,1729,2028,85.3,3730,1716,2014,85.2
29003, 동부,040003, 37세,2016,3755,1782,1973,90.3,3727,1765,1962,90
29003, 동부,040004, 38세,2016,3387,1599,1788,89.4,3366,1586,1780,89.1
29003, 동부,040005, 39세,2016,3475,1654,1821,90.8,3453,1642,1811,90.7
29003, 동부,045,40~44세,2016,16218,8168,8050,101.5,16144,8130,8014,101.4
29003, 동부,045001, 40세,2016,3292,1593,1699,93.8,3268,1581,1687,93.7
29003, 동부,045002, 41세,2016,3370,1644,1726,95.2,3353,1636,1717,95.3
29003, 동부,045003, 42세,2016,3442,1690,1752,96.5,3430,1685,1745,96.6
29003, 동부,045004, 43세,2016,3160,1646,1514,108.7,3148,1638,1510,108.5
29003, 동부,045005, 44세,2016,2954,1595,1359,117.4,2945,1590,1355,117.3
29003, 동부,050,45~49세,2016,11295,6035,5260,114.7,11232,6001,5231,114.7
29003, 동부,050001, 45세,2016,2975,1568,1407,111.4,2959,1560,1399,111.5
29003, 동부,050002, 46세,2016,2392,1341,1051,127.6,2375,1330,1045,127.3
29003, 동부,050003, 47세,2016,2242,1200,1042,115.2,2232,1196,1036,115.4
29003, 동부,050004, 48세,2016,2027,1060,967,109.6,2015,1053,962,109.5
29003, 동부,050005, 49세,2016,1659,866,793,109.2,1651,862,789,109.3
29003, 동부,055,50~54세,2016,6780,3465,3315,104.5,6726,3449,3277,105.2
29003, 동부,055001, 50세,2016,1467,746,721,103.5,1460,742,718,103.3
29003, 동부,055002, 51세,2016,1460,743,717,103.6,1449,739,710,104.1
29003, 동부,055003, 52세,2016,1291,648,643,100.8,1278,645,633,101.9
29003, 동부,055004, 53세,2016,1281,667,614,108.6,1269,665,604,110.1
29003, 동부,055005, 54세,2016,1281,661,620,106.6,1270,658,612,107.5
29003, 동부,060,55~59세,2016,5719,2775,2944,94.3,5663,2745,2918,94.1
29003, 동부,060001, 55세,2016,1343,645,698,92.4,1334,641,693,92.5
29003, 동부,060002, 56세,2016,1282,619,663,93.4,1266,611,655,93.3
29003, 동부,060003, 57세,2016,1093,533,560,95.2,1082,528,554,95.3
29003, 동부,060004, 58세,2016,1032,493,539,91.5,1024,488,536,91
29003, 동부,060005, 59세,2016,969,485,484,100.2,957,477,480,99.4
29003, 동부,065,60~64세,2016,3679,1718,1961,87.6,3649,1705,1944,87.7
29003, 동부,065001, 60세,2016,882,428,454,94.3,877,425,452,94
29003, 동부,065002, 61세,2016,897,429,468,91.7,885,427,458,93.2
29003, 동부,065003, 62세,2016,693,319,374,85.3,689,318,371,85.7
29003, 동부,065004, 63세,2016,588,262,326,80.4,582,258,324,79.6
29003, 동부,065005, 64세,2016,619,280,339,82.6,616,277,339,81.7
29003, 동부,070,65~69세,2016,2320,1069,1251,85.5,2307,1063,1244,85.5
29003, 동부,070001, 65세,2016,461,180,281,64.1,457,178,279,63.8
29003, 동부,070002, 66세,2016,510,239,271,88.2,506,238,268,88.8
29003, 동부,070003, 67세,2016,472,227,245,92.7,470,226,244,92.6
29003, 동부,070004, 68세,2016,448,220,228,96.5,446,219,227,96.5
29003, 동부,070005, 69세,2016,429,203,226,89.8,428,202,226,89.4
29003, 동부,075,70~74세,2016,1476,678,798,85,1469,676,793,85.2
29003, 동부,075001, 70세,2016,314,162,152,106.6,313,161,152,105.9
29003, 동부,075002, 71세,2016,300,138,162,85.2,300,138,162,85.2
29003, 동부,075003, 72세,2016,275,132,143,92.3,273,131,142,92.3
29003, 동부,075004, 73세,2016,265,110,155,71,261,110,151,72.8
29003, 동부,075005, 74세,2016,322,136,186,73.1,322,136,186,73.1
29003, 동부,080,75~79세,2016,948,375,573,65.4,944,375,569,65.9
29003, 동부,080001, 75세,2016,231,99,132,75,230,99,131,75.6
29003, 동부,080002, 76세,2016,204,82,122,67.2,203,82,121,67.8
29003, 동부,080003, 77세,2016,187,75,112,67,187,75,112,67
29003, 동부,080004, 78세,2016,170,65,105,61.9,169,65,104,62.5
29003, 동부,080005, 79세,2016,156,54,102,52.9,155,54,101,53.5
29003, 동부,085,80~84세,2016,582,178,404,44.1,578,176,402,43.8
29003, 동부,085001, 80세,2016,142,50,92,54.3,140,48,92,52.2
29003, 동부,085002, 81세,2016,120,34,86,39.5,119,34,85,40
29003, 동부,085003, 82세,2016,124,38,86,44.2,123,38,85,44.7
29003, 동부,085004, 83세,2016,105,26,79,32.9,105,26,79,32.9
29003, 동부,085005, 84세,2016,91,30,61,49.2,91,30,61,49.2
29003, 동부,090,85~89세,2016,285,62,223,27.8,283,60,223,26.9
29003, 동부,090001, 85세,2016,71,16,55,29.1,69,14,55,25.5
29003, 동부,090002, 86세,2016,74,15,59,25.4,74,15,59,25.4
29003, 동부,090003, 87세,2016,61,18,43,41.9,61,18,43,41.9
29003, 동부,090004, 88세,2016,47,8,39,20.5,47,8,39,20.5
29003, 동부,090005, 89세,2016,32,5,27,18.5,32,5,27,18.5
29003, 동부,095,90~94세,2016,86,21,65,32.3,86,21,65,32.3
29003, 동부,095001, 90세,2016,22,5,17,29.4,22,5,17,29.4
29003, 동부,095002, 91세,2016,17,5,12,41.7,17,5,12,41.7
29003, 동부,095003, 92세,2016,16,5,11,45.5,16,5,11,45.5
29003, 동부,095004, 93세,2016,20,X,17,17.6,20,X,17,17.6
29003, 동부,095005, 94세,2016,11,X,8,37.5,11,X,8,37.5
29003, 동부,100,95~99세,2016,13,X,10,30,13,X,10,30
29003, 동부,100001, 95세,2016,X,X,X,50,X,X,X,50
29003, 동부,100002, 96세,2016,X,X,X,33.3,X,X,X,33.3
29003, 동부,100003, 97세,2016,X,X,X,100,X,X,X,100
29003, 동부,100004, 98세,2016,X,X,X,0,X,X,X,0
29003, 동부,100005, 99세,2016,X,X,X,0,X,X,X,0
29003, 동부,101,100세이상,2016,X,X,X,0,X,X,X,0
29003, 동부,102,15세미만,2016,36850,18658,18192,102.6,36810,18640,18170,102.6
29003, 동부,103,15~64세,2016,93411,45174,48237,93.7,92587,44782,47805,93.7
29003, 동부,104,65세이상,2016,5713,2386,3327,71.7,5683,2374,3309,71.7
29003, 동부,086,85세이상,2016,387,86,301,28.6,385,84,301,27.9
29003, 동부,126,평균연령,2016,31.9,31.5,32.3,,31.9,31.5,32.3,
29003, 동부,127,중위연령,2016,34.9,34.9,34.8,,34.9,34.9,34.8,
29010, 세종시,000,합계,2016,242507,122648,119859,102.3,237672,119765,117907,101.6
29010, 세종시,005,0~4세,2016,16725,8632,8093,106.7,16658,8592,8066,106.5
29010, 세종시,005001, 0세,2016,3300,1698,1602,106,3290,1692,1598,105.9
29010, 세종시,005002, 1세,2016,3255,1714,1541,111.2,3240,1707,1533,111.4
29010, 세종시,005003, 2세,2016,3235,1674,1561,107.2,3221,1662,1559,106.6
29010, 세종시,005004, 3세,2016,3366,1708,1658,103,3350,1700,1650,103
29010, 세종시,005005, 4세,2016,3569,1838,1731,106.2,3557,1831,1726,106.1
29010, 세종시,010,5~9세,2016,17134,8603,8531,100.8,17094,8585,8509,100.9
29010, 세종시,010001, 5세,2016,3591,1779,1812,98.2,3586,1776,1810,98.1
29010, 세종시,010002, 6세,2016,3423,1747,1676,104.2,3406,1739,1667,104.3
29010, 세종시,010003, 7세,2016,3421,1732,1689,102.5,3416,1729,1687,102.5
29010, 세종시,010004, 8세,2016,3446,1736,1710,101.5,3438,1734,1704,101.8
29010, 세종시,010005, 9세,2016,3253,1609,1644,97.9,3248,1607,1641,97.9
29010, 세종시,015,10~14세,2016,14118,7103,7015,101.3,14104,7099,7005,101.3
29010, 세종시,015001, 10세,2016,3034,1550,1484,104.4,3029,1549,1480,104.7
29010, 세종시,015002, 11세,2016,2766,1382,1384,99.9,2764,1381,1383,99.9
29010, 세종시,015003, 12세,2016,2950,1471,1479,99.5,2948,1470,1478,99.5
29010, 세종시,015004, 13세,2016,2791,1398,1393,100.4,2791,1398,1393,100.4
29010, 세종시,015005, 14세,2016,2577,1302,1275,102.1,2572,1301,1271,102.4
29010, 세종시,020,15~19세,2016,14111,7183,6928,103.7,13955,7100,6855,103.6
29010, 세종시,020001, 15세,2016,2656,1327,1329,99.8,2649,1321,1328,99.5
29010, 세종시,020002, 16세,2016,2847,1415,1432,98.8,2841,1410,1431,98.5
29010, 세종시,020003, 17세,2016,2418,1183,1235,95.8,2409,1179,1230,95.9
29010, 세종시,020004, 18세,2016,2490,1257,1233,101.9,2434,1235,1199,103
29010, 세종시,020005, 19세,2016,3700,2001,1699,117.8,3622,1955,1667,117.3
29010, 세종시,025,20~24세,2016,17254,9452,7802,121.1,16686,9137,7549,121
29010, 세종시,025001, 20세,2016,3589,1773,1816,97.6,3489,1731,1758,98.5
29010, 세종시,025002, 21세,2016,3204,1603,1601,100.1,3114,1560,1554,100.4
29010, 세종시,025003, 22세,2016,3363,1841,1522,121,3276,1790,1486,120.5
29010, 세종시,025004, 23세,2016,3620,2191,1429,153.3,3476,2097,1379,152.1
29010, 세종시,025005, 24세,2016,3478,2044,1434,142.5,3331,1959,1372,142.8
29010, 세종시,030,25~29세,2016,14806,7947,6859,115.9,13914,7374,6540,112.8
29010, 세종시,030001, 25세,2016,3157,1857,1300,142.8,2997,1757,1240,141.7
29010, 세종시,030002, 26세,2016,2925,1625,1300,125,2739,1511,1228,123
29010, 세종시,030003, 27세,2016,2837,1510,1327,113.8,2649,1388,1261,110.1
29010, 세종시,030004, 28세,2016,2835,1463,1372,106.6,2650,1343,1307,102.8
29010, 세종시,030005, 29세,2016,3052,1492,1560,95.6,2879,1375,1504,91.4
29010, 세종시,035,30~34세,2016,19952,9779,10173,96.1,19155,9278,9877,93.9
29010, 세종시,035001, 30세,2016,3193,1618,1575,102.7,3022,1512,1510,100.1
29010, 세종시,035002, 31세,2016,3536,1752,1784,98.2,3354,1641,1713,95.8
29010, 세종시,035003, 32세,2016,3829,1901,1928,98.6,3674,1797,1877,95.7
29010, 세종시,035004, 33세,2016,4311,2025,2286,88.6,4164,1937,2227,87
29010, 세종시,035005, 34세,2016,5083,2483,2600,95.5,4941,2391,2550,93.8
29010, 세종시,040,35~39세,2016,24898,12290,12608,97.5,24347,11940,12407,96.2
29010, 세종시,040001, 35세,2016,5079,2461,2618,94,4969,2388,2581,92.5
29010, 세종시,040002, 36세,2016,5213,2542,2671,95.2,5083,2466,2617,94.2
29010, 세종시,040003, 37세,2016,5127,2546,2581,98.6,5007,2466,2541,97
29010, 세종시,040004, 38세,2016,4667,2336,2331,100.2,4574,2274,2300,98.9
29010, 세종시,040005, 39세,2016,4812,2405,2407,99.9,4714,2346,2368,99.1
29010, 세종시,045,40~44세,2016,23274,12194,11080,110.1,22851,11925,10926,109.1
29010, 세종시,045001, 40세,2016,4594,2298,2296,100.1,4499,2242,2257,99.3
29010, 세종시,045002, 41세,2016,4676,2387,2289,104.3,4581,2330,2251,103.5
29010, 세종시,045003, 42세,2016,4958,2605,2353,110.7,4859,2535,2324,109.1
29010, 세종시,045004, 43세,2016,4649,2478,2171,114.1,4588,2436,2152,113.2
29010, 세종시,045005, 44세,2016,4397,2426,1971,123.1,4324,2382,1942,122.7
29010, 세종시,050,45~49세,2016,18891,10272,8619,119.2,18501,10045,8456,118.8
29010, 세종시,050001, 45세,2016,4583,2499,2084,119.9,4491,2444,2047,119.4
29010, 세종시,050002, 46세,2016,3822,2182,1640,133,3744,2133,1611,132.4
29010, 세종시,050003, 47세,2016,3844,2113,1731,122.1,3761,2059,1702,121
29010, 세종시,050004, 48세,2016,3560,1869,1691,110.5,3487,1834,1653,110.9
29010, 세종시,050005, 49세,2016,3082,1609,1473,109.2,3018,1575,1443,109.1
29010, 세종시,055,50~54세,2016,14335,7558,6777,111.5,13951,7344,6607,111.2
29010, 세종시,055001, 50세,2016,2839,1490,1349,110.5,2767,1447,1320,109.6
29010, 세종시,055002, 51세,2016,3042,1625,1417,114.7,2965,1575,1390,113.3
29010, 세종시,055003, 52세,2016,2749,1458,1291,112.9,2662,1406,1256,111.9
29010, 세종시,055004, 53세,2016,2794,1474,1320,111.7,2708,1429,1279,111.7
29010, 세종시,055005, 54세,2016,2911,1511,1400,107.9,2849,1487,1362,109.2
29010, 세종시,060,55~59세,2016,13770,6953,6817,102,13517,6819,6698,101.8
29010, 세종시,060001, 55세,2016,3152,1585,1567,101.1,3106,1563,1543,101.3
29010, 세종시,060002, 56세,2016,3047,1567,1480,105.9,2980,1527,1453,105.1
29010, 세종시,060003, 57세,2016,2640,1309,1331,98.3,2598,1291,1307,98.8
29010, 세종시,060004, 58세,2016,2476,1263,1213,104.1,2429,1235,1194,103.4
29010, 세종시,060005, 59세,2016,2455,1229,1226,100.2,2404,1203,1201,100.2
29010, 세종시,065,60~64세,2016,10247,5070,5177,97.9,10079,4977,5102,97.5
29010, 세종시,065001, 60세,2016,2343,1189,1154,103,2310,1169,1141,102.5
29010, 세종시,065002, 61세,2016,2440,1220,1220,100,2387,1197,1190,100.6
29010, 세종시,065003, 62세,2016,1996,976,1020,95.7,1965,960,1005,95.5
29010, 세종시,065004, 63세,2016,1678,809,869,93.1,1645,790,855,92.4
29010, 세종시,065005, 64세,2016,1790,876,914,95.8,1772,861,911,94.5
29010, 세종시,070,65~69세,2016,7153,3436,3717,92.4,7078,3396,3682,92.2
29010, 세종시,070001, 65세,2016,1366,630,736,85.6,1347,620,727,85.3
29010, 세종시,070002, 66세,2016,1582,790,792,99.7,1561,779,782,99.6
29010, 세종시,070003, 67세,2016,1511,720,791,91,1497,711,786,90.5
29010, 세종시,070004, 68세,2016,1391,675,716,94.3,1379,671,708,94.8
29010, 세종시,070005, 69세,2016,1303,621,682,91.1,1294,615,679,90.6
29010, 세종시,075,70~74세,2016,5584,2528,3056,82.7,5560,2517,3043,82.7
29010, 세종시,075001, 70세,2016,1044,503,541,93,1036,496,540,91.9
29010, 세종시,075002, 71세,2016,1023,479,544,88.1,1019,478,541,88.4
29010, 세종시,075003, 72세,2016,1088,474,614,77.2,1085,472,613,77
29010, 세종시,075004, 73세,2016,1064,468,596,78.5,1057,468,589,79.5
29010, 세종시,075005, 74세,2016,1365,604,761,79.4,1363,603,760,79.3
29010, 세종시,080,75~79세,2016,4833,1954,2879,67.9,4817,1950,2867,68
29010, 세종시,080001, 75세,2016,1092,451,641,70.4,1091,451,640,70.5
29010, 세종시,080002, 76세,2016,997,404,593,68.1,995,404,591,68.4
29010, 세종시,080003, 77세,2016,992,400,592,67.6,988,397,591,67.2
29010, 세종시,080004, 78세,2016,930,378,552,68.5,924,377,547,68.9
29010, 세종시,080005, 79세,2016,822,321,501,64.1,819,321,498,64.5
29010, 세종시,085,80~84세,2016,3287,1155,2132,54.2,3275,1151,2124,54.2
29010, 세종시,085001, 80세,2016,808,314,494,63.6,804,311,493,63.1
29010, 세종시,085002, 81세,2016,741,273,468,58.3,739,273,466,58.6
29010, 세종시,085003, 82세,2016,668,248,420,59,665,248,417,59.5
29010, 세종시,085004, 83세,2016,586,173,413,41.9,584,172,412,41.7
29010, 세종시,085005, 84세,2016,484,147,337,43.6,483,147,336,43.8
29010, 세종시,090,85~89세,2016,1559,422,1137,37.1,1554,419,1135,36.9
29010, 세종시,090001, 85세,2016,397,123,274,44.9,395,121,274,44.2
29010, 세종시,090002, 86세,2016,362,98,264,37.1,362,98,264,37.1
29010, 세종시,090003, 87세,2016,317,88,229,38.4,317,88,229,38.4
29010, 세종시,090004, 88세,2016,266,59,207,28.5,264,59,205,28.8
29010, 세종시,090005, 89세,2016,217,54,163,33.1,216,53,163,32.5
29010, 세종시,095,90~94세,2016,468,102,366,27.9,468,102,366,27.9
29010, 세종시,095001, 90세,2016,129,31,98,31.6,129,31,98,31.6
29010, 세종시,095002, 91세,2016,113,21,92,22.8,113,21,92,22.8
29010, 세종시,095003, 92세,2016,87,22,65,33.8,87,22,65,33.8
29010, 세종시,095004, 93세,2016,73,14,59,23.7,73,14,59,23.7
29010, 세종시,095005, 94세,2016,66,14,52,26.9,66,14,52,26.9
29010, 세종시,100,95~99세,2016,87,15,72,20.8,87,15,72,20.8
29010, 세종시,100001, 95세,2016,38,9,29,31,38,9,29,31
29010, 세종시,100002, 96세,2016,13,X,10,30,13,X,10,30
29010, 세종시,100003, 97세,2016,18,X,15,20,18,X,15,20
29010, 세종시,100004, 98세,2016,10,X,10,0,10,X,10,0
29010, 세종시,100005, 99세,2016,8,X,8,0,8,X,8,0
29010, 세종시,101,100세이상,2016,21,X,21,0,21,X,21,0
29010, 세종시,102,15세미만,2016,47977,24338,23639,103,47856,24276,23580,103
29010, 세종시,103,15~64세,2016,171538,88698,82840,107.1,166956,85939,81017,106.1
29010, 세종시,104,65세이상,2016,22992,9612,13380,71.8,22860,9550,13310,71.8
29010, 세종시,086,85세이상,2016,2135,539,1596,33.8,2130,536,1594,33.6
29010, 세종시,126,평균연령,2016,36.1,35.4,36.9,,36.1,35.3,36.9,
29010, 세종시,127,중위연령,2016,36.4,36.1,36.7,,36.5,36.1,36.8,
31,경기도,000,합계,2016,12671956,6405301,6266655,102.2,12199257,6122936,6076321,100.8
31,경기도,005,0~4세,2016,603740,308993,294747,104.8,593820,303952,289868,104.9
31,경기도,005001, 0세,2016,110711,56620,54091,104.7,108388,55420,52968,104.6
31,경기도,005002, 1세,2016,119426,61119,58307,104.8,117449,60083,57366,104.7
31,경기도,005003, 2세,2016,119389,60978,58411,104.4,117341,59971,57370,104.5
31,경기도,005004, 3세,2016,121411,62128,59283,104.8,119563,61208,58355,104.9
31,경기도,005005, 4세,2016,132803,68148,64655,105.4,131079,67270,63809,105.4
31,경기도,010,5~9세,2016,638717,328388,310329,105.8,633075,325413,307662,105.8
31,경기도,010001, 5세,2016,130647,67062,63585,105.5,129220,66296,62924,105.4
31,경기도,010002, 6세,2016,125867,64801,61066,106.1,124570,64097,60473,106
31,경기도,010003, 7세,2016,122314,62969,59345,106.1,121215,62404,58811,106.1
31,경기도,010004, 8세,2016,129042,66357,62685,105.9,128066,65840,62226,105.8
31,경기도,010005, 9세,2016,130847,67199,63648,105.6,130004,66776,63228,105.6
31,경기도,015,10~14세,2016,619832,319827,300005,106.6,616887,318298,298589,106.6
31,경기도,015001, 10세,2016,119671,61648,58023,106.2,119033,61300,57733,106.2
31,경기도,015002, 11세,2016,116469,59839,56630,105.7,115858,59518,56340,105.6
31,경기도,015003, 12세,2016,126209,64996,61213,106.2,125588,64675,60913,106.2
31,경기도,015004, 13세,2016,127423,65882,61541,107.1,126926,65618,61308,107
31,경기도,015005, 14세,2016,130060,67462,62598,107.8,129482,67187,62295,107.9
31,경기도,020,15~19세,2016,774124,399498,374626,106.6,768556,396700,371856,106.7
31,경기도,020001, 15세,2016,146811,75899,70912,107,146186,75565,70621,107
31,경기도,020002, 16세,2016,159159,82166,76993,106.7,158441,81801,76640,106.7
31,경기도,020003, 17세,2016,154278,79768,74510,107.1,153454,79339,74115,107
31,경기도,020004, 18세,2016,157230,80888,76342,106,155983,80265,75718,106
31,경기도,020005, 19세,2016,156646,80777,75869,106.5,154492,79730,74762,106.6
31,경기도,025,20~24세,2016,850579,454093,396486,114.5,813226,429973,383253,112.2
31,경기도,025001, 20세,2016,163095,87362,75733,115.4,159451,85341,74110,115.2
31,경기도,025002, 21세,2016,166202,90879,75323,120.7,160972,87670,73302,119.6
31,경기도,025003, 22세,2016,169195,91190,78005,116.9,162160,86659,75501,114.8
31,경기도,025004, 23세,2016,173581,91315,82266,111,163741,84761,78980,107.3
31,경기도,025005, 24세,2016,178506,93347,85159,109.6,166902,85542,81360,105.1
31,경기도,030,25~29세,2016,834467,444835,389632,114.2,756646,393321,363325,108.3
31,경기도,030001, 25세,2016,173335,91488,81847,111.8,160318,82655,77663,106.4
31,경기도,030002, 26세,2016,167792,89680,78112,114.8,152263,79350,72913,108.8
31,경기도,030003, 27세,2016,165234,88763,76471,116.1,149437,78280,71157,110
31,경기도,030004, 28세,2016,163872,87565,76307,114.8,147205,76691,70514,108.8
31,경기도,030005, 29세,2016,164234,87339,76895,113.6,147423,76345,71078,107.4
31,경기도,035,30~34세,2016,939423,492343,447080,110.1,863963,442564,421399,105
31,경기도,035001, 30세,2016,167810,88972,78838,112.9,151239,78214,73025,107.1
31,경기도,035002, 31세,2016,172453,90982,81471,111.7,156760,80633,76127,105.9
31,경기도,035003, 32세,2016,180494,94610,85884,110.2,165445,84618,80827,104.7
31,경기도,035004, 33세,2016,199590,104135,95455,109.1,185533,94756,90777,104.4
31,경기도,035005, 34세,2016,219076,113644,105432,107.8,204986,104343,100643,103.7
31,경기도,040,35~39세,2016,1073515,551432,522083,105.6,1019400,515797,503603,102.4
31,경기도,040001, 35세,2016,222199,115341,106858,107.9,210121,107296,102825,104.3
31,경기도,040002, 36세,2016,226963,116405,110558,105.3,215522,108832,106690,102
31,경기도,040003, 37세,2016,217077,111274,105803,105.2,205629,103729,101900,101.8
31,경기도,040004, 38세,2016,199778,102429,97349,105.2,189734,95850,93884,102.1
31,경기도,040005, 39세,2016,207498,105983,101515,104.4,198394,100090,98304,101.8
31,경기도,045,40~44세,2016,1119278,572150,547128,104.6,1076513,545567,530946,102.8
31,경기도,045001, 40세,2016,204674,105454,99220,106.3,195793,99659,96134,103.7
31,경기도,045002, 41세,2016,213919,109024,104895,103.9,205610,103775,101835,101.9
31,경기도,045003, 42세,2016,231441,118264,113177,104.5,223366,113238,110128,102.8
31,경기도,045004, 43세,2016,233291,118029,115262,102.4,224768,112918,111850,101
31,경기도,045005, 44세,2016,235953,121379,114574,105.9,226976,115977,110999,104.5
31,경기도,050,45~49세,2016,1176250,592917,583333,101.6,1132327,568495,563832,100.8
31,경기도,050001, 45세,2016,248299,126704,121595,104.2,238956,121329,117627,103.1
31,경기도,050002, 46세,2016,238175,121120,117055,103.5,228634,115720,112914,102.5
31,경기도,050003, 47세,2016,240264,120976,119288,101.4,231438,116118,115320,100.7
31,경기도,050004, 48세,2016,235486,117349,118137,99.3,226574,112477,114097,98.6
31,경기도,050005, 49세,2016,214026,106768,107258,99.5,206725,102851,103874,99
31,경기도,055,50~54세,2016,1047131,537301,509830,105.4,1003764,515033,488731,105.4
31,경기도,055001, 50세,2016,209899,108054,101845,106.1,201869,103797,98072,105.8
31,경기도,055002, 51세,2016,216139,109768,106371,103.2,207391,105250,102141,103
31,경기도,055003, 52세,2016,201635,103359,98276,105.2,193165,98990,94175,105.1
31,경기도,055004, 53세,2016,209751,108305,101446,106.8,199501,103103,96398,107
31,경기도,055005, 54세,2016,209707,107815,101892,105.8,201838,103893,97945,106.1
31,경기도,060,55~59세,2016,971760,493228,478532,103.1,940329,477623,462706,103.2
31,경기도,060001, 55세,2016,220147,111324,108823,102.3,215062,108834,106228,102.5
31,경기도,060002, 56세,2016,214806,108685,106121,102.4,207104,104893,102211,102.6
31,경기도,060003, 57세,2016,190025,96784,93241,103.8,183890,93689,90201,103.9
31,경기도,060004, 58세,2016,178631,91372,87259,104.7,172298,88223,84075,104.9
31,경기도,060005, 59세,2016,168151,85063,83088,102.4,161975,81984,79991,102.5
31,경기도,065,60~64세,2016,663883,330267,333616,99,639097,317802,321295,98.9
31,경기도,065001, 60세,2016,152937,77066,75871,101.6,147158,74169,72989,101.6
31,경기도,065002, 61세,2016,153419,76154,77265,98.6,147618,73181,74437,98.3
31,경기도,065003, 62세,2016,128004,63767,64237,99.3,122846,61155,61691,99.1
31,경기도,065004, 63세,2016,110448,54493,55955,97.4,106158,52353,53805,97.3
31,경기도,065005, 64세,2016,119075,58787,60288,97.5,115317,56944,58373,97.6
31,경기도,070,65~69세,2016,440781,211582,229199,92.3,430447,206599,223848,92.3
31,경기도,070001, 65세,2016,80929,39446,41483,95.1,77975,38010,39965,95.1
31,경기도,070002, 66세,2016,90148,43363,46785,92.7,87639,42121,45518,92.5
31,경기도,070003, 67세,2016,90581,43667,46914,93.1,88432,42656,45776,93.2
31,경기도,070004, 68세,2016,88946,42677,46269,92.2,87464,41963,45501,92.2
31,경기도,070005, 69세,2016,90177,42429,47748,88.9,88937,41849,47088,88.9
31,경기도,075,70~74세,2016,352010,159523,192487,82.9,348702,158178,190524,83
31,경기도,075001, 70세,2016,70477,33037,37440,88.2,69543,32634,36909,88.4
31,경기도,075002, 71세,2016,68207,31565,36642,86.1,67502,31258,36244,86.2
31,경기도,075003, 72세,2016,67230,30118,37112,81.2,66642,29871,36771,81.2
31,경기도,075004, 73세,2016,67956,30144,37812,79.7,67432,29958,37474,79.9
31,경기도,075005, 74세,2016,78140,34659,43481,79.7,77583,34457,43126,79.9
31,경기도,080,75~79세,2016,279663,116975,162688,71.9,277523,116245,161278,72.1
31,경기도,080001, 75세,2016,64409,28114,36295,77.5,63917,27940,35977,77.7
31,경기도,080002, 76세,2016,58051,24753,33298,74.3,57612,24596,33016,74.5
31,경기도,080003, 77세,2016,57265,23786,33479,71,56863,23647,33216,71.2
31,경기도,080004, 78세,2016,52303,21300,31003,68.7,51839,21148,30691,68.9
31,경기도,080005, 79세,2016,47635,19022,28613,66.5,47292,18914,28378,66.7
31,경기도,085,80~84세,2016,172937,61754,111183,55.5,171786,61383,110403,55.6
31,경기도,085001, 80세,2016,43319,16639,26680,62.4,42991,16527,26464,62.5
31,경기도,085002, 81세,2016,40600,14820,25780,57.5,40350,14749,25601,57.6
31,경기도,085003, 82세,2016,34263,12162,22101,55,34021,12077,21944,55
31,경기도,085004, 83세,2016,29044,9799,19245,50.9,28853,9736,19117,50.9
31,경기도,085005, 84세,2016,25711,8334,17377,48,25571,8294,17277,48
31,경기도,090,85~89세,2016,79459,22169,57290,38.7,79010,22039,56971,38.7
31,경기도,090001, 85세,2016,19995,6160,13835,44.5,19875,6123,13752,44.5
31,경기도,090002, 86세,2016,19032,5375,13657,39.4,18925,5340,13585,39.3
31,경기도,090003, 87세,2016,16382,4630,11752,39.4,16284,4608,11676,39.5
31,경기도,090004, 88세,2016,13366,3391,9975,34,13292,3369,9923,34
31,경기도,090005, 89세,2016,10684,2613,8071,32.4,10634,2599,8035,32.3
31,경기도,095,90~94세,2016,27510,6527,20983,31.1,27335,6475,20860,31
31,경기도,095001, 90세,2016,7805,1821,5984,30.4,7754,1805,5949,30.3
31,경기도,095002, 91세,2016,6654,1440,5214,27.6,6619,1430,5189,27.6
31,경기도,095003, 92세,2016,4868,1239,3629,34.1,4843,1234,3609,34.2
31,경기도,095004, 93세,2016,4710,1195,3515,34,4680,1184,3496,33.9
31,경기도,095005, 94세,2016,3473,832,2641,31.5,3439,822,2617,31.4
31,경기도,100,95~99세,2016,6091,1373,4718,29.1,6060,1362,4698,29
31,경기도,100001, 95세,2016,2251,526,1725,30.5,2244,524,1720,30.5
31,경기도,100002, 96세,2016,1549,355,1194,29.7,1541,352,1189,29.6
31,경기도,100003, 97세,2016,1090,274,816,33.6,1084,272,812,33.5
31,경기도,100004, 98세,2016,728,134,594,22.6,722,131,591,22.2
31,경기도,100005, 99세,2016,473,84,389,21.6,469,83,386,21.5
31,경기도,101,100세이상,2016,806,126,680,18.5,791,117,674,17.4
31,경기도,102,15세미만,2016,1862289,957208,905081,105.8,1843782,947663,896119,105.8
31,경기도,103,15~64세,2016,9450410,4868064,4582346,106.2,9013821,4602875,4410946,104.4
31,경기도,104,65세이상,2016,1359257,580029,779228,74.4,1341654,572398,769256,74.4
31,경기도,086,85세이상,2016,113866,30195,83671,36.1,113196,29993,83203,36
31,경기도,126,평균연령,2016,39.3,38.4,40.2,,39.3,38.4,40.2,
31,경기도,127,중위연령,2016,40,39.1,41,,40.2,39.4,41,
31004, 읍부,000,합계,2016,1329033,688546,640487,107.5,1265292,645423,619869,104.1
31004, 읍부,005,0~4세,2016,70184,36014,34170,105.4,69382,35618,33764,105.5
31004, 읍부,005001, 0세,2016,12662,6544,6118,107,12478,6455,6023,107.2
31004, 읍부,005002, 1세,2016,13774,7064,6710,105.3,13620,6974,6646,104.9
31004, 읍부,005003, 2세,2016,13851,7077,6774,104.5,13690,7005,6685,104.8
31004, 읍부,005004, 3세,2016,14160,7262,6898,105.3,14012,7192,6820,105.5
31004, 읍부,005005, 4세,2016,15737,8067,7670,105.2,15582,7992,7590,105.3
31004, 읍부,010,5~9세,2016,74718,38235,36483,104.8,74240,38001,36239,104.9
31004, 읍부,010001, 5세,2016,15463,7905,7558,104.6,15355,7841,7514,104.4
31004, 읍부,010002, 6세,2016,14867,7609,7258,104.8,14757,7552,7205,104.8
31004, 읍부,010003, 7세,2016,14225,7252,6973,104,14142,7217,6925,104.2
31004, 읍부,010004, 8세,2016,15019,7718,7301,105.7,14935,7671,7264,105.6
31004, 읍부,010005, 9세,2016,15144,7751,7393,104.8,15051,7720,7331,105.3
31004, 읍부,015,10~14세,2016,68398,35430,32968,107.5,68116,35274,32842,107.4
31004, 읍부,015001, 10세,2016,13781,7069,6712,105.3,13724,7034,6690,105.1
31004, 읍부,015002, 11세,2016,13299,6942,6357,109.2,13229,6903,6326,109.1
31004, 읍부,015003, 12세,2016,13837,7186,6651,108,13772,7149,6623,107.9
31004, 읍부,015004, 13세,2016,13457,6979,6478,107.7,13416,6959,6457,107.8
31004, 읍부,015005, 14세,2016,14024,7254,6770,107.1,13975,7229,6746,107.2
31004, 읍부,020,15~19세,2016,76761,39730,37031,107.3,76139,39404,36735,107.3
31004, 읍부,020001, 15세,2016,15329,7934,7395,107.3,15268,7903,7365,107.3
31004, 읍부,020002, 16세,2016,16052,8381,7671,109.3,15983,8339,7644,109.1
31004, 읍부,020003, 17세,2016,15572,7994,7578,105.5,15507,7952,7555,105.3
31004, 읍부,020004, 18세,2016,15130,7801,7329,106.4,15028,7755,7273,106.6
31004, 읍부,020005, 19세,2016,14678,7620,7058,108,14353,7455,6898,108.1
31004, 읍부,025,20~24세,2016,79133,44134,34999,126.1,72567,39257,33310,117.9
31004, 읍부,025001, 20세,2016,15423,8399,7024,119.6,14913,8090,6823,118.6
31004, 읍부,025002, 21세,2016,15466,8717,6749,129.2,14594,8087,6507,124.3
31004, 읍부,025003, 22세,2016,15538,8757,6781,129.1,14302,7831,6471,121
31004, 읍부,025004, 23세,2016,15961,8835,7126,124,14181,7480,6701,111.6
31004, 읍부,025005, 24세,2016,16745,9426,7319,128.8,14577,7769,6808,114.1
31004, 읍부,030,25~29세,2016,81272,46145,35127,131.4,68258,36541,31717,115.2
31004, 읍부,030001, 25세,2016,15977,9034,6943,130.1,13728,7326,6402,114.4
31004, 읍부,030002, 26세,2016,16140,9273,6867,135,13413,7259,6154,118
31004, 읍부,030003, 27세,2016,16198,9264,6934,133.6,13608,7340,6268,117.1
31004, 읍부,030004, 28세,2016,16281,9209,7072,130.2,13590,7228,6362,113.6
31004, 읍부,030005, 29세,2016,16676,9365,7311,128.1,13919,7388,6531,113.1
31004, 읍부,035,30~34세,2016,100818,54831,45987,119.2,88634,45880,42754,107.3
31004, 읍부,035001, 30세,2016,17429,9628,7801,123.4,14826,7755,7071,109.7
31004, 읍부,035002, 31세,2016,18190,10012,8178,122.4,15629,8117,7512,108.1
31004, 읍부,035003, 32세,2016,19437,10628,8809,120.6,16980,8809,8171,107.8
31004, 읍부,035004, 33세,2016,21646,11654,9992,116.6,19345,9971,9374,106.4
31004, 읍부,035005, 34세,2016,24116,12909,11207,115.2,21854,11228,10626,105.7
31004, 읍부,040,35~39세,2016,120017,63535,56482,112.5,111396,57283,54113,105.9
31004, 읍부,040001, 35세,2016,24665,13405,11260,119,22631,11889,10742,110.7
31004, 읍부,040002, 36세,2016,25510,13477,12033,112,23622,12121,11501,105.4
31004, 읍부,040003, 37세,2016,24129,12641,11488,110,22397,11384,11013,103.4
31004, 읍부,040004, 38세,2016,22529,11741,10788,108.8,20942,10607,10335,102.6
31004, 읍부,040005, 39세,2016,23184,12271,10913,112.4,21804,11282,10522,107.2
31004, 읍부,045,40~44세,2016,120921,64498,56423,114.3,115107,60631,54476,111.3
31004, 읍부,045001, 40세,2016,22607,11963,10644,112.4,21265,11029,10236,107.7
31004, 읍부,045002, 41세,2016,23519,12432,11087,112.1,22356,11645,10711,108.7
31004, 읍부,045003, 42세,2016,24945,13280,11665,113.8,23849,12564,11285,111.3
31004, 읍부,045004, 43세,2016,25041,13346,11695,114.1,23942,12643,11299,111.9
31004, 읍부,045005, 44세,2016,24809,13477,11332,118.9,23695,12750,10945,116.5
31004, 읍부,050,45~49세,2016,116908,62186,54722,113.6,111982,59240,52742,112.3
31004, 읍부,050001, 45세,2016,25478,13792,11686,118,24347,13082,11265,116.1
31004, 읍부,050002, 46세,2016,23813,12722,11091,114.7,22698,12050,10648,113.2
31004, 읍부,050003, 47세,2016,23647,12527,11120,112.7,22669,11938,10731,111.2
31004, 읍부,050004, 48세,2016,23094,12140,10954,110.8,22156,11610,10546,110.1
31004, 읍부,050005, 49세,2016,20876,11005,9871,111.5,20112,10560,9552,110.6
31004, 읍부,055,50~54세,2016,102155,54648,47507,115,97878,52289,45589,114.7
31004, 읍부,055001, 50세,2016,20936,11375,9561,119,20080,10883,9197,118.3
31004, 읍부,055002, 51세,2016,20739,11035,9704,113.7,19832,10538,9294,113.4
31004, 읍부,055003, 52세,2016,19702,10522,9180,114.6,18851,10044,8807,114
31004, 읍부,055004, 53세,2016,20264,10861,9403,115.5,19341,10357,8984,115.3
31004, 읍부,055005, 54세,2016,20514,10855,9659,112.4,19774,10467,9307,112.5
31004, 읍부,060,55~59세,2016,95742,48978,46764,104.7,93018,47537,45481,104.5
31004, 읍부,060001, 55세,2016,21508,11092,10416,106.5,21003,10839,10164,106.6
31004, 읍부,060002, 56세,2016,20555,10588,9967,106.2,19888,10228,9660,105.9
31004, 읍부,060003, 57세,2016,18784,9546,9238,103.3,18258,9260,8998,102.9
31004, 읍부,060004, 58세,2016,18112,9259,8853,104.6,17587,8980,8607,104.3
31004, 읍부,060005, 59세,2016,16783,8493,8290,102.4,16282,8230,8052,102.2
31004, 읍부,065,60~64세,2016,69586,34581,35005,98.8,67641,33565,34076,98.5
31004, 읍부,065001, 60세,2016,15905,7978,7927,100.6,15419,7740,7679,100.8
31004, 읍부,065002, 61세,2016,15779,7795,7984,97.6,15356,7564,7792,97.1
31004, 읍부,065003, 62세,2016,13504,6729,6775,99.3,13086,6522,6564,99.4
31004, 읍부,065004, 63세,2016,11593,5755,5838,98.6,11250,5558,5692,97.6
31004, 읍부,065005, 64세,2016,12805,6324,6481,97.6,12530,6181,6349,97.4
31004, 읍부,070,65~69세,2016,48027,23037,24990,92.2,47204,22618,24586,92
31004, 읍부,070001, 65세,2016,8651,4215,4436,95,8435,4096,4339,94.4
31004, 읍부,070002, 66세,2016,9546,4539,5007,90.7,9359,4444,4915,90.4
31004, 읍부,070003, 67세,2016,10057,4735,5322,89,9886,4659,5227,89.1
31004, 읍부,070004, 68세,2016,9782,4736,5046,93.9,9650,4666,4984,93.6
31004, 읍부,070005, 69세,2016,9991,4812,5179,92.9,9874,4753,5121,92.8
31004, 읍부,075,70~74세,2016,39820,18272,21548,84.8,39517,18133,21384,84.8
31004, 읍부,075001, 70세,2016,7863,3720,4143,89.8,7793,3687,4106,89.8
31004, 읍부,075002, 71세,2016,7771,3669,4102,89.4,7707,3638,4069,89.4
31004, 읍부,075003, 72세,2016,7498,3377,4121,81.9,7441,3348,4093,81.8
31004, 읍부,075004, 73세,2016,7713,3483,4230,82.3,7658,3459,4199,82.4
31004, 읍부,075005, 74세,2016,8975,4023,4952,81.2,8918,4001,4917,81.4
31004, 읍부,080,75~79세,2016,32325,13657,18668,73.2,32121,13584,18537,73.3
31004, 읍부,080001, 75세,2016,7408,3231,4177,77.4,7364,3211,4153,77.3
31004, 읍부,080002, 76세,2016,6727,2930,3797,77.2,6684,2917,3767,77.4
31004, 읍부,080003, 77세,2016,6709,2797,3912,71.5,6670,2781,3889,71.5
31004, 읍부,080004, 78세,2016,6061,2475,3586,69,6013,2462,3551,69.3
31004, 읍부,080005, 79세,2016,5420,2224,3196,69.6,5390,2213,3177,69.7
31004, 읍부,085,80~84세,2016,19908,7275,12633,57.6,19817,7240,12577,57.6
31004, 읍부,085001, 80세,2016,5098,1980,3118,63.5,5081,1976,3105,63.6
31004, 읍부,085002, 81세,2016,4702,1760,2942,59.8,4678,1752,2926,59.9
31004, 읍부,085003, 82세,2016,3965,1486,2479,59.9,3947,1475,2472,59.7
31004, 읍부,085004, 83세,2016,3277,1143,2134,53.6,3255,1134,2121,53.5
31004, 읍부,085005, 84세,2016,2866,906,1960,46.2,2856,903,1953,46.2
31004, 읍부,090,85~89세,2016,8585,2422,6163,39.3,8541,2401,6140,39.1
31004, 읍부,090001, 85세,2016,2222,709,1513,46.9,2206,702,1504,46.7
31004, 읍부,090002, 86세,2016,2058,600,1458,41.2,2050,595,1455,40.9
31004, 읍부,090003, 87세,2016,1784,495,1289,38.4,1773,489,1284,38.1
31004, 읍부,090004, 88세,2016,1408,362,1046,34.6,1401,359,1042,34.5
31004, 읍부,090005, 89세,2016,1113,256,857,29.9,1111,256,855,29.9
31004, 읍부,095,90~94세,2016,3000,743,2257,32.9,2983,735,2248,32.7
31004, 읍부,095001, 90세,2016,863,208,655,31.8,855,203,652,31.1
31004, 읍부,095002, 91세,2016,722,155,567,27.3,720,154,566,27.2
31004, 읍부,095003, 92세,2016,528,140,388,36.1,528,140,388,36.1
31004, 읍부,095004, 93세,2016,493,133,360,36.9,490,133,357,37.3
31004, 읍부,095005, 94세,2016,394,107,287,37.3,390,105,285,36.8
31004, 읍부,100,95~99세,2016,671,179,492,36.4,668,177,491,36
31004, 읍부,100001, 95세,2016,251,73,178,41,250,73,177,41.2
31004, 읍부,100002, 96세,2016,155,41,114,36,153,39,114,34.2
31004, 읍부,100003, 97세,2016,130,41,89,46.1,130,41,89,46.1
31004, 읍부,100004, 98세,2016,86,13,73,17.8,86,13,73,17.8
31004, 읍부,100005, 99세,2016,49,11,38,28.9,49,11,38,28.9
31004, 읍부,101,100세이상,2016,84,16,68,23.5,83,15,68,22.1
31004, 읍부,102,15세미만,2016,213300,109679,103621,105.8,211738,108893,102845,105.9
31004, 읍부,103,15~64세,2016,963313,513266,450047,114,902620,471627,430993,109.4
31004, 읍부,104,65세이상,2016,152420,65601,86819,75.6,150934,64903,86031,75.4
31004, 읍부,086,85세이상,2016,12340,3360,8980,37.4,12275,3328,8947,37.2
31004, 읍부,126,평균연령,2016,39.1,38.2,40.1,,39.2,38.4,40.1,
31004, 읍부,127,중위연령,2016,39.7,38.9,40.7,,40.2,39.6,40.8,
31005, 면부,000,합계,2016,860715,468157,392558,119.3,777441,405076,372365,108.8
31005, 면부,005,0~4세,2016,25411,13134,12277,107,25040,12934,12106,106.8
31005, 면부,005001, 0세,2016,4644,2427,2217,109.5,4559,2375,2184,108.7
31005, 면부,005002, 1세,2016,4985,2620,2365,110.8,4909,2577,2332,110.5
31005, 면부,005003, 2세,2016,5039,2625,2414,108.7,4975,2589,2386,108.5
31005, 면부,005004, 3세,2016,5082,2616,2466,106.1,5026,2590,2436,106.3
31005, 면부,005005, 4세,2016,5661,2846,2815,101.1,5571,2803,2768,101.3
31005, 면부,010,5~9세,2016,27377,14245,13132,108.5,27087,14088,12999,108.4
31005, 면부,010001, 5세,2016,5553,2911,2642,110.2,5484,2876,2608,110.3
31005, 면부,010002, 6세,2016,5337,2780,2557,108.7,5282,2754,2528,108.9
31005, 면부,010003, 7세,2016,5388,2820,2568,109.8,5330,2789,2541,109.8
31005, 면부,010004, 8세,2016,5562,2895,2667,108.5,5504,2862,2642,108.3
31005, 면부,010005, 9세,2016,5537,2839,2698,105.2,5487,2807,2680,104.7
31005, 면부,015,10~14세,2016,27044,14374,12670,113.4,26884,14307,12577,113.8
31005, 면부,015001, 10세,2016,5227,2764,2463,112.2,5190,2751,2439,112.8
31005, 면부,015002, 11세,2016,5019,2684,2335,114.9,4988,2670,2318,115.2
31005, 면부,015003, 12세,2016,5362,2891,2471,117,5331,2878,2453,117.3
31005, 면부,015004, 13세,2016,5478,2836,2642,107.3,5456,2826,2630,107.5
31005, 면부,015005, 14세,2016,5958,3199,2759,115.9,5919,3182,2737,116.3
31005, 면부,020,15~19세,2016,46699,24071,22628,106.4,46126,23748,22378,106.1
31005, 면부,020001, 15세,2016,7148,3631,3517,103.2,7107,3610,3497,103.2
31005, 면부,020002, 16세,2016,8941,4423,4518,97.9,8887,4396,4491,97.9
31005, 면부,020003, 17세,2016,8204,4208,3996,105.3,8117,4161,3956,105.2
31005, 면부,020004, 18세,2016,9562,4944,4618,107.1,9439,4874,4565,106.8
31005, 면부,020005, 19세,2016,12844,6865,5979,114.8,12576,6707,5869,114.3
31005, 면부,025,20~24세,2016,61729,35878,25851,138.8,51259,27771,23488,118.2
31005, 면부,025001, 20세,2016,12232,6603,5629,117.3,11512,6071,5441,111.6
31005, 면부,025002, 21세,2016,11116,6165,4951,124.5,9780,5144,4636,111
31005, 면부,025003, 22세,2016,11753,6744,5009,134.6,9818,5265,4553,115.6
31005, 면부,025004, 23세,2016,12917,7905,5012,157.7,9956,5615,4341,129.3
31005, 면부,025005, 24세,2016,13711,8461,5250,161.2,10193,5676,4517,125.7
31005, 면부,030,25~29세,2016,65555,43146,22409,192.5,45047,26719,18328,145.8
31005, 면부,030001, 25세,2016,13440,8461,4979,169.9,9574,5350,4224,126.7
31005, 면부,030002, 26세,2016,13421,8746,4675,187.1,9166,5383,3783,142.3
31005, 면부,030003, 27세,2016,13010,8685,4325,200.8,8889,5397,3492,154.6
31005, 면부,030004, 28세,2016,13002,8761,4241,206.6,8750,5347,3403,157.1
31005, 면부,030005, 29세,2016,12682,8493,4189,202.7,8668,5242,3426,153
31005, 면부,035,30~34세,2016,61634,40211,21423,187.7,43820,25851,17969,143.9
31005, 면부,035001, 30세,2016,12639,8539,4100,208.3,8706,5374,3332,161.3
31005, 면부,035002, 31세,2016,12185,8102,4083,198.4,8399,5050,3349,150.8
31005, 면부,035003, 32세,2016,11768,7710,4058,190,8185,4789,3396,141
31005, 면부,035004, 33세,2016,12276,7865,4411,178.3,8938,5155,3783,136.3
31005, 면부,035005, 34세,2016,12766,7995,4771,167.6,9592,5483,4109,133.4
31005, 면부,040,35~39세,2016,57172,34869,22303,156.3,45568,25652,19916,128.8
31005, 면부,040001, 35세,2016,12281,7661,4620,165.8,9536,5478,4058,135
31005, 면부,040002, 36세,2016,12231,7495,4736,158.3,9699,5454,4245,128.5
31005, 면부,040003, 37세,2016,11433,7023,4410,159.3,9053,5130,3923,130.8
31005, 면부,040004, 38세,2016,10575,6341,4234,149.8,8462,4680,3782,123.7
31005, 면부,040005, 39세,2016,10652,6349,4303,147.5,8818,4910,3908,125.6
31005, 면부,045,40~44세,2016,56533,33196,23337,142.2,49239,27851,21388,130.2
31005, 면부,045001, 40세,2016,10576,6267,4309,145.4,8804,4910,3894,126.1
31005, 면부,045002, 41세,2016,10843,6430,4413,145.7,9336,5307,4029,131.7
31005, 면부,045003, 42세,2016,11557,6762,4795,141,10127,5721,4406,129.8
31005, 면부,045004, 43세,2016,11712,6770,4942,137,10434,5837,4597,127
31005, 면부,045005, 44세,2016,11845,6967,4878,142.8,10538,6076,4462,136.2
31005, 면부,050,45~49세,2016,63380,35328,28052,125.9,58105,31791,26314,120.8
31005, 면부,050001, 45세,2016,12476,7188,5288,135.9,11281,6371,4910,129.8
31005, 면부,050002, 46세,2016,12471,7119,5352,133,11253,6287,4966,126.6
31005, 면부,050003, 47세,2016,12810,7159,5651,126.7,11776,6467,5309,121.8
31005, 면부,050004, 48세,2016,13075,7152,5923,120.7,12047,6468,5579,115.9
31005, 면부,050005, 49세,2016,12548,6710,5838,114.9,11748,6198,5550,111.7
31005, 면부,055,50~54세,2016,69256,37735,31521,119.7,65357,35311,30046,117.5
31005, 면부,055001, 50세,2016,12838,7166,5672,126.3,11998,6633,5365,123.6
31005, 면부,055002, 51세,2016,14070,7642,6428,118.9,13229,7109,6120,116.2
31005, 면부,055003, 52세,2016,13321,7291,6030,120.9,12569,6828,5741,118.9
31005, 면부,055004, 53세,2016,14255,7723,6532,118.2,13417,7198,6219,115.7
31005, 면부,055005, 54세,2016,14772,7913,6859,115.4,14144,7543,6601,114.3
31005, 면부,060,55~59세,2016,78438,41105,37333,110.1,75999,39628,36371,109
31005, 면부,060001, 55세,2016,16728,8795,7933,110.9,16286,8534,7752,110.1
31005, 면부,060002, 56세,2016,16628,8595,8033,107,16018,8228,7790,105.6
31005, 면부,060003, 57세,2016,15523,8179,7344,111.4,15056,7910,7146,110.7
31005, 면부,060004, 58세,2016,15173,8041,7132,112.7,14710,7752,6958,111.4
31005, 면부,060005, 59세,2016,14386,7495,6891,108.8,13929,7204,6725,107.1
31005, 면부,065,60~64세,2016,63043,32358,30685,105.5,61541,31487,30054,104.8
31005, 면부,065001, 60세,2016,13949,7302,6647,109.9,13605,7089,6516,108.8
31005, 면부,065002, 61세,2016,14058,7224,6834,105.7,13703,7008,6695,104.7
31005, 면부,065003, 62세,2016,12182,6233,5949,104.8,11865,6056,5809,104.3
31005, 면부,065004, 63세,2016,10798,5384,5414,99.4,10546,5241,5305,98.8
31005, 면부,065005, 64세,2016,12056,6215,5841,106.4,11822,6093,5729,106.4
31005, 면부,070,65~69세,2016,44082,22158,21924,101.1,43454,21793,21661,100.6
31005, 면부,070001, 65세,2016,7790,3905,3885,100.5,7624,3807,3817,99.7
31005, 면부,070002, 66세,2016,8850,4385,4465,98.2,8706,4307,4399,97.9
31005, 면부,070003, 67세,2016,8948,4486,4462,100.5,8800,4394,4406,99.7
31005, 면부,070004, 68세,2016,9069,4717,4352,108.4,8977,4666,4311,108.2
31005, 면부,070005, 69세,2016,9425,4665,4760,98,9347,4619,4728,97.7
31005, 면부,075,70~74세,2016,39176,18337,20839,88,38963,18235,20728,88
31005, 면부,075001, 70세,2016,7673,3764,3909,96.3,7614,3737,3877,96.4
31005, 면부,075002, 71세,2016,7587,3682,3905,94.3,7540,3661,3879,94.4
31005, 면부,075003, 72세,2016,7372,3428,3944,86.9,7335,3407,3928,86.7
31005, 면부,075004, 73세,2016,7674,3457,4217,82,7640,3441,4199,81.9
31005, 면부,075005, 74세,2016,8870,4006,4864,82.4,8834,3989,4845,82.3
31005, 면부,080,75~79세,2016,34740,15062,19678,76.5,34601,15004,19597,76.6
31005, 면부,080001, 75세,2016,7681,3495,4186,83.5,7646,3475,4171,83.3
31005, 면부,080002, 76세,2016,6888,3057,3831,79.8,6862,3048,3814,79.9
31005, 면부,080003, 77세,2016,7252,3065,4187,73.2,7224,3051,4173,73.1
31005, 면부,080004, 78세,2016,6627,2785,3842,72.5,6595,2776,3819,72.7
31005, 면부,080005, 79세,2016,6292,2660,3632,73.2,6274,2654,3620,73.3
31005, 면부,085,80~84세,2016,23264,8720,14544,60,23210,8692,14518,59.9
31005, 면부,085001, 80세,2016,5780,2394,3386,70.7,5762,2382,3380,70.5
31005, 면부,085002, 81세,2016,5393,2089,3304,63.2,5383,2085,3298,63.2
31005, 면부,085003, 82세,2016,4721,1777,2944,60.4,4711,1771,2940,60.2
31005, 면부,085004, 83세,2016,3921,1359,2562,53,3914,1356,2558,53
31005, 면부,085005, 84세,2016,3449,1101,2348,46.9,3440,1098,2342,46.9
31005, 면부,090,85~89세,2016,10996,3019,7977,37.8,10967,3008,7959,37.8
31005, 면부,090001, 85세,2016,2725,861,1864,46.2,2716,859,1857,46.3
31005, 면부,090002, 86세,2016,2626,752,1874,40.1,2619,748,1871,40
31005, 면부,090003, 87세,2016,2318,629,1689,37.2,2312,627,1685,37.2
31005, 면부,090004, 88세,2016,1881,429,1452,29.5,1878,427,1451,29.4
31005, 면부,090005, 89세,2016,1446,348,1098,31.7,1442,347,1095,31.7
31005, 면부,095,90~94세,2016,4118,984,3134,31.4,4111,982,3129,31.4
31005, 면부,095001, 90세,2016,1163,269,894,30.1,1162,269,893,30.1
31005, 면부,095002, 91세,2016,998,227,771,29.4,998,227,771,29.4
31005, 면부,095003, 92세,2016,728,202,526,38.4,728,202,526,38.4
31005, 면부,095004, 93세,2016,713,177,536,33,708,175,533,32.8
31005, 면부,095005, 94세,2016,516,109,407,26.8,515,109,406,26.8
31005, 면부,100,95~99세,2016,947,207,740,28,945,206,739,27.9
31005, 면부,100001, 95세,2016,354,72,282,25.5,354,72,282,25.5
31005, 면부,100002, 96세,2016,251,60,191,31.4,251,60,191,31.4
31005, 면부,100003, 97세,2016,169,41,128,32,168,41,127,32.3
31005, 면부,100004, 98세,2016,108,22,86,25.6,107,21,86,24.4
31005, 면부,100005, 99세,2016,65,12,53,22.6,65,12,53,22.6
31005, 면부,101,100세이상,2016,121,20,101,19.8,118,18,100,18
31005, 면부,102,15세미만,2016,79832,41753,38079,109.6,79011,41329,37682,109.7
31005, 면부,103,15~64세,2016,623439,357897,265542,134.8,542061,295809,246252,120.1
31005, 면부,104,65세이상,2016,157444,68507,88937,77,156369,67938,88431,76.8
31005, 면부,086,85세이상,2016,16182,4230,11952,35.4,16141,4214,11927,35.3
31005, 면부,126,평균연령,2016,44.3,42.5,46.5,,45.3,43.8,47,
31005, 면부,127,중위연령,2016,45.1,42.2,48.7,,47.5,45.6,49.8,
31003, 동부,000,합계,2016,10482208,5248598,5233610,100.3,10156524,5072437,5084087,99.8
31003, 동부,005,0~4세,2016,508145,259845,248300,104.6,499398,255400,243998,104.7
31003, 동부,005001, 0세,2016,93405,47649,45756,104.1,91351,46590,44761,104.1
31003, 동부,005002, 1세,2016,100667,51435,49232,104.5,98920,50532,48388,104.4
31003, 동부,005003, 2세,2016,100499,51276,49223,104.2,98676,50377,48299,104.3
31003, 동부,005004, 3세,2016,102169,52250,49919,104.7,100525,51426,49099,104.7
31003, 동부,005005, 4세,2016,111405,57235,54170,105.7,109926,56475,53451,105.7
31003, 동부,010,5~9세,2016,536622,275908,260714,105.8,531748,273324,258424,105.8
31003, 동부,010001, 5세,2016,109631,56246,53385,105.4,108381,55579,52802,105.3
31003, 동부,010002, 6세,2016,105663,54412,51251,106.2,104531,53791,50740,106
31003, 동부,010003, 7세,2016,102701,52897,49804,106.2,101743,52398,49345,106.2
31003, 동부,010004, 8세,2016,108461,55744,52717,105.7,107627,55307,52320,105.7
31003, 동부,010005, 9세,2016,110166,56609,53557,105.7,109466,56249,53217,105.7
31003, 동부,015,10~14세,2016,524390,270023,254367,106.2,521887,268717,253170,106.1
31003, 동부,015001, 10세,2016,100663,51815,48848,106.1,100119,51515,48604,106
31003, 동부,015002, 11세,2016,98151,50213,47938,104.7,97641,49945,47696,104.7
31003, 동부,015003, 12세,2016,107010,54919,52091,105.4,106485,54648,51837,105.4
31003, 동부,015004, 13세,2016,108488,56067,52421,107,108054,55833,52221,106.9
31003, 동부,015005, 14세,2016,110078,57009,53069,107.4,109588,56776,52812,107.5
31003, 동부,020,15~19세,2016,650664,335697,314967,106.6,646291,333548,312743,106.7
31003, 동부,020001, 15세,2016,124334,64334,60000,107.2,123811,64052,59759,107.2
31003, 동부,020002, 16세,2016,134166,69362,64804,107,133571,69066,64505,107.1
31003, 동부,020003, 17세,2016,130502,67566,62936,107.4,129830,67226,62604,107.4
31003, 동부,020004, 18세,2016,132538,68143,64395,105.8,131516,67636,63880,105.9
31003, 동부,020005, 19세,2016,129124,66292,62832,105.5,127563,65568,61995,105.8
31003, 동부,025,20~24세,2016,709717,374081,335636,111.5,689400,362945,326455,111.2
31003, 동부,025001, 20세,2016,135440,72360,63080,114.7,133026,71180,61846,115.1
31003, 동부,025002, 21세,2016,139620,75997,63623,119.4,136598,74439,62159,119.8
31003, 동부,025003, 22세,2016,141904,75689,66215,114.3,138040,73563,64477,114.1
31003, 동부,025004, 23세,2016,144703,74575,70128,106.3,139604,71666,67938,105.5
31003, 동부,025005, 24세,2016,148050,75460,72590,104,142132,72097,70035,102.9
31003, 동부,030,25~29세,2016,687640,355544,332096,107.1,643341,330061,313280,105.4
31003, 동부,030001, 25세,2016,143918,73993,69925,105.8,137016,69979,67037,104.4
31003, 동부,030002, 26세,2016,138231,71661,66570,107.6,129684,66708,62976,105.9
31003, 동부,030003, 27세,2016,136026,70814,65212,108.6,126940,65543,61397,106.8
31003, 동부,030004, 28세,2016,134589,69595,64994,107.1,124865,64116,60749,105.5
31003, 동부,030005, 29세,2016,134876,69481,65395,106.2,124836,63715,61121,104.2
31003, 동부,035,30~34세,2016,776971,397301,379670,104.6,731509,370833,360676,102.8
31003, 동부,035001, 30세,2016,137742,70805,66937,105.8,127707,65085,62622,103.9
31003, 동부,035002, 31세,2016,142078,72868,69210,105.3,132732,67466,65266,103.4
31003, 동부,035003, 32세,2016,149289,76272,73017,104.5,140280,71020,69260,102.5
31003, 동부,035004, 33세,2016,165668,84616,81052,104.4,157250,79630,77620,102.6
31003, 동부,035005, 34세,2016,182194,92740,89454,103.7,173540,87632,85908,102
31003, 동부,040,35~39세,2016,896326,453028,443298,102.2,862436,432862,429574,100.8
31003, 동부,040001, 35세,2016,185253,94275,90978,103.6,177954,89929,88025,102.2
31003, 동부,040002, 36세,2016,189222,95433,93789,101.8,182201,91257,90944,100.3
31003, 동부,040003, 37세,2016,181515,91610,89905,101.9,174179,87215,86964,100.3
31003, 동부,040004, 38세,2016,166674,84347,82327,102.5,160330,80563,79767,101
31003, 동부,040005, 39세,2016,173662,87363,86299,101.2,167772,83898,83874,100
31003, 동부,045,40~44세,2016,941824,474456,467368,101.5,912167,457085,455082,100.4
31003, 동부,045001, 40세,2016,171491,87224,84267,103.5,165724,83720,82004,102.1
31003, 동부,045002, 41세,2016,179557,90162,89395,100.9,173918,86823,87095,99.7
31003, 동부,045003, 42세,2016,194939,98222,96717,101.6,189390,94953,94437,100.5
31003, 동부,045004, 43세,2016,196538,97913,98625,99.3,190392,94438,95954,98.4
31003, 동부,045005, 44세,2016,199299,100935,98364,102.6,192743,97151,95592,101.6
31003, 동부,050,45~49세,2016,995962,495403,500559,99,962240,477464,484776,98.5
31003, 동부,050001, 45세,2016,210345,105724,104621,101.1,203328,101876,101452,100.4
31003, 동부,050002, 46세,2016,201891,101279,100612,100.7,194683,97383,97300,100.1
31003, 동부,050003, 47세,2016,203807,101290,102517,98.8,196993,97713,99280,98.4
31003, 동부,050004, 48세,2016,199317,98057,101260,96.8,192371,94399,97972,96.4
31003, 동부,050005, 49세,2016,180602,89053,91549,97.3,174865,86093,88772,97
31003, 동부,055,50~54세,2016,875720,444918,430802,103.3,840529,427433,413096,103.5
31003, 동부,055001, 50세,2016,176125,89513,86612,103.3,169791,86281,83510,103.3
31003, 동부,055002, 51세,2016,181330,91091,90239,100.9,174330,87603,86727,101
31003, 동부,055003, 52세,2016,168612,85546,83066,103,161745,82118,79627,103.1
31003, 동부,055004, 53세,2016,175232,89721,85511,104.9,166743,85548,81195,105.4
31003, 동부,055005, 54세,2016,174421,89047,85374,104.3,167920,85883,82037,104.7
31003, 동부,060,55~59세,2016,797580,403145,394435,102.2,771312,390458,380854,102.5
31003, 동부,060001, 55세,2016,181911,91437,90474,101.1,177773,89461,88312,101.3
31003, 동부,060002, 56세,2016,177623,89502,88121,101.6,171198,86437,84761,102
31003, 동부,060003, 57세,2016,155718,79059,76659,103.1,150576,76519,74057,103.3
31003, 동부,060004, 58세,2016,145346,74072,71274,103.9,140001,71491,68510,104.4
31003, 동부,060005, 59세,2016,136982,69075,67907,101.7,131764,66550,65214,102
31003, 동부,065,60~64세,2016,531254,263328,267926,98.3,509915,252750,257165,98.3
31003, 동부,065001, 60세,2016,123083,61786,61297,100.8,118134,59340,58794,100.9
31003, 동부,065002, 61세,2016,123582,61135,62447,97.9,118559,58609,59950,97.8
31003, 동부,065003, 62세,2016,102318,50805,51513,98.6,97895,48577,49318,98.5
31003, 동부,065004, 63세,2016,88057,43354,44703,97,84362,41554,42808,97.1
31003, 동부,065005, 64세,2016,94214,46248,47966,96.4,90965,44670,46295,96.5
31003, 동부,070,65~69세,2016,348672,166387,182285,91.3,339789,162188,177601,91.3
31003, 동부,070001, 65세,2016,64488,31326,33162,94.5,61916,30107,31809,94.6
31003, 동부,070002, 66세,2016,71752,34439,37313,92.3,69574,33370,36204,92.2
31003, 동부,070003, 67세,2016,71576,34446,37130,92.8,69746,33603,36143,93
31003, 동부,070004, 68세,2016,70095,33224,36871,90.1,68837,32631,36206,90.1
31003, 동부,070005, 69세,2016,70761,32952,37809,87.2,69716,32477,37239,87.2
31003, 동부,075,70~74세,2016,273014,122914,150100,81.9,270222,121810,148412,82.1
31003, 동부,075001, 70세,2016,54941,25553,29388,87,54136,25210,28926,87.2
31003, 동부,075002, 71세,2016,52849,24214,28635,84.6,52255,23959,28296,84.7
31003, 동부,075003, 72세,2016,52360,23313,29047,80.3,51866,23116,28750,80.4
31003, 동부,075004, 73세,2016,52569,23204,29365,79,52134,23058,29076,79.3
31003, 동부,075005, 74세,2016,60295,26630,33665,79.1,59831,26467,33364,79.3
31003, 동부,080,75~79세,2016,212598,88256,124342,71,210801,87657,123144,71.2
31003, 동부,080001, 75세,2016,49320,21388,27932,76.6,48907,21254,27653,76.9
31003, 동부,080002, 76세,2016,44436,18766,25670,73.1,44066,18631,25435,73.2
31003, 동부,080003, 77세,2016,43304,17924,25380,70.6,42969,17815,25154,70.8
31003, 동부,080004, 78세,2016,39615,16040,23575,68,39231,15910,23321,68.2
31003, 동부,080005, 79세,2016,35923,14138,21785,64.9,35628,14047,21581,65.1
31003, 동부,085,80~84세,2016,129765,45759,84006,54.5,128759,45451,83308,54.6
31003, 동부,085001, 80세,2016,32441,12265,20176,60.8,32148,12169,19979,60.9
31003, 동부,085002, 81세,2016,30505,10971,19534,56.2,30289,10912,19377,56.3
31003, 동부,085003, 82세,2016,25577,8899,16678,53.4,25363,8831,16532,53.4
31003, 동부,085004, 83세,2016,21846,7297,14549,50.2,21684,7246,14438,50.2
31003, 동부,085005, 84세,2016,19396,6327,13069,48.4,19275,6293,12982,48.5
31003, 동부,090,85~89세,2016,59878,16728,43150,38.8,59502,16630,42872,38.8
31003, 동부,090001, 85세,2016,15048,4590,10458,43.9,14953,4562,10391,43.9
31003, 동부,090002, 86세,2016,14348,4023,10325,39,14256,3997,10259,39
31003, 동부,090003, 87세,2016,12280,3506,8774,40,12199,3492,8707,40.1
31003, 동부,090004, 88세,2016,10077,2600,7477,34.8,10013,2583,7430,34.8
31003, 동부,090005, 89세,2016,8125,2009,6116,32.8,8081,1996,6085,32.8
31003, 동부,095,90~94세,2016,20392,4800,15592,30.8,20241,4758,15483,30.7
31003, 동부,095001, 90세,2016,5779,1344,4435,30.3,5737,1333,4404,30.3
31003, 동부,095002, 91세,2016,4934,1058,3876,27.3,4901,1049,3852,27.2
31003, 동부,095003, 92세,2016,3612,897,2715,33,3587,892,2695,33.1
31003, 동부,095004, 93세,2016,3504,885,2619,33.8,3482,876,2606,33.6
31003, 동부,095005, 94세,2016,2563,616,1947,31.6,2534,608,1926,31.6
31003, 동부,100,95~99세,2016,4473,987,3486,28.3,4447,979,3468,28.2
31003, 동부,100001, 95세,2016,1646,381,1265,30.1,1640,379,1261,30.1
31003, 동부,100002, 96세,2016,1143,254,889,28.6,1137,253,884,28.6
31003, 동부,100003, 97세,2016,791,192,599,32.1,786,190,596,31.9
31003, 동부,100004, 98세,2016,534,99,435,22.8,529,97,432,22.5
31003, 동부,100005, 99세,2016,359,61,298,20.5,355,60,295,20.3
31003, 동부,101,100세이상,2016,601,90,511,17.6,590,84,506,16.6
31003, 동부,102,15세미만,2016,1569157,805776,763381,105.6,1553033,797441,755592,105.5
31003, 동부,103,15~64세,2016,7863658,3996901,3866757,103.4,7569140,3835439,3733701,102.7
31003, 동부,104,65세이상,2016,1049393,445921,603472,73.9,1034351,439557,594794,73.9
31003, 동부,086,85세이상,2016,85344,22605,62739,36,84780,22451,62329,36
31003, 동부,126,평균연령,2016,38.9,38,39.7,,38.8,37.9,39.7,
31003, 동부,127,중위연령,2016,39.7,38.9,40.6,,39.7,38.9,40.5,
31010, 수원시,000,합계,2016,1207032,609777,597255,102.1,1161838,585827,576011,101.7
31010, 수원시,005,0~4세,2016,59873,30725,29148,105.4,58321,29920,28401,105.3
31010, 수원시,005001, 0세,2016,11590,5972,5618,106.3,11212,5771,5441,106.1
31010, 수원시,005002, 1세,2016,12128,6200,5928,104.6,11812,6028,5784,104.2
31010, 수원시,005003, 2세,2016,11806,6050,5756,105.1,11476,5892,5584,105.5
31010, 수원시,005004, 3세,2016,11778,6084,5694,106.8,11494,5934,5560,106.7
31010, 수원시,005005, 4세,2016,12571,6419,6152,104.3,12327,6295,6032,104.4
31010, 수원시,010,5~9세,2016,59107,30483,28624,106.5,58331,30049,28282,106.2
31010, 수원시,010001, 5세,2016,12242,6330,5912,107.1,12029,6214,5815,106.9
31010, 수원시,010002, 6세,2016,11487,5949,5538,107.4,11300,5829,5471,106.5
31010, 수원시,010003, 7세,2016,11278,5793,5485,105.6,11115,5702,5413,105.3
31010, 수원시,010004, 8세,2016,12020,6179,5841,105.8,11901,6117,5784,105.8
31010, 수원시,010005, 9세,2016,12080,6232,5848,106.6,11986,6187,5799,106.7
31010, 수원시,015,10~14세,2016,57929,29874,28055,106.5,57598,29716,27882,106.6
31010, 수원시,015001, 10세,2016,10924,5631,5293,106.4,10842,5599,5243,106.8
31010, 수원시,015002, 11세,2016,10663,5405,5258,102.8,10594,5370,5224,102.8
31010, 수원시,015003, 12세,2016,11914,6192,5722,108.2,11854,6155,5699,108
31010, 수원시,015004, 13세,2016,12209,6350,5859,108.4,12160,6326,5834,108.4
31010, 수원시,015005, 14세,2016,12219,6296,5923,106.3,12148,6266,5882,106.5
31010, 수원시,020,15~19세,2016,77341,40707,36634,111.1,76615,40366,36249,111.4
31010, 수원시,020001, 15세,2016,14297,7604,6693,113.6,14226,7560,6666,113.4
31010, 수원시,020002, 16세,2016,15682,8187,7495,109.2,15609,8154,7455,109.4
31010, 수원시,020003, 17세,2016,14883,7830,7053,111,14808,7798,7010,111.2
31010, 수원시,020004, 18세,2016,16027,8420,7607,110.7,15829,8325,7504,110.9
31010, 수원시,020005, 19세,2016,16452,8666,7786,111.3,16143,8529,7614,112
31010, 수원시,025,20~24세,2016,91766,48490,43276,112,88982,47065,41917,112.3
31010, 수원시,025001, 20세,2016,17102,9135,7967,114.7,16729,8960,7769,115.3
31010, 수원시,025002, 21세,2016,17600,9440,8160,115.7,17147,9215,7932,116.2
31010, 수원시,025003, 22세,2016,18191,9701,8490,114.3,17658,9425,8233,114.5
31010, 수원시,025004, 23세,2016,19135,10013,9122,109.8,18475,9663,8812,109.7
31010, 수원시,025005, 24세,2016,19738,10201,9537,107,18973,9802,9171,106.9
31010, 수원시,030,25~29세,2016,91968,48798,43170,113,86318,45767,40551,112.9
31010, 수원시,030001, 25세,2016,19304,10165,9139,111.2,18454,9721,8733,111.3
31010, 수원시,030002, 26세,2016,18428,9817,8611,114,17290,9222,8068,114.3
31010, 수원시,030003, 27세,2016,18315,9793,8522,114.9,17141,9165,7976,114.9
31010, 수원시,030004, 28세,2016,17884,9495,8389,113.2,16669,8856,7813,113.3
31010, 수원시,030005, 29세,2016,18037,9528,8509,112,16764,8803,7961,110.6
31010, 수원시,035,30~34세,2016,97576,50539,47037,107.4,92014,47445,44569,106.5
31010, 수원시,035001, 30세,2016,17849,9302,8547,108.8,16580,8611,7969,108.1
31010, 수원시,035002, 31세,2016,18245,9447,8798,107.4,17107,8848,8259,107.1
31010, 수원시,035003, 32세,2016,18737,9806,8931,109.8,17627,9186,8441,108.8
31010, 수원시,035004, 33세,2016,20487,10662,9825,108.5,19467,10079,9388,107.4
31010, 수원시,035005, 34세,2016,22258,11322,10936,103.5,21233,10721,10512,102
31010, 수원시,040,35~39세,2016,105577,54086,51491,105,101600,51791,49809,104
31010, 수원시,040001, 35세,2016,22481,11424,11057,103.3,21697,10980,10717,102.5
31010, 수원시,040002, 36세,2016,22313,11474,10839,105.9,21496,10986,10510,104.5
31010, 수원시,040003, 37세,2016,21342,10904,10438,104.5,20443,10371,10072,103
31010, 수원시,040004, 38세,2016,19394,10074,9320,108.1,18634,9647,8987,107.3
31010, 수원시,040005, 39세,2016,20047,10210,9837,103.8,19330,9807,9523,103
31010, 수원시,045,40~44세,2016,104989,53050,51939,102.1,101265,50879,50386,101
31010, 수원시,045001, 40세,2016,19539,10006,9533,105,18875,9612,9263,103.8
31010, 수원시,045002, 41세,2016,20151,10211,9940,102.7,19498,9823,9675,101.5
31010, 수원시,045003, 42세,2016,21528,10827,10701,101.2,20826,10393,10433,99.6
31010, 수원시,045004, 43세,2016,22004,10900,11104,98.2,21223,10485,10738,97.6
31010, 수원시,045005, 44세,2016,21767,11106,10661,104.2,20843,10566,10277,102.8
31010, 수원시,050,45~49세,2016,112884,55644,57240,97.2,108238,53180,55058,96.6
31010, 수원시,050001, 45세,2016,23340,11754,11586,101.5,22390,11237,11153,100.8
31010, 수원시,050002, 46세,2016,22369,11213,11156,100.5,21406,10696,10710,99.9
31010, 수원시,050003, 47세,2016,23321,11349,11972,94.8,22389,10875,11514,94.5
31010, 수원시,050004, 48세,2016,23023,11128,11895,93.6,22042,10609,11433,92.8
31010, 수원시,050005, 49세,2016,20831,10200,10631,95.9,20011,9763,10248,95.3
31010, 수원시,055,50~54세,2016,100488,51044,49444,103.2,94763,48147,46616,103.3
31010, 수원시,055001, 50세,2016,20195,10135,10060,100.7,19192,9629,9563,100.7
31010, 수원시,055002, 51세,2016,20783,10470,10313,101.5,19653,9887,9766,101.2
31010, 수원시,055003, 52세,2016,19346,9848,9498,103.7,18240,9265,8975,103.2
31010, 수원시,055004, 53세,2016,20411,10488,9923,105.7,18976,9772,9204,106.2
31010, 수원시,055005, 54세,2016,19753,10103,9650,104.7,18702,9594,9108,105.3
31010, 수원시,060,55~59세,2016,87605,44717,42888,104.3,83581,42653,40928,104.2
31010, 수원시,060001, 55세,2016,20747,10445,10302,101.4,20135,10142,9993,101.5
31010, 수원시,060002, 56세,2016,19809,10114,9695,104.3,18799,9597,9202,104.3
31010, 수원시,060003, 57세,2016,17107,8834,8273,106.8,16357,8441,7916,106.6
31010, 수원시,060004, 58세,2016,15718,8084,7634,105.9,14893,7660,7233,105.9
31010, 수원시,060005, 59세,2016,14224,7240,6984,103.7,13397,6813,6584,103.5
31010, 수원시,065,60~64세,2016,55771,27541,28230,97.6,52409,25813,26596,97.1
31010, 수원시,065001, 60세,2016,12930,6513,6417,101.5,12143,6106,6037,101.1
31010, 수원시,065002, 61세,2016,12900,6353,6547,97,12104,5949,6155,96.7
31010, 수원시,065003, 62세,2016,10727,5276,5451,96.8,10005,4885,5120,95.4
31010, 수원시,065004, 63세,2016,9242,4475,4767,93.9,8662,4184,4478,93.4
31010, 수원시,065005, 64세,2016,9972,4924,5048,97.5,9495,4689,4806,97.6
31010, 수원시,070,65~69세,2016,35606,17141,18465,92.8,34177,16419,17758,92.5
31010, 수원시,070001, 65세,2016,6694,3258,3436,94.8,6269,3047,3222,94.6
31010, 수원시,070002, 66세,2016,7472,3618,3854,93.9,7116,3427,3689,92.9
31010, 수원시,070003, 67세,2016,7214,3518,3696,95.2,6932,3383,3549,95.3
31010, 수원시,070004, 68세,2016,7131,3416,3715,92,6930,3309,3621,91.4
31010, 수원시,070005, 69세,2016,7095,3331,3764,88.5,6930,3253,3677,88.5
31010, 수원시,075,70~74세,2016,26983,12173,14810,82.2,26563,12007,14556,82.5
31010, 수원시,075001, 70세,2016,5464,2602,2862,90.9,5356,2553,2803,91.1
31010, 수원시,075002, 71세,2016,5338,2467,2871,85.9,5242,2431,2811,86.5
31010, 수원시,075003, 72세,2016,5232,2317,2915,79.5,5152,2285,2867,79.7
31010, 수원시,075004, 73세,2016,5193,2250,2943,76.5,5124,2222,2902,76.6
31010, 수원시,075005, 74세,2016,5756,2537,3219,78.8,5689,2516,3173,79.3
31010, 수원시,080,75~79세,2016,20484,8270,12214,67.7,20221,8193,12028,68.1
31010, 수원시,080001, 75세,2016,4801,2016,2785,72.4,4745,2006,2739,73.2
31010, 수원시,080002, 76세,2016,4219,1726,2493,69.2,4175,1707,2468,69.2
31010, 수원시,080003, 77세,2016,4171,1662,2509,66.2,4122,1651,2471,66.8
31010, 수원시,080004, 78세,2016,3816,1548,2268,68.3,3758,1531,2227,68.7
31010, 수원시,080005, 79세,2016,3477,1318,2159,61,3421,1298,2123,61.1
31010, 수원시,085,80~84세,2016,12630,4331,8299,52.2,12464,4275,8189,52.2
31010, 수원시,085001, 80세,2016,3159,1121,2038,55,3108,1101,2007,54.9
31010, 수원시,085002, 81세,2016,2944,1043,1901,54.9,2916,1038,1878,55.3
31010, 수원시,085003, 82세,2016,2504,867,1637,53,2464,852,1612,52.9
31010, 수원시,085004, 83세,2016,2139,692,1447,47.8,2108,681,1427,47.7
31010, 수원시,085005, 84세,2016,1884,608,1276,47.6,1868,603,1265,47.7
31010, 수원시,090,85~89세,2016,5962,1583,4379,36.1,5905,1567,4338,36.1
31010, 수원시,090001, 85세,2016,1469,431,1038,41.5,1453,425,1028,41.3
31010, 수원시,090002, 86세,2016,1430,368,1062,34.7,1413,365,1048,34.8
31010, 수원시,090003, 87세,2016,1241,338,903,37.4,1228,335,893,37.5
31010, 수원시,090004, 88세,2016,1013,246,767,32.1,1007,244,763,32
31010, 수원시,090005, 89세,2016,809,200,609,32.8,804,198,606,32.7
31010, 수원시,095,90~94세,2016,2034,502,1532,32.8,2017,497,1520,32.7
31010, 수원시,095001, 90세,2016,579,143,436,32.8,573,141,432,32.6
31010, 수원시,095002, 91세,2016,480,104,376,27.7,479,104,375,27.7
31010, 수원시,095003, 92세,2016,365,107,258,41.5,361,106,255,41.6
31010, 수원시,095004, 93세,2016,344,94,250,37.6,339,92,247,37.2
31010, 수원시,095005, 94세,2016,266,54,212,25.5,265,54,211,25.6
31010, 수원시,100,95~99세,2016,416,71,345,20.6,414,71,343,20.7
31010, 수원시,100001, 95세,2016,170,31,139,22.3,170,31,139,22.3
31010, 수원시,100002, 96세,2016,98,14,84,16.7,98,14,84,16.7
31010, 수원시,100003, 97세,2016,81,17,64,26.6,81,17,64,26.6
31010, 수원시,100004, 98세,2016,32,X,28,14.3,31,X,27,14.8
31010, 수원시,100005, 99세,2016,35,5,30,16.7,34,5,29,17.2
31010, 수원시,101,100세이상,2016,43,8,35,22.9,42,7,35,20
31010, 수원시,102,15세미만,2016,176909,91082,85827,106.1,174250,89685,84565,106.1
31010, 수원시,103,15~64세,2016,925965,474616,451349,105.2,885785,453106,432679,104.7
31010, 수원시,104,65세이상,2016,104158,44079,60079,73.4,101803,43036,58767,73.2
31010, 수원시,086,85세이상,2016,8455,2164,6291,34.4,8378,2142,6236,34.3
31010, 수원시,126,평균연령,2016,37.9,37,38.8,,37.8,36.9,38.7,
31010, 수원시,127,중위연령,2016,38.1,37.2,39.1,,38,37.1,39,
31011, 장안구,000,합계,2016,297942,150663,147279,102.3,290238,146639,143599,102.1
31011, 장안구,005,0~4세,2016,12439,6409,6030,106.3,12212,6286,5926,106.1
31011, 장안구,005001, 0세,2016,2245,1138,1107,102.8,2195,1111,1084,102.5
31011, 장안구,005002, 1세,2016,2528,1324,1204,110,2485,1301,1184,109.9
31011, 장안구,005003, 2세,2016,2424,1269,1155,109.9,2369,1240,1129,109.8
31011, 장안구,005004, 3세,2016,2526,1314,1212,108.4,2482,1288,1194,107.9
31011, 장안구,005005, 4세,2016,2716,1364,1352,100.9,2681,1346,1335,100.8
31011, 장안구,010,5~9세,2016,14108,7238,6870,105.4,13994,7172,6822,105.1
31011, 장안구,010001, 5세,2016,2782,1445,1337,108.1,2758,1434,1324,108.3
31011, 장안구,010002, 6세,2016,2682,1385,1297,106.8,2642,1358,1284,105.8
31011, 장안구,010003, 7세,2016,2712,1383,1329,104.1,2689,1368,1321,103.6
31011, 장안구,010004, 8세,2016,2970,1516,1454,104.3,2954,1507,1447,104.1
31011, 장안구,010005, 9세,2016,2962,1509,1453,103.9,2951,1505,1446,104.1
31011, 장안구,015,10~14세,2016,14735,7591,7144,106.3,14687,7571,7116,106.4
31011, 장안구,015001, 10세,2016,2755,1407,1348,104.4,2745,1404,1341,104.7
31011, 장안구,015002, 11세,2016,2685,1343,1342,100.1,2675,1338,1337,100.1
31011, 장안구,015003, 12세,2016,2979,1573,1406,111.9,2970,1569,1401,112
31011, 장안구,015004, 13세,2016,3170,1624,1546,105,3164,1621,1543,105.1
31011, 장안구,015005, 14세,2016,3146,1644,1502,109.5,3133,1639,1494,109.7
31011, 장안구,020,15~19세,2016,21349,11616,9733,119.3,21111,11495,9616,119.5
31011, 장안구,020001, 15세,2016,3793,2043,1750,116.7,3786,2039,1747,116.7
31011, 장안구,020002, 16세,2016,4247,2266,1981,114.4,4235,2259,1976,114.3
31011, 장안구,020003, 17세,2016,3904,2116,1788,118.3,3890,2110,1780,118.5
31011, 장안구,020004, 18세,2016,4533,2445,2088,117.1,4464,2406,2058,116.9
31011, 장안구,020005, 19세,2016,4872,2746,2126,129.2,4736,2681,2055,130.5
31011, 장안구,025,20~24세,2016,25416,14196,11220,126.5,24607,13768,10839,127
31011, 장안구,025001, 20세,2016,4884,2718,2166,125.5,4759,2650,2109,125.7
31011, 장안구,025002, 21세,2016,4895,2771,2124,130.5,4769,2704,2065,130.9
31011, 장안구,025003, 22세,2016,5070,2842,2228,127.6,4900,2765,2135,129.5
31011, 장안구,025004, 23세,2016,5267,2942,2325,126.5,5084,2842,2242,126.8
31011, 장안구,025005, 24세,2016,5300,2923,2377,123,5095,2807,2288,122.7
31011, 장안구,030,25~29세,2016,20748,11377,9371,121.4,19654,10765,8889,121.1
31011, 장안구,030001, 25세,2016,4851,2671,2180,122.5,4651,2565,2086,123
31011, 장안구,030002, 26세,2016,4431,2494,1937,128.8,4198,2356,1842,127.9
31011, 장안구,030003, 27세,2016,4049,2222,1827,121.6,3816,2098,1718,122.1
31011, 장안구,030004, 28세,2016,3750,2016,1734,116.3,3535,1901,1634,116.3
31011, 장안구,030005, 29세,2016,3667,1974,1693,116.6,3454,1845,1609,114.7
31011, 장안구,035,30~34세,2016,19479,9994,9485,105.4,18609,9509,9100,104.5
31011, 장안구,035001, 30세,2016,3569,1856,1713,108.3,3359,1739,1620,107.3
31011, 장안구,035002, 31세,2016,3640,1919,1721,111.5,3461,1820,1641,110.9
31011, 장안구,035003, 32세,2016,3717,1862,1855,100.4,3537,1777,1760,101
31011, 장안구,035004, 33세,2016,4123,2109,2014,104.7,3971,2020,1951,103.5
31011, 장안구,035005, 34세,2016,4430,2248,2182,103,4281,2153,2128,101.2
31011, 장안구,040,35~39세,2016,22739,11367,11372,100,22143,11055,11088,99.7
31011, 장안구,040001, 35세,2016,4625,2322,2303,100.8,4490,2254,2236,100.8
31011, 장안구,040002, 36세,2016,4656,2325,2331,99.7,4536,2255,2281,98.9
31011, 장안구,040003, 37세,2016,4630,2264,2366,95.7,4502,2198,2304,95.4
31011, 장안구,040004, 38세,2016,4310,2220,2090,106.2,4202,2166,2036,106.4
31011, 장안구,040005, 39세,2016,4518,2236,2282,98,4413,2182,2231,97.8
31011, 장안구,045,40~44세,2016,25350,12625,12725,99.2,24803,12302,12501,98.4
31011, 장안구,045001, 40세,2016,4573,2314,2259,102.4,4463,2248,2215,101.5
31011, 장안구,045002, 41세,2016,4800,2390,2410,99.2,4721,2340,2381,98.3
31011, 장안구,045003, 42세,2016,5217,2607,2610,99.9,5108,2534,2574,98.4
31011, 장안구,045004, 43세,2016,5370,2594,2776,93.4,5246,2534,2712,93.4
31011, 장안구,045005, 44세,2016,5390,2720,2670,101.9,5265,2646,2619,101
31011, 장안구,050,45~49세,2016,29030,14118,14912,94.7,28316,13764,14552,94.6
31011, 장안구,050001, 45세,2016,5751,2834,2917,97.2,5624,2768,2856,96.9
31011, 장안구,050002, 46세,2016,5758,2872,2886,99.5,5607,2789,2818,99
31011, 장안구,050003, 47세,2016,6021,2859,3162,90.4,5881,2797,3084,90.7
31011, 장안구,050004, 48세,2016,5990,2878,3112,92.5,5826,2800,3026,92.5
31011, 장안구,050005, 49세,2016,5510,2675,2835,94.4,5378,2610,2768,94.3
31011, 장안구,055,50~54세,2016,25756,13122,12634,103.9,24853,12681,12172,104.2
31011, 장안구,055001, 50세,2016,5298,2675,2623,102,5148,2605,2543,102.4
31011, 장안구,055002, 51세,2016,5295,2670,2625,101.7,5116,2579,2537,101.7
31011, 장안구,055003, 52세,2016,4887,2458,2429,101.2,4705,2367,2338,101.2
31011, 장안구,055004, 53세,2016,5218,2718,2500,108.7,4998,2619,2379,110.1
31011, 장안구,055005, 54세,2016,5058,2601,2457,105.9,4886,2511,2375,105.7
31011, 장안구,060,55~59세,2016,22300,11292,11008,102.6,21697,10992,10705,102.7
31011, 장안구,060001, 55세,2016,5336,2644,2692,98.2,5254,2607,2647,98.5
31011, 장안구,060002, 56세,2016,5023,2551,2472,103.2,4860,2477,2383,103.9
31011, 장안구,060003, 57세,2016,4380,2238,2142,104.5,4261,2178,2083,104.6
31011, 장안구,060004, 58세,2016,4004,2031,1973,102.9,3880,1958,1922,101.9
31011, 장안구,060005, 59세,2016,3557,1828,1729,105.7,3442,1772,1670,106.1
31011, 장안구,065,60~64세,2016,14368,7097,7271,97.6,13833,6827,7006,97.4
31011, 장안구,065001, 60세,2016,3329,1676,1653,101.4,3204,1610,1594,101
31011, 장안구,065002, 61세,2016,3253,1594,1659,96.1,3138,1540,1598,96.4
31011, 장안구,065003, 62세,2016,2771,1367,1404,97.4,2649,1312,1337,98.1
31011, 장안구,065004, 63세,2016,2405,1175,1230,95.5,2306,1121,1185,94.6
31011, 장안구,065005, 64세,2016,2610,1285,1325,97,2536,1244,1292,96.3
31011, 장안구,070,65~69세,2016,9572,4573,4999,91.5,9364,4462,4902,91
31011, 장안구,070001, 65세,2016,1761,846,915,92.5,1701,817,884,92.4
31011, 장안구,070002, 66세,2016,1972,929,1043,89.1,1922,901,1021,88.2
31011, 장안구,070003, 67세,2016,1953,954,999,95.5,1911,933,978,95.4
31011, 장안구,070004, 68세,2016,1906,921,985,93.5,1876,902,974,92.6
31011, 장안구,070005, 69세,2016,1980,923,1057,87.3,1954,909,1045,87
31011, 장안구,075,70~74세,2016,7760,3416,4344,78.6,7676,3394,4282,79.3
31011, 장안구,075001, 70세,2016,1542,728,814,89.4,1516,718,798,90
31011, 장안구,075002, 71세,2016,1517,669,848,78.9,1500,662,838,79
31011, 장안구,075003, 72세,2016,1505,658,847,77.7,1487,656,831,78.9
31011, 장안구,075004, 73세,2016,1510,647,863,75,1502,647,855,75.7
31011, 장안구,075005, 74세,2016,1686,714,972,73.5,1671,711,960,74.1
31011, 장안구,080,75~79세,2016,6126,2525,3601,70.1,6070,2509,3561,70.5
31011, 장안구,080001, 75세,2016,1387,594,793,74.9,1377,593,784,75.6
31011, 장안구,080002, 76세,2016,1275,512,763,67.1,1266,508,758,67
31011, 장안구,080003, 77세,2016,1242,514,728,70.6,1232,511,721,70.9
31011, 장안구,080004, 78세,2016,1146,481,665,72.3,1131,477,654,72.9
31011, 장안구,080005, 79세,2016,1076,424,652,65,1064,420,644,65.2
31011, 장안구,085,80~84세,2016,3898,1342,2556,52.5,3860,1330,2530,52.6
31011, 장안구,085001, 80세,2016,1003,354,649,54.5,991,349,642,54.4
31011, 장안구,085002, 81세,2016,892,309,583,53,886,309,577,53.6
31011, 장안구,085003, 82세,2016,746,264,482,54.8,738,262,476,55
31011, 장안구,085004, 83세,2016,658,216,442,48.9,649,212,437,48.5
31011, 장안구,085005, 84세,2016,599,199,400,49.8,596,198,398,49.7
31011, 장안구,090,85~89세,2016,1946,554,1392,39.8,1930,547,1383,39.6
31011, 장안구,090001, 85세,2016,470,150,320,46.9,466,148,318,46.5
31011, 장안구,090002, 86세,2016,462,122,340,35.9,461,121,340,35.6
31011, 장안구,090003, 87세,2016,404,123,281,43.8,400,121,279,43.4
31011, 장안구,090004, 88세,2016,334,92,242,38,330,91,239,38.1
31011, 장안구,090005, 89세,2016,276,67,209,32.1,273,66,207,31.9
31011, 장안구,095,90~94세,2016,676,184,492,37.4,673,183,490,37.3
31011, 장안구,095001, 90세,2016,181,45,136,33.1,181,45,136,33.1
31011, 장안구,095002, 91세,2016,165,46,119,38.7,165,46,119,38.7
31011, 장안구,095003, 92세,2016,123,40,83,48.2,122,39,83,47
31011, 장안구,095004, 93세,2016,113,35,78,44.9,111,35,76,46.1
31011, 장안구,095005, 94세,2016,94,18,76,23.7,94,18,76,23.7
31011, 장안구,100,95~99세,2016,132,24,108,22.2,131,24,107,22.4
31011, 장안구,100001, 95세,2016,50,9,41,22,50,9,41,22
31011, 장안구,100002, 96세,2016,28,X,24,16.7,28,X,24,16.7
31011, 장안구,100003, 97세,2016,31,9,22,40.9,31,9,22,40.9
31011, 장안구,100004, 98세,2016,13,X,11,18.2,12,X,10,20
31011, 장안구,100005, 99세,2016,10,X,10,0,10,X,10,0
31011, 장안구,101,100세이상,2016,15,X,12,25,15,X,12,25
31011, 장안구,102,15세미만,2016,41282,21238,20044,106,40893,21029,19864,105.9
31011, 장안구,103,15~64세,2016,226535,116804,109731,106.4,219626,113158,106468,106.3
31011, 장안구,104,65세이상,2016,30125,12621,17504,72.1,29719,12452,17267,72.1
31011, 장안구,086,85세이상,2016,2769,765,2004,38.2,2749,757,1992,38
31011, 장안구,126,평균연령,2016,38.8,37.6,40,,38.8,37.6,40,
31011, 장안구,127,중위연령,2016,39.5,38,41.1,,39.6,38,41.1,
31012, 권선구,000,합계,2016,357995,180459,177536,101.6,346592,174611,171981,101.5
31012, 권선구,005,0~4세,2016,19312,9872,9440,104.6,18946,9683,9263,104.5
31012, 권선구,005001, 0세,2016,3769,1960,1809,108.3,3662,1898,1764,107.6
31012, 권선구,005002, 1세,2016,3871,1952,1919,101.7,3800,1909,1891,101
31012, 권선구,005003, 2세,2016,3843,1936,1907,101.5,3769,1906,1863,102.3
31012, 권선구,005004, 3세,2016,3827,1945,1882,103.3,3759,1914,1845,103.7
31012, 권선구,005005, 4세,2016,4002,2079,1923,108.1,3956,2056,1900,108.2
31012, 권선구,010,5~9세,2016,17292,8933,8359,106.9,17156,8860,8296,106.8
31012, 권선구,010001, 5세,2016,3816,1976,1840,107.4,3774,1949,1825,106.8
31012, 권선구,010002, 6세,2016,3399,1720,1679,102.4,3371,1704,1667,102.2
31012, 권선구,010003, 7세,2016,3251,1669,1582,105.5,3228,1659,1569,105.7
31012, 권선구,010004, 8세,2016,3384,1782,1602,111.2,3365,1774,1591,111.5
31012, 권선구,010005, 9세,2016,3442,1786,1656,107.9,3418,1774,1644,107.9
31012, 권선구,015,10~14세,2016,15901,8363,7538,110.9,15838,8341,7497,111.3
31012, 권선구,015001, 10세,2016,2998,1578,1420,111.1,2983,1570,1413,111.1
31012, 권선구,015002, 11세,2016,2907,1501,1406,106.8,2896,1498,1398,107.2
31012, 권선구,015003, 12세,2016,3274,1740,1534,113.4,3264,1735,1529,113.5
31012, 권선구,015004, 13세,2016,3347,1789,1558,114.8,3334,1786,1548,115.4
31012, 권선구,015005, 14세,2016,3375,1755,1620,108.3,3361,1752,1609,108.9
31012, 권선구,020,15~19세,2016,20508,10629,9879,107.6,20428,10592,9836,107.7
31012, 권선구,020001, 15세,2016,3826,2050,1776,115.4,3810,2041,1769,115.4
31012, 권선구,020002, 16세,2016,4087,2110,1977,106.7,4076,2104,1972,106.7
31012, 권선구,020003, 17세,2016,4127,2119,2008,105.5,4109,2112,1997,105.8
31012, 권선구,020004, 18세,2016,4200,2226,1974,112.8,4181,2217,1964,112.9
31012, 권선구,020005, 19세,2016,4268,2124,2144,99.1,4252,2118,2134,99.3
31012, 권선구,025,20~24세,2016,25169,13018,12151,107.1,24715,12770,11945,106.9
31012, 권선구,025001, 20세,2016,4681,2499,2182,114.5,4642,2480,2162,114.7
31012, 권선구,025002, 21세,2016,4933,2626,2307,113.8,4872,2591,2281,113.6
31012, 권선구,025003, 22세,2016,4917,2563,2354,108.9,4836,2512,2324,108.1
31012, 권선구,025004, 23세,2016,5234,2666,2568,103.8,5108,2595,2513,103.3
31012, 권선구,025005, 24세,2016,5404,2664,2740,97.2,5257,2592,2665,97.3
31012, 권선구,030,25~29세,2016,26659,13570,13089,103.7,25300,12890,12410,103.9
31012, 권선구,030001, 25세,2016,5467,2748,2719,101.1,5285,2660,2625,101.3
31012, 권선구,030002, 26세,2016,5141,2605,2536,102.7,4909,2501,2408,103.9
31012, 권선구,030003, 27세,2016,5232,2670,2562,104.2,4970,2536,2434,104.2
31012, 권선구,030004, 28세,2016,5269,2698,2571,104.9,4955,2544,2411,105.5
31012, 권선구,030005, 29세,2016,5550,2849,2701,105.5,5181,2649,2532,104.6
31012, 권선구,035,30~34세,2016,30809,15908,14901,106.8,29323,15112,14211,106.3
31012, 권선구,035001, 30세,2016,5409,2715,2694,100.8,5098,2555,2543,100.5
31012, 권선구,035002, 31세,2016,5715,2949,2766,106.6,5398,2792,2606,107.1
31012, 권선구,035003, 32세,2016,6005,3189,2816,113.2,5707,3022,2685,112.6
31012, 권선구,035004, 33세,2016,6547,3400,3147,108,6259,3234,3025,106.9
31012, 권선구,035005, 34세,2016,7133,3655,3478,105.1,6861,3509,3352,104.7
31012, 권선구,040,35~39세,2016,33053,17306,15747,109.9,32020,16727,15293,109.4
31012, 권선구,040001, 35세,2016,7233,3714,3519,105.5,7042,3621,3421,105.8
31012, 권선구,040002, 36세,2016,7175,3796,3379,112.3,6962,3666,3296,111.2
31012, 권선구,040003, 37세,2016,6704,3516,3188,110.3,6452,3366,3086,109.1
31012, 권선구,040004, 38세,2016,5946,3116,2830,110.1,5748,3003,2745,109.4
31012, 권선구,040005, 39세,2016,5995,3164,2831,111.8,5816,3071,2745,111.9
31012, 권선구,045,40~44세,2016,30101,15590,14511,107.4,29089,15027,14062,106.9
31012, 권선구,045001, 40세,2016,5701,3018,2683,112.5,5519,2912,2607,111.7
31012, 권선구,045002, 41세,2016,5817,3011,2806,107.3,5614,2900,2714,106.9
31012, 권선구,045003, 42세,2016,6165,3205,2960,108.3,5978,3099,2879,107.6
31012, 권선구,045004, 43세,2016,6272,3178,3094,102.7,6075,3083,2992,103
31012, 권선구,045005, 44세,2016,6146,3178,2968,107.1,5903,3033,2870,105.7
31012, 권선구,050,45~49세,2016,32415,15853,16562,95.7,31159,15232,15927,95.6
31012, 권선구,050001, 45세,2016,6597,3353,3244,103.4,6351,3227,3124,103.3
31012, 권선구,050002, 46세,2016,6154,3047,3107,98.1,5894,2919,2975,98.1
31012, 권선구,050003, 47세,2016,6740,3235,3505,92.3,6469,3110,3359,92.6
31012, 권선구,050004, 48세,2016,6759,3239,3520,92,6489,3103,3386,91.6
31012, 권선구,050005, 49세,2016,6165,2979,3186,93.5,5956,2873,3083,93.2
31012, 권선구,055,50~54세,2016,30571,15395,15176,101.4,29068,14665,14403,101.8
31012, 권선구,055001, 50세,2016,6090,3005,3085,97.4,5833,2879,2954,97.5
31012, 권선구,055002, 51세,2016,6371,3160,3211,98.4,6081,3013,3068,98.2
31012, 권선구,055003, 52세,2016,5877,3002,2875,104.4,5603,2858,2745,104.1
31012, 권선구,055004, 53세,2016,6139,3132,3007,104.2,5736,2944,2792,105.4
31012, 권선구,055005, 54세,2016,6094,3096,2998,103.3,5815,2971,2844,104.5
31012, 권선구,060,55~59세,2016,27791,14021,13770,101.8,26658,13429,13229,101.5
31012, 권선구,060001, 55세,2016,6575,3268,3307,98.8,6406,3181,3225,98.6
31012, 권선구,060002, 56세,2016,6214,3144,3070,102.4,5921,2998,2923,102.6
31012, 권선구,060003, 57세,2016,5501,2792,2709,103.1,5292,2687,2605,103.1
31012, 권선구,060004, 58세,2016,4945,2500,2445,102.2,4721,2387,2334,102.3
31012, 권선구,060005, 59세,2016,4556,2317,2239,103.5,4318,2176,2142,101.6
31012, 권선구,065,60~64세,2016,17643,8795,8848,99.4,16711,8331,8380,99.4
31012, 권선구,065001, 60세,2016,4077,2037,2040,99.9,3855,1928,1927,100.1
31012, 권선구,065002, 61세,2016,4116,2062,2054,100.4,3892,1958,1934,101.2
31012, 권선구,065003, 62세,2016,3370,1677,1693,99.1,3176,1565,1611,97.1
31012, 권선구,065004, 63세,2016,2966,1450,1516,95.6,2797,1366,1431,95.5
31012, 권선구,065005, 64세,2016,3114,1569,1545,101.6,2991,1514,1477,102.5
31012, 권선구,070,65~69세,2016,10937,5341,5596,95.4,10578,5160,5418,95.2
31012, 권선구,070001, 65세,2016,2110,1027,1083,94.8,1995,967,1028,94.1
31012, 권선구,070002, 66세,2016,2291,1119,1172,95.5,2199,1071,1128,94.9
31012, 권선구,070003, 67세,2016,2199,1083,1116,97,2138,1054,1084,97.2
31012, 권선구,070004, 68세,2016,2178,1049,1129,92.9,2125,1024,1101,93
31012, 권선구,070005, 69세,2016,2159,1063,1096,97,2121,1044,1077,96.9
31012, 권선구,075,70~74세,2016,7924,3697,4227,87.5,7802,3645,4157,87.7
31012, 권선구,075001, 70세,2016,1618,769,849,90.6,1589,755,834,90.5
31012, 권선구,075002, 71세,2016,1628,782,846,92.4,1596,772,824,93.7
31012, 권선구,075003, 72세,2016,1565,727,838,86.8,1544,717,827,86.7
31012, 권선구,075004, 73세,2016,1474,655,819,80,1452,646,806,80.1
31012, 권선구,075005, 74세,2016,1639,764,875,87.3,1621,755,866,87.2
31012, 권선구,080,75~79세,2016,5938,2345,3593,65.3,5875,2336,3539,66
31012, 권선구,080001, 75세,2016,1404,572,832,68.8,1386,571,815,70.1
31012, 권선구,080002, 76세,2016,1185,475,710,66.9,1176,473,703,67.3
31012, 권선구,080003, 77세,2016,1244,480,764,62.8,1237,480,757,63.4
31012, 권선구,080004, 78세,2016,1128,454,674,67.4,1111,451,660,68.3
31012, 권선구,080005, 79세,2016,977,364,613,59.4,965,361,604,59.8
31012, 권선구,085,80~84세,2016,3604,1244,2360,52.7,3568,1235,2333,52.9
31012, 권선구,085001, 80세,2016,883,322,561,57.4,874,319,555,57.5
31012, 권선구,085002, 81세,2016,845,297,548,54.2,839,296,543,54.5
31012, 권선구,085003, 82세,2016,738,266,472,56.4,728,264,464,56.9
31012, 권선구,085004, 83세,2016,631,199,432,46.1,621,197,424,46.5
31012, 권선구,085005, 84세,2016,507,160,347,46.1,506,159,347,45.8
31012, 권선구,090,85~89세,2016,1670,439,1231,35.7,1664,437,1227,35.6
31012, 권선구,090001, 85세,2016,423,128,295,43.4,419,127,292,43.5
31012, 권선구,090002, 86세,2016,406,103,303,34,404,102,302,33.8
31012, 권선구,090003, 87세,2016,333,87,246,35.4,333,87,246,35.4
31012, 권선구,090004, 88세,2016,285,69,216,31.9,285,69,216,31.9
31012, 권선구,090005, 89세,2016,223,52,171,30.4,223,52,171,30.4
31012, 권선구,095,90~94세,2016,570,121,449,26.9,566,120,446,26.9
31012, 권선구,095001, 90세,2016,167,43,124,34.7,166,42,124,33.9
31012, 권선구,095002, 91세,2016,145,23,122,18.9,145,23,122,18.9
31012, 권선구,095003, 92세,2016,90,24,66,36.4,87,24,63,38.1
31012, 권선구,095004, 93세,2016,108,21,87,24.1,108,21,87,24.1
31012, 권선구,095005, 94세,2016,60,10,50,20,60,10,50,20
31012, 권선구,100,95~99세,2016,120,19,101,18.8,120,19,101,18.8
31012, 권선구,100001, 95세,2016,53,5,48,10.4,53,5,48,10.4
31012, 권선구,100002, 96세,2016,32,6,26,23.1,32,6,26,23.1
31012, 권선구,100003, 97세,2016,14,X,11,27.3,14,X,11,27.3
31012, 권선구,100004, 98세,2016,7,X,5,40,7,X,5,40
31012, 권선구,100005, 99세,2016,14,X,11,27.3,14,X,11,27.3
31012, 권선구,101,100세이상,2016,8,X,8,0,8,X,8,0
31012, 권선구,102,15세미만,2016,52505,27168,25337,107.2,51940,26884,25056,107.3
31012, 권선구,103,15~64세,2016,274719,140085,134634,104,264471,134775,129696,103.9
31012, 권선구,104,65세이상,2016,30771,13206,17565,75.2,30181,12952,17229,75.2
31012, 권선구,086,85세이상,2016,2368,579,1789,32.4,2358,576,1782,32.3
31012, 권선구,126,평균연령,2016,38.2,37.4,39,,38.1,37.3,38.9,
31012, 권선구,127,중위연령,2016,38.4,37.7,39.2,,38.2,37.5,39,
31013, 팔달구,000,합계,2016,208363,105235,103128,102,190431,95614,94817,100.8
31013, 팔달구,005,0~4세,2016,7902,4097,3805,107.7,7348,3801,3547,107.2
31013, 팔달구,005001, 0세,2016,1597,833,764,109,1461,762,699,109
31013, 팔달구,005002, 1세,2016,1601,819,782,104.7,1488,757,731,103.6
31013, 팔달구,005003, 2세,2016,1586,822,764,107.6,1468,763,705,108.2
31013, 팔달구,005004, 3세,2016,1502,798,704,113.4,1403,740,663,111.6
31013, 팔달구,005005, 4세,2016,1616,825,791,104.3,1528,779,749,104
31013, 팔달구,010,5~9세,2016,7504,3929,3575,109.9,7255,3799,3456,109.9
31013, 팔달구,010001, 5세,2016,1557,816,741,110.1,1488,783,705,111.1
31013, 팔달구,010002, 6세,2016,1474,782,692,113,1427,750,677,110.8
31013, 팔달구,010003, 7세,2016,1400,754,646,116.7,1339,723,616,117.4
31013, 팔달구,010004, 8세,2016,1542,795,747,106.4,1497,773,724,106.8
31013, 팔달구,010005, 9세,2016,1531,782,749,104.4,1504,770,734,104.9
31013, 팔달구,015,10~14세,2016,7664,3889,3775,103,7558,3841,3717,103.3
31013, 팔달구,015001, 10세,2016,1421,715,706,101.3,1391,707,684,103.4
31013, 팔달구,015002, 11세,2016,1419,702,717,97.9,1394,690,704,98
31013, 팔달구,015003, 12세,2016,1591,802,789,101.6,1573,790,783,100.9
31013, 팔달구,015004, 13세,2016,1583,836,747,111.9,1568,829,739,112.2
31013, 팔달구,015005, 14세,2016,1650,834,816,102.2,1632,825,807,102.2
31013, 팔달구,020,15~19세,2016,10626,5553,5073,109.5,10494,5481,5013,109.3
31013, 팔달구,020001, 15세,2016,1913,988,925,106.8,1892,976,916,106.6
31013, 팔달구,020002, 16세,2016,2113,1109,1004,110.5,2090,1099,991,110.9
31013, 팔달구,020003, 17세,2016,2176,1166,1010,115.4,2153,1153,1000,115.3
31013, 팔달구,020004, 18세,2016,2250,1163,1087,107,2223,1146,1077,106.4
31013, 팔달구,020005, 19세,2016,2174,1127,1047,107.6,2136,1107,1029,107.6
31013, 팔달구,025,20~24세,2016,13926,7237,6689,108.2,13389,6965,6424,108.4
31013, 팔달구,025001, 20세,2016,2411,1297,1114,116.4,2356,1267,1089,116.3
31013, 팔달구,025002, 21세,2016,2534,1315,1219,107.9,2454,1277,1177,108.5
31013, 팔달구,025003, 22세,2016,2720,1408,1312,107.3,2650,1375,1275,107.8
31013, 팔달구,025004, 23세,2016,2988,1541,1447,106.5,2847,1466,1381,106.2
31013, 팔달구,025005, 24세,2016,3273,1676,1597,104.9,3082,1580,1502,105.2
31013, 팔달구,030,25~29세,2016,16612,8706,7906,110.1,14706,7699,7007,109.9
31013, 팔달구,030001, 25세,2016,3229,1659,1570,105.7,2985,1536,1449,106
31013, 팔달구,030002, 26세,2016,3284,1685,1599,105.4,2893,1492,1401,106.5
31013, 팔달구,030003, 27세,2016,3395,1795,1600,112.2,2982,1576,1406,112.1
31013, 팔달구,030004, 28세,2016,3393,1784,1609,110.9,2967,1562,1405,111.2
31013, 팔달구,030005, 29세,2016,3311,1783,1528,116.7,2879,1533,1346,113.9
31013, 팔달구,035,30~34세,2016,16998,8996,8002,112.4,15012,7886,7126,110.7
31013, 팔달구,035001, 30세,2016,3356,1789,1567,114.2,2868,1519,1349,112.6
31013, 팔달구,035002, 31세,2016,3160,1611,1549,104,2778,1412,1366,103.4
31013, 팔달구,035003, 32세,2016,3332,1810,1522,118.9,2959,1593,1366,116.6
31013, 팔달구,035004, 33세,2016,3451,1851,1600,115.7,3078,1640,1438,114
31013, 팔달구,035005, 34세,2016,3699,1935,1764,109.7,3329,1722,1607,107.2
31013, 팔달구,040,35~39세,2016,16822,8907,7915,112.5,15330,8030,7300,110
31013, 팔달구,040001, 35세,2016,3644,1919,1725,111.2,3351,1738,1613,107.7
31013, 팔달구,040002, 36세,2016,3555,1928,1627,118.5,3261,1750,1511,115.8
31013, 팔달구,040003, 37세,2016,3428,1826,1602,114,3103,1634,1469,111.2
31013, 팔달구,040004, 38세,2016,3041,1615,1426,113.3,2743,1448,1295,111.8
31013, 팔달구,040005, 39세,2016,3154,1619,1535,105.5,2872,1460,1412,103.4
31013, 팔달구,045,40~44세,2016,16885,8846,8039,110,15370,7974,7396,107.8
31013, 팔달구,045001, 40세,2016,3040,1596,1444,110.5,2800,1460,1340,109
31013, 팔달구,045002, 41세,2016,3280,1705,1575,108.3,3024,1549,1475,105
31013, 팔달구,045003, 42세,2016,3524,1862,1662,112,3250,1698,1552,109.4
31013, 팔달구,045004, 43세,2016,3518,1816,1702,106.7,3187,1639,1548,105.9
31013, 팔달구,045005, 44세,2016,3523,1867,1656,112.7,3109,1628,1481,109.9
31013, 팔달구,050,45~49세,2016,18933,9512,9421,101,16857,8374,8483,98.7
31013, 팔달구,050001, 45세,2016,3892,1993,1899,104.9,3450,1749,1701,102.8
31013, 팔달구,050002, 46세,2016,3767,1949,1818,107.2,3353,1726,1627,106.1
31013, 팔달구,050003, 47세,2016,3838,1920,1918,100.1,3422,1688,1734,97.3
31013, 팔달구,050004, 48세,2016,3907,1882,2025,92.9,3485,1652,1833,90.1
31013, 팔달구,050005, 49세,2016,3529,1768,1761,100.4,3147,1559,1588,98.2
31013, 팔달구,055,50~54세,2016,18866,9594,9272,103.5,16116,8146,7970,102.2
31013, 팔달구,055001, 50세,2016,3591,1848,1743,106,3107,1597,1510,105.8
31013, 팔달구,055002, 51세,2016,3730,1913,1817,105.3,3197,1633,1564,104.4
31013, 팔달구,055003, 52세,2016,3759,1935,1824,106.1,3206,1634,1572,103.9
31013, 팔달구,055004, 53세,2016,3977,1971,2006,98.3,3297,1607,1690,95.1
31013, 팔달구,055005, 54세,2016,3809,1927,1882,102.4,3309,1675,1634,102.5
31013, 팔달구,060,55~59세,2016,18164,9178,8986,102.1,16243,8204,8039,102.1
31013, 팔달구,060001, 55세,2016,4042,2026,2016,100.5,3743,1881,1862,101
31013, 팔달구,060002, 56세,2016,4029,2028,2001,101.3,3564,1784,1780,100.2
31013, 팔달구,060003, 57세,2016,3554,1818,1736,104.7,3203,1627,1576,103.2
31013, 팔달구,060004, 58세,2016,3368,1729,1639,105.5,2961,1523,1438,105.9
31013, 팔달구,060005, 59세,2016,3171,1577,1594,98.9,2772,1389,1383,100.4
31013, 팔달구,065,60~64세,2016,13122,6359,6763,94,11521,5499,6022,91.3
31013, 팔달구,065001, 60세,2016,2949,1461,1488,98.2,2580,1262,1318,95.8
31013, 팔달구,065002, 61세,2016,3031,1434,1597,89.8,2644,1220,1424,85.7
31013, 팔달구,065003, 62세,2016,2616,1279,1337,95.7,2263,1083,1180,91.8
31013, 팔달구,065004, 63세,2016,2141,1024,1117,91.7,1881,891,990,90
31013, 팔달구,065005, 64세,2016,2385,1161,1224,94.9,2153,1043,1110,94
31013, 팔달구,070,65~69세,2016,8644,4130,4514,91.5,7936,3766,4170,90.3
31013, 팔달구,070001, 65세,2016,1640,809,831,97.4,1441,709,732,96.9
31013, 팔달구,070002, 66세,2016,1823,900,923,97.5,1645,801,844,94.9
31013, 팔달구,070003, 67세,2016,1744,851,893,95.3,1595,778,817,95.2
31013, 팔달구,070004, 68세,2016,1744,822,922,89.2,1645,768,877,87.6
31013, 팔달구,070005, 69세,2016,1693,748,945,79.2,1610,710,900,78.9
31013, 팔달구,075,70~74세,2016,6427,2938,3489,84.2,6262,2868,3394,84.5
31013, 팔달구,075001, 70세,2016,1297,619,678,91.3,1261,601,660,91.1
31013, 팔달구,075002, 71세,2016,1232,579,653,88.7,1196,564,632,89.2
31013, 팔달구,075003, 72세,2016,1248,551,697,79.1,1216,537,679,79.1
31013, 팔달구,075004, 73세,2016,1252,556,696,79.9,1218,539,679,79.4
31013, 팔달구,075005, 74세,2016,1398,633,765,82.7,1371,627,744,84.3
31013, 팔달구,080,75~79세,2016,4739,1972,2767,71.3,4616,1927,2689,71.7
31013, 팔달구,080001, 75세,2016,1149,492,657,74.9,1126,485,641,75.7
31013, 팔달구,080002, 76세,2016,997,414,583,71,974,403,571,70.6
31013, 팔달구,080003, 77세,2016,955,403,552,73,928,396,532,74.4
31013, 팔달구,080004, 78세,2016,856,360,496,72.6,831,351,480,73.1
31013, 팔달구,080005, 79세,2016,782,303,479,63.3,757,292,465,62.8
31013, 팔달구,085,80~84세,2016,2772,961,1811,53.1,2700,933,1767,52.8
31013, 팔달구,085001, 80세,2016,704,250,454,55.1,677,239,438,54.6
31013, 팔달구,085002, 81세,2016,650,242,408,59.3,636,239,397,60.2
31013, 팔달구,085003, 82세,2016,554,195,359,54.3,537,186,351,53
31013, 팔달구,085004, 83세,2016,445,146,299,48.8,439,143,296,48.3
31013, 팔달구,085005, 84세,2016,419,128,291,44,411,126,285,44.2
31013, 팔달구,090,85~89세,2016,1236,308,928,33.2,1207,301,906,33.2
31013, 팔달구,090001, 85세,2016,303,82,221,37.1,295,79,216,36.6
31013, 팔달구,090002, 86세,2016,276,79,197,40.1,267,78,189,41.3
31013, 팔달구,090003, 87세,2016,276,67,209,32.1,268,66,202,32.7
31013, 팔달구,090004, 88세,2016,212,43,169,25.4,210,42,168,25
31013, 팔달구,090005, 89세,2016,169,37,132,28,167,36,131,27.5
31013, 팔달구,095,90~94세,2016,431,107,324,33,423,105,318,33
31013, 팔달구,095001, 90세,2016,120,28,92,30.4,116,27,89,30.3
31013, 팔달구,095002, 91세,2016,95,15,80,18.8,94,15,79,19
31013, 팔달구,095003, 92세,2016,78,25,53,47.2,78,25,53,47.2
31013, 팔달구,095004, 93세,2016,72,26,46,56.5,70,25,45,55.6
31013, 팔달구,095005, 94세,2016,66,13,53,24.5,65,13,52,25
31013, 팔달구,100,95~99세,2016,81,14,67,20.9,80,14,66,21.2
31013, 팔달구,100001, 95세,2016,39,9,30,30,39,9,30,30
31013, 팔달구,100002, 96세,2016,20,X,19,5.3,20,X,19,5.3
31013, 팔달구,100003, 97세,2016,10,X,8,25,10,X,8,25
31013, 팔달구,100004, 98세,2016,6,X,6,0,6,X,6,0
31013, 팔달구,100005, 99세,2016,6,X,X,50,5,X,X,66.7
31013, 팔달구,101,100세이상,2016,9,X,7,28.6,8,X,7,14.3
31013, 팔달구,102,15세미만,2016,23070,11915,11155,106.8,22161,11441,10720,106.7
31013, 팔달구,103,15~64세,2016,160954,82888,78066,106.2,145038,74258,70780,104.9
31013, 팔달구,104,65세이상,2016,24339,10432,13907,75,23232,9915,13317,74.5
31013, 팔달구,086,85세이상,2016,1757,431,1326,32.5,1718,421,1297,32.5
31013, 팔달구,126,평균연령,2016,41.2,40.2,42.2,,40.9,39.9,42,
31013, 팔달구,127,중위연령,2016,41.9,40.8,43.1,,41.4,40.2,42.6,
31014, 영통구,000,합계,2016,342732,173420,169312,102.4,334577,168963,165614,102
31014, 영통구,005,0~4세,2016,20220,10347,9873,104.8,19815,10150,9665,105
31014, 영통구,005001, 0세,2016,3979,2041,1938,105.3,3894,2000,1894,105.6
31014, 영통구,005002, 1세,2016,4128,2105,2023,104.1,4039,2061,1978,104.2
31014, 영통구,005003, 2세,2016,3953,2023,1930,104.8,3870,1983,1887,105.1
31014, 영통구,005004, 3세,2016,3923,2027,1896,106.9,3850,1992,1858,107.2
31014, 영통구,005005, 4세,2016,4237,2151,2086,103.1,4162,2114,2048,103.2
31014, 영통구,010,5~9세,2016,20203,10383,9820,105.7,19926,10218,9708,105.3
31014, 영통구,010001, 5세,2016,4087,2093,1994,105,4009,2048,1961,104.4
31014, 영통구,010002, 6세,2016,3932,2062,1870,110.3,3860,2017,1843,109.4
31014, 영통구,010003, 7세,2016,3915,1987,1928,103.1,3859,1952,1907,102.4
31014, 영통구,010004, 8세,2016,4124,2086,2038,102.4,4085,2063,2022,102
31014, 영통구,010005, 9세,2016,4145,2155,1990,108.3,4113,2138,1975,108.3
31014, 영통구,015,10~14세,2016,19629,10031,9598,104.5,19515,9963,9552,104.3
31014, 영통구,015001, 10세,2016,3750,1931,1819,106.2,3723,1918,1805,106.3
31014, 영통구,015002, 11세,2016,3652,1859,1793,103.7,3629,1844,1785,103.3
31014, 영통구,015003, 12세,2016,4070,2077,1993,104.2,4047,2061,1986,103.8
31014, 영통구,015004, 13세,2016,4109,2101,2008,104.6,4094,2090,2004,104.3
31014, 영통구,015005, 14세,2016,4048,2063,1985,103.9,4022,2050,1972,104
31014, 영통구,020,15~19세,2016,24858,12909,11949,108,24582,12798,11784,108.6
31014, 영통구,020001, 15세,2016,4765,2523,2242,112.5,4738,2504,2234,112.1
31014, 영통구,020002, 16세,2016,5235,2702,2533,106.7,5208,2692,2516,107
31014, 영통구,020003, 17세,2016,4676,2429,2247,108.1,4656,2423,2233,108.5
31014, 영통구,020004, 18세,2016,5044,2586,2458,105.2,4961,2556,2405,106.3
31014, 영통구,020005, 19세,2016,5138,2669,2469,108.1,5019,2623,2396,109.5
31014, 영통구,025,20~24세,2016,27255,14039,13216,106.2,26271,13562,12709,106.7
31014, 영통구,025001, 20세,2016,5126,2621,2505,104.6,4972,2563,2409,106.4
31014, 영통구,025002, 21세,2016,5238,2728,2510,108.7,5052,2643,2409,109.7
31014, 영통구,025003, 22세,2016,5484,2888,2596,111.2,5272,2773,2499,111
31014, 영통구,025004, 23세,2016,5646,2864,2782,102.9,5436,2760,2676,103.1
31014, 영통구,025005, 24세,2016,5761,2938,2823,104.1,5539,2823,2716,103.9
31014, 영통구,030,25~29세,2016,27949,15145,12804,118.3,26658,14413,12245,117.7
31014, 영통구,030001, 25세,2016,5757,3087,2670,115.6,5533,2960,2573,115
31014, 영통구,030002, 26세,2016,5572,3033,2539,119.5,5290,2873,2417,118.9
31014, 영통구,030003, 27세,2016,5639,3106,2533,122.6,5373,2955,2418,122.2
31014, 영통구,030004, 28세,2016,5472,2997,2475,121.1,5212,2849,2363,120.6
31014, 영통구,030005, 29세,2016,5509,2922,2587,112.9,5250,2776,2474,112.2
31014, 영통구,035,30~34세,2016,30290,15641,14649,106.8,29070,14938,14132,105.7
31014, 영통구,035001, 30세,2016,5515,2942,2573,114.3,5255,2798,2457,113.9
31014, 영통구,035002, 31세,2016,5730,2968,2762,107.5,5470,2824,2646,106.7
31014, 영통구,035003, 32세,2016,5683,2945,2738,107.6,5424,2794,2630,106.2
31014, 영통구,035004, 33세,2016,6366,3302,3064,107.8,6159,3185,2974,107.1
31014, 영통구,035005, 34세,2016,6996,3484,3512,99.2,6762,3337,3425,97.4
31014, 영통구,040,35~39세,2016,32963,16506,16457,100.3,32107,15979,16128,99.1
31014, 영통구,040001, 35세,2016,6979,3469,3510,98.8,6814,3367,3447,97.7
31014, 영통구,040002, 36세,2016,6927,3425,3502,97.8,6737,3315,3422,96.9
31014, 영통구,040003, 37세,2016,6580,3298,3282,100.5,6386,3173,3213,98.8
31014, 영통구,040004, 38세,2016,6097,3123,2974,105,5941,3030,2911,104.1
31014, 영통구,040005, 39세,2016,6380,3191,3189,100.1,6229,3094,3135,98.7
31014, 영통구,045,40~44세,2016,32653,15989,16664,95.9,32003,15576,16427,94.8
31014, 영통구,045001, 40세,2016,6225,3078,3147,97.8,6093,2992,3101,96.5
31014, 영통구,045002, 41세,2016,6254,3105,3149,98.6,6139,3034,3105,97.7
31014, 영통구,045003, 42세,2016,6622,3153,3469,90.9,6490,3062,3428,89.3
31014, 영통구,045004, 43세,2016,6844,3312,3532,93.8,6715,3229,3486,92.6
31014, 영통구,045005, 44세,2016,6708,3341,3367,99.2,6566,3259,3307,98.5
31014, 영통구,050,45~49세,2016,32506,16161,16345,98.9,31906,15810,16096,98.2
31014, 영통구,050001, 45세,2016,7100,3574,3526,101.4,6965,3493,3472,100.6
31014, 영통구,050002, 46세,2016,6690,3345,3345,100,6552,3262,3290,99.1
31014, 영통구,050003, 47세,2016,6722,3335,3387,98.5,6617,3280,3337,98.3
31014, 영통구,050004, 48세,2016,6367,3129,3238,96.6,6242,3054,3188,95.8
31014, 영통구,050005, 49세,2016,5627,2778,2849,97.5,5530,2721,2809,96.9
31014, 영통구,055,50~54세,2016,25295,12933,12362,104.6,24726,12655,12071,104.8
31014, 영통구,055001, 50세,2016,5216,2607,2609,99.9,5104,2548,2556,99.7
31014, 영통구,055002, 51세,2016,5387,2727,2660,102.5,5259,2662,2597,102.5
31014, 영통구,055003, 52세,2016,4823,2453,2370,103.5,4726,2406,2320,103.7
31014, 영통구,055004, 53세,2016,5077,2667,2410,110.7,4945,2602,2343,111.1
31014, 영통구,055005, 54세,2016,4792,2479,2313,107.2,4692,2437,2255,108.1
31014, 영통구,060,55~59세,2016,19350,10226,9124,112.1,18983,10028,8955,112
31014, 영통구,060001, 55세,2016,4794,2507,2287,109.6,4732,2473,2259,109.5
31014, 영통구,060002, 56세,2016,4543,2391,2152,111.1,4454,2338,2116,110.5
31014, 영통구,060003, 57세,2016,3672,1986,1686,117.8,3601,1949,1652,118
31014, 영통구,060004, 58세,2016,3401,1824,1577,115.7,3331,1792,1539,116.4
31014, 영통구,060005, 59세,2016,2940,1518,1422,106.8,2865,1476,1389,106.3
31014, 영통구,065,60~64세,2016,10638,5290,5348,98.9,10344,5156,5188,99.4
31014, 영통구,065001, 60세,2016,2575,1339,1236,108.3,2504,1306,1198,109
31014, 영통구,065002, 61세,2016,2500,1263,1237,102.1,2430,1231,1199,102.7
31014, 영통구,065003, 62세,2016,1970,953,1017,93.7,1917,925,992,93.2
31014, 영통구,065004, 63세,2016,1730,826,904,91.4,1678,806,872,92.4
31014, 영통구,065005, 64세,2016,1863,909,954,95.3,1815,888,927,95.8
31014, 영통구,070,65~69세,2016,6453,3097,3356,92.3,6299,3031,3268,92.7
31014, 영통구,070001, 65세,2016,1183,576,607,94.9,1132,554,578,95.8
31014, 영통구,070002, 66세,2016,1386,670,716,93.6,1350,654,696,94
31014, 영통구,070003, 67세,2016,1318,630,688,91.6,1288,618,670,92.2
31014, 영통구,070004, 68세,2016,1303,624,679,91.9,1284,615,669,91.9
31014, 영통구,070005, 69세,2016,1263,597,666,89.6,1245,590,655,90.1
31014, 영통구,075,70~74세,2016,4872,2122,2750,77.2,4823,2100,2723,77.1
31014, 영통구,075001, 70세,2016,1007,486,521,93.3,990,479,511,93.7
31014, 영통구,075002, 71세,2016,961,437,524,83.4,950,433,517,83.8
31014, 영통구,075003, 72세,2016,914,381,533,71.5,905,375,530,70.8
31014, 영통구,075004, 73세,2016,957,392,565,69.4,952,390,562,69.4
31014, 영통구,075005, 74세,2016,1033,426,607,70.2,1026,423,603,70.1
31014, 영통구,080,75~79세,2016,3681,1428,2253,63.4,3660,1421,2239,63.5
31014, 영통구,080001, 75세,2016,861,358,503,71.2,856,357,499,71.5
31014, 영통구,080002, 76세,2016,762,325,437,74.4,759,323,436,74.1
31014, 영통구,080003, 77세,2016,730,265,465,57,725,264,461,57.3
31014, 영통구,080004, 78세,2016,686,253,433,58.4,685,252,433,58.2
31014, 영통구,080005, 79세,2016,642,227,415,54.7,635,225,410,54.9
31014, 영통구,085,80~84세,2016,2356,784,1572,49.9,2336,777,1559,49.8
31014, 영통구,085001, 80세,2016,569,195,374,52.1,566,194,372,52.2
31014, 영통구,085002, 81세,2016,557,195,362,53.9,555,194,361,53.7
31014, 영통구,085003, 82세,2016,466,142,324,43.8,461,140,321,43.6
31014, 영통구,085004, 83세,2016,405,131,274,47.8,399,129,270,47.8
31014, 영통구,085005, 84세,2016,359,121,238,50.8,355,120,235,51.1
31014, 영통구,090,85~89세,2016,1110,282,828,34.1,1104,282,822,34.3
31014, 영통구,090001, 85세,2016,273,71,202,35.1,273,71,202,35.1
31014, 영통구,090002, 86세,2016,286,64,222,28.8,281,64,217,29.5
31014, 영통구,090003, 87세,2016,228,61,167,36.5,227,61,166,36.7
31014, 영통구,090004, 88세,2016,182,42,140,30,182,42,140,30
31014, 영통구,090005, 89세,2016,141,44,97,45.4,141,44,97,45.4
31014, 영통구,095,90~94세,2016,357,90,267,33.7,355,89,266,33.5
31014, 영통구,095001, 90세,2016,111,27,84,32.1,110,27,83,32.5
31014, 영통구,095002, 91세,2016,75,20,55,36.4,75,20,55,36.4
31014, 영통구,095003, 92세,2016,74,18,56,32.1,74,18,56,32.1
31014, 영통구,095004, 93세,2016,51,12,39,30.8,50,11,39,28.2
31014, 영통구,095005, 94세,2016,46,13,33,39.4,46,13,33,39.4
31014, 영통구,100,95~99세,2016,83,14,69,20.3,83,14,69,20.3
31014, 영통구,100001, 95세,2016,28,8,20,40,28,8,20,40
31014, 영통구,100002, 96세,2016,18,X,15,20,18,X,15,20
31014, 영통구,100003, 97세,2016,26,X,23,13,26,X,23,13
31014, 영통구,100004, 98세,2016,6,X,6,0,6,X,6,0
31014, 영통구,100005, 99세,2016,5,X,5,0,5,X,5,0
31014, 영통구,101,100세이상,2016,11,X,8,37.5,11,X,8,37.5
31014, 영통구,102,15세미만,2016,60052,30761,29291,105,59256,30331,28925,104.9
31014, 영통구,103,15~64세,2016,263757,134839,128918,104.6,256650,130915,125735,104.1
31014, 영통구,104,65세이상,2016,18923,7820,11103,70.4,18671,7717,10954,70.4
31014, 영통구,086,85세이상,2016,1561,389,1172,33.2,1553,388,1165,33.3
31014, 영통구,126,평균연령,2016,34.8,34.2,35.4,,34.8,34.2,35.4,
31014, 영통구,127,중위연령,2016,35.1,34.5,35.8,,35.2,34.5,35.9,
31020, 성남시,000,합계,2016,951518,470829,480689,97.9,928132,459385,468747,98
31020, 성남시,005,0~4세,2016,40555,20693,19862,104.2,39974,20403,19571,104.3
31020, 성남시,005001, 0세,2016,8107,4103,4004,102.5,7996,4043,3953,102.3
31020, 성남시,005002, 1세,2016,8178,4167,4011,103.9,8068,4117,3951,104.2
31020, 성남시,005003, 2세,2016,7960,4019,3941,102,7833,3956,3877,102
31020, 성남시,005004, 3세,2016,8010,4079,3931,103.8,7882,4017,3865,103.9
31020, 성남시,005005, 4세,2016,8300,4325,3975,108.8,8195,4270,3925,108.8
31020, 성남시,010,5~9세,2016,41019,21149,19870,106.4,40595,20944,19651,106.6
31020, 성남시,010001, 5세,2016,8330,4336,3994,108.6,8248,4294,3954,108.6
31020, 성남시,010002, 6세,2016,8080,4139,3941,105,7995,4104,3891,105.5
31020, 성남시,010003, 7세,2016,7843,3990,3853,103.6,7746,3938,3808,103.4
31020, 성남시,010004, 8세,2016,8168,4220,3948,106.9,8095,4181,3914,106.8
31020, 성남시,010005, 9세,2016,8598,4464,4134,108,8511,4427,4084,108.4
31020, 성남시,015,10~14세,2016,42499,21984,20515,107.2,42161,21777,20384,106.8
31020, 성남시,015001, 10세,2016,7828,4011,3817,105.1,7761,3968,3793,104.6
31020, 성남시,015002, 11세,2016,7768,3981,3787,105.1,7706,3946,3760,104.9
31020, 성남시,015003, 12세,2016,8819,4598,4221,108.9,8741,4547,4194,108.4
31020, 성남시,015004, 13세,2016,9021,4679,4342,107.8,8960,4643,4317,107.6
31020, 성남시,015005, 14세,2016,9063,4715,4348,108.4,8993,4673,4320,108.2
31020, 성남시,020,15~19세,2016,55168,28197,26971,104.5,54683,27954,26729,104.6
31020, 성남시,020001, 15세,2016,10438,5431,5007,108.5,10361,5385,4976,108.2
31020, 성남시,020002, 16세,2016,11320,5701,5619,101.5,11243,5662,5581,101.5
31020, 성남시,020003, 17세,2016,11047,5634,5413,104.1,10968,5589,5379,103.9
31020, 성남시,020004, 18세,2016,11256,5795,5461,106.1,11147,5744,5403,106.3
31020, 성남시,020005, 19세,2016,11107,5636,5471,103,10964,5574,5390,103.4
31020, 성남시,025,20~24세,2016,61715,31856,29859,106.7,60186,31113,29073,107
31020, 성남시,025001, 20세,2016,11591,6013,5578,107.8,11380,5908,5472,108
31020, 성남시,025002, 21세,2016,11809,6292,5517,114,11520,6151,5369,114.6
31020, 성남시,025003, 22세,2016,12343,6479,5864,110.5,12065,6348,5717,111
31020, 성남시,025004, 23세,2016,12581,6445,6136,105,12233,6261,5972,104.8
31020, 성남시,025005, 24세,2016,13391,6627,6764,98,12988,6445,6543,98.5
31020, 성남시,030,25~29세,2016,66733,33200,33533,99,64109,31944,32165,99.3
31020, 성남시,030001, 25세,2016,13519,6672,6847,97.4,13086,6457,6629,97.4
31020, 성남시,030002, 26세,2016,13107,6483,6624,97.9,12592,6244,6348,98.4
31020, 성남시,030003, 27세,2016,13209,6642,6567,101.1,12687,6396,6291,101.7
31020, 성남시,030004, 28세,2016,13330,6633,6697,99,12766,6369,6397,99.6
31020, 성남시,030005, 29세,2016,13568,6770,6798,99.6,12978,6478,6500,99.7
31020, 성남시,035,30~34세,2016,75084,38067,37017,102.8,72585,36798,35787,102.8
31020, 성남시,035001, 30세,2016,13666,6842,6824,100.3,13154,6582,6572,100.2
31020, 성남시,035002, 31세,2016,14150,7114,7036,101.1,13631,6862,6769,101.4
31020, 성남시,035003, 32세,2016,14559,7396,7163,103.3,14034,7142,6892,103.6
31020, 성남시,035004, 33세,2016,15863,8125,7738,105,15429,7891,7538,104.7
31020, 성남시,035005, 34세,2016,16846,8590,8256,104,16337,8321,8016,103.8
31020, 성남시,040,35~39세,2016,78017,39343,38674,101.7,76153,38355,37798,101.5
31020, 성남시,040001, 35세,2016,16673,8487,8186,103.7,16288,8278,8010,103.3
31020, 성남시,040002, 36세,2016,16610,8339,8271,100.8,16233,8141,8092,100.6
31020, 성남시,040003, 37세,2016,15874,7995,7879,101.5,15448,7767,7681,101.1
31020, 성남시,040004, 38세,2016,14172,7082,7090,99.9,13832,6891,6941,99.3
31020, 성남시,040005, 39세,2016,14688,7440,7248,102.6,14352,7278,7074,102.9
31020, 성남시,045,40~44세,2016,80912,40110,40802,98.3,78957,39070,39887,98
31020, 성남시,045001, 40세,2016,14553,7391,7162,103.2,14219,7194,7025,102.4
31020, 성남시,045002, 41세,2016,15179,7551,7628,99,14807,7359,7448,98.8
31020, 성남시,045003, 42세,2016,16536,8123,8413,96.6,16176,7933,8243,96.2
31020, 성남시,045004, 43세,2016,16999,8261,8738,94.5,16571,8039,8532,94.2
31020, 성남시,045005, 44세,2016,17645,8784,8861,99.1,17184,8545,8639,98.9
31020, 성남시,050,45~49세,2016,89582,44483,45099,98.6,86958,43160,43798,98.5
31020, 성남시,050001, 45세,2016,19053,9563,9490,100.8,18499,9265,9234,100.3
31020, 성남시,050002, 46세,2016,18407,9218,9189,100.3,17868,8943,8925,100.2
31020, 성남시,050003, 47세,2016,18233,9017,9216,97.8,17695,8763,8932,98.1
31020, 성남시,050004, 48세,2016,17576,8590,8986,95.6,17040,8322,8718,95.5
31020, 성남시,050005, 49세,2016,16313,8095,8218,98.5,15856,7867,7989,98.5
31020, 성남시,055,50~54세,2016,79514,39754,39760,100,76517,38368,38149,100.6
31020, 성남시,055001, 50세,2016,15675,7952,7723,103,15145,7709,7436,103.7
31020, 성남시,055002, 51세,2016,16125,8031,8094,99.2,15538,7745,7793,99.4
31020, 성남시,055003, 52세,2016,15542,7710,7832,98.4,14982,7463,7519,99.3
31020, 성남시,055004, 53세,2016,16204,8125,8079,100.6,15464,7777,7687,101.2
31020, 성남시,055005, 54세,2016,15968,7936,8032,98.8,15388,7674,7714,99.5
31020, 성남시,060,55~59세,2016,77698,38464,39234,98,75358,37413,37945,98.6
31020, 성남시,060001, 55세,2016,17146,8257,8889,92.9,16794,8107,8687,93.3
31020, 성남시,060002, 56세,2016,16956,8310,8646,96.1,16409,8084,8325,97.1
31020, 성남시,060003, 57세,2016,15180,7481,7699,97.2,14719,7268,7451,97.5
31020, 성남시,060004, 58세,2016,14397,7403,6994,105.8,13883,7157,6726,106.4
31020, 성남시,060005, 59세,2016,14019,7013,7006,100.1,13553,6797,6756,100.6
31020, 성남시,065,60~64세,2016,54783,26862,27921,96.2,52994,25979,27015,96.2
31020, 성남시,065001, 60세,2016,12578,6228,6350,98.1,12118,6000,6118,98.1
31020, 성남시,065002, 61세,2016,12757,6247,6510,96,12356,6040,6316,95.6
31020, 성남시,065003, 62세,2016,10521,5129,5392,95.1,10179,4964,5215,95.2
31020, 성남시,065004, 63세,2016,9201,4465,4736,94.3,8901,4321,4580,94.3
31020, 성남시,065005, 64세,2016,9726,4793,4933,97.2,9440,4654,4786,97.2
31020, 성남시,070,65~69세,2016,37277,17802,19475,91.4,36488,17432,19056,91.5
31020, 성남시,070001, 65세,2016,6851,3291,3560,92.4,6617,3193,3424,93.3
31020, 성남시,070002, 66세,2016,7525,3661,3864,94.7,7333,3559,3774,94.3
31020, 성남시,070003, 67세,2016,7840,3716,4124,90.1,7667,3639,4028,90.3
31020, 성남시,070004, 68세,2016,7446,3575,3871,92.4,7330,3517,3813,92.2
31020, 성남시,070005, 69세,2016,7615,3559,4056,87.7,7541,3524,4017,87.7
31020, 성남시,075,70~74세,2016,28407,13001,15406,84.4,28153,12894,15259,84.5
31020, 성남시,075001, 70세,2016,5725,2589,3136,82.6,5645,2558,3087,82.9
31020, 성남시,075002, 71세,2016,5594,2564,3030,84.6,5539,2540,2999,84.7
31020, 성남시,075003, 72세,2016,5461,2495,2966,84.1,5413,2475,2938,84.2
31020, 성남시,075004, 73세,2016,5403,2460,2943,83.6,5371,2449,2922,83.8
31020, 성남시,075005, 74세,2016,6224,2893,3331,86.9,6185,2872,3313,86.7
31020, 성남시,080,75~79세,2016,20935,8963,11972,74.9,20782,8918,11864,75.2
31020, 성남시,080001, 75세,2016,4890,2234,2656,84.1,4851,2217,2634,84.2
31020, 성남시,080002, 76세,2016,4417,1893,2524,75,4383,1879,2504,75
31020, 성남시,080003, 77세,2016,4297,1818,2479,73.3,4277,1816,2461,73.8
31020, 성남시,080004, 78세,2016,3816,1583,2233,70.9,3786,1576,2210,71.3
31020, 성남시,080005, 79세,2016,3515,1435,2080,69,3485,1430,2055,69.6
31020, 성남시,085,80~84세,2016,12664,4501,8163,55.1,12574,4477,8097,55.3
31020, 성남시,085001, 80세,2016,3194,1274,1920,66.4,3171,1266,1905,66.5
31020, 성남시,085002, 81세,2016,2959,1089,1870,58.2,2939,1086,1853,58.6
31020, 성남시,085003, 82세,2016,2498,843,1655,50.9,2475,838,1637,51.2
31020, 성남시,085004, 83세,2016,2099,692,1407,49.2,2086,688,1398,49.2
31020, 성남시,085005, 84세,2016,1914,603,1311,46,1903,599,1304,45.9
31020, 성남시,090,85~89세,2016,6239,1748,4491,38.9,6213,1745,4468,39.1
31020, 성남시,090001, 85세,2016,1479,434,1045,41.5,1474,434,1040,41.7
31020, 성남시,090002, 86세,2016,1481,432,1049,41.2,1474,431,1043,41.3
31020, 성남시,090003, 87세,2016,1321,387,934,41.4,1314,386,928,41.6
31020, 성남시,090004, 88세,2016,1088,300,788,38.1,1083,299,784,38.1
31020, 성남시,090005, 89세,2016,870,195,675,28.9,868,195,673,29
31020, 성남시,095,90~94세,2016,2185,529,1656,31.9,2168,523,1645,31.8
31020, 성남시,095001, 90세,2016,582,138,444,31.1,577,137,440,31.1
31020, 성남시,095002, 91세,2016,536,109,427,25.5,532,107,425,25.2
31020, 성남시,095003, 92세,2016,376,94,282,33.3,374,94,280,33.6
31020, 성남시,095004, 93세,2016,389,111,278,39.9,385,108,277,39
31020, 성남시,095005, 94세,2016,302,77,225,34.2,300,77,223,34.5
31020, 성남시,100,95~99세,2016,468,110,358,30.7,464,107,357,30
31020, 성남시,100001, 95세,2016,185,42,143,29.4,184,41,143,28.7
31020, 성남시,100002, 96세,2016,119,30,89,33.7,118,30,88,34.1
31020, 성남시,100003, 97세,2016,85,21,64,32.8,84,20,64,31.3
31020, 성남시,100004, 98세,2016,48,13,35,37.1,47,12,35,34.3
31020, 성남시,100005, 99세,2016,31,X,27,14.8,31,X,27,14.8
31020, 성남시,101,100세이상,2016,64,13,51,25.5,60,11,49,22.4
31020, 성남시,102,15세미만,2016,124073,63826,60247,105.9,122730,63124,59606,105.9
31020, 성남시,103,15~64세,2016,719206,360336,358870,100.4,698500,350154,348346,100.5
31020, 성남시,104,65세이상,2016,108239,46667,61572,75.8,106902,46107,60795,75.8
31020, 성남시,086,85세이상,2016,8956,2400,6556,36.6,8905,2386,6519,36.6
31020, 성남시,126,평균연령,2016,40.2,39.4,41.1,,40.2,39.3,41.1,
31020, 성남시,127,중위연령,2016,41,40.1,41.9,,41,40.1,41.8,
31021, 수정구,000,합계,2016,236957,119900,117057,102.4,223546,113200,110346,102.6
31021, 수정구,005,0~4세,2016,8960,4527,4433,102.1,8645,4383,4262,102.8
31021, 수정구,005001, 0세,2016,1912,967,945,102.3,1838,932,906,102.9
31021, 수정구,005002, 1세,2016,1821,893,928,96.2,1758,865,893,96.9
31021, 수정구,005003, 2세,2016,1809,920,889,103.5,1741,886,855,103.6
31021, 수정구,005004, 3세,2016,1716,873,843,103.6,1653,848,805,105.3
31021, 수정구,005005, 4세,2016,1702,874,828,105.6,1655,852,803,106.1
31021, 수정구,010,5~9세,2016,8206,4194,4012,104.5,8056,4116,3940,104.5
31021, 수정구,010001, 5세,2016,1745,897,848,105.8,1707,873,834,104.7
31021, 수정구,010002, 6세,2016,1687,840,847,99.2,1656,825,831,99.3
31021, 수정구,010003, 7세,2016,1483,779,704,110.7,1453,763,690,110.6
31021, 수정구,010004, 8세,2016,1616,816,800,102,1592,805,787,102.3
31021, 수정구,010005, 9세,2016,1675,862,813,106,1648,850,798,106.5
31021, 수정구,015,10~14세,2016,8104,4224,3880,108.9,8018,4180,3838,108.9
31021, 수정구,015001, 10세,2016,1516,770,746,103.2,1492,759,733,103.5
31021, 수정구,015002, 11세,2016,1500,778,722,107.8,1479,769,710,108.3
31021, 수정구,015003, 12세,2016,1672,902,770,117.1,1650,888,762,116.5
31021, 수정구,015004, 13세,2016,1700,868,832,104.3,1694,866,828,104.6
31021, 수정구,015005, 14세,2016,1716,906,810,111.9,1703,898,805,111.6
31021, 수정구,020,15~19세,2016,11798,6103,5695,107.2,11613,6013,5600,107.4
31021, 수정구,020001, 15세,2016,1944,1028,916,112.2,1932,1021,911,112.1
31021, 수정구,020002, 16세,2016,2088,1104,984,112.2,2072,1095,977,112.1
31021, 수정구,020003, 17세,2016,2241,1191,1050,113.4,2219,1177,1042,113
31021, 수정구,020004, 18세,2016,2472,1277,1195,106.9,2426,1258,1168,107.7
31021, 수정구,020005, 19세,2016,3053,1503,1550,97,2964,1462,1502,97.3
31021, 수정구,025,20~24세,2016,17005,8789,8216,107,16060,8316,7744,107.4
31021, 수정구,025001, 20세,2016,3210,1576,1634,96.5,3051,1502,1549,97
31021, 수정구,025002, 21세,2016,3165,1632,1533,106.5,2955,1521,1434,106.1
31021, 수정구,025003, 22세,2016,3445,1802,1643,109.7,3271,1714,1557,110.1
31021, 수정구,025004, 23세,2016,3497,1842,1655,111.3,3296,1737,1559,111.4
31021, 수정구,025005, 24세,2016,3688,1937,1751,110.6,3487,1842,1645,112
31021, 수정구,030,25~29세,2016,17538,9282,8256,112.4,16210,8597,7613,112.9
31021, 수정구,030001, 25세,2016,3594,1889,1705,110.8,3368,1770,1598,110.8
31021, 수정구,030002, 26세,2016,3541,1901,1640,115.9,3286,1774,1512,117.3
31021, 수정구,030003, 27세,2016,3443,1829,1614,113.3,3186,1703,1483,114.8
31021, 수정구,030004, 28세,2016,3442,1781,1661,107.2,3155,1629,1526,106.7
31021, 수정구,030005, 29세,2016,3518,1882,1636,115,3215,1721,1494,115.2
31021, 수정구,035,30~34세,2016,19061,10299,8762,117.5,17873,9681,8192,118.2
31021, 수정구,035001, 30세,2016,3447,1861,1586,117.3,3205,1736,1469,118.2
31021, 수정구,035002, 31세,2016,3623,1925,1698,113.4,3377,1800,1577,114.1
31021, 수정구,035003, 32세,2016,3648,1950,1698,114.8,3405,1831,1574,116.3
31021, 수정구,035004, 33세,2016,4001,2200,1801,122.2,3799,2081,1718,121.1
31021, 수정구,035005, 34세,2016,4342,2363,1979,119.4,4087,2233,1854,120.4
31021, 수정구,040,35~39세,2016,19269,10359,8910,116.3,18381,9865,8516,115.8
31021, 수정구,040001, 35세,2016,4157,2257,1900,118.8,3986,2159,1827,118.2
31021, 수정구,040002, 36세,2016,4110,2179,1931,112.8,3929,2084,1845,113
31021, 수정구,040003, 37세,2016,3951,2125,1826,116.4,3745,1999,1746,114.5
31021, 수정구,040004, 38세,2016,3468,1845,1623,113.7,3306,1757,1549,113.4
31021, 수정구,040005, 39세,2016,3583,1953,1630,119.8,3415,1866,1549,120.5
31021, 수정구,045,40~44세,2016,18948,10237,8711,117.5,17857,9643,8214,117.4
31021, 수정구,045001, 40세,2016,3455,1929,1526,126.4,3274,1814,1460,124.2
31021, 수정구,045002, 41세,2016,3669,1987,1682,118.1,3469,1870,1599,116.9
31021, 수정구,045003, 42세,2016,3779,2066,1713,120.6,3599,1969,1630,120.8
31021, 수정구,045004, 43세,2016,3939,2009,1930,104.1,3700,1888,1812,104.2
31021, 수정구,045005, 44세,2016,4106,2246,1860,120.8,3815,2102,1713,122.7
31021, 수정구,050,45~49세,2016,20665,10769,9896,108.8,19047,9929,9118,108.9
31021, 수정구,050001, 45세,2016,4321,2344,1977,118.6,3959,2143,1816,118
31021, 수정구,050002, 46세,2016,4182,2168,2014,107.6,3862,2004,1858,107.9
31021, 수정구,050003, 47세,2016,4135,2142,1993,107.5,3801,1986,1815,109.4
31021, 수정구,050004, 48세,2016,4102,2103,1999,105.2,3785,1936,1849,104.7
31021, 수정구,050005, 49세,2016,3925,2012,1913,105.2,3640,1860,1780,104.5
31021, 수정구,055,50~54세,2016,20669,10383,10286,100.9,18622,9419,9203,102.3
31021, 수정구,055001, 50세,2016,3993,1986,2007,99,3633,1828,1805,101.3
31021, 수정구,055002, 51세,2016,4051,2011,2040,98.6,3665,1829,1836,99.6
31021, 수정구,055003, 52세,2016,4012,2026,1986,102,3640,1852,1788,103.6
31021, 수정구,055004, 53세,2016,4355,2211,2144,103.1,3814,1950,1864,104.6
31021, 수정구,055005, 54세,2016,4258,2149,2109,101.9,3870,1960,1910,102.6
31021, 수정구,060,55~59세,2016,21170,10282,10888,94.4,19621,9573,10048,95.3
31021, 수정구,060001, 55세,2016,4561,2184,2377,91.9,4339,2082,2257,92.2
31021, 수정구,060002, 56세,2016,4603,2220,2383,93.2,4224,2058,2166,95
31021, 수정구,060003, 57세,2016,4130,2029,2101,96.6,3832,1899,1933,98.2
31021, 수정구,060004, 58세,2016,3987,1987,2000,99.4,3658,1828,1830,99.9
31021, 수정구,060005, 59세,2016,3889,1862,2027,91.9,3568,1706,1862,91.6
31021, 수정구,065,60~64세,2016,15901,7698,8203,93.8,14710,7081,7629,92.8
31021, 수정구,065001, 60세,2016,3600,1777,1823,97.5,3283,1609,1674,96.1
31021, 수정구,065002, 61세,2016,3598,1767,1831,96.5,3330,1617,1713,94.4
31021, 수정구,065003, 62세,2016,3114,1495,1619,92.3,2881,1380,1501,91.9
31021, 수정구,065004, 63세,2016,2695,1283,1412,90.9,2498,1183,1315,90
31021, 수정구,065005, 64세,2016,2894,1376,1518,90.6,2718,1292,1426,90.6
31021, 수정구,070,65~69세,2016,11082,5265,5817,90.5,10564,5009,5555,90.2
31021, 수정구,070001, 65세,2016,2121,1002,1119,89.5,1953,929,1024,90.7
31021, 수정구,070002, 66세,2016,2251,1086,1165,93.2,2129,1021,1108,92.1
31021, 수정구,070003, 67세,2016,2370,1115,1255,88.8,2263,1066,1197,89.1
31021, 수정구,070004, 68세,2016,2188,1042,1146,90.9,2110,998,1112,89.7
31021, 수정구,070005, 69세,2016,2152,1020,1132,90.1,2109,995,1114,89.3
31021, 수정구,075,70~74세,2016,8112,3681,4431,83.1,7960,3618,4342,83.3
31021, 수정구,075001, 70세,2016,1620,748,872,85.8,1575,730,845,86.4
31021, 수정구,075002, 71세,2016,1571,691,880,78.5,1535,679,856,79.3
31021, 수정구,075003, 72세,2016,1544,705,839,84,1510,689,821,83.9
31021, 수정구,075004, 73세,2016,1567,694,873,79.5,1553,689,864,79.7
31021, 수정구,075005, 74세,2016,1810,843,967,87.2,1787,831,956,86.9
31021, 수정구,080,75~79세,2016,5535,2332,3203,72.8,5444,2313,3131,73.9
31021, 수정구,080001, 75세,2016,1302,571,731,78.1,1281,566,715,79.2
31021, 수정구,080002, 76세,2016,1185,506,679,74.5,1165,500,665,75.2
31021, 수정구,080003, 77세,2016,1198,507,691,73.4,1184,507,677,74.9
31021, 수정구,080004, 78세,2016,1023,419,604,69.4,1005,413,592,69.8
31021, 수정구,080005, 79세,2016,827,329,498,66.1,809,327,482,67.8
31021, 수정구,085,80~84세,2016,3063,1043,2020,51.6,3013,1032,1981,52.1
31021, 수정구,085001, 80세,2016,801,308,493,62.5,787,302,485,62.3
31021, 수정구,085002, 81세,2016,749,250,499,50.1,733,249,484,51.4
31021, 수정구,085003, 82세,2016,603,208,395,52.7,593,206,387,53.2
31021, 수정구,085004, 83세,2016,499,163,336,48.5,493,161,332,48.5
31021, 수정구,085005, 84세,2016,411,114,297,38.4,407,114,293,38.9
31021, 수정구,090,85~89세,2016,1315,321,994,32.3,1301,321,980,32.8
31021, 수정구,090001, 85세,2016,302,81,221,36.7,299,81,218,37.2
31021, 수정구,090002, 86세,2016,323,87,236,36.9,319,87,232,37.5
31021, 수정구,090003, 87세,2016,292,67,225,29.8,288,67,221,30.3
31021, 수정구,090004, 88세,2016,212,48,164,29.3,210,48,162,29.6
31021, 수정구,090005, 89세,2016,186,38,148,25.7,185,38,147,25.9
31021, 수정구,095,90~94세,2016,439,88,351,25.1,436,88,348,25.3
31021, 수정구,095001, 90세,2016,116,28,88,31.8,114,28,86,32.6
31021, 수정구,095002, 91세,2016,103,21,82,25.6,103,21,82,25.6
31021, 수정구,095003, 92세,2016,74,13,61,21.3,74,13,61,21.3
31021, 수정구,095004, 93세,2016,83,16,67,23.9,83,16,67,23.9
31021, 수정구,095005, 94세,2016,63,10,53,18.9,62,10,52,19.2
31021, 수정구,100,95~99세,2016,101,21,80,26.3,100,21,79,26.6
31021, 수정구,100001, 95세,2016,42,10,32,31.3,42,10,32,31.3
31021, 수정구,100002, 96세,2016,24,X,20,20,23,X,19,21.1
31021, 수정구,100003, 97세,2016,14,X,11,27.3,14,X,11,27.3
31021, 수정구,100004, 98세,2016,10,X,7,42.9,10,X,7,42.9
31021, 수정구,100005, 99세,2016,11,X,10,10,11,X,10,10
31021, 수정구,101,100세이상,2016,16,X,13,23.1,15,X,13,15.4
31021, 수정구,102,15세미만,2016,25270,12945,12325,105,24719,12679,12040,105.3
31021, 수정구,103,15~64세,2016,182024,94201,87823,107.3,169994,88117,81877,107.6
31021, 수정구,104,65세이상,2016,29663,12754,16909,75.4,28833,12404,16429,75.5
31021, 수정구,086,85세이상,2016,1871,433,1438,30.1,1852,432,1420,30.4
31021, 수정구,126,평균연령,2016,41.6,40.6,42.7,,41.5,40.5,42.6,
31021, 수정구,127,중위연령,2016,42.4,41.1,43.7,,42,40.8,43.4,
31022, 중원구,000,합계,2016,236284,119038,117246,101.5,231599,116792,114807,101.7
31022, 중원구,005,0~4세,2016,9399,4843,4556,106.3,9302,4787,4515,106
31022, 중원구,005001, 0세,2016,1862,962,900,106.9,1846,951,895,106.3
31022, 중원구,005002, 1세,2016,1948,1009,939,107.5,1931,1001,930,107.6
31022, 중원구,005003, 2세,2016,1828,928,900,103.1,1805,915,890,102.8
31022, 중원구,005004, 3세,2016,1794,923,871,106,1777,913,864,105.7
31022, 중원구,005005, 4세,2016,1967,1021,946,107.9,1943,1007,936,107.6
31022, 중원구,010,5~9세,2016,9071,4638,4433,104.6,9025,4621,4404,104.9
31022, 중원구,010001, 5세,2016,1906,1011,895,113,1897,1009,888,113.6
31022, 중원구,010002, 6세,2016,1762,916,846,108.3,1756,914,842,108.6
31022, 중원구,010003, 7세,2016,1726,831,895,92.8,1719,829,890,93.1
31022, 중원구,010004, 8세,2016,1765,937,828,113.2,1756,931,825,112.8
31022, 중원구,010005, 9세,2016,1912,943,969,97.3,1897,938,959,97.8
31022, 중원구,015,10~14세,2016,8959,4621,4338,106.5,8928,4603,4325,106.4
31022, 중원구,015001, 10세,2016,1636,832,804,103.5,1631,828,803,103.1
31022, 중원구,015002, 11세,2016,1650,811,839,96.7,1642,806,836,96.4
31022, 중원구,015003, 12세,2016,1821,960,861,111.5,1812,955,857,111.4
31022, 중원구,015004, 13세,2016,1868,1001,867,115.5,1863,999,864,115.6
31022, 중원구,015005, 14세,2016,1984,1017,967,105.2,1980,1015,965,105.2
31022, 중원구,020,15~19세,2016,12303,6292,6011,104.7,12255,6275,5980,104.9
31022, 중원구,020001, 15세,2016,2230,1194,1036,115.3,2225,1192,1033,115.4
31022, 중원구,020002, 16세,2016,2455,1222,1233,99.1,2449,1219,1230,99.1
31022, 중원구,020003, 17세,2016,2508,1269,1239,102.4,2504,1269,1235,102.8
31022, 중원구,020004, 18세,2016,2475,1279,1196,106.9,2460,1272,1188,107.1
31022, 중원구,020005, 19세,2016,2635,1328,1307,101.6,2617,1323,1294,102.2
31022, 중원구,025,20~24세,2016,16233,8425,7808,107.9,15962,8299,7663,108.3
31022, 중원구,025001, 20세,2016,2969,1530,1439,106.3,2947,1518,1429,106.2
31022, 중원구,025002, 21세,2016,3067,1634,1433,114,3023,1618,1405,115.2
31022, 중원구,025003, 22세,2016,3202,1670,1532,109,3153,1649,1504,109.6
31022, 중원구,025004, 23세,2016,3358,1753,1605,109.2,3297,1716,1581,108.5
31022, 중원구,025005, 24세,2016,3637,1838,1799,102.2,3542,1798,1744,103.1
31022, 중원구,030,25~29세,2016,17030,8818,8212,107.4,16474,8568,7906,108.4
31022, 중원구,030001, 25세,2016,3569,1795,1774,101.2,3482,1754,1728,101.5
31022, 중원구,030002, 26세,2016,3375,1727,1648,104.8,3258,1672,1586,105.4
31022, 중원구,030003, 27세,2016,3339,1744,1595,109.3,3233,1696,1537,110.3
31022, 중원구,030004, 28세,2016,3389,1789,1600,111.8,3253,1732,1521,113.9
31022, 중원구,030005, 29세,2016,3358,1763,1595,110.5,3248,1714,1534,111.7
31022, 중원구,035,30~34세,2016,18878,9896,8982,110.2,18338,9634,8704,110.7
31022, 중원구,035001, 30세,2016,3376,1794,1582,113.4,3274,1743,1531,113.8
31022, 중원구,035002, 31세,2016,3517,1812,1705,106.3,3407,1760,1647,106.9
31022, 중원구,035003, 32세,2016,3665,1924,1741,110.5,3543,1871,1672,111.9
31022, 중원구,035004, 33세,2016,4068,2155,1913,112.7,3970,2106,1864,113
31022, 중원구,035005, 34세,2016,4252,2211,2041,108.3,4144,2154,1990,108.2
31022, 중원구,040,35~39세,2016,19082,10128,8954,113.1,18657,9905,8752,113.2
31022, 중원구,040001, 35세,2016,4174,2183,1991,109.6,4083,2131,1952,109.2
31022, 중원구,040002, 36세,2016,4090,2172,1918,113.2,4006,2128,1878,113.3
31022, 중원구,040003, 37세,2016,3952,2053,1899,108.1,3863,2012,1851,108.7
31022, 중원구,040004, 38세,2016,3428,1849,1579,117.1,3343,1795,1548,116
31022, 중원구,040005, 39세,2016,3438,1871,1567,119.4,3362,1839,1523,120.7
31022, 중원구,045,40~44세,2016,18806,9970,8836,112.8,18413,9761,8652,112.8
31022, 중원구,045001, 40세,2016,3373,1819,1554,117.1,3316,1790,1526,117.3
31022, 중원구,045002, 41세,2016,3572,1885,1687,111.7,3497,1850,1647,112.3
31022, 중원구,045003, 42세,2016,3863,2027,1836,110.4,3773,1977,1796,110.1
31022, 중원구,045004, 43세,2016,3960,2061,1899,108.5,3870,2013,1857,108.4
31022, 중원구,045005, 44세,2016,4038,2178,1860,117.1,3957,2131,1826,116.7
31022, 중원구,050,45~49세,2016,21011,10671,10340,103.2,20444,10406,10038,103.7
31022, 중원구,050001, 45세,2016,4262,2248,2014,111.6,4159,2198,1961,112.1
31022, 중원구,050002, 46세,2016,4134,2144,1990,107.7,4014,2084,1930,108
31022, 중원구,050003, 47세,2016,4246,2097,2149,97.6,4136,2048,2088,98.1
31022, 중원구,050004, 48세,2016,4299,2168,2131,101.7,4165,2112,2053,102.9
31022, 중원구,050005, 49세,2016,4070,2014,2056,98,3970,1964,2006,97.9
31022, 중원구,055,50~54세,2016,20641,10319,10322,100,20038,10033,10005,100.3
31022, 중원구,055001, 50세,2016,4004,2004,2000,100.2,3897,1948,1949,99.9
31022, 중원구,055002, 51세,2016,4176,2077,2099,99,4044,2010,2034,98.8
31022, 중원구,055003, 52세,2016,3939,1926,2013,95.7,3810,1872,1938,96.6
31022, 중원구,055004, 53세,2016,4128,2133,1995,106.9,4006,2074,1932,107.3
31022, 중원구,055005, 54세,2016,4394,2179,2215,98.4,4281,2129,2152,98.9
31022, 중원구,060,55~59세,2016,21458,10743,10715,100.3,20983,10514,10469,100.4
31022, 중원구,060001, 55세,2016,4693,2243,2450,91.6,4635,2219,2416,91.8
31022, 중원구,060002, 56세,2016,4797,2388,2409,99.1,4687,2340,2347,99.7
31022, 중원구,060003, 57세,2016,4132,2051,2081,98.6,4024,1993,2031,98.1
31022, 중원구,060004, 58세,2016,3997,2085,1912,109,3886,2029,1857,109.3
31022, 중원구,060005, 59세,2016,3839,1976,1863,106.1,3751,1933,1818,106.3
31022, 중원구,065,60~64세,2016,15075,7375,7700,95.8,14713,7204,7509,95.9
31022, 중원구,065001, 60세,2016,3406,1677,1729,97,3318,1637,1681,97.4
31022, 중원구,065002, 61세,2016,3540,1682,1858,90.5,3458,1647,1811,90.9
31022, 중원구,065003, 62세,2016,2917,1430,1487,96.2,2852,1399,1453,96.3
31022, 중원구,065004, 63세,2016,2459,1212,1247,97.2,2397,1183,1214,97.4
31022, 중원구,065005, 64세,2016,2753,1374,1379,99.6,2688,1338,1350,99.1
31022, 중원구,070,65~69세,2016,10374,5092,5282,96.4,10215,5014,5201,96.4
31022, 중원구,070001, 65세,2016,1976,953,1023,93.2,1935,937,998,93.9
31022, 중원구,070002, 66세,2016,2081,1043,1038,100.5,2041,1017,1024,99.3
31022, 중원구,070003, 67세,2016,2164,1072,1092,98.2,2126,1054,1072,98.3
31022, 중원구,070004, 68세,2016,2057,1025,1032,99.3,2033,1013,1020,99.3
31022, 중원구,070005, 69세,2016,2096,999,1097,91.1,2080,993,1087,91.4
31022, 중원구,075,70~74세,2016,7673,3533,4140,85.3,7616,3511,4105,85.5
31022, 중원구,075001, 70세,2016,1529,709,820,86.5,1506,700,806,86.8
31022, 중원구,075002, 71세,2016,1515,715,800,89.4,1508,710,798,89
31022, 중원구,075003, 72세,2016,1470,642,828,77.5,1463,641,822,78
31022, 중원구,075004, 73세,2016,1447,686,761,90.1,1435,683,752,90.8
31022, 중원구,075005, 74세,2016,1712,781,931,83.9,1704,777,927,83.8
31022, 중원구,080,75~79세,2016,5368,2246,3122,71.9,5338,2237,3101,72.1
31022, 중원구,080001, 75세,2016,1301,588,713,82.5,1293,583,710,82.1
31022, 중원구,080002, 76세,2016,1166,494,672,73.5,1161,492,669,73.5
31022, 중원구,080003, 77세,2016,1074,436,638,68.3,1071,436,635,68.7
31022, 중원구,080004, 78세,2016,962,384,578,66.4,957,384,573,67
31022, 중원구,080005, 79세,2016,865,344,521,66,856,342,514,66.5
31022, 중원구,085,80~84세,2016,2922,990,1932,51.2,2903,984,1919,51.3
31022, 중원구,085001, 80세,2016,747,296,451,65.6,742,295,447,66
31022, 중원구,085002, 81세,2016,689,244,445,54.8,686,243,443,54.9
31022, 중원구,085003, 82세,2016,605,194,411,47.2,600,193,407,47.4
31022, 중원구,085004, 83세,2016,460,129,331,39,456,127,329,38.6
31022, 중원구,085005, 84세,2016,421,127,294,43.2,419,126,293,43
31022, 중원구,090,85~89세,2016,1380,319,1061,30.1,1377,319,1058,30.2
31022, 중원구,090001, 85세,2016,328,71,257,27.6,327,71,256,27.7
31022, 중원구,090002, 86세,2016,335,85,250,34,335,85,250,34
31022, 중원구,090003, 87세,2016,293,79,214,36.9,292,79,213,37.1
31022, 중원구,090004, 88세,2016,226,48,178,27,226,48,178,27
31022, 중원구,090005, 89세,2016,198,36,162,22.2,197,36,161,22.4
31022, 중원구,095,90~94세,2016,489,96,393,24.4,487,95,392,24.2
31022, 중원구,095001, 90세,2016,132,26,106,24.5,131,25,106,23.6
31022, 중원구,095002, 91세,2016,131,17,114,14.9,131,17,114,14.9
31022, 중원구,095003, 92세,2016,76,21,55,38.2,75,21,54,38.9
31022, 중원구,095004, 93세,2016,87,19,68,27.9,87,19,68,27.9
31022, 중원구,095005, 94세,2016,63,13,50,26,63,13,50,26
31022, 중원구,100,95~99세,2016,118,19,99,19.2,118,19,99,19.2
31022, 중원구,100001, 95세,2016,38,7,31,22.6,38,7,31,22.6
31022, 중원구,100002, 96세,2016,40,8,32,25,40,8,32,25
31022, 중원구,100003, 97세,2016,17,X,16,6.3,17,X,16,6.3
31022, 중원구,100004, 98세,2016,18,X,15,20,18,X,15,20
31022, 중원구,100005, 99세,2016,5,X,5,0,5,X,5,0
31022, 중원구,101,100세이상,2016,14,X,10,40,13,X,10,30
31022, 중원구,102,15세미만,2016,27429,14102,13327,105.8,27255,14011,13244,105.8
31022, 중원구,103,15~64세,2016,180517,92637,87880,105.4,176277,90599,85678,105.7
31022, 중원구,104,65세이상,2016,28338,12299,16039,76.7,28067,12182,15885,76.7
31022, 중원구,086,85세이상,2016,2001,438,1563,28,1995,436,1559,28
31022, 중원구,126,평균연령,2016,41.2,40.3,42.1,,41.1,40.2,42.1,
31022, 중원구,127,중위연령,2016,42.1,41,43.1,,42,41,43.1,
31023, 분당구,000,합계,2016,478277,231891,246386,94.1,472987,229393,243594,94.2
31023, 분당구,005,0~4세,2016,22196,11323,10873,104.1,22027,11233,10794,104.1
31023, 분당구,005001, 0세,2016,4333,2174,2159,100.7,4312,2160,2152,100.4
31023, 분당구,005002, 1세,2016,4409,2265,2144,105.6,4379,2251,2128,105.8
31023, 분당구,005003, 2세,2016,4323,2171,2152,100.9,4287,2155,2132,101.1
31023, 분당구,005004, 3세,2016,4500,2283,2217,103,4452,2256,2196,102.7
31023, 분당구,005005, 4세,2016,4631,2430,2201,110.4,4597,2411,2186,110.3
31023, 분당구,010,5~9세,2016,23742,12317,11425,107.8,23514,12207,11307,108
31023, 분당구,010001, 5세,2016,4679,2428,2251,107.9,4644,2412,2232,108.1
31023, 분당구,010002, 6세,2016,4631,2383,2248,106,4583,2365,2218,106.6
31023, 분당구,010003, 7세,2016,4634,2380,2254,105.6,4574,2346,2228,105.3
31023, 분당구,010004, 8세,2016,4787,2467,2320,106.3,4747,2445,2302,106.2
31023, 분당구,010005, 9세,2016,5011,2659,2352,113.1,4966,2639,2327,113.4
31023, 분당구,015,10~14세,2016,25436,13139,12297,106.8,25215,12994,12221,106.3
31023, 분당구,015001, 10세,2016,4676,2409,2267,106.3,4638,2381,2257,105.5
31023, 분당구,015002, 11세,2016,4618,2392,2226,107.5,4585,2371,2214,107.1
31023, 분당구,015003, 12세,2016,5326,2736,2590,105.6,5279,2704,2575,105
31023, 분당구,015004, 13세,2016,5453,2810,2643,106.3,5403,2778,2625,105.8
31023, 분당구,015005, 14세,2016,5363,2792,2571,108.6,5310,2760,2550,108.2
31023, 분당구,020,15~19세,2016,31067,15802,15265,103.5,30815,15666,15149,103.4
31023, 분당구,020001, 15세,2016,6264,3209,3055,105,6204,3172,3032,104.6
31023, 분당구,020002, 16세,2016,6777,3375,3402,99.2,6722,3348,3374,99.2
31023, 분당구,020003, 17세,2016,6298,3174,3124,101.6,6245,3143,3102,101.3
31023, 분당구,020004, 18세,2016,6309,3239,3070,105.5,6261,3214,3047,105.5
31023, 분당구,020005, 19세,2016,5419,2805,2614,107.3,5383,2789,2594,107.5
31023, 분당구,025,20~24세,2016,28477,14642,13835,105.8,28164,14498,13666,106.1
31023, 분당구,025001, 20세,2016,5412,2907,2505,116,5382,2888,2494,115.8
31023, 분당구,025002, 21세,2016,5577,3026,2551,118.6,5542,3012,2530,119.1
31023, 분당구,025003, 22세,2016,5696,3007,2689,111.8,5641,2985,2656,112.4
31023, 분당구,025004, 23세,2016,5726,2850,2876,99.1,5640,2808,2832,99.2
31023, 분당구,025005, 24세,2016,6066,2852,3214,88.7,5959,2805,3154,88.9
31023, 분당구,030,25~29세,2016,32165,15100,17065,88.5,31425,14779,16646,88.8
31023, 분당구,030001, 25세,2016,6356,2988,3368,88.7,6236,2933,3303,88.8
31023, 분당구,030002, 26세,2016,6191,2855,3336,85.6,6048,2798,3250,86.1
31023, 분당구,030003, 27세,2016,6427,3069,3358,91.4,6268,2997,3271,91.6
31023, 분당구,030004, 28세,2016,6499,3063,3436,89.1,6358,3008,3350,89.8
31023, 분당구,030005, 29세,2016,6692,3125,3567,87.6,6515,3043,3472,87.6
31023, 분당구,035,30~34세,2016,37145,17872,19273,92.7,36374,17483,18891,92.5
31023, 분당구,035001, 30세,2016,6843,3187,3656,87.2,6675,3103,3572,86.9
31023, 분당구,035002, 31세,2016,7010,3377,3633,93,6847,3302,3545,93.1
31023, 분당구,035003, 32세,2016,7246,3522,3724,94.6,7086,3440,3646,94.3
31023, 분당구,035004, 33세,2016,7794,3770,4024,93.7,7660,3704,3956,93.6
31023, 분당구,035005, 34세,2016,8252,4016,4236,94.8,8106,3934,4172,94.3
31023, 분당구,040,35~39세,2016,39666,18856,20810,90.6,39115,18585,20530,90.5
31023, 분당구,040001, 35세,2016,8342,4047,4295,94.2,8219,3988,4231,94.3
31023, 분당구,040002, 36세,2016,8410,3988,4422,90.2,8298,3929,4369,89.9
31023, 분당구,040003, 37세,2016,7971,3817,4154,91.9,7840,3756,4084,92
31023, 분당구,040004, 38세,2016,7276,3388,3888,87.1,7183,3339,3844,86.9
31023, 분당구,040005, 39세,2016,7667,3616,4051,89.3,7575,3573,4002,89.3
31023, 분당구,045,40~44세,2016,43158,19903,23255,85.6,42687,19666,23021,85.4
31023, 분당구,045001, 40세,2016,7725,3643,4082,89.2,7629,3590,4039,88.9
31023, 분당구,045002, 41세,2016,7938,3679,4259,86.4,7841,3639,4202,86.6
31023, 분당구,045003, 42세,2016,8894,4030,4864,82.9,8804,3987,4817,82.8
31023, 분당구,045004, 43세,2016,9100,4191,4909,85.4,9001,4138,4863,85.1
31023, 분당구,045005, 44세,2016,9501,4360,5141,84.8,9412,4312,5100,84.5
31023, 분당구,050,45~49세,2016,47906,23043,24863,92.7,47467,22825,24642,92.6
31023, 분당구,050001, 45세,2016,10470,4971,5499,90.4,10381,4924,5457,90.2
31023, 분당구,050002, 46세,2016,10091,4906,5185,94.6,9992,4855,5137,94.5
31023, 분당구,050003, 47세,2016,9852,4778,5074,94.2,9758,4729,5029,94
31023, 분당구,050004, 48세,2016,9175,4319,4856,88.9,9090,4274,4816,88.7
31023, 분당구,050005, 49세,2016,8318,4069,4249,95.8,8246,4043,4203,96.2
31023, 분당구,055,50~54세,2016,38204,19052,19152,99.5,37857,18916,18941,99.9
31023, 분당구,055001, 50세,2016,7678,3962,3716,106.6,7615,3933,3682,106.8
31023, 분당구,055002, 51세,2016,7898,3943,3955,99.7,7829,3906,3923,99.6
31023, 분당구,055003, 52세,2016,7591,3758,3833,98,7532,3739,3793,98.6
31023, 분당구,055004, 53세,2016,7721,3781,3940,96,7644,3753,3891,96.5
31023, 분당구,055005, 54세,2016,7316,3608,3708,97.3,7237,3585,3652,98.2
31023, 분당구,060,55~59세,2016,35070,17439,17631,98.9,34754,17326,17428,99.4
31023, 분당구,060001, 55세,2016,7892,3830,4062,94.3,7820,3806,4014,94.8
31023, 분당구,060002, 56세,2016,7556,3702,3854,96.1,7498,3686,3812,96.7
31023, 분당구,060003, 57세,2016,6918,3401,3517,96.7,6863,3376,3487,96.8
31023, 분당구,060004, 58세,2016,6413,3331,3082,108.1,6339,3300,3039,108.6
31023, 분당구,060005, 59세,2016,6291,3175,3116,101.9,6234,3158,3076,102.7
31023, 분당구,065,60~64세,2016,23807,11789,12018,98.1,23571,11694,11877,98.5
31023, 분당구,065001, 60세,2016,5572,2774,2798,99.1,5517,2754,2763,99.7
31023, 분당구,065002, 61세,2016,5619,2798,2821,99.2,5568,2776,2792,99.4
31023, 분당구,065003, 62세,2016,4490,2204,2286,96.4,4446,2185,2261,96.6
31023, 분당구,065004, 63세,2016,4047,1970,2077,94.8,4006,1955,2051,95.3
31023, 분당구,065005, 64세,2016,4079,2043,2036,100.3,4034,2024,2010,100.7
31023, 분당구,070,65~69세,2016,15821,7445,8376,88.9,15709,7409,8300,89.3
31023, 분당구,070001, 65세,2016,2754,1336,1418,94.2,2729,1327,1402,94.7
31023, 분당구,070002, 66세,2016,3193,1532,1661,92.2,3163,1521,1642,92.6
31023, 분당구,070003, 67세,2016,3306,1529,1777,86,3278,1519,1759,86.4
31023, 분당구,070004, 68세,2016,3201,1508,1693,89.1,3187,1506,1681,89.6
31023, 분당구,070005, 69세,2016,3367,1540,1827,84.3,3352,1536,1816,84.6
31023, 분당구,075,70~74세,2016,12622,5787,6835,84.7,12577,5765,6812,84.6
31023, 분당구,075001, 70세,2016,2576,1132,1444,78.4,2564,1128,1436,78.6
31023, 분당구,075002, 71세,2016,2508,1158,1350,85.8,2496,1151,1345,85.6
31023, 분당구,075003, 72세,2016,2447,1148,1299,88.4,2440,1145,1295,88.4
31023, 분당구,075004, 73세,2016,2389,1080,1309,82.5,2383,1077,1306,82.5
31023, 분당구,075005, 74세,2016,2702,1269,1433,88.6,2694,1264,1430,88.4
31023, 분당구,080,75~79세,2016,10032,4385,5647,77.7,10000,4368,5632,77.6
31023, 분당구,080001, 75세,2016,2287,1075,1212,88.7,2277,1068,1209,88.3
31023, 분당구,080002, 76세,2016,2066,893,1173,76.1,2057,887,1170,75.8
31023, 분당구,080003, 77세,2016,2025,875,1150,76.1,2022,873,1149,76
31023, 분당구,080004, 78세,2016,1831,780,1051,74.2,1824,779,1045,74.5
31023, 분당구,080005, 79세,2016,1823,762,1061,71.8,1820,761,1059,71.9
31023, 분당구,085,80~84세,2016,6679,2468,4211,58.6,6658,2461,4197,58.6
31023, 분당구,085001, 80세,2016,1646,670,976,68.6,1642,669,973,68.8
31023, 분당구,085002, 81세,2016,1521,595,926,64.3,1520,594,926,64.1
31023, 분당구,085003, 82세,2016,1290,441,849,51.9,1282,439,843,52.1
31023, 분당구,085004, 83세,2016,1140,400,740,54.1,1137,400,737,54.3
31023, 분당구,085005, 84세,2016,1082,362,720,50.3,1077,359,718,50
31023, 분당구,090,85~89세,2016,3544,1108,2436,45.5,3535,1105,2430,45.5
31023, 분당구,090001, 85세,2016,849,282,567,49.7,848,282,566,49.8
31023, 분당구,090002, 86세,2016,823,260,563,46.2,820,259,561,46.2
31023, 분당구,090003, 87세,2016,736,241,495,48.7,734,240,494,48.6
31023, 분당구,090004, 88세,2016,650,204,446,45.7,647,203,444,45.7
31023, 분당구,090005, 89세,2016,486,121,365,33.2,486,121,365,33.2
31023, 분당구,095,90~94세,2016,1257,345,912,37.8,1245,340,905,37.6
31023, 분당구,095001, 90세,2016,334,84,250,33.6,332,84,248,33.9
31023, 분당구,095002, 91세,2016,302,71,231,30.7,298,69,229,30.1
31023, 분당구,095003, 92세,2016,226,60,166,36.1,225,60,165,36.4
31023, 분당구,095004, 93세,2016,219,76,143,53.1,215,73,142,51.4
31023, 분당구,095005, 94세,2016,176,54,122,44.3,175,54,121,44.6
31023, 분당구,100,95~99세,2016,249,70,179,39.1,246,67,179,37.4
31023, 분당구,100001, 95세,2016,105,25,80,31.3,104,24,80,30
31023, 분당구,100002, 96세,2016,55,18,37,48.6,55,18,37,48.6
31023, 분당구,100003, 97세,2016,54,17,37,45.9,53,16,37,43.2
31023, 분당구,100004, 98세,2016,20,7,13,53.8,19,6,13,46.2
31023, 분당구,100005, 99세,2016,15,X,12,25,15,X,12,25
31023, 분당구,101,100세이상,2016,34,6,28,21.4,32,6,26,23.1
31023, 분당구,102,15세미만,2016,71374,36779,34595,106.3,70756,36434,34322,106.2
31023, 분당구,103,15~64세,2016,356665,173498,183167,94.7,352229,171438,180791,94.8
31023, 분당구,104,65세이상,2016,50238,21614,28624,75.5,50002,21521,28481,75.6
31023, 분당구,086,85세이상,2016,5084,1529,3555,43,5058,1518,3540,42.9
31023, 분당구,126,평균연령,2016,39.1,38.3,39.9,,39.1,38.3,39.9,
31023, 분당구,127,중위연령,2016,39.9,39.1,40.6,,40,39.2,40.6,
31030, 의정부시,000,합계,2016,424722,209604,215118,97.4,419838,207303,212535,97.5
31030, 의정부시,005,0~4세,2016,17565,8975,8590,104.5,17487,8934,8553,104.5
31030, 의정부시,005001, 0세,2016,3058,1548,1510,102.5,3046,1540,1506,102.3
31030, 의정부시,005002, 1세,2016,3491,1805,1686,107.1,3470,1796,1674,107.3
31030, 의정부시,005003, 2세,2016,3485,1775,1710,103.8,3472,1767,1705,103.6
31030, 의정부시,005004, 3세,2016,3585,1843,1742,105.8,3564,1832,1732,105.8
31030, 의정부시,005005, 4세,2016,3946,2004,1942,103.2,3935,1999,1936,103.3
31030, 의정부시,010,5~9세,2016,19302,9937,9365,106.1,19226,9899,9327,106.1
31030, 의정부시,010001, 5세,2016,3865,1990,1875,106.1,3849,1984,1865,106.4
31030, 의정부시,010002, 6세,2016,3814,1954,1860,105.1,3799,1948,1851,105.2
31030, 의정부시,010003, 7세,2016,3648,1814,1834,98.9,3627,1802,1825,98.7
31030, 의정부시,010004, 8세,2016,3852,2006,1846,108.7,3839,1999,1840,108.6
31030, 의정부시,010005, 9세,2016,4123,2173,1950,111.4,4112,2166,1946,111.3
31030, 의정부시,015,10~14세,2016,20084,10311,9773,105.5,20032,10273,9759,105.3
31030, 의정부시,015001, 10세,2016,3682,1860,1822,102.1,3671,1852,1819,101.8
31030, 의정부시,015002, 11세,2016,3725,1919,1806,106.3,3715,1913,1802,106.2
31030, 의정부시,015003, 12세,2016,4049,2064,1985,104,4037,2055,1982,103.7
31030, 의정부시,015004, 13세,2016,4154,2137,2017,105.9,4143,2128,2015,105.6
31030, 의정부시,015005, 14세,2016,4474,2331,2143,108.8,4466,2325,2141,108.6
31030, 의정부시,020,15~19세,2016,26144,13522,12622,107.1,26014,13448,12566,107
31030, 의정부시,020001, 15세,2016,4923,2526,2397,105.4,4913,2521,2392,105.4
31030, 의정부시,020002, 16세,2016,5447,2903,2544,114.1,5431,2894,2537,114.1
31030, 의정부시,020003, 17세,2016,5345,2829,2516,112.4,5326,2815,2511,112.1
31030, 의정부시,020004, 18세,2016,5235,2684,2551,105.2,5205,2669,2536,105.2
31030, 의정부시,020005, 19세,2016,5194,2580,2614,98.7,5139,2549,2590,98.4
31030, 의정부시,025,20~24세,2016,29442,15216,14226,107,29012,15011,14001,107.2
31030, 의정부시,025001, 20세,2016,5575,2972,2603,114.2,5510,2938,2572,114.2
31030, 의정부시,025002, 21세,2016,5843,3093,2750,112.5,5773,3054,2719,112.3
31030, 의정부시,025003, 22세,2016,5894,3086,2808,109.9,5820,3054,2766,110.4
31030, 의정부시,025004, 23세,2016,6109,3070,3039,101,6010,3021,2989,101.1
31030, 의정부시,025005, 24세,2016,6021,2995,3026,99,5899,2944,2955,99.6
31030, 의정부시,030,25~29세,2016,25859,12957,12902,100.4,25211,12669,12542,101
31030, 의정부시,030001, 25세,2016,5823,2887,2936,98.3,5696,2829,2867,98.7
31030, 의정부시,030002, 26세,2016,5322,2656,2666,99.6,5180,2590,2590,100
31030, 의정부시,030003, 27세,2016,5007,2550,2457,103.8,4883,2494,2389,104.4
31030, 의정부시,030004, 28세,2016,4932,2449,2483,98.6,4806,2400,2406,99.8
31030, 의정부시,030005, 29세,2016,4775,2415,2360,102.3,4646,2356,2290,102.9
31030, 의정부시,035,30~34세,2016,27330,13874,13456,103.1,26717,13596,13121,103.6
31030, 의정부시,035001, 30세,2016,4862,2487,2375,104.7,4732,2420,2312,104.7
31030, 의정부시,035002, 31세,2016,4919,2491,2428,102.6,4807,2444,2363,103.4
31030, 의정부시,035003, 32세,2016,5258,2675,2583,103.6,5126,2614,2512,104.1
31030, 의정부시,035004, 33세,2016,5961,3009,2952,101.9,5849,2964,2885,102.7
31030, 의정부시,035005, 34세,2016,6330,3212,3118,103,6203,3154,3049,103.4
31030, 의정부시,040,35~39세,2016,31945,16203,15742,102.9,31485,15980,15505,103.1
31030, 의정부시,040001, 35세,2016,6666,3383,3283,103,6567,3342,3225,103.6
31030, 의정부시,040002, 36세,2016,6685,3435,3250,105.7,6590,3387,3203,105.7
31030, 의정부시,040003, 37세,2016,6435,3281,3154,104,6344,3244,3100,104.6
31030, 의정부시,040004, 38세,2016,5899,2966,2933,101.1,5821,2920,2901,100.7
31030, 의정부시,040005, 39세,2016,6260,3138,3122,100.5,6163,3087,3076,100.4
31030, 의정부시,045,40~44세,2016,36009,17816,18193,97.9,35573,17596,17977,97.9
31030, 의정부시,045001, 40세,2016,6120,3083,3037,101.5,6031,3031,3000,101
31030, 의정부시,045002, 41세,2016,6720,3325,3395,97.9,6632,3284,3348,98.1
31030, 의정부시,045003, 42세,2016,7587,3771,3816,98.8,7512,3733,3779,98.8
31030, 의정부시,045004, 43세,2016,7590,3685,3905,94.4,7512,3647,3865,94.4
31030, 의정부시,045005, 44세,2016,7992,3952,4040,97.8,7886,3901,3985,97.9
31030, 의정부시,050,45~49세,2016,39818,19482,20336,95.8,39333,19240,20093,95.8
31030, 의정부시,050001, 45세,2016,8357,4189,4168,100.5,8258,4140,4118,100.5
31030, 의정부시,050002, 46세,2016,8067,3998,4069,98.3,7962,3943,4019,98.1
31030, 의정부시,050003, 47세,2016,8077,3950,4127,95.7,7985,3908,4077,95.9
31030, 의정부시,050004, 48세,2016,8027,3831,4196,91.3,7922,3778,4144,91.2
31030, 의정부시,050005, 49세,2016,7290,3514,3776,93.1,7206,3471,3735,92.9
31030, 의정부시,055,50~54세,2016,37228,18643,18585,100.3,36757,18435,18322,100.6
31030, 의정부시,055001, 50세,2016,7512,3695,3817,96.8,7412,3651,3761,97.1
31030, 의정부시,055002, 51세,2016,7554,3763,3791,99.3,7446,3719,3727,99.8
31030, 의정부시,055003, 52세,2016,7084,3573,3511,101.8,7002,3537,3465,102.1
31030, 의정부시,055004, 53세,2016,7520,3834,3686,104,7426,3784,3642,103.9
31030, 의정부시,055005, 54세,2016,7558,3778,3780,99.9,7471,3744,3727,100.5
31030, 의정부시,060,55~59세,2016,35181,17681,17500,101,34811,17517,17294,101.3
31030, 의정부시,060001, 55세,2016,7671,3798,3873,98.1,7599,3767,3832,98.3
31030, 의정부시,060002, 56세,2016,7790,3930,3860,101.8,7709,3897,3812,102.2
31030, 의정부시,060003, 57세,2016,6799,3431,3368,101.9,6726,3400,3326,102.2
31030, 의정부시,060004, 58세,2016,6576,3362,3214,104.6,6506,3332,3174,105
31030, 의정부시,060005, 59세,2016,6345,3160,3185,99.2,6271,3121,3150,99.1
31030, 의정부시,065,60~64세,2016,24612,11964,12648,94.6,24281,11818,12463,94.8
31030, 의정부시,065001, 60세,2016,5511,2765,2746,100.7,5446,2733,2713,100.7
31030, 의정부시,065002, 61세,2016,5662,2710,2952,91.8,5587,2673,2914,91.7
31030, 의정부시,065003, 62세,2016,4877,2395,2482,96.5,4812,2373,2439,97.3
31030, 의정부시,065004, 63세,2016,4125,2019,2106,95.9,4062,1993,2069,96.3
31030, 의정부시,065005, 64세,2016,4437,2075,2362,87.8,4374,2046,2328,87.9
31030, 의정부시,070,65~69세,2016,17367,8061,9306,86.6,17212,7988,9224,86.6
31030, 의정부시,070001, 65세,2016,3031,1424,1607,88.6,2992,1405,1587,88.5
31030, 의정부시,070002, 66세,2016,3476,1600,1876,85.3,3444,1588,1856,85.6
31030, 의정부시,070003, 67세,2016,3601,1677,1924,87.2,3572,1664,1908,87.2
31030, 의정부시,070004, 68세,2016,3540,1630,1910,85.3,3512,1616,1896,85.2
31030, 의정부시,070005, 69세,2016,3719,1730,1989,87,3692,1715,1977,86.7
31030, 의정부시,075,70~74세,2016,14631,6507,8124,80.1,14569,6481,8088,80.1
31030, 의정부시,075001, 70세,2016,2881,1277,1604,79.6,2864,1271,1593,79.8
31030, 의정부시,075002, 71세,2016,2823,1275,1548,82.4,2814,1271,1543,82.4
31030, 의정부시,075003, 72세,2016,2763,1232,1531,80.5,2752,1226,1526,80.3
31030, 의정부시,075004, 73세,2016,2847,1269,1578,80.4,2833,1264,1569,80.6
31030, 의정부시,075005, 74세,2016,3317,1454,1863,78,3306,1449,1857,78
31030, 의정부시,080,75~79세,2016,11599,4899,6700,73.1,11552,4882,6670,73.2
31030, 의정부시,080001, 75세,2016,2680,1176,1504,78.2,2665,1172,1493,78.5
31030, 의정부시,080002, 76세,2016,2481,1056,1425,74.1,2468,1052,1416,74.3
31030, 의정부시,080003, 77세,2016,2397,1037,1360,76.3,2390,1034,1356,76.3
31030, 의정부시,080004, 78세,2016,2144,857,1287,66.6,2137,853,1284,66.4
31030, 의정부시,080005, 79세,2016,1897,773,1124,68.8,1892,771,1121,68.8
31030, 의정부시,085,80~84세,2016,6658,2464,4194,58.8,6637,2455,4182,58.7
31030, 의정부시,085001, 80세,2016,1741,658,1083,60.8,1735,656,1079,60.8
31030, 의정부시,085002, 81세,2016,1541,593,948,62.6,1536,591,945,62.5
31030, 의정부시,085003, 82세,2016,1325,464,861,53.9,1323,462,861,53.7
31030, 의정부시,085004, 83세,2016,1107,412,695,59.3,1103,411,692,59.4
31030, 의정부시,085005, 84세,2016,944,337,607,55.5,940,335,605,55.4
31030, 의정부시,090,85~89세,2016,2798,819,1979,41.4,2787,813,1974,41.2
31030, 의정부시,090001, 85세,2016,683,231,452,51.1,681,230,451,51
31030, 의정부시,090002, 86세,2016,701,186,515,36.1,698,184,514,35.8
31030, 의정부시,090003, 87세,2016,586,177,409,43.3,583,175,408,42.9
31030, 의정부시,090004, 88세,2016,449,131,318,41.2,448,131,317,41.3
31030, 의정부시,090005, 89세,2016,379,94,285,33,377,93,284,32.7
31030, 의정부시,095,90~94세,2016,911,217,694,31.3,905,213,692,30.8
31030, 의정부시,095001, 90세,2016,268,63,205,30.7,268,63,205,30.7
31030, 의정부시,095002, 91세,2016,218,43,175,24.6,216,41,175,23.4
31030, 의정부시,095003, 92세,2016,157,36,121,29.8,157,36,121,29.8
31030, 의정부시,095004, 93세,2016,156,45,111,40.5,155,44,111,39.6
31030, 의정부시,095005, 94세,2016,112,30,82,36.6,109,29,80,36.3
31030, 의정부시,100,95~99세,2016,212,52,160,32.5,210,51,159,32.1
31030, 의정부시,100001, 95세,2016,76,23,53,43.4,75,23,52,44.2
31030, 의정부시,100002, 96세,2016,54,6,48,12.5,54,6,48,12.5
31030, 의정부시,100003, 97세,2016,37,14,23,60.9,36,13,23,56.5
31030, 의정부시,100004, 98세,2016,27,6,21,28.6,27,6,21,28.6
31030, 의정부시,100005, 99세,2016,18,X,15,20,18,X,15,20
31030, 의정부시,101,100세이상,2016,27,X,23,17.4,27,X,23,17.4
31030, 의정부시,102,15세미만,2016,56951,29223,27728,105.4,56745,29106,27639,105.3
31030, 의정부시,103,15~64세,2016,313568,157358,156210,100.7,309194,155310,153884,100.9
31030, 의정부시,104,65세이상,2016,54203,23023,31180,73.8,53899,22887,31012,73.8
31030, 의정부시,086,85세이상,2016,3948,1092,2856,38.2,3929,1081,2848,38
31030, 의정부시,126,평균연령,2016,40.8,39.8,41.8,,40.8,39.8,41.8,
31030, 의정부시,127,중위연령,2016,42.2,41.2,43.2,,42.3,41.2,43.2,
31040, 안양시,000,합계,2016,582049,288694,293355,98.4,572549,284027,288522,98.4
31040, 안양시,005,0~4세,2016,24505,12446,12059,103.2,24253,12328,11925,103.4
31040, 안양시,005001, 0세,2016,4861,2442,2419,101,4800,2411,2389,100.9
31040, 안양시,005002, 1세,2016,4973,2481,2492,99.6,4926,2455,2471,99.4
31040, 안양시,005003, 2세,2016,4844,2470,2374,104,4791,2447,2344,104.4
31040, 안양시,005004, 3세,2016,4698,2387,2311,103.3,4649,2368,2281,103.8
31040, 안양시,005005, 4세,2016,5129,2666,2463,108.2,5087,2647,2440,108.5
31040, 안양시,010,5~9세,2016,24965,12869,12096,106.4,24816,12797,12019,106.5
31040, 안양시,010001, 5세,2016,5107,2592,2515,103.1,5071,2577,2494,103.3
31040, 안양시,010002, 6세,2016,4864,2534,2330,108.8,4820,2517,2303,109.3
31040, 안양시,010003, 7세,2016,4656,2410,2246,107.3,4631,2394,2237,107
31040, 안양시,010004, 8세,2016,5114,2637,2477,106.5,5091,2623,2468,106.3
31040, 안양시,010005, 9세,2016,5224,2696,2528,106.6,5203,2686,2517,106.7
31040, 안양시,015,10~14세,2016,26816,13937,12879,108.2,26733,13887,12846,108.1
31040, 안양시,015001, 10세,2016,4979,2563,2416,106.1,4964,2555,2409,106.1
31040, 안양시,015002, 11세,2016,4916,2546,2370,107.4,4894,2532,2362,107.2
31040, 안양시,015003, 12세,2016,5350,2789,2561,108.9,5329,2776,2553,108.7
31040, 안양시,015004, 13세,2016,5780,3010,2770,108.7,5767,3002,2765,108.6
31040, 안양시,015005, 14세,2016,5791,3029,2762,109.7,5779,3022,2757,109.6
31040, 안양시,020,15~19세,2016,36340,18807,17533,107.3,36189,18742,17447,107.4
31040, 안양시,020001, 15세,2016,6720,3460,3260,106.1,6701,3451,3250,106.2
31040, 안양시,020002, 16세,2016,7156,3749,3407,110,7137,3741,3396,110.2
31040, 안양시,020003, 17세,2016,7257,3844,3413,112.6,7239,3835,3404,112.7
31040, 안양시,020004, 18세,2016,7581,3888,3693,105.3,7545,3867,3678,105.1
31040, 안양시,020005, 19세,2016,7626,3866,3760,102.8,7567,3848,3719,103.5
31040, 안양시,025,20~24세,2016,41601,21707,19894,109.1,41059,21441,19618,109.3
31040, 안양시,025001, 20세,2016,7757,4110,3647,112.7,7697,4081,3616,112.9
31040, 안양시,025002, 21세,2016,8294,4459,3835,116.3,8220,4423,3797,116.5
31040, 안양시,025003, 22세,2016,8499,4490,4009,112,8395,4425,3970,111.5
31040, 안양시,025004, 23세,2016,8351,4301,4050,106.2,8217,4242,3975,106.7
31040, 안양시,025005, 24세,2016,8700,4347,4353,99.9,8530,4270,4260,100.2
31040, 안양시,030,25~29세,2016,40595,20758,19837,104.6,39472,20256,19216,105.4
31040, 안양시,030001, 25세,2016,8640,4443,4197,105.9,8449,4355,4094,106.4
31040, 안양시,030002, 26세,2016,8154,4184,3970,105.4,7931,4083,3848,106.1
31040, 안양시,030003, 27세,2016,8054,4075,3979,102.4,7842,3980,3862,103.1
31040, 안양시,030004, 28세,2016,7960,4121,3839,107.3,7702,3999,3703,108
31040, 안양시,030005, 29세,2016,7787,3935,3852,102.2,7548,3839,3709,103.5
31040, 안양시,035,30~34세,2016,43043,22309,20734,107.6,41947,21728,20219,107.5
31040, 안양시,035001, 30세,2016,7952,4106,3846,106.8,7712,3979,3733,106.6
31040, 안양시,035002, 31세,2016,7952,4095,3857,106.2,7745,3998,3747,106.7
31040, 안양시,035003, 32세,2016,8516,4429,4087,108.4,8287,4306,3981,108.2
31040, 안양시,035004, 33세,2016,9025,4661,4364,106.8,8817,4546,4271,106.4
31040, 안양시,035005, 34세,2016,9598,5018,4580,109.6,9386,4899,4487,109.2
31040, 안양시,040,35~39세,2016,44144,22175,21969,100.9,43331,21727,21604,100.6
31040, 안양시,040001, 35세,2016,9499,4899,4600,106.5,9332,4814,4518,106.6
31040, 안양시,040002, 36세,2016,9338,4670,4668,100,9176,4569,4607,99.2
31040, 안양시,040003, 37세,2016,8897,4510,4387,102.8,8697,4408,4289,102.8
31040, 안양시,040004, 38세,2016,8037,3986,4051,98.4,7889,3904,3985,98
31040, 안양시,040005, 39세,2016,8373,4110,4263,96.4,8237,4032,4205,95.9
31040, 안양시,045,40~44세,2016,47451,23414,24037,97.4,46687,22991,23696,97
31040, 안양시,045001, 40세,2016,8378,4199,4179,100.5,8247,4123,4124,100
31040, 안양시,045002, 41세,2016,8930,4390,4540,96.7,8791,4310,4481,96.2
31040, 안양시,045003, 42세,2016,9858,4894,4964,98.6,9701,4812,4889,98.4
31040, 안양시,045004, 43세,2016,10037,4826,5211,92.6,9875,4739,5136,92.3
31040, 안양시,045005, 44세,2016,10248,5105,5143,99.3,10073,5007,5066,98.8
31040, 안양시,050,45~49세,2016,54752,26266,28486,92.2,53735,25773,27962,92.2
31040, 안양시,050001, 45세,2016,11077,5374,5703,94.2,10882,5282,5600,94.3
31040, 안양시,050002, 46세,2016,10887,5225,5662,92.3,10671,5134,5537,92.7
31040, 안양시,050003, 47세,2016,11247,5402,5845,92.4,11052,5310,5742,92.5
31040, 안양시,050004, 48세,2016,11260,5404,5856,92.3,11053,5295,5758,92
31040, 안양시,050005, 49세,2016,10281,4861,5420,89.7,10077,4752,5325,89.2
31040, 안양시,055,50~54세,2016,51795,25505,26290,97,50653,24949,25704,97.1
31040, 안양시,055001, 50세,2016,10147,5076,5071,100.1,9955,4979,4976,100.1
31040, 안양시,055002, 51세,2016,10578,5153,5425,95,10354,5048,5306,95.1
31040, 안양시,055003, 52세,2016,10030,5024,5006,100.4,9790,4901,4889,100.2
31040, 안양시,055004, 53세,2016,10321,5078,5243,96.9,10047,4946,5101,97
31040, 안양시,055005, 54세,2016,10719,5174,5545,93.3,10507,5075,5432,93.4
31040, 안양시,060,55~59세,2016,51136,25166,25970,96.9,50113,24700,25413,97.2
31040, 안양시,060001, 55세,2016,11346,5436,5910,92,11185,5367,5818,92.2
31040, 안양시,060002, 56세,2016,11533,5575,5958,93.6,11300,5466,5834,93.7
31040, 안양시,060003, 57세,2016,9939,4935,5004,98.6,9750,4850,4900,99
31040, 안양시,060004, 58세,2016,9382,4784,4598,104,9165,4683,4482,104.5
31040, 안양시,060005, 59세,2016,8936,4436,4500,98.6,8713,4334,4379,99
31040, 안양시,065,60~64세,2016,34140,17305,16835,102.8,33334,16890,16444,102.7
31040, 안양시,065001, 60세,2016,7908,3933,3975,98.9,7723,3842,3881,99
31040, 안양시,065002, 61세,2016,8125,4093,4032,101.5,7939,3991,3948,101.1
31040, 안양시,065003, 62세,2016,6548,3385,3163,107,6394,3302,3092,106.8
31040, 안양시,065004, 63세,2016,5646,2887,2759,104.6,5497,2815,2682,105
31040, 안양시,065005, 64세,2016,5913,3007,2906,103.5,5781,2940,2841,103.5
31040, 안양시,070,65~69세,2016,20969,10373,10596,97.9,20673,10240,10433,98.2
31040, 안양시,070001, 65세,2016,4028,1988,2040,97.5,3946,1950,1996,97.7
31040, 안양시,070002, 66세,2016,4510,2319,2191,105.8,4439,2290,2149,106.6
31040, 안양시,070003, 67세,2016,4248,2154,2094,102.9,4174,2117,2057,102.9
31040, 안양시,070004, 68세,2016,4154,2022,2132,94.8,4110,2004,2106,95.2
31040, 안양시,070005, 69세,2016,4029,1890,2139,88.4,4004,1879,2125,88.4
31040, 안양시,075,70~74세,2016,15620,7105,8515,83.4,15523,7072,8451,83.7
31040, 안양시,075001, 70세,2016,3142,1498,1644,91.1,3123,1491,1632,91.4
31040, 안양시,075002, 71세,2016,3015,1375,1640,83.8,2993,1367,1626,84.1
31040, 안양시,075003, 72세,2016,3025,1347,1678,80.3,3000,1336,1664,80.3
31040, 안양시,075004, 73세,2016,2937,1337,1600,83.6,2921,1333,1588,83.9
31040, 안양시,075005, 74세,2016,3501,1548,1953,79.3,3486,1545,1941,79.6
31040, 안양시,080,75~79세,2016,11799,4834,6965,69.4,11728,4807,6921,69.5
31040, 안양시,080001, 75세,2016,2735,1175,1560,75.3,2712,1167,1545,75.5
31040, 안양시,080002, 76세,2016,2365,981,1384,70.9,2354,977,1377,71
31040, 안양시,080003, 77세,2016,2413,1014,1399,72.5,2399,1009,1390,72.6
31040, 안양시,080004, 78세,2016,2275,898,1377,65.2,2266,894,1372,65.2
31040, 안양시,080005, 79세,2016,2011,766,1245,61.5,1997,760,1237,61.4
31040, 안양시,085,80~84세,2016,7468,2458,5010,49.1,7423,2448,4975,49.2
31040, 안양시,085001, 80세,2016,1778,632,1146,55.1,1764,628,1136,55.3
31040, 안양시,085002, 81세,2016,1719,573,1146,50,1709,572,1137,50.3
31040, 안양시,085003, 82세,2016,1501,478,1023,46.7,1493,474,1019,46.5
31040, 안양시,085004, 83세,2016,1305,419,886,47.3,1300,418,882,47.4
31040, 안양시,085005, 84세,2016,1165,356,809,44,1157,356,801,44.4
31040, 안양시,090,85~89세,2016,3484,931,2553,36.5,3461,923,2538,36.4
31040, 안양시,090001, 85세,2016,912,255,657,38.8,908,255,653,39.1
31040, 안양시,090002, 86세,2016,867,240,627,38.3,859,234,625,37.4
31040, 안양시,090003, 87세,2016,651,175,476,36.8,648,174,474,36.7
31040, 안양시,090004, 88세,2016,585,144,441,32.7,580,143,437,32.7
31040, 안양시,090005, 89세,2016,469,117,352,33.2,466,117,349,33.5
31040, 안양시,095,90~94세,2016,1169,270,899,30,1163,269,894,30.1
31040, 안양시,095001, 90세,2016,342,73,269,27.1,340,72,268,26.9
31040, 안양시,095002, 91세,2016,314,76,238,31.9,312,76,236,32.2
31040, 안양시,095003, 92세,2016,200,58,142,40.8,199,58,141,41.1
31040, 안양시,095004, 93세,2016,189,39,150,26,189,39,150,26
31040, 안양시,095005, 94세,2016,124,24,100,24,123,24,99,24.2
31040, 안양시,100,95~99세,2016,232,56,176,31.8,231,56,175,32
31040, 안양시,100001, 95세,2016,85,17,68,25,85,17,68,25
31040, 안양시,100002, 96세,2016,64,20,44,45.5,63,20,43,46.5
31040, 안양시,100003, 97세,2016,40,12,28,42.9,40,12,28,42.9
31040, 안양시,100004, 98세,2016,24,5,19,26.3,24,5,19,26.3
31040, 안양시,100005, 99세,2016,19,X,17,11.8,19,X,17,11.8
31040, 안양시,101,100세이상,2016,25,X,22,13.6,25,X,22,13.6
31040, 안양시,102,15세미만,2016,76286,39252,37034,106,75802,39012,36790,106
31040, 안양시,103,15~64세,2016,444997,223412,221585,100.8,436520,219197,217323,100.9
31040, 안양시,104,65세이상,2016,60766,26030,34736,74.9,60227,25818,34409,75
31040, 안양시,086,85세이상,2016,4910,1260,3650,34.5,4880,1251,3629,34.5
31040, 안양시,126,평균연령,2016,39.9,39,40.9,,39.9,38.9,40.8,
31040, 안양시,127,중위연령,2016,41.1,39.8,42.2,,41,39.8,42.2,
31041, 만안구,000,합계,2016,244472,122449,122023,100.3,237665,119091,118574,100.4
31041, 만안구,005,0~4세,2016,9790,4941,4849,101.9,9606,4858,4748,102.3
31041, 만안구,005001, 0세,2016,2022,981,1041,94.2,1968,953,1015,93.9
31041, 만안구,005002, 1세,2016,1974,1009,965,104.6,1941,992,949,104.5
31041, 만안구,005003, 2세,2016,1933,969,964,100.5,1898,956,942,101.5
31041, 만안구,005004, 3세,2016,1835,915,920,99.5,1808,904,904,100
31041, 만안구,005005, 4세,2016,2026,1067,959,111.3,1991,1053,938,112.3
31041, 만안구,010,5~9세,2016,8972,4634,4338,106.8,8888,4595,4293,107
31041, 만안구,010001, 5세,2016,1831,920,911,101,1813,913,900,101.4
31041, 만안구,010002, 6세,2016,1780,926,854,108.4,1755,917,838,109.4
31041, 만안구,010003, 7세,2016,1651,850,801,106.1,1636,840,796,105.5
31041, 만안구,010004, 8세,2016,1869,978,891,109.8,1858,972,886,109.7
31041, 만안구,010005, 9세,2016,1841,960,881,109,1826,953,873,109.2
31041, 만안구,015,10~14세,2016,9250,4850,4400,110.2,9212,4834,4378,110.4
31041, 만안구,015001, 10세,2016,1749,900,849,106,1741,896,845,106
31041, 만안구,015002, 11세,2016,1678,884,794,111.3,1668,879,789,111.4
31041, 만안구,015003, 12세,2016,1814,964,850,113.4,1805,961,844,113.9
31041, 만안구,015004, 13세,2016,2039,1082,957,113.1,2035,1081,954,113.3
31041, 만안구,015005, 14세,2016,1970,1020,950,107.4,1963,1017,946,107.5
31041, 만안구,020,15~19세,2016,13931,7259,6672,108.8,13828,7213,6615,109
31041, 만안구,020001, 15세,2016,2351,1245,1106,112.6,2341,1238,1103,112.2
31041, 만안구,020002, 16세,2016,2781,1451,1330,109.1,2774,1449,1325,109.4
31041, 만안구,020003, 17세,2016,2673,1430,1243,115,2660,1424,1236,115.2
31041, 만안구,020004, 18세,2016,2904,1550,1354,114.5,2880,1535,1345,114.1
31041, 만안구,020005, 19세,2016,3222,1583,1639,96.6,3173,1567,1606,97.6
31041, 만안구,025,20~24세,2016,18229,9343,8886,105.1,17861,9160,8701,105.3
31041, 만안구,025001, 20세,2016,3237,1700,1537,110.6,3194,1680,1514,111
31041, 만안구,025002, 21세,2016,3628,1874,1754,106.8,3567,1845,1722,107.1
31041, 만안구,025003, 22세,2016,3784,1943,1841,105.5,3708,1895,1813,104.5
31041, 만안구,025004, 23세,2016,3716,1909,1807,105.6,3638,1870,1768,105.8
31041, 만안구,025005, 24세,2016,3864,1917,1947,98.5,3754,1870,1884,99.3
31041, 만안구,030,25~29세,2016,17676,9154,8522,107.4,16925,8821,8104,108.8
31041, 만안구,030001, 25세,2016,3769,1982,1787,110.9,3635,1922,1713,112.2
31041, 만안구,030002, 26세,2016,3554,1837,1717,107,3408,1778,1630,109.1
31041, 만안구,030003, 27세,2016,3517,1798,1719,104.6,3369,1725,1644,104.9
31041, 만안구,030004, 28세,2016,3504,1844,1660,111.1,3340,1769,1571,112.6
31041, 만안구,030005, 29세,2016,3332,1693,1639,103.3,3173,1627,1546,105.2
31041, 만안구,035,30~34세,2016,18249,9689,8560,113.2,17528,9305,8223,113.2
31041, 만안구,035001, 30세,2016,3383,1764,1619,109,3228,1683,1545,108.9
31041, 만안구,035002, 31세,2016,3369,1794,1575,113.9,3225,1721,1504,114.4
31041, 만안구,035003, 32세,2016,3606,1964,1642,119.6,3465,1884,1581,119.2
31041, 만안구,035004, 33세,2016,3845,2009,1836,109.4,3706,1938,1768,109.6
31041, 만안구,035005, 34세,2016,4046,2158,1888,114.3,3904,2079,1825,113.9
31041, 만안구,040,35~39세,2016,18330,9613,8717,110.3,17784,9299,8485,109.6
31041, 만안구,040001, 35세,2016,4007,2155,1852,116.4,3906,2100,1806,116.3
31041, 만안구,040002, 36세,2016,3940,2042,1898,107.6,3836,1972,1864,105.8
31041, 만안구,040003, 37세,2016,3690,1920,1770,108.5,3544,1847,1697,108.8
31041, 만안구,040004, 38세,2016,3255,1703,1552,109.7,3158,1645,1513,108.7
31041, 만안구,040005, 39세,2016,3438,1793,1645,109,3340,1735,1605,108.1
31041, 만안구,045,40~44세,2016,18188,9529,8659,110,17662,9231,8431,109.5
31041, 만안구,045001, 40세,2016,3341,1798,1543,116.5,3251,1744,1507,115.7
31041, 만안구,045002, 41세,2016,3389,1780,1609,110.6,3296,1727,1569,110.1
31041, 만안구,045003, 42세,2016,3728,1976,1752,112.8,3626,1922,1704,112.8
31041, 만안구,045004, 43세,2016,3832,1949,1883,103.5,3710,1882,1828,103
31041, 만안구,045005, 44세,2016,3898,2026,1872,108.2,3779,1956,1823,107.3
31041, 만안구,050,45~49세,2016,21171,10264,10907,94.1,20426,9906,10520,94.2
31041, 만안구,050001, 45세,2016,4151,2076,2075,100,4018,2018,2000,100.9
31041, 만안구,050002, 46세,2016,4161,2019,2142,94.3,4001,1955,2046,95.6
31041, 만안구,050003, 47세,2016,4297,2078,2219,93.6,4156,2013,2143,93.9
31041, 만안구,050004, 48세,2016,4423,2137,2286,93.5,4267,2052,2215,92.6
31041, 만안구,050005, 49세,2016,4139,1954,2185,89.4,3984,1868,2116,88.3
31041, 만안구,055,50~54세,2016,22033,10893,11140,97.8,21139,10452,10687,97.8
31041, 만안구,055001, 50세,2016,4221,2111,2110,100,4073,2033,2040,99.7
31041, 만안구,055002, 51세,2016,4462,2144,2318,92.5,4297,2066,2231,92.6
31041, 만안구,055003, 52세,2016,4240,2180,2060,105.8,4049,2084,1965,106.1
31041, 만안구,055004, 53세,2016,4456,2178,2278,95.6,4232,2070,2162,95.7
31041, 만안구,055005, 54세,2016,4654,2280,2374,96,4488,2199,2289,96.1
31041, 만안구,060,55~59세,2016,22939,11290,11649,96.9,22117,10913,11204,97.4
31041, 만안구,060001, 55세,2016,4992,2413,2579,93.6,4858,2353,2505,93.9
31041, 만안구,060002, 56세,2016,5119,2504,2615,95.8,4935,2418,2517,96.1
31041, 만안구,060003, 57세,2016,4465,2211,2254,98.1,4315,2141,2174,98.5
31041, 만안구,060004, 58세,2016,4245,2140,2105,101.7,4071,2066,2005,103
31041, 만안구,060005, 59세,2016,4118,2022,2096,96.5,3938,1935,2003,96.6
31041, 만안구,065,60~64세,2016,16038,8021,8017,100,15404,7686,7718,99.6
31041, 만안구,065001, 60세,2016,3641,1800,1841,97.8,3490,1722,1768,97.4
31041, 만안구,065002, 61세,2016,3692,1807,1885,95.9,3541,1723,1818,94.8
31041, 만안구,065003, 62세,2016,3148,1632,1516,107.7,3032,1568,1464,107.1
31041, 만안구,065004, 63세,2016,2662,1349,1313,102.7,2549,1292,1257,102.8
31041, 만안구,065005, 64세,2016,2895,1433,1462,98,2792,1381,1411,97.9
31041, 만안구,070,65~69세,2016,10339,5146,5193,99.1,10124,5052,5072,99.6
31041, 만안구,070001, 65세,2016,1966,960,1006,95.4,1904,932,972,95.9
31041, 만안구,070002, 66세,2016,2213,1157,1056,109.6,2160,1136,1024,110.9
31041, 만안구,070003, 67세,2016,2108,1091,1017,107.3,2057,1064,993,107.2
31041, 만안구,070004, 68세,2016,2065,1018,1047,97.2,2033,1007,1026,98.1
31041, 만안구,070005, 69세,2016,1987,920,1067,86.2,1970,913,1057,86.4
31041, 만안구,075,70~74세,2016,7853,3629,4224,85.9,7781,3603,4178,86.2
31041, 만안구,075001, 70세,2016,1550,741,809,91.6,1537,735,802,91.6
31041, 만안구,075002, 71세,2016,1508,684,824,83,1491,677,814,83.2
31041, 만안구,075003, 72세,2016,1494,701,793,88.4,1475,693,782,88.6
31041, 만안구,075004, 73세,2016,1486,689,797,86.4,1473,686,787,87.2
31041, 만안구,075005, 74세,2016,1815,814,1001,81.3,1805,812,993,81.8
31041, 만안구,080,75~79세,2016,5821,2465,3356,73.5,5769,2446,3323,73.6
31041, 만안구,080001, 75세,2016,1362,608,754,80.6,1345,603,742,81.3
31041, 만안구,080002, 76세,2016,1148,491,657,74.7,1138,488,650,75.1
31041, 만안구,080003, 77세,2016,1198,520,678,76.7,1190,518,672,77.1
31041, 만안구,080004, 78세,2016,1123,456,667,68.4,1117,453,664,68.2
31041, 만안구,080005, 79세,2016,990,390,600,65,979,384,595,64.5
31041, 만안구,085,80~84세,2016,3472,1178,2294,51.4,3437,1173,2264,51.8
31041, 만안구,085001, 80세,2016,811,308,503,61.2,801,306,495,61.8
31041, 만안구,085002, 81세,2016,825,283,542,52.2,817,282,535,52.7
31041, 만안구,085003, 82세,2016,695,233,462,50.4,690,232,458,50.7
31041, 만안구,085004, 83세,2016,610,202,408,49.5,605,201,404,49.8
31041, 만안구,085005, 84세,2016,531,152,379,40.1,524,152,372,40.9
31041, 만안구,090,85~89세,2016,1532,397,1135,35,1516,391,1125,34.8
31041, 만안구,090001, 85세,2016,403,113,290,39,400,113,287,39.4
31041, 만안구,090002, 86세,2016,368,93,275,33.8,363,89,274,32.5
31041, 만안구,090003, 87세,2016,289,76,213,35.7,286,75,211,35.5
31041, 만안구,090004, 88세,2016,256,62,194,32,254,61,193,31.6
31041, 만안구,090005, 89세,2016,216,53,163,32.5,213,53,160,33.1
31041, 만안구,095,90~94세,2016,545,132,413,32,544,131,413,31.7
31041, 만안구,095001, 90세,2016,150,28,122,23,149,27,122,22.1
31041, 만안구,095002, 91세,2016,152,43,109,39.4,152,43,109,39.4
31041, 만안구,095003, 92세,2016,94,33,61,54.1,94,33,61,54.1
31041, 만안구,095004, 93세,2016,94,18,76,23.7,94,18,76,23.7
31041, 만안구,095005, 94세,2016,55,10,45,22.2,55,10,45,22.2
31041, 만안구,100,95~99세,2016,100,21,79,26.6,100,21,79,26.6
31041, 만안구,100001, 95세,2016,36,5,31,16.1,36,5,31,16.1
31041, 만안구,100002, 96세,2016,25,9,16,56.3,25,9,16,56.3
31041, 만안구,100003, 97세,2016,18,X,14,28.6,18,X,14,28.6
31041, 만안구,100004, 98세,2016,13,X,11,18.2,13,X,11,18.2
31041, 만안구,100005, 99세,2016,8,X,7,14.3,8,X,7,14.3
31041, 만안구,101,100세이상,2016,14,X,13,7.7,14,X,13,7.7
31041, 만안구,102,15세미만,2016,28012,14425,13587,106.2,27706,14287,13419,106.5
31041, 만안구,103,15~64세,2016,186784,95055,91729,103.6,180674,91986,88688,103.7
31041, 만안구,104,65세이상,2016,29676,12969,16707,77.6,29285,12818,16467,77.8
31041, 만안구,086,85세이상,2016,2191,551,1640,33.6,2174,544,1630,33.4
31041, 만안구,126,평균연령,2016,41.2,40.3,42.2,,41.2,40.2,42.2,
31041, 만안구,127,중위연령,2016,42.3,41,43.6,,42.2,40.8,43.5,
31042, 동안구,000,합계,2016,337577,166245,171332,97,334884,164936,169948,97.1
31042, 동안구,005,0~4세,2016,14715,7505,7210,104.1,14647,7470,7177,104.1
31042, 동안구,005001, 0세,2016,2839,1461,1378,106,2832,1458,1374,106.1
31042, 동안구,005002, 1세,2016,2999,1472,1527,96.4,2985,1463,1522,96.1
31042, 동안구,005003, 2세,2016,2911,1501,1410,106.5,2893,1491,1402,106.3
31042, 동안구,005004, 3세,2016,2863,1472,1391,105.8,2841,1464,1377,106.3
31042, 동안구,005005, 4세,2016,3103,1599,1504,106.3,3096,1594,1502,106.1
31042, 동안구,010,5~9세,2016,15993,8235,7758,106.1,15928,8202,7726,106.2
31042, 동안구,010001, 5세,2016,3276,1672,1604,104.2,3258,1664,1594,104.4
31042, 동안구,010002, 6세,2016,3084,1608,1476,108.9,3065,1600,1465,109.2
31042, 동안구,010003, 7세,2016,3005,1560,1445,108,2995,1554,1441,107.8
31042, 동안구,010004, 8세,2016,3245,1659,1586,104.6,3233,1651,1582,104.4
31042, 동안구,010005, 9세,2016,3383,1736,1647,105.4,3377,1733,1644,105.4
31042, 동안구,015,10~14세,2016,17566,9087,8479,107.2,17521,9053,8468,106.9
31042, 동안구,015001, 10세,2016,3230,1663,1567,106.1,3223,1659,1564,106.1
31042, 동안구,015002, 11세,2016,3238,1662,1576,105.5,3226,1653,1573,105.1
31042, 동안구,015003, 12세,2016,3536,1825,1711,106.7,3524,1815,1709,106.2
31042, 동안구,015004, 13세,2016,3741,1928,1813,106.3,3732,1921,1811,106.1
31042, 동안구,015005, 14세,2016,3821,2009,1812,110.9,3816,2005,1811,110.7
31042, 동안구,020,15~19세,2016,22409,11548,10861,106.3,22361,11529,10832,106.4
31042, 동안구,020001, 15세,2016,4369,2215,2154,102.8,4360,2213,2147,103.1
31042, 동안구,020002, 16세,2016,4375,2298,2077,110.6,4363,2292,2071,110.7
31042, 동안구,020003, 17세,2016,4584,2414,2170,111.2,4579,2411,2168,111.2
31042, 동안구,020004, 18세,2016,4677,2338,2339,100,4665,2332,2333,100
31042, 동안구,020005, 19세,2016,4404,2283,2121,107.6,4394,2281,2113,108
31042, 동안구,025,20~24세,2016,23372,12364,11008,112.3,23198,12281,10917,112.5
31042, 동안구,025001, 20세,2016,4520,2410,2110,114.2,4503,2401,2102,114.2
31042, 동안구,025002, 21세,2016,4666,2585,2081,124.2,4653,2578,2075,124.2
31042, 동안구,025003, 22세,2016,4715,2547,2168,117.5,4687,2530,2157,117.3
31042, 동안구,025004, 23세,2016,4635,2392,2243,106.6,4579,2372,2207,107.5
31042, 동안구,025005, 24세,2016,4836,2430,2406,101,4776,2400,2376,101
31042, 동안구,030,25~29세,2016,22919,11604,11315,102.6,22547,11435,11112,102.9
31042, 동안구,030001, 25세,2016,4871,2461,2410,102.1,4814,2433,2381,102.2
31042, 동안구,030002, 26세,2016,4600,2347,2253,104.2,4523,2305,2218,103.9
31042, 동안구,030003, 27세,2016,4537,2277,2260,100.8,4473,2255,2218,101.7
31042, 동안구,030004, 28세,2016,4456,2277,2179,104.5,4362,2230,2132,104.6
31042, 동안구,030005, 29세,2016,4455,2242,2213,101.3,4375,2212,2163,102.3
31042, 동안구,035,30~34세,2016,24794,12620,12174,103.7,24419,12423,11996,103.6
31042, 동안구,035001, 30세,2016,4569,2342,2227,105.2,4484,2296,2188,104.9
31042, 동안구,035002, 31세,2016,4583,2301,2282,100.8,4520,2277,2243,101.5
31042, 동안구,035003, 32세,2016,4910,2465,2445,100.8,4822,2422,2400,100.9
31042, 동안구,035004, 33세,2016,5180,2652,2528,104.9,5111,2608,2503,104.2
31042, 동안구,035005, 34세,2016,5552,2860,2692,106.2,5482,2820,2662,105.9
31042, 동안구,040,35~39세,2016,25814,12562,13252,94.8,25547,12428,13119,94.7
31042, 동안구,040001, 35세,2016,5492,2744,2748,99.9,5426,2714,2712,100.1
31042, 동안구,040002, 36세,2016,5398,2628,2770,94.9,5340,2597,2743,94.7
31042, 동안구,040003, 37세,2016,5207,2590,2617,99,5153,2561,2592,98.8
31042, 동안구,040004, 38세,2016,4782,2283,2499,91.4,4731,2259,2472,91.4
31042, 동안구,040005, 39세,2016,4935,2317,2618,88.5,4897,2297,2600,88.3
31042, 동안구,045,40~44세,2016,29263,13885,15378,90.3,29025,13760,15265,90.1
31042, 동안구,045001, 40세,2016,5037,2401,2636,91.1,4996,2379,2617,90.9
31042, 동안구,045002, 41세,2016,5541,2610,2931,89,5495,2583,2912,88.7
31042, 동안구,045003, 42세,2016,6130,2918,3212,90.8,6075,2890,3185,90.7
31042, 동안구,045004, 43세,2016,6205,2877,3328,86.4,6165,2857,3308,86.4
31042, 동안구,045005, 44세,2016,6350,3079,3271,94.1,6294,3051,3243,94.1
31042, 동안구,050,45~49세,2016,33581,16002,17579,91,33309,15867,17442,91
31042, 동안구,050001, 45세,2016,6926,3298,3628,90.9,6864,3264,3600,90.7
31042, 동안구,050002, 46세,2016,6726,3206,3520,91.1,6670,3179,3491,91.1
31042, 동안구,050003, 47세,2016,6950,3324,3626,91.7,6896,3297,3599,91.6
31042, 동안구,050004, 48세,2016,6837,3267,3570,91.5,6786,3243,3543,91.5
31042, 동안구,050005, 49세,2016,6142,2907,3235,89.9,6093,2884,3209,89.9
31042, 동안구,055,50~54세,2016,29762,14612,15150,96.4,29514,14497,15017,96.5
31042, 동안구,055001, 50세,2016,5926,2965,2961,100.1,5882,2946,2936,100.3
31042, 동안구,055002, 51세,2016,6116,3009,3107,96.8,6057,2982,3075,97
31042, 동안구,055003, 52세,2016,5790,2844,2946,96.5,5741,2817,2924,96.3
31042, 동안구,055004, 53세,2016,5865,2900,2965,97.8,5815,2876,2939,97.9
31042, 동안구,055005, 54세,2016,6065,2894,3171,91.3,6019,2876,3143,91.5
31042, 동안구,060,55~59세,2016,28197,13876,14321,96.9,27996,13787,14209,97
31042, 동안구,060001, 55세,2016,6354,3023,3331,90.8,6327,3014,3313,91
31042, 동안구,060002, 56세,2016,6414,3071,3343,91.9,6365,3048,3317,91.9
31042, 동안구,060003, 57세,2016,5474,2724,2750,99.1,5435,2709,2726,99.4
31042, 동안구,060004, 58세,2016,5137,2644,2493,106.1,5094,2617,2477,105.7
31042, 동안구,060005, 59세,2016,4818,2414,2404,100.4,4775,2399,2376,101
31042, 동안구,065,60~64세,2016,18102,9284,8818,105.3,17930,9204,8726,105.5
31042, 동안구,065001, 60세,2016,4267,2133,2134,100,4233,2120,2113,100.3
31042, 동안구,065002, 61세,2016,4433,2286,2147,106.5,4398,2268,2130,106.5
31042, 동안구,065003, 62세,2016,3400,1753,1647,106.4,3362,1734,1628,106.5
31042, 동안구,065004, 63세,2016,2984,1538,1446,106.4,2948,1523,1425,106.9
31042, 동안구,065005, 64세,2016,3018,1574,1444,109,2989,1559,1430,109
31042, 동안구,070,65~69세,2016,10630,5227,5403,96.7,10549,5188,5361,96.8
31042, 동안구,070001, 65세,2016,2062,1028,1034,99.4,2042,1018,1024,99.4
31042, 동안구,070002, 66세,2016,2297,1162,1135,102.4,2279,1154,1125,102.6
31042, 동안구,070003, 67세,2016,2140,1063,1077,98.7,2117,1053,1064,99
31042, 동안구,070004, 68세,2016,2089,1004,1085,92.5,2077,997,1080,92.3
31042, 동안구,070005, 69세,2016,2042,970,1072,90.5,2034,966,1068,90.4
31042, 동안구,075,70~74세,2016,7767,3476,4291,81,7742,3469,4273,81.2
31042, 동안구,075001, 70세,2016,1592,757,835,90.7,1586,756,830,91.1
31042, 동안구,075002, 71세,2016,1507,691,816,84.7,1502,690,812,85
31042, 동안구,075003, 72세,2016,1531,646,885,73,1525,643,882,72.9
31042, 동안구,075004, 73세,2016,1451,648,803,80.7,1448,647,801,80.8
31042, 동안구,075005, 74세,2016,1686,734,952,77.1,1681,733,948,77.3
31042, 동안구,080,75~79세,2016,5978,2369,3609,65.6,5959,2361,3598,65.6
31042, 동안구,080001, 75세,2016,1373,567,806,70.3,1367,564,803,70.2
31042, 동안구,080002, 76세,2016,1217,490,727,67.4,1216,489,727,67.3
31042, 동안구,080003, 77세,2016,1215,494,721,68.5,1209,491,718,68.4
31042, 동안구,080004, 78세,2016,1152,442,710,62.3,1149,441,708,62.3
31042, 동안구,080005, 79세,2016,1021,376,645,58.3,1018,376,642,58.6
31042, 동안구,085,80~84세,2016,3996,1280,2716,47.1,3986,1275,2711,47
31042, 동안구,085001, 80세,2016,967,324,643,50.4,963,322,641,50.2
31042, 동안구,085002, 81세,2016,894,290,604,48,892,290,602,48.2
31042, 동안구,085003, 82세,2016,806,245,561,43.7,803,242,561,43.1
31042, 동안구,085004, 83세,2016,695,217,478,45.4,695,217,478,45.4
31042, 동안구,085005, 84세,2016,634,204,430,47.4,633,204,429,47.6
31042, 동안구,090,85~89세,2016,1952,534,1418,37.7,1945,532,1413,37.7
31042, 동안구,090001, 85세,2016,509,142,367,38.7,508,142,366,38.8
31042, 동안구,090002, 86세,2016,499,147,352,41.8,496,145,351,41.3
31042, 동안구,090003, 87세,2016,362,99,263,37.6,362,99,263,37.6
31042, 동안구,090004, 88세,2016,329,82,247,33.2,326,82,244,33.6
31042, 동안구,090005, 89세,2016,253,64,189,33.9,253,64,189,33.9
31042, 동안구,095,90~94세,2016,624,138,486,28.4,619,138,481,28.7
31042, 동안구,095001, 90세,2016,192,45,147,30.6,191,45,146,30.8
31042, 동안구,095002, 91세,2016,162,33,129,25.6,160,33,127,26
31042, 동안구,095003, 92세,2016,106,25,81,30.9,105,25,80,31.3
31042, 동안구,095004, 93세,2016,95,21,74,28.4,95,21,74,28.4
31042, 동안구,095005, 94세,2016,69,14,55,25.5,68,14,54,25.9
31042, 동안구,100,95~99세,2016,132,35,97,36.1,131,35,96,36.5
31042, 동안구,100001, 95세,2016,49,12,37,32.4,49,12,37,32.4
31042, 동안구,100002, 96세,2016,39,11,28,39.3,38,11,27,40.7
31042, 동안구,100003, 97세,2016,22,8,14,57.1,22,8,14,57.1
31042, 동안구,100004, 98세,2016,11,X,8,37.5,11,X,8,37.5
31042, 동안구,100005, 99세,2016,11,X,10,10,11,X,10,10
31042, 동안구,101,100세이상,2016,11,X,9,22.2,11,X,9,22.2
31042, 동안구,102,15세미만,2016,48274,24827,23447,105.9,48096,24725,23371,105.8
31042, 동안구,103,15~64세,2016,258213,128357,129856,98.8,255846,127211,128635,98.9
31042, 동안구,104,65세이상,2016,31090,13061,18029,72.4,30942,13000,17942,72.5
31042, 동안구,086,85세이상,2016,2719,709,2010,35.3,2706,707,1999,35.4
31042, 동안구,126,평균연령,2016,39,38,39.9,,39,38,39.9,
31042, 동안구,127,중위연령,2016,40.2,39,41.3,,40.3,39,41.3,
31050, 부천시,000,합계,2016,844043,419916,424127,99,819205,407363,411842,98.9
31050, 부천시,005,0~4세,2016,35089,17991,17098,105.2,34381,17643,16738,105.4
31050, 부천시,005001, 0세,2016,6731,3466,3265,106.2,6549,3379,3170,106.6
31050, 부천시,005002, 1세,2016,6948,3595,3353,107.2,6813,3525,3288,107.2
31050, 부천시,005003, 2세,2016,7048,3517,3531,99.6,6900,3456,3444,100.3
31050, 부천시,005004, 3세,2016,6869,3548,3321,106.8,6749,3491,3258,107.2
31050, 부천시,005005, 4세,2016,7493,3865,3628,106.5,7370,3792,3578,106
31050, 부천시,010,5~9세,2016,35525,18175,17350,104.8,35244,18030,17214,104.7
31050, 부천시,010001, 5세,2016,7250,3667,3583,102.3,7178,3631,3547,102.4
31050, 부천시,010002, 6세,2016,7013,3582,3431,104.4,6950,3545,3405,104.1
31050, 부천시,010003, 7세,2016,6771,3482,3289,105.9,6722,3458,3264,105.9
31050, 부천시,010004, 8세,2016,7078,3649,3429,106.4,7028,3623,3405,106.4
31050, 부천시,010005, 9세,2016,7413,3795,3618,104.9,7366,3773,3593,105
31050, 부천시,015,10~14세,2016,35560,18283,17277,105.8,35421,18200,17221,105.7
31050, 부천시,015001, 10세,2016,6764,3487,3277,106.4,6723,3457,3266,105.8
31050, 부천시,015002, 11세,2016,6496,3316,3180,104.3,6462,3295,3167,104
31050, 부천시,015003, 12세,2016,7128,3578,3550,100.8,7098,3563,3535,100.8
31050, 부천시,015004, 13세,2016,7482,3927,3555,110.5,7469,3919,3550,110.4
31050, 부천시,015005, 14세,2016,7690,3975,3715,107,7669,3966,3703,107.1
31050, 부천시,020,15~19세,2016,48679,25106,23573,106.5,48405,24954,23451,106.4
31050, 부천시,020001, 15세,2016,8853,4562,4291,106.3,8826,4548,4278,106.3
31050, 부천시,020002, 16세,2016,9673,5065,4608,109.9,9645,5050,4595,109.9
31050, 부천시,020003, 17세,2016,9676,5006,4670,107.2,9635,4984,4651,107.2
31050, 부천시,020004, 18세,2016,10133,5239,4894,107,10077,5205,4872,106.8
31050, 부천시,020005, 19세,2016,10344,5234,5110,102.4,10222,5167,5055,102.2
31050, 부천시,025,20~24세,2016,60591,31857,28734,110.9,59347,31317,28030,111.7
31050, 부천시,025001, 20세,2016,11100,5957,5143,115.8,10939,5889,5050,116.6
31050, 부천시,025002, 21세,2016,11649,6382,5267,121.2,11465,6304,5161,122.1
31050, 부천시,025003, 22세,2016,12127,6439,5688,113.2,11909,6347,5562,114.1
31050, 부천시,025004, 23세,2016,12497,6413,6084,105.4,12209,6291,5918,106.3
31050, 부천시,025005, 24세,2016,13218,6666,6552,101.7,12825,6486,6339,102.3
31050, 부천시,030,25~29세,2016,61364,31167,30197,103.2,58215,29477,28738,102.6
31050, 부천시,030001, 25세,2016,12695,6383,6312,101.1,12283,6170,6113,100.9
31050, 부천시,030002, 26세,2016,12275,6162,6113,100.8,11683,5864,5819,100.8
31050, 부천시,030003, 27세,2016,12284,6325,5959,106.1,11627,5944,5683,104.6
31050, 부천시,030004, 28세,2016,12197,6284,5913,106.3,11481,5899,5582,105.7
31050, 부천시,030005, 29세,2016,11913,6013,5900,101.9,11141,5600,5541,101.1
31050, 부천시,035,30~34세,2016,65080,33538,31542,106.3,61724,31698,30026,105.6
31050, 부천시,035001, 30세,2016,12023,6243,5780,108,11314,5861,5453,107.5
31050, 부천시,035002, 31세,2016,12217,6270,5947,105.4,11507,5902,5605,105.3
31050, 부천시,035003, 32세,2016,12548,6378,6170,103.4,11891,6008,5883,102.1
31050, 부천시,035004, 33세,2016,13663,7032,6631,106,13012,6666,6346,105
31050, 부천시,035005, 34세,2016,14629,7615,7014,108.6,14000,7261,6739,107.7
31050, 부천시,040,35~39세,2016,67616,34680,32936,105.3,65310,33353,31957,104.4
31050, 부천시,040001, 35세,2016,14560,7560,7000,108,14056,7269,6787,107.1
31050, 부천시,040002, 36세,2016,14502,7348,7154,102.7,14037,7077,6960,101.7
31050, 부천시,040003, 37세,2016,13768,7111,6657,106.8,13276,6832,6444,106
31050, 부천시,040004, 38세,2016,12261,6314,5947,106.2,11821,6065,5756,105.4
31050, 부천시,040005, 39세,2016,12525,6347,6178,102.7,12120,6110,6010,101.7
31050, 부천시,045,40~44세,2016,67476,34280,33196,103.3,65451,33183,32268,102.8
31050, 부천시,045001, 40세,2016,12095,6223,5872,106,11703,6001,5702,105.2
31050, 부천시,045002, 41세,2016,12810,6506,6304,103.2,12430,6288,6142,102.4
31050, 부천시,045003, 42세,2016,14088,7171,6917,103.7,13723,6970,6753,103.2
31050, 부천시,045004, 43세,2016,14104,7106,6998,101.5,13684,6892,6792,101.5
31050, 부천시,045005, 44세,2016,14379,7274,7105,102.4,13911,7032,6879,102.2
31050, 부천시,050,45~49세,2016,75683,36813,38870,94.7,73305,35652,37653,94.7
31050, 부천시,050001, 45세,2016,15503,7742,7761,99.8,15056,7508,7548,99.5
31050, 부천시,050002, 46세,2016,14921,7275,7646,95.1,14421,7031,7390,95.1
31050, 부천시,050003, 47세,2016,15397,7516,7881,95.4,14902,7259,7643,95
31050, 부천시,050004, 48세,2016,15596,7447,8149,91.4,15059,7211,7848,91.9
31050, 부천시,050005, 49세,2016,14266,6833,7433,91.9,13867,6643,7224,92
31050, 부천시,055,50~54세,2016,76399,37347,39052,95.6,73402,35946,37456,96
31050, 부천시,055001, 50세,2016,14441,7039,7402,95.1,13987,6818,7169,95.1
31050, 부천시,055002, 51세,2016,15560,7424,8136,91.2,14970,7162,7808,91.7
31050, 부천시,055003, 52세,2016,14815,7186,7629,94.2,14217,6902,7315,94.4
31050, 부천시,055004, 53세,2016,15485,7654,7831,97.7,14737,7304,7433,98.3
31050, 부천시,055005, 54세,2016,16098,8044,8054,99.9,15491,7760,7731,100.4
31050, 부천시,060,55~59세,2016,77268,38254,39014,98.1,74832,37079,37753,98.2
31050, 부천시,060001, 55세,2016,17118,8368,8750,95.6,16764,8187,8577,95.5
31050, 부천시,060002, 56세,2016,17421,8543,8878,96.2,16812,8252,8560,96.4
31050, 부천시,060003, 57세,2016,15213,7579,7634,99.3,14717,7342,7375,99.6
31050, 부천시,060004, 58세,2016,14110,7041,7069,99.6,13617,6811,6806,100.1
31050, 부천시,060005, 59세,2016,13406,6723,6683,100.6,12922,6487,6435,100.8
31050, 부천시,065,60~64세,2016,50874,25518,25356,100.6,48700,24479,24221,101.1
31050, 부천시,065001, 60세,2016,12135,6086,6049,100.6,11661,5854,5807,100.8
31050, 부천시,065002, 61세,2016,12015,6035,5980,100.9,11498,5783,5715,101.2
31050, 부천시,065003, 62세,2016,9782,4875,4907,99.3,9312,4642,4670,99.4
31050, 부천시,065004, 63세,2016,8236,4183,4053,103.2,7856,4011,3845,104.3
31050, 부천시,065005, 64세,2016,8706,4339,4367,99.4,8373,4189,4184,100.1
31050, 부천시,070,65~69세,2016,30797,15399,15398,100,29945,15011,14934,100.5
31050, 부천시,070001, 65세,2016,6031,3122,2909,107.3,5782,3012,2770,108.7
31050, 부천시,070002, 66세,2016,6594,3269,3325,98.3,6360,3161,3199,98.8
31050, 부천시,070003, 67세,2016,6291,3173,3118,101.8,6113,3096,3017,102.6
31050, 부천시,070004, 68세,2016,6024,3024,3000,100.8,5904,2963,2941,100.7
31050, 부천시,070005, 69세,2016,5857,2811,3046,92.3,5786,2779,3007,92.4
31050, 부천시,075,70~74세,2016,21474,9930,11544,86,21246,9842,11404,86.3
31050, 부천시,075001, 70세,2016,4340,2170,2170,100,4267,2139,2128,100.5
31050, 부천시,075002, 71세,2016,4089,1963,2126,92.3,4044,1942,2102,92.4
31050, 부천시,075003, 72세,2016,4137,1869,2268,82.4,4096,1854,2242,82.7
31050, 부천시,075004, 73세,2016,4053,1801,2252,80,4019,1787,2232,80.1
31050, 부천시,075005, 74세,2016,4855,2127,2728,78,4820,2120,2700,78.5
31050, 부천시,080,75~79세,2016,16347,6374,9973,63.9,16204,6329,9875,64.1
31050, 부천시,080001, 75세,2016,3670,1497,2173,68.9,3632,1482,2150,68.9
31050, 부천시,080002, 76세,2016,3443,1427,2016,70.8,3414,1420,1994,71.2
31050, 부천시,080003, 77세,2016,3427,1339,2088,64.1,3402,1331,2071,64.3
31050, 부천시,080004, 78세,2016,3080,1133,1947,58.2,3045,1124,1921,58.5
31050, 부천시,080005, 79세,2016,2727,978,1749,55.9,2711,972,1739,55.9
31050, 부천시,085,80~84세,2016,10813,3407,7406,46,10706,3378,7328,46.1
31050, 부천시,085001, 80세,2016,2664,910,1754,51.9,2630,895,1735,51.6
31050, 부천시,085002, 81세,2016,2598,813,1785,45.5,2564,809,1755,46.1
31050, 부천시,085003, 82세,2016,2065,674,1391,48.5,2045,671,1374,48.8
31050, 부천시,085004, 83세,2016,1868,566,1302,43.5,1856,562,1294,43.4
31050, 부천시,085005, 84세,2016,1618,444,1174,37.8,1611,441,1170,37.7
31050, 부천시,090,85~89세,2016,5218,1350,3868,34.9,5186,1345,3841,35
31050, 부천시,090001, 85세,2016,1313,376,937,40.1,1308,375,933,40.2
31050, 부천시,090002, 86세,2016,1205,309,896,34.5,1198,308,890,34.6
31050, 부천시,090003, 87세,2016,1096,280,816,34.3,1088,280,808,34.7
31050, 부천시,090004, 88세,2016,910,214,696,30.7,903,213,690,30.9
31050, 부천시,090005, 89세,2016,694,171,523,32.7,689,169,520,32.5
31050, 부천시,095,90~94세,2016,1728,357,1371,26,1720,357,1363,26.2
31050, 부천시,095001, 90세,2016,474,99,375,26.4,473,99,374,26.5
31050, 부천시,095002, 91세,2016,418,79,339,23.3,417,79,338,23.4
31050, 부천시,095003, 92세,2016,315,70,245,28.6,313,70,243,28.8
31050, 부천시,095004, 93세,2016,314,63,251,25.1,313,63,250,25.2
31050, 부천시,095005, 94세,2016,207,46,161,28.6,204,46,158,29.1
31050, 부천시,100,95~99세,2016,404,83,321,25.9,403,83,320,25.9
31050, 부천시,100001, 95세,2016,164,33,131,25.2,164,33,131,25.2
31050, 부천시,100002, 96세,2016,93,18,75,24,92,18,74,24.3
31050, 부천시,100003, 97세,2016,70,17,53,32.1,70,17,53,32.1
31050, 부천시,100004, 98세,2016,53,13,40,32.5,53,13,40,32.5
31050, 부천시,100005, 99세,2016,24,X,22,9.1,24,X,22,9.1
31050, 부천시,101,100세이상,2016,58,7,51,13.7,58,7,51,13.7
31050, 부천시,102,15세미만,2016,106174,54449,51725,105.3,105046,53873,51173,105.3
31050, 부천시,103,15~64세,2016,651030,328560,322470,101.9,628691,317138,311553,101.8
31050, 부천시,104,65세이상,2016,86839,36907,49932,73.9,85468,36352,49116,74
31050, 부천시,086,85세이상,2016,7408,1797,5611,32,7367,1792,5575,32.1
31050, 부천시,126,평균연령,2016,40.2,39.2,41.1,,40.1,39.1,41,
31050, 부천시,127,중위연령,2016,41,39.9,42.2,,41,39.8,42.1,
31060, 광명시,000,합계,2016,334361,165500,168861,98,326540,161708,164832,98.1
31060, 광명시,005,0~4세,2016,15836,8133,7703,105.6,15624,8025,7599,105.6
31060, 광명시,005001, 0세,2016,2962,1535,1427,107.6,2920,1514,1406,107.7
31060, 광명시,005002, 1세,2016,3060,1577,1483,106.3,3022,1560,1462,106.7
31060, 광명시,005003, 2세,2016,3140,1620,1520,106.6,3096,1597,1499,106.5
31060, 광명시,005004, 3세,2016,3184,1599,1585,100.9,3132,1572,1560,100.8
31060, 광명시,005005, 4세,2016,3490,1802,1688,106.8,3454,1782,1672,106.6
31060, 광명시,010,5~9세,2016,17056,8678,8378,103.6,16962,8632,8330,103.6
31060, 광명시,010001, 5세,2016,3441,1774,1667,106.4,3410,1753,1657,105.8
31060, 광명시,010002, 6세,2016,3307,1713,1594,107.5,3284,1704,1580,107.8
31060, 광명시,010003, 7세,2016,3276,1677,1599,104.9,3258,1670,1588,105.2
31060, 광명시,010004, 8세,2016,3489,1771,1718,103.1,3478,1765,1713,103
31060, 광명시,010005, 9세,2016,3543,1743,1800,96.8,3532,1740,1792,97.1
31060, 광명시,015,10~14세,2016,16587,8675,7912,109.6,16556,8660,7896,109.7
31060, 광명시,015001, 10세,2016,3241,1690,1551,109,3237,1689,1548,109.1
31060, 광명시,015002, 11세,2016,3136,1648,1488,110.8,3128,1642,1486,110.5
31060, 광명시,015003, 12세,2016,3449,1794,1655,108.4,3443,1792,1651,108.5
31060, 광명시,015004, 13세,2016,3363,1766,1597,110.6,3354,1762,1592,110.7
31060, 광명시,015005, 14세,2016,3398,1777,1621,109.6,3394,1775,1619,109.6
31060, 광명시,020,15~19세,2016,19743,10192,9551,106.7,19675,10159,9516,106.8
31060, 광명시,020001, 15세,2016,3916,2001,1915,104.5,3906,1997,1909,104.6
31060, 광명시,020002, 16세,2016,4124,2171,1953,111.2,4115,2165,1950,111
31060, 광명시,020003, 17세,2016,3979,2011,1968,102.2,3960,2002,1958,102.2
31060, 광명시,020004, 18세,2016,3999,2069,1930,107.2,3983,2063,1920,107.4
31060, 광명시,020005, 19세,2016,3725,1940,1785,108.7,3711,1932,1779,108.6
31060, 광명시,025,20~24세,2016,20258,10993,9265,118.7,19981,10859,9122,119
31060, 광명시,025001, 20세,2016,3855,2144,1711,125.3,3827,2130,1697,125.5
31060, 광명시,025002, 21세,2016,4003,2263,1740,130.1,3970,2246,1724,130.3
31060, 광명시,025003, 22세,2016,4024,2229,1795,124.2,3982,2208,1774,124.5
31060, 광명시,025004, 23세,2016,4078,2144,1934,110.9,3975,2092,1883,111.1
31060, 광명시,025005, 24세,2016,4298,2213,2085,106.1,4227,2183,2044,106.8
31060, 광명시,030,25~29세,2016,20646,10433,10213,102.2,19783,10019,9764,102.6
31060, 광명시,030001, 25세,2016,4346,2234,2112,105.8,4200,2160,2040,105.9
31060, 광명시,030002, 26세,2016,4063,2087,1976,105.6,3916,2018,1898,106.3
31060, 광명시,030003, 27세,2016,4025,2054,1971,104.2,3838,1972,1866,105.7
31060, 광명시,030004, 28세,2016,4079,2030,2049,99.1,3890,1937,1953,99.2
31060, 광명시,030005, 29세,2016,4133,2028,2105,96.3,3939,1932,2007,96.3
31060, 광명시,035,30~34세,2016,25044,12507,12537,99.8,24152,12075,12077,100
31060, 광명시,035001, 30세,2016,4372,2157,2215,97.4,4147,2045,2102,97.3
31060, 광명시,035002, 31세,2016,4493,2216,2277,97.3,4337,2141,2196,97.5
31060, 광명시,035003, 32세,2016,4896,2438,2458,99.2,4696,2345,2351,99.7
31060, 광명시,035004, 33세,2016,5281,2698,2583,104.5,5131,2627,2504,104.9
31060, 광명시,035005, 34세,2016,6002,2998,3004,99.8,5841,2917,2924,99.8
31060, 광명시,040,35~39세,2016,29004,14388,14616,98.4,28355,14046,14309,98.2
31060, 광명시,040001, 35세,2016,6072,3007,3065,98.1,5933,2934,2999,97.8
31060, 광명시,040002, 36세,2016,6095,3055,3040,100.5,5976,2992,2984,100.3
31060, 광명시,040003, 37세,2016,5916,2949,2967,99.4,5762,2871,2891,99.3
31060, 광명시,040004, 38세,2016,5328,2622,2706,96.9,5209,2559,2650,96.6
31060, 광명시,040005, 39세,2016,5593,2755,2838,97.1,5475,2690,2785,96.6
31060, 광명시,045,40~44세,2016,30202,15185,15017,101.1,29569,14853,14716,100.9
31060, 광명시,045001, 40세,2016,5524,2787,2737,101.8,5414,2723,2691,101.2
31060, 광명시,045002, 41세,2016,5859,2946,2913,101.1,5751,2888,2863,100.9
31060, 광명시,045003, 42세,2016,6189,3178,3011,105.5,6087,3130,2957,105.9
31060, 광명시,045004, 43세,2016,6318,3142,3176,98.9,6166,3063,3103,98.7
31060, 광명시,045005, 44세,2016,6312,3132,3180,98.5,6151,3049,3102,98.3
31060, 광명시,050,45~49세,2016,30496,15168,15328,99,29624,14752,14872,99.2
31060, 광명시,050001, 45세,2016,6577,3336,3241,102.9,6404,3249,3155,103
31060, 광명시,050002, 46세,2016,6118,3060,3058,100.1,5927,2969,2958,100.4
31060, 광명시,050003, 47세,2016,6128,3076,3052,100.8,5960,2999,2961,101.3
31060, 광명시,050004, 48세,2016,6112,2998,3114,96.3,5922,2902,3020,96.1
31060, 광명시,050005, 49세,2016,5561,2698,2863,94.2,5411,2633,2778,94.8
31060, 광명시,055,50~54세,2016,26755,13424,13331,100.7,25656,12889,12767,101
31060, 광명시,055001, 50세,2016,5286,2698,2588,104.3,5117,2615,2502,104.5
31060, 광명시,055002, 51세,2016,5593,2766,2827,97.8,5383,2673,2710,98.6
31060, 광명시,055003, 52세,2016,5046,2548,2498,102,4818,2436,2382,102.3
31060, 광명시,055004, 53세,2016,5371,2687,2684,100.1,5075,2542,2533,100.4
31060, 광명시,055005, 54세,2016,5459,2725,2734,99.7,5263,2623,2640,99.4
31060, 광명시,060,55~59세,2016,27168,13028,14140,92.1,26304,12609,13695,92.1
31060, 광명시,060001, 55세,2016,5956,2884,3072,93.9,5837,2824,3013,93.7
31060, 광명시,060002, 56세,2016,5840,2758,3082,89.5,5621,2665,2956,90.2
31060, 광명시,060003, 57세,2016,5339,2513,2826,88.9,5184,2446,2738,89.3
31060, 광명시,060004, 58세,2016,5063,2508,2555,98.2,4886,2411,2475,97.4
31060, 광명시,060005, 59세,2016,4970,2365,2605,90.8,4776,2263,2513,90.1
31060, 광명시,065,60~64세,2016,19716,9532,10184,93.6,18954,9173,9781,93.8
31060, 광명시,065001, 60세,2016,4518,2149,2369,90.7,4349,2066,2283,90.5
31060, 광명시,065002, 61세,2016,4570,2215,2355,94.1,4373,2127,2246,94.7
31060, 광명시,065003, 62세,2016,3845,1896,1949,97.3,3718,1840,1878,98
31060, 광명시,065004, 63세,2016,3249,1557,1692,92,3126,1498,1628,92
31060, 광명시,065005, 64세,2016,3534,1715,1819,94.3,3388,1642,1746,94
31060, 광명시,070,65~69세,2016,12823,6205,6618,93.8,12528,6068,6460,93.9
31060, 광명시,070001, 65세,2016,2469,1223,1246,98.2,2373,1178,1195,98.6
31060, 광명시,070002, 66세,2016,2684,1295,1389,93.2,2622,1264,1358,93.1
31060, 광명시,070003, 67세,2016,2586,1251,1335,93.7,2532,1226,1306,93.9
31060, 광명시,070004, 68세,2016,2530,1236,1294,95.5,2484,1214,1270,95.6
31060, 광명시,070005, 69세,2016,2554,1200,1354,88.6,2517,1186,1331,89.1
31060, 광명시,075,70~74세,2016,9301,4118,5183,79.5,9206,4083,5123,79.7
31060, 광명시,075001, 70세,2016,1825,839,986,85.1,1794,829,965,85.9
31060, 광명시,075002, 71세,2016,1798,821,977,84,1781,813,968,84
31060, 광명시,075003, 72세,2016,1730,774,956,81,1714,767,947,81
31060, 광명시,075004, 73세,2016,1840,794,1046,75.9,1826,790,1036,76.3
31060, 광명시,075005, 74세,2016,2108,890,1218,73.1,2091,884,1207,73.2
31060, 광명시,080,75~79세,2016,6959,2833,4126,68.7,6896,2810,4086,68.8
31060, 광명시,080001, 75세,2016,1654,685,969,70.7,1641,680,961,70.8
31060, 광명시,080002, 76세,2016,1447,605,842,71.9,1434,600,834,71.9
31060, 광명시,080003, 77세,2016,1431,600,831,72.2,1422,599,823,72.8
31060, 광명시,080004, 78세,2016,1293,509,784,64.9,1274,501,773,64.8
31060, 광명시,080005, 79세,2016,1134,434,700,62,1125,430,695,61.9
31060, 광명시,085,80~84세,2016,4204,1352,2852,47.4,4170,1343,2827,47.5
31060, 광명시,085001, 80세,2016,1037,348,689,50.5,1030,347,683,50.8
31060, 광명시,085002, 81세,2016,1003,302,701,43.1,998,302,696,43.4
31060, 광명시,085003, 82세,2016,814,275,539,51,805,273,532,51.3
31060, 광명시,085004, 83세,2016,701,220,481,45.7,693,217,476,45.6
31060, 광명시,085005, 84세,2016,649,207,442,46.8,644,204,440,46.4
31060, 광명시,090,85~89세,2016,1873,501,1372,36.5,1863,500,1363,36.7
31060, 광명시,090001, 85세,2016,497,143,354,40.4,494,143,351,40.7
31060, 광명시,090002, 86세,2016,475,125,350,35.7,474,124,350,35.4
31060, 광명시,090003, 87세,2016,360,105,255,41.2,355,105,250,42
31060, 광명시,090004, 88세,2016,325,74,251,29.5,324,74,250,29.6
31060, 광명시,090005, 89세,2016,216,54,162,33.3,216,54,162,33.3
31060, 광명시,095,90~94세,2016,550,124,426,29.1,543,122,421,29
31060, 광명시,095001, 90세,2016,160,36,124,29,158,35,123,28.5
31060, 광명시,095002, 91세,2016,137,25,112,22.3,136,24,112,21.4
31060, 광명시,095003, 92세,2016,98,22,76,28.9,98,22,76,28.9
31060, 광명시,095004, 93세,2016,87,26,61,42.6,86,26,60,43.3
31060, 광명시,095005, 94세,2016,68,15,53,28.3,65,15,50,30
31060, 광명시,100,95~99세,2016,122,26,96,27.1,121,26,95,27.4
31060, 광명시,100001, 95세,2016,41,11,30,36.7,41,11,30,36.7
31060, 광명시,100002, 96세,2016,32,8,24,33.3,32,8,24,33.3
31060, 광명시,100003, 97세,2016,22,X,19,15.8,21,X,18,16.7
31060, 광명시,100004, 98세,2016,19,X,15,26.7,19,X,15,26.7
31060, 광명시,100005, 99세,2016,8,X,8,0,8,X,8,0
31060, 광명시,101,100세이상,2016,18,5,13,38.5,18,5,13,38.5
31060, 광명시,102,15세미만,2016,49479,25486,23993,106.2,49142,25317,23825,106.3
31060, 광명시,103,15~64세,2016,249032,124850,124182,100.5,242053,121434,120619,100.7
31060, 광명시,104,65세이상,2016,35850,15164,20686,73.3,35345,14957,20388,73.4
31060, 광명시,086,85세이상,2016,2563,656,1907,34.4,2545,653,1892,34.5
31060, 광명시,126,평균연령,2016,39.6,38.5,40.6,,39.4,38.4,40.5,
31060, 광명시,127,중위연령,2016,40.5,39.5,41.5,,40.4,39.4,41.4,
31070, 평택시,000,합계,2016,472254,244149,228105,107,447825,229345,218480,105
31070, 평택시,005,0~4세,2016,23566,11992,11574,103.6,22992,11732,11260,104.2
31070, 평택시,005001, 0세,2016,4483,2280,2203,103.5,4333,2213,2120,104.4
31070, 평택시,005002, 1세,2016,4795,2491,2304,108.1,4670,2426,2244,108.1
31070, 평택시,005003, 2세,2016,4630,2318,2312,100.3,4521,2276,2245,101.4
31070, 평택시,005004, 3세,2016,4624,2273,2351,96.7,4527,2234,2293,97.4
31070, 평택시,005005, 4세,2016,5034,2630,2404,109.4,4941,2583,2358,109.5
31070, 평택시,010,5~9세,2016,24579,12600,11979,105.2,24262,12432,11830,105.1
31070, 평택시,010001, 5세,2016,4976,2527,2449,103.2,4903,2481,2422,102.4
31070, 평택시,010002, 6세,2016,4925,2585,2340,110.5,4843,2540,2303,110.3
31070, 평택시,010003, 7세,2016,4789,2440,2349,103.9,4725,2409,2316,104
31070, 평택시,010004, 8세,2016,4898,2488,2410,103.2,4850,2462,2388,103.1
31070, 평택시,010005, 9세,2016,4991,2560,2431,105.3,4941,2540,2401,105.8
31070, 평택시,015,10~14세,2016,23609,12143,11466,105.9,23467,12064,11403,105.8
31070, 평택시,015001, 10세,2016,4639,2333,2306,101.2,4606,2313,2293,100.9
31070, 평택시,015002, 11세,2016,4415,2253,2162,104.2,4390,2240,2150,104.2
31070, 평택시,015003, 12세,2016,4619,2383,2236,106.6,4589,2365,2224,106.3
31070, 평택시,015004, 13세,2016,4867,2492,2375,104.9,4845,2478,2367,104.7
31070, 평택시,015005, 14세,2016,5069,2682,2387,112.4,5037,2668,2369,112.6
31070, 평택시,020,15~19세,2016,29056,15381,13675,112.5,28787,15234,13553,112.4
31070, 평택시,020001, 15세,2016,5607,2919,2688,108.6,5568,2903,2665,108.9
31070, 평택시,020002, 16세,2016,6247,3349,2898,115.6,6203,3323,2880,115.4
31070, 평택시,020003, 17세,2016,5831,3094,2737,113,5779,3060,2719,112.5
31070, 평택시,020004, 18세,2016,5879,3080,2799,110,5827,3049,2778,109.8
31070, 평택시,020005, 19세,2016,5492,2939,2553,115.1,5410,2899,2511,115.5
31070, 평택시,025,20~24세,2016,30832,16620,14212,116.9,29090,15522,13568,114.4
31070, 평택시,025001, 20세,2016,5922,3181,2741,116.1,5763,3089,2674,115.5
31070, 평택시,025002, 21세,2016,6175,3407,2768,123.1,5937,3263,2674,122
31070, 평택시,025003, 22세,2016,6178,3300,2878,114.7,5822,3081,2741,112.4
31070, 평택시,025004, 23세,2016,6219,3316,2903,114.2,5769,3033,2736,110.9
31070, 평택시,025005, 24세,2016,6338,3416,2922,116.9,5799,3056,2743,111.4
31070, 평택시,030,25~29세,2016,31790,17797,13993,127.2,27795,15208,12587,120.8
31070, 평택시,030001, 25세,2016,6286,3446,2840,121.3,5658,3025,2633,114.9
31070, 평택시,030002, 26세,2016,6455,3632,2823,128.7,5656,3103,2553,121.5
31070, 평택시,030003, 27세,2016,6215,3546,2669,132.9,5418,3026,2392,126.5
31070, 평택시,030004, 28세,2016,6298,3512,2786,126.1,5432,2978,2454,121.4
31070, 평택시,030005, 29세,2016,6536,3661,2875,127.3,5631,3076,2555,120.4
31070, 평택시,035,30~34세,2016,36934,20215,16719,120.9,32644,17391,15253,114
31070, 평택시,035001, 30세,2016,6661,3673,2988,122.9,5728,3073,2655,115.7
31070, 평택시,035002, 31세,2016,6735,3689,3046,121.1,5913,3156,2757,114.5
31070, 평택시,035003, 32세,2016,7156,3960,3196,123.9,6276,3365,2911,115.6
31070, 평택시,035004, 33세,2016,7742,4189,3553,117.9,6923,3641,3282,110.9
31070, 평택시,035005, 34세,2016,8640,4704,3936,119.5,7804,4156,3648,113.9
31070, 평택시,040,35~39세,2016,41162,22319,18843,118.4,38010,20169,17841,113
31070, 평택시,040001, 35세,2016,8590,4725,3865,122.3,7885,4240,3645,116.3
31070, 평택시,040002, 36세,2016,8579,4656,3923,118.7,7923,4203,3720,113
31070, 평택시,040003, 37세,2016,8290,4457,3833,116.3,7615,4003,3612,110.8
31070, 평택시,040004, 38세,2016,7833,4220,3613,116.8,7235,3815,3420,111.5
31070, 평택시,040005, 39세,2016,7870,4261,3609,118.1,7352,3908,3444,113.5
31070, 평택시,045,40~44세,2016,42163,22261,19902,111.9,39873,20823,19050,109.3
31070, 평택시,045001, 40세,2016,7901,4242,3659,115.9,7361,3874,3487,111.1
31070, 평택시,045002, 41세,2016,8147,4263,3884,109.8,7712,3990,3722,107.2
31070, 평택시,045003, 42세,2016,8643,4600,4043,113.8,8209,4317,3892,110.9
31070, 평택시,045004, 43세,2016,8716,4460,4256,104.8,8287,4204,4083,103
31070, 평택시,045005, 44세,2016,8756,4696,4060,115.7,8304,4438,3866,114.8
31070, 평택시,050,45~49세,2016,43258,22426,20832,107.7,41088,21198,19890,106.6
31070, 평택시,050001, 45세,2016,9114,4824,4290,112.4,8647,4559,4088,111.5
31070, 평택시,050002, 46세,2016,8854,4682,4172,112.2,8374,4401,3973,110.8
31070, 평택시,050003, 47세,2016,8971,4570,4401,103.8,8498,4316,4182,103.2
31070, 평택시,050004, 48세,2016,8524,4328,4196,103.1,8095,4093,4002,102.3
31070, 평택시,050005, 49세,2016,7795,4022,3773,106.6,7474,3829,3645,105
31070, 평택시,055,50~54세,2016,37879,20144,17735,113.6,35849,19070,16779,113.7
31070, 평택시,055001, 50세,2016,7726,4160,3566,116.7,7324,3930,3394,115.8
31070, 평택시,055002, 51세,2016,8035,4185,3850,108.7,7617,3976,3641,109.2
31070, 평택시,055003, 52세,2016,7220,3854,3366,114.5,6836,3638,3198,113.8
31070, 평택시,055004, 53세,2016,7461,4006,3455,115.9,6976,3762,3214,117.1
31070, 평택시,055005, 54세,2016,7437,3939,3498,112.6,7096,3764,3332,113
31070, 평택시,060,55~59세,2016,33784,17529,16255,107.8,32306,16801,15505,108.4
31070, 평택시,060001, 55세,2016,7856,4135,3721,111.1,7630,4030,3600,111.9
31070, 평택시,060002, 56세,2016,7489,3796,3693,102.8,7127,3608,3519,102.5
31070, 평택시,060003, 57세,2016,6639,3437,3202,107.3,6348,3294,3054,107.9
31070, 평택시,060004, 58세,2016,6270,3278,2992,109.6,5959,3124,2835,110.2
31070, 평택시,060005, 59세,2016,5530,2883,2647,108.9,5242,2745,2497,109.9
31070, 평택시,065,60~64세,2016,22851,11340,11511,98.5,21715,10739,10976,97.8
31070, 평택시,065001, 60세,2016,5400,2780,2620,106.1,5110,2625,2485,105.6
31070, 평택시,065002, 61세,2016,5207,2538,2669,95.1,4936,2402,2534,94.8
31070, 평택시,065003, 62세,2016,4414,2176,2238,97.2,4195,2055,2140,96
31070, 평택시,065004, 63세,2016,3757,1854,1903,97.4,3557,1746,1811,96.4
31070, 평택시,065005, 64세,2016,4073,1992,2081,95.7,3917,1911,2006,95.3
31070, 평택시,070,65~69세,2016,15719,7436,8283,89.8,15261,7204,8057,89.4
31070, 평택시,070001, 65세,2016,2895,1408,1487,94.7,2764,1330,1434,92.7
31070, 평택시,070002, 66세,2016,3233,1532,1701,90.1,3133,1481,1652,89.6
31070, 평택시,070003, 67세,2016,3171,1476,1695,87.1,3089,1441,1648,87.4
31070, 평택시,070004, 68세,2016,3203,1481,1722,86,3130,1449,1681,86.2
31070, 평택시,070005, 69세,2016,3217,1539,1678,91.7,3145,1503,1642,91.5
31070, 평택시,075,70~74세,2016,13001,5743,7258,79.1,12830,5654,7176,78.8
31070, 평택시,075001, 70세,2016,2477,1179,1298,90.8,2422,1147,1275,90
31070, 평택시,075002, 71세,2016,2477,1118,1359,82.3,2444,1104,1340,82.4
31070, 평택시,075003, 72세,2016,2488,1048,1440,72.8,2463,1033,1430,72.2
31070, 평택시,075004, 73세,2016,2585,1122,1463,76.7,2550,1106,1444,76.6
31070, 평택시,075005, 74세,2016,2974,1276,1698,75.1,2951,1264,1687,74.9
31070, 평택시,080,75~79세,2016,11244,4631,6613,70,11121,4578,6543,70
31070, 평택시,080001, 75세,2016,2554,1100,1454,75.7,2521,1087,1434,75.8
31070, 평택시,080002, 76세,2016,2272,980,1292,75.9,2247,970,1277,76
31070, 평택시,080003, 77세,2016,2292,930,1362,68.3,2270,921,1349,68.3
31070, 평택시,080004, 78세,2016,2165,846,1319,64.1,2141,832,1309,63.6
31070, 평택시,080005, 79세,2016,1961,775,1186,65.3,1942,768,1174,65.4
31070, 평택시,085,80~84세,2016,6814,2468,4346,56.8,6754,2436,4318,56.4
31070, 평택시,085001, 80세,2016,1799,700,1099,63.7,1779,693,1086,63.8
31070, 평택시,085002, 81세,2016,1618,594,1024,58,1607,588,1019,57.7
31070, 평택시,085003, 82세,2016,1331,485,846,57.3,1320,478,842,56.8
31070, 평택시,085004, 83세,2016,1104,397,707,56.2,1095,391,704,55.5
31070, 평택시,085005, 84세,2016,962,292,670,43.6,953,286,667,42.9
31070, 평택시,090,85~89세,2016,2877,812,2065,39.3,2856,804,2052,39.2
31070, 평택시,090001, 85세,2016,742,218,524,41.6,739,216,523,41.3
31070, 평택시,090002, 86세,2016,687,201,486,41.4,683,200,483,41.4
31070, 평택시,090003, 87세,2016,599,159,440,36.1,591,156,435,35.9
31070, 평택시,090004, 88세,2016,462,124,338,36.7,459,122,337,36.2
31070, 평택시,090005, 89세,2016,387,110,277,39.7,384,110,274,40.1
31070, 평택시,095,90~94세,2016,903,229,674,34,894,224,670,33.4
31070, 평택시,095001, 90세,2016,252,53,199,26.6,251,52,199,26.1
31070, 평택시,095002, 91세,2016,211,49,162,30.2,209,48,161,29.8
31070, 평택시,095003, 92세,2016,158,48,110,43.6,158,48,110,43.6
31070, 평택시,095004, 93세,2016,172,52,120,43.3,168,50,118,42.4
31070, 평택시,095005, 94세,2016,110,27,83,32.5,108,26,82,31.7
31070, 평택시,100,95~99세,2016,204,59,145,40.7,202,58,144,40.3
31070, 평택시,100001, 95세,2016,70,22,48,45.8,69,22,47,46.8
31070, 평택시,100002, 96세,2016,49,12,37,32.4,48,11,37,29.7
31070, 평택시,100003, 97세,2016,35,8,27,29.6,35,8,27,29.6
31070, 평택시,100004, 98세,2016,30,10,20,50,30,10,20,50
31070, 평택시,100005, 99세,2016,20,7,13,53.8,20,7,13,53.8
31070, 평택시,101,100세이상,2016,29,X,25,16,29,X,25,16
31070, 평택시,102,15세미만,2016,71754,36735,35019,104.9,70721,36228,34493,105
31070, 평택시,103,15~64세,2016,349709,186032,163677,113.7,327157,172155,155002,111.1
31070, 평택시,104,65세이상,2016,50791,21382,29409,72.7,49947,20962,28985,72.3
31070, 평택시,086,85세이상,2016,4013,1104,2909,38,3981,1090,2891,37.7
31070, 평택시,126,평균연령,2016,38.9,37.9,39.8,,38.9,37.9,39.9,
31070, 평택시,127,중위연령,2016,39.3,38.4,40.4,,39.6,38.7,40.6,
31080, 동두천시,000,합계,2016,98625,49238,49387,99.7,94678,47130,47548,99.1
31080, 동두천시,005,0~4세,2016,4123,2135,1988,107.4,4009,2061,1948,105.8
31080, 동두천시,005001, 0세,2016,746,386,360,107.2,715,364,351,103.7
31080, 동두천시,005002, 1세,2016,800,422,378,111.6,771,402,369,108.9
31080, 동두천시,005003, 2세,2016,832,432,400,108,804,416,388,107.2
31080, 동두천시,005004, 3세,2016,859,440,419,105,842,431,411,104.9
31080, 동두천시,005005, 4세,2016,886,455,431,105.6,877,448,429,104.4
31080, 동두천시,010,5~9세,2016,4706,2379,2327,102.2,4638,2344,2294,102.2
31080, 동두천시,010001, 5세,2016,921,473,448,105.6,905,467,438,106.6
31080, 동두천시,010002, 6세,2016,972,521,451,115.5,953,509,444,114.6
31080, 동두천시,010003, 7세,2016,904,442,462,95.7,892,434,458,94.8
31080, 동두천시,010004, 8세,2016,901,431,470,91.7,890,427,463,92.2
31080, 동두천시,010005, 9세,2016,1008,512,496,103.2,998,507,491,103.3
31080, 동두천시,015,10~14세,2016,4426,2279,2147,106.1,4383,2252,2131,105.7
31080, 동두천시,015001, 10세,2016,862,430,432,99.5,854,427,427,100
31080, 동두천시,015002, 11세,2016,844,430,414,103.9,837,425,412,103.2
31080, 동두천시,015003, 12세,2016,895,468,427,109.6,880,458,422,108.5
31080, 동두천시,015004, 13세,2016,948,496,452,109.7,942,492,450,109.3
31080, 동두천시,015005, 14세,2016,877,455,422,107.8,870,450,420,107.1
31080, 동두천시,020,15~19세,2016,6027,2995,3032,98.8,5979,2979,3000,99.3
31080, 동두천시,020001, 15세,2016,1093,560,533,105.1,1080,555,525,105.7
31080, 동두천시,020002, 16세,2016,1362,649,713,91,1355,646,709,91.1
31080, 동두천시,020003, 17세,2016,1289,670,619,108.2,1284,668,616,108.4
31080, 동두천시,020004, 18세,2016,1203,616,587,104.9,1194,612,582,105.2
31080, 동두천시,020005, 19세,2016,1080,500,580,86.2,1066,498,568,87.7
31080, 동두천시,025,20~24세,2016,5858,3190,2668,119.6,5506,3014,2492,120.9
31080, 동두천시,025001, 20세,2016,1079,591,488,121.1,1057,583,474,123
31080, 동두천시,025002, 21세,2016,1212,678,534,127,1153,652,501,130.1
31080, 동두천시,025003, 22세,2016,1173,657,516,127.3,1103,620,483,128.4
31080, 동두천시,025004, 23세,2016,1202,642,560,114.6,1105,591,514,115
31080, 동두천시,025005, 24세,2016,1192,622,570,109.1,1088,568,520,109.2
31080, 동두천시,030,25~29세,2016,5532,2907,2625,110.7,4890,2595,2295,113.1
31080, 동두천시,030001, 25세,2016,1186,595,591,100.7,1081,547,534,102.4
31080, 동두천시,030002, 26세,2016,1098,571,527,108.3,979,511,468,109.2
31080, 동두천시,030003, 27세,2016,1053,557,496,112.3,911,484,427,113.3
31080, 동두천시,030004, 28세,2016,1092,580,512,113.3,946,518,428,121
31080, 동두천시,030005, 29세,2016,1103,604,499,121,973,535,438,122.1
31080, 동두천시,035,30~34세,2016,6400,3254,3146,103.4,5662,2898,2764,104.8
31080, 동두천시,035001, 30세,2016,1145,610,535,114,987,533,454,117.4
31080, 동두천시,035002, 31세,2016,1197,611,586,104.3,1034,538,496,108.5
31080, 동두천시,035003, 32세,2016,1220,584,636,91.8,1077,514,563,91.3
31080, 동두천시,035004, 33세,2016,1358,689,669,103,1203,619,584,106
31080, 동두천시,035005, 34세,2016,1480,760,720,105.6,1361,694,667,104
31080, 동두천시,040,35~39세,2016,7169,3669,3500,104.8,6670,3392,3278,103.5
31080, 동두천시,040001, 35세,2016,1550,776,774,100.3,1437,723,714,101.3
31080, 동두천시,040002, 36세,2016,1433,732,701,104.4,1339,676,663,102
31080, 동두천시,040003, 37세,2016,1435,745,690,108,1338,694,644,107.8
31080, 동두천시,040004, 38세,2016,1311,673,638,105.5,1215,618,597,103.5
31080, 동두천시,040005, 39세,2016,1440,743,697,106.6,1341,681,660,103.2
31080, 동두천시,045,40~44세,2016,8017,4206,3811,110.4,7624,3977,3647,109
31080, 동두천시,045001, 40세,2016,1450,775,675,114.8,1376,732,644,113.7
31080, 동두천시,045002, 41세,2016,1564,824,740,111.4,1454,757,697,108.6
31080, 동두천시,045003, 42세,2016,1607,850,757,112.3,1529,805,724,111.2
31080, 동두천시,045004, 43세,2016,1664,846,818,103.4,1587,801,786,101.9
31080, 동두천시,045005, 44세,2016,1732,911,821,111,1678,882,796,110.8
31080, 동두천시,050,45~49세,2016,8494,4543,3951,115,8138,4304,3834,112.3
31080, 동두천시,050001, 45세,2016,1763,920,843,109.1,1682,868,814,106.6
31080, 동두천시,050002, 46세,2016,1690,901,789,114.2,1608,846,762,111
31080, 동두천시,050003, 47세,2016,1755,944,811,116.4,1700,908,792,114.6
31080, 동두천시,050004, 48세,2016,1747,949,798,118.9,1671,898,773,116.2
31080, 동두천시,050005, 49세,2016,1539,829,710,116.8,1477,784,693,113.1
31080, 동두천시,055,50~54세,2016,7883,4184,3699,113.1,7636,4042,3594,112.5
31080, 동두천시,055001, 50세,2016,1621,906,715,126.7,1571,881,690,127.7
31080, 동두천시,055002, 51세,2016,1611,835,776,107.6,1541,794,747,106.3
31080, 동두천시,055003, 52세,2016,1482,779,703,110.8,1444,757,687,110.2
31080, 동두천시,055004, 53세,2016,1569,823,746,110.3,1522,794,728,109.1
31080, 동두천시,055005, 54세,2016,1600,841,759,110.8,1558,816,742,110
31080, 동두천시,060,55~59세,2016,7952,4037,3915,103.1,7762,3945,3817,103.4
31080, 동두천시,060001, 55세,2016,1695,862,833,103.5,1670,846,824,102.7
31080, 동두천시,060002, 56세,2016,1692,839,853,98.4,1651,820,831,98.7
31080, 동두천시,060003, 57세,2016,1550,784,766,102.3,1510,765,745,102.7
31080, 동두천시,060004, 58세,2016,1585,802,783,102.4,1544,786,758,103.7
31080, 동두천시,060005, 59세,2016,1430,750,680,110.3,1387,728,659,110.5
31080, 동두천시,065,60~64세,2016,5861,2862,2999,95.4,5728,2791,2937,95
31080, 동두천시,065001, 60세,2016,1296,658,638,103.1,1259,637,622,102.4
31080, 동두천시,065002, 61세,2016,1356,677,679,99.7,1331,661,670,98.7
31080, 동두천시,065003, 62세,2016,1167,567,600,94.5,1143,551,592,93.1
31080, 동두천시,065004, 63세,2016,979,449,530,84.7,953,441,512,86.1
31080, 동두천시,065005, 64세,2016,1063,511,552,92.6,1042,501,541,92.6
31080, 동두천시,070,65~69세,2016,4523,2055,2468,83.3,4460,2018,2442,82.6
31080, 동두천시,070001, 65세,2016,789,375,414,90.6,775,365,410,89
31080, 동두천시,070002, 66세,2016,837,402,435,92.4,824,394,430,91.6
31080, 동두천시,070003, 67세,2016,928,425,503,84.5,912,418,494,84.6
31080, 동두천시,070004, 68세,2016,954,410,544,75.4,945,404,541,74.7
31080, 동두천시,070005, 69세,2016,1015,443,572,77.4,1004,437,567,77.1
31080, 동두천시,075,70~74세,2016,4153,1765,2388,73.9,4126,1758,2368,74.2
31080, 동두천시,075001, 70세,2016,796,354,442,80.1,792,353,439,80.4
31080, 동두천시,075002, 71세,2016,759,343,416,82.5,754,342,412,83
31080, 동두천시,075003, 72세,2016,778,295,483,61.1,776,294,482,61
31080, 동두천시,075004, 73세,2016,832,370,462,80.1,826,369,457,80.7
31080, 동두천시,075005, 74세,2016,988,403,585,68.9,978,400,578,69.2
31080, 동두천시,080,75~79세,2016,3849,1509,2340,64.5,3831,1499,2332,64.3
31080, 동두천시,080001, 75세,2016,924,375,549,68.3,921,373,548,68.1
31080, 동두천시,080002, 76세,2016,804,321,483,66.5,797,317,480,66
31080, 동두천시,080003, 77세,2016,755,297,458,64.8,749,293,456,64.3
31080, 동두천시,080004, 78세,2016,718,275,443,62.1,717,275,442,62.2
31080, 동두천시,080005, 79세,2016,648,241,407,59.2,647,241,406,59.4
31080, 동두천시,085,80~84세,2016,2205,844,1361,62,2196,841,1355,62.1
31080, 동두천시,085001, 80세,2016,578,242,336,72,574,241,333,72.4
31080, 동두천시,085002, 81세,2016,509,203,306,66.3,507,202,305,66.2
31080, 동두천시,085003, 82세,2016,388,138,250,55.2,387,137,250,54.8
31080, 동두천시,085004, 83세,2016,396,137,259,52.9,395,137,258,53.1
31080, 동두천시,085005, 84세,2016,334,124,210,59,333,124,209,59.3
31080, 동두천시,090,85~89세,2016,990,304,686,44.3,987,301,686,43.9
31080, 동두천시,090001, 85세,2016,229,74,155,47.7,226,71,155,45.8
31080, 동두천시,090002, 86세,2016,231,72,159,45.3,231,72,159,45.3
31080, 동두천시,090003, 87세,2016,213,61,152,40.1,213,61,152,40.1
31080, 동두천시,090004, 88세,2016,180,56,124,45.2,180,56,124,45.2
31080, 동두천시,090005, 89세,2016,137,41,96,42.7,137,41,96,42.7
31080, 동두천시,095,90~94세,2016,355,95,260,36.5,351,93,258,36
31080, 동두천시,095001, 90세,2016,102,23,79,29.1,101,22,79,27.8
31080, 동두천시,095002, 91세,2016,83,22,61,36.1,83,22,61,36.1
31080, 동두천시,095003, 92세,2016,63,15,48,31.3,61,14,47,29.8
31080, 동두천시,095004, 93세,2016,58,20,38,52.6,58,20,38,52.6
31080, 동두천시,095005, 94세,2016,49,15,34,44.1,48,15,33,45.5
31080, 동두천시,100,95~99세,2016,85,21,64,32.8,85,21,64,32.8
31080, 동두천시,100001, 95세,2016,25,8,17,47.1,25,8,17,47.1
31080, 동두천시,100002, 96세,2016,24,5,19,26.3,24,5,19,26.3
31080, 동두천시,100003, 97세,2016,14,X,10,40,14,X,10,40
31080, 동두천시,100004, 98세,2016,12,X,10,20,12,X,10,20
31080, 동두천시,100005, 99세,2016,10,X,8,25,10,X,8,25
31080, 동두천시,101,100세이상,2016,17,5,12,41.7,17,5,12,41.7
31080, 동두천시,102,15세미만,2016,13255,6793,6462,105.1,13030,6657,6373,104.5
31080, 동두천시,103,15~64세,2016,69193,35847,33346,107.5,65595,33937,31658,107.2
31080, 동두천시,104,65세이상,2016,16177,6598,9579,68.9,16053,6536,9517,68.7
31080, 동두천시,086,85세이상,2016,1447,425,1022,41.6,1440,420,1020,41.2
31080, 동두천시,126,평균연령,2016,42.2,40.9,43.5,,42.4,41.1,43.8,
31080, 동두천시,127,중위연령,2016,43.3,42.2,44.3,,43.8,42.7,44.9,
31090, 안산시,000,합계,2016,743072,384147,358925,107,675377,345068,330309,104.5
31090, 안산시,005,0~4세,2016,29808,15037,14771,101.8,28002,14149,13853,102.1
31090, 안산시,005001, 0세,2016,5598,2870,2728,105.2,5191,2671,2520,106
31090, 안산시,005002, 1세,2016,6051,3002,3049,98.5,5695,2826,2869,98.5
31090, 안산시,005003, 2세,2016,5885,3003,2882,104.2,5498,2808,2690,104.4
31090, 안산시,005004, 3세,2016,5889,2975,2914,102.1,5558,2814,2744,102.6
31090, 안산시,005005, 4세,2016,6385,3187,3198,99.7,6060,3030,3030,100
31090, 안산시,010,5~9세,2016,31710,16294,15416,105.7,30695,15762,14933,105.6
31090, 안산시,010001, 5세,2016,6396,3253,3143,103.5,6136,3120,3016,103.4
31090, 안산시,010002, 6세,2016,6088,3133,2955,106,5875,3007,2868,104.8
31090, 안산시,010003, 7세,2016,5995,3111,2884,107.9,5794,3011,2783,108.2
31090, 안산시,010004, 8세,2016,6383,3317,3066,108.2,6198,3216,2982,107.8
31090, 안산시,010005, 9세,2016,6848,3480,3368,103.3,6692,3408,3284,103.8
31090, 안산시,015,10~14세,2016,33994,17487,16507,105.9,33494,17258,16236,106.3
31090, 안산시,015001, 10세,2016,6019,3130,2889,108.3,5903,3063,2840,107.9
31090, 안산시,015002, 11세,2016,6268,3189,3079,103.6,6172,3149,3023,104.2
31090, 안산시,015003, 12세,2016,6957,3596,3361,107,6857,3550,3307,107.3
31090, 안산시,015004, 13세,2016,7079,3648,3431,106.3,6983,3605,3378,106.7
31090, 안산시,015005, 14세,2016,7671,3924,3747,104.7,7579,3891,3688,105.5
31090, 안산시,020,15~19세,2016,50147,26151,23996,109,49515,25816,23699,108.9
31090, 안산시,020001, 15세,2016,9018,4654,4364,106.6,8940,4612,4328,106.6
31090, 안산시,020002, 16세,2016,10148,5361,4787,112,10035,5299,4736,111.9
31090, 안산시,020003, 17세,2016,10187,5310,4877,108.9,10055,5244,4811,109
31090, 안산시,020004, 18세,2016,10236,5326,4910,108.5,10101,5251,4850,108.3
31090, 안산시,020005, 19세,2016,10558,5500,5058,108.7,10384,5410,4974,108.8
31090, 안산시,025,20~24세,2016,59428,31300,28128,111.3,56338,29384,26954,109
31090, 안산시,025001, 20세,2016,11246,5899,5347,110.3,10944,5726,5218,109.7
31090, 안산시,025002, 21세,2016,11625,6190,5435,113.9,11223,5971,5252,113.7
31090, 안산시,025003, 22세,2016,11935,6362,5573,114.2,11352,5987,5365,111.6
31090, 안산시,025004, 23세,2016,12098,6280,5818,107.9,11288,5765,5523,104.4
31090, 안산시,025005, 24세,2016,12524,6569,5955,110.3,11531,5935,5596,106.1
31090, 안산시,030,25~29세,2016,56319,31143,25176,123.7,47387,25484,21903,116.3
31090, 안산시,030001, 25세,2016,11893,6393,5500,116.2,10630,5568,5062,110
31090, 안산시,030002, 26세,2016,11649,6473,5176,125.1,9913,5340,4573,116.8
31090, 안산시,030003, 27세,2016,11229,6188,5041,122.8,9367,5012,4355,115.1
31090, 안산시,030004, 28세,2016,10909,6122,4787,127.9,8908,4861,4047,120.1
31090, 안산시,030005, 29세,2016,10639,5967,4672,127.7,8569,4703,3866,121.7
31090, 안산시,035,30~34세,2016,55986,31224,24762,126.1,46217,25066,21151,118.5
31090, 안산시,035001, 30세,2016,10725,6010,4715,127.5,8618,4722,3896,121.2
31090, 안산시,035002, 31세,2016,10639,5930,4709,125.9,8541,4628,3913,118.3
31090, 안산시,035003, 32세,2016,10876,6065,4811,126.1,8916,4828,4088,118.1
31090, 안산시,035004, 33세,2016,11296,6236,5060,123.2,9606,5141,4465,115.1
31090, 안산시,035005, 34세,2016,12450,6983,5467,127.7,10536,5747,4789,120
31090, 안산시,040,35~39세,2016,59305,31871,27434,116.2,51574,27065,24509,110.4
31090, 안산시,040001, 35세,2016,12123,6681,5442,122.8,10489,5661,4828,117.3
31090, 안산시,040002, 36세,2016,12590,6756,5834,115.8,11023,5769,5254,109.8
31090, 안산시,040003, 37세,2016,11899,6343,5556,114.2,10210,5282,4928,107.2
31090, 안산시,040004, 38세,2016,11194,5975,5219,114.5,9717,5074,4643,109.3
31090, 안산시,040005, 39세,2016,11499,6116,5383,113.6,10135,5279,4856,108.7
31090, 안산시,045,40~44세,2016,66034,34340,31694,108.3,58970,29961,29009,103.3
31090, 안산시,045001, 40세,2016,11548,6137,5411,113.4,10170,5270,4900,107.6
31090, 안산시,045002, 41세,2016,12411,6529,5882,111,11102,5690,5412,105.1
31090, 안산시,045003, 42세,2016,13729,7196,6533,110.1,12381,6379,6002,106.3
31090, 안산시,045004, 43세,2016,13964,7153,6811,105,12491,6258,6233,100.4
31090, 안산시,045005, 44세,2016,14382,7325,7057,103.8,12826,6364,6462,98.5
31090, 안산시,050,45~49세,2016,77468,38805,38663,100.4,69605,34317,35288,97.2
31090, 안산시,050001, 45세,2016,15552,7819,7733,101.1,13829,6833,6996,97.7
31090, 안산시,050002, 46세,2016,15321,7698,7623,101,13646,6720,6926,97
31090, 안산시,050003, 47세,2016,16026,7960,8066,98.7,14447,7052,7395,95.4
31090, 안산시,050004, 48세,2016,16009,7965,8044,99,14417,7079,7338,96.5
31090, 안산시,050005, 49세,2016,14560,7363,7197,102.3,13266,6633,6633,100
31090, 안산시,055,50~54세,2016,71016,37254,33762,110.3,63596,33344,30252,110.2
31090, 안산시,055001, 50세,2016,14552,7492,7060,106.1,13131,6732,6399,105.2
31090, 안산시,055002, 51세,2016,15017,7731,7286,106.1,13513,6942,6571,105.6
31090, 안산시,055003, 52세,2016,13551,7117,6434,110.6,12084,6343,5741,110.5
31090, 안산시,055004, 53세,2016,14014,7516,6498,115.7,12301,6622,5679,116.6
31090, 안산시,055005, 54세,2016,13882,7398,6484,114.1,12567,6705,5862,114.4
31090, 안산시,060,55~59세,2016,58430,31168,27262,114.3,53243,28534,24709,115.5
31090, 안산시,060001, 55세,2016,13907,7365,6542,112.6,13029,6925,6104,113.5
31090, 안산시,060002, 56세,2016,13488,7191,6297,114.2,12169,6532,5637,115.9
31090, 안산시,060003, 57세,2016,11432,6183,5249,117.8,10415,5635,4780,117.9
31090, 안산시,060004, 58세,2016,10270,5506,4764,115.6,9247,4984,4263,116.9
31090, 안산시,060005, 59세,2016,9333,4923,4410,111.6,8383,4458,3925,113.6
31090, 안산시,065,60~64세,2016,33642,17448,16194,107.7,29643,15426,14217,108.5
31090, 안산시,065001, 60세,2016,8282,4374,3908,111.9,7330,3911,3419,114.4
31090, 안산시,065002, 61세,2016,7933,4142,3791,109.3,6979,3637,3342,108.8
31090, 안산시,065003, 62세,2016,6420,3283,3137,104.7,5559,2831,2728,103.8
31090, 안산시,065004, 63세,2016,5344,2797,2547,109.8,4661,2459,2202,111.7
31090, 안산시,065005, 64세,2016,5663,2852,2811,101.5,5114,2588,2526,102.5
31090, 안산시,070,65~69세,2016,19860,9766,10094,96.8,18201,8990,9211,97.6
31090, 안산시,070001, 65세,2016,3975,2017,1958,103,3481,1777,1704,104.3
31090, 안산시,070002, 66세,2016,4281,2125,2156,98.6,3862,1919,1943,98.8
31090, 안산시,070003, 67세,2016,4060,2014,2046,98.4,3713,1858,1855,100.2
31090, 안산시,070004, 68세,2016,3748,1816,1932,94,3548,1731,1817,95.3
31090, 안산시,070005, 69세,2016,3796,1794,2002,89.6,3597,1705,1892,90.1
31090, 안산시,075,70~74세,2016,14664,6465,8199,78.9,14176,6283,7893,79.6
31090, 안산시,075001, 70세,2016,2914,1379,1535,89.8,2771,1321,1450,91.1
31090, 안산시,075002, 71세,2016,2767,1237,1530,80.8,2667,1195,1472,81.2
31090, 안산시,075003, 72세,2016,2798,1240,1558,79.6,2701,1205,1496,80.5
31090, 안산시,075004, 73세,2016,2902,1218,1684,72.3,2830,1196,1634,73.2
31090, 안산시,075005, 74세,2016,3283,1391,1892,73.5,3207,1366,1841,74.2
31090, 안산시,080,75~79세,2016,12086,4574,7512,60.9,11749,4459,7290,61.2
31090, 안산시,080001, 75세,2016,2686,1049,1637,64.1,2622,1028,1594,64.5
31090, 안산시,080002, 76세,2016,2501,1019,1482,68.8,2421,992,1429,69.4
31090, 안산시,080003, 77세,2016,2474,954,1520,62.8,2403,928,1475,62.9
31090, 안산시,080004, 78세,2016,2292,800,1492,53.6,2217,773,1444,53.5
31090, 안산시,080005, 79세,2016,2133,752,1381,54.5,2086,738,1348,54.7
31090, 안산시,085,80~84세,2016,8034,2586,5448,47.5,7900,2546,5354,47.6
31090, 안산시,085001, 80세,2016,1980,678,1302,52.1,1940,667,1273,52.4
31090, 안산시,085002, 81세,2016,1901,629,1272,49.4,1872,617,1255,49.2
31090, 안산시,085003, 82세,2016,1587,505,1082,46.7,1560,497,1063,46.8
31090, 안산시,085004, 83세,2016,1353,417,936,44.6,1332,410,922,44.5
31090, 안산시,085005, 84세,2016,1213,357,856,41.7,1196,355,841,42.2
31090, 안산시,090,85~89세,2016,3562,921,2641,34.9,3511,914,2597,35.2
31090, 안산시,090001, 85세,2016,893,258,635,40.6,878,256,622,41.2
31090, 안산시,090002, 86세,2016,845,227,618,36.7,832,226,606,37.3
31090, 안산시,090003, 87세,2016,695,192,503,38.2,689,192,497,38.6
31090, 안산시,090004, 88세,2016,618,144,474,30.4,605,142,463,30.7
31090, 안산시,090005, 89세,2016,511,100,411,24.3,507,98,409,24
31090, 안산시,095,90~94세,2016,1283,268,1015,26.4,1269,265,1004,26.4
31090, 안산시,095001, 90세,2016,394,84,310,27.1,388,84,304,27.6
31090, 안산시,095002, 91세,2016,304,59,245,24.1,301,57,244,23.4
31090, 안산시,095003, 92세,2016,225,51,174,29.3,223,51,172,29.7
31090, 안산시,095004, 93세,2016,218,47,171,27.5,217,47,170,27.6
31090, 안산시,095005, 94세,2016,142,27,115,23.5,140,26,114,22.8
31090, 안산시,100,95~99세,2016,258,42,216,19.4,254,42,212,19.8
31090, 안산시,100001, 95세,2016,84,17,67,25.4,84,17,67,25.4
31090, 안산시,100002, 96세,2016,78,16,62,25.8,77,16,61,26.2
31090, 안산시,100003, 97세,2016,34,X,32,6.3,33,X,31,6.5
31090, 안산시,100004, 98세,2016,41,5,36,13.9,39,5,34,14.7
31090, 안산시,100005, 99세,2016,21,X,19,10.5,21,X,19,10.5
31090, 안산시,101,100세이상,2016,38,X,35,8.6,38,X,35,8.6
31090, 안산시,102,15세미만,2016,95512,48818,46694,104.5,92191,47169,45022,104.8
31090, 안산시,103,15~64세,2016,587775,310704,277071,112.1,526088,274397,251691,109
31090, 안산시,104,65세이상,2016,59785,24625,35160,70,57098,23502,33596,70
31090, 안산시,086,85세이상,2016,5141,1234,3907,31.6,5072,1224,3848,31.8
31090, 안산시,126,평균연령,2016,38.6,37.9,39.4,,38.4,37.7,39.1,
31090, 안산시,127,중위연령,2016,39.6,38.6,40.6,,39.5,38.6,40.4,
31091, 상록구,000,합계,2016,382533,194561,187972,103.5,368802,187475,181327,103.4
31091, 상록구,005,0~4세,2016,16015,8149,7866,103.6,15544,7917,7627,103.8
31091, 상록구,005001, 0세,2016,3037,1568,1469,106.7,2947,1522,1425,106.8
31091, 상록구,005002, 1세,2016,3359,1700,1659,102.5,3249,1644,1605,102.4
31091, 상록구,005003, 2세,2016,3115,1618,1497,108.1,3002,1558,1444,107.9
31091, 상록구,005004, 3세,2016,3131,1563,1568,99.7,3051,1522,1529,99.5
31091, 상록구,005005, 4세,2016,3373,1700,1673,101.6,3295,1671,1624,102.9
31091, 상록구,010,5~9세,2016,16460,8417,8043,104.7,16226,8287,7939,104.4
31091, 상록구,010001, 5세,2016,3311,1657,1654,100.2,3248,1630,1618,100.7
31091, 상록구,010002, 6세,2016,3224,1649,1575,104.7,3175,1620,1555,104.2
31091, 상록구,010003, 7세,2016,3066,1596,1470,108.6,3021,1568,1453,107.9
31091, 상록구,010004, 8세,2016,3275,1702,1573,108.2,3231,1672,1559,107.2
31091, 상록구,010005, 9세,2016,3584,1813,1771,102.4,3551,1797,1754,102.5
31091, 상록구,015,10~14세,2016,17878,9211,8667,106.3,17769,9161,8608,106.4
31091, 상록구,015001, 10세,2016,3155,1628,1527,106.6,3129,1612,1517,106.3
31091, 상록구,015002, 11세,2016,3330,1673,1657,101,3309,1667,1642,101.5
31091, 상록구,015003, 12세,2016,3612,1903,1709,111.4,3596,1896,1700,111.5
31091, 상록구,015004, 13세,2016,3729,1913,1816,105.3,3701,1900,1801,105.5
31091, 상록구,015005, 14세,2016,4052,2094,1958,106.9,4034,2086,1948,107.1
31091, 상록구,020,15~19세,2016,27073,13976,13097,106.7,26892,13881,13011,106.7
31091, 상록구,020001, 15세,2016,4807,2458,2349,104.6,4791,2450,2341,104.7
31091, 상록구,020002, 16세,2016,5223,2738,2485,110.2,5205,2728,2477,110.1
31091, 상록구,020003, 17세,2016,5404,2774,2630,105.5,5367,2756,2611,105.6
31091, 상록구,020004, 18세,2016,5557,2861,2696,106.1,5516,2839,2677,106.1
31091, 상록구,020005, 19세,2016,6082,3145,2937,107.1,6013,3108,2905,107
31091, 상록구,025,20~24세,2016,32943,17218,15725,109.5,32128,16809,15319,109.7
31091, 상록구,025001, 20세,2016,6404,3299,3105,106.2,6279,3234,3045,106.2
31091, 상록구,025002, 21세,2016,6463,3367,3096,108.8,6325,3315,3010,110.1
31091, 상록구,025003, 22세,2016,6647,3528,3119,113.1,6492,3448,3044,113.3
31091, 상록구,025004, 23세,2016,6643,3447,3196,107.9,6461,3351,3110,107.7
31091, 상록구,025005, 24세,2016,6786,3577,3209,111.5,6571,3461,3110,111.3
31091, 상록구,030,25~29세,2016,27850,14847,13003,114.2,26020,13896,12124,114.6
31091, 상록구,030001, 25세,2016,6175,3228,2947,109.5,5901,3092,2809,110.1
31091, 상록구,030002, 26세,2016,5861,3156,2705,116.7,5498,2952,2546,115.9
31091, 상록구,030003, 27세,2016,5459,2883,2576,111.9,5061,2676,2385,112.2
31091, 상록구,030004, 28세,2016,5241,2827,2414,117.1,4873,2636,2237,117.8
31091, 상록구,030005, 29세,2016,5114,2753,2361,116.6,4687,2540,2147,118.3
31091, 상록구,035,30~34세,2016,27504,14928,12576,118.7,25415,13760,11655,118.1
31091, 상록구,035001, 30세,2016,5242,2873,2369,121.3,4758,2612,2146,121.7
31091, 상록구,035002, 31세,2016,5175,2821,2354,119.8,4741,2585,2156,119.9
31091, 상록구,035003, 32세,2016,5274,2854,2420,117.9,4831,2607,2224,117.2
31091, 상록구,035004, 33세,2016,5656,3010,2646,113.8,5309,2809,2500,112.4
31091, 상록구,035005, 34세,2016,6157,3370,2787,120.9,5776,3147,2629,119.7
31091, 상록구,040,35~39세,2016,29283,15392,13891,110.8,27820,14595,13225,110.4
31091, 상록구,040001, 35세,2016,5903,3174,2729,116.3,5565,2982,2583,115.4
31091, 상록구,040002, 36세,2016,6319,3302,3017,109.4,6005,3127,2878,108.7
31091, 상록구,040003, 37세,2016,5846,3018,2828,106.7,5518,2834,2684,105.6
31091, 상록구,040004, 38세,2016,5507,2897,2610,111,5237,2754,2483,110.9
31091, 상록구,040005, 39세,2016,5708,3001,2707,110.9,5495,2898,2597,111.6
31091, 상록구,045,40~44세,2016,33024,16798,16226,103.5,31741,16076,15665,102.6
31091, 상록구,045001, 40세,2016,5685,2964,2721,108.9,5456,2826,2630,107.5
31091, 상록구,045002, 41세,2016,6219,3144,3075,102.2,5948,2981,2967,100.5
31091, 상록구,045003, 42세,2016,6879,3533,3346,105.6,6622,3392,3230,105
31091, 상록구,045004, 43세,2016,6977,3518,3459,101.7,6722,3389,3333,101.7
31091, 상록구,045005, 44세,2016,7264,3639,3625,100.4,6993,3488,3505,99.5
31091, 상록구,050,45~49세,2016,39266,19245,20021,96.1,37924,18537,19387,95.6
31091, 상록구,050001, 45세,2016,7853,3860,3993,96.7,7552,3692,3860,95.6
31091, 상록구,050002, 46세,2016,7732,3806,3926,96.9,7472,3673,3799,96.7
31091, 상록구,050003, 47세,2016,8164,3968,4196,94.6,7903,3828,4075,93.9
31091, 상록구,050004, 48세,2016,8023,3879,4144,93.6,7736,3732,4004,93.2
31091, 상록구,050005, 49세,2016,7494,3732,3762,99.2,7261,3612,3649,99
31091, 상록구,055,50~54세,2016,35538,18533,17005,109,34175,17878,16297,109.7
31091, 상록구,055001, 50세,2016,7430,3780,3650,103.6,7178,3660,3518,104
31091, 상록구,055002, 51세,2016,7611,3880,3731,104,7370,3761,3609,104.2
31091, 상록구,055003, 52세,2016,6636,3451,3185,108.4,6348,3304,3044,108.5
31091, 상록구,055004, 53세,2016,6949,3701,3248,113.9,6641,3568,3073,116.1
31091, 상록구,055005, 54세,2016,6912,3721,3191,116.6,6638,3585,3053,117.4
31091, 상록구,060,55~59세,2016,29558,15634,13924,112.3,28496,15135,13361,113.3
31091, 상록구,060001, 55세,2016,7219,3817,3402,112.2,7037,3732,3305,112.9
31091, 상록구,060002, 56세,2016,6763,3610,3153,114.5,6517,3498,3019,115.9
31091, 상록구,060003, 57세,2016,5778,3088,2690,114.8,5555,2972,2583,115.1
31091, 상록구,060004, 58세,2016,5115,2709,2406,112.6,4896,2608,2288,114
31091, 상록구,060005, 59세,2016,4683,2410,2273,106,4491,2325,2166,107.3
31091, 상록구,065,60~64세,2016,16820,8638,8182,105.6,15964,8226,7738,106.3
31091, 상록구,065001, 60세,2016,4164,2193,1971,111.3,3971,2111,1860,113.5
31091, 상록구,065002, 61세,2016,3968,2034,1934,105.2,3770,1934,1836,105.3
31091, 상록구,065003, 62세,2016,3157,1578,1579,99.9,2971,1480,1491,99.3
31091, 상록구,065004, 63세,2016,2650,1371,1279,107.2,2501,1308,1193,109.6
31091, 상록구,065005, 64세,2016,2881,1462,1419,103,2751,1393,1358,102.6
31091, 상록구,070,65~69세,2016,10403,5054,5349,94.5,10039,4890,5149,95
31091, 상록구,070001, 65세,2016,2011,978,1033,94.7,1893,913,980,93.2
31091, 상록구,070002, 66세,2016,2145,1076,1069,100.7,2057,1041,1016,102.5
31091, 상록구,070003, 67세,2016,2080,1018,1062,95.9,2018,991,1027,96.5
31091, 상록구,070004, 68세,2016,2077,999,1078,92.7,2033,982,1051,93.4
31091, 상록구,070005, 69세,2016,2090,983,1107,88.8,2038,963,1075,89.6
31091, 상록구,075,70~74세,2016,8421,3654,4767,76.7,8304,3611,4693,76.9
31091, 상록구,075001, 70세,2016,1646,764,882,86.6,1615,748,867,86.3
31091, 상록구,075002, 71세,2016,1580,699,881,79.3,1560,693,867,79.9
31091, 상록구,075003, 72세,2016,1555,673,882,76.3,1533,666,867,76.8
31091, 상록구,075004, 73세,2016,1681,682,999,68.3,1665,677,988,68.5
31091, 상록구,075005, 74세,2016,1959,836,1123,74.4,1931,827,1104,74.9
31091, 상록구,080,75~79세,2016,6991,2641,4350,60.7,6898,2602,4296,60.6
31091, 상록구,080001, 75세,2016,1522,600,922,65.1,1505,595,910,65.4
31091, 상록구,080002, 76세,2016,1461,591,870,67.9,1437,579,858,67.5
31091, 상록구,080003, 77세,2016,1411,537,874,61.4,1391,527,864,61
31091, 상록구,080004, 78세,2016,1337,467,870,53.7,1320,460,860,53.5
31091, 상록구,080005, 79세,2016,1260,446,814,54.8,1245,441,804,54.9
31091, 상록구,085,80~84세,2016,4568,1505,3063,49.1,4533,1497,3036,49.3
31091, 상록구,085001, 80세,2016,1131,389,742,52.4,1120,387,733,52.8
31091, 상록구,085002, 81세,2016,1059,353,706,50,1054,353,701,50.4
31091, 상록구,085003, 82세,2016,925,304,621,49,916,301,615,48.9
31091, 상록구,085004, 83세,2016,760,239,521,45.9,755,237,518,45.8
31091, 상록구,085005, 84세,2016,693,220,473,46.5,688,219,469,46.7
31091, 상록구,090,85~89세,2016,2006,535,1471,36.4,1989,533,1456,36.6
31091, 상록구,090001, 85세,2016,502,148,354,41.8,498,147,351,41.9
31091, 상록구,090002, 86세,2016,458,141,317,44.5,454,141,313,45
31091, 상록구,090003, 87세,2016,400,118,282,41.8,398,118,280,42.1
31091, 상록구,090004, 88세,2016,349,76,273,27.8,343,75,268,28
31091, 상록구,090005, 89세,2016,297,52,245,21.2,296,52,244,21.3
31091, 상록구,095,90~94세,2016,748,156,592,26.4,743,154,589,26.1
31091, 상록구,095001, 90세,2016,233,46,187,24.6,232,46,186,24.7
31091, 상록구,095002, 91세,2016,162,33,129,25.6,160,31,129,24
31091, 상록구,095003, 92세,2016,144,34,110,30.9,144,34,110,30.9
31091, 상록구,095004, 93세,2016,124,23,101,22.8,123,23,100,23
31091, 상록구,095005, 94세,2016,85,20,65,30.8,84,20,64,31.3
31091, 상록구,100,95~99세,2016,160,29,131,22.1,158,29,129,22.5
31091, 상록구,100001, 95세,2016,52,10,42,23.8,52,10,42,23.8
31091, 상록구,100002, 96세,2016,54,12,42,28.6,53,12,41,29.3
31091, 상록구,100003, 97세,2016,23,X,21,9.5,23,X,21,9.5
31091, 상록구,100004, 98세,2016,22,X,19,15.8,21,X,18,16.7
31091, 상록구,100005, 99세,2016,9,X,7,28.6,9,X,7,28.6
31091, 상록구,101,100세이상,2016,24,X,23,4.3,24,X,23,4.3
31091, 상록구,102,15세미만,2016,50353,25777,24576,104.9,49539,25365,24174,104.9
31091, 상록구,103,15~64세,2016,298859,155209,143650,108,286575,148793,137782,108
31091, 상록구,104,65세이상,2016,33321,13575,19746,68.7,32688,13317,19371,68.7
31091, 상록구,086,85세이상,2016,2938,721,2217,32.5,2914,717,2197,32.6
31091, 상록구,126,평균연령,2016,38.5,37.7,39.3,,38.5,37.7,39.3,
31091, 상록구,127,중위연령,2016,39.3,38.4,40.4,,39.4,38.4,40.4,
31092, 단원구,000,합계,2016,360539,189586,170953,110.9,306575,157593,148982,105.8
31092, 단원구,005,0~4세,2016,13793,6888,6905,99.8,12458,6232,6226,100.1
31092, 단원구,005001, 0세,2016,2561,1302,1259,103.4,2244,1149,1095,104.9
31092, 단원구,005002, 1세,2016,2692,1302,1390,93.7,2446,1182,1264,93.5
31092, 단원구,005003, 2세,2016,2770,1385,1385,100,2496,1250,1246,100.3
31092, 단원구,005004, 3세,2016,2758,1412,1346,104.9,2507,1292,1215,106.3
31092, 단원구,005005, 4세,2016,3012,1487,1525,97.5,2765,1359,1406,96.7
31092, 단원구,010,5~9세,2016,15250,7877,7373,106.8,14469,7475,6994,106.9
31092, 단원구,010001, 5세,2016,3085,1596,1489,107.2,2888,1490,1398,106.6
31092, 단원구,010002, 6세,2016,2864,1484,1380,107.5,2700,1387,1313,105.6
31092, 단원구,010003, 7세,2016,2929,1515,1414,107.1,2773,1443,1330,108.5
31092, 단원구,010004, 8세,2016,3108,1615,1493,108.2,2967,1544,1423,108.5
31092, 단원구,010005, 9세,2016,3264,1667,1597,104.4,3141,1611,1530,105.3
31092, 단원구,015,10~14세,2016,16116,8276,7840,105.6,15725,8097,7628,106.1
31092, 단원구,015001, 10세,2016,2864,1502,1362,110.3,2774,1451,1323,109.7
31092, 단원구,015002, 11세,2016,2938,1516,1422,106.6,2863,1482,1381,107.3
31092, 단원구,015003, 12세,2016,3345,1693,1652,102.5,3261,1654,1607,102.9
31092, 단원구,015004, 13세,2016,3350,1735,1615,107.4,3282,1705,1577,108.1
31092, 단원구,015005, 14세,2016,3619,1830,1789,102.3,3545,1805,1740,103.7
31092, 단원구,020,15~19세,2016,23074,12175,10899,111.7,22623,11935,10688,111.7
31092, 단원구,020001, 15세,2016,4211,2196,2015,109,4149,2162,1987,108.8
31092, 단원구,020002, 16세,2016,4925,2623,2302,113.9,4830,2571,2259,113.8
31092, 단원구,020003, 17세,2016,4783,2536,2247,112.9,4688,2488,2200,113.1
31092, 단원구,020004, 18세,2016,4679,2465,2214,111.3,4585,2412,2173,111
31092, 단원구,020005, 19세,2016,4476,2355,2121,111,4371,2302,2069,111.3
31092, 단원구,025,20~24세,2016,26485,14082,12403,113.5,24210,12575,11635,108.1
31092, 단원구,025001, 20세,2016,4842,2600,2242,116,4665,2492,2173,114.7
31092, 단원구,025002, 21세,2016,5162,2823,2339,120.7,4898,2656,2242,118.5
31092, 단원구,025003, 22세,2016,5288,2834,2454,115.5,4860,2539,2321,109.4
31092, 단원구,025004, 23세,2016,5455,2833,2622,108,4827,2414,2413,100
31092, 단원구,025005, 24세,2016,5738,2992,2746,109,4960,2474,2486,99.5
31092, 단원구,030,25~29세,2016,28469,16296,12173,133.9,21367,11588,9779,118.5
31092, 단원구,030001, 25세,2016,5718,3165,2553,124,4729,2476,2253,109.9
31092, 단원구,030002, 26세,2016,5788,3317,2471,134.2,4415,2388,2027,117.8
31092, 단원구,030003, 27세,2016,5770,3305,2465,134.1,4306,2336,1970,118.6
31092, 단원구,030004, 28세,2016,5668,3295,2373,138.9,4035,2225,1810,122.9
31092, 단원구,030005, 29세,2016,5525,3214,2311,139.1,3882,2163,1719,125.8
31092, 단원구,035,30~34세,2016,28482,16296,12186,133.7,20802,11306,9496,119.1
31092, 단원구,035001, 30세,2016,5483,3137,2346,133.7,3860,2110,1750,120.6
31092, 단원구,035002, 31세,2016,5464,3109,2355,132,3800,2043,1757,116.3
31092, 단원구,035003, 32세,2016,5602,3211,2391,134.3,4085,2221,1864,119.2
31092, 단원구,035004, 33세,2016,5640,3226,2414,133.6,4297,2332,1965,118.7
31092, 단원구,035005, 34세,2016,6293,3613,2680,134.8,4760,2600,2160,120.4
31092, 단원구,040,35~39세,2016,30022,16479,13543,121.7,23754,12470,11284,110.5
31092, 단원구,040001, 35세,2016,6220,3507,2713,129.3,4924,2679,2245,119.3
31092, 단원구,040002, 36세,2016,6271,3454,2817,122.6,5018,2642,2376,111.2
31092, 단원구,040003, 37세,2016,6053,3325,2728,121.9,4692,2448,2244,109.1
31092, 단원구,040004, 38세,2016,5687,3078,2609,118,4480,2320,2160,107.4
31092, 단원구,040005, 39세,2016,5791,3115,2676,116.4,4640,2381,2259,105.4
31092, 단원구,045,40~44세,2016,33010,17542,15468,113.4,27229,13885,13344,104.1
31092, 단원구,045001, 40세,2016,5863,3173,2690,118,4714,2444,2270,107.7
31092, 단원구,045002, 41세,2016,6192,3385,2807,120.6,5154,2709,2445,110.8
31092, 단원구,045003, 42세,2016,6850,3663,3187,114.9,5759,2987,2772,107.8
31092, 단원구,045004, 43세,2016,6987,3635,3352,108.4,5769,2869,2900,98.9
31092, 단원구,045005, 44세,2016,7118,3686,3432,107.4,5833,2876,2957,97.3
31092, 단원구,050,45~49세,2016,38202,19560,18642,104.9,31681,15780,15901,99.2
31092, 단원구,050001, 45세,2016,7699,3959,3740,105.9,6277,3141,3136,100.2
31092, 단원구,050002, 46세,2016,7589,3892,3697,105.3,6174,3047,3127,97.4
31092, 단원구,050003, 47세,2016,7862,3992,3870,103.2,6544,3224,3320,97.1
31092, 단원구,050004, 48세,2016,7986,4086,3900,104.8,6681,3347,3334,100.4
31092, 단원구,050005, 49세,2016,7066,3631,3435,105.7,6005,3021,2984,101.2
31092, 단원구,055,50~54세,2016,35478,18721,16757,111.7,29421,15466,13955,110.8
31092, 단원구,055001, 50세,2016,7122,3712,3410,108.9,5953,3072,2881,106.6
31092, 단원구,055002, 51세,2016,7406,3851,3555,108.3,6143,3181,2962,107.4
31092, 단원구,055003, 52세,2016,6915,3666,3249,112.8,5736,3039,2697,112.7
31092, 단원구,055004, 53세,2016,7065,3815,3250,117.4,5660,3054,2606,117.2
31092, 단원구,055005, 54세,2016,6970,3677,3293,111.7,5929,3120,2809,111.1
31092, 단원구,060,55~59세,2016,28872,15534,13338,116.5,24747,13399,11348,118.1
31092, 단원구,060001, 55세,2016,6688,3548,3140,113,5992,3193,2799,114.1
31092, 단원구,060002, 56세,2016,6725,3581,3144,113.9,5652,3034,2618,115.9
31092, 단원구,060003, 57세,2016,5654,3095,2559,120.9,4860,2663,2197,121.2
31092, 단원구,060004, 58세,2016,5155,2797,2358,118.6,4351,2376,1975,120.3
31092, 단원구,060005, 59세,2016,4650,2513,2137,117.6,3892,2133,1759,121.3
31092, 단원구,065,60~64세,2016,16822,8810,8012,110,13679,7200,6479,111.1
31092, 단원구,065001, 60세,2016,4118,2181,1937,112.6,3359,1800,1559,115.5
31092, 단원구,065002, 61세,2016,3965,2108,1857,113.5,3209,1703,1506,113.1
31092, 단원구,065003, 62세,2016,3263,1705,1558,109.4,2588,1351,1237,109.2
31092, 단원구,065004, 63세,2016,2694,1426,1268,112.5,2160,1151,1009,114.1
31092, 단원구,065005, 64세,2016,2782,1390,1392,99.9,2363,1195,1168,102.3
31092, 단원구,070,65~69세,2016,9457,4712,4745,99.3,8162,4100,4062,100.9
31092, 단원구,070001, 65세,2016,1964,1039,925,112.3,1588,864,724,119.3
31092, 단원구,070002, 66세,2016,2136,1049,1087,96.5,1805,878,927,94.7
31092, 단원구,070003, 67세,2016,1980,996,984,101.2,1695,867,828,104.7
31092, 단원구,070004, 68세,2016,1671,817,854,95.7,1515,749,766,97.8
31092, 단원구,070005, 69세,2016,1706,811,895,90.6,1559,742,817,90.8
31092, 단원구,075,70~74세,2016,6243,2811,3432,81.9,5872,2672,3200,83.5
31092, 단원구,075001, 70세,2016,1268,615,653,94.2,1156,573,583,98.3
31092, 단원구,075002, 71세,2016,1187,538,649,82.9,1107,502,605,83
31092, 단원구,075003, 72세,2016,1243,567,676,83.9,1168,539,629,85.7
31092, 단원구,075004, 73세,2016,1221,536,685,78.2,1165,519,646,80.3
31092, 단원구,075005, 74세,2016,1324,555,769,72.2,1276,539,737,73.1
31092, 단원구,080,75~79세,2016,5095,1933,3162,61.1,4851,1857,2994,62
31092, 단원구,080001, 75세,2016,1164,449,715,62.8,1117,433,684,63.3
31092, 단원구,080002, 76세,2016,1040,428,612,69.9,984,413,571,72.3
31092, 단원구,080003, 77세,2016,1063,417,646,64.6,1012,401,611,65.6
31092, 단원구,080004, 78세,2016,955,333,622,53.5,897,313,584,53.6
31092, 단원구,080005, 79세,2016,873,306,567,54,841,297,544,54.6
31092, 단원구,085,80~84세,2016,3466,1081,2385,45.3,3367,1049,2318,45.3
31092, 단원구,085001, 80세,2016,849,289,560,51.6,820,280,540,51.9
31092, 단원구,085002, 81세,2016,842,276,566,48.8,818,264,554,47.7
31092, 단원구,085003, 82세,2016,662,201,461,43.6,644,196,448,43.8
31092, 단원구,085004, 83세,2016,593,178,415,42.9,577,173,404,42.8
31092, 단원구,085005, 84세,2016,520,137,383,35.8,508,136,372,36.6
31092, 단원구,090,85~89세,2016,1556,386,1170,33,1522,381,1141,33.4
31092, 단원구,090001, 85세,2016,391,110,281,39.1,380,109,271,40.2
31092, 단원구,090002, 86세,2016,387,86,301,28.6,378,85,293,29
31092, 단원구,090003, 87세,2016,295,74,221,33.5,291,74,217,34.1
31092, 단원구,090004, 88세,2016,269,68,201,33.8,262,67,195,34.4
31092, 단원구,090005, 89세,2016,214,48,166,28.9,211,46,165,27.9
31092, 단원구,095,90~94세,2016,535,112,423,26.5,526,111,415,26.7
31092, 단원구,095001, 90세,2016,161,38,123,30.9,156,38,118,32.2
31092, 단원구,095002, 91세,2016,142,26,116,22.4,141,26,115,22.6
31092, 단원구,095003, 92세,2016,81,17,64,26.6,79,17,62,27.4
31092, 단원구,095004, 93세,2016,94,24,70,34.3,94,24,70,34.3
31092, 단원구,095005, 94세,2016,57,7,50,14,56,6,50,12
31092, 단원구,100,95~99세,2016,98,13,85,15.3,96,13,83,15.7
31092, 단원구,100001, 95세,2016,32,7,25,28,32,7,25,28
31092, 단원구,100002, 96세,2016,24,X,20,20,24,X,20,20
31092, 단원구,100003, 97세,2016,11,X,11,0,10,X,10,0
31092, 단원구,100004, 98세,2016,19,X,17,11.8,18,X,16,12.5
31092, 단원구,100005, 99세,2016,12,X,12,0,12,X,12,0
31092, 단원구,101,100세이상,2016,14,X,12,16.7,14,X,12,16.7
31092, 단원구,102,15세미만,2016,45159,23041,22118,104.2,42652,21804,20848,104.6
31092, 단원구,103,15~64세,2016,288916,155495,133421,116.5,239513,125604,113909,110.3
31092, 단원구,104,65세이상,2016,26464,11050,15414,71.7,24410,10185,14225,71.6
31092, 단원구,086,85세이상,2016,2203,513,1690,30.4,2158,507,1651,30.7
31092, 단원구,126,평균연령,2016,38.7,38,39.4,,38.3,37.6,38.9,
31092, 단원구,127,중위연령,2016,39.8,38.9,40.8,,39.5,38.8,40.3,
31100, 고양시,000,합계,2016,999098,489991,509107,96.2,982582,481396,501186,96.1
31100, 고양시,005,0~4세,2016,43142,22087,21055,104.9,42838,21929,20909,104.9
31100, 고양시,005001, 0세,2016,7808,3998,3810,104.9,7744,3962,3782,104.8
31100, 고양시,005002, 1세,2016,8603,4346,4257,102.1,8556,4319,4237,101.9
31100, 고양시,005003, 2세,2016,8450,4358,4092,106.5,8376,4322,4054,106.6
31100, 고양시,005004, 3세,2016,8690,4443,4247,104.6,8631,4409,4222,104.4
31100, 고양시,005005, 4세,2016,9591,4942,4649,106.3,9531,4917,4614,106.6
31100, 고양시,010,5~9세,2016,47247,24349,22898,106.3,47005,24224,22781,106.3
31100, 고양시,010001, 5세,2016,9456,4832,4624,104.5,9401,4806,4595,104.6
31100, 고양시,010002, 6세,2016,9280,4781,4499,106.3,9227,4749,4478,106.1
31100, 고양시,010003, 7세,2016,8976,4680,4296,108.9,8929,4658,4271,109.1
31100, 고양시,010004, 8세,2016,9863,5030,4833,104.1,9815,5008,4807,104.2
31100, 고양시,010005, 9세,2016,9672,5026,4646,108.2,9633,5003,4630,108.1
31100, 고양시,015,10~14세,2016,50345,25855,24490,105.6,50181,25775,24406,105.6
31100, 고양시,015001, 10세,2016,9240,4703,4537,103.7,9215,4690,4525,103.6
31100, 고양시,015002, 11세,2016,9236,4680,4556,102.7,9204,4664,4540,102.7
31100, 고양시,015003, 12세,2016,10442,5323,5119,104,10409,5308,5101,104.1
31100, 고양시,015004, 13세,2016,10580,5566,5014,111,10548,5550,4998,111
31100, 고양시,015005, 14세,2016,10847,5583,5264,106.1,10805,5563,5242,106.1
31100, 고양시,020,15~19세,2016,63520,32524,30996,104.9,63269,32396,30873,104.9
31100, 고양시,020001, 15세,2016,12189,6315,5874,107.5,12158,6303,5855,107.7
31100, 고양시,020002, 16세,2016,13266,6757,6509,103.8,13222,6730,6492,103.7
31100, 고양시,020003, 17세,2016,13168,6812,6356,107.2,13116,6784,6332,107.1
31100, 고양시,020004, 18세,2016,13240,6712,6528,102.8,13186,6687,6499,102.9
31100, 고양시,020005, 19세,2016,11657,5928,5729,103.5,11587,5892,5695,103.5
31100, 고양시,025,20~24세,2016,67321,35444,31877,111.2,65986,34684,31302,110.8
31100, 고양시,025001, 20세,2016,12656,6954,5702,122,12539,6891,5648,122
31100, 고양시,025002, 21세,2016,13253,7405,5848,126.6,13078,7307,5771,126.6
31100, 고양시,025003, 22세,2016,13458,7327,6131,119.5,13172,7164,6008,119.2
31100, 고양시,025004, 23세,2016,13757,6873,6884,99.8,13387,6653,6734,98.8
31100, 고양시,025005, 24세,2016,14197,6885,7312,94.2,13810,6669,7141,93.4
31100, 고양시,030,25~29세,2016,62779,31091,31688,98.1,60377,29751,30626,97.1
31100, 고양시,030001, 25세,2016,13854,6823,7031,97,13438,6604,6834,96.6
31100, 고양시,030002, 26세,2016,13065,6471,6594,98.1,12604,6208,6396,97.1
31100, 고양시,030003, 27세,2016,12359,6176,6183,99.9,11870,5897,5973,98.7
31100, 고양시,030004, 28세,2016,11838,5824,6014,96.8,11300,5544,5756,96.3
31100, 고양시,030005, 29세,2016,11663,5797,5866,98.8,11165,5498,5667,97
31100, 고양시,035,30~34세,2016,64553,31826,32727,97.2,62252,30527,31725,96.2
31100, 고양시,035001, 30세,2016,11574,5738,5836,98.3,11081,5462,5619,97.2
31100, 고양시,035002, 31세,2016,12055,5941,6114,97.2,11584,5671,5913,95.9
31100, 고양시,035003, 32세,2016,12366,6071,6295,96.4,11921,5811,6110,95.1
31100, 고양시,035004, 33세,2016,13880,6862,7018,97.8,13449,6622,6827,97
31100, 고양시,035005, 34세,2016,14678,7214,7464,96.7,14217,6961,7256,95.9
31100, 고양시,040,35~39세,2016,75971,36486,39485,92.4,74204,35474,38730,91.6
31100, 고양시,040001, 35세,2016,15229,7362,7867,93.6,14832,7136,7696,92.7
31100, 고양시,040002, 36세,2016,15581,7484,8097,92.4,15186,7281,7905,92.1
31100, 고양시,040003, 37세,2016,15546,7460,8086,92.3,15184,7239,7945,91.1
31100, 고양시,040004, 38세,2016,14333,6937,7396,93.8,14034,6756,7278,92.8
31100, 고양시,040005, 39세,2016,15282,7243,8039,90.1,14968,7062,7906,89.3
31100, 고양시,045,40~44세,2016,89586,43237,46349,93.3,88129,42439,45690,92.9
31100, 고양시,045001, 40세,2016,15351,7478,7873,95,15053,7296,7757,94.1
31100, 고양시,045002, 41세,2016,16470,7937,8533,93,16167,7782,8385,92.8
31100, 고양시,045003, 42세,2016,18556,8989,9567,94,18267,8826,9441,93.5
31100, 고양시,045004, 43세,2016,19095,9132,9963,91.7,18803,8986,9817,91.5
31100, 고양시,045005, 44세,2016,20114,9701,10413,93.2,19839,9549,10290,92.8
31100, 고양시,050,45~49세,2016,101722,49371,52351,94.3,100183,48614,51569,94.3
31100, 고양시,050001, 45세,2016,21327,10374,10953,94.7,21001,10214,10787,94.7
31100, 고양시,050002, 46세,2016,20803,10156,10647,95.4,20467,9989,10478,95.3
31100, 고양시,050003, 47세,2016,20843,10226,10617,96.3,20536,10078,10458,96.4
31100, 고양시,050004, 48세,2016,20158,9713,10445,93,19853,9550,10303,92.7
31100, 고양시,050005, 49세,2016,18591,8902,9689,91.9,18326,8783,9543,92
31100, 고양시,055,50~54세,2016,90904,45327,45577,99.5,89326,44612,44714,99.8
31100, 고양시,055001, 50세,2016,18049,9012,9037,99.7,17769,8863,8906,99.5
31100, 고양시,055002, 51세,2016,18725,9154,9571,95.6,18423,9021,9402,95.9
31100, 고양시,055003, 52세,2016,17670,8752,8918,98.1,17365,8623,8742,98.6
31100, 고양시,055004, 53세,2016,18489,9332,9157,101.9,18094,9166,8928,102.7
31100, 고양시,055005, 54세,2016,17971,9077,8894,102.1,17675,8939,8736,102.3
31100, 고양시,060,55~59세,2016,79431,40856,38575,105.9,78143,40290,37853,106.4
31100, 고양시,060001, 55세,2016,18333,9391,8942,105,18117,9301,8816,105.5
31100, 고양시,060002, 56세,2016,17843,9094,8749,103.9,17519,8953,8566,104.5
31100, 고양시,060003, 57세,2016,15501,7943,7558,105.1,15251,7823,7428,105.3
31100, 고양시,060004, 58세,2016,14243,7361,6882,107,13974,7247,6727,107.7
31100, 고양시,060005, 59세,2016,13511,7067,6444,109.7,13282,6966,6316,110.3
31100, 고양시,065,60~64세,2016,49649,25286,24363,103.8,48624,24789,23835,104
31100, 고양시,065001, 60세,2016,11859,6179,5680,108.8,11644,6063,5581,108.6
31100, 고양시,065002, 61세,2016,11852,5977,5875,101.7,11619,5864,5755,101.9
31100, 고양시,065003, 62세,2016,9465,4902,4563,107.4,9246,4797,4449,107.8
31100, 고양시,065004, 63세,2016,8173,4082,4091,99.8,7969,3991,3978,100.3
31100, 고양시,065005, 64세,2016,8300,4146,4154,99.8,8146,4074,4072,100
31100, 고양시,070,65~69세,2016,32631,14896,17735,84,32193,14690,17503,83.9
31100, 고양시,070001, 65세,2016,5606,2698,2908,92.8,5495,2640,2855,92.5
31100, 고양시,070002, 66세,2016,6531,2986,3545,84.2,6438,2944,3494,84.3
31100, 고양시,070003, 67세,2016,6710,3077,3633,84.7,6619,3041,3578,85
31100, 고양시,070004, 68세,2016,6796,3026,3770,80.3,6729,2992,3737,80.1
31100, 고양시,070005, 69세,2016,6988,3109,3879,80.1,6912,3073,3839,80
31100, 고양시,075,70~74세,2016,28932,12313,16619,74.1,28737,12235,16502,74.1
31100, 고양시,075001, 70세,2016,5613,2466,3147,78.4,5555,2444,3111,78.6
31100, 고양시,075002, 71세,2016,5430,2333,3097,75.3,5388,2311,3077,75.1
31100, 고양시,075003, 72세,2016,5569,2327,3242,71.8,5539,2313,3226,71.7
31100, 고양시,075004, 73세,2016,5740,2408,3332,72.3,5710,2399,3311,72.5
31100, 고양시,075005, 74세,2016,6580,2779,3801,73.1,6545,2768,3777,73.3
31100, 고양시,080,75~79세,2016,25043,10179,14864,68.5,24929,10140,14789,68.6
31100, 고양시,080001, 75세,2016,5557,2360,3197,73.8,5532,2353,3179,74
31100, 고양시,080002, 76세,2016,5228,2121,3107,68.3,5207,2117,3090,68.5
31100, 고양시,080003, 77세,2016,5156,2063,3093,66.7,5134,2053,3081,66.6
31100, 고양시,080004, 78세,2016,4717,1930,2787,69.3,4687,1917,2770,69.2
31100, 고양시,080005, 79세,2016,4385,1705,2680,63.6,4369,1700,2669,63.7
31100, 고양시,085,80~84세,2016,16039,5882,10157,57.9,15972,5862,10110,58
31100, 고양시,085001, 80세,2016,4024,1584,2440,64.9,4008,1580,2428,65.1
31100, 고양시,085002, 81세,2016,3832,1440,2392,60.2,3819,1435,2384,60.2
31100, 고양시,085003, 82세,2016,3157,1090,2067,52.7,3138,1082,2056,52.6
31100, 고양시,085004, 83세,2016,2665,924,1741,53.1,2657,922,1735,53.1
31100, 고양시,085005, 84세,2016,2361,844,1517,55.6,2350,843,1507,55.9
31100, 고양시,090,85~89세,2016,7267,2199,5068,43.4,7240,2188,5052,43.3
31100, 고양시,090001, 85세,2016,1939,675,1264,53.4,1931,672,1259,53.4
31100, 고양시,090002, 86세,2016,1712,506,1206,42,1707,504,1203,41.9
31100, 고양시,090003, 87세,2016,1475,450,1025,43.9,1472,450,1022,44
31100, 고양시,090004, 88세,2016,1178,324,854,37.9,1173,321,852,37.7
31100, 고양시,090005, 89세,2016,963,244,719,33.9,957,241,716,33.7
31100, 고양시,095,90~94세,2016,2404,625,1779,35.1,2385,620,1765,35.1
31100, 고양시,095001, 90세,2016,693,165,528,31.3,689,164,525,31.2
31100, 고양시,095002, 91세,2016,591,143,448,31.9,587,143,444,32.2
31100, 고양시,095003, 92세,2016,424,119,305,39,421,118,303,38.9
31100, 고양시,095004, 93세,2016,385,103,282,36.5,381,102,279,36.6
31100, 고양시,095005, 94세,2016,311,95,216,44,307,93,214,43.5
31100, 고양시,100,95~99세,2016,530,143,387,37,529,143,386,37
31100, 고양시,100001, 95세,2016,188,55,133,41.4,188,55,133,41.4
31100, 고양시,100002, 96세,2016,138,41,97,42.3,137,41,96,42.7
31100, 고양시,100003, 97세,2016,95,26,69,37.7,95,26,69,37.7
31100, 고양시,100004, 98세,2016,64,8,56,14.3,64,8,56,14.3
31100, 고양시,100005, 99세,2016,45,13,32,40.6,45,13,32,40.6
31100, 고양시,101,100세이상,2016,82,15,67,22.4,80,14,66,21.2
31100, 고양시,102,15세미만,2016,140734,72291,68443,105.6,140024,71928,68096,105.6
31100, 고양시,103,15~64세,2016,745436,371448,373988,99.3,730493,363576,366917,99.1
31100, 고양시,104,65세이상,2016,112928,46252,66676,69.4,112065,45892,66173,69.4
31100, 고양시,086,85세이상,2016,10283,2982,7301,40.8,10234,2965,7269,40.8
31100, 고양시,126,평균연령,2016,40,39,40.9,,40,39,40.9,
31100, 고양시,127,중위연령,2016,41.6,40.7,42.3,,41.6,40.8,42.3,
31101, 덕양구,000,합계,2016,430013,213002,217011,98.2,423693,209879,213814,98.2
31101, 덕양구,005,0~4세,2016,20055,10220,9835,103.9,19959,10167,9792,103.8
31101, 덕양구,005001, 0세,2016,3715,1883,1832,102.8,3696,1872,1824,102.6
31101, 덕양구,005002, 1세,2016,4009,1990,2019,98.6,3996,1982,2014,98.4
31101, 덕양구,005003, 2세,2016,3945,2035,1910,106.5,3921,2024,1897,106.7
31101, 덕양구,005004, 3세,2016,3979,2041,1938,105.3,3960,2027,1933,104.9
31101, 덕양구,005005, 4세,2016,4407,2271,2136,106.3,4386,2262,2124,106.5
31101, 덕양구,010,5~9세,2016,20355,10483,9872,106.2,20267,10447,9820,106.4
31101, 덕양구,010001, 5세,2016,4302,2210,2092,105.6,4285,2203,2082,105.8
31101, 덕양구,010002, 6세,2016,4044,2092,1952,107.2,4020,2081,1939,107.3
31101, 덕양구,010003, 7세,2016,3888,2027,1861,108.9,3874,2024,1850,109.4
31101, 덕양구,010004, 8세,2016,4126,2104,2022,104.1,4106,2096,2010,104.3
31101, 덕양구,010005, 9세,2016,3995,2050,1945,105.4,3982,2043,1939,105.4
31101, 덕양구,015,10~14세,2016,19621,10001,9620,104,19563,9978,9585,104.1
31101, 덕양구,015001, 10세,2016,3699,1863,1836,101.5,3691,1860,1831,101.6
31101, 덕양구,015002, 11세,2016,3642,1798,1844,97.5,3631,1793,1838,97.6
31101, 덕양구,015003, 12세,2016,4035,2079,1956,106.3,4022,2073,1949,106.4
31101, 덕양구,015004, 13세,2016,4114,2134,1980,107.8,4100,2130,1970,108.1
31101, 덕양구,015005, 14세,2016,4131,2127,2004,106.1,4119,2122,1997,106.3
31101, 덕양구,020,15~19세,2016,24469,12690,11779,107.7,24380,12643,11737,107.7
31101, 덕양구,020001, 15세,2016,4658,2399,2259,106.2,4651,2397,2254,106.3
31101, 덕양구,020002, 16세,2016,4971,2539,2432,104.4,4953,2529,2424,104.3
31101, 덕양구,020003, 17세,2016,4983,2637,2346,112.4,4967,2630,2337,112.5
31101, 덕양구,020004, 18세,2016,5019,2549,2470,103.2,5001,2538,2463,103
31101, 덕양구,020005, 19세,2016,4838,2566,2272,112.9,4808,2549,2259,112.8
31101, 덕양구,025,20~24세,2016,28604,15224,13380,113.8,28010,14907,13103,113.8
31101, 덕양구,025001, 20세,2016,5319,2905,2414,120.3,5266,2875,2391,120.2
31101, 덕양구,025002, 21세,2016,5602,3050,2552,119.5,5514,3003,2511,119.6
31101, 덕양구,025003, 22세,2016,5693,3157,2536,124.5,5558,3080,2478,124.3
31101, 덕양구,025004, 23세,2016,5904,3043,2861,106.4,5747,2963,2784,106.4
31101, 덕양구,025005, 24세,2016,6086,3069,3017,101.7,5925,2986,2939,101.6
31101, 덕양구,030,25~29세,2016,26550,13422,13128,102.2,25621,12947,12674,102.2
31101, 덕양구,030001, 25세,2016,5908,3015,2893,104.2,5754,2939,2815,104.4
31101, 덕양구,030002, 26세,2016,5558,2806,2752,102,5384,2719,2665,102
31101, 덕양구,030003, 27세,2016,5136,2608,2528,103.2,4953,2506,2447,102.4
31101, 덕양구,030004, 28세,2016,4977,2477,2500,99.1,4764,2377,2387,99.6
31101, 덕양구,030005, 29세,2016,4971,2516,2455,102.5,4766,2406,2360,101.9
31101, 덕양구,035,30~34세,2016,29102,14593,14509,100.6,28302,14186,14116,100.5
31101, 덕양구,035001, 30세,2016,5039,2549,2490,102.4,4872,2462,2410,102.2
31101, 덕양구,035002, 31세,2016,5411,2706,2705,100,5249,2623,2626,99.9
31101, 덕양구,035003, 32세,2016,5559,2773,2786,99.5,5405,2695,2710,99.4
31101, 덕양구,035004, 33세,2016,6379,3200,3179,100.7,6226,3124,3102,100.7
31101, 덕양구,035005, 34세,2016,6714,3365,3349,100.5,6550,3282,3268,100.4
31101, 덕양구,040,35~39세,2016,34360,16978,17382,97.7,33723,16638,17085,97.4
31101, 덕양구,040001, 35세,2016,6991,3503,3488,100.4,6853,3428,3425,100.1
31101, 덕양구,040002, 36세,2016,7072,3498,3574,97.9,6908,3422,3486,98.2
31101, 덕양구,040003, 37세,2016,6992,3411,3581,95.3,6868,3342,3526,94.8
31101, 덕양구,040004, 38세,2016,6501,3253,3248,100.2,6400,3194,3206,99.6
31101, 덕양구,040005, 39세,2016,6804,3313,3491,94.9,6694,3252,3442,94.5
31101, 덕양구,045,40~44세,2016,37407,18967,18440,102.9,36839,18673,18166,102.8
31101, 덕양구,045001, 40세,2016,6703,3441,3262,105.5,6577,3375,3202,105.4
31101, 덕양구,045002, 41세,2016,7053,3528,3525,100.1,6933,3475,3458,100.5
31101, 덕양구,045003, 42세,2016,7793,3962,3831,103.4,7673,3895,3778,103.1
31101, 덕양구,045004, 43세,2016,7767,3935,3832,102.7,7668,3885,3783,102.7
31101, 덕양구,045005, 44세,2016,8091,4101,3990,102.8,7988,4043,3945,102.5
31101, 덕양구,050,45~49세,2016,40442,20013,20429,98,39826,19721,20105,98.1
31101, 덕양구,050001, 45세,2016,8471,4249,4222,100.6,8335,4190,4145,101.1
31101, 덕양구,050002, 46세,2016,8187,4130,4057,101.8,8061,4070,3991,102
31101, 덕양구,050003, 47세,2016,8228,4101,4127,99.4,8110,4049,4061,99.7
31101, 덕양구,050004, 48세,2016,8029,3911,4118,95,7911,3845,4066,94.6
31101, 덕양구,050005, 49세,2016,7527,3622,3905,92.8,7409,3567,3842,92.8
31101, 덕양구,055,50~54세,2016,37831,18983,18848,100.7,37199,18697,18502,101.1
31101, 덕양구,055001, 50세,2016,7456,3736,3720,100.4,7359,3680,3679,100
31101, 덕양구,055002, 51세,2016,7806,3855,3951,97.6,7676,3799,3877,98
31101, 덕양구,055003, 52세,2016,7230,3614,3616,99.9,7111,3567,3544,100.6
31101, 덕양구,055004, 53세,2016,7756,3939,3817,103.2,7595,3870,3725,103.9
31101, 덕양구,055005, 54세,2016,7583,3839,3744,102.5,7458,3781,3677,102.8
31101, 덕양구,060,55~59세,2016,34899,17863,17036,104.9,34393,17628,16765,105.1
31101, 덕양구,060001, 55세,2016,7855,4030,3825,105.4,7773,3992,3781,105.6
31101, 덕양구,060002, 56세,2016,7788,3964,3824,103.7,7657,3899,3758,103.8
31101, 덕양구,060003, 57세,2016,6805,3480,3325,104.7,6712,3434,3278,104.8
31101, 덕양구,060004, 58세,2016,6377,3274,3103,105.5,6271,3230,3041,106.2
31101, 덕양구,060005, 59세,2016,6074,3115,2959,105.3,5980,3073,2907,105.7
31101, 덕양구,065,60~64세,2016,23251,11622,11629,99.9,22865,11430,11435,100
31101, 덕양구,065001, 60세,2016,5333,2714,2619,103.6,5260,2674,2586,103.4
31101, 덕양구,065002, 61세,2016,5499,2698,2801,96.3,5402,2649,2753,96.2
31101, 덕양구,065003, 62세,2016,4445,2261,2184,103.5,4374,2227,2147,103.7
31101, 덕양구,065004, 63세,2016,3873,1901,1972,96.4,3792,1860,1932,96.3
31101, 덕양구,065005, 64세,2016,4101,2048,2053,99.8,4037,2020,2017,100.1
31101, 덕양구,070,65~69세,2016,15970,7291,8679,84,15797,7219,8578,84.2
31101, 덕양구,070001, 65세,2016,2762,1313,1449,90.6,2722,1295,1427,90.7
31101, 덕양구,070002, 66세,2016,3158,1417,1741,81.4,3125,1404,1721,81.6
31101, 덕양구,070003, 67세,2016,3300,1527,1773,86.1,3253,1510,1743,86.6
31101, 덕양구,070004, 68세,2016,3350,1501,1849,81.2,3328,1490,1838,81.1
31101, 덕양구,070005, 69세,2016,3400,1533,1867,82.1,3369,1520,1849,82.2
31101, 덕양구,075,70~74세,2016,14093,6001,8092,74.2,14020,5970,8050,74.2
31101, 덕양구,075001, 70세,2016,2793,1250,1543,81,2769,1239,1530,81
31101, 덕양구,075002, 71세,2016,2683,1150,1533,75,2669,1142,1527,74.8
31101, 덕양구,075003, 72세,2016,2662,1080,1582,68.3,2655,1075,1580,68
31101, 덕양구,075004, 73세,2016,2754,1171,1583,74,2742,1169,1573,74.3
31101, 덕양구,075005, 74세,2016,3201,1350,1851,72.9,3185,1345,1840,73.1
31101, 덕양구,080,75~79세,2016,11690,4897,6793,72.1,11649,4887,6762,72.3
31101, 덕양구,080001, 75세,2016,2650,1188,1462,81.3,2639,1185,1454,81.5
31101, 덕양구,080002, 76세,2016,2512,1050,1462,71.8,2501,1047,1454,72
31101, 덕양구,080003, 77세,2016,2415,994,1421,70,2409,993,1416,70.1
31101, 덕양구,080004, 78세,2016,2162,905,1257,72,2152,902,1250,72.2
31101, 덕양구,080005, 79세,2016,1951,760,1191,63.8,1948,760,1188,64
31101, 덕양구,085,80~84세,2016,6958,2520,4438,56.8,6935,2511,4424,56.8
31101, 덕양구,085001, 80세,2016,1777,686,1091,62.9,1772,686,1086,63.2
31101, 덕양구,085002, 81세,2016,1632,620,1012,61.3,1631,620,1011,61.3
31101, 덕양구,085003, 82세,2016,1349,463,886,52.3,1337,456,881,51.8
31101, 덕양구,085004, 83세,2016,1164,398,766,52,1161,397,764,52
31101, 덕양구,085005, 84세,2016,1036,353,683,51.7,1034,352,682,51.6
31101, 덕양구,090,85~89세,2016,3069,928,2141,43.3,3064,925,2139,43.2
31101, 덕양구,090001, 85세,2016,827,304,523,58.1,826,304,522,58.2
31101, 덕양구,090002, 86세,2016,707,200,507,39.4,705,199,506,39.3
31101, 덕양구,090003, 87세,2016,620,185,435,42.5,620,185,435,42.5
31101, 덕양구,090004, 88세,2016,501,144,357,40.3,500,143,357,40.1
31101, 덕양구,090005, 89세,2016,414,95,319,29.8,413,94,319,29.5
31101, 덕양구,095,90~94세,2016,1018,245,773,31.7,1013,244,769,31.7
31101, 덕양구,095001, 90세,2016,317,71,246,28.9,315,70,245,28.6
31101, 덕양구,095002, 91세,2016,235,54,181,29.8,234,54,180,30
31101, 덕양구,095003, 92세,2016,186,47,139,33.8,185,47,138,34.1
31101, 덕양구,095004, 93세,2016,152,34,118,28.8,152,34,118,28.8
31101, 덕양구,095005, 94세,2016,128,39,89,43.8,127,39,88,44.3
31101, 덕양구,100,95~99세,2016,236,58,178,32.6,235,58,177,32.8
31101, 덕양구,100001, 95세,2016,78,17,61,27.9,78,17,61,27.9
31101, 덕양구,100002, 96세,2016,59,21,38,55.3,58,21,37,56.8
31101, 덕양구,100003, 97세,2016,48,12,36,33.3,48,12,36,33.3
31101, 덕양구,100004, 98세,2016,32,X,29,10.3,32,X,29,10.3
31101, 덕양구,100005, 99세,2016,19,5,14,35.7,19,5,14,35.7
31101, 덕양구,101,100세이상,2016,33,X,30,10,33,X,30,10
31101, 덕양구,102,15세미만,2016,60031,30704,29327,104.7,59789,30592,29197,104.8
31101, 덕양구,103,15~64세,2016,316915,160355,156560,102.4,311158,157470,153688,102.5
31101, 덕양구,104,65세이상,2016,53067,21943,31124,70.5,52746,21817,30929,70.5
31101, 덕양구,086,85세이상,2016,4356,1234,3122,39.5,4345,1230,3115,39.5
31101, 덕양구,126,평균연령,2016,40.5,39.4,41.5,,40.5,39.4,41.5,
31101, 덕양구,127,중위연령,2016,41.7,40.8,42.6,,41.8,40.9,42.6,
31103, 일산동구,000,합계,2016,281635,137358,144277,95.2,275936,134162,141774,94.6
31103, 일산동구,005,0~4세,2016,10787,5591,5196,107.6,10682,5535,5147,107.5
31103, 일산동구,005001, 0세,2016,1910,988,922,107.2,1890,977,913,107
31103, 일산동구,005002, 1세,2016,2180,1136,1044,108.8,2161,1124,1037,108.4
31103, 일산동구,005003, 2세,2016,2129,1100,1029,106.9,2107,1088,1019,106.8
31103, 일산동구,005004, 3세,2016,2168,1112,1056,105.3,2144,1100,1044,105.4
31103, 일산동구,005005, 4세,2016,2400,1255,1145,109.6,2380,1246,1134,109.9
31103, 일산동구,010,5~9세,2016,12438,6418,6020,106.6,12344,6364,5980,106.4
31103, 일산동구,010001, 5세,2016,2377,1181,1196,98.7,2355,1171,1184,98.9
31103, 일산동구,010002, 6세,2016,2472,1267,1205,105.1,2454,1253,1201,104.3
31103, 일산동구,010003, 7세,2016,2390,1270,1120,113.4,2372,1261,1111,113.5
31103, 일산동구,010004, 8세,2016,2608,1344,1264,106.3,2590,1334,1256,106.2
31103, 일산동구,010005, 9세,2016,2591,1356,1235,109.8,2573,1345,1228,109.5
31103, 일산동구,015,10~14세,2016,14058,7269,6789,107.1,13999,7236,6763,107
31103, 일산동구,015001, 10세,2016,2564,1319,1245,105.9,2557,1314,1243,105.7
31103, 일산동구,015002, 11세,2016,2546,1323,1223,108.2,2532,1315,1217,108.1
31103, 일산동구,015003, 12세,2016,2931,1465,1466,99.9,2918,1459,1459,100
31103, 일산동구,015004, 13세,2016,2968,1578,1390,113.5,2959,1571,1388,113.2
31103, 일산동구,015005, 14세,2016,3049,1584,1465,108.1,3033,1577,1456,108.3
31103, 일산동구,020,15~19세,2016,18406,9366,9040,103.6,18324,9320,9004,103.5
31103, 일산동구,020001, 15세,2016,3474,1873,1601,117,3460,1867,1593,117.2
31103, 일산동구,020002, 16세,2016,3840,1962,1878,104.5,3826,1951,1875,104.1
31103, 일산동구,020003, 17세,2016,3878,1980,1898,104.3,3855,1967,1888,104.2
31103, 일산동구,020004, 18세,2016,3871,1922,1949,98.6,3858,1916,1942,98.7
31103, 일산동구,020005, 19세,2016,3343,1629,1714,95,3325,1619,1706,94.9
31103, 일산동구,025,20~24세,2016,19623,10215,9408,108.6,19119,9915,9204,107.7
31103, 일산동구,025001, 20세,2016,3608,1941,1667,116.4,3562,1919,1643,116.8
31103, 일산동구,025002, 21세,2016,3785,2178,1607,135.5,3729,2144,1585,135.3
31103, 일산동구,025003, 22세,2016,3916,2108,1808,116.6,3817,2052,1765,116.3
31103, 일산동구,025004, 23세,2016,4049,1958,2091,93.6,3897,1859,2038,91.2
31103, 일산동구,025005, 24세,2016,4265,2030,2235,90.8,4114,1941,2173,89.3
31103, 일산동구,030,25~29세,2016,19268,9404,9864,95.3,18317,8823,9494,92.9
31103, 일산동구,030001, 25세,2016,4077,1935,2142,90.3,3903,1834,2069,88.6
31103, 일산동구,030002, 26세,2016,3990,1954,2036,96,3794,1830,1964,93.2
31103, 일산동구,030003, 27세,2016,3840,1909,1931,98.9,3645,1792,1853,96.7
31103, 일산동구,030004, 28세,2016,3688,1800,1888,95.3,3495,1690,1805,93.6
31103, 일산동구,030005, 29세,2016,3673,1806,1867,96.7,3480,1677,1803,93
31103, 일산동구,035,30~34세,2016,18685,9212,9473,97.2,17757,8624,9133,94.4
31103, 일산동구,035001, 30세,2016,3528,1751,1777,98.5,3320,1630,1690,96.4
31103, 일산동구,035002, 31세,2016,3544,1753,1791,97.9,3347,1619,1728,93.7
31103, 일산동구,035003, 32세,2016,3609,1786,1823,98,3425,1665,1760,94.6
31103, 일산동구,035004, 33세,2016,3845,1890,1955,96.7,3685,1791,1894,94.6
31103, 일산동구,035005, 34세,2016,4159,2032,2127,95.5,3980,1919,2061,93.1
31103, 일산동구,040,35~39세,2016,21039,9910,11129,89,20384,9512,10872,87.5
31103, 일산동구,040001, 35세,2016,4241,1984,2257,87.9,4085,1893,2192,86.4
31103, 일산동구,040002, 36세,2016,4354,2036,2318,87.8,4224,1960,2264,86.6
31103, 일산동구,040003, 37세,2016,4319,2067,2252,91.8,4174,1971,2203,89.5
31103, 일산동구,040004, 38세,2016,3960,1874,2086,89.8,3850,1808,2042,88.5
31103, 일산동구,040005, 39세,2016,4165,1949,2216,88,4051,1880,2171,86.6
31103, 일산동구,045,40~44세,2016,25601,12056,13545,89,25076,11750,13326,88.2
31103, 일산동구,045001, 40세,2016,4342,2082,2260,92.1,4235,2008,2227,90.2
31103, 일산동구,045002, 41세,2016,4581,2181,2400,90.9,4468,2114,2354,89.8
31103, 일산동구,045003, 42세,2016,5288,2476,2812,88.1,5190,2421,2769,87.4
31103, 일산동구,045004, 43세,2016,5536,2517,3019,83.4,5434,2468,2966,83.2
31103, 일산동구,045005, 44세,2016,5854,2800,3054,91.7,5749,2739,3010,91
31103, 일산동구,050,45~49세,2016,29684,14270,15414,92.6,29207,14023,15184,92.4
31103, 일산동구,050001, 45세,2016,6253,2993,3260,91.8,6141,2929,3212,91.2
31103, 일산동구,050002, 46세,2016,6123,2944,3179,92.6,6016,2888,3128,92.3
31103, 일산동구,050003, 47세,2016,6124,2964,3160,93.8,6019,2909,3110,93.5
31103, 일산동구,050004, 48세,2016,5825,2812,3013,93.3,5742,2770,2972,93.2
31103, 일산동구,050005, 49세,2016,5359,2557,2802,91.3,5289,2527,2762,91.5
31103, 일산동구,055,50~54세,2016,26400,13051,13349,97.8,25946,12844,13102,98
31103, 일산동구,055001, 50세,2016,5252,2601,2651,98.1,5157,2550,2607,97.8
31103, 일산동구,055002, 51세,2016,5365,2589,2776,93.3,5275,2546,2729,93.3
31103, 일산동구,055003, 52세,2016,5201,2532,2669,94.9,5101,2493,2608,95.6
31103, 일산동구,055004, 53세,2016,5385,2704,2681,100.9,5287,2663,2624,101.5
31103, 일산동구,055005, 54세,2016,5197,2625,2572,102.1,5126,2592,2534,102.3
31103, 일산동구,060,55~59세,2016,22511,11507,11004,104.6,22171,11363,10808,105.1
31103, 일산동구,060001, 55세,2016,5228,2701,2527,106.9,5173,2679,2494,107.4
31103, 일산동구,060002, 56세,2016,5055,2518,2537,99.3,4968,2486,2482,100.2
31103, 일산동구,060003, 57세,2016,4366,2187,2179,100.4,4295,2152,2143,100.4
31103, 일산동구,060004, 58세,2016,4074,2097,1977,106.1,3997,2066,1931,107
31103, 일산동구,060005, 59세,2016,3788,2004,1784,112.3,3738,1980,1758,112.6
31103, 일산동구,065,60~64세,2016,13547,7049,6498,108.5,13267,6924,6343,109.2
31103, 일산동구,065001, 60세,2016,3345,1757,1588,110.6,3285,1722,1563,110.2
31103, 일산동구,065002, 61세,2016,3238,1658,1580,104.9,3178,1631,1547,105.4
31103, 일산동구,065003, 62세,2016,2606,1389,1217,114.1,2540,1360,1180,115.3
31103, 일산동구,065004, 63세,2016,2241,1173,1068,109.8,2188,1156,1032,112
31103, 일산동구,065005, 64세,2016,2117,1072,1045,102.6,2076,1055,1021,103.3
31103, 일산동구,070,65~69세,2016,8337,3838,4499,85.3,8222,3776,4446,84.9
31103, 일산동구,070001, 65세,2016,1408,685,723,94.7,1375,666,709,93.9
31103, 일산동구,070002, 66세,2016,1745,834,911,91.5,1716,819,897,91.3
31103, 일산동구,070003, 67세,2016,1699,760,939,80.9,1677,750,927,80.9
31103, 일산동구,070004, 68세,2016,1730,767,963,79.6,1718,761,957,79.5
31103, 일산동구,070005, 69세,2016,1755,792,963,82.2,1736,780,956,81.6
31103, 일산동구,075,70~74세,2016,7351,3195,4156,76.9,7295,3172,4123,76.9
31103, 일산동구,075001, 70세,2016,1380,595,785,75.8,1365,590,775,76.1
31103, 일산동구,075002, 71세,2016,1344,600,744,80.6,1332,595,737,80.7
31103, 일산동구,075003, 72세,2016,1526,667,859,77.6,1514,661,853,77.5
31103, 일산동구,075004, 73세,2016,1485,650,835,77.8,1474,645,829,77.8
31103, 일산동구,075005, 74세,2016,1616,683,933,73.2,1610,681,929,73.3
31103, 일산동구,080,75~79세,2016,6364,2528,3836,65.9,6330,2512,3818,65.8
31103, 일산동구,080001, 75세,2016,1355,546,809,67.5,1347,543,804,67.5
31103, 일산동구,080002, 76세,2016,1345,541,804,67.3,1339,540,799,67.6
31103, 일산동구,080003, 77세,2016,1292,481,811,59.3,1287,478,809,59.1
31103, 일산동구,080004, 78세,2016,1201,503,698,72.1,1192,497,695,71.5
31103, 일산동구,080005, 79세,2016,1171,457,714,64,1165,454,711,63.9
31103, 일산동구,085,80~84세,2016,4498,1620,2878,56.3,4479,1617,2862,56.5
31103, 일산동구,085001, 80세,2016,1094,419,675,62.1,1087,417,670,62.2
31103, 일산동구,085002, 81세,2016,1069,400,669,59.8,1063,399,664,60.1
31103, 일산동구,085003, 82세,2016,903,299,604,49.5,903,299,604,49.5
31103, 일산동구,085004, 83세,2016,748,267,481,55.5,747,267,480,55.6
31103, 일산동구,085005, 84세,2016,684,235,449,52.3,679,235,444,52.9
31103, 일산동구,090,85~89세,2016,2089,616,1473,41.8,2075,611,1464,41.7
31103, 일산동구,090001, 85세,2016,525,170,355,47.9,521,169,352,48
31103, 일산동구,090002, 86세,2016,478,137,341,40.2,475,136,339,40.1
31103, 일산동구,090003, 87세,2016,444,137,307,44.6,444,137,307,44.6
31103, 일산동구,090004, 88세,2016,363,93,270,34.4,360,92,268,34.3
31103, 일산동구,090005, 89세,2016,279,79,200,39.5,275,77,198,38.9
31103, 일산동구,095,90~94세,2016,765,192,573,33.5,759,190,569,33.4
31103, 일산동구,095001, 90세,2016,186,42,144,29.2,184,42,142,29.6
31103, 일산동구,095002, 91세,2016,207,50,157,31.8,207,50,157,31.8
31103, 일산동구,095003, 92세,2016,130,36,94,38.3,128,35,93,37.6
31103, 일산동구,095004, 93세,2016,146,38,108,35.2,146,38,108,35.2
31103, 일산동구,095005, 94세,2016,96,26,70,37.1,94,25,69,36.2
31103, 일산동구,100,95~99세,2016,160,46,114,40.4,160,46,114,40.4
31103, 일산동구,100001, 95세,2016,64,22,42,52.4,64,22,42,52.4
31103, 일산동구,100002, 96세,2016,43,9,34,26.5,43,9,34,26.5
31103, 일산동구,100003, 97세,2016,24,8,16,50,24,8,16,50
31103, 일산동구,100004, 98세,2016,16,X,14,14.3,16,X,14,14.3
31103, 일산동구,100005, 99세,2016,13,5,8,62.5,13,5,8,62.5
31103, 일산동구,101,100세이상,2016,24,5,19,26.3,23,5,18,27.8
31103, 일산동구,102,15세미만,2016,37283,19278,18005,107.1,37025,19135,17890,107
31103, 일산동구,103,15~64세,2016,214764,106040,108724,97.5,209568,103098,106470,96.8
31103, 일산동구,104,65세이상,2016,29588,12040,17548,68.6,29343,11929,17414,68.5
31103, 일산동구,086,85세이상,2016,3038,859,2179,39.4,3017,852,2165,39.4
31103, 일산동구,126,평균연령,2016,39.9,38.9,40.8,,39.9,39,40.8,
31103, 일산동구,127,중위연령,2016,41.5,40.6,42.2,,41.6,40.9,42.3,
31104, 일산서구,000,합계,2016,287450,139631,147819,94.5,282953,137355,145598,94.3
31104, 일산서구,005,0~4세,2016,12300,6276,6024,104.2,12197,6227,5970,104.3
31104, 일산서구,005001, 0세,2016,2183,1127,1056,106.7,2158,1113,1045,106.5
31104, 일산서구,005002, 1세,2016,2414,1220,1194,102.2,2399,1213,1186,102.3
31104, 일산서구,005003, 2세,2016,2376,1223,1153,106.1,2348,1210,1138,106.3
31104, 일산서구,005004, 3세,2016,2543,1290,1253,103,2527,1282,1245,103
31104, 일산서구,005005, 4세,2016,2784,1416,1368,103.5,2765,1409,1356,103.9
31104, 일산서구,010,5~9세,2016,14454,7448,7006,106.3,14394,7413,6981,106.2
31104, 일산서구,010001, 5세,2016,2777,1441,1336,107.9,2761,1432,1329,107.8
31104, 일산서구,010002, 6세,2016,2764,1422,1342,106,2753,1415,1338,105.8
31104, 일산서구,010003, 7세,2016,2698,1383,1315,105.2,2683,1373,1310,104.8
31104, 일산서구,010004, 8세,2016,3129,1582,1547,102.3,3119,1578,1541,102.4
31104, 일산서구,010005, 9세,2016,3086,1620,1466,110.5,3078,1615,1463,110.4
31104, 일산서구,015,10~14세,2016,16666,8585,8081,106.2,16619,8561,8058,106.2
31104, 일산서구,015001, 10세,2016,2977,1521,1456,104.5,2967,1516,1451,104.5
31104, 일산서구,015002, 11세,2016,3048,1559,1489,104.7,3041,1556,1485,104.8
31104, 일산서구,015003, 12세,2016,3476,1779,1697,104.8,3469,1776,1693,104.9
31104, 일산서구,015004, 13세,2016,3498,1854,1644,112.8,3489,1849,1640,112.7
31104, 일산서구,015005, 14세,2016,3667,1872,1795,104.3,3653,1864,1789,104.2
31104, 일산서구,020,15~19세,2016,20645,10468,10177,102.9,20565,10433,10132,103
31104, 일산서구,020001, 15세,2016,4057,2043,2014,101.4,4047,2039,2008,101.5
31104, 일산서구,020002, 16세,2016,4455,2256,2199,102.6,4443,2250,2193,102.6
31104, 일산서구,020003, 17세,2016,4307,2195,2112,103.9,4294,2187,2107,103.8
31104, 일산서구,020004, 18세,2016,4350,2241,2109,106.3,4327,2233,2094,106.6
31104, 일산서구,020005, 19세,2016,3476,1733,1743,99.4,3454,1724,1730,99.7
31104, 일산서구,025,20~24세,2016,19094,10005,9089,110.1,18857,9862,8995,109.6
31104, 일산서구,025001, 20세,2016,3729,2108,1621,130,3711,2097,1614,129.9
31104, 일산서구,025002, 21세,2016,3866,2177,1689,128.9,3835,2160,1675,129
31104, 일산서구,025003, 22세,2016,3849,2062,1787,115.4,3797,2032,1765,115.1
31104, 일산서구,025004, 23세,2016,3804,1872,1932,96.9,3743,1831,1912,95.8
31104, 일산서구,025005, 24세,2016,3846,1786,2060,86.7,3771,1742,2029,85.9
31104, 일산서구,030,25~29세,2016,16961,8265,8696,95,16439,7981,8458,94.4
31104, 일산서구,030001, 25세,2016,3869,1873,1996,93.8,3781,1831,1950,93.9
31104, 일산서구,030002, 26세,2016,3517,1711,1806,94.7,3426,1659,1767,93.9
31104, 일산서구,030003, 27세,2016,3383,1659,1724,96.2,3272,1599,1673,95.6
31104, 일산서구,030004, 28세,2016,3173,1547,1626,95.1,3041,1477,1564,94.4
31104, 일산서구,030005, 29세,2016,3019,1475,1544,95.5,2919,1415,1504,94.1
31104, 일산서구,035,30~34세,2016,16766,8021,8745,91.7,16193,7717,8476,91
31104, 일산서구,035001, 30세,2016,3007,1438,1569,91.7,2889,1370,1519,90.2
31104, 일산서구,035002, 31세,2016,3100,1482,1618,91.6,2988,1429,1559,91.7
31104, 일산서구,035003, 32세,2016,3198,1512,1686,89.7,3091,1451,1640,88.5
31104, 일산서구,035004, 33세,2016,3656,1772,1884,94.1,3538,1707,1831,93.2
31104, 일산서구,035005, 34세,2016,3805,1817,1988,91.4,3687,1760,1927,91.3
31104, 일산서구,040,35~39세,2016,20572,9598,10974,87.5,20097,9324,10773,86.5
31104, 일산서구,040001, 35세,2016,3997,1875,2122,88.4,3894,1815,2079,87.3
31104, 일산서구,040002, 36세,2016,4155,1950,2205,88.4,4054,1899,2155,88.1
31104, 일산서구,040003, 37세,2016,4235,1982,2253,88,4142,1926,2216,86.9
31104, 일산서구,040004, 38세,2016,3872,1810,2062,87.8,3784,1754,2030,86.4
31104, 일산서구,040005, 39세,2016,4313,1981,2332,84.9,4223,1930,2293,84.2
31104, 일산서구,045,40~44세,2016,26578,12214,14364,85,26214,12016,14198,84.6
31104, 일산서구,045001, 40세,2016,4306,1955,2351,83.2,4241,1913,2328,82.2
31104, 일산서구,045002, 41세,2016,4836,2228,2608,85.4,4766,2193,2573,85.2
31104, 일산서구,045003, 42세,2016,5475,2551,2924,87.2,5404,2510,2894,86.7
31104, 일산서구,045004, 43세,2016,5792,2680,3112,86.1,5701,2633,3068,85.8
31104, 일산서구,045005, 44세,2016,6169,2800,3369,83.1,6102,2767,3335,83
31104, 일산서구,050,45~49세,2016,31596,15088,16508,91.4,31150,14870,16280,91.3
31104, 일산서구,050001, 45세,2016,6603,3132,3471,90.2,6525,3095,3430,90.2
31104, 일산서구,050002, 46세,2016,6493,3082,3411,90.4,6390,3031,3359,90.2
31104, 일산서구,050003, 47세,2016,6491,3161,3330,94.9,6407,3120,3287,94.9
31104, 일산서구,050004, 48세,2016,6304,2990,3314,90.2,6200,2935,3265,89.9
31104, 일산서구,050005, 49세,2016,5705,2723,2982,91.3,5628,2689,2939,91.5
31104, 일산서구,055,50~54세,2016,26673,13293,13380,99.3,26181,13071,13110,99.7
31104, 일산서구,055001, 50세,2016,5341,2675,2666,100.3,5253,2633,2620,100.5
31104, 일산서구,055002, 51세,2016,5554,2710,2844,95.3,5472,2676,2796,95.7
31104, 일산서구,055003, 52세,2016,5239,2606,2633,99,5153,2563,2590,99
31104, 일산서구,055004, 53세,2016,5348,2689,2659,101.1,5212,2633,2579,102.1
31104, 일산서구,055005, 54세,2016,5191,2613,2578,101.4,5091,2566,2525,101.6
31104, 일산서구,060,55~59세,2016,22021,11486,10535,109,21579,11299,10280,109.9
31104, 일산서구,060001, 55세,2016,5250,2660,2590,102.7,5171,2630,2541,103.5
31104, 일산서구,060002, 56세,2016,5000,2612,2388,109.4,4894,2568,2326,110.4
31104, 일산서구,060003, 57세,2016,4330,2276,2054,110.8,4244,2237,2007,111.5
31104, 일산서구,060004, 58세,2016,3792,1990,1802,110.4,3706,1951,1755,111.2
31104, 일산서구,060005, 59세,2016,3649,1948,1701,114.5,3564,1913,1651,115.9
31104, 일산서구,065,60~64세,2016,12851,6615,6236,106.1,12492,6435,6057,106.2
31104, 일산서구,065001, 60세,2016,3181,1708,1473,116,3099,1667,1432,116.4
31104, 일산서구,065002, 61세,2016,3115,1621,1494,108.5,3039,1584,1455,108.9
31104, 일산서구,065003, 62세,2016,2414,1252,1162,107.7,2332,1210,1122,107.8
31104, 일산서구,065004, 63세,2016,2059,1008,1051,95.9,1989,975,1014,96.2
31104, 일산서구,065005, 64세,2016,2082,1026,1056,97.2,2033,999,1034,96.6
31104, 일산서구,070,65~69세,2016,8324,3767,4557,82.7,8174,3695,4479,82.5
31104, 일산서구,070001, 65세,2016,1436,700,736,95.1,1398,679,719,94.4
31104, 일산서구,070002, 66세,2016,1628,735,893,82.3,1597,721,876,82.3
31104, 일산서구,070003, 67세,2016,1711,790,921,85.8,1689,781,908,86
31104, 일산서구,070004, 68세,2016,1716,758,958,79.1,1683,741,942,78.7
31104, 일산서구,070005, 69세,2016,1833,784,1049,74.7,1807,773,1034,74.8
31104, 일산서구,075,70~74세,2016,7488,3117,4371,71.3,7422,3093,4329,71.4
31104, 일산서구,075001, 70세,2016,1440,621,819,75.8,1421,615,806,76.3
31104, 일산서구,075002, 71세,2016,1403,583,820,71.1,1387,574,813,70.6
31104, 일산서구,075003, 72세,2016,1381,580,801,72.4,1370,577,793,72.8
31104, 일산서구,075004, 73세,2016,1501,587,914,64.2,1494,585,909,64.4
31104, 일산서구,075005, 74세,2016,1763,746,1017,73.4,1750,742,1008,73.6
31104, 일산서구,080,75~79세,2016,6989,2754,4235,65,6950,2741,4209,65.1
31104, 일산서구,080001, 75세,2016,1552,626,926,67.6,1546,625,921,67.9
31104, 일산서구,080002, 76세,2016,1371,530,841,63,1367,530,837,63.3
31104, 일산서구,080003, 77세,2016,1449,588,861,68.3,1438,582,856,68
31104, 일산서구,080004, 78세,2016,1354,522,832,62.7,1343,518,825,62.8
31104, 일산서구,080005, 79세,2016,1263,488,775,63,1256,486,770,63.1
31104, 일산서구,085,80~84세,2016,4583,1742,2841,61.3,4558,1734,2824,61.4
31104, 일산서구,085001, 80세,2016,1153,479,674,71.1,1149,477,672,71
31104, 일산서구,085002, 81세,2016,1131,420,711,59.1,1125,416,709,58.7
31104, 일산서구,085003, 82세,2016,905,328,577,56.8,898,327,571,57.3
31104, 일산서구,085004, 83세,2016,753,259,494,52.4,749,258,491,52.5
31104, 일산서구,085005, 84세,2016,641,256,385,66.5,637,256,381,67.2
31104, 일산서구,090,85~89세,2016,2109,655,1454,45,2101,652,1449,45
31104, 일산서구,090001, 85세,2016,587,201,386,52.1,584,199,385,51.7
31104, 일산서구,090002, 86세,2016,527,169,358,47.2,527,169,358,47.2
31104, 일산서구,090003, 87세,2016,411,128,283,45.2,408,128,280,45.7
31104, 일산서구,090004, 88세,2016,314,87,227,38.3,313,86,227,37.9
31104, 일산서구,090005, 89세,2016,270,70,200,35,269,70,199,35.2
31104, 일산서구,095,90~94세,2016,621,188,433,43.4,613,186,427,43.6
31104, 일산서구,095001, 90세,2016,190,52,138,37.7,190,52,138,37.7
31104, 일산서구,095002, 91세,2016,149,39,110,35.5,146,39,107,36.4
31104, 일산서구,095003, 92세,2016,108,36,72,50,108,36,72,50
31104, 일산서구,095004, 93세,2016,87,31,56,55.4,83,30,53,56.6
31104, 일산서구,095005, 94세,2016,87,30,57,52.6,86,29,57,50.9
31104, 일산서구,100,95~99세,2016,134,39,95,41.1,134,39,95,41.1
31104, 일산서구,100001, 95세,2016,46,16,30,53.3,46,16,30,53.3
31104, 일산서구,100002, 96세,2016,36,11,25,44,36,11,25,44
31104, 일산서구,100003, 97세,2016,23,6,17,35.3,23,6,17,35.3
31104, 일산서구,100004, 98세,2016,16,X,13,23.1,16,X,13,23.1
31104, 일산서구,100005, 99세,2016,13,X,10,30,13,X,10,30
31104, 일산서구,101,100세이상,2016,25,7,18,38.9,24,6,18,33.3
31104, 일산서구,102,15세미만,2016,43420,22309,21111,105.7,43210,22201,21009,105.7
31104, 일산서구,103,15~64세,2016,213757,105053,108704,96.6,209767,103008,106759,96.5
31104, 일산서구,104,65세이상,2016,30273,12269,18004,68.1,29976,12146,17830,68.1
31104, 일산서구,086,85세이상,2016,2889,889,2000,44.5,2872,883,1989,44.4
31104, 일산서구,126,평균연령,2016,39.3,38.4,40.2,,39.3,38.3,40.2,
31104, 일산서구,127,중위연령,2016,41.4,40.6,42.1,,41.4,40.6,42,
31110, 과천시,000,합계,2016,60923,29729,31194,95.3,60498,29523,30975,95.3
31110, 과천시,005,0~4세,2016,2244,1132,1112,101.8,2235,1127,1108,101.7
31110, 과천시,005001, 0세,2016,407,198,209,94.7,405,196,209,93.8
31110, 과천시,005002, 1세,2016,413,210,203,103.4,410,209,201,104
31110, 과천시,005003, 2세,2016,426,226,200,113,426,226,200,113
31110, 과천시,005004, 3세,2016,471,226,245,92.2,468,225,243,92.6
31110, 과천시,005005, 4세,2016,527,272,255,106.7,526,271,255,106.3
31110, 과천시,010,5~9세,2016,2710,1413,1297,108.9,2695,1405,1290,108.9
31110, 과천시,010001, 5세,2016,492,245,247,99.2,492,245,247,99.2
31110, 과천시,010002, 6세,2016,526,275,251,109.6,521,274,247,110.9
31110, 과천시,010003, 7세,2016,516,264,252,104.8,512,261,251,104
31110, 과천시,010004, 8세,2016,581,309,272,113.6,577,307,270,113.7
31110, 과천시,010005, 9세,2016,595,320,275,116.4,593,318,275,115.6
31110, 과천시,015,10~14세,2016,3329,1747,1582,110.4,3317,1742,1575,110.6
31110, 과천시,015001, 10세,2016,603,318,285,111.6,601,316,285,110.9
31110, 과천시,015002, 11세,2016,597,313,284,110.2,595,312,283,110.2
31110, 과천시,015003, 12세,2016,676,372,304,122.4,673,371,302,122.8
31110, 과천시,015004, 13세,2016,718,361,357,101.1,718,361,357,101.1
31110, 과천시,015005, 14세,2016,735,383,352,108.8,730,382,348,109.8
31110, 과천시,020,15~19세,2016,4246,2251,1995,112.8,4236,2246,1990,112.9
31110, 과천시,020001, 15세,2016,806,427,379,112.7,806,427,379,112.7
31110, 과천시,020002, 16세,2016,843,444,399,111.3,842,443,399,111
31110, 과천시,020003, 17세,2016,849,457,392,116.6,848,457,391,116.9
31110, 과천시,020004, 18세,2016,893,439,454,96.7,889,439,450,97.6
31110, 과천시,020005, 19세,2016,855,484,371,130.5,851,480,371,129.4
31110, 과천시,025,20~24세,2016,4050,2116,1934,109.4,4012,2100,1912,109.8
31110, 과천시,025001, 20세,2016,800,423,377,112.2,796,421,375,112.3
31110, 과천시,025002, 21세,2016,833,463,370,125.1,827,461,366,126
31110, 과천시,025003, 22세,2016,797,429,368,116.6,789,426,363,117.4
31110, 과천시,025004, 23세,2016,837,411,426,96.5,828,407,421,96.7
31110, 과천시,025005, 24세,2016,783,390,393,99.2,772,385,387,99.5
31110, 과천시,030,25~29세,2016,3910,2047,1863,109.9,3867,2035,1832,111.1
31110, 과천시,030001, 25세,2016,809,423,386,109.6,799,420,379,110.8
31110, 과천시,030002, 26세,2016,804,459,345,133,801,458,343,133.5
31110, 과천시,030003, 27세,2016,785,417,368,113.3,777,414,363,114
31110, 과천시,030004, 28세,2016,767,391,376,104,756,389,367,106
31110, 과천시,030005, 29세,2016,745,357,388,92,734,354,380,93.2
31110, 과천시,035,30~34세,2016,3673,1873,1800,104.1,3632,1849,1783,103.7
31110, 과천시,035001, 30세,2016,683,340,343,99.1,674,337,337,100
31110, 과천시,035002, 31세,2016,720,380,340,111.8,712,374,338,110.7
31110, 과천시,035003, 32세,2016,740,396,344,115.1,732,392,340,115.3
31110, 과천시,035004, 33세,2016,760,377,383,98.4,752,370,382,96.9
31110, 과천시,035005, 34세,2016,770,380,390,97.4,762,376,386,97.4
31110, 과천시,040,35~39세,2016,3823,1836,1987,92.4,3778,1804,1974,91.4
31110, 과천시,040001, 35세,2016,803,407,396,102.8,793,400,393,101.8
31110, 과천시,040002, 36세,2016,786,401,385,104.2,778,395,383,103.1
31110, 과천시,040003, 37세,2016,800,380,420,90.5,791,373,418,89.2
31110, 과천시,040004, 38세,2016,705,323,382,84.6,694,316,378,83.6
31110, 과천시,040005, 39세,2016,729,325,404,80.4,722,320,402,79.6
31110, 과천시,045,40~44세,2016,4857,2269,2588,87.7,4826,2252,2574,87.5
31110, 과천시,045001, 40세,2016,787,356,431,82.6,785,354,431,82.1
31110, 과천시,045002, 41세,2016,840,377,463,81.4,830,374,456,82
31110, 과천시,045003, 42세,2016,979,474,505,93.9,974,470,504,93.3
31110, 과천시,045004, 43세,2016,1126,535,591,90.5,1117,529,588,90
31110, 과천시,045005, 44세,2016,1125,527,598,88.1,1120,525,595,88.2
31110, 과천시,050,45~49세,2016,6218,2935,3283,89.4,6174,2915,3259,89.4
31110, 과천시,050001, 45세,2016,1283,589,694,84.9,1276,583,693,84.1
31110, 과천시,050002, 46세,2016,1229,575,654,87.9,1221,571,650,87.8
31110, 과천시,050003, 47세,2016,1250,603,647,93.2,1242,600,642,93.5
31110, 과천시,050004, 48세,2016,1293,602,691,87.1,1284,599,685,87.4
31110, 과천시,050005, 49세,2016,1163,566,597,94.8,1151,562,589,95.4
31110, 과천시,055,50~54세,2016,5698,2819,2879,97.9,5668,2804,2864,97.9
31110, 과천시,055001, 50세,2016,1167,590,577,102.3,1159,586,573,102.3
31110, 과천시,055002, 51세,2016,1161,562,599,93.8,1155,559,596,93.8
31110, 과천시,055003, 52세,2016,1082,525,557,94.3,1075,523,552,94.7
31110, 과천시,055004, 53세,2016,1196,601,595,101,1191,598,593,100.8
31110, 과천시,055005, 54세,2016,1092,541,551,98.2,1088,538,550,97.8
31110, 과천시,060,55~59세,2016,5280,2554,2726,93.7,5232,2537,2695,94.1
31110, 과천시,060001, 55세,2016,1208,579,629,92.1,1204,578,626,92.3
31110, 과천시,060002, 56세,2016,1167,526,641,82.1,1153,522,631,82.7
31110, 과천시,060003, 57세,2016,984,486,498,97.6,976,483,493,98
31110, 과천시,060004, 58세,2016,989,497,492,101,977,492,485,101.4
31110, 과천시,060005, 59세,2016,932,466,466,100,922,462,460,100.4
31110, 과천시,065,60~64세,2016,3460,1707,1753,97.4,3431,1693,1738,97.4
31110, 과천시,065001, 60세,2016,812,406,406,100,803,400,403,99.3
31110, 과천시,065002, 61세,2016,825,405,420,96.4,816,403,413,97.6
31110, 과천시,065003, 62세,2016,652,332,320,103.8,647,328,319,102.8
31110, 과천시,065004, 63세,2016,614,302,312,96.8,611,301,310,97.1
31110, 과천시,065005, 64세,2016,557,262,295,88.8,554,261,293,89.1
31110, 과천시,070,65~69세,2016,2234,1023,1211,84.5,2221,1018,1203,84.6
31110, 과천시,070001, 65세,2016,407,185,222,83.3,407,185,222,83.3
31110, 과천시,070002, 66세,2016,506,244,262,93.1,501,242,259,93.4
31110, 과천시,070003, 67세,2016,449,207,242,85.5,446,206,240,85.8
31110, 과천시,070004, 68세,2016,434,196,238,82.4,430,194,236,82.2
31110, 과천시,070005, 69세,2016,438,191,247,77.3,437,191,246,77.6
31110, 과천시,075,70~74세,2016,1865,811,1054,76.9,1859,806,1053,76.5
31110, 과천시,075001, 70세,2016,383,166,217,76.5,381,165,216,76.4
31110, 과천시,075002, 71세,2016,337,163,174,93.7,336,162,174,93.1
31110, 과천시,075003, 72세,2016,363,139,224,62.1,361,137,224,61.2
31110, 과천시,075004, 73세,2016,386,179,207,86.5,386,179,207,86.5
31110, 과천시,075005, 74세,2016,396,164,232,70.7,395,163,232,70.3
31110, 과천시,080,75~79세,2016,1492,604,888,68,1487,602,885,68
31110, 과천시,080001, 75세,2016,327,133,194,68.6,324,133,191,69.6
31110, 과천시,080002, 76세,2016,312,133,179,74.3,312,133,179,74.3
31110, 과천시,080003, 77세,2016,312,127,185,68.6,311,126,185,68.1
31110, 과천시,080004, 78세,2016,271,113,158,71.5,270,112,158,70.9
31110, 과천시,080005, 79세,2016,270,98,172,57,270,98,172,57
31110, 과천시,085,80~84세,2016,1049,379,670,56.6,1047,378,669,56.5
31110, 과천시,085001, 80세,2016,249,96,153,62.7,248,96,152,63.2
31110, 과천시,085002, 81세,2016,267,106,161,65.8,267,106,161,65.8
31110, 과천시,085003, 82세,2016,200,69,131,52.7,200,69,131,52.7
31110, 과천시,085004, 83세,2016,190,59,131,45,190,59,131,45
31110, 과천시,085005, 84세,2016,143,49,94,52.1,142,48,94,51.1
31110, 과천시,090,85~89세,2016,559,158,401,39.4,557,157,400,39.3
31110, 과천시,090001, 85세,2016,130,39,91,42.9,130,39,91,42.9
31110, 과천시,090002, 86세,2016,132,42,90,46.7,131,41,90,45.6
31110, 과천시,090003, 87세,2016,115,40,75,53.3,114,40,74,54.1
31110, 과천시,090004, 88세,2016,102,21,81,25.9,102,21,81,25.9
31110, 과천시,090005, 89세,2016,80,16,64,25,80,16,64,25
31110, 과천시,095,90~94세,2016,184,47,137,34.3,182,45,137,32.8
31110, 과천시,095001, 90세,2016,55,13,42,31,55,13,42,31
31110, 과천시,095002, 91세,2016,49,10,39,25.6,49,10,39,25.6
31110, 과천시,095003, 92세,2016,31,10,21,47.6,30,9,21,42.9
31110, 과천시,095004, 93세,2016,28,6,22,27.3,28,6,22,27.3
31110, 과천시,095005, 94세,2016,21,8,13,61.5,20,7,13,53.8
31110, 과천시,100,95~99세,2016,36,7,29,24.1,36,7,29,24.1
31110, 과천시,100001, 95세,2016,8,X,7,14.3,8,X,7,14.3
31110, 과천시,100002, 96세,2016,7,X,6,16.7,7,X,6,16.7
31110, 과천시,100003, 97세,2016,8,X,6,33.3,8,X,6,33.3
31110, 과천시,100004, 98세,2016,7,X,5,40,7,X,5,40
31110, 과천시,100005, 99세,2016,6,X,5,20,6,X,5,20
31110, 과천시,101,100세이상,2016,6,X,5,20,6,X,5,20
31110, 과천시,102,15세미만,2016,8283,4292,3991,107.5,8247,4274,3973,107.6
31110, 과천시,103,15~64세,2016,45215,22407,22808,98.2,44856,22235,22621,98.3
31110, 과천시,104,65세이상,2016,7425,3030,4395,68.9,7395,3014,4381,68.8
31110, 과천시,086,85세이상,2016,785,213,572,37.2,781,210,571,36.8
31110, 과천시,126,평균연령,2016,40.7,39.4,42,,40.7,39.3,42.1,
31110, 과천시,127,중위연령,2016,42.9,41.2,44.1,,42.9,41.3,44.1,
31120, 구리시,000,합계,2016,183905,91067,92838,98.1,182188,90284,91904,98.2
31120, 구리시,005,0~4세,2016,7951,4064,3887,104.6,7922,4047,3875,104.4
31120, 구리시,005001, 0세,2016,1424,702,722,97.2,1418,698,720,96.9
31120, 구리시,005002, 1세,2016,1569,789,780,101.2,1562,783,779,100.5
31120, 구리시,005003, 2세,2016,1584,819,765,107.1,1581,817,764,106.9
31120, 구리시,005004, 3세,2016,1624,859,765,112.3,1621,859,762,112.7
31120, 구리시,005005, 4세,2016,1750,895,855,104.7,1740,890,850,104.7
31120, 구리시,010,5~9세,2016,8457,4357,4100,106.3,8428,4341,4087,106.2
31120, 구리시,010001, 5세,2016,1691,856,835,102.5,1686,853,833,102.4
31120, 구리시,010002, 6세,2016,1628,826,802,103,1621,824,797,103.4
31120, 구리시,010003, 7세,2016,1642,864,778,111.1,1635,859,776,110.7
31120, 구리시,010004, 8세,2016,1750,887,863,102.8,1744,883,861,102.6
31120, 구리시,010005, 9세,2016,1746,924,822,112.4,1742,922,820,112.4
31120, 구리시,015,10~14세,2016,8982,4691,4291,109.3,8961,4679,4282,109.3
31120, 구리시,015001, 10세,2016,1741,945,796,118.7,1739,944,795,118.7
31120, 구리시,015002, 11세,2016,1612,885,727,121.7,1607,884,723,122.3
31120, 구리시,015003, 12세,2016,1822,918,904,101.5,1815,914,901,101.4
31120, 구리시,015004, 13세,2016,1863,933,930,100.3,1859,929,930,99.9
31120, 구리시,015005, 14세,2016,1944,1010,934,108.1,1941,1008,933,108
31120, 구리시,020,15~19세,2016,11570,5925,5645,105,11547,5912,5635,104.9
31120, 구리시,020001, 15세,2016,2205,1120,1085,103.2,2201,1118,1083,103.2
31120, 구리시,020002, 16세,2016,2439,1280,1159,110.4,2436,1278,1158,110.4
31120, 구리시,020003, 17세,2016,2334,1163,1171,99.3,2328,1159,1169,99.1
31120, 구리시,020004, 18세,2016,2386,1234,1152,107.1,2382,1231,1151,107
31120, 구리시,020005, 19세,2016,2206,1128,1078,104.6,2200,1126,1074,104.8
31120, 구리시,025,20~24세,2016,12872,6752,6120,110.3,12733,6693,6040,110.8
31120, 구리시,025001, 20세,2016,2434,1326,1108,119.7,2419,1321,1098,120.3
31120, 구리시,025002, 21세,2016,2584,1417,1167,121.4,2563,1410,1153,122.3
31120, 구리시,025003, 22세,2016,2603,1396,1207,115.7,2587,1385,1202,115.2
31120, 구리시,025004, 23세,2016,2581,1285,1296,99.2,2534,1264,1270,99.5
31120, 구리시,025005, 24세,2016,2670,1328,1342,99,2630,1313,1317,99.7
31120, 구리시,030,25~29세,2016,11498,5775,5723,100.9,11232,5637,5595,100.8
31120, 구리시,030001, 25세,2016,2501,1219,1282,95.1,2449,1189,1260,94.4
31120, 구리시,030002, 26세,2016,2392,1199,1193,100.5,2346,1172,1174,99.8
31120, 구리시,030003, 27세,2016,2262,1161,1101,105.4,2201,1134,1067,106.3
31120, 구리시,030004, 28세,2016,2177,1114,1063,104.8,2118,1086,1032,105.2
31120, 구리시,030005, 29세,2016,2166,1082,1084,99.8,2118,1056,1062,99.4
31120, 구리시,035,30~34세,2016,12204,6055,6149,98.5,11997,5946,6051,98.3
31120, 구리시,035001, 30세,2016,2132,1058,1074,98.5,2093,1042,1051,99.1
31120, 구리시,035002, 31세,2016,2240,1107,1133,97.7,2204,1086,1118,97.1
31120, 구리시,035003, 32세,2016,2292,1160,1132,102.5,2245,1133,1112,101.9
31120, 구리시,035004, 33세,2016,2664,1334,1330,100.3,2624,1313,1311,100.2
31120, 구리시,035005, 34세,2016,2876,1396,1480,94.3,2831,1372,1459,94
31120, 구리시,040,35~39세,2016,14413,7208,7205,100,14253,7137,7116,100.3
31120, 구리시,040001, 35세,2016,2976,1489,1487,100.1,2935,1471,1464,100.5
31120, 구리시,040002, 36세,2016,3019,1484,1535,96.7,2991,1471,1520,96.8
31120, 구리시,040003, 37세,2016,2947,1492,1455,102.5,2915,1476,1439,102.6
31120, 구리시,040004, 38세,2016,2650,1316,1334,98.7,2628,1307,1321,98.9
31120, 구리시,040005, 39세,2016,2821,1427,1394,102.4,2784,1412,1372,102.9
31120, 구리시,045,40~44세,2016,15904,7831,8073,97,15753,7764,7989,97.2
31120, 구리시,045001, 40세,2016,2825,1398,1427,98,2788,1384,1404,98.6
31120, 구리시,045002, 41세,2016,3027,1434,1593,90,2997,1425,1572,90.6
31120, 구리시,045003, 42세,2016,3232,1600,1632,98,3203,1587,1616,98.2
31120, 구리시,045004, 43세,2016,3372,1670,1702,98.1,3346,1657,1689,98.1
31120, 구리시,045005, 44세,2016,3448,1729,1719,100.6,3419,1711,1708,100.2
31120, 구리시,050,45~49세,2016,17921,8552,9369,91.3,17745,8486,9259,91.7
31120, 구리시,050001, 45세,2016,3678,1717,1961,87.6,3645,1704,1941,87.8
31120, 구리시,050002, 46세,2016,3548,1764,1784,98.9,3509,1745,1764,98.9
31120, 구리시,050003, 47세,2016,3656,1735,1921,90.3,3625,1724,1901,90.7
31120, 구리시,050004, 48세,2016,3765,1761,2004,87.9,3720,1746,1974,88.4
31120, 구리시,050005, 49세,2016,3274,1575,1699,92.7,3246,1567,1679,93.3
31120, 구리시,055,50~54세,2016,16769,8466,8303,102,16585,8401,8184,102.7
31120, 구리시,055001, 50세,2016,3397,1658,1739,95.3,3369,1646,1723,95.5
31120, 구리시,055002, 51세,2016,3384,1702,1682,101.2,3350,1683,1667,101
31120, 구리시,055003, 52세,2016,3179,1557,1622,96,3145,1547,1598,96.8
31120, 구리시,055004, 53세,2016,3335,1740,1595,109.1,3292,1728,1564,110.5
31120, 구리시,055005, 54세,2016,3474,1809,1665,108.6,3429,1797,1632,110.1
31120, 구리시,060,55~59세,2016,15428,7749,7679,100.9,15274,7682,7592,101.2
31120, 구리시,060001, 55세,2016,3556,1747,1809,96.6,3530,1733,1797,96.4
31120, 구리시,060002, 56세,2016,3413,1688,1725,97.9,3378,1678,1700,98.7
31120, 구리시,060003, 57세,2016,2997,1555,1442,107.8,2969,1545,1424,108.5
31120, 구리시,060004, 58세,2016,2786,1414,1372,103.1,2756,1397,1359,102.8
31120, 구리시,060005, 59세,2016,2676,1345,1331,101.1,2641,1329,1312,101.3
31120, 구리시,065,60~64세,2016,10222,5118,5104,100.3,10124,5076,5048,100.6
31120, 구리시,065001, 60세,2016,2351,1189,1162,102.3,2334,1182,1152,102.6
31120, 구리시,065002, 61세,2016,2384,1190,1194,99.7,2365,1182,1183,99.9
31120, 구리시,065003, 62세,2016,1950,1007,943,106.8,1929,1000,929,107.6
31120, 구리시,065004, 63세,2016,1671,821,850,96.6,1652,810,842,96.2
31120, 구리시,065005, 64세,2016,1866,911,955,95.4,1844,902,942,95.8
31120, 구리시,070,65~69세,2016,6574,3153,3421,92.2,6530,3127,3403,91.9
31120, 구리시,070001, 65세,2016,1241,632,609,103.8,1230,624,606,103
31120, 구리시,070002, 66세,2016,1326,626,700,89.4,1314,619,695,89.1
31120, 구리시,070003, 67세,2016,1267,627,640,98,1258,622,636,97.8
31120, 구리시,070004, 68세,2016,1364,631,733,86.1,1360,629,731,86
31120, 구리시,070005, 69세,2016,1376,637,739,86.2,1368,633,735,86.1
31120, 구리시,075,70~74세,2016,5424,2443,2981,82,5410,2436,2974,81.9
31120, 구리시,075001, 70세,2016,1108,513,595,86.2,1105,511,594,86
31120, 구리시,075002, 71세,2016,1049,480,569,84.4,1044,478,566,84.5
31120, 구리시,075003, 72세,2016,1034,440,594,74.1,1032,439,593,74
31120, 구리시,075004, 73세,2016,1041,459,582,78.9,1040,458,582,78.7
31120, 구리시,075005, 74세,2016,1192,551,641,86,1189,550,639,86.1
31120, 구리시,080,75~79세,2016,4114,1761,2353,74.8,4099,1755,2344,74.9
31120, 구리시,080001, 75세,2016,1007,455,552,82.4,1002,454,548,82.8
31120, 구리시,080002, 76세,2016,853,349,504,69.2,853,349,504,69.2
31120, 구리시,080003, 77세,2016,850,364,486,74.9,845,363,482,75.3
31120, 구리시,080004, 78세,2016,747,320,427,74.9,743,317,426,74.4
31120, 구리시,080005, 79세,2016,657,273,384,71.1,656,272,384,70.8
31120, 구리시,085,80~84세,2016,2200,793,1407,56.4,2195,791,1404,56.3
31120, 구리시,085001, 80세,2016,554,204,350,58.3,553,203,350,58
31120, 구리시,085002, 81세,2016,514,177,337,52.5,514,177,337,52.5
31120, 구리시,085003, 82세,2016,452,170,282,60.3,449,169,280,60.4
31120, 구리시,085004, 83세,2016,371,139,232,59.9,371,139,232,59.9
31120, 구리시,085005, 84세,2016,309,103,206,50,308,103,205,50.2
31120, 구리시,090,85~89세,2016,1002,284,718,39.6,1001,284,717,39.6
31120, 구리시,090001, 85세,2016,253,89,164,54.3,253,89,164,54.3
31120, 구리시,090002, 86세,2016,278,82,196,41.8,278,82,196,41.8
31120, 구리시,090003, 87세,2016,193,53,140,37.9,193,53,140,37.9
31120, 구리시,090004, 88세,2016,156,33,123,26.8,155,33,122,27
31120, 구리시,090005, 89세,2016,122,27,95,28.4,122,27,95,28.4
31120, 구리시,095,90~94세,2016,324,75,249,30.1,323,75,248,30.2
31120, 구리시,095001, 90세,2016,100,22,78,28.2,100,22,78,28.2
31120, 구리시,095002, 91세,2016,79,21,58,36.2,78,21,57,36.8
31120, 구리시,095003, 92세,2016,65,16,49,32.7,65,16,49,32.7
31120, 구리시,095004, 93세,2016,43,7,36,19.4,43,7,36,19.4
31120, 구리시,095005, 94세,2016,37,9,28,32.1,37,9,28,32.1
31120, 구리시,100,95~99세,2016,68,14,54,25.9,68,14,54,25.9
31120, 구리시,100001, 95세,2016,25,6,19,31.6,25,6,19,31.6
31120, 구리시,100002, 96세,2016,20,5,15,33.3,20,5,15,33.3
31120, 구리시,100003, 97세,2016,12,X,10,20,12,X,10,20
31120, 구리시,100004, 98세,2016,6,X,6,0,6,X,6,0
31120, 구리시,100005, 99세,2016,5,X,X,25,5,X,X,25
31120, 구리시,101,100세이상,2016,8,X,7,14.3,8,X,7,14.3
31120, 구리시,102,15세미만,2016,25390,13112,12278,106.8,25311,13067,12244,106.7
31120, 구리시,103,15~64세,2016,138801,69431,69370,100.1,137243,68734,68509,100.3
31120, 구리시,104,65세이상,2016,19714,8524,11190,76.2,19634,8483,11151,76.1
31120, 구리시,086,85세이상,2016,1402,374,1028,36.4,1400,374,1026,36.5
31120, 구리시,126,평균연령,2016,39.9,39,40.7,,39.9,39,40.7,
31120, 구리시,127,중위연령,2016,41.4,40.5,42.2,,41.4,40.5,42.2,
31130, 남양주시,000,합계,2016,641589,320811,320778,100,633349,315834,317515,99.5
31130, 남양주시,005,0~4세,2016,32527,16741,15786,106,32453,16699,15754,106
31130, 남양주시,005001, 0세,2016,5461,2830,2631,107.6,5448,2822,2626,107.5
31130, 남양주시,005002, 1세,2016,6248,3146,3102,101.4,6234,3136,3098,101.2
31130, 남양주시,005003, 2세,2016,6353,3309,3044,108.7,6338,3302,3036,108.8
31130, 남양주시,005004, 3세,2016,6808,3536,3272,108.1,6797,3530,3267,108.1
31130, 남양주시,005005, 4세,2016,7657,3920,3737,104.9,7636,3909,3727,104.9
31130, 남양주시,010,5~9세,2016,37679,19467,18212,106.9,37595,19425,18170,106.9
31130, 남양주시,010001, 5세,2016,7687,3930,3757,104.6,7670,3921,3749,104.6
31130, 남양주시,010002, 6세,2016,7341,3843,3498,109.9,7318,3832,3486,109.9
31130, 남양주시,010003, 7세,2016,7333,3764,3569,105.5,7316,3756,3560,105.5
31130, 남양주시,010004, 8세,2016,7613,3936,3677,107,7597,3928,3669,107.1
31130, 남양주시,010005, 9세,2016,7705,3994,3711,107.6,7694,3988,3706,107.6
31130, 남양주시,015,10~14세,2016,34870,17970,16900,106.3,34808,17940,16868,106.4
31130, 남양주시,015001, 10세,2016,6933,3568,3365,106,6919,3561,3358,106
31130, 남양주시,015002, 11세,2016,6701,3460,3241,106.8,6689,3456,3233,106.9
31130, 남양주시,015003, 12세,2016,7218,3713,3505,105.9,7202,3705,3497,105.9
31130, 남양주시,015004, 13세,2016,6963,3575,3388,105.5,6953,3568,3385,105.4
31130, 남양주시,015005, 14세,2016,7055,3654,3401,107.4,7045,3650,3395,107.5
31130, 남양주시,020,15~19세,2016,39089,20109,18980,105.9,38957,20047,18910,106
31130, 남양주시,020001, 15세,2016,7831,3991,3840,103.9,7820,3986,3834,104
31130, 남양주시,020002, 16세,2016,8041,4207,3834,109.7,8020,4195,3825,109.7
31130, 남양주시,020003, 17세,2016,7912,4013,3899,102.9,7893,4004,3889,103
31130, 남양주시,020004, 18세,2016,7784,3981,3803,104.7,7770,3975,3795,104.7
31130, 남양주시,020005, 19세,2016,7521,3917,3604,108.7,7454,3887,3567,109
31130, 남양주시,025,20~24세,2016,38465,20733,17732,116.9,37608,20149,17459,115.4
31130, 남양주시,025001, 20세,2016,7922,4399,3523,124.9,7848,4349,3499,124.3
31130, 남양주시,025002, 21세,2016,7797,4393,3404,129.1,7699,4327,3372,128.3
31130, 남양주시,025003, 22세,2016,7505,4027,3478,115.8,7348,3928,3420,114.9
31130, 남양주시,025004, 23세,2016,7617,3935,3682,106.9,7369,3767,3602,104.6
31130, 남양주시,025005, 24세,2016,7624,3979,3645,109.2,7344,3778,3566,105.9
31130, 남양주시,030,25~29세,2016,33167,17181,15986,107.5,31470,15996,15474,103.4
31130, 남양주시,030001, 25세,2016,7270,3708,3562,104.1,6930,3464,3466,99.9
31130, 남양주시,030002, 26세,2016,6709,3539,3170,111.6,6372,3310,3062,108.1
31130, 남양주시,030003, 27세,2016,6461,3342,3119,107.1,6125,3112,3013,103.3
31130, 남양주시,030004, 28세,2016,6466,3385,3081,109.9,6102,3125,2977,105
31130, 남양주시,030005, 29세,2016,6261,3207,3054,105,5941,2985,2956,101
31130, 남양주시,035,30~34세,2016,40484,19904,20580,96.7,39037,18966,20071,94.5
31130, 남양주시,035001, 30세,2016,6718,3328,3390,98.2,6422,3154,3268,96.5
31130, 남양주시,035002, 31세,2016,7178,3573,3605,99.1,6858,3355,3503,95.8
31130, 남양주시,035003, 32세,2016,7740,3769,3971,94.9,7443,3568,3875,92.1
31130, 남양주시,035004, 33세,2016,8750,4372,4378,99.9,8472,4197,4275,98.2
31130, 남양주시,035005, 34세,2016,10098,4862,5236,92.9,9842,4692,5150,91.1
31130, 남양주시,040,35~39세,2016,55447,27202,28245,96.3,54468,26571,27897,95.2
31130, 남양주시,040001, 35세,2016,10805,5267,5538,95.1,10585,5130,5455,94
31130, 남양주시,040002, 36세,2016,11686,5696,5990,95.1,11446,5534,5912,93.6
31130, 남양주시,040003, 37세,2016,11317,5547,5770,96.1,11107,5400,5707,94.6
31130, 남양주시,040004, 38세,2016,10574,5203,5371,96.9,10410,5105,5305,96.2
31130, 남양주시,040005, 39세,2016,11065,5489,5576,98.4,10920,5402,5518,97.9
31130, 남양주시,045,40~44세,2016,60694,30841,29853,103.3,59934,30382,29552,102.8
31130, 남양주시,045001, 40세,2016,10963,5441,5522,98.5,10791,5342,5449,98
31130, 남양주시,045002, 41세,2016,11860,5983,5877,101.8,11710,5893,5817,101.3
31130, 남양주시,045003, 42세,2016,12548,6372,6176,103.2,12390,6279,6111,102.7
31130, 남양주시,045004, 43세,2016,12618,6445,6173,104.4,12471,6349,6122,103.7
31130, 남양주시,045005, 44세,2016,12705,6600,6105,108.1,12572,6519,6053,107.7
31130, 남양주시,050,45~49세,2016,59581,30314,29267,103.6,58932,29954,28978,103.4
31130, 남양주시,050001, 45세,2016,13068,6700,6368,105.2,12929,6623,6306,105
31130, 남양주시,050002, 46세,2016,12181,6316,5865,107.7,12030,6233,5797,107.5
31130, 남양주시,050003, 47세,2016,12031,6076,5955,102,11902,5998,5904,101.6
31130, 남양주시,050004, 48세,2016,11614,5841,5773,101.2,11496,5779,5717,101.1
31130, 남양주시,050005, 49세,2016,10687,5381,5306,101.4,10575,5321,5254,101.3
31130, 남양주시,055,50~54세,2016,51084,26393,24691,106.9,50554,26145,24409,107.1
31130, 남양주시,055001, 50세,2016,10454,5452,5002,109,10347,5394,4953,108.9
31130, 남양주시,055002, 51세,2016,10438,5301,5137,103.2,10325,5252,5073,103.5
31130, 남양주시,055003, 52세,2016,10032,5206,4826,107.9,9932,5163,4769,108.3
31130, 남양주시,055004, 53세,2016,10117,5226,4891,106.8,10014,5176,4838,107
31130, 남양주시,055005, 54세,2016,10043,5208,4835,107.7,9936,5160,4776,108
31130, 남양주시,060,55~59세,2016,47774,24008,23766,101,47385,23855,23530,101.4
31130, 남양주시,060001, 55세,2016,10499,5325,5174,102.9,10414,5300,5114,103.6
31130, 남양주시,060002, 56세,2016,10442,5311,5131,103.5,10369,5278,5091,103.7
31130, 남양주시,060003, 57세,2016,9277,4650,4627,100.5,9204,4624,4580,101
31130, 남양주시,060004, 58세,2016,8966,4471,4495,99.5,8894,4442,4452,99.8
31130, 남양주시,060005, 59세,2016,8590,4251,4339,98,8504,4211,4293,98.1
31130, 남양주시,065,60~64세,2016,35339,17155,18184,94.3,35028,17022,18006,94.5
31130, 남양주시,065001, 60세,2016,7936,3932,4004,98.2,7857,3897,3960,98.4
31130, 남양주시,065002, 61세,2016,7990,3845,4145,92.8,7928,3821,4107,93
31130, 남양주시,065003, 62세,2016,6956,3367,3589,93.8,6890,3341,3549,94.1
31130, 남양주시,065004, 63세,2016,5782,2808,2974,94.4,5736,2784,2952,94.3
31130, 남양주시,065005, 64세,2016,6675,3203,3472,92.3,6617,3179,3438,92.5
31130, 남양주시,070,65~69세,2016,24810,11805,13005,90.8,24668,11745,12923,90.9
31130, 남양주시,070001, 65세,2016,4451,2120,2331,90.9,4416,2107,2309,91.3
31130, 남양주시,070002, 66세,2016,5002,2329,2673,87.1,4960,2312,2648,87.3
31130, 남양주시,070003, 67세,2016,5130,2446,2684,91.1,5106,2435,2671,91.2
31130, 남양주시,070004, 68세,2016,5124,2445,2679,91.3,5093,2431,2662,91.3
31130, 남양주시,070005, 69세,2016,5103,2465,2638,93.4,5093,2460,2633,93.4
31130, 남양주시,075,70~74세,2016,20382,9387,10995,85.4,20327,9361,10966,85.4
31130, 남양주시,075001, 70세,2016,4067,1870,2197,85.1,4056,1863,2193,85
31130, 남양주시,075002, 71세,2016,3990,1891,2099,90.1,3980,1888,2092,90.2
31130, 남양주시,075003, 72세,2016,3893,1793,2100,85.4,3877,1786,2091,85.4
31130, 남양주시,075004, 73세,2016,3921,1759,2162,81.4,3909,1753,2156,81.3
31130, 남양주시,075005, 74세,2016,4511,2074,2437,85.1,4505,2071,2434,85.1
31130, 남양주시,080,75~79세,2016,15400,6713,8687,77.3,15357,6700,8657,77.4
31130, 남양주시,080001, 75세,2016,3595,1614,1981,81.5,3582,1609,1973,81.6
31130, 남양주시,080002, 76세,2016,3312,1481,1831,80.9,3299,1478,1821,81.2
31130, 남양주시,080003, 77세,2016,3284,1408,1876,75.1,3280,1406,1874,75
31130, 남양주시,080004, 78세,2016,2700,1156,1544,74.9,2696,1156,1540,75.1
31130, 남양주시,080005, 79세,2016,2509,1054,1455,72.4,2500,1051,1449,72.5
31130, 남양주시,085,80~84세,2016,8984,3344,5640,59.3,8967,3336,5631,59.2
31130, 남양주시,085001, 80세,2016,2307,898,1409,63.7,2304,896,1408,63.6
31130, 남양주시,085002, 81세,2016,2107,836,1271,65.8,2104,835,1269,65.8
31130, 남양주시,085003, 82세,2016,1787,649,1138,57,1783,645,1138,56.7
31130, 남양주시,085004, 83세,2016,1455,501,954,52.5,1449,500,949,52.7
31130, 남양주시,085005, 84세,2016,1328,460,868,53,1327,460,867,53.1
31130, 남양주시,090,85~89세,2016,3990,1105,2885,38.3,3983,1104,2879,38.3
31130, 남양주시,090001, 85세,2016,1020,322,698,46.1,1014,322,692,46.5
31130, 남양주시,090002, 86세,2016,963,255,708,36,963,255,708,36
31130, 남양주시,090003, 87세,2016,841,251,590,42.5,841,251,590,42.5
31130, 남양주시,090004, 88세,2016,663,171,492,34.8,662,170,492,34.6
31130, 남양주시,090005, 89세,2016,503,106,397,26.7,503,106,397,26.7
31130, 남양주시,095,90~94세,2016,1448,337,1111,30.3,1444,336,1108,30.3
31130, 남양주시,095001, 90세,2016,428,88,340,25.9,426,87,339,25.7
31130, 남양주시,095002, 91세,2016,341,76,265,28.7,339,76,263,28.9
31130, 남양주시,095003, 92세,2016,220,59,161,36.6,220,59,161,36.6
31130, 남양주시,095004, 93세,2016,242,58,184,31.5,242,58,184,31.5
31130, 남양주시,095005, 94세,2016,217,56,161,34.8,217,56,161,34.8
31130, 남양주시,100,95~99세,2016,325,95,230,41.3,324,94,230,40.9
31130, 남양주시,100001, 95세,2016,123,39,84,46.4,123,39,84,46.4
31130, 남양주시,100002, 96세,2016,65,19,46,41.3,64,18,46,39.1
31130, 남양주시,100003, 97세,2016,65,22,43,51.2,65,22,43,51.2
31130, 남양주시,100004, 98세,2016,45,10,35,28.6,45,10,35,28.6
31130, 남양주시,100005, 99세,2016,27,5,22,22.7,27,5,22,22.7
31130, 남양주시,101,100세이상,2016,50,7,43,16.3,50,7,43,16.3
31130, 남양주시,102,15세미만,2016,105076,54178,50898,106.4,104856,54064,50792,106.4
31130, 남양주시,103,15~64세,2016,461124,233840,227284,102.9,453373,229087,224286,102.1
31130, 남양주시,104,65세이상,2016,75389,32793,42596,77,75120,32683,42437,77
31130, 남양주시,086,85세이상,2016,5813,1544,4269,36.2,5801,1541,4260,36.2
31130, 남양주시,126,평균연령,2016,39.4,38.5,40.3,,39.5,38.6,40.3,
31130, 남양주시,127,중위연령,2016,40.8,40.2,41.4,,41,40.4,41.5,
31140, 오산시,000,합계,2016,215478,110540,104938,105.3,204840,105039,99801,105.2
31140, 오산시,005,0~4세,2016,13512,6910,6602,104.7,13188,6741,6447,104.6
31140, 오산시,005001, 0세,2016,2393,1209,1184,102.1,2310,1168,1142,102.3
31140, 오산시,005002, 1세,2016,2545,1295,1250,103.6,2474,1263,1211,104.3
31140, 오산시,005003, 2세,2016,2738,1390,1348,103.1,2662,1350,1312,102.9
31140, 오산시,005004, 3세,2016,2746,1438,1308,109.9,2701,1409,1292,109.1
31140, 오산시,005005, 4세,2016,3090,1578,1512,104.4,3041,1551,1490,104.1
31140, 오산시,010,5~9세,2016,14085,7357,6728,109.3,13940,7275,6665,109.2
31140, 오산시,010001, 5세,2016,2974,1552,1422,109.1,2928,1523,1405,108.4
31140, 오산시,010002, 6세,2016,2862,1460,1402,104.1,2832,1445,1387,104.2
31140, 오산시,010003, 7세,2016,2678,1396,1282,108.9,2646,1381,1265,109.2
31140, 오산시,010004, 8세,2016,2803,1501,1302,115.3,2778,1486,1292,115
31140, 오산시,010005, 9세,2016,2768,1448,1320,109.7,2756,1440,1316,109.4
31140, 오산시,015,10~14세,2016,11477,5828,5649,103.2,11427,5802,5625,103.1
31140, 오산시,015001, 10세,2016,2371,1196,1175,101.8,2357,1187,1170,101.5
31140, 오산시,015002, 11세,2016,2288,1178,1110,106.1,2277,1170,1107,105.7
31140, 오산시,015003, 12세,2016,2308,1178,1130,104.2,2298,1176,1122,104.8
31140, 오산시,015004, 13세,2016,2268,1166,1102,105.8,2258,1160,1098,105.6
31140, 오산시,015005, 14세,2016,2242,1110,1132,98.1,2237,1109,1128,98.3
31140, 오산시,020,15~19세,2016,12421,6337,6084,104.2,12289,6274,6015,104.3
31140, 오산시,020001, 15세,2016,2464,1261,1203,104.8,2448,1251,1197,104.5
31140, 오산시,020002, 16세,2016,2532,1295,1237,104.7,2521,1292,1229,105.1
31140, 오산시,020003, 17세,2016,2513,1276,1237,103.2,2499,1270,1229,103.3
31140, 오산시,020004, 18세,2016,2447,1243,1204,103.2,2408,1223,1185,103.2
31140, 오산시,020005, 19세,2016,2465,1262,1203,104.9,2413,1238,1175,105.4
31140, 오산시,025,20~24세,2016,13013,6869,6144,111.8,12572,6656,5916,112.5
31140, 오산시,025001, 20세,2016,2461,1332,1129,118,2403,1302,1101,118.3
31140, 오산시,025002, 21세,2016,2610,1347,1263,106.7,2532,1304,1228,106.2
31140, 오산시,025003, 22세,2016,2522,1371,1151,119.1,2440,1338,1102,121.4
31140, 오산시,025004, 23세,2016,2613,1350,1263,106.9,2510,1300,1210,107.4
31140, 오산시,025005, 24세,2016,2807,1469,1338,109.8,2687,1412,1275,110.7
31140, 오산시,030,25~29세,2016,14317,7582,6735,112.6,12931,6872,6059,113.4
31140, 오산시,030001, 25세,2016,2739,1426,1313,108.6,2533,1317,1216,108.3
31140, 오산시,030002, 26세,2016,2762,1459,1303,112,2525,1346,1179,114.2
31140, 오산시,030003, 27세,2016,2779,1530,1249,122.5,2513,1394,1119,124.6
31140, 오산시,030004, 28세,2016,2950,1588,1362,116.6,2619,1406,1213,115.9
31140, 오산시,030005, 29세,2016,3087,1579,1508,104.7,2741,1409,1332,105.8
31140, 오산시,035,30~34세,2016,19986,10467,9519,110,18351,9588,8763,109.4
31140, 오산시,035001, 30세,2016,3318,1758,1560,112.7,2974,1586,1388,114.3
31140, 오산시,035002, 31세,2016,3582,1870,1712,109.2,3264,1697,1567,108.3
31140, 오산시,035003, 32세,2016,3806,1967,1839,107,3485,1807,1678,107.7
31140, 오산시,035004, 33세,2016,4315,2257,2058,109.7,4013,2099,1914,109.7
31140, 오산시,035005, 34세,2016,4965,2615,2350,111.3,4615,2399,2216,108.3
31140, 오산시,040,35~39세,2016,23421,12335,11086,111.3,22207,11654,10553,110.4
31140, 오산시,040001, 35세,2016,4911,2592,2319,111.8,4647,2444,2203,110.9
31140, 오산시,040002, 36세,2016,5073,2610,2463,106,4789,2458,2331,105.4
31140, 오산시,040003, 37세,2016,4755,2506,2249,111.4,4485,2353,2132,110.4
31140, 오산시,040004, 38세,2016,4321,2291,2030,112.9,4124,2182,1942,112.4
31140, 오산시,040005, 39세,2016,4361,2336,2025,115.4,4162,2217,1945,114
31140, 오산시,045,40~44세,2016,21060,11166,9894,112.9,20053,10591,9462,111.9
31140, 오산시,045001, 40세,2016,4170,2223,1947,114.2,3986,2117,1869,113.3
31140, 오산시,045002, 41세,2016,4253,2270,1983,114.5,4061,2157,1904,113.3
31140, 오산시,045003, 42세,2016,4417,2347,2070,113.4,4231,2240,1991,112.5
31140, 오산시,045004, 43세,2016,4221,2208,2013,109.7,3988,2083,1905,109.3
31140, 오산시,045005, 44세,2016,3999,2118,1881,112.6,3787,1994,1793,111.2
31140, 오산시,050,45~49세,2016,18943,9856,9087,108.5,17806,9265,8541,108.5
31140, 오산시,050001, 45세,2016,4092,2121,1971,107.6,3880,2019,1861,108.5
31140, 오산시,050002, 46세,2016,3839,2051,1788,114.7,3601,1931,1670,115.6
31140, 오산시,050003, 47세,2016,3886,2044,1842,111,3634,1904,1730,110.1
31140, 오산시,050004, 48세,2016,3853,1982,1871,105.9,3613,1854,1759,105.4
31140, 오산시,050005, 49세,2016,3273,1658,1615,102.7,3078,1557,1521,102.4
31140, 오산시,055,50~54세,2016,15076,7936,7140,111.1,13944,7366,6578,112
31140, 오산시,055001, 50세,2016,3088,1615,1473,109.6,2882,1525,1357,112.4
31140, 오산시,055002, 51세,2016,3267,1722,1545,111.5,3045,1604,1441,111.3
31140, 오산시,055003, 52세,2016,2879,1526,1353,112.8,2662,1403,1259,111.4
31140, 오산시,055004, 53세,2016,2896,1524,1372,111.1,2640,1406,1234,113.9
31140, 오산시,055005, 54세,2016,2946,1549,1397,110.9,2715,1428,1287,111
31140, 오산시,060,55~59세,2016,13146,6651,6495,102.4,12267,6253,6014,104
31140, 오산시,060001, 55세,2016,3101,1585,1516,104.6,2982,1534,1448,105.9
31140, 오산시,060002, 56세,2016,2996,1520,1476,103,2777,1416,1361,104
31140, 오산시,060003, 57세,2016,2561,1307,1254,104.2,2387,1227,1160,105.8
31140, 오산시,060004, 58세,2016,2343,1176,1167,100.8,2158,1090,1068,102.1
31140, 오산시,060005, 59세,2016,2145,1063,1082,98.2,1963,986,977,100.9
31140, 오산시,065,60~64세,2016,8674,4312,4362,98.9,7984,3973,4011,99.1
31140, 오산시,065001, 60세,2016,2024,999,1025,97.5,1868,923,945,97.7
31140, 오산시,065002, 61세,2016,2020,1013,1007,100.6,1850,923,927,99.6
31140, 오산시,065003, 62세,2016,1677,827,850,97.3,1528,765,763,100.3
31140, 오산시,065004, 63세,2016,1372,671,701,95.7,1264,617,647,95.4
31140, 오산시,065005, 64세,2016,1581,802,779,103,1474,745,729,102.2
31140, 오산시,070,65~69세,2016,5565,2656,2909,91.3,5265,2505,2760,90.8
31140, 오산시,070001, 65세,2016,1073,503,570,88.2,992,461,531,86.8
31140, 오산시,070002, 66세,2016,1129,549,580,94.7,1051,508,543,93.6
31140, 오산시,070003, 67세,2016,1145,540,605,89.3,1080,506,574,88.2
31140, 오산시,070004, 68세,2016,1116,539,577,93.4,1075,522,553,94.4
31140, 오산시,070005, 69세,2016,1102,525,577,91,1067,508,559,90.9
31140, 오산시,075,70~74세,2016,4404,1909,2495,76.5,4315,1875,2440,76.8
31140, 오산시,075001, 70세,2016,878,405,473,85.6,853,394,459,85.8
31140, 오산시,075002, 71세,2016,842,368,474,77.6,823,360,463,77.8
31140, 오산시,075003, 72세,2016,847,360,487,73.9,831,352,479,73.5
31140, 오산시,075004, 73세,2016,850,349,501,69.7,839,348,491,70.9
31140, 오산시,075005, 74세,2016,987,427,560,76.3,969,421,548,76.8
31140, 오산시,080,75~79세,2016,3353,1388,1965,70.6,3319,1377,1942,70.9
31140, 오산시,080001, 75세,2016,784,333,451,73.8,773,331,442,74.9
31140, 오산시,080002, 76세,2016,701,289,412,70.1,692,285,407,70
31140, 오산시,080003, 77세,2016,684,289,395,73.2,677,286,391,73.1
31140, 오산시,080004, 78세,2016,664,270,394,68.5,662,269,393,68.4
31140, 오산시,080005, 79세,2016,520,207,313,66.1,515,206,309,66.7
31140, 오산시,085,80~84세,2016,1940,728,1212,60.1,1911,719,1192,60.3
31140, 오산시,085001, 80세,2016,533,217,316,68.7,524,216,308,70.1
31140, 오산시,085002, 81세,2016,460,173,287,60.3,455,172,283,60.8
31140, 오산시,085003, 82세,2016,396,157,239,65.7,390,154,236,65.3
31140, 오산시,085004, 83세,2016,285,98,187,52.4,282,97,185,52.4
31140, 오산시,085005, 84세,2016,266,83,183,45.4,260,80,180,44.4
31140, 오산시,090,85~89세,2016,738,180,558,32.3,731,180,551,32.7
31140, 오산시,090001, 85세,2016,195,53,142,37.3,192,53,139,38.1
31140, 오산시,090002, 86세,2016,195,42,153,27.5,193,42,151,27.8
31140, 오산시,090003, 87세,2016,115,34,81,42,115,34,81,42
31140, 오산시,090004, 88세,2016,123,32,91,35.2,121,32,89,36
31140, 오산시,090005, 89세,2016,110,19,91,20.9,110,19,91,20.9
31140, 오산시,095,90~94세,2016,275,57,218,26.1,269,57,212,26.9
31140, 오산시,095001, 90세,2016,73,13,60,21.7,72,13,59,22
31140, 오산시,095002, 91세,2016,70,17,53,32.1,69,17,52,32.7
31140, 오산시,095003, 92세,2016,49,9,40,22.5,48,9,39,23.1
31140, 오산시,095004, 93세,2016,43,7,36,19.4,43,7,36,19.4
31140, 오산시,095005, 94세,2016,40,11,29,37.9,37,11,26,42.3
31140, 오산시,100,95~99세,2016,63,16,47,34,62,16,46,34.8
31140, 오산시,100001, 95세,2016,24,5,19,26.3,23,5,18,27.8
31140, 오산시,100002, 96세,2016,14,X,10,40,14,X,10,40
31140, 오산시,100003, 97세,2016,10,5,5,100,10,5,5,100
31140, 오산시,100004, 98세,2016,6,X,5,20,6,X,5,20
31140, 오산시,100005, 99세,2016,9,X,8,12.5,9,X,8,12.5
31140, 오산시,101,100세이상,2016,9,X,9,0,9,X,9,0
31140, 오산시,102,15세미만,2016,39074,20095,18979,105.9,38555,19818,18737,105.8
31140, 오산시,103,15~64세,2016,160057,83511,76546,109.1,150404,78492,71912,109.2
31140, 오산시,104,65세이상,2016,16347,6934,9413,73.7,15881,6729,9152,73.5
31140, 오산시,086,85세이상,2016,1085,253,832,30.4,1071,253,818,30.9
31140, 오산시,126,평균연령,2016,36.2,35.6,36.9,,36,35.4,36.6,
31140, 오산시,127,중위연령,2016,36.8,36.5,37.1,,36.6,36.4,36.9,
31150, 시흥시,000,합계,2016,429321,227832,201489,113.1,390396,204585,185811,110.1
31150, 시흥시,005,0~4세,2016,19023,9821,9202,106.7,17821,9169,8652,106
31150, 시흥시,005001, 0세,2016,3455,1736,1719,101,3153,1572,1581,99.4
31150, 시흥시,005002, 1세,2016,3843,2021,1822,110.9,3590,1879,1711,109.8
31150, 시흥시,005003, 2세,2016,3585,1812,1773,102.2,3345,1677,1668,100.5
31150, 시흥시,005004, 3세,2016,3928,2055,1873,109.7,3704,1945,1759,110.6
31150, 시흥시,005005, 4세,2016,4212,2197,2015,109,4029,2096,1933,108.4
31150, 시흥시,010,5~9세,2016,21127,10823,10304,105,20657,10564,10093,104.7
31150, 시흥시,010001, 5세,2016,4220,2187,2033,107.6,4079,2107,1972,106.8
31150, 시흥시,010002, 6세,2016,4086,2063,2023,102,3977,2011,1966,102.3
31150, 시흥시,010003, 7세,2016,4126,2145,1981,108.3,4044,2100,1944,108
31150, 시흥시,010004, 8세,2016,4322,2250,2072,108.6,4249,2211,2038,108.5
31150, 시흥시,010005, 9세,2016,4373,2178,2195,99.2,4308,2135,2173,98.3
31150, 시흥시,015,10~14세,2016,21384,11026,10358,106.4,21227,10951,10276,106.6
31150, 시흥시,015001, 10세,2016,4111,2070,2041,101.4,4071,2050,2021,101.4
31150, 시흥시,015002, 11세,2016,4040,2041,1999,102.1,4009,2024,1985,102
31150, 시흥시,015003, 12세,2016,4281,2250,2031,110.8,4246,2234,2012,111
31150, 시흥시,015004, 13세,2016,4435,2276,2159,105.4,4406,2266,2140,105.9
31150, 시흥시,015005, 14세,2016,4517,2389,2128,112.3,4495,2377,2118,112.2
31150, 시흥시,020,15~19세,2016,27887,14583,13304,109.6,27606,14461,13145,110
31150, 시흥시,020001, 15세,2016,5154,2699,2455,109.9,5122,2684,2438,110.1
31150, 시흥시,020002, 16세,2016,5698,3025,2673,113.2,5656,3010,2646,113.8
31150, 시흥시,020003, 17세,2016,5656,2922,2734,106.9,5614,2902,2712,107
31150, 시흥시,020004, 18세,2016,5746,2972,2774,107.1,5680,2939,2741,107.2
31150, 시흥시,020005, 19세,2016,5633,2965,2668,111.1,5534,2926,2608,112.2
31150, 시흥시,025,20~24세,2016,31291,17626,13665,129,29097,16126,12971,124.3
31150, 시흥시,025001, 20세,2016,5867,3251,2616,124.3,5672,3136,2536,123.7
31150, 시흥시,025002, 21세,2016,6170,3548,2622,135.3,5904,3368,2536,132.8
31150, 시흥시,025003, 22세,2016,6331,3520,2811,125.2,5918,3242,2676,121.2
31150, 시흥시,025004, 23세,2016,6480,3682,2798,131.6,5860,3243,2617,123.9
31150, 시흥시,025005, 24세,2016,6443,3625,2818,128.6,5743,3137,2606,120.4
31150, 시흥시,030,25~29세,2016,30000,17067,12933,132,23842,13101,10741,122
31150, 시흥시,030001, 25세,2016,6249,3513,2736,128.4,5349,2922,2427,120.4
31150, 시흥시,030002, 26세,2016,6154,3556,2598,136.9,5028,2811,2217,126.8
31150, 시흥시,030003, 27세,2016,5933,3414,2519,135.5,4656,2573,2083,123.5
31150, 시흥시,030004, 28세,2016,5870,3286,2584,127.2,4474,2413,2061,117.1
31150, 시흥시,030005, 29세,2016,5794,3298,2496,132.1,4335,2382,1953,122
31150, 시흥시,035,30~34세,2016,32767,18467,14300,129.1,25858,14014,11844,118.3
31150, 시흥시,035001, 30세,2016,6106,3445,2661,129.5,4508,2446,2062,118.6
31150, 시흥시,035002, 31세,2016,6041,3487,2554,136.5,4630,2534,2096,120.9
31150, 시흥시,035003, 32세,2016,6174,3478,2696,129,4847,2627,2220,118.3
31150, 시흥시,035004, 33세,2016,6797,3840,2957,129.9,5472,2951,2521,117.1
31150, 시흥시,035005, 34세,2016,7649,4217,3432,122.9,6401,3456,2945,117.4
31150, 시흥시,040,35~39세,2016,37893,21048,16845,125,33029,17798,15231,116.9
31150, 시흥시,040001, 35세,2016,7673,4330,3343,129.5,6577,3594,2983,120.5
31150, 시흥시,040002, 36세,2016,8008,4434,3574,124.1,6961,3757,3204,117.3
31150, 시흥시,040003, 37세,2016,7606,4225,3381,125,6572,3523,3049,115.5
31150, 시흥시,040004, 38세,2016,7242,3974,3268,121.6,6331,3346,2985,112.1
31150, 시흥시,040005, 39세,2016,7364,4085,3279,124.6,6588,3578,3010,118.9
31150, 시흥시,045,40~44세,2016,40901,22173,18728,118.4,37216,19810,17406,113.8
31150, 시흥시,045001, 40세,2016,7477,4164,3313,125.7,6682,3640,3042,119.7
31150, 시흥시,045002, 41세,2016,7872,4306,3566,120.8,7156,3833,3323,115.3
31150, 시흥시,045003, 42세,2016,8426,4600,3826,120.2,7765,4164,3601,115.6
31150, 시흥시,045004, 43세,2016,8479,4534,3945,114.9,7794,4097,3697,110.8
31150, 시흥시,045005, 44세,2016,8647,4569,4078,112,7819,4076,3743,108.9
31150, 시흥시,050,45~49세,2016,45518,23658,21860,108.2,41685,21503,20182,106.5
31150, 시흥시,050001, 45세,2016,9307,4836,4471,108.2,8438,4329,4109,105.4
31150, 시흥시,050002, 46세,2016,9003,4688,4315,108.6,8162,4203,3959,106.2
31150, 시흥시,050003, 47세,2016,9416,4947,4469,110.7,8636,4495,4141,108.5
31150, 시흥시,050004, 48세,2016,9262,4794,4468,107.3,8509,4387,4122,106.4
31150, 시흥시,050005, 49세,2016,8530,4393,4137,106.2,7940,4089,3851,106.2
31150, 시흥시,055,50~54세,2016,39590,21472,18118,118.5,36208,19712,16496,119.5
31150, 시흥시,055001, 50세,2016,8115,4431,3684,120.3,7506,4089,3417,119.7
31150, 시흥시,055002, 51세,2016,8328,4399,3929,112,7650,4045,3605,112.2
31150, 시흥시,055003, 52세,2016,7614,4088,3526,115.9,6920,3730,3190,116.9
31150, 시흥시,055004, 53세,2016,7831,4328,3503,123.6,7033,3907,3126,125
31150, 시흥시,055005, 54세,2016,7702,4226,3476,121.6,7099,3941,3158,124.8
31150, 시흥시,060,55~59세,2016,31203,17120,14083,121.6,28779,15955,12824,124.4
31150, 시흥시,060001, 55세,2016,7443,4065,3378,120.3,7068,3885,3183,122.1
31150, 시흥시,060002, 56세,2016,7179,3976,3203,124.1,6583,3690,2893,127.5
31150, 시흥시,060003, 57세,2016,6053,3381,2672,126.5,5589,3155,2434,129.6
31150, 시흥시,060004, 58세,2016,5529,3004,2525,119,5031,2771,2260,122.6
31150, 시흥시,060005, 59세,2016,4999,2694,2305,116.9,4508,2454,2054,119.5
31150, 시흥시,065,60~64세,2016,17961,9482,8479,111.8,15848,8446,7402,114.1
31150, 시흥시,065001, 60세,2016,4312,2277,2035,111.9,3800,2037,1763,115.5
31150, 시흥시,065002, 61세,2016,4215,2248,1967,114.3,3719,2011,1708,117.7
31150, 시흥시,065003, 62세,2016,3488,1834,1654,110.9,3054,1622,1432,113.3
31150, 시흥시,065004, 63세,2016,2906,1545,1361,113.5,2555,1365,1190,114.7
31150, 시흥시,065005, 64세,2016,3040,1578,1462,107.9,2720,1411,1309,107.8
31150, 시흥시,070,65~69세,2016,10644,5228,5416,96.5,9885,4884,5001,97.7
31150, 시흥시,070001, 65세,2016,2127,1051,1076,97.7,1875,931,944,98.6
31150, 시흥시,070002, 66세,2016,2221,1138,1083,105.1,2041,1052,989,106.4
31150, 시흥시,070003, 67세,2016,2163,1070,1093,97.9,2022,1005,1017,98.8
31150, 시흥시,070004, 68세,2016,2075,1012,1063,95.2,1975,967,1008,95.9
31150, 시흥시,070005, 69세,2016,2058,957,1101,86.9,1972,929,1043,89.1
31150, 시흥시,075,70~74세,2016,8133,3568,4565,78.2,7904,3484,4420,78.8
31150, 시흥시,075001, 70세,2016,1592,708,884,80.1,1525,674,851,79.2
31150, 시흥시,075002, 71세,2016,1554,678,876,77.4,1497,658,839,78.4
31150, 시흥시,075003, 72세,2016,1544,711,833,85.4,1512,702,810,86.7
31150, 시흥시,075004, 73세,2016,1599,695,904,76.9,1565,686,879,78
31150, 시흥시,075005, 74세,2016,1844,776,1068,72.7,1805,764,1041,73.4
31150, 시흥시,080,75~79세,2016,6902,2633,4269,61.7,6754,2596,4158,62.4
31150, 시흥시,080001, 75세,2016,1551,616,935,65.9,1512,608,904,67.3
31150, 시흥시,080002, 76세,2016,1412,537,875,61.4,1383,529,854,61.9
31150, 시흥시,080003, 77세,2016,1444,528,916,57.6,1410,519,891,58.2
31150, 시흥시,080004, 78세,2016,1364,518,846,61.2,1335,512,823,62.2
31150, 시흥시,080005, 79세,2016,1131,434,697,62.3,1114,428,686,62.4
31150, 시흥시,085,80~84세,2016,4298,1390,2908,47.8,4216,1369,2847,48.1
31150, 시흥시,085001, 80세,2016,1074,363,711,51.1,1053,358,695,51.5
31150, 시흥시,085002, 81세,2016,969,325,644,50.5,947,318,629,50.6
31150, 시흥시,085003, 82세,2016,882,280,602,46.5,868,279,589,47.4
31150, 시흥시,085004, 83세,2016,720,239,481,49.7,703,233,470,49.6
31150, 시흥시,085005, 84세,2016,653,183,470,38.9,645,181,464,39
31150, 시흥시,090,85~89세,2016,1951,463,1488,31.1,1924,459,1465,31.3
31150, 시흥시,090001, 85세,2016,476,132,344,38.4,468,130,338,38.5
31150, 시흥시,090002, 86세,2016,454,96,358,26.8,447,95,352,27
31150, 시흥시,090003, 87세,2016,389,95,294,32.3,380,94,286,32.9
31150, 시흥시,090004, 88세,2016,349,88,261,33.7,349,88,261,33.7
31150, 시흥시,090005, 89세,2016,283,52,231,22.5,280,52,228,22.8
31150, 시흥시,095,90~94세,2016,679,154,525,29.3,671,153,518,29.5
31150, 시흥시,095001, 90세,2016,195,32,163,19.6,191,31,160,19.4
31150, 시흥시,095002, 91세,2016,168,41,127,32.3,167,41,126,32.5
31150, 시흥시,095003, 92세,2016,102,28,74,37.8,100,28,72,38.9
31150, 시흥시,095004, 93세,2016,132,35,97,36.1,131,35,96,36.5
31150, 시흥시,095005, 94세,2016,82,18,64,28.1,82,18,64,28.1
31150, 시흥시,100,95~99세,2016,152,27,125,21.6,152,27,125,21.6
31150, 시흥시,100001, 95세,2016,54,9,45,20,54,9,45,20
31150, 시흥시,100002, 96세,2016,42,6,36,16.7,42,6,36,16.7
31150, 시흥시,100003, 97세,2016,27,X,23,17.4,27,X,23,17.4
31150, 시흥시,100004, 98세,2016,19,5,14,35.7,19,5,14,35.7
31150, 시흥시,100005, 99세,2016,10,X,7,42.9,10,X,7,42.9
31150, 시흥시,101,100세이상,2016,17,X,14,21.4,17,X,14,21.4
31150, 시흥시,102,15세미만,2016,61534,31670,29864,106,59705,30684,29021,105.7
31150, 시흥시,103,15~64세,2016,335011,182696,152315,119.9,299168,160926,138242,116.4
31150, 시흥시,104,65세이상,2016,32776,13466,19310,69.7,31523,12975,18548,70
31150, 시흥시,086,85세이상,2016,2799,647,2152,30.1,2764,642,2122,30.3
31150, 시흥시,126,평균연령,2016,38,37.3,38.7,,37.9,37.3,38.6,
31150, 시흥시,127,중위연령,2016,39.1,38.4,39.9,,39.4,38.9,40,
31160, 군포시,000,합계,2016,284301,141252,143049,98.7,275376,136553,138823,98.4
31160, 군포시,005,0~4세,2016,14228,7241,6987,103.6,13982,7122,6860,103.8
31160, 군포시,005001, 0세,2016,2886,1462,1424,102.7,2820,1429,1391,102.7
31160, 군포시,005002, 1세,2016,2851,1455,1396,104.2,2812,1441,1371,105.1
31160, 군포시,005003, 2세,2016,2787,1444,1343,107.5,2731,1417,1314,107.8
31160, 군포시,005004, 3세,2016,2774,1396,1378,101.3,2734,1371,1363,100.6
31160, 군포시,005005, 4세,2016,2930,1484,1446,102.6,2885,1464,1421,103
31160, 군포시,010,5~9세,2016,14029,7269,6760,107.5,13900,7196,6704,107.3
31160, 군포시,010001, 5세,2016,2957,1540,1417,108.7,2918,1518,1400,108.4
31160, 군포시,010002, 6세,2016,2736,1429,1307,109.3,2702,1404,1298,108.2
31160, 군포시,010003, 7세,2016,2658,1343,1315,102.1,2631,1333,1298,102.7
31160, 군포시,010004, 8세,2016,2891,1492,1399,106.6,2874,1482,1392,106.5
31160, 군포시,010005, 9세,2016,2787,1465,1322,110.8,2775,1459,1316,110.9
31160, 군포시,015,10~14세,2016,13809,7107,6702,106,13757,7083,6674,106.1
31160, 군포시,015001, 10세,2016,2613,1356,1257,107.9,2602,1351,1251,108
31160, 군포시,015002, 11세,2016,2541,1311,1230,106.6,2528,1305,1223,106.7
31160, 군포시,015003, 12세,2016,2813,1430,1383,103.4,2805,1426,1379,103.4
31160, 군포시,015004, 13세,2016,2877,1485,1392,106.7,2868,1480,1388,106.6
31160, 군포시,015005, 14세,2016,2965,1525,1440,105.9,2954,1521,1433,106.1
31160, 군포시,020,15~19세,2016,16721,8599,8122,105.9,16625,8554,8071,106
31160, 군포시,020001, 15세,2016,3157,1564,1593,98.2,3144,1559,1585,98.4
31160, 군포시,020002, 16세,2016,3497,1844,1653,111.6,3487,1840,1647,111.7
31160, 군포시,020003, 17세,2016,3361,1775,1586,111.9,3345,1768,1577,112.1
31160, 군포시,020004, 18세,2016,3469,1785,1684,106,3446,1777,1669,106.5
31160, 군포시,020005, 19세,2016,3237,1631,1606,101.6,3203,1610,1593,101.1
31160, 군포시,025,20~24세,2016,18520,9791,8729,112.2,18037,9520,8517,111.8
31160, 군포시,025001, 20세,2016,3516,1918,1598,120,3461,1890,1571,120.3
31160, 군포시,025002, 21세,2016,3635,1983,1652,120,3584,1956,1628,120.1
31160, 군포시,025003, 22세,2016,3687,1970,1717,114.7,3588,1922,1666,115.4
31160, 군포시,025004, 23세,2016,3756,1906,1850,103,3630,1835,1795,102.2
31160, 군포시,025005, 24세,2016,3926,2014,1912,105.3,3774,1917,1857,103.2
31160, 군포시,030,25~29세,2016,19274,9780,9494,103,18116,9116,9000,101.3
31160, 군포시,030001, 25세,2016,3881,1936,1945,99.5,3701,1819,1882,96.7
31160, 군포시,030002, 26세,2016,3782,1946,1836,106,3556,1813,1743,104
31160, 군포시,030003, 27세,2016,3878,1969,1909,103.1,3648,1840,1808,101.8
31160, 군포시,030004, 28세,2016,3811,1912,1899,100.7,3586,1793,1793,100
31160, 군포시,030005, 29세,2016,3922,2017,1905,105.9,3625,1851,1774,104.3
31160, 군포시,035,30~34세,2016,22514,11567,10947,105.7,21317,10887,10430,104.4
31160, 군포시,035001, 30세,2016,4172,2108,2064,102.1,3896,1978,1918,103.1
31160, 군포시,035002, 31세,2016,4092,2111,1981,106.6,3860,1980,1880,105.3
31160, 군포시,035003, 32세,2016,4464,2302,2162,106.5,4242,2173,2069,105
31160, 군포시,035004, 33세,2016,4734,2483,2251,110.3,4496,2336,2160,108.1
31160, 군포시,035005, 34세,2016,5052,2563,2489,103,4823,2420,2403,100.7
31160, 군포시,040,35~39세,2016,23539,11949,11590,103.1,22718,11485,11233,102.2
31160, 군포시,040001, 35세,2016,4976,2592,2384,108.7,4805,2493,2312,107.8
31160, 군포시,040002, 36세,2016,5073,2598,2475,105,4895,2499,2396,104.3
31160, 군포시,040003, 37세,2016,4701,2350,2351,100,4512,2252,2260,99.6
31160, 군포시,040004, 38세,2016,4305,2189,2116,103.4,4157,2105,2052,102.6
31160, 군포시,040005, 39세,2016,4484,2220,2264,98.1,4349,2136,2213,96.5
31160, 군포시,045,40~44세,2016,24418,12148,12270,99,23657,11718,11939,98.1
31160, 군포시,045001, 40세,2016,4399,2225,2174,102.3,4277,2158,2119,101.8
31160, 군포시,045002, 41세,2016,4608,2283,2325,98.2,4461,2202,2259,97.5
31160, 군포시,045003, 42세,2016,4978,2434,2544,95.7,4848,2358,2490,94.7
31160, 군포시,045004, 43세,2016,5258,2630,2628,100.1,5070,2520,2550,98.8
31160, 군포시,045005, 44세,2016,5175,2576,2599,99.1,5001,2480,2521,98.4
31160, 군포시,050,45~49세,2016,26013,12568,13445,93.5,25060,12081,12979,93.1
31160, 군포시,050001, 45세,2016,5408,2592,2816,92,5215,2487,2728,91.2
31160, 군포시,050002, 46세,2016,5326,2620,2706,96.8,5111,2510,2601,96.5
31160, 군포시,050003, 47세,2016,5334,2623,2711,96.8,5139,2528,2611,96.8
31160, 군포시,050004, 48세,2016,5238,2495,2743,91,5074,2401,2673,89.8
31160, 군포시,050005, 49세,2016,4707,2238,2469,90.6,4521,2155,2366,91.1
31160, 군포시,055,50~54세,2016,24325,12022,12303,97.7,23207,11463,11744,97.6
31160, 군포시,055001, 50세,2016,4815,2445,2370,103.2,4626,2347,2279,103
31160, 군포시,055002, 51세,2016,4887,2379,2508,94.9,4682,2276,2406,94.6
31160, 군포시,055003, 52세,2016,4613,2253,2360,95.5,4398,2157,2241,96.3
31160, 군포시,055004, 53세,2016,4966,2452,2514,97.5,4667,2294,2373,96.7
31160, 군포시,055005, 54세,2016,5044,2493,2551,97.7,4834,2389,2445,97.7
31160, 군포시,060,55~59세,2016,23498,11668,11830,98.6,22668,11270,11398,98.9
31160, 군포시,060001, 55세,2016,5273,2576,2697,95.5,5149,2516,2633,95.6
31160, 군포시,060002, 56세,2016,5228,2590,2638,98.2,5028,2493,2535,98.3
31160, 군포시,060003, 57세,2016,4635,2303,2332,98.8,4464,2229,2235,99.7
31160, 군포시,060004, 58세,2016,4385,2170,2215,98,4218,2087,2131,97.9
31160, 군포시,060005, 59세,2016,3977,2029,1948,104.2,3809,1945,1864,104.3
31160, 군포시,065,60~64세,2016,14704,7420,7284,101.9,14056,7103,6953,102.2
31160, 군포시,065001, 60세,2016,3511,1788,1723,103.8,3368,1716,1652,103.9
31160, 군포시,065002, 61세,2016,3416,1667,1749,95.3,3253,1585,1668,95
31160, 군포시,065003, 62세,2016,2872,1491,1381,108,2725,1418,1307,108.5
31160, 군포시,065004, 63세,2016,2409,1230,1179,104.3,2311,1183,1128,104.9
31160, 군포시,065005, 64세,2016,2496,1244,1252,99.4,2399,1201,1198,100.3
31160, 군포시,070,65~69세,2016,9114,4486,4628,96.9,8851,4369,4482,97.5
31160, 군포시,070001, 65세,2016,1756,874,882,99.1,1669,833,836,99.6
31160, 군포시,070002, 66세,2016,1843,918,925,99.2,1788,894,894,100
31160, 군포시,070003, 67세,2016,1842,937,905,103.5,1789,913,876,104.2
31160, 군포시,070004, 68세,2016,1796,874,922,94.8,1752,856,896,95.5
31160, 군포시,070005, 69세,2016,1877,883,994,88.8,1853,873,980,89.1
31160, 군포시,075,70~74세,2016,7024,3080,3944,78.1,6950,3055,3895,78.4
31160, 군포시,075001, 70세,2016,1442,647,795,81.4,1422,642,780,82.3
31160, 군포시,075002, 71세,2016,1309,593,716,82.8,1292,584,708,82.5
31160, 군포시,075003, 72세,2016,1355,592,763,77.6,1342,589,753,78.2
31160, 군포시,075004, 73세,2016,1338,566,772,73.3,1327,563,764,73.7
31160, 군포시,075005, 74세,2016,1580,682,898,75.9,1567,677,890,76.1
31160, 군포시,080,75~79세,2016,5880,2356,3524,66.9,5833,2345,3488,67.2
31160, 군포시,080001, 75세,2016,1296,578,718,80.5,1292,577,715,80.7
31160, 군포시,080002, 76세,2016,1185,470,715,65.7,1175,467,708,66
31160, 군포시,080003, 77세,2016,1155,453,702,64.5,1150,453,697,65
31160, 군포시,080004, 78세,2016,1158,428,730,58.6,1140,424,716,59.2
31160, 군포시,080005, 79세,2016,1086,427,659,64.8,1076,424,652,65
31160, 군포시,085,80~84세,2016,4010,1433,2577,55.6,3978,1424,2554,55.8
31160, 군포시,085001, 80세,2016,926,341,585,58.3,918,338,580,58.3
31160, 군포시,085002, 81세,2016,934,340,594,57.2,928,339,589,57.6
31160, 군포시,085003, 82세,2016,828,290,538,53.9,817,286,531,53.9
31160, 군포시,085004, 83세,2016,691,252,439,57.4,687,252,435,57.9
31160, 군포시,085005, 84세,2016,631,210,421,49.9,628,209,419,49.9
31160, 군포시,090,85~89세,2016,1873,579,1294,44.7,1861,575,1286,44.7
31160, 군포시,090001, 85세,2016,448,140,308,45.5,445,139,306,45.4
31160, 군포시,090002, 86세,2016,458,145,313,46.3,455,144,311,46.3
31160, 군포시,090003, 87세,2016,393,133,260,51.2,392,132,260,50.8
31160, 군포시,090004, 88세,2016,337,89,248,35.9,334,88,246,35.8
31160, 군포시,090005, 89세,2016,237,72,165,43.6,235,72,163,44.2
31160, 군포시,095,90~94세,2016,638,153,485,31.5,635,152,483,31.5
31160, 군포시,095001, 90세,2016,170,46,124,37.1,168,46,122,37.7
31160, 군포시,095002, 91세,2016,156,37,119,31.1,155,36,119,30.3
31160, 군포시,095003, 92세,2016,114,29,85,34.1,114,29,85,34.1
31160, 군포시,095004, 93세,2016,114,24,90,26.7,114,24,90,26.7
31160, 군포시,095005, 94세,2016,84,17,67,25.4,84,17,67,25.4
31160, 군포시,100,95~99세,2016,151,35,116,30.2,149,34,115,29.6
31160, 군포시,100001, 95세,2016,55,13,42,31,55,13,42,31
31160, 군포시,100002, 96세,2016,35,9,26,34.6,35,9,26,34.6
31160, 군포시,100003, 97세,2016,25,9,16,56.3,24,9,15,60
31160, 군포시,100004, 98세,2016,23,X,22,4.5,23,X,22,4.5
31160, 군포시,100005, 99세,2016,13,X,10,30,12,X,10,20
31160, 군포시,101,100세이상,2016,19,X,18,5.6,19,X,18,5.6
31160, 군포시,102,15세미만,2016,42066,21617,20449,105.7,41639,21401,20238,105.7
31160, 군포시,103,15~64세,2016,213526,107512,106014,101.4,205461,103197,102264,100.9
31160, 군포시,104,65세이상,2016,28709,12123,16586,73.1,28276,11955,16321,73.2
31160, 군포시,086,85세이상,2016,2681,768,1913,40.1,2664,762,1902,40.1
31160, 군포시,126,평균연령,2016,39.2,38.2,40.1,,39.1,38.1,40,
31160, 군포시,127,중위연령,2016,39.9,38.8,41,,39.8,38.7,40.9,
31170, 의왕시,000,합계,2016,153629,76597,77032,99.4,151954,75668,76286,99.2
31170, 의왕시,005,0~4세,2016,6919,3563,3356,106.2,6896,3553,3343,106.3
31170, 의왕시,005001, 0세,2016,1235,643,592,108.6,1231,641,590,108.6
31170, 의왕시,005002, 1세,2016,1322,687,635,108.2,1317,685,632,108.4
31170, 의왕시,005003, 2세,2016,1374,712,662,107.6,1372,711,661,107.6
31170, 의왕시,005004, 3세,2016,1441,685,756,90.6,1436,682,754,90.5
31170, 의왕시,005005, 4세,2016,1547,836,711,117.6,1540,834,706,118.1
31170, 의왕시,010,5~9세,2016,7299,3779,3520,107.4,7278,3767,3511,107.3
31170, 의왕시,010001, 5세,2016,1532,803,729,110.2,1527,800,727,110
31170, 의왕시,010002, 6세,2016,1451,755,696,108.5,1445,751,694,108.2
31170, 의왕시,010003, 7세,2016,1434,735,699,105.2,1429,732,697,105
31170, 의왕시,010004, 8세,2016,1457,758,699,108.4,1456,758,698,108.6
31170, 의왕시,010005, 9세,2016,1425,728,697,104.4,1421,726,695,104.5
31170, 의왕시,015,10~14세,2016,6714,3460,3254,106.3,6706,3455,3251,106.3
31170, 의왕시,015001, 10세,2016,1316,690,626,110.2,1313,689,624,110.4
31170, 의왕시,015002, 11세,2016,1292,671,621,108.1,1291,670,621,107.9
31170, 의왕시,015003, 12세,2016,1303,634,669,94.8,1301,632,669,94.5
31170, 의왕시,015004, 13세,2016,1370,750,620,121,1368,749,619,121
31170, 의왕시,015005, 14세,2016,1433,715,718,99.6,1433,715,718,99.6
31170, 의왕시,020,15~19세,2016,10122,4953,5169,95.8,10103,4943,5160,95.8
31170, 의왕시,020001, 15세,2016,1785,902,883,102.2,1784,901,883,102
31170, 의왕시,020002, 16세,2016,2192,1011,1181,85.6,2188,1009,1179,85.6
31170, 의왕시,020003, 17세,2016,2055,991,1064,93.1,2053,989,1064,93
31170, 의왕시,020004, 18세,2016,2096,1041,1055,98.7,2092,1039,1053,98.7
31170, 의왕시,020005, 19세,2016,1994,1008,986,102.2,1986,1005,981,102.4
31170, 의왕시,025,20~24세,2016,10838,5806,5032,115.4,10682,5707,4975,114.7
31170, 의왕시,025001, 20세,2016,2144,1126,1018,110.6,2127,1117,1010,110.6
31170, 의왕시,025002, 21세,2016,2132,1173,959,122.3,2118,1165,953,122.2
31170, 의왕시,025003, 22세,2016,2108,1126,982,114.7,2076,1111,965,115.1
31170, 의왕시,025004, 23세,2016,2240,1207,1033,116.8,2200,1179,1021,115.5
31170, 의왕시,025005, 24세,2016,2214,1174,1040,112.9,2161,1135,1026,110.6
31170, 의왕시,030,25~29세,2016,10163,5296,4867,108.8,9878,5145,4733,108.7
31170, 의왕시,030001, 25세,2016,2141,1084,1057,102.6,2095,1059,1036,102.2
31170, 의왕시,030002, 26세,2016,2049,1045,1004,104.1,1989,1014,975,104
31170, 의왕시,030003, 27세,2016,2060,1057,1003,105.4,2003,1030,973,105.9
31170, 의왕시,030004, 28세,2016,1957,1023,934,109.5,1893,985,908,108.5
31170, 의왕시,030005, 29세,2016,1956,1087,869,125.1,1898,1057,841,125.7
31170, 의왕시,035,30~34세,2016,10398,5446,4952,110,10116,5276,4840,109
31170, 의왕시,035001, 30세,2016,1872,971,901,107.8,1829,945,884,106.9
31170, 의왕시,035002, 31세,2016,1920,1033,887,116.5,1857,1001,856,116.9
31170, 의왕시,035003, 32세,2016,1986,1044,942,110.8,1924,1004,920,109.1
31170, 의왕시,035004, 33세,2016,2191,1137,1054,107.9,2135,1099,1036,106.1
31170, 의왕시,035005, 34세,2016,2429,1261,1168,108,2371,1227,1144,107.3
31170, 의왕시,040,35~39세,2016,11757,5967,5790,103.1,11577,5864,5713,102.6
31170, 의왕시,040001, 35세,2016,2453,1242,1211,102.6,2405,1213,1192,101.8
31170, 의왕시,040002, 36세,2016,2491,1259,1232,102.2,2452,1232,1220,101
31170, 의왕시,040003, 37세,2016,2381,1222,1159,105.4,2341,1197,1144,104.6
31170, 의왕시,040004, 38세,2016,2088,1064,1024,103.9,2061,1053,1008,104.5
31170, 의왕시,040005, 39세,2016,2344,1180,1164,101.4,2318,1169,1149,101.7
31170, 의왕시,045,40~44세,2016,12405,6279,6126,102.5,12263,6194,6069,102.1
31170, 의왕시,045001, 40세,2016,2315,1206,1109,108.7,2288,1189,1099,108.2
31170, 의왕시,045002, 41세,2016,2292,1152,1140,101.1,2268,1137,1131,100.5
31170, 의왕시,045003, 42세,2016,2497,1272,1225,103.8,2467,1253,1214,103.2
31170, 의왕시,045004, 43세,2016,2665,1326,1339,99,2634,1312,1322,99.2
31170, 의왕시,045005, 44세,2016,2636,1323,1313,100.8,2606,1303,1303,100
31170, 의왕시,050,45~49세,2016,14044,6738,7306,92.2,13882,6643,7239,91.8
31170, 의왕시,050001, 45세,2016,2813,1368,1445,94.7,2778,1340,1438,93.2
31170, 의왕시,050002, 46세,2016,2769,1299,1470,88.4,2733,1284,1449,88.6
31170, 의왕시,050003, 47세,2016,2843,1364,1479,92.2,2814,1345,1469,91.6
31170, 의왕시,050004, 48세,2016,2908,1408,1500,93.9,2865,1384,1481,93.5
31170, 의왕시,050005, 49세,2016,2711,1299,1412,92,2692,1290,1402,92
31170, 의왕시,055,50~54세,2016,13525,6664,6861,97.1,13387,6596,6791,97.1
31170, 의왕시,055001, 50세,2016,2500,1270,1230,103.3,2470,1257,1213,103.6
31170, 의왕시,055002, 51세,2016,2744,1350,1394,96.8,2714,1333,1381,96.5
31170, 의왕시,055003, 52세,2016,2644,1288,1356,95,2617,1273,1344,94.7
31170, 의왕시,055004, 53세,2016,2817,1398,1419,98.5,2789,1384,1405,98.5
31170, 의왕시,055005, 54세,2016,2820,1358,1462,92.9,2797,1349,1448,93.2
31170, 의왕시,060,55~59세,2016,13672,6824,6848,99.6,13558,6768,6790,99.7
31170, 의왕시,060001, 55세,2016,3068,1479,1589,93.1,3048,1472,1576,93.4
31170, 의왕시,060002, 56세,2016,3034,1521,1513,100.5,2997,1501,1496,100.3
31170, 의왕시,060003, 57세,2016,2702,1332,1370,97.2,2686,1325,1361,97.4
31170, 의왕시,060004, 58세,2016,2533,1281,1252,102.3,2512,1270,1242,102.3
31170, 의왕시,060005, 59세,2016,2335,1211,1124,107.7,2315,1200,1115,107.6
31170, 의왕시,065,60~64세,2016,9121,4670,4451,104.9,9049,4639,4410,105.2
31170, 의왕시,065001, 60세,2016,2153,1097,1056,103.9,2135,1089,1046,104.1
31170, 의왕시,065002, 61세,2016,2175,1097,1078,101.8,2159,1092,1067,102.3
31170, 의왕시,065003, 62세,2016,1761,897,864,103.8,1748,893,855,104.4
31170, 의왕시,065004, 63세,2016,1469,746,723,103.2,1457,738,719,102.6
31170, 의왕시,065005, 64세,2016,1563,833,730,114.1,1550,827,723,114.4
31170, 의왕시,070,65~69세,2016,5516,2738,2778,98.6,5471,2715,2756,98.5
31170, 의왕시,070001, 65세,2016,1057,555,502,110.6,1042,549,493,111.4
31170, 의왕시,070002, 66세,2016,1106,556,550,101.1,1092,546,546,100
31170, 의왕시,070003, 67세,2016,1191,583,608,95.9,1185,580,605,95.9
31170, 의왕시,070004, 68세,2016,1098,513,585,87.7,1094,511,583,87.7
31170, 의왕시,070005, 69세,2016,1064,531,533,99.6,1058,529,529,100
31170, 의왕시,075,70~74세,2016,4116,1911,2205,86.7,4101,1903,2198,86.6
31170, 의왕시,075001, 70세,2016,819,395,424,93.2,811,391,420,93.1
31170, 의왕시,075002, 71세,2016,786,373,413,90.3,784,372,412,90.3
31170, 의왕시,075003, 72세,2016,784,374,410,91.2,781,373,408,91.4
31170, 의왕시,075004, 73세,2016,784,347,437,79.4,783,346,437,79.2
31170, 의왕시,075005, 74세,2016,943,422,521,81,942,421,521,80.8
31170, 의왕시,080,75~79세,2016,3300,1377,1923,71.6,3293,1376,1917,71.8
31170, 의왕시,080001, 75세,2016,731,326,405,80.5,730,326,404,80.7
31170, 의왕시,080002, 76세,2016,675,270,405,66.7,673,270,403,67
31170, 의왕시,080003, 77세,2016,669,287,382,75.1,666,286,380,75.3
31170, 의왕시,080004, 78세,2016,630,273,357,76.5,630,273,357,76.5
31170, 의왕시,080005, 79세,2016,595,221,374,59.1,594,221,373,59.2
31170, 의왕시,085,80~84세,2016,2164,710,1454,48.8,2159,708,1451,48.8
31170, 의왕시,085001, 80세,2016,504,168,336,50,501,167,334,50
31170, 의왕시,085002, 81세,2016,489,168,321,52.3,488,167,321,52
31170, 의왕시,085003, 82세,2016,459,141,318,44.3,459,141,318,44.3
31170, 의왕시,085004, 83세,2016,392,117,275,42.5,391,117,274,42.7
31170, 의왕시,085005, 84세,2016,320,116,204,56.9,320,116,204,56.9
31170, 의왕시,090,85~89세,2016,1089,308,781,39.4,1089,308,781,39.4
31170, 의왕시,090001, 85세,2016,291,90,201,44.8,291,90,201,44.8
31170, 의왕시,090002, 86세,2016,245,66,179,36.9,245,66,179,36.9
31170, 의왕시,090003, 87세,2016,234,67,167,40.1,234,67,167,40.1
31170, 의왕시,090004, 88세,2016,171,41,130,31.5,171,41,130,31.5
31170, 의왕시,090005, 89세,2016,148,44,104,42.3,148,44,104,42.3
31170, 의왕시,095,90~94세,2016,378,90,288,31.3,377,90,287,31.4
31170, 의왕시,095001, 90세,2016,93,24,69,34.8,92,24,68,35.3
31170, 의왕시,095002, 91세,2016,87,16,71,22.5,87,16,71,22.5
31170, 의왕시,095003, 92세,2016,73,19,54,35.2,73,19,54,35.2
31170, 의왕시,095004, 93세,2016,79,17,62,27.4,79,17,62,27.4
31170, 의왕시,095005, 94세,2016,46,14,32,43.8,46,14,32,43.8
31170, 의왕시,100,95~99세,2016,85,18,67,26.9,85,18,67,26.9
31170, 의왕시,100001, 95세,2016,30,6,24,25,30,6,24,25
31170, 의왕시,100002, 96세,2016,19,6,13,46.2,19,6,13,46.2
31170, 의왕시,100003, 97세,2016,19,X,17,11.8,19,X,17,11.8
31170, 의왕시,100004, 98세,2016,10,X,8,25,10,X,8,25
31170, 의왕시,100005, 99세,2016,7,X,5,40,7,X,5,40
31170, 의왕시,101,100세이상,2016,X,X,X,0,X,X,X,0
31170, 의왕시,102,15세미만,2016,20932,10802,10130,106.6,20880,10775,10105,106.6
31170, 의왕시,103,15~64세,2016,116045,58643,57402,102.2,114495,57775,56720,101.9
31170, 의왕시,104,65세이상,2016,16652,7152,9500,75.3,16579,7118,9461,75.2
31170, 의왕시,086,85세이상,2016,1556,416,1140,36.5,1555,416,1139,36.5
31170, 의왕시,126,평균연령,2016,40,39,40.9,,40,39.1,40.9,
31170, 의왕시,127,중위연령,2016,41.1,40,42.3,,41.2,40.1,42.3,
31180, 하남시,000,합계,2016,195422,98271,97151,101.2,193073,96907,96166,100.8
31180, 하남시,005,0~4세,2016,11226,5798,5428,106.8,11213,5790,5423,106.8
31180, 하남시,005001, 0세,2016,2010,1005,1005,100,2008,1003,1005,99.8
31180, 하남시,005002, 1세,2016,2209,1138,1071,106.3,2204,1134,1070,106
31180, 하남시,005003, 2세,2016,2179,1119,1060,105.6,2176,1118,1058,105.7
31180, 하남시,005004, 3세,2016,2329,1213,1116,108.7,2328,1213,1115,108.8
31180, 하남시,005005, 4세,2016,2499,1323,1176,112.5,2497,1322,1175,112.5
31180, 하남시,010,5~9세,2016,10715,5472,5243,104.4,10691,5462,5229,104.5
31180, 하남시,010001, 5세,2016,2370,1195,1175,101.7,2365,1194,1171,102
31180, 하남시,010002, 6세,2016,2227,1132,1095,103.4,2221,1130,1091,103.6
31180, 하남시,010003, 7세,2016,2046,1045,1001,104.4,2042,1045,997,104.8
31180, 하남시,010004, 8세,2016,2011,1010,1001,100.9,2006,1006,1000,100.6
31180, 하남시,010005, 9세,2016,2061,1090,971,112.3,2057,1087,970,112.1
31180, 하남시,015,10~14세,2016,8396,4311,4085,105.5,8382,4303,4079,105.5
31180, 하남시,015001, 10세,2016,1721,896,825,108.6,1719,896,823,108.9
31180, 하남시,015002, 11세,2016,1619,831,788,105.5,1616,830,786,105.6
31180, 하남시,015003, 12세,2016,1727,879,848,103.7,1724,877,847,103.5
31180, 하남시,015004, 13세,2016,1658,863,795,108.6,1657,862,795,108.4
31180, 하남시,015005, 14세,2016,1671,842,829,101.6,1666,838,828,101.2
31180, 하남시,020,15~19세,2016,9703,4966,4737,104.8,9677,4950,4727,104.7
31180, 하남시,020001, 15세,2016,1878,984,894,110.1,1874,981,893,109.9
31180, 하남시,020002, 16세,2016,2070,1045,1025,102,2067,1044,1023,102.1
31180, 하남시,020003, 17세,2016,1985,987,998,98.9,1980,986,994,99.2
31180, 하남시,020004, 18세,2016,1903,963,940,102.4,1900,961,939,102.3
31180, 하남시,020005, 19세,2016,1867,987,880,112.2,1856,978,878,111.4
31180, 하남시,025,20~24세,2016,10727,5768,4959,116.3,10508,5631,4877,115.5
31180, 하남시,025001, 20세,2016,1994,1115,879,126.8,1975,1100,875,125.7
31180, 하남시,025002, 21세,2016,2039,1160,879,132,2007,1143,864,132.3
31180, 하남시,025003, 22세,2016,2129,1163,966,120.4,2085,1140,945,120.6
31180, 하남시,025004, 23세,2016,2159,1140,1019,111.9,2102,1105,997,110.8
31180, 하남시,025005, 24세,2016,2406,1190,1216,97.9,2339,1143,1196,95.6
31180, 하남시,030,25~29세,2016,11501,5943,5558,106.9,11101,5674,5427,104.6
31180, 하남시,030001, 25세,2016,2299,1194,1105,108.1,2239,1153,1086,106.2
31180, 하남시,030002, 26세,2016,2328,1185,1143,103.7,2254,1136,1118,101.6
31180, 하남시,030003, 27세,2016,2257,1157,1100,105.2,2179,1106,1073,103.1
31180, 하남시,030004, 28세,2016,2210,1145,1065,107.5,2123,1084,1039,104.3
31180, 하남시,030005, 29세,2016,2407,1262,1145,110.2,2306,1195,1111,107.6
31180, 하남시,035,30~34세,2016,14881,7568,7313,103.5,14519,7322,7197,101.7
31180, 하남시,035001, 30세,2016,2449,1243,1206,103.1,2367,1193,1174,101.6
31180, 하남시,035002, 31세,2016,2596,1356,1240,109.4,2528,1304,1224,106.5
31180, 하남시,035003, 32세,2016,2843,1444,1399,103.2,2768,1390,1378,100.9
31180, 하남시,035004, 33세,2016,3299,1649,1650,99.9,3229,1600,1629,98.2
31180, 하남시,035005, 34세,2016,3694,1876,1818,103.2,3627,1835,1792,102.4
31180, 하남시,040,35~39세,2016,18789,9509,9280,102.5,18480,9315,9165,101.6
31180, 하남시,040001, 35세,2016,4003,1965,2038,96.4,3941,1925,2016,95.5
31180, 하남시,040002, 36세,2016,4045,2016,2029,99.4,3971,1965,2006,98
31180, 하남시,040003, 37세,2016,3856,1957,1899,103.1,3800,1923,1877,102.5
31180, 하남시,040004, 38세,2016,3402,1774,1628,109,3344,1737,1607,108.1
31180, 하남시,040005, 39세,2016,3483,1797,1686,106.6,3424,1765,1659,106.4
31180, 하남시,045,40~44세,2016,16797,8883,7914,112.2,16582,8758,7824,111.9
31180, 하남시,045001, 40세,2016,3292,1730,1562,110.8,3241,1697,1544,109.9
31180, 하남시,045002, 41세,2016,3230,1701,1529,111.2,3186,1676,1510,111
31180, 하남시,045003, 42세,2016,3548,1885,1663,113.3,3511,1864,1647,113.2
31180, 하남시,045004, 43세,2016,3268,1724,1544,111.7,3233,1705,1528,111.6
31180, 하남시,045005, 44세,2016,3459,1843,1616,114,3411,1816,1595,113.9
31180, 하남시,050,45~49세,2016,15919,8123,7796,104.2,15730,8026,7704,104.2
31180, 하남시,050001, 45세,2016,3493,1869,1624,115.1,3460,1850,1610,114.9
31180, 하남시,050002, 46세,2016,3102,1603,1499,106.9,3064,1585,1479,107.2
31180, 하남시,050003, 47세,2016,3180,1621,1559,104,3138,1603,1535,104.4
31180, 하남시,050004, 48세,2016,3207,1565,1642,95.3,3165,1541,1624,94.9
31180, 하남시,050005, 49세,2016,2937,1465,1472,99.5,2903,1447,1456,99.4
31180, 하남시,055,50~54세,2016,15268,7551,7717,97.8,15070,7458,7612,98
31180, 하남시,055001, 50세,2016,2968,1468,1500,97.9,2925,1448,1477,98
31180, 하남시,055002, 51세,2016,3030,1522,1508,100.9,2990,1501,1489,100.8
31180, 하남시,055003, 52세,2016,2932,1459,1473,99,2891,1440,1451,99.2
31180, 하남시,055004, 53세,2016,3086,1499,1587,94.5,3050,1486,1564,95
31180, 하남시,055005, 54세,2016,3252,1603,1649,97.2,3214,1583,1631,97.1
31180, 하남시,060,55~59세,2016,16655,8071,8584,94,16509,8014,8495,94.3
31180, 하남시,060001, 55세,2016,3647,1716,1931,88.9,3617,1705,1912,89.2
31180, 하남시,060002, 56세,2016,3609,1717,1892,90.8,3573,1706,1867,91.4
31180, 하남시,060003, 57세,2016,3224,1578,1646,95.9,3192,1568,1624,96.6
31180, 하남시,060004, 58세,2016,3111,1555,1556,99.9,3090,1548,1542,100.4
31180, 하남시,060005, 59세,2016,3064,1505,1559,96.5,3037,1487,1550,95.9
31180, 하남시,065,60~64세,2016,12726,6270,6456,97.1,12578,6203,6375,97.3
31180, 하남시,065001, 60세,2016,2802,1365,1437,95,2769,1351,1418,95.3
31180, 하남시,065002, 61세,2016,2921,1421,1500,94.7,2891,1410,1481,95.2
31180, 하남시,065003, 62세,2016,2500,1237,1263,97.9,2466,1222,1244,98.2
31180, 하남시,065004, 63세,2016,2164,1077,1087,99.1,2140,1064,1076,98.9
31180, 하남시,065005, 64세,2016,2339,1170,1169,100.1,2312,1156,1156,100
31180, 하남시,070,65~69세,2016,8397,4291,4106,104.5,8347,4268,4079,104.6
31180, 하남시,070001, 65세,2016,1567,797,770,103.5,1551,793,758,104.6
31180, 하남시,070002, 66세,2016,1736,863,873,98.9,1724,856,868,98.6
31180, 하남시,070003, 67세,2016,1764,903,861,104.9,1756,899,857,104.9
31180, 하남시,070004, 68세,2016,1700,893,807,110.7,1695,888,807,110
31180, 하남시,070005, 69세,2016,1630,835,795,105,1621,832,789,105.4
31180, 하남시,075,70~74세,2016,5709,2836,2873,98.7,5691,2829,2862,98.8
31180, 하남시,075001, 70세,2016,1223,617,606,101.8,1219,615,604,101.8
31180, 하남시,075002, 71세,2016,1154,603,551,109.4,1151,602,549,109.7
31180, 하남시,075003, 72세,2016,1161,608,553,109.9,1159,606,553,109.6
31180, 하남시,075004, 73세,2016,1037,514,523,98.3,1033,513,520,98.7
31180, 하남시,075005, 74세,2016,1134,494,640,77.2,1129,493,636,77.5
31180, 하남시,080,75~79세,2016,3900,1742,2158,80.7,3888,1740,2148,81
31180, 하남시,080001, 75세,2016,938,429,509,84.3,937,429,508,84.4
31180, 하남시,080002, 76세,2016,812,382,430,88.8,810,381,429,88.8
31180, 하남시,080003, 77세,2016,801,345,456,75.7,801,345,456,75.7
31180, 하남시,080004, 78세,2016,725,324,401,80.8,722,323,399,81
31180, 하남시,080005, 79세,2016,624,262,362,72.4,618,262,356,73.6
31180, 하남시,085,80~84세,2016,2320,759,1561,48.6,2316,755,1561,48.4
31180, 하남시,085001, 80세,2016,594,229,365,62.7,594,229,365,62.7
31180, 하남시,085002, 81세,2016,529,178,351,50.7,528,177,351,50.4
31180, 하남시,085003, 82세,2016,459,136,323,42.1,456,133,323,41.2
31180, 하남시,085004, 83세,2016,399,122,277,44,399,122,277,44
31180, 하남시,085005, 84세,2016,339,94,245,38.4,339,94,245,38.4
31180, 하남시,090,85~89세,2016,1184,281,903,31.1,1182,280,902,31
31180, 하남시,090001, 85세,2016,286,72,214,33.6,285,71,214,33.2
31180, 하남시,090002, 86세,2016,277,70,207,33.8,276,70,206,34
31180, 하남시,090003, 87세,2016,231,51,180,28.3,231,51,180,28.3
31180, 하남시,090004, 88세,2016,210,49,161,30.4,210,49,161,30.4
31180, 하남시,090005, 89세,2016,180,39,141,27.7,180,39,141,27.7
31180, 하남시,095,90~94세,2016,492,105,387,27.1,492,105,387,27.1
31180, 하남시,095001, 90세,2016,122,23,99,23.2,122,23,99,23.2
31180, 하남시,095002, 91세,2016,124,28,96,29.2,124,28,96,29.2
31180, 하남시,095003, 92세,2016,85,22,63,34.9,85,22,63,34.9
31180, 하남시,095004, 93세,2016,86,21,65,32.3,86,21,65,32.3
31180, 하남시,095005, 94세,2016,75,11,64,17.2,75,11,64,17.2
31180, 하남시,100,95~99세,2016,103,20,83,24.1,103,20,83,24.1
31180, 하남시,100001, 95세,2016,35,7,28,25,35,7,28,25
31180, 하남시,100002, 96세,2016,31,6,25,24,31,6,25,24
31180, 하남시,100003, 97세,2016,17,X,15,13.3,17,X,15,13.3
31180, 하남시,100004, 98세,2016,11,X,8,37.5,11,X,8,37.5
31180, 하남시,100005, 99세,2016,9,X,7,28.6,9,X,7,28.6
31180, 하남시,101,100세이상,2016,14,X,10,40,14,X,10,40
31180, 하남시,102,15세미만,2016,30337,15581,14756,105.6,30286,15555,14731,105.6
31180, 하남시,103,15~64세,2016,142966,72652,70314,103.3,140754,71351,69403,102.8
31180, 하남시,104,65세이상,2016,22119,10038,12081,83.1,22033,10001,12032,83.1
31180, 하남시,086,85세이상,2016,1793,410,1383,29.6,1791,409,1382,29.6
31180, 하남시,126,평균연령,2016,39.8,39,40.7,,39.8,39.1,40.6,
31180, 하남시,127,중위연령,2016,40.5,39.9,41.3,,40.6,40,41.3,
31190, 용인시,000,합계,2016,982590,490583,492007,99.7,960573,478022,482551,99.1
31190, 용인시,005,0~4세,2016,51189,26324,24865,105.9,50784,26116,24668,105.9
31190, 용인시,005001, 0세,2016,8600,4433,4167,106.4,8511,4386,4125,106.3
31190, 용인시,005002, 1세,2016,9888,5093,4795,106.2,9810,5051,4759,106.1
31190, 용인시,005003, 2세,2016,10274,5266,5008,105.2,10194,5226,4968,105.2
31190, 용인시,005004, 3세,2016,10563,5447,5116,106.5,10486,5405,5081,106.4
31190, 용인시,005005, 4세,2016,11864,6085,5779,105.3,11783,6048,5735,105.5
31190, 용인시,010,5~9세,2016,58647,30166,28481,105.9,58309,29980,28329,105.8
31190, 용인시,010001, 5세,2016,11621,5950,5671,104.9,11537,5904,5633,104.8
31190, 용인시,010002, 6세,2016,11421,5861,5560,105.4,11342,5818,5524,105.3
31190, 용인시,010003, 7세,2016,11277,5864,5413,108.3,11211,5826,5385,108.2
31190, 용인시,010004, 8세,2016,12113,6230,5883,105.9,12051,6201,5850,106
31190, 용인시,010005, 9세,2016,12215,6261,5954,105.2,12168,6231,5937,105
31190, 용인시,015,10~14세,2016,55773,28835,26938,107,55538,28710,26828,107
31190, 용인시,015001, 10세,2016,11097,5811,5286,109.9,11058,5789,5269,109.9
31190, 용인시,015002, 11세,2016,10792,5596,5196,107.7,10748,5570,5178,107.6
31190, 용인시,015003, 12세,2016,11390,5823,5567,104.6,11339,5798,5541,104.6
31190, 용인시,015004, 13세,2016,11185,5727,5458,104.9,11140,5701,5439,104.8
31190, 용인시,015005, 14세,2016,11309,5878,5431,108.2,11253,5852,5401,108.4
31190, 용인시,020,15~19세,2016,65529,33892,31637,107.1,64955,33632,31323,107.4
31190, 용인시,020001, 15세,2016,12218,6333,5885,107.6,12159,6298,5861,107.5
31190, 용인시,020002, 16세,2016,12811,6577,6234,105.5,12755,6551,6204,105.6
31190, 용인시,020003, 17세,2016,11994,6196,5798,106.9,11921,6164,5757,107.1
31190, 용인시,020004, 18세,2016,13135,6750,6385,105.7,12994,6688,6306,106.1
31190, 용인시,020005, 19세,2016,15371,8036,7335,109.6,15126,7931,7195,110.2
31190, 용인시,025,20~24세,2016,68691,35780,32911,108.7,65981,34322,31659,108.4
31190, 용인시,025001, 20세,2016,14816,7515,7301,102.9,14384,7333,7051,104
31190, 용인시,025002, 21세,2016,13405,7009,6396,109.6,12962,6802,6160,110.4
31190, 용인시,025003, 22세,2016,13893,7292,6601,110.5,13336,6998,6338,110.4
31190, 용인시,025004, 23세,2016,13618,7066,6552,107.8,12999,6698,6301,106.3
31190, 용인시,025005, 24세,2016,12959,6898,6061,113.8,12300,6491,5809,111.7
31190, 용인시,030,25~29세,2016,55023,29320,25703,114.1,51275,26887,24388,110.2
31190, 용인시,030001, 25세,2016,11967,6514,5453,119.5,11248,6043,5205,116.1
31190, 용인시,030002, 26세,2016,11230,5948,5282,112.6,10465,5461,5004,109.1
31190, 용인시,030003, 27세,2016,10880,5774,5106,113.1,10116,5278,4838,109.1
31190, 용인시,030004, 28세,2016,10580,5696,4884,116.6,9811,5180,4631,111.9
31190, 용인시,030005, 29세,2016,10366,5388,4978,108.2,9635,4925,4710,104.6
31190, 용인시,035,30~34세,2016,65029,32390,32639,99.2,61872,30354,31518,96.3
31190, 용인시,035001, 30세,2016,10777,5569,5208,106.9,10059,5112,4947,103.3
31190, 용인시,035002, 31세,2016,11441,5820,5621,103.5,10766,5389,5377,100.2
31190, 용인시,035003, 32세,2016,12253,6065,6188,98,11662,5663,5999,94.4
31190, 용인시,035004, 33세,2016,14346,6997,7349,95.2,13748,6632,7116,93.2
31190, 용인시,035005, 34세,2016,16212,7939,8273,96,15637,7558,8079,93.6
31190, 용인시,040,35~39세,2016,87401,42448,44953,94.4,85131,40994,44137,92.9
31190, 용인시,040001, 35세,2016,17053,8445,8608,98.1,16549,8106,8443,96
31190, 용인시,040002, 36세,2016,18014,8748,9266,94.4,17528,8432,9096,92.7
31190, 용인시,040003, 37세,2016,17868,8577,9291,92.3,17415,8290,9125,90.8
31190, 용인시,040004, 38세,2016,16377,7877,8500,92.7,15968,7626,8342,91.4
31190, 용인시,040005, 39세,2016,18089,8801,9288,94.8,17671,8540,9131,93.5
31190, 용인시,045,40~44세,2016,96165,47926,48239,99.4,94358,46817,47541,98.5
31190, 용인시,045001, 40세,2016,17749,8792,8957,98.2,17376,8552,8824,96.9
31190, 용인시,045002, 41세,2016,18459,9120,9339,97.7,18131,8918,9213,96.8
31190, 용인시,045003, 42세,2016,20157,10083,10074,100.1,19806,9871,9935,99.4
31190, 용인시,045004, 43세,2016,19824,9833,9991,98.4,19452,9612,9840,97.7
31190, 용인시,045005, 44세,2016,19976,10098,9878,102.2,19593,9864,9729,101.4
31190, 용인시,050,45~49세,2016,93289,47152,46137,102.2,91519,46231,45288,102.1
31190, 용인시,050001, 45세,2016,20785,10600,10185,104.1,20398,10393,10005,103.9
31190, 용인시,050002, 46세,2016,19627,9890,9737,101.6,19231,9674,9557,101.2
31190, 용인시,050003, 47세,2016,18877,9551,9326,102.4,18516,9363,9153,102.3
31190, 용인시,050004, 48세,2016,17972,9035,8937,101.1,17623,8842,8781,100.7
31190, 용인시,050005, 49세,2016,16028,8076,7952,101.6,15751,7959,7792,102.1
31190, 용인시,055,50~54세,2016,70502,36670,33832,108.4,68782,35846,32936,108.8
31190, 용인시,055001, 50세,2016,14763,7616,7147,106.6,14454,7462,6992,106.7
31190, 용인시,055002, 51세,2016,14980,7778,7202,108,14644,7604,7040,108
31190, 용인시,055003, 52세,2016,13644,7165,6479,110.6,13308,7006,6302,111.2
31190, 용인시,055004, 53세,2016,13909,7217,6692,107.8,13496,7036,6460,108.9
31190, 용인시,055005, 54세,2016,13206,6894,6312,109.2,12880,6738,6142,109.7
31190, 용인시,060,55~59세,2016,60310,30188,30122,100.2,59023,29571,29452,100.4
31190, 용인시,060001, 55세,2016,13929,7120,6809,104.6,13712,7011,6701,104.6
31190, 용인시,060002, 56세,2016,13027,6615,6412,103.2,12723,6478,6245,103.7
31190, 용인시,060003, 57세,2016,11781,5988,5793,103.4,11547,5863,5684,103.1
31190, 용인시,060004, 58세,2016,10995,5457,5538,98.5,10731,5319,5412,98.3
31190, 용인시,060005, 59세,2016,10578,5008,5570,89.9,10310,4900,5410,90.6
31190, 용인시,065,60~64세,2016,46117,21633,24484,88.4,45037,21097,23940,88.1
31190, 용인시,065001, 60세,2016,9931,4758,5173,92,9675,4624,5051,91.5
31190, 용인시,065002, 61세,2016,10286,4914,5372,91.5,10044,4790,5254,91.2
31190, 용인시,065003, 62세,2016,8857,4108,4749,86.5,8644,4003,4641,86.3
31190, 용인시,065004, 63세,2016,8207,3757,4450,84.4,8015,3671,4344,84.5
31190, 용인시,065005, 64세,2016,8836,4096,4740,86.4,8659,4009,4650,86.2
31190, 용인시,070,65~69세,2016,35412,16015,19397,82.6,34907,15778,19129,82.5
31190, 용인시,070001, 65세,2016,6173,2754,3419,80.5,6037,2690,3347,80.4
31190, 용인시,070002, 66세,2016,7074,3240,3834,84.5,6955,3185,3770,84.5
31190, 용인시,070003, 67세,2016,7187,3324,3863,86,7078,3272,3806,86
31190, 용인시,070004, 68세,2016,7276,3299,3977,83,7206,3271,3935,83.1
31190, 용인시,070005, 69세,2016,7702,3398,4304,78.9,7631,3360,4271,78.7
31190, 용인시,075,70~74세,2016,29667,13842,15825,87.5,29486,13774,15712,87.7
31190, 용인시,075001, 70세,2016,6207,2850,3357,84.9,6164,2832,3332,85
31190, 용인시,075002, 71세,2016,5878,2764,3114,88.8,5841,2745,3096,88.7
31190, 용인시,075003, 72세,2016,5606,2587,3019,85.7,5571,2574,2997,85.9
31190, 용인시,075004, 73세,2016,5641,2629,3012,87.3,5612,2624,2988,87.8
31190, 용인시,075005, 74세,2016,6335,3012,3323,90.6,6298,2999,3299,90.9
31190, 용인시,080,75~79세,2016,22193,10361,11832,87.6,22082,10310,11772,87.6
31190, 용인시,080001, 75세,2016,5412,2582,2830,91.2,5388,2571,2817,91.3
31190, 용인시,080002, 76세,2016,4623,2219,2404,92.3,4603,2209,2394,92.3
31190, 용인시,080003, 77세,2016,4506,2086,2420,86.2,4484,2070,2414,85.7
31190, 용인시,080004, 78세,2016,3991,1839,2152,85.5,3966,1832,2134,85.8
31190, 용인시,080005, 79세,2016,3661,1635,2026,80.7,3641,1628,2013,80.9
31190, 용인시,085,80~84세,2016,12776,5139,7637,67.3,12713,5120,7593,67.4
31190, 용인시,085001, 80세,2016,3172,1353,1819,74.4,3153,1346,1807,74.5
31190, 용인시,085002, 81세,2016,3014,1255,1759,71.3,3000,1249,1751,71.3
31190, 용인시,085003, 82세,2016,2536,1043,1493,69.9,2528,1043,1485,70.2
31190, 용인시,085004, 83세,2016,2122,767,1355,56.6,2106,761,1345,56.6
31190, 용인시,085005, 84세,2016,1932,721,1211,59.5,1926,721,1205,59.8
31190, 용인시,090,85~89세,2016,6085,1845,4240,43.5,6048,1834,4214,43.5
31190, 용인시,090001, 85세,2016,1486,481,1005,47.9,1480,480,1000,48
31190, 용인시,090002, 86세,2016,1418,462,956,48.3,1408,457,951,48.1
31190, 용인시,090003, 87세,2016,1324,395,929,42.5,1312,392,920,42.6
31190, 용인시,090004, 88세,2016,1030,280,750,37.3,1024,278,746,37.3
31190, 용인시,090005, 89세,2016,827,227,600,37.8,824,227,597,38
31190, 용인시,095,90~94세,2016,2197,544,1653,32.9,2186,540,1646,32.8
31190, 용인시,095001, 90세,2016,646,180,466,38.6,644,179,465,38.5
31190, 용인시,095002, 91세,2016,521,100,421,23.8,519,100,419,23.9
31190, 용인시,095003, 92세,2016,382,95,287,33.1,379,94,285,33
31190, 용인시,095004, 93세,2016,364,104,260,40,363,104,259,40.2
31190, 용인시,095005, 94세,2016,284,65,219,29.7,281,63,218,28.9
31190, 용인시,100,95~99세,2016,523,107,416,25.7,519,105,414,25.4
31190, 용인시,100001, 95세,2016,204,52,152,34.2,202,51,151,33.8
31190, 용인시,100002, 96세,2016,117,19,98,19.4,117,19,98,19.4
31190, 용인시,100003, 97세,2016,90,21,69,30.4,90,21,69,30.4
31190, 용인시,100004, 98세,2016,65,11,54,20.4,64,10,54,18.5
31190, 용인시,100005, 99세,2016,47,X,43,9.3,46,X,42,9.5
31190, 용인시,101,100세이상,2016,72,6,66,9.1,68,X,64,6.3
31190, 용인시,102,15세미만,2016,165609,85325,80284,106.3,164631,84806,79825,106.2
31190, 용인시,103,15~64세,2016,708056,357399,350657,101.9,687933,345751,342182,101
31190, 용인시,104,65세이상,2016,108925,47859,61066,78.4,108009,47465,60544,78.4
31190, 용인시,086,85세이상,2016,8877,2502,6375,39.2,8821,2483,6338,39.2
31190, 용인시,126,평균연령,2016,38.2,37.3,39.1,,38.2,37.4,39.1,
31190, 용인시,127,중위연령,2016,39.1,38.4,39.8,,39.2,38.5,39.8,
31191, 처인구,000,합계,2016,234916,122365,112551,108.7,223593,115024,108569,105.9
31191, 처인구,005,0~4세,2016,9696,5006,4690,106.7,9548,4924,4624,106.5
31191, 처인구,005001, 0세,2016,1755,916,839,109.2,1721,898,823,109.1
31191, 처인구,005002, 1세,2016,1901,979,922,106.2,1872,962,910,105.7
31191, 처인구,005003, 2세,2016,1961,1021,940,108.6,1927,1003,924,108.5
31191, 처인구,005004, 3세,2016,1903,984,919,107.1,1877,971,906,107.2
31191, 처인구,005005, 4세,2016,2176,1106,1070,103.4,2151,1090,1061,102.7
31191, 처인구,010,5~9세,2016,10809,5497,5312,103.5,10730,5454,5276,103.4
31191, 처인구,010001, 5세,2016,2163,1101,1062,103.7,2146,1092,1054,103.6
31191, 처인구,010002, 6세,2016,2105,1054,1051,100.3,2079,1038,1041,99.7
31191, 처인구,010003, 7세,2016,2099,1091,1008,108.2,2085,1083,1002,108.1
31191, 처인구,010004, 8세,2016,2193,1113,1080,103.1,2179,1108,1071,103.5
31191, 처인구,010005, 9세,2016,2249,1138,1111,102.4,2241,1133,1108,102.3
31191, 처인구,015,10~14세,2016,10742,5711,5031,113.5,10696,5689,5007,113.6
31191, 처인구,015001, 10세,2016,2055,1124,931,120.7,2047,1121,926,121.1
31191, 처인구,015002, 11세,2016,2050,1061,989,107.3,2038,1058,980,108
31191, 처인구,015003, 12세,2016,2123,1140,983,116,2116,1135,981,115.7
31191, 처인구,015004, 13세,2016,2168,1141,1027,111.1,2158,1135,1023,110.9
31191, 처인구,015005, 14세,2016,2346,1245,1101,113.1,2337,1240,1097,113
31191, 처인구,020,15~19세,2016,17834,9528,8306,114.7,17719,9467,8252,114.7
31191, 처인구,020001, 15세,2016,2615,1371,1244,110.2,2609,1368,1241,110.2
31191, 처인구,020002, 16세,2016,3199,1664,1535,108.4,3191,1660,1531,108.4
31191, 처인구,020003, 17세,2016,2808,1476,1332,110.8,2793,1467,1326,110.6
31191, 처인구,020004, 18세,2016,3629,1914,1715,111.6,3606,1903,1703,111.7
31191, 처인구,020005, 19세,2016,5583,3103,2480,125.1,5520,3069,2451,125.2
31191, 처인구,025,20~24세,2016,20985,11480,9505,120.8,19751,10669,9082,117.5
31191, 처인구,025001, 20세,2016,4983,2590,2393,108.2,4858,2529,2329,108.6
31191, 처인구,025002, 21세,2016,3978,2096,1882,111.4,3824,2003,1821,110
31191, 처인구,025003, 22세,2016,4126,2257,1869,120.8,3877,2092,1785,117.2
31191, 처인구,025004, 23세,2016,3985,2236,1749,127.8,3658,2009,1649,121.8
31191, 처인구,025005, 24세,2016,3913,2301,1612,142.7,3534,2036,1498,135.9
31191, 처인구,030,25~29세,2016,15446,9222,6224,148.2,13131,7559,5572,135.7
31191, 처인구,030001, 25세,2016,3504,2126,1378,154.3,3068,1801,1267,142.1
31191, 처인구,030002, 26세,2016,3163,1878,1285,146.1,2683,1545,1138,135.8
31191, 처인구,030003, 27세,2016,2989,1818,1171,155.3,2522,1480,1042,142
31191, 처인구,030004, 28세,2016,2923,1721,1202,143.2,2433,1367,1066,128.2
31191, 처인구,030005, 29세,2016,2867,1679,1188,141.3,2425,1366,1059,129
31191, 처인구,035,30~34세,2016,16382,9082,7300,124.4,14367,7643,6724,113.7
31191, 처인구,035001, 30세,2016,2989,1709,1280,133.5,2532,1403,1129,124.3
31191, 처인구,035002, 31세,2016,3031,1766,1265,139.6,2599,1457,1142,127.6
31191, 처인구,035003, 32세,2016,3130,1704,1426,119.5,2739,1410,1329,106.1
31191, 처인구,035004, 33세,2016,3448,1872,1576,118.8,3066,1601,1465,109.3
31191, 처인구,035005, 34세,2016,3784,2031,1753,115.9,3431,1772,1659,106.8
31191, 처인구,040,35~39세,2016,18215,9801,8414,116.5,16876,8839,8037,110
31191, 처인구,040001, 35세,2016,3701,2075,1626,127.6,3401,1844,1557,118.4
31191, 처인구,040002, 36세,2016,3782,2041,1741,117.2,3500,1836,1664,110.3
31191, 처인구,040003, 37세,2016,3767,2027,1740,116.5,3495,1835,1660,110.5
31191, 처인구,040004, 38세,2016,3329,1758,1571,111.9,3086,1596,1490,107.1
31191, 처인구,040005, 39세,2016,3636,1900,1736,109.4,3394,1728,1666,103.7
31191, 처인구,045,40~44세,2016,19406,10312,9094,113.4,18446,9667,8779,110.1
31191, 처인구,045001, 40세,2016,3597,1894,1703,111.2,3382,1747,1635,106.9
31191, 처인구,045002, 41세,2016,3677,1973,1704,115.8,3507,1850,1657,111.6
31191, 처인구,045003, 42세,2016,4083,2200,1883,116.8,3889,2069,1820,113.7
31191, 처인구,045004, 43세,2016,3993,2063,1930,106.9,3819,1954,1865,104.8
31191, 처인구,045005, 44세,2016,4056,2182,1874,116.4,3849,2047,1802,113.6
31191, 처인구,050,45~49세,2016,20121,10307,9814,105,19262,9838,9424,104.4
31191, 처인구,050001, 45세,2016,4155,2144,2011,106.6,3971,2041,1930,105.8
31191, 처인구,050002, 46세,2016,4082,2135,1947,109.7,3879,2018,1861,108.4
31191, 처인구,050003, 47세,2016,4185,2124,2061,103.1,4003,2020,1983,101.9
31191, 처인구,050004, 48세,2016,4059,2080,1979,105.1,3888,1979,1909,103.7
31191, 처인구,050005, 49세,2016,3640,1824,1816,100.4,3521,1780,1741,102.2
31191, 처인구,055,50~54세,2016,18365,9628,8737,110.2,17555,9213,8342,110.4
31191, 처인구,055001, 50세,2016,3692,1939,1753,110.6,3553,1862,1691,110.1
31191, 처인구,055002, 51세,2016,3864,1990,1874,106.2,3686,1893,1793,105.6
31191, 처인구,055003, 52세,2016,3456,1848,1608,114.9,3299,1770,1529,115.8
31191, 처인구,055004, 53세,2016,3676,1926,1750,110.1,3483,1830,1653,110.7
31191, 처인구,055005, 54세,2016,3677,1925,1752,109.9,3534,1858,1676,110.9
31191, 처인구,060,55~59세,2016,17225,8874,8351,106.3,16684,8589,8095,106.1
31191, 처인구,060001, 55세,2016,4056,2106,1950,108,3959,2052,1907,107.6
31191, 처인구,060002, 56세,2016,3756,1978,1778,111.2,3624,1908,1716,111.2
31191, 처인구,060003, 57세,2016,3366,1789,1577,113.4,3282,1744,1538,113.4
31191, 처인구,060004, 58세,2016,3118,1598,1520,105.1,3002,1531,1471,104.1
31191, 처인구,060005, 59세,2016,2929,1403,1526,91.9,2817,1354,1463,92.5
31191, 처인구,065,60~64세,2016,12607,6308,6299,100.1,12127,6039,6088,99.2
31191, 처인구,065001, 60세,2016,2854,1467,1387,105.8,2736,1394,1342,103.9
31191, 처인구,065002, 61세,2016,2831,1437,1394,103.1,2733,1378,1355,101.7
31191, 처인구,065003, 62세,2016,2361,1139,1222,93.2,2267,1092,1175,92.9
31191, 처인구,065004, 63세,2016,2190,1057,1133,93.3,2106,1017,1089,93.4
31191, 처인구,065005, 64세,2016,2371,1208,1163,103.9,2285,1158,1127,102.8
31191, 처인구,070,65~69세,2016,8424,4053,4371,92.7,8192,3932,4260,92.3
31191, 처인구,070001, 65세,2016,1625,752,873,86.1,1555,714,841,84.9
31191, 처인구,070002, 66세,2016,1714,830,884,93.9,1660,802,858,93.5
31191, 처인구,070003, 67세,2016,1675,843,832,101.3,1625,814,811,100.4
31191, 처인구,070004, 68세,2016,1699,832,867,96,1666,820,846,96.9
31191, 처인구,070005, 69세,2016,1711,796,915,87,1686,782,904,86.5
31191, 처인구,075,70~74세,2016,6894,3168,3726,85,6820,3143,3677,85.5
31191, 처인구,075001, 70세,2016,1392,663,729,90.9,1374,657,717,91.6
31191, 처인구,075002, 71세,2016,1357,650,707,91.9,1341,641,700,91.6
31191, 처인구,075003, 72세,2016,1328,609,719,84.7,1314,604,710,85.1
31191, 처인구,075004, 73세,2016,1362,595,767,77.6,1351,594,757,78.5
31191, 처인구,075005, 74세,2016,1455,651,804,81,1440,647,793,81.6
31191, 처인구,080,75~79세,2016,5622,2378,3244,73.3,5581,2359,3222,73.2
31191, 처인구,080001, 75세,2016,1305,559,746,74.9,1298,555,743,74.7
31191, 처인구,080002, 76세,2016,1128,496,632,78.5,1121,492,629,78.2
31191, 처인구,080003, 77세,2016,1180,497,683,72.8,1170,490,680,72.1
31191, 처인구,080004, 78세,2016,1024,409,615,66.5,1015,408,607,67.2
31191, 처인구,080005, 79세,2016,985,417,568,73.4,977,414,563,73.5
31191, 처인구,085,80~84세,2016,3668,1387,2281,60.8,3648,1382,2266,61
31191, 처인구,085001, 80세,2016,854,344,510,67.5,846,341,505,67.5
31191, 처인구,085002, 81세,2016,902,358,544,65.8,897,357,540,66.1
31191, 처인구,085003, 82세,2016,751,299,452,66.2,749,299,450,66.4
31191, 처인구,085004, 83세,2016,612,212,400,53,610,211,399,52.9
31191, 처인구,085005, 84세,2016,549,174,375,46.4,546,174,372,46.8
31191, 처인구,090,85~89세,2016,1718,460,1258,36.6,1706,456,1250,36.5
31191, 처인구,090001, 85세,2016,417,122,295,41.4,416,122,294,41.5
31191, 처인구,090002, 86세,2016,423,117,306,38.2,415,113,302,37.4
31191, 처인구,090003, 87세,2016,367,101,266,38,366,101,265,38.1
31191, 처인구,090004, 88세,2016,285,61,224,27.2,284,61,223,27.4
31191, 처인구,090005, 89세,2016,226,59,167,35.3,225,59,166,35.5
31191, 처인구,095,90~94세,2016,606,132,474,27.8,604,131,473,27.7
31191, 처인구,095001, 90세,2016,185,44,141,31.2,185,44,141,31.2
31191, 처인구,095002, 91세,2016,154,30,124,24.2,154,30,124,24.2
31191, 처인구,095003, 92세,2016,97,21,76,27.6,97,21,76,27.6
31191, 처인구,095004, 93세,2016,103,24,79,30.4,102,24,78,30.8
31191, 처인구,095005, 94세,2016,67,13,54,24.1,66,12,54,22.2
31191, 처인구,100,95~99세,2016,138,31,107,29,137,31,106,29.2
31191, 처인구,100001, 95세,2016,65,18,47,38.3,64,18,46,39.1
31191, 처인구,100002, 96세,2016,27,6,21,28.6,27,6,21,28.6
31191, 처인구,100003, 97세,2016,19,X,16,18.8,19,X,16,18.8
31191, 처인구,100004, 98세,2016,18,X,14,28.6,18,X,14,28.6
31191, 처인구,100005, 99세,2016,9,X,9,0,9,X,9,0
31191, 처인구,101,100세이상,2016,13,X,13,0,13,X,13,0
31191, 처인구,102,15세미만,2016,31247,16214,15033,107.9,30974,16067,14907,107.8
31191, 처인구,103,15~64세,2016,176586,94542,82044,115.2,165918,87523,78395,111.6
31191, 처인구,104,65세이상,2016,27083,11609,15474,75,26701,11434,15267,74.9
31191, 처인구,086,85세이상,2016,2475,623,1852,33.6,2460,618,1842,33.6
31191, 처인구,126,평균연령,2016,39.2,38.1,40.5,,39.3,38.2,40.5,
31191, 처인구,127,중위연령,2016,39.3,37.8,40.9,,39.7,38.4,41,
31192, 기흥구,000,합계,2016,412713,204413,208300,98.1,405871,200953,204918,98.1
31192, 기흥구,005,0~4세,2016,24047,12279,11768,104.3,23891,12200,11691,104.4
31192, 기흥구,005001, 0세,2016,3956,2036,1920,106,3924,2016,1908,105.7
31192, 기흥구,005002, 1세,2016,4653,2371,2282,103.9,4623,2353,2270,103.7
31192, 기흥구,005003, 2세,2016,4800,2449,2351,104.2,4774,2439,2335,104.5
31192, 기흥구,005004, 3세,2016,4963,2547,2416,105.4,4930,2530,2400,105.4
31192, 기흥구,005005, 4세,2016,5675,2876,2799,102.8,5640,2862,2778,103
31192, 기흥구,010,5~9세,2016,27159,14046,13113,107.1,27019,13967,13052,107
31192, 기흥구,010001, 5세,2016,5430,2793,2637,105.9,5391,2770,2621,105.7
31192, 기흥구,010002, 6세,2016,5323,2746,2577,106.6,5294,2732,2562,106.6
31192, 기흥구,010003, 7세,2016,5088,2648,2440,108.5,5058,2630,2428,108.3
31192, 기흥구,010004, 8세,2016,5619,2898,2721,106.5,5599,2889,2710,106.6
31192, 기흥구,010005, 9세,2016,5699,2961,2738,108.1,5677,2946,2731,107.9
31192, 기흥구,015,10~14세,2016,24251,12486,11765,106.1,24155,12435,11720,106.1
31192, 기흥구,015001, 10세,2016,4965,2632,2333,112.8,4950,2622,2328,112.6
31192, 기흥구,015002, 11세,2016,4844,2498,2346,106.5,4827,2485,2342,106.1
31192, 기흥구,015003, 12세,2016,4945,2493,2452,101.7,4922,2484,2438,101.9
31192, 기흥구,015004, 13세,2016,4778,2422,2356,102.8,4762,2413,2349,102.7
31192, 기흥구,015005, 14세,2016,4719,2441,2278,107.2,4694,2431,2263,107.4
31192, 기흥구,020,15~19세,2016,25391,13012,12379,105.1,25138,12910,12228,105.6
31192, 기흥구,020001, 15세,2016,5089,2667,2422,110.1,5062,2652,2410,110
31192, 기흥구,020002, 16세,2016,5006,2583,2423,106.6,4981,2573,2408,106.9
31192, 기흥구,020003, 17세,2016,4835,2486,2349,105.8,4805,2472,2333,106
31192, 기흥구,020004, 18세,2016,4989,2496,2493,100.1,4920,2469,2451,100.7
31192, 기흥구,020005, 19세,2016,5472,2780,2692,103.3,5370,2744,2626,104.5
31192, 기흥구,025,20~24세,2016,27135,13811,13324,103.7,26132,13373,12759,104.8
31192, 기흥구,025001, 20세,2016,5666,2822,2844,99.2,5464,2747,2717,101.1
31192, 기흥구,025002, 21세,2016,5324,2748,2576,106.7,5135,2677,2458,108.9
31192, 기흥구,025003, 22세,2016,5575,2865,2710,105.7,5359,2774,2585,107.3
31192, 기흥구,025004, 23세,2016,5566,2790,2776,100.5,5360,2691,2669,100.8
31192, 기흥구,025005, 24세,2016,5004,2586,2418,106.9,4814,2484,2330,106.6
31192, 기흥구,030,25~29세,2016,22539,11645,10894,106.9,21564,11100,10464,106.1
31192, 기흥구,030001, 25세,2016,4737,2527,2210,114.3,4548,2421,2127,113.8
31192, 기흥구,030002, 26세,2016,4593,2353,2240,105,4398,2239,2159,103.7
31192, 기흥구,030003, 27세,2016,4487,2288,2199,104,4292,2185,2107,103.7
31192, 기흥구,030004, 28세,2016,4427,2332,2095,111.3,4232,2214,2018,109.7
31192, 기흥구,030005, 29세,2016,4295,2145,2150,99.8,4094,2041,2053,99.4
31192, 기흥구,035,30~34세,2016,28005,13611,14394,94.6,27263,13221,14042,94.2
31192, 기흥구,035001, 30세,2016,4439,2222,2217,100.2,4269,2125,2144,99.1
31192, 기흥구,035002, 31세,2016,4837,2433,2404,101.2,4667,2345,2322,101
31192, 기흥구,035003, 32세,2016,5245,2559,2686,95.3,5115,2494,2621,95.2
31192, 기흥구,035004, 33세,2016,6249,2978,3271,91,6119,2919,3200,91.2
31192, 기흥구,035005, 34세,2016,7235,3419,3816,89.6,7093,3338,3755,88.9
31192, 기흥구,040,35~39세,2016,39573,18989,20584,92.3,39008,18687,20321,92
31192, 기흥구,040001, 35세,2016,7746,3731,4015,92.9,7628,3669,3959,92.7
31192, 기흥구,040002, 36세,2016,8230,3963,4267,92.9,8107,3892,4215,92.3
31192, 기흥구,040003, 37세,2016,8025,3820,4205,90.8,7904,3760,4144,90.7
31192, 기흥구,040004, 38세,2016,7424,3518,3906,90.1,7323,3462,3861,89.7
31192, 기흥구,040005, 39세,2016,8148,3957,4191,94.4,8046,3904,4142,94.3
31192, 기흥구,045,40~44세,2016,42295,21090,21205,99.5,41772,20786,20986,99
31192, 기흥구,045001, 40세,2016,7803,3891,3912,99.5,7709,3834,3875,98.9
31192, 기흥구,045002, 41세,2016,8211,3991,4220,94.6,8112,3944,4168,94.6
31192, 기흥구,045003, 42세,2016,8830,4427,4403,100.5,8739,4375,4364,100.3
31192, 기흥구,045004, 43세,2016,8834,4419,4415,100.1,8712,4345,4367,99.5
31192, 기흥구,045005, 44세,2016,8617,4362,4255,102.5,8500,4288,4212,101.8
31192, 기흥구,050,45~49세,2016,39270,19965,19305,103.4,38691,19660,19031,103.3
31192, 기흥구,050001, 45세,2016,8892,4605,4287,107.4,8768,4542,4226,107.5
31192, 기흥구,050002, 46세,2016,8447,4263,4184,101.9,8319,4193,4126,101.6
31192, 기흥구,050003, 47세,2016,7794,3964,3830,103.5,7691,3913,3778,103.6
31192, 기흥구,050004, 48세,2016,7435,3722,3713,100.2,7314,3652,3662,99.7
31192, 기흥구,050005, 49세,2016,6702,3411,3291,103.6,6599,3360,3239,103.7
31192, 기흥구,055,50~54세,2016,28048,14490,13558,106.9,27445,14193,13252,107.1
31192, 기흥구,055001, 50세,2016,5960,3060,2900,105.5,5850,3006,2844,105.7
31192, 기흥구,055002, 51세,2016,6049,3143,2906,108.2,5937,3082,2855,108
31192, 기흥구,055003, 52세,2016,5334,2785,2549,109.3,5215,2728,2487,109.7
31192, 기흥구,055004, 53세,2016,5514,2830,2684,105.4,5373,2767,2606,106.2
31192, 기흥구,055005, 54세,2016,5191,2672,2519,106.1,5070,2610,2460,106.1
31192, 기흥구,060,55~59세,2016,23470,11539,11931,96.7,22990,11311,11679,96.8
31192, 기흥구,060001, 55세,2016,5344,2720,2624,103.7,5273,2686,2587,103.8
31192, 기흥구,060002, 56세,2016,4988,2475,2513,98.5,4884,2431,2453,99.1
31192, 기흥구,060003, 57세,2016,4649,2322,2327,99.8,4547,2267,2280,99.4
31192, 기흥구,060004, 58세,2016,4332,2080,2252,92.4,4233,2031,2202,92.2
31192, 기흥구,060005, 59세,2016,4157,1942,2215,87.7,4053,1896,2157,87.9
31192, 기흥구,065,60~64세,2016,18204,8423,9781,86.1,17825,8235,9590,85.9
31192, 기흥구,065001, 60세,2016,3921,1855,2066,89.8,3836,1815,2021,89.8
31192, 기흥구,065002, 61세,2016,3984,1880,2104,89.4,3891,1835,2056,89.3
31192, 기흥구,065003, 62세,2016,3566,1635,1931,84.7,3486,1595,1891,84.3
31192, 기흥구,065004, 63세,2016,3226,1474,1752,84.1,3157,1437,1720,83.5
31192, 기흥구,065005, 64세,2016,3507,1579,1928,81.9,3455,1553,1902,81.7
31192, 기흥구,070,65~69세,2016,14346,6386,7960,80.2,14158,6302,7856,80.2
31192, 기흥구,070001, 65세,2016,2485,1105,1380,80.1,2435,1086,1349,80.5
31192, 기흥구,070002, 66세,2016,2813,1255,1558,80.6,2768,1235,1533,80.6
31192, 기흥구,070003, 67세,2016,2933,1295,1638,79.1,2894,1278,1616,79.1
31192, 기흥구,070004, 68세,2016,2938,1318,1620,81.4,2914,1309,1605,81.6
31192, 기흥구,070005, 69세,2016,3177,1413,1764,80.1,3147,1394,1753,79.5
31192, 기흥구,075,70~74세,2016,11893,5552,6341,87.6,11822,5519,6303,87.6
31192, 기흥구,075001, 70세,2016,2534,1170,1364,85.8,2515,1160,1355,85.6
31192, 기흥구,075002, 71세,2016,2327,1086,1241,87.5,2314,1079,1235,87.4
31192, 기흥구,075003, 72세,2016,2225,1007,1218,82.7,2212,1001,1211,82.7
31192, 기흥구,075004, 73세,2016,2256,1070,1186,90.2,2244,1066,1178,90.5
31192, 기흥구,075005, 74세,2016,2551,1219,1332,91.5,2537,1213,1324,91.6
31192, 기흥구,080,75~79세,2016,8702,4080,4622,88.3,8660,4061,4599,88.3
31192, 기흥구,080001, 75세,2016,2170,1054,1116,94.4,2158,1049,1109,94.6
31192, 기흥구,080002, 76세,2016,1840,873,967,90.3,1831,869,962,90.3
31192, 기흥구,080003, 77세,2016,1754,804,950,84.6,1747,798,949,84.1
31192, 기흥구,080004, 78세,2016,1570,735,835,88,1564,734,830,88.4
31192, 기흥구,080005, 79세,2016,1368,614,754,81.4,1360,611,749,81.6
31192, 기흥구,085,80~84세,2016,4870,1971,2899,68,4845,1963,2882,68.1
31192, 기흥구,085001, 80세,2016,1259,541,718,75.3,1250,538,712,75.6
31192, 기흥구,085002, 81세,2016,1114,455,659,69,1109,452,657,68.8
31192, 기흥구,085003, 82세,2016,979,394,585,67.4,976,394,582,67.7
31192, 기흥구,085004, 83세,2016,801,291,510,57.1,795,289,506,57.1
31192, 기흥구,085005, 84세,2016,717,290,427,67.9,715,290,425,68.2
31192, 기흥구,090,85~89세,2016,2427,773,1654,46.7,2413,769,1644,46.8
31192, 기흥구,090001, 85세,2016,579,191,388,49.2,576,191,385,49.6
31192, 기흥구,090002, 86세,2016,563,198,365,54.2,561,197,364,54.1
31192, 기흥구,090003, 87세,2016,543,176,367,48,538,174,364,47.8
31192, 기흥구,090004, 88세,2016,393,115,278,41.4,389,114,275,41.5
31192, 기흥구,090005, 89세,2016,349,93,256,36.3,349,93,256,36.3
31192, 기흥구,095,90~94세,2016,839,215,624,34.5,834,214,620,34.5
31192, 기흥구,095001, 90세,2016,240,69,171,40.4,240,69,171,40.4
31192, 기흥구,095002, 91세,2016,196,36,160,22.5,194,36,158,22.8
31192, 기흥구,095003, 92세,2016,155,41,114,36,153,40,113,35.4
31192, 기흥구,095004, 93세,2016,133,49,84,58.3,133,49,84,58.3
31192, 기흥구,095005, 94세,2016,115,20,95,21.1,114,20,94,21.3
31192, 기흥구,100,95~99세,2016,218,47,171,27.5,217,46,171,26.9
31192, 기흥구,100001, 95세,2016,74,20,54,37,74,20,54,37
31192, 기흥구,100002, 96세,2016,51,6,45,13.3,51,6,45,13.3
31192, 기흥구,100003, 97세,2016,41,13,28,46.4,41,13,28,46.4
31192, 기흥구,100004, 98세,2016,29,X,25,16,28,X,25,12
31192, 기흥구,100005, 99세,2016,23,X,19,21.1,23,X,19,21.1
31192, 기흥구,101,100세이상,2016,31,X,28,10.7,29,X,28,3.6
31192, 기흥구,102,15세미만,2016,75457,38811,36646,105.9,75065,38602,36463,105.9
31192, 기흥구,103,15~64세,2016,293930,146575,147355,99.5,287828,143476,144352,99.4
31192, 기흥구,104,65세이상,2016,43326,19027,24299,78.3,42978,18875,24103,78.3
31192, 기흥구,086,85세이상,2016,3515,1038,2477,41.9,3493,1030,2463,41.8
31192, 기흥구,126,평균연령,2016,37.5,36.7,38.3,,37.5,36.7,38.3,
31192, 기흥구,127,중위연령,2016,38.5,37.9,39,,38.6,38,39.1,
31193, 수지구,000,합계,2016,334961,163805,171156,95.7,331109,162045,169064,95.8
31193, 수지구,005,0~4세,2016,17446,9039,8407,107.5,17345,8992,8353,107.6
31193, 수지구,005001, 0세,2016,2889,1481,1408,105.2,2866,1472,1394,105.6
31193, 수지구,005002, 1세,2016,3334,1743,1591,109.6,3315,1736,1579,109.9
31193, 수지구,005003, 2세,2016,3513,1796,1717,104.6,3493,1784,1709,104.4
31193, 수지구,005004, 3세,2016,3697,1916,1781,107.6,3679,1904,1775,107.3
31193, 수지구,005005, 4세,2016,4013,2103,1910,110.1,3992,2096,1896,110.5
31193, 수지구,010,5~9세,2016,20679,10623,10056,105.6,20560,10559,10001,105.6
31193, 수지구,010001, 5세,2016,4028,2056,1972,104.3,4000,2042,1958,104.3
31193, 수지구,010002, 6세,2016,3993,2061,1932,106.7,3969,2048,1921,106.6
31193, 수지구,010003, 7세,2016,4090,2125,1965,108.1,4068,2113,1955,108.1
31193, 수지구,010004, 8세,2016,4301,2219,2082,106.6,4273,2204,2069,106.5
31193, 수지구,010005, 9세,2016,4267,2162,2105,102.7,4250,2152,2098,102.6
31193, 수지구,015,10~14세,2016,20780,10638,10142,104.9,20687,10586,10101,104.8
31193, 수지구,015001, 10세,2016,4077,2055,2022,101.6,4061,2046,2015,101.5
31193, 수지구,015002, 11세,2016,3898,2037,1861,109.5,3883,2027,1856,109.2
31193, 수지구,015003, 12세,2016,4322,2190,2132,102.7,4301,2179,2122,102.7
31193, 수지구,015004, 13세,2016,4239,2164,2075,104.3,4220,2153,2067,104.2
31193, 수지구,015005, 14세,2016,4244,2192,2052,106.8,4222,2181,2041,106.9
31193, 수지구,020,15~19세,2016,22304,11352,10952,103.7,22098,11255,10843,103.8
31193, 수지구,020001, 15세,2016,4514,2295,2219,103.4,4488,2278,2210,103.1
31193, 수지구,020002, 16세,2016,4606,2330,2276,102.4,4583,2318,2265,102.3
31193, 수지구,020003, 17세,2016,4351,2234,2117,105.5,4323,2225,2098,106.1
31193, 수지구,020004, 18세,2016,4517,2340,2177,107.5,4468,2316,2152,107.6
31193, 수지구,020005, 19세,2016,4316,2153,2163,99.5,4236,2118,2118,100
31193, 수지구,025,20~24세,2016,20571,10489,10082,104,20098,10280,9818,104.7
31193, 수지구,025001, 20세,2016,4167,2103,2064,101.9,4062,2057,2005,102.6
31193, 수지구,025002, 21세,2016,4103,2165,1938,111.7,4003,2122,1881,112.8
31193, 수지구,025003, 22세,2016,4192,2170,2022,107.3,4100,2132,1968,108.3
31193, 수지구,025004, 23세,2016,4067,2040,2027,100.6,3981,1998,1983,100.8
31193, 수지구,025005, 24세,2016,4042,2011,2031,99,3952,1971,1981,99.5
31193, 수지구,030,25~29세,2016,17038,8453,8585,98.5,16580,8228,8352,98.5
31193, 수지구,030001, 25세,2016,3726,1861,1865,99.8,3632,1821,1811,100.6
31193, 수지구,030002, 26세,2016,3474,1717,1757,97.7,3384,1677,1707,98.2
31193, 수지구,030003, 27세,2016,3404,1668,1736,96.1,3302,1613,1689,95.5
31193, 수지구,030004, 28세,2016,3230,1643,1587,103.5,3146,1599,1547,103.4
31193, 수지구,030005, 29세,2016,3204,1564,1640,95.4,3116,1518,1598,95
31193, 수지구,035,30~34세,2016,20642,9697,10945,88.6,20242,9490,10752,88.3
31193, 수지구,035001, 30세,2016,3349,1638,1711,95.7,3258,1584,1674,94.6
31193, 수지구,035002, 31세,2016,3573,1621,1952,83,3500,1587,1913,83
31193, 수지구,035003, 32세,2016,3878,1802,2076,86.8,3808,1759,2049,85.8
31193, 수지구,035004, 33세,2016,4649,2147,2502,85.8,4563,2112,2451,86.2
31193, 수지구,035005, 34세,2016,5193,2489,2704,92,5113,2448,2665,91.9
31193, 수지구,040,35~39세,2016,29613,13658,15955,85.6,29247,13468,15779,85.4
31193, 수지구,040001, 35세,2016,5606,2639,2967,88.9,5520,2593,2927,88.6
31193, 수지구,040002, 36세,2016,6002,2744,3258,84.2,5921,2704,3217,84.1
31193, 수지구,040003, 37세,2016,6076,2730,3346,81.6,6016,2695,3321,81.2
31193, 수지구,040004, 38세,2016,5624,2601,3023,86,5559,2568,2991,85.9
31193, 수지구,040005, 39세,2016,6305,2944,3361,87.6,6231,2908,3323,87.5
31193, 수지구,045,40~44세,2016,34464,16524,17940,92.1,34140,16364,17776,92.1
31193, 수지구,045001, 40세,2016,6349,3007,3342,90,6285,2971,3314,89.6
31193, 수지구,045002, 41세,2016,6571,3156,3415,92.4,6512,3124,3388,92.2
31193, 수지구,045003, 42세,2016,7244,3456,3788,91.2,7178,3427,3751,91.4
31193, 수지구,045004, 43세,2016,6997,3351,3646,91.9,6921,3313,3608,91.8
31193, 수지구,045005, 44세,2016,7303,3554,3749,94.8,7244,3529,3715,95
31193, 수지구,050,45~49세,2016,33898,16880,17018,99.2,33566,16733,16833,99.4
31193, 수지구,050001, 45세,2016,7738,3851,3887,99.1,7659,3810,3849,99
31193, 수지구,050002, 46세,2016,7098,3492,3606,96.8,7033,3463,3570,97
31193, 수지구,050003, 47세,2016,6898,3463,3435,100.8,6822,3430,3392,101.1
31193, 수지구,050004, 48세,2016,6478,3233,3245,99.6,6421,3211,3210,100
31193, 수지구,050005, 49세,2016,5686,2841,2845,99.9,5631,2819,2812,100.2
31193, 수지구,055,50~54세,2016,24089,12552,11537,108.8,23782,12440,11342,109.7
31193, 수지구,055001, 50세,2016,5111,2617,2494,104.9,5051,2594,2457,105.6
31193, 수지구,055002, 51세,2016,5067,2645,2422,109.2,5021,2629,2392,109.9
31193, 수지구,055003, 52세,2016,4854,2532,2322,109,4794,2508,2286,109.7
31193, 수지구,055004, 53세,2016,4719,2461,2258,109,4640,2439,2201,110.8
31193, 수지구,055005, 54세,2016,4338,2297,2041,112.5,4276,2270,2006,113.2
31193, 수지구,060,55~59세,2016,19615,9775,9840,99.3,19349,9671,9678,99.9
31193, 수지구,060001, 55세,2016,4529,2294,2235,102.6,4480,2273,2207,103
31193, 수지구,060002, 56세,2016,4283,2162,2121,101.9,4215,2139,2076,103
31193, 수지구,060003, 57세,2016,3766,1877,1889,99.4,3718,1852,1866,99.2
31193, 수지구,060004, 58세,2016,3545,1779,1766,100.7,3496,1757,1739,101
31193, 수지구,060005, 59세,2016,3492,1663,1829,90.9,3440,1650,1790,92.2
31193, 수지구,065,60~64세,2016,15306,6902,8404,82.1,15085,6823,8262,82.6
31193, 수지구,065001, 60세,2016,3156,1436,1720,83.5,3103,1415,1688,83.8
31193, 수지구,065002, 61세,2016,3471,1597,1874,85.2,3420,1577,1843,85.6
31193, 수지구,065003, 62세,2016,2930,1334,1596,83.6,2891,1316,1575,83.6
31193, 수지구,065004, 63세,2016,2791,1226,1565,78.3,2752,1217,1535,79.3
31193, 수지구,065005, 64세,2016,2958,1309,1649,79.4,2919,1298,1621,80.1
31193, 수지구,070,65~69세,2016,12642,5576,7066,78.9,12557,5544,7013,79.1
31193, 수지구,070001, 65세,2016,2063,897,1166,76.9,2047,890,1157,76.9
31193, 수지구,070002, 66세,2016,2547,1155,1392,83,2527,1148,1379,83.2
31193, 수지구,070003, 67세,2016,2579,1186,1393,85.1,2559,1180,1379,85.6
31193, 수지구,070004, 68세,2016,2639,1149,1490,77.1,2626,1142,1484,77
31193, 수지구,070005, 69세,2016,2814,1189,1625,73.2,2798,1184,1614,73.4
31193, 수지구,075,70~74세,2016,10880,5122,5758,89,10844,5112,5732,89.2
31193, 수지구,075001, 70세,2016,2281,1017,1264,80.5,2275,1015,1260,80.6
31193, 수지구,075002, 71세,2016,2194,1028,1166,88.2,2186,1025,1161,88.3
31193, 수지구,075003, 72세,2016,2053,971,1082,89.7,2045,969,1076,90.1
31193, 수지구,075004, 73세,2016,2023,964,1059,91,2017,964,1053,91.5
31193, 수지구,075005, 74세,2016,2329,1142,1187,96.2,2321,1139,1182,96.4
31193, 수지구,080,75~79세,2016,7869,3903,3966,98.4,7841,3890,3951,98.5
31193, 수지구,080001, 75세,2016,1937,969,968,100.1,1932,967,965,100.2
31193, 수지구,080002, 76세,2016,1655,850,805,105.6,1651,848,803,105.6
31193, 수지구,080003, 77세,2016,1572,785,787,99.7,1567,782,785,99.6
31193, 수지구,080004, 78세,2016,1397,695,702,99,1387,690,697,99
31193, 수지구,080005, 79세,2016,1308,604,704,85.8,1304,603,701,86
31193, 수지구,085,80~84세,2016,4238,1781,2457,72.5,4220,1775,2445,72.6
31193, 수지구,085001, 80세,2016,1059,468,591,79.2,1057,467,590,79.2
31193, 수지구,085002, 81세,2016,998,442,556,79.5,994,440,554,79.4
31193, 수지구,085003, 82세,2016,806,350,456,76.8,803,350,453,77.3
31193, 수지구,085004, 83세,2016,709,264,445,59.3,701,261,440,59.3
31193, 수지구,085005, 84세,2016,666,257,409,62.8,665,257,408,63
31193, 수지구,090,85~89세,2016,1940,612,1328,46.1,1929,609,1320,46.1
31193, 수지구,090001, 85세,2016,490,168,322,52.2,488,167,321,52
31193, 수지구,090002, 86세,2016,432,147,285,51.6,432,147,285,51.6
31193, 수지구,090003, 87세,2016,414,118,296,39.9,408,117,291,40.2
31193, 수지구,090004, 88세,2016,352,104,248,41.9,351,103,248,41.5
31193, 수지구,090005, 89세,2016,252,75,177,42.4,250,75,175,42.9
31193, 수지구,095,90~94세,2016,752,197,555,35.5,748,195,553,35.3
31193, 수지구,095001, 90세,2016,221,67,154,43.5,219,66,153,43.1
31193, 수지구,095002, 91세,2016,171,34,137,24.8,171,34,137,24.8
31193, 수지구,095003, 92세,2016,130,33,97,34,129,33,96,34.4
31193, 수지구,095004, 93세,2016,128,31,97,32,128,31,97,32
31193, 수지구,095005, 94세,2016,102,32,70,45.7,101,31,70,44.3
31193, 수지구,100,95~99세,2016,167,29,138,21,165,28,137,20.4
31193, 수지구,100001, 95세,2016,65,14,51,27.5,64,13,51,25.5
31193, 수지구,100002, 96세,2016,39,7,32,21.9,39,7,32,21.9
31193, 수지구,100003, 97세,2016,30,5,25,20,30,5,25,20
31193, 수지구,100004, 98세,2016,18,X,15,20,18,X,15,20
31193, 수지구,100005, 99세,2016,15,X,15,0,14,X,14,0
31193, 수지구,101,100세이상,2016,28,X,25,12,26,X,23,13
31193, 수지구,102,15세미만,2016,58905,30300,28605,105.9,58592,30137,28455,105.9
31193, 수지구,103,15~64세,2016,237540,116282,121258,95.9,234187,114752,119435,96.1
31193, 수지구,104,65세이상,2016,38516,17223,21293,80.9,38330,17156,21174,81
31193, 수지구,086,85세이상,2016,2887,841,2046,41.1,2868,835,2033,41.1
31193, 수지구,126,평균연령,2016,38.3,37.6,39.1,,38.4,37.6,39.1,
31193, 수지구,127,중위연령,2016,39.7,39.3,40.1,,39.8,39.4,40.2,
31200, 파주시,000,합계,2016,423957,216785,207172,104.6,410575,207688,202887,102.4
31200, 파주시,005,0~4세,2016,22873,11664,11209,104.1,22758,11603,11155,104
31200, 파주시,005001, 0세,2016,4029,2089,1940,107.7,4003,2075,1928,107.6
31200, 파주시,005002, 1세,2016,4416,2237,2179,102.7,4392,2224,2168,102.6
31200, 파주시,005003, 2세,2016,4655,2377,2278,104.3,4632,2368,2264,104.6
31200, 파주시,005004, 3세,2016,4633,2324,2309,100.6,4613,2312,2301,100.5
31200, 파주시,005005, 4세,2016,5140,2637,2503,105.4,5118,2624,2494,105.2
31200, 파주시,010,5~9세,2016,24399,12479,11920,104.7,24313,12435,11878,104.7
31200, 파주시,010001, 5세,2016,4990,2553,2437,104.8,4982,2549,2433,104.8
31200, 파주시,010002, 6세,2016,4911,2463,2448,100.6,4892,2454,2438,100.7
31200, 파주시,010003, 7세,2016,4609,2401,2208,108.7,4585,2389,2196,108.8
31200, 파주시,010004, 8세,2016,4941,2552,2389,106.8,4918,2540,2378,106.8
31200, 파주시,010005, 9세,2016,4948,2510,2438,103,4936,2503,2433,102.9
31200, 파주시,015,10~14세,2016,22132,11459,10673,107.4,22082,11432,10650,107.3
31200, 파주시,015001, 10세,2016,4416,2227,2189,101.7,4404,2220,2184,101.6
31200, 파주시,015002, 11세,2016,4249,2196,2053,107,4239,2190,2049,106.9
31200, 파주시,015003, 12세,2016,4489,2340,2149,108.9,4480,2338,2142,109.2
31200, 파주시,015004, 13세,2016,4503,2352,2151,109.3,4495,2346,2149,109.2
31200, 파주시,015005, 14세,2016,4475,2344,2131,110,4464,2338,2126,110
31200, 파주시,020,15~19세,2016,24990,12705,12285,103.4,24904,12655,12249,103.3
31200, 파주시,020001, 15세,2016,4999,2563,2436,105.2,4982,2553,2429,105.1
31200, 파주시,020002, 16세,2016,5619,2831,2788,101.5,5610,2826,2784,101.5
31200, 파주시,020003, 17세,2016,5230,2658,2572,103.3,5218,2650,2568,103.2
31200, 파주시,020004, 18세,2016,4881,2497,2384,104.7,4864,2488,2376,104.7
31200, 파주시,020005, 19세,2016,4261,2156,2105,102.4,4230,2138,2092,102.2
31200, 파주시,025,20~24세,2016,25246,13398,11848,113.1,23639,12121,11518,105.2
31200, 파주시,025001, 20세,2016,4450,2506,1944,128.9,4331,2417,1914,126.3
31200, 파주시,025002, 21세,2016,4853,2691,2162,124.5,4616,2509,2107,119.1
31200, 파주시,025003, 22세,2016,5089,2730,2359,115.7,4756,2450,2306,106.2
31200, 파주시,025004, 23세,2016,5355,2710,2645,102.5,4896,2349,2547,92.2
31200, 파주시,025005, 24세,2016,5499,2761,2738,100.8,5040,2396,2644,90.6
31200, 파주시,030,25~29세,2016,27711,15462,12249,126.2,25140,13611,11529,118.1
31200, 파주시,030001, 25세,2016,5453,2782,2671,104.2,4943,2410,2533,95.1
31200, 파주시,030002, 26세,2016,5257,2887,2370,121.8,4729,2500,2229,112.2
31200, 파주시,030003, 27세,2016,5478,3160,2318,136.3,4939,2767,2172,127.4
31200, 파주시,030004, 28세,2016,5678,3263,2415,135.1,5188,2910,2278,127.7
31200, 파주시,030005, 29세,2016,5845,3370,2475,136.2,5341,3024,2317,130.5
31200, 파주시,035,30~34세,2016,32820,18423,14397,128,30396,16671,13725,121.5
31200, 파주시,035001, 30세,2016,6010,3548,2462,144.1,5546,3226,2320,139.1
31200, 파주시,035002, 31세,2016,6262,3633,2629,138.2,5740,3258,2482,131.3
31200, 파주시,035003, 32세,2016,6157,3406,2751,123.8,5660,3042,2618,116.2
31200, 파주시,035004, 33세,2016,6926,3800,3126,121.6,6434,3443,2991,115.1
31200, 파주시,035005, 34세,2016,7465,4036,3429,117.7,7016,3702,3314,111.7
31200, 파주시,040,35~39세,2016,36599,19104,17495,109.2,34751,17766,16985,104.6
31200, 파주시,040001, 35세,2016,7621,4065,3556,114.3,7173,3721,3452,107.8
31200, 파주시,040002, 36세,2016,7827,4129,3698,111.7,7422,3850,3572,107.8
31200, 파주시,040003, 37세,2016,7283,3760,3523,106.7,6919,3501,3418,102.4
31200, 파주시,040004, 38세,2016,6791,3520,3271,107.6,6447,3266,3181,102.7
31200, 파주시,040005, 39세,2016,7077,3630,3447,105.3,6790,3428,3362,102
31200, 파주시,045,40~44세,2016,38043,19566,18477,105.9,36722,18676,18046,103.5
31200, 파주시,045001, 40세,2016,6932,3591,3341,107.5,6609,3364,3245,103.7
31200, 파주시,045002, 41세,2016,7143,3587,3556,100.9,6876,3411,3465,98.4
31200, 파주시,045003, 42세,2016,7835,3973,3862,102.9,7581,3814,3767,101.2
31200, 파주시,045004, 43세,2016,8003,4125,3878,106.4,7763,3960,3803,104.1
31200, 파주시,045005, 44세,2016,8130,4290,3840,111.7,7893,4127,3766,109.6
31200, 파주시,050,45~49세,2016,37671,19879,17792,111.7,36507,19172,17335,110.6
31200, 파주시,050001, 45세,2016,8405,4433,3972,111.6,8147,4271,3876,110.2
31200, 파주시,050002, 46세,2016,7842,4177,3665,114,7578,4007,3571,112.2
31200, 파주시,050003, 47세,2016,7420,3911,3509,111.5,7193,3786,3407,111.1
31200, 파주시,050004, 48세,2016,7450,3923,3527,111.2,7224,3789,3435,110.3
31200, 파주시,050005, 49세,2016,6554,3435,3119,110.1,6365,3319,3046,109
31200, 파주시,055,50~54세,2016,31576,16662,14914,111.7,30711,16181,14530,111.4
31200, 파주시,055001, 50세,2016,6475,3465,3010,115.1,6298,3370,2928,115.1
31200, 파주시,055002, 51세,2016,6376,3328,3048,109.2,6183,3211,2972,108
31200, 파주시,055003, 52세,2016,6047,3174,2873,110.5,5876,3072,2804,109.6
31200, 파주시,055004, 53세,2016,6287,3323,2964,112.1,6116,3235,2881,112.3
31200, 파주시,055005, 54세,2016,6391,3372,3019,111.7,6238,3293,2945,111.8
31200, 파주시,060,55~59세,2016,29031,14774,14257,103.6,28510,14498,14012,103.5
31200, 파주시,060001, 55세,2016,6582,3379,3203,105.5,6498,3337,3161,105.6
31200, 파주시,060002, 56세,2016,6052,3080,2972,103.6,5925,3019,2906,103.9
31200, 파주시,060003, 57세,2016,5706,2881,2825,102,5587,2818,2769,101.8
31200, 파주시,060004, 58세,2016,5452,2776,2676,103.7,5351,2727,2624,103.9
31200, 파주시,060005, 59세,2016,5239,2658,2581,103,5149,2597,2552,101.8
31200, 파주시,065,60~64세,2016,20361,9960,10401,95.8,19969,9757,10212,95.5
31200, 파주시,065001, 60세,2016,4609,2268,2341,96.9,4524,2230,2294,97.2
31200, 파주시,065002, 61세,2016,4711,2310,2401,96.2,4621,2260,2361,95.7
31200, 파주시,065003, 62세,2016,3859,1916,1943,98.6,3787,1879,1908,98.5
31200, 파주시,065004, 63세,2016,3493,1700,1793,94.8,3428,1669,1759,94.9
31200, 파주시,065005, 64세,2016,3689,1766,1923,91.8,3609,1719,1890,91
31200, 파주시,070,65~69세,2016,14725,6818,7907,86.2,14552,6734,7818,86.1
31200, 파주시,070001, 65세,2016,2451,1138,1313,86.7,2414,1118,1296,86.3
31200, 파주시,070002, 66세,2016,2923,1339,1584,84.5,2880,1319,1561,84.5
31200, 파주시,070003, 67세,2016,3108,1419,1689,84,3068,1402,1666,84.2
31200, 파주시,070004, 68세,2016,3117,1449,1668,86.9,3089,1434,1655,86.6
31200, 파주시,070005, 69세,2016,3126,1473,1653,89.1,3101,1461,1640,89.1
31200, 파주시,075,70~74세,2016,13344,5910,7434,79.5,13284,5890,7394,79.7
31200, 파주시,075001, 70세,2016,2537,1167,1370,85.2,2524,1164,1360,85.6
31200, 파주시,075002, 71세,2016,2511,1123,1388,80.9,2501,1119,1382,81
31200, 파주시,075003, 72세,2016,2576,1112,1464,76,2566,1107,1459,75.9
31200, 파주시,075004, 73세,2016,2680,1140,1540,74,2667,1136,1531,74.2
31200, 파주시,075005, 74세,2016,3040,1368,1672,81.8,3026,1364,1662,82.1
31200, 파주시,080,75~79세,2016,11252,4703,6549,71.8,11199,4684,6515,71.9
31200, 파주시,080001, 75세,2016,2590,1105,1485,74.4,2576,1098,1478,74.3
31200, 파주시,080002, 76세,2016,2348,1008,1340,75.2,2340,1004,1336,75.1
31200, 파주시,080003, 77세,2016,2247,957,1290,74.2,2235,954,1281,74.5
31200, 파주시,080004, 78세,2016,2183,846,1337,63.3,2171,843,1328,63.5
31200, 파주시,080005, 79세,2016,1884,787,1097,71.7,1877,785,1092,71.9
31200, 파주시,085,80~84세,2016,6732,2549,4183,60.9,6704,2539,4165,61
31200, 파주시,085001, 80세,2016,1745,705,1040,67.8,1734,703,1031,68.2
31200, 파주시,085002, 81세,2016,1577,631,946,66.7,1570,627,943,66.5
31200, 파주시,085003, 82세,2016,1265,470,795,59.1,1259,467,792,59
31200, 파주시,085004, 83세,2016,1121,389,732,53.1,1120,389,731,53.2
31200, 파주시,085005, 84세,2016,1024,354,670,52.8,1021,353,668,52.8
31200, 파주시,090,85~89세,2016,3137,943,2194,43,3125,938,2187,42.9
31200, 파주시,090001, 85세,2016,809,258,551,46.8,808,257,551,46.6
31200, 파주시,090002, 86세,2016,732,251,481,52.2,730,251,479,52.4
31200, 파주시,090003, 87세,2016,663,197,466,42.3,661,197,464,42.5
31200, 파주시,090004, 88세,2016,512,131,381,34.4,509,130,379,34.3
31200, 파주시,090005, 89세,2016,421,106,315,33.7,417,103,314,32.8
31200, 파주시,095,90~94세,2016,1040,257,783,32.8,1035,256,779,32.9
31200, 파주시,095001, 90세,2016,301,80,221,36.2,298,79,219,36.1
31200, 파주시,095002, 91세,2016,226,45,181,24.9,225,45,180,25
31200, 파주시,095003, 92세,2016,196,50,146,34.2,196,50,146,34.2
31200, 파주시,095004, 93세,2016,179,46,133,34.6,178,46,132,34.8
31200, 파주시,095005, 94세,2016,138,36,102,35.3,138,36,102,35.3
31200, 파주시,100,95~99세,2016,240,64,176,36.4,240,64,176,36.4
31200, 파주시,100001, 95세,2016,90,19,71,26.8,90,19,71,26.8
31200, 파주시,100002, 96세,2016,63,23,40,57.5,63,23,40,57.5
31200, 파주시,100003, 97세,2016,43,12,31,38.7,43,12,31,38.7
31200, 파주시,100004, 98세,2016,23,X,21,9.5,23,X,21,9.5
31200, 파주시,100005, 99세,2016,21,8,13,61.5,21,8,13,61.5
31200, 파주시,101,100세이상,2016,35,6,29,20.7,34,5,29,17.2
31200, 파주시,102,15세미만,2016,69404,35602,33802,105.3,69153,35470,33683,105.3
31200, 파주시,103,15~64세,2016,304048,159933,144115,111,291249,151108,140141,107.8
31200, 파주시,104,65세이상,2016,50505,21250,29255,72.6,50173,21110,29063,72.6
31200, 파주시,086,85세이상,2016,4452,1270,3182,39.9,4434,1263,3171,39.8
31200, 파주시,126,평균연령,2016,38.9,37.9,40,,39,38.1,40,
31200, 파주시,127,중위연령,2016,39.3,38.2,40.5,,39.6,38.7,40.5,
31210, 이천시,000,합계,2016,214766,109731,105035,104.5,206486,104728,101758,102.9
31210, 이천시,005,0~4세,2016,10662,5424,5238,103.6,10593,5383,5210,103.3
31210, 이천시,005001, 0세,2016,1920,974,946,103,1910,969,941,103
31210, 이천시,005002, 1세,2016,2157,1092,1065,102.5,2147,1086,1061,102.4
31210, 이천시,005003, 2세,2016,2092,1094,998,109.6,2084,1088,996,109.2
31210, 이천시,005004, 3세,2016,2152,1077,1075,100.2,2130,1066,1064,100.2
31210, 이천시,005005, 4세,2016,2341,1187,1154,102.9,2322,1174,1148,102.3
31210, 이천시,010,5~9세,2016,11090,5782,5308,108.9,11048,5759,5289,108.9
31210, 이천시,010001, 5세,2016,2285,1215,1070,113.6,2273,1207,1066,113.2
31210, 이천시,010002, 6세,2016,2206,1174,1032,113.8,2198,1169,1029,113.6
31210, 이천시,010003, 7세,2016,2079,1082,997,108.5,2069,1079,990,109
31210, 이천시,010004, 8세,2016,2236,1161,1075,108,2228,1157,1071,108
31210, 이천시,010005, 9세,2016,2284,1150,1134,101.4,2280,1147,1133,101.2
31210, 이천시,015,10~14세,2016,10795,5623,5172,108.7,10769,5607,5162,108.6
31210, 이천시,015001, 10세,2016,2119,1106,1013,109.2,2113,1101,1012,108.8
31210, 이천시,015002, 11세,2016,2048,1080,968,111.6,2039,1074,965,111.3
31210, 이천시,015003, 12세,2016,2191,1134,1057,107.3,2185,1133,1052,107.7
31210, 이천시,015004, 13세,2016,2131,1083,1048,103.3,2129,1082,1047,103.3
31210, 이천시,015005, 14세,2016,2306,1220,1086,112.3,2303,1217,1086,112.1
31210, 이천시,020,15~19세,2016,14422,7556,6866,110,14357,7514,6843,109.8
31210, 이천시,020001, 15세,2016,2493,1269,1224,103.7,2483,1263,1220,103.5
31210, 이천시,020002, 16세,2016,2784,1431,1353,105.8,2780,1429,1351,105.8
31210, 이천시,020003, 17세,2016,2714,1457,1257,115.9,2700,1447,1253,115.5
31210, 이천시,020004, 18세,2016,2930,1515,1415,107.1,2922,1508,1414,106.6
31210, 이천시,020005, 19세,2016,3501,1884,1617,116.5,3472,1867,1605,116.3
31210, 이천시,025,20~24세,2016,15219,7987,7232,110.4,14109,7365,6744,109.2
31210, 이천시,025001, 20세,2016,3422,1865,1557,119.8,3349,1821,1528,119.2
31210, 이천시,025002, 21세,2016,2844,1546,1298,119.1,2712,1470,1242,118.4
31210, 이천시,025003, 22세,2016,2801,1446,1355,106.7,2607,1351,1256,107.6
31210, 이천시,025004, 23세,2016,2995,1511,1484,101.8,2696,1339,1357,98.7
31210, 이천시,025005, 24세,2016,3157,1619,1538,105.3,2745,1384,1361,101.7
31210, 이천시,030,25~29세,2016,15369,8095,7274,111.3,13352,6829,6523,104.7
31210, 이천시,030001, 25세,2016,2873,1493,1380,108.2,2510,1272,1238,102.7
31210, 이천시,030002, 26세,2016,3160,1681,1479,113.7,2669,1389,1280,108.5
31210, 이천시,030003, 27세,2016,3200,1701,1499,113.5,2786,1428,1358,105.2
31210, 이천시,030004, 28세,2016,3076,1598,1478,108.1,2668,1338,1330,100.6
31210, 이천시,030005, 29세,2016,3060,1622,1438,112.8,2719,1402,1317,106.5
31210, 이천시,035,30~34세,2016,16317,8746,7571,115.5,14911,7854,7057,111.3
31210, 이천시,035001, 30세,2016,2995,1563,1432,109.1,2677,1356,1321,102.6
31210, 이천시,035002, 31세,2016,3096,1587,1509,105.2,2795,1393,1402,99.4
31210, 이천시,035003, 32세,2016,3139,1698,1441,117.8,2862,1518,1344,112.9
31210, 이천시,035004, 33세,2016,3316,1796,1520,118.2,3073,1646,1427,115.3
31210, 이천시,035005, 34세,2016,3771,2102,1669,125.9,3504,1941,1563,124.2
31210, 이천시,040,35~39세,2016,17327,9021,8306,108.6,16397,8410,7987,105.3
31210, 이천시,040001, 35세,2016,3526,1928,1598,120.7,3323,1805,1518,118.9
31210, 이천시,040002, 36세,2016,3540,1906,1634,116.6,3350,1780,1570,113.4
31210, 이천시,040003, 37세,2016,3435,1765,1670,105.7,3244,1640,1604,102.2
31210, 이천시,040004, 38세,2016,3452,1763,1689,104.4,3261,1629,1632,99.8
31210, 이천시,040005, 39세,2016,3374,1659,1715,96.7,3219,1556,1663,93.6
31210, 이천시,045,40~44세,2016,17287,8914,8373,106.5,16601,8480,8121,104.4
31210, 이천시,045001, 40세,2016,3360,1658,1702,97.4,3199,1548,1651,93.8
31210, 이천시,045002, 41세,2016,3304,1704,1600,106.5,3180,1623,1557,104.2
31210, 이천시,045003, 42세,2016,3587,1872,1715,109.2,3435,1772,1663,106.6
31210, 이천시,045004, 43세,2016,3521,1797,1724,104.2,3400,1731,1669,103.7
31210, 이천시,045005, 44세,2016,3515,1883,1632,115.4,3387,1806,1581,114.2
31210, 이천시,050,45~49세,2016,17882,9321,8561,108.9,17281,8979,8302,108.2
31210, 이천시,050001, 45세,2016,3658,1968,1690,116.4,3521,1888,1633,115.6
31210, 이천시,050002, 46세,2016,3658,1964,1694,115.9,3530,1886,1644,114.7
31210, 이천시,050003, 47세,2016,3677,1872,1805,103.7,3561,1812,1749,103.6
31210, 이천시,050004, 48세,2016,3591,1845,1746,105.7,3468,1775,1693,104.8
31210, 이천시,050005, 49세,2016,3298,1672,1626,102.8,3201,1618,1583,102.2
31210, 이천시,055,50~54세,2016,16290,8576,7714,111.2,15742,8286,7456,111.1
31210, 이천시,055001, 50세,2016,3278,1745,1533,113.8,3179,1691,1488,113.6
31210, 이천시,055002, 51세,2016,3377,1748,1629,107.3,3270,1686,1584,106.4
31210, 이천시,055003, 52세,2016,3139,1632,1507,108.3,3015,1569,1446,108.5
31210, 이천시,055004, 53세,2016,3128,1656,1472,112.5,2991,1582,1409,112.3
31210, 이천시,055005, 54세,2016,3368,1795,1573,114.1,3287,1758,1529,115
31210, 이천시,060,55~59세,2016,16123,8400,7723,108.8,15763,8201,7562,108.5
31210, 이천시,060001, 55세,2016,3824,2038,1786,114.1,3755,1997,1758,113.6
31210, 이천시,060002, 56세,2016,3482,1763,1719,102.6,3383,1711,1672,102.3
31210, 이천시,060003, 57세,2016,3100,1621,1479,109.6,3042,1590,1452,109.5
31210, 이천시,060004, 58세,2016,3003,1596,1407,113.4,2939,1560,1379,113.1
31210, 이천시,060005, 59세,2016,2714,1382,1332,103.8,2644,1343,1301,103.2
31210, 이천시,065,60~64세,2016,11131,5706,5425,105.2,10905,5582,5323,104.9
31210, 이천시,065001, 60세,2016,2504,1353,1151,117.5,2448,1322,1126,117.4
31210, 이천시,065002, 61세,2016,2512,1249,1263,98.9,2449,1214,1235,98.3
31210, 이천시,065003, 62세,2016,2093,1077,1016,106,2048,1048,1000,104.8
31210, 이천시,065004, 63세,2016,1771,875,896,97.7,1733,860,873,98.5
31210, 이천시,065005, 64세,2016,2251,1152,1099,104.8,2227,1138,1089,104.5
31210, 이천시,070,65~69세,2016,7346,3565,3781,94.3,7216,3494,3722,93.9
31210, 이천시,070001, 65세,2016,1356,635,721,88.1,1318,617,701,88
31210, 이천시,070002, 66세,2016,1497,713,784,90.9,1470,694,776,89.4
31210, 이천시,070003, 67세,2016,1517,760,757,100.4,1480,738,742,99.5
31210, 이천시,070004, 68세,2016,1467,731,736,99.3,1452,723,729,99.2
31210, 이천시,070005, 69세,2016,1509,726,783,92.7,1496,722,774,93.3
31210, 이천시,075,70~74세,2016,6211,2861,3350,85.4,6178,2845,3333,85.4
31210, 이천시,075001, 70세,2016,1255,642,613,104.7,1245,637,608,104.8
31210, 이천시,075002, 71세,2016,1180,542,638,85,1171,539,632,85.3
31210, 이천시,075003, 72세,2016,1106,507,599,84.6,1103,504,599,84.1
31210, 이천시,075004, 73세,2016,1233,554,679,81.6,1230,553,677,81.7
31210, 이천시,075005, 74세,2016,1437,616,821,75,1429,612,817,74.9
31210, 이천시,080,75~79세,2016,5472,2283,3189,71.6,5456,2278,3178,71.7
31210, 이천시,080001, 75세,2016,1200,526,674,78,1195,524,671,78.1
31210, 이천시,080002, 76세,2016,1175,510,665,76.7,1170,508,662,76.7
31210, 이천시,080003, 77세,2016,1092,450,642,70.1,1090,450,640,70.3
31210, 이천시,080004, 78세,2016,1021,424,597,71,1018,423,595,71.1
31210, 이천시,080005, 79세,2016,984,373,611,61,983,373,610,61.1
31210, 이천시,085,80~84세,2016,3530,1271,2259,56.3,3522,1266,2256,56.1
31210, 이천시,085001, 80세,2016,847,339,508,66.7,844,336,508,66.1
31210, 이천시,085002, 81세,2016,829,288,541,53.2,829,288,541,53.2
31210, 이천시,085003, 82세,2016,736,279,457,61.1,736,279,457,61.1
31210, 이천시,085004, 83세,2016,615,207,408,50.7,611,205,406,50.5
31210, 이천시,085005, 84세,2016,503,158,345,45.8,502,158,344,45.9
31210, 이천시,090,85~89세,2016,1590,444,1146,38.7,1584,441,1143,38.6
31210, 이천시,090001, 85세,2016,390,120,270,44.4,388,118,270,43.7
31210, 이천시,090002, 86세,2016,382,114,268,42.5,379,113,266,42.5
31210, 이천시,090003, 87세,2016,365,101,264,38.3,364,101,263,38.4
31210, 이천시,090004, 88세,2016,256,59,197,29.9,256,59,197,29.9
31210, 이천시,090005, 89세,2016,197,50,147,34,197,50,147,34
31210, 이천시,095,90~94세,2016,566,129,437,29.5,565,128,437,29.3
31210, 이천시,095001, 90세,2016,161,39,122,32,160,38,122,31.1
31210, 이천시,095002, 91세,2016,157,31,126,24.6,157,31,126,24.6
31210, 이천시,095003, 92세,2016,92,27,65,41.5,92,27,65,41.5
31210, 이천시,095004, 93세,2016,95,21,74,28.4,95,21,74,28.4
31210, 이천시,095005, 94세,2016,61,11,50,22,61,11,50,22
31210, 이천시,100,95~99세,2016,123,27,96,28.1,123,27,96,28.1
31210, 이천시,100001, 95세,2016,51,8,43,18.6,51,8,43,18.6
31210, 이천시,100002, 96세,2016,30,6,24,25,30,6,24,25
31210, 이천시,100003, 97세,2016,19,8,11,72.7,19,8,11,72.7
31210, 이천시,100004, 98세,2016,12,X,8,50,12,X,8,50
31210, 이천시,100005, 99세,2016,11,X,10,10,11,X,10,10
31210, 이천시,101,100세이상,2016,14,X,14,0,14,X,14,0
31210, 이천시,102,15세미만,2016,32547,16829,15718,107.1,32410,16749,15661,106.9
31210, 이천시,103,15~64세,2016,157367,82322,75045,109.7,149418,77500,71918,107.8
31210, 이천시,104,65세이상,2016,24852,10580,14272,74.1,24658,10479,14179,73.9
31210, 이천시,086,85세이상,2016,2293,600,1693,35.4,2286,596,1690,35.3
31210, 이천시,126,평균연령,2016,39,38.1,39.9,,39.1,38.2,40,
31210, 이천시,127,중위연령,2016,38.9,38,39.7,,39.3,38.5,40,
31220, 안성시,000,합계,2016,196362,101737,94625,107.5,183468,93341,90127,103.6
31220, 안성시,005,0~4세,2016,8427,4314,4113,104.9,8241,4221,4020,105
31220, 안성시,005001, 0세,2016,1504,773,731,105.7,1475,754,721,104.6
31220, 안성시,005002, 1세,2016,1633,858,775,110.7,1593,832,761,109.3
31220, 안성시,005003, 2세,2016,1636,815,821,99.3,1600,803,797,100.8
31220, 안성시,005004, 3세,2016,1756,929,827,112.3,1714,912,802,113.7
31220, 안성시,005005, 4세,2016,1898,939,959,97.9,1859,920,939,98
31220, 안성시,010,5~9세,2016,9359,4821,4538,106.2,9259,4766,4493,106.1
31220, 안성시,010001, 5세,2016,1937,997,940,106.1,1911,982,929,105.7
31220, 안성시,010002, 6세,2016,1822,942,880,107,1802,930,872,106.7
31220, 안성시,010003, 7세,2016,1821,941,880,106.9,1804,933,871,107.1
31220, 안성시,010004, 8세,2016,1895,966,929,104,1875,956,919,104
31220, 안성시,010005, 9세,2016,1884,975,909,107.3,1867,965,902,107
31220, 안성시,015,10~14세,2016,8686,4556,4130,110.3,8634,4535,4099,110.6
31220, 안성시,015001, 10세,2016,1711,895,816,109.7,1698,891,807,110.4
31220, 안성시,015002, 11세,2016,1660,876,784,111.7,1645,872,773,112.8
31220, 안성시,015003, 12세,2016,1705,875,830,105.4,1696,868,828,104.8
31220, 안성시,015004, 13세,2016,1724,907,817,111,1716,903,813,111.1
31220, 안성시,015005, 14세,2016,1886,1003,883,113.6,1879,1001,878,114
31220, 안성시,020,15~19세,2016,12673,6473,6200,104.4,12488,6374,6114,104.3
31220, 안성시,020001, 15세,2016,2277,1195,1082,110.4,2266,1188,1078,110.2
31220, 안성시,020002, 16세,2016,2354,1221,1133,107.8,2339,1214,1125,107.9
31220, 안성시,020003, 17세,2016,2174,1138,1036,109.8,2147,1124,1023,109.9
31220, 안성시,020004, 18세,2016,2540,1291,1249,103.4,2501,1270,1231,103.2
31220, 안성시,020005, 19세,2016,3328,1628,1700,95.8,3235,1578,1657,95.2
31220, 안성시,025,20~24세,2016,14929,8029,6900,116.4,13508,7051,6457,109.2
31220, 안성시,025001, 20세,2016,3303,1617,1686,95.9,3168,1532,1636,93.6
31220, 안성시,025002, 21세,2016,2977,1429,1548,92.3,2746,1289,1457,88.5
31220, 안성시,025003, 22세,2016,2854,1571,1283,122.4,2581,1381,1200,115.1
31220, 안성시,025004, 23세,2016,3001,1744,1257,138.7,2635,1483,1152,128.7
31220, 안성시,025005, 24세,2016,2794,1668,1126,148.1,2378,1366,1012,135
31220, 안성시,030,25~29세,2016,12322,7158,5164,138.6,9967,5517,4450,124
31220, 안성시,030001, 25세,2016,2537,1467,1070,137.1,2143,1190,953,124.9
31220, 안성시,030002, 26세,2016,2509,1485,1024,145,2020,1143,877,130.3
31220, 안성시,030003, 27세,2016,2421,1400,1021,137.1,1959,1086,873,124.4
31220, 안성시,030004, 28세,2016,2411,1401,1010,138.7,1896,1034,862,120
31220, 안성시,030005, 29세,2016,2444,1405,1039,135.2,1949,1064,885,120.2
31220, 안성시,035,30~34세,2016,14286,8126,6160,131.9,11917,6422,5495,116.9
31220, 안성시,035001, 30세,2016,2568,1492,1076,138.7,2041,1121,920,121.8
31220, 안성시,035002, 31세,2016,2608,1540,1068,144.2,2114,1168,946,123.5
31220, 안성시,035003, 32세,2016,2752,1571,1181,133,2276,1232,1044,118
31220, 안성시,035004, 33세,2016,3043,1666,1377,121,2604,1360,1244,109.3
31220, 안성시,035005, 34세,2016,3315,1857,1458,127.4,2882,1541,1341,114.9
31220, 안성시,040,35~39세,2016,16200,8885,7315,121.5,14498,7680,6818,112.6
31220, 안성시,040001, 35세,2016,3402,1869,1533,121.9,3006,1586,1420,111.7
31220, 안성시,040002, 36세,2016,3450,1890,1560,121.2,3113,1643,1470,111.8
31220, 안성시,040003, 37세,2016,3305,1811,1494,121.2,2942,1560,1382,112.9
31220, 안성시,040004, 38세,2016,3061,1678,1383,121.3,2718,1441,1277,112.8
31220, 안성시,040005, 39세,2016,2982,1637,1345,121.7,2719,1450,1269,114.3
31220, 안성시,045,40~44세,2016,15776,8548,7228,118.3,14544,7731,6813,113.5
31220, 안성시,045001, 40세,2016,2994,1648,1346,122.4,2699,1450,1249,116.1
31220, 안성시,045002, 41세,2016,3011,1618,1393,116.2,2762,1452,1310,110.8
31220, 안성시,045003, 42세,2016,3276,1790,1486,120.5,3062,1642,1420,115.6
31220, 안성시,045004, 43세,2016,3295,1731,1564,110.7,3057,1578,1479,106.7
31220, 안성시,045005, 44세,2016,3200,1761,1439,122.4,2964,1609,1355,118.7
31220, 안성시,050,45~49세,2016,16206,8650,7556,114.5,15166,8039,7127,112.8
31220, 안성시,050001, 45세,2016,3419,1862,1557,119.6,3186,1718,1468,117
31220, 안성시,050002, 46세,2016,3267,1740,1527,113.9,3026,1601,1425,112.4
31220, 안성시,050003, 47세,2016,3355,1808,1547,116.9,3147,1692,1455,116.3
31220, 안성시,050004, 48세,2016,3247,1719,1528,112.5,3035,1594,1441,110.6
31220, 안성시,050005, 49세,2016,2918,1521,1397,108.9,2772,1434,1338,107.2
31220, 안성시,055,50~54세,2016,14620,7798,6822,114.3,13725,7334,6391,114.8
31220, 안성시,055001, 50세,2016,2933,1588,1345,118.1,2760,1505,1255,119.9
31220, 안성시,055002, 51세,2016,2963,1571,1392,112.9,2786,1477,1309,112.8
31220, 안성시,055003, 52세,2016,2825,1488,1337,111.3,2653,1395,1258,110.9
31220, 안성시,055004, 53세,2016,3007,1606,1401,114.6,2801,1496,1305,114.6
31220, 안성시,055005, 54세,2016,2892,1545,1347,114.7,2725,1461,1264,115.6
31220, 안성시,060,55~59세,2016,14868,7625,7243,105.3,14232,7277,6955,104.6
31220, 안성시,060001, 55세,2016,3347,1726,1621,106.5,3236,1668,1568,106.4
31220, 안성시,060002, 56세,2016,3231,1665,1566,106.3,3085,1586,1499,105.8
31220, 안성시,060003, 57세,2016,2952,1500,1452,103.3,2816,1421,1395,101.9
31220, 안성시,060004, 58세,2016,2783,1423,1360,104.6,2655,1359,1296,104.9
31220, 안성시,060005, 59세,2016,2555,1311,1244,105.4,2440,1243,1197,103.8
31220, 안성시,065,60~64세,2016,11128,5610,5518,101.7,10714,5394,5320,101.4
31220, 안성시,065001, 60세,2016,2481,1246,1235,100.9,2390,1199,1191,100.7
31220, 안성시,065002, 61세,2016,2442,1234,1208,102.2,2337,1177,1160,101.5
31220, 안성시,065003, 62세,2016,2158,1105,1053,104.9,2071,1063,1008,105.5
31220, 안성시,065004, 63세,2016,1875,913,962,94.9,1801,875,926,94.5
31220, 안성시,065005, 64세,2016,2172,1112,1060,104.9,2115,1080,1035,104.3
31220, 안성시,070,65~69세,2016,7641,3696,3945,93.7,7452,3598,3854,93.4
31220, 안성시,070001, 65세,2016,1446,692,754,91.8,1402,670,732,91.5
31220, 안성시,070002, 66세,2016,1573,773,800,96.6,1519,747,772,96.8
31220, 안성시,070003, 67세,2016,1472,718,754,95.2,1429,694,735,94.4
31220, 안성시,070004, 68세,2016,1506,743,763,97.4,1484,730,754,96.8
31220, 안성시,070005, 69세,2016,1644,770,874,88.1,1618,757,861,87.9
31220, 안성시,075,70~74세,2016,6429,2890,3539,81.7,6382,2870,3512,81.7
31220, 안성시,075001, 70세,2016,1233,606,627,96.7,1219,602,617,97.6
31220, 안성시,075002, 71세,2016,1265,582,683,85.2,1251,577,674,85.6
31220, 안성시,075003, 72세,2016,1251,569,682,83.4,1243,564,679,83.1
31220, 안성시,075004, 73세,2016,1231,535,696,76.9,1223,530,693,76.5
31220, 안성시,075005, 74세,2016,1449,598,851,70.3,1446,597,849,70.3
31220, 안성시,080,75~79세,2016,5980,2476,3504,70.7,5934,2457,3477,70.7
31220, 안성시,080001, 75세,2016,1254,549,705,77.9,1246,545,701,77.7
31220, 안성시,080002, 76세,2016,1251,520,731,71.1,1239,517,722,71.6
31220, 안성시,080003, 77세,2016,1225,492,733,67.1,1218,489,729,67.1
31220, 안성시,080004, 78세,2016,1114,456,658,69.3,1104,452,652,69.3
31220, 안성시,080005, 79세,2016,1136,459,677,67.8,1127,454,673,67.5
31220, 안성시,085,80~84세,2016,4129,1437,2692,53.4,4114,1432,2682,53.4
31220, 안성시,085001, 80세,2016,1022,399,623,64,1020,398,622,64
31220, 안성시,085002, 81세,2016,878,310,568,54.6,874,308,566,54.4
31220, 안성시,085003, 82세,2016,872,315,557,56.6,868,314,554,56.7
31220, 안성시,085004, 83세,2016,700,222,478,46.4,697,222,475,46.7
31220, 안성시,085005, 84세,2016,657,191,466,41,655,190,465,40.9
31220, 안성시,090,85~89세,2016,1834,451,1383,32.6,1827,449,1378,32.6
31220, 안성시,090001, 85세,2016,517,154,363,42.4,514,154,360,42.8
31220, 안성시,090002, 86세,2016,445,113,332,34,444,112,332,33.7
31220, 안성시,090003, 87세,2016,346,77,269,28.6,345,77,268,28.7
31220, 안성시,090004, 88세,2016,303,54,249,21.7,302,54,248,21.8
31220, 안성시,090005, 89세,2016,223,53,170,31.2,222,52,170,30.6
31220, 안성시,095,90~94세,2016,697,163,534,30.5,695,163,532,30.6
31220, 안성시,095001, 90세,2016,207,43,164,26.2,207,43,164,26.2
31220, 안성시,095002, 91세,2016,156,34,122,27.9,155,34,121,28.1
31220, 안성시,095003, 92세,2016,138,40,98,40.8,138,40,98,40.8
31220, 안성시,095004, 93세,2016,109,28,81,34.6,108,28,80,35
31220, 안성시,095005, 94세,2016,87,18,69,26.1,87,18,69,26.1
31220, 안성시,100,95~99세,2016,142,27,115,23.5,142,27,115,23.5
31220, 안성시,100001, 95세,2016,54,9,45,20,54,9,45,20
31220, 안성시,100002, 96세,2016,33,6,27,22.2,33,6,27,22.2
31220, 안성시,100003, 97세,2016,34,9,25,36,34,9,25,36
31220, 안성시,100004, 98세,2016,12,X,9,33.3,12,X,9,33.3
31220, 안성시,100005, 99세,2016,9,X,9,0,9,X,9,0
31220, 안성시,101,100세이상,2016,30,X,26,15.4,29,X,25,16
31220, 안성시,102,15세미만,2016,26472,13691,12781,107.1,26134,13522,12612,107.2
31220, 안성시,103,15~64세,2016,143008,76902,66106,116.3,130759,68819,61940,111.1
31220, 안성시,104,65세이상,2016,26882,11144,15738,70.8,26575,11000,15575,70.6
31220, 안성시,086,85세이상,2016,2703,645,2058,31.3,2693,643,2050,31.4
31220, 안성시,126,평균연령,2016,40.5,39.2,41.9,,40.7,39.5,42,
31220, 안성시,127,중위연령,2016,40.4,39.1,42,,41.2,40.1,42.4,
31230, 김포시,000,합계,2016,365770,188970,176800,106.9,343744,172130,171614,100.3
31230, 김포시,005,0~4세,2016,21706,11001,10705,102.8,21479,10889,10590,102.8
31230, 김포시,005001, 0세,2016,3666,1873,1793,104.5,3604,1840,1764,104.3
31230, 김포시,005002, 1세,2016,4245,2173,2072,104.9,4208,2154,2054,104.9
31230, 김포시,005003, 2세,2016,4356,2217,2139,103.6,4312,2196,2116,103.8
31230, 김포시,005004, 3세,2016,4439,2270,2169,104.7,4396,2252,2144,105
31230, 김포시,005005, 4세,2016,5000,2468,2532,97.5,4959,2447,2512,97.4
31230, 김포시,010,5~9세,2016,22090,11348,10742,105.6,21944,11263,10681,105.4
31230, 김포시,010001, 5세,2016,4781,2451,2330,105.2,4738,2428,2310,105.1
31230, 김포시,010002, 6세,2016,4549,2414,2135,113.1,4521,2395,2126,112.7
31230, 김포시,010003, 7세,2016,4228,2146,2082,103.1,4210,2137,2073,103.1
31230, 김포시,010004, 8세,2016,4367,2245,2122,105.8,4337,2224,2113,105.3
31230, 김포시,010005, 9세,2016,4165,2092,2073,100.9,4138,2079,2059,101
31230, 김포시,015,10~14세,2016,18707,9603,9104,105.5,18633,9564,9069,105.5
31230, 김포시,015001, 10세,2016,3856,2045,1811,112.9,3840,2033,1807,112.5
31230, 김포시,015002, 11세,2016,3619,1810,1809,100.1,3601,1799,1802,99.8
31230, 김포시,015003, 12세,2016,3783,1921,1862,103.2,3770,1915,1855,103.2
31230, 김포시,015004, 13세,2016,3723,1918,1805,106.3,3712,1912,1800,106.2
31230, 김포시,015005, 14세,2016,3726,1909,1817,105.1,3710,1905,1805,105.5
31230, 김포시,020,15~19세,2016,19033,9872,9161,107.8,18893,9792,9101,107.6
31230, 김포시,020001, 15세,2016,3971,2052,1919,106.9,3960,2045,1915,106.8
31230, 김포시,020002, 16세,2016,4218,2182,2036,107.2,4195,2171,2024,107.3
31230, 김포시,020003, 17세,2016,3938,2019,1919,105.2,3918,2007,1911,105
31230, 김포시,020004, 18세,2016,3812,1985,1827,108.6,3776,1969,1807,109
31230, 김포시,020005, 19세,2016,3094,1634,1460,111.9,3044,1600,1444,110.8
31230, 김포시,025,20~24세,2016,19669,11284,8385,134.6,17415,9384,8031,116.8
31230, 김포시,025001, 20세,2016,3484,2015,1469,137.2,3365,1923,1442,133.4
31230, 김포시,025002, 21세,2016,3751,2209,1542,143.3,3503,2017,1486,135.7
31230, 김포시,025003, 22세,2016,3839,2166,1673,129.5,3443,1833,1610,113.9
31230, 김포시,025004, 23세,2016,4229,2381,1848,128.8,3581,1831,1750,104.6
31230, 김포시,025005, 24세,2016,4366,2513,1853,135.6,3523,1780,1743,102.1
31230, 김포시,030,25~29세,2016,21853,12708,9145,139,16817,8444,8373,100.8
31230, 김포시,030001, 25세,2016,4411,2568,1843,139.3,3487,1769,1718,103
31230, 김포시,030002, 26세,2016,4396,2608,1788,145.9,3323,1695,1628,104.1
31230, 김포시,030003, 27세,2016,4419,2647,1772,149.4,3379,1766,1613,109.5
31230, 김포시,030004, 28세,2016,4177,2417,1760,137.3,3205,1606,1599,100.4
31230, 김포시,030005, 29세,2016,4450,2468,1982,124.5,3423,1608,1815,88.6
31230, 김포시,035,30~34세,2016,28563,15219,13344,114.1,24031,11428,12603,90.7
31230, 김포시,035001, 30세,2016,4656,2592,2064,125.6,3650,1741,1909,91.2
31230, 김포시,035002, 31세,2016,4869,2680,2189,122.4,3919,1866,2053,90.9
31230, 김포시,035003, 32세,2016,5432,2856,2576,110.9,4557,2131,2426,87.8
31230, 김포시,035004, 33세,2016,6378,3346,3032,110.4,5523,2626,2897,90.6
31230, 김포시,035005, 34세,2016,7228,3745,3483,107.5,6382,3064,3318,92.3
31230, 김포시,040,35~39세,2016,36601,19176,17425,110,33686,16832,16854,99.9
31230, 김포시,040001, 35세,2016,7479,3925,3554,110.4,6755,3342,3413,97.9
31230, 김포시,040002, 36세,2016,7830,4098,3732,109.8,7208,3591,3617,99.3
31230, 김포시,040003, 37세,2016,7378,3810,3568,106.8,6782,3335,3447,96.8
31230, 김포시,040004, 38세,2016,6904,3665,3239,113.2,6394,3260,3134,104
31230, 김포시,040005, 39세,2016,7010,3678,3332,110.4,6547,3304,3243,101.9
31230, 김포시,045,40~44세,2016,34765,18525,16240,114.1,32989,17228,15761,109.3
31230, 김포시,045001, 40세,2016,6815,3626,3189,113.7,6385,3297,3088,106.8
31230, 김포시,045002, 41세,2016,6852,3625,3227,112.3,6499,3355,3144,106.7
31230, 김포시,045003, 42세,2016,7240,3817,3423,111.5,6920,3589,3331,107.7
31230, 김포시,045004, 43세,2016,6824,3683,3141,117.3,6500,3453,3047,113.3
31230, 김포시,045005, 44세,2016,7034,3774,3260,115.8,6685,3534,3151,112.2
31230, 김포시,050,45~49세,2016,31360,16329,15031,108.6,29819,15332,14487,105.8
31230, 김포시,050001, 45세,2016,6852,3616,3236,111.7,6541,3409,3132,108.8
31230, 김포시,050002, 46세,2016,6444,3390,3054,111,6081,3146,2935,107.2
31230, 김포시,050003, 47세,2016,6317,3265,3052,107,6019,3086,2933,105.2
31230, 김포시,050004, 48세,2016,6122,3185,2937,108.4,5798,2975,2823,105.4
31230, 김포시,050005, 49세,2016,5625,2873,2752,104.4,5380,2716,2664,102
31230, 김포시,055,50~54세,2016,27350,14293,13057,109.5,26001,13469,12532,107.5
31230, 김포시,055001, 50세,2016,5571,2929,2642,110.9,5299,2747,2552,107.6
31230, 김포시,055002, 51세,2016,5558,2825,2733,103.4,5278,2651,2627,100.9
31230, 김포시,055003, 52세,2016,5177,2719,2458,110.6,4918,2572,2346,109.6
31230, 김포시,055004, 53세,2016,5450,2860,2590,110.4,5142,2680,2462,108.9
31230, 김포시,055005, 54세,2016,5594,2960,2634,112.4,5364,2819,2545,110.8
31230, 김포시,060,55~59세,2016,25756,13121,12635,103.8,24833,12595,12238,102.9
31230, 김포시,060001, 55세,2016,5616,2896,2720,106.5,5450,2793,2657,105.1
31230, 김포시,060002, 56세,2016,5574,2895,2679,108.1,5350,2766,2584,107
31230, 김포시,060003, 57세,2016,5102,2599,2503,103.8,4910,2492,2418,103.1
31230, 김포시,060004, 58세,2016,4792,2393,2399,99.7,4629,2308,2321,99.4
31230, 김포시,060005, 59세,2016,4672,2338,2334,100.2,4494,2236,2258,99
31230, 김포시,065,60~64세,2016,18868,9157,9711,94.3,18210,8777,9433,93
31230, 김포시,065001, 60세,2016,4184,2025,2159,93.8,4029,1936,2093,92.5
31230, 김포시,065002, 61세,2016,4365,2114,2251,93.9,4208,2020,2188,92.3
31230, 김포시,065003, 62세,2016,3623,1775,1848,96,3497,1701,1796,94.7
31230, 김포시,065004, 63세,2016,3226,1531,1695,90.3,3100,1455,1645,88.4
31230, 김포시,065005, 64세,2016,3470,1712,1758,97.4,3376,1665,1711,97.3
31230, 김포시,070,65~69세,2016,13404,6519,6885,94.7,13134,6395,6739,94.9
31230, 김포시,070001, 65세,2016,2369,1153,1216,94.8,2300,1120,1180,94.9
31230, 김포시,070002, 66세,2016,2771,1308,1463,89.4,2707,1280,1427,89.7
31230, 김포시,070003, 67세,2016,2893,1420,1473,96.4,2834,1393,1441,96.7
31230, 김포시,070004, 68세,2016,2746,1361,1385,98.3,2703,1344,1359,98.9
31230, 김포시,070005, 69세,2016,2625,1277,1348,94.7,2590,1258,1332,94.4
31230, 김포시,075,70~74세,2016,10466,4842,5624,86.1,10387,4806,5581,86.1
31230, 김포시,075001, 70세,2016,2211,1074,1137,94.5,2189,1065,1124,94.8
31230, 김포시,075002, 71세,2016,2077,990,1087,91.1,2060,979,1081,90.6
31230, 김포시,075003, 72세,2016,1887,843,1044,80.7,1876,839,1037,80.9
31230, 김포시,075004, 73세,2016,2022,940,1082,86.9,2007,935,1072,87.2
31230, 김포시,075005, 74세,2016,2269,995,1274,78.1,2255,988,1267,78
31230, 김포시,080,75~79세,2016,7797,3362,4435,75.8,7739,3341,4398,76
31230, 김포시,080001, 75세,2016,1824,828,996,83.1,1814,826,988,83.6
31230, 김포시,080002, 76세,2016,1582,708,874,81,1568,701,867,80.9
31230, 김포시,080003, 77세,2016,1574,656,918,71.5,1562,651,911,71.5
31230, 김포시,080004, 78세,2016,1487,631,856,73.7,1476,626,850,73.6
31230, 김포시,080005, 79세,2016,1330,539,791,68.1,1319,537,782,68.7
31230, 김포시,085,80~84세,2016,4693,1747,2946,59.3,4665,1735,2930,59.2
31230, 김포시,085001, 80세,2016,1153,485,668,72.6,1146,482,664,72.6
31230, 김포시,085002, 81세,2016,1110,425,685,62,1103,422,681,62
31230, 김포시,085003, 82세,2016,951,350,601,58.2,946,348,598,58.2
31230, 김포시,085004, 83세,2016,766,262,504,52,762,261,501,52.1
31230, 김포시,085005, 84세,2016,713,225,488,46.1,708,222,486,45.7
31230, 김포시,090,85~89세,2016,2174,633,1541,41.1,2160,626,1534,40.8
31230, 김포시,090001, 85세,2016,581,195,386,50.5,578,193,385,50.1
31230, 김포시,090002, 86세,2016,499,139,360,38.6,498,139,359,38.7
31230, 김포시,090003, 87세,2016,438,120,318,37.7,434,118,316,37.3
31230, 김포시,090004, 88세,2016,333,93,240,38.8,329,90,239,37.7
31230, 김포시,090005, 89세,2016,323,86,237,36.3,321,86,235,36.6
31230, 김포시,095,90~94세,2016,740,184,556,33.1,734,183,551,33.2
31230, 김포시,095001, 90세,2016,206,51,155,32.9,204,50,154,32.5
31230, 김포시,095002, 91세,2016,194,50,144,34.7,192,50,142,35.2
31230, 김포시,095003, 92세,2016,134,26,108,24.1,134,26,108,24.1
31230, 김포시,095004, 93세,2016,127,38,89,42.7,125,38,87,43.7
31230, 김포시,095005, 94세,2016,79,19,60,31.7,79,19,60,31.7
31230, 김포시,100,95~99세,2016,157,41,116,35.3,157,41,116,35.3
31230, 김포시,100001, 95세,2016,57,15,42,35.7,57,15,42,35.7
31230, 김포시,100002, 96세,2016,47,10,37,27,47,10,37,27
31230, 김포시,100003, 97세,2016,26,10,16,62.5,26,10,16,62.5
31230, 김포시,100004, 98세,2016,19,5,14,35.7,19,5,14,35.7
31230, 김포시,100005, 99세,2016,8,X,7,14.3,8,X,7,14.3
31230, 김포시,101,100세이상,2016,18,6,12,50,18,6,12,50
31230, 김포시,102,15세미만,2016,62503,31952,30551,104.6,62056,31716,30340,104.5
31230, 김포시,103,15~64세,2016,263818,139684,124134,112.5,242694,123281,119413,103.2
31230, 김포시,104,65세이상,2016,39449,17334,22115,78.4,38994,17133,21861,78.4
31230, 김포시,086,85세이상,2016,3089,864,2225,38.8,3069,856,2213,38.7
31230, 김포시,126,평균연령,2016,38.6,37.7,39.5,,38.8,38,39.5,
31230, 김포시,127,중위연령,2016,39.2,38.4,40.1,,39.8,39.5,40.2,
31240, 화성시,000,합계,2016,655350,345293,310057,111.4,612093,314323,297770,105.6
31240, 화성시,005,0~4세,2016,43247,22165,21082,105.1,42785,21926,20859,105.1
31240, 화성시,005001, 0세,2016,7660,3889,3771,103.1,7544,3827,3717,103
31240, 화성시,005002, 1세,2016,8413,4333,4080,106.2,8320,4284,4036,106.1
31240, 화성시,005003, 2세,2016,8588,4369,4219,103.6,8505,4324,4181,103.4
31240, 화성시,005004, 3세,2016,8849,4594,4255,108,8756,4546,4210,108
31240, 화성시,005005, 4세,2016,9737,4980,4757,104.7,9660,4945,4715,104.9
31240, 화성시,010,5~9세,2016,45937,23430,22507,104.1,45670,23295,22375,104.1
31240, 화성시,010001, 5세,2016,9614,4919,4695,104.8,9552,4885,4667,104.7
31240, 화성시,010002, 6세,2016,9240,4717,4523,104.3,9176,4686,4490,104.4
31240, 화성시,010003, 7세,2016,9031,4629,4402,105.2,8986,4606,4380,105.2
31240, 화성시,010004, 8세,2016,9105,4620,4485,103,9058,4595,4463,103
31240, 화성시,010005, 9세,2016,8947,4545,4402,103.2,8898,4523,4375,103.4
31240, 화성시,015,10~14세,2016,37862,19361,18501,104.6,37727,19300,18427,104.7
31240, 화성시,015001, 10세,2016,8063,4106,3957,103.8,8028,4090,3938,103.9
31240, 화성시,015002, 11세,2016,7397,3732,3665,101.8,7366,3717,3649,101.9
31240, 화성시,015003, 12세,2016,7844,4024,3820,105.3,7815,4016,3799,105.7
31240, 화성시,015004, 13세,2016,7449,3859,3590,107.5,7431,3851,3580,107.6
31240, 화성시,015005, 14세,2016,7109,3640,3469,104.9,7087,3626,3461,104.8
31240, 화성시,020,15~19세,2016,37357,19030,18327,103.8,37086,18884,18202,103.7
31240, 화성시,020001, 15세,2016,7749,3983,3766,105.8,7727,3971,3756,105.7
31240, 화성시,020002, 16세,2016,8231,4204,4027,104.4,8204,4190,4014,104.4
31240, 화성시,020003, 17세,2016,7459,3803,3656,104,7431,3787,3644,103.9
31240, 화성시,020004, 18세,2016,7076,3558,3518,101.1,7018,3524,3494,100.9
31240, 화성시,020005, 19세,2016,6842,3482,3360,103.6,6706,3412,3294,103.6
31240, 화성시,025,20~24세,2016,35908,20126,15782,127.5,31707,16897,14810,114.1
31240, 화성시,025001, 20세,2016,6891,3608,3283,109.9,6570,3408,3162,107.8
31240, 화성시,025002, 21세,2016,6946,3958,2988,132.5,6429,3558,2871,123.9
31240, 화성시,025003, 22세,2016,6955,3918,3037,129,6211,3343,2868,116.6
31240, 화성시,025004, 23세,2016,7411,4197,3214,130.6,6267,3307,2960,111.7
31240, 화성시,025005, 24세,2016,7705,4445,3260,136.3,6230,3281,2949,111.3
31240, 화성시,030,25~29세,2016,43094,25055,18039,138.9,33675,17746,15929,111.4
31240, 화성시,030001, 25세,2016,7640,4444,3196,139,5995,3151,2844,110.8
31240, 화성시,030002, 26세,2016,8064,4772,3292,145,6241,3323,2918,113.9
31240, 화성시,030003, 27세,2016,8650,5021,3629,138.4,6776,3578,3198,111.9
31240, 화성시,030004, 28세,2016,9122,5261,3861,136.3,7101,3693,3408,108.4
31240, 화성시,030005, 29세,2016,9618,5557,4061,136.8,7562,4001,3561,112.4
31240, 화성시,035,30~34세,2016,60033,32749,27284,120,50966,25748,25218,102.1
31240, 화성시,035001, 30세,2016,10112,5664,4448,127.3,8126,4135,3991,103.6
31240, 화성시,035002, 31세,2016,10642,5968,4674,127.7,8750,4506,4244,106.2
31240, 화성시,035003, 32세,2016,11422,6277,5145,122,9563,4839,4724,102.4
31240, 화성시,035004, 33세,2016,13052,7002,6050,115.7,11331,5656,5675,99.7
31240, 화성시,035005, 34세,2016,14805,7838,6967,112.5,13196,6612,6584,100.4
31240, 화성시,040,35~39세,2016,73344,39504,33840,116.7,67108,34766,32342,107.5
31240, 화성시,040001, 35세,2016,15048,8209,6839,120,13580,7062,6518,108.3
31240, 화성시,040002, 36세,2016,15730,8385,7345,114.2,14325,7324,7001,104.6
31240, 화성시,040003, 37세,2016,14795,7998,6797,117.7,13562,7055,6507,108.4
31240, 화성시,040004, 38세,2016,13707,7366,6341,116.2,12551,6510,6041,107.8
31240, 화성시,040005, 39세,2016,14064,7546,6518,115.8,13090,6815,6275,108.6
31240, 화성시,045,40~44세,2016,66243,35836,30407,117.9,62201,33019,29182,113.1
31240, 화성시,045001, 40세,2016,13318,7225,6093,118.6,12389,6542,5847,111.9
31240, 화성시,045002, 41세,2016,13400,7164,6236,114.9,12524,6553,5971,109.7
31240, 화성시,045003, 42세,2016,13754,7317,6437,113.7,12969,6774,6195,109.3
31240, 화성시,045004, 43세,2016,13253,7193,6060,118.7,12502,6665,5837,114.2
31240, 화성시,045005, 44세,2016,12518,6937,5581,124.3,11817,6485,5332,121.6
31240, 화성시,050,45~49세,2016,56215,30825,25390,121.4,53033,28874,24159,119.5
31240, 화성시,050001, 45세,2016,12744,7081,5663,125,12026,6620,5406,122.5
31240, 화성시,050002, 46세,2016,11976,6662,5314,125.4,11260,6212,5048,123.1
31240, 화성시,050003, 47세,2016,11475,6269,5206,120.4,10863,5885,4978,118.2
31240, 화성시,050004, 48세,2016,10662,5750,4912,117.1,10034,5387,4647,115.9
31240, 화성시,050005, 49세,2016,9358,5063,4295,117.9,8850,4770,4080,116.9
31240, 화성시,055,50~54세,2016,42695,23358,19337,120.8,40030,21813,18217,119.7
31240, 화성시,055001, 50세,2016,8901,4939,3962,124.7,8334,4609,3725,123.7
31240, 화성시,055002, 51세,2016,9168,5053,4115,122.8,8607,4724,3883,121.7
31240, 화성시,055003, 52세,2016,8130,4434,3696,120,7635,4149,3486,119
31240, 화성시,055004, 53세,2016,8271,4511,3760,120,7690,4166,3524,118.2
31240, 화성시,055005, 54세,2016,8225,4421,3804,116.2,7764,4165,3599,115.7
31240, 화성시,060,55~59세,2016,36599,19152,17447,109.8,35052,18259,16793,108.7
31240, 화성시,060001, 55세,2016,8745,4666,4079,114.4,8484,4522,3962,114.1
31240, 화성시,060002, 56세,2016,8054,4286,3768,113.7,7667,4062,3605,112.7
31240, 화성시,060003, 57세,2016,7255,3783,3472,109,6930,3588,3342,107.4
31240, 화성시,060004, 58세,2016,6556,3411,3145,108.5,6265,3239,3026,107
31240, 화성시,060005, 59세,2016,5989,3006,2983,100.8,5706,2848,2858,99.7
31240, 화성시,065,60~64세,2016,25530,12723,12807,99.3,24489,12171,12318,98.8
31240, 화성시,065001, 60세,2016,5880,2990,2890,103.5,5627,2852,2775,102.8
31240, 화성시,065002, 61세,2016,5644,2799,2845,98.4,5421,2670,2751,97.1
31240, 화성시,065003, 62세,2016,4844,2403,2441,98.4,4600,2288,2312,99
31240, 화성시,065004, 63세,2016,4370,2186,2184,100.1,4183,2082,2101,99.1
31240, 화성시,065005, 64세,2016,4792,2345,2447,95.8,4658,2279,2379,95.8
31240, 화성시,070,65~69세,2016,16874,8236,8638,95.3,16459,8005,8454,94.7
31240, 화성시,070001, 65세,2016,3092,1545,1547,99.9,2976,1474,1502,98.1
31240, 화성시,070002, 66세,2016,3519,1703,1816,93.8,3425,1657,1768,93.7
31240, 화성시,070003, 67세,2016,3500,1689,1811,93.3,3405,1639,1766,92.8
31240, 화성시,070004, 68세,2016,3371,1657,1714,96.7,3311,1623,1688,96.1
31240, 화성시,070005, 69세,2016,3392,1642,1750,93.8,3342,1612,1730,93.2
31240, 화성시,075,70~74세,2016,13003,5932,7071,83.9,12868,5867,7001,83.8
31240, 화성시,075001, 70세,2016,2697,1320,1377,95.9,2667,1305,1362,95.8
31240, 화성시,075002, 71세,2016,2577,1232,1345,91.6,2544,1214,1330,91.3
31240, 화성시,075003, 72세,2016,2477,1094,1383,79.1,2454,1085,1369,79.3
31240, 화성시,075004, 73세,2016,2444,1052,1392,75.6,2421,1041,1380,75.4
31240, 화성시,075005, 74세,2016,2808,1234,1574,78.4,2782,1222,1560,78.3
31240, 화성시,080,75~79세,2016,10458,4400,6058,72.6,10370,4367,6003,72.7
31240, 화성시,080001, 75세,2016,2379,1068,1311,81.5,2361,1057,1304,81.1
31240, 화성시,080002, 76세,2016,2074,858,1216,70.6,2057,852,1205,70.7
31240, 화성시,080003, 77세,2016,2158,890,1268,70.2,2141,884,1257,70.3
31240, 화성시,080004, 78세,2016,1994,834,1160,71.9,1973,829,1144,72.5
31240, 화성시,080005, 79세,2016,1853,750,1103,68,1838,745,1093,68.2
31240, 화성시,085,80~84세,2016,6705,2361,4344,54.4,6655,2346,4309,54.4
31240, 화성시,085001, 80세,2016,1687,672,1015,66.2,1675,668,1007,66.3
31240, 화성시,085002, 81세,2016,1512,512,1000,51.2,1501,510,991,51.5
31240, 화성시,085003, 82세,2016,1341,487,854,57,1331,482,849,56.8
31240, 화성시,085004, 83세,2016,1137,383,754,50.8,1128,380,748,50.8
31240, 화성시,085005, 84세,2016,1028,307,721,42.6,1020,306,714,42.9
31240, 화성시,090,85~89세,2016,2987,768,2219,34.6,2964,761,2203,34.5
31240, 화성시,090001, 85세,2016,742,206,536,38.4,731,202,529,38.2
31240, 화성시,090002, 86세,2016,727,184,543,33.9,724,183,541,33.8
31240, 화성시,090003, 87세,2016,599,169,430,39.3,594,167,427,39.1
31240, 화성시,090004, 88세,2016,502,116,386,30.1,501,116,385,30.1
31240, 화성시,090005, 89세,2016,417,93,324,28.7,414,93,321,29
31240, 화성시,095,90~94세,2016,1005,238,767,31,997,236,761,31
31240, 화성시,095001, 90세,2016,274,76,198,38.4,273,75,198,37.9
31240, 화성시,095002, 91세,2016,262,55,207,26.6,261,55,206,26.7
31240, 화성시,095003, 92세,2016,182,38,144,26.4,180,38,142,26.8
31240, 화성시,095004, 93세,2016,169,43,126,34.1,167,42,125,33.6
31240, 화성시,095005, 94세,2016,118,26,92,28.3,116,26,90,28.9
31240, 화성시,100,95~99세,2016,224,41,183,22.4,221,40,181,22.1
31240, 화성시,100001, 95세,2016,79,15,64,23.4,78,15,63,23.8
31240, 화성시,100002, 96세,2016,58,7,51,13.7,57,6,51,11.8
31240, 화성시,100003, 97세,2016,49,12,37,32.4,48,12,36,33.3
31240, 화성시,100004, 98세,2016,24,X,21,14.3,24,X,21,14.3
31240, 화성시,100005, 99세,2016,14,X,10,40,14,X,10,40
31240, 화성시,101,100세이상,2016,30,X,27,11.1,30,X,27,11.1
31240, 화성시,102,15세미만,2016,127046,64956,62090,104.6,126182,64521,61661,104.6
31240, 화성시,103,15~64세,2016,477018,258358,218660,118.2,435347,228177,207170,110.1
31240, 화성시,104,65세이상,2016,51286,21979,29307,75,50564,21625,28939,74.7
31240, 화성시,086,85세이상,2016,4246,1050,3196,32.9,4212,1040,3172,32.8
31240, 화성시,126,평균연령,2016,35.9,35.4,36.5,,35.9,35.4,36.4,
31240, 화성시,127,중위연령,2016,36.6,36.3,36.9,,36.9,36.9,36.9,
31250, 광주시,000,합계,2016,322302,167206,155096,107.8,307355,157014,150341,104.4
31250, 광주시,005,0~4세,2016,17434,8993,8441,106.5,17274,8920,8354,106.8
31250, 광주시,005001, 0세,2016,3325,1718,1607,106.9,3289,1704,1585,107.5
31250, 광주시,005002, 1세,2016,3540,1855,1685,110.1,3508,1840,1668,110.3
31250, 광주시,005003, 2세,2016,3506,1804,1702,106,3474,1789,1685,106.2
31250, 광주시,005004, 3세,2016,3381,1691,1690,100.1,3355,1678,1677,100.1
31250, 광주시,005005, 4세,2016,3682,1925,1757,109.6,3648,1909,1739,109.8
31250, 광주시,010,5~9세,2016,15940,8111,7829,103.6,15841,8062,7779,103.6
31250, 광주시,010001, 5세,2016,3513,1795,1718,104.5,3488,1780,1708,104.2
31250, 광주시,010002, 6세,2016,3180,1630,1550,105.2,3154,1618,1536,105.3
31250, 광주시,010003, 7세,2016,2935,1519,1416,107.3,2921,1514,1407,107.6
31250, 광주시,010004, 8세,2016,3163,1590,1573,101.1,3140,1578,1562,101
31250, 광주시,010005, 9세,2016,3149,1577,1572,100.3,3138,1572,1566,100.4
31250, 광주시,015,10~14세,2016,14444,7410,7034,105.3,14390,7384,7006,105.4
31250, 광주시,015001, 10세,2016,2929,1490,1439,103.5,2922,1488,1434,103.8
31250, 광주시,015002, 11세,2016,2750,1403,1347,104.2,2732,1391,1341,103.7
31250, 광주시,015003, 12세,2016,2892,1498,1394,107.5,2877,1491,1386,107.6
31250, 광주시,015004, 13세,2016,2862,1439,1423,101.1,2856,1436,1420,101.1
31250, 광주시,015005, 14세,2016,3011,1580,1431,110.4,3003,1578,1425,110.7
31250, 광주시,020,15~19세,2016,16940,8694,8246,105.4,16771,8606,8165,105.4
31250, 광주시,020001, 15세,2016,3214,1653,1561,105.9,3206,1649,1557,105.9
31250, 광주시,020002, 16세,2016,3402,1673,1729,96.8,3392,1665,1727,96.4
31250, 광주시,020003, 17세,2016,3366,1729,1637,105.6,3356,1724,1632,105.6
31250, 광주시,020004, 18세,2016,3509,1789,1720,104,3471,1771,1700,104.2
31250, 광주시,020005, 19세,2016,3449,1850,1599,115.7,3346,1797,1549,116
31250, 광주시,025,20~24세,2016,19228,10737,8491,126.5,17499,9432,8067,116.9
31250, 광주시,025001, 20세,2016,3582,1995,1587,125.7,3421,1895,1526,124.2
31250, 광주시,025002, 21세,2016,3724,2125,1599,132.9,3470,1933,1537,125.8
31250, 광주시,025003, 22세,2016,3875,2196,1679,130.8,3552,1945,1607,121
31250, 광주시,025004, 23세,2016,3866,2148,1718,125,3418,1802,1616,111.5
31250, 광주시,025005, 24세,2016,4181,2273,1908,119.1,3638,1857,1781,104.3
31250, 광주시,030,25~29세,2016,20141,11110,9031,123,17167,8919,8248,108.1
31250, 광주시,030001, 25세,2016,3926,2173,1753,124,3426,1795,1631,110.1
31250, 광주시,030002, 26세,2016,3971,2188,1783,122.7,3323,1725,1598,107.9
31250, 광주시,030003, 27세,2016,3958,2193,1765,124.2,3397,1775,1622,109.4
31250, 광주시,030004, 28세,2016,4071,2221,1850,120.1,3414,1754,1660,105.7
31250, 광주시,030005, 29세,2016,4215,2335,1880,124.2,3607,1870,1737,107.7
31250, 광주시,035,30~34세,2016,27078,14665,12413,118.1,24345,12625,11720,107.7
31250, 광주시,035001, 30세,2016,4538,2492,2046,121.8,3990,2096,1894,110.7
31250, 광주시,035002, 31세,2016,4861,2635,2226,118.4,4271,2196,2075,105.8
31250, 광주시,035003, 32세,2016,5234,2835,2399,118.2,4696,2426,2270,106.9
31250, 광주시,035004, 33세,2016,5912,3191,2721,117.3,5379,2788,2591,107.6
31250, 광주시,035005, 34세,2016,6533,3512,3021,116.3,6009,3119,2890,107.9
31250, 광주시,040,35~39세,2016,30330,16366,13964,117.2,28285,14878,13407,111
31250, 광주시,040001, 35세,2016,6569,3577,2992,119.6,6087,3220,2867,112.3
31250, 광주시,040002, 36세,2016,6834,3666,3168,115.7,6391,3355,3036,110.5
31250, 광주시,040003, 37세,2016,6001,3252,2749,118.3,5592,2941,2651,110.9
31250, 광주시,040004, 38세,2016,5437,2869,2568,111.7,5053,2596,2457,105.7
31250, 광주시,040005, 39세,2016,5489,3002,2487,120.7,5162,2766,2396,115.4
31250, 광주시,045,40~44세,2016,28193,15118,13075,115.6,26860,14205,12655,112.2
31250, 광주시,045001, 40세,2016,5415,2936,2479,118.4,5128,2728,2400,113.7
31250, 광주시,045002, 41세,2016,5492,2942,2550,115.4,5221,2753,2468,111.5
31250, 광주시,045003, 42세,2016,5688,3009,2679,112.3,5431,2831,2600,108.9
31250, 광주시,045004, 43세,2016,5780,3075,2705,113.7,5515,2906,2609,111.4
31250, 광주시,045005, 44세,2016,5818,3156,2662,118.6,5565,2987,2578,115.9
31250, 광주시,050,45~49세,2016,28268,14844,13424,110.6,27173,14159,13014,108.8
31250, 광주시,050001, 45세,2016,6005,3182,2823,112.7,5786,3033,2753,110.2
31250, 광주시,050002, 46세,2016,5719,3089,2630,117.5,5464,2925,2539,115.2
31250, 광주시,050003, 47세,2016,5777,3063,2714,112.9,5544,2909,2635,110.4
31250, 광주시,050004, 48세,2016,5673,2952,2721,108.5,5470,2838,2632,107.8
31250, 광주시,050005, 49세,2016,5094,2558,2536,100.9,4909,2454,2455,100
31250, 광주시,055,50~54세,2016,25519,13203,12316,107.2,24491,12659,11832,107
31250, 광주시,055001, 50세,2016,5087,2656,2431,109.3,4894,2554,2340,109.1
31250, 광주시,055002, 51세,2016,5254,2753,2501,110.1,5042,2641,2401,110
31250, 광주시,055003, 52세,2016,4852,2486,2366,105.1,4645,2377,2268,104.8
31250, 광주시,055004, 53세,2016,4976,2557,2419,105.7,4735,2428,2307,105.2
31250, 광주시,055005, 54세,2016,5350,2751,2599,105.8,5175,2659,2516,105.7
31250, 광주시,060,55~59세,2016,25709,12888,12821,100.5,25012,12523,12489,100.3
31250, 광주시,060001, 55세,2016,5526,2738,2788,98.2,5395,2673,2722,98.2
31250, 광주시,060002, 56세,2016,5494,2753,2741,100.4,5347,2672,2675,99.9
31250, 광주시,060003, 57세,2016,5085,2533,2552,99.3,4945,2456,2489,98.7
31250, 광주시,060004, 58세,2016,4902,2474,2428,101.9,4756,2403,2353,102.1
31250, 광주시,060005, 59세,2016,4702,2390,2312,103.4,4569,2319,2250,103.1
31250, 광주시,065,60~64세,2016,18951,9579,9372,102.2,18465,9323,9142,102
31250, 광주시,065001, 60세,2016,4258,2148,2110,101.8,4166,2109,2057,102.5
31250, 광주시,065002, 61세,2016,4385,2192,2193,100,4271,2127,2144,99.2
31250, 광주시,065003, 62세,2016,3680,1891,1789,105.7,3570,1826,1744,104.7
31250, 광주시,065004, 63세,2016,3194,1595,1599,99.7,3101,1542,1559,98.9
31250, 광주시,065005, 64세,2016,3434,1753,1681,104.3,3357,1719,1638,104.9
31250, 광주시,070,65~69세,2016,12318,6147,6171,99.6,12113,6043,6070,99.6
31250, 광주시,070001, 65세,2016,2362,1174,1188,98.8,2310,1151,1159,99.3
31250, 광주시,070002, 66세,2016,2484,1228,1256,97.8,2435,1201,1234,97.3
31250, 광주시,070003, 67세,2016,2544,1248,1296,96.3,2505,1228,1277,96.2
31250, 광주시,070004, 68세,2016,2451,1244,1207,103.1,2419,1228,1191,103.1
31250, 광주시,070005, 69세,2016,2477,1253,1224,102.4,2444,1235,1209,102.2
31250, 광주시,075,70~74세,2016,8983,4396,4587,95.8,8906,4357,4549,95.8
31250, 광주시,075001, 70세,2016,1897,909,988,92,1873,900,973,92.5
31250, 광주시,075002, 71세,2016,1743,900,843,106.8,1725,888,837,106.1
31250, 광주시,075003, 72세,2016,1708,828,880,94.1,1698,825,873,94.5
31250, 광주시,075004, 73세,2016,1699,837,862,97.1,1684,828,856,96.7
31250, 광주시,075005, 74세,2016,1936,922,1014,90.9,1926,916,1010,90.7
31250, 광주시,080,75~79세,2016,6485,2879,3606,79.8,6448,2865,3583,80
31250, 광주시,080001, 75세,2016,1580,725,855,84.8,1573,721,852,84.6
31250, 광주시,080002, 76세,2016,1386,623,763,81.7,1380,619,761,81.3
31250, 광주시,080003, 77세,2016,1287,577,710,81.3,1280,574,706,81.3
31250, 광주시,080004, 78세,2016,1188,507,681,74.4,1176,505,671,75.3
31250, 광주시,080005, 79세,2016,1044,447,597,74.9,1039,446,593,75.2
31250, 광주시,085,80~84세,2016,3803,1415,2388,59.3,3790,1410,2380,59.2
31250, 광주시,085001, 80세,2016,949,409,540,75.7,946,408,538,75.8
31250, 광주시,085002, 81세,2016,915,326,589,55.3,914,326,588,55.4
31250, 광주시,085003, 82세,2016,737,283,454,62.3,734,281,453,62
31250, 광주시,085004, 83세,2016,659,225,434,51.8,655,224,431,52
31250, 광주시,085005, 84세,2016,543,172,371,46.4,541,171,370,46.2
31250, 광주시,090,85~89세,2016,1739,480,1259,38.1,1731,475,1256,37.8
31250, 광주시,090001, 85세,2016,410,128,282,45.4,409,127,282,45
31250, 광주시,090002, 86세,2016,444,134,310,43.2,440,131,309,42.4
31250, 광주시,090003, 87세,2016,358,104,254,40.9,356,103,253,40.7
31250, 광주시,090004, 88세,2016,286,63,223,28.3,286,63,223,28.3
31250, 광주시,090005, 89세,2016,241,51,190,26.8,240,51,189,27
31250, 광주시,095,90~94세,2016,654,134,520,25.8,649,132,517,25.5
31250, 광주시,095001, 90세,2016,185,47,138,34.1,182,46,136,33.8
31250, 광주시,095002, 91세,2016,131,24,107,22.4,130,23,107,21.5
31250, 광주시,095003, 92세,2016,123,22,101,21.8,123,22,101,21.8
31250, 광주시,095004, 93세,2016,127,26,101,25.7,127,26,101,25.7
31250, 광주시,095005, 94세,2016,88,15,73,20.5,87,15,72,20.8
31250, 광주시,100,95~99세,2016,128,36,92,39.1,128,36,92,39.1
31250, 광주시,100001, 95세,2016,41,13,28,46.4,41,13,28,46.4
31250, 광주시,100002, 96세,2016,38,12,26,46.2,38,12,26,46.2
31250, 광주시,100003, 97세,2016,21,6,15,40,21,6,15,40
31250, 광주시,100004, 98세,2016,18,X,16,12.5,18,X,16,12.5
31250, 광주시,100005, 99세,2016,10,X,7,42.9,10,X,7,42.9
31250, 광주시,101,100세이상,2016,17,X,16,6.3,17,X,16,6.3
31250, 광주시,102,15세미만,2016,47818,24514,23304,105.2,47505,24366,23139,105.3
31250, 광주시,103,15~64세,2016,240357,127204,113153,112.4,226068,117329,108739,107.9
31250, 광주시,104,65세이상,2016,34127,15488,18639,83.1,33782,15319,18463,83
31250, 광주시,086,85세이상,2016,2538,651,1887,34.5,2525,644,1881,34.2
31250, 광주시,126,평균연령,2016,39.4,38.7,40.2,,39.6,38.9,40.2,
31250, 광주시,127,중위연령,2016,39.9,39.2,40.8,,40.4,39.9,41,
31260, 양주시,000,합계,2016,207009,106410,100599,105.8,197306,99290,98016,101.3
31260, 양주시,005,0~4세,2016,9352,4771,4581,104.1,9294,4739,4555,104
31260, 양주시,005001, 0세,2016,1558,795,763,104.2,1544,789,755,104.5
31260, 양주시,005002, 1세,2016,1781,940,841,111.8,1767,931,836,111.4
31260, 양주시,005003, 2세,2016,1843,938,905,103.6,1832,933,899,103.8
31260, 양주시,005004, 3세,2016,1902,956,946,101.1,1897,953,944,101
31260, 양주시,005005, 4세,2016,2268,1142,1126,101.4,2254,1133,1121,101.1
31260, 양주시,010,5~9세,2016,11029,5620,5409,103.9,10967,5592,5375,104
31260, 양주시,010001, 5세,2016,2177,1111,1066,104.2,2159,1103,1056,104.5
31260, 양주시,010002, 6세,2016,2144,1061,1083,98,2125,1053,1072,98.2
31260, 양주시,010003, 7세,2016,2132,1096,1036,105.8,2125,1093,1032,105.9
31260, 양주시,010004, 8세,2016,2248,1143,1105,103.4,2237,1137,1100,103.4
31260, 양주시,010005, 9세,2016,2328,1209,1119,108,2321,1206,1115,108.2
31260, 양주시,015,10~14세,2016,10988,5699,5289,107.8,10950,5678,5272,107.7
31260, 양주시,015001, 10세,2016,2149,1115,1034,107.8,2142,1111,1031,107.8
31260, 양주시,015002, 11세,2016,2116,1135,981,115.7,2108,1132,976,116
31260, 양주시,015003, 12세,2016,2243,1169,1074,108.8,2239,1167,1072,108.9
31260, 양주시,015004, 13세,2016,2208,1074,1134,94.7,2197,1067,1130,94.4
31260, 양주시,015005, 14세,2016,2272,1206,1066,113.1,2264,1201,1063,113
31260, 양주시,020,15~19세,2016,12373,6194,6179,100.2,12299,6158,6141,100.3
31260, 양주시,020001, 15세,2016,2500,1252,1248,100.3,2493,1250,1243,100.6
31260, 양주시,020002, 16세,2016,2496,1259,1237,101.8,2478,1250,1228,101.8
31260, 양주시,020003, 17세,2016,2646,1346,1300,103.5,2635,1340,1295,103.5
31260, 양주시,020004, 18세,2016,2399,1205,1194,100.9,2389,1200,1189,100.9
31260, 양주시,020005, 19세,2016,2332,1132,1200,94.3,2304,1118,1186,94.3
31260, 양주시,025,20~24세,2016,12638,6968,5670,122.9,11640,6173,5467,112.9
31260, 양주시,025001, 20세,2016,2421,1308,1113,117.5,2361,1262,1099,114.8
31260, 양주시,025002, 21세,2016,2490,1368,1122,121.9,2378,1278,1100,116.2
31260, 양주시,025003, 22세,2016,2526,1384,1142,121.2,2340,1243,1097,113.3
31260, 양주시,025004, 23세,2016,2537,1429,1108,129,2259,1200,1059,113.3
31260, 양주시,025005, 24세,2016,2664,1479,1185,124.8,2302,1190,1112,107
31260, 양주시,030,25~29세,2016,12022,7082,4940,143.4,9860,5312,4548,116.8
31260, 양주시,030001, 25세,2016,2613,1524,1089,139.9,2231,1207,1024,117.9
31260, 양주시,030002, 26세,2016,2487,1485,1002,148.2,2039,1115,924,120.7
31260, 양주시,030003, 27세,2016,2292,1344,948,141.8,1855,992,863,114.9
31260, 양주시,030004, 28세,2016,2352,1392,960,145,1899,1025,874,117.3
31260, 양주시,030005, 29세,2016,2278,1337,941,142.1,1836,973,863,112.7
31260, 양주시,035,30~34세,2016,13187,7307,5880,124.3,11276,5820,5456,106.7
31260, 양주시,035001, 30세,2016,2394,1375,1019,134.9,1977,1043,934,111.7
31260, 양주시,035002, 31세,2016,2320,1303,1017,128.1,1906,983,923,106.5
31260, 양주시,035003, 32세,2016,2554,1430,1124,127.2,2156,1114,1042,106.9
31260, 양주시,035004, 33세,2016,2805,1566,1239,126.4,2451,1292,1159,111.5
31260, 양주시,035005, 34세,2016,3114,1633,1481,110.3,2786,1388,1398,99.3
31260, 양주시,040,35~39세,2016,16278,8368,7910,105.8,14948,7386,7562,97.7
31260, 양주시,040001, 35세,2016,3169,1640,1529,107.3,2884,1435,1449,99
31260, 양주시,040002, 36세,2016,3514,1818,1696,107.2,3201,1581,1620,97.6
31260, 양주시,040003, 37세,2016,3229,1656,1573,105.3,2956,1449,1507,96.2
31260, 양주시,040004, 38세,2016,3164,1638,1526,107.3,2904,1447,1457,99.3
31260, 양주시,040005, 39세,2016,3202,1616,1586,101.9,3003,1474,1529,96.4
31260, 양주시,045,40~44세,2016,19027,9907,9120,108.6,18058,9255,8803,105.1
31260, 양주시,045001, 40세,2016,3372,1719,1653,104,3172,1583,1589,99.6
31260, 양주시,045002, 41세,2016,3608,1860,1748,106.4,3416,1727,1689,102.2
31260, 양주시,045003, 42세,2016,3909,2020,1889,106.9,3723,1898,1825,104
31260, 양주시,045004, 43세,2016,4159,2166,1993,108.7,3974,2045,1929,106
31260, 양주시,045005, 44세,2016,3979,2142,1837,116.6,3773,2002,1771,113
31260, 양주시,050,45~49세,2016,18966,9949,9017,110.3,18173,9400,8773,107.1
31260, 양주시,050001, 45세,2016,3980,2129,1851,115,3812,2003,1809,110.7
31260, 양주시,050002, 46세,2016,3882,2023,1859,108.8,3717,1913,1804,106
31260, 양주시,050003, 47세,2016,3955,2009,1946,103.2,3790,1899,1891,100.4
31260, 양주시,050004, 48세,2016,3732,1973,1759,112.2,3569,1858,1711,108.6
31260, 양주시,050005, 49세,2016,3417,1815,1602,113.3,3285,1727,1558,110.8
31260, 양주시,055,50~54세,2016,16540,8852,7688,115.1,16039,8528,7511,113.5
31260, 양주시,055001, 50세,2016,3310,1727,1583,109.1,3194,1653,1541,107.3
31260, 양주시,055002, 51세,2016,3435,1856,1579,117.5,3329,1784,1545,115.5
31260, 양주시,055003, 52세,2016,3151,1731,1420,121.9,3051,1667,1384,120.4
31260, 양주시,055004, 53세,2016,3322,1766,1556,113.5,3204,1689,1515,111.5
31260, 양주시,055005, 54세,2016,3322,1772,1550,114.3,3261,1735,1526,113.7
31260, 양주시,060,55~59세,2016,16118,8255,7863,105,15762,8030,7732,103.9
31260, 양주시,060001, 55세,2016,3501,1799,1702,105.7,3429,1750,1679,104.2
31260, 양주시,060002, 56세,2016,3463,1763,1700,103.7,3373,1700,1673,101.6
31260, 양주시,060003, 57세,2016,3168,1651,1517,108.8,3101,1611,1490,108.1
31260, 양주시,060004, 58세,2016,3015,1535,1480,103.7,2943,1491,1452,102.7
31260, 양주시,060005, 59세,2016,2971,1507,1464,102.9,2916,1478,1438,102.8
31260, 양주시,065,60~64세,2016,11786,5831,5955,97.9,11545,5711,5834,97.9
31260, 양주시,065001, 60세,2016,2705,1370,1335,102.6,2653,1349,1304,103.5
31260, 양주시,065002, 61세,2016,2703,1332,1371,97.2,2653,1304,1349,96.7
31260, 양주시,065003, 62세,2016,2354,1175,1179,99.7,2303,1153,1150,100.3
31260, 양주시,065004, 63세,2016,1946,945,1001,94.4,1904,917,987,92.9
31260, 양주시,065005, 64세,2016,2078,1009,1069,94.4,2032,988,1044,94.6
31260, 양주시,070,65~69세,2016,8412,4043,4369,92.5,8277,3978,4299,92.5
31260, 양주시,070001, 65세,2016,1432,691,741,93.3,1404,678,726,93.4
31260, 양주시,070002, 66세,2016,1655,790,865,91.3,1624,775,849,91.3
31260, 양주시,070003, 67세,2016,1745,814,931,87.4,1709,793,916,86.6
31260, 양주시,070004, 68세,2016,1742,852,890,95.7,1722,846,876,96.6
31260, 양주시,070005, 69세,2016,1838,896,942,95.1,1818,886,932,95.1
31260, 양주시,075,70~74세,2016,7210,3382,3828,88.3,7168,3359,3809,88.2
31260, 양주시,075001, 70세,2016,1433,691,742,93.1,1418,682,736,92.7
31260, 양주시,075002, 71세,2016,1413,681,732,93,1402,677,725,93.4
31260, 양주시,075003, 72세,2016,1374,630,744,84.7,1368,626,742,84.4
31260, 양주시,075004, 73세,2016,1397,656,741,88.5,1393,653,740,88.2
31260, 양주시,075005, 74세,2016,1593,724,869,83.3,1587,721,866,83.3
31260, 양주시,080,75~79세,2016,5506,2365,3141,75.3,5489,2360,3129,75.4
31260, 양주시,080001, 75세,2016,1300,567,733,77.4,1298,566,732,77.3
31260, 양주시,080002, 76세,2016,1124,505,619,81.6,1120,504,616,81.8
31260, 양주시,080003, 77세,2016,1074,444,630,70.5,1072,444,628,70.7
31260, 양주시,080004, 78세,2016,1060,441,619,71.2,1055,439,616,71.3
31260, 양주시,080005, 79세,2016,948,408,540,75.6,944,407,537,75.8
31260, 양주시,085,80~84세,2016,3375,1248,2127,58.7,3367,1246,2121,58.7
31260, 양주시,085001, 80세,2016,837,327,510,64.1,836,326,510,63.9
31260, 양주시,085002, 81세,2016,816,323,493,65.5,813,323,490,65.9
31260, 양주시,085003, 82세,2016,672,253,419,60.4,672,253,419,60.4
31260, 양주시,085004, 83세,2016,577,191,386,49.5,573,190,383,49.6
31260, 양주시,085005, 84세,2016,473,154,319,48.3,473,154,319,48.3
31260, 양주시,090,85~89세,2016,1489,424,1065,39.8,1485,422,1063,39.7
31260, 양주시,090001, 85세,2016,374,110,264,41.7,372,108,264,40.9
31260, 양주시,090002, 86세,2016,330,94,236,39.8,330,94,236,39.8
31260, 양주시,090003, 87세,2016,326,94,232,40.5,326,94,232,40.5
31260, 양주시,090004, 88세,2016,278,78,200,39,276,78,198,39.4
31260, 양주시,090005, 89세,2016,181,48,133,36.1,181,48,133,36.1
31260, 양주시,095,90~94세,2016,567,119,448,26.6,565,118,447,26.4
31260, 양주시,095001, 90세,2016,158,25,133,18.8,157,25,132,18.9
31260, 양주시,095002, 91세,2016,128,32,96,33.3,128,32,96,33.3
31260, 양주시,095003, 92세,2016,116,24,92,26.1,116,24,92,26.1
31260, 양주시,095004, 93세,2016,102,21,81,25.9,102,21,81,25.9
31260, 양주시,095005, 94세,2016,63,17,46,37,62,16,46,34.8
31260, 양주시,100,95~99세,2016,130,22,108,20.4,129,22,107,20.6
31260, 양주시,100001, 95세,2016,46,8,38,21.1,46,8,38,21.1
31260, 양주시,100002, 96세,2016,35,7,28,25,35,7,28,25
31260, 양주시,100003, 97세,2016,28,6,22,27.3,28,6,22,27.3
31260, 양주시,100004, 98세,2016,15,X,14,7.1,15,X,14,7.1
31260, 양주시,100005, 99세,2016,6,X,6,0,5,X,5,0
31260, 양주시,101,100세이상,2016,16,X,12,33.3,15,X,12,25
31260, 양주시,102,15세미만,2016,31369,16090,15279,105.3,31211,16009,15202,105.3
31260, 양주시,103,15~64세,2016,148935,78713,70222,112.1,139600,71773,67827,105.8
31260, 양주시,104,65세이상,2016,26705,11607,15098,76.9,26495,11508,14987,76.8
31260, 양주시,086,85세이상,2016,2202,569,1633,34.8,2194,565,1629,34.7
31260, 양주시,126,평균연령,2016,40.3,39.4,41.3,,40.5,39.7,41.4,
31260, 양주시,127,중위연령,2016,41.6,40.7,42.6,,42.2,41.7,42.7,
31270, 포천시,000,합계,2016,162698,87938,74760,117.6,146173,75623,70550,107.2
31270, 포천시,005,0~4세,2016,5517,2829,2688,105.2,5435,2784,2651,105
31270, 포천시,005001, 0세,2016,1039,556,483,115.1,1025,547,478,114.4
31270, 포천시,005002, 1세,2016,1109,562,547,102.7,1091,555,536,103.5
31270, 포천시,005003, 2세,2016,1051,535,516,103.7,1039,527,512,102.9
31270, 포천시,005004, 3세,2016,1085,545,540,100.9,1063,533,530,100.6
31270, 포천시,005005, 4세,2016,1233,631,602,104.8,1217,622,595,104.5
31270, 포천시,010,5~9세,2016,6118,3222,2896,111.3,6045,3188,2857,111.6
31270, 포천시,010001, 5세,2016,1190,652,538,121.2,1172,642,530,121.1
31270, 포천시,010002, 6세,2016,1204,609,595,102.4,1186,603,583,103.4
31270, 포천시,010003, 7세,2016,1164,584,580,100.7,1151,578,573,100.9
31270, 포천시,010004, 8세,2016,1248,664,584,113.7,1236,659,577,114.2
31270, 포천시,010005, 9세,2016,1312,713,599,119,1300,706,594,118.9
31270, 포천시,015,10~14세,2016,6581,3420,3161,108.2,6554,3407,3147,108.3
31270, 포천시,015001, 10세,2016,1252,652,600,108.7,1246,649,597,108.7
31270, 포천시,015002, 11세,2016,1192,635,557,114,1188,634,554,114.4
31270, 포천시,015003, 12세,2016,1241,642,599,107.2,1236,638,598,106.7
31270, 포천시,015004, 13세,2016,1453,722,731,98.8,1447,721,726,99.3
31270, 포천시,015005, 14세,2016,1443,769,674,114.1,1437,765,672,113.8
31270, 포천시,020,15~19세,2016,9134,4703,4431,106.1,8993,4627,4366,106
31270, 포천시,020001, 15세,2016,1618,857,761,112.6,1608,851,757,112.4
31270, 포천시,020002, 16세,2016,1709,874,835,104.7,1696,866,830,104.3
31270, 포천시,020003, 17세,2016,1791,943,848,111.2,1775,936,839,111.6
31270, 포천시,020004, 18세,2016,1938,1029,909,113.2,1909,1017,892,114
31270, 포천시,020005, 19세,2016,2078,1000,1078,92.8,2005,957,1048,91.3
31270, 포천시,025,20~24세,2016,12503,7279,5224,139.3,10200,5559,4641,119.8
31270, 포천시,025001, 20세,2016,2285,1184,1101,107.5,2088,1062,1026,103.5
31270, 포천시,025002, 21세,2016,2479,1378,1101,125.2,2132,1131,1001,113
31270, 포천시,025003, 22세,2016,2429,1424,1005,141.7,2016,1114,902,123.5
31270, 포천시,025004, 23세,2016,2617,1622,995,163,1995,1137,858,132.5
31270, 포천시,025005, 24세,2016,2693,1671,1022,163.5,1969,1115,854,130.6
31270, 포천시,030,25~29세,2016,12327,7917,4410,179.5,8153,4551,3602,126.3
31270, 포천시,030001, 25세,2016,2697,1742,955,182.4,1872,1069,803,133.1
31270, 포천시,030002, 26세,2016,2568,1580,988,159.9,1720,909,811,112.1
31270, 포천시,030003, 27세,2016,2420,1578,842,187.4,1574,886,688,128.8
31270, 포천시,030004, 28세,2016,2358,1545,813,190,1524,875,649,134.8
31270, 포천시,030005, 29세,2016,2284,1472,812,181.3,1463,812,651,124.7
31270, 포천시,035,30~34세,2016,11051,6839,4212,162.4,7762,4245,3517,120.7
31270, 포천시,035001, 30세,2016,2277,1467,810,181.1,1474,823,651,126.4
31270, 포천시,035002, 31세,2016,2146,1367,779,175.5,1456,808,648,124.7
31270, 포천시,035003, 32세,2016,2082,1299,783,165.9,1460,813,647,125.7
31270, 포천시,035004, 33세,2016,2255,1328,927,143.3,1661,870,791,110
31270, 포천시,035005, 34세,2016,2291,1378,913,150.9,1711,931,780,119.4
31270, 포천시,040,35~39세,2016,11026,6305,4721,133.6,8857,4637,4220,109.9
31270, 포천시,040001, 35세,2016,2301,1384,917,150.9,1784,976,808,120.8
31270, 포천시,040002, 36세,2016,2222,1282,940,136.4,1804,952,852,111.7
31270, 포천시,040003, 37세,2016,2174,1246,928,134.3,1708,887,821,108
31270, 포천시,040004, 38세,2016,2129,1157,972,119,1743,871,872,99.9
31270, 포천시,040005, 39세,2016,2200,1236,964,128.2,1818,951,867,109.7
31270, 포천시,045,40~44세,2016,12035,6646,5389,123.3,10577,5598,4979,112.4
31270, 포천시,045001, 40세,2016,2188,1202,986,121.9,1836,946,890,106.3
31270, 포천시,045002, 41세,2016,2290,1251,1039,120.4,1988,1032,956,107.9
31270, 포천시,045003, 42세,2016,2482,1405,1077,130.5,2195,1200,995,120.6
31270, 포천시,045004, 43세,2016,2472,1338,1134,118,2222,1162,1060,109.6
31270, 포천시,045005, 44세,2016,2603,1450,1153,125.8,2336,1258,1078,116.7
31270, 포천시,050,45~49세,2016,13713,7428,6285,118.2,12677,6751,5926,113.9
31270, 포천시,050001, 45세,2016,2775,1543,1232,125.2,2542,1379,1163,118.6
31270, 포천시,050002, 46세,2016,2605,1410,1195,118,2365,1246,1119,111.3
31270, 포천시,050003, 47세,2016,2709,1457,1252,116.4,2524,1337,1187,112.6
31270, 포천시,050004, 48세,2016,2941,1574,1367,115.1,2744,1452,1292,112.4
31270, 포천시,050005, 49세,2016,2683,1444,1239,116.5,2502,1337,1165,114.8
31270, 포천시,055,50~54세,2016,14373,7990,6383,125.2,13566,7486,6080,123.1
31270, 포천시,055001, 50세,2016,2852,1612,1240,130,2666,1489,1177,126.5
31270, 포천시,055002, 51세,2016,2930,1630,1300,125.4,2752,1525,1227,124.3
31270, 포천시,055003, 52세,2016,2792,1553,1239,125.3,2624,1446,1178,122.8
31270, 포천시,055004, 53세,2016,2914,1633,1281,127.5,2756,1534,1222,125.5
31270, 포천시,055005, 54세,2016,2885,1562,1323,118.1,2768,1492,1276,116.9
31270, 포천시,060,55~59세,2016,14712,7911,6801,116.3,14225,7614,6611,115.2
31270, 포천시,060001, 55세,2016,3126,1677,1449,115.7,3035,1623,1412,114.9
31270, 포천시,060002, 56세,2016,3162,1721,1441,119.4,3041,1640,1401,117.1
31270, 포천시,060003, 57세,2016,2884,1513,1371,110.4,2787,1460,1327,110
31270, 포천시,060004, 58세,2016,2887,1550,1337,115.9,2805,1501,1304,115.1
31270, 포천시,060005, 59세,2016,2653,1450,1203,120.5,2557,1390,1167,119.1
31270, 포천시,065,60~64세,2016,10069,5373,4696,114.4,9785,5210,4575,113.9
31270, 포천시,065001, 60세,2016,2411,1322,1089,121.4,2340,1283,1057,121.4
31270, 포천시,065002, 61세,2016,2318,1268,1050,120.8,2262,1236,1026,120.5
31270, 포천시,065003, 62세,2016,1989,1022,967,105.7,1923,987,936,105.4
31270, 포천시,065004, 63세,2016,1638,851,787,108.1,1592,822,770,106.8
31270, 포천시,065005, 64세,2016,1713,910,803,113.3,1668,882,786,112.2
31270, 포천시,070,65~69세,2016,6667,3313,3354,98.8,6573,3249,3324,97.7
31270, 포천시,070001, 65세,2016,1098,585,513,114,1080,572,508,112.6
31270, 포천시,070002, 66세,2016,1306,632,674,93.8,1283,615,668,92.1
31270, 포천시,070003, 67세,2016,1447,749,698,107.3,1427,737,690,106.8
31270, 포천시,070004, 68세,2016,1377,701,676,103.7,1359,687,672,102.2
31270, 포천시,070005, 69세,2016,1439,646,793,81.5,1424,638,786,81.2
31270, 포천시,075,70~74세,2016,5920,2650,3270,81,5867,2625,3242,81
31270, 포천시,075001, 70세,2016,1163,550,613,89.7,1147,539,608,88.7
31270, 포천시,075002, 71세,2016,1201,558,643,86.8,1193,556,637,87.3
31270, 포천시,075003, 72세,2016,1085,487,598,81.4,1075,481,594,81
31270, 포천시,075004, 73세,2016,1133,488,645,75.7,1125,485,640,75.8
31270, 포천시,075005, 74세,2016,1338,567,771,73.5,1327,564,763,73.9
31270, 포천시,080,75~79세,2016,5375,2236,3139,71.2,5345,2220,3125,71
31270, 포천시,080001, 75세,2016,1158,492,666,73.9,1150,487,663,73.5
31270, 포천시,080002, 76세,2016,1171,503,668,75.3,1168,501,667,75.1
31270, 포천시,080003, 77세,2016,1135,467,668,69.9,1127,462,665,69.5
31270, 포천시,080004, 78세,2016,989,392,597,65.7,982,389,593,65.6
31270, 포천시,080005, 79세,2016,922,382,540,70.7,918,381,537,70.9
31270, 포천시,085,80~84세,2016,3333,1256,2077,60.5,3324,1254,2070,60.6
31270, 포천시,085001, 80세,2016,826,324,502,64.5,822,323,499,64.7
31270, 포천시,085002, 81세,2016,840,324,516,62.8,837,323,514,62.8
31270, 포천시,085003, 82세,2016,664,252,412,61.2,663,252,411,61.3
31270, 포천시,085004, 83세,2016,552,205,347,59.1,552,205,347,59.1
31270, 포천시,085005, 84세,2016,451,151,300,50.3,450,151,299,50.5
31270, 포천시,090,85~89세,2016,1521,432,1089,39.7,1515,431,1084,39.8
31270, 포천시,090001, 85세,2016,361,129,232,55.6,358,129,229,56.3
31270, 포천시,090002, 86세,2016,403,110,293,37.5,403,110,293,37.5
31270, 포천시,090003, 87세,2016,326,92,234,39.3,324,91,233,39.1
31270, 포천시,090004, 88세,2016,228,49,179,27.4,228,49,179,27.4
31270, 포천시,090005, 89세,2016,203,52,151,34.4,202,52,150,34.7
31270, 포천시,095,90~94세,2016,578,150,428,35,577,150,427,35.1
31270, 포천시,095001, 90세,2016,152,40,112,35.7,152,40,112,35.7
31270, 포천시,095002, 91세,2016,148,34,114,29.8,147,34,113,30.1
31270, 포천시,095003, 92세,2016,99,29,70,41.4,99,29,70,41.4
31270, 포천시,095004, 93세,2016,106,25,81,30.9,106,25,81,30.9
31270, 포천시,095005, 94세,2016,73,22,51,43.1,73,22,51,43.1
31270, 포천시,100,95~99세,2016,134,34,100,34,133,33,100,33
31270, 포천시,100001, 95세,2016,52,12,40,30,52,12,40,30
31270, 포천시,100002, 96세,2016,37,12,25,48,37,12,25,48
31270, 포천시,100003, 97세,2016,20,6,14,42.9,20,6,14,42.9
31270, 포천시,100004, 98세,2016,17,X,15,13.3,16,X,15,6.7
31270, 포천시,100005, 99세,2016,8,X,6,33.3,8,X,6,33.3
31270, 포천시,101,100세이상,2016,11,5,6,83.3,10,X,6,66.7
31270, 포천시,102,15세미만,2016,18216,9471,8745,108.3,18034,9379,8655,108.4
31270, 포천시,103,15~64세,2016,120943,68391,52552,130.1,104795,56278,48517,116
31270, 포천시,104,65세이상,2016,23539,10076,13463,74.8,23344,9966,13378,74.5
31270, 포천시,086,85세이상,2016,2244,621,1623,38.3,2235,618,1617,38.2
31270, 포천시,126,평균연령,2016,42.1,40.8,43.7,,43,41.9,44.2,
31270, 포천시,127,중위연령,2016,43.1,41.2,45.2,,45.2,44.4,46.1,
31280, 여주시,000,합계,2016,110273,56034,54239,103.3,106223,53511,52712,101.5
31280, 여주시,005,0~4세,2016,4254,2259,1995,113.2,4239,2251,1988,113.2
31280, 여주시,005001, 0세,2016,784,409,375,109.1,780,407,373,109.1
31280, 여주시,005002, 1세,2016,824,431,393,109.7,823,430,393,109.4
31280, 여주시,005003, 2세,2016,835,431,404,106.7,832,429,403,106.5
31280, 여주시,005004, 3세,2016,880,494,386,128,878,494,384,128.6
31280, 여주시,005005, 4세,2016,931,494,437,113,926,491,435,112.9
31280, 여주시,010,5~9세,2016,4715,2433,2282,106.6,4700,2424,2276,106.5
31280, 여주시,010001, 5세,2016,985,494,491,100.6,980,490,490,100
31280, 여주시,010002, 6세,2016,919,458,461,99.3,918,457,461,99.1
31280, 여주시,010003, 7세,2016,919,503,416,120.9,917,502,415,121
31280, 여주시,010004, 8세,2016,909,480,429,111.9,907,479,428,111.9
31280, 여주시,010005, 9세,2016,983,498,485,102.7,978,496,482,102.9
31280, 여주시,015,10~14세,2016,4795,2454,2341,104.8,4785,2448,2337,104.7
31280, 여주시,015001, 10세,2016,893,455,438,103.9,893,455,438,103.9
31280, 여주시,015002, 11세,2016,930,484,446,108.5,927,483,444,108.8
31280, 여주시,015003, 12세,2016,988,528,460,114.8,986,527,459,114.8
31280, 여주시,015004, 13세,2016,944,450,494,91.1,944,450,494,91.1
31280, 여주시,015005, 14세,2016,1040,537,503,106.8,1035,533,502,106.2
31280, 여주시,020,15~19세,2016,6620,3361,3259,103.1,6571,3336,3235,103.1
31280, 여주시,020001, 15세,2016,1158,597,561,106.4,1154,594,560,106.1
31280, 여주시,020002, 16세,2016,1336,663,673,98.5,1328,660,668,98.8
31280, 여주시,020003, 17세,2016,1388,697,691,100.9,1385,695,690,100.7
31280, 여주시,020004, 18세,2016,1359,686,673,101.9,1353,684,669,102.2
31280, 여주시,020005, 19세,2016,1379,718,661,108.6,1351,703,648,108.5
31280, 여주시,025,20~24세,2016,6757,3706,3051,121.5,6169,3336,2833,117.8
31280, 여주시,025001, 20세,2016,1352,683,669,102.1,1307,664,643,103.3
31280, 여주시,025002, 21세,2016,1356,788,568,138.7,1274,735,539,136.4
31280, 여주시,025003, 22세,2016,1307,717,590,121.5,1206,646,560,115.4
31280, 여주시,025004, 23세,2016,1325,748,577,129.6,1143,637,506,125.9
31280, 여주시,025005, 24세,2016,1417,770,647,119,1239,654,585,111.8
31280, 여주시,030,25~29세,2016,6228,3559,2669,133.3,5195,2849,2346,121.4
31280, 여주시,030001, 25세,2016,1361,787,574,137.1,1154,637,517,123.2
31280, 여주시,030002, 26세,2016,1305,749,556,134.7,1066,587,479,122.5
31280, 여주시,030003, 27세,2016,1219,727,492,147.8,1015,585,430,136
31280, 여주시,030004, 28세,2016,1210,662,548,120.8,1007,527,480,109.8
31280, 여주시,030005, 29세,2016,1133,634,499,127.1,953,513,440,116.6
31280, 여주시,035,30~34세,2016,6608,3500,3108,112.6,5879,2999,2880,104.1
31280, 여주시,035001, 30세,2016,1206,682,524,130.2,1046,566,480,117.9
31280, 여주시,035002, 31세,2016,1225,658,567,116,1046,548,498,110
31280, 여주시,035003, 32세,2016,1305,725,580,125,1153,608,545,111.6
31280, 여주시,035004, 33세,2016,1325,656,669,98.1,1201,571,630,90.6
31280, 여주시,035005, 34세,2016,1547,779,768,101.4,1433,706,727,97.1
31280, 여주시,040,35~39세,2016,7484,3901,3583,108.9,7048,3628,3420,106.1
31280, 여주시,040001, 35세,2016,1565,832,733,113.5,1453,770,683,112.7
31280, 여주시,040002, 36세,2016,1590,819,771,106.2,1501,764,737,103.7
31280, 여주시,040003, 37세,2016,1484,752,732,102.7,1397,696,701,99.3
31280, 여주시,040004, 38세,2016,1399,744,655,113.6,1323,689,634,108.7
31280, 여주시,040005, 39세,2016,1446,754,692,109,1374,709,665,106.6
31280, 여주시,045,40~44세,2016,7885,4115,3770,109.2,7583,3933,3650,107.8
31280, 여주시,045001, 40세,2016,1431,724,707,102.4,1370,683,687,99.4
31280, 여주시,045002, 41세,2016,1464,742,722,102.8,1401,700,701,99.9
31280, 여주시,045003, 42세,2016,1666,868,798,108.8,1615,839,776,108.1
31280, 여주시,045004, 43세,2016,1699,879,820,107.2,1633,844,789,107
31280, 여주시,045005, 44세,2016,1625,902,723,124.8,1564,867,697,124.4
31280, 여주시,050,45~49세,2016,8916,4679,4237,110.4,8664,4543,4121,110.2
31280, 여주시,050001, 45세,2016,1803,957,846,113.1,1741,919,822,111.8
31280, 여주시,050002, 46세,2016,1713,907,806,112.5,1667,883,784,112.6
31280, 여주시,050003, 47세,2016,1886,980,906,108.2,1834,951,883,107.7
31280, 여주시,050004, 48세,2016,1798,959,839,114.3,1752,935,817,114.4
31280, 여주시,050005, 49세,2016,1716,876,840,104.3,1670,855,815,104.9
31280, 여주시,055,50~54세,2016,9099,4818,4281,112.5,8858,4693,4165,112.7
31280, 여주시,055001, 50세,2016,1767,954,813,117.3,1720,926,794,116.6
31280, 여주시,055002, 51세,2016,1813,950,863,110.1,1757,925,832,111.2
31280, 여주시,055003, 52세,2016,1780,930,850,109.4,1738,909,829,109.7
31280, 여주시,055004, 53세,2016,1809,974,835,116.6,1766,950,816,116.4
31280, 여주시,055005, 54세,2016,1930,1010,920,109.8,1877,983,894,110
31280, 여주시,060,55~59세,2016,9702,4965,4737,104.8,9534,4885,4649,105.1
31280, 여주시,060001, 55세,2016,2141,1112,1029,108.1,2103,1094,1009,108.4
31280, 여주시,060002, 56세,2016,2076,1061,1015,104.5,2041,1042,999,104.3
31280, 여주시,060003, 57세,2016,1842,956,886,107.9,1807,942,865,108.9
31280, 여주시,060004, 58세,2016,1894,957,937,102.1,1867,945,922,102.5
31280, 여주시,060005, 59세,2016,1749,879,870,101,1716,862,854,100.9
31280, 여주시,065,60~64세,2016,8054,4040,4014,100.6,7949,3984,3965,100.5
31280, 여주시,065001, 60세,2016,1794,925,869,106.4,1772,912,860,106
31280, 여주시,065002, 61세,2016,1762,887,875,101.4,1740,873,867,100.7
31280, 여주시,065003, 62세,2016,1509,724,785,92.2,1479,707,772,91.6
31280, 여주시,065004, 63세,2016,1330,656,674,97.3,1316,648,668,97
31280, 여주시,065005, 64세,2016,1659,848,811,104.6,1642,844,798,105.8
31280, 여주시,070,65~69세,2016,5233,2652,2581,102.8,5171,2626,2545,103.2
31280, 여주시,070001, 65세,2016,986,515,471,109.3,973,513,460,111.5
31280, 여주시,070002, 66세,2016,972,483,489,98.8,959,476,483,98.6
31280, 여주시,070003, 67세,2016,1063,522,541,96.5,1049,513,536,95.7
31280, 여주시,070004, 68세,2016,1069,552,517,106.8,1058,549,509,107.9
31280, 여주시,070005, 69세,2016,1143,580,563,103,1132,575,557,103.2
31280, 여주시,075,70~74세,2016,4797,2203,2594,84.9,4773,2196,2577,85.2
31280, 여주시,075001, 70세,2016,896,437,459,95.2,888,435,453,96
31280, 여주시,075002, 71세,2016,918,429,489,87.7,914,428,486,88.1
31280, 여주시,075003, 72세,2016,937,393,544,72.2,933,391,542,72.1
31280, 여주시,075004, 73세,2016,929,430,499,86.2,925,429,496,86.5
31280, 여주시,075005, 74세,2016,1117,514,603,85.2,1113,513,600,85.5
31280, 여주시,080,75~79세,2016,4402,1892,2510,75.4,4391,1888,2503,75.4
31280, 여주시,080001, 75세,2016,1069,486,583,83.4,1067,484,583,83
31280, 여주시,080002, 76세,2016,846,356,490,72.7,844,356,488,73
31280, 여주시,080003, 77세,2016,877,376,501,75,874,375,499,75.2
31280, 여주시,080004, 78세,2016,818,349,469,74.4,817,349,468,74.6
31280, 여주시,080005, 79세,2016,792,325,467,69.6,789,324,465,69.7
31280, 여주시,085,80~84세,2016,2818,1025,1793,57.2,2812,1022,1790,57.1
31280, 여주시,085001, 80세,2016,711,265,446,59.4,709,264,445,59.3
31280, 여주시,085002, 81세,2016,675,258,417,61.9,674,257,417,61.6
31280, 여주시,085003, 82세,2016,553,227,326,69.6,551,227,324,70.1
31280, 여주시,085004, 83세,2016,484,154,330,46.7,483,153,330,46.4
31280, 여주시,085005, 84세,2016,395,121,274,44.2,395,121,274,44.2
31280, 여주시,090,85~89세,2016,1319,361,958,37.7,1316,360,956,37.7
31280, 여주시,090001, 85세,2016,346,108,238,45.4,345,107,238,45
31280, 여주시,090002, 86세,2016,322,94,228,41.2,321,94,227,41.4
31280, 여주시,090003, 87세,2016,279,66,213,31,278,66,212,31.1
31280, 여주시,090004, 88세,2016,226,59,167,35.3,226,59,167,35.3
31280, 여주시,090005, 89세,2016,146,34,112,30.4,146,34,112,30.4
31280, 여주시,095,90~94세,2016,487,94,393,23.9,486,93,393,23.7
31280, 여주시,095001, 90세,2016,138,26,112,23.2,138,26,112,23.2
31280, 여주시,095002, 91세,2016,106,16,90,17.8,106,16,90,17.8
31280, 여주시,095003, 92세,2016,102,22,80,27.5,102,22,80,27.5
31280, 여주시,095004, 93세,2016,80,15,65,23.1,80,15,65,23.1
31280, 여주시,095005, 94세,2016,61,15,46,32.6,60,14,46,30.4
31280, 여주시,100,95~99세,2016,89,14,75,18.7,89,14,75,18.7
31280, 여주시,100001, 95세,2016,40,5,35,14.3,40,5,35,14.3
31280, 여주시,100002, 96세,2016,21,5,16,31.3,21,5,16,31.3
31280, 여주시,100003, 97세,2016,15,X,13,15.4,15,X,13,15.4
31280, 여주시,100004, 98세,2016,8,X,8,0,8,X,8,0
31280, 여주시,100005, 99세,2016,5,X,X,66.7,5,X,X,66.7
31280, 여주시,101,100세이상,2016,11,X,8,37.5,11,X,8,37.5
31280, 여주시,102,15세미만,2016,13764,7146,6618,108,13724,7123,6601,107.9
31280, 여주시,103,15~64세,2016,77353,40644,36709,110.7,73450,38186,35264,108.3
31280, 여주시,104,65세이상,2016,19156,8244,10912,75.5,19049,8202,10847,75.6
31280, 여주시,086,85세이상,2016,1906,472,1434,32.9,1902,470,1432,32.8
31280, 여주시,126,평균연령,2016,43.4,42,44.8,,43.7,42.4,45,
31280, 여주시,127,중위연령,2016,44.9,43.6,46.3,,45.5,44.5,46.7,
31350, 연천군,000,합계,2016,44437,23445,20992,111.7,43189,22581,20608,109.6
31350, 연천군,005,0~4세,2016,1862,927,935,99.1,1857,924,933,99
31350, 연천군,005001, 0세,2016,389,193,196,98.5,388,193,195,99
31350, 연천군,005002, 1세,2016,367,177,190,93.2,365,175,190,92.1
31350, 연천군,005003, 2세,2016,372,180,192,93.8,372,180,192,93.8
31350, 연천군,005004, 3세,2016,379,190,189,100.5,379,190,189,100.5
31350, 연천군,005005, 4세,2016,355,187,168,111.3,353,186,167,111.4
31350, 연천군,010,5~9세,2016,1579,833,746,111.7,1568,829,739,112.2
31350, 연천군,010001, 5세,2016,339,180,159,113.2,334,178,156,114.1
31350, 연천군,010002, 6세,2016,327,168,159,105.7,325,167,158,105.7
31350, 연천군,010003, 7세,2016,287,154,133,115.8,287,154,133,115.8
31350, 연천군,010004, 8세,2016,316,164,152,107.9,315,164,151,108.6
31350, 연천군,010005, 9세,2016,310,167,143,116.8,307,166,141,117.7
31350, 연천군,015,10~14세,2016,1609,864,745,116,1606,862,744,115.9
31350, 연천군,015001, 10세,2016,287,161,126,127.8,287,161,126,127.8
31350, 연천군,015002, 11세,2016,323,161,162,99.4,323,161,162,99.4
31350, 연천군,015003, 12세,2016,313,167,146,114.4,313,167,146,114.4
31350, 연천군,015004, 13세,2016,307,172,135,127.4,306,171,135,126.7
31350, 연천군,015005, 14세,2016,379,203,176,115.3,377,202,175,115.4
31350, 연천군,020,15~19세,2016,2075,1097,978,112.2,2063,1087,976,111.4
31350, 연천군,020001, 15세,2016,462,262,200,131,461,262,199,131.7
31350, 연천군,020002, 16세,2016,450,229,221,103.6,449,228,221,103.2
31350, 연천군,020003, 17세,2016,444,233,211,110.4,442,231,211,109.5
31350, 연천군,020004, 18세,2016,394,210,184,114.1,388,205,183,112
31350, 연천군,020005, 19세,2016,325,163,162,100.6,323,161,162,99.4
31350, 연천군,025,20~24세,2016,2801,1903,898,211.9,2627,1768,859,205.8
31350, 연천군,025001, 20세,2016,377,243,134,181.3,365,234,131,178.6
31350, 연천군,025002, 21세,2016,469,315,154,204.5,437,285,152,187.5
31350, 연천군,025003, 22세,2016,535,349,186,187.6,493,318,175,181.7
31350, 연천군,025004, 23세,2016,643,442,201,219.9,592,406,186,218.3
31350, 연천군,025005, 24세,2016,777,554,223,248.4,740,525,215,244.2
31350, 연천군,030,25~29세,2016,2991,1932,1059,182.4,2719,1729,990,174.6
31350, 연천군,030001, 25세,2016,724,486,238,204.2,667,442,225,196.4
31350, 연천군,030002, 26세,2016,603,415,188,220.7,552,376,176,213.6
31350, 연천군,030003, 27세,2016,589,375,214,175.2,532,334,198,168.7
31350, 연천군,030004, 28세,2016,556,355,201,176.6,503,317,186,170.4
31350, 연천군,030005, 29세,2016,519,301,218,138.1,465,260,205,126.8
31350, 연천군,035,30~34세,2016,2522,1458,1064,137,2326,1321,1005,131.4
31350, 연천군,035001, 30세,2016,535,335,200,167.5,489,302,187,161.5
31350, 연천군,035002, 31세,2016,491,285,206,138.3,450,256,194,132
31350, 연천군,035003, 32세,2016,491,280,211,132.7,456,256,200,128
31350, 연천군,035004, 33세,2016,481,274,207,132.4,448,254,194,130.9
31350, 연천군,035005, 34세,2016,524,284,240,118.3,483,253,230,110
31350, 연천군,040,35~39세,2016,2477,1332,1145,116.3,2322,1209,1113,108.6
31350, 연천군,040001, 35세,2016,556,321,235,136.6,519,292,227,128.6
31350, 연천군,040002, 36세,2016,523,264,259,101.9,488,237,251,94.4
31350, 연천군,040003, 37세,2016,481,252,229,110,451,230,221,104.1
31350, 연천군,040004, 38세,2016,438,236,202,116.8,403,208,195,106.7
31350, 연천군,040005, 39세,2016,479,259,220,117.7,461,242,219,110.5
31350, 연천군,045,40~44세,2016,2699,1547,1152,134.3,2607,1484,1123,132.1
31350, 연천군,045001, 40세,2016,440,249,191,130.4,414,231,183,126.2
31350, 연천군,045002, 41세,2016,509,287,222,129.3,490,273,217,125.8
31350, 연천군,045003, 42세,2016,590,313,277,113,571,303,268,113.1
31350, 연천군,045004, 43세,2016,569,345,224,154,551,332,219,151.6
31350, 연천군,045005, 44세,2016,591,353,238,148.3,581,345,236,146.2
31350, 연천군,050,45~49세,2016,3012,1626,1386,117.3,2904,1564,1340,116.7
31350, 연천군,050001, 45세,2016,597,350,247,141.7,573,337,236,142.8
31350, 연천군,050002, 46세,2016,530,267,263,101.5,507,252,255,98.8
31350, 연천군,050003, 47세,2016,648,367,281,130.6,623,350,273,128.2
31350, 연천군,050004, 48세,2016,625,323,302,107,607,314,293,107.2
31350, 연천군,050005, 49세,2016,612,319,293,108.9,594,311,283,109.9
31350, 연천군,055,50~54세,2016,3571,1946,1625,119.8,3499,1905,1594,119.5
31350, 연천군,055001, 50세,2016,652,361,291,124.1,635,349,286,122
31350, 연천군,055002, 51세,2016,722,394,328,120.1,704,384,320,120
31350, 연천군,055003, 52세,2016,700,382,318,120.1,689,374,315,118.7
31350, 연천군,055004, 53세,2016,748,394,354,111.3,731,387,344,112.5
31350, 연천군,055005, 54세,2016,749,415,334,124.3,740,411,329,124.9
31350, 연천군,060,55~59세,2016,4097,2117,1980,106.9,4041,2090,1951,107.1
31350, 연천군,060001, 55세,2016,794,414,380,108.9,786,411,375,109.6
31350, 연천군,060002, 56세,2016,851,417,434,96.1,834,409,425,96.2
31350, 연천군,060003, 57세,2016,807,431,376,114.6,795,427,368,116
31350, 연천군,060004, 58세,2016,806,417,389,107.2,799,414,385,107.5
31350, 연천군,060005, 59세,2016,839,438,401,109.2,827,429,398,107.8
31350, 연천군,065,60~64세,2016,3359,1710,1649,103.7,3307,1680,1627,103.3
31350, 연천군,065001, 60세,2016,758,375,383,97.9,750,371,379,97.9
31350, 연천군,065002, 61세,2016,804,423,381,111,789,417,372,112.1
31350, 연천군,065003, 62세,2016,688,374,314,119.1,677,367,310,118.4
31350, 연천군,065004, 63세,2016,513,253,260,97.3,504,245,259,94.6
31350, 연천군,065005, 64세,2016,596,285,311,91.6,587,280,307,91.2
31350, 연천군,070,65~69세,2016,2591,1224,1367,89.5,2568,1207,1361,88.7
31350, 연천군,070001, 65세,2016,412,191,221,86.4,404,185,219,84.5
31350, 연천군,070002, 66세,2016,461,220,241,91.3,459,219,240,91.3
31350, 연천군,070003, 67세,2016,555,269,286,94.1,549,265,284,93.3
31350, 연천군,070004, 68세,2016,572,274,298,91.9,566,268,298,89.9
31350, 연천군,070005, 69세,2016,591,270,321,84.1,590,270,320,84.4
31350, 연천군,075,70~74세,2016,2526,1152,1374,83.8,2515,1148,1367,84
31350, 연천군,075001, 70세,2016,499,243,256,94.9,496,242,254,95.3
31350, 연천군,075002, 71세,2016,487,234,253,92.5,487,234,253,92.5
31350, 연천군,075003, 72세,2016,461,220,241,91.3,461,220,241,91.3
31350, 연천군,075004, 73세,2016,477,195,282,69.1,475,194,281,69
31350, 연천군,075005, 74세,2016,602,260,342,76,596,258,338,76.3
31350, 연천군,080,75~79세,2016,2330,963,1367,70.4,2327,961,1366,70.4
31350, 연천군,080001, 75세,2016,526,246,280,87.9,524,244,280,87.1
31350, 연천군,080002, 76세,2016,478,190,288,66,477,190,287,66.2
31350, 연천군,080003, 77세,2016,455,176,279,63.1,455,176,279,63.1
31350, 연천군,080004, 78세,2016,451,194,257,75.5,451,194,257,75.5
31350, 연천군,080005, 79세,2016,420,157,263,59.7,420,157,263,59.7
31350, 연천군,085,80~84세,2016,1431,554,877,63.2,1430,554,876,63.2
31350, 연천군,085001, 80세,2016,335,141,194,72.7,335,141,194,72.7
31350, 연천군,085002, 81세,2016,372,145,227,63.9,371,145,226,64.2
31350, 연천군,085003, 82세,2016,271,102,169,60.4,271,102,169,60.4
31350, 연천군,085004, 83세,2016,229,89,140,63.6,229,89,140,63.6
31350, 연천군,085005, 84세,2016,224,77,147,52.4,224,77,147,52.4
31350, 연천군,090,85~89세,2016,617,186,431,43.2,616,186,430,43.3
31350, 연천군,090001, 85세,2016,139,52,87,59.8,139,52,87,59.8
31350, 연천군,090002, 86세,2016,143,52,91,57.1,143,52,91,57.1
31350, 연천군,090003, 87세,2016,140,37,103,35.9,140,37,103,35.9
31350, 연천군,090004, 88세,2016,92,18,74,24.3,91,18,73,24.7
31350, 연천군,090005, 89세,2016,103,27,76,35.5,103,27,76,35.5
31350, 연천군,095,90~94세,2016,223,60,163,36.8,222,59,163,36.2
31350, 연천군,095001, 90세,2016,56,14,42,33.3,56,14,42,33.3
31350, 연천군,095002, 91세,2016,61,14,47,29.8,61,14,47,29.8
31350, 연천군,095003, 92세,2016,41,9,32,28.1,41,9,32,28.1
31350, 연천군,095004, 93세,2016,45,16,29,55.2,44,15,29,51.7
31350, 연천군,095005, 94세,2016,20,7,13,53.8,20,7,13,53.8
31350, 연천군,100,95~99세,2016,58,14,44,31.8,58,14,44,31.8
31350, 연천군,100001, 95세,2016,11,X,8,37.5,11,X,8,37.5
31350, 연천군,100002, 96세,2016,20,7,13,53.8,20,7,13,53.8
31350, 연천군,100003, 97세,2016,13,X,10,30,13,X,10,30
31350, 연천군,100004, 98세,2016,8,X,7,14.3,8,X,7,14.3
31350, 연천군,100005, 99세,2016,6,X,6,0,6,X,6,0
31350, 연천군,101,100세이상,2016,7,X,7,0,7,X,7,0
31350, 연천군,102,15세미만,2016,5050,2624,2426,108.2,5031,2615,2416,108.2
31350, 연천군,103,15~64세,2016,29604,16668,12936,128.8,28415,15837,12578,125.9
31350, 연천군,104,65세이상,2016,9783,4153,5630,73.8,9743,4129,5614,73.5
31350, 연천군,086,85세이상,2016,905,260,645,40.3,903,259,644,40.2
31350, 연천군,126,평균연령,2016,45.5,43.3,47.9,,45.7,43.6,48.1,
31350, 연천군,127,중위연령,2016,47.7,44.5,51.3,,48.3,45.2,51.6,
31370, 가평군,000,합계,2016,59391,30121,29270,102.9,58117,29550,28567,103.4
31370, 가평군,005,0~4세,2016,1893,981,912,107.6,1872,970,902,107.5
31370, 가평군,005001, 0세,2016,363,205,158,129.7,358,204,154,132.5
31370, 가평군,005002, 1세,2016,367,197,170,115.9,362,194,168,115.5
31370, 가평군,005003, 2세,2016,345,171,174,98.3,341,167,174,96
31370, 가평군,005004, 3세,2016,371,197,174,113.2,368,196,172,114
31370, 가평군,005005, 4세,2016,447,211,236,89.4,443,209,234,89.3
31370, 가평군,010,5~9세,2016,2194,1108,1086,102,2159,1091,1068,102.2
31370, 가평군,010001, 5세,2016,459,218,241,90.5,453,216,237,91.1
31370, 가평군,010002, 6세,2016,441,224,217,103.2,432,218,214,101.9
31370, 가평군,010003, 7세,2016,411,209,202,103.5,404,205,199,103
31370, 가평군,010004, 8세,2016,440,232,208,111.5,432,229,203,112.8
31370, 가평군,010005, 9세,2016,443,225,218,103.2,438,223,215,103.7
31370, 가평군,015,10~14세,2016,2299,1224,1075,113.9,2270,1209,1061,113.9
31370, 가평군,015001, 10세,2016,422,233,189,123.3,418,232,186,124.7
31370, 가평군,015002, 11세,2016,437,230,207,111.1,431,225,206,109.2
31370, 가평군,015003, 12세,2016,455,233,222,105,448,230,218,105.5
31370, 가평군,015004, 13세,2016,447,249,198,125.8,444,248,196,126.5
31370, 가평군,015005, 14세,2016,538,279,259,107.7,529,274,255,107.5
31370, 가평군,020,15~19세,2016,3181,1546,1635,94.6,3155,1536,1619,94.9
31370, 가평군,020001, 15세,2016,752,346,406,85.2,745,342,403,84.9
31370, 가평군,020002, 16세,2016,675,320,355,90.1,669,317,352,90.1
31370, 가평군,020003, 17세,2016,603,320,283,113.1,598,319,279,114.3
31370, 가평군,020004, 18세,2016,586,288,298,96.6,583,287,296,97
31370, 가평군,020005, 19세,2016,565,272,293,92.8,560,271,289,93.8
31370, 가평군,025,20~24세,2016,3092,1763,1329,132.7,2976,1699,1277,133
31370, 가평군,025001, 20세,2016,656,368,288,127.8,645,360,285,126.3
31370, 가평군,025002, 21세,2016,603,368,235,156.6,591,359,232,154.7
31370, 가평군,025003, 22세,2016,546,337,209,161.2,524,324,200,162
31370, 가평군,025004, 23세,2016,634,343,291,117.9,598,329,269,122.3
31370, 가평군,025005, 24세,2016,653,347,306,113.4,618,327,291,112.4
31370, 가평군,030,25~29세,2016,2937,1681,1256,133.8,2756,1592,1164,136.8
31370, 가평군,030001, 25세,2016,626,355,271,131,593,339,254,133.5
31370, 가평군,030002, 26세,2016,561,328,233,140.8,529,313,216,144.9
31370, 가평군,030003, 27세,2016,596,341,255,133.7,551,322,229,140.6
31370, 가평군,030004, 28세,2016,559,328,231,142,525,309,216,143.1
31370, 가평군,030005, 29세,2016,595,329,266,123.7,558,309,249,124.1
31370, 가평군,035,30~34세,2016,2914,1537,1377,111.6,2761,1476,1285,114.9
31370, 가평군,035001, 30세,2016,543,285,258,110.5,503,271,232,116.8
31370, 가평군,035002, 31세,2016,571,297,274,108.4,536,283,253,111.9
31370, 가평군,035003, 32세,2016,538,295,243,121.4,508,284,224,126.8
31370, 가평군,035004, 33세,2016,606,331,275,120.4,582,317,265,119.6
31370, 가평군,035005, 34세,2016,656,329,327,100.6,632,321,311,103.2
31370, 가평군,040,35~39세,2016,3337,1765,1572,112.3,3238,1724,1514,113.9
31370, 가평군,040001, 35세,2016,672,357,315,113.3,655,350,305,114.8
31370, 가평군,040002, 36세,2016,675,334,341,97.9,658,328,330,99.4
31370, 가평군,040003, 37세,2016,662,358,304,117.8,637,347,290,119.7
31370, 가평군,040004, 38세,2016,674,358,316,113.3,653,351,302,116.2
31370, 가평군,040005, 39세,2016,654,358,296,120.9,635,348,287,121.3
31370, 가평군,045,40~44세,2016,3842,2096,1746,120,3744,2055,1689,121.7
31370, 가평군,045001, 40세,2016,665,331,334,99.1,648,325,323,100.6
31370, 가평군,045002, 41세,2016,748,393,355,110.7,726,385,341,112.9
31370, 가평군,045003, 42세,2016,794,429,365,117.5,776,421,355,118.6
31370, 가평군,045004, 43세,2016,778,452,326,138.7,760,446,314,142
31370, 가평군,045005, 44세,2016,857,491,366,134.2,834,478,356,134.3
31370, 가평군,050,45~49세,2016,4541,2373,2168,109.5,4416,2325,2091,111.2
31370, 가평군,050001, 45세,2016,860,462,398,116.1,833,451,382,118.1
31370, 가평군,050002, 46세,2016,897,447,450,99.3,873,437,436,100.2
31370, 가평군,050003, 47세,2016,970,536,434,123.5,948,527,421,125.2
31370, 가평군,050004, 48세,2016,919,476,443,107.4,890,465,425,109.4
31370, 가평군,050005, 49세,2016,895,452,443,102,872,445,427,104.2
31370, 가평군,055,50~54세,2016,5137,2737,2400,114,5003,2686,2317,115.9
31370, 가평군,055001, 50세,2016,956,524,432,121.3,930,514,416,123.6
31370, 가평군,055002, 51세,2016,1011,534,477,111.9,981,526,455,115.6
31370, 가평군,055003, 52세,2016,1012,536,476,112.6,988,524,464,112.9
31370, 가평군,055004, 53세,2016,1055,566,489,115.7,1021,553,468,118.2
31370, 가평군,055005, 54세,2016,1103,577,526,109.7,1083,569,514,110.7
31370, 가평군,060,55~59세,2016,5971,3054,2917,104.7,5879,3013,2866,105.1
31370, 가평군,060001, 55세,2016,1192,600,592,101.4,1174,596,578,103.1
31370, 가평군,060002, 56세,2016,1275,625,650,96.2,1251,617,634,97.3
31370, 가평군,060003, 57세,2016,1174,608,566,107.4,1164,603,561,107.5
31370, 가평군,060004, 58세,2016,1183,610,573,106.5,1163,597,566,105.5
31370, 가평군,060005, 59세,2016,1147,611,536,114,1127,600,527,113.9
31370, 가평군,065,60~64세,2016,5281,2696,2585,104.3,5198,2654,2544,104.3
31370, 가평군,065001, 60세,2016,1169,615,554,111,1150,604,546,110.6
31370, 가평군,065002, 61세,2016,1178,592,586,101,1159,586,573,102.3
31370, 가평군,065003, 62세,2016,1035,513,522,98.3,1023,505,518,97.5
31370, 가평군,065004, 63세,2016,915,475,440,108,895,465,430,108.1
31370, 가평군,065005, 64세,2016,984,501,483,103.7,971,494,477,103.6
31370, 가평군,070,65~69세,2016,3357,1672,1685,99.2,3321,1655,1666,99.3
31370, 가평군,070001, 65세,2016,592,307,285,107.7,583,304,279,109
31370, 가평군,070002, 66세,2016,666,313,353,88.7,655,308,347,88.8
31370, 가평군,070003, 67세,2016,651,317,334,94.9,644,313,331,94.6
31370, 가평군,070004, 68세,2016,707,373,334,111.7,701,369,332,111.1
31370, 가평군,070005, 69세,2016,741,362,379,95.5,738,361,377,95.8
31370, 가평군,075,70~74세,2016,3352,1536,1816,84.6,3333,1525,1808,84.3
31370, 가평군,075001, 70세,2016,632,291,341,85.3,627,289,338,85.5
31370, 가평군,075002, 71세,2016,685,317,368,86.1,681,314,367,85.6
31370, 가평군,075003, 72세,2016,640,310,330,93.9,635,306,329,93
31370, 가평군,075004, 73세,2016,651,277,374,74.1,648,276,372,74.2
31370, 가평군,075005, 74세,2016,744,341,403,84.6,742,340,402,84.6
31370, 가평군,080,75~79세,2016,2926,1274,1652,77.1,2912,1269,1643,77.2
31370, 가평군,080001, 75세,2016,639,284,355,80,636,282,354,79.7
31370, 가평군,080002, 76세,2016,625,280,345,81.2,622,279,343,81.3
31370, 가평군,080003, 77세,2016,632,273,359,76,628,272,356,76.4
31370, 가평군,080004, 78세,2016,515,206,309,66.7,511,205,306,67
31370, 가평군,080005, 79세,2016,515,231,284,81.3,515,231,284,81.3
31370, 가평군,085,80~84세,2016,1938,731,1207,60.6,1929,727,1202,60.5
31370, 가평군,085001, 80세,2016,497,205,292,70.2,496,204,292,69.9
31370, 가평군,085002, 81세,2016,443,175,268,65.3,441,174,267,65.2
31370, 가평군,085003, 82세,2016,378,135,243,55.6,377,134,243,55.1
31370, 가평군,085004, 83세,2016,317,115,202,56.9,315,114,201,56.7
31370, 가평군,085005, 84세,2016,303,101,202,50,300,101,199,50.8
31370, 가평군,090,85~89세,2016,833,258,575,44.9,829,255,574,44.4
31370, 가평군,090001, 85세,2016,207,73,134,54.5,205,72,133,54.1
31370, 가평군,090002, 86세,2016,193,61,132,46.2,192,60,132,45.5
31370, 가평군,090003, 87세,2016,177,47,130,36.2,177,47,130,36.2
31370, 가평군,090004, 88세,2016,148,45,103,43.7,147,44,103,42.7
31370, 가평군,090005, 89세,2016,108,32,76,42.1,108,32,76,42.1
31370, 가평군,095,90~94세,2016,288,74,214,34.6,288,74,214,34.6
31370, 가평군,095001, 90세,2016,85,21,64,32.8,85,21,64,32.8
31370, 가평군,095002, 91세,2016,72,13,59,22,72,13,59,22
31370, 가평군,095003, 92세,2016,47,14,33,42.4,47,14,33,42.4
31370, 가평군,095004, 93세,2016,41,14,27,51.9,41,14,27,51.9
31370, 가평군,095005, 94세,2016,43,12,31,38.7,43,12,31,38.7
31370, 가평군,100,95~99세,2016,71,14,57,24.6,71,14,57,24.6
31370, 가평군,100001, 95세,2016,24,7,17,41.2,24,7,17,41.2
31370, 가평군,100002, 96세,2016,26,X,22,18.2,26,X,22,18.2
31370, 가평군,100003, 97세,2016,8,X,6,33.3,8,X,6,33.3
31370, 가평군,100004, 98세,2016,9,X,8,12.5,9,X,8,12.5
31370, 가평군,100005, 99세,2016,X,X,X,0,X,X,X,0
31370, 가평군,101,100세이상,2016,7,X,6,16.7,7,X,6,16.7
31370, 가평군,102,15세미만,2016,6386,3313,3073,107.8,6301,3270,3031,107.9
31370, 가평군,103,15~64세,2016,40233,21248,18985,111.9,39126,20760,18366,113
31370, 가평군,104,65세이상,2016,12772,5560,7212,77.1,12690,5520,7170,77
31370, 가평군,086,85세이상,2016,1199,347,852,40.7,1195,344,851,40.4
31370, 가평군,126,평균연령,2016,46.5,45.1,47.9,,46.6,45.2,48.1,
31370, 가평군,127,중위연령,2016,49.4,47.8,51.1,,49.7,48,51.4,
31380, 양평군,000,합계,2016,105709,53104,52605,100.9,103717,52190,51527,101.3
31380, 양평군,005,0~4세,2016,3632,1857,1775,104.6,3618,1854,1764,105.1
31380, 양평군,005001, 0세,2016,659,328,331,99.1,658,328,330,99.4
31380, 양평군,005002, 1세,2016,659,344,315,109.2,657,343,314,109.2
31380, 양평군,005003, 2세,2016,730,388,342,113.5,726,386,340,113.5
31380, 양평군,005004, 3세,2016,714,335,379,88.4,711,335,376,89.1
31380, 양평군,005005, 4세,2016,870,462,408,113.2,866,462,404,114.4
31380, 양평군,010,5~9세,2016,4303,2185,2118,103.2,4294,2181,2113,103.2
31380, 양평군,010001, 5세,2016,849,445,404,110.1,846,444,402,110.4
31380, 양평군,010002, 6세,2016,816,406,410,99,816,406,410,99
31380, 양평군,010003, 7세,2016,852,446,406,109.9,851,445,406,109.6
31380, 양평군,010004, 8세,2016,867,439,428,102.6,866,439,427,102.8
31380, 양평군,010005, 9세,2016,919,449,470,95.5,915,447,468,95.5
31380, 양평군,015,10~14세,2016,4351,2351,2000,117.6,4338,2345,1993,117.7
31380, 양평군,015001, 10세,2016,890,475,415,114.5,887,473,414,114.3
31380, 양평군,015002, 11세,2016,799,444,355,125.1,797,443,354,125.1
31380, 양평군,015003, 12세,2016,905,483,422,114.5,903,483,420,115
31380, 양평군,015004, 13세,2016,852,450,402,111.9,851,450,401,112.2
31380, 양평군,015005, 14세,2016,905,499,406,122.9,900,496,404,122.8
31380, 양평군,020,15~19세,2016,5873,3070,2803,109.5,5850,3064,2786,110
31380, 양평군,020001, 15세,2016,1066,557,509,109.4,1064,557,507,109.9
31380, 양평군,020002, 16세,2016,1337,659,678,97.2,1334,659,675,97.6
31380, 양평군,020003, 17세,2016,1204,605,599,101,1198,601,597,100.7
31380, 양평군,020004, 18세,2016,1158,598,560,106.8,1154,598,556,107.6
31380, 양평군,020005, 19세,2016,1108,651,457,142.5,1100,649,451,143.9
31380, 양평군,025,20~24세,2016,5310,2999,2311,129.8,5020,2874,2146,133.9
31380, 양평군,025001, 20세,2016,1035,609,426,143,1011,599,412,145.4
31380, 양평군,025002, 21세,2016,1042,602,440,136.8,1002,584,418,139.7
31380, 양평군,025003, 22세,2016,1042,588,454,129.5,986,562,424,132.5
31380, 양평군,025004, 23세,2016,1040,561,479,117.1,961,531,430,123.5
31380, 양평군,025005, 24세,2016,1151,639,512,124.8,1060,598,462,129.4
31380, 양평군,030,25~29세,2016,5034,2834,2200,128.8,4576,2589,1987,130.3
31380, 양평군,030001, 25세,2016,1072,609,463,131.5,979,552,427,129.3
31380, 양평군,030002, 26세,2016,1085,630,455,138.5,972,571,401,142.4
31380, 양평군,030003, 27세,2016,947,549,398,137.9,872,510,362,140.9
31380, 양평군,030004, 28세,2016,995,532,463,114.9,893,481,412,116.7
31380, 양평군,030005, 29세,2016,935,514,421,122.1,860,475,385,123.4
31380, 양평군,035,30~34세,2016,5078,2684,2394,112.1,4780,2531,2249,112.5
31380, 양평군,035001, 30세,2016,920,489,431,113.5,845,453,392,115.6
31380, 양평군,035002, 31세,2016,950,488,462,105.6,892,460,432,106.5
31380, 양평군,035003, 32세,2016,958,511,447,114.3,899,479,420,114
31380, 양평군,035004, 33세,2016,1079,570,509,112,1019,540,479,112.7
31380, 양평군,035005, 34세,2016,1171,626,545,114.9,1125,599,526,113.9
31380, 양평군,040,35~39세,2016,6119,2983,3136,95.1,5929,2907,3022,96.2
31380, 양평군,040001, 35세,2016,1195,601,594,101.2,1149,584,565,103.4
31380, 양평군,040002, 36세,2016,1307,619,688,90,1271,603,668,90.3
31380, 양평군,040003, 37세,2016,1217,603,614,98.2,1184,590,594,99.3
31380, 양평군,040004, 38세,2016,1196,575,621,92.6,1160,556,604,92.1
31380, 양평군,040005, 39세,2016,1204,585,619,94.5,1165,574,591,97.1
31380, 양평군,045,40~44세,2016,7443,3917,3526,111.1,7287,3845,3442,111.7
31380, 양평군,045001, 40세,2016,1308,689,619,111.3,1281,673,608,110.7
31380, 양평군,045002, 41세,2016,1416,743,673,110.4,1383,725,658,110.2
31380, 양평군,045003, 42세,2016,1517,785,732,107.2,1482,771,711,108.4
31380, 양평군,045004, 43세,2016,1616,829,787,105.3,1587,818,769,106.4
31380, 양평군,045005, 44세,2016,1586,871,715,121.8,1554,858,696,123.3
31380, 양평군,050,45~49세,2016,7897,4117,3780,108.9,7774,4063,3711,109.5
31380, 양평군,050001, 45세,2016,1611,834,777,107.3,1581,818,763,107.2
31380, 양평군,050002, 46세,2016,1581,812,769,105.6,1554,804,750,107.2
31380, 양평군,050003, 47세,2016,1604,865,739,117.1,1582,856,726,117.9
31380, 양평군,050004, 48세,2016,1582,834,748,111.5,1560,825,735,112.2
31380, 양평군,050005, 49세,2016,1519,772,747,103.3,1497,760,737,103.1
31380, 양평군,055,50~54세,2016,8663,4449,4214,105.6,8539,4400,4139,106.3
31380, 양평군,055001, 50세,2016,1646,844,802,105.2,1619,829,790,104.9
31380, 양평군,055002, 51세,2016,1732,899,833,107.9,1709,892,817,109.2
31380, 양평군,055003, 52세,2016,1625,836,789,106,1607,829,778,106.6
31380, 양평군,055004, 53세,2016,1786,931,855,108.9,1758,919,839,109.5
31380, 양평군,055005, 54세,2016,1874,939,935,100.4,1846,931,915,101.7
31380, 양평군,060,55~59세,2016,10455,5233,5222,100.2,10338,5192,5146,100.9
31380, 양평군,060001, 55세,2016,2254,1146,1108,103.4,2233,1140,1093,104.3
31380, 양평군,060002, 56세,2016,2136,1042,1094,95.2,2110,1033,1077,95.9
31380, 양평군,060003, 57세,2016,2037,1008,1029,98,2015,998,1017,98.1
31380, 양평군,060004, 58세,2016,2107,1076,1031,104.4,2085,1068,1017,105
31380, 양평군,060005, 59세,2016,1921,961,960,100.1,1895,953,942,101.2
31380, 양평군,065,60~64세,2016,9142,4457,4685,95.1,9044,4410,4634,95.2
31380, 양평군,065001, 60세,2016,1935,953,982,97,1917,946,971,97.4
31380, 양평군,065002, 61세,2016,1986,967,1019,94.9,1961,953,1008,94.5
31380, 양평군,065003, 62세,2016,1693,808,885,91.3,1674,799,875,91.3
31380, 양평군,065004, 63세,2016,1631,788,843,93.5,1616,781,835,93.5
31380, 양평군,065005, 64세,2016,1897,941,956,98.4,1876,931,945,98.5
31380, 양평군,070,65~69세,2016,6375,3168,3207,98.8,6328,3146,3182,98.9
31380, 양평군,070001, 65세,2016,1112,545,567,96.1,1098,538,560,96.1
31380, 양평군,070002, 66세,2016,1235,591,644,91.8,1226,589,637,92.5
31380, 양평군,070003, 67세,2016,1299,624,675,92.4,1290,620,670,92.5
31380, 양평군,070004, 68세,2016,1312,702,610,115.1,1298,694,604,114.9
31380, 양평군,070005, 69세,2016,1417,706,711,99.3,1416,705,711,99.2
31380, 양평군,075,70~74세,2016,5879,2862,3017,94.9,5869,2858,3011,94.9
31380, 양평군,075001, 70세,2016,1128,583,545,107,1125,581,544,106.8
31380, 양평군,075002, 71세,2016,1161,568,593,95.8,1159,568,591,96.1
31380, 양평군,075003, 72세,2016,1160,577,583,99,1158,577,581,99.3
31380, 양평군,075004, 73세,2016,1131,514,617,83.3,1130,513,617,83.1
31380, 양평군,075005, 74세,2016,1299,620,679,91.3,1297,619,678,91.3
31380, 양평군,080,75~79세,2016,4801,2141,2660,80.5,4788,2139,2649,80.7
31380, 양평군,080001, 75세,2016,1098,505,593,85.2,1095,503,592,85
31380, 양평군,080002, 76세,2016,929,433,496,87.3,927,433,494,87.7
31380, 양평군,080003, 77세,2016,991,427,564,75.7,989,427,562,76
31380, 양평군,080004, 78세,2016,917,400,517,77.4,913,400,513,78
31380, 양평군,080005, 79세,2016,866,376,490,76.7,864,376,488,77
31380, 양평군,085,80~84세,2016,3180,1192,1988,60,3176,1191,1985,60
31380, 양평군,085001, 80세,2016,843,352,491,71.7,841,351,490,71.6
31380, 양평군,085002, 81세,2016,726,266,460,57.8,725,266,459,58
31380, 양평군,085003, 82세,2016,654,255,399,63.9,653,255,398,64.1
31380, 양평군,085004, 83세,2016,525,187,338,55.3,525,187,338,55.3
31380, 양평군,085005, 84세,2016,432,132,300,44,432,132,300,44
31380, 양평군,090,85~89세,2016,1478,418,1060,39.4,1473,414,1059,39.1
31380, 양평군,090001, 85세,2016,378,114,264,43.2,378,114,264,43.2
31380, 양평군,090002, 86세,2016,358,103,255,40.4,356,101,255,39.6
31380, 양평군,090003, 87세,2016,293,83,210,39.5,292,82,210,39
31380, 양평군,090004, 88세,2016,253,65,188,34.6,251,64,187,34.2
31380, 양평군,090005, 89세,2016,196,53,143,37.1,196,53,143,37.1
31380, 양평군,095,90~94세,2016,528,147,381,38.6,528,147,381,38.6
31380, 양평군,095001, 90세,2016,154,41,113,36.3,154,41,113,36.3
31380, 양평군,095002, 91세,2016,126,37,89,41.6,126,37,89,41.6
31380, 양평군,095003, 92세,2016,96,31,65,47.7,96,31,65,47.7
31380, 양평군,095004, 93세,2016,87,23,64,35.9,87,23,64,35.9
31380, 양평군,095005, 94세,2016,65,15,50,30,65,15,50,30
31380, 양평군,100,95~99세,2016,158,37,121,30.6,158,37,121,30.6
31380, 양평군,100001, 95세,2016,60,15,45,33.3,60,15,45,33.3
31380, 양평군,100002, 96세,2016,42,11,31,35.5,42,11,31,35.5
31380, 양평군,100003, 97세,2016,28,5,23,21.7,28,5,23,21.7
31380, 양평군,100004, 98세,2016,21,5,16,31.3,21,5,16,31.3
31380, 양평군,100005, 99세,2016,7,X,6,16.7,7,X,6,16.7
31380, 양평군,101,100세이상,2016,10,X,7,42.9,10,X,7,42.9
31380, 양평군,102,15세미만,2016,12286,6393,5893,108.5,12250,6380,5870,108.7
31380, 양평군,103,15~64세,2016,71014,36743,34271,107.2,69137,35875,33262,107.9
31380, 양평군,104,65세이상,2016,22409,9968,12441,80.1,22330,9935,12395,80.2
31380, 양평군,086,85세이상,2016,2174,605,1569,38.6,2169,601,1568,38.3
31380, 양평군,126,평균연령,2016,45.9,44.5,47.4,,46.1,44.6,47.6,
31380, 양평군,127,중위연령,2016,48.6,47,50.3,,48.9,47.3,50.7,
32,강원도,000,합계,2016,1521751,769461,752290,102.3,1502387,759122,743265,102.1
32,강원도,005,0~4세,2016,56307,28676,27631,103.8,56153,28592,27561,103.7
32,강원도,005001, 0세,2016,10222,5228,4994,104.7,10185,5204,4981,104.5
32,강원도,005002, 1세,2016,10984,5543,5441,101.9,10954,5531,5423,102
32,강원도,005003, 2세,2016,10939,5562,5377,103.4,10918,5554,5364,103.5
32,강원도,005004, 3세,2016,11309,5803,5506,105.4,11284,5787,5497,105.3
32,강원도,005005, 4세,2016,12853,6540,6313,103.6,12812,6516,6296,103.5
32,강원도,010,5~9세,2016,63701,32878,30823,106.7,63520,32790,30730,106.7
32,강원도,010001, 5세,2016,12727,6549,6178,106,12678,6521,6157,105.9
32,강원도,010002, 6세,2016,12561,6461,6100,105.9,12520,6442,6078,106
32,강원도,010003, 7세,2016,12273,6313,5960,105.9,12246,6300,5946,106
32,강원도,010004, 8세,2016,12734,6550,6184,105.9,12702,6540,6162,106.1
32,강원도,010005, 9세,2016,13406,7005,6401,109.4,13374,6987,6387,109.4
32,강원도,015,10~14세,2016,67581,35129,32452,108.2,67469,35073,32396,108.3
32,강원도,015001, 10세,2016,12479,6468,6011,107.6,12453,6459,5994,107.8
32,강원도,015002, 11세,2016,12733,6628,6105,108.6,12711,6619,6092,108.7
32,강원도,015003, 12세,2016,13687,7127,6560,108.6,13665,7115,6550,108.6
32,강원도,015004, 13세,2016,13889,7207,6682,107.9,13871,7197,6674,107.8
32,강원도,015005, 14세,2016,14793,7699,7094,108.5,14769,7683,7086,108.4
32,강원도,020,15~19세,2016,94329,50246,44083,114,93835,50012,43823,114.1
32,강원도,020001, 15세,2016,17042,9012,8030,112.2,17022,9002,8020,112.2
32,강원도,020002, 16세,2016,18434,9780,8654,113,18408,9768,8640,113.1
32,강원도,020003, 17세,2016,18166,9454,8712,108.5,18135,9438,8697,108.5
32,강원도,020004, 18세,2016,19176,10231,8945,114.4,19056,10172,8884,114.5
32,강원도,020005, 19세,2016,21511,11769,9742,120.8,21214,11632,9582,121.4
32,강원도,025,20~24세,2016,109384,62987,46397,135.8,105907,61068,44839,136.2
32,강원도,025001, 20세,2016,21837,11841,9996,118.5,21303,11589,9714,119.3
32,강원도,025002, 21세,2016,21338,11516,9822,117.2,20716,11180,9536,117.2
32,강원도,025003, 22세,2016,21943,12516,9427,132.8,21251,12114,9137,132.6
32,강원도,025004, 23세,2016,22312,13539,8773,154.3,21524,13096,8428,155.4
32,강원도,025005, 24세,2016,21954,13575,8379,162,21113,13089,8024,163.1
32,강원도,030,25~29세,2016,82158,46644,35514,131.3,78496,44637,33859,131.8
32,강원도,030001, 25세,2016,18985,11248,7737,145.4,18208,10838,7370,147.1
32,강원도,030002, 26세,2016,16917,9737,7180,135.6,16119,9312,6807,136.8
32,강원도,030003, 27세,2016,15847,9062,6785,133.6,15139,8640,6499,132.9
32,강원도,030004, 28세,2016,15343,8406,6937,121.2,14637,8040,6597,121.9
32,강원도,030005, 29세,2016,15066,8191,6875,119.1,14393,7807,6586,118.5
32,강원도,035,30~34세,2016,84544,45018,39526,113.9,81620,43336,38284,113.2
32,강원도,035001, 30세,2016,15424,8424,7000,120.3,14762,8061,6701,120.3
32,강원도,035002, 31세,2016,15464,8414,7050,119.3,14818,8048,6770,118.9
32,강원도,035003, 32세,2016,16046,8589,7457,115.2,15492,8259,7233,114.2
32,강원도,035004, 33세,2016,18019,9547,8472,112.7,17451,9216,8235,111.9
32,강원도,035005, 34세,2016,19591,10044,9547,105.2,19097,9752,9345,104.4
32,강원도,040,35~39세,2016,98366,50256,48110,104.5,96444,49084,47360,103.6
32,강원도,040001, 35세,2016,19854,10339,9515,108.7,19404,10063,9341,107.7
32,강원도,040002, 36세,2016,20269,10261,10008,102.5,19837,9986,9851,101.4
32,강원도,040003, 37세,2016,19618,9955,9663,103,19225,9727,9498,102.4
32,강원도,040004, 38세,2016,19086,9725,9361,103.9,18752,9517,9235,103.1
32,강원도,040005, 39세,2016,19539,9976,9563,104.3,19226,9791,9435,103.8
32,강원도,045,40~44세,2016,111842,57895,53947,107.3,110354,57039,53315,107
32,강원도,045001, 40세,2016,19654,10078,9576,105.2,19344,9875,9469,104.3
32,강원도,045002, 41세,2016,21027,10763,10264,104.9,20688,10566,10122,104.4
32,강원도,045003, 42세,2016,23712,12140,11572,104.9,23445,11996,11449,104.8
32,강원도,045004, 43세,2016,24136,12555,11581,108.4,23830,12382,11448,108.2
32,강원도,045005, 44세,2016,23313,12359,10954,112.8,23047,12220,10827,112.9
32,강원도,050,45~49세,2016,126043,65377,60666,107.8,124660,64720,59940,108
32,강원도,050001, 45세,2016,25333,13067,12266,106.5,25041,12922,12119,106.6
32,강원도,050002, 46세,2016,24781,12986,11795,110.1,24469,12830,11639,110.2
32,강원도,050003, 47세,2016,25872,13421,12451,107.8,25591,13294,12297,108.1
32,강원도,050004, 48세,2016,26183,13621,12562,108.4,25902,13487,12415,108.6
32,강원도,050005, 49세,2016,23874,12282,11592,106,23657,12187,11470,106.3
32,강원도,055,50~54세,2016,123781,63750,60031,106.2,122535,63234,59301,106.6
32,강원도,055001, 50세,2016,24453,12868,11585,111.1,24182,12747,11435,111.5
32,강원도,055002, 51세,2016,23329,11727,11602,101.1,23065,11613,11452,101.4
32,강원도,055003, 52세,2016,23679,12286,11393,107.8,23426,12190,11236,108.5
32,강원도,055004, 53세,2016,25325,13039,12286,106.1,25075,12939,12136,106.6
32,강원도,055005, 54세,2016,26995,13830,13165,105.1,26787,13745,13042,105.4
32,강원도,060,55~59세,2016,138849,69577,69272,100.4,137941,69177,68764,100.6
32,강원도,060001, 55세,2016,29867,14933,14934,100,29707,14861,14846,100.1
32,강원도,060002, 56세,2016,29495,14453,15042,96.1,29281,14352,14929,96.1
32,강원도,060003, 57세,2016,26909,13453,13456,100,26718,13377,13341,100.3
32,강원도,060004, 58세,2016,26554,13407,13147,102,26379,13330,13049,102.2
32,강원도,060005, 59세,2016,26024,13331,12693,105,25856,13257,12599,105.2
32,강원도,065,60~64세,2016,106474,53218,53256,99.9,105785,52882,52903,100
32,강원도,065001, 60세,2016,23687,11962,11725,102,23532,11885,11647,102
32,강원도,065002, 61세,2016,23675,11917,11758,101.4,23518,11839,11679,101.4
32,강원도,065003, 62세,2016,20836,10471,10365,101,20700,10396,10304,100.9
32,강원도,065004, 63세,2016,17324,8553,8771,97.5,17208,8507,8701,97.8
32,강원도,065005, 64세,2016,20952,10315,10637,97,20827,10255,10572,97
32,강원도,070,65~69세,2016,69592,33055,36537,90.5,69228,32888,36340,90.5
32,강원도,070001, 65세,2016,12307,5854,6453,90.7,12207,5814,6393,90.9
32,강원도,070002, 66세,2016,13219,6151,7068,87,13144,6117,7027,87
32,강원도,070003, 67세,2016,14098,6801,7297,93.2,14016,6761,7255,93.2
32,강원도,070004, 68세,2016,14925,7064,7861,89.9,14868,7031,7837,89.7
32,강원도,070005, 69세,2016,15043,7185,7858,91.4,14993,7165,7828,91.5
32,강원도,075,70~74세,2016,68911,31046,37865,82,68721,30946,37775,81.9
32,강원도,075001, 70세,2016,12690,5973,6717,88.9,12633,5943,6690,88.8
32,강원도,075002, 71세,2016,13767,6333,7434,85.2,13731,6312,7419,85.1
32,강원도,075003, 72세,2016,13523,6018,7505,80.2,13493,5999,7494,80.1
32,강원도,075004, 73세,2016,13714,6052,7662,79,13683,6038,7645,79
32,강원도,075005, 74세,2016,15217,6670,8547,78,15181,6654,8527,78
32,강원도,080,75~79세,2016,60715,25390,35325,71.9,60625,25352,35273,71.9
32,강원도,080001, 75세,2016,13706,5931,7775,76.3,13683,5923,7760,76.3
32,강원도,080002, 76세,2016,12926,5433,7493,72.5,12907,5421,7486,72.4
32,강원도,080003, 77세,2016,12399,5131,7268,70.6,12388,5127,7261,70.6
32,강원도,080004, 78세,2016,11628,4783,6845,69.9,11610,4777,6833,69.9
32,강원도,080005, 79세,2016,10056,4112,5944,69.2,10037,4104,5933,69.2
32,강원도,085,80~84세,2016,34842,12020,22822,52.7,34797,12005,22792,52.7
32,강원도,085001, 80세,2016,9097,3570,5527,64.6,9087,3566,5521,64.6
32,강원도,085002, 81세,2016,8195,2865,5330,53.8,8187,2863,5324,53.8
32,강원도,085003, 82세,2016,6828,2256,4572,49.3,6813,2250,4563,49.3
32,강원도,085004, 83세,2016,5788,1864,3924,47.5,5781,1862,3919,47.5
32,강원도,085005, 84세,2016,4934,1465,3469,42.2,4929,1464,3465,42.3
32,강원도,090,85~89세,2016,16772,4375,12397,35.3,16755,4368,12387,35.3
32,강원도,090001, 85세,2016,4190,1221,2969,41.1,4188,1219,2969,41.1
32,강원도,090002, 86세,2016,4084,1071,3013,35.5,4077,1069,3008,35.5
32,강원도,090003, 87세,2016,3445,864,2581,33.5,3443,864,2579,33.5
32,강원도,090004, 88세,2016,2762,670,2092,32,2759,669,2090,32
32,강원도,090005, 89세,2016,2291,549,1742,31.5,2288,547,1741,31.4
32,강원도,095,90~94세,2016,6106,1606,4500,35.7,6096,1603,4493,35.7
32,강원도,095001, 90세,2016,1741,396,1345,29.4,1737,395,1342,29.4
32,강원도,095002, 91세,2016,1520,407,1113,36.6,1520,407,1113,36.6
32,강원도,095003, 92세,2016,1148,336,812,41.4,1147,336,811,41.4
32,강원도,095004, 93세,2016,1010,283,727,38.9,1008,282,726,38.8
32,강원도,095005, 94세,2016,687,184,503,36.6,684,183,501,36.5
32,강원도,100,95~99세,2016,1296,289,1007,28.7,1288,287,1001,28.7
32,강원도,100001, 95세,2016,474,93,381,24.4,472,93,379,24.5
32,강원도,100002, 96세,2016,299,78,221,35.3,296,78,218,35.8
32,강원도,100003, 97세,2016,244,63,181,34.8,242,62,180,34.4
32,강원도,100004, 98세,2016,159,28,131,21.4,159,28,131,21.4
32,강원도,100005, 99세,2016,120,27,93,29,119,26,93,28
32,강원도,101,100세이상,2016,158,29,129,22.5,158,29,129,22.5
32,강원도,102,15세미만,2016,187589,96683,90906,106.4,187142,96455,90687,106.4
32,강원도,103,15~64세,2016,1075770,564968,510802,110.6,1057577,555189,502388,110.5
32,강원도,104,65세이상,2016,258392,107810,150582,71.6,257668,107478,150190,71.6
32,강원도,086,85세이상,2016,24332,6299,18033,34.9,24297,6287,18010,34.9
32,강원도,126,평균연령,2016,43.1,41.5,44.8,,43.2,41.6,44.8,
32,강원도,127,중위연령,2016,44.7,43,46.5,,44.9,43.2,46.6,
32004, 읍부,000,합계,2016,262715,134992,127723,105.7,258876,132841,126035,105.4
32004, 읍부,005,0~4세,2016,9847,5028,4819,104.3,9828,5017,4811,104.3
32004, 읍부,005001, 0세,2016,1836,950,886,107.2,1834,949,885,107.2
32004, 읍부,005002, 1세,2016,1983,1006,977,103,1979,1004,975,103
32004, 읍부,005003, 2세,2016,1895,973,922,105.5,1892,972,920,105.7
32004, 읍부,005004, 3세,2016,1922,969,953,101.7,1919,966,953,101.4
32004, 읍부,005005, 4세,2016,2211,1130,1081,104.5,2204,1126,1078,104.5
32004, 읍부,010,5~9세,2016,10900,5672,5228,108.5,10876,5662,5214,108.6
32004, 읍부,010001, 5세,2016,2184,1120,1064,105.3,2178,1115,1063,104.9
32004, 읍부,010002, 6세,2016,2150,1120,1030,108.7,2146,1119,1027,109
32004, 읍부,010003, 7세,2016,2091,1105,986,112.1,2088,1105,983,112.4
32004, 읍부,010004, 8세,2016,2237,1166,1071,108.9,2230,1164,1066,109.2
32004, 읍부,010005, 9세,2016,2238,1161,1077,107.8,2234,1159,1075,107.8
32004, 읍부,015,10~14세,2016,11358,5886,5472,107.6,11351,5881,5470,107.5
32004, 읍부,015001, 10세,2016,2185,1141,1044,109.3,2183,1139,1044,109.1
32004, 읍부,015002, 11세,2016,2192,1156,1036,111.6,2190,1155,1035,111.6
32004, 읍부,015003, 12세,2016,2205,1129,1076,104.9,2205,1129,1076,104.9
32004, 읍부,015004, 13세,2016,2281,1168,1113,104.9,2280,1167,1113,104.9
32004, 읍부,015005, 14세,2016,2495,1292,1203,107.4,2493,1291,1202,107.4
32004, 읍부,020,15~19세,2016,15603,8171,7432,109.9,15581,8164,7417,110.1
32004, 읍부,020001, 15세,2016,2857,1523,1334,114.2,2854,1522,1332,114.3
32004, 읍부,020002, 16세,2016,3244,1712,1532,111.7,3241,1711,1530,111.8
32004, 읍부,020003, 17세,2016,3332,1744,1588,109.8,3331,1744,1587,109.9
32004, 읍부,020004, 18세,2016,3185,1692,1493,113.3,3181,1689,1492,113.2
32004, 읍부,020005, 19세,2016,2985,1500,1485,101,2974,1498,1476,101.5
32004, 읍부,025,20~24세,2016,17567,10576,6991,151.3,16874,10107,6767,149.4
32004, 읍부,025001, 20세,2016,3205,1799,1406,128,3164,1770,1394,127
32004, 읍부,025002, 21세,2016,3415,1895,1520,124.7,3316,1821,1495,121.8
32004, 읍부,025003, 22세,2016,3509,2089,1420,147.1,3360,1988,1372,144.9
32004, 읍부,025004, 23세,2016,3679,2302,1377,167.2,3463,2162,1301,166.2
32004, 읍부,025005, 24세,2016,3759,2491,1268,196.5,3571,2366,1205,196.3
32004, 읍부,030,25~29세,2016,14678,8876,5802,153,13931,8432,5499,153.3
32004, 읍부,030001, 25세,2016,3491,2165,1326,163.3,3338,2081,1257,165.6
32004, 읍부,030002, 26세,2016,3009,1844,1165,158.3,2855,1763,1092,161.4
32004, 읍부,030003, 27세,2016,2827,1747,1080,161.8,2664,1642,1022,160.7
32004, 읍부,030004, 28세,2016,2654,1541,1113,138.5,2519,1457,1062,137.2
32004, 읍부,030005, 29세,2016,2697,1579,1118,141.2,2555,1489,1066,139.7
32004, 읍부,035,30~34세,2016,14417,7851,6566,119.6,13786,7475,6311,118.4
32004, 읍부,035001, 30세,2016,2702,1548,1154,134.1,2567,1471,1096,134.2
32004, 읍부,035002, 31세,2016,2643,1501,1142,131.4,2498,1412,1086,130
32004, 읍부,035003, 32세,2016,2784,1478,1306,113.2,2662,1405,1257,111.8
32004, 읍부,035004, 33세,2016,3013,1584,1429,110.8,2887,1509,1378,109.5
32004, 읍부,035005, 34세,2016,3275,1740,1535,113.4,3172,1678,1494,112.3
32004, 읍부,040,35~39세,2016,16613,8749,7864,111.3,16157,8470,7687,110.2
32004, 읍부,040001, 35세,2016,3448,1818,1630,111.5,3338,1751,1587,110.3
32004, 읍부,040002, 36세,2016,3371,1777,1594,111.5,3261,1712,1549,110.5
32004, 읍부,040003, 37세,2016,3211,1717,1494,114.9,3113,1654,1459,113.4
32004, 읍부,040004, 38세,2016,3251,1712,1539,111.2,3186,1676,1510,111
32004, 읍부,040005, 39세,2016,3332,1725,1607,107.3,3259,1677,1582,106
32004, 읍부,045,40~44세,2016,18398,9905,8493,116.6,18114,9752,8362,116.6
32004, 읍부,045001, 40세,2016,3288,1757,1531,114.8,3217,1706,1511,112.9
32004, 읍부,045002, 41세,2016,3512,1853,1659,111.7,3443,1817,1626,111.7
32004, 읍부,045003, 42세,2016,3896,2141,1755,122,3856,2121,1735,122.2
32004, 읍부,045004, 43세,2016,3908,2127,1781,119.4,3847,2096,1751,119.7
32004, 읍부,045005, 44세,2016,3794,2027,1767,114.7,3751,2012,1739,115.7
32004, 읍부,050,45~49세,2016,20460,11072,9388,117.9,20155,10942,9213,118.8
32004, 읍부,050001, 45세,2016,4122,2233,1889,118.2,4057,2199,1858,118.4
32004, 읍부,050002, 46세,2016,3944,2139,1805,118.5,3882,2110,1772,119.1
32004, 읍부,050003, 47세,2016,4203,2279,1924,118.5,4127,2251,1876,120
32004, 읍부,050004, 48세,2016,4341,2386,1955,122,4277,2360,1917,123.1
32004, 읍부,050005, 49세,2016,3850,2035,1815,112.1,3812,2022,1790,113
32004, 읍부,055,50~54세,2016,21065,11235,9830,114.3,20817,11137,9680,115.1
32004, 읍부,055001, 50세,2016,4088,2205,1883,117.1,4032,2179,1853,117.6
32004, 읍부,055002, 51세,2016,3857,1977,1880,105.2,3802,1952,1850,105.5
32004, 읍부,055003, 52세,2016,4058,2207,1851,119.2,4005,2191,1814,120.8
32004, 읍부,055004, 53세,2016,4363,2369,1994,118.8,4320,2356,1964,120
32004, 읍부,055005, 54세,2016,4699,2477,2222,111.5,4658,2459,2199,111.8
32004, 읍부,060,55~59세,2016,23797,12371,11426,108.3,23612,12301,11311,108.8
32004, 읍부,060001, 55세,2016,5130,2671,2459,108.6,5096,2656,2440,108.9
32004, 읍부,060002, 56세,2016,5056,2552,2504,101.9,5015,2537,2478,102.4
32004, 읍부,060003, 57세,2016,4518,2361,2157,109.5,4482,2349,2133,110.1
32004, 읍부,060004, 58세,2016,4674,2458,2216,110.9,4632,2442,2190,111.5
32004, 읍부,060005, 59세,2016,4419,2329,2090,111.4,4387,2317,2070,111.9
32004, 읍부,065,60~64세,2016,18681,9218,9463,97.4,18573,9169,9404,97.5
32004, 읍부,065001, 60세,2016,4242,2118,2124,99.7,4215,2106,2109,99.9
32004, 읍부,065002, 61세,2016,4099,2104,1995,105.5,4081,2091,1990,105.1
32004, 읍부,065003, 62세,2016,3737,1814,1923,94.3,3716,1803,1913,94.2
32004, 읍부,065004, 63세,2016,2998,1434,1564,91.7,2981,1431,1550,92.3
32004, 읍부,065005, 64세,2016,3605,1748,1857,94.1,3580,1738,1842,94.4
32004, 읍부,070,65~69세,2016,13039,6029,7010,86,12983,6004,6979,86
32004, 읍부,070001, 65세,2016,2305,1080,1225,88.2,2286,1072,1214,88.3
32004, 읍부,070002, 66세,2016,2422,1117,1305,85.6,2408,1109,1299,85.4
32004, 읍부,070003, 67세,2016,2688,1252,1436,87.2,2682,1249,1433,87.2
32004, 읍부,070004, 68세,2016,2732,1245,1487,83.7,2722,1242,1480,83.9
32004, 읍부,070005, 69세,2016,2892,1335,1557,85.7,2885,1332,1553,85.8
32004, 읍부,075,70~74세,2016,13400,6027,7373,81.7,13364,6006,7358,81.6
32004, 읍부,075001, 70세,2016,2426,1146,1280,89.5,2416,1141,1275,89.5
32004, 읍부,075002, 71세,2016,2676,1243,1433,86.7,2669,1237,1432,86.4
32004, 읍부,075003, 72세,2016,2593,1147,1446,79.3,2589,1144,1445,79.2
32004, 읍부,075004, 73세,2016,2686,1166,1520,76.7,2679,1163,1516,76.7
32004, 읍부,075005, 74세,2016,3019,1325,1694,78.2,3011,1321,1690,78.2
32004, 읍부,080,75~79세,2016,11797,4865,6932,70.2,11787,4863,6924,70.2
32004, 읍부,080001, 75세,2016,2698,1157,1541,75.1,2696,1157,1539,75.2
32004, 읍부,080002, 76세,2016,2545,1061,1484,71.5,2544,1060,1484,71.4
32004, 읍부,080003, 77세,2016,2439,1006,1433,70.2,2437,1006,1431,70.3
32004, 읍부,080004, 78세,2016,2170,875,1295,67.6,2167,874,1293,67.6
32004, 읍부,080005, 79세,2016,1945,766,1179,65,1943,766,1177,65.1
32004, 읍부,085,80~84세,2016,6489,2234,4255,52.5,6484,2232,4252,52.5
32004, 읍부,085001, 80세,2016,1660,651,1009,64.5,1658,649,1009,64.3
32004, 읍부,085002, 81세,2016,1496,522,974,53.6,1494,522,972,53.7
32004, 읍부,085003, 82세,2016,1240,380,860,44.2,1239,380,859,44.2
32004, 읍부,085004, 83세,2016,1124,384,740,51.9,1124,384,740,51.9
32004, 읍부,085005, 84세,2016,969,297,672,44.2,969,297,672,44.2
32004, 읍부,090,85~89세,2016,3195,847,2348,36.1,3193,847,2346,36.1
32004, 읍부,090001, 85세,2016,769,225,544,41.4,769,225,544,41.4
32004, 읍부,090002, 86세,2016,804,212,592,35.8,803,212,591,35.9
32004, 읍부,090003, 87세,2016,647,170,477,35.6,646,170,476,35.7
32004, 읍부,090004, 88세,2016,544,128,416,30.8,544,128,416,30.8
32004, 읍부,090005, 89세,2016,431,112,319,35.1,431,112,319,35.1
32004, 읍부,095,90~94세,2016,1128,311,817,38.1,1128,311,817,38.1
32004, 읍부,095001, 90세,2016,316,68,248,27.4,316,68,248,27.4
32004, 읍부,095002, 91세,2016,305,93,212,43.9,305,93,212,43.9
32004, 읍부,095003, 92세,2016,213,70,143,49,213,70,143,49
32004, 읍부,095004, 93세,2016,178,43,135,31.9,178,43,135,31.9
32004, 읍부,095005, 94세,2016,116,37,79,46.8,116,37,79,46.8
32004, 읍부,100,95~99세,2016,254,63,191,33,253,63,190,33.2
32004, 읍부,100001, 95세,2016,95,20,75,26.7,95,20,75,26.7
32004, 읍부,100002, 96세,2016,57,20,37,54.1,56,20,36,55.6
32004, 읍부,100003, 97세,2016,46,9,37,24.3,46,9,37,24.3
32004, 읍부,100004, 98세,2016,35,7,28,25,35,7,28,25
32004, 읍부,100005, 99세,2016,21,7,14,50,21,7,14,50
32004, 읍부,101,100세이상,2016,29,6,23,26.1,29,6,23,26.1
32004, 읍부,102,15세미만,2016,32105,16586,15519,106.9,32055,16560,15495,106.9
32004, 읍부,103,15~64세,2016,181279,98024,83255,117.7,177600,95949,81651,117.5
32004, 읍부,104,65세이상,2016,49331,20382,28949,70.4,49221,20332,28889,70.4
32004, 읍부,086,85세이상,2016,4606,1227,3379,36.3,4603,1227,3376,36.3
32004, 읍부,126,평균연령,2016,43.8,42,45.8,,44,42.2,45.8,
32004, 읍부,127,중위연령,2016,45.5,43.4,47.8,,45.7,43.7,48,
32005, 면부,000,합계,2016,336412,174756,161656,108.1,330124,171052,159072,107.5
32005, 면부,005,0~4세,2016,9295,4738,4557,104,9281,4728,4553,103.8
32005, 면부,005001, 0세,2016,1735,862,873,98.7,1732,859,873,98.4
32005, 면부,005002, 1세,2016,1783,908,875,103.8,1783,908,875,103.8
32005, 면부,005003, 2세,2016,1813,926,887,104.4,1812,925,887,104.3
32005, 면부,005004, 3세,2016,1879,992,887,111.8,1874,989,885,111.8
32005, 면부,005005, 4세,2016,2085,1050,1035,101.4,2080,1047,1033,101.4
32005, 면부,010,5~9세,2016,10363,5308,5055,105,10325,5290,5035,105.1
32005, 면부,010001, 5세,2016,2093,1117,976,114.4,2082,1111,971,114.4
32005, 면부,010002, 6세,2016,2068,1053,1015,103.7,2060,1049,1011,103.8
32005, 면부,010003, 7세,2016,2011,1009,1002,100.7,2002,1005,997,100.8
32005, 면부,010004, 8세,2016,2061,1045,1016,102.9,2055,1043,1012,103.1
32005, 면부,010005, 9세,2016,2130,1084,1046,103.6,2126,1082,1044,103.6
32005, 면부,015,10~14세,2016,10216,5336,4880,109.3,10196,5326,4870,109.4
32005, 면부,015001, 10세,2016,2009,1043,966,108,2004,1042,962,108.3
32005, 면부,015002, 11세,2016,1919,997,922,108.1,1917,996,921,108.1
32005, 면부,015003, 12세,2016,2094,1101,993,110.9,2091,1099,992,110.8
32005, 면부,015004, 13세,2016,2019,1048,971,107.9,2013,1045,968,108
32005, 면부,015005, 14세,2016,2175,1147,1028,111.6,2171,1144,1027,111.4
32005, 면부,020,15~19세,2016,15845,8560,7285,117.5,15674,8470,7204,117.6
32005, 면부,020001, 15세,2016,2598,1372,1226,111.9,2594,1370,1224,111.9
32005, 면부,020002, 16세,2016,2915,1505,1410,106.7,2911,1504,1407,106.9
32005, 면부,020003, 17세,2016,2868,1474,1394,105.7,2863,1471,1392,105.7
32005, 면부,020004, 18세,2016,3240,1776,1464,121.3,3200,1756,1444,121.6
32005, 면부,020005, 19세,2016,4224,2433,1791,135.8,4106,2369,1737,136.4
32005, 면부,025,20~24세,2016,23169,14448,8721,165.7,21995,13677,8318,164.4
32005, 면부,025001, 20세,2016,4321,2434,1887,129,4150,2331,1819,128.1
32005, 면부,025002, 21세,2016,4081,2253,1828,123.2,3861,2113,1748,120.9
32005, 면부,025003, 22세,2016,4552,2756,1796,153.5,4326,2602,1724,150.9
32005, 면부,025004, 23세,2016,5043,3425,1618,211.7,4801,3259,1542,211.3
32005, 면부,025005, 24세,2016,5172,3580,1592,224.9,4857,3372,1485,227.1
32005, 면부,030,25~29세,2016,17765,11148,6617,168.5,16504,10366,6138,168.9
32005, 면부,030001, 25세,2016,4338,2886,1452,198.8,4066,2713,1353,200.5
32005, 면부,030002, 26세,2016,3738,2376,1362,174.4,3448,2189,1259,173.9
32005, 면부,030003, 27세,2016,3337,2098,1239,169.3,3100,1942,1158,167.7
32005, 면부,030004, 28세,2016,3265,1956,1309,149.4,3036,1830,1206,151.7
32005, 면부,030005, 29세,2016,3087,1832,1255,146,2854,1692,1162,145.6
32005, 면부,035,30~34세,2016,15977,9250,6727,137.5,14955,8603,6352,135.4
32005, 면부,035001, 30세,2016,3128,1858,1270,146.3,2900,1716,1184,144.9
32005, 면부,035002, 31세,2016,3039,1786,1253,142.5,2810,1638,1172,139.8
32005, 면부,035003, 32세,2016,3076,1792,1284,139.6,2876,1663,1213,137.1
32005, 면부,035004, 33세,2016,3304,1890,1414,133.7,3102,1765,1337,132
32005, 면부,035005, 34세,2016,3430,1924,1506,127.8,3267,1821,1446,125.9
32005, 면부,040,35~39세,2016,16699,9246,7453,124.1,16040,8816,7224,122
32005, 면부,040001, 35세,2016,3369,1928,1441,133.8,3206,1818,1388,131
32005, 면부,040002, 36세,2016,3405,1843,1562,118,3274,1754,1520,115.4
32005, 면부,040003, 37세,2016,3371,1829,1542,118.6,3232,1746,1486,117.5
32005, 면부,040004, 38세,2016,3223,1806,1417,127.5,3104,1726,1378,125.3
32005, 면부,040005, 39세,2016,3331,1840,1491,123.4,3224,1772,1452,122
32005, 면부,045,40~44세,2016,18727,10763,7964,135.1,18265,10482,7783,134.7
32005, 면부,045001, 40세,2016,3354,1927,1427,135,3257,1860,1397,133.1
32005, 면부,045002, 41세,2016,3469,1966,1503,130.8,3370,1909,1461,130.7
32005, 면부,045003, 42세,2016,3912,2203,1709,128.9,3822,2149,1673,128.5
32005, 면부,045004, 43세,2016,4085,2361,1724,136.9,3995,2309,1686,137
32005, 면부,045005, 44세,2016,3907,2306,1601,144,3821,2255,1566,144
32005, 면부,050,45~49세,2016,22976,12691,10285,123.4,22574,12500,10074,124.1
32005, 면부,050001, 45세,2016,4270,2433,1837,132.4,4178,2384,1794,132.9
32005, 면부,050002, 46세,2016,4252,2359,1893,124.6,4162,2316,1846,125.5
32005, 면부,050003, 47세,2016,4764,2620,2144,122.2,4689,2584,2105,122.8
32005, 면부,050004, 48세,2016,5041,2742,2299,119.3,4959,2706,2253,120.1
32005, 면부,050005, 49세,2016,4649,2537,2112,120.1,4586,2510,2076,120.9
32005, 면부,055,50~54세,2016,27530,14530,13000,111.8,27162,14384,12778,112.6
32005, 면부,055001, 50세,2016,5027,2750,2277,120.8,4945,2715,2230,121.7
32005, 면부,055002, 51세,2016,5017,2640,2377,111.1,4947,2609,2338,111.6
32005, 면부,055003, 52세,2016,5257,2774,2483,111.7,5184,2748,2436,112.8
32005, 면부,055004, 53세,2016,5784,2985,2799,106.6,5716,2959,2757,107.3
32005, 면부,055005, 54세,2016,6445,3381,3064,110.3,6370,3353,3017,111.1
32005, 면부,060,55~59세,2016,36341,18522,17819,103.9,36062,18393,17669,104.1
32005, 면부,060001, 55세,2016,7528,3781,3747,100.9,7488,3764,3724,101.1
32005, 면부,060002, 56세,2016,7513,3793,3720,102,7446,3760,3686,102
32005, 면부,060003, 57세,2016,6949,3542,3407,104,6895,3520,3375,104.3
32005, 면부,060004, 58세,2016,7221,3678,3543,103.8,7159,3651,3508,104.1
32005, 면부,060005, 59세,2016,7130,3728,3402,109.6,7074,3698,3376,109.5
32005, 면부,065,60~64세,2016,30301,15764,14537,108.4,30086,15653,14433,108.5
32005, 면부,065001, 60세,2016,6491,3346,3145,106.4,6450,3326,3124,106.5
32005, 면부,065002, 61세,2016,6634,3421,3213,106.5,6585,3398,3187,106.6
32005, 면부,065003, 62세,2016,5910,3127,2783,112.4,5858,3095,2763,112
32005, 면부,065004, 63세,2016,5036,2609,2427,107.5,5002,2596,2406,107.9
32005, 면부,065005, 64세,2016,6230,3261,2969,109.8,6191,3238,2953,109.7
32005, 면부,070,65~69세,2016,20027,9920,10107,98.1,19907,9868,10039,98.3
32005, 면부,070001, 65세,2016,3518,1712,1806,94.8,3492,1702,1790,95.1
32005, 면부,070002, 66세,2016,3743,1789,1954,91.6,3717,1776,1941,91.5
32005, 면부,070003, 67세,2016,4050,2033,2017,100.8,4019,2019,2000,101
32005, 면부,070004, 68세,2016,4320,2144,2176,98.5,4304,2135,2169,98.4
32005, 면부,070005, 69세,2016,4396,2242,2154,104.1,4375,2236,2139,104.5
32005, 면부,075,70~74세,2016,21035,9729,11306,86.1,20986,9703,11283,86
32005, 면부,075001, 70세,2016,3835,1894,1941,97.6,3820,1886,1934,97.5
32005, 면부,075002, 71세,2016,4083,1934,2149,90,4073,1929,2144,90
32005, 면부,075003, 72세,2016,4063,1800,2263,79.5,4057,1796,2261,79.4
32005, 면부,075004, 73세,2016,4235,1901,2334,81.4,4225,1896,2329,81.4
32005, 면부,075005, 74세,2016,4819,2200,2619,84,4811,2196,2615,84
32005, 면부,080,75~79세,2016,20090,8637,11453,75.4,20073,8631,11442,75.4
32005, 면부,080001, 75세,2016,4431,1956,2475,79,4428,1956,2472,79.1
32005, 면부,080002, 76세,2016,4212,1873,2339,80.1,4205,1869,2336,80
32005, 면부,080003, 77세,2016,4069,1717,2352,73,4068,1717,2351,73
32005, 면부,080004, 78세,2016,3924,1650,2274,72.6,3922,1649,2273,72.5
32005, 면부,080005, 79세,2016,3454,1441,2013,71.6,3450,1440,2010,71.6
32005, 면부,085,80~84세,2016,11691,4038,7653,52.8,11684,4038,7646,52.8
32005, 면부,085001, 80세,2016,3090,1260,1830,68.9,3087,1260,1827,69
32005, 면부,085002, 81세,2016,2763,960,1803,53.2,2762,960,1802,53.3
32005, 면부,085003, 82세,2016,2299,754,1545,48.8,2298,754,1544,48.8
32005, 면부,085004, 83세,2016,1882,587,1295,45.3,1882,587,1295,45.3
32005, 면부,085005, 84세,2016,1657,477,1180,40.4,1655,477,1178,40.5
32005, 면부,090,85~89세,2016,5565,1402,4163,33.7,5560,1399,4161,33.6
32005, 면부,090001, 85세,2016,1461,417,1044,39.9,1460,416,1044,39.8
32005, 면부,090002, 86세,2016,1332,342,990,34.5,1329,341,988,34.5
32005, 면부,090003, 87세,2016,1101,273,828,33,1101,273,828,33
32005, 면부,090004, 88세,2016,902,218,684,31.9,901,217,684,31.7
32005, 면부,090005, 89세,2016,769,152,617,24.6,769,152,617,24.6
32005, 면부,095,90~94세,2016,2258,614,1644,37.3,2255,614,1641,37.4
32005, 면부,095001, 90세,2016,616,145,471,30.8,615,145,470,30.9
32005, 면부,095002, 91세,2016,554,156,398,39.2,554,156,398,39.2
32005, 면부,095003, 92세,2016,451,141,310,45.5,451,141,310,45.5
32005, 면부,095004, 93세,2016,373,106,267,39.7,372,106,266,39.8
32005, 면부,095005, 94세,2016,264,66,198,33.3,263,66,197,33.5
32005, 면부,100,95~99세,2016,477,100,377,26.5,475,99,376,26.3
32005, 면부,100001, 95세,2016,161,22,139,15.8,161,22,139,15.8
32005, 면부,100002, 96세,2016,111,25,86,29.1,111,25,86,29.1
32005, 면부,100003, 97세,2016,99,33,66,50,97,32,65,49.2
32005, 면부,100004, 98세,2016,61,10,51,19.6,61,10,51,19.6
32005, 면부,100005, 99세,2016,45,10,35,28.6,45,10,35,28.6
32005, 면부,101,100세이상,2016,65,12,53,22.6,65,12,53,22.6
32005, 면부,102,15세미만,2016,29874,15382,14492,106.1,29802,15344,14458,106.1
32005, 면부,103,15~64세,2016,225330,124922,100408,124.4,219317,121344,97973,123.9
32005, 면부,104,65세이상,2016,81208,34452,46756,73.7,81005,34364,46641,73.7
32005, 면부,086,85세이상,2016,8365,2128,6237,34.1,8355,2124,6231,34.1
32005, 면부,126,평균연령,2016,47.9,45.7,50.3,,48.2,46,50.5,
32005, 면부,127,중위연령,2016,51.4,48.4,54.4,,51.9,48.9,54.7,
32003, 동부,000,합계,2016,922624,459713,462911,99.3,913387,455229,458158,99.4
32003, 동부,005,0~4세,2016,37165,18910,18255,103.6,37044,18847,18197,103.6
32003, 동부,005001, 0세,2016,6651,3416,3235,105.6,6619,3396,3223,105.4
32003, 동부,005002, 1세,2016,7218,3629,3589,101.1,7192,3619,3573,101.3
32003, 동부,005003, 2세,2016,7231,3663,3568,102.7,7214,3657,3557,102.8
32003, 동부,005004, 3세,2016,7508,3842,3666,104.8,7491,3832,3659,104.7
32003, 동부,005005, 4세,2016,8557,4360,4197,103.9,8528,4343,4185,103.8
32003, 동부,010,5~9세,2016,42438,21898,20540,106.6,42319,21838,20481,106.6
32003, 동부,010001, 5세,2016,8450,4312,4138,104.2,8418,4295,4123,104.2
32003, 동부,010002, 6세,2016,8343,4288,4055,105.7,8314,4274,4040,105.8
32003, 동부,010003, 7세,2016,8171,4199,3972,105.7,8156,4190,3966,105.6
32003, 동부,010004, 8세,2016,8436,4339,4097,105.9,8417,4333,4084,106.1
32003, 동부,010005, 9세,2016,9038,4760,4278,111.3,9014,4746,4268,111.2
32003, 동부,015,10~14세,2016,46007,23907,22100,108.2,45922,23866,22056,108.2
32003, 동부,015001, 10세,2016,8285,4284,4001,107.1,8266,4278,3988,107.3
32003, 동부,015002, 11세,2016,8622,4475,4147,107.9,8604,4468,4136,108
32003, 동부,015003, 12세,2016,9388,4897,4491,109,9369,4887,4482,109
32003, 동부,015004, 13세,2016,9589,4991,4598,108.5,9578,4985,4593,108.5
32003, 동부,015005, 14세,2016,10123,5260,4863,108.2,10105,5248,4857,108.1
32003, 동부,020,15~19세,2016,62881,33515,29366,114.1,62580,33378,29202,114.3
32003, 동부,020001, 15세,2016,11587,6117,5470,111.8,11574,6110,5464,111.8
32003, 동부,020002, 16세,2016,12275,6563,5712,114.9,12256,6553,5703,114.9
32003, 동부,020003, 17세,2016,11966,6236,5730,108.8,11941,6223,5718,108.8
32003, 동부,020004, 18세,2016,12751,6763,5988,112.9,12675,6727,5948,113.1
32003, 동부,020005, 19세,2016,14302,7836,6466,121.2,14134,7765,6369,121.9
32003, 동부,025,20~24세,2016,68648,37963,30685,123.7,67038,37284,29754,125.3
32003, 동부,025001, 20세,2016,14311,7608,6703,113.5,13989,7488,6501,115.2
32003, 동부,025002, 21세,2016,13842,7368,6474,113.8,13539,7246,6293,115.1
32003, 동부,025003, 22세,2016,13882,7671,6211,123.5,13565,7524,6041,124.5
32003, 동부,025004, 23세,2016,13590,7812,5778,135.2,13260,7675,5585,137.4
32003, 동부,025005, 24세,2016,13023,7504,5519,136,12685,7351,5334,137.8
32003, 동부,030,25~29세,2016,49715,26620,23095,115.3,48061,25839,22222,116.3
32003, 동부,030001, 25세,2016,11156,6197,4959,125,10804,6044,4760,127
32003, 동부,030002, 26세,2016,10170,5517,4653,118.6,9816,5360,4456,120.3
32003, 동부,030003, 27세,2016,9683,5217,4466,116.8,9375,5056,4319,117.1
32003, 동부,030004, 28세,2016,9424,4909,4515,108.7,9082,4753,4329,109.8
32003, 동부,030005, 29세,2016,9282,4780,4502,106.2,8984,4626,4358,106.1
32003, 동부,035,30~34세,2016,54150,27917,26233,106.4,52879,27258,25621,106.4
32003, 동부,035001, 30세,2016,9594,5018,4576,109.7,9295,4874,4421,110.2
32003, 동부,035002, 31세,2016,9782,5127,4655,110.1,9510,4998,4512,110.8
32003, 동부,035003, 32세,2016,10186,5319,4867,109.3,9954,5191,4763,109
32003, 동부,035004, 33세,2016,11702,6073,5629,107.9,11462,5942,5520,107.6
32003, 동부,035005, 34세,2016,12886,6380,6506,98.1,12658,6253,6405,97.6
32003, 동부,040,35~39세,2016,65054,32261,32793,98.4,64247,31798,32449,98
32003, 동부,040001, 35세,2016,13037,6593,6444,102.3,12860,6494,6366,102
32003, 동부,040002, 36세,2016,13493,6641,6852,96.9,13302,6520,6782,96.1
32003, 동부,040003, 37세,2016,13036,6409,6627,96.7,12880,6327,6553,96.6
32003, 동부,040004, 38세,2016,12612,6207,6405,96.9,12462,6115,6347,96.3
32003, 동부,040005, 39세,2016,12876,6411,6465,99.2,12743,6342,6401,99.1
32003, 동부,045,40~44세,2016,74717,37227,37490,99.3,73975,36805,37170,99
32003, 동부,045001, 40세,2016,13012,6394,6618,96.6,12870,6309,6561,96.2
32003, 동부,045002, 41세,2016,14046,6944,7102,97.8,13875,6840,7035,97.2
32003, 동부,045003, 42세,2016,15904,7796,8108,96.2,15767,7726,8041,96.1
32003, 동부,045004, 43세,2016,16143,8067,8076,99.9,15988,7977,8011,99.6
32003, 동부,045005, 44세,2016,15612,8026,7586,105.8,15475,7953,7522,105.7
32003, 동부,050,45~49세,2016,82607,41614,40993,101.5,81931,41278,40653,101.5
32003, 동부,050001, 45세,2016,16941,8401,8540,98.4,16806,8339,8467,98.5
32003, 동부,050002, 46세,2016,16585,8488,8097,104.8,16425,8404,8021,104.8
32003, 동부,050003, 47세,2016,16905,8522,8383,101.7,16775,8459,8316,101.7
32003, 동부,050004, 48세,2016,16801,8493,8308,102.2,16666,8421,8245,102.1
32003, 동부,050005, 49세,2016,15375,7710,7665,100.6,15259,7655,7604,100.7
32003, 동부,055,50~54세,2016,75186,37985,37201,102.1,74556,37713,36843,102.4
32003, 동부,055001, 50세,2016,15338,7913,7425,106.6,15205,7853,7352,106.8
32003, 동부,055002, 51세,2016,14455,7110,7345,96.8,14316,7052,7264,97.1
32003, 동부,055003, 52세,2016,14364,7305,7059,103.5,14237,7251,6986,103.8
32003, 동부,055004, 53세,2016,15178,7685,7493,102.6,15039,7624,7415,102.8
32003, 동부,055005, 54세,2016,15851,7972,7879,101.2,15759,7933,7826,101.4
32003, 동부,060,55~59세,2016,78711,38684,40027,96.6,78267,38483,39784,96.7
32003, 동부,060001, 55세,2016,17209,8481,8728,97.2,17123,8441,8682,97.2
32003, 동부,060002, 56세,2016,16926,8108,8818,91.9,16820,8055,8765,91.9
32003, 동부,060003, 57세,2016,15442,7550,7892,95.7,15341,7508,7833,95.9
32003, 동부,060004, 58세,2016,14659,7271,7388,98.4,14588,7237,7351,98.4
32003, 동부,060005, 59세,2016,14475,7274,7201,101,14395,7242,7153,101.2
32003, 동부,065,60~64세,2016,57492,28236,29256,96.5,57126,28060,29066,96.5
32003, 동부,065001, 60세,2016,12954,6498,6456,100.7,12867,6453,6414,100.6
32003, 동부,065002, 61세,2016,12942,6392,6550,97.6,12852,6350,6502,97.7
32003, 동부,065003, 62세,2016,11189,5530,5659,97.7,11126,5498,5628,97.7
32003, 동부,065004, 63세,2016,9290,4510,4780,94.4,9225,4480,4745,94.4
32003, 동부,065005, 64세,2016,11117,5306,5811,91.3,11056,5279,5777,91.4
32003, 동부,070,65~69세,2016,36526,17106,19420,88.1,36338,17016,19322,88.1
32003, 동부,070001, 65세,2016,6484,3062,3422,89.5,6429,3040,3389,89.7
32003, 동부,070002, 66세,2016,7054,3245,3809,85.2,7019,3232,3787,85.3
32003, 동부,070003, 67세,2016,7360,3516,3844,91.5,7315,3493,3822,91.4
32003, 동부,070004, 68세,2016,7873,3675,4198,87.5,7842,3654,4188,87.2
32003, 동부,070005, 69세,2016,7755,3608,4147,87,7733,3597,4136,87
32003, 동부,075,70~74세,2016,34476,15290,19186,79.7,34371,15237,19134,79.6
32003, 동부,075001, 70세,2016,6429,2933,3496,83.9,6397,2916,3481,83.8
32003, 동부,075002, 71세,2016,7008,3156,3852,81.9,6989,3146,3843,81.9
32003, 동부,075003, 72세,2016,6867,3071,3796,80.9,6847,3059,3788,80.8
32003, 동부,075004, 73세,2016,6793,2985,3808,78.4,6779,2979,3800,78.4
32003, 동부,075005, 74세,2016,7379,3145,4234,74.3,7359,3137,4222,74.3
32003, 동부,080,75~79세,2016,28828,11888,16940,70.2,28765,11858,16907,70.1
32003, 동부,080001, 75세,2016,6577,2818,3759,75,6559,2810,3749,75
32003, 동부,080002, 76세,2016,6169,2499,3670,68.1,6158,2492,3666,68
32003, 동부,080003, 77세,2016,5891,2408,3483,69.1,5883,2404,3479,69.1
32003, 동부,080004, 78세,2016,5534,2258,3276,68.9,5521,2254,3267,69
32003, 동부,080005, 79세,2016,4657,1905,2752,69.2,4644,1898,2746,69.1
32003, 동부,085,80~84세,2016,16662,5748,10914,52.7,16629,5735,10894,52.6
32003, 동부,085001, 80세,2016,4347,1659,2688,61.7,4342,1657,2685,61.7
32003, 동부,085002, 81세,2016,3936,1383,2553,54.2,3931,1381,2550,54.2
32003, 동부,085003, 82세,2016,3289,1122,2167,51.8,3276,1116,2160,51.7
32003, 동부,085004, 83세,2016,2782,893,1889,47.3,2775,891,1884,47.3
32003, 동부,085005, 84세,2016,2308,691,1617,42.7,2305,690,1615,42.7
32003, 동부,090,85~89세,2016,8012,2126,5886,36.1,8002,2122,5880,36.1
32003, 동부,090001, 85세,2016,1960,579,1381,41.9,1959,578,1381,41.9
32003, 동부,090002, 86세,2016,1948,517,1431,36.1,1945,516,1429,36.1
32003, 동부,090003, 87세,2016,1697,421,1276,33,1696,421,1275,33
32003, 동부,090004, 88세,2016,1316,324,992,32.7,1314,324,990,32.7
32003, 동부,090005, 89세,2016,1091,285,806,35.4,1088,283,805,35.2
32003, 동부,095,90~94세,2016,2720,681,2039,33.4,2713,678,2035,33.3
32003, 동부,095001, 90세,2016,809,183,626,29.2,806,182,624,29.2
32003, 동부,095002, 91세,2016,661,158,503,31.4,661,158,503,31.4
32003, 동부,095003, 92세,2016,484,125,359,34.8,483,125,358,34.9
32003, 동부,095004, 93세,2016,459,134,325,41.2,458,133,325,40.9
32003, 동부,095005, 94세,2016,307,81,226,35.8,305,80,225,35.6
32003, 동부,100,95~99세,2016,565,126,439,28.7,560,125,435,28.7
32003, 동부,100001, 95세,2016,218,51,167,30.5,216,51,165,30.9
32003, 동부,100002, 96세,2016,131,33,98,33.7,129,33,96,34.4
32003, 동부,100003, 97세,2016,99,21,78,26.9,99,21,78,26.9
32003, 동부,100004, 98세,2016,63,11,52,21.2,63,11,52,21.2
32003, 동부,100005, 99세,2016,54,10,44,22.7,53,9,44,20.5
32003, 동부,101,100세이상,2016,64,11,53,20.8,64,11,53,20.8
32003, 동부,102,15세미만,2016,125610,64715,60895,106.3,125285,64551,60734,106.3
32003, 동부,103,15~64세,2016,669161,342022,327139,104.5,660660,337896,322764,104.7
32003, 동부,104,65세이상,2016,127853,52976,74877,70.8,127442,52782,74660,70.7
32003, 동부,086,85세이상,2016,11361,2944,8417,35,11339,2936,8403,34.9
32003, 동부,126,평균연령,2016,41.1,39.7,42.5,,41.2,39.8,42.6,
32003, 동부,127,중위연령,2016,42.5,41.1,43.8,,42.6,41.2,43.9,
32010, 춘천시,000,합계,2016,283027,138962,144065,96.5,279200,137190,142010,96.6
32010, 춘천시,005,0~4세,2016,11303,5848,5455,107.2,11237,5814,5423,107.2
32010, 춘천시,005001, 0세,2016,2042,1054,988,106.7,2021,1040,981,106
32010, 춘천시,005002, 1세,2016,2143,1091,1052,103.7,2127,1087,1040,104.5
32010, 춘천시,005003, 2세,2016,2238,1152,1086,106.1,2231,1149,1082,106.2
32010, 춘천시,005004, 3세,2016,2331,1204,1127,106.8,2321,1198,1123,106.7
32010, 춘천시,005005, 4세,2016,2549,1347,1202,112.1,2537,1340,1197,111.9
32010, 춘천시,010,5~9세,2016,12484,6448,6036,106.8,12434,6419,6015,106.7
32010, 춘천시,010001, 5세,2016,2624,1354,1270,106.6,2607,1343,1264,106.3
32010, 춘천시,010002, 6세,2016,2445,1259,1186,106.2,2433,1253,1180,106.2
32010, 춘천시,010003, 7세,2016,2339,1234,1105,111.7,2329,1227,1102,111.3
32010, 춘천시,010004, 8세,2016,2514,1278,1236,103.4,2509,1275,1234,103.3
32010, 춘천시,010005, 9세,2016,2562,1323,1239,106.8,2556,1321,1235,107
32010, 춘천시,015,10~14세,2016,13107,6863,6244,109.9,13075,6845,6230,109.9
32010, 춘천시,015001, 10세,2016,2402,1236,1166,106,2396,1235,1161,106.4
32010, 춘천시,015002, 11세,2016,2455,1292,1163,111.1,2448,1290,1158,111.4
32010, 춘천시,015003, 12세,2016,2614,1375,1239,111,2607,1371,1236,110.9
32010, 춘천시,015004, 13세,2016,2754,1425,1329,107.2,2750,1422,1328,107.1
32010, 춘천시,015005, 14세,2016,2882,1535,1347,114,2874,1527,1347,113.4
32010, 춘천시,020,15~19세,2016,20015,10218,9797,104.3,19838,10131,9707,104.4
32010, 춘천시,020001, 15세,2016,3404,1770,1634,108.3,3399,1766,1633,108.1
32010, 춘천시,020002, 16세,2016,3734,1998,1736,115.1,3725,1994,1731,115.2
32010, 춘천시,020003, 17세,2016,3559,1830,1729,105.8,3549,1823,1726,105.6
32010, 춘천시,020004, 18세,2016,4038,2096,1942,107.9,3994,2073,1921,107.9
32010, 춘천시,020005, 19세,2016,5280,2524,2756,91.6,5171,2475,2696,91.8
32010, 춘천시,025,20~24세,2016,23635,11795,11840,99.6,22725,11429,11296,101.2
32010, 춘천시,025001, 20세,2016,5150,2258,2892,78.1,4951,2193,2758,79.5
32010, 춘천시,025002, 21세,2016,4890,2256,2634,85.6,4718,2191,2527,86.7
32010, 춘천시,025003, 22세,2016,4713,2398,2315,103.6,4541,2325,2216,104.9
32010, 춘천시,025004, 23세,2016,4530,2457,2073,118.5,4349,2380,1969,120.9
32010, 춘천시,025005, 24세,2016,4352,2426,1926,126,4166,2340,1826,128.1
32010, 춘천시,030,25~29세,2016,16762,8820,7942,111.1,16054,8501,7553,112.6
32010, 춘천시,030001, 25세,2016,3800,2060,1740,118.4,3644,2001,1643,121.8
32010, 춘천시,030002, 26세,2016,3555,1906,1649,115.6,3379,1831,1548,118.3
32010, 춘천시,030003, 27세,2016,3204,1688,1516,111.3,3074,1621,1453,111.6
32010, 춘천시,030004, 28세,2016,3202,1659,1543,107.5,3059,1597,1462,109.2
32010, 춘천시,030005, 29세,2016,3001,1507,1494,100.9,2898,1451,1447,100.3
32010, 춘천시,035,30~34세,2016,17076,8747,8329,105,16592,8504,8088,105.1
32010, 춘천시,035001, 30세,2016,3108,1612,1496,107.8,2979,1548,1431,108.2
32010, 춘천시,035002, 31세,2016,3137,1629,1508,108,3024,1571,1453,108.1
32010, 춘천시,035003, 32세,2016,3221,1674,1547,108.2,3134,1626,1508,107.8
32010, 춘천시,035004, 33세,2016,3687,1910,1777,107.5,3603,1867,1736,107.5
32010, 춘천시,035005, 34세,2016,3923,1922,2001,96.1,3852,1892,1960,96.5
32010, 춘천시,040,35~39세,2016,19025,9417,9608,98,18763,9281,9482,97.9
32010, 춘천시,040001, 35세,2016,3871,1899,1972,96.3,3812,1867,1945,96
32010, 춘천시,040002, 36세,2016,4054,1997,2057,97.1,3992,1966,2026,97
32010, 춘천시,040003, 37세,2016,3817,1870,1947,96,3775,1850,1925,96.1
32010, 춘천시,040004, 38세,2016,3687,1867,1820,102.6,3642,1841,1801,102.2
32010, 춘천시,040005, 39세,2016,3596,1784,1812,98.5,3542,1757,1785,98.4
32010, 춘천시,045,40~44세,2016,21157,10382,10775,96.4,20914,10240,10674,95.9
32010, 춘천시,045001, 40세,2016,3697,1791,1906,94,3656,1766,1890,93.4
32010, 춘천시,045002, 41세,2016,3955,1872,2083,89.9,3896,1841,2055,89.6
32010, 춘천시,045003, 42세,2016,4404,2160,2244,96.3,4362,2136,2226,96
32010, 춘천시,045004, 43세,2016,4518,2223,2295,96.9,4464,2190,2274,96.3
32010, 춘천시,045005, 44세,2016,4583,2336,2247,104,4536,2307,2229,103.5
32010, 춘천시,050,45~49세,2016,23981,12124,11857,102.3,23722,12001,11721,102.4
32010, 춘천시,050001, 45세,2016,4956,2477,2479,99.9,4905,2455,2450,100.2
32010, 춘천시,050002, 46세,2016,4635,2388,2247,106.3,4580,2359,2221,106.2
32010, 춘천시,050003, 47세,2016,4903,2448,2455,99.7,4849,2420,2429,99.6
32010, 춘천시,050004, 48세,2016,4953,2490,2463,101.1,4900,2466,2434,101.3
32010, 춘천시,050005, 49세,2016,4534,2321,2213,104.9,4488,2301,2187,105.2
32010, 춘천시,055,50~54세,2016,22233,11192,11041,101.4,22004,11100,10904,101.8
32010, 춘천시,055001, 50세,2016,4476,2284,2192,104.2,4420,2258,2162,104.4
32010, 춘천시,055002, 51세,2016,4088,2053,2035,100.9,4039,2036,2003,101.6
32010, 춘천시,055003, 52세,2016,4448,2267,2181,103.9,4407,2252,2155,104.5
32010, 춘천시,055004, 53세,2016,4531,2270,2261,100.4,4480,2244,2236,100.4
32010, 춘천시,055005, 54세,2016,4690,2318,2372,97.7,4658,2310,2348,98.4
32010, 춘천시,060,55~59세,2016,23393,11388,12005,94.9,23242,11321,11921,95
32010, 춘천시,060001, 55세,2016,5364,2650,2714,97.6,5337,2636,2701,97.6
32010, 춘천시,060002, 56세,2016,4724,2211,2513,88,4684,2192,2492,88
32010, 춘천시,060003, 57세,2016,4441,2168,2273,95.4,4410,2155,2255,95.6
32010, 춘천시,060004, 58세,2016,4514,2231,2283,97.7,4490,2218,2272,97.6
32010, 춘천시,060005, 59세,2016,4350,2128,2222,95.8,4321,2120,2201,96.3
32010, 춘천시,065,60~64세,2016,17725,8727,8998,97,17595,8663,8932,97
32010, 춘천시,065001, 60세,2016,4061,2005,2056,97.5,4033,1986,2047,97
32010, 춘천시,065002, 61세,2016,3987,1955,2032,96.2,3958,1944,2014,96.5
32010, 춘천시,065003, 62세,2016,3389,1730,1659,104.3,3360,1715,1645,104.3
32010, 춘천시,065004, 63세,2016,2891,1396,1495,93.4,2869,1387,1482,93.6
32010, 춘천시,065005, 64세,2016,3397,1641,1756,93.5,3375,1631,1744,93.5
32010, 춘천시,070,65~69세,2016,10522,4846,5676,85.4,10463,4822,5641,85.5
32010, 춘천시,070001, 65세,2016,1816,850,966,88,1799,844,955,88.4
32010, 춘천시,070002, 66세,2016,1878,831,1047,79.4,1865,826,1039,79.5
32010, 춘천시,070003, 67세,2016,2055,956,1099,87,2043,951,1092,87.1
32010, 춘천시,070004, 68세,2016,2304,1034,1270,81.4,2297,1030,1267,81.3
32010, 춘천시,070005, 69세,2016,2469,1175,1294,90.8,2459,1171,1288,90.9
32010, 춘천시,075,70~74세,2016,11003,4919,6084,80.9,10965,4900,6065,80.8
32010, 춘천시,075001, 70세,2016,2144,977,1167,83.7,2134,974,1160,84
32010, 춘천시,075002, 71세,2016,2169,999,1170,85.4,2161,996,1165,85.5
32010, 춘천시,075003, 72세,2016,2083,930,1153,80.7,2079,928,1151,80.6
32010, 춘천시,075004, 73세,2016,2128,920,1208,76.2,2121,916,1205,76
32010, 춘천시,075005, 74세,2016,2479,1093,1386,78.9,2470,1086,1384,78.5
32010, 춘천시,080,75~79세,2016,9765,4045,5720,70.7,9748,4042,5706,70.8
32010, 춘천시,080001, 75세,2016,2237,933,1304,71.5,2233,932,1301,71.6
32010, 춘천시,080002, 76세,2016,2057,856,1201,71.3,2055,855,1200,71.3
32010, 춘천시,080003, 77세,2016,1947,795,1152,69,1943,794,1149,69.1
32010, 춘천시,080004, 78세,2016,1885,778,1107,70.3,1881,778,1103,70.5
32010, 춘천시,080005, 79세,2016,1639,683,956,71.4,1636,683,953,71.7
32010, 춘천시,085,80~84세,2016,5749,2012,3737,53.8,5741,2009,3732,53.8
32010, 춘천시,085001, 80세,2016,1531,590,941,62.7,1529,589,940,62.7
32010, 춘천시,085002, 81세,2016,1354,484,870,55.6,1353,484,869,55.7
32010, 춘천시,085003, 82세,2016,1093,375,718,52.2,1092,374,718,52.1
32010, 춘천시,085004, 83세,2016,942,300,642,46.7,940,299,641,46.6
32010, 춘천시,085005, 84세,2016,829,263,566,46.5,827,263,564,46.6
32010, 춘천시,090,85~89세,2016,2825,811,2014,40.3,2823,809,2014,40.2
32010, 춘천시,090001, 85세,2016,691,224,467,48,691,224,467,48
32010, 춘천시,090002, 86세,2016,675,207,468,44.2,673,205,468,43.8
32010, 춘천시,090003, 87세,2016,595,171,424,40.3,595,171,424,40.3
32010, 춘천시,090004, 88세,2016,453,107,346,30.9,453,107,346,30.9
32010, 춘천시,090005, 89세,2016,411,102,309,33,411,102,309,33
32010, 춘천시,095,90~94세,2016,999,293,706,41.5,998,293,705,41.6
32010, 춘천시,095001, 90세,2016,279,64,215,29.8,279,64,215,29.8
32010, 춘천시,095002, 91세,2016,260,72,188,38.3,260,72,188,38.3
32010, 춘천시,095003, 92세,2016,171,57,114,50,171,57,114,50
32010, 춘천시,095004, 93세,2016,167,55,112,49.1,167,55,112,49.1
32010, 춘천시,095005, 94세,2016,122,45,77,58.4,121,45,76,59.2
32010, 춘천시,100,95~99세,2016,238,62,176,35.2,237,61,176,34.7
32010, 춘천시,100001, 95세,2016,91,24,67,35.8,91,24,67,35.8
32010, 춘천시,100002, 96세,2016,55,16,39,41,55,16,39,41
32010, 춘천시,100003, 97세,2016,40,10,30,33.3,39,9,30,30
32010, 춘천시,100004, 98세,2016,24,X,20,20,24,X,20,20
32010, 춘천시,100005, 99세,2016,28,8,20,40,28,8,20,40
32010, 춘천시,101,100세이상,2016,30,5,25,20,30,5,25,20
32010, 춘천시,102,15세미만,2016,36894,19159,17735,108,36746,19078,17668,108
32010, 춘천시,103,15~64세,2016,205002,102810,102192,100.6,201449,101171,100278,100.9
32010, 춘천시,104,65세이상,2016,41131,16993,24138,70.4,41005,16941,24064,70.4
32010, 춘천시,086,85세이상,2016,4092,1171,2921,40.1,4088,1168,2920,40
32010, 춘천시,126,평균연령,2016,41.2,39.9,42.4,,41.3,40,42.6,
32010, 춘천시,127,중위연령,2016,42.1,40.7,43.2,,42.3,40.9,43.5,
32020, 원주시,000,합계,2016,337479,168226,169253,99.4,333667,166114,167553,99.1
32020, 원주시,005,0~4세,2016,13996,7068,6928,102,13973,7055,6918,102
32020, 원주시,005001, 0세,2016,2465,1259,1206,104.4,2460,1256,1204,104.3
32020, 원주시,005002, 1세,2016,2721,1371,1350,101.6,2717,1368,1349,101.4
32020, 원주시,005003, 2세,2016,2725,1358,1367,99.3,2722,1358,1364,99.6
32020, 원주시,005004, 3세,2016,2782,1401,1381,101.4,2779,1399,1380,101.4
32020, 원주시,005005, 4세,2016,3303,1679,1624,103.4,3295,1674,1621,103.3
32020, 원주시,010,5~9세,2016,16413,8409,8004,105.1,16380,8400,7980,105.3
32020, 원주시,010001, 5세,2016,3203,1624,1579,102.8,3194,1621,1573,103.1
32020, 원주시,010002, 6세,2016,3275,1645,1630,100.9,3266,1641,1625,101
32020, 원주시,010003, 7세,2016,3182,1664,1518,109.6,3177,1664,1513,110
32020, 원주시,010004, 8세,2016,3219,1652,1567,105.4,3214,1652,1562,105.8
32020, 원주시,010005, 9세,2016,3534,1824,1710,106.7,3529,1822,1707,106.7
32020, 원주시,015,10~14세,2016,16975,8771,8204,106.9,16953,8763,8190,107
32020, 원주시,015001, 10세,2016,3121,1612,1509,106.8,3117,1612,1505,107.1
32020, 원주시,015002, 11세,2016,3232,1665,1567,106.3,3227,1663,1564,106.3
32020, 원주시,015003, 12세,2016,3487,1807,1680,107.6,3482,1804,1678,107.5
32020, 원주시,015004, 13세,2016,3470,1822,1648,110.6,3467,1821,1646,110.6
32020, 원주시,015005, 14세,2016,3665,1865,1800,103.6,3660,1863,1797,103.7
32020, 원주시,020,15~19세,2016,23365,12321,11044,111.6,23277,12280,10997,111.7
32020, 원주시,020001, 15세,2016,4188,2227,1961,113.6,4185,2226,1959,113.6
32020, 원주시,020002, 16세,2016,4305,2299,2006,114.6,4301,2295,2006,114.4
32020, 원주시,020003, 17세,2016,4413,2318,2095,110.6,4400,2312,2088,110.7
32020, 원주시,020004, 18세,2016,4751,2487,2264,109.8,4733,2480,2253,110.1
32020, 원주시,020005, 19세,2016,5708,2990,2718,110,5658,2967,2691,110.3
32020, 원주시,025,20~24세,2016,25851,13776,12075,114.1,25306,13449,11857,113.4
32020, 원주시,025001, 20세,2016,5487,2878,2609,110.3,5406,2838,2568,110.5
32020, 원주시,025002, 21세,2016,5220,2696,2524,106.8,5119,2637,2482,106.2
32020, 원주시,025003, 22세,2016,5250,2753,2497,110.3,5147,2687,2460,109.2
32020, 원주시,025004, 23세,2016,5074,2802,2272,123.3,4947,2727,2220,122.8
32020, 원주시,025005, 24세,2016,4820,2647,2173,121.8,4687,2560,2127,120.4
32020, 원주시,030,25~29세,2016,19307,10270,9037,113.6,18632,9874,8758,112.7
32020, 원주시,030001, 25세,2016,4351,2352,1999,117.7,4217,2282,1935,117.9
32020, 원주시,030002, 26세,2016,3925,2063,1862,110.8,3792,1988,1804,110.2
32020, 원주시,030003, 27세,2016,3758,2050,1708,120,3609,1957,1652,118.5
32020, 원주시,030004, 28세,2016,3668,1919,1749,109.7,3527,1837,1690,108.7
32020, 원주시,030005, 29세,2016,3605,1886,1719,109.7,3487,1810,1677,107.9
32020, 원주시,035,30~34세,2016,21357,11039,10318,107,20764,10669,10095,105.7
32020, 원주시,035001, 30세,2016,3932,2038,1894,107.6,3797,1963,1834,107
32020, 원주시,035002, 31세,2016,3839,2035,1804,112.8,3714,1956,1758,111.3
32020, 원주시,035003, 32세,2016,4027,2095,1932,108.4,3909,2021,1888,107
32020, 원주시,035004, 33세,2016,4615,2402,2213,108.5,4496,2325,2171,107.1
32020, 원주시,035005, 34세,2016,4944,2469,2475,99.8,4848,2404,2444,98.4
32020, 원주시,040,35~39세,2016,24788,12307,12481,98.6,24331,12018,12313,97.6
32020, 원주시,040001, 35세,2016,5011,2543,2468,103,4912,2475,2437,101.6
32020, 원주시,040002, 36세,2016,5085,2492,2593,96.1,4996,2432,2564,94.9
32020, 원주시,040003, 37세,2016,4939,2462,2477,99.4,4838,2405,2433,98.8
32020, 원주시,040004, 38세,2016,4734,2318,2416,95.9,4656,2269,2387,95.1
32020, 원주시,040005, 39세,2016,5019,2492,2527,98.6,4929,2437,2492,97.8
32020, 원주시,045,40~44세,2016,27808,13747,14061,97.8,27492,13578,13914,97.6
32020, 원주시,045001, 40세,2016,4938,2427,2511,96.7,4869,2381,2488,95.7
32020, 원주시,045002, 41세,2016,5251,2623,2628,99.8,5172,2582,2590,99.7
32020, 원주시,045003, 42세,2016,5905,2830,3075,92,5854,2805,3049,92
32020, 원주시,045004, 43세,2016,5984,2958,3026,97.8,5917,2921,2996,97.5
32020, 원주시,045005, 44세,2016,5730,2909,2821,103.1,5680,2889,2791,103.5
32020, 원주시,050,45~49세,2016,30210,15141,15069,100.5,29904,14996,14908,100.6
32020, 원주시,050001, 45세,2016,6166,3085,3081,100.1,6102,3049,3053,99.9
32020, 원주시,050002, 46세,2016,6019,3003,3016,99.6,5944,2967,2977,99.7
32020, 원주시,050003, 47세,2016,6257,3167,3090,102.5,6191,3136,3055,102.7
32020, 원주시,050004, 48세,2016,6184,3146,3038,103.6,6126,3122,3004,103.9
32020, 원주시,050005, 49세,2016,5584,2740,2844,96.3,5541,2722,2819,96.6
32020, 원주시,055,50~54세,2016,28008,14167,13841,102.4,27771,14057,13714,102.5
32020, 원주시,055001, 50세,2016,5726,2941,2785,105.6,5684,2922,2762,105.8
32020, 원주시,055002, 51세,2016,5665,2781,2884,96.4,5613,2751,2862,96.1
32020, 원주시,055003, 52세,2016,5162,2629,2533,103.8,5107,2607,2500,104.3
32020, 원주시,055004, 53세,2016,5560,2840,2720,104.4,5522,2824,2698,104.7
32020, 원주시,055005, 54세,2016,5895,2976,2919,102,5845,2953,2892,102.1
32020, 원주시,060,55~59세,2016,28248,14210,14038,101.2,28051,14125,13926,101.4
32020, 원주시,060001, 55세,2016,6248,3181,3067,103.7,6207,3165,3042,104
32020, 원주시,060002, 56세,2016,6248,3074,3174,96.8,6208,3054,3154,96.8
32020, 원주시,060003, 57세,2016,5554,2748,2806,97.9,5508,2726,2782,98
32020, 원주시,060004, 58세,2016,5172,2609,2563,101.8,5139,2596,2543,102.1
32020, 원주시,060005, 59세,2016,5026,2598,2428,107,4989,2584,2405,107.4
32020, 원주시,065,60~64세,2016,19438,9812,9626,101.9,19285,9737,9548,102
32020, 원주시,065001, 60세,2016,4552,2343,2209,106.1,4514,2322,2192,105.9
32020, 원주시,065002, 61세,2016,4228,2135,2093,102,4196,2116,2080,101.7
32020, 원주시,065003, 62세,2016,3679,1891,1788,105.8,3650,1879,1771,106.1
32020, 원주시,065004, 63세,2016,2893,1436,1457,98.6,2867,1429,1438,99.4
32020, 원주시,065005, 64세,2016,4086,2007,2079,96.5,4058,1991,2067,96.3
32020, 원주시,070,65~69세,2016,11178,5312,5866,90.6,11089,5269,5820,90.5
32020, 원주시,070001, 65세,2016,2093,994,1099,90.4,2063,983,1080,91
32020, 원주시,070002, 66세,2016,2114,1001,1113,89.9,2096,992,1104,89.9
32020, 원주시,070003, 67세,2016,2179,1025,1154,88.8,2162,1015,1147,88.5
32020, 원주시,070004, 68세,2016,2354,1133,1221,92.8,2338,1124,1214,92.6
32020, 원주시,070005, 69세,2016,2438,1159,1279,90.6,2430,1155,1275,90.6
32020, 원주시,075,70~74세,2016,10792,4746,6046,78.5,10756,4730,6026,78.5
32020, 원주시,075001, 70세,2016,2013,915,1098,83.3,1998,906,1092,83
32020, 원주시,075002, 71세,2016,2080,964,1116,86.4,2074,961,1113,86.3
32020, 원주시,075003, 72세,2016,2087,938,1149,81.6,2081,936,1145,81.7
32020, 원주시,075004, 73세,2016,2160,919,1241,74.1,2157,918,1239,74.1
32020, 원주시,075005, 74세,2016,2452,1010,1442,70,2446,1009,1437,70.2
32020, 원주시,080,75~79세,2016,9881,4053,5828,69.5,9862,4045,5817,69.5
32020, 원주시,080001, 75세,2016,2231,962,1269,75.8,2226,961,1265,76
32020, 원주시,080002, 76세,2016,2035,802,1233,65,2032,800,1232,64.9
32020, 원주시,080003, 77세,2016,2065,841,1224,68.7,2063,841,1222,68.8
32020, 원주시,080004, 78세,2016,1900,761,1139,66.8,1895,759,1136,66.8
32020, 원주시,080005, 79세,2016,1650,687,963,71.3,1646,684,962,71.1
32020, 원주시,085,80~84세,2016,5912,2024,3888,52.1,5900,2020,3880,52.1
32020, 원주시,085001, 80세,2016,1506,597,909,65.7,1506,597,909,65.7
32020, 원주시,085002, 81세,2016,1365,457,908,50.3,1361,456,905,50.4
32020, 원주시,085003, 82세,2016,1153,365,788,46.3,1148,363,785,46.2
32020, 원주시,085004, 83세,2016,1018,344,674,51,1018,344,674,51
32020, 원주시,085005, 84세,2016,870,261,609,42.9,867,260,607,42.8
32020, 원주시,090,85~89세,2016,2787,742,2045,36.3,2779,739,2040,36.2
32020, 원주시,090001, 85세,2016,710,203,507,40,709,202,507,39.8
32020, 원주시,090002, 86세,2016,691,184,507,36.3,689,184,505,36.4
32020, 원주시,090003, 87세,2016,554,140,414,33.8,553,140,413,33.9
32020, 원주시,090004, 88세,2016,467,115,352,32.7,466,115,351,32.8
32020, 원주시,090005, 89세,2016,365,100,265,37.7,362,98,264,37.1
32020, 원주시,095,90~94세,2016,946,273,673,40.6,943,272,671,40.5
32020, 원주시,095001, 90세,2016,276,66,210,31.4,275,65,210,31
32020, 원주시,095002, 91세,2016,225,78,147,53.1,225,78,147,53.1
32020, 원주시,095003, 92세,2016,195,65,130,50,194,65,129,50.4
32020, 원주시,095004, 93세,2016,141,40,101,39.6,141,40,101,39.6
32020, 원주시,095005, 94세,2016,109,24,85,28.2,108,24,84,28.6
32020, 원주시,100,95~99세,2016,189,33,156,21.2,189,33,156,21.2
32020, 원주시,100001, 95세,2016,60,9,51,17.6,60,9,51,17.6
32020, 원주시,100002, 96세,2016,51,15,36,41.7,51,15,36,41.7
32020, 원주시,100003, 97세,2016,39,6,33,18.2,39,6,33,18.2
32020, 원주시,100004, 98세,2016,19,X,18,5.6,19,X,18,5.6
32020, 원주시,100005, 99세,2016,20,X,18,11.1,20,X,18,11.1
32020, 원주시,101,100세이상,2016,30,5,25,20,30,5,25,20
32020, 원주시,102,15세미만,2016,47384,24248,23136,104.8,47306,24218,23088,104.9
32020, 원주시,103,15~64세,2016,248380,126790,121590,104.3,244813,124783,120030,104
32020, 원주시,104,65세이상,2016,41715,17188,24527,70.1,41548,17113,24435,70
32020, 원주시,086,85세이상,2016,3952,1053,2899,36.3,3941,1049,2892,36.3
32020, 원주시,126,평균연령,2016,40.3,39.1,41.4,,40.3,39.1,41.5,
32020, 원주시,127,중위연령,2016,41.3,40.1,42.5,,41.5,40.2,42.5,
32030, 강릉시,000,합계,2016,215977,108852,107125,101.6,213664,107611,106053,101.5
32030, 강릉시,005,0~4세,2016,7060,3614,3446,104.9,7034,3598,3436,104.7
32030, 강릉시,005001, 0세,2016,1286,662,624,106.1,1281,660,621,106.3
32030, 강릉시,005002, 1세,2016,1395,697,698,99.9,1389,692,697,99.3
32030, 강릉시,005003, 2세,2016,1332,677,655,103.4,1327,675,652,103.5
32030, 강릉시,005004, 3세,2016,1415,752,663,113.4,1413,751,662,113.4
32030, 강릉시,005005, 4세,2016,1632,826,806,102.5,1624,820,804,102
32030, 강릉시,010,5~9세,2016,8396,4385,4011,109.3,8356,4364,3992,109.3
32030, 강릉시,010001, 5세,2016,1660,871,789,110.4,1649,866,783,110.6
32030, 강릉시,010002, 6세,2016,1635,867,768,112.9,1626,862,764,112.8
32030, 강릉시,010003, 7세,2016,1660,818,842,97.1,1656,815,841,96.9
32030, 강릉시,010004, 8세,2016,1660,849,811,104.7,1653,847,806,105.1
32030, 강릉시,010005, 9세,2016,1781,980,801,122.3,1772,974,798,122.1
32030, 강릉시,015,10~14세,2016,9520,5022,4498,111.6,9498,5012,4486,111.7
32030, 강릉시,015001, 10세,2016,1698,942,756,124.6,1691,940,751,125.2
32030, 강릉시,015002, 11세,2016,1745,904,841,107.5,1741,902,839,107.5
32030, 강릉시,015003, 12세,2016,1969,1010,959,105.3,1963,1007,956,105.3
32030, 강릉시,015004, 13세,2016,1990,1034,956,108.2,1988,1032,956,107.9
32030, 강릉시,015005, 14세,2016,2118,1132,986,114.8,2115,1131,984,114.9
32030, 강릉시,020,15~19세,2016,15240,8170,7070,115.6,15170,8139,7031,115.8
32030, 강릉시,020001, 15세,2016,2437,1280,1157,110.6,2435,1278,1157,110.5
32030, 강릉시,020002, 16세,2016,2709,1365,1344,101.6,2702,1364,1338,101.9
32030, 강릉시,020003, 17세,2016,2492,1266,1226,103.3,2489,1264,1225,103.2
32030, 강릉시,020004, 18세,2016,3193,1702,1491,114.2,3174,1692,1482,114.2
32030, 강릉시,020005, 19세,2016,4409,2557,1852,138.1,4370,2541,1829,138.9
32030, 강릉시,025,20~24세,2016,18472,10982,7490,146.6,18083,10798,7285,148.2
32030, 강릉시,025001, 20세,2016,3844,2072,1772,116.9,3802,2055,1747,117.6
32030, 강릉시,025002, 21세,2016,3577,1867,1710,109.2,3500,1836,1664,110.3
32030, 강릉시,025003, 22세,2016,3861,2289,1572,145.6,3769,2242,1527,146.8
32030, 강릉시,025004, 23세,2016,3720,2432,1288,188.8,3635,2395,1240,193.1
32030, 강릉시,025005, 24세,2016,3470,2322,1148,202.3,3377,2270,1107,205.1
32030, 강릉시,030,25~29세,2016,10784,6198,4586,135.2,10372,5966,4406,135.4
32030, 강릉시,030001, 25세,2016,2702,1648,1054,156.4,2624,1606,1018,157.8
32030, 강릉시,030002, 26세,2016,2147,1285,862,149.1,2064,1236,828,149.3
32030, 강릉시,030003, 27세,2016,2088,1179,909,129.7,2010,1135,875,129.7
32030, 강릉시,030004, 28세,2016,1927,1047,880,119,1837,993,844,117.7
32030, 강릉시,030005, 29세,2016,1920,1039,881,117.9,1837,996,841,118.4
32030, 강릉시,035,30~34세,2016,10647,5570,5077,109.7,10317,5368,4949,108.5
32030, 강릉시,035001, 30세,2016,1919,1059,860,123.1,1844,1012,832,121.6
32030, 강릉시,035002, 31세,2016,1926,1021,905,112.8,1858,981,877,111.9
32030, 강릉시,035003, 32세,2016,2027,1090,937,116.3,1959,1046,913,114.6
32030, 강릉시,035004, 33세,2016,2272,1176,1096,107.3,2207,1138,1069,106.5
32030, 강릉시,035005, 34세,2016,2503,1224,1279,95.7,2449,1191,1258,94.7
32030, 강릉시,040,35~39세,2016,13465,6852,6613,103.6,13249,6731,6518,103.3
32030, 강릉시,040001, 35세,2016,2635,1384,1251,110.6,2584,1358,1226,110.8
32030, 강릉시,040002, 36세,2016,2738,1367,1371,99.7,2687,1338,1349,99.2
32030, 강릉시,040003, 37세,2016,2763,1399,1364,102.6,2711,1371,1340,102.3
32030, 강릉시,040004, 38세,2016,2596,1302,1294,100.6,2558,1278,1280,99.8
32030, 강릉시,040005, 39세,2016,2733,1400,1333,105,2709,1386,1323,104.8
32030, 강릉시,045,40~44세,2016,16173,8307,7866,105.6,15987,8200,7787,105.3
32030, 강릉시,045001, 40세,2016,2797,1397,1400,99.8,2765,1379,1386,99.5
32030, 강릉시,045002, 41세,2016,3069,1552,1517,102.3,3024,1521,1503,101.2
32030, 강릉시,045003, 42세,2016,3448,1765,1683,104.9,3410,1744,1666,104.7
32030, 강릉시,045004, 43세,2016,3618,1859,1759,105.7,3574,1835,1739,105.5
32030, 강릉시,045005, 44세,2016,3241,1734,1507,115.1,3214,1721,1493,115.3
32030, 강릉시,050,45~49세,2016,17827,9096,8731,104.2,17653,8998,8655,104
32030, 강릉시,050001, 45세,2016,3601,1835,1766,103.9,3572,1821,1751,104
32030, 강릉시,050002, 46세,2016,3666,1916,1750,109.5,3621,1887,1734,108.8
32030, 강릉시,050003, 47세,2016,3564,1815,1749,103.8,3531,1800,1731,104
32030, 강릉시,050004, 48세,2016,3652,1821,1831,99.5,3611,1794,1817,98.7
32030, 강릉시,050005, 49세,2016,3344,1709,1635,104.5,3318,1696,1622,104.6
32030, 강릉시,055,50~54세,2016,17013,8585,8428,101.9,16861,8518,8343,102.1
32030, 강릉시,055001, 50세,2016,3415,1777,1638,108.5,3379,1759,1620,108.6
32030, 강릉시,055002, 51세,2016,3070,1478,1592,92.8,3041,1467,1574,93.2
32030, 강릉시,055003, 52세,2016,3226,1669,1557,107.2,3199,1654,1545,107.1
32030, 강릉시,055004, 53세,2016,3563,1771,1792,98.8,3529,1759,1770,99.4
32030, 강릉시,055005, 54세,2016,3739,1890,1849,102.2,3713,1879,1834,102.5
32030, 강릉시,060,55~59세,2016,19437,9458,9979,94.8,19319,9391,9928,94.6
32030, 강릉시,060001, 55세,2016,4053,1906,2147,88.8,4029,1892,2137,88.5
32030, 강릉시,060002, 56세,2016,4108,2003,2105,95.2,4075,1984,2091,94.9
32030, 강릉시,060003, 57세,2016,3946,1897,2049,92.6,3922,1885,2037,92.5
32030, 강릉시,060004, 58세,2016,3669,1823,1846,98.8,3645,1809,1836,98.5
32030, 강릉시,060005, 59세,2016,3661,1829,1832,99.8,3648,1821,1827,99.7
32030, 강릉시,065,60~64세,2016,15015,7182,7833,91.7,14927,7140,7787,91.7
32030, 강릉시,065001, 60세,2016,3302,1604,1698,94.5,3281,1597,1684,94.8
32030, 강릉시,065002, 61세,2016,3282,1568,1714,91.5,3264,1560,1704,91.5
32030, 강릉시,065003, 62세,2016,2949,1397,1552,90,2935,1388,1547,89.7
32030, 강릉시,065004, 63세,2016,2556,1210,1346,89.9,2537,1200,1337,89.8
32030, 강릉시,065005, 64세,2016,2926,1403,1523,92.1,2910,1395,1515,92.1
32030, 강릉시,070,65~69세,2016,10562,4987,5575,89.5,10523,4970,5553,89.5
32030, 강릉시,070001, 65세,2016,1909,904,1005,90,1894,898,996,90.2
32030, 강릉시,070002, 66세,2016,1983,921,1062,86.7,1978,919,1059,86.8
32030, 강릉시,070003, 67세,2016,2226,1045,1181,88.5,2217,1041,1176,88.5
32030, 강릉시,070004, 68세,2016,2253,1100,1153,95.4,2247,1097,1150,95.4
32030, 강릉시,070005, 69세,2016,2191,1017,1174,86.6,2187,1015,1172,86.6
32030, 강릉시,075,70~74세,2016,9861,4501,5360,84,9840,4488,5352,83.9
32030, 강릉시,075001, 70세,2016,1795,871,924,94.3,1791,868,923,94
32030, 강릉시,075002, 71세,2016,2070,943,1127,83.7,2067,942,1125,83.7
32030, 강릉시,075003, 72세,2016,2012,906,1106,81.9,2005,900,1105,81.4
32030, 강릉시,075004, 73세,2016,1904,858,1046,82,1902,856,1046,81.8
32030, 강릉시,075005, 74세,2016,2080,923,1157,79.8,2075,922,1153,80
32030, 강릉시,080,75~79세,2016,8176,3418,4758,71.8,8160,3409,4751,71.8
32030, 강릉시,080001, 75세,2016,1792,749,1043,71.8,1790,748,1042,71.8
32030, 강릉시,080002, 76세,2016,1813,775,1038,74.7,1809,772,1037,74.4
32030, 강릉시,080003, 77세,2016,1640,698,942,74.1,1637,696,941,74
32030, 강릉시,080004, 78세,2016,1594,667,927,72,1592,666,926,71.9
32030, 강릉시,080005, 79세,2016,1337,529,808,65.5,1332,527,805,65.5
32030, 강릉시,085,80~84세,2016,4792,1689,3103,54.4,4783,1687,3096,54.5
32030, 강릉시,085001, 80세,2016,1226,481,745,64.6,1224,481,743,64.7
32030, 강릉시,085002, 81세,2016,1143,411,732,56.1,1141,410,731,56.1
32030, 강릉시,085003, 82세,2016,954,328,626,52.4,951,327,624,52.4
32030, 강릉시,085004, 83세,2016,804,262,542,48.3,802,262,540,48.5
32030, 강릉시,085005, 84세,2016,665,207,458,45.2,665,207,458,45.2
32030, 강릉시,090,85~89세,2016,2396,606,1790,33.9,2396,606,1790,33.9
32030, 강릉시,090001, 85세,2016,585,163,422,38.6,585,163,422,38.6
32030, 강릉시,090002, 86세,2016,560,144,416,34.6,560,144,416,34.6
32030, 강릉시,090003, 87세,2016,525,122,403,30.3,525,122,403,30.3
32030, 강릉시,090004, 88세,2016,385,95,290,32.8,385,95,290,32.8
32030, 강릉시,090005, 89세,2016,341,82,259,31.7,341,82,259,31.7
32030, 강릉시,095,90~94세,2016,916,188,728,25.8,914,187,727,25.7
32030, 강릉시,095001, 90세,2016,259,54,205,26.3,258,54,204,26.5
32030, 강릉시,095002, 91세,2016,226,46,180,25.6,226,46,180,25.6
32030, 강릉시,095003, 92세,2016,162,31,131,23.7,162,31,131,23.7
32030, 강릉시,095004, 93세,2016,154,36,118,30.5,153,35,118,29.7
32030, 강릉시,095005, 94세,2016,115,21,94,22.3,115,21,94,22.3
32030, 강릉시,100,95~99세,2016,201,39,162,24.1,198,38,160,23.8
32030, 강릉시,100001, 95세,2016,84,20,64,31.3,83,20,63,31.7
32030, 강릉시,100002, 96세,2016,39,6,33,18.2,38,6,32,18.8
32030, 강릉시,100003, 97세,2016,38,7,31,22.6,38,7,31,22.6
32030, 강릉시,100004, 98세,2016,24,X,20,20,24,X,20,20
32030, 강릉시,100005, 99세,2016,16,X,14,14.3,15,X,14,7.1
32030, 강릉시,101,100세이상,2016,24,X,21,14.3,24,X,21,14.3
32030, 강릉시,102,15세미만,2016,24976,13021,11955,108.9,24888,12974,11914,108.9
32030, 강릉시,103,15~64세,2016,154073,80400,73673,109.1,151938,79249,72689,109
32030, 강릉시,104,65세이상,2016,36928,15431,21497,71.8,36838,15388,21450,71.7
32030, 강릉시,086,85세이상,2016,3537,836,2701,31,3532,834,2698,30.9
32030, 강릉시,126,평균연령,2016,43,41.1,44.9,,43.1,41.2,45,
32030, 강릉시,127,중위연령,2016,44.5,42.4,46.7,,44.6,42.5,46.8,
32040, 동해시,000,합계,2016,89527,45410,44117,102.9,88752,45010,43742,102.9
32040, 동해시,005,0~4세,2016,3735,1938,1797,107.8,3729,1933,1796,107.6
32040, 동해시,005001, 0세,2016,688,345,343,100.6,685,342,343,99.7
32040, 동해시,005002, 1세,2016,689,360,329,109.4,688,360,328,109.8
32040, 동해시,005003, 2세,2016,728,396,332,119.3,727,395,332,119
32040, 동해시,005004, 3세,2016,774,389,385,101,774,389,385,101
32040, 동해시,005005, 4세,2016,856,448,408,109.8,855,447,408,109.6
32040, 동해시,010,5~9세,2016,4248,2231,2017,110.6,4243,2229,2014,110.7
32040, 동해시,010001, 5세,2016,851,431,420,102.6,851,431,420,102.6
32040, 동해시,010002, 6세,2016,779,423,356,118.8,777,421,356,118.3
32040, 동해시,010003, 7세,2016,841,425,416,102.2,840,425,415,102.4
32040, 동해시,010004, 8세,2016,872,469,403,116.4,871,469,402,116.7
32040, 동해시,010005, 9세,2016,905,483,422,114.5,904,483,421,114.7
32040, 동해시,015,10~14세,2016,4479,2319,2160,107.4,4474,2316,2158,107.3
32040, 동해시,015001, 10세,2016,815,401,414,96.9,813,399,414,96.4
32040, 동해시,015002, 11세,2016,854,434,420,103.3,853,433,420,103.1
32040, 동해시,015003, 12세,2016,924,499,425,117.4,924,499,425,117.4
32040, 동해시,015004, 13세,2016,903,484,419,115.5,902,484,418,115.8
32040, 동해시,015005, 14세,2016,983,501,482,103.9,982,501,481,104.2
32040, 동해시,020,15~19세,2016,5093,2795,2298,121.6,5086,2794,2292,121.9
32040, 동해시,020001, 15세,2016,1098,575,523,109.9,1096,575,521,110.4
32040, 동해시,020002, 16세,2016,1102,580,522,111.1,1102,580,522,111.1
32040, 동해시,020003, 17세,2016,1135,612,523,117,1135,612,523,117
32040, 동해시,020004, 18세,2016,1029,548,481,113.9,1026,547,479,114.2
32040, 동해시,020005, 19세,2016,729,480,249,192.8,727,480,247,194.3
32040, 동해시,025,20~24세,2016,4582,2791,1791,155.8,4515,2759,1756,157.1
32040, 동해시,025001, 20세,2016,911,630,281,224.2,907,627,280,223.9
32040, 동해시,025002, 21세,2016,921,598,323,185.1,913,593,320,185.3
32040, 동해시,025003, 22세,2016,908,525,383,137.1,890,517,373,138.6
32040, 동해시,025004, 23세,2016,955,524,431,121.6,937,516,421,122.6
32040, 동해시,025005, 24세,2016,887,514,373,137.8,868,506,362,139.8
32040, 동해시,030,25~29세,2016,3884,2139,1745,122.6,3728,2062,1666,123.8
32040, 동해시,030001, 25세,2016,771,431,340,126.8,739,416,323,128.8
32040, 동해시,030002, 26세,2016,784,444,340,130.6,761,437,324,134.9
32040, 동해시,030003, 27세,2016,782,444,338,131.4,746,423,323,131
32040, 동해시,030004, 28세,2016,762,406,356,114,731,392,339,115.6
32040, 동해시,030005, 29세,2016,785,414,371,111.6,751,394,357,110.4
32040, 동해시,035,30~34세,2016,4919,2665,2254,118.2,4791,2595,2196,118.2
32040, 동해시,035001, 30세,2016,811,443,368,120.4,784,429,355,120.8
32040, 동해시,035002, 31세,2016,911,492,419,117.4,884,479,405,118.3
32040, 동해시,035003, 32세,2016,910,511,399,128.1,891,504,387,130.2
32040, 동해시,035004, 33세,2016,1054,568,486,116.9,1028,549,479,114.6
32040, 동해시,035005, 34세,2016,1233,651,582,111.9,1204,634,570,111.2
32040, 동해시,040,35~39세,2016,6460,3250,3210,101.2,6346,3171,3175,99.9
32040, 동해시,040001, 35세,2016,1290,677,613,110.4,1268,661,607,108.9
32040, 동해시,040002, 36세,2016,1279,638,641,99.5,1248,614,634,96.8
32040, 동해시,040003, 37세,2016,1260,621,639,97.2,1236,603,633,95.3
32040, 동해시,040004, 38세,2016,1307,633,674,93.9,1285,618,667,92.7
32040, 동해시,040005, 39세,2016,1324,681,643,105.9,1309,675,634,106.5
32040, 동해시,045,40~44세,2016,7491,3982,3509,113.5,7415,3940,3475,113.4
32040, 동해시,045001, 40세,2016,1290,676,614,110.1,1276,665,611,108.8
32040, 동해시,045002, 41세,2016,1420,741,679,109.1,1402,727,675,107.7
32040, 동해시,045003, 42세,2016,1634,833,801,104,1612,827,785,105.4
32040, 동해시,045004, 43세,2016,1621,888,733,121.1,1612,883,729,121.1
32040, 동해시,045005, 44세,2016,1526,844,682,123.8,1513,838,675,124.1
32040, 동해시,050,45~49세,2016,8012,4148,3864,107.3,7944,4115,3829,107.5
32040, 동해시,050001, 45세,2016,1680,839,841,99.8,1658,829,829,100
32040, 동해시,050002, 46세,2016,1610,845,765,110.5,1597,838,759,110.4
32040, 동해시,050003, 47세,2016,1618,815,803,101.5,1606,810,796,101.8
32040, 동해시,050004, 48세,2016,1592,860,732,117.5,1581,854,727,117.5
32040, 동해시,050005, 49세,2016,1512,789,723,109.1,1502,784,718,109.2
32040, 동해시,055,50~54세,2016,7340,3771,3569,105.7,7285,3751,3534,106.1
32040, 동해시,055001, 50세,2016,1451,734,717,102.4,1439,731,708,103.2
32040, 동해시,055002, 51세,2016,1412,730,682,107,1398,725,673,107.7
32040, 동해시,055003, 52세,2016,1387,720,667,107.9,1372,714,658,108.5
32040, 동해시,055004, 53세,2016,1480,755,725,104.1,1473,754,719,104.9
32040, 동해시,055005, 54세,2016,1610,832,778,106.9,1603,827,776,106.6
32040, 동해시,060,55~59세,2016,8165,3975,4190,94.9,8130,3959,4171,94.9
32040, 동해시,060001, 55세,2016,1637,819,818,100.1,1634,817,817,100
32040, 동해시,060002, 56세,2016,1844,903,941,96,1834,899,935,96.1
32040, 동해시,060003, 57세,2016,1587,747,840,88.9,1581,746,835,89.3
32040, 동해시,060004, 58세,2016,1562,735,827,88.9,1554,731,823,88.8
32040, 동해시,060005, 59세,2016,1535,771,764,100.9,1527,766,761,100.7
32040, 동해시,065,60~64세,2016,6423,3171,3252,97.5,6396,3164,3232,97.9
32040, 동해시,065001, 60세,2016,1324,671,653,102.8,1318,668,650,102.8
32040, 동해시,065002, 61세,2016,1468,718,750,95.7,1460,717,743,96.5
32040, 동해시,065003, 62세,2016,1283,619,664,93.2,1279,617,662,93.2
32040, 동해시,065004, 63세,2016,1169,596,573,104,1164,595,569,104.6
32040, 동해시,065005, 64세,2016,1179,567,612,92.6,1175,567,608,93.3
32040, 동해시,070,65~69세,2016,4413,2142,2271,94.3,4398,2134,2264,94.3
32040, 동해시,070001, 65세,2016,746,360,386,93.3,744,358,386,92.7
32040, 동해시,070002, 66세,2016,887,428,459,93.2,883,427,456,93.6
32040, 동해시,070003, 67세,2016,900,449,451,99.6,897,448,449,99.8
32040, 동해시,070004, 68세,2016,1020,499,521,95.8,1016,496,520,95.4
32040, 동해시,070005, 69세,2016,860,406,454,89.4,858,405,453,89.4
32040, 동해시,075,70~74세,2016,4005,1810,2195,82.5,3998,1807,2191,82.5
32040, 동해시,075001, 70세,2016,669,308,361,85.3,666,307,359,85.5
32040, 동해시,075002, 71세,2016,811,371,440,84.3,811,371,440,84.3
32040, 동해시,075003, 72세,2016,847,390,457,85.3,846,390,456,85.5
32040, 동해시,075004, 73세,2016,810,351,459,76.5,810,351,459,76.5
32040, 동해시,075005, 74세,2016,868,390,478,81.6,865,388,477,81.3
32040, 동해시,080,75~79세,2016,3197,1358,1839,73.8,3195,1357,1838,73.8
32040, 동해시,080001, 75세,2016,738,347,391,88.7,737,346,391,88.5
32040, 동해시,080002, 76세,2016,674,256,418,61.2,673,256,417,61.4
32040, 동해시,080003, 77세,2016,654,290,364,79.7,654,290,364,79.7
32040, 동해시,080004, 78세,2016,635,265,370,71.6,635,265,370,71.6
32040, 동해시,080005, 79세,2016,496,200,296,67.6,496,200,296,67.6
32040, 동해시,085,80~84세,2016,1881,647,1234,52.4,1881,647,1234,52.4
32040, 동해시,085001, 80세,2016,465,179,286,62.6,465,179,286,62.6
32040, 동해시,085002, 81세,2016,449,163,286,57,449,163,286,57
32040, 동해시,085003, 82세,2016,391,141,250,56.4,391,141,250,56.4
32040, 동해시,085004, 83세,2016,309,96,213,45.1,309,96,213,45.1
32040, 동해시,085005, 84세,2016,267,68,199,34.2,267,68,199,34.2
32040, 동해시,090,85~89세,2016,848,213,635,33.5,848,213,635,33.5
32040, 동해시,090001, 85세,2016,240,67,173,38.7,240,67,173,38.7
32040, 동해시,090002, 86세,2016,201,46,155,29.7,201,46,155,29.7
32040, 동해시,090003, 87세,2016,168,37,131,28.2,168,37,131,28.2
32040, 동해시,090004, 88세,2016,135,32,103,31.1,135,32,103,31.1
32040, 동해시,090005, 89세,2016,104,31,73,42.5,104,31,73,42.5
32040, 동해시,095,90~94세,2016,298,56,242,23.1,296,55,241,22.8
32040, 동해시,095001, 90세,2016,78,13,65,20,77,13,64,20.3
32040, 동해시,095002, 91세,2016,75,16,59,27.1,75,16,59,27.1
32040, 동해시,095003, 92세,2016,56,7,49,14.3,56,7,49,14.3
32040, 동해시,095004, 93세,2016,56,10,46,21.7,56,10,46,21.7
32040, 동해시,095005, 94세,2016,33,10,23,43.5,32,9,23,39.1
32040, 동해시,100,95~99세,2016,49,8,41,19.5,49,8,41,19.5
32040, 동해시,100001, 95세,2016,26,X,22,18.2,26,X,22,18.2
32040, 동해시,100002, 96세,2016,9,X,8,12.5,9,X,8,12.5
32040, 동해시,100003, 97세,2016,5,X,X,66.7,5,X,X,66.7
32040, 동해시,100004, 98세,2016,5,X,X,25,5,X,X,25
32040, 동해시,100005, 99세,2016,X,X,X,0,X,X,X,0
32040, 동해시,101,100세이상,2016,5,X,X,25,5,X,X,25
32040, 동해시,102,15세미만,2016,12462,6488,5974,108.6,12446,6478,5968,108.5
32040, 동해시,103,15~64세,2016,62369,32687,29682,110.1,61636,32310,29326,110.2
32040, 동해시,104,65세이상,2016,14696,6235,8461,73.7,14670,6222,8448,73.7
32040, 동해시,086,85세이상,2016,1200,278,922,30.2,1198,277,921,30.1
32040, 동해시,126,평균연령,2016,43,41.4,44.7,,43.1,41.4,44.7,
32040, 동해시,127,중위연령,2016,44.9,43.4,46.6,,45,43.5,46.7,
32050, 태백시,000,합계,2016,45708,23137,22571,102.5,45421,23035,22386,102.9
32050, 태백시,005,0~4세,2016,1612,825,787,104.8,1610,824,786,104.8
32050, 태백시,005001, 0세,2016,258,139,119,116.8,257,138,119,116
32050, 태백시,005002, 1세,2016,308,158,150,105.3,307,158,149,106
32050, 태백시,005003, 2세,2016,319,164,155,105.8,319,164,155,105.8
32050, 태백시,005004, 3세,2016,326,163,163,100,326,163,163,100
32050, 태백시,005005, 4세,2016,401,201,200,100.5,401,201,200,100.5
32050, 태백시,010,5~9세,2016,2003,1011,992,101.9,2001,1010,991,101.9
32050, 태백시,010001, 5세,2016,396,195,201,97,396,195,201,97
32050, 태백시,010002, 6세,2016,398,203,195,104.1,398,203,195,104.1
32050, 태백시,010003, 7세,2016,390,190,200,95,389,189,200,94.5
32050, 태백시,010004, 8세,2016,388,197,191,103.1,388,197,191,103.1
32050, 태백시,010005, 9세,2016,431,226,205,110.2,430,226,204,110.8
32050, 태백시,015,10~14세,2016,1921,971,950,102.2,1917,969,948,102.2
32050, 태백시,015001, 10세,2016,359,178,181,98.3,357,177,180,98.3
32050, 태백시,015002, 11세,2016,386,207,179,115.6,386,207,179,115.6
32050, 태백시,015003, 12세,2016,366,180,186,96.8,364,179,185,96.8
32050, 태백시,015004, 13세,2016,389,199,190,104.7,389,199,190,104.7
32050, 태백시,015005, 14세,2016,421,207,214,96.7,421,207,214,96.7
32050, 태백시,020,15~19세,2016,2471,1438,1033,139.2,2468,1438,1030,139.6
32050, 태백시,020001, 15세,2016,508,290,218,133,508,290,218,133
32050, 태백시,020002, 16세,2016,563,349,214,163.1,563,349,214,163.1
32050, 태백시,020003, 17세,2016,492,295,197,149.7,491,295,196,150.5
32050, 태백시,020004, 18세,2016,477,267,210,127.1,476,267,209,127.8
32050, 태백시,020005, 19세,2016,431,237,194,122.2,430,237,193,122.8
32050, 태백시,025,20~24세,2016,2130,1214,916,132.5,2106,1211,895,135.3
32050, 태백시,025001, 20세,2016,482,286,196,145.9,479,286,193,148.2
32050, 태백시,025002, 21세,2016,447,260,187,139,447,260,187,139
32050, 태백시,025003, 22세,2016,445,263,182,144.5,439,263,176,149.4
32050, 태백시,025004, 23세,2016,391,211,180,117.2,384,211,173,122
32050, 태백시,025005, 24세,2016,365,194,171,113.5,357,191,166,115.1
32050, 태백시,030,25~29세,2016,1720,878,842,104.3,1653,866,787,110
32050, 태백시,030001, 25세,2016,323,159,164,97,310,156,154,101.3
32050, 태백시,030002, 26세,2016,335,171,164,104.3,322,168,154,109.1
32050, 태백시,030003, 27세,2016,367,191,176,108.5,354,190,164,115.9
32050, 태백시,030004, 28세,2016,329,175,154,113.6,319,174,145,120
32050, 태백시,030005, 29세,2016,366,182,184,98.9,348,178,170,104.7
32050, 태백시,035,30~34세,2016,2230,1167,1063,109.8,2181,1151,1030,111.7
32050, 태백시,035001, 30세,2016,348,205,143,143.4,338,200,138,144.9
32050, 태백시,035002, 31세,2016,349,188,161,116.8,337,185,152,121.7
32050, 태백시,035003, 32세,2016,416,200,216,92.6,411,198,213,93
32050, 태백시,035004, 33세,2016,514,261,253,103.2,501,259,242,107
32050, 태백시,035005, 34세,2016,603,313,290,107.9,594,309,285,108.4
32050, 태백시,040,35~39세,2016,3244,1657,1587,104.4,3217,1643,1574,104.4
32050, 태백시,040001, 35세,2016,560,278,282,98.6,555,277,278,99.6
32050, 태백시,040002, 36세,2016,681,364,317,114.8,671,359,312,115.1
32050, 태백시,040003, 37세,2016,653,326,327,99.7,649,324,325,99.7
32050, 태백시,040004, 38세,2016,695,343,352,97.4,692,341,351,97.2
32050, 태백시,040005, 39세,2016,655,346,309,112,650,342,308,111
32050, 태백시,045,40~44세,2016,3515,1943,1572,123.6,3485,1929,1556,124
32050, 태백시,045001, 40세,2016,628,343,285,120.4,620,339,281,120.6
32050, 태백시,045002, 41세,2016,694,400,294,136.1,689,397,292,136
32050, 태백시,045003, 42세,2016,735,409,326,125.5,731,408,323,126.3
32050, 태백시,045004, 43세,2016,712,382,330,115.8,707,380,327,116.2
32050, 태백시,045005, 44세,2016,746,409,337,121.4,738,405,333,121.6
32050, 태백시,050,45~49세,2016,3878,2127,1751,121.5,3860,2118,1742,121.6
32050, 태백시,050001, 45세,2016,733,387,346,111.8,729,384,345,111.3
32050, 태백시,050002, 46세,2016,799,437,362,120.7,793,434,359,120.9
32050, 태백시,050003, 47세,2016,781,443,338,131.1,778,442,336,131.5
32050, 태백시,050004, 48세,2016,824,460,364,126.4,821,459,362,126.8
32050, 태백시,050005, 49세,2016,741,400,341,117.3,739,399,340,117.4
32050, 태백시,055,50~54세,2016,3727,1979,1748,113.2,3700,1966,1734,113.4
32050, 태백시,055001, 50세,2016,759,397,362,109.7,752,394,358,110.1
32050, 태백시,055002, 51세,2016,742,380,362,105,737,379,358,105.9
32050, 태백시,055003, 52세,2016,683,366,317,115.5,680,365,315,115.9
32050, 태백시,055004, 53세,2016,766,433,333,130,755,426,329,129.5
32050, 태백시,055005, 54세,2016,777,403,374,107.8,776,402,374,107.5
32050, 태백시,060,55~59세,2016,4535,2309,2226,103.7,4522,2305,2217,104
32050, 태백시,060001, 55세,2016,932,468,464,100.9,930,466,464,100.4
32050, 태백시,060002, 56세,2016,990,500,490,102,985,499,486,102.7
32050, 태백시,060003, 57세,2016,912,459,453,101.3,909,459,450,102
32050, 태백시,060004, 58세,2016,817,422,395,106.8,816,422,394,107.1
32050, 태백시,060005, 59세,2016,884,460,424,108.5,882,459,423,108.5
32050, 태백시,065,60~64세,2016,3829,1870,1959,95.5,3822,1867,1955,95.5
32050, 태백시,065001, 60세,2016,811,422,389,108.5,808,420,388,108.2
32050, 태백시,065002, 61세,2016,870,409,461,88.7,867,409,458,89.3
32050, 태백시,065003, 62세,2016,736,360,376,95.7,735,359,376,95.5
32050, 태백시,065004, 63세,2016,664,329,335,98.2,664,329,335,98.2
32050, 태백시,065005, 64세,2016,748,350,398,87.9,748,350,398,87.9
32050, 태백시,070,65~69세,2016,2896,1335,1561,85.5,2891,1332,1559,85.4
32050, 태백시,070001, 65세,2016,541,261,280,93.2,540,260,280,92.9
32050, 태백시,070002, 66세,2016,616,269,347,77.5,614,268,346,77.5
32050, 태백시,070003, 67세,2016,599,292,307,95.1,597,291,306,95.1
32050, 태백시,070004, 68세,2016,581,266,315,84.4,581,266,315,84.4
32050, 태백시,070005, 69세,2016,559,247,312,79.2,559,247,312,79.2
32050, 태백시,075,70~74세,2016,2521,1136,1385,82,2516,1132,1384,81.8
32050, 태백시,075001, 70세,2016,452,202,250,80.8,451,201,250,80.4
32050, 태백시,075002, 71세,2016,510,225,285,78.9,508,223,285,78.2
32050, 태백시,075003, 72세,2016,485,205,280,73.2,484,204,280,72.9
32050, 태백시,075004, 73세,2016,513,248,265,93.6,513,248,265,93.6
32050, 태백시,075005, 74세,2016,561,256,305,83.9,560,256,304,84.2
32050, 태백시,080,75~79세,2016,1961,810,1151,70.4,1957,807,1150,70.2
32050, 태백시,080001, 75세,2016,465,219,246,89,462,217,245,88.6
32050, 태백시,080002, 76세,2016,416,154,262,58.8,415,153,262,58.4
32050, 태백시,080003, 77세,2016,431,173,258,67.1,431,173,258,67.1
32050, 태백시,080004, 78세,2016,346,138,208,66.3,346,138,208,66.3
32050, 태백시,080005, 79세,2016,303,126,177,71.2,303,126,177,71.2
32050, 태백시,085,80~84세,2016,1000,364,636,57.2,1000,364,636,57.2
32050, 태백시,085001, 80세,2016,278,109,169,64.5,278,109,169,64.5
32050, 태백시,085002, 81세,2016,250,88,162,54.3,250,88,162,54.3
32050, 태백시,085003, 82세,2016,202,68,134,50.7,202,68,134,50.7
32050, 태백시,085004, 83세,2016,168,65,103,63.1,168,65,103,63.1
32050, 태백시,085005, 84세,2016,102,34,68,50,102,34,68,50
32050, 태백시,090,85~89세,2016,373,77,296,26,373,77,296,26
32050, 태백시,090001, 85세,2016,95,15,80,18.8,95,15,80,18.8
32050, 태백시,090002, 86세,2016,105,29,76,38.2,105,29,76,38.2
32050, 태백시,090003, 87세,2016,61,7,54,13,61,7,54,13
32050, 태백시,090004, 88세,2016,59,13,46,28.3,59,13,46,28.3
32050, 태백시,090005, 89세,2016,53,13,40,32.5,53,13,40,32.5
32050, 태백시,095,90~94세,2016,123,23,100,23,123,23,100,23
32050, 태백시,095001, 90세,2016,38,6,32,18.8,38,6,32,18.8
32050, 태백시,095002, 91세,2016,25,X,21,19,25,X,21,19
32050, 태백시,095003, 92세,2016,26,X,25,4,26,X,25,4
32050, 태백시,095004, 93세,2016,16,6,10,60,16,6,10,60
32050, 태백시,095005, 94세,2016,18,6,12,50,18,6,12,50
32050, 태백시,100,95~99세,2016,19,X,16,18.8,19,X,16,18.8
32050, 태백시,100001, 95세,2016,X,X,X,0,X,X,X,0
32050, 태백시,100002, 96세,2016,6,X,5,20,6,X,5,20
32050, 태백시,100003, 97세,2016,X,X,X,33.3,X,X,X,33.3
32050, 태백시,100004, 98세,2016,5,X,X,25,5,X,X,25
32050, 태백시,100005, 99세,2016,X,X,X,0,X,X,X,0
32050, 태백시,101,100세이상,2016,X,X,X,,X,X,X,
32050, 태백시,102,15세미만,2016,5536,2807,2729,102.9,5528,2803,2725,102.9
32050, 태백시,103,15~64세,2016,31279,16582,14697,112.8,31014,16494,14520,113.6
32050, 태백시,104,65세이상,2016,8893,3748,5145,72.8,8879,3738,5141,72.7
32050, 태백시,086,85세이상,2016,515,103,412,25,515,103,412,25
32050, 태백시,126,평균연령,2016,45.1,43.6,46.7,,45.2,43.7,46.8,
32050, 태백시,127,중위연령,2016,47.6,46.2,49.4,,47.7,46.2,49.6,
32060, 속초시,000,합계,2016,79109,39191,39918,98.2,78039,38531,39508,97.5
32060, 속초시,005,0~4세,2016,3140,1544,1596,96.7,3132,1541,1591,96.9
32060, 속초시,005001, 0세,2016,545,277,268,103.4,545,277,268,103.4
32060, 속초시,005002, 1세,2016,665,313,352,88.9,664,313,351,89.2
32060, 속초시,005003, 2세,2016,616,307,309,99.4,615,307,308,99.7
32060, 속초시,005004, 3세,2016,633,329,304,108.2,630,327,303,107.9
32060, 속초시,005005, 4세,2016,681,318,363,87.6,678,317,361,87.8
32060, 속초시,010,5~9세,2016,3354,1723,1631,105.6,3343,1715,1628,105.3
32060, 속초시,010001, 5세,2016,684,350,334,104.8,682,348,334,104.2
32060, 속초시,010002, 6세,2016,687,352,335,105.1,686,352,334,105.4
32060, 속초시,010003, 7세,2016,637,316,321,98.4,637,316,321,98.4
32060, 속초시,010004, 8세,2016,654,333,321,103.7,651,332,319,104.1
32060, 속초시,010005, 9세,2016,692,372,320,116.3,687,367,320,114.7
32060, 속초시,015,10~14세,2016,3856,1982,1874,105.8,3850,1979,1871,105.8
32060, 속초시,015001, 10세,2016,657,321,336,95.5,657,321,336,95.5
32060, 속초시,015002, 11세,2016,683,345,338,102.1,682,345,337,102.4
32060, 속초시,015003, 12세,2016,834,440,394,111.7,834,440,394,111.7
32060, 속초시,015004, 13세,2016,817,424,393,107.9,815,423,392,107.9
32060, 속초시,015005, 14세,2016,865,452,413,109.4,862,450,412,109.2
32060, 속초시,020,15~19세,2016,4536,2409,2127,113.3,4521,2400,2121,113.2
32060, 속초시,020001, 15세,2016,987,478,509,93.9,986,478,508,94.1
32060, 속초시,020002, 16세,2016,1087,585,502,116.5,1085,583,502,116.1
32060, 속초시,020003, 17세,2016,1027,534,493,108.3,1026,534,492,108.5
32060, 속초시,020004, 18세,2016,899,494,405,122,897,492,405,121.5
32060, 속초시,020005, 19세,2016,536,318,218,145.9,527,313,214,146.3
32060, 속초시,025,20~24세,2016,3858,2237,1621,138,3683,2139,1544,138.5
32060, 속초시,025001, 20세,2016,768,480,288,166.7,720,457,263,173.8
32060, 속초시,025002, 21세,2016,831,545,286,190.6,790,523,267,195.9
32060, 속초시,025003, 22세,2016,767,436,331,131.7,736,416,320,130
32060, 속초시,025004, 23세,2016,697,373,324,115.1,677,359,318,112.9
32060, 속초시,025005, 24세,2016,795,403,392,102.8,760,384,376,102.1
32060, 속초시,030,25~29세,2016,3775,2071,1704,121.5,3597,1957,1640,119.3
32060, 속초시,030001, 25세,2016,772,413,359,115,733,390,343,113.7
32060, 속초시,030002, 26세,2016,769,426,343,124.2,724,398,326,122.1
32060, 속초시,030003, 27세,2016,723,404,319,126.6,696,382,314,121.7
32060, 속초시,030004, 28세,2016,756,422,334,126.3,722,403,319,126.3
32060, 속초시,030005, 29세,2016,755,406,349,116.3,722,384,338,113.6
32060, 속초시,035,30~34세,2016,4382,2338,2044,114.4,4210,2225,1985,112.1
32060, 속초시,035001, 30세,2016,739,392,347,113,708,371,337,110.1
32060, 속초시,035002, 31세,2016,771,413,358,115.4,734,394,340,115.9
32060, 속초시,035003, 32세,2016,864,473,391,121,832,451,381,118.4
32060, 속초시,035004, 33세,2016,916,498,418,119.1,882,477,405,117.8
32060, 속초시,035005, 34세,2016,1092,562,530,106,1054,532,522,101.9
32060, 속초시,040,35~39세,2016,5405,2729,2676,102,5286,2638,2648,99.6
32060, 속초시,040001, 35세,2016,1130,591,539,109.6,1103,573,530,108.1
32060, 속초시,040002, 36세,2016,1098,540,558,96.8,1075,523,552,94.7
32060, 속초시,040003, 37세,2016,1092,538,554,97.1,1072,523,549,95.3
32060, 속초시,040004, 38세,2016,1021,512,509,100.6,994,489,505,96.8
32060, 속초시,040005, 39세,2016,1064,548,516,106.2,1042,530,512,103.5
32060, 속초시,045,40~44세,2016,6244,3122,3122,100,6131,3035,3096,98
32060, 속초시,045001, 40세,2016,1069,529,540,98,1045,511,534,95.7
32060, 속초시,045002, 41세,2016,1135,554,581,95.4,1112,535,577,92.7
32060, 속초시,045003, 42세,2016,1337,680,657,103.5,1319,665,654,101.7
32060, 속초시,045004, 43세,2016,1335,667,668,99.9,1306,647,659,98.2
32060, 속초시,045005, 44세,2016,1368,692,676,102.4,1349,677,672,100.7
32060, 속초시,050,45~49세,2016,7487,3695,3792,97.4,7422,3656,3766,97.1
32060, 속초시,050001, 45세,2016,1472,708,764,92.7,1458,701,757,92.6
32060, 속초시,050002, 46세,2016,1514,774,740,104.6,1499,764,735,103.9
32060, 속초시,050003, 47세,2016,1554,781,773,101,1543,774,769,100.7
32060, 속초시,050004, 48세,2016,1561,757,804,94.2,1546,747,799,93.5
32060, 속초시,050005, 49세,2016,1386,675,711,94.9,1376,670,706,94.9
32060, 속초시,055,50~54세,2016,7160,3672,3488,105.3,7091,3642,3449,105.6
32060, 속초시,055001, 50세,2016,1364,744,620,120,1355,740,615,120.3
32060, 속초시,055002, 51세,2016,1350,678,672,100.9,1331,669,662,101.1
32060, 속초시,055003, 52세,2016,1428,708,720,98.3,1417,704,713,98.7
32060, 속초시,055004, 53세,2016,1537,774,763,101.4,1514,765,749,102.1
32060, 속초시,055005, 54세,2016,1481,768,713,107.7,1474,764,710,107.6
32060, 속초시,060,55~59세,2016,7617,3733,3884,96.1,7573,3718,3855,96.4
32060, 속초시,060001, 55세,2016,1628,767,861,89.1,1621,765,856,89.4
32060, 속초시,060002, 56세,2016,1647,773,874,88.4,1636,768,868,88.5
32060, 속초시,060003, 57세,2016,1476,730,746,97.9,1467,727,740,98.2
32060, 속초시,060004, 58세,2016,1506,758,748,101.3,1499,757,742,102
32060, 속초시,060005, 59세,2016,1360,705,655,107.6,1350,701,649,108
32060, 속초시,065,60~64세,2016,5649,2844,2805,101.4,5610,2821,2789,101.1
32060, 속초시,065001, 60세,2016,1251,665,586,113.5,1248,663,585,113.3
32060, 속초시,065002, 61세,2016,1340,692,648,106.8,1329,686,643,106.7
32060, 속초시,065003, 62세,2016,1201,583,618,94.3,1193,577,616,93.7
32060, 속초시,065004, 63세,2016,906,447,459,97.4,897,440,457,96.3
32060, 속초시,065005, 64세,2016,951,457,494,92.5,943,455,488,93.2
32060, 속초시,070,65~69세,2016,3628,1669,1959,85.2,3605,1657,1948,85.1
32060, 속초시,070001, 65세,2016,651,269,382,70.4,644,267,377,70.8
32060, 속초시,070002, 66세,2016,706,323,383,84.3,703,322,381,84.5
32060, 속초시,070003, 67세,2016,743,371,372,99.7,736,367,369,99.5
32060, 속초시,070004, 68세,2016,738,340,398,85.4,734,336,398,84.4
32060, 속초시,070005, 69세,2016,790,366,424,86.3,788,365,423,86.3
32060, 속초시,075,70~74세,2016,3425,1486,1939,76.6,3413,1481,1932,76.7
32060, 속초시,075001, 70세,2016,677,305,372,82,674,303,371,81.7
32060, 속초시,075002, 71세,2016,732,319,413,77.2,730,318,412,77.2
32060, 속초시,075003, 72세,2016,660,272,388,70.1,658,271,387,70
32060, 속초시,075004, 73세,2016,664,310,354,87.6,661,310,351,88.3
32060, 속초시,075005, 74세,2016,692,280,412,68,690,279,411,67.9
32060, 속초시,080,75~79세,2016,2715,1105,1610,68.6,2705,1099,1606,68.4
32060, 속초시,080001, 75세,2016,638,276,362,76.2,634,274,360,76.1
32060, 속초시,080002, 76세,2016,580,252,328,76.8,579,251,328,76.5
32060, 속초시,080003, 77세,2016,537,202,335,60.3,537,202,335,60.3
32060, 속초시,080004, 78세,2016,514,205,309,66.3,511,204,307,66.4
32060, 속초시,080005, 79세,2016,446,170,276,61.6,444,168,276,60.9
32060, 속초시,085,80~84세,2016,1609,535,1074,49.8,1601,531,1070,49.6
32060, 속초시,085001, 80세,2016,435,170,265,64.2,434,169,265,63.8
32060, 속초시,085002, 81세,2016,371,122,249,49,371,122,249,49
32060, 속초시,085003, 82세,2016,324,104,220,47.3,320,102,218,46.8
32060, 속초시,085004, 83세,2016,266,88,178,49.4,263,87,176,49.4
32060, 속초시,085005, 84세,2016,213,51,162,31.5,213,51,162,31.5
32060, 속초시,090,85~89세,2016,892,195,697,28,891,195,696,28
32060, 속초시,090001, 85세,2016,192,41,151,27.2,192,41,151,27.2
32060, 속초시,090002, 86세,2016,196,40,156,25.6,196,40,156,25.6
32060, 속초시,090003, 87세,2016,208,48,160,30,208,48,160,30
32060, 속초시,090004, 88세,2016,162,42,120,35,161,42,119,35.3
32060, 속초시,090005, 89세,2016,134,24,110,21.8,134,24,110,21.8
32060, 속초시,095,90~94세,2016,313,86,227,37.9,313,86,227,37.9
32060, 속초시,095001, 90세,2016,97,24,73,32.9,97,24,73,32.9
32060, 속초시,095002, 91세,2016,86,21,65,32.3,86,21,65,32.3
32060, 속초시,095003, 92세,2016,46,11,35,31.4,46,11,35,31.4
32060, 속초시,095004, 93세,2016,57,21,36,58.3,57,21,36,58.3
32060, 속초시,095005, 94세,2016,27,9,18,50,27,9,18,50
32060, 속초시,100,95~99세,2016,59,15,44,34.1,57,15,42,35.7
32060, 속초시,100001, 95세,2016,30,9,21,42.9,29,9,20,45
32060, 속초시,100002, 96세,2016,15,X,12,25,14,X,11,27.3
32060, 속초시,100003, 97세,2016,8,X,6,33.3,8,X,6,33.3
32060, 속초시,100004, 98세,2016,X,X,X,50,X,X,X,50
32060, 속초시,100005, 99세,2016,X,X,X,0,X,X,X,0
32060, 속초시,101,100세이상,2016,5,X,X,25,5,X,X,25
32060, 속초시,102,15세미만,2016,10350,5249,5101,102.9,10325,5235,5090,102.8
32060, 속초시,103,15~64세,2016,56113,28850,27263,105.8,55124,28231,26893,105
32060, 속초시,104,65세이상,2016,12646,5092,7554,67.4,12590,5065,7525,67.3
32060, 속초시,086,85세이상,2016,1269,297,972,30.6,1266,297,969,30.7
32060, 속초시,126,평균연령,2016,43.4,41.8,44.9,,43.5,41.9,45,
32060, 속초시,127,중위연령,2016,45.7,44.2,47.1,,45.9,44.5,47.2,
32070, 삼척시,000,합계,2016,69364,35916,33448,107.4,68544,35457,33087,107.2
32070, 삼척시,005,0~4세,2016,2142,1093,1049,104.2,2139,1091,1048,104.1
32070, 삼척시,005001, 0세,2016,373,186,187,99.5,373,186,187,99.5
32070, 삼척시,005002, 1세,2016,402,213,189,112.7,402,213,189,112.7
32070, 삼척시,005003, 2세,2016,428,213,215,99.1,427,213,214,99.5
32070, 삼척시,005004, 3세,2016,437,225,212,106.1,435,223,212,105.2
32070, 삼척시,005005, 4세,2016,502,256,246,104.1,502,256,246,104.1
32070, 삼척시,010,5~9세,2016,2384,1225,1159,105.7,2383,1224,1159,105.6
32070, 삼척시,010001, 5세,2016,483,255,228,111.8,483,255,228,111.8
32070, 삼척시,010002, 6세,2016,444,215,229,93.9,444,215,229,93.9
32070, 삼척시,010003, 7세,2016,483,260,223,116.6,483,260,223,116.6
32070, 삼척시,010004, 8세,2016,478,239,239,100,477,238,239,99.6
32070, 삼척시,010005, 9세,2016,496,256,240,106.7,496,256,240,106.7
32070, 삼척시,015,10~14세,2016,2537,1303,1234,105.6,2532,1303,1229,106
32070, 삼척시,015001, 10세,2016,471,253,218,116.1,470,253,217,116.6
32070, 삼척시,015002, 11세,2016,487,262,225,116.4,485,262,223,117.5
32070, 삼척시,015003, 12세,2016,487,231,256,90.2,487,231,256,90.2
32070, 삼척시,015004, 13세,2016,530,265,265,100,528,265,263,100.8
32070, 삼척시,015005, 14세,2016,562,292,270,108.1,562,292,270,108.1
32070, 삼척시,020,15~19세,2016,4414,2541,1873,135.7,4402,2538,1864,136.2
32070, 삼척시,020001, 15세,2016,640,367,273,134.4,639,366,273,134.1
32070, 삼척시,020002, 16세,2016,738,428,310,138.1,738,428,310,138.1
32070, 삼척시,020003, 17세,2016,732,384,348,110.3,732,384,348,110.3
32070, 삼척시,020004, 18세,2016,905,522,383,136.3,903,522,381,137
32070, 삼척시,020005, 19세,2016,1399,840,559,150.3,1390,838,552,151.8
32070, 삼척시,025,20~24세,2016,6873,4098,2775,147.7,6716,4015,2701,148.6
32070, 삼척시,025001, 20세,2016,1450,813,637,127.6,1434,806,628,128.3
32070, 삼척시,025002, 21세,2016,1299,643,656,98,1285,634,651,97.4
32070, 삼척시,025003, 22세,2016,1369,805,564,142.7,1334,787,547,143.9
32070, 삼척시,025004, 23세,2016,1446,945,501,188.6,1400,915,485,188.7
32070, 삼척시,025005, 24세,2016,1309,892,417,213.9,1263,873,390,223.8
32070, 삼척시,030,25~29세,2016,3295,2040,1255,162.5,3112,1939,1173,165.3
32070, 삼척시,030001, 25세,2016,892,606,286,211.9,850,582,268,217.2
32070, 삼척시,030002, 26세,2016,725,476,249,191.2,681,455,226,201.3
32070, 삼척시,030003, 27세,2016,579,352,227,155.1,548,331,217,152.5
32070, 삼척시,030004, 28세,2016,543,286,257,111.3,511,274,237,115.6
32070, 삼척시,030005, 29세,2016,556,320,236,135.6,522,297,225,132
32070, 삼척시,035,30~34세,2016,3205,1790,1415,126.5,3064,1709,1355,126.1
32070, 삼척시,035001, 30세,2016,561,330,231,142.9,535,315,220,143.2
32070, 삼척시,035002, 31세,2016,614,354,260,136.2,576,333,243,137
32070, 삼척시,035003, 32세,2016,591,320,271,118.1,574,310,264,117.4
32070, 삼척시,035004, 33세,2016,692,378,314,120.4,659,360,299,120.4
32070, 삼척시,035005, 34세,2016,747,408,339,120.4,720,391,329,118.8
32070, 삼척시,040,35~39세,2016,3892,2099,1793,117.1,3795,2030,1765,115
32070, 삼척시,040001, 35세,2016,765,421,344,122.4,740,404,336,120.2
32070, 삼척시,040002, 36세,2016,781,402,379,106.1,758,383,375,102.1
32070, 삼척시,040003, 37세,2016,784,427,357,119.6,764,414,350,118.3
32070, 삼척시,040004, 38세,2016,779,418,361,115.8,762,406,356,114
32070, 삼척시,040005, 39세,2016,783,431,352,122.4,771,423,348,121.6
32070, 삼척시,045,40~44세,2016,4595,2599,1996,130.2,4516,2545,1971,129.1
32070, 삼척시,045001, 40세,2016,817,435,382,113.9,806,426,380,112.1
32070, 삼척시,045002, 41세,2016,905,504,401,125.7,886,489,397,123.2
32070, 삼척시,045003, 42세,2016,1009,572,437,130.9,994,560,434,129
32070, 삼척시,045004, 43세,2016,984,578,406,142.4,966,566,400,141.5
32070, 삼척시,045005, 44세,2016,880,510,370,137.8,864,504,360,140
32070, 삼척시,050,45~49세,2016,5156,2880,2276,126.5,5112,2860,2252,127
32070, 삼척시,050001, 45세,2016,1047,608,439,138.5,1034,603,431,139.9
32070, 삼척시,050002, 46세,2016,988,557,431,129.2,978,551,427,129
32070, 삼척시,050003, 47세,2016,1045,579,466,124.2,1039,578,461,125.4
32070, 삼척시,050004, 48세,2016,1073,603,470,128.3,1067,600,467,128.5
32070, 삼척시,050005, 49세,2016,1003,533,470,113.4,994,528,466,113.3
32070, 삼척시,055,50~54세,2016,5264,2780,2484,111.9,5229,2765,2464,112.2
32070, 삼척시,055001, 50세,2016,1067,590,477,123.7,1056,585,471,124.2
32070, 삼척시,055002, 51세,2016,964,488,476,102.5,956,485,471,103
32070, 삼척시,055003, 52세,2016,1029,555,474,117.1,1023,552,471,117.2
32070, 삼척시,055004, 53세,2016,1024,541,483,112,1016,538,478,112.6
32070, 삼척시,055005, 54세,2016,1180,606,574,105.6,1178,605,573,105.6
32070, 삼척시,060,55~59세,2016,6487,3302,3185,103.7,6453,3287,3166,103.8
32070, 삼척시,060001, 55세,2016,1424,715,709,100.8,1419,713,706,101
32070, 삼척시,060002, 56세,2016,1404,720,684,105.3,1395,716,679,105.4
32070, 삼척시,060003, 57세,2016,1289,656,633,103.6,1280,654,626,104.5
32070, 삼척시,060004, 58세,2016,1158,595,563,105.7,1153,592,561,105.5
32070, 삼척시,060005, 59세,2016,1212,616,596,103.4,1206,612,594,103
32070, 삼척시,065,60~64세,2016,5062,2521,2541,99.2,5045,2512,2533,99.2
32070, 삼척시,065001, 60세,2016,1075,515,560,92,1069,514,555,92.6
32070, 삼척시,065002, 61세,2016,1125,562,563,99.8,1119,557,562,99.1
32070, 삼척시,065003, 62세,2016,969,487,482,101,966,486,480,101.3
32070, 삼척시,065004, 63세,2016,912,456,456,100,912,456,456,100
32070, 삼척시,065005, 64세,2016,981,501,480,104.4,979,499,480,104
32070, 삼척시,070,65~69세,2016,3823,1840,1983,92.8,3816,1837,1979,92.8
32070, 삼척시,070001, 65세,2016,631,292,339,86.1,629,292,337,86.6
32070, 삼척시,070002, 66세,2016,791,388,403,96.3,789,387,402,96.3
32070, 삼척시,070003, 67세,2016,826,413,413,100,823,411,412,99.8
32070, 삼척시,070004, 68세,2016,850,384,466,82.4,850,384,466,82.4
32070, 삼척시,070005, 69세,2016,725,363,362,100.3,725,363,362,100.3
32070, 삼척시,075,70~74세,2016,3593,1550,2043,75.9,3591,1549,2042,75.9
32070, 삼척시,075001, 70세,2016,622,296,326,90.8,622,296,326,90.8
32070, 삼척시,075002, 71세,2016,709,327,382,85.6,709,327,382,85.6
32070, 삼척시,075003, 72세,2016,733,305,428,71.3,732,304,428,71
32070, 삼척시,075004, 73세,2016,777,327,450,72.7,776,327,449,72.8
32070, 삼척시,075005, 74세,2016,752,295,457,64.6,752,295,457,64.6
32070, 삼척시,080,75~79세,2016,3215,1259,1956,64.4,3213,1257,1956,64.3
32070, 삼척시,080001, 75세,2016,699,261,438,59.6,699,261,438,59.6
32070, 삼척시,080002, 76세,2016,713,301,412,73.1,712,300,412,72.8
32070, 삼척시,080003, 77세,2016,648,266,382,69.6,647,265,382,69.4
32070, 삼척시,080004, 78세,2016,613,232,381,60.9,613,232,381,60.9
32070, 삼척시,080005, 79세,2016,542,199,343,58,542,199,343,58
32070, 삼척시,085,80~84세,2016,2094,693,1401,49.5,2094,693,1401,49.5
32070, 삼척시,085001, 80세,2016,508,178,330,53.9,508,178,330,53.9
32070, 삼척시,085002, 81세,2016,502,181,321,56.4,502,181,321,56.4
32070, 삼척시,085003, 82세,2016,439,140,299,46.8,439,140,299,46.8
32070, 삼척시,085004, 83세,2016,325,100,225,44.4,325,100,225,44.4
32070, 삼척시,085005, 84세,2016,320,94,226,41.6,320,94,226,41.6
32070, 삼척시,090,85~89세,2016,964,238,726,32.8,963,238,725,32.8
32070, 삼척시,090001, 85세,2016,253,73,180,40.6,253,73,180,40.6
32070, 삼척시,090002, 86세,2016,239,59,180,32.8,239,59,180,32.8
32070, 삼척시,090003, 87세,2016,193,44,149,29.5,192,44,148,29.7
32070, 삼척시,090004, 88세,2016,164,36,128,28.1,164,36,128,28.1
32070, 삼척시,090005, 89세,2016,115,26,89,29.2,115,26,89,29.2
32070, 삼척시,095,90~94세,2016,316,58,258,22.5,316,58,258,22.5
32070, 삼척시,095001, 90세,2016,102,20,82,24.4,102,20,82,24.4
32070, 삼척시,095002, 91세,2016,85,17,68,25,85,17,68,25
32070, 삼척시,095003, 92세,2016,51,11,40,27.5,51,11,40,27.5
32070, 삼척시,095004, 93세,2016,50,6,44,13.6,50,6,44,13.6
32070, 삼척시,095005, 94세,2016,28,X,24,16.7,28,X,24,16.7
32070, 삼척시,100,95~99세,2016,47,7,40,17.5,47,7,40,17.5
32070, 삼척시,100001, 95세,2016,17,X,16,6.3,17,X,16,6.3
32070, 삼척시,100002, 96세,2016,9,X,7,28.6,9,X,7,28.6
32070, 삼척시,100003, 97세,2016,8,X,6,33.3,8,X,6,33.3
32070, 삼척시,100004, 98세,2016,12,X,11,9.1,12,X,11,9.1
32070, 삼척시,100005, 99세,2016,X,X,X,,X,X,X,
32070, 삼척시,101,100세이상,2016,6,X,6,0,6,X,6,0
32070, 삼척시,102,15세미만,2016,7063,3621,3442,105.2,7054,3618,3436,105.3
32070, 삼척시,103,15~64세,2016,48243,26650,21593,123.4,47444,26200,21244,123.3
32070, 삼척시,104,65세이상,2016,14058,5645,8413,67.1,14046,5639,8407,67.1
32070, 삼척시,086,85세이상,2016,1333,303,1030,29.4,1332,303,1029,29.4
32070, 삼척시,126,평균연령,2016,44.6,42.2,47.1,,44.7,42.3,47.2,
32070, 삼척시,127,중위연령,2016,46.3,43.4,49.8,,46.6,43.7,50.1,
32310, 홍천군,000,합계,2016,66791,34113,32678,104.4,65622,33409,32213,103.7
32310, 홍천군,005,0~4세,2016,2172,1108,1064,104.1,2171,1107,1064,104
32310, 홍천군,005001, 0세,2016,411,232,179,129.6,411,232,179,129.6
32310, 홍천군,005002, 1세,2016,450,230,220,104.5,450,230,220,104.5
32310, 홍천군,005003, 2세,2016,408,198,210,94.3,408,198,210,94.3
32310, 홍천군,005004, 3세,2016,420,213,207,102.9,419,212,207,102.4
32310, 홍천군,005005, 4세,2016,483,235,248,94.8,483,235,248,94.8
32310, 홍천군,010,5~9세,2016,2488,1233,1255,98.2,2481,1230,1251,98.3
32310, 홍천군,010001, 5세,2016,463,215,248,86.7,463,215,248,86.7
32310, 홍천군,010002, 6세,2016,510,264,246,107.3,509,264,245,107.8
32310, 홍천군,010003, 7세,2016,485,257,228,112.7,484,257,227,113.2
32310, 홍천군,010004, 8세,2016,497,239,258,92.6,495,238,257,92.6
32310, 홍천군,010005, 9세,2016,533,258,275,93.8,530,256,274,93.4
32310, 홍천군,015,10~14세,2016,2667,1386,1281,108.2,2663,1382,1281,107.9
32310, 홍천군,015001, 10세,2016,471,252,219,115.1,470,251,219,114.6
32310, 홍천군,015002, 11세,2016,501,258,243,106.2,500,257,243,105.8
32310, 홍천군,015003, 12세,2016,500,254,246,103.3,499,253,246,102.8
32310, 홍천군,015004, 13세,2016,570,292,278,105,569,291,278,104.7
32310, 홍천군,015005, 14세,2016,625,330,295,111.9,625,330,295,111.9
32310, 홍천군,020,15~19세,2016,3415,1757,1658,106,3404,1753,1651,106.2
32310, 홍천군,020001, 15세,2016,738,399,339,117.7,735,399,336,118.8
32310, 홍천군,020002, 16세,2016,793,380,413,92,792,380,412,92.2
32310, 홍천군,020003, 17세,2016,817,395,422,93.6,815,395,420,94
32310, 홍천군,020004, 18세,2016,640,317,323,98.1,638,315,323,97.5
32310, 홍천군,020005, 19세,2016,427,266,161,165.2,424,264,160,165
32310, 홍천군,025,20~24세,2016,3200,1872,1328,141,3017,1743,1274,136.8
32310, 홍천군,025001, 20세,2016,537,331,206,160.7,533,329,204,161.3
32310, 홍천군,025002, 21세,2016,640,392,248,158.1,617,375,242,155
32310, 홍천군,025003, 22세,2016,597,353,244,144.7,558,324,234,138.5
32310, 홍천군,025004, 23세,2016,711,396,315,125.7,654,357,297,120.2
32310, 홍천군,025005, 24세,2016,715,400,315,127,655,358,297,120.5
32310, 홍천군,030,25~29세,2016,3483,2068,1415,146.1,3201,1858,1343,138.3
32310, 홍천군,030001, 25세,2016,754,438,316,138.6,693,395,298,132.6
32310, 홍천군,030002, 26세,2016,699,431,268,160.8,639,390,249,156.6
32310, 홍천군,030003, 27세,2016,703,425,278,152.9,643,374,269,139
32310, 홍천군,030004, 28세,2016,663,386,277,139.4,608,346,262,132.1
32310, 홍천군,030005, 29세,2016,664,388,276,140.6,618,353,265,133.2
32310, 홍천군,035,30~34세,2016,3391,1926,1465,131.5,3179,1787,1392,128.4
32310, 홍천군,035001, 30세,2016,668,398,270,147.4,612,358,254,140.9
32310, 홍천군,035002, 31세,2016,659,381,278,137.1,618,355,263,135
32310, 홍천군,035003, 32세,2016,644,368,276,133.3,599,339,260,130.4
32310, 홍천군,035004, 33세,2016,652,365,287,127.2,613,339,274,123.7
32310, 홍천군,035005, 34세,2016,768,414,354,116.9,737,396,341,116.1
32310, 홍천군,040,35~39세,2016,3619,1913,1706,112.1,3523,1854,1669,111.1
32310, 홍천군,040001, 35세,2016,751,410,341,120.2,729,395,334,118.3
32310, 홍천군,040002, 36세,2016,741,394,347,113.5,723,382,341,112
32310, 홍천군,040003, 37세,2016,681,353,328,107.6,665,343,322,106.5
32310, 홍천군,040004, 38세,2016,696,377,319,118.2,674,365,309,118.1
32310, 홍천군,040005, 39세,2016,750,379,371,102.2,732,369,363,101.7
32310, 홍천군,045,40~44세,2016,4206,2274,1932,117.7,4146,2244,1902,118
32310, 홍천군,045001, 40세,2016,751,400,351,114,729,386,343,112.5
32310, 홍천군,045002, 41세,2016,749,396,353,112.2,738,390,348,112.1
32310, 홍천군,045003, 42세,2016,905,503,402,125.1,894,500,394,126.9
32310, 홍천군,045004, 43세,2016,928,506,422,119.9,922,505,417,121.1
32310, 홍천군,045005, 44세,2016,873,469,404,116.1,863,463,400,115.8
32310, 홍천군,050,45~49세,2016,4971,2599,2372,109.6,4900,2577,2323,110.9
32310, 홍천군,050001, 45세,2016,944,509,435,117,932,502,430,116.7
32310, 홍천군,050002, 46세,2016,906,473,433,109.2,887,468,419,111.7
32310, 홍천군,050003, 47세,2016,1068,553,515,107.4,1052,547,505,108.3
32310, 홍천군,050004, 48세,2016,1056,546,510,107.1,1040,545,495,110.1
32310, 홍천군,050005, 49세,2016,997,518,479,108.1,989,515,474,108.6
32310, 홍천군,055,50~54세,2016,5717,3031,2686,112.8,5636,3001,2635,113.9
32310, 홍천군,055001, 50세,2016,1050,565,485,116.5,1029,554,475,116.6
32310, 홍천군,055002, 51세,2016,989,521,468,111.3,971,514,457,112.5
32310, 홍천군,055003, 52세,2016,1170,646,524,123.3,1150,642,508,126.4
32310, 홍천군,055004, 53세,2016,1178,619,559,110.7,1171,616,555,111
32310, 홍천군,055005, 54세,2016,1330,680,650,104.6,1315,675,640,105.5
32310, 홍천군,060,55~59세,2016,7169,3665,3504,104.6,7108,3637,3471,104.8
32310, 홍천군,060001, 55세,2016,1578,808,770,104.9,1568,803,765,105
32310, 홍천군,060002, 56세,2016,1364,663,701,94.6,1352,655,697,94
32310, 홍천군,060003, 57세,2016,1321,693,628,110.4,1310,689,621,111
32310, 홍천군,060004, 58세,2016,1472,754,718,105,1455,746,709,105.2
32310, 홍천군,060005, 59세,2016,1434,747,687,108.7,1423,744,679,109.6
32310, 홍천군,065,60~64세,2016,5885,3073,2812,109.3,5837,3050,2787,109.4
32310, 홍천군,065001, 60세,2016,1340,684,656,104.3,1332,682,650,104.9
32310, 홍천군,065002, 61세,2016,1278,685,593,115.5,1267,679,588,115.5
32310, 홍천군,065003, 62세,2016,1107,581,526,110.5,1094,572,522,109.6
32310, 홍천군,065004, 63세,2016,924,456,468,97.4,916,453,463,97.8
32310, 홍천군,065005, 64세,2016,1236,667,569,117.2,1228,664,564,117.7
32310, 홍천군,070,65~69세,2016,3567,1800,1767,101.9,3534,1786,1748,102.2
32310, 홍천군,070001, 65세,2016,626,318,308,103.2,619,315,304,103.6
32310, 홍천군,070002, 66세,2016,680,342,338,101.2,675,339,336,100.9
32310, 홍천군,070003, 67세,2016,685,361,324,111.4,674,357,317,112.6
32310, 홍천군,070004, 68세,2016,758,369,389,94.9,755,367,388,94.6
32310, 홍천군,070005, 69세,2016,818,410,408,100.5,811,408,403,101.2
32310, 홍천군,075,70~74세,2016,3638,1670,1968,84.9,3623,1663,1960,84.8
32310, 홍천군,075001, 70세,2016,706,338,368,91.8,705,338,367,92.1
32310, 홍천군,075002, 71세,2016,706,344,362,95,704,343,361,95
32310, 홍천군,075003, 72세,2016,649,293,356,82.3,646,291,355,82
32310, 홍천군,075004, 73세,2016,743,337,406,83,736,333,403,82.6
32310, 홍천군,075005, 74세,2016,834,358,476,75.2,832,358,474,75.5
32310, 홍천군,080,75~79세,2016,3638,1604,2034,78.9,3637,1604,2033,78.9
32310, 홍천군,080001, 75세,2016,790,368,422,87.2,789,368,421,87.4
32310, 홍천군,080002, 76세,2016,715,315,400,78.8,715,315,400,78.8
32310, 홍천군,080003, 77세,2016,759,313,446,70.2,759,313,446,70.2
32310, 홍천군,080004, 78세,2016,719,325,394,82.5,719,325,394,82.5
32310, 홍천군,080005, 79세,2016,655,283,372,76.1,655,283,372,76.1
32310, 홍천군,085,80~84세,2016,2128,740,1388,53.3,2126,739,1387,53.3
32310, 홍천군,085001, 80세,2016,564,248,316,78.5,562,247,315,78.4
32310, 홍천군,085002, 81세,2016,525,181,344,52.6,525,181,344,52.6
32310, 홍천군,085003, 82세,2016,437,134,303,44.2,437,134,303,44.2
32310, 홍천군,085004, 83세,2016,323,100,223,44.8,323,100,223,44.8
32310, 홍천군,085005, 84세,2016,279,77,202,38.1,279,77,202,38.1
32310, 홍천군,090,85~89세,2016,986,267,719,37.1,985,267,718,37.2
32310, 홍천군,090001, 85세,2016,257,66,191,34.6,257,66,191,34.6
32310, 홍천군,090002, 86세,2016,270,75,195,38.5,269,75,194,38.7
32310, 홍천군,090003, 87세,2016,181,51,130,39.2,181,51,130,39.2
32310, 홍천군,090004, 88세,2016,158,45,113,39.8,158,45,113,39.8
32310, 홍천군,090005, 89세,2016,120,30,90,33.3,120,30,90,33.3
32310, 홍천군,095,90~94세,2016,351,105,246,42.7,351,105,246,42.7
32310, 홍천군,095001, 90세,2016,100,26,74,35.1,100,26,74,35.1
32310, 홍천군,095002, 91세,2016,102,31,71,43.7,102,31,71,43.7
32310, 홍천군,095003, 92세,2016,63,25,38,65.8,63,25,38,65.8
32310, 홍천군,095004, 93세,2016,54,18,36,50,54,18,36,50
32310, 홍천군,095005, 94세,2016,32,5,27,18.5,32,5,27,18.5
32310, 홍천군,100,95~99세,2016,83,18,65,27.7,83,18,65,27.7
32310, 홍천군,100001, 95세,2016,23,X,20,15,23,X,20,15
32310, 홍천군,100002, 96세,2016,24,X,20,20,24,X,20,20
32310, 홍천군,100003, 97세,2016,15,6,9,66.7,15,6,9,66.7
32310, 홍천군,100004, 98세,2016,13,X,11,18.2,13,X,11,18.2
32310, 홍천군,100005, 99세,2016,8,X,5,60,8,X,5,60
32310, 홍천군,101,100세이상,2016,17,X,13,30.8,17,X,13,30.8
32310, 홍천군,102,15세미만,2016,7327,3727,3600,103.5,7315,3719,3596,103.4
32310, 홍천군,103,15~64세,2016,45056,24178,20878,115.8,43951,23504,20447,115
32310, 홍천군,104,65세이상,2016,14408,6208,8200,75.7,14356,6186,8170,75.7
32310, 홍천군,086,85세이상,2016,1437,394,1043,37.8,1436,394,1042,37.8
32310, 홍천군,126,평균연령,2016,46.7,45.1,48.3,,46.8,45.3,48.4,
32310, 홍천군,127,중위연령,2016,49.8,48,51.8,,50.1,48.4,52,
32320, 횡성군,000,합계,2016,42927,21720,21207,102.4,42085,21193,20892,101.4
32320, 횡성군,005,0~4세,2016,1117,540,577,93.6,1114,539,575,93.7
32320, 횡성군,005001, 0세,2016,198,101,97,104.1,197,101,96,105.2
32320, 횡성군,005002, 1세,2016,232,106,126,84.1,232,106,126,84.1
32320, 횡성군,005003, 2세,2016,203,99,104,95.2,203,99,104,95.2
32320, 횡성군,005004, 3세,2016,222,109,113,96.5,222,109,113,96.5
32320, 횡성군,005005, 4세,2016,262,125,137,91.2,260,124,136,91.2
32320, 횡성군,010,5~9세,2016,1385,729,656,111.1,1379,724,655,110.5
32320, 횡성군,010001, 5세,2016,264,141,123,114.6,263,140,123,113.8
32320, 횡성군,010002, 6세,2016,264,132,132,100,261,130,131,99.2
32320, 횡성군,010003, 7세,2016,272,133,139,95.7,271,132,139,95
32320, 횡성군,010004, 8세,2016,286,167,119,140.3,285,166,119,139.5
32320, 횡성군,010005, 9세,2016,299,156,143,109.1,299,156,143,109.1
32320, 횡성군,015,10~14세,2016,1455,767,688,111.5,1453,766,687,111.5
32320, 횡성군,015001, 10세,2016,283,147,136,108.1,282,146,136,107.4
32320, 횡성군,015002, 11세,2016,299,148,151,98,299,148,151,98
32320, 횡성군,015003, 12세,2016,273,153,120,127.5,273,153,120,127.5
32320, 횡성군,015004, 13세,2016,288,158,130,121.5,288,158,130,121.5
32320, 횡성군,015005, 14세,2016,312,161,151,106.6,311,161,150,107.3
32320, 횡성군,020,15~19세,2016,2374,1262,1112,113.5,2359,1255,1104,113.7
32320, 횡성군,020001, 15세,2016,352,193,159,121.4,351,193,158,122.2
32320, 횡성군,020002, 16세,2016,506,259,247,104.9,505,259,246,105.3
32320, 횡성군,020003, 17세,2016,543,284,259,109.7,543,284,259,109.7
32320, 횡성군,020004, 18세,2016,527,300,227,132.2,524,299,225,132.9
32320, 횡성군,020005, 19세,2016,446,226,220,102.7,436,220,216,101.9
32320, 횡성군,025,20~24세,2016,2146,1221,925,132,2026,1130,896,126.1
32320, 횡성군,025001, 20세,2016,511,283,228,124.1,501,276,225,122.7
32320, 횡성군,025002, 21세,2016,456,256,200,128,436,242,194,124.7
32320, 횡성군,025003, 22세,2016,392,234,158,148.1,369,218,151,144.4
32320, 횡성군,025004, 23세,2016,391,232,159,145.9,357,203,154,131.8
32320, 횡성군,025005, 24세,2016,396,216,180,120,363,191,172,111
32320, 횡성군,030,25~29세,2016,1803,1017,786,129.4,1629,902,727,124.1
32320, 횡성군,030001, 25세,2016,397,228,169,134.9,365,206,159,129.6
32320, 횡성군,030002, 26세,2016,382,206,176,117,352,190,162,117.3
32320, 횡성군,030003, 27세,2016,343,207,136,152.2,309,185,124,149.2
32320, 횡성군,030004, 28세,2016,320,178,142,125.4,289,155,134,115.7
32320, 횡성군,030005, 29세,2016,361,198,163,121.5,314,166,148,112.2
32320, 횡성군,035,30~34세,2016,1877,1016,861,118,1738,918,820,112
32320, 횡성군,035001, 30세,2016,317,165,152,108.6,290,149,141,105.7
32320, 횡성군,035002, 31세,2016,395,230,165,139.4,359,205,154,133.1
32320, 횡성군,035003, 32세,2016,353,209,144,145.1,317,184,133,138.3
32320, 횡성군,035004, 33세,2016,417,216,201,107.5,397,200,197,101.5
32320, 횡성군,035005, 34세,2016,395,196,199,98.5,375,180,195,92.3
32320, 횡성군,040,35~39세,2016,2006,1090,916,119,1914,1036,878,118
32320, 횡성군,040001, 35세,2016,419,219,200,109.5,395,206,189,109
32320, 횡성군,040002, 36세,2016,402,222,180,123.3,381,206,175,117.7
32320, 횡성군,040003, 37세,2016,414,225,189,119,392,211,181,116.6
32320, 횡성군,040004, 38세,2016,400,207,193,107.3,382,199,183,108.7
32320, 횡성군,040005, 39세,2016,371,217,154,140.9,364,214,150,142.7
32320, 횡성군,045,40~44세,2016,2330,1290,1040,124,2282,1260,1022,123.3
32320, 횡성군,045001, 40세,2016,392,230,162,142,379,222,157,141.4
32320, 횡성군,045002, 41세,2016,423,242,181,133.7,410,232,178,130.3
32320, 횡성군,045003, 42세,2016,481,251,230,109.1,478,249,229,108.7
32320, 횡성군,045004, 43세,2016,518,285,233,122.3,512,282,230,122.6
32320, 횡성군,045005, 44세,2016,516,282,234,120.5,503,275,228,120.6
32320, 횡성군,050,45~49세,2016,3149,1658,1491,111.2,3072,1621,1451,111.7
32320, 횡성군,050001, 45세,2016,588,318,270,117.8,571,310,261,118.8
32320, 횡성군,050002, 46세,2016,594,318,276,115.2,583,311,272,114.3
32320, 횡성군,050003, 47세,2016,684,360,324,111.1,669,356,313,113.7
32320, 횡성군,050004, 48세,2016,650,350,300,116.7,632,339,293,115.7
32320, 횡성군,050005, 49세,2016,633,312,321,97.2,617,305,312,97.8
32320, 횡성군,055,50~54세,2016,3644,1916,1728,110.9,3571,1882,1689,111.4
32320, 횡성군,055001, 50세,2016,665,364,301,120.9,646,355,291,122
32320, 횡성군,055002, 51세,2016,699,353,346,102,688,346,342,101.2
32320, 횡성군,055003, 52세,2016,678,364,314,115.9,661,357,304,117.4
32320, 횡성군,055004, 53세,2016,750,386,364,106,741,384,357,107.6
32320, 횡성군,055005, 54세,2016,852,449,403,111.4,835,440,395,111.4
32320, 횡성군,060,55~59세,2016,4842,2442,2400,101.8,4802,2419,2383,101.5
32320, 횡성군,060001, 55세,2016,951,479,472,101.5,943,472,471,100.2
32320, 횡성군,060002, 56세,2016,1058,524,534,98.1,1049,519,530,97.9
32320, 횡성군,060003, 57세,2016,924,473,451,104.9,917,471,446,105.6
32320, 횡성군,060004, 58세,2016,978,487,491,99.2,972,484,488,99.2
32320, 횡성군,060005, 59세,2016,931,479,452,106,921,473,448,105.6
32320, 횡성군,065,60~64세,2016,4049,2080,1969,105.6,4020,2063,1957,105.4
32320, 횡성군,065001, 60세,2016,924,448,476,94.1,916,444,472,94.1
32320, 횡성군,065002, 61세,2016,817,447,370,120.8,814,444,370,120
32320, 횡성군,065003, 62세,2016,780,390,390,100,775,388,387,100.3
32320, 횡성군,065004, 63세,2016,631,324,307,105.5,624,320,304,105.3
32320, 횡성군,065005, 64세,2016,897,471,426,110.6,891,467,424,110.1
32320, 횡성군,070,65~69세,2016,2679,1373,1306,105.1,2664,1365,1299,105.1
32320, 횡성군,070001, 65세,2016,453,244,209,116.7,450,242,208,116.3
32320, 횡성군,070002, 66세,2016,518,258,260,99.2,513,255,258,98.8
32320, 횡성군,070003, 67세,2016,503,265,238,111.3,500,263,237,111
32320, 횡성군,070004, 68세,2016,574,274,300,91.3,573,274,299,91.6
32320, 횡성군,070005, 69세,2016,631,332,299,111,628,331,297,111.4
32320, 횡성군,075,70~74세,2016,2676,1267,1409,89.9,2670,1263,1407,89.8
32320, 횡성군,075001, 70세,2016,499,234,265,88.3,497,233,264,88.3
32320, 횡성군,075002, 71세,2016,518,265,253,104.7,515,262,253,103.6
32320, 횡성군,075003, 72세,2016,522,228,294,77.6,522,228,294,77.6
32320, 횡성군,075004, 73세,2016,530,231,299,77.3,530,231,299,77.3
32320, 횡성군,075005, 74세,2016,607,309,298,103.7,606,309,297,104
32320, 횡성군,080,75~79세,2016,2681,1218,1463,83.3,2679,1217,1462,83.2
32320, 횡성군,080001, 75세,2016,612,284,328,86.6,612,284,328,86.6
32320, 횡성군,080002, 76세,2016,518,249,269,92.6,517,248,269,92.2
32320, 횡성군,080003, 77세,2016,527,215,312,68.9,527,215,312,68.9
32320, 횡성군,080004, 78세,2016,540,250,290,86.2,540,250,290,86.2
32320, 횡성군,080005, 79세,2016,484,220,264,83.3,483,220,263,83.7
32320, 횡성군,085,80~84세,2016,1545,525,1020,51.5,1545,525,1020,51.5
32320, 횡성군,085001, 80세,2016,420,177,243,72.8,420,177,243,72.8
32320, 횡성군,085002, 81세,2016,341,106,235,45.1,341,106,235,45.1
32320, 횡성군,085003, 82세,2016,301,103,198,52,301,103,198,52
32320, 횡성군,085004, 83세,2016,264,81,183,44.3,264,81,183,44.3
32320, 횡성군,085005, 84세,2016,219,58,161,36,219,58,161,36
32320, 횡성군,090,85~89세,2016,824,224,600,37.3,823,223,600,37.2
32320, 횡성군,090001, 85세,2016,210,69,141,48.9,209,68,141,48.2
32320, 횡성군,090002, 86세,2016,224,56,168,33.3,224,56,168,33.3
32320, 횡성군,090003, 87세,2016,152,39,113,34.5,152,39,113,34.5
32320, 횡성군,090004, 88세,2016,132,37,95,38.9,132,37,95,38.9
32320, 횡성군,090005, 89세,2016,106,23,83,27.7,106,23,83,27.7
32320, 횡성군,095,90~94세,2016,278,76,202,37.6,278,76,202,37.6
32320, 횡성군,095001, 90세,2016,82,21,61,34.4,82,21,61,34.4
32320, 횡성군,095002, 91세,2016,73,19,54,35.2,73,19,54,35.2
32320, 횡성군,095003, 92세,2016,45,17,28,60.7,45,17,28,60.7
32320, 횡성군,095004, 93세,2016,45,13,32,40.6,45,13,32,40.6
32320, 횡성군,095005, 94세,2016,33,6,27,22.2,33,6,27,22.2
32320, 횡성군,100,95~99세,2016,64,9,55,16.4,64,9,55,16.4
32320, 횡성군,100001, 95세,2016,22,X,19,15.8,22,X,19,15.8
32320, 횡성군,100002, 96세,2016,16,X,14,14.3,16,X,14,14.3
32320, 횡성군,100003, 97세,2016,12,X,9,33.3,12,X,9,33.3
32320, 횡성군,100004, 98세,2016,6,X,5,20,6,X,5,20
32320, 횡성군,100005, 99세,2016,8,X,8,0,8,X,8,0
32320, 횡성군,101,100세이상,2016,X,X,X,0,X,X,X,0
32320, 횡성군,102,15세미만,2016,3957,2036,1921,106,3946,2029,1917,105.8
32320, 횡성군,103,15~64세,2016,28220,14992,13228,113.3,27413,14486,12927,112.1
32320, 횡성군,104,65세이상,2016,10750,4692,6058,77.5,10726,4678,6048,77.3
32320, 횡성군,086,85세이상,2016,1169,309,860,35.9,1168,308,860,35.8
32320, 횡성군,126,평균연령,2016,48.8,47.1,50.5,,49,47.3,50.7,
32320, 횡성군,127,중위연령,2016,52.7,50.7,54.6,,53.1,51.3,54.9,
32330, 영월군,000,합계,2016,37019,19043,17976,105.9,36551,18850,17701,106.5
32330, 영월군,005,0~4세,2016,872,462,410,112.7,871,462,409,113
32330, 영월군,005001, 0세,2016,155,79,76,103.9,155,79,76,103.9
32330, 영월군,005002, 1세,2016,154,76,78,97.4,153,76,77,98.7
32330, 영월군,005003, 2세,2016,194,106,88,120.5,194,106,88,120.5
32330, 영월군,005004, 3세,2016,177,95,82,115.9,177,95,82,115.9
32330, 영월군,005005, 4세,2016,192,106,86,123.3,192,106,86,123.3
32330, 영월군,010,5~9세,2016,1128,595,533,111.6,1125,595,530,112.3
32330, 영월군,010001, 5세,2016,246,124,122,101.6,245,124,121,102.5
32330, 영월군,010002, 6세,2016,218,118,100,118,218,118,100,118
32330, 영월군,010003, 7세,2016,215,116,99,117.2,214,116,98,118.4
32330, 영월군,010004, 8세,2016,222,117,105,111.4,221,117,104,112.5
32330, 영월군,010005, 9세,2016,227,120,107,112.1,227,120,107,112.1
32330, 영월군,015,10~14세,2016,1357,730,627,116.4,1355,728,627,116.1
32330, 영월군,015001, 10세,2016,278,149,129,115.5,277,148,129,114.7
32330, 영월군,015002, 11세,2016,240,135,105,128.6,240,135,105,128.6
32330, 영월군,015003, 12세,2016,279,147,132,111.4,279,147,132,111.4
32330, 영월군,015004, 13세,2016,267,143,124,115.3,267,143,124,115.3
32330, 영월군,015005, 14세,2016,293,156,137,113.9,292,155,137,113.1
32330, 영월군,020,15~19세,2016,1941,1126,815,138.2,1941,1126,815,138.2
32330, 영월군,020001, 15세,2016,376,203,173,117.3,376,203,173,117.3
32330, 영월군,020002, 16세,2016,382,242,140,172.9,382,242,140,172.9
32330, 영월군,020003, 17세,2016,402,214,188,113.8,402,214,188,113.8
32330, 영월군,020004, 18세,2016,408,230,178,129.2,408,230,178,129.2
32330, 영월군,020005, 19세,2016,373,237,136,174.3,373,237,136,174.3
32330, 영월군,025,20~24세,2016,1694,1028,666,154.4,1647,1011,636,159
32330, 영월군,025001, 20세,2016,394,254,140,181.4,390,253,137,184.7
32330, 영월군,025002, 21세,2016,341,221,120,184.2,339,221,118,187.3
32330, 영월군,025003, 22세,2016,313,195,118,165.3,304,191,113,169
32330, 영월군,025004, 23세,2016,322,183,139,131.7,309,177,132,134.1
32330, 영월군,025005, 24세,2016,324,175,149,117.4,305,169,136,124.3
32330, 영월군,030,25~29세,2016,1408,786,622,126.4,1325,761,564,134.9
32330, 영월군,030001, 25세,2016,302,174,128,135.9,287,169,118,143.2
32330, 영월군,030002, 26세,2016,269,157,112,140.2,246,149,97,153.6
32330, 영월군,030003, 27세,2016,284,153,131,116.8,270,149,121,123.1
32330, 영월군,030004, 28세,2016,290,160,130,123.1,276,158,118,133.9
32330, 영월군,030005, 29세,2016,263,142,121,117.4,246,136,110,123.6
32330, 영월군,035,30~34세,2016,1498,840,658,127.7,1422,809,613,132
32330, 영월군,035001, 30세,2016,269,168,101,166.3,258,164,94,174.5
32330, 영월군,035002, 31세,2016,254,127,127,100,239,121,118,102.5
32330, 영월군,035003, 32세,2016,298,161,137,117.5,282,155,127,122
32330, 영월군,035004, 33세,2016,314,172,142,121.1,299,169,130,130
32330, 영월군,035005, 34세,2016,363,212,151,140.4,344,200,144,138.9
32330, 영월군,040,35~39세,2016,1724,924,800,115.5,1666,895,771,116.1
32330, 영월군,040001, 35세,2016,343,198,145,136.6,331,192,139,138.1
32330, 영월군,040002, 36세,2016,342,173,169,102.4,329,167,162,103.1
32330, 영월군,040003, 37세,2016,316,156,160,97.5,307,152,155,98.1
32330, 영월군,040004, 38세,2016,364,205,159,128.9,350,197,153,128.8
32330, 영월군,040005, 39세,2016,359,192,167,115,349,187,162,115.4
32330, 영월군,045,40~44세,2016,2307,1248,1059,117.8,2248,1217,1031,118
32330, 영월군,045001, 40세,2016,397,212,185,114.6,382,203,179,113.4
32330, 영월군,045002, 41세,2016,416,223,193,115.5,406,220,186,118.3
32330, 영월군,045003, 42세,2016,499,248,251,98.8,489,244,245,99.6
32330, 영월군,045004, 43세,2016,519,302,217,139.2,508,296,212,139.6
32330, 영월군,045005, 44세,2016,476,263,213,123.5,463,254,209,121.5
32330, 영월군,050,45~49세,2016,2929,1627,1302,125,2883,1608,1275,126.1
32330, 영월군,050001, 45세,2016,609,335,274,122.3,600,330,270,122.2
32330, 영월군,050002, 46세,2016,543,311,232,134.1,530,307,223,137.7
32330, 영월군,050003, 47세,2016,576,312,264,118.2,569,310,259,119.7
32330, 영월군,050004, 48세,2016,654,364,290,125.5,642,358,284,126.1
32330, 영월군,050005, 49세,2016,547,305,242,126,542,303,239,126.8
32330, 영월군,055,50~54세,2016,3322,1813,1509,120.1,3281,1798,1483,121.2
32330, 영월군,055001, 50세,2016,656,361,295,122.4,643,358,285,125.6
32330, 영월군,055002, 51세,2016,605,308,297,103.7,598,305,293,104.1
32330, 영월군,055003, 52세,2016,579,316,263,120.2,568,311,257,121
32330, 영월군,055004, 53세,2016,693,400,293,136.5,686,399,287,139
32330, 영월군,055005, 54세,2016,789,428,361,118.6,786,425,361,117.7
32330, 영월군,060,55~59세,2016,4007,2089,1918,108.9,3988,2084,1904,109.5
32330, 영월군,060001, 55세,2016,775,432,343,125.9,771,432,339,127.4
32330, 영월군,060002, 56세,2016,839,393,446,88.1,838,393,445,88.3
32330, 영월군,060003, 57세,2016,794,418,376,111.2,786,413,373,110.7
32330, 영월군,060004, 58세,2016,816,420,396,106.1,813,420,393,106.9
32330, 영월군,060005, 59세,2016,783,426,357,119.3,780,426,354,120.3
32330, 영월군,065,60~64세,2016,3501,1807,1694,106.7,3482,1795,1687,106.4
32330, 영월군,065001, 60세,2016,742,390,352,110.8,737,386,351,110
32330, 영월군,065002, 61세,2016,742,387,355,109,739,385,354,108.8
32330, 영월군,065003, 62세,2016,671,344,327,105.2,668,343,325,105.5
32330, 영월군,065004, 63세,2016,580,282,298,94.6,579,282,297,94.9
32330, 영월군,065005, 64세,2016,766,404,362,111.6,759,399,360,110.8
32330, 영월군,070,65~69세,2016,2495,1203,1292,93.1,2488,1200,1288,93.2
32330, 영월군,070001, 65세,2016,453,209,244,85.7,452,208,244,85.2
32330, 영월군,070002, 66세,2016,496,233,263,88.6,495,232,263,88.2
32330, 영월군,070003, 67세,2016,498,246,252,97.6,496,246,250,98.4
32330, 영월군,070004, 68세,2016,537,257,280,91.8,536,257,279,92.1
32330, 영월군,070005, 69세,2016,511,258,253,102,509,257,252,102
32330, 영월군,075,70~74세,2016,2458,1125,1333,84.4,2454,1123,1331,84.4
32330, 영월군,075001, 70세,2016,436,217,219,99.1,435,216,219,98.6
32330, 영월군,075002, 71세,2016,453,223,230,97,452,223,229,97.4
32330, 영월군,075003, 72세,2016,501,216,285,75.8,501,216,285,75.8
32330, 영월군,075004, 73세,2016,470,208,262,79.4,469,207,262,79
32330, 영월군,075005, 74세,2016,598,261,337,77.4,597,261,336,77.7
32330, 영월군,080,75~79세,2016,2307,982,1325,74.1,2304,980,1324,74
32330, 영월군,080001, 75세,2016,512,223,289,77.2,512,223,289,77.2
32330, 영월군,080002, 76세,2016,520,235,285,82.5,519,234,285,82.1
32330, 영월군,080003, 77세,2016,468,196,272,72.1,468,196,272,72.1
32330, 영월군,080004, 78세,2016,443,187,256,73,443,187,256,73
32330, 영월군,080005, 79세,2016,364,141,223,63.2,362,140,222,63.1
32330, 영월군,085,80~84세,2016,1283,441,842,52.4,1283,441,842,52.4
32330, 영월군,085001, 80세,2016,348,150,198,75.8,348,150,198,75.8
32330, 영월군,085002, 81세,2016,290,112,178,62.9,290,112,178,62.9
32330, 영월군,085003, 82세,2016,265,78,187,41.7,265,78,187,41.7
32330, 영월군,085004, 83세,2016,201,54,147,36.7,201,54,147,36.7
32330, 영월군,085005, 84세,2016,179,47,132,35.6,179,47,132,35.6
32330, 영월군,090,85~89세,2016,548,149,399,37.3,548,149,399,37.3
32330, 영월군,090001, 85세,2016,141,48,93,51.6,141,48,93,51.6
32330, 영월군,090002, 86세,2016,137,26,111,23.4,137,26,111,23.4
32330, 영월군,090003, 87세,2016,128,39,89,43.8,128,39,89,43.8
32330, 영월군,090004, 88세,2016,70,19,51,37.3,70,19,51,37.3
32330, 영월군,090005, 89세,2016,72,17,55,30.9,72,17,55,30.9
32330, 영월군,095,90~94세,2016,189,55,134,41,189,55,134,41
32330, 영월군,095001, 90세,2016,45,14,31,45.2,45,14,31,45.2
32330, 영월군,095002, 91세,2016,54,18,36,50,54,18,36,50
32330, 영월군,095003, 92세,2016,37,12,25,48,37,12,25,48
32330, 영월군,095004, 93세,2016,30,X,26,15.4,30,X,26,15.4
32330, 영월군,095005, 94세,2016,23,7,16,43.8,23,7,16,43.8
32330, 영월군,100,95~99세,2016,47,11,36,30.6,47,11,36,30.6
32330, 영월군,100001, 95세,2016,23,X,19,21.1,23,X,19,21.1
32330, 영월군,100002, 96세,2016,7,X,X,75,7,X,X,75
32330, 영월군,100003, 97세,2016,10,X,8,25,10,X,8,25
32330, 영월군,100004, 98세,2016,X,X,X,33.3,X,X,X,33.3
32330, 영월군,100005, 99세,2016,X,X,X,50,X,X,X,50
32330, 영월군,101,100세이상,2016,X,X,X,100,X,X,X,100
32330, 영월군,102,15세미만,2016,3357,1787,1570,113.8,3351,1785,1566,114
32330, 영월군,103,15~64세,2016,24331,13288,11043,120.3,23883,13104,10779,121.6
32330, 영월군,104,65세이상,2016,9331,3968,5363,74,9317,3961,5356,74
32330, 영월군,086,85세이상,2016,788,217,571,38,788,217,571,38
32330, 영월군,126,평균연령,2016,49,47,51.2,,49.1,47,51.4,
32330, 영월군,127,중위연령,2016,52.7,50.4,55,,53,50.6,55.3,
32340, 평창군,000,합계,2016,40470,20808,19662,105.8,39928,20530,19398,105.8
32340, 평창군,005,0~4세,2016,1072,525,547,96,1066,523,543,96.3
32340, 평창군,005001, 0세,2016,191,90,101,89.1,191,90,101,89.1
32340, 평창군,005002, 1세,2016,193,89,104,85.6,193,89,104,85.6
32340, 평창군,005003, 2세,2016,200,97,103,94.2,199,96,103,93.2
32340, 평창군,005004, 3세,2016,239,129,110,117.3,237,129,108,119.4
32340, 평창군,005005, 4세,2016,249,120,129,93,246,119,127,93.7
32340, 평창군,010,5~9세,2016,1397,742,655,113.3,1393,740,653,113.3
32340, 평창군,010001, 5세,2016,253,139,114,121.9,252,138,114,121.1
32340, 평창군,010002, 6세,2016,258,135,123,109.8,258,135,123,109.8
32340, 평창군,010003, 7세,2016,269,135,134,100.7,267,134,133,100.8
32340, 평창군,010004, 8세,2016,305,159,146,108.9,304,159,145,109.7
32340, 평창군,010005, 9세,2016,312,174,138,126.1,312,174,138,126.1
32340, 평창군,015,10~14세,2016,1563,824,739,111.5,1559,821,738,111.2
32340, 평창군,015001, 10세,2016,284,151,133,113.5,284,151,133,113.5
32340, 평창군,015002, 11세,2016,275,150,125,120,275,150,125,120
32340, 평창군,015003, 12세,2016,319,168,151,111.3,318,168,150,112
32340, 평창군,015004, 13세,2016,338,168,170,98.8,337,167,170,98.2
32340, 평창군,015005, 14세,2016,347,187,160,116.9,345,185,160,115.6
32340, 평창군,020,15~19세,2016,1655,903,752,120.1,1654,902,752,119.9
32340, 평창군,020001, 15세,2016,351,190,161,118,351,190,161,118
32340, 평창군,020002, 16세,2016,388,201,187,107.5,388,201,187,107.5
32340, 평창군,020003, 17세,2016,372,188,184,102.2,372,188,184,102.2
32340, 평창군,020004, 18세,2016,342,204,138,147.8,342,204,138,147.8
32340, 평창군,020005, 19세,2016,202,120,82,146.3,201,119,82,145.1
32340, 평창군,025,20~24세,2016,1676,1021,655,155.9,1597,980,617,158.8
32340, 평창군,025001, 20세,2016,307,214,93,230.1,298,210,88,238.6
32340, 평창군,025002, 21세,2016,302,212,90,235.6,293,209,84,248.8
32340, 평창군,025003, 22세,2016,330,197,133,148.1,315,188,127,148
32340, 평창군,025004, 23세,2016,359,190,169,112.4,338,179,159,112.6
32340, 평창군,025005, 24세,2016,378,208,170,122.4,353,194,159,122
32340, 평창군,030,25~29세,2016,1741,1006,735,136.9,1659,959,700,137
32340, 평창군,030001, 25세,2016,355,199,156,127.6,339,190,149,127.5
32340, 평창군,030002, 26세,2016,352,205,147,139.5,332,188,144,130.6
32340, 평창군,030003, 27세,2016,363,219,144,152.1,347,211,136,155.1
32340, 평창군,030004, 28세,2016,337,188,149,126.2,325,182,143,127.3
32340, 평창군,030005, 29세,2016,334,195,139,140.3,316,188,128,146.9
32340, 평창군,035,30~34세,2016,1814,1008,806,125.1,1746,969,777,124.7
32340, 평창군,035001, 30세,2016,350,190,160,118.8,330,180,150,120
32340, 평창군,035002, 31세,2016,318,167,151,110.6,300,155,145,106.9
32340, 평창군,035003, 32세,2016,348,196,152,128.9,341,193,148,130.4
32340, 평창군,035004, 33세,2016,381,222,159,139.6,372,217,155,140
32340, 평창군,035005, 34세,2016,417,233,184,126.6,403,224,179,125.1
32340, 평창군,040,35~39세,2016,2229,1201,1028,116.8,2172,1168,1004,116.3
32340, 평창군,040001, 35세,2016,435,254,181,140.3,420,244,176,138.6
32340, 평창군,040002, 36세,2016,461,249,212,117.5,454,245,209,117.2
32340, 평창군,040003, 37세,2016,453,242,211,114.7,432,231,201,114.9
32340, 평창군,040004, 38세,2016,439,239,200,119.5,433,236,197,119.8
32340, 평창군,040005, 39세,2016,441,217,224,96.9,433,212,221,95.9
32340, 평창군,045,40~44세,2016,2739,1523,1216,125.2,2691,1498,1193,125.6
32340, 평창군,045001, 40세,2016,469,273,196,139.3,462,267,195,136.9
32340, 평창군,045002, 41세,2016,516,271,245,110.6,507,269,238,113
32340, 평창군,045003, 42세,2016,561,296,265,111.7,550,289,261,110.7
32340, 평창군,045004, 43세,2016,619,351,268,131,607,344,263,130.8
32340, 평창군,045005, 44세,2016,574,332,242,137.2,565,329,236,139.4
32340, 평창군,050,45~49세,2016,3301,1811,1490,121.5,3254,1790,1464,122.3
32340, 평창군,050001, 45세,2016,612,333,279,119.4,602,328,274,119.7
32340, 평창군,050002, 46세,2016,638,354,284,124.6,632,352,280,125.7
32340, 평창군,050003, 47세,2016,691,381,310,122.9,684,378,306,123.5
32340, 평창군,050004, 48세,2016,725,399,326,122.4,711,392,319,122.9
32340, 평창군,050005, 49세,2016,635,344,291,118.2,625,340,285,119.3
32340, 평창군,055,50~54세,2016,3626,1935,1691,114.4,3583,1917,1666,115.1
32340, 평창군,055001, 50세,2016,675,371,304,122,666,367,299,122.7
32340, 평창군,055002, 51세,2016,708,384,324,118.5,702,380,322,118
32340, 평창군,055003, 52세,2016,657,328,329,99.7,646,324,322,100.6
32340, 평창군,055004, 53세,2016,714,387,327,118.3,702,382,320,119.4
32340, 평창군,055005, 54세,2016,872,465,407,114.3,867,464,403,115.1
32340, 평창군,060,55~59세,2016,4585,2359,2226,106,4546,2342,2204,106.3
32340, 평창군,060001, 55세,2016,911,462,449,102.9,906,460,446,103.1
32340, 평창군,060002, 56세,2016,1001,491,510,96.3,994,488,506,96.4
32340, 평창군,060003, 57세,2016,833,446,387,115.2,828,445,383,116.2
32340, 평창군,060004, 58세,2016,908,477,431,110.7,893,471,422,111.6
32340, 평창군,060005, 59세,2016,932,483,449,107.6,925,478,447,106.9
32340, 평창군,065,60~64세,2016,3746,1956,1790,109.3,3706,1939,1767,109.7
32340, 평창군,065001, 60세,2016,807,422,385,109.6,796,418,378,110.6
32340, 평창군,065002, 61세,2016,846,444,402,110.4,836,439,397,110.6
32340, 평창군,065003, 62세,2016,698,366,332,110.2,692,362,330,109.7
32340, 평창군,065004, 63세,2016,572,296,276,107.2,566,294,272,108.1
32340, 평창군,065005, 64세,2016,823,428,395,108.4,816,426,390,109.2
32340, 평창군,070,65~69세,2016,2477,1197,1280,93.5,2467,1192,1275,93.5
32340, 평창군,070001, 65세,2016,429,205,224,91.5,428,204,224,91.1
32340, 평창군,070002, 66세,2016,445,215,230,93.5,442,215,227,94.7
32340, 평창군,070003, 67세,2016,517,242,275,88,516,242,274,88.3
32340, 평창군,070004, 68세,2016,546,269,277,97.1,542,266,276,96.4
32340, 평창군,070005, 69세,2016,540,266,274,97.1,539,265,274,96.7
32340, 평창군,075,70~74세,2016,2428,1113,1315,84.6,2417,1106,1311,84.4
32340, 평창군,075001, 70세,2016,445,216,229,94.3,440,213,227,93.8
32340, 평창군,075002, 71세,2016,532,234,298,78.5,529,231,298,77.5
32340, 평창군,075003, 72세,2016,475,211,264,79.9,475,211,264,79.9
32340, 평창군,075004, 73세,2016,449,214,235,91.1,447,213,234,91
32340, 평창군,075005, 74세,2016,527,238,289,82.4,526,238,288,82.6
32340, 평창군,080,75~79세,2016,2393,1043,1350,77.3,2392,1043,1349,77.3
32340, 평창군,080001, 75세,2016,535,252,283,89,535,252,283,89
32340, 평창군,080002, 76세,2016,523,230,293,78.5,523,230,293,78.5
32340, 평창군,080003, 77세,2016,516,220,296,74.3,516,220,296,74.3
32340, 평창군,080004, 78세,2016,423,171,252,67.9,422,171,251,68.1
32340, 평창군,080005, 79세,2016,396,170,226,75.2,396,170,226,75.2
32340, 평창군,085,80~84세,2016,1201,409,792,51.6,1199,409,790,51.8
32340, 평창군,085001, 80세,2016,348,138,210,65.7,347,138,209,66
32340, 평창군,085002, 81세,2016,290,99,191,51.8,290,99,191,51.8
32340, 평창군,085003, 82세,2016,200,63,137,46,199,63,136,46.3
32340, 평창군,085004, 83세,2016,198,64,134,47.8,198,64,134,47.8
32340, 평창군,085005, 84세,2016,165,45,120,37.5,165,45,120,37.5
32340, 평창군,090,85~89세,2016,532,132,400,33,532,132,400,33
32340, 평창군,090001, 85세,2016,154,35,119,29.4,154,35,119,29.4
32340, 평창군,090002, 86세,2016,126,34,92,37,126,34,92,37
32340, 평창군,090003, 87세,2016,116,34,82,41.5,116,34,82,41.5
32340, 평창군,090004, 88세,2016,74,16,58,27.6,74,16,58,27.6
32340, 평창군,090005, 89세,2016,62,13,49,26.5,62,13,49,26.5
32340, 평창군,095,90~94세,2016,231,77,154,50,231,77,154,50
32340, 평창군,095001, 90세,2016,57,15,42,35.7,57,15,42,35.7
32340, 평창군,095002, 91세,2016,50,12,38,31.6,50,12,38,31.6
32340, 평창군,095003, 92세,2016,66,29,37,78.4,66,29,37,78.4
32340, 평창군,095004, 93세,2016,37,12,25,48,37,12,25,48
32340, 평창군,095005, 94세,2016,21,9,12,75,21,9,12,75
32340, 평창군,100,95~99세,2016,61,22,39,56.4,61,22,39,56.4
32340, 평창군,100001, 95세,2016,14,X,14,0,14,X,14,0
32340, 평창군,100002, 96세,2016,19,9,10,90,19,9,10,90
32340, 평창군,100003, 97세,2016,12,6,6,100,12,6,6,100
32340, 평창군,100004, 98세,2016,6,X,X,50,6,X,X,50
32340, 평창군,100005, 99세,2016,10,5,5,100,10,5,5,100
32340, 평창군,101,100세이상,2016,X,X,X,50,X,X,X,50
32340, 평창군,102,15세미만,2016,4032,2091,1941,107.7,4018,2084,1934,107.8
32340, 평창군,103,15~64세,2016,27112,14723,12389,118.8,26608,14464,12144,119.1
32340, 평창군,104,65세이상,2016,9326,3994,5332,74.9,9302,3982,5320,74.8
32340, 평창군,086,85세이상,2016,827,232,595,39,827,232,595,39
32340, 평창군,126,평균연령,2016,48.3,46.6,50.1,,48.4,46.7,50.2,
32340, 평창군,127,중위연령,2016,51.5,49.5,53.8,,51.7,49.7,54,
32350, 정선군,000,합계,2016,36233,18765,17468,107.4,35890,18651,17239,108.2
32350, 정선군,005,0~4세,2016,1040,535,505,105.9,1040,535,505,105.9
32350, 정선군,005001, 0세,2016,166,95,71,133.8,166,95,71,133.8
32350, 정선군,005002, 1세,2016,204,106,98,108.2,204,106,98,108.2
32350, 정선군,005003, 2세,2016,197,96,101,95,197,96,101,95
32350, 정선군,005004, 3세,2016,213,107,106,100.9,213,107,106,100.9
32350, 정선군,005005, 4세,2016,260,131,129,101.6,260,131,129,101.6
32350, 정선군,010,5~9세,2016,1276,644,632,101.9,1274,643,631,101.9
32350, 정선군,010001, 5세,2016,224,112,112,100,224,112,112,100
32350, 정선군,010002, 6세,2016,270,131,139,94.2,270,131,139,94.2
32350, 정선군,010003, 7세,2016,253,140,113,123.9,253,140,113,123.9
32350, 정선군,010004, 8세,2016,269,131,138,94.9,268,131,137,95.6
32350, 정선군,010005, 9세,2016,260,130,130,100,259,129,130,99.2
32350, 정선군,015,10~14세,2016,1251,640,611,104.7,1250,639,611,104.6
32350, 정선군,015001, 10세,2016,237,115,122,94.3,237,115,122,94.3
32350, 정선군,015002, 11세,2016,249,124,125,99.2,248,123,125,98.4
32350, 정선군,015003, 12세,2016,244,130,114,114,244,130,114,114
32350, 정선군,015004, 13세,2016,241,123,118,104.2,241,123,118,104.2
32350, 정선군,015005, 14세,2016,280,148,132,112.1,280,148,132,112.1
32350, 정선군,020,15~19세,2016,1461,771,690,111.7,1456,769,687,111.9
32350, 정선군,020001, 15세,2016,320,166,154,107.8,319,165,154,107.1
32350, 정선군,020002, 16세,2016,355,181,174,104,354,180,174,103.4
32350, 정선군,020003, 17세,2016,362,189,173,109.2,362,189,173,109.2
32350, 정선군,020004, 18세,2016,267,137,130,105.4,266,137,129,106.2
32350, 정선군,020005, 19세,2016,157,98,59,166.1,155,98,57,171.9
32350, 정선군,025,20~24세,2016,1247,746,501,148.9,1213,738,475,155.4
32350, 정선군,025001, 20세,2016,230,170,60,283.3,227,169,58,291.4
32350, 정선군,025002, 21세,2016,278,188,90,208.9,276,187,89,210.1
32350, 정선군,025003, 22세,2016,244,140,104,134.6,239,138,101,136.6
32350, 정선군,025004, 23세,2016,239,125,114,109.6,227,122,105,116.2
32350, 정선군,025005, 24세,2016,256,123,133,92.5,244,122,122,100
32350, 정선군,030,25~29세,2016,1701,903,798,113.2,1647,891,756,117.9
32350, 정선군,030001, 25세,2016,303,142,161,88.2,293,141,152,92.8
32350, 정선군,030002, 26세,2016,317,157,160,98.1,311,155,156,99.4
32350, 정선군,030003, 27세,2016,329,173,156,110.9,317,170,147,115.6
32350, 정선군,030004, 28세,2016,378,210,168,125,363,206,157,131.2
32350, 정선군,030005, 29세,2016,374,221,153,144.4,363,219,144,152.1
32350, 정선군,035,30~34세,2016,1944,1082,862,125.5,1888,1063,825,128.8
32350, 정선군,035001, 30세,2016,349,188,161,116.8,340,187,153,122.2
32350, 정선군,035002, 31세,2016,364,234,130,180,346,224,122,183.6
32350, 정선군,035003, 32세,2016,382,187,195,95.9,368,184,184,100
32350, 정선군,035004, 33세,2016,419,239,180,132.8,409,235,174,135.1
32350, 정선군,035005, 34세,2016,430,234,196,119.4,425,233,192,121.4
32350, 정선군,040,35~39세,2016,2298,1345,953,141.1,2273,1336,937,142.6
32350, 정선군,040001, 35세,2016,462,266,196,135.7,457,266,191,139.3
32350, 정선군,040002, 36세,2016,482,286,196,145.9,477,283,194,145.9
32350, 정선군,040003, 37세,2016,478,272,206,132,474,269,205,131.2
32350, 정선군,040004, 38세,2016,437,257,180,142.8,430,254,176,144.3
32350, 정선군,040005, 39세,2016,439,264,175,150.9,435,264,171,154.4
32350, 정선군,045,40~44세,2016,2436,1419,1017,139.5,2410,1411,999,141.2
32350, 정선군,045001, 40세,2016,462,262,200,131,457,260,197,132
32350, 정선군,045002, 41세,2016,456,272,184,147.8,451,270,181,149.2
32350, 정선군,045003, 42세,2016,542,315,227,138.8,536,312,224,139.3
32350, 정선군,045004, 43세,2016,491,288,203,141.9,486,288,198,145.5
32350, 정선군,045005, 44세,2016,485,282,203,138.9,480,281,199,141.2
32350, 정선군,050,45~49세,2016,2884,1681,1203,139.7,2848,1671,1177,142
32350, 정선군,050001, 45세,2016,566,337,229,147.2,557,335,222,150.9
32350, 정선군,050002, 46세,2016,512,295,217,135.9,502,293,209,140.2
32350, 정선군,050003, 47세,2016,587,341,246,138.6,583,341,242,140.9
32350, 정선군,050004, 48세,2016,649,386,263,146.8,640,383,257,149
32350, 정선군,050005, 49세,2016,570,322,248,129.8,566,319,247,129.1
32350, 정선군,055,50~54세,2016,3098,1717,1381,124.3,3056,1702,1354,125.7
32350, 정선군,055001, 50세,2016,586,329,257,128,576,324,252,128.6
32350, 정선군,055002, 51세,2016,540,286,254,112.6,534,285,249,114.5
32350, 정선군,055003, 52세,2016,580,325,255,127.5,573,323,250,129.2
32350, 정선군,055004, 53세,2016,662,381,281,135.6,655,378,277,136.5
32350, 정선군,055005, 54세,2016,730,396,334,118.6,718,392,326,120.2
32350, 정선군,060,55~59세,2016,4058,2089,1969,106.1,4028,2075,1953,106.2
32350, 정선군,060001, 55세,2016,837,415,422,98.3,832,414,418,99
32350, 정선군,060002, 56세,2016,876,438,438,100,868,433,435,99.5
32350, 정선군,060003, 57세,2016,769,404,365,110.7,761,400,361,110.8
32350, 정선군,060004, 58세,2016,793,418,375,111.5,790,417,373,111.8
32350, 정선군,060005, 59세,2016,783,414,369,112.2,777,411,366,112.3
32350, 정선군,065,60~64세,2016,3213,1685,1528,110.3,3200,1677,1523,110.1
32350, 정선군,065001, 60세,2016,742,410,332,123.5,740,408,332,122.9
32350, 정선군,065002, 61세,2016,706,390,316,123.4,700,386,314,122.9
32350, 정선군,065003, 62세,2016,602,319,283,112.7,599,318,281,113.2
32350, 정선군,065004, 63세,2016,514,259,255,101.6,513,258,255,101.2
32350, 정선군,065005, 64세,2016,649,307,342,89.8,648,307,341,90
32350, 정선군,070,65~69세,2016,2362,1135,1227,92.5,2349,1129,1220,92.5
32350, 정선군,070001, 65세,2016,440,217,223,97.3,437,216,221,97.7
32350, 정선군,070002, 66세,2016,459,196,263,74.5,455,195,260,75
32350, 정선군,070003, 67세,2016,488,250,238,105,485,247,238,103.8
32350, 정선군,070004, 68세,2016,511,258,253,102,509,257,252,102
32350, 정선군,070005, 69세,2016,464,214,250,85.6,463,214,249,85.9
32350, 정선군,075,70~74세,2016,2312,1070,1242,86.2,2309,1069,1240,86.2
32350, 정선군,075001, 70세,2016,399,201,198,101.5,398,201,197,102
32350, 정선군,075002, 71세,2016,460,211,249,84.7,459,210,249,84.3
32350, 정선군,075003, 72세,2016,451,207,244,84.8,451,207,244,84.8
32350, 정선군,075004, 73세,2016,492,214,278,77,491,214,277,77.3
32350, 정선군,075005, 74세,2016,510,237,273,86.8,510,237,273,86.8
32350, 정선군,080,75~79세,2016,1915,797,1118,71.3,1913,797,1116,71.4
32350, 정선군,080001, 75세,2016,433,188,245,76.7,432,188,244,77
32350, 정선군,080002, 76세,2016,465,199,266,74.8,465,199,266,74.8
32350, 정선군,080003, 77세,2016,393,170,223,76.2,392,170,222,76.6
32350, 정선군,080004, 78세,2016,323,124,199,62.3,323,124,199,62.3
32350, 정선군,080005, 79세,2016,301,116,185,62.7,301,116,185,62.7
32350, 정선군,085,80~84세,2016,1064,355,709,50.1,1064,355,709,50.1
32350, 정선군,085001, 80세,2016,252,90,162,55.6,252,90,162,55.6
32350, 정선군,085002, 81세,2016,245,88,157,56.1,245,88,157,56.1
32350, 정선군,085003, 82세,2016,230,81,149,54.4,230,81,149,54.4
32350, 정선군,085004, 83세,2016,180,53,127,41.7,180,53,127,41.7
32350, 정선군,085005, 84세,2016,157,43,114,37.7,157,43,114,37.7
32350, 정선군,090,85~89세,2016,445,96,349,27.5,445,96,349,27.5
32350, 정선군,090001, 85세,2016,102,27,75,36,102,27,75,36
32350, 정선군,090002, 86세,2016,121,29,92,31.5,121,29,92,31.5
32350, 정선군,090003, 87세,2016,86,16,70,22.9,86,16,70,22.9
32350, 정선군,090004, 88세,2016,69,16,53,30.2,69,16,53,30.2
32350, 정선군,090005, 89세,2016,67,8,59,13.6,67,8,59,13.6
32350, 정선군,095,90~94세,2016,191,47,144,32.6,190,47,143,32.9
32350, 정선군,095001, 90세,2016,54,14,40,35,54,14,40,35
32350, 정선군,095002, 91세,2016,41,13,28,46.4,41,13,28,46.4
32350, 정선군,095003, 92세,2016,44,9,35,25.7,44,9,35,25.7
32350, 정선군,095004, 93세,2016,39,9,30,30,38,9,29,31
32350, 정선군,095005, 94세,2016,13,X,11,18.2,13,X,11,18.2
32350, 정선군,100,95~99세,2016,34,8,26,30.8,34,8,26,30.8
32350, 정선군,100001, 95세,2016,10,X,8,25,10,X,8,25
32350, 정선군,100002, 96세,2016,9,X,7,28.6,9,X,7,28.6
32350, 정선군,100003, 97세,2016,6,X,X,100,6,X,X,100
32350, 정선군,100004, 98세,2016,X,X,X,0,X,X,X,0
32350, 정선군,100005, 99세,2016,5,X,X,25,5,X,X,25
32350, 정선군,101,100세이상,2016,X,X,X,0,X,X,X,0
32350, 정선군,102,15세미만,2016,3567,1819,1748,104.1,3564,1817,1747,104
32350, 정선군,103,15~64세,2016,24340,13438,10902,123.3,24019,13333,10686,124.8
32350, 정선군,104,65세이상,2016,8326,3508,4818,72.8,8307,3501,4806,72.8
32350, 정선군,086,85세이상,2016,673,151,522,28.9,672,151,521,29
32350, 정선군,126,평균연령,2016,48,46.3,49.7,,48,46.3,49.9,
32350, 정선군,127,중위연령,2016,51,48.8,53.7,,51.1,48.9,54,
32360, 철원군,000,합계,2016,45433,24256,21177,114.5,44527,23706,20821,113.9
32360, 철원군,005,0~4세,2016,1870,938,932,100.6,1868,937,931,100.6
32360, 철원군,005001, 0세,2016,390,192,198,97,390,192,198,97
32360, 철원군,005002, 1세,2016,367,190,177,107.3,367,190,177,107.3
32360, 철원군,005003, 2세,2016,369,181,188,96.3,369,181,188,96.3
32360, 철원군,005004, 3세,2016,351,179,172,104.1,350,178,172,103.5
32360, 철원군,005005, 4세,2016,393,196,197,99.5,392,196,196,100
32360, 철원군,010,5~9세,2016,1907,1007,900,111.9,1904,1005,899,111.8
32360, 철원군,010001, 5세,2016,368,201,167,120.4,366,199,167,119.2
32360, 철원군,010002, 6세,2016,383,213,170,125.3,383,213,170,125.3
32360, 철원군,010003, 7세,2016,357,182,175,104,357,182,175,104
32360, 철원군,010004, 8세,2016,416,216,200,108,415,216,199,108.5
32360, 철원군,010005, 9세,2016,383,195,188,103.7,383,195,188,103.7
32360, 철원군,015,10~14세,2016,2033,1030,1003,102.7,2032,1029,1003,102.6
32360, 철원군,015001, 10세,2016,421,213,208,102.4,421,213,208,102.4
32360, 철원군,015002, 11세,2016,373,191,182,104.9,373,191,182,104.9
32360, 철원군,015003, 12세,2016,402,218,184,118.5,402,218,184,118.5
32360, 철원군,015004, 13세,2016,396,190,206,92.2,395,189,206,91.7
32360, 철원군,015005, 14세,2016,441,218,223,97.8,441,218,223,97.8
32360, 철원군,020,15~19세,2016,2210,1182,1028,115,2202,1177,1025,114.8
32360, 철원군,020001, 15세,2016,479,251,228,110.1,478,250,228,109.6
32360, 철원군,020002, 16세,2016,487,266,221,120.4,487,266,221,120.4
32360, 철원군,020003, 17세,2016,504,260,244,106.6,504,260,244,106.6
32360, 철원군,020004, 18세,2016,440,240,200,120,439,239,200,119.5
32360, 철원군,020005, 19세,2016,300,165,135,122.2,294,162,132,122.7
32360, 철원군,025,20~24세,2016,3430,2606,824,316.3,3153,2390,763,313.2
32360, 철원군,025001, 20세,2016,385,264,121,218.2,364,247,117,211.1
32360, 철원군,025002, 21세,2016,514,366,148,247.3,453,320,133,240.6
32360, 철원군,025003, 22세,2016,660,492,168,292.9,600,445,155,287.1
32360, 철원군,025004, 23세,2016,824,636,188,338.3,756,587,169,347.3
32360, 철원군,025005, 24세,2016,1047,848,199,426.1,980,791,189,418.5
32360, 철원군,030,25~29세,2016,3273,2226,1047,212.6,3065,2100,965,217.6
32360, 철원군,030001, 25세,2016,900,660,240,275,842,619,223,277.6
32360, 철원군,030002, 26세,2016,676,473,203,233,635,449,186,241.4
32360, 철원군,030003, 27세,2016,611,412,199,207,573,387,186,208.1
32360, 철원군,030004, 28세,2016,549,340,209,162.7,524,325,199,163.3
32360, 철원군,030005, 29세,2016,537,341,196,174,491,320,171,187.1
32360, 철원군,035,30~34세,2016,2614,1481,1133,130.7,2470,1410,1060,133
32360, 철원군,035001, 30세,2016,513,302,211,143.1,475,288,187,154
32360, 철원군,035002, 31세,2016,488,287,201,142.8,460,268,192,139.6
32360, 철원군,035003, 32세,2016,495,266,229,116.2,467,251,216,116.2
32360, 철원군,035004, 33세,2016,555,310,245,126.5,530,299,231,129.4
32360, 철원군,035005, 34세,2016,563,316,247,127.9,538,304,234,129.9
32360, 철원군,040,35~39세,2016,2798,1441,1357,106.2,2714,1389,1325,104.8
32360, 철원군,040001, 35세,2016,591,309,282,109.6,574,298,276,108
32360, 철원군,040002, 36세,2016,554,282,272,103.7,530,267,263,101.5
32360, 철원군,040003, 37세,2016,525,263,262,100.4,506,256,250,102.4
32360, 철원군,040004, 38세,2016,549,286,263,108.7,539,278,261,106.5
32360, 철원군,040005, 39세,2016,579,301,278,108.3,565,290,275,105.5
32360, 철원군,045,40~44세,2016,3047,1668,1379,121,3010,1648,1362,121
32360, 철원군,045001, 40세,2016,515,286,229,124.9,503,277,226,122.6
32360, 철원군,045002, 41세,2016,551,295,256,115.2,544,291,253,115
32360, 철원군,045003, 42세,2016,661,362,299,121.1,653,359,294,122.1
32360, 철원군,045004, 43세,2016,652,350,302,115.9,647,348,299,116.4
32360, 철원군,045005, 44세,2016,668,375,293,128,663,373,290,128.6
32360, 철원군,050,45~49세,2016,3238,1749,1489,117.5,3192,1726,1466,117.7
32360, 철원군,050001, 45세,2016,635,344,291,118.2,626,337,289,116.6
32360, 철원군,050002, 46세,2016,631,347,284,122.2,623,342,281,121.7
32360, 철원군,050003, 47세,2016,646,346,300,115.3,627,338,289,117
32360, 철원군,050004, 48세,2016,677,360,317,113.6,672,358,314,114
32360, 철원군,050005, 49세,2016,649,352,297,118.5,644,351,293,119.8
32360, 철원군,055,50~54세,2016,3466,1840,1626,113.2,3440,1833,1607,114.1
32360, 철원군,055001, 50세,2016,681,370,311,119,679,369,310,119
32360, 철원군,055002, 51세,2016,645,329,316,104.1,638,326,312,104.5
32360, 철원군,055003, 52세,2016,647,345,302,114.2,641,344,297,115.8
32360, 철원군,055004, 53세,2016,751,396,355,111.5,746,396,350,113.1
32360, 철원군,055005, 54세,2016,742,400,342,117,736,398,338,117.8
32360, 철원군,060,55~59세,2016,3865,2013,1852,108.7,3837,2005,1832,109.4
32360, 철원군,060001, 55세,2016,837,447,390,114.6,832,447,385,116.1
32360, 철원군,060002, 56세,2016,819,425,394,107.9,815,423,392,107.9
32360, 철원군,060003, 57세,2016,715,363,352,103.1,706,361,345,104.6
32360, 철원군,060004, 58세,2016,763,385,378,101.9,758,383,375,102.1
32360, 철원군,060005, 59세,2016,731,393,338,116.3,726,391,335,116.7
32360, 철원군,065,60~64세,2016,3007,1418,1589,89.2,2988,1409,1579,89.2
32360, 철원군,065001, 60세,2016,665,315,350,90,661,313,348,89.9
32360, 철원군,065002, 61세,2016,690,343,347,98.8,688,342,346,98.8
32360, 철원군,065003, 62세,2016,666,335,331,101.2,662,331,331,100
32360, 철원군,065004, 63세,2016,508,221,287,77,504,220,284,77.5
32360, 철원군,065005, 64세,2016,478,204,274,74.5,473,203,270,75.2
32360, 철원군,070,65~69세,2016,2255,1051,1204,87.3,2245,1049,1196,87.7
32360, 철원군,070001, 65세,2016,348,165,183,90.2,346,165,181,91.2
32360, 철원군,070002, 66세,2016,420,192,228,84.2,417,191,226,84.5
32360, 철원군,070003, 67세,2016,494,232,262,88.5,493,232,261,88.9
32360, 철원군,070004, 68세,2016,477,211,266,79.3,473,210,263,79.8
32360, 철원군,070005, 69세,2016,516,251,265,94.7,516,251,265,94.7
32360, 철원군,075,70~74세,2016,2534,1150,1384,83.1,2526,1144,1382,82.8
32360, 철원군,075001, 70세,2016,434,208,226,92,431,207,224,92.4
32360, 철원군,075002, 71세,2016,551,263,288,91.3,550,262,288,91
32360, 철원군,075003, 72세,2016,493,210,283,74.2,491,208,283,73.5
32360, 철원군,075004, 73세,2016,521,230,291,79,520,229,291,78.7
32360, 철원군,075005, 74세,2016,535,239,296,80.7,534,238,296,80.4
32360, 철원군,080,75~79세,2016,2117,897,1220,73.5,2114,896,1218,73.6
32360, 철원군,080001, 75세,2016,495,216,279,77.4,494,216,278,77.7
32360, 철원군,080002, 76세,2016,458,197,261,75.5,458,197,261,75.5
32360, 철원군,080003, 77세,2016,435,177,258,68.6,435,177,258,68.6
32360, 철원군,080004, 78세,2016,379,166,213,77.9,378,165,213,77.5
32360, 철원군,080005, 79세,2016,350,141,209,67.5,349,141,208,67.8
32360, 철원군,085,80~84세,2016,987,341,646,52.8,987,341,646,52.8
32360, 철원군,085001, 80세,2016,252,90,162,55.6,252,90,162,55.6
32360, 철원군,085002, 81세,2016,222,75,147,51,222,75,147,51
32360, 철원군,085003, 82세,2016,174,53,121,43.8,174,53,121,43.8
32360, 철원군,085004, 83세,2016,186,63,123,51.2,186,63,123,51.2
32360, 철원군,085005, 84세,2016,153,60,93,64.5,153,60,93,64.5
32360, 철원군,090,85~89세,2016,540,142,398,35.7,539,142,397,35.8
32360, 철원군,090001, 85세,2016,115,36,79,45.6,115,36,79,45.6
32360, 철원군,090002, 86세,2016,129,42,87,48.3,128,42,86,48.8
32360, 철원군,090003, 87세,2016,120,24,96,25,120,24,96,25
32360, 철원군,090004, 88세,2016,102,21,81,25.9,102,21,81,25.9
32360, 철원군,090005, 89세,2016,74,19,55,34.5,74,19,55,34.5
32360, 철원군,095,90~94세,2016,190,59,131,45,190,59,131,45
32360, 철원군,095001, 90세,2016,55,13,42,31,55,13,42,31
32360, 철원군,095002, 91세,2016,46,12,34,35.3,46,12,34,35.3
32360, 철원군,095003, 92세,2016,32,10,22,45.5,32,10,22,45.5
32360, 철원군,095004, 93세,2016,31,15,16,93.8,31,15,16,93.8
32360, 철원군,095005, 94세,2016,26,9,17,52.9,26,9,17,52.9
32360, 철원군,100,95~99세,2016,45,13,32,40.6,44,13,31,41.9
32360, 철원군,100001, 95세,2016,15,X,12,25,15,X,12,25
32360, 철원군,100002, 96세,2016,8,X,6,33.3,8,X,6,33.3
32360, 철원군,100003, 97세,2016,10,5,5,100,9,5,X,125
32360, 철원군,100004, 98세,2016,7,X,6,16.7,7,X,6,16.7
32360, 철원군,100005, 99세,2016,5,X,X,66.7,5,X,X,66.7
32360, 철원군,101,100세이상,2016,7,X,X,133.3,7,X,X,133.3
32360, 철원군,102,15세미만,2016,5810,2975,2835,104.9,5804,2971,2833,104.9
32360, 철원군,103,15~64세,2016,30948,17624,13324,132.3,30071,17087,12984,131.6
32360, 철원군,104,65세이상,2016,8675,3657,5018,72.9,8652,3648,5004,72.9
32360, 철원군,086,85세이상,2016,782,218,564,38.7,780,218,562,38.8
32360, 철원군,126,평균연령,2016,43.3,40.9,46,,43.5,41.2,46.2,
32360, 철원군,127,중위연령,2016,44.3,40.8,48.3,,44.8,41.5,48.7,
32370, 화천군,000,합계,2016,24820,13816,11004,125.6,24517,13665,10852,125.9
32370, 화천군,005,0~4세,2016,1205,606,599,101.2,1203,604,599,100.8
32370, 화천군,005001, 0세,2016,229,109,120,90.8,229,109,120,90.8
32370, 화천군,005002, 1세,2016,265,132,133,99.2,265,132,133,99.2
32370, 화천군,005003, 2세,2016,252,132,120,110,252,132,120,110
32370, 화천군,005004, 3세,2016,227,119,108,110.2,226,118,108,109.3
32370, 화천군,005005, 4세,2016,232,114,118,96.6,231,113,118,95.8
32370, 화천군,010,5~9세,2016,1018,497,521,95.4,1017,497,520,95.6
32370, 화천군,010001, 5세,2016,217,106,111,95.5,217,106,111,95.5
32370, 화천군,010002, 6세,2016,212,110,102,107.8,212,110,102,107.8
32370, 화천군,010003, 7세,2016,199,85,114,74.6,198,85,113,75.2
32370, 화천군,010004, 8세,2016,184,95,89,106.7,184,95,89,106.7
32370, 화천군,010005, 9세,2016,206,101,105,96.2,206,101,105,96.2
32370, 화천군,015,10~14세,2016,916,460,456,100.9,916,460,456,100.9
32370, 화천군,015001, 10세,2016,192,100,92,108.7,192,100,92,108.7
32370, 화천군,015002, 11세,2016,162,86,76,113.2,162,86,76,113.2
32370, 화천군,015003, 12세,2016,189,92,97,94.8,189,92,97,94.8
32370, 화천군,015004, 13세,2016,171,91,80,113.8,171,91,80,113.8
32370, 화천군,015005, 14세,2016,202,91,111,82,202,91,111,82
32370, 화천군,020,15~19세,2016,1011,550,461,119.3,1008,550,458,120.1
32370, 화천군,020001, 15세,2016,231,129,102,126.5,231,129,102,126.5
32370, 화천군,020002, 16세,2016,214,113,101,111.9,213,113,100,113
32370, 화천군,020003, 17세,2016,231,135,96,140.6,231,135,96,140.6
32370, 화천군,020004, 18세,2016,193,93,100,93,193,93,100,93
32370, 화천군,020005, 19세,2016,142,80,62,129,140,80,60,133.3
32370, 화천군,025,20~24세,2016,2293,1808,485,372.8,2238,1772,466,380.3
32370, 화천군,025001, 20세,2016,182,121,61,198.4,180,121,59,205.1
32370, 화천군,025002, 21세,2016,253,180,73,246.6,247,175,72,243.1
32370, 화천군,025003, 22세,2016,414,304,110,276.4,402,294,108,272.2
32370, 화천군,025004, 23세,2016,695,591,104,568.3,680,582,98,593.9
32370, 화천군,025005, 24세,2016,749,612,137,446.7,729,600,129,465.1
32370, 화천군,030,25~29세,2016,2267,1637,630,259.8,2190,1592,598,266.2
32370, 화천군,030001, 25세,2016,616,501,115,435.7,594,489,105,465.7
32370, 화천군,030002, 26세,2016,471,343,128,268,457,333,124,268.5
32370, 화천군,030003, 27세,2016,423,311,112,277.7,412,302,110,274.5
32370, 화천군,030004, 28세,2016,385,245,140,175,374,242,132,183.3
32370, 화천군,030005, 29세,2016,372,237,135,175.6,353,226,127,178
32370, 화천군,035,30~34세,2016,1688,984,704,139.8,1653,970,683,142
32370, 화천군,035001, 30세,2016,394,245,149,164.4,388,244,144,169.4
32370, 화천군,035002, 31세,2016,320,200,120,166.7,316,199,117,170.1
32370, 화천군,035003, 32세,2016,326,178,148,120.3,319,175,144,121.5
32370, 화천군,035004, 33세,2016,313,172,141,122,302,166,136,122.1
32370, 화천군,035005, 34세,2016,335,189,146,129.5,328,186,142,131
32370, 화천군,040,35~39세,2016,1422,797,625,127.5,1395,781,614,127.2
32370, 화천군,040001, 35세,2016,322,184,138,133.3,314,181,133,136.1
32370, 화천군,040002, 36세,2016,285,147,138,106.5,278,144,134,107.5
32370, 화천군,040003, 37세,2016,293,181,112,161.6,288,177,111,159.5
32370, 화천군,040004, 38세,2016,248,143,105,136.2,243,139,104,133.7
32370, 화천군,040005, 39세,2016,274,142,132,107.6,272,140,132,106.1
32370, 화천군,045,40~44세,2016,1419,783,636,123.1,1396,768,628,122.3
32370, 화천군,045001, 40세,2016,273,153,120,127.5,269,151,118,128
32370, 화천군,045002, 41세,2016,279,167,112,149.1,273,163,110,148.2
32370, 화천군,045003, 42세,2016,261,136,125,108.8,257,133,124,107.3
32370, 화천군,045004, 43세,2016,300,154,146,105.5,297,152,145,104.8
32370, 화천군,045005, 44세,2016,306,173,133,130.1,300,169,131,129
32370, 화천군,050,45~49세,2016,1596,897,699,128.3,1581,892,689,129.5
32370, 화천군,050001, 45세,2016,299,170,129,131.8,296,170,126,134.9
32370, 화천군,050002, 46세,2016,303,175,128,136.7,301,174,127,137
32370, 화천군,050003, 47세,2016,350,199,151,131.8,345,197,148,133.1
32370, 화천군,050004, 48세,2016,333,182,151,120.5,330,180,150,120
32370, 화천군,050005, 49세,2016,311,171,140,122.1,309,171,138,123.9
32370, 화천군,055,50~54세,2016,1734,955,779,122.6,1711,950,761,124.8
32370, 화천군,055001, 50세,2016,322,180,142,126.8,318,178,140,127.1
32370, 화천군,055002, 51세,2016,336,185,151,122.5,331,184,147,125.2
32370, 화천군,055003, 52세,2016,372,193,179,107.8,368,192,176,109.1
32370, 화천군,055004, 53세,2016,326,175,151,115.9,321,174,147,118.4
32370, 화천군,055005, 54세,2016,378,222,156,142.3,373,222,151,147
32370, 화천군,060,55~59세,2016,2075,1110,965,115,2053,1104,949,116.3
32370, 화천군,060001, 55세,2016,482,263,219,120.1,480,263,217,121.2
32370, 화천군,060002, 56세,2016,413,215,198,108.6,405,213,192,110.9
32370, 화천군,060003, 57세,2016,399,216,183,118,395,215,180,119.4
32370, 화천군,060004, 58세,2016,378,202,176,114.8,374,200,174,114.9
32370, 화천군,060005, 59세,2016,403,214,189,113.2,399,213,186,114.5
32370, 화천군,065,60~64세,2016,1581,841,740,113.6,1570,837,733,114.2
32370, 화천군,065001, 60세,2016,349,182,167,109,348,181,167,108.4
32370, 화천군,065002, 61세,2016,361,196,165,118.8,356,194,162,119.8
32370, 화천군,065003, 62세,2016,334,183,151,121.2,333,182,151,120.5
32370, 화천군,065004, 63세,2016,271,141,130,108.5,268,141,127,111
32370, 화천군,065005, 64세,2016,266,139,127,109.4,265,139,126,110.3
32370, 화천군,070,65~69세,2016,1046,473,573,82.5,1043,470,573,82
32370, 화천군,070001, 65세,2016,153,72,81,88.9,152,71,81,87.7
32370, 화천군,070002, 66세,2016,199,86,113,76.1,199,86,113,76.1
32370, 화천군,070003, 67세,2016,211,88,123,71.5,210,87,123,70.7
32370, 화천군,070004, 68세,2016,236,111,125,88.8,236,111,125,88.8
32370, 화천군,070005, 69세,2016,247,116,131,88.5,246,115,131,87.8
32370, 화천군,075,70~74세,2016,1268,586,682,85.9,1266,586,680,86.2
32370, 화천군,075001, 70세,2016,225,114,111,102.7,224,114,110,103.6
32370, 화천군,075002, 71세,2016,222,87,135,64.4,222,87,135,64.4
32370, 화천군,075003, 72세,2016,240,123,117,105.1,240,123,117,105.1
32370, 화천군,075004, 73세,2016,281,134,147,91.2,280,134,146,91.8
32370, 화천군,075005, 74세,2016,300,128,172,74.4,300,128,172,74.4
32370, 화천군,080,75~79세,2016,1249,494,755,65.4,1247,494,753,65.6
32370, 화천군,080001, 75세,2016,301,121,180,67.2,300,121,179,67.6
32370, 화천군,080002, 76세,2016,267,103,164,62.8,267,103,164,62.8
32370, 화천군,080003, 77세,2016,254,110,144,76.4,254,110,144,76.4
32370, 화천군,080004, 78세,2016,218,75,143,52.4,218,75,143,52.4
32370, 화천군,080005, 79세,2016,209,85,124,68.5,208,85,123,69.1
32370, 화천군,085,80~84세,2016,606,212,394,53.8,606,212,394,53.8
32370, 화천군,085001, 80세,2016,162,53,109,48.6,162,53,109,48.6
32370, 화천군,085002, 81세,2016,132,40,92,43.5,132,40,92,43.5
32370, 화천군,085003, 82세,2016,124,48,76,63.2,124,48,76,63.2
32370, 화천군,085004, 83세,2016,102,44,58,75.9,102,44,58,75.9
32370, 화천군,085005, 84세,2016,86,27,59,45.8,86,27,59,45.8
32370, 화천군,090,85~89세,2016,284,81,203,39.9,283,81,202,40.1
32370, 화천군,090001, 85세,2016,69,27,42,64.3,69,27,42,64.3
32370, 화천군,090002, 86세,2016,84,27,57,47.4,83,27,56,48.2
32370, 화천군,090003, 87세,2016,53,12,41,29.3,53,12,41,29.3
32370, 화천군,090004, 88세,2016,44,6,38,15.8,44,6,38,15.8
32370, 화천군,090005, 89세,2016,34,9,25,36,34,9,25,36
32370, 화천군,095,90~94세,2016,117,41,76,53.9,117,41,76,53.9
32370, 화천군,095001, 90세,2016,23,8,15,53.3,23,8,15,53.3
32370, 화천군,095002, 91세,2016,28,10,18,55.6,28,10,18,55.6
32370, 화천군,095003, 92세,2016,20,7,13,53.8,20,7,13,53.8
32370, 화천군,095004, 93세,2016,29,10,19,52.6,29,10,19,52.6
32370, 화천군,095005, 94세,2016,17,6,11,54.5,17,6,11,54.5
32370, 화천군,100,95~99세,2016,20,X,16,25,19,X,15,26.7
32370, 화천군,100001, 95세,2016,9,X,8,12.5,9,X,8,12.5
32370, 화천군,100002, 96세,2016,7,X,6,16.7,6,X,5,20
32370, 화천군,100003, 97세,2016,X,X,X,0,X,X,X,0
32370, 화천군,100004, 98세,2016,X,X,X,,X,X,X,
32370, 화천군,100005, 99세,2016,X,X,X,0,X,X,X,0
32370, 화천군,101,100세이상,2016,5,X,5,0,5,X,5,0
32370, 화천군,102,15세미만,2016,3139,1563,1576,99.2,3136,1561,1575,99.1
32370, 화천군,103,15~64세,2016,17086,10362,6724,154.1,16795,10216,6579,155.3
32370, 화천군,104,65세이상,2016,4595,1891,2704,69.9,4586,1888,2698,70
32370, 화천군,086,85세이상,2016,426,126,300,42,424,126,298,42.3
32370, 화천군,126,평균연령,2016,42.5,40,45.7,,42.6,40,45.7,
32370, 화천군,127,중위연령,2016,42.1,37.2,47.8,,42.4,37.4,48,
32380, 양구군,000,합계,2016,22454,12029,10425,115.4,22111,11907,10204,116.7
32380, 양구군,005,0~4세,2016,1053,521,532,97.9,1051,520,531,97.9
32380, 양구군,005001, 0세,2016,216,98,118,83.1,216,98,118,83.1
32380, 양구군,005002, 1세,2016,232,121,111,109,232,121,111,109
32380, 양구군,005003, 2세,2016,181,97,84,115.5,180,96,84,114.3
32380, 양구군,005004, 3세,2016,192,89,103,86.4,192,89,103,86.4
32380, 양구군,005005, 4세,2016,232,116,116,100,231,116,115,100.9
32380, 양구군,010,5~9세,2016,937,483,454,106.4,935,482,453,106.4
32380, 양구군,010001, 5세,2016,197,112,85,131.8,196,111,85,130.6
32380, 양구군,010002, 6세,2016,206,95,111,85.6,206,95,111,85.6
32380, 양구군,010003, 7세,2016,167,88,79,111.4,167,88,79,111.4
32380, 양구군,010004, 8세,2016,185,93,92,101.1,184,93,91,102.2
32380, 양구군,010005, 9세,2016,182,95,87,109.2,182,95,87,109.2
32380, 양구군,015,10~14세,2016,949,493,456,108.1,949,493,456,108.1
32380, 양구군,015001, 10세,2016,196,93,103,90.3,196,93,103,90.3
32380, 양구군,015002, 11세,2016,188,115,73,157.5,188,115,73,157.5
32380, 양구군,015003, 12세,2016,205,89,116,76.7,205,89,116,76.7
32380, 양구군,015004, 13세,2016,168,90,78,115.4,168,90,78,115.4
32380, 양구군,015005, 14세,2016,192,106,86,123.3,192,106,86,123.3
32380, 양구군,020,15~19세,2016,1308,638,670,95.2,1308,638,670,95.2
32380, 양구군,020001, 15세,2016,230,123,107,115,230,123,107,115
32380, 양구군,020002, 16세,2016,355,165,190,86.8,355,165,190,86.8
32380, 양구군,020003, 17세,2016,325,141,184,76.6,325,141,184,76.6
32380, 양구군,020004, 18세,2016,295,140,155,90.3,295,140,155,90.3
32380, 양구군,020005, 19세,2016,103,69,34,202.9,103,69,34,202.9
32380, 양구군,025,20~24세,2016,1751,1361,390,349,1717,1346,371,362.8
32380, 양구군,025001, 20세,2016,145,104,41,253.7,142,102,40,255
32380, 양구군,025002, 21세,2016,218,165,53,311.3,214,164,50,328
32380, 양구군,025003, 22세,2016,353,281,72,390.3,347,277,70,395.7
32380, 양구군,025004, 23세,2016,495,382,113,338.1,485,377,108,349.1
32380, 양구군,025005, 24세,2016,540,429,111,386.5,529,426,103,413.6
32380, 양구군,030,25~29세,2016,1787,1172,615,190.6,1715,1154,561,205.7
32380, 양구군,030001, 25세,2016,472,333,139,239.6,457,328,129,254.3
32380, 양구군,030002, 26세,2016,386,260,126,206.3,363,254,109,233
32380, 양구군,030003, 27세,2016,314,205,109,188.1,300,200,100,200
32380, 양구군,030004, 28세,2016,309,189,120,157.5,297,188,109,172.5
32380, 양구군,030005, 29세,2016,306,185,121,152.9,298,184,114,161.4
32380, 양구군,035,30~34세,2016,1431,774,657,117.8,1379,757,622,121.7
32380, 양구군,035001, 30세,2016,271,157,114,137.7,264,154,110,140
32380, 양구군,035002, 31세,2016,272,154,118,130.5,257,149,108,138
32380, 양구군,035003, 32세,2016,298,162,136,119.1,289,160,129,124
32380, 양구군,035004, 33세,2016,290,143,147,97.3,280,140,140,100
32380, 양구군,035005, 34세,2016,300,158,142,111.3,289,154,135,114.1
32380, 양구군,040,35~39세,2016,1334,700,634,110.4,1296,685,611,112.1
32380, 양구군,040001, 35세,2016,294,145,149,97.3,279,140,139,100.7
32380, 양구군,040002, 36세,2016,309,177,132,134.1,298,171,127,134.6
32380, 양구군,040003, 37세,2016,243,126,117,107.7,238,123,115,107
32380, 양구군,040004, 38세,2016,257,140,117,119.7,253,140,113,123.9
32380, 양구군,040005, 39세,2016,231,112,119,94.1,228,111,117,94.9
32380, 양구군,045,40~44세,2016,1358,746,612,121.9,1329,735,594,123.7
32380, 양구군,045001, 40세,2016,247,130,117,111.1,243,127,116,109.5
32380, 양구군,045002, 41세,2016,253,130,123,105.7,244,128,116,110.3
32380, 양구군,045003, 42세,2016,296,162,134,120.9,291,160,131,122.1
32380, 양구군,045004, 43세,2016,297,169,128,132,291,167,124,134.7
32380, 양구군,045005, 44세,2016,265,155,110,140.9,260,153,107,143
32380, 양구군,050,45~49세,2016,1510,821,689,119.2,1474,807,667,121
32380, 양구군,050001, 45세,2016,258,135,123,109.8,252,132,120,110
32380, 양구군,050002, 46세,2016,293,154,139,110.8,285,152,133,114.3
32380, 양구군,050003, 47세,2016,327,183,144,127.1,319,180,139,129.5
32380, 양구군,050004, 48세,2016,333,181,152,119.1,325,178,147,121.1
32380, 양구군,050005, 49세,2016,299,168,131,128.2,293,165,128,128.9
32380, 양구군,055,50~54세,2016,1673,888,785,113.1,1646,877,769,114
32380, 양구군,055001, 50세,2016,283,148,135,109.6,280,147,133,110.5
32380, 양구군,055002, 51세,2016,282,156,126,123.8,277,153,124,123.4
32380, 양구군,055003, 52세,2016,345,182,163,111.7,341,181,160,113.1
32380, 양구군,055004, 53세,2016,372,199,173,115,365,195,170,114.7
32380, 양구군,055005, 54세,2016,391,203,188,108,383,201,182,110.4
32380, 양구군,060,55~59세,2016,1968,1057,911,116,1946,1050,896,117.2
32380, 양구군,060001, 55세,2016,419,218,201,108.5,414,216,198,109.1
32380, 양구군,060002, 56세,2016,420,227,193,117.6,419,227,192,118.2
32380, 양구군,060003, 57세,2016,370,205,165,124.2,367,204,163,125.2
32380, 양구군,060004, 58세,2016,394,202,192,105.2,384,199,185,107.6
32380, 양구군,060005, 59세,2016,365,205,160,128.1,362,204,158,129.1
32380, 양구군,065,60~64세,2016,1446,788,658,119.8,1429,780,649,120.2
32380, 양구군,065001, 60세,2016,330,177,153,115.7,328,177,151,117.2
32380, 양구군,065002, 61세,2016,337,190,147,129.3,332,189,143,132.2
32380, 양구군,065003, 62세,2016,323,174,149,116.8,317,171,146,117.1
32380, 양구군,065004, 63세,2016,215,114,101,112.9,214,113,101,111.9
32380, 양구군,065005, 64세,2016,241,133,108,123.1,238,130,108,120.4
32380, 양구군,070,65~69세,2016,923,402,521,77.2,919,401,518,77.4
32380, 양구군,070001, 65세,2016,166,74,92,80.4,166,74,92,80.4
32380, 양구군,070002, 66세,2016,167,76,91,83.5,166,75,91,82.4
32380, 양구군,070003, 67세,2016,195,80,115,69.6,194,80,114,70.2
32380, 양구군,070004, 68세,2016,181,83,98,84.7,181,83,98,84.7
32380, 양구군,070005, 69세,2016,214,89,125,71.2,212,89,123,72.4
32380, 양구군,075,70~74세,2016,1108,505,603,83.7,1102,502,600,83.7
32380, 양구군,075001, 70세,2016,185,88,97,90.7,185,88,97,90.7
32380, 양구군,075002, 71세,2016,197,99,98,101,194,98,96,102.1
32380, 양구군,075003, 72세,2016,240,111,129,86,239,110,129,85.3
32380, 양구군,075004, 73세,2016,216,91,125,72.8,216,91,125,72.8
32380, 양구군,075005, 74세,2016,270,116,154,75.3,268,115,153,75.2
32380, 양구군,080,75~79세,2016,969,384,585,65.6,967,384,583,65.9
32380, 양구군,080001, 75세,2016,227,92,135,68.1,227,92,135,68.1
32380, 양구군,080002, 76세,2016,199,77,122,63.1,197,77,120,64.2
32380, 양구군,080003, 77세,2016,210,87,123,70.7,210,87,123,70.7
32380, 양구군,080004, 78세,2016,180,68,112,60.7,180,68,112,60.7
32380, 양구군,080005, 79세,2016,153,60,93,64.5,153,60,93,64.5
32380, 양구군,085,80~84세,2016,559,191,368,51.9,559,191,368,51.9
32380, 양구군,085001, 80세,2016,146,64,82,78,146,64,82,78
32380, 양구군,085002, 81세,2016,125,40,85,47.1,125,40,85,47.1
32380, 양구군,085003, 82세,2016,109,32,77,41.6,109,32,77,41.6
32380, 양구군,085004, 83세,2016,106,29,77,37.7,106,29,77,37.7
32380, 양구군,085005, 84세,2016,73,26,47,55.3,73,26,47,55.3
32380, 양구군,090,85~89세,2016,271,72,199,36.2,271,72,199,36.2
32380, 양구군,090001, 85세,2016,84,27,57,47.4,84,27,57,47.4
32380, 양구군,090002, 86세,2016,55,10,45,22.2,55,10,45,22.2
32380, 양구군,090003, 87세,2016,55,13,42,31,55,13,42,31
32380, 양구군,090004, 88세,2016,39,13,26,50,39,13,26,50
32380, 양구군,090005, 89세,2016,38,9,29,31,38,9,29,31
32380, 양구군,095,90~94세,2016,97,25,72,34.7,97,25,72,34.7
32380, 양구군,095001, 90세,2016,24,X,20,20,24,X,20,20
32380, 양구군,095002, 91세,2016,28,8,20,40,28,8,20,40
32380, 양구군,095003, 92세,2016,19,6,13,46.2,19,6,13,46.2
32380, 양구군,095004, 93세,2016,19,5,14,35.7,19,5,14,35.7
32380, 양구군,095005, 94세,2016,7,X,5,40,7,X,5,40
32380, 양구군,100,95~99세,2016,19,8,11,72.7,19,8,11,72.7
32380, 양구군,100001, 95세,2016,8,X,6,33.3,8,X,6,33.3
32380, 양구군,100002, 96세,2016,X,X,X,,X,X,X,
32380, 양구군,100003, 97세,2016,X,X,X,50,X,X,X,50
32380, 양구군,100004, 98세,2016,X,X,X,0,X,X,X,0
32380, 양구군,100005, 99세,2016,X,X,X,,X,X,X,
32380, 양구군,101,100세이상,2016,X,X,X,0,X,X,X,0
32380, 양구군,102,15세미만,2016,2939,1497,1442,103.8,2935,1495,1440,103.8
32380, 양구군,103,15~64세,2016,15566,8945,6621,135.1,15239,8829,6410,137.7
32380, 양구군,104,65세이상,2016,3949,1587,2362,67.2,3937,1583,2354,67.2
32380, 양구군,086,85세이상,2016,390,105,285,36.8,390,105,285,36.8
32380, 양구군,126,평균연령,2016,42.3,40.1,44.7,,42.3,40.1,44.8,
32380, 양구군,127,중위연령,2016,42.6,38.9,46.5,,42.7,38.9,46.8,
32390, 인제군,000,합계,2016,30759,16642,14117,117.9,30298,16390,13908,117.8
32390, 인제군,005,0~4세,2016,1533,785,748,104.9,1532,784,748,104.8
32390, 인제군,005001, 0세,2016,333,174,159,109.4,332,173,159,108.8
32390, 인제군,005002, 1세,2016,308,152,156,97.4,308,152,156,97.4
32390, 인제군,005003, 2세,2016,278,144,134,107.5,278,144,134,107.5
32390, 인제군,005004, 3세,2016,293,153,140,109.3,293,153,140,109.3
32390, 인제군,005005, 4세,2016,321,162,159,101.9,321,162,159,101.9
32390, 인제군,010,5~9세,2016,1388,725,663,109.4,1384,724,660,109.7
32390, 인제군,010001, 5세,2016,283,153,130,117.7,282,152,130,116.9
32390, 인제군,010002, 6세,2016,307,156,151,103.3,305,156,149,104.7
32390, 인제군,010003, 7세,2016,248,136,112,121.4,248,136,112,121.4
32390, 인제군,010004, 8세,2016,278,137,141,97.2,277,137,140,97.9
32390, 인제군,010005, 9세,2016,272,143,129,110.9,272,143,129,110.9
32390, 인제군,015,10~14세,2016,1257,657,600,109.5,1257,657,600,109.5
32390, 인제군,015001, 10세,2016,274,131,143,91.6,274,131,143,91.6
32390, 인제군,015002, 11세,2016,264,137,127,107.9,264,137,127,107.9
32390, 인제군,015003, 12세,2016,257,143,114,125.4,257,143,114,125.4
32390, 인제군,015004, 13세,2016,241,125,116,107.8,241,125,116,107.8
32390, 인제군,015005, 14세,2016,221,121,100,121,221,121,100,121
32390, 인제군,020,15~19세,2016,1143,619,524,118.1,1142,619,523,118.4
32390, 인제군,020001, 15세,2016,260,134,126,106.3,260,134,126,106.3
32390, 인제군,020002, 16세,2016,252,131,121,108.3,252,131,121,108.3
32390, 인제군,020003, 17세,2016,274,151,123,122.8,274,151,123,122.8
32390, 인제군,020004, 18세,2016,229,122,107,114,229,122,107,114
32390, 인제군,020005, 19세,2016,128,81,47,172.3,127,81,46,176.1
32390, 인제군,025,20~24세,2016,1838,1348,490,275.1,1746,1291,455,283.7
32390, 인제군,025001, 20세,2016,216,157,59,266.1,213,156,57,273.7
32390, 인제군,025002, 21세,2016,262,190,72,263.9,250,182,68,267.6
32390, 인제군,025003, 22세,2016,335,229,106,216,318,221,97,227.8
32390, 인제군,025004, 23세,2016,471,347,124,279.8,440,327,113,289.4
32390, 인제군,025005, 24세,2016,554,425,129,329.5,525,405,120,337.5
32390, 인제군,030,25~29세,2016,2202,1454,748,194.4,2112,1406,706,199.2
32390, 인제군,030001, 25세,2016,520,376,144,261.1,499,362,137,264.2
32390, 인제군,030002, 26세,2016,472,307,165,186.1,448,294,154,190.9
32390, 인제군,030003, 27세,2016,413,278,135,205.9,398,273,125,218.4
32390, 인제군,030004, 28세,2016,409,255,154,165.6,392,247,145,170.3
32390, 인제군,030005, 29세,2016,388,238,150,158.7,375,230,145,158.6
32390, 인제군,035,30~34세,2016,2090,1191,899,132.5,2013,1145,868,131.9
32390, 인제군,035001, 30세,2016,441,267,174,153.4,417,251,166,151.2
32390, 인제군,035002, 31세,2016,384,237,147,161.2,368,227,141,161
32390, 인제군,035003, 32세,2016,377,221,156,141.7,363,209,154,135.7
32390, 인제군,035004, 33세,2016,429,225,204,110.3,417,221,196,112.8
32390, 인제군,035005, 34세,2016,459,241,218,110.6,448,237,211,112.3
32390, 인제군,040,35~39세,2016,2125,1131,994,113.8,2088,1109,979,113.3
32390, 인제군,040001, 35세,2016,478,259,219,118.3,467,253,214,118.2
32390, 인제군,040002, 36세,2016,453,243,210,115.7,445,238,207,115
32390, 인제군,040003, 37세,2016,423,225,198,113.6,413,220,193,114
32390, 인제군,040004, 38세,2016,374,204,170,120,371,202,169,119.5
32390, 인제군,040005, 39세,2016,397,200,197,101.5,392,196,196,100
32390, 인제군,045,40~44세,2016,1976,1139,837,136.1,1953,1127,826,136.4
32390, 인제군,045001, 40세,2016,375,213,162,131.5,370,209,161,129.8
32390, 인제군,045002, 41세,2016,407,229,178,128.7,403,228,175,130.3
32390, 인제군,045003, 42세,2016,414,255,159,160.4,409,253,156,162.2
32390, 인제군,045004, 43세,2016,382,217,165,131.5,376,213,163,130.7
32390, 인제군,045005, 44세,2016,398,225,173,130.1,395,224,171,131
32390, 인제군,050,45~49세,2016,2123,1184,939,126.1,2094,1171,923,126.9
32390, 인제군,050001, 45세,2016,428,239,189,126.5,421,235,186,126.3
32390, 인제군,050002, 46세,2016,410,229,181,126.5,406,228,178,128.1
32390, 인제군,050003, 47세,2016,442,251,191,131.4,438,249,189,131.7
32390, 인제군,050004, 48세,2016,452,251,201,124.9,446,248,198,125.3
32390, 인제군,050005, 49세,2016,391,214,177,120.9,383,211,172,122.7
32390, 인제군,055,50~54세,2016,2507,1336,1171,114.1,2463,1313,1150,114.2
32390, 인제군,055001, 50세,2016,475,278,197,141.1,467,273,194,140.7
32390, 인제군,055002, 51세,2016,439,221,218,101.4,429,217,212,102.4
32390, 인제군,055003, 52세,2016,487,262,225,116.4,480,258,222,116.2
32390, 인제군,055004, 53세,2016,525,256,269,95.2,514,251,263,95.4
32390, 인제군,055005, 54세,2016,581,319,262,121.8,573,314,259,121.2
32390, 인제군,060,55~59세,2016,2948,1602,1346,119,2927,1594,1333,119.6
32390, 인제군,060001, 55세,2016,672,345,327,105.5,670,345,325,106.2
32390, 인제군,060002, 56세,2016,602,315,287,109.8,595,313,282,111
32390, 인제군,060003, 57세,2016,520,283,237,119.4,515,281,234,120.1
32390, 인제군,060004, 58세,2016,567,324,243,133.3,563,323,240,134.6
32390, 인제군,060005, 59세,2016,587,335,252,132.9,584,332,252,131.7
32390, 인제군,065,60~64세,2016,2202,1133,1069,106,2185,1125,1060,106.1
32390, 인제군,065001, 60세,2016,479,254,225,112.9,475,253,222,114
32390, 인제군,065002, 61세,2016,506,255,251,101.6,504,254,250,101.6
32390, 인제군,065003, 62세,2016,433,219,214,102.3,427,215,212,101.4
32390, 인제군,065004, 63세,2016,344,182,162,112.3,342,182,160,113.8
32390, 인제군,065005, 64세,2016,440,223,217,102.8,437,221,216,102.3
32390, 인제군,070,65~69세,2016,1345,655,690,94.9,1329,647,682,94.9
32390, 인제군,070001, 65세,2016,247,125,122,102.5,245,124,121,102.5
32390, 인제군,070002, 66세,2016,236,107,129,82.9,234,106,128,82.8
32390, 인제군,070003, 67세,2016,271,131,140,93.6,266,129,137,94.2
32390, 인제군,070004, 68세,2016,275,138,137,100.7,273,136,137,99.3
32390, 인제군,070005, 69세,2016,316,154,162,95.1,311,152,159,95.6
32390, 인제군,075,70~74세,2016,1471,713,758,94.1,1464,708,756,93.7
32390, 인제군,075001, 70세,2016,271,139,132,105.3,267,136,131,103.8
32390, 인제군,075002, 71세,2016,298,140,158,88.6,297,139,158,88
32390, 인제군,075003, 72세,2016,289,154,135,114.1,289,154,135,114.1
32390, 인제군,075004, 73세,2016,301,126,175,72,300,126,174,72.4
32390, 인제군,075005, 74세,2016,312,154,158,97.5,311,153,158,96.8
32390, 인제군,080,75~79세,2016,1365,589,776,75.9,1364,589,775,76
32390, 인제군,080001, 75세,2016,302,144,158,91.1,302,144,158,91.1
32390, 인제군,080002, 76세,2016,285,128,157,81.5,284,128,156,82.1
32390, 인제군,080003, 77세,2016,267,102,165,61.8,267,102,165,61.8
32390, 인제군,080004, 78세,2016,285,107,178,60.1,285,107,178,60.1
32390, 인제군,080005, 79세,2016,226,108,118,91.5,226,108,118,91.5
32390, 인제군,085,80~84세,2016,704,225,479,47,704,225,479,47
32390, 인제군,085001, 80세,2016,181,69,112,61.6,181,69,112,61.6
32390, 인제군,085002, 81세,2016,166,47,119,39.5,166,47,119,39.5
32390, 인제군,085003, 82세,2016,125,43,82,52.4,125,43,82,52.4
32390, 인제군,085004, 83세,2016,123,37,86,43,123,37,86,43
32390, 인제군,085005, 84세,2016,109,29,80,36.3,109,29,80,36.3
32390, 인제군,090,85~89세,2016,353,90,263,34.2,353,90,263,34.2
32390, 인제군,090001, 85세,2016,83,25,58,43.1,83,25,58,43.1
32390, 인제군,090002, 86세,2016,83,16,67,23.9,83,16,67,23.9
32390, 인제군,090003, 87세,2016,69,18,51,35.3,69,18,51,35.3
32390, 인제군,090004, 88세,2016,75,19,56,33.9,75,19,56,33.9
32390, 인제군,090005, 89세,2016,43,12,31,38.7,43,12,31,38.7
32390, 인제군,095,90~94세,2016,151,52,99,52.5,150,52,98,53.1
32390, 인제군,095001, 90세,2016,46,8,38,21.1,45,8,37,21.6
32390, 인제군,095002, 91세,2016,25,10,15,66.7,25,10,15,66.7
32390, 인제군,095003, 92세,2016,32,17,15,113.3,32,17,15,113.3
32390, 인제군,095004, 93세,2016,28,9,19,47.4,28,9,19,47.4
32390, 인제군,095005, 94세,2016,20,8,12,66.7,20,8,12,66.7
32390, 인제군,100,95~99세,2016,37,14,23,60.9,37,14,23,60.9
32390, 인제군,100001, 95세,2016,12,X,8,50,12,X,8,50
32390, 인제군,100002, 96세,2016,9,X,5,80,9,X,5,80
32390, 인제군,100003, 97세,2016,10,X,6,66.7,10,X,6,66.7
32390, 인제군,100004, 98세,2016,X,X,X,200,X,X,X,200
32390, 인제군,100005, 99세,2016,X,X,X,0,X,X,X,0
32390, 인제군,101,100세이상,2016,X,X,X,0,X,X,X,0
32390, 인제군,102,15세미만,2016,4178,2167,2011,107.8,4173,2165,2008,107.8
32390, 인제군,103,15~64세,2016,21154,12137,9017,134.6,20723,11900,8823,134.9
32390, 인제군,104,65세이상,2016,5427,2338,3089,75.7,5402,2325,3077,75.6
32390, 인제군,086,85세이상,2016,542,156,386,40.4,541,156,385,40.5
32390, 인제군,126,평균연령,2016,43.3,41.4,45.5,,43.4,41.5,45.6,
32390, 인제군,127,중위연령,2016,44.6,41.9,48,,44.8,42.1,48.2,
32400, 고성군,000,합계,2016,28984,15589,13395,116.4,28249,15076,13173,114.4
32400, 고성군,005,0~4세,2016,694,368,326,112.9,694,368,326,112.9
32400, 고성군,005001, 0세,2016,148,74,74,100,148,74,74,100
32400, 고성군,005002, 1세,2016,124,70,54,129.6,124,70,54,129.6
32400, 고성군,005003, 2세,2016,141,76,65,116.9,141,76,65,116.9
32400, 고성군,005004, 3세,2016,125,58,67,86.6,125,58,67,86.6
32400, 고성군,005005, 4세,2016,156,90,66,136.4,156,90,66,136.4
32400, 고성군,010,5~9세,2016,710,380,330,115.2,707,379,328,115.5
32400, 고성군,010001, 5세,2016,156,85,71,119.7,153,84,69,121.7
32400, 고성군,010002, 6세,2016,120,65,55,118.2,120,65,55,118.2
32400, 고성군,010003, 7세,2016,127,59,68,86.8,127,59,68,86.8
32400, 고성군,010004, 8세,2016,155,94,61,154.1,155,94,61,154.1
32400, 고성군,010005, 9세,2016,152,77,75,102.7,152,77,75,102.7
32400, 고성군,015,10~14세,2016,853,458,395,115.9,852,458,394,116.2
32400, 고성군,015001, 10세,2016,157,90,67,134.3,157,90,67,134.3
32400, 고성군,015002, 11세,2016,163,87,76,114.5,163,87,76,114.5
32400, 고성군,015003, 12세,2016,162,87,75,116,162,87,75,116
32400, 고성군,015004, 13세,2016,179,90,89,101.1,178,90,88,102.3
32400, 고성군,015005, 14세,2016,192,104,88,118.2,192,104,88,118.2
32400, 고성군,020,15~19세,2016,1640,979,661,148.1,1562,936,626,149.5
32400, 고성군,020001, 15세,2016,211,119,92,129.3,211,119,92,129.3
32400, 고성군,020002, 16세,2016,221,113,108,104.6,221,113,108,104.6
32400, 고성군,020003, 17세,2016,246,132,114,115.8,245,131,114,114.9
32400, 고성군,020004, 18세,2016,349,210,139,151.1,325,198,127,155.9
32400, 고성군,020005, 19세,2016,613,405,208,194.7,560,375,185,202.7
32400, 고성군,025,20~24세,2016,3690,2423,1267,191.2,3435,2233,1202,185.8
32400, 고성군,025001, 20세,2016,667,398,269,148,588,338,250,135.2
32400, 고성군,025002, 21세,2016,664,325,339,95.9,600,280,320,87.5
32400, 고성군,025003, 22세,2016,812,498,314,158.6,768,462,306,151
32400, 고성군,025004, 23세,2016,765,587,178,329.8,729,562,167,336.5
32400, 고성군,025005, 24세,2016,782,615,167,368.3,750,591,159,371.7
32400, 고성군,030,25~29세,2016,1827,1299,528,246,1736,1227,509,241.1
32400, 고성군,030001, 25세,2016,517,391,126,310.3,495,373,122,305.7
32400, 고성군,030002, 26세,2016,429,305,124,246,406,285,121,235.5
32400, 고성군,030003, 27세,2016,337,235,102,230.4,318,221,97,227.8
32400, 고성군,030004, 28세,2016,285,196,89,220.2,272,186,86,216.3
32400, 고성군,030005, 29세,2016,259,172,87,197.7,245,162,83,195.2
32400, 고성군,035,30~34세,2016,1241,760,481,158,1137,678,459,147.7
32400, 고성군,035001, 30세,2016,240,152,88,172.7,225,140,85,164.7
32400, 고성군,035002, 31세,2016,255,159,96,165.6,233,144,89,161.8
32400, 고성군,035003, 32세,2016,264,149,115,129.6,243,132,111,118.9
32400, 고성군,035004, 33세,2016,246,150,96,156.3,213,123,90,136.7
32400, 고성군,035005, 34세,2016,236,150,86,174.4,223,139,84,165.5
32400, 고성군,040,35~39세,2016,1166,666,500,133.2,1087,604,483,125.1
32400, 고성군,040001, 35세,2016,243,148,95,155.8,225,131,94,139.4
32400, 고성군,040002, 36세,2016,256,143,113,126.5,235,129,106,121.7
32400, 고성군,040003, 37세,2016,217,125,92,135.9,202,112,90,124.4
32400, 고성군,040004, 38세,2016,215,126,89,141.6,205,119,86,138.4
32400, 고성군,040005, 39세,2016,235,124,111,111.7,220,113,107,105.6
32400, 고성군,045,40~44세,2016,1457,822,635,129.4,1405,791,614,128.8
32400, 고성군,045001, 40세,2016,268,149,119,125.2,256,140,116,120.7
32400, 고성군,045002, 41세,2016,249,137,112,122.3,239,132,107,123.4
32400, 고성군,045003, 42세,2016,310,187,123,152,302,182,120,151.7
32400, 고성군,045004, 43세,2016,296,161,135,119.3,283,153,130,117.7
32400, 고성군,045005, 44세,2016,334,188,146,128.8,325,184,141,130.5
32400, 고성군,050,45~49세,2016,1880,1068,812,131.5,1857,1056,801,131.8
32400, 고성군,050001, 45세,2016,370,217,153,141.8,364,215,149,144.3
32400, 고성군,050002, 46세,2016,370,213,157,135.7,362,209,153,136.6
32400, 고성군,050003, 47세,2016,377,217,160,135.6,372,213,159,134
32400, 고성군,050004, 48세,2016,403,227,176,129,401,226,175,129.1
32400, 고성군,050005, 49세,2016,360,194,166,116.9,358,193,165,117
32400, 고성군,055,50~54세,2016,2112,1099,1013,108.5,2088,1093,995,109.8
32400, 고성군,055001, 50세,2016,386,211,175,120.6,381,209,172,121.5
32400, 고성군,055002, 51세,2016,391,200,191,104.7,383,198,185,107
32400, 고성군,055003, 52세,2016,386,210,176,119.3,382,209,173,120.8
32400, 고성군,055004, 53세,2016,466,237,229,103.5,460,236,224,105.4
32400, 고성군,055005, 54세,2016,483,241,242,99.6,482,241,241,100
32400, 고성군,060,55~59세,2016,2681,1391,1290,107.8,2673,1385,1288,107.5
32400, 고성군,060001, 55세,2016,570,278,292,95.2,568,276,292,94.5
32400, 고성군,060002, 56세,2016,554,283,271,104.4,551,282,269,104.8
32400, 고성군,060003, 57세,2016,529,275,254,108.3,529,275,254,108.3
32400, 고성군,060004, 58세,2016,526,282,244,115.6,525,281,244,115.2
32400, 고성군,060005, 59세,2016,502,273,229,119.2,500,271,229,118.3
32400, 고성군,065,60~64세,2016,2306,1140,1166,97.8,2302,1138,1164,97.8
32400, 고성군,065001, 60세,2016,471,232,239,97.1,469,231,238,97.1
32400, 고성군,065002, 61세,2016,538,260,278,93.5,537,259,278,93.2
32400, 고성군,065003, 62세,2016,496,236,260,90.8,496,236,260,90.8
32400, 고성군,065004, 63세,2016,390,214,176,121.6,390,214,176,121.6
32400, 고성군,065005, 64세,2016,411,198,213,93,410,198,212,93.4
32400, 고성군,070,65~69세,2016,1653,777,876,88.7,1645,775,870,89.1
32400, 고성군,070001, 65세,2016,301,145,156,92.9,299,145,154,94.2
32400, 고성군,070002, 66세,2016,295,133,162,82.1,293,132,161,82
32400, 고성군,070003, 67세,2016,354,172,182,94.5,353,171,182,94
32400, 고성군,070004, 68세,2016,357,173,184,94,356,173,183,94.5
32400, 고성군,070005, 69세,2016,346,154,192,80.2,344,154,190,81.1
32400, 고성군,075,70~74세,2016,1897,826,1071,77.1,1896,825,1071,77
32400, 고성군,075001, 70세,2016,367,166,201,82.6,366,165,201,82.1
32400, 고성군,075002, 71세,2016,372,166,206,80.6,372,166,206,80.6
32400, 고성군,075003, 72세,2016,352,137,215,63.7,352,137,215,63.7
32400, 고성군,075004, 73세,2016,360,158,202,78.2,360,158,202,78.2
32400, 고성군,075005, 74세,2016,446,199,247,80.6,446,199,247,80.6
32400, 고성군,080,75~79세,2016,1605,656,949,69.1,1603,655,948,69.1
32400, 고성군,080001, 75세,2016,345,141,204,69.1,345,141,204,69.1
32400, 고성군,080002, 76세,2016,340,147,193,76.2,340,147,193,76.2
32400, 고성군,080003, 77세,2016,338,144,194,74.2,338,144,194,74.2
32400, 고성군,080004, 78세,2016,314,131,183,71.6,312,130,182,71.4
32400, 고성군,080005, 79세,2016,268,93,175,53.1,268,93,175,53.1
32400, 고성군,085,80~84세,2016,840,294,546,53.8,839,293,546,53.7
32400, 고성군,085001, 80세,2016,220,92,128,71.9,219,91,128,71.1
32400, 고성군,085002, 81세,2016,207,75,132,56.8,207,75,132,56.8
32400, 고성군,085003, 82세,2016,154,52,102,51,154,52,102,51
32400, 고성군,085004, 83세,2016,137,42,95,44.2,137,42,95,44.2
32400, 고성군,085005, 84세,2016,122,33,89,37.1,122,33,89,37.1
32400, 고성군,090,85~89세,2016,483,117,366,32,482,116,366,31.7
32400, 고성군,090001, 85세,2016,106,35,71,49.3,106,35,71,49.3
32400, 고성군,090002, 86세,2016,106,26,80,32.5,106,26,80,32.5
32400, 고성군,090003, 87세,2016,99,26,73,35.6,99,26,73,35.6
32400, 고성군,090004, 88세,2016,94,16,78,20.5,93,15,78,19.2
32400, 고성군,090005, 89세,2016,78,14,64,21.9,78,14,64,21.9
32400, 고성군,095,90~94세,2016,199,56,143,39.2,199,56,143,39.2
32400, 고성군,095001, 90세,2016,63,14,49,28.6,63,14,49,28.6
32400, 고성군,095002, 91세,2016,46,14,32,43.8,46,14,32,43.8
32400, 고성군,095003, 92세,2016,41,13,28,46.4,41,13,28,46.4
32400, 고성군,095004, 93세,2016,26,6,20,30,26,6,20,30
32400, 고성군,095005, 94세,2016,23,9,14,64.3,23,9,14,64.3
32400, 고성군,100,95~99세,2016,46,9,37,24.3,46,9,37,24.3
32400, 고성군,100001, 95세,2016,14,X,12,16.7,14,X,12,16.7
32400, 고성군,100002, 96세,2016,5,X,5,0,5,X,5,0
32400, 고성군,100003, 97세,2016,15,X,12,25,15,X,12,25
32400, 고성군,100004, 98세,2016,10,X,7,42.9,10,X,7,42.9
32400, 고성군,100005, 99세,2016,X,X,X,100,X,X,X,100
32400, 고성군,101,100세이상,2016,X,X,X,33.3,X,X,X,33.3
32400, 고성군,102,15세미만,2016,2257,1206,1051,114.7,2253,1205,1048,115
32400, 고성군,103,15~64세,2016,20000,11647,8353,139.4,19282,11141,8141,136.9
32400, 고성군,104,65세이상,2016,6727,2736,3991,68.6,6714,2730,3984,68.5
32400, 고성군,086,85세이상,2016,732,183,549,33.3,731,182,549,33.2
32400, 고성군,126,평균연령,2016,46,42.7,49.8,,46.4,43.1,50.1,
32400, 고성군,127,중위연령,2016,48.2,42.9,54,,49,44.3,54.4,
32410, 양양군,000,합계,2016,25670,12986,12684,102.4,25322,12797,12525,102.2
32410, 양양군,005,0~4세,2016,691,358,333,107.5,689,357,332,107.5
32410, 양양군,005001, 0세,2016,128,62,66,93.9,128,62,66,93.9
32410, 양양군,005002, 1세,2016,132,68,64,106.3,132,68,64,106.3
32410, 양양군,005003, 2세,2016,130,69,61,113.1,129,69,60,115
32410, 양양군,005004, 3세,2016,152,89,63,141.3,152,89,63,141.3
32410, 양양군,005005, 4세,2016,149,70,79,88.6,148,69,79,87.3
32410, 양양군,010,5~9세,2016,785,411,374,109.9,781,410,371,110.5
32410, 양양군,010001, 5세,2016,155,81,74,109.5,155,81,74,109.5
32410, 양양군,010002, 6세,2016,150,78,72,108.3,148,78,70,111.4
32410, 양양군,010003, 7세,2016,149,75,74,101.4,149,75,74,101.4
32410, 양양군,010004, 8세,2016,152,85,67,126.9,151,84,67,125.4
32410, 양양군,010005, 9세,2016,179,92,87,105.7,178,92,86,107
32410, 양양군,015,10~14세,2016,885,453,432,104.9,884,453,431,105.1
32410, 양양군,015001, 10세,2016,163,84,79,106.3,162,84,78,107.7
32410, 양양군,015002, 11세,2016,177,88,89,98.9,177,88,89,98.9
32410, 양양군,015003, 12세,2016,176,104,72,144.4,176,104,72,144.4
32410, 양양군,015004, 13세,2016,177,84,93,90.3,177,84,93,90.3
32410, 양양군,015005, 14세,2016,192,93,99,93.9,192,93,99,93.9
32410, 양양군,020,15~19세,2016,1037,567,470,120.6,1037,567,470,120.6
32410, 양양군,020001, 15세,2016,232,118,114,103.5,232,118,114,103.5
32410, 양양군,020002, 16세,2016,243,125,118,105.9,243,125,118,105.9
32410, 양양군,020003, 17세,2016,240,126,114,110.5,240,126,114,110.5
32410, 양양군,020004, 18세,2016,194,122,72,169.4,194,122,72,169.4
32410, 양양군,020005, 19세,2016,128,76,52,146.2,128,76,52,146.2
32410, 양양군,025,20~24세,2016,1018,660,358,184.4,984,634,350,181.1
32410, 양양군,025001, 20세,2016,171,128,43,297.7,168,126,42,300
32410, 양양군,025002, 21세,2016,225,156,69,226.1,219,151,68,222.1
32410, 양양군,025003, 22세,2016,180,124,56,221.4,175,119,56,212.5
32410, 양양군,025004, 23세,2016,227,126,101,124.8,220,120,100,120
32410, 양양군,025005, 24세,2016,215,126,89,141.6,202,118,84,140.5
32410, 양양군,030,25~29세,2016,1139,660,479,137.8,1069,622,447,139.1
32410, 양양군,030001, 25세,2016,238,137,101,135.6,227,133,94,141.5
32410, 양양군,030002, 26세,2016,224,122,102,119.6,207,112,95,117.9
32410, 양양군,030003, 27세,2016,226,136,90,151.1,215,129,86,150
32410, 양양군,030004, 28세,2016,231,145,86,168.6,211,135,76,177.6
32410, 양양군,030005, 29세,2016,220,120,100,120,209,113,96,117.7
32410, 양양군,035,30~34세,2016,1140,640,500,128,1076,609,467,130.4
32410, 양양군,035001, 30세,2016,194,113,81,139.5,178,108,70,154.3
32410, 양양군,035002, 31세,2016,208,106,102,103.9,195,102,93,109.7
32410, 양양군,035003, 32세,2016,205,129,76,169.7,194,121,73,165.8
32410, 양양군,035004, 33세,2016,253,140,113,123.9,243,132,111,118.9
32410, 양양군,035005, 34세,2016,280,152,128,118.8,266,146,120,121.7
32410, 양양군,040,35~39세,2016,1366,737,629,117.2,1329,715,614,116.4
32410, 양양군,040001, 35세,2016,254,154,100,154,239,142,97,146.4
32410, 양양군,040002, 36세,2016,268,145,123,117.9,260,139,121,114.9
32410, 양양군,040003, 37세,2016,267,144,123,117.1,263,143,120,119.2
32410, 양양군,040004, 38세,2016,288,148,140,105.7,283,146,137,106.6
32410, 양양군,040005, 39세,2016,289,146,143,102.1,284,145,139,104.3
32410, 양양군,045,40~44세,2016,1584,901,683,131.9,1544,873,671,130.1
32410, 양양군,045001, 40세,2016,269,172,97,177.3,257,166,91,182.4
32410, 양양군,045002, 41세,2016,299,155,144,107.6,292,151,141,107.1
32410, 양양군,045003, 42세,2016,310,176,134,131.3,304,170,134,126.9
32410, 양양군,045004, 43세,2016,362,217,145,149.7,355,212,143,148.3
32410, 양양군,045005, 44세,2016,344,181,163,111,336,174,162,107.4
32410, 양양군,050,45~49세,2016,1911,1071,840,127.5,1888,1057,831,127.2
32410, 양양군,050001, 45세,2016,369,191,178,107.3,362,186,176,105.7
32410, 양양군,050002, 46세,2016,350,197,153,128.8,346,194,152,127.6
32410, 양양군,050003, 47세,2016,402,230,172,133.7,396,225,171,131.6
32410, 양양군,050004, 48세,2016,412,238,174,136.8,411,238,173,137.6
32410, 양양군,050005, 49세,2016,378,215,163,131.9,373,214,159,134.6
32410, 양양군,055,50~54세,2016,2137,1074,1063,101,2119,1069,1050,101.8
32410, 양양군,055001, 50세,2016,416,224,192,116.7,412,224,188,119.1
32410, 양양군,055002, 51세,2016,404,196,208,94.2,399,193,206,93.7
32410, 양양군,055003, 52세,2016,415,201,214,93.9,411,201,210,95.7
32410, 양양군,055004, 53세,2016,427,219,208,105.3,425,218,207,105.3
32410, 양양군,055005, 54세,2016,475,234,241,97.1,472,233,239,97.5
32410, 양양군,060,55~59세,2016,2769,1385,1384,100.1,2743,1376,1367,100.7
32410, 양양군,060001, 55세,2016,549,280,269,104.1,546,279,267,104.5
32410, 양양군,060002, 56세,2016,584,295,289,102.1,578,294,284,103.5
32410, 양양군,060003, 57세,2016,530,272,258,105.4,527,271,256,105.9
32410, 양양군,060004, 58세,2016,561,283,278,101.8,556,281,275,102.2
32410, 양양군,060005, 59세,2016,545,255,290,87.9,536,251,285,88.1
32410, 양양군,065,60~64세,2016,2397,1170,1227,95.4,2386,1165,1221,95.4
32410, 양양군,065001, 60세,2016,462,223,239,93.3,459,222,237,93.7
32410, 양양군,065002, 61세,2016,554,281,273,102.9,552,279,273,102.2
32410, 양양군,065003, 62세,2016,520,257,263,97.7,519,257,262,98.1
32410, 양양군,065004, 63세,2016,384,194,190,102.1,382,194,188,103.2
32410, 양양군,065005, 64세,2016,477,215,262,82.1,474,213,261,81.6
32410, 양양군,070,65~69세,2016,1768,858,910,94.3,1760,853,907,94
32410, 양양군,070001, 65세,2016,304,150,154,97.4,300,148,152,97.4
32410, 양양군,070002, 66세,2016,329,152,177,85.9,327,150,177,84.7
32410, 양양군,070003, 67세,2016,354,183,171,107,354,183,171,107
32410, 양양군,070004, 68세,2016,373,165,208,79.3,371,164,207,79.2
32410, 양양군,070005, 69세,2016,408,208,200,104,408,208,200,104
32410, 양양군,075,70~74세,2016,1921,873,1048,83.3,1915,870,1045,83.3
32410, 양양군,075001, 70세,2016,351,178,173,102.9,349,177,172,102.9
32410, 양양군,075002, 71세,2016,377,153,224,68.3,377,153,224,68.3
32410, 양양군,075003, 72세,2016,404,182,222,82,402,181,221,81.9
32410, 양양군,075004, 73세,2016,395,176,219,80.4,394,176,218,80.7
32410, 양양군,075005, 74세,2016,394,184,210,87.6,393,183,210,87.1
32410, 양양군,080,75~79세,2016,1566,678,888,76.4,1565,677,888,76.2
32410, 양양군,080001, 75세,2016,354,155,199,77.9,354,155,199,77.9
32410, 양양군,080002, 76세,2016,348,157,191,82.2,347,156,191,81.7
32410, 양양군,080003, 77세,2016,310,132,178,74.2,310,132,178,74.2
32410, 양양군,080004, 78세,2016,317,133,184,72.3,317,133,184,72.3
32410, 양양군,080005, 79세,2016,237,101,136,74.3,237,101,136,74.3
32410, 양양군,085,80~84세,2016,888,323,565,57.2,885,323,562,57.5
32410, 양양군,085001, 80세,2016,255,95,160,59.4,254,95,159,59.7
32410, 양양군,085002, 81세,2016,218,96,122,78.7,217,96,121,79.3
32410, 양양군,085003, 82세,2016,153,48,105,45.7,152,48,104,46.2
32410, 양양군,085004, 83세,2016,136,42,94,44.7,136,42,94,44.7
32410, 양양군,085005, 84세,2016,126,42,84,50,126,42,84,50
32410, 양양군,090,85~89세,2016,421,123,298,41.3,421,123,298,41.3
32410, 양양군,090001, 85세,2016,103,40,63,63.5,103,40,63,63.5
32410, 양양군,090002, 86세,2016,82,21,61,34.4,82,21,61,34.4
32410, 양양군,090003, 87세,2016,82,23,59,39,82,23,59,39
32410, 양양군,090004, 88세,2016,80,22,58,37.9,80,22,58,37.9
32410, 양양군,090005, 89세,2016,74,17,57,29.8,74,17,57,29.8
32410, 양양군,095,90~94세,2016,201,36,165,21.8,201,36,165,21.8
32410, 양양군,095001, 90세,2016,63,12,51,23.5,63,12,51,23.5
32410, 양양군,095002, 91세,2016,45,6,39,15.4,45,6,39,15.4
32410, 양양군,095003, 92세,2016,42,8,34,23.5,42,8,34,23.5
32410, 양양군,095004, 93세,2016,31,8,23,34.8,31,8,23,34.8
32410, 양양군,095005, 94세,2016,20,X,18,11.1,20,X,18,11.1
32410, 양양군,100,95~99세,2016,38,6,32,18.8,38,6,32,18.8
32410, 양양군,100001, 95세,2016,13,X,11,18.2,13,X,11,18.2
32410, 양양군,100002, 96세,2016,7,X,X,75,7,X,X,75
32410, 양양군,100003, 97세,2016,8,X,8,0,8,X,8,0
32410, 양양군,100004, 98세,2016,9,X,8,12.5,9,X,8,12.5
32410, 양양군,100005, 99세,2016,X,X,X,0,X,X,X,0
32410, 양양군,101,100세이상,2016,8,X,6,33.3,8,X,6,33.3
32410, 양양군,102,15세미만,2016,2361,1222,1139,107.3,2354,1220,1134,107.6
32410, 양양군,103,15~64세,2016,16498,8865,7633,116.1,16175,8687,7488,116
32410, 양양군,104,65세이상,2016,6811,2899,3912,74.1,6793,2890,3903,74
32410, 양양군,086,85세이상,2016,668,167,501,33.3,668,167,501,33.3
32410, 양양군,126,평균연령,2016,49.5,47.3,51.8,,49.7,47.5,52,
32410, 양양군,127,중위연령,2016,53.1,50.2,55.7,,53.4,50.5,55.9,
33,충청북도,000,합계,2016,1603404,814049,789355,103.1,1558503,785824,772679,101.7
33,충청북도,005,0~4세,2016,68300,34795,33505,103.9,67807,34541,33266,103.8
33,충청북도,005001, 0세,2016,13000,6691,6309,106.1,12893,6632,6261,105.9
33,충청북도,005002, 1세,2016,13365,6815,6550,104,13258,6755,6503,103.9
33,충청북도,005003, 2세,2016,13439,6751,6688,100.9,13337,6698,6639,100.9
33,충청북도,005004, 3세,2016,13623,6919,6704,103.2,13527,6875,6652,103.4
33,충청북도,005005, 4세,2016,14873,7619,7254,105,14792,7581,7211,105.1
33,충청북도,010,5~9세,2016,72243,37336,34907,107,71868,37142,34726,107
33,충청북도,010001, 5세,2016,14883,7622,7261,105,14793,7580,7213,105.1
33,충청북도,010002, 6세,2016,14349,7409,6940,106.8,14261,7362,6899,106.7
33,충청북도,010003, 7세,2016,13693,7154,6539,109.4,13631,7125,6506,109.5
33,충청북도,010004, 8세,2016,14449,7496,6953,107.8,14371,7454,6917,107.8
33,충청북도,010005, 9세,2016,14869,7655,7214,106.1,14812,7621,7191,106
33,충청북도,015,10~14세,2016,72190,37639,34551,108.9,71958,37525,34433,109
33,충청북도,015001, 10세,2016,13520,6987,6533,106.9,13474,6960,6514,106.8
33,충청북도,015002, 11세,2016,13427,6970,6457,107.9,13380,6944,6436,107.9
33,충청북도,015003, 12세,2016,14683,7711,6972,110.6,14631,7686,6945,110.7
33,충청북도,015004, 13세,2016,14868,7776,7092,109.6,14834,7758,7076,109.6
33,충청북도,015005, 14세,2016,15692,8195,7497,109.3,15639,8177,7462,109.6
33,충청북도,020,15~19세,2016,103069,54018,49051,110.1,102312,53649,48663,110.2
33,충청북도,020001, 15세,2016,18004,9418,8586,109.7,17950,9389,8561,109.7
33,충청북도,020002, 16세,2016,19606,10212,9394,108.7,19554,10180,9374,108.6
33,충청북도,020003, 17세,2016,19354,10252,9102,112.6,19277,10215,9062,112.7
33,충청북도,020004, 18세,2016,21422,11161,10261,108.8,21234,11065,10169,108.8
33,충청북도,020005, 19세,2016,24683,12975,11708,110.8,24297,12800,11497,111.3
33,충청북도,025,20~24세,2016,119018,65689,53329,123.2,113189,62101,51088,121.6
33,충청북도,025001, 20세,2016,24335,12644,11691,108.2,23546,12217,11329,107.8
33,충청북도,025002, 21세,2016,23914,12529,11385,110,22855,11905,10950,108.7
33,충청북도,025003, 22세,2016,24270,13496,10774,125.3,23062,12739,10323,123.4
33,충청북도,025004, 23세,2016,23719,13699,10020,136.7,22403,12874,9529,135.1
33,충청북도,025005, 24세,2016,22780,13321,9459,140.8,21323,12366,8957,138.1
33,충청북도,030,25~29세,2016,96743,54042,42701,126.6,88270,48432,39838,121.6
33,충청북도,030001, 25세,2016,20707,11861,8846,134.1,19150,10853,8297,130.8
33,충청북도,030002, 26세,2016,19740,11181,8559,130.6,17958,10004,7954,125.8
33,충청북도,030003, 27세,2016,18672,10513,8159,128.9,17008,9403,7605,123.6
33,충청북도,030004, 28세,2016,18708,10240,8468,120.9,16975,9071,7904,114.8
33,충청북도,030005, 29세,2016,18916,10247,8669,118.2,17179,9101,8078,112.7
33,충청북도,035,30~34세,2016,105171,56451,48720,115.9,98108,51638,46470,111.1
33,충청북도,035001, 30세,2016,19301,10641,8660,122.9,17731,9585,8146,117.7
33,충청북도,035002, 31세,2016,19216,10433,8783,118.8,17712,9401,8311,113.1
33,충청북도,035003, 32세,2016,20413,11074,9339,118.6,19092,10187,8905,114.4
33,충청북도,035004, 33세,2016,21941,11594,10347,112.1,20567,10638,9929,107.1
33,충청북도,035005, 34세,2016,24300,12709,11591,109.6,23006,11827,11179,105.8
33,충청북도,040,35~39세,2016,113582,59855,53727,111.4,108415,56198,52217,107.6
33,충청북도,040001, 35세,2016,23188,12389,10799,114.7,22000,11545,10455,110.4
33,충청북도,040002, 36세,2016,23906,12463,11443,108.9,22880,11752,11128,105.6
33,충청북도,040003, 37세,2016,23028,12144,10884,111.6,21908,11350,10558,107.5
33,충청북도,040004, 38세,2016,21311,11249,10062,111.8,20346,10569,9777,108.1
33,충청북도,040005, 39세,2016,22149,11610,10539,110.2,21281,10982,10299,106.6
33,충청북도,045,40~44세,2016,121128,62923,58205,108.1,117220,60433,56787,106.4
33,충청북도,045001, 40세,2016,22166,11677,10489,111.3,21319,11092,10227,108.5
33,충청북도,045002, 41세,2016,23321,11951,11370,105.1,22552,11458,11094,103.3
33,충청북도,045003, 42세,2016,25516,13268,12248,108.3,24807,12835,11972,107.2
33,충청북도,045004, 43세,2016,25782,13286,12496,106.3,24996,12792,12204,104.8
33,충청북도,045005, 44세,2016,24343,12741,11602,109.8,23546,12256,11290,108.6
33,충청북도,050,45~49세,2016,135838,69737,66101,105.5,132036,67495,64541,104.6
33,충청북도,050001, 45세,2016,26946,14007,12939,108.3,26148,13531,12617,107.2
33,충청북도,050002, 46세,2016,26133,13620,12513,108.8,25360,13151,12209,107.7
33,충청북도,050003, 47세,2016,28673,14631,14042,104.2,27909,14176,13733,103.2
33,충청북도,050004, 48세,2016,28174,14208,13966,101.7,27342,13715,13627,100.6
33,충청북도,050005, 49세,2016,25912,13271,12641,105,25277,12922,12355,104.6
33,충청북도,055,50~54세,2016,127449,66108,61341,107.8,123802,64035,59767,107.1
33,충청북도,055001, 50세,2016,25771,13409,12362,108.5,25044,13006,12038,108
33,충청북도,055002, 51세,2016,26363,13505,12858,105,25640,13067,12573,103.9
33,충청북도,055003, 52세,2016,23230,12039,11191,107.6,22482,11624,10858,107.1
33,충청북도,055004, 53세,2016,24606,12883,11723,109.9,23794,12423,11371,109.3
33,충청북도,055005, 54세,2016,27479,14272,13207,108.1,26842,13915,12927,107.6
33,충청북도,060,55~59세,2016,133712,67906,65806,103.2,131247,66532,64715,102.8
33,충청북도,060001, 55세,2016,30685,15694,14991,104.7,30276,15485,14791,104.7
33,충청북도,060002, 56세,2016,27425,13713,13712,100,26816,13377,13439,99.5
33,충청북도,060003, 57세,2016,25612,12894,12718,101.4,25135,12619,12516,100.8
33,충청북도,060004, 58세,2016,25285,13061,12224,106.8,24792,12770,12022,106.2
33,충청북도,060005, 59세,2016,24705,12544,12161,103.1,24228,12281,11947,102.8
33,충청북도,065,60~64세,2016,99665,49872,49793,100.2,98139,48973,49166,99.6
33,충청북도,065001, 60세,2016,22665,11546,11119,103.8,22280,11314,10966,103.2
33,충청북도,065002, 61세,2016,21771,10784,10987,98.2,21422,10583,10839,97.6
33,충청북도,065003, 62세,2016,19479,9746,9733,100.1,19144,9537,9607,99.3
33,충청북도,065004, 63세,2016,16687,8356,8331,100.3,16431,8202,8229,99.7
33,충청북도,065005, 64세,2016,19063,9440,9623,98.1,18862,9337,9525,98
33,충청북도,070,65~69세,2016,66606,32400,34206,94.7,65921,32045,33876,94.6
33,충청북도,070001, 65세,2016,12561,6075,6486,93.7,12384,5977,6407,93.3
33,충청북도,070002, 66세,2016,13184,6445,6739,95.6,13044,6382,6662,95.8
33,충청북도,070003, 67세,2016,13803,6825,6978,97.8,13626,6729,6897,97.6
33,충청북도,070004, 68세,2016,13648,6706,6942,96.6,13554,6658,6896,96.5
33,충청북도,070005, 69세,2016,13410,6349,7061,89.9,13313,6299,7014,89.8
33,충청북도,075,70~74세,2016,59285,26414,32871,80.4,59066,26318,32748,80.4
33,충청북도,075001, 70세,2016,10265,4874,5391,90.4,10210,4850,5360,90.5
33,충청북도,075002, 71세,2016,11196,5169,6027,85.8,11141,5145,5996,85.8
33,충청북도,075003, 72세,2016,11403,4928,6475,76.1,11356,4908,6448,76.1
33,충청북도,075004, 73세,2016,12000,5208,6792,76.7,11964,5187,6777,76.5
33,충청북도,075005, 74세,2016,14421,6235,8186,76.2,14395,6228,8167,76.3
33,충청북도,080,75~79세,2016,53112,21566,31546,68.4,52971,21515,31456,68.4
33,충청북도,080001, 75세,2016,11772,4958,6814,72.8,11747,4950,6797,72.8
33,충청북도,080002, 76세,2016,10710,4471,6239,71.7,10684,4463,6221,71.7
33,충청북도,080003, 77세,2016,11242,4567,6675,68.4,11209,4555,6654,68.5
33,충청북도,080004, 78세,2016,9978,3927,6051,64.9,9948,3914,6034,64.9
33,충청북도,080005, 79세,2016,9410,3643,5767,63.2,9383,3633,5750,63.2
33,충청북도,085,80~84세,2016,35197,11992,23205,51.7,35130,11962,23168,51.6
33,충청북도,085001, 80세,2016,8869,3279,5590,58.7,8848,3272,5576,58.7
33,충청북도,085002, 81세,2016,8464,2986,5478,54.5,8451,2979,5472,54.4
33,충청북도,085003, 82세,2016,6901,2332,4569,51,6888,2326,4562,51
33,충청북도,085004, 83세,2016,5949,1888,4061,46.5,5938,1884,4054,46.5
33,충청북도,085005, 84세,2016,5014,1507,3507,43,5005,1501,3504,42.8
33,충청북도,090,85~89세,2016,15024,3962,11062,35.8,14993,3952,11041,35.8
33,충청북도,090001, 85세,2016,3684,1009,2675,37.7,3674,1005,2669,37.7
33,충청북도,090002, 86세,2016,3713,971,2742,35.4,3708,968,2740,35.3
33,충청북도,090003, 87세,2016,3145,829,2316,35.8,3138,827,2311,35.8
33,충청북도,090004, 88세,2016,2468,649,1819,35.7,2463,649,1814,35.8
33,충청북도,090005, 89세,2016,2014,504,1510,33.4,2010,503,1507,33.4
33,충청북도,095,90~94세,2016,4894,1160,3734,31.1,4876,1155,3721,31
33,충청북도,095001, 90세,2016,1347,331,1016,32.6,1341,330,1011,32.6
33,충청북도,095002, 91세,2016,1270,293,977,30,1268,293,975,30.1
33,충청북도,095003, 92세,2016,825,212,613,34.6,821,209,612,34.2
33,충청북도,095004, 93세,2016,834,182,652,27.9,831,181,650,27.8
33,충청북도,095005, 94세,2016,618,142,476,29.8,615,142,473,30
33,충청북도,100,95~99세,2016,1042,169,873,19.4,1040,168,872,19.3
33,충청북도,100001, 95세,2016,415,75,340,22.1,415,75,340,22.1
33,충청북도,100002, 96세,2016,259,42,217,19.4,259,42,217,19.4
33,충청북도,100003, 97세,2016,186,32,154,20.8,185,32,153,20.9
33,충청북도,100004, 98세,2016,116,12,104,11.5,116,12,104,11.5
33,충청북도,100005, 99세,2016,66,8,58,13.8,65,7,58,12.1
33,충청북도,101,100세이상,2016,136,15,121,12.4,135,15,120,12.5
33,충청북도,102,15세미만,2016,212733,109770,102963,106.6,211633,109208,102425,106.6
33,충청북도,103,15~64세,2016,1155375,606601,548774,110.5,1112738,579486,533252,108.7
33,충청북도,104,65세이상,2016,235296,97678,137618,71,234132,97130,137002,70.9
33,충청북도,086,85세이상,2016,21096,5306,15790,33.6,21044,5290,15754,33.6
33,충청북도,126,평균연령,2016,41.4,40,42.8,,41.5,40.1,42.9,
33,충청북도,127,중위연령,2016,42.2,40.6,43.8,,42.5,41.1,44,
33004, 읍부,000,합계,2016,317692,163516,154176,106.1,307644,157202,150442,104.5
33004, 읍부,005,0~4세,2016,17129,8726,8403,103.8,16999,8653,8346,103.7
33004, 읍부,005001, 0세,2016,3364,1724,1640,105.1,3332,1704,1628,104.7
33004, 읍부,005002, 1세,2016,3383,1729,1654,104.5,3349,1705,1644,103.7
33004, 읍부,005003, 2세,2016,3413,1731,1682,102.9,3387,1717,1670,102.8
33004, 읍부,005004, 3세,2016,3366,1718,1648,104.2,3344,1709,1635,104.5
33004, 읍부,005005, 4세,2016,3603,1824,1779,102.5,3587,1818,1769,102.8
33004, 읍부,010,5~9세,2016,16729,8676,8053,107.7,16648,8634,8014,107.7
33004, 읍부,010001, 5세,2016,3558,1827,1731,105.5,3533,1814,1719,105.5
33004, 읍부,010002, 6세,2016,3366,1772,1594,111.2,3347,1760,1587,110.9
33004, 읍부,010003, 7세,2016,3157,1659,1498,110.7,3140,1652,1488,111
33004, 읍부,010004, 8세,2016,3317,1714,1603,106.9,3303,1707,1596,107
33004, 읍부,010005, 9세,2016,3331,1704,1627,104.7,3325,1701,1624,104.7
33004, 읍부,015,10~14세,2016,15003,7804,7199,108.4,14949,7772,7177,108.3
33004, 읍부,015001, 10세,2016,2953,1565,1388,112.8,2937,1555,1382,112.5
33004, 읍부,015002, 11세,2016,2890,1536,1354,113.4,2880,1530,1350,113.3
33004, 읍부,015003, 12세,2016,3077,1601,1476,108.5,3068,1595,1473,108.3
33004, 읍부,015004, 13세,2016,2980,1523,1457,104.5,2974,1518,1456,104.3
33004, 읍부,015005, 14세,2016,3103,1579,1524,103.6,3090,1574,1516,103.8
33004, 읍부,020,15~19세,2016,20308,10600,9708,109.2,20223,10559,9664,109.3
33004, 읍부,020001, 15세,2016,3535,1851,1684,109.9,3520,1843,1677,109.9
33004, 읍부,020002, 16세,2016,4128,2034,2094,97.1,4120,2027,2093,96.8
33004, 읍부,020003, 17세,2016,3918,2021,1897,106.5,3907,2014,1893,106.4
33004, 읍부,020004, 18세,2016,4067,2134,1933,110.4,4053,2130,1923,110.8
33004, 읍부,020005, 19세,2016,4660,2560,2100,121.9,4623,2545,2078,122.5
33004, 읍부,025,20~24세,2016,20307,11556,8751,132.1,19354,10960,8394,130.6
33004, 읍부,025001, 20세,2016,4307,2305,2002,115.1,4222,2255,1967,114.6
33004, 읍부,025002, 21세,2016,4060,2172,1888,115,3921,2091,1830,114.3
33004, 읍부,025003, 22세,2016,4112,2342,1770,132.3,3913,2220,1693,131.1
33004, 읍부,025004, 23세,2016,3918,2363,1555,152,3688,2217,1471,150.7
33004, 읍부,025005, 24세,2016,3910,2374,1536,154.6,3610,2177,1433,151.9
33004, 읍부,030,25~29세,2016,18512,10485,8027,130.6,16713,9291,7422,125.2
33004, 읍부,030001, 25세,2016,3551,2101,1450,144.9,3200,1868,1332,140.2
33004, 읍부,030002, 26세,2016,3586,2100,1486,141.3,3227,1863,1364,136.6
33004, 읍부,030003, 27세,2016,3613,2077,1536,135.2,3255,1841,1414,130.2
33004, 읍부,030004, 28세,2016,3786,2056,1730,118.8,3446,1823,1623,112.3
33004, 읍부,030005, 29세,2016,3976,2151,1825,117.9,3585,1896,1689,112.3
33004, 읍부,035,30~34세,2016,23864,12875,10989,117.2,22304,11826,10478,112.9
33004, 읍부,035001, 30세,2016,4180,2327,1853,125.6,3849,2097,1752,119.7
33004, 읍부,035002, 31세,2016,4379,2371,2008,118.1,4033,2151,1882,114.3
33004, 읍부,035003, 32세,2016,4663,2545,2118,120.2,4358,2349,2009,116.9
33004, 읍부,035004, 33세,2016,5036,2695,2341,115.1,4742,2492,2250,110.8
33004, 읍부,035005, 34세,2016,5606,2937,2669,110,5322,2737,2585,105.9
33004, 읍부,040,35~39세,2016,25816,13814,12002,115.1,24601,12966,11635,111.4
33004, 읍부,040001, 35세,2016,5356,2904,2452,118.4,5065,2691,2374,113.4
33004, 읍부,040002, 36세,2016,5533,2916,2617,111.4,5304,2761,2543,108.6
33004, 읍부,040003, 37세,2016,5248,2807,2441,115,4984,2625,2359,111.3
33004, 읍부,040004, 38세,2016,4875,2599,2276,114.2,4645,2438,2207,110.5
33004, 읍부,040005, 39세,2016,4804,2588,2216,116.8,4603,2451,2152,113.9
33004, 읍부,045,40~44세,2016,25093,13487,11606,116.2,24166,12910,11256,114.7
33004, 읍부,045001, 40세,2016,4801,2597,2204,117.8,4608,2473,2135,115.8
33004, 읍부,045002, 41세,2016,4992,2650,2342,113.2,4801,2530,2271,111.4
33004, 읍부,045003, 42세,2016,5192,2785,2407,115.7,5026,2682,2344,114.4
33004, 읍부,045004, 43세,2016,5300,2858,2442,117,5111,2744,2367,115.9
33004, 읍부,045005, 44세,2016,4808,2597,2211,117.5,4620,2481,2139,116
33004, 읍부,050,45~49세,2016,25332,13685,11647,117.5,24451,13171,11280,116.8
33004, 읍부,050001, 45세,2016,5248,2800,2448,114.4,5057,2685,2372,113.2
33004, 읍부,050002, 46세,2016,4915,2744,2171,126.4,4747,2651,2096,126.5
33004, 읍부,050003, 47세,2016,5382,2914,2468,118.1,5204,2797,2407,116.2
33004, 읍부,050004, 48세,2016,5141,2750,2391,115,4945,2633,2312,113.9
33004, 읍부,050005, 49세,2016,4646,2477,2169,114.2,4498,2405,2093,114.9
33004, 읍부,055,50~54세,2016,22943,12294,10649,115.4,21950,11712,10238,114.4
33004, 읍부,055001, 50세,2016,4636,2489,2147,115.9,4453,2387,2066,115.5
33004, 읍부,055002, 51세,2016,4729,2509,2220,113,4525,2385,2140,111.4
33004, 읍부,055003, 52세,2016,4190,2254,1936,116.4,3982,2129,1853,114.9
33004, 읍부,055004, 53세,2016,4390,2344,2046,114.6,4176,2216,1960,113.1
33004, 읍부,055005, 54세,2016,4998,2698,2300,117.3,4814,2595,2219,116.9
33004, 읍부,060,55~59세,2016,23829,12092,11737,103,23193,11741,11452,102.5
33004, 읍부,060001, 55세,2016,5452,2788,2664,104.7,5359,2742,2617,104.8
33004, 읍부,060002, 56세,2016,4871,2437,2434,100.1,4709,2349,2360,99.5
33004, 읍부,060003, 57세,2016,4603,2347,2256,104,4478,2283,2195,104
33004, 읍부,060004, 58세,2016,4424,2264,2160,104.8,4299,2188,2111,103.6
33004, 읍부,060005, 59세,2016,4479,2256,2223,101.5,4348,2179,2169,100.5
33004, 읍부,065,60~64세,2016,18221,9030,9191,98.2,17791,8773,9018,97.3
33004, 읍부,065001, 60세,2016,4076,2052,2024,101.4,3975,1997,1978,101
33004, 읍부,065002, 61세,2016,4047,2011,2036,98.8,3939,1945,1994,97.5
33004, 읍부,065003, 62세,2016,3586,1734,1852,93.6,3495,1673,1822,91.8
33004, 읍부,065004, 63세,2016,3067,1531,1536,99.7,2998,1488,1510,98.5
33004, 읍부,065005, 64세,2016,3445,1702,1743,97.6,3384,1670,1714,97.4
33004, 읍부,070,65~69세,2016,12710,6087,6623,91.9,12514,5977,6537,91.4
33004, 읍부,070001, 65세,2016,2355,1116,1239,90.1,2301,1080,1221,88.5
33004, 읍부,070002, 66세,2016,2570,1239,1331,93.1,2535,1221,1314,92.9
33004, 읍부,070003, 67세,2016,2671,1325,1346,98.4,2618,1292,1326,97.4
33004, 읍부,070004, 68세,2016,2578,1218,1360,89.6,2552,1207,1345,89.7
33004, 읍부,070005, 69세,2016,2536,1189,1347,88.3,2508,1177,1331,88.4
33004, 읍부,075,70~74세,2016,11210,4928,6282,78.4,11162,4906,6256,78.4
33004, 읍부,075001, 70세,2016,1992,932,1060,87.9,1980,926,1054,87.9
33004, 읍부,075002, 71세,2016,2064,974,1090,89.4,2049,968,1081,89.5
33004, 읍부,075003, 72세,2016,2092,863,1229,70.2,2079,858,1221,70.3
33004, 읍부,075004, 73세,2016,2335,999,1336,74.8,2329,995,1334,74.6
33004, 읍부,075005, 74세,2016,2727,1160,1567,74,2725,1159,1566,74
33004, 읍부,080,75~79세,2016,10039,4161,5878,70.8,10000,4143,5857,70.7
33004, 읍부,080001, 75세,2016,2247,966,1281,75.4,2238,961,1277,75.3
33004, 읍부,080002, 76세,2016,2044,894,1150,77.7,2036,890,1146,77.7
33004, 읍부,080003, 77세,2016,2079,847,1232,68.8,2075,846,1229,68.8
33004, 읍부,080004, 78세,2016,1907,751,1156,65,1901,748,1153,64.9
33004, 읍부,080005, 79세,2016,1762,703,1059,66.4,1750,698,1052,66.3
33004, 읍부,085,80~84세,2016,6635,2197,4438,49.5,6626,2195,4431,49.5
33004, 읍부,085001, 80세,2016,1656,584,1072,54.5,1654,584,1070,54.6
33004, 읍부,085002, 81세,2016,1579,539,1040,51.8,1579,539,1040,51.8
33004, 읍부,085003, 82세,2016,1311,448,863,51.9,1307,447,860,52
33004, 읍부,085004, 83세,2016,1103,343,760,45.1,1100,342,758,45.1
33004, 읍부,085005, 84세,2016,986,283,703,40.3,986,283,703,40.3
33004, 읍부,090,85~89세,2016,2862,767,2095,36.6,2853,762,2091,36.4
33004, 읍부,090001, 85세,2016,751,213,538,39.6,748,211,537,39.3
33004, 읍부,090002, 86세,2016,694,175,519,33.7,693,175,518,33.8
33004, 읍부,090003, 87세,2016,596,159,437,36.4,594,157,437,35.9
33004, 읍부,090004, 88세,2016,461,124,337,36.8,461,124,337,36.8
33004, 읍부,090005, 89세,2016,360,96,264,36.4,357,95,262,36.3
33004, 읍부,095,90~94세,2016,938,215,723,29.7,935,214,721,29.7
33004, 읍부,095001, 90세,2016,251,63,188,33.5,250,63,187,33.7
33004, 읍부,095002, 91세,2016,230,56,174,32.2,229,56,173,32.4
33004, 읍부,095003, 92세,2016,169,42,127,33.1,169,42,127,33.1
33004, 읍부,095004, 93세,2016,178,30,148,20.3,177,29,148,19.6
33004, 읍부,095005, 94세,2016,110,24,86,27.9,110,24,86,27.9
33004, 읍부,100,95~99세,2016,192,36,156,23.1,192,36,156,23.1
33004, 읍부,100001, 95세,2016,76,14,62,22.6,76,14,62,22.6
33004, 읍부,100002, 96세,2016,41,11,30,36.7,41,11,30,36.7
33004, 읍부,100003, 97세,2016,40,8,32,25,40,8,32,25
33004, 읍부,100004, 98세,2016,29,X,26,11.5,29,X,26,11.5
33004, 읍부,100005, 99세,2016,6,X,6,0,6,X,6,0
33004, 읍부,101,100세이상,2016,20,X,19,5.3,20,X,19,5.3
33004, 읍부,102,15세미만,2016,48861,25206,23655,106.6,48596,25059,23537,106.5
33004, 읍부,103,15~64세,2016,224225,119918,104307,115,214746,113909,100837,113
33004, 읍부,104,65세이상,2016,44606,18392,26214,70.2,44302,18234,26068,69.9
33004, 읍부,086,85세이상,2016,4012,1019,2993,34,4000,1013,2987,33.9
33004, 읍부,126,평균연령,2016,40.1,38.8,41.6,,40.2,38.8,41.6,
33004, 읍부,127,중위연령,2016,40.2,38.9,41.7,,40.4,39.2,41.9,
33005, 면부,000,합계,2016,333343,174682,158661,110.1,313541,160568,152973,105
33005, 면부,005,0~4세,2016,8436,4308,4128,104.4,8326,4257,4069,104.6
33005, 면부,005001, 0세,2016,1637,860,777,110.7,1607,847,760,111.4
33005, 면부,005002, 1세,2016,1646,848,798,106.3,1621,834,787,106
33005, 면부,005003, 2세,2016,1649,815,834,97.7,1628,804,824,97.6
33005, 면부,005004, 3세,2016,1648,815,833,97.8,1630,806,824,97.8
33005, 면부,005005, 4세,2016,1856,970,886,109.5,1840,966,874,110.5
33005, 면부,010,5~9세,2016,9158,4855,4303,112.8,9072,4812,4260,113
33005, 면부,010001, 5세,2016,1882,1001,881,113.6,1866,993,873,113.7
33005, 면부,010002, 6세,2016,1760,932,828,112.6,1739,923,816,113.1
33005, 면부,010003, 7세,2016,1750,931,819,113.7,1736,926,810,114.3
33005, 면부,010004, 8세,2016,1886,998,888,112.4,1861,982,879,111.7
33005, 면부,010005, 9세,2016,1880,993,887,112,1870,988,882,112
33005, 면부,015,10~14세,2016,9208,4855,4353,111.5,9176,4843,4333,111.8
33005, 면부,015001, 10세,2016,1729,863,866,99.7,1724,859,865,99.3
33005, 면부,015002, 11세,2016,1702,910,792,114.9,1694,905,789,114.7
33005, 면부,015003, 12세,2016,1799,986,813,121.3,1792,985,807,122.1
33005, 면부,015004, 13세,2016,1885,1031,854,120.7,1880,1030,850,121.2
33005, 면부,015005, 14세,2016,2093,1065,1028,103.6,2086,1064,1022,104.1
33005, 면부,020,15~19세,2016,14649,7993,6656,120.1,14546,7935,6611,120
33005, 면부,020001, 15세,2016,2430,1271,1159,109.7,2423,1266,1157,109.4
33005, 면부,020002, 16세,2016,2659,1477,1182,125,2648,1470,1178,124.8
33005, 면부,020003, 17세,2016,2485,1381,1104,125.1,2475,1374,1101,124.8
33005, 면부,020004, 18세,2016,3033,1670,1363,122.5,3008,1655,1353,122.3
33005, 면부,020005, 19세,2016,4042,2194,1848,118.7,3992,2170,1822,119.1
33005, 면부,025,20~24세,2016,20340,12056,8284,145.5,18012,10367,7645,135.6
33005, 면부,025001, 20세,2016,3991,2106,1885,111.7,3771,1971,1800,109.5
33005, 면부,025002, 21세,2016,3983,2194,1789,122.6,3621,1945,1676,116.1
33005, 면부,025003, 22세,2016,4128,2441,1687,144.7,3652,2080,1572,132.3
33005, 면부,025004, 23세,2016,4184,2719,1465,185.6,3599,2286,1313,174.1
33005, 면부,025005, 24세,2016,4054,2596,1458,178.1,3369,2085,1284,162.4
33005, 면부,030,25~29세,2016,17682,11066,6616,167.3,13421,7904,5517,143.3
33005, 면부,030001, 25세,2016,3786,2398,1388,172.8,3036,1837,1199,153.2
33005, 면부,030002, 26세,2016,3621,2251,1370,164.3,2731,1595,1136,140.4
33005, 면부,030003, 27세,2016,3450,2189,1261,173.6,2598,1548,1050,147.4
33005, 면부,030004, 28세,2016,3432,2152,1280,168.1,2529,1487,1042,142.7
33005, 면부,030005, 29세,2016,3393,2076,1317,157.6,2527,1437,1090,131.8
33005, 면부,035,30~34세,2016,17046,10583,6463,163.7,13425,7804,5621,138.8
33005, 면부,035001, 30세,2016,3260,2034,1226,165.9,2455,1430,1025,139.5
33005, 면부,035002, 31세,2016,3283,2110,1173,179.9,2498,1504,994,151.3
33005, 면부,035003, 32세,2016,3215,2026,1189,170.4,2555,1513,1042,145.2
33005, 면부,035004, 33세,2016,3581,2177,1404,155.1,2874,1628,1246,130.7
33005, 면부,035005, 34세,2016,3707,2236,1471,152,3043,1729,1314,131.6
33005, 면부,040,35~39세,2016,17307,10442,6865,152.1,14721,8421,6300,133.7
33005, 면부,040001, 35세,2016,3631,2206,1425,154.8,3041,1742,1299,134.1
33005, 면부,040002, 36세,2016,3570,2113,1457,145,3033,1708,1325,128.9
33005, 면부,040003, 37세,2016,3503,2105,1398,150.6,2936,1660,1276,130.1
33005, 면부,040004, 38세,2016,3187,1949,1238,157.4,2726,1579,1147,137.7
33005, 면부,040005, 39세,2016,3416,2069,1347,153.6,2985,1732,1253,138.2
33005, 면부,045,40~44세,2016,18306,10970,7336,149.5,16490,9682,6808,142.2
33005, 면부,045001, 40세,2016,3405,2087,1318,158.3,2992,1768,1224,144.4
33005, 면부,045002, 41세,2016,3483,2091,1392,150.2,3133,1834,1299,141.2
33005, 면부,045003, 42세,2016,3846,2290,1556,147.2,3512,2073,1439,144.1
33005, 면부,045004, 43세,2016,3883,2321,1562,148.6,3528,2070,1458,142
33005, 면부,045005, 44세,2016,3689,2181,1508,144.6,3325,1937,1388,139.6
33005, 면부,050,45~49세,2016,23315,13087,10228,128,21674,12053,9621,125.3
33005, 면부,050001, 45세,2016,4283,2517,1766,142.5,3940,2298,1642,140
33005, 면부,050002, 46세,2016,4277,2480,1797,138,3939,2263,1676,135
33005, 면부,050003, 47세,2016,4838,2694,2144,125.7,4501,2488,2013,123.6
33005, 면부,050004, 48세,2016,5025,2763,2262,122.1,4671,2532,2139,118.4
33005, 면부,050005, 49세,2016,4892,2633,2259,116.6,4623,2472,2151,114.9
33005, 면부,055,50~54세,2016,27636,15011,12625,118.9,26221,14113,12108,116.6
33005, 면부,055001, 50세,2016,5211,2911,2300,126.6,4915,2724,2191,124.3
33005, 면부,055002, 51세,2016,5536,2984,2552,116.9,5244,2792,2452,113.9
33005, 면부,055003, 52세,2016,5066,2718,2348,115.8,4775,2536,2239,113.3
33005, 면부,055004, 53세,2016,5458,3008,2450,122.8,5137,2810,2327,120.8
33005, 면부,055005, 54세,2016,6365,3390,2975,113.9,6150,3251,2899,112.1
33005, 면부,060,55~59세,2016,34482,18215,16267,112,33565,17643,15922,110.8
33005, 면부,060001, 55세,2016,7425,3970,3455,114.9,7248,3871,3377,114.6
33005, 면부,060002, 56세,2016,6868,3545,3323,106.7,6638,3405,3233,105.3
33005, 면부,060003, 57세,2016,6626,3511,3115,112.7,6455,3393,3062,110.8
33005, 면부,060004, 58세,2016,6792,3611,3181,113.5,6630,3506,3124,112.2
33005, 면부,060005, 59세,2016,6771,3578,3193,112.1,6594,3468,3126,110.9
33005, 면부,065,60~64세,2016,29425,15175,14250,106.5,28888,14839,14049,105.6
33005, 면부,065001, 60세,2016,6504,3409,3095,110.1,6355,3302,3053,108.2
33005, 면부,065002, 61세,2016,6243,3154,3089,102.1,6121,3086,3035,101.7
33005, 면부,065003, 62세,2016,5936,3052,2884,105.8,5816,2970,2846,104.4
33005, 면부,065004, 63세,2016,4915,2588,2327,111.2,4833,2537,2296,110.5
33005, 면부,065005, 64세,2016,5827,2972,2855,104.1,5763,2944,2819,104.4
33005, 면부,070,65~69세,2016,21153,10729,10424,102.9,20945,10612,10333,102.7
33005, 면부,070001, 65세,2016,3950,1974,1976,99.9,3902,1947,1955,99.6
33005, 면부,070002, 66세,2016,4131,2107,2024,104.1,4084,2082,2002,104
33005, 면부,070003, 67세,2016,4514,2284,2230,102.4,4466,2256,2210,102.1
33005, 면부,070004, 68세,2016,4307,2209,2098,105.3,4275,2193,2082,105.3
33005, 면부,070005, 69세,2016,4251,2155,2096,102.8,4218,2134,2084,102.4
33005, 면부,075,70~74세,2016,20695,9310,11385,81.8,20631,9280,11351,81.8
33005, 면부,075001, 70세,2016,3433,1701,1732,98.2,3415,1692,1723,98.2
33005, 면부,075002, 71세,2016,3779,1760,2019,87.2,3767,1755,2012,87.2
33005, 면부,075003, 72세,2016,3900,1662,2238,74.3,3885,1656,2229,74.3
33005, 면부,075004, 73세,2016,4252,1849,2403,76.9,4242,1841,2401,76.7
33005, 면부,075005, 74세,2016,5331,2338,2993,78.1,5322,2336,2986,78.2
33005, 면부,080,75~79세,2016,20965,8573,12392,69.2,20919,8559,12360,69.2
33005, 면부,080001, 75세,2016,4465,1917,2548,75.2,4458,1915,2543,75.3
33005, 면부,080002, 76세,2016,4152,1730,2422,71.4,4142,1728,2414,71.6
33005, 면부,080003, 77세,2016,4522,1842,2680,68.7,4511,1838,2673,68.8
33005, 면부,080004, 78세,2016,4020,1621,2399,67.6,4010,1617,2393,67.6
33005, 면부,080005, 79세,2016,3806,1463,2343,62.4,3798,1461,2337,62.5
33005, 면부,085,80~84세,2016,14776,5110,9666,52.9,14757,5102,9655,52.8
33005, 면부,085001, 80세,2016,3642,1359,2283,59.5,3636,1357,2279,59.5
33005, 면부,085002, 81세,2016,3621,1268,2353,53.9,3614,1264,2350,53.8
33005, 면부,085003, 82세,2016,2895,981,1914,51.3,2893,980,1913,51.2
33005, 면부,085004, 83세,2016,2547,822,1725,47.7,2544,821,1723,47.6
33005, 면부,085005, 84세,2016,2071,680,1391,48.9,2070,680,1390,48.9
33005, 면부,090,85~89세,2016,6250,1742,4508,38.6,6243,1741,4502,38.7
33005, 면부,090001, 85세,2016,1528,408,1120,36.4,1526,408,1118,36.5
33005, 면부,090002, 86세,2016,1513,422,1091,38.7,1512,421,1091,38.6
33005, 면부,090003, 87세,2016,1290,381,909,41.9,1289,381,908,42
33005, 면부,090004, 88세,2016,1080,310,770,40.3,1078,310,768,40.4
33005, 면부,090005, 89세,2016,839,221,618,35.8,838,221,617,35.8
33005, 면부,095,90~94세,2016,2009,519,1490,34.8,2004,518,1486,34.9
33005, 면부,095001, 90세,2016,562,155,407,38.1,558,154,404,38.1
33005, 면부,095002, 91세,2016,525,126,399,31.6,524,126,398,31.7
33005, 면부,095003, 92세,2016,338,104,234,44.4,338,104,234,44.4
33005, 면부,095004, 93세,2016,338,76,262,29,338,76,262,29
33005, 면부,095005, 94세,2016,246,58,188,30.9,246,58,188,30.9
33005, 면부,100,95~99세,2016,435,74,361,20.5,435,74,361,20.5
33005, 면부,100001, 95세,2016,175,35,140,25,175,35,140,25
33005, 면부,100002, 96세,2016,116,17,99,17.2,116,17,99,17.2
33005, 면부,100003, 97세,2016,77,13,64,20.3,77,13,64,20.3
33005, 면부,100004, 98세,2016,42,5,37,13.5,42,5,37,13.5
33005, 면부,100005, 99세,2016,25,X,21,19,25,X,21,19
33005, 면부,101,100세이상,2016,70,9,61,14.8,70,9,61,14.8
33005, 면부,102,15세미만,2016,26802,14018,12784,109.7,26574,13912,12662,109.9
33005, 면부,103,15~64세,2016,220188,124598,95590,130.3,200963,110761,90202,122.8
33005, 면부,104,65세이상,2016,86353,36066,50287,71.7,86004,35895,50109,71.6
33005, 면부,086,85세이상,2016,8764,2344,6420,36.5,8752,2342,6410,36.5
33005, 면부,126,평균연령,2016,49,46.5,51.7,,49.7,47.4,52.2,
33005, 면부,127,중위연령,2016,52.1,48.9,55.4,,53.6,50.8,56.1,
33003, 동부,000,합계,2016,952369,475851,476518,99.9,937318,468054,469264,99.7
33003, 동부,005,0~4세,2016,42735,21761,20974,103.8,42482,21631,20851,103.7
33003, 동부,005001, 0세,2016,7999,4107,3892,105.5,7954,4081,3873,105.4
33003, 동부,005002, 1세,2016,8336,4238,4098,103.4,8288,4216,4072,103.5
33003, 동부,005003, 2세,2016,8377,4205,4172,100.8,8322,4177,4145,100.8
33003, 동부,005004, 3세,2016,8609,4386,4223,103.9,8553,4360,4193,104
33003, 동부,005005, 4세,2016,9414,4825,4589,105.1,9365,4797,4568,105
33003, 동부,010,5~9세,2016,46356,23805,22551,105.6,46148,23696,22452,105.5
33003, 동부,010001, 5세,2016,9443,4794,4649,103.1,9394,4773,4621,103.3
33003, 동부,010002, 6세,2016,9223,4705,4518,104.1,9175,4679,4496,104.1
33003, 동부,010003, 7세,2016,8786,4564,4222,108.1,8755,4547,4208,108.1
33003, 동부,010004, 8세,2016,9246,4784,4462,107.2,9207,4765,4442,107.3
33003, 동부,010005, 9세,2016,9658,4958,4700,105.5,9617,4932,4685,105.3
33003, 동부,015,10~14세,2016,47979,24980,22999,108.6,47833,24910,22923,108.7
33003, 동부,015001, 10세,2016,8838,4559,4279,106.5,8813,4546,4267,106.5
33003, 동부,015002, 11세,2016,8835,4524,4311,104.9,8806,4509,4297,104.9
33003, 동부,015003, 12세,2016,9807,5124,4683,109.4,9771,5106,4665,109.5
33003, 동부,015004, 13세,2016,10003,5222,4781,109.2,9980,5210,4770,109.2
33003, 동부,015005, 14세,2016,10496,5551,4945,112.3,10463,5539,4924,112.5
33003, 동부,020,15~19세,2016,68112,35425,32687,108.4,67543,35155,32388,108.5
33003, 동부,020001, 15세,2016,12039,6296,5743,109.6,12007,6280,5727,109.7
33003, 동부,020002, 16세,2016,12819,6701,6118,109.5,12786,6683,6103,109.5
33003, 동부,020003, 17세,2016,12951,6850,6101,112.3,12895,6827,6068,112.5
33003, 동부,020004, 18세,2016,14322,7357,6965,105.6,14173,7280,6893,105.6
33003, 동부,020005, 19세,2016,15981,8221,7760,105.9,15682,8085,7597,106.4
33003, 동부,025,20~24세,2016,78371,42077,36294,115.9,75823,40774,35049,116.3
33003, 동부,025001, 20세,2016,16037,8233,7804,105.5,15553,7991,7562,105.7
33003, 동부,025002, 21세,2016,15871,8163,7708,105.9,15313,7869,7444,105.7
33003, 동부,025003, 22세,2016,16030,8713,7317,119.1,15497,8439,7058,119.6
33003, 동부,025004, 23세,2016,15617,8617,7000,123.1,15116,8371,6745,124.1
33003, 동부,025005, 24세,2016,14816,8351,6465,129.2,14344,8104,6240,129.9
33003, 동부,030,25~29세,2016,60549,32491,28058,115.8,58136,31237,26899,116.1
33003, 동부,030001, 25세,2016,13370,7362,6008,122.5,12914,7148,5766,124
33003, 동부,030002, 26세,2016,12533,6830,5703,119.8,12000,6546,5454,120
33003, 동부,030003, 27세,2016,11609,6247,5362,116.5,11155,6014,5141,117
33003, 동부,030004, 28세,2016,11490,6032,5458,110.5,11000,5761,5239,110
33003, 동부,030005, 29세,2016,11547,6020,5527,108.9,11067,5768,5299,108.9
33003, 동부,035,30~34세,2016,64261,32993,31268,105.5,62379,32008,30371,105.4
33003, 동부,035001, 30세,2016,11861,6280,5581,112.5,11427,6058,5369,112.8
33003, 동부,035002, 31세,2016,11554,5952,5602,106.2,11181,5746,5435,105.7
33003, 동부,035003, 32세,2016,12535,6503,6032,107.8,12179,6325,5854,108
33003, 동부,035004, 33세,2016,13324,6722,6602,101.8,12951,6518,6433,101.3
33003, 동부,035005, 34세,2016,14987,7536,7451,101.1,14641,7361,7280,101.1
33003, 동부,040,35~39세,2016,70459,35599,34860,102.1,69093,34811,34282,101.5
33003, 동부,040001, 35세,2016,14201,7279,6922,105.2,13894,7112,6782,104.9
33003, 동부,040002, 36세,2016,14803,7434,7369,100.9,14543,7283,7260,100.3
33003, 동부,040003, 37세,2016,14277,7232,7045,102.7,13988,7065,6923,102.1
33003, 동부,040004, 38세,2016,13249,6701,6548,102.3,12975,6552,6423,102
33003, 동부,040005, 39세,2016,13929,6953,6976,99.7,13693,6799,6894,98.6
33003, 동부,045,40~44세,2016,77729,38466,39263,98,76564,37841,38723,97.7
33003, 동부,045001, 40세,2016,13960,6993,6967,100.4,13719,6851,6868,99.8
33003, 동부,045002, 41세,2016,14846,7210,7636,94.4,14618,7094,7524,94.3
33003, 동부,045003, 42세,2016,16478,8193,8285,98.9,16269,8080,8189,98.7
33003, 동부,045004, 43세,2016,16599,8107,8492,95.5,16357,7978,8379,95.2
33003, 동부,045005, 44세,2016,15846,7963,7883,101,15601,7838,7763,101
33003, 동부,050,45~49세,2016,87191,42965,44226,97.1,85911,42271,43640,96.9
33003, 동부,050001, 45세,2016,17415,8690,8725,99.6,17151,8548,8603,99.4
33003, 동부,050002, 46세,2016,16941,8396,8545,98.3,16674,8237,8437,97.6
33003, 동부,050003, 47세,2016,18453,9023,9430,95.7,18204,8891,9313,95.5
33003, 동부,050004, 48세,2016,18008,8695,9313,93.4,17726,8550,9176,93.2
33003, 동부,050005, 49세,2016,16374,8161,8213,99.4,16156,8045,8111,99.2
33003, 동부,055,50~54세,2016,76870,38803,38067,101.9,75631,38210,37421,102.1
33003, 동부,055001, 50세,2016,15924,8009,7915,101.2,15676,7895,7781,101.5
33003, 동부,055002, 51세,2016,16098,8012,8086,99.1,15871,7890,7981,98.9
33003, 동부,055003, 52세,2016,13974,7067,6907,102.3,13725,6959,6766,102.9
33003, 동부,055004, 53세,2016,14758,7531,7227,104.2,14481,7397,7084,104.4
33003, 동부,055005, 54세,2016,16116,8184,7932,103.2,15878,8069,7809,103.3
33003, 동부,060,55~59세,2016,75401,37599,37802,99.5,74489,37148,37341,99.5
33003, 동부,060001, 55세,2016,17808,8936,8872,100.7,17669,8872,8797,100.9
33003, 동부,060002, 56세,2016,15686,7731,7955,97.2,15469,7623,7846,97.2
33003, 동부,060003, 57세,2016,14383,7036,7347,95.8,14202,6943,7259,95.6
33003, 동부,060004, 58세,2016,14069,7186,6883,104.4,13863,7076,6787,104.3
33003, 동부,060005, 59세,2016,13455,6710,6745,99.5,13286,6634,6652,99.7
33003, 동부,065,60~64세,2016,52019,25667,26352,97.4,51460,25361,26099,97.2
33003, 동부,065001, 60세,2016,12085,6085,6000,101.4,11950,6015,5935,101.3
33003, 동부,065002, 61세,2016,11481,5619,5862,95.9,11362,5552,5810,95.6
33003, 동부,065003, 62세,2016,9957,4960,4997,99.3,9833,4894,4939,99.1
33003, 동부,065004, 63세,2016,8705,4237,4468,94.8,8600,4177,4423,94.4
33003, 동부,065005, 64세,2016,9791,4766,5025,94.8,9715,4723,4992,94.6
33003, 동부,070,65~69세,2016,32743,15584,17159,90.8,32462,15456,17006,90.9
33003, 동부,070001, 65세,2016,6256,2985,3271,91.3,6181,2950,3231,91.3
33003, 동부,070002, 66세,2016,6483,3099,3384,91.6,6425,3079,3346,92
33003, 동부,070003, 67세,2016,6618,3216,3402,94.5,6542,3181,3361,94.6
33003, 동부,070004, 68세,2016,6763,3279,3484,94.1,6727,3258,3469,93.9
33003, 동부,070005, 69세,2016,6623,3005,3618,83.1,6587,2988,3599,83
33003, 동부,075,70~74세,2016,27380,12176,15204,80.1,27273,12132,15141,80.1
33003, 동부,075001, 70세,2016,4840,2241,2599,86.2,4815,2232,2583,86.4
33003, 동부,075002, 71세,2016,5353,2435,2918,83.4,5325,2422,2903,83.4
33003, 동부,075003, 72세,2016,5411,2403,3008,79.9,5392,2394,2998,79.9
33003, 동부,075004, 73세,2016,5413,2360,3053,77.3,5393,2351,3042,77.3
33003, 동부,075005, 74세,2016,6363,2737,3626,75.5,6348,2733,3615,75.6
33003, 동부,080,75~79세,2016,22108,8832,13276,66.5,22052,8813,13239,66.6
33003, 동부,080001, 75세,2016,5060,2075,2985,69.5,5051,2074,2977,69.7
33003, 동부,080002, 76세,2016,4514,1847,2667,69.3,4506,1845,2661,69.3
33003, 동부,080003, 77세,2016,4641,1878,2763,68,4623,1871,2752,68
33003, 동부,080004, 78세,2016,4051,1555,2496,62.3,4037,1549,2488,62.3
33003, 동부,080005, 79세,2016,3842,1477,2365,62.5,3835,1474,2361,62.4
33003, 동부,085,80~84세,2016,13786,4685,9101,51.5,13747,4665,9082,51.4
33003, 동부,085001, 80세,2016,3571,1336,2235,59.8,3558,1331,2227,59.8
33003, 동부,085002, 81세,2016,3264,1179,2085,56.5,3258,1176,2082,56.5
33003, 동부,085003, 82세,2016,2695,903,1792,50.4,2688,899,1789,50.3
33003, 동부,085004, 83세,2016,2299,723,1576,45.9,2294,721,1573,45.8
33003, 동부,085005, 84세,2016,1957,544,1413,38.5,1949,538,1411,38.1
33003, 동부,090,85~89세,2016,5912,1453,4459,32.6,5897,1449,4448,32.6
33003, 동부,090001, 85세,2016,1405,388,1017,38.2,1400,386,1014,38.1
33003, 동부,090002, 86세,2016,1506,374,1132,33,1503,372,1131,32.9
33003, 동부,090003, 87세,2016,1259,289,970,29.8,1255,289,966,29.9
33003, 동부,090004, 88세,2016,927,215,712,30.2,924,215,709,30.3
33003, 동부,090005, 89세,2016,815,187,628,29.8,815,187,628,29.8
33003, 동부,095,90~94세,2016,1947,426,1521,28,1937,423,1514,27.9
33003, 동부,095001, 90세,2016,534,113,421,26.8,533,113,420,26.9
33003, 동부,095002, 91세,2016,515,111,404,27.5,515,111,404,27.5
33003, 동부,095003, 92세,2016,318,66,252,26.2,314,63,251,25.1
33003, 동부,095004, 93세,2016,318,76,242,31.4,316,76,240,31.7
33003, 동부,095005, 94세,2016,262,60,202,29.7,259,60,199,30.2
33003, 동부,100,95~99세,2016,415,59,356,16.6,413,58,355,16.3
33003, 동부,100001, 95세,2016,164,26,138,18.8,164,26,138,18.8
33003, 동부,100002, 96세,2016,102,14,88,15.9,102,14,88,15.9
33003, 동부,100003, 97세,2016,69,11,58,19,68,11,57,19.3
33003, 동부,100004, 98세,2016,45,X,41,9.8,45,X,41,9.8
33003, 동부,100005, 99세,2016,35,X,31,12.9,34,X,31,9.7
33003, 동부,101,100세이상,2016,46,5,41,12.2,45,5,40,12.5
33003, 동부,102,15세미만,2016,137070,70546,66524,106,136463,70237,66226,106.1
33003, 동부,103,15~64세,2016,710962,362085,348877,103.8,697029,354816,342213,103.7
33003, 동부,104,65세이상,2016,104337,43220,61117,70.7,103826,43001,60825,70.7
33003, 동부,086,85세이상,2016,8320,1943,6377,30.5,8292,1935,6357,30.4
33003, 동부,126,평균연령,2016,39.1,38,40.3,,39.2,38,40.3,
33003, 동부,127,중위연령,2016,39.8,38.4,41.2,,39.9,38.5,41.3,
33020, 충주시,000,합계,2016,211890,107725,104165,103.4,206229,104202,102027,102.1
33020, 충주시,005,0~4세,2016,7517,3776,3741,100.9,7491,3761,3730,100.8
33020, 충주시,005001, 0세,2016,1452,741,711,104.2,1449,739,710,104.1
33020, 충주시,005002, 1세,2016,1449,716,733,97.7,1439,711,728,97.7
33020, 충주시,005003, 2세,2016,1490,741,749,98.9,1486,739,747,98.9
33020, 충주시,005004, 3세,2016,1483,760,723,105.1,1479,758,721,105.1
33020, 충주시,005005, 4세,2016,1643,818,825,99.2,1638,814,824,98.8
33020, 충주시,010,5~9세,2016,8695,4486,4209,106.6,8666,4475,4191,106.8
33020, 충주시,010001, 5세,2016,1748,924,824,112.1,1742,922,820,112.4
33020, 충주시,010002, 6세,2016,1713,839,874,96,1707,838,869,96.4
33020, 충주시,010003, 7세,2016,1610,814,796,102.3,1604,813,791,102.8
33020, 충주시,010004, 8세,2016,1779,952,827,115.1,1772,949,823,115.3
33020, 충주시,010005, 9세,2016,1845,957,888,107.8,1841,953,888,107.3
33020, 충주시,015,10~14세,2016,9134,4766,4368,109.1,9112,4750,4362,108.9
33020, 충주시,015001, 10세,2016,1668,865,803,107.7,1664,863,801,107.7
33020, 충주시,015002, 11세,2016,1661,872,789,110.5,1657,868,789,110
33020, 충주시,015003, 12세,2016,1875,956,919,104,1868,949,919,103.3
33020, 충주시,015004, 13세,2016,1918,1018,900,113.1,1915,1015,900,112.8
33020, 충주시,015005, 14세,2016,2012,1055,957,110.2,2008,1055,953,110.7
33020, 충주시,020,15~19세,2016,14050,7397,6653,111.2,13772,7270,6502,111.8
33020, 충주시,020001, 15세,2016,2412,1245,1167,106.7,2410,1244,1166,106.7
33020, 충주시,020002, 16세,2016,2560,1322,1238,106.8,2554,1319,1235,106.8
33020, 충주시,020003, 17세,2016,2609,1364,1245,109.6,2585,1358,1227,110.7
33020, 충주시,020004, 18세,2016,2959,1520,1439,105.6,2872,1476,1396,105.7
33020, 충주시,020005, 19세,2016,3510,1946,1564,124.4,3351,1873,1478,126.7
33020, 충주시,025,20~24세,2016,16945,9589,7356,130.4,15790,8929,6861,130.1
33020, 충주시,025001, 20세,2016,3408,1783,1625,109.7,3203,1674,1529,109.5
33020, 충주시,025002, 21세,2016,3382,1775,1607,110.5,3141,1650,1491,110.7
33020, 충주시,025003, 22세,2016,3399,1924,1475,130.4,3169,1782,1387,128.5
33020, 충주시,025004, 23세,2016,3480,2091,1389,150.5,3238,1952,1286,151.8
33020, 충주시,025005, 24세,2016,3276,2016,1260,160,3039,1871,1168,160.2
33020, 충주시,030,25~29세,2016,12011,7007,5004,140,10914,6267,4647,134.9
33020, 충주시,030001, 25세,2016,2833,1702,1131,150.5,2602,1547,1055,146.6
33020, 충주시,030002, 26세,2016,2476,1450,1026,141.3,2252,1299,953,136.3
33020, 충주시,030003, 27세,2016,2219,1301,918,141.7,1998,1163,835,139.3
33020, 충주시,030004, 28세,2016,2261,1326,935,141.8,2039,1172,867,135.2
33020, 충주시,030005, 29세,2016,2222,1228,994,123.5,2023,1086,937,115.9
33020, 충주시,035,30~34세,2016,12063,6536,5527,118.3,11255,5990,5265,113.8
33020, 충주시,035001, 30세,2016,2276,1264,1012,124.9,2089,1142,947,120.6
33020, 충주시,035002, 31세,2016,2113,1164,949,122.7,1936,1040,896,116.1
33020, 충주시,035003, 32세,2016,2383,1316,1067,123.3,2245,1218,1027,118.6
33020, 충주시,035004, 33세,2016,2513,1326,1187,111.7,2355,1218,1137,107.1
33020, 충주시,035005, 34세,2016,2778,1466,1312,111.7,2630,1372,1258,109.1
33020, 충주시,040,35~39세,2016,13340,6946,6394,108.6,12832,6578,6254,105.2
33020, 충주시,040001, 35세,2016,2709,1500,1209,124.1,2595,1416,1179,120.1
33020, 충주시,040002, 36세,2016,2704,1348,1356,99.4,2605,1280,1325,96.6
33020, 충주시,040003, 37세,2016,2702,1400,1302,107.5,2602,1330,1272,104.6
33020, 충주시,040004, 38세,2016,2484,1287,1197,107.5,2402,1226,1176,104.3
33020, 충주시,040005, 39세,2016,2741,1411,1330,106.1,2628,1326,1302,101.8
33020, 충주시,045,40~44세,2016,15494,8067,7427,108.6,15072,7784,7288,106.8
33020, 충주시,045001, 40세,2016,2752,1451,1301,111.5,2655,1373,1282,107.1
33020, 충주시,045002, 41세,2016,2912,1468,1444,101.7,2843,1418,1425,99.5
33020, 충주시,045003, 42세,2016,3286,1749,1537,113.8,3208,1703,1505,113.2
33020, 충주시,045004, 43세,2016,3367,1736,1631,106.4,3274,1674,1600,104.6
33020, 충주시,045005, 44세,2016,3177,1663,1514,109.8,3092,1616,1476,109.5
33020, 충주시,050,45~49세,2016,18149,9241,8908,103.7,17731,8991,8740,102.9
33020, 충주시,050001, 45세,2016,3567,1794,1773,101.2,3484,1748,1736,100.7
33020, 충주시,050002, 46세,2016,3397,1740,1657,105,3300,1675,1625,103.1
33020, 충주시,050003, 47세,2016,3817,1912,1905,100.4,3733,1863,1870,99.6
33020, 충주시,050004, 48세,2016,3829,1969,1860,105.9,3745,1920,1825,105.2
33020, 충주시,050005, 49세,2016,3539,1826,1713,106.6,3469,1785,1684,106
33020, 충주시,055,50~54세,2016,17510,9131,8379,109,17121,8909,8212,108.5
33020, 충주시,055001, 50세,2016,3525,1894,1631,116.1,3448,1850,1598,115.8
33020, 충주시,055002, 51세,2016,3634,1880,1754,107.2,3554,1825,1729,105.6
33020, 충주시,055003, 52세,2016,3137,1629,1508,108,3054,1585,1469,107.9
33020, 충주시,055004, 53세,2016,3432,1750,1682,104,3352,1709,1643,104
33020, 충주시,055005, 54세,2016,3782,1978,1804,109.6,3713,1940,1773,109.4
33020, 충주시,060,55~59세,2016,18763,9621,9142,105.2,18516,9476,9040,104.8
33020, 충주시,060001, 55세,2016,4301,2170,2131,101.8,4266,2148,2118,101.4
33020, 충주시,060002, 56세,2016,3844,1960,1884,104,3794,1934,1860,104
33020, 충주시,060003, 57세,2016,3635,1874,1761,106.4,3582,1844,1738,106.1
33020, 충주시,060004, 58세,2016,3560,1851,1709,108.3,3507,1819,1688,107.8
33020, 충주시,060005, 59세,2016,3423,1766,1657,106.6,3367,1731,1636,105.8
33020, 충주시,065,60~64세,2016,14157,7046,7111,99.1,14016,6959,7057,98.6
33020, 충주시,065001, 60세,2016,3283,1676,1607,104.3,3248,1654,1594,103.8
33020, 충주시,065002, 61세,2016,2971,1479,1492,99.1,2940,1462,1478,98.9
33020, 충주시,065003, 62세,2016,2651,1343,1308,102.7,2622,1323,1299,101.8
33020, 충주시,065004, 63세,2016,2372,1163,1209,96.2,2345,1145,1200,95.4
33020, 충주시,065005, 64세,2016,2880,1385,1495,92.6,2861,1375,1486,92.5
33020, 충주시,070,65~69세,2016,9120,4355,4765,91.4,9049,4321,4728,91.4
33020, 충주시,070001, 65세,2016,1716,839,877,95.7,1698,831,867,95.8
33020, 충주시,070002, 66세,2016,1709,805,904,89,1697,801,896,89.4
33020, 충주시,070003, 67세,2016,1865,889,976,91.1,1844,875,969,90.3
33020, 충주시,070004, 68세,2016,1825,893,932,95.8,1816,890,926,96.1
33020, 충주시,070005, 69세,2016,2005,929,1076,86.3,1994,924,1070,86.4
33020, 충주시,075,70~74세,2016,8776,3922,4854,80.8,8753,3916,4837,81
33020, 충주시,075001, 70세,2016,1517,717,800,89.6,1510,715,795,89.9
33020, 충주시,075002, 71세,2016,1618,711,907,78.4,1614,709,905,78.3
33020, 충주시,075003, 72세,2016,1790,791,999,79.2,1786,791,995,79.5
33020, 충주시,075004, 73세,2016,1731,763,968,78.8,1727,762,965,79
33020, 충주시,075005, 74세,2016,2120,940,1180,79.7,2116,939,1177,79.8
33020, 충주시,080,75~79세,2016,8150,3337,4813,69.3,8137,3329,4808,69.2
33020, 충주시,080001, 75세,2016,1828,761,1067,71.3,1824,759,1065,71.3
33020, 충주시,080002, 76세,2016,1653,718,935,76.8,1652,717,935,76.7
33020, 충주시,080003, 77세,2016,1795,710,1085,65.4,1789,707,1082,65.3
33020, 충주시,080004, 78세,2016,1491,600,891,67.3,1491,600,891,67.3
33020, 충주시,080005, 79세,2016,1383,548,835,65.6,1381,546,835,65.4
33020, 충주시,085,80~84세,2016,5122,1722,3400,50.6,5111,1718,3393,50.6
33020, 충주시,085001, 80세,2016,1291,492,799,61.6,1286,491,795,61.8
33020, 충주시,085002, 81세,2016,1178,394,784,50.3,1176,392,784,50
33020, 충주시,085003, 82세,2016,1024,349,675,51.7,1023,349,674,51.8
33020, 충주시,085004, 83세,2016,874,272,602,45.2,871,271,600,45.2
33020, 충주시,085005, 84세,2016,755,215,540,39.8,755,215,540,39.8
33020, 충주시,090,85~89세,2016,2025,545,1480,36.8,2024,545,1479,36.8
33020, 충주시,090001, 85세,2016,499,140,359,39,499,140,359,39
33020, 충주시,090002, 86세,2016,509,141,368,38.3,509,141,368,38.3
33020, 충주시,090003, 87세,2016,443,110,333,33,443,110,333,33
33020, 충주시,090004, 88세,2016,308,80,228,35.1,307,80,227,35.2
33020, 충주시,090005, 89세,2016,266,74,192,38.5,266,74,192,38.5
33020, 충주시,095,90~94세,2016,706,208,498,41.8,705,207,498,41.6
33020, 충주시,095001, 90세,2016,197,55,142,38.7,196,54,142,38
33020, 충주시,095002, 91세,2016,182,62,120,51.7,182,62,120,51.7
33020, 충주시,095003, 92세,2016,111,36,75,48,111,36,75,48
33020, 충주시,095004, 93세,2016,118,36,82,43.9,118,36,82,43.9
33020, 충주시,095005, 94세,2016,98,19,79,24.1,98,19,79,24.1
33020, 충주시,100,95~99세,2016,147,24,123,19.5,146,24,122,19.7
33020, 충주시,100001, 95세,2016,57,12,45,26.7,57,12,45,26.7
33020, 충주시,100002, 96세,2016,40,8,32,25,40,8,32,25
33020, 충주시,100003, 97세,2016,22,X,19,15.8,21,X,18,16.7
33020, 충주시,100004, 98세,2016,16,X,15,6.7,16,X,15,6.7
33020, 충주시,100005, 99세,2016,12,X,12,0,12,X,12,0
33020, 충주시,101,100세이상,2016,16,X,13,23.1,16,X,13,23.1
33020, 충주시,102,15세미만,2016,25346,13028,12318,105.8,25269,12986,12283,105.7
33020, 충주시,103,15~64세,2016,152482,80581,71901,112.1,147019,77153,69866,110.4
33020, 충주시,104,65세이상,2016,34062,14116,19946,70.8,33941,14063,19878,70.7
33020, 충주시,086,85세이상,2016,2894,780,2114,36.9,2891,779,2112,36.9
33020, 충주시,126,평균연령,2016,42.6,41,44.2,,42.8,41.2,44.3,
33020, 충주시,127,중위연령,2016,44,42.3,45.8,,44.4,42.8,46.1,
33030, 제천시,000,합계,2016,137022,68953,68069,101.3,135172,68002,67170,101.2
33030, 제천시,005,0~4세,2016,4863,2487,2376,104.7,4846,2481,2365,104.9
33030, 제천시,005001, 0세,2016,906,504,402,125.4,904,504,400,126
33030, 제천시,005002, 1세,2016,890,443,447,99.1,885,439,446,98.4
33030, 제천시,005003, 2세,2016,1011,503,508,99,1006,503,503,100
33030, 제천시,005004, 3세,2016,965,467,498,93.8,962,465,497,93.6
33030, 제천시,005005, 4세,2016,1091,570,521,109.4,1089,570,519,109.8
33030, 제천시,010,5~9세,2016,5298,2662,2636,101,5285,2656,2629,101
33030, 제천시,010001, 5세,2016,1052,515,537,95.9,1046,514,532,96.6
33030, 제천시,010002, 6세,2016,1075,518,557,93,1072,515,557,92.5
33030, 제천시,010003, 7세,2016,995,508,487,104.3,995,508,487,104.3
33030, 제천시,010004, 8세,2016,1100,592,508,116.5,1096,590,506,116.6
33030, 제천시,010005, 9세,2016,1076,529,547,96.7,1076,529,547,96.7
33030, 제천시,015,10~14세,2016,5717,2987,2730,109.4,5707,2983,2724,109.5
33030, 제천시,015001, 10세,2016,1066,563,503,111.9,1063,561,502,111.8
33030, 제천시,015002, 11세,2016,1052,547,505,108.3,1049,545,504,108.1
33030, 제천시,015003, 12세,2016,1161,603,558,108.1,1160,603,557,108.3
33030, 제천시,015004, 13세,2016,1168,595,573,103.8,1167,595,572,104
33030, 제천시,015005, 14세,2016,1270,679,591,114.9,1268,679,589,115.3
33030, 제천시,020,15~19세,2016,9298,4894,4404,111.1,9235,4856,4379,110.9
33030, 제천시,020001, 15세,2016,1508,809,699,115.7,1504,809,695,116.4
33030, 제천시,020002, 16세,2016,1502,748,754,99.2,1499,746,753,99.1
33030, 제천시,020003, 17세,2016,1583,816,767,106.4,1573,810,763,106.2
33030, 제천시,020004, 18세,2016,2027,1081,946,114.3,2006,1067,939,113.6
33030, 제천시,020005, 19세,2016,2678,1440,1238,116.3,2653,1424,1229,115.9
33030, 제천시,025,20~24세,2016,11318,6325,4993,126.7,10990,6155,4835,127.3
33030, 제천시,025001, 20세,2016,2354,1165,1189,98,2320,1151,1169,98.5
33030, 제천시,025002, 21세,2016,2302,1153,1149,100.3,2228,1109,1119,99.1
33030, 제천시,025003, 22세,2016,2430,1387,1043,133,2346,1343,1003,133.9
33030, 제천시,025004, 23세,2016,2245,1369,876,156.3,2174,1336,838,159.4
33030, 제천시,025005, 24세,2016,1987,1251,736,170,1922,1216,706,172.2
33030, 제천시,030,25~29세,2016,6687,3676,3011,122.1,6354,3496,2858,122.3
33030, 제천시,030001, 25세,2016,1572,928,644,144.1,1510,897,613,146.3
33030, 제천시,030002, 26세,2016,1403,779,624,124.8,1333,739,594,124.4
33030, 제천시,030003, 27세,2016,1301,700,601,116.5,1240,665,575,115.7
33030, 제천시,030004, 28세,2016,1196,637,559,114,1123,596,527,113.1
33030, 제천시,030005, 29세,2016,1215,632,583,108.4,1148,599,549,109.1
33030, 제천시,035,30~34세,2016,6936,3673,3263,112.6,6676,3544,3132,113.2
33030, 제천시,035001, 30세,2016,1283,701,582,120.4,1220,670,550,121.8
33030, 제천시,035002, 31세,2016,1265,669,596,112.2,1208,637,571,111.6
33030, 제천시,035003, 32세,2016,1353,728,625,116.5,1309,703,606,116
33030, 제천시,035004, 33세,2016,1414,737,677,108.9,1368,716,652,109.8
33030, 제천시,035005, 34세,2016,1621,838,783,107,1571,818,753,108.6
33030, 제천시,040,35~39세,2016,7844,4050,3794,106.7,7679,3963,3716,106.6
33030, 제천시,040001, 35세,2016,1586,817,769,106.2,1550,799,751,106.4
33030, 제천시,040002, 36세,2016,1635,841,794,105.9,1591,817,774,105.6
33030, 제천시,040003, 37세,2016,1598,815,783,104.1,1566,798,768,103.9
33030, 제천시,040004, 38세,2016,1488,760,728,104.4,1455,743,712,104.4
33030, 제천시,040005, 39세,2016,1537,817,720,113.5,1517,806,711,113.4
33030, 제천시,045,40~44세,2016,9389,4773,4616,103.4,9248,4700,4548,103.3
33030, 제천시,045001, 40세,2016,1576,800,776,103.1,1551,787,764,103
33030, 제천시,045002, 41세,2016,1796,888,908,97.8,1768,873,895,97.5
33030, 제천시,045003, 42세,2016,1998,1013,985,102.8,1969,996,973,102.4
33030, 제천시,045004, 43세,2016,1996,1008,988,102,1964,995,969,102.7
33030, 제천시,045005, 44세,2016,2023,1064,959,110.9,1996,1049,947,110.8
33030, 제천시,050,45~49세,2016,11441,5944,5497,108.1,11308,5871,5437,108
33030, 제천시,050001, 45세,2016,2219,1170,1049,111.5,2191,1153,1038,111.1
33030, 제천시,050002, 46세,2016,2143,1121,1022,109.7,2123,1111,1012,109.8
33030, 제천시,050003, 47세,2016,2385,1241,1144,108.5,2359,1227,1132,108.4
33030, 제천시,050004, 48세,2016,2457,1246,1211,102.9,2426,1228,1198,102.5
33030, 제천시,050005, 49세,2016,2237,1166,1071,108.9,2209,1152,1057,109
33030, 제천시,055,50~54세,2016,11167,5673,5494,103.3,11041,5612,5429,103.4
33030, 제천시,055001, 50세,2016,2252,1162,1090,106.6,2227,1150,1077,106.8
33030, 제천시,055002, 51세,2016,2232,1152,1080,106.7,2213,1142,1071,106.6
33030, 제천시,055003, 52세,2016,2002,1035,967,107,1971,1020,951,107.3
33030, 제천시,055004, 53세,2016,2127,1058,1069,99,2099,1048,1051,99.7
33030, 제천시,055005, 54세,2016,2554,1266,1288,98.3,2531,1252,1279,97.9
33030, 제천시,060,55~59세,2016,13052,6562,6490,101.1,12939,6509,6430,101.2
33030, 제천시,060001, 55세,2016,2815,1458,1357,107.4,2798,1451,1347,107.7
33030, 제천시,060002, 56세,2016,2641,1271,1370,92.8,2612,1260,1352,93.2
33030, 제천시,060003, 57세,2016,2486,1231,1255,98.1,2460,1218,1242,98.1
33030, 제천시,060004, 58세,2016,2608,1343,1265,106.2,2586,1329,1257,105.7
33030, 제천시,060005, 59세,2016,2502,1259,1243,101.3,2483,1251,1232,101.5
33030, 제천시,065,60~64세,2016,10424,5281,5143,102.7,10350,5243,5107,102.7
33030, 제천시,065001, 60세,2016,2304,1165,1139,102.3,2277,1154,1123,102.8
33030, 제천시,065002, 61세,2016,2174,1115,1059,105.3,2158,1106,1052,105.1
33030, 제천시,065003, 62세,2016,1976,960,1016,94.5,1963,951,1012,94
33030, 제천시,065004, 63세,2016,1769,920,849,108.4,1756,912,844,108.1
33030, 제천시,065005, 64세,2016,2201,1121,1080,103.8,2196,1120,1076,104.1
33030, 제천시,070,65~69세,2016,6717,3244,3473,93.4,6675,3225,3450,93.5
33030, 제천시,070001, 65세,2016,1281,600,681,88.1,1270,594,676,87.9
33030, 제천시,070002, 66세,2016,1282,637,645,98.8,1273,634,639,99.2
33030, 제천시,070003, 67세,2016,1304,638,666,95.8,1296,634,662,95.8
33030, 제천시,070004, 68세,2016,1428,707,721,98.1,1422,704,718,98.1
33030, 제천시,070005, 69세,2016,1422,662,760,87.1,1414,659,755,87.3
33030, 제천시,075,70~74세,2016,6208,2825,3383,83.5,6195,2820,3375,83.6
33030, 제천시,075001, 70세,2016,1020,478,542,88.2,1018,478,540,88.5
33030, 제천시,075002, 71세,2016,1198,550,648,84.9,1197,550,647,85
33030, 제천시,075003, 72세,2016,1249,580,669,86.7,1246,577,669,86.2
33030, 제천시,075004, 73세,2016,1252,569,683,83.3,1249,568,681,83.4
33030, 제천시,075005, 74세,2016,1489,648,841,77.1,1485,647,838,77.2
33030, 제천시,080,75~79세,2016,5438,2237,3201,69.9,5432,2235,3197,69.9
33030, 제천시,080001, 75세,2016,1229,526,703,74.8,1228,526,702,74.9
33030, 제천시,080002, 76세,2016,1090,430,660,65.2,1090,430,660,65.2
33030, 제천시,080003, 77세,2016,1123,469,654,71.7,1119,467,652,71.6
33030, 제천시,080004, 78세,2016,1061,445,616,72.2,1061,445,616,72.2
33030, 제천시,080005, 79세,2016,935,367,568,64.6,934,367,567,64.7
33030, 제천시,085,80~84세,2016,3258,1168,2090,55.9,3250,1163,2087,55.7
33030, 제천시,085001, 80세,2016,845,330,515,64.1,841,328,513,63.9
33030, 제천시,085002, 81세,2016,788,291,497,58.6,787,291,496,58.7
33030, 제천시,085003, 82세,2016,640,223,417,53.5,639,222,417,53.2
33030, 제천시,085004, 83세,2016,533,190,343,55.4,532,189,343,55.1
33030, 제천시,085005, 84세,2016,452,134,318,42.1,451,133,318,41.8
33030, 제천시,090,85~89세,2016,1382,370,1012,36.6,1378,369,1009,36.6
33030, 제천시,090001, 85세,2016,354,99,255,38.8,352,99,253,39.1
33030, 제천시,090002, 86세,2016,366,102,264,38.6,365,101,264,38.3
33030, 제천시,090003, 87세,2016,276,85,191,44.5,275,85,190,44.7
33030, 제천시,090004, 88세,2016,208,49,159,30.8,208,49,159,30.8
33030, 제천시,090005, 89세,2016,178,35,143,24.5,178,35,143,24.5
33030, 제천시,095,90~94세,2016,459,102,357,28.6,458,101,357,28.3
33030, 제천시,095001, 90세,2016,140,26,114,22.8,140,26,114,22.8
33030, 제천시,095002, 91세,2016,111,26,85,30.6,111,26,85,30.6
33030, 제천시,095003, 92세,2016,85,17,68,25,85,17,68,25
33030, 제천시,095004, 93세,2016,73,15,58,25.9,72,14,58,24.1
33030, 제천시,095005, 94세,2016,50,18,32,56.3,50,18,32,56.3
33030, 제천시,100,95~99세,2016,113,18,95,18.9,113,18,95,18.9
33030, 제천시,100001, 95세,2016,38,7,31,22.6,38,7,31,22.6
33030, 제천시,100002, 96세,2016,33,X,29,13.8,33,X,29,13.8
33030, 제천시,100003, 97세,2016,19,X,15,26.7,19,X,15,26.7
33030, 제천시,100004, 98세,2016,11,X,9,22.2,11,X,9,22.2
33030, 제천시,100005, 99세,2016,12,X,11,9.1,12,X,11,9.1
33030, 제천시,101,100세이상,2016,13,X,11,18.2,13,X,11,18.2
33030, 제천시,102,15세미만,2016,15878,8136,7742,105.1,15838,8120,7718,105.2
33030, 제천시,103,15~64세,2016,97556,50851,46705,108.9,95820,49949,45871,108.9
33030, 제천시,104,65세이상,2016,23588,9966,13622,73.2,23514,9933,13581,73.1
33030, 제천시,086,85세이상,2016,1967,492,1475,33.4,1962,490,1472,33.3
33030, 제천시,126,평균연령,2016,43.4,42,44.9,,43.5,42,45,
33030, 제천시,127,중위연령,2016,45.5,44,47.1,,45.7,44.2,47.3,
33040, 청주시,000,합계,2016,840338,421930,418408,100.8,825574,413781,411793,100.5
33040, 청주시,005,0~4세,2016,41540,21180,20360,104,41283,21045,20238,104
33040, 청주시,005001, 0세,2016,7853,3998,3855,103.7,7803,3968,3835,103.5
33040, 청주시,005002, 1세,2016,8259,4226,4033,104.8,8210,4203,4007,104.9
33040, 청주시,005003, 2세,2016,8100,4081,4019,101.5,8045,4049,3996,101.3
33040, 청주시,005004, 3세,2016,8331,4273,4058,105.3,8275,4248,4027,105.5
33040, 청주시,005005, 4세,2016,8997,4602,4395,104.7,8950,4577,4373,104.7
33040, 청주시,010,5~9세,2016,42617,21942,20675,106.1,42420,21837,20583,106.1
33040, 청주시,010001, 5세,2016,8824,4434,4390,101,8775,4410,4365,101
33040, 청주시,010002, 6세,2016,8452,4388,4064,108,8409,4363,4046,107.8
33040, 청주시,010003, 7세,2016,8153,4279,3874,110.5,8122,4262,3860,110.4
33040, 청주시,010004, 8세,2016,8443,4335,4108,105.5,8407,4318,4089,105.6
33040, 청주시,010005, 9세,2016,8745,4506,4239,106.3,8707,4484,4223,106.2
33040, 청주시,015,10~14세,2016,41834,21811,20023,108.9,41695,21750,19945,109
33040, 청주시,015001, 10세,2016,7915,4075,3840,106.1,7891,4063,3828,106.1
33040, 청주시,015002, 11세,2016,7785,4005,3780,106,7760,3994,3766,106.1
33040, 청주시,015003, 12세,2016,8507,4468,4039,110.6,8475,4455,4020,110.8
33040, 청주시,015004, 13세,2016,8674,4525,4149,109.1,8650,4513,4137,109.1
33040, 청주시,015005, 14세,2016,8953,4738,4215,112.4,8919,4725,4194,112.7
33040, 청주시,020,15~19세,2016,57435,29787,27648,107.7,57152,29657,27495,107.9
33040, 청주시,020001, 15세,2016,10128,5301,4827,109.8,10096,5283,4813,109.8
33040, 청주시,020002, 16세,2016,11262,5936,5326,111.5,11234,5920,5314,111.4
33040, 청주시,020003, 17세,2016,10934,5829,5105,114.2,10906,5814,5092,114.2
33040, 청주시,020004, 18세,2016,11932,6113,5819,105.1,11875,6086,5789,105.1
33040, 청주시,020005, 19세,2016,13179,6608,6571,100.6,13041,6554,6487,101
33040, 청주시,025,20~24세,2016,65736,35095,30641,114.5,63716,33984,29732,114.3
33040, 청주시,025001, 20세,2016,13428,6871,6557,104.8,13104,6722,6382,105.3
33040, 청주시,025002, 21세,2016,13126,6719,6407,104.9,12738,6509,6229,104.5
33040, 청주시,025003, 22세,2016,13345,7227,6118,118.1,12931,6995,5936,117.8
33040, 청주시,025004, 23세,2016,13080,7156,5924,120.8,12657,6913,5744,120.4
33040, 청주시,025005, 24세,2016,12757,7122,5635,126.4,12286,6845,5441,125.8
33040, 청주시,030,25~29세,2016,56624,30484,26140,116.6,53999,28978,25021,115.8
33040, 청주시,030001, 25세,2016,11889,6545,5344,122.5,11424,6292,5132,122.6
33040, 청주시,030002, 26세,2016,11456,6302,5154,122.3,10868,5952,4916,121.1
33040, 청주시,030003, 27세,2016,11016,5994,5022,119.4,10513,5700,4813,118.4
33040, 청주시,030004, 28세,2016,11043,5787,5256,110.1,10522,5478,5044,108.6
33040, 청주시,030005, 29세,2016,11220,5856,5364,109.2,10672,5556,5116,108.6
33040, 청주시,035,30~34세,2016,62589,32393,30196,107.3,60421,31126,29295,106.3
33040, 청주시,035001, 30세,2016,11430,6080,5350,113.6,10923,5776,5147,112.2
33040, 청주시,035002, 31세,2016,11375,5942,5433,109.4,10958,5706,5252,108.6
33040, 청주시,035003, 32세,2016,12203,6400,5803,110.3,11787,6165,5622,109.7
33040, 청주시,035004, 33세,2016,13092,6673,6419,104,12644,6396,6248,102.4
33040, 청주시,035005, 34세,2016,14489,7298,7191,101.5,14109,7083,7026,100.8
33040, 청주시,040,35~39세,2016,66488,34205,32283,106,64907,33225,31682,104.9
33040, 청주시,040001, 35세,2016,13528,6998,6530,107.2,13167,6792,6375,106.5
33040, 청주시,040002, 36세,2016,14129,7276,6853,106.2,13833,7092,6741,105.2
33040, 청주시,040003, 37세,2016,13507,6966,6541,106.5,13164,6752,6412,105.3
33040, 청주시,040004, 38세,2016,12416,6432,5984,107.5,12096,6232,5864,106.3
33040, 청주시,040005, 39세,2016,12908,6533,6375,102.5,12647,6357,6290,101.1
33040, 청주시,045,40~44세,2016,68614,34489,34125,101.1,67376,33796,33580,100.6
33040, 청주시,045001, 40세,2016,12727,6504,6223,104.5,12456,6347,6109,103.9
33040, 청주시,045002, 41세,2016,13326,6619,6707,98.7,13077,6487,6590,98.4
33040, 청주시,045003, 42세,2016,14465,7296,7169,101.8,14234,7164,7070,101.3
33040, 청주시,045004, 43세,2016,14481,7170,7311,98.1,14250,7041,7209,97.7
33040, 청주시,045005, 44세,2016,13615,6900,6715,102.8,13359,6757,6602,102.3
33040, 청주시,050,45~49세,2016,74156,36888,37268,99,72941,36220,36721,98.6
33040, 청주시,050001, 45세,2016,14966,7600,7366,103.2,14696,7453,7243,102.9
33040, 청주시,050002, 46세,2016,14468,7282,7186,101.3,14217,7133,7084,100.7
33040, 청주시,050003, 47세,2016,15739,7767,7972,97.4,15495,7626,7869,96.9
33040, 청주시,050004, 48세,2016,15146,7324,7822,93.6,14884,7189,7695,93.4
33040, 청주시,050005, 49세,2016,13837,6915,6922,99.9,13649,6819,6830,99.8
33040, 청주시,055,50~54세,2016,65090,33038,32052,103.1,63902,32466,31436,103.3
33040, 청주시,055001, 50세,2016,13407,6730,6677,100.8,13176,6620,6556,101
33040, 청주시,055002, 51세,2016,13720,6817,6903,98.8,13484,6705,6779,98.9
33040, 청주시,055003, 52세,2016,11882,6031,5851,103.1,11666,5935,5731,103.6
33040, 청주시,055004, 53세,2016,12545,6510,6035,107.9,12274,6370,5904,107.9
33040, 청주시,055005, 54세,2016,13536,6950,6586,105.5,13302,6836,6466,105.7
33040, 청주시,060,55~59세,2016,63423,31559,31864,99,62570,31141,31429,99.1
33040, 청주시,060001, 55세,2016,15046,7571,7475,101.3,14919,7517,7402,101.6
33040, 청주시,060002, 56세,2016,13100,6471,6629,97.6,12882,6354,6528,97.3
33040, 청주시,060003, 57세,2016,12146,5936,6210,95.6,11992,5861,6131,95.6
33040, 청주시,060004, 58세,2016,11716,5930,5786,102.5,11526,5830,5696,102.4
33040, 청주시,060005, 59세,2016,11415,5651,5764,98,11251,5579,5672,98.4
33040, 청주시,065,60~64세,2016,43817,21721,22096,98.3,43266,21422,21844,98.1
33040, 청주시,065001, 60세,2016,10151,5151,5000,103,10023,5085,4938,103
33040, 청주시,065002, 61세,2016,9820,4757,5063,94,9700,4688,5012,93.5
33040, 청주시,065003, 62세,2016,8544,4262,4282,99.5,8428,4200,4228,99.3
33040, 청주시,065004, 63세,2016,7321,3600,3721,96.7,7218,3546,3672,96.6
33040, 청주시,065005, 64세,2016,7981,3951,4030,98,7897,3903,3994,97.7
33040, 청주시,070,65~69세,2016,27948,13444,14504,92.7,27700,13324,14376,92.7
33040, 청주시,070001, 65세,2016,5344,2572,2772,92.8,5274,2536,2738,92.6
33040, 청주시,070002, 66세,2016,5619,2717,2902,93.6,5573,2701,2872,94
33040, 청주시,070003, 67세,2016,5761,2819,2942,95.8,5693,2790,2903,96.1
33040, 청주시,070004, 68세,2016,5763,2789,2974,93.8,5729,2766,2963,93.4
33040, 청주시,070005, 69세,2016,5461,2547,2914,87.4,5431,2531,2900,87.3
33040, 청주시,075,70~74세,2016,23058,10295,12763,80.7,22968,10253,12715,80.6
33040, 청주시,075001, 70세,2016,4172,1978,2194,90.2,4150,1969,2181,90.3
33040, 청주시,075002, 71세,2016,4469,2083,2386,87.3,4442,2069,2373,87.2
33040, 청주시,075003, 72세,2016,4389,1887,2502,75.4,4373,1879,2494,75.3
33040, 청주시,075004, 73세,2016,4606,2004,2602,77,4590,1995,2595,76.9
33040, 청주시,075005, 74세,2016,5422,2343,3079,76.1,5413,2341,3072,76.2
33040, 청주시,080,75~79세,2016,18966,7575,11391,66.5,18908,7557,11351,66.6
33040, 청주시,080001, 75세,2016,4224,1731,2493,69.4,4213,1730,2483,69.7
33040, 청주시,080002, 76세,2016,3864,1595,2269,70.3,3856,1594,2262,70.5
33040, 청주시,080003, 77세,2016,3961,1601,2360,67.8,3950,1598,2352,67.9
33040, 청주시,080004, 78세,2016,3520,1340,2180,61.5,3499,1330,2169,61.3
33040, 청주시,080005, 79세,2016,3397,1308,2089,62.6,3390,1305,2085,62.6
33040, 청주시,085,80~84세,2016,12661,4224,8437,50.1,12633,4209,8424,50
33040, 청주시,085001, 80세,2016,3221,1165,2056,56.7,3215,1162,2053,56.6
33040, 청주시,085002, 81세,2016,3062,1095,1967,55.7,3057,1092,1965,55.6
33040, 청주시,085003, 82세,2016,2457,799,1658,48.2,2450,795,1655,48
33040, 청주시,085004, 83세,2016,2127,666,1461,45.6,2124,666,1458,45.7
33040, 청주시,085005, 84세,2016,1794,499,1295,38.5,1787,494,1293,38.2
33040, 청주시,090,85~89세,2016,5529,1370,4159,32.9,5516,1365,4151,32.9
33040, 청주시,090001, 85세,2016,1296,349,947,36.9,1293,347,946,36.7
33040, 청주시,090002, 86세,2016,1392,349,1043,33.5,1389,347,1042,33.3
33040, 청주시,090003, 87세,2016,1173,263,910,28.9,1169,263,906,29
33040, 청주시,090004, 88세,2016,913,236,677,34.9,911,236,675,35
33040, 청주시,090005, 89세,2016,755,173,582,29.7,754,172,582,29.6
33040, 청주시,095,90~94세,2016,1780,369,1411,26.2,1770,366,1404,26.1
33040, 청주시,095001, 90세,2016,478,102,376,27.1,477,102,375,27.2
33040, 청주시,095002, 91세,2016,474,92,382,24.1,474,92,382,24.1
33040, 청주시,095003, 92세,2016,295,63,232,27.2,291,60,231,26
33040, 청주시,095004, 93세,2016,291,63,228,27.6,289,63,226,27.9
33040, 청주시,095005, 94세,2016,242,49,193,25.4,239,49,190,25.8
33040, 청주시,100,95~99세,2016,385,56,329,17,384,55,329,16.7
33040, 청주시,100001, 95세,2016,164,31,133,23.3,164,31,133,23.3
33040, 청주시,100002, 96세,2016,85,9,76,11.8,85,9,76,11.8
33040, 청주시,100003, 97세,2016,66,9,57,15.8,66,9,57,15.8
33040, 청주시,100004, 98세,2016,44,X,41,7.3,44,X,41,7.3
33040, 청주시,100005, 99세,2016,26,X,22,18.2,25,X,22,13.6
33040, 청주시,101,100세이상,2016,48,5,43,11.6,47,5,42,11.9
33040, 청주시,102,15세미만,2016,125991,64933,61058,106.3,125398,64632,60766,106.4
33040, 청주시,103,15~64세,2016,623972,319659,304313,105,610250,312015,298235,104.6
33040, 청주시,104,65세이상,2016,90375,37338,53037,70.4,89926,37134,52792,70.3
33040, 청주시,086,85세이상,2016,7742,1800,5942,30.3,7717,1791,5926,30.2
33040, 청주시,126,평균연령,2016,38.7,37.6,39.8,,38.7,37.6,39.9,
33040, 청주시,127,중위연령,2016,38.9,37.6,40.2,,39,37.7,40.3,
33041, 상당구,000,합계,2016,169463,84734,84729,100,168138,84083,84055,100
33041, 상당구,005,0~4세,2016,6918,3544,3374,105,6906,3538,3368,105
33041, 상당구,005001, 0세,2016,1176,606,570,106.3,1174,605,569,106.3
33041, 상당구,005002, 1세,2016,1339,687,652,105.4,1337,686,651,105.4
33041, 상당구,005003, 2세,2016,1341,677,664,102,1338,675,663,101.8
33041, 상당구,005004, 3세,2016,1447,740,707,104.7,1444,739,705,104.8
33041, 상당구,005005, 4세,2016,1615,834,781,106.8,1613,833,780,106.8
33041, 상당구,010,5~9세,2016,7905,4128,3777,109.3,7891,4121,3770,109.3
33041, 상당구,010001, 5세,2016,1578,800,778,102.8,1571,797,774,103
33041, 상당구,010002, 6세,2016,1606,882,724,121.8,1603,880,723,121.7
33041, 상당구,010003, 7세,2016,1447,762,685,111.2,1447,762,685,111.2
33041, 상당구,010004, 8세,2016,1548,781,767,101.8,1547,781,766,102
33041, 상당구,010005, 9세,2016,1726,903,823,109.7,1723,901,822,109.6
33041, 상당구,015,10~14세,2016,8626,4465,4161,107.3,8616,4461,4155,107.4
33041, 상당구,015001, 10세,2016,1516,757,759,99.7,1516,757,759,99.7
33041, 상당구,015002, 11세,2016,1563,808,755,107,1561,808,753,107.3
33041, 상당구,015003, 12세,2016,1778,922,856,107.7,1774,920,854,107.7
33041, 상당구,015004, 13세,2016,1801,927,874,106.1,1799,926,873,106.1
33041, 상당구,015005, 14세,2016,1968,1051,917,114.6,1966,1050,916,114.6
33041, 상당구,020,15~19세,2016,11793,6318,5475,115.4,11778,6313,5465,115.5
33041, 상당구,020001, 15세,2016,2225,1174,1051,111.7,2222,1173,1049,111.8
33041, 상당구,020002, 16세,2016,2540,1346,1194,112.7,2539,1346,1193,112.8
33041, 상당구,020003, 17세,2016,2496,1343,1153,116.5,2494,1341,1153,116.3
33041, 상당구,020004, 18세,2016,2459,1349,1110,121.5,2457,1348,1109,121.6
33041, 상당구,020005, 19세,2016,2073,1106,967,114.4,2066,1105,961,115
33041, 상당구,025,20~24세,2016,11779,6582,5197,126.6,11631,6493,5138,126.4
33041, 상당구,025001, 20세,2016,2380,1371,1009,135.9,2368,1366,1002,136.3
33041, 상당구,025002, 21세,2016,2379,1347,1032,130.5,2347,1323,1024,129.2
33041, 상당구,025003, 22세,2016,2353,1348,1005,134.1,2320,1327,993,133.6
33041, 상당구,025004, 23세,2016,2353,1273,1080,117.9,2318,1254,1064,117.9
33041, 상당구,025005, 24세,2016,2314,1243,1071,116.1,2278,1223,1055,115.9
33041, 상당구,030,25~29세,2016,9305,4955,4350,113.9,9063,4828,4235,114
33041, 상당구,030001, 25세,2016,2043,1087,956,113.7,2007,1071,936,114.4
33041, 상당구,030002, 26세,2016,2005,1090,915,119.1,1952,1062,890,119.3
33041, 상당구,030003, 27세,2016,1728,934,794,117.6,1680,905,775,116.8
33041, 상당구,030004, 28세,2016,1785,904,881,102.6,1722,874,848,103.1
33041, 상당구,030005, 29세,2016,1744,940,804,116.9,1702,916,786,116.5
33041, 상당구,035,30~34세,2016,9866,5049,4817,104.8,9706,4964,4742,104.7
33041, 상당구,035001, 30세,2016,1764,935,829,112.8,1728,919,809,113.6
33041, 상당구,035002, 31세,2016,1786,956,830,115.2,1757,935,822,113.7
33041, 상당구,035003, 32세,2016,1897,985,912,108,1864,967,897,107.8
33041, 상당구,035004, 33세,2016,2077,1003,1074,93.4,2047,989,1058,93.5
33041, 상당구,035005, 34세,2016,2342,1170,1172,99.8,2310,1154,1156,99.8
33041, 상당구,040,35~39세,2016,11796,5922,5874,100.8,11684,5874,5810,101.1
33041, 상당구,040001, 35세,2016,2303,1176,1127,104.3,2278,1167,1111,105
33041, 상당구,040002, 36세,2016,2518,1273,1245,102.2,2501,1267,1234,102.7
33041, 상당구,040003, 37세,2016,2382,1219,1163,104.8,2353,1206,1147,105.1
33041, 상당구,040004, 38세,2016,2208,1086,1122,96.8,2187,1077,1110,97
33041, 상당구,040005, 39세,2016,2385,1168,1217,96,2365,1157,1208,95.8
33041, 상당구,045,40~44세,2016,13586,6772,6814,99.4,13469,6722,6747,99.6
33041, 상당구,045001, 40세,2016,2375,1195,1180,101.3,2349,1184,1165,101.6
33041, 상당구,045002, 41세,2016,2589,1285,1304,98.5,2566,1276,1290,98.9
33041, 상당구,045003, 42세,2016,2856,1413,1443,97.9,2838,1408,1430,98.5
33041, 상당구,045004, 43세,2016,2950,1427,1523,93.7,2924,1414,1510,93.6
33041, 상당구,045005, 44세,2016,2816,1452,1364,106.5,2792,1440,1352,106.5
33041, 상당구,050,45~49세,2016,15773,7729,8044,96.1,15655,7669,7986,96
33041, 상당구,050001, 45세,2016,3129,1574,1555,101.2,3093,1553,1540,100.8
33041, 상당구,050002, 46세,2016,3049,1520,1529,99.4,3032,1511,1521,99.3
33041, 상당구,050003, 47세,2016,3321,1591,1730,92,3299,1578,1721,91.7
33041, 상당구,050004, 48세,2016,3260,1571,1689,93,3236,1559,1677,93
33041, 상당구,050005, 49세,2016,3014,1473,1541,95.6,2995,1468,1527,96.1
33041, 상당구,055,50~54세,2016,14602,7501,7101,105.6,14449,7437,7012,106.1
33041, 상당구,055001, 50세,2016,3011,1531,1480,103.4,2978,1520,1458,104.3
33041, 상당구,055002, 51세,2016,3053,1513,1540,98.2,3031,1507,1524,98.9
33041, 상당구,055003, 52세,2016,2659,1358,1301,104.4,2630,1348,1282,105.1
33041, 상당구,055004, 53세,2016,2839,1520,1319,115.2,2798,1497,1301,115.1
33041, 상당구,055005, 54세,2016,3040,1579,1461,108.1,3012,1565,1447,108.2
33041, 상당구,060,55~59세,2016,14267,7171,7096,101.1,14183,7131,7052,101.1
33041, 상당구,060001, 55세,2016,3357,1726,1631,105.8,3342,1721,1621,106.2
33041, 상당구,060002, 56세,2016,2915,1444,1471,98.2,2901,1437,1464,98.2
33041, 상당구,060003, 57세,2016,2651,1279,1372,93.2,2641,1275,1366,93.3
33041, 상당구,060004, 58세,2016,2678,1362,1316,103.5,2652,1346,1306,103.1
33041, 상당구,060005, 59세,2016,2666,1360,1306,104.1,2647,1352,1295,104.4
33041, 상당구,065,60~64세,2016,10342,5140,5202,98.8,10273,5106,5167,98.8
33041, 상당구,065001, 60세,2016,2324,1177,1147,102.6,2308,1169,1139,102.6
33041, 상당구,065002, 61세,2016,2264,1087,1177,92.4,2253,1081,1172,92.2
33041, 상당구,065003, 62세,2016,2040,1056,984,107.3,2026,1048,978,107.2
33041, 상당구,065004, 63세,2016,1779,859,920,93.4,1761,851,910,93.5
33041, 상당구,065005, 64세,2016,1935,961,974,98.7,1925,957,968,98.9
33041, 상당구,070,65~69세,2016,6780,3270,3510,93.2,6745,3255,3490,93.3
33041, 상당구,070001, 65세,2016,1253,623,630,98.9,1247,619,628,98.6
33041, 상당구,070002, 66세,2016,1342,643,699,92,1333,641,692,92.6
33041, 상당구,070003, 67세,2016,1390,694,696,99.7,1381,692,689,100.4
33041, 상당구,070004, 68세,2016,1429,675,754,89.5,1422,672,750,89.6
33041, 상당구,070005, 69세,2016,1366,635,731,86.9,1362,631,731,86.3
33041, 상당구,075,70~74세,2016,5893,2600,3293,79,5873,2589,3284,78.8
33041, 상당구,075001, 70세,2016,1022,492,530,92.8,1018,489,529,92.4
33041, 상당구,075002, 71세,2016,1120,520,600,86.7,1112,517,595,86.9
33041, 상당구,075003, 72세,2016,1128,480,648,74.1,1126,478,648,73.8
33041, 상당구,075004, 73세,2016,1166,497,669,74.3,1163,494,669,73.8
33041, 상당구,075005, 74세,2016,1457,611,846,72.2,1454,611,843,72.5
33041, 상당구,080,75~79세,2016,4938,1984,2954,67.2,4926,1981,2945,67.3
33041, 상당구,080001, 75세,2016,1102,465,637,73,1100,465,635,73.2
33041, 상당구,080002, 76세,2016,999,407,592,68.8,997,407,590,69
33041, 상당구,080003, 77세,2016,1030,445,585,76.1,1030,445,585,76.1
33041, 상당구,080004, 78세,2016,903,344,559,61.5,896,341,555,61.4
33041, 상당구,080005, 79세,2016,904,323,581,55.6,903,323,580,55.7
33041, 상당구,085,80~84세,2016,3284,1109,2175,51,3282,1107,2175,50.9
33041, 상당구,085001, 80세,2016,838,309,529,58.4,837,308,529,58.2
33041, 상당구,085002, 81세,2016,809,299,510,58.6,809,299,510,58.6
33041, 상당구,085003, 82세,2016,639,214,425,50.4,638,213,425,50.1
33041, 상당구,085004, 83세,2016,529,157,372,42.2,529,157,372,42.2
33041, 상당구,085005, 84세,2016,469,130,339,38.3,469,130,339,38.3
33041, 상당구,090,85~89세,2016,1450,381,1069,35.6,1450,381,1069,35.6
33041, 상당구,090001, 85세,2016,310,80,230,34.8,310,80,230,34.8
33041, 상당구,090002, 86세,2016,376,96,280,34.3,376,96,280,34.3
33041, 상당구,090003, 87세,2016,327,88,239,36.8,327,88,239,36.8
33041, 상당구,090004, 88세,2016,242,66,176,37.5,242,66,176,37.5
33041, 상당구,090005, 89세,2016,195,51,144,35.4,195,51,144,35.4
33041, 상당구,095,90~94세,2016,454,96,358,26.8,453,96,357,26.9
33041, 상당구,095001, 90세,2016,125,25,100,25,125,25,100,25
33041, 상당구,095002, 91세,2016,113,27,86,31.4,113,27,86,31.4
33041, 상당구,095003, 92세,2016,83,14,69,20.3,83,14,69,20.3
33041, 상당구,095004, 93세,2016,64,14,50,28,64,14,50,28
33041, 상당구,095005, 94세,2016,69,16,53,30.2,68,16,52,30.8
33041, 상당구,100,95~99세,2016,96,18,78,23.1,95,17,78,21.8
33041, 상당구,100001, 95세,2016,48,13,35,37.1,48,13,35,37.1
33041, 상당구,100002, 96세,2016,20,X,17,17.6,20,X,17,17.6
33041, 상당구,100003, 97세,2016,11,X,11,0,11,X,11,0
33041, 상당구,100004, 98세,2016,11,X,11,0,11,X,11,0
33041, 상당구,100005, 99세,2016,6,X,X,50,5,X,X,25
33041, 상당구,101,100세이상,2016,10,X,10,0,10,X,10,0
33041, 상당구,102,15세미만,2016,23449,12137,11312,107.3,23413,12120,11293,107.3
33041, 상당구,103,15~64세,2016,123109,63139,59970,105.3,121891,62537,59354,105.4
33041, 상당구,104,65세이상,2016,22905,9458,13447,70.3,22834,9426,13408,70.3
33041, 상당구,086,85세이상,2016,2010,495,1515,32.7,2008,494,1514,32.6
33041, 상당구,126,평균연령,2016,41,39.6,42.4,,41,39.6,42.4,
33041, 상당구,127,중위연령,2016,42.6,41.2,43.9,,42.7,41.2,44,
33042, 서원구,000,합계,2016,221143,109708,111435,98.5,217869,108057,109812,98.4
33042, 서원구,005,0~4세,2016,9822,5046,4776,105.7,9756,5014,4742,105.7
33042, 서원구,005001, 0세,2016,1812,914,898,101.8,1801,906,895,101.2
33042, 서원구,005002, 1세,2016,1924,1011,913,110.7,1910,1005,905,111
33042, 서원구,005003, 2세,2016,1896,985,911,108.1,1886,980,906,108.2
33042, 서원구,005004, 3세,2016,1993,1001,992,100.9,1976,996,980,101.6
33042, 서원구,005005, 4세,2016,2197,1135,1062,106.9,2183,1127,1056,106.7
33042, 서원구,010,5~9세,2016,10734,5525,5209,106.1,10678,5494,5184,106
33042, 서원구,010001, 5세,2016,2183,1094,1089,100.5,2178,1092,1086,100.6
33042, 서원구,010002, 6세,2016,2078,1084,994,109.1,2063,1075,988,108.8
33042, 서원구,010003, 7세,2016,2074,1090,984,110.8,2060,1084,976,111.1
33042, 서원구,010004, 8세,2016,2170,1105,1065,103.8,2160,1099,1061,103.6
33042, 서원구,010005, 9세,2016,2229,1152,1077,107,2217,1144,1073,106.6
33042, 서원구,015,10~14세,2016,11228,5874,5354,109.7,11178,5850,5328,109.8
33042, 서원구,015001, 10세,2016,2075,1054,1021,103.2,2068,1051,1017,103.3
33042, 서원구,015002, 11세,2016,2097,1057,1040,101.6,2091,1054,1037,101.6
33042, 서원구,015003, 12세,2016,2236,1184,1052,112.5,2223,1177,1046,112.5
33042, 서원구,015004, 13세,2016,2399,1286,1113,115.5,2389,1280,1109,115.4
33042, 서원구,015005, 14세,2016,2421,1293,1128,114.6,2407,1288,1119,115.1
33042, 서원구,020,15~19세,2016,16425,8374,8051,104,16302,8319,7983,104.2
33042, 서원구,020001, 15세,2016,2753,1398,1355,103.2,2737,1390,1347,103.2
33042, 서원구,020002, 16세,2016,2805,1506,1299,115.9,2787,1496,1291,115.9
33042, 서원구,020003, 17세,2016,2869,1566,1303,120.2,2858,1559,1299,120
33042, 서원구,020004, 18세,2016,3512,1757,1755,100.1,3490,1747,1743,100.2
33042, 서원구,020005, 19세,2016,4486,2147,2339,91.8,4430,2127,2303,92.4
33042, 서원구,025,20~24세,2016,19930,10635,9295,114.4,19346,10342,9004,114.9
33042, 서원구,025001, 20세,2016,4142,2019,2123,95.1,4024,1968,2056,95.7
33042, 서원구,025002, 21세,2016,4048,1999,2049,97.6,3922,1943,1979,98.2
33042, 서원구,025003, 22세,2016,4115,2245,1870,120.1,4001,2183,1818,120.1
33042, 서원구,025004, 23세,2016,3938,2223,1715,129.6,3825,2163,1662,130.1
33042, 서원구,025005, 24세,2016,3687,2149,1538,139.7,3574,2085,1489,140
33042, 서원구,030,25~29세,2016,14301,7706,6595,116.8,13758,7409,6349,116.7
33042, 서원구,030001, 25세,2016,3299,1859,1440,129.1,3205,1817,1388,130.9
33042, 서원구,030002, 26세,2016,2974,1656,1318,125.6,2855,1590,1265,125.7
33042, 서원구,030003, 27세,2016,2727,1499,1228,122.1,2621,1437,1184,121.4
33042, 서원구,030004, 28세,2016,2617,1344,1273,105.6,2506,1279,1227,104.2
33042, 서원구,030005, 29세,2016,2684,1348,1336,100.9,2571,1286,1285,100.1
33042, 서원구,035,30~34세,2016,14531,7387,7144,103.4,14084,7147,6937,103
33042, 서원구,035001, 30세,2016,2605,1393,1212,114.9,2490,1327,1163,114.1
33042, 서원구,035002, 31세,2016,2631,1323,1308,101.1,2550,1283,1267,101.3
33042, 서원구,035003, 32세,2016,2865,1477,1388,106.4,2773,1424,1349,105.6
33042, 서원구,035004, 33세,2016,3016,1497,1519,98.6,2929,1448,1481,97.8
33042, 서원구,035005, 34세,2016,3414,1697,1717,98.8,3342,1665,1677,99.3
33042, 서원구,040,35~39세,2016,16077,8045,8032,100.2,15787,7889,7898,99.9
33042, 서원구,040001, 35세,2016,3266,1646,1620,101.6,3189,1609,1580,101.8
33042, 서원구,040002, 36세,2016,3345,1670,1675,99.7,3287,1638,1649,99.3
33042, 서원구,040003, 37세,2016,3220,1604,1616,99.3,3176,1578,1598,98.7
33042, 서원구,040004, 38세,2016,3059,1528,1531,99.8,3002,1502,1500,100.1
33042, 서원구,040005, 39세,2016,3187,1597,1590,100.4,3133,1562,1571,99.4
33042, 서원구,045,40~44세,2016,17857,8691,9166,94.8,17620,8576,9044,94.8
33042, 서원구,045001, 40세,2016,3229,1620,1609,100.7,3172,1592,1580,100.8
33042, 서원구,045002, 41세,2016,3376,1602,1774,90.3,3337,1584,1753,90.4
33042, 서원구,045003, 42세,2016,3798,1878,1920,97.8,3753,1857,1896,97.9
33042, 서원구,045004, 43세,2016,3804,1788,2016,88.7,3759,1767,1992,88.7
33042, 서원구,045005, 44세,2016,3650,1803,1847,97.6,3599,1776,1823,97.4
33042, 서원구,050,45~49세,2016,19875,9608,10267,93.6,19640,9494,10146,93.6
33042, 서원구,050001, 45세,2016,3905,1918,1987,96.5,3861,1902,1959,97.1
33042, 서원구,050002, 46세,2016,3859,1894,1965,96.4,3807,1867,1940,96.2
33042, 서원구,050003, 47세,2016,4265,2037,2228,91.4,4220,2017,2203,91.6
33042, 서원구,050004, 48세,2016,4060,1902,2158,88.1,4005,1871,2134,87.7
33042, 서원구,050005, 49세,2016,3786,1857,1929,96.3,3747,1837,1910,96.2
33042, 서원구,055,50~54세,2016,17353,8700,8653,100.5,17124,8604,8520,101
33042, 서원구,055001, 50세,2016,3540,1780,1760,101.1,3497,1760,1737,101.3
33042, 서원구,055002, 51세,2016,3677,1845,1832,100.7,3630,1824,1806,101
33042, 서원구,055003, 52세,2016,3138,1535,1603,95.8,3093,1522,1571,96.9
33042, 서원구,055004, 53세,2016,3368,1719,1649,104.2,3327,1698,1629,104.2
33042, 서원구,055005, 54세,2016,3630,1821,1809,100.7,3577,1800,1777,101.3
33042, 서원구,060,55~59세,2016,17204,8464,8740,96.8,17007,8364,8643,96.8
33042, 서원구,060001, 55세,2016,4042,2008,2034,98.7,4011,1998,2013,99.3
33042, 서원구,060002, 56세,2016,3569,1740,1829,95.1,3515,1710,1805,94.7
33042, 서원구,060003, 57세,2016,3262,1550,1712,90.5,3227,1533,1694,90.5
33042, 서원구,060004, 58세,2016,3183,1591,1592,99.9,3133,1564,1569,99.7
33042, 서원구,060005, 59세,2016,3148,1575,1573,100.1,3121,1559,1562,99.8
33042, 서원구,065,60~64세,2016,11782,5801,5981,97,11665,5740,5925,96.9
33042, 서원구,065001, 60세,2016,2739,1367,1372,99.6,2726,1360,1366,99.6
33042, 서원구,065002, 61세,2016,2600,1269,1331,95.3,2571,1254,1317,95.2
33042, 서원구,065003, 62세,2016,2320,1174,1146,102.4,2284,1158,1126,102.8
33042, 서원구,065004, 63세,2016,1970,930,1040,89.4,1949,916,1033,88.7
33042, 서원구,065005, 64세,2016,2153,1061,1092,97.2,2135,1052,1083,97.1
33042, 서원구,070,65~69세,2016,7503,3532,3971,88.9,7452,3512,3940,89.1
33042, 서원구,070001, 65세,2016,1440,670,770,87,1426,663,763,86.9
33042, 서원구,070002, 66세,2016,1530,718,812,88.4,1519,713,806,88.5
33042, 서원구,070003, 67세,2016,1534,718,816,88,1515,712,803,88.7
33042, 서원구,070004, 68세,2016,1533,748,785,95.3,1530,747,783,95.4
33042, 서원구,070005, 69세,2016,1466,678,788,86,1462,677,785,86.2
33042, 서원구,075,70~74세,2016,6066,2736,3330,82.2,6044,2729,3315,82.3
33042, 서원구,075001, 70세,2016,1098,517,581,89,1091,514,577,89.1
33042, 서원구,075002, 71세,2016,1196,558,638,87.5,1192,556,636,87.4
33042, 서원구,075003, 72세,2016,1167,528,639,82.6,1164,527,637,82.7
33042, 서원구,075004, 73세,2016,1207,521,686,75.9,1203,520,683,76.1
33042, 서원구,075005, 74세,2016,1398,612,786,77.9,1394,612,782,78.3
33042, 서원구,080,75~79세,2016,5006,2008,2998,67,4993,2005,2988,67.1
33042, 서원구,080001, 75세,2016,1134,455,679,67,1133,455,678,67.1
33042, 서원구,080002, 76세,2016,1027,423,604,70,1025,423,602,70.3
33042, 서원구,080003, 77세,2016,1035,412,623,66.1,1033,411,622,66.1
33042, 서원구,080004, 78세,2016,919,361,558,64.7,914,359,555,64.7
33042, 서원구,080005, 79세,2016,891,357,534,66.9,888,357,531,67.2
33042, 서원구,085,80~84세,2016,3330,1117,2213,50.5,3320,1111,2209,50.3
33042, 서원구,085001, 80세,2016,850,321,529,60.7,849,320,529,60.5
33042, 서원구,085002, 81세,2016,806,294,512,57.4,805,293,512,57.2
33042, 서원구,085003, 82세,2016,627,190,437,43.5,625,189,436,43.3
33042, 서원구,085004, 83세,2016,581,191,390,49,579,191,388,49.2
33042, 서원구,085005, 84세,2016,466,121,345,35.1,462,118,344,34.3
33042, 서원구,090,85~89세,2016,1490,350,1140,30.7,1488,349,1139,30.6
33042, 서원구,090001, 85세,2016,352,81,271,29.9,352,81,271,29.9
33042, 서원구,090002, 86세,2016,391,102,289,35.3,390,101,289,34.9
33042, 서원구,090003, 87세,2016,296,58,238,24.4,295,58,237,24.5
33042, 서원구,090004, 88세,2016,244,65,179,36.3,244,65,179,36.3
33042, 서원구,090005, 89세,2016,207,44,163,27,207,44,163,27
33042, 서원구,095,90~94세,2016,519,93,426,21.8,517,93,424,21.9
33042, 서원구,095001, 90세,2016,145,29,116,25,145,29,116,25
33042, 서원구,095002, 91세,2016,145,21,124,16.9,145,21,124,16.9
33042, 서원구,095003, 92세,2016,77,17,60,28.3,77,17,60,28.3
33042, 서원구,095004, 93세,2016,82,15,67,22.4,81,15,66,22.7
33042, 서원구,095005, 94세,2016,70,11,59,18.6,69,11,58,19
33042, 서원구,100,95~99세,2016,95,14,81,17.3,95,14,81,17.3
33042, 서원구,100001, 95세,2016,42,7,35,20,42,7,35,20
33042, 서원구,100002, 96세,2016,18,X,15,20,18,X,15,20
33042, 서원구,100003, 97세,2016,19,X,17,11.8,19,X,17,11.8
33042, 서원구,100004, 98세,2016,10,X,9,11.1,10,X,9,11.1
33042, 서원구,100005, 99세,2016,6,X,5,20,6,X,5,20
33042, 서원구,101,100세이상,2016,15,X,13,15.4,15,X,13,15.4
33042, 서원구,102,15세미만,2016,31784,16445,15339,107.2,31612,16358,15254,107.2
33042, 서원구,103,15~64세,2016,165335,83411,81924,101.8,162333,81884,80449,101.8
33042, 서원구,104,65세이상,2016,24024,9852,14172,69.5,23924,9815,14109,69.6
33042, 서원구,086,85세이상,2016,2119,459,1660,27.7,2115,458,1657,27.6
33042, 서원구,126,평균연령,2016,38.8,37.6,40.1,,38.9,37.6,40.1,
33042, 서원구,127,중위연령,2016,39.2,37.6,40.8,,39.4,37.8,40.9,
33043, 흥덕구,000,합계,2016,257050,129285,127765,101.2,251541,126314,125227,100.9
33043, 흥덕구,005,0~4세,2016,12635,6432,6203,103.7,12527,6377,6150,103.7
33043, 흥덕구,005001, 0세,2016,2414,1257,1157,108.6,2396,1247,1149,108.5
33043, 흥덕구,005002, 1세,2016,2530,1284,1246,103,2516,1278,1238,103.2
33043, 흥덕구,005003, 2세,2016,2498,1232,1266,97.3,2468,1214,1254,96.8
33043, 흥덕구,005004, 3세,2016,2556,1323,1233,107.3,2532,1312,1220,107.5
33043, 흥덕구,005005, 4세,2016,2637,1336,1301,102.7,2615,1326,1289,102.9
33043, 흥덕구,010,5~9세,2016,13073,6742,6331,106.5,12984,6690,6294,106.3
33043, 흥덕구,010001, 5세,2016,2731,1378,1353,101.8,2710,1365,1345,101.5
33043, 흥덕구,010002, 6세,2016,2615,1325,1290,102.7,2597,1314,1283,102.4
33043, 흥덕구,010003, 7세,2016,2518,1297,1221,106.2,2506,1288,1218,105.7
33043, 흥덕구,010004, 8세,2016,2598,1373,1225,112.1,2580,1365,1215,112.3
33043, 흥덕구,010005, 9세,2016,2611,1369,1242,110.2,2591,1358,1233,110.1
33043, 흥덕구,015,10~14세,2016,12817,6660,6157,108.2,12766,6639,6127,108.4
33043, 흥덕구,015001, 10세,2016,2452,1273,1179,108,2442,1269,1173,108.2
33043, 흥덕구,015002, 11세,2016,2354,1205,1149,104.9,2344,1199,1145,104.7
33043, 흥덕구,015003, 12세,2016,2672,1406,1266,111.1,2660,1402,1258,111.4
33043, 흥덕구,015004, 13세,2016,2653,1373,1280,107.3,2646,1371,1275,107.5
33043, 흥덕구,015005, 14세,2016,2686,1403,1283,109.4,2674,1398,1276,109.6
33043, 흥덕구,020,15~19세,2016,17050,8863,8187,108.3,16970,8826,8144,108.4
33043, 흥덕구,020001, 15세,2016,3098,1665,1433,116.2,3090,1659,1431,115.9
33043, 흥덕구,020002, 16세,2016,3486,1849,1637,113,3479,1844,1635,112.8
33043, 흥덕구,020003, 17세,2016,3303,1759,1544,113.9,3294,1755,1539,114
33043, 흥덕구,020004, 18세,2016,3498,1757,1741,100.9,3479,1748,1731,101
33043, 흥덕구,020005, 19세,2016,3665,1833,1832,100.1,3628,1820,1808,100.7
33043, 흥덕구,025,20~24세,2016,20380,10583,9797,108,19765,10272,9493,108.2
33043, 흥덕구,025001, 20세,2016,4091,2085,2006,103.9,3996,2037,1959,104
33043, 흥덕구,025002, 21세,2016,3994,2016,1978,101.9,3887,1963,1924,102
33043, 흥덕구,025003, 22세,2016,4166,2170,1996,108.7,4040,2101,1939,108.4
33043, 흥덕구,025004, 23세,2016,4081,2178,1903,114.5,3936,2105,1831,115
33043, 흥덕구,025005, 24세,2016,4048,2134,1914,111.5,3906,2066,1840,112.3
33043, 흥덕구,030,25~29세,2016,19612,10312,9300,110.9,18635,9803,8832,111
33043, 흥덕구,030001, 25세,2016,3952,2098,1854,113.2,3790,2016,1774,113.6
33043, 흥덕구,030002, 26세,2016,3951,2087,1864,112,3721,1960,1761,111.3
33043, 흥덕구,030003, 27세,2016,3954,2081,1873,111.1,3762,1986,1776,111.8
33043, 흥덕구,030004, 28세,2016,3839,1993,1846,108,3653,1891,1762,107.3
33043, 흥덕구,030005, 29세,2016,3916,2053,1863,110.2,3709,1950,1759,110.9
33043, 흥덕구,035,30~34세,2016,20718,10662,10056,106,19898,10197,9701,105.1
33043, 흥덕구,035001, 30세,2016,3919,2048,1871,109.5,3720,1931,1789,107.9
33043, 흥덕구,035002, 31세,2016,3787,1967,1820,108.1,3623,1875,1748,107.3
33043, 흥덕구,035003, 32세,2016,4032,2080,1952,106.6,3884,2004,1880,106.6
33043, 흥덕구,035004, 33세,2016,4311,2241,2070,108.3,4144,2140,2004,106.8
33043, 흥덕구,035005, 34세,2016,4669,2326,2343,99.3,4527,2247,2280,98.6
33043, 흥덕구,040,35~39세,2016,20984,10767,10217,105.4,20340,10354,9986,103.7
33043, 흥덕구,040001, 35세,2016,4318,2223,2095,106.1,4171,2135,2036,104.9
33043, 흥덕구,040002, 36세,2016,4365,2227,2138,104.2,4245,2150,2095,102.6
33043, 흥덕구,040003, 37세,2016,4273,2211,2062,107.2,4135,2123,2012,105.5
33043, 흥덕구,040004, 38세,2016,3947,2079,1868,111.3,3800,1983,1817,109.1
33043, 흥덕구,040005, 39세,2016,4081,2027,2054,98.7,3989,1963,2026,96.9
33043, 흥덕구,045,40~44세,2016,21537,10858,10679,101.7,21056,10586,10470,101.1
33043, 흥덕구,045001, 40세,2016,3985,2029,1956,103.7,3880,1969,1911,103
33043, 흥덕구,045002, 41세,2016,4225,2136,2089,102.2,4122,2084,2038,102.3
33043, 흥덕구,045003, 42세,2016,4532,2248,2284,98.4,4443,2196,2247,97.7
33043, 흥덕구,045004, 43세,2016,4578,2297,2281,100.7,4491,2244,2247,99.9
33043, 흥덕구,045005, 44세,2016,4217,2148,2069,103.8,4120,2093,2027,103.3
33043, 흥덕구,050,45~49세,2016,23377,11743,11634,100.9,22877,11468,11409,100.5
33043, 흥덕구,050001, 45세,2016,4738,2442,2296,106.4,4631,2378,2253,105.5
33043, 흥덕구,050002, 46세,2016,4689,2351,2338,100.6,4580,2289,2291,99.9
33043, 흥덕구,050003, 47세,2016,4987,2489,2498,99.6,4887,2432,2455,99.1
33043, 흥덕구,050004, 48세,2016,4731,2323,2408,96.5,4617,2267,2350,96.5
33043, 흥덕구,050005, 49세,2016,4232,2138,2094,102.1,4162,2102,2060,102
33043, 흥덕구,055,50~54세,2016,20211,10175,10036,101.4,19731,9935,9796,101.4
33043, 흥덕구,055001, 50세,2016,4125,2032,2093,97.1,4037,1989,2048,97.1
33043, 흥덕구,055002, 51세,2016,4229,2042,2187,93.4,4141,1996,2145,93.1
33043, 흥덕구,055003, 52세,2016,3787,1964,1823,107.7,3695,1919,1776,108.1
33043, 흥덕구,055004, 53세,2016,3905,2005,1900,105.5,3793,1951,1842,105.9
33043, 흥덕구,055005, 54세,2016,4165,2132,2033,104.9,4065,2080,1985,104.8
33043, 흥덕구,060,55~59세,2016,18881,9501,9380,101.3,18547,9350,9197,101.7
33043, 흥덕구,060001, 55세,2016,4632,2372,2260,105,4577,2346,2231,105.2
33043, 흥덕구,060002, 56세,2016,3952,1985,1967,100.9,3863,1942,1921,101.1
33043, 흥덕구,060003, 57세,2016,3604,1805,1799,100.3,3546,1777,1769,100.5
33043, 흥덕구,060004, 58세,2016,3441,1780,1661,107.2,3381,1751,1630,107.4
33043, 흥덕구,060005, 59세,2016,3252,1559,1693,92.1,3180,1534,1646,93.2
33043, 흥덕구,065,60~64세,2016,12425,6227,6198,100.5,12236,6122,6114,100.1
33043, 흥덕구,065001, 60세,2016,2932,1517,1415,107.2,2879,1487,1392,106.8
33043, 흥덕구,065002, 61세,2016,2855,1395,1460,95.5,2816,1373,1443,95.1
33043, 흥덕구,065003, 62세,2016,2418,1205,1213,99.3,2382,1185,1197,99
33043, 흥덕구,065004, 63세,2016,1992,1019,973,104.7,1961,1005,956,105.1
33043, 흥덕구,065005, 64세,2016,2228,1091,1137,96,2198,1072,1126,95.2
33043, 흥덕구,070,65~69세,2016,7636,3738,3898,95.9,7556,3700,3856,96
33043, 흥덕구,070001, 65세,2016,1512,722,790,91.4,1485,710,775,91.6
33043, 흥덕구,070002, 66세,2016,1570,784,786,99.7,1556,780,776,100.5
33043, 흥덕구,070003, 67세,2016,1629,826,803,102.9,1611,817,794,102.9
33043, 흥덕구,070004, 68세,2016,1495,743,752,98.8,1484,735,749,98.1
33043, 흥덕구,070005, 69세,2016,1430,663,767,86.4,1420,658,762,86.4
33043, 흥덕구,075,70~74세,2016,5948,2666,3282,81.2,5920,2651,3269,81.1
33043, 흥덕구,075001, 70세,2016,1096,522,574,90.9,1090,520,570,91.2
33043, 흥덕구,075002, 71세,2016,1166,553,613,90.2,1156,547,609,89.8
33043, 흥덕구,075003, 72세,2016,1140,480,660,72.7,1133,476,657,72.5
33043, 흥덕구,075004, 73세,2016,1220,528,692,76.3,1216,526,690,76.2
33043, 흥덕구,075005, 74세,2016,1326,583,743,78.5,1325,582,743,78.3
33043, 흥덕구,080,75~79세,2016,4680,1842,2838,64.9,4665,1839,2826,65.1
33043, 흥덕구,080001, 75세,2016,1052,419,633,66.2,1048,419,629,66.6
33043, 흥덕구,080002, 76세,2016,939,389,550,70.7,938,389,549,70.9
33043, 흥덕구,080003, 77세,2016,989,379,610,62.1,982,378,604,62.6
33043, 흥덕구,080004, 78세,2016,860,322,538,59.9,857,320,537,59.6
33043, 흥덕구,080005, 79세,2016,840,333,507,65.7,840,333,507,65.7
33043, 흥덕구,085,80~84세,2016,3191,1059,2132,49.7,3181,1054,2127,49.6
33043, 흥덕구,085001, 80세,2016,816,292,524,55.7,815,292,523,55.8
33043, 흥덕구,085002, 81세,2016,788,275,513,53.6,785,273,512,53.3
33043, 흥덕구,085003, 82세,2016,610,205,405,50.6,608,204,404,50.5
33043, 흥덕구,085004, 83세,2016,526,168,358,46.9,525,168,357,47.1
33043, 흥덕구,085005, 84세,2016,451,119,332,35.8,448,117,331,35.3
33043, 흥덕구,090,85~89세,2016,1349,333,1016,32.8,1345,332,1013,32.8
33043, 흥덕구,090001, 85세,2016,323,94,229,41,321,93,228,40.8
33043, 흥덕구,090002, 86세,2016,341,82,259,31.7,341,82,259,31.7
33043, 흥덕구,090003, 87세,2016,269,54,215,25.1,268,54,214,25.2
33043, 흥덕구,090004, 88세,2016,238,60,178,33.7,237,60,177,33.9
33043, 흥덕구,090005, 89세,2016,178,43,135,31.9,178,43,135,31.9
33043, 흥덕구,095,90~94세,2016,439,106,333,31.8,435,103,332,31
33043, 흥덕구,095001, 90세,2016,114,27,87,31,114,27,87,31
33043, 흥덕구,095002, 91세,2016,124,26,98,26.5,124,26,98,26.5
33043, 흥덕구,095003, 92세,2016,71,18,53,34,68,15,53,28.3
33043, 흥덕구,095004, 93세,2016,73,21,52,40.4,73,21,52,40.4
33043, 흥덕구,095005, 94세,2016,57,14,43,32.6,56,14,42,33.3
33043, 흥덕구,100,95~99세,2016,97,14,83,16.9,97,14,83,16.9
33043, 흥덕구,100001, 95세,2016,35,6,29,20.7,35,6,29,20.7
33043, 흥덕구,100002, 96세,2016,25,X,24,4.2,25,X,24,4.2
33043, 흥덕구,100003, 97세,2016,18,5,13,38.5,18,5,13,38.5
33043, 흥덕구,100004, 98세,2016,12,X,10,20,12,X,10,20
33043, 흥덕구,100005, 99세,2016,7,X,7,0,7,X,7,0
33043, 흥덕구,101,100세이상,2016,10,X,8,25,10,X,8,25
33043, 흥덕구,102,15세미만,2016,38525,19834,18691,106.1,38277,19706,18571,106.1
33043, 흥덕구,103,15~64세,2016,195175,99691,95484,104.4,190055,96913,93142,104
33043, 흥덕구,104,65세이상,2016,23350,9760,13590,71.8,23209,9695,13514,71.7
33043, 흥덕구,086,85세이상,2016,1895,455,1440,31.6,1887,451,1436,31.4
33043, 흥덕구,126,평균연령,2016,37.9,37,38.8,,37.9,37,38.8,
33043, 흥덕구,127,중위연령,2016,37.8,37,38.8,,37.9,37,39,
33044, 청원구,000,합계,2016,192682,98203,94479,103.9,188026,95327,92699,102.8
33044, 청원구,005,0~4세,2016,12165,6158,6007,102.5,12094,6116,5978,102.3
33044, 청원구,005001, 0세,2016,2451,1221,1230,99.3,2432,1210,1222,99
33044, 청원구,005002, 1세,2016,2466,1244,1222,101.8,2447,1234,1213,101.7
33044, 청원구,005003, 2세,2016,2365,1187,1178,100.8,2353,1180,1173,100.6
33044, 청원구,005004, 3세,2016,2335,1209,1126,107.4,2323,1201,1122,107
33044, 청원구,005005, 4세,2016,2548,1297,1251,103.7,2539,1291,1248,103.4
33044, 청원구,010,5~9세,2016,10905,5547,5358,103.5,10867,5532,5335,103.7
33044, 청원구,010001, 5세,2016,2332,1162,1170,99.3,2316,1156,1160,99.7
33044, 청원구,010002, 6세,2016,2153,1097,1056,103.9,2146,1094,1052,104
33044, 청원구,010003, 7세,2016,2114,1130,984,114.8,2109,1128,981,115
33044, 청원구,010004, 8세,2016,2127,1076,1051,102.4,2120,1073,1047,102.5
33044, 청원구,010005, 9세,2016,2179,1082,1097,98.6,2176,1081,1095,98.7
33044, 청원구,015,10~14세,2016,9163,4812,4351,110.6,9135,4800,4335,110.7
33044, 청원구,015001, 10세,2016,1872,991,881,112.5,1865,986,879,112.2
33044, 청원구,015002, 11세,2016,1771,935,836,111.8,1764,933,831,112.3
33044, 청원구,015003, 12세,2016,1821,956,865,110.5,1818,956,862,110.9
33044, 청원구,015004, 13세,2016,1821,939,882,106.5,1816,936,880,106.4
33044, 청원구,015005, 14세,2016,1878,991,887,111.7,1872,989,883,112
33044, 청원구,020,15~19세,2016,12167,6232,5935,105,12102,6199,5903,105
33044, 청원구,020001, 15세,2016,2052,1064,988,107.7,2047,1061,986,107.6
33044, 청원구,020002, 16세,2016,2431,1235,1196,103.3,2429,1234,1195,103.3
33044, 청원구,020003, 17세,2016,2266,1161,1105,105.1,2260,1159,1101,105.3
33044, 청원구,020004, 18세,2016,2463,1250,1213,103.1,2449,1243,1206,103.1
33044, 청원구,020005, 19세,2016,2955,1522,1433,106.2,2917,1502,1415,106.1
33044, 청원구,025,20~24세,2016,13647,7295,6352,114.8,12974,6877,6097,112.8
33044, 청원구,025001, 20세,2016,2815,1396,1419,98.4,2716,1351,1365,99
33044, 청원구,025002, 21세,2016,2705,1357,1348,100.7,2582,1280,1302,98.3
33044, 청원구,025003, 22세,2016,2711,1464,1247,117.4,2570,1384,1186,116.7
33044, 청원구,025004, 23세,2016,2708,1482,1226,120.9,2578,1391,1187,117.2
33044, 청원구,025005, 24세,2016,2708,1596,1112,143.5,2528,1471,1057,139.2
33044, 청원구,030,25~29세,2016,13406,7511,5895,127.4,12543,6938,5605,123.8
33044, 청원구,030001, 25세,2016,2595,1501,1094,137.2,2422,1388,1034,134.2
33044, 청원구,030002, 26세,2016,2526,1469,1057,139,2340,1340,1000,134
33044, 청원구,030003, 27세,2016,2607,1480,1127,131.3,2450,1372,1078,127.3
33044, 청원구,030004, 28세,2016,2802,1546,1256,123.1,2641,1434,1207,118.8
33044, 청원구,030005, 29세,2016,2876,1515,1361,111.3,2690,1404,1286,109.2
33044, 청원구,035,30~34세,2016,17474,9295,8179,113.6,16733,8818,7915,111.4
33044, 청원구,035001, 30세,2016,3142,1704,1438,118.5,2985,1599,1386,115.4
33044, 청원구,035002, 31세,2016,3171,1696,1475,115,3028,1613,1415,114
33044, 청원구,035003, 32세,2016,3409,1858,1551,119.8,3266,1770,1496,118.3
33044, 청원구,035004, 33세,2016,3688,1932,1756,110,3524,1819,1705,106.7
33044, 청원구,035005, 34세,2016,4064,2105,1959,107.5,3930,2017,1913,105.4
33044, 청원구,040,35~39세,2016,17631,9471,8160,116.1,17096,9108,7988,114
33044, 청원구,040001, 35세,2016,3641,1953,1688,115.7,3529,1881,1648,114.1
33044, 청원구,040002, 36세,2016,3901,2106,1795,117.3,3800,2037,1763,115.5
33044, 청원구,040003, 37세,2016,3632,1932,1700,113.6,3500,1845,1655,111.5
33044, 청원구,040004, 38세,2016,3202,1739,1463,118.9,3107,1670,1437,116.2
33044, 청원구,040005, 39세,2016,3255,1741,1514,115,3160,1675,1485,112.8
33044, 청원구,045,40~44세,2016,15634,8168,7466,109.4,15231,7912,7319,108.1
33044, 청원구,045001, 40세,2016,3138,1660,1478,112.3,3055,1602,1453,110.3
33044, 청원구,045002, 41세,2016,3136,1596,1540,103.6,3052,1543,1509,102.3
33044, 청원구,045003, 42세,2016,3279,1757,1522,115.4,3200,1703,1497,113.8
33044, 청원구,045004, 43세,2016,3149,1658,1491,111.2,3076,1616,1460,110.7
33044, 청원구,045005, 44세,2016,2932,1497,1435,104.3,2848,1448,1400,103.4
33044, 청원구,050,45~49세,2016,15131,7808,7323,106.6,14769,7589,7180,105.7
33044, 청원구,050001, 45세,2016,3194,1666,1528,109,3111,1620,1491,108.7
33044, 청원구,050002, 46세,2016,2871,1517,1354,112,2798,1466,1332,110.1
33044, 청원구,050003, 47세,2016,3166,1650,1516,108.8,3089,1599,1490,107.3
33044, 청원구,050004, 48세,2016,3095,1528,1567,97.5,3026,1492,1534,97.3
33044, 청원구,050005, 49세,2016,2805,1447,1358,106.6,2745,1412,1333,105.9
33044, 청원구,055,50~54세,2016,12924,6662,6262,106.4,12598,6490,6108,106.3
33044, 청원구,055001, 50세,2016,2731,1387,1344,103.2,2664,1351,1313,102.9
33044, 청원구,055002, 51세,2016,2761,1417,1344,105.4,2682,1378,1304,105.7
33044, 청원구,055003, 52세,2016,2298,1174,1124,104.4,2248,1146,1102,104
33044, 청원구,055004, 53세,2016,2433,1266,1167,108.5,2356,1224,1132,108.1
33044, 청원구,055005, 54세,2016,2701,1418,1283,110.5,2648,1391,1257,110.7
33044, 청원구,060,55~59세,2016,13071,6423,6648,96.6,12833,6296,6537,96.3
33044, 청원구,060001, 55세,2016,3015,1465,1550,94.5,2989,1452,1537,94.5
33044, 청원구,060002, 56세,2016,2664,1302,1362,95.6,2603,1265,1338,94.5
33044, 청원구,060003, 57세,2016,2629,1302,1327,98.1,2578,1276,1302,98
33044, 청원구,060004, 58세,2016,2414,1197,1217,98.4,2360,1169,1191,98.2
33044, 청원구,060005, 59세,2016,2349,1157,1192,97.1,2303,1134,1169,97
33044, 청원구,065,60~64세,2016,9268,4553,4715,96.6,9092,4454,4638,96
33044, 청원구,065001, 60세,2016,2156,1090,1066,102.3,2110,1069,1041,102.7
33044, 청원구,065002, 61세,2016,2101,1006,1095,91.9,2060,980,1080,90.7
33044, 청원구,065003, 62세,2016,1766,827,939,88.1,1736,809,927,87.3
33044, 청원구,065004, 63세,2016,1580,792,788,100.5,1547,774,773,100.1
33044, 청원구,065005, 64세,2016,1665,838,827,101.3,1639,822,817,100.6
33044, 청원구,070,65~69세,2016,6029,2904,3125,92.9,5947,2857,3090,92.5
33044, 청원구,070001, 65세,2016,1139,557,582,95.7,1116,544,572,95.1
33044, 청원구,070002, 66세,2016,1177,572,605,94.5,1165,567,598,94.8
33044, 청원구,070003, 67세,2016,1208,581,627,92.7,1186,569,617,92.2
33044, 청원구,070004, 68세,2016,1306,623,683,91.2,1293,612,681,89.9
33044, 청원구,070005, 69세,2016,1199,571,628,90.9,1187,565,622,90.8
33044, 청원구,075,70~74세,2016,5151,2293,2858,80.2,5131,2284,2847,80.2
33044, 청원구,075001, 70세,2016,956,447,509,87.8,951,446,505,88.3
33044, 청원구,075002, 71세,2016,987,452,535,84.5,982,449,533,84.2
33044, 청원구,075003, 72세,2016,954,399,555,71.9,950,398,552,72.1
33044, 청원구,075004, 73세,2016,1013,458,555,82.5,1008,455,553,82.3
33044, 청원구,075005, 74세,2016,1241,537,704,76.3,1240,536,704,76.1
33044, 청원구,080,75~79세,2016,4342,1741,2601,66.9,4324,1732,2592,66.8
33044, 청원구,080001, 75세,2016,936,392,544,72.1,932,391,541,72.3
33044, 청원구,080002, 76세,2016,899,376,523,71.9,896,375,521,72
33044, 청원구,080003, 77세,2016,907,365,542,67.3,905,364,541,67.3
33044, 청원구,080004, 78세,2016,838,313,525,59.6,832,310,522,59.4
33044, 청원구,080005, 79세,2016,762,295,467,63.2,759,292,467,62.5
33044, 청원구,085,80~84세,2016,2856,939,1917,49,2850,937,1913,49
33044, 청원구,085001, 80세,2016,717,243,474,51.3,714,242,472,51.3
33044, 청원구,085002, 81세,2016,659,227,432,52.5,658,227,431,52.7
33044, 청원구,085003, 82세,2016,581,190,391,48.6,579,189,390,48.5
33044, 청원구,085004, 83세,2016,491,150,341,44,491,150,341,44
33044, 청원구,085005, 84세,2016,408,129,279,46.2,408,129,279,46.2
33044, 청원구,090,85~89세,2016,1240,306,934,32.8,1233,303,930,32.6
33044, 청원구,090001, 85세,2016,311,94,217,43.3,310,93,217,42.9
33044, 청원구,090002, 86세,2016,284,69,215,32.1,282,68,214,31.8
33044, 청원구,090003, 87세,2016,281,63,218,28.9,279,63,216,29.2
33044, 청원구,090004, 88세,2016,189,45,144,31.3,188,45,143,31.5
33044, 청원구,090005, 89세,2016,175,35,140,25,174,34,140,24.3
33044, 청원구,095,90~94세,2016,368,74,294,25.2,365,74,291,25.4
33044, 청원구,095001, 90세,2016,94,21,73,28.8,93,21,72,29.2
33044, 청원구,095002, 91세,2016,92,18,74,24.3,92,18,74,24.3
33044, 청원구,095003, 92세,2016,64,14,50,28,63,14,49,28.6
33044, 청원구,095004, 93세,2016,72,13,59,22,71,13,58,22.4
33044, 청원구,095005, 94세,2016,46,8,38,21.1,46,8,38,21.1
33044, 청원구,100,95~99세,2016,97,10,87,11.5,97,10,87,11.5
33044, 청원구,100001, 95세,2016,39,5,34,14.7,39,5,34,14.7
33044, 청원구,100002, 96세,2016,22,X,20,10,22,X,20,10
33044, 청원구,100003, 97세,2016,18,X,16,12.5,18,X,16,12.5
33044, 청원구,100004, 98세,2016,11,X,11,0,11,X,11,0
33044, 청원구,100005, 99세,2016,7,X,6,16.7,7,X,6,16.7
33044, 청원구,101,100세이상,2016,13,X,12,8.3,12,X,11,9.1
33044, 청원구,102,15세미만,2016,32233,16517,15716,105.1,32096,16448,15648,105.1
33044, 청원구,103,15~64세,2016,140353,73418,66935,109.7,135971,70681,65290,108.3
33044, 청원구,104,65세이상,2016,20096,8268,11828,69.9,19959,8198,11761,69.7
33044, 청원구,086,85세이상,2016,1718,391,1327,29.5,1707,388,1319,29.4
33044, 청원구,126,평균연령,2016,37.6,36.5,38.7,,37.6,36.5,38.7,
33044, 청원구,127,중위연령,2016,37,36.1,38,,37.1,36.2,38.1,
33320, 보은군,000,합계,2016,32517,16234,16283,99.7,31987,15971,16016,99.7
33320, 보은군,005,0~4세,2016,887,463,424,109.2,885,462,423,109.2
33320, 보은군,005001, 0세,2016,199,117,82,142.7,198,116,82,141.5
33320, 보은군,005002, 1세,2016,170,86,84,102.4,170,86,84,102.4
33320, 보은군,005003, 2세,2016,166,88,78,112.8,166,88,78,112.8
33320, 보은군,005004, 3세,2016,168,73,95,76.8,167,73,94,77.7
33320, 보은군,005005, 4세,2016,184,99,85,116.5,184,99,85,116.5
33320, 보은군,010,5~9세,2016,951,519,432,120.1,951,519,432,120.1
33320, 보은군,010001, 5세,2016,203,107,96,111.5,203,107,96,111.5
33320, 보은군,010002, 6세,2016,187,109,78,139.7,187,109,78,139.7
33320, 보은군,010003, 7세,2016,182,94,88,106.8,182,94,88,106.8
33320, 보은군,010004, 8세,2016,183,96,87,110.3,183,96,87,110.3
33320, 보은군,010005, 9세,2016,196,113,83,136.1,196,113,83,136.1
33320, 보은군,015,10~14세,2016,1121,580,541,107.2,1119,578,541,106.8
33320, 보은군,015001, 10세,2016,180,104,76,136.8,179,103,76,135.5
33320, 보은군,015002, 11세,2016,218,126,92,137,218,126,92,137
33320, 보은군,015003, 12세,2016,226,108,118,91.5,226,108,118,91.5
33320, 보은군,015004, 13세,2016,230,116,114,101.8,229,115,114,100.9
33320, 보은군,015005, 14세,2016,267,126,141,89.4,267,126,141,89.4
33320, 보은군,020,15~19세,2016,1497,815,682,119.5,1493,812,681,119.2
33320, 보은군,020001, 15세,2016,312,181,131,138.2,312,181,131,138.2
33320, 보은군,020002, 16세,2016,331,174,157,110.8,331,174,157,110.8
33320, 보은군,020003, 17세,2016,338,172,166,103.6,338,172,166,103.6
33320, 보은군,020004, 18세,2016,296,153,143,107,296,153,143,107
33320, 보은군,020005, 19세,2016,220,135,85,158.8,216,132,84,157.1
33320, 보은군,025,20~24세,2016,1344,788,556,141.7,1289,764,525,145.5
33320, 보은군,025001, 20세,2016,269,167,102,163.7,263,163,100,163
33320, 보은군,025002, 21세,2016,269,172,97,177.3,262,171,91,187.9
33320, 보은군,025003, 22세,2016,246,139,107,129.9,236,132,104,126.9
33320, 보은군,025004, 23세,2016,284,154,130,118.5,271,148,123,120.3
33320, 보은군,025005, 24세,2016,276,156,120,130,257,150,107,140.2
33320, 보은군,030,25~29세,2016,1238,693,545,127.2,1140,647,493,131.2
33320, 보은군,030001, 25세,2016,247,141,106,133,225,130,95,136.8
33320, 보은군,030002, 26세,2016,250,129,121,106.6,228,122,106,115.1
33320, 보은군,030003, 27세,2016,242,134,108,124.1,223,125,98,127.6
33320, 보은군,030004, 28세,2016,239,142,97,146.4,223,134,89,150.6
33320, 보은군,030005, 29세,2016,260,147,113,130.1,241,136,105,129.5
33320, 보은군,035,30~34세,2016,1295,729,566,128.8,1217,687,530,129.6
33320, 보은군,035001, 30세,2016,229,137,92,148.9,216,129,87,148.3
33320, 보은군,035002, 31세,2016,263,155,108,143.5,249,149,100,149
33320, 보은군,035003, 32세,2016,265,142,123,115.4,244,132,112,117.9
33320, 보은군,035004, 33세,2016,256,146,110,132.7,236,133,103,129.1
33320, 보은군,035005, 34세,2016,282,149,133,112,272,144,128,112.5
33320, 보은군,040,35~39세,2016,1334,763,571,133.6,1283,730,553,132
33320, 보은군,040001, 35세,2016,313,184,129,142.6,298,172,126,136.5
33320, 보은군,040002, 36세,2016,250,143,107,133.6,241,138,103,134
33320, 보은군,040003, 37세,2016,278,160,118,135.6,269,155,114,136
33320, 보은군,040004, 38세,2016,247,142,105,135.2,237,134,103,130.1
33320, 보은군,040005, 39세,2016,246,134,112,119.6,238,131,107,122.4
33320, 보은군,045,40~44세,2016,1673,941,732,128.6,1639,927,712,130.2
33320, 보은군,045001, 40세,2016,311,185,126,146.8,307,181,126,143.7
33320, 보은군,045002, 41세,2016,269,136,133,102.3,263,134,129,103.9
33320, 보은군,045003, 42세,2016,358,204,154,132.5,352,201,151,133.1
33320, 보은군,045004, 43세,2016,375,215,160,134.4,366,213,153,139.2
33320, 보은군,045005, 44세,2016,360,201,159,126.4,351,198,153,129.4
33320, 보은군,050,45~49세,2016,2168,1166,1002,116.4,2120,1142,978,116.8
33320, 보은군,050001, 45세,2016,427,233,194,120.1,419,229,190,120.5
33320, 보은군,050002, 46세,2016,403,219,184,119,390,211,179,117.9
33320, 보은군,050003, 47세,2016,417,227,190,119.5,410,225,185,121.6
33320, 보은군,050004, 48세,2016,453,233,220,105.9,442,226,216,104.6
33320, 보은군,050005, 49세,2016,468,254,214,118.7,459,251,208,120.7
33320, 보은군,055,50~54세,2016,2651,1446,1205,120,2581,1413,1168,121
33320, 보은군,055001, 50세,2016,511,286,225,127.1,490,277,213,130
33320, 보은군,055002, 51세,2016,529,288,241,119.5,515,279,236,118.2
33320, 보은군,055003, 52세,2016,454,234,220,106.4,440,227,213,106.6
33320, 보은군,055004, 53세,2016,508,273,235,116.2,493,267,226,118.1
33320, 보은군,055005, 54세,2016,649,365,284,128.5,643,363,280,129.6
33320, 보은군,060,55~59세,2016,3440,1779,1661,107.1,3395,1759,1636,107.5
33320, 보은군,060001, 55세,2016,754,405,349,116,744,401,343,116.9
33320, 보은군,060002, 56세,2016,653,322,331,97.3,642,316,326,96.9
33320, 보은군,060003, 57세,2016,632,326,306,106.5,623,322,301,107
33320, 보은군,060004, 58세,2016,724,385,339,113.6,717,382,335,114
33320, 보은군,060005, 59세,2016,677,341,336,101.5,669,338,331,102.1
33320, 보은군,065,60~64세,2016,3034,1520,1514,100.4,3011,1508,1503,100.3
33320, 보은군,065001, 60세,2016,695,354,341,103.8,693,352,341,103.2
33320, 보은군,065002, 61세,2016,687,341,346,98.6,677,335,342,98
33320, 보은군,065003, 62세,2016,609,300,309,97.1,606,300,306,98
33320, 보은군,065004, 63세,2016,497,248,249,99.6,491,245,246,99.6
33320, 보은군,065005, 64세,2016,546,277,269,103,544,276,268,103
33320, 보은군,070,65~69세,2016,2338,1173,1165,100.7,2327,1166,1161,100.4
33320, 보은군,070001, 65세,2016,424,213,211,100.9,422,211,211,100
33320, 보은군,070002, 66세,2016,471,230,241,95.4,470,229,241,95
33320, 보은군,070003, 67세,2016,509,269,240,112.1,506,266,240,110.8
33320, 보은군,070004, 68세,2016,462,238,224,106.3,459,237,222,106.8
33320, 보은군,070005, 69세,2016,472,223,249,89.6,470,223,247,90.3
33320, 보은군,075,70~74세,2016,2243,969,1274,76.1,2239,968,1271,76.2
33320, 보은군,075001, 70세,2016,395,188,207,90.8,395,188,207,90.8
33320, 보은군,075002, 71세,2016,391,185,206,89.8,391,185,206,89.8
33320, 보은군,075003, 72세,2016,402,170,232,73.3,400,169,231,73.2
33320, 보은군,075004, 73세,2016,486,203,283,71.7,485,203,282,72
33320, 보은군,075005, 74세,2016,569,223,346,64.5,568,223,345,64.6
33320, 보은군,080,75~79세,2016,2429,963,1466,65.7,2425,962,1463,65.8
33320, 보은군,080001, 75세,2016,524,206,318,64.8,524,206,318,64.8
33320, 보은군,080002, 76세,2016,477,199,278,71.6,476,199,277,71.8
33320, 보은군,080003, 77세,2016,523,213,310,68.7,523,213,310,68.7
33320, 보은군,080004, 78세,2016,453,185,268,69,452,185,267,69.3
33320, 보은군,080005, 79세,2016,452,160,292,54.8,450,159,291,54.6
33320, 보은군,085,80~84세,2016,1773,622,1151,54,1773,622,1151,54
33320, 보은군,085001, 80세,2016,417,152,265,57.4,417,152,265,57.4
33320, 보은군,085002, 81세,2016,441,162,279,58.1,441,162,279,58.1
33320, 보은군,085003, 82세,2016,348,129,219,58.9,348,129,219,58.9
33320, 보은군,085004, 83세,2016,306,90,216,41.7,306,90,216,41.7
33320, 보은군,085005, 84세,2016,261,89,172,51.7,261,89,172,51.7
33320, 보은군,090,85~89세,2016,782,225,557,40.4,781,225,556,40.5
33320, 보은군,090001, 85세,2016,184,53,131,40.5,184,53,131,40.5
33320, 보은군,090002, 86세,2016,178,44,134,32.8,178,44,134,32.8
33320, 보은군,090003, 87세,2016,184,56,128,43.8,184,56,128,43.8
33320, 보은군,090004, 88세,2016,109,34,75,45.3,109,34,75,45.3
33320, 보은군,090005, 89세,2016,127,38,89,42.7,126,38,88,43.2
33320, 보은군,095,90~94세,2016,267,73,194,37.6,267,73,194,37.6
33320, 보은군,095001, 90세,2016,84,30,54,55.6,84,30,54,55.6
33320, 보은군,095002, 91세,2016,73,18,55,32.7,73,18,55,32.7
33320, 보은군,095003, 92세,2016,43,12,31,38.7,43,12,31,38.7
33320, 보은군,095004, 93세,2016,44,9,35,25.7,44,9,35,25.7
33320, 보은군,095005, 94세,2016,23,X,19,21.1,23,X,19,21.1
33320, 보은군,100,95~99세,2016,45,7,38,18.4,45,7,38,18.4
33320, 보은군,100001, 95세,2016,10,X,7,42.9,10,X,7,42.9
33320, 보은군,100002, 96세,2016,15,X,13,15.4,15,X,13,15.4
33320, 보은군,100003, 97세,2016,7,X,7,0,7,X,7,0
33320, 보은군,100004, 98세,2016,10,X,8,25,10,X,8,25
33320, 보은군,100005, 99세,2016,X,X,X,0,X,X,X,0
33320, 보은군,101,100세이상,2016,7,X,7,0,7,X,7,0
33320, 보은군,102,15세미만,2016,2959,1562,1397,111.8,2955,1559,1396,111.7
33320, 보은군,103,15~64세,2016,19674,10640,9034,117.8,19168,10389,8779,118.3
33320, 보은군,104,65세이상,2016,9884,4032,5852,68.9,9864,4023,5841,68.9
33320, 보은군,086,85세이상,2016,1101,305,796,38.3,1100,305,795,38.4
33320, 보은군,126,평균연령,2016,51,48.4,53.6,,51.2,48.6,53.8,
33320, 보은군,127,중위연령,2016,55.1,52.4,57.7,,55.4,52.7,58,
33330, 옥천군,000,합계,2016,50159,25153,25006,100.6,49266,24615,24651,99.9
33330, 옥천군,005,0~4세,2016,1461,751,710,105.8,1459,750,709,105.8
33330, 옥천군,005001, 0세,2016,268,142,126,112.7,267,141,126,111.9
33330, 옥천군,005002, 1세,2016,271,145,126,115.1,270,145,125,116
33330, 옥천군,005003, 2세,2016,297,147,150,98,297,147,150,98
33330, 옥천군,005004, 3세,2016,287,154,133,115.8,287,154,133,115.8
33330, 옥천군,005005, 4세,2016,338,163,175,93.1,338,163,175,93.1
33330, 옥천군,010,5~9세,2016,1826,954,872,109.4,1824,953,871,109.4
33330, 옥천군,010001, 5세,2016,390,216,174,124.1,390,216,174,124.1
33330, 옥천군,010002, 6세,2016,353,189,164,115.2,353,189,164,115.2
33330, 옥천군,010003, 7세,2016,338,173,165,104.8,338,173,165,104.8
33330, 옥천군,010004, 8세,2016,376,186,190,97.9,374,185,189,97.9
33330, 옥천군,010005, 9세,2016,369,190,179,106.1,369,190,179,106.1
33330, 옥천군,015,10~14세,2016,1848,971,877,110.7,1846,970,876,110.7
33330, 옥천군,015001, 10세,2016,362,193,169,114.2,361,192,169,113.6
33330, 옥천군,015002, 11세,2016,347,178,169,105.3,347,178,169,105.3
33330, 옥천군,015003, 12세,2016,376,197,179,110.1,376,197,179,110.1
33330, 옥천군,015004, 13세,2016,363,194,169,114.8,363,194,169,114.8
33330, 옥천군,015005, 14세,2016,400,209,191,109.4,399,209,190,110
33330, 옥천군,020,15~19세,2016,2535,1363,1172,116.3,2530,1361,1169,116.4
33330, 옥천군,020001, 15세,2016,514,271,243,111.5,513,271,242,112
33330, 옥천군,020002, 16세,2016,498,254,244,104.1,498,254,244,104.1
33330, 옥천군,020003, 17세,2016,508,268,240,111.7,508,268,240,111.7
33330, 옥천군,020004, 18세,2016,496,258,238,108.4,496,258,238,108.4
33330, 옥천군,020005, 19세,2016,519,312,207,150.7,515,310,205,151.2
33330, 옥천군,025,20~24세,2016,2450,1433,1017,140.9,2362,1396,966,144.5
33330, 옥천군,025001, 20세,2016,518,316,202,156.4,509,311,198,157.1
33330, 옥천군,025002, 21세,2016,528,336,192,175,513,332,181,183.4
33330, 옥천군,025003, 22세,2016,479,287,192,149.5,460,279,181,154.1
33330, 옥천군,025004, 23세,2016,465,265,200,132.5,443,256,187,136.9
33330, 옥천군,025005, 24세,2016,460,229,231,99.1,437,218,219,99.5
33330, 옥천군,030,25~29세,2016,2000,1125,875,128.6,1820,1008,812,124.1
33330, 옥천군,030001, 25세,2016,418,242,176,137.5,394,228,166,137.3
33330, 옥천군,030002, 26세,2016,440,241,199,121.1,391,214,177,120.9
33330, 옥천군,030003, 27세,2016,371,212,159,133.3,343,193,150,128.7
33330, 옥천군,030004, 28세,2016,396,215,181,118.8,356,187,169,110.7
33330, 옥천군,030005, 29세,2016,375,215,160,134.4,336,186,150,124
33330, 옥천군,035,30~34세,2016,2245,1236,1009,122.5,2083,1122,961,116.8
33330, 옥천군,035001, 30세,2016,408,235,173,135.8,368,206,162,127.2
33330, 옥천군,035002, 31세,2016,386,221,165,133.9,353,196,157,124.8
33330, 옥천군,035003, 32세,2016,430,232,198,117.2,405,214,191,112
33330, 옥천군,035004, 33세,2016,457,254,203,125.1,427,233,194,120.1
33330, 옥천군,035005, 34세,2016,564,294,270,108.9,530,273,257,106.2
33330, 옥천군,040,35~39세,2016,2721,1501,1220,123,2601,1413,1188,118.9
33330, 옥천군,040001, 35세,2016,548,305,243,125.5,517,282,235,120
33330, 옥천군,040002, 36세,2016,568,294,274,107.3,541,276,265,104.2
33330, 옥천군,040003, 37세,2016,520,301,219,137.4,498,285,213,133.8
33330, 옥천군,040004, 38세,2016,551,300,251,119.5,531,285,246,115.9
33330, 옥천군,040005, 39세,2016,534,301,233,129.2,514,285,229,124.5
33330, 옥천군,045,40~44세,2016,3081,1690,1391,121.5,3006,1640,1366,120.1
33330, 옥천군,045001, 40세,2016,544,299,245,122,525,285,240,118.8
33330, 옥천군,045002, 41세,2016,583,321,262,122.5,570,312,258,120.9
33330, 옥천군,045003, 42세,2016,660,349,311,112.2,650,342,308,111
33330, 옥천군,045004, 43세,2016,688,381,307,124.1,667,367,300,122.3
33330, 옥천군,045005, 44세,2016,606,340,266,127.8,594,334,260,128.5
33330, 옥천군,050,45~49세,2016,3722,1978,1744,113.4,3656,1953,1703,114.7
33330, 옥천군,050001, 45세,2016,699,371,328,113.1,688,364,324,112.3
33330, 옥천군,050002, 46세,2016,679,396,283,139.9,671,394,277,142.2
33330, 옥천군,050003, 47세,2016,819,429,390,110,803,424,379,111.9
33330, 옥천군,050004, 48세,2016,800,412,388,106.2,786,408,378,107.9
33330, 옥천군,050005, 49세,2016,725,370,355,104.2,708,363,345,105.2
33330, 옥천군,055,50~54세,2016,4024,2128,1896,112.2,3957,2091,1866,112.1
33330, 옥천군,055001, 50세,2016,733,388,345,112.5,719,381,338,112.7
33330, 옥천군,055002, 51세,2016,780,403,377,106.9,768,394,374,105.3
33330, 옥천군,055003, 52세,2016,742,389,353,110.2,729,383,346,110.7
33330, 옥천군,055004, 53세,2016,818,437,381,114.7,800,428,372,115.1
33330, 옥천군,055005, 54세,2016,951,511,440,116.1,941,505,436,115.8
33330, 옥천군,060,55~59세,2016,4957,2525,2432,103.8,4910,2501,2409,103.8
33330, 옥천군,060001, 55세,2016,1090,551,539,102.2,1082,548,534,102.6
33330, 옥천군,060002, 56세,2016,1014,489,525,93.1,1002,483,519,93.1
33330, 옥천군,060003, 57세,2016,922,485,437,111,911,478,433,110.4
33330, 옥천군,060004, 58세,2016,905,464,441,105.2,897,459,438,104.8
33330, 옥천군,060005, 59세,2016,1026,536,490,109.4,1018,533,485,109.9
33330, 옥천군,065,60~64세,2016,4381,2161,2220,97.3,4340,2138,2202,97.1
33330, 옥천군,065001, 60세,2016,939,473,466,101.5,927,467,460,101.5
33330, 옥천군,065002, 61세,2016,925,450,475,94.7,915,443,472,93.9
33330, 옥천군,065003, 62세,2016,889,446,443,100.7,881,441,440,100.2
33330, 옥천군,065004, 63세,2016,759,382,377,101.3,755,379,376,100.8
33330, 옥천군,065005, 64세,2016,869,410,459,89.3,862,408,454,89.9
33330, 옥천군,070,65~69세,2016,3421,1706,1715,99.5,3395,1691,1704,99.2
33330, 옥천군,070001, 65세,2016,662,318,344,92.4,657,316,341,92.7
33330, 옥천군,070002, 66세,2016,753,409,344,118.9,746,405,341,118.8
33330, 옥천군,070003, 67세,2016,706,362,344,105.2,701,360,341,105.6
33330, 옥천군,070004, 68세,2016,648,316,332,95.2,644,313,331,94.6
33330, 옥천군,070005, 69세,2016,652,301,351,85.8,647,297,350,84.9
33330, 옥천군,075,70~74세,2016,3094,1355,1739,77.9,3089,1353,1736,77.9
33330, 옥천군,075001, 70세,2016,499,234,265,88.3,499,234,265,88.3
33330, 옥천군,075002, 71세,2016,516,245,271,90.4,514,245,269,91.1
33330, 옥천군,075003, 72세,2016,562,237,325,72.9,559,235,324,72.5
33330, 옥천군,075004, 73세,2016,633,264,369,71.5,633,264,369,71.5
33330, 옥천군,075005, 74세,2016,884,375,509,73.7,884,375,509,73.7
33330, 옥천군,080,75~79세,2016,2839,1149,1690,68,2836,1148,1688,68
33330, 옥천군,080001, 75세,2016,623,261,362,72.1,622,261,361,72.3
33330, 옥천군,080002, 76세,2016,530,221,309,71.5,529,220,309,71.2
33330, 옥천군,080003, 77세,2016,619,238,381,62.5,618,238,380,62.6
33330, 옥천군,080004, 78세,2016,546,209,337,62,546,209,337,62
33330, 옥천군,080005, 79세,2016,521,220,301,73.1,521,220,301,73.1
33330, 옥천군,085,80~84세,2016,2217,765,1452,52.7,2216,765,1451,52.7
33330, 옥천군,085001, 80세,2016,528,194,334,58.1,528,194,334,58.1
33330, 옥천군,085002, 81세,2016,541,195,346,56.4,541,195,346,56.4
33330, 옥천군,085003, 82세,2016,443,150,293,51.2,443,150,293,51.2
33330, 옥천군,085004, 83세,2016,401,126,275,45.8,400,126,274,46
33330, 옥천군,085005, 84세,2016,304,100,204,49,304,100,204,49
33330, 옥천군,090,85~89세,2016,951,271,680,39.9,951,271,680,39.9
33330, 옥천군,090001, 85세,2016,235,65,170,38.2,235,65,170,38.2
33330, 옥천군,090002, 86세,2016,239,66,173,38.2,239,66,173,38.2
33330, 옥천군,090003, 87세,2016,182,59,123,48,182,59,123,48
33330, 옥천군,090004, 88세,2016,164,48,116,41.4,164,48,116,41.4
33330, 옥천군,090005, 89세,2016,131,33,98,33.7,131,33,98,33.7
33330, 옥천군,095,90~94세,2016,310,80,230,34.8,309,80,229,34.9
33330, 옥천군,095001, 90세,2016,73,22,51,43.1,72,22,50,44
33330, 옥천군,095002, 91세,2016,77,24,53,45.3,77,24,53,45.3
33330, 옥천군,095003, 92세,2016,61,20,41,48.8,61,20,41,48.8
33330, 옥천군,095004, 93세,2016,63,7,56,12.5,63,7,56,12.5
33330, 옥천군,095005, 94세,2016,36,7,29,24.1,36,7,29,24.1
33330, 옥천군,100,95~99세,2016,65,11,54,20.4,65,11,54,20.4
33330, 옥천군,100001, 95세,2016,26,X,22,18.2,26,X,22,18.2
33330, 옥천군,100002, 96세,2016,23,7,16,43.8,23,7,16,43.8
33330, 옥천군,100003, 97세,2016,10,X,10,0,10,X,10,0
33330, 옥천군,100004, 98세,2016,6,X,6,0,6,X,6,0
33330, 옥천군,100005, 99세,2016,X,X,X,,X,X,X,
33330, 옥천군,101,100세이상,2016,11,X,11,0,11,X,11,0
33330, 옥천군,102,15세미만,2016,5135,2676,2459,108.8,5129,2673,2456,108.8
33330, 옥천군,103,15~64세,2016,32116,17140,14976,114.4,31265,16623,14642,113.5
33330, 옥천군,104,65세이상,2016,12908,5337,7571,70.5,12872,5319,7553,70.4
33330, 옥천군,086,85세이상,2016,1337,362,975,37.1,1336,362,974,37.2
33330, 옥천군,126,평균연령,2016,48.4,46.1,50.6,,48.5,46.3,50.8,
33330, 옥천군,127,중위연령,2016,51.6,48.9,54.4,,51.9,49.3,54.6,
33340, 영동군,000,합계,2016,48879,24394,24485,99.6,48193,24055,24138,99.7
33340, 영동군,005,0~4세,2016,1284,650,634,102.5,1280,648,632,102.5
33340, 영동군,005001, 0세,2016,236,128,108,118.5,236,128,108,118.5
33340, 영동군,005002, 1세,2016,247,135,112,120.5,246,134,112,119.6
33340, 영동군,005003, 2세,2016,275,135,140,96.4,273,134,139,96.4
33340, 영동군,005004, 3세,2016,233,117,116,100.9,233,117,116,100.9
33340, 영동군,005005, 4세,2016,293,135,158,85.4,292,135,157,86
33340, 영동군,010,5~9세,2016,1479,814,665,122.4,1476,811,665,122
33340, 영동군,010001, 5세,2016,309,174,135,128.9,309,174,135,128.9
33340, 영동군,010002, 6세,2016,305,173,132,131.1,304,172,132,130.3
33340, 영동군,010003, 7세,2016,264,144,120,120,264,144,120,120
33340, 영동군,010004, 8세,2016,279,149,130,114.6,278,148,130,113.8
33340, 영동군,010005, 9세,2016,322,174,148,117.6,321,173,148,116.9
33340, 영동군,015,10~14세,2016,1659,838,821,102.1,1657,838,819,102.3
33340, 영동군,015001, 10세,2016,298,151,147,102.7,297,151,146,103.4
33340, 영동군,015002, 11세,2016,295,160,135,118.5,295,160,135,118.5
33340, 영동군,015003, 12세,2016,333,154,179,86,333,154,179,86
33340, 영동군,015004, 13세,2016,343,173,170,101.8,342,173,169,102.4
33340, 영동군,015005, 14세,2016,390,200,190,105.3,390,200,190,105.3
33340, 영동군,020,15~19세,2016,2774,1501,1273,117.9,2763,1499,1264,118.6
33340, 영동군,020001, 15세,2016,442,227,215,105.6,442,227,215,105.6
33340, 영동군,020002, 16세,2016,490,258,232,111.2,490,258,232,111.2
33340, 영동군,020003, 17세,2016,480,242,238,101.7,479,242,237,102.1
33340, 영동군,020004, 18세,2016,562,308,254,121.3,557,307,250,122.8
33340, 영동군,020005, 19세,2016,800,466,334,139.5,795,465,330,140.9
33340, 영동군,025,20~24세,2016,3633,2124,1509,140.8,3557,2093,1464,143
33340, 영동군,025001, 20세,2016,736,393,343,114.6,730,390,340,114.7
33340, 영동군,025002, 21세,2016,754,362,392,92.3,748,360,388,92.8
33340, 영동군,025003, 22세,2016,796,449,347,129.4,782,443,339,130.7
33340, 영동군,025004, 23세,2016,707,477,230,207.4,680,470,210,223.8
33340, 영동군,025005, 24세,2016,640,443,197,224.9,617,430,187,229.9
33340, 영동군,030,25~29세,2016,2025,1166,859,135.7,1882,1092,790,138.2
33340, 영동군,030001, 25세,2016,489,314,175,179.4,461,301,160,188.1
33340, 영동군,030002, 26세,2016,404,236,168,140.5,380,221,159,139
33340, 영동군,030003, 27세,2016,377,217,160,135.6,356,208,148,140.5
33340, 영동군,030004, 28세,2016,376,210,166,126.5,347,193,154,125.3
33340, 영동군,030005, 29세,2016,379,189,190,99.5,338,169,169,100
33340, 영동군,035,30~34세,2016,1872,1047,825,126.9,1763,981,782,125.4
33340, 영동군,035001, 30세,2016,369,219,150,146,339,197,142,138.7
33340, 영동군,035002, 31세,2016,356,210,146,143.8,332,197,135,145.9
33340, 영동군,035003, 32세,2016,356,201,155,129.7,329,185,144,128.5
33340, 영동군,035004, 33세,2016,379,199,180,110.6,370,196,174,112.6
33340, 영동군,035005, 34세,2016,412,218,194,112.4,393,206,187,110.2
33340, 영동군,040,35~39세,2016,2168,1127,1041,108.3,2092,1084,1008,107.5
33340, 영동군,040001, 35세,2016,432,224,208,107.7,417,214,203,105.4
33340, 영동군,040002, 36세,2016,452,231,221,104.5,440,228,212,107.5
33340, 영동군,040003, 37세,2016,434,211,223,94.6,417,204,213,95.8
33340, 영동군,040004, 38세,2016,434,227,207,109.7,415,212,203,104.4
33340, 영동군,040005, 39세,2016,416,234,182,128.6,403,226,177,127.7
33340, 영동군,045,40~44세,2016,2761,1500,1261,119,2706,1474,1232,119.6
33340, 영동군,045001, 40세,2016,460,259,201,128.9,447,253,194,130.4
33340, 영동군,045002, 41세,2016,531,284,247,115,524,282,242,116.5
33340, 영동군,045003, 42세,2016,587,320,267,119.9,577,312,265,117.7
33340, 영동군,045004, 43세,2016,627,349,278,125.5,615,343,272,126.1
33340, 영동군,045005, 44세,2016,556,288,268,107.5,543,284,259,109.7
33340, 영동군,050,45~49세,2016,3518,1905,1613,118.1,3463,1884,1579,119.3
33340, 영동군,050001, 45세,2016,623,347,276,125.7,613,343,270,127
33340, 영동군,050002, 46세,2016,687,372,315,118.1,672,365,307,118.9
33340, 영동군,050003, 47세,2016,722,398,324,122.8,717,395,322,122.7
33340, 영동군,050004, 48세,2016,764,412,352,117,747,405,342,118.4
33340, 영동군,050005, 49세,2016,722,376,346,108.7,714,376,338,111.2
33340, 영동군,055,50~54세,2016,3825,1992,1833,108.7,3780,1970,1810,108.8
33340, 영동군,055001, 50세,2016,737,396,341,116.1,728,393,335,117.3
33340, 영동군,055002, 51세,2016,776,422,354,119.2,769,418,351,119.1
33340, 영동군,055003, 52세,2016,688,353,335,105.4,670,345,325,106.2
33340, 영동군,055004, 53세,2016,720,374,346,108.1,716,370,346,106.9
33340, 영동군,055005, 54세,2016,904,447,457,97.8,897,444,453,98
33340, 영동군,060,55~59세,2016,4724,2417,2307,104.8,4683,2400,2283,105.1
33340, 영동군,060001, 55세,2016,1047,536,511,104.9,1043,534,509,104.9
33340, 영동군,060002, 56세,2016,943,467,476,98.1,929,461,468,98.5
33340, 영동군,060003, 57세,2016,892,438,454,96.5,886,436,450,96.9
33340, 영동군,060004, 58세,2016,898,500,398,125.6,890,496,394,125.9
33340, 영동군,060005, 59세,2016,944,476,468,101.7,935,473,462,102.4
33340, 영동군,065,60~64세,2016,3965,1973,1992,99,3933,1961,1972,99.4
33340, 영동군,065001, 60세,2016,849,401,448,89.5,838,397,441,90
33340, 영동군,065002, 61세,2016,895,473,422,112.1,891,471,420,112.1
33340, 영동군,065003, 62세,2016,768,394,374,105.3,765,392,373,105.1
33340, 영동군,065004, 63세,2016,687,352,335,105.1,681,350,331,105.7
33340, 영동군,065005, 64세,2016,766,353,413,85.5,758,351,407,86.2
33340, 영동군,070,65~69세,2016,3320,1575,1745,90.3,3299,1564,1735,90.1
33340, 영동군,070001, 65세,2016,617,287,330,87,614,285,329,86.6
33340, 영동군,070002, 66세,2016,663,310,353,87.8,658,309,349,88.5
33340, 영동군,070003, 67세,2016,753,343,410,83.7,746,338,408,82.8
33340, 영동군,070004, 68세,2016,677,329,348,94.5,674,328,346,94.8
33340, 영동군,070005, 69세,2016,610,306,304,100.7,607,304,303,100.3
33340, 영동군,075,70~74세,2016,3264,1386,1878,73.8,3258,1381,1877,73.6
33340, 영동군,075001, 70세,2016,530,237,293,80.9,529,236,293,80.5
33340, 영동군,075002, 71세,2016,541,245,296,82.8,538,243,295,82.4
33340, 영동군,075003, 72세,2016,602,234,368,63.6,602,234,368,63.6
33340, 영동군,075004, 73세,2016,731,308,423,72.8,729,306,423,72.3
33340, 영동군,075005, 74세,2016,860,362,498,72.7,860,362,498,72.7
33340, 영동군,080,75~79세,2016,3179,1272,1907,66.7,3175,1270,1905,66.7
33340, 영동군,080001, 75세,2016,679,284,395,71.9,678,283,395,71.6
33340, 영동군,080002, 76세,2016,617,262,355,73.8,616,261,355,73.5
33340, 영동군,080003, 77세,2016,688,280,408,68.6,687,280,407,68.8
33340, 영동군,080004, 78세,2016,605,239,366,65.3,605,239,366,65.3
33340, 영동군,080005, 79세,2016,590,207,383,54,589,207,382,54.2
33340, 영동군,085,80~84세,2016,2140,767,1373,55.9,2138,765,1373,55.7
33340, 영동군,085001, 80세,2016,552,192,360,53.3,552,192,360,53.3
33340, 영동군,085002, 81세,2016,515,197,318,61.9,514,196,318,61.6
33340, 영동군,085003, 82세,2016,408,141,267,52.8,408,141,267,52.8
33340, 영동군,085004, 83세,2016,350,116,234,49.6,349,115,234,49.1
33340, 영동군,085005, 84세,2016,315,121,194,62.4,315,121,194,62.4
33340, 영동군,090,85~89세,2016,938,260,678,38.3,937,260,677,38.4
33340, 영동군,090001, 85세,2016,239,66,173,38.2,238,66,172,38.4
33340, 영동군,090002, 86세,2016,194,54,140,38.6,194,54,140,38.6
33340, 영동군,090003, 87세,2016,186,47,139,33.8,186,47,139,33.8
33340, 영동군,090004, 88세,2016,158,46,112,41.1,158,46,112,41.1
33340, 영동군,090005, 89세,2016,161,47,114,41.2,161,47,114,41.2
33340, 영동군,095,90~94세,2016,287,71,216,32.9,287,71,216,32.9
33340, 영동군,095001, 90세,2016,85,21,64,32.8,85,21,64,32.8
33340, 영동군,095002, 91세,2016,74,18,56,32.1,74,18,56,32.1
33340, 영동군,095003, 92세,2016,44,17,27,63,44,17,27,63
33340, 영동군,095004, 93세,2016,39,7,32,21.9,39,7,32,21.9
33340, 영동군,095005, 94세,2016,45,8,37,21.6,45,8,37,21.6
33340, 영동군,100,95~99세,2016,56,9,47,19.1,56,9,47,19.1
33340, 영동군,100001, 95세,2016,19,X,18,5.6,19,X,18,5.6
33340, 영동군,100002, 96세,2016,21,X,18,16.7,21,X,18,16.7
33340, 영동군,100003, 97세,2016,9,X,5,80,9,X,5,80
33340, 영동군,100004, 98세,2016,5,X,X,25,5,X,X,25
33340, 영동군,100005, 99세,2016,X,X,X,0,X,X,X,0
33340, 영동군,101,100세이상,2016,8,X,8,0,8,X,8,0
33340, 영동군,102,15세미만,2016,4422,2302,2120,108.6,4413,2297,2116,108.6
33340, 영동군,103,15~64세,2016,31265,16752,14513,115.4,30622,16438,14184,115.9
33340, 영동군,104,65세이상,2016,13192,5340,7852,68,13158,5320,7838,67.9
33340, 영동군,086,85세이상,2016,1289,340,949,35.8,1288,340,948,35.9
33340, 영동군,126,평균연령,2016,48.4,46,50.9,,48.6,46.1,51.1,
33340, 영동군,127,중위연령,2016,51.7,48.8,54.8,,51.9,49,55,
33350, 진천군,000,합계,2016,74222,39919,34303,116.4,67026,34766,32260,107.8
33350, 진천군,005,0~4세,2016,3165,1626,1539,105.7,3081,1584,1497,105.8
33350, 진천군,005001, 0세,2016,581,303,278,109,561,291,270,107.8
33350, 진천군,005002, 1세,2016,634,334,300,111.3,615,320,295,108.5
33350, 진천군,005003, 2세,2016,601,307,294,104.4,584,299,285,104.9
33350, 진천군,005004, 3세,2016,670,337,333,101.2,654,332,322,103.1
33350, 진천군,005005, 4세,2016,679,345,334,103.3,667,342,325,105.2
33350, 진천군,010,5~9세,2016,3493,1806,1687,107.1,3437,1775,1662,106.8
33350, 진천군,010001, 5세,2016,733,376,357,105.3,721,370,351,105.4
33350, 진천군,010002, 6세,2016,689,353,336,105.1,674,346,328,105.5
33350, 진천군,010003, 7세,2016,661,335,326,102.8,650,329,321,102.5
33350, 진천군,010004, 8세,2016,697,374,323,115.8,684,365,319,114.4
33350, 진천군,010005, 9세,2016,713,368,345,106.7,708,365,343,106.4
33350, 진천군,015,10~14세,2016,3148,1675,1473,113.7,3120,1659,1461,113.6
33350, 진천군,015001, 10세,2016,603,319,284,112.3,597,315,282,111.7
33350, 진천군,015002, 11세,2016,582,318,264,120.5,574,312,262,119.1
33350, 진천군,015003, 12세,2016,677,387,290,133.4,672,385,287,134.1
33350, 진천군,015004, 13세,2016,627,338,289,117,624,336,288,116.7
33350, 진천군,015005, 14세,2016,659,313,346,90.5,653,311,342,90.9
33350, 진천군,020,15~19세,2016,4413,2378,2035,116.9,4371,2351,2020,116.4
33350, 진천군,020001, 15세,2016,793,411,382,107.6,785,406,379,107.1
33350, 진천군,020002, 16세,2016,948,504,444,113.5,941,497,444,111.9
33350, 진천군,020003, 17세,2016,871,460,411,111.9,862,454,408,111.3
33350, 진천군,020004, 18세,2016,877,465,412,112.9,873,462,411,112.4
33350, 진천군,020005, 19세,2016,924,538,386,139.4,910,532,378,140.7
33350, 진천군,025,20~24세,2016,4107,2487,1620,153.5,3566,2082,1484,140.3
33350, 진천군,025001, 20세,2016,867,520,347,149.9,817,480,337,142.4
33350, 진천군,025002, 21세,2016,820,505,315,160.3,747,453,294,154.1
33350, 진천군,025003, 22세,2016,777,469,308,152.3,664,389,275,141.5
33350, 진천군,025004, 23세,2016,811,479,332,144.3,682,387,295,131.2
33350, 진천군,025005, 24세,2016,832,514,318,161.6,656,373,283,131.8
33350, 진천군,030,25~29세,2016,4452,2834,1618,175.2,3078,1773,1305,135.9
33350, 진천군,030001, 25세,2016,845,532,313,170,628,366,262,139.7
33350, 진천군,030002, 26세,2016,921,602,319,188.7,641,383,258,148.4
33350, 진천군,030003, 27세,2016,856,549,307,178.8,580,338,242,139.7
33350, 진천군,030004, 28세,2016,913,578,335,172.5,607,342,265,129.1
33350, 진천군,030005, 29세,2016,917,573,344,166.6,622,344,278,123.7
33350, 진천군,035,30~34세,2016,5532,3339,2193,152.3,4224,2330,1894,123
33350, 진천군,035001, 30세,2016,1005,612,393,155.7,729,411,318,129.2
33350, 진천군,035002, 31세,2016,1008,610,398,153.3,725,393,332,118.4
33350, 진천군,035003, 32세,2016,1019,609,410,148.5,764,414,350,118.3
33350, 진천군,035004, 33세,2016,1194,717,477,150.3,946,517,429,120.5
33350, 진천군,035005, 34세,2016,1306,791,515,153.6,1060,595,465,128
33350, 진천군,040,35~39세,2016,6031,3460,2571,134.6,5065,2694,2371,113.6
33350, 진천군,040001, 35세,2016,1220,691,529,130.6,1007,528,479,110.2
33350, 진천군,040002, 36세,2016,1308,737,571,129.1,1113,576,537,107.3
33350, 진천군,040003, 37세,2016,1231,720,511,140.9,1008,541,467,115.8
33350, 진천군,040004, 38세,2016,1153,674,479,140.7,979,537,442,121.5
33350, 진천군,040005, 39세,2016,1119,638,481,132.6,958,512,446,114.8
33350, 진천군,045,40~44세,2016,5817,3307,2510,131.8,5119,2821,2298,122.8
33350, 진천군,045001, 40세,2016,1186,697,489,142.5,1020,569,451,126.2
33350, 진천군,045002, 41세,2016,1149,647,502,128.9,997,533,464,114.9
33350, 진천군,045003, 42세,2016,1154,646,508,127.2,1047,582,465,125.2
33350, 진천군,045004, 43세,2016,1203,687,516,133.1,1064,597,467,127.8
33350, 진천군,045005, 44세,2016,1125,630,495,127.3,991,540,451,119.7
33350, 진천군,050,45~49세,2016,6249,3482,2767,125.8,5582,3060,2522,121.3
33350, 진천군,050001, 45세,2016,1250,703,547,128.5,1103,613,490,125.1
33350, 진천군,050002, 46세,2016,1217,684,533,128.3,1085,598,487,122.8
33350, 진천군,050003, 47세,2016,1339,733,606,121,1201,648,553,117.2
33350, 진천군,050004, 48세,2016,1279,702,577,121.7,1126,602,524,114.9
33350, 진천군,050005, 49세,2016,1164,660,504,131,1067,599,468,128
33350, 진천군,055,50~54세,2016,6114,3403,2711,125.5,5483,2999,2484,120.7
33350, 진천군,055001, 50세,2016,1220,691,529,130.6,1093,615,478,128.7
33350, 진천군,055002, 51세,2016,1287,711,576,123.4,1163,631,532,118.6
33350, 진천군,055003, 52세,2016,1134,625,509,122.8,1006,540,466,115.9
33350, 진천군,055004, 53세,2016,1161,648,513,126.3,1006,550,456,120.6
33350, 진천군,055005, 54세,2016,1312,728,584,124.7,1215,663,552,120.1
33350, 진천군,060,55~59세,2016,6040,3235,2805,115.3,5612,2960,2652,111.6
33350, 진천군,060001, 55세,2016,1454,751,703,106.8,1381,710,671,105.8
33350, 진천군,060002, 56세,2016,1237,678,559,121.3,1121,608,513,118.5
33350, 진천군,060003, 57세,2016,1151,618,533,115.9,1069,559,510,109.6
33350, 진천군,060004, 58세,2016,1098,611,487,125.5,1016,555,461,120.4
33350, 진천군,060005, 59세,2016,1100,577,523,110.3,1025,528,497,106.2
33350, 진천군,065,60~64세,2016,4525,2260,2265,99.8,4297,2124,2173,97.7
33350, 진천군,065001, 60세,2016,1008,536,472,113.6,949,492,457,107.7
33350, 진천군,065002, 61세,2016,963,476,487,97.7,911,452,459,98.5
33350, 진천군,065003, 62세,2016,917,446,471,94.7,868,418,450,92.9
33350, 진천군,065004, 63세,2016,796,398,398,100,765,375,390,96.2
33350, 진천군,065005, 64세,2016,841,404,437,92.4,804,387,417,92.8
33350, 진천군,070,65~69세,2016,2970,1501,1469,102.2,2887,1452,1435,101.2
33350, 진천군,070001, 65세,2016,568,288,280,102.9,545,271,274,98.9
33350, 진천군,070002, 66세,2016,583,284,299,95,568,276,292,94.5
33350, 진천군,070003, 67세,2016,628,340,288,118.1,605,325,280,116.1
33350, 진천군,070004, 68세,2016,618,306,312,98.1,604,303,301,100.7
33350, 진천군,070005, 69세,2016,573,283,290,97.6,565,277,288,96.2
33350, 진천군,075,70~74세,2016,2671,1183,1488,79.5,2641,1167,1474,79.2
33350, 진천군,075001, 70세,2016,467,236,231,102.2,458,231,227,101.8
33350, 진천군,075002, 71세,2016,528,234,294,79.6,523,233,290,80.3
33350, 진천군,075003, 72세,2016,497,208,289,72,490,205,285,71.9
33350, 진천군,075004, 73세,2016,531,224,307,73,524,218,306,71.2
33350, 진천군,075005, 74세,2016,648,281,367,76.6,646,280,366,76.5
33350, 진천군,080,75~79세,2016,2637,1086,1551,70,2619,1081,1538,70.3
33350, 진천군,080001, 75세,2016,518,217,301,72.1,516,215,301,71.4
33350, 진천군,080002, 76세,2016,533,234,299,78.3,528,233,295,79
33350, 진천군,080003, 77세,2016,578,217,361,60.1,572,215,357,60.2
33350, 진천군,080004, 78세,2016,510,222,288,77.1,507,222,285,77.9
33350, 진천군,080005, 79세,2016,498,196,302,64.9,496,196,300,65.3
33350, 진천군,085,80~84세,2016,1819,615,1204,51.1,1811,613,1198,51.2
33350, 진천군,085001, 80세,2016,469,169,300,56.3,467,169,298,56.7
33350, 진천군,085002, 81세,2016,447,135,312,43.3,445,134,311,43.1
33350, 진천군,085003, 82세,2016,372,132,240,55,370,132,238,55.5
33350, 진천군,085004, 83세,2016,307,100,207,48.3,305,99,206,48.1
33350, 진천군,085005, 84세,2016,224,79,145,54.5,224,79,145,54.5
33350, 진천군,090,85~89세,2016,752,191,561,34,749,190,559,34
33350, 진천군,090001, 85세,2016,183,45,138,32.6,182,44,138,31.9
33350, 진천군,090002, 86세,2016,179,40,139,28.8,179,40,139,28.8
33350, 진천군,090003, 87세,2016,149,47,102,46.1,149,47,102,46.1
33350, 진천군,090004, 88세,2016,142,32,110,29.1,141,32,109,29.4
33350, 진천군,090005, 89세,2016,99,27,72,37.5,98,27,71,38
33350, 진천군,095,90~94세,2016,232,38,194,19.6,229,38,191,19.9
33350, 진천군,095001, 90세,2016,68,13,55,23.6,66,13,53,24.5
33350, 진천군,095002, 91세,2016,54,X,50,8,53,X,49,8.2
33350, 진천군,095003, 92세,2016,37,X,33,12.1,37,X,33,12.1
33350, 진천군,095004, 93세,2016,46,10,36,27.8,46,10,36,27.8
33350, 진천군,095005, 94세,2016,27,7,20,35,27,7,20,35
33350, 진천군,100,95~99세,2016,48,12,36,33.3,48,12,36,33.3
33350, 진천군,100001, 95세,2016,25,5,20,25,25,5,20,25
33350, 진천군,100002, 96세,2016,7,X,X,75,7,X,X,75
33350, 진천군,100003, 97세,2016,12,X,10,20,12,X,10,20
33350, 진천군,100004, 98세,2016,X,X,X,100,X,X,X,100
33350, 진천군,100005, 99세,2016,X,X,X,,X,X,X,
33350, 진천군,101,100세이상,2016,7,X,6,16.7,7,X,6,16.7
33350, 진천군,102,15세미만,2016,9806,5107,4699,108.7,9638,5018,4620,108.6
33350, 진천군,103,15~64세,2016,53280,30185,23095,130.7,46397,25194,21203,118.8
33350, 진천군,104,65세이상,2016,11136,4627,6509,71.1,10991,4554,6437,70.7
33350, 진천군,086,85세이상,2016,1039,242,797,30.4,1033,241,792,30.4
33350, 진천군,126,평균연령,2016,41.9,40.3,43.7,,42.3,40.7,43.9,
33350, 진천군,127,중위연령,2016,42.4,40.5,44.8,,43.5,42.1,45.3,
33360, 괴산군,000,합계,2016,38164,19557,18607,105.1,37204,18962,18242,103.9
33360, 괴산군,005,0~4세,2016,702,353,349,101.1,701,353,348,101.4
33360, 괴산군,005001, 0세,2016,122,71,51,139.2,122,71,51,139.2
33360, 괴산군,005002, 1세,2016,117,48,69,69.6,117,48,69,69.6
33360, 괴산군,005003, 2세,2016,148,69,79,87.3,147,69,78,88.5
33360, 괴산군,005004, 3세,2016,138,66,72,91.7,138,66,72,91.7
33360, 괴산군,005005, 4세,2016,177,99,78,126.9,177,99,78,126.9
33360, 괴산군,010,5~9세,2016,888,422,466,90.6,879,417,462,90.3
33360, 괴산군,010001, 5세,2016,156,76,80,95,154,75,79,94.9
33360, 괴산군,010002, 6세,2016,188,98,90,108.9,185,95,90,105.6
33360, 괴산군,010003, 7세,2016,164,70,94,74.5,162,70,92,76.1
33360, 괴산군,010004, 8세,2016,186,85,101,84.2,185,84,101,83.2
33360, 괴산군,010005, 9세,2016,194,93,101,92.1,193,93,100,93
33360, 괴산군,015,10~14세,2016,965,516,449,114.9,962,514,448,114.7
33360, 괴산군,015001, 10세,2016,150,71,79,89.9,150,71,79,89.9
33360, 괴산군,015002, 11세,2016,174,89,85,104.7,171,87,84,103.6
33360, 괴산군,015003, 12세,2016,199,107,92,116.3,199,107,92,116.3
33360, 괴산군,015004, 13세,2016,215,128,87,147.1,215,128,87,147.1
33360, 괴산군,015005, 14세,2016,227,121,106,114.2,227,121,106,114.2
33360, 괴산군,020,15~19세,2016,2227,1227,1000,122.7,2219,1224,995,123
33360, 괴산군,020001, 15세,2016,275,132,143,92.3,275,132,143,92.3
33360, 괴산군,020002, 16세,2016,306,166,140,118.6,305,165,140,117.9
33360, 괴산군,020003, 17세,2016,299,163,136,119.9,299,163,136,119.9
33360, 괴산군,020004, 18세,2016,438,253,185,136.8,437,253,184,137.5
33360, 괴산군,020005, 19세,2016,909,513,396,129.5,903,511,392,130.4
33360, 괴산군,025,20~24세,2016,2967,1722,1245,138.3,2821,1641,1180,139.1
33360, 괴산군,025001, 20세,2016,747,366,381,96.1,720,352,368,95.7
33360, 괴산군,025002, 21세,2016,600,284,316,89.9,573,271,302,89.7
33360, 괴산군,025003, 22세,2016,633,386,247,156.3,608,373,235,158.7
33360, 괴산군,025004, 23세,2016,544,381,163,233.7,512,364,148,245.9
33360, 괴산군,025005, 24세,2016,443,305,138,221,408,281,127,221.3
33360, 괴산군,030,25~29세,2016,1491,900,591,152.3,1312,780,532,146.6
33360, 괴산군,030001, 25세,2016,352,224,128,175,312,194,118,164.4
33360, 괴산군,030002, 26세,2016,315,189,126,150,281,165,116,142.2
33360, 괴산군,030003, 27세,2016,302,182,120,151.7,265,156,109,143.1
33360, 괴산군,030004, 28세,2016,270,160,110,145.5,225,132,93,141.9
33360, 괴산군,030005, 29세,2016,252,145,107,135.5,229,133,96,138.5
33360, 괴산군,035,30~34세,2016,1404,820,584,140.4,1261,724,537,134.8
33360, 괴산군,035001, 30세,2016,297,176,121,145.5,253,146,107,136.4
33360, 괴산군,035002, 31세,2016,254,147,107,137.4,227,132,95,138.9
33360, 괴산군,035003, 32세,2016,279,161,118,136.4,252,141,111,127
33360, 괴산군,035004, 33세,2016,274,158,116,136.2,249,141,108,130.6
33360, 괴산군,035005, 34세,2016,300,178,122,145.9,280,164,116,141.4
33360, 괴산군,040,35~39세,2016,1488,843,645,130.7,1386,772,614,125.7
33360, 괴산군,040001, 35세,2016,290,171,119,143.7,271,155,116,133.6
33360, 괴산군,040002, 36세,2016,307,175,132,132.6,282,159,123,129.3
33360, 괴산군,040003, 37세,2016,304,163,141,115.6,278,144,134,107.5
33360, 괴산군,040004, 38세,2016,298,166,132,125.8,286,160,126,127
33360, 괴산군,040005, 39세,2016,289,168,121,138.8,269,154,115,133.9
33360, 괴산군,045,40~44세,2016,1763,1053,710,148.3,1686,1010,676,149.4
33360, 괴산군,045001, 40세,2016,292,161,131,122.9,281,154,127,121.3
33360, 괴산군,045002, 41세,2016,353,224,129,173.6,335,214,121,176.9
33360, 괴산군,045003, 42세,2016,372,216,156,138.5,355,207,148,139.9
33360, 괴산군,045004, 43세,2016,380,219,161,136,360,207,153,135.3
33360, 괴산군,045005, 44세,2016,366,233,133,175.2,355,228,127,179.5
33360, 괴산군,050,45~49세,2016,2469,1401,1068,131.2,2404,1359,1045,130
33360, 괴산군,050001, 45세,2016,448,254,194,130.9,437,247,190,130
33360, 괴산군,050002, 46세,2016,428,265,163,162.6,415,254,161,157.8
33360, 괴산군,050003, 47세,2016,512,278,234,118.8,501,271,230,117.8
33360, 괴산군,050004, 48세,2016,538,311,227,137,523,300,223,134.5
33360, 괴산군,050005, 49세,2016,543,293,250,117.2,528,287,241,119.1
33360, 괴산군,055,50~54세,2016,3068,1611,1457,110.6,3004,1575,1429,110.2
33360, 괴산군,055001, 50세,2016,580,320,260,123.1,575,318,257,123.7
33360, 괴산군,055002, 51세,2016,588,309,279,110.8,568,299,269,111.2
33360, 괴산군,055003, 52세,2016,578,303,275,110.2,558,289,269,107.4
33360, 괴산군,055004, 53세,2016,606,311,295,105.4,597,306,291,105.2
33360, 괴산군,055005, 54세,2016,716,368,348,105.7,706,363,343,105.8
33360, 괴산군,060,55~59세,2016,4077,2181,1896,115,3995,2134,1861,114.7
33360, 괴산군,060001, 55세,2016,841,448,393,114,824,436,388,112.4
33360, 괴산군,060002, 56세,2016,840,450,390,115.4,820,441,379,116.4
33360, 괴산군,060003, 57세,2016,781,411,370,111.1,766,402,364,110.4
33360, 괴산군,060004, 58세,2016,861,457,404,113.1,848,452,396,114.1
33360, 괴산군,060005, 59세,2016,754,415,339,122.4,737,403,334,120.7
33360, 괴산군,065,60~64세,2016,3662,1855,1807,102.7,3610,1824,1786,102.1
33360, 괴산군,065001, 60세,2016,816,440,376,117,807,433,374,115.8
33360, 괴산군,065002, 61세,2016,785,391,394,99.2,769,382,387,98.7
33360, 괴산군,065003, 62세,2016,753,374,379,98.7,740,366,374,97.9
33360, 괴산군,065004, 63세,2016,620,295,325,90.8,608,289,319,90.6
33360, 괴산군,065005, 64세,2016,688,355,333,106.6,686,354,332,106.6
33360, 괴산군,070,65~69세,2016,2800,1445,1355,106.6,2781,1432,1349,106.2
33360, 괴산군,070001, 65세,2016,512,252,260,96.9,508,249,259,96.1
33360, 괴산군,070002, 66세,2016,545,282,263,107.2,541,279,262,106.5
33360, 괴산군,070003, 67세,2016,583,305,278,109.7,578,301,277,108.7
33360, 괴산군,070004, 68세,2016,563,296,267,110.9,561,295,266,110.9
33360, 괴산군,070005, 69세,2016,597,310,287,108,593,308,285,108.1
33360, 괴산군,075,70~74세,2016,2657,1178,1479,79.6,2649,1174,1475,79.6
33360, 괴산군,075001, 70세,2016,431,218,213,102.3,429,217,212,102.4
33360, 괴산군,075002, 71세,2016,553,263,290,90.7,549,261,288,90.6
33360, 괴산군,075003, 72세,2016,475,197,278,70.9,475,197,278,70.9
33360, 괴산군,075004, 73세,2016,542,225,317,71,542,225,317,71
33360, 괴산군,075005, 74세,2016,656,275,381,72.2,654,274,380,72.1
33360, 괴산군,080,75~79세,2016,2728,1143,1585,72.1,2727,1142,1585,72.1
33360, 괴산군,080001, 75세,2016,613,276,337,81.9,613,276,337,81.9
33360, 괴산군,080002, 76세,2016,558,235,323,72.8,558,235,323,72.8
33360, 괴산군,080003, 77세,2016,558,238,320,74.4,558,238,320,74.4
33360, 괴산군,080004, 78세,2016,521,220,301,73.1,521,220,301,73.1
33360, 괴산군,080005, 79세,2016,478,174,304,57.2,477,173,304,56.9
33360, 괴산군,085,80~84세,2016,1765,615,1150,53.5,1764,615,1149,53.5
33360, 괴산군,085001, 80세,2016,434,165,269,61.3,434,165,269,61.3
33360, 괴산군,085002, 81세,2016,411,155,256,60.5,410,155,255,60.8
33360, 괴산군,085003, 82세,2016,358,119,239,49.8,358,119,239,49.8
33360, 괴산군,085004, 83세,2016,305,87,218,39.9,305,87,218,39.9
33360, 괴산군,085005, 84세,2016,257,89,168,53,257,89,168,53
33360, 괴산군,090,85~89세,2016,738,202,536,37.7,738,202,536,37.7
33360, 괴산군,090001, 85세,2016,196,56,140,40,196,56,140,40
33360, 괴산군,090002, 86세,2016,176,45,131,34.4,176,45,131,34.4
33360, 괴산군,090003, 87세,2016,144,40,104,38.5,144,40,104,38.5
33360, 괴산군,090004, 88세,2016,137,38,99,38.4,137,38,99,38.4
33360, 괴산군,090005, 89세,2016,85,23,62,37.1,85,23,62,37.1
33360, 괴산군,095,90~94세,2016,243,60,183,32.8,243,60,183,32.8
33360, 괴산군,095001, 90세,2016,64,13,51,25.5,64,13,51,25.5
33360, 괴산군,095002, 91세,2016,60,15,45,33.3,60,15,45,33.3
33360, 괴산군,095003, 92세,2016,40,11,29,37.9,40,11,29,37.9
33360, 괴산군,095004, 93세,2016,45,11,34,32.4,45,11,34,32.4
33360, 괴산군,095005, 94세,2016,34,10,24,41.7,34,10,24,41.7
33360, 괴산군,100,95~99세,2016,49,8,41,19.5,49,8,41,19.5
33360, 괴산군,100001, 95세,2016,20,X,17,17.6,20,X,17,17.6
33360, 괴산군,100002, 96세,2016,13,X,13,0,13,X,13,0
33360, 괴산군,100003, 97세,2016,9,X,5,80,9,X,5,80
33360, 괴산군,100004, 98세,2016,X,X,X,0,X,X,X,0
33360, 괴산군,100005, 99세,2016,X,X,X,33.3,X,X,X,33.3
33360, 괴산군,101,100세이상,2016,13,X,11,18.2,13,X,11,18.2
33360, 괴산군,102,15세미만,2016,2555,1291,1264,102.1,2542,1284,1258,102.1
33360, 괴산군,103,15~64세,2016,24616,13613,11003,123.7,23698,13043,10655,122.4
33360, 괴산군,104,65세이상,2016,10993,4653,6340,73.4,10964,4635,6329,73.2
33360, 괴산군,086,85세이상,2016,1043,272,771,35.3,1043,272,771,35.3
33360, 괴산군,126,평균연령,2016,50.2,48,52.6,,50.6,48.3,52.9,
33360, 괴산군,127,중위연령,2016,54.5,51.7,56.9,,55,52.2,57.2,
33370, 음성군,000,합계,2016,104635,57109,47526,120.2,93395,48974,44421,110.2
33370, 음성군,005,0~4세,2016,4155,2150,2005,107.2,4067,2102,1965,107
33370, 음성군,005001, 0세,2016,856,435,421,103.3,830,423,407,103.9
33370, 음성군,005002, 1세,2016,801,406,395,102.8,782,394,388,101.5
33370, 음성군,005003, 2세,2016,788,414,374,110.7,771,404,367,110.1
33370, 음성군,005004, 3세,2016,791,383,408,93.9,777,375,402,93.3
33370, 음성군,005005, 4세,2016,919,512,407,125.8,907,506,401,126.2
33370, 음성군,010,5~9세,2016,4188,2244,1944,115.4,4129,2214,1915,115.6
33370, 음성군,010001, 5세,2016,873,484,389,124.4,861,477,384,124.2
33370, 음성군,010002, 6세,2016,825,441,384,114.8,810,434,376,115.4
33370, 음성군,010003, 7세,2016,785,441,344,128.2,773,436,337,129.4
33370, 음성군,010004, 8세,2016,834,435,399,109,822,428,394,108.6
33370, 음성군,010005, 9세,2016,871,443,428,103.5,863,439,424,103.5
33370, 음성군,015,10~14세,2016,4032,2074,1958,105.9,4011,2064,1947,106
33370, 음성군,015001, 10세,2016,761,383,378,101.3,755,378,377,100.3
33370, 음성군,015002, 11세,2016,755,371,384,96.6,751,370,381,97.1
33370, 음성군,015003, 12세,2016,784,433,351,123.4,780,432,348,124.1
33370, 음성군,015004, 13세,2016,800,419,381,110,799,419,380,110.3
33370, 음성군,015005, 14세,2016,932,468,464,100.9,926,465,461,100.9
33370, 음성군,020,15~19세,2016,5493,2932,2561,114.5,5435,2898,2537,114.2
33370, 음성군,020001, 15세,2016,998,511,487,104.9,991,506,485,104.3
33370, 음성군,020002, 16세,2016,1002,507,495,102.4,996,505,491,102.9
33370, 음성군,020003, 17세,2016,1088,591,497,118.9,1083,587,496,118.3
33370, 음성군,020004, 18세,2016,1127,630,497,126.8,1117,625,492,127
33370, 음성군,020005, 19세,2016,1278,693,585,118.5,1248,675,573,117.8
33370, 음성군,025,20~24세,2016,6846,4115,2731,150.7,5525,3100,2425,127.8
33370, 음성군,025001, 20세,2016,1294,693,601,115.3,1174,609,565,107.8
33370, 음성군,025002, 21세,2016,1377,820,557,147.2,1172,658,514,128
33370, 음성군,025003, 22세,2016,1393,814,579,140.6,1117,602,515,116.9
33370, 음성군,025004, 23세,2016,1378,909,469,193.8,1040,643,397,162
33370, 음성군,025005, 24세,2016,1404,879,525,167.4,1022,588,434,135.5
33370, 음성군,030,25~29세,2016,7016,4352,2664,163.4,4769,2684,2085,128.7
33370, 음성군,030001, 25세,2016,1425,877,548,160,994,558,436,128
33370, 음성군,030002, 26세,2016,1413,862,551,156.4,974,546,428,127.6
33370, 음성군,030003, 27세,2016,1361,861,500,172.2,906,512,394,129.9
33370, 음성군,030004, 28세,2016,1399,857,542,158.1,945,524,421,124.5
33370, 음성군,030005, 29세,2016,1418,895,523,171.1,950,544,406,134
33370, 음성군,035,30~34세,2016,7387,4551,2836,160.5,5544,3103,2441,127.1
33370, 음성군,035001, 30세,2016,1348,832,516,161.2,977,546,431,126.7
33370, 음성군,035002, 31세,2016,1467,907,560,162,1034,560,474,118.1
33370, 음성군,035003, 32세,2016,1376,872,504,173,1061,632,429,147.3
33370, 음성군,035004, 33세,2016,1516,917,599,153.1,1156,636,520,122.3
33370, 음성군,035005, 34세,2016,1680,1023,657,155.7,1316,729,587,124.2
33370, 음성군,040,35~39세,2016,7972,4723,3249,145.4,6480,3559,2921,121.8
33370, 음성군,040001, 35세,2016,1696,1033,663,155.8,1338,740,598,123.7
33370, 음성군,040002, 36세,2016,1655,947,708,133.8,1353,721,632,114.1
33370, 음성군,040003, 37세,2016,1614,960,654,146.8,1284,703,581,121
33370, 음성군,040004, 38세,2016,1463,841,622,135.2,1193,636,557,114.2
33370, 음성군,040005, 39세,2016,1544,942,602,156.5,1312,759,553,137.3
33370, 음성군,045,40~44세,2016,8022,4642,3380,137.3,6961,3880,3081,125.9
33370, 음성군,045001, 40세,2016,1504,876,628,139.5,1280,705,575,122.6
33370, 음성군,045002, 41세,2016,1572,906,666,136,1372,764,608,125.7
33370, 음성군,045003, 42세,2016,1659,935,724,129.1,1458,799,659,121.2
33370, 음성군,045004, 43세,2016,1694,986,708,139.3,1489,834,655,127.3
33370, 음성군,045005, 44세,2016,1593,939,654,143.6,1362,778,584,133.2
33370, 음성군,050,45~49세,2016,8825,5057,3768,134.2,7792,4389,3403,129
33370, 음성군,050001, 45세,2016,1757,1030,727,141.7,1545,886,659,134.4
33370, 음성군,050002, 46세,2016,1740,1012,728,139,1537,892,645,138.3
33370, 음성군,050003, 47세,2016,1845,1073,772,139,1638,936,702,133.3
33370, 음성군,050004, 48세,2016,1829,1045,784,133.3,1604,893,711,125.6
33370, 음성군,050005, 49세,2016,1654,897,757,118.5,1468,782,686,114
33370, 음성군,055,50~54세,2016,8706,4866,3840,126.7,7770,4242,3528,120.2
33370, 음성군,055001, 50세,2016,1731,987,744,132.7,1538,857,681,125.8
33370, 음성군,055002, 51세,2016,1779,986,793,124.3,1586,846,740,114.3
33370, 음성군,055003, 52세,2016,1652,912,740,123.2,1454,785,669,117.3
33370, 음성군,055004, 53세,2016,1656,955,701,136.2,1456,826,630,131.1
33370, 음성군,055005, 54세,2016,1888,1026,862,119,1736,928,808,114.9
33370, 음성군,060,55~59세,2016,8958,4867,4091,119,8430,4531,3899,116.2
33370, 음성군,060001, 55세,2016,1978,1116,862,129.5,1876,1060,816,129.9
33370, 음성군,060002, 56세,2016,1888,1010,878,115,1764,933,831,112.3
33370, 음성군,060003, 57세,2016,1785,958,827,115.8,1683,889,794,112
33370, 음성군,060004, 58세,2016,1718,924,794,116.4,1622,861,761,113.1
33370, 음성군,060005, 59세,2016,1589,859,730,117.7,1485,788,697,113.1
33370, 음성군,065,60~64세,2016,6742,3559,3183,111.8,6400,3329,3071,108.4
33370, 음성군,065001, 60세,2016,1532,801,731,109.6,1446,741,705,105.1
33370, 음성군,065002, 61세,2016,1473,768,705,108.9,1390,716,674,106.2
33370, 음성군,065003, 62세,2016,1354,707,647,109.3,1265,642,623,103
33370, 음성군,065004, 63세,2016,1084,608,476,127.7,1034,575,459,125.3
33370, 음성군,065005, 64세,2016,1299,675,624,108.2,1265,655,610,107.4
33370, 음성군,070,65~69세,2016,4434,2237,2197,101.8,4299,2163,2136,101.3
33370, 음성군,070001, 65세,2016,825,412,413,99.8,793,393,400,98.3
33370, 음성군,070002, 66세,2016,866,437,429,101.9,831,418,413,101.2
33370, 음성군,070003, 67세,2016,964,489,475,102.9,933,473,460,102.8
33370, 음성군,070004, 68세,2016,888,452,436,103.7,870,442,428,103.3
33370, 음성군,070005, 69세,2016,891,447,444,100.7,872,437,435,100.5
33370, 음성군,075,70~74세,2016,4059,1912,2147,89.1,4026,1902,2124,89.5
33370, 음성군,075001, 70세,2016,708,353,355,99.4,699,350,349,100.3
33370, 음성군,075002, 71세,2016,765,370,395,93.7,759,369,390,94.6
33370, 음성군,075003, 72세,2016,796,362,434,83.4,785,359,426,84.3
33370, 음성군,075004, 73세,2016,794,363,431,84.2,791,361,430,84
33370, 음성군,075005, 74세,2016,996,464,532,87.2,992,463,529,87.5
33370, 음성군,080,75~79세,2016,3692,1538,2154,71.4,3663,1527,2136,71.5
33370, 음성군,080001, 75세,2016,822,370,452,81.9,817,368,449,82
33370, 음성군,080002, 76세,2016,781,328,453,72.4,773,326,447,72.9
33370, 음성군,080003, 77세,2016,767,332,435,76.3,763,330,433,76.2
33370, 음성군,080004, 78세,2016,663,250,413,60.5,660,248,412,60.2
33370, 음성군,080005, 79세,2016,659,258,401,64.3,650,255,395,64.6
33370, 음성군,085,80~84세,2016,2531,859,1672,51.4,2524,857,1667,51.4
33370, 음성군,085001, 80세,2016,613,235,378,62.2,610,234,376,62.2
33370, 음성군,085002, 81세,2016,637,213,424,50.2,636,213,423,50.4
33370, 음성군,085003, 82세,2016,487,162,325,49.8,485,161,324,49.7
33370, 음성군,085004, 83세,2016,409,139,270,51.5,409,139,270,51.5
33370, 음성군,085005, 84세,2016,385,110,275,40,384,110,274,40.1
33370, 음성군,090,85~89세,2016,1142,319,823,38.8,1136,318,818,38.9
33370, 음성군,090001, 85세,2016,294,77,217,35.5,292,77,215,35.8
33370, 음성군,090002, 86세,2016,281,81,200,40.5,280,81,199,40.7
33370, 음성군,090003, 87세,2016,242,74,168,44,241,73,168,43.5
33370, 음성군,090004, 88세,2016,202,54,148,36.5,201,54,147,36.7
33370, 음성군,090005, 89세,2016,123,33,90,36.7,122,33,89,37.1
33370, 음성군,095,90~94세,2016,354,97,257,37.7,353,97,256,37.9
33370, 음성군,095001, 90세,2016,90,27,63,42.9,89,27,62,43.5
33370, 음성군,095002, 91세,2016,109,26,83,31.3,109,26,83,31.3
33370, 음성군,095003, 92세,2016,58,17,41,41.5,58,17,41,41.5
33370, 음성군,095004, 93세,2016,71,17,54,31.5,71,17,54,31.5
33370, 음성군,095005, 94세,2016,26,10,16,62.5,26,10,16,62.5
33370, 음성군,100,95~99세,2016,72,13,59,22,72,13,59,22
33370, 음성군,100001, 95세,2016,30,6,24,25,30,6,24,25
33370, 음성군,100002, 96세,2016,13,X,9,44.4,13,X,9,44.4
33370, 음성군,100003, 97세,2016,17,X,17,0,17,X,17,0
33370, 음성군,100004, 98세,2016,8,X,7,14.3,8,X,7,14.3
33370, 음성군,100005, 99세,2016,X,X,X,100,X,X,X,100
33370, 음성군,101,100세이상,2016,9,X,7,28.6,9,X,7,28.6
33370, 음성군,102,15세미만,2016,12375,6468,5907,109.5,12207,6380,5827,109.5
33370, 음성군,103,15~64세,2016,75967,43664,32303,135.2,65106,35715,29391,121.5
33370, 음성군,104,65세이상,2016,16293,6977,9316,74.9,16082,6879,9203,74.7
33370, 음성군,086,85세이상,2016,1577,431,1146,37.6,1570,430,1140,37.7
33370, 음성군,126,평균연령,2016,42.6,41.1,44.3,,43.2,41.9,44.7,
33370, 음성군,127,중위연령,2016,43.3,41.6,45.6,,44.8,43.6,46.4,
33380, 단양군,000,합계,2016,28503,14284,14219,100.5,28210,14138,14072,100.5
33380, 단양군,005,0~4세,2016,680,338,342,98.8,679,337,342,98.5
33380, 단양군,005001, 0세,2016,117,51,66,77.3,117,51,66,77.3
33380, 단양군,005002, 1세,2016,135,64,71,90.1,135,64,71,90.1
33380, 단양군,005003, 2세,2016,141,80,61,131.1,141,80,61,131.1
33380, 단양군,005004, 3세,2016,123,62,61,101.6,122,61,61,100
33380, 단양군,005005, 4세,2016,164,81,83,97.6,164,81,83,97.6
33380, 단양군,010,5~9세,2016,863,464,399,116.3,861,464,397,116.9
33380, 단양군,010001, 5세,2016,155,87,68,127.9,155,87,68,127.9
33380, 단양군,010002, 6세,2016,150,85,65,130.8,149,85,64,132.8
33380, 단양군,010003, 7세,2016,172,96,76,126.3,172,96,76,126.3
33380, 단양군,010004, 8세,2016,193,93,100,93,192,93,99,93.9
33380, 단양군,010005, 9세,2016,193,103,90,114.4,193,103,90,114.4
33380, 단양군,015,10~14세,2016,1035,555,480,115.6,1035,555,480,115.6
33380, 단양군,015001, 10세,2016,196,97,99,98,196,97,99,98
33380, 단양군,015002, 11세,2016,197,114,83,137.3,197,114,83,137.3
33380, 단양군,015003, 12세,2016,208,122,86,141.9,208,122,86,141.9
33380, 단양군,015004, 13세,2016,207,108,99,109.1,207,108,99,109.1
33380, 단양군,015005, 14세,2016,227,114,113,100.9,227,114,113,100.9
33380, 단양군,020,15~19세,2016,1224,656,568,115.5,1224,656,568,115.5
33380, 단양군,020001, 15세,2016,266,137,129,106.2,266,137,129,106.2
33380, 단양군,020002, 16세,2016,296,127,169,75.1,296,127,169,75.1
33380, 단양군,020003, 17세,2016,271,154,117,131.6,271,154,117,131.6
33380, 단양군,020004, 18세,2016,257,151,106,142.5,257,151,106,142.5
33380, 단양군,020005, 19세,2016,134,87,47,185.1,134,87,47,185.1
33380, 단양군,025,20~24세,2016,1138,697,441,158,1102,676,426,158.7
33380, 단양군,025001, 20세,2016,215,153,62,246.8,214,152,62,245.2
33380, 단양군,025002, 21세,2016,231,143,88,162.5,221,138,83,166.3
33380, 단양군,025003, 22세,2016,237,145,92,157.6,229,141,88,160.2
33380, 단양군,025004, 23세,2016,206,117,89,131.5,202,113,89,127
33380, 단양군,025005, 24세,2016,249,139,110,126.4,236,132,104,126.9
33380, 단양군,030,25~29세,2016,1035,586,449,130.5,982,564,418,134.9
33380, 단양군,030001, 25세,2016,200,114,86,132.6,187,106,81,130.9
33380, 단양군,030002, 26세,2016,214,130,84,154.8,198,123,75,164
33380, 단양군,030003, 27세,2016,223,129,94,137.2,216,128,88,145.5
33380, 단양군,030004, 28세,2016,188,104,84,123.8,182,102,80,127.5
33380, 단양군,030005, 29세,2016,210,109,101,107.9,199,105,94,111.7
33380, 단양군,035,30~34세,2016,1079,600,479,125.3,1046,583,463,125.9
33380, 단양군,035001, 30세,2016,184,115,69,166.7,179,111,68,163.2
33380, 단양군,035002, 31세,2016,205,121,84,144,195,118,77,153.2
33380, 단양군,035003, 32세,2016,197,107,90,118.9,187,101,86,117.4
33380, 단양군,035004, 33세,2016,241,125,116,107.8,236,122,114,107
33380, 단양군,035005, 34세,2016,252,132,120,110,249,131,118,111
33380, 단양군,040,35~39세,2016,1326,730,596,122.5,1289,709,580,122.2
33380, 단양군,040001, 35세,2016,268,142,126,112.7,260,134,126,106.3
33380, 단양군,040002, 36세,2016,284,161,123,130.9,276,158,118,133.9
33380, 단양군,040003, 37세,2016,264,141,123,114.6,257,138,119,116
33380, 단양군,040004, 38세,2016,266,152,114,133.3,257,145,112,129.5
33380, 단양군,040005, 39세,2016,244,134,110,121.8,239,134,105,127.6
33380, 단양군,045,40~44세,2016,1686,923,763,121,1657,906,751,120.6
33380, 단양군,045001, 40세,2016,281,159,122,130.3,277,157,120,130.8
33380, 단양군,045002, 41세,2016,300,166,134,123.9,292,159,133,119.5
33380, 단양군,045003, 42세,2016,354,187,167,112,348,184,164,112.2
33380, 단양군,045004, 43세,2016,380,210,170,123.5,374,207,167,124
33380, 단양군,045005, 44세,2016,371,201,170,118.2,366,199,167,119.2
33380, 단양군,050,45~49세,2016,2189,1141,1048,108.9,2161,1127,1034,109
33380, 단양군,050001, 45세,2016,410,201,209,96.2,405,199,206,96.6
33380, 단양군,050002, 46세,2016,430,244,186,131.2,426,243,183,132.8
33380, 단양군,050003, 47세,2016,434,245,189,129.6,426,241,185,130.3
33380, 단양군,050004, 48세,2016,486,240,246,97.6,480,235,245,95.9
33380, 단양군,050005, 49세,2016,429,211,218,96.8,424,209,215,97.2
33380, 단양군,055,50~54세,2016,2531,1369,1162,117.8,2496,1355,1141,118.8
33380, 단양군,055001, 50세,2016,496,263,233,112.9,490,261,229,114
33380, 단양군,055002, 51세,2016,499,268,231,116,493,265,228,116.2
33380, 단양군,055003, 52세,2016,453,250,203,123.2,446,248,198,125.3
33380, 단양군,055004, 53세,2016,503,275,228,120.6,493,271,222,122.1
33380, 단양군,055005, 54세,2016,580,313,267,117.2,574,310,264,117.4
33380, 단양군,060,55~59세,2016,3374,1681,1693,99.3,3358,1676,1682,99.6
33380, 단양군,060001, 55세,2016,719,375,344,109,717,374,343,109
33380, 단양군,060002, 56세,2016,669,299,370,80.8,666,298,368,81
33380, 단양군,060003, 57세,2016,632,312,320,97.5,629,311,318,97.8
33380, 단양군,060004, 58세,2016,658,329,329,100,654,328,326,100.6
33380, 단양군,060005, 59세,2016,696,366,330,110.9,692,365,327,111.6
33380, 단양군,065,60~64세,2016,2739,1407,1332,105.6,2725,1397,1328,105.2
33380, 단양군,065001, 60세,2016,590,310,280,110.7,585,307,278,110.4
33380, 단양군,065002, 61세,2016,604,299,305,98,602,298,304,98
33380, 단양군,065003, 62세,2016,561,295,266,110.9,556,291,265,109.8
33380, 단양군,065004, 63세,2016,427,216,211,102.4,426,215,211,101.9
33380, 단양군,065005, 64세,2016,557,287,270,106.3,556,286,270,105.9
33380, 단양군,070,65~69세,2016,2089,1003,1086,92.4,2085,1002,1083,92.5
33380, 단양군,070001, 65세,2016,326,157,169,92.9,325,157,168,93.5
33380, 단양군,070002, 66세,2016,411,188,223,84.3,410,188,222,84.7
33380, 단양군,070003, 67세,2016,454,243,211,115.2,452,242,210,115.2
33380, 단양군,070004, 68세,2016,462,217,245,88.6,462,217,245,88.6
33380, 단양군,070005, 69세,2016,436,198,238,83.2,436,198,238,83.2
33380, 단양군,075,70~74세,2016,1916,804,1112,72.3,1914,802,1112,72.1
33380, 단양군,075001, 70세,2016,299,125,174,71.8,298,124,174,71.3
33380, 단양군,075002, 71세,2016,358,156,202,77.2,357,155,202,76.7
33380, 단양군,075003, 72세,2016,384,155,229,67.7,384,155,229,67.7
33380, 단양군,075004, 73세,2016,399,168,231,72.7,399,168,231,72.7
33380, 단양군,075005, 74세,2016,476,200,276,72.5,476,200,276,72.5
33380, 단양군,080,75~79세,2016,1858,773,1085,71.2,1857,773,1084,71.3
33380, 단양군,080001, 75세,2016,436,212,224,94.6,436,212,224,94.6
33380, 단양군,080002, 76세,2016,375,143,232,61.6,375,143,232,61.6
33380, 단양군,080003, 77세,2016,397,170,227,74.9,397,170,227,74.9
33380, 단양군,080004, 78세,2016,356,126,230,54.8,356,126,230,54.8
33380, 단양군,080005, 79세,2016,294,122,172,70.9,293,122,171,71.3
33380, 단양군,085,80~84세,2016,1098,392,706,55.5,1098,392,706,55.5
33380, 단양군,085001, 80세,2016,289,118,171,69,289,118,171,69
33380, 단양군,085002, 81세,2016,250,89,161,55.3,250,89,161,55.3
33380, 단양군,085003, 82세,2016,220,79,141,56,220,79,141,56
33380, 단양군,085004, 83세,2016,188,64,124,51.6,188,64,124,51.6
33380, 단양군,085005, 84세,2016,151,42,109,38.5,151,42,109,38.5
33380, 단양군,090,85~89세,2016,452,117,335,34.9,451,116,335,34.6
33380, 단양군,090001, 85세,2016,112,35,77,45.5,112,35,77,45.5
33380, 단양군,090002, 86세,2016,124,30,94,31.9,124,30,94,31.9
33380, 단양군,090003, 87세,2016,97,29,68,42.6,96,28,68,41.2
33380, 단양군,090004, 88세,2016,72,14,58,24.1,72,14,58,24.1
33380, 단양군,090005, 89세,2016,47,9,38,23.7,47,9,38,23.7
33380, 단양군,095,90~94세,2016,149,44,105,41.9,148,44,104,42.3
33380, 단양군,095001, 90세,2016,40,14,26,53.8,40,14,26,53.8
33380, 단양군,095002, 91세,2016,30,6,24,25,29,6,23,26.1
33380, 단양군,095003, 92세,2016,32,12,20,60,32,12,20,60
33380, 단양군,095004, 93세,2016,24,5,19,26.3,24,5,19,26.3
33380, 단양군,095005, 94세,2016,23,7,16,43.8,23,7,16,43.8
33380, 단양군,100,95~99세,2016,41,X,37,10.8,41,X,37,10.8
33380, 단양군,100001, 95세,2016,20,X,19,5.3,20,X,19,5.3
33380, 단양군,100002, 96세,2016,6,X,5,20,6,X,5,20
33380, 단양군,100003, 97세,2016,7,X,5,40,7,X,5,40
33380, 단양군,100004, 98세,2016,6,X,6,0,6,X,6,0
33380, 단양군,100005, 99세,2016,X,X,X,0,X,X,X,0
33380, 단양군,101,100세이상,2016,X,X,X,0,X,X,X,0
33380, 단양군,102,15세미만,2016,2578,1357,1221,111.1,2575,1356,1219,111.2
33380, 단양군,103,15~64세,2016,18321,9790,8531,114.8,18040,9649,8391,115
33380, 단양군,104,65세이상,2016,7604,3137,4467,70.2,7595,3133,4462,70.2
33380, 단양군,086,85세이상,2016,643,165,478,34.5,641,164,477,34.4
33380, 단양군,126,평균연령,2016,50.1,47.9,52.2,,50.2,48,52.4,
33380, 단양군,127,중위연령,2016,54.1,51.7,56.1,,54.3,51.9,56.3,
33390, 증평군,000,합계,2016,37075,18791,18284,102.8,36247,18358,17889,102.6
33390, 증평군,005,0~4세,2016,2046,1021,1025,99.6,2035,1018,1017,100.1
33390, 증평군,005001, 0세,2016,410,201,209,96.2,406,200,206,97.1
33390, 증평군,005002, 1세,2016,392,212,180,117.8,389,211,178,118.5
33390, 증평군,005003, 2세,2016,422,186,236,78.8,421,186,235,79.1
33390, 증평군,005004, 3세,2016,434,227,207,109.7,433,226,207,109.2
33390, 증평군,005005, 4세,2016,388,195,193,101,386,195,191,102.1
33390, 증평군,010,5~9세,2016,1945,1023,922,111,1940,1021,919,111.1
33390, 증평군,010001, 5세,2016,440,229,211,108.5,437,228,209,109.1
33390, 증평군,010002, 6세,2016,412,216,196,110.2,411,216,195,110.8
33390, 증평군,010003, 7세,2016,369,200,169,118.3,369,200,169,118.3
33390, 증평군,010004, 8세,2016,379,199,180,110.6,378,198,180,110
33390, 증평군,010005, 9세,2016,345,179,166,107.8,345,179,166,107.8
33390, 증평군,015,10~14세,2016,1697,866,831,104.2,1694,864,830,104.1
33390, 증평군,015001, 10세,2016,321,166,155,107.1,321,166,155,107.1
33390, 증평군,015002, 11세,2016,361,190,171,111.1,361,190,171,111.1
33390, 증평군,015003, 12세,2016,337,176,161,109.3,334,174,160,108.8
33390, 증평군,015004, 13세,2016,323,162,161,100.6,323,162,161,100.6
33390, 증평군,015005, 14세,2016,355,172,183,94,355,172,183,94
33390, 증평군,020,15~19세,2016,2123,1068,1055,101.2,2118,1065,1053,101.1
33390, 증평군,020001, 15세,2016,356,193,163,118.4,356,193,163,118.4
33390, 증평군,020002, 16세,2016,411,216,195,110.8,410,215,195,110.3
33390, 증평군,020003, 17세,2016,373,193,180,107.2,373,193,180,107.2
33390, 증평군,020004, 18세,2016,451,229,222,103.2,448,227,221,102.7
33390, 증평군,020005, 19세,2016,532,237,295,80.3,531,237,294,80.6
33390, 증평군,025,20~24세,2016,2534,1314,1220,107.7,2471,1281,1190,107.6
33390, 증평군,025001, 20세,2016,499,217,282,77,492,213,279,76.3
33390, 증평군,025002, 21세,2016,525,260,265,98.1,512,254,258,98.4
33390, 증평군,025003, 22세,2016,535,269,266,101.1,520,260,260,100
33390, 증평군,025004, 23세,2016,519,301,218,138.1,504,292,212,137.7
33390, 증평군,025005, 24세,2016,456,267,189,141.3,443,262,181,144.8
33390, 증평군,030,25~29세,2016,2164,1219,945,129,2020,1143,877,130.3
33390, 증평군,030001, 25세,2016,437,242,195,124.1,413,234,179,130.7
33390, 증평군,030002, 26세,2016,448,261,187,139.6,412,240,172,139.5
33390, 증평군,030003, 27세,2016,404,234,170,137.6,368,215,153,140.5
33390, 증평군,030004, 28세,2016,427,224,203,110.3,406,211,195,108.2
33390, 증평군,030005, 29세,2016,448,258,190,135.8,421,243,178,136.5
33390, 증평군,035,30~34세,2016,2769,1527,1242,122.9,2618,1448,1170,123.8
33390, 증평군,035001, 30세,2016,472,270,202,133.7,438,251,187,134.2
33390, 증평군,035002, 31세,2016,524,287,237,121.1,495,273,222,123
33390, 증평군,035003, 32세,2016,552,306,246,124.4,509,282,227,124.2
33390, 증평군,035004, 33세,2016,605,342,263,130,580,330,250,132
33390, 증평군,035005, 34세,2016,616,322,294,109.5,596,312,284,109.9
33390, 증평군,040,35~39세,2016,2870,1507,1363,110.6,2801,1471,1330,110.6
33390, 증평군,040001, 35세,2016,598,324,274,118.2,580,313,267,117.2
33390, 증평군,040002, 36세,2016,614,310,304,102,605,307,298,103
33390, 증평군,040003, 37세,2016,576,307,269,114.1,565,300,265,113.2
33390, 증평군,040004, 38세,2016,511,268,243,110.3,495,259,236,109.7
33390, 증평군,040005, 39세,2016,571,298,273,109.2,556,292,264,110.6
33390, 증평군,045,40~44세,2016,2828,1538,1290,119.2,2750,1495,1255,119.1
33390, 증평군,045001, 40세,2016,533,286,247,115.8,520,281,239,117.6
33390, 증평군,045002, 41세,2016,530,292,238,122.7,511,282,229,123.1
33390, 증평군,045003, 42세,2016,623,353,270,130.7,609,345,264,130.7
33390, 증평군,045004, 43세,2016,591,325,266,122.2,573,314,259,121.2
33390, 증평군,045005, 44세,2016,551,282,269,104.8,537,273,264,103.4
33390, 증평군,050,45~49세,2016,2952,1534,1418,108.2,2878,1499,1379,108.7
33390, 증평군,050001, 45세,2016,580,304,276,110.1,567,296,271,109.2
33390, 증평군,050002, 46세,2016,541,285,256,111.3,524,275,249,110.4
33390, 증평군,050003, 47세,2016,644,328,316,103.8,626,320,306,104.6
33390, 증평군,050004, 48세,2016,593,314,279,112.5,579,309,270,114.4
33390, 증평군,050005, 49세,2016,594,303,291,104.1,582,299,283,105.7
33390, 증평군,055,50~54세,2016,2763,1451,1312,110.6,2667,1403,1264,111
33390, 증평군,055001, 50세,2016,579,292,287,101.7,560,284,276,102.9
33390, 증평군,055002, 51세,2016,539,269,270,99.6,527,263,264,99.6
33390, 증평군,055003, 52세,2016,508,278,230,120.9,488,267,221,120.8
33390, 증평군,055004, 53세,2016,530,292,238,122.7,508,278,230,120.9
33390, 증평군,055005, 54세,2016,607,320,287,111.5,584,311,273,113.9
33390, 증평군,060,55~59세,2016,2904,1479,1425,103.8,2839,1445,1394,103.7
33390, 증평군,060001, 55세,2016,640,313,327,95.7,626,306,320,95.6
33390, 증평군,060002, 56세,2016,596,296,300,98.7,584,289,295,98
33390, 증평군,060003, 57세,2016,550,305,245,124.5,534,299,235,127.2
33390, 증평군,060004, 58세,2016,539,267,272,98.2,529,259,270,95.9
33390, 증평군,060005, 59세,2016,579,298,281,106,566,292,274,106.6
33390, 증평군,065,60~64세,2016,2219,1089,1130,96.4,2191,1068,1123,95.1
33390, 증평군,065001, 60세,2016,498,239,259,92.3,487,232,255,91
33390, 증평군,065002, 61세,2016,474,235,239,98.3,469,230,239,96.2
33390, 증평군,065003, 62세,2016,457,219,238,92,450,213,237,89.9
33390, 증평군,065004, 63세,2016,355,174,181,96.1,352,171,181,94.5
33390, 증평군,065005, 64세,2016,435,222,213,104.2,433,222,211,105.2
33390, 증평군,070,65~69세,2016,1449,717,732,98,1424,705,719,98.1
33390, 증평군,070001, 65세,2016,286,137,149,91.9,278,134,144,93.1
33390, 증평군,070002, 66세,2016,282,146,136,107.4,277,142,135,105.2
33390, 증평군,070003, 67세,2016,276,128,148,86.5,272,125,147,85
33390, 증평군,070004, 68세,2016,314,163,151,107.9,313,163,150,108.7
33390, 증평군,070005, 69세,2016,291,143,148,96.6,284,141,143,98.6
33390, 증평군,075,70~74세,2016,1339,585,754,77.6,1334,582,752,77.4
33390, 증평군,075001, 70세,2016,227,110,117,94,225,108,117,92.3
33390, 증평군,075002, 71세,2016,259,127,132,96.2,257,126,131,96.2
33390, 증평군,075003, 72세,2016,257,107,150,71.3,256,107,149,71.8
33390, 증평군,075004, 73세,2016,295,117,178,65.7,295,117,178,65.7
33390, 증평군,075005, 74세,2016,301,124,177,70.1,301,124,177,70.1
33390, 증평군,080,75~79세,2016,1196,493,703,70.1,1192,491,701,70
33390, 증평군,080001, 75세,2016,276,114,162,70.4,276,114,162,70.4
33390, 증평군,080002, 76세,2016,232,106,126,84.1,231,105,126,83.3
33390, 증평군,080003, 77세,2016,233,99,134,73.9,233,99,134,73.9
33390, 증평군,080004, 78세,2016,252,91,161,56.5,250,90,160,56.3
33390, 증평군,080005, 79세,2016,203,83,120,69.2,202,83,119,69.7
33390, 증평군,085,80~84세,2016,813,243,570,42.6,812,243,569,42.7
33390, 증평군,085001, 80세,2016,210,67,143,46.9,209,67,142,47.2
33390, 증평군,085002, 81세,2016,194,60,134,44.8,194,60,134,44.8
33390, 증평군,085003, 82세,2016,144,49,95,51.6,144,49,95,51.6
33390, 증평군,085004, 83세,2016,149,38,111,34.2,149,38,111,34.2
33390, 증평군,085005, 84세,2016,116,29,87,33.3,116,29,87,33.3
33390, 증평군,090,85~89세,2016,333,92,241,38.2,332,91,241,37.8
33390, 증평군,090001, 85세,2016,92,24,68,35.3,91,23,68,33.8
33390, 증평군,090002, 86세,2016,75,19,56,33.9,75,19,56,33.9
33390, 증평군,090003, 87세,2016,69,19,50,38,69,19,50,38
33390, 증평군,090004, 88세,2016,55,18,37,48.6,55,18,37,48.6
33390, 증평군,090005, 89세,2016,42,12,30,40,42,12,30,40
33390, 증평군,095,90~94세,2016,107,18,89,20.2,107,18,89,20.2
33390, 증평군,095001, 90세,2016,28,8,20,40,28,8,20,40
33390, 증평군,095002, 91세,2016,26,X,24,8.3,26,X,24,8.3
33390, 증평군,095003, 92세,2016,19,X,16,18.8,19,X,16,18.8
33390, 증평군,095004, 93세,2016,20,X,18,11.1,20,X,18,11.1
33390, 증평군,095005, 94세,2016,14,X,11,27.3,14,X,11,27.3
33390, 증평군,100,95~99세,2016,21,7,14,50,21,7,14,50
33390, 증평군,100001, 95세,2016,6,X,X,50,6,X,X,50
33390, 증평군,100002, 96세,2016,X,X,X,50,X,X,X,50
33390, 증평군,100003, 97세,2016,8,X,X,100,8,X,X,100
33390, 증평군,100004, 98세,2016,X,X,X,0,X,X,X,0
33390, 증평군,100005, 99세,2016,X,X,X,0,X,X,X,0
33390, 증평군,101,100세이상,2016,X,X,X,0,X,X,X,0
33390, 증평군,102,15세미만,2016,5688,2910,2778,104.8,5669,2903,2766,105
33390, 증평군,103,15~64세,2016,26126,13726,12400,110.7,25353,13318,12035,110.7
33390, 증평군,104,65세이상,2016,5261,2155,3106,69.4,5225,2137,3088,69.2
33390, 증평군,086,85세이상,2016,464,117,347,33.7,463,116,347,33.4
33390, 증평군,126,평균연령,2016,40.4,39.2,41.7,,40.5,39.1,41.8,
33390, 증평군,127,중위연령,2016,40.7,39.5,42.2,,40.8,39.5,42.3,
34,충청남도,000,합계,2016,2132566,1091091,1041475,104.8,2055033,1043049,1011984,103.1
34,충청남도,005,0~4세,2016,95828,48964,46864,104.5,94805,48428,46377,104.4
34,충청남도,005001, 0세,2016,17725,8986,8739,102.8,17489,8863,8626,102.7
34,충청남도,005002, 1세,2016,18981,9670,9311,103.9,18764,9572,9192,104.1
34,충청남도,005003, 2세,2016,18661,9581,9080,105.5,18472,9481,8991,105.4
34,충청남도,005004, 3세,2016,19491,9992,9499,105.2,19302,9884,9418,104.9
34,충청남도,005005, 4세,2016,20970,10735,10235,104.9,20778,10628,10150,104.7
34,충청남도,010,5~9세,2016,100534,52093,48441,107.5,99909,51766,48143,107.5
34,충청남도,010001, 5세,2016,20722,10748,9974,107.8,20535,10654,9881,107.8
34,충청남도,010002, 6세,2016,20003,10388,9615,108,19860,10317,9543,108.1
34,충청남도,010003, 7세,2016,19177,9933,9244,107.5,19081,9880,9201,107.4
34,충청남도,010004, 8세,2016,20203,10414,9789,106.4,20098,10356,9742,106.3
34,충청남도,010005, 9세,2016,20429,10610,9819,108.1,20335,10559,9776,108
34,충청남도,015,10~14세,2016,96299,49907,46392,107.6,95974,49750,46224,107.6
34,충청남도,015001, 10세,2016,18770,9677,9093,106.4,18695,9648,9047,106.6
34,충청남도,015002, 11세,2016,18215,9398,8817,106.6,18135,9355,8780,106.5
34,충청남도,015003, 12세,2016,19530,10114,9416,107.4,19452,10075,9377,107.4
34,충청남도,015004, 13세,2016,19619,10162,9457,107.5,19571,10135,9436,107.4
34,충청남도,015005, 14세,2016,20165,10556,9609,109.9,20121,10537,9584,109.9
34,충청남도,020,15~19세,2016,133487,69607,63880,109,132137,69012,63125,109.3
34,충청남도,020001, 15세,2016,23582,12312,11270,109.2,23507,12272,11235,109.2
34,충청남도,020002, 16세,2016,25815,13640,12175,112,25720,13590,12130,112
34,충청남도,020003, 17세,2016,24986,13156,11830,111.2,24869,13099,11770,111.3
34,충청남도,020004, 18세,2016,27419,14422,12997,111,27112,14289,12823,111.4
34,충청남도,020005, 19세,2016,31685,16077,15608,103,30929,15762,15167,103.9
34,충청남도,025,20~24세,2016,149280,79892,69388,115.1,139392,74262,65130,114
34,충청남도,025001, 20세,2016,30569,15116,15453,97.8,29251,14534,14717,98.8
34,충청남도,025002, 21세,2016,29954,15326,14628,104.8,28157,14425,13732,105
34,충청남도,025003, 22세,2016,30243,16386,13857,118.3,28163,15208,12955,117.4
34,충청남도,025004, 23세,2016,29423,16461,12962,127,27236,15098,12138,124.4
34,충청남도,025005, 24세,2016,29091,16603,12488,133,26585,14997,11588,129.4
34,충청남도,030,25~29세,2016,128291,71924,56367,127.6,114044,62541,51503,121.4
34,충청남도,030001, 25세,2016,25654,14405,11249,128.1,23185,12862,10323,124.6
34,충청남도,030002, 26세,2016,25334,14264,11070,128.9,22383,12336,10047,122.8
34,충청남도,030003, 27세,2016,25185,14241,10944,130.1,22320,12296,10024,122.7
34,충청남도,030004, 28세,2016,25628,14275,11353,125.7,22693,12326,10367,118.9
34,충청남도,030005, 29세,2016,26490,14739,11751,125.4,23463,12721,10742,118.4
34,충청남도,035,30~34세,2016,147304,81133,66171,122.6,134323,72301,62022,116.6
34,충청남도,035001, 30세,2016,26614,14775,11839,124.8,23824,12933,10891,118.7
34,충청남도,035002, 31세,2016,26910,15053,11857,127,24142,13169,10973,120
34,충청남도,035003, 32세,2016,28328,15556,12772,121.8,25813,13829,11984,115.4
34,충청남도,035004, 33세,2016,31352,17198,14154,121.5,28844,15468,13376,115.6
34,충청남도,035005, 34세,2016,34100,18551,15549,119.3,31700,16902,14798,114.2
34,충청남도,040,35~39세,2016,161684,87950,73734,119.3,152285,81350,70935,114.7
34,충청남도,040001, 35세,2016,33721,18562,15159,122.4,31609,17071,14538,117.4
34,충청남도,040002, 36세,2016,34683,18723,15960,117.3,32606,17271,15335,112.6
34,충청남도,040003, 37세,2016,32224,17411,14813,117.5,30339,16092,14247,113
34,충청남도,040004, 38세,2016,30183,16613,13570,122.4,28436,15366,13070,117.6
34,충청남도,040005, 39세,2016,30873,16641,14232,116.9,29295,15550,13745,113.1
34,충청남도,045,40~44세,2016,162513,87050,75463,115.4,155285,82237,73048,112.6
34,충청남도,045001, 40세,2016,30317,16231,14086,115.2,28780,15180,13600,111.6
34,충청남도,045002, 41세,2016,31218,16505,14713,112.2,29767,15504,14263,108.7
34,충청남도,045003, 42세,2016,34112,18396,15716,117.1,32731,17452,15279,114.2
34,충청남도,045004, 43세,2016,34085,18149,15936,113.9,32708,17283,15425,112
34,충청남도,045005, 44세,2016,32781,17769,15012,118.4,31299,16818,14481,116.1
34,충청남도,050,45~49세,2016,172448,91787,80661,113.8,165861,87859,78002,112.6
34,충청남도,050001, 45세,2016,36113,19591,16522,118.6,34640,18649,15991,116.6
34,충청남도,050002, 46세,2016,33957,18240,15717,116.1,32530,17366,15164,114.5
34,충청남도,050003, 47세,2016,35534,18881,16653,113.4,34181,18101,16080,112.6
34,충청남도,050004, 48세,2016,35003,18335,16668,110,33732,17606,16126,109.2
34,충청남도,050005, 49세,2016,31841,16740,15101,110.9,30778,16137,14641,110.2
34,충청남도,055,50~54세,2016,157710,83553,74157,112.7,151996,80467,71529,112.5
34,충청남도,055001, 50세,2016,29396,15682,13714,114.4,28255,15072,13183,114.3
34,충청남도,055002, 51세,2016,33521,17664,15857,111.4,32280,16990,15290,111.1
34,충청남도,055003, 52세,2016,30331,16078,14253,112.8,29209,15463,13746,112.5
34,충청남도,055004, 53세,2016,31022,16386,14636,112,29780,15715,14065,111.7
34,충청남도,055005, 54세,2016,33440,17743,15697,113,32472,17227,15245,113
34,충청남도,060,55~59세,2016,162864,83190,79674,104.4,159233,81273,77960,104.2
34,충청남도,060001, 55세,2016,37076,19248,17828,108,36445,18920,17525,108
34,충청남도,060002, 56세,2016,36293,18398,17895,102.8,35371,17925,17446,102.7
34,충청남도,060003, 57세,2016,31268,15745,15523,101.4,30552,15398,15154,101.6
34,충청남도,060004, 58세,2016,29432,14956,14476,103.3,28718,14569,14149,103
34,충청남도,060005, 59세,2016,28795,14843,13952,106.4,28147,14461,13686,105.7
34,충청남도,065,60~64세,2016,123639,61406,62233,98.7,121018,60055,60963,98.5
34,충청남도,065001, 60세,2016,27499,13884,13615,102,26870,13556,13314,101.8
34,충청남도,065002, 61세,2016,28618,14346,14272,100.5,28010,14045,13965,100.6
34,충청남도,065003, 62세,2016,24549,12059,12490,96.5,24007,11771,12236,96.2
34,충청남도,065004, 63세,2016,20076,9931,10145,97.9,19609,9689,9920,97.7
34,충청남도,065005, 64세,2016,22897,11186,11711,95.5,22522,10994,11528,95.4
34,충청남도,070,65~69세,2016,97199,47424,49775,95.3,96161,46882,49279,95.1
34,충청남도,070001, 65세,2016,17968,8886,9082,97.8,17686,8715,8971,97.1
34,충청남도,070002, 66세,2016,20551,9953,10598,93.9,20311,9827,10484,93.7
34,충청남도,070003, 67세,2016,20524,10077,10447,96.5,20292,9956,10336,96.3
34,충청남도,070004, 68세,2016,19275,9381,9894,94.8,19124,9316,9808,95
34,충청남도,070005, 69세,2016,18881,9127,9754,93.6,18748,9068,9680,93.7
34,충청남도,075,70~74세,2016,80326,36022,44304,81.3,79927,35847,44080,81.3
34,충청남도,075001, 70세,2016,13854,6835,7019,97.4,13738,6776,6962,97.3
34,충청남도,075002, 71세,2016,14194,6527,7667,85.1,14114,6491,7623,85.2
34,충청남도,075003, 72세,2016,15655,6829,8826,77.4,15570,6795,8775,77.4
34,충청남도,075004, 73세,2016,16036,7107,8929,79.6,15973,7078,8895,79.6
34,충청남도,075005, 74세,2016,20587,8724,11863,73.5,20532,8707,11825,73.6
34,충청남도,080,75~79세,2016,75162,30332,44830,67.7,74883,30228,44655,67.7
34,충청남도,080001, 75세,2016,15561,6483,9078,71.4,15498,6455,9043,71.4
34,충청남도,080002, 76세,2016,14556,6005,8551,70.2,14495,5977,8518,70.2
34,충청남도,080003, 77세,2016,16093,6468,9625,67.2,16051,6454,9597,67.3
34,충청남도,080004, 78세,2016,15008,5875,9133,64.3,14946,5858,9088,64.5
34,충청남도,080005, 79세,2016,13944,5501,8443,65.2,13893,5484,8409,65.2
34,충청남도,085,80~84세,2016,55141,19971,35170,56.8,55021,19930,35091,56.8
34,충청남도,085001, 80세,2016,13425,5148,8277,62.2,13392,5134,8258,62.2
34,충청남도,085002, 81세,2016,12846,4659,8187,56.9,12815,4650,8165,57
34,충청남도,085003, 82세,2016,10829,3990,6839,58.3,10804,3981,6823,58.3
34,충청남도,085004, 83세,2016,9428,3293,6135,53.7,9410,3289,6121,53.7
34,충청남도,085005, 84세,2016,8613,2881,5732,50.3,8600,2876,5724,50.2
34,충청남도,090,85~89세,2016,23443,6763,16680,40.5,23396,6748,16648,40.5
34,충청남도,090001, 85세,2016,6036,1851,4185,44.2,6020,1846,4174,44.2
34,충청남도,090002, 86세,2016,5498,1627,3871,42,5488,1625,3863,42.1
34,충청남도,090003, 87세,2016,4800,1364,3436,39.7,4790,1360,3430,39.7
34,충청남도,090004, 88세,2016,3994,1104,2890,38.2,3990,1103,2887,38.2
34,충청남도,090005, 89세,2016,3115,817,2298,35.6,3108,814,2294,35.5
34,충청남도,095,90~94세,2016,7588,1785,5803,30.8,7569,1781,5788,30.8
34,충청남도,095001, 90세,2016,2199,555,1644,33.8,2195,554,1641,33.8
34,충청남도,095002, 91세,2016,1812,461,1351,34.1,1808,460,1348,34.1
34,충청남도,095003, 92세,2016,1298,305,993,30.7,1297,304,993,30.6
34,충청남도,095004, 93세,2016,1293,279,1014,27.5,1289,279,1010,27.6
34,충청남도,095005, 94세,2016,986,185,801,23.1,980,184,796,23.1
34,충청남도,100,95~99세,2016,1627,321,1306,24.6,1617,315,1302,24.2
34,충청남도,100001, 95세,2016,612,135,477,28.3,606,133,473,28.1
34,충청남도,100002, 96세,2016,423,80,343,23.3,420,77,343,22.4
34,충청남도,100003, 97세,2016,287,52,235,22.1,287,52,235,22.1
34,충청남도,100004, 98세,2016,185,34,151,22.5,184,33,151,21.9
34,충청남도,100005, 99세,2016,120,20,100,20,120,20,100,20
34,충청남도,101,100세이상,2016,199,17,182,9.3,197,17,180,9.4
34,충청남도,102,15세미만,2016,292661,150964,141697,106.5,290688,149944,140744,106.5
34,충청남도,103,15~64세,2016,1499220,797492,701728,113.6,1425574,751357,674217,111.4
34,충청남도,104,65세이상,2016,340685,142635,198050,72,338771,141748,197023,71.9
34,충청남도,086,85세이상,2016,32857,8886,23971,37.1,32779,8861,23918,37
34,충청남도,126,평균연령,2016,41.5,40.1,42.9,,41.6,40.2,43.1,
34,충청남도,127,중위연령,2016,41.7,40.3,43.3,,42.2,40.8,43.6,
34004, 읍부,000,합계,2016,484407,249185,235222,105.9,468512,239257,229255,104.4
34004, 읍부,005,0~4세,2016,21423,10939,10484,104.3,21259,10844,10415,104.1
34004, 읍부,005001, 0세,2016,3765,1904,1861,102.3,3732,1885,1847,102.1
34004, 읍부,005002, 1세,2016,4258,2178,2080,104.7,4223,2165,2058,105.2
34004, 읍부,005003, 2세,2016,4206,2145,2061,104.1,4182,2127,2055,103.5
34004, 읍부,005004, 3세,2016,4401,2301,2100,109.6,4357,2271,2086,108.9
34004, 읍부,005005, 4세,2016,4793,2411,2382,101.2,4765,2396,2369,101.1
34004, 읍부,010,5~9세,2016,23507,12242,11265,108.7,23394,12177,11217,108.6
34004, 읍부,010001, 5세,2016,4761,2456,2305,106.6,4724,2435,2289,106.4
34004, 읍부,010002, 6세,2016,4616,2435,2181,111.6,4585,2417,2168,111.5
34004, 읍부,010003, 7세,2016,4530,2373,2157,110,4513,2364,2149,110
34004, 읍부,010004, 8세,2016,4745,2465,2280,108.1,4728,2453,2275,107.8
34004, 읍부,010005, 9세,2016,4855,2513,2342,107.3,4844,2508,2336,107.4
34004, 읍부,015,10~14세,2016,22549,11606,10943,106.1,22485,11580,10905,106.2
34004, 읍부,015001, 10세,2016,4401,2264,2137,105.9,4389,2263,2126,106.4
34004, 읍부,015002, 11세,2016,4300,2191,2109,103.9,4282,2182,2100,103.9
34004, 읍부,015003, 12세,2016,4535,2292,2243,102.2,4516,2284,2232,102.3
34004, 읍부,015004, 13세,2016,4560,2379,2181,109.1,4552,2375,2177,109.1
34004, 읍부,015005, 14세,2016,4753,2480,2273,109.1,4746,2476,2270,109.1
34004, 읍부,020,15~19세,2016,31704,16576,15128,109.6,31452,16451,15001,109.7
34004, 읍부,020001, 15세,2016,5551,2883,2668,108.1,5541,2876,2665,107.9
34004, 읍부,020002, 16세,2016,6474,3386,3088,109.7,6458,3380,3078,109.8
34004, 읍부,020003, 17세,2016,6192,3222,2970,108.5,6178,3216,2962,108.6
34004, 읍부,020004, 18세,2016,6570,3453,3117,110.8,6505,3421,3084,110.9
34004, 읍부,020005, 19세,2016,6917,3632,3285,110.6,6770,3558,3212,110.8
34004, 읍부,025,20~24세,2016,31413,17468,13945,125.3,29383,16302,13081,124.6
34004, 읍부,025001, 20세,2016,6759,3471,3288,105.6,6495,3346,3149,106.3
34004, 읍부,025002, 21세,2016,6398,3456,2942,117.5,6021,3263,2758,118.3
34004, 읍부,025003, 22세,2016,6352,3617,2735,132.2,5940,3371,2569,131.2
34004, 읍부,025004, 23세,2016,5925,3423,2502,136.8,5470,3159,2311,136.7
34004, 읍부,025005, 24세,2016,5979,3501,2478,141.3,5457,3163,2294,137.9
34004, 읍부,030,25~29세,2016,26589,15166,11423,132.8,23673,13234,10439,126.8
34004, 읍부,030001, 25세,2016,5305,3078,2227,138.2,4797,2756,2041,135
34004, 읍부,030002, 26세,2016,5231,2980,2251,132.4,4626,2600,2026,128.3
34004, 읍부,030003, 27세,2016,5258,3021,2237,135,4680,2623,2057,127.5
34004, 읍부,030004, 28세,2016,5417,3055,2362,129.3,4816,2651,2165,122.4
34004, 읍부,030005, 29세,2016,5378,3032,2346,129.2,4754,2604,2150,121.1
34004, 읍부,035,30~34세,2016,31314,17300,14014,123.4,28654,15452,13202,117
34004, 읍부,035001, 30세,2016,5489,3059,2430,125.9,4897,2667,2230,119.6
34004, 읍부,035002, 31세,2016,5576,3168,2408,131.6,4977,2758,2219,124.3
34004, 읍부,035003, 32세,2016,6094,3331,2763,120.6,5593,2979,2614,114
34004, 읍부,035004, 33세,2016,6704,3716,2988,124.4,6212,3352,2860,117.2
34004, 읍부,035005, 34세,2016,7451,4026,3425,117.5,6975,3696,3279,112.7
34004, 읍부,040,35~39세,2016,36792,20010,16782,119.2,34835,18641,16194,115.1
34004, 읍부,040001, 35세,2016,7552,4209,3343,125.9,7112,3901,3211,121.5
34004, 읍부,040002, 36세,2016,7861,4290,3571,120.1,7399,3962,3437,115.3
34004, 읍부,040003, 37세,2016,7210,3866,3344,115.6,6845,3615,3230,111.9
34004, 읍부,040004, 38세,2016,6985,3770,3215,117.3,6633,3527,3106,113.6
34004, 읍부,040005, 39세,2016,7184,3875,3309,117.1,6846,3636,3210,113.3
34004, 읍부,045,40~44세,2016,37758,20405,17353,117.6,36211,19383,16828,115.2
34004, 읍부,045001, 40세,2016,7025,3766,3259,115.6,6703,3546,3157,112.3
34004, 읍부,045002, 41세,2016,7283,3884,3399,114.3,6943,3647,3296,110.6
34004, 읍부,045003, 42세,2016,7833,4215,3618,116.5,7553,4026,3527,114.1
34004, 읍부,045004, 43세,2016,7976,4328,3648,118.6,7687,4155,3532,117.6
34004, 읍부,045005, 44세,2016,7641,4212,3429,122.8,7325,4009,3316,120.9
34004, 읍부,050,45~49세,2016,39682,21492,18190,118.2,38361,20718,17643,117.4
34004, 읍부,050001, 45세,2016,8297,4525,3772,120,8001,4334,3667,118.2
34004, 읍부,050002, 46세,2016,7946,4301,3645,118,7662,4134,3528,117.2
34004, 읍부,050003, 47세,2016,8131,4404,3727,118.2,7880,4256,3624,117.4
34004, 읍부,050004, 48세,2016,8018,4339,3679,117.9,7745,4188,3557,117.7
34004, 읍부,050005, 49세,2016,7290,3923,3367,116.5,7073,3806,3267,116.5
34004, 읍부,055,50~54세,2016,36234,19305,16929,114,35107,18697,16410,113.9
34004, 읍부,055001, 50세,2016,6806,3648,3158,115.5,6596,3540,3056,115.8
34004, 읍부,055002, 51세,2016,7705,4103,3602,113.9,7450,3968,3482,114
34004, 읍부,055003, 52세,2016,6984,3709,3275,113.3,6759,3573,3186,112.1
34004, 읍부,055004, 53세,2016,7086,3731,3355,111.2,6860,3614,3246,111.3
34004, 읍부,055005, 54세,2016,7653,4114,3539,116.2,7442,4002,3440,116.3
34004, 읍부,060,55~59세,2016,38041,19347,18694,103.5,37262,18950,18312,103.5
34004, 읍부,060001, 55세,2016,8609,4448,4161,106.9,8475,4383,4092,107.1
34004, 읍부,060002, 56세,2016,8349,4218,4131,102.1,8170,4132,4038,102.3
34004, 읍부,060003, 57세,2016,7294,3598,3696,97.3,7135,3523,3612,97.5
34004, 읍부,060004, 58세,2016,6890,3506,3384,103.6,6732,3426,3306,103.6
34004, 읍부,060005, 59세,2016,6899,3577,3322,107.7,6750,3486,3264,106.8
34004, 읍부,065,60~64세,2016,29098,14301,14797,96.6,28551,14006,14545,96.3
34004, 읍부,065001, 60세,2016,6402,3238,3164,102.3,6282,3178,3104,102.4
34004, 읍부,065002, 61세,2016,6669,3290,3379,97.4,6538,3216,3322,96.8
34004, 읍부,065003, 62세,2016,5832,2845,2987,95.2,5707,2773,2934,94.5
34004, 읍부,065004, 63세,2016,4778,2319,2459,94.3,4678,2270,2408,94.3
34004, 읍부,065005, 64세,2016,5417,2609,2808,92.9,5346,2569,2777,92.5
34004, 읍부,070,65~69세,2016,23290,11306,11984,94.3,23065,11189,11876,94.2
34004, 읍부,070001, 65세,2016,4351,2107,2244,93.9,4290,2068,2222,93.1
34004, 읍부,070002, 66세,2016,4827,2338,2489,93.9,4779,2312,2467,93.7
34004, 읍부,070003, 67세,2016,4854,2355,2499,94.2,4802,2329,2473,94.2
34004, 읍부,070004, 68세,2016,4680,2269,2411,94.1,4652,2259,2393,94.4
34004, 읍부,070005, 69세,2016,4578,2237,2341,95.6,4542,2221,2321,95.7
34004, 읍부,075,70~74세,2016,18839,8509,10330,82.4,18750,8466,10284,82.3
34004, 읍부,075001, 70세,2016,3396,1673,1723,97.1,3368,1658,1710,97
34004, 읍부,075002, 71세,2016,3384,1603,1781,90,3367,1594,1773,89.9
34004, 읍부,075003, 72세,2016,3605,1572,2033,77.3,3587,1565,2022,77.4
34004, 읍부,075004, 73세,2016,3814,1685,2129,79.1,3805,1677,2128,78.8
34004, 읍부,075005, 74세,2016,4640,1976,2664,74.2,4623,1972,2651,74.4
34004, 읍부,080,75~79세,2016,16840,6845,9995,68.5,16779,6813,9966,68.4
34004, 읍부,080001, 75세,2016,3516,1444,2072,69.7,3505,1439,2066,69.7
34004, 읍부,080002, 76세,2016,3290,1370,1920,71.4,3274,1360,1914,71.1
34004, 읍부,080003, 77세,2016,3624,1486,2138,69.5,3616,1482,2134,69.4
34004, 읍부,080004, 78세,2016,3353,1352,2001,67.6,3339,1347,1992,67.6
34004, 읍부,080005, 79세,2016,3057,1193,1864,64,3045,1185,1860,63.7
34004, 읍부,085,80~84세,2016,12070,4375,7695,56.9,12045,4366,7679,56.9
34004, 읍부,085001, 80세,2016,2952,1162,1790,64.9,2942,1157,1785,64.8
34004, 읍부,085002, 81세,2016,2827,1021,1806,56.5,2824,1020,1804,56.5
34004, 읍부,085003, 82세,2016,2360,873,1487,58.7,2354,873,1481,58.9
34004, 읍부,085004, 83세,2016,2052,711,1341,53,2049,709,1340,52.9
34004, 읍부,085005, 84세,2016,1879,608,1271,47.8,1876,607,1269,47.8
34004, 읍부,090,85~89세,2016,5156,1510,3646,41.4,5144,1506,3638,41.4
34004, 읍부,090001, 85세,2016,1319,413,906,45.6,1316,413,903,45.7
34004, 읍부,090002, 86세,2016,1212,365,847,43.1,1210,364,846,43
34004, 읍부,090003, 87세,2016,1046,318,728,43.7,1044,318,726,43.8
34004, 읍부,090004, 88세,2016,880,241,639,37.7,878,240,638,37.6
34004, 읍부,090005, 89세,2016,699,173,526,32.9,696,171,525,32.6
34004, 읍부,095,90~94세,2016,1714,395,1319,29.9,1709,394,1315,30
34004, 읍부,095001, 90세,2016,480,124,356,34.8,479,124,355,34.9
34004, 읍부,095002, 91세,2016,412,98,314,31.2,411,97,314,30.9
34004, 읍부,095003, 92세,2016,309,68,241,28.2,309,68,241,28.2
34004, 읍부,095004, 93세,2016,279,60,219,27.4,277,60,217,27.6
34004, 읍부,095005, 94세,2016,234,45,189,23.8,233,45,188,23.9
34004, 읍부,100,95~99세,2016,356,84,272,30.9,355,84,271,31
34004, 읍부,100001, 95세,2016,145,38,107,35.5,144,38,106,35.8
34004, 읍부,100002, 96세,2016,83,21,62,33.9,83,21,62,33.9
34004, 읍부,100003, 97세,2016,54,10,44,22.7,54,10,44,22.7
34004, 읍부,100004, 98세,2016,43,10,33,30.3,43,10,33,30.3
34004, 읍부,100005, 99세,2016,31,5,26,19.2,31,5,26,19.2
34004, 읍부,101,100세이상,2016,38,X,34,11.8,38,X,34,11.8
34004, 읍부,102,15세미만,2016,67479,34787,32692,106.4,67138,34601,32537,106.3
34004, 읍부,103,15~64세,2016,338625,181370,157255,115.3,323489,171834,151655,113.3
34004, 읍부,104,65세이상,2016,78303,33028,45275,72.9,77885,32822,45063,72.8
34004, 읍부,086,85세이상,2016,7264,1993,5271,37.8,7246,1988,5258,37.8
34004, 읍부,126,평균연령,2016,41.7,40.3,43.2,,41.8,40.4,43.3,
34004, 읍부,127,중위연령,2016,42.3,40.9,43.9,,42.7,41.4,44.2,
34005, 면부,000,합계,2016,694904,361007,333897,108.1,656946,335206,321740,104.2
34005, 면부,005,0~4세,2016,22370,11523,10847,106.2,22056,11358,10698,106.2
34005, 면부,005001, 0세,2016,4065,2049,2016,101.6,3990,2011,1979,101.6
34005, 면부,005002, 1세,2016,4411,2259,2152,105,4361,2233,2128,104.9
34005, 면부,005003, 2세,2016,4397,2257,2140,105.5,4335,2227,2108,105.6
34005, 면부,005004, 3세,2016,4558,2344,2214,105.9,4499,2313,2186,105.8
34005, 면부,005005, 4세,2016,4939,2614,2325,112.4,4871,2574,2297,112.1
34005, 면부,010,5~9세,2016,23336,12070,11266,107.1,23105,11965,11140,107.4
34005, 면부,010001, 5세,2016,4792,2476,2316,106.9,4726,2449,2277,107.6
34005, 면부,010002, 6세,2016,4664,2396,2268,105.6,4622,2377,2245,105.9
34005, 면부,010003, 7세,2016,4453,2338,2115,110.5,4413,2318,2095,110.6
34005, 면부,010004, 8세,2016,4712,2377,2335,101.8,4669,2356,2313,101.9
34005, 면부,010005, 9세,2016,4715,2483,2232,111.2,4675,2465,2210,111.5
34005, 면부,015,10~14세,2016,21849,11309,10540,107.3,21729,11248,10481,107.3
34005, 면부,015001, 10세,2016,4351,2216,2135,103.8,4322,2199,2123,103.6
34005, 면부,015002, 11세,2016,4094,2089,2005,104.2,4067,2076,1991,104.3
34005, 면부,015003, 12세,2016,4267,2184,2083,104.8,4241,2172,2069,105
34005, 면부,015004, 13세,2016,4572,2400,2172,110.5,4551,2388,2163,110.4
34005, 면부,015005, 14세,2016,4565,2420,2145,112.8,4548,2413,2135,113
34005, 면부,020,15~19세,2016,34431,18256,16175,112.9,33883,18007,15876,113.4
34005, 면부,020001, 15세,2016,5447,2857,2590,110.3,5420,2844,2576,110.4
34005, 면부,020002, 16세,2016,5634,2934,2700,108.7,5599,2909,2690,108.1
34005, 면부,020003, 17세,2016,5861,3084,2777,111.1,5820,3064,2756,111.2
34005, 면부,020004, 18세,2016,7150,3814,3336,114.3,7051,3765,3286,114.6
34005, 면부,020005, 19세,2016,10339,5567,4772,116.7,9993,5425,4568,118.8
34005, 면부,025,20~24세,2016,45955,25927,20028,129.5,40056,22341,17715,126.1
34005, 면부,025001, 20세,2016,8959,4323,4636,93.2,8198,3995,4203,95.1
34005, 면부,025002, 21세,2016,9005,4745,4260,111.4,7933,4177,3756,111.2
34005, 면부,025003, 22세,2016,9576,5517,4059,135.9,8285,4750,3535,134.4
34005, 면부,025004, 23세,2016,9358,5690,3668,155.1,8050,4793,3257,147.2
34005, 면부,025005, 24세,2016,9057,5652,3405,166,7590,4626,2964,156.1
34005, 면부,030,25~29세,2016,38938,23921,15017,159.3,30975,18184,12791,142.2
34005, 면부,030001, 25세,2016,7859,4763,3096,153.8,6459,3798,2661,142.7
34005, 면부,030002, 26세,2016,8007,4920,3087,159.4,6331,3731,2600,143.5
34005, 면부,030003, 27세,2016,7658,4726,2932,161.2,6043,3530,2513,140.5
34005, 면부,030004, 28세,2016,7563,4655,2908,160.1,5943,3473,2470,140.6
34005, 면부,030005, 29세,2016,7851,4857,2994,162.2,6199,3652,2547,143.4
34005, 면부,035,30~34세,2016,39865,24129,15736,153.3,32920,18969,13951,136
34005, 면부,035001, 30세,2016,7518,4636,2882,160.9,6042,3560,2482,143.4
34005, 면부,035002, 31세,2016,7552,4591,2961,155,6069,3490,2579,135.3
34005, 면부,035003, 32세,2016,7633,4628,3005,154,6277,3615,2662,135.8
34005, 면부,035004, 33세,2016,8374,5013,3361,149.2,6985,3980,3005,132.4
34005, 면부,035005, 34세,2016,8788,5261,3527,149.2,7547,4324,3223,134.2
34005, 면부,040,35~39세,2016,41628,24804,16824,147.4,36723,21066,15657,134.5
34005, 면부,040001, 35세,2016,8812,5271,3541,148.9,7663,4382,3281,133.6
34005, 면부,040002, 36세,2016,8851,5228,3623,144.3,7800,4431,3369,131.5
34005, 면부,040003, 37세,2016,8285,4897,3388,144.5,7304,4153,3151,131.8
34005, 면부,040004, 38세,2016,7795,4705,3090,152.3,6880,4004,2876,139.2
34005, 면부,040005, 39세,2016,7885,4703,3182,147.8,7076,4096,2980,137.4
34005, 면부,045,40~44세,2016,41978,24867,17111,145.3,38542,22397,16145,138.7
34005, 면부,045001, 40세,2016,7811,4653,3158,147.3,7062,4111,2951,139.3
34005, 면부,045002, 41세,2016,7990,4716,3274,144,7310,4212,3098,136
34005, 면부,045003, 42세,2016,8789,5279,3510,150.4,8074,4752,3322,143
34005, 면부,045004, 43세,2016,8711,5091,3620,140.6,8092,4662,3430,135.9
34005, 면부,045005, 44세,2016,8677,5128,3549,144.5,8004,4660,3344,139.4
34005, 면부,050,45~49세,2016,47249,26940,20309,132.7,44421,25094,19327,129.8
34005, 면부,050001, 45세,2016,9617,5660,3957,143,8955,5203,3752,138.7
34005, 면부,050002, 46세,2016,8993,5216,3777,138.1,8355,4795,3560,134.7
34005, 면부,050003, 47세,2016,9784,5599,4185,133.8,9205,5231,3974,131.6
34005, 면부,050004, 48세,2016,9711,5406,4305,125.6,9184,5066,4118,123
34005, 면부,050005, 49세,2016,9144,5059,4085,123.8,8722,4799,3923,122.3
34005, 면부,055,50~54세,2016,49911,27089,22822,118.7,47714,25797,21917,117.7
34005, 면부,055001, 50세,2016,8644,4737,3907,121.2,8183,4464,3719,120
34005, 면부,055002, 51세,2016,10244,5633,4611,122.2,9780,5358,4422,121.2
34005, 면부,055003, 52세,2016,9617,5249,4368,120.2,9180,4989,4191,119
34005, 면부,055004, 53세,2016,10040,5419,4621,117.3,9571,5151,4420,116.5
34005, 면부,055005, 54세,2016,11366,6051,5315,113.8,11000,5835,5165,113
34005, 면부,060,55~59세,2016,61106,31319,29787,105.1,59849,30587,29262,104.5
34005, 면부,060001, 55세,2016,13131,6790,6341,107.1,12915,6672,6243,106.9
34005, 면부,060002, 56세,2016,13464,6863,6601,104,13107,6660,6447,103.3
34005, 면부,060003, 57세,2016,11744,6028,5716,105.5,11515,5903,5612,105.2
34005, 면부,060004, 58세,2016,11388,5776,5612,102.9,11124,5615,5509,101.9
34005, 면부,060005, 59세,2016,11379,5862,5517,106.3,11188,5737,5451,105.2
34005, 면부,065,60~64세,2016,52229,26123,26106,100.1,51478,25715,25763,99.8
34005, 면부,065001, 60세,2016,11295,5680,5615,101.2,11105,5577,5528,100.9
34005, 면부,065002, 61세,2016,11872,6044,5828,103.7,11693,5947,5746,103.5
34005, 면부,065003, 62세,2016,10500,5203,5297,98.2,10354,5118,5236,97.7
34005, 면부,065004, 63세,2016,8663,4297,4366,98.4,8533,4223,4310,98
34005, 면부,065005, 64세,2016,9899,4899,5000,98,9793,4850,4943,98.1
34005, 면부,070,65~69세,2016,44881,22173,22708,97.6,44590,22022,22568,97.6
34005, 면부,070001, 65세,2016,8201,4073,4128,98.7,8123,4027,4096,98.3
34005, 면부,070002, 66세,2016,9468,4646,4822,96.4,9400,4612,4788,96.3
34005, 면부,070003, 67세,2016,9569,4800,4769,100.7,9503,4768,4735,100.7
34005, 면부,070004, 68세,2016,8886,4397,4489,98,8835,4370,4465,97.9
34005, 면부,070005, 69세,2016,8757,4257,4500,94.6,8729,4245,4484,94.7
34005, 면부,075,70~74세,2016,39715,17867,21848,81.8,39596,17816,21780,81.8
34005, 면부,075001, 70세,2016,6378,3167,3211,98.6,6346,3151,3195,98.6
34005, 면부,075002, 71세,2016,6779,3113,3666,84.9,6753,3099,3654,84.8
34005, 면부,075003, 72세,2016,7730,3392,4338,78.2,7705,3385,4320,78.4
34005, 면부,075004, 73세,2016,8065,3577,4488,79.7,8046,3567,4479,79.6
34005, 면부,075005, 74세,2016,10763,4618,6145,75.2,10746,4614,6132,75.2
34005, 면부,080,75~79세,2016,40272,16273,23999,67.8,40178,16241,23937,67.8
34005, 면부,080001, 75세,2016,8126,3429,4697,73,8105,3421,4684,73
34005, 면부,080002, 76세,2016,7670,3149,4521,69.7,7647,3137,4510,69.6
34005, 면부,080003, 77세,2016,8695,3483,5212,66.8,8680,3476,5204,66.8
34005, 면부,080004, 78세,2016,8179,3154,5025,62.8,8156,3151,5005,63
34005, 면부,080005, 79세,2016,7602,3058,4544,67.3,7590,3056,4534,67.4
34005, 면부,085,80~84세,2016,31027,11405,19622,58.1,30992,11395,19597,58.1
34005, 면부,085001, 80세,2016,7512,2937,4575,64.2,7502,2934,4568,64.2
34005, 면부,085002, 81세,2016,7191,2650,4541,58.4,7181,2649,4532,58.5
34005, 면부,085003, 82세,2016,6124,2258,3866,58.4,6118,2255,3863,58.4
34005, 면부,085004, 83세,2016,5349,1881,3468,54.2,5344,1880,3464,54.3
34005, 면부,085005, 84세,2016,4851,1679,3172,52.9,4847,1677,3170,52.9
34005, 면부,090,85~89세,2016,13002,3835,9167,41.8,12989,3831,9158,41.8
34005, 면부,090001, 85세,2016,3380,1065,2315,46,3376,1063,2313,46
34005, 면부,090002, 86세,2016,3064,910,2154,42.2,3060,910,2150,42.3
34005, 면부,090003, 87세,2016,2658,753,1905,39.5,2655,752,1903,39.5
34005, 면부,090004, 88세,2016,2213,627,1586,39.5,2213,627,1586,39.5
34005, 면부,090005, 89세,2016,1687,480,1207,39.8,1685,479,1206,39.7
34005, 면부,095,90~94세,2016,4188,1010,3178,31.8,4178,1008,3170,31.8
34005, 면부,095001, 90세,2016,1204,305,899,33.9,1202,305,897,34
34005, 면부,095002, 91세,2016,1002,268,734,36.5,999,268,731,36.7
34005, 면부,095003, 92세,2016,696,174,522,33.3,695,173,522,33.1
34005, 면부,095004, 93세,2016,749,169,580,29.1,748,169,579,29.2
34005, 면부,095005, 94세,2016,537,94,443,21.2,534,93,441,21.1
34005, 면부,100,95~99세,2016,866,156,710,22,864,154,710,21.7
34005, 면부,100001, 95세,2016,327,73,254,28.7,326,72,254,28.3
34005, 면부,100002, 96세,2016,229,36,193,18.7,228,35,193,18.1
34005, 면부,100003, 97세,2016,161,25,136,18.4,161,25,136,18.4
34005, 면부,100004, 98세,2016,93,13,80,16.3,93,13,80,16.3
34005, 면부,100005, 99세,2016,56,9,47,19.1,56,9,47,19.1
34005, 면부,101,100세이상,2016,108,11,97,11.3,108,11,97,11.3
34005, 면부,102,15세미만,2016,67555,34902,32653,106.9,66890,34571,32319,107
34005, 면부,103,15~64세,2016,453290,253375,199915,126.7,416561,228157,188404,121.1
34005, 면부,104,65세이상,2016,174059,72730,101329,71.8,173495,72478,101017,71.7
34005, 면부,086,85세이상,2016,18164,5012,13152,38.1,18139,5004,13135,38.1
34005, 면부,126,평균연령,2016,47.1,44.8,49.5,,47.8,45.6,50.1,
34005, 면부,127,중위연령,2016,48.9,45.7,53,,50.5,47.4,54.1,
34003, 동부,000,합계,2016,953255,480899,472356,101.8,929575,468586,460989,101.6
34003, 동부,005,0~4세,2016,52035,26502,25533,103.8,51490,26226,25264,103.8
34003, 동부,005001, 0세,2016,9895,5033,4862,103.5,9767,4967,4800,103.5
34003, 동부,005002, 1세,2016,10312,5233,5079,103,10180,5174,5006,103.4
34003, 동부,005003, 2세,2016,10058,5179,4879,106.1,9955,5127,4828,106.2
34003, 동부,005004, 3세,2016,10532,5347,5185,103.1,10446,5300,5146,103
34003, 동부,005005, 4세,2016,11238,5710,5528,103.3,11142,5658,5484,103.2
34003, 동부,010,5~9세,2016,53691,27781,25910,107.2,53410,27624,25786,107.1
34003, 동부,010001, 5세,2016,11169,5816,5353,108.6,11085,5770,5315,108.6
34003, 동부,010002, 6세,2016,10723,5557,5166,107.6,10653,5523,5130,107.7
34003, 동부,010003, 7세,2016,10194,5222,4972,105,10155,5198,4957,104.9
34003, 동부,010004, 8세,2016,10746,5572,5174,107.7,10701,5547,5154,107.6
34003, 동부,010005, 9세,2016,10859,5614,5245,107,10816,5586,5230,106.8
34003, 동부,015,10~14세,2016,51901,26992,24909,108.4,51760,26922,24838,108.4
34003, 동부,015001, 10세,2016,10018,5197,4821,107.8,9984,5186,4798,108.1
34003, 동부,015002, 11세,2016,9821,5118,4703,108.8,9786,5097,4689,108.7
34003, 동부,015003, 12세,2016,10728,5638,5090,110.8,10695,5619,5076,110.7
34003, 동부,015004, 13세,2016,10487,5383,5104,105.5,10468,5372,5096,105.4
34003, 동부,015005, 14세,2016,10847,5656,5191,109,10827,5648,5179,109.1
34003, 동부,020,15~19세,2016,67352,34775,32577,106.7,66802,34554,32248,107.2
34003, 동부,020001, 15세,2016,12584,6572,6012,109.3,12546,6552,5994,109.3
34003, 동부,020002, 16세,2016,13707,7320,6387,114.6,13663,7301,6362,114.8
34003, 동부,020003, 17세,2016,12933,6850,6083,112.6,12871,6819,6052,112.7
34003, 동부,020004, 18세,2016,13699,7155,6544,109.3,13556,7103,6453,110.1
34003, 동부,020005, 19세,2016,14429,6878,7551,91.1,14166,6779,7387,91.8
34003, 동부,025,20~24세,2016,71912,36497,35415,103.1,69953,35619,34334,103.7
34003, 동부,025001, 20세,2016,14851,7322,7529,97.3,14558,7193,7365,97.7
34003, 동부,025002, 21세,2016,14551,7125,7426,95.9,14203,6985,7218,96.8
34003, 동부,025003, 22세,2016,14315,7252,7063,102.7,13938,7087,6851,103.4
34003, 동부,025004, 23세,2016,14140,7348,6792,108.2,13716,7146,6570,108.8
34003, 동부,025005, 24세,2016,14055,7450,6605,112.8,13538,7208,6330,113.9
34003, 동부,030,25~29세,2016,62764,32837,29927,109.7,59396,31123,28273,110.1
34003, 동부,030001, 25세,2016,12490,6564,5926,110.8,11929,6308,5621,112.2
34003, 동부,030002, 26세,2016,12096,6364,5732,111,11426,6005,5421,110.8
34003, 동부,030003, 27세,2016,12269,6494,5775,112.5,11597,6143,5454,112.6
34003, 동부,030004, 28세,2016,12648,6565,6083,107.9,11934,6202,5732,108.2
34003, 동부,030005, 29세,2016,13261,6850,6411,106.8,12510,6465,6045,106.9
34003, 동부,035,30~34세,2016,76125,39704,36421,109,72749,37880,34869,108.6
34003, 동부,035001, 30세,2016,13607,7080,6527,108.5,12885,6706,6179,108.5
34003, 동부,035002, 31세,2016,13782,7294,6488,112.4,13096,6921,6175,112.1
34003, 동부,035003, 32세,2016,14601,7597,7004,108.5,13943,7235,6708,107.9
34003, 동부,035004, 33세,2016,16274,8469,7805,108.5,15647,8136,7511,108.3
34003, 동부,035005, 34세,2016,17861,9264,8597,107.8,17178,8882,8296,107.1
34003, 동부,040,35~39세,2016,83264,43136,40128,107.5,80727,41643,39084,106.5
34003, 동부,040001, 35세,2016,17357,9082,8275,109.8,16834,8788,8046,109.2
34003, 동부,040002, 36세,2016,17971,9205,8766,105,17407,8878,8529,104.1
34003, 동부,040003, 37세,2016,16729,8648,8081,107,16190,8324,7866,105.8
34003, 동부,040004, 38세,2016,15403,8138,7265,112,14923,7835,7088,110.5
34003, 동부,040005, 39세,2016,15804,8063,7741,104.2,15373,7818,7555,103.5
34003, 동부,045,40~44세,2016,82777,41778,40999,101.9,80532,40457,40075,101
34003, 동부,045001, 40세,2016,15481,7812,7669,101.9,15015,7523,7492,100.4
34003, 동부,045002, 41세,2016,15945,7905,8040,98.3,15514,7645,7869,97.2
34003, 동부,045003, 42세,2016,17490,8902,8588,103.7,17104,8674,8430,102.9
34003, 동부,045004, 43세,2016,17398,8730,8668,100.7,16929,8466,8463,100
34003, 동부,045005, 44세,2016,16463,8429,8034,104.9,15970,8149,7821,104.2
34003, 동부,050,45~49세,2016,85517,43355,42162,102.8,83079,42047,41032,102.5
34003, 동부,050001, 45세,2016,18199,9406,8793,107,17684,9112,8572,106.3
34003, 동부,050002, 46세,2016,17018,8723,8295,105.2,16513,8437,8076,104.5
34003, 동부,050003, 47세,2016,17619,8878,8741,101.6,17096,8614,8482,101.6
34003, 동부,050004, 48세,2016,17274,8590,8684,98.9,16803,8352,8451,98.8
34003, 동부,050005, 49세,2016,15407,7758,7649,101.4,14983,7532,7451,101.1
34003, 동부,055,50~54세,2016,71565,37159,34406,108,69175,35973,33202,108.3
34003, 동부,055001, 50세,2016,13946,7297,6649,109.7,13476,7068,6408,110.3
34003, 동부,055002, 51세,2016,15572,7928,7644,103.7,15050,7664,7386,103.8
34003, 동부,055003, 52세,2016,13730,7120,6610,107.7,13270,6901,6369,108.4
34003, 동부,055004, 53세,2016,13896,7236,6660,108.6,13349,6950,6399,108.6
34003, 동부,055005, 54세,2016,14421,7578,6843,110.7,14030,7390,6640,111.3
34003, 동부,060,55~59세,2016,63717,32524,31193,104.3,62122,31736,30386,104.4
34003, 동부,060001, 55세,2016,15336,8010,7326,109.3,15055,7865,7190,109.4
34003, 동부,060002, 56세,2016,14480,7317,7163,102.1,14094,7133,6961,102.5
34003, 동부,060003, 57세,2016,12230,6119,6111,100.1,11902,5972,5930,100.7
34003, 동부,060004, 58세,2016,11154,5674,5480,103.5,10862,5528,5334,103.6
34003, 동부,060005, 59세,2016,10517,5404,5113,105.7,10209,5238,4971,105.4
34003, 동부,065,60~64세,2016,42312,20982,21330,98.4,40989,20334,20655,98.4
34003, 동부,065001, 60세,2016,9802,4966,4836,102.7,9483,4801,4682,102.5
34003, 동부,065002, 61세,2016,10077,5012,5065,99,9779,4882,4897,99.7
34003, 동부,065003, 62세,2016,8217,4011,4206,95.4,7946,3880,4066,95.4
34003, 동부,065004, 63세,2016,6635,3315,3320,99.8,6398,3196,3202,99.8
34003, 동부,065005, 64세,2016,7581,3678,3903,94.2,7383,3575,3808,93.9
34003, 동부,070,65~69세,2016,29028,13945,15083,92.5,28506,13671,14835,92.2
34003, 동부,070001, 65세,2016,5416,2706,2710,99.9,5273,2620,2653,98.8
34003, 동부,070002, 66세,2016,6256,2969,3287,90.3,6132,2903,3229,89.9
34003, 동부,070003, 67세,2016,6101,2922,3179,91.9,5987,2859,3128,91.4
34003, 동부,070004, 68세,2016,5709,2715,2994,90.7,5637,2687,2950,91.1
34003, 동부,070005, 69세,2016,5546,2633,2913,90.4,5477,2602,2875,90.5
34003, 동부,075,70~74세,2016,21772,9646,12126,79.5,21581,9565,12016,79.6
34003, 동부,075001, 70세,2016,4080,1995,2085,95.7,4024,1967,2057,95.6
34003, 동부,075002, 71세,2016,4031,1811,2220,81.6,3994,1798,2196,81.9
34003, 동부,075003, 72세,2016,4320,1865,2455,76,4278,1845,2433,75.8
34003, 동부,075004, 73세,2016,4157,1845,2312,79.8,4122,1834,2288,80.2
34003, 동부,075005, 74세,2016,5184,2130,3054,69.7,5163,2121,3042,69.7
34003, 동부,080,75~79세,2016,18050,7214,10836,66.6,17926,7174,10752,66.7
34003, 동부,080001, 75세,2016,3919,1610,2309,69.7,3888,1595,2293,69.6
34003, 동부,080002, 76세,2016,3596,1486,2110,70.4,3574,1480,2094,70.7
34003, 동부,080003, 77세,2016,3774,1499,2275,65.9,3755,1496,2259,66.2
34003, 동부,080004, 78세,2016,3476,1369,2107,65,3451,1360,2091,65
34003, 동부,080005, 79세,2016,3285,1250,2035,61.4,3258,1243,2015,61.7
34003, 동부,085,80~84세,2016,12044,4191,7853,53.4,11984,4169,7815,53.3
34003, 동부,085001, 80세,2016,2961,1049,1912,54.9,2948,1043,1905,54.8
34003, 동부,085002, 81세,2016,2828,988,1840,53.7,2810,981,1829,53.6
34003, 동부,085003, 82세,2016,2345,859,1486,57.8,2332,853,1479,57.7
34003, 동부,085004, 83세,2016,2027,701,1326,52.9,2017,700,1317,53.2
34003, 동부,085005, 84세,2016,1883,594,1289,46.1,1877,592,1285,46.1
34003, 동부,090,85~89세,2016,5285,1418,3867,36.7,5263,1411,3852,36.6
34003, 동부,090001, 85세,2016,1337,373,964,38.7,1328,370,958,38.6
34003, 동부,090002, 86세,2016,1222,352,870,40.5,1218,351,867,40.5
34003, 동부,090003, 87세,2016,1096,293,803,36.5,1091,290,801,36.2
34003, 동부,090004, 88세,2016,901,236,665,35.5,899,236,663,35.6
34003, 동부,090005, 89세,2016,729,164,565,29,727,164,563,29.1
34003, 동부,095,90~94세,2016,1686,380,1306,29.1,1682,379,1303,29.1
34003, 동부,095001, 90세,2016,515,126,389,32.4,514,125,389,32.1
34003, 동부,095002, 91세,2016,398,95,303,31.4,398,95,303,31.4
34003, 동부,095003, 92세,2016,293,63,230,27.4,293,63,230,27.4
34003, 동부,095004, 93세,2016,265,50,215,23.3,264,50,214,23.4
34003, 동부,095005, 94세,2016,215,46,169,27.2,213,46,167,27.5
34003, 동부,100,95~99세,2016,405,81,324,25,398,77,321,24
34003, 동부,100001, 95세,2016,140,24,116,20.7,136,23,113,20.4
34003, 동부,100002, 96세,2016,111,23,88,26.1,109,21,88,23.9
34003, 동부,100003, 97세,2016,72,17,55,30.9,72,17,55,30.9
34003, 동부,100004, 98세,2016,49,11,38,28.9,48,10,38,26.3
34003, 동부,100005, 99세,2016,33,6,27,22.2,33,6,27,22.2
34003, 동부,101,100세이상,2016,53,X,51,3.9,51,X,49,4.1
34003, 동부,102,15세미만,2016,157627,81275,76352,106.4,156660,80772,75888,106.4
34003, 동부,103,15~64세,2016,707305,362747,344558,105.3,685524,351366,334158,105.1
34003, 동부,104,65세이상,2016,88323,36877,51446,71.7,87391,36448,50943,71.5
34003, 동부,086,85세이상,2016,7429,1881,5548,33.9,7394,1869,5525,33.8
34003, 동부,126,평균연령,2016,37.3,36.4,38.1,,37.2,36.4,38.1,
34003, 동부,127,중위연령,2016,37.3,36.7,38.1,,37.3,36.6,38.1,
34010, 천안시,000,합계,2016,638752,327305,311447,105.1,615190,312976,302214,103.6
34010, 천안시,005,0~4세,2016,32694,16676,16018,104.1,32297,16465,15832,104
34010, 천안시,005001, 0세,2016,6252,3169,3083,102.8,6154,3116,3038,102.6
34010, 천안시,005002, 1세,2016,6526,3368,3158,106.6,6449,3334,3115,107
34010, 천안시,005003, 2세,2016,6309,3226,3083,104.6,6238,3188,3050,104.5
34010, 천안시,005004, 3세,2016,6537,3348,3189,105,6460,3297,3163,104.2
34010, 천안시,005005, 4세,2016,7070,3565,3505,101.7,6996,3530,3466,101.8
34010, 천안시,010,5~9세,2016,32928,17037,15891,107.2,32696,16908,15788,107.1
34010, 천안시,010001, 5세,2016,6770,3519,3251,108.2,6694,3478,3216,108.1
34010, 천안시,010002, 6세,2016,6548,3373,3175,106.2,6488,3342,3146,106.2
34010, 천안시,010003, 7세,2016,6314,3278,3036,108,6288,3265,3023,108
34010, 천안시,010004, 8세,2016,6610,3447,3163,109,6574,3425,3149,108.8
34010, 천안시,010005, 9세,2016,6686,3420,3266,104.7,6652,3398,3254,104.4
34010, 천안시,015,10~14세,2016,31874,16645,15229,109.3,31761,16590,15171,109.4
34010, 천안시,015001, 10세,2016,6115,3217,2898,111,6087,3207,2880,111.4
34010, 천안시,015002, 11세,2016,6079,3134,2945,106.4,6051,3119,2932,106.4
34010, 천안시,015003, 12세,2016,6538,3460,3078,112.4,6512,3445,3067,112.3
34010, 천안시,015004, 13세,2016,6460,3347,3113,107.5,6444,3338,3106,107.5
34010, 천안시,015005, 14세,2016,6682,3487,3195,109.1,6667,3481,3186,109.3
34010, 천안시,020,15~19세,2016,44812,23090,21722,106.3,44242,22837,21405,106.7
34010, 천안시,020001, 15세,2016,7865,4076,3789,107.6,7842,4060,3782,107.4
34010, 천안시,020002, 16세,2016,8316,4482,3834,116.9,8288,4469,3819,117
34010, 천안시,020003, 17세,2016,8020,4241,3779,112.2,7977,4218,3759,112.2
34010, 천안시,020004, 18세,2016,9210,4773,4437,107.6,9057,4715,4342,108.6
34010, 천안시,020005, 19세,2016,11401,5518,5883,93.8,11078,5375,5703,94.2
34010, 천안시,025,20~24세,2016,53975,27763,26212,105.9,51362,26235,25127,104.4
34010, 천안시,025001, 20세,2016,10877,5205,5672,91.8,10490,5021,5469,91.8
34010, 천안시,025002, 21세,2016,10509,5115,5394,94.8,10050,4875,5175,94.2
34010, 천안시,025003, 22세,2016,10818,5640,5178,108.9,10303,5345,4958,107.8
34010, 천안시,025004, 23세,2016,10933,5843,5090,114.8,10361,5476,4885,112.1
34010, 천안시,025005, 24세,2016,10838,5960,4878,122.2,10158,5518,4640,118.9
34010, 천안시,030,25~29세,2016,46418,24852,21566,115.2,42341,22182,20159,110
34010, 천안시,030001, 25세,2016,9262,4944,4318,114.5,8573,4529,4044,112
34010, 천안시,030002, 26세,2016,9011,4844,4167,116.2,8186,4291,3895,110.2
34010, 천안시,030003, 27세,2016,8934,4858,4076,119.2,8133,4300,3833,112.2
34010, 천안시,030004, 28세,2016,9367,4982,4385,113.6,8536,4451,4085,109
34010, 천안시,030005, 29세,2016,9844,5224,4620,113.1,8913,4611,4302,107.2
34010, 천안시,035,30~34세,2016,53714,28934,24780,116.8,50003,26454,23549,112.3
34010, 천안시,035001, 30세,2016,9877,5360,4517,118.7,9113,4867,4246,114.6
34010, 천안시,035002, 31세,2016,9893,5381,4512,119.3,9105,4848,4257,113.9
34010, 천안시,035003, 32세,2016,10317,5609,4708,119.1,9566,5091,4475,113.8
34010, 천안시,035004, 33세,2016,11413,6064,5349,113.4,10700,5595,5105,109.6
34010, 천안시,035005, 34세,2016,12214,6520,5694,114.5,11519,6053,5466,110.7
34010, 천안시,040,35~39세,2016,55674,29927,25747,116.2,52951,28073,24878,112.8
34010, 천안시,040001, 35세,2016,11837,6429,5408,118.9,11244,6032,5212,115.7
34010, 천안시,040002, 36세,2016,12043,6474,5569,116.3,11416,6056,5360,113
34010, 천안시,040003, 37세,2016,11102,5920,5182,114.2,10567,5555,5012,110.8
34010, 천안시,040004, 38세,2016,10244,5609,4635,121,9751,5251,4500,116.7
34010, 천안시,040005, 39세,2016,10448,5495,4953,110.9,9973,5179,4794,108
34010, 천안시,045,40~44세,2016,54314,27883,26431,105.5,52090,26453,25637,103.2
34010, 천안시,045001, 40세,2016,10213,5305,4908,108.1,9738,4987,4751,105
34010, 천안시,045002, 41세,2016,10575,5350,5225,102.4,10099,5032,5067,99.3
34010, 천안시,045003, 42세,2016,11386,5877,5509,106.7,11003,5620,5383,104.4
34010, 천안시,045004, 43세,2016,11249,5781,5468,105.7,10823,5527,5296,104.4
34010, 천안시,045005, 44세,2016,10891,5570,5321,104.7,10427,5287,5140,102.9
34010, 천안시,050,45~49세,2016,56644,29000,27644,104.9,54522,27740,26782,103.6
34010, 천안시,050001, 45세,2016,11840,6171,5669,108.9,11385,5882,5503,106.9
34010, 천안시,050002, 46세,2016,11335,5860,5475,107,10913,5587,5326,104.9
34010, 천안시,050003, 47세,2016,11699,5975,5724,104.4,11238,5727,5511,103.9
34010, 천안시,050004, 48세,2016,11558,5866,5692,103.1,11127,5616,5511,101.9
34010, 천안시,050005, 49세,2016,10212,5128,5084,100.9,9859,4928,4931,99.9
34010, 천안시,055,50~54세,2016,48355,25334,23021,110,46394,24287,22107,109.9
34010, 천안시,055001, 50세,2016,9475,4939,4536,108.9,9068,4723,4345,108.7
34010, 천안시,055002, 51세,2016,10465,5420,5045,107.4,10043,5193,4850,107.1
34010, 천안시,055003, 52세,2016,9258,4776,4482,106.6,8881,4583,4298,106.6
34010, 천안시,055004, 53세,2016,9443,4979,4464,111.5,9018,4738,4280,110.7
34010, 천안시,055005, 54세,2016,9714,5220,4494,116.2,9384,5050,4334,116.5
34010, 천안시,060,55~59세,2016,42963,22394,20569,108.9,41722,21751,19971,108.9
34010, 천안시,060001, 55세,2016,10301,5424,4877,111.2,10095,5316,4779,111.2
34010, 천안시,060002, 56세,2016,9886,5106,4780,106.8,9585,4952,4633,106.9
34010, 천안시,060003, 57세,2016,8344,4261,4083,104.4,8088,4142,3946,105
34010, 천안시,060004, 58세,2016,7416,3896,3520,110.7,7172,3770,3402,110.8
34010, 천안시,060005, 59세,2016,7016,3707,3309,112,6782,3571,3211,111.2
34010, 천안시,065,60~64세,2016,27627,14003,13624,102.8,26661,13504,13157,102.6
34010, 천안시,065001, 60세,2016,6387,3269,3118,104.8,6160,3161,2999,105.4
34010, 천안시,065002, 61세,2016,6605,3341,3264,102.4,6358,3216,3142,102.4
34010, 천안시,065003, 62세,2016,5316,2662,2654,100.3,5124,2560,2564,99.8
34010, 천안시,065004, 63세,2016,4366,2250,2116,106.3,4192,2161,2031,106.4
34010, 천안시,065005, 64세,2016,4953,2481,2472,100.4,4827,2406,2421,99.4
34010, 천안시,070,65~69세,2016,18116,8783,9333,94.1,17765,8605,9160,93.9
34010, 천안시,070001, 65세,2016,3425,1731,1694,102.2,3322,1670,1652,101.1
34010, 천안시,070002, 66세,2016,3844,1834,2010,91.2,3772,1792,1980,90.5
34010, 천안시,070003, 67세,2016,3753,1809,1944,93.1,3683,1773,1910,92.8
34010, 천안시,070004, 68세,2016,3570,1753,1817,96.5,3511,1732,1779,97.4
34010, 천안시,070005, 69세,2016,3524,1656,1868,88.7,3477,1638,1839,89.1
34010, 천안시,075,70~74세,2016,13788,6135,7653,80.2,13679,6094,7585,80.3
34010, 천안시,075001, 70세,2016,2573,1279,1294,98.8,2540,1265,1275,99.2
34010, 천안시,075002, 71세,2016,2549,1174,1375,85.4,2531,1168,1363,85.7
34010, 천안시,075003, 72세,2016,2737,1188,1549,76.7,2709,1175,1534,76.6
34010, 천안시,075004, 73세,2016,2684,1139,1545,73.7,2670,1134,1536,73.8
34010, 천안시,075005, 74세,2016,3245,1355,1890,71.7,3229,1352,1877,72
34010, 천안시,080,75~79세,2016,11828,4751,7077,67.1,11737,4719,7018,67.2
34010, 천안시,080001, 75세,2016,2526,1041,1485,70.1,2505,1030,1475,69.8
34010, 천안시,080002, 76세,2016,2428,1025,1403,73.1,2406,1016,1390,73.1
34010, 천안시,080003, 77세,2016,2485,984,1501,65.6,2474,984,1490,66
34010, 천안시,080004, 78세,2016,2264,899,1365,65.9,2250,894,1356,65.9
34010, 천안시,080005, 79세,2016,2125,802,1323,60.6,2102,795,1307,60.8
34010, 천안시,085,80~84세,2016,7987,2764,5223,52.9,7948,2748,5200,52.8
34010, 천안시,085001, 80세,2016,1923,692,1231,56.2,1911,684,1227,55.7
34010, 천안시,085002, 81세,2016,1850,641,1209,53,1843,640,1203,53.2
34010, 천안시,085003, 82세,2016,1620,582,1038,56.1,1611,579,1032,56.1
34010, 천안시,085004, 83세,2016,1338,460,878,52.4,1332,458,874,52.4
34010, 천안시,085005, 84세,2016,1256,389,867,44.9,1251,387,864,44.8
34010, 천안시,090,85~89세,2016,3560,988,2572,38.4,3547,986,2561,38.5
34010, 천안시,090001, 85세,2016,906,257,649,39.6,898,255,643,39.7
34010, 천안시,090002, 86세,2016,815,252,563,44.8,813,252,561,44.9
34010, 천안시,090003, 87세,2016,737,197,540,36.5,735,197,538,36.6
34010, 천안시,090004, 88세,2016,612,163,449,36.3,611,163,448,36.4
34010, 천안시,090005, 89세,2016,490,119,371,32.1,490,119,371,32.1
34010, 천안시,095,90~94세,2016,1198,293,905,32.4,1192,293,899,32.6
34010, 천안시,095001, 90세,2016,345,68,277,24.5,343,68,275,24.7
34010, 천안시,095002, 91세,2016,294,78,216,36.1,293,78,215,36.3
34010, 천안시,095003, 92세,2016,199,59,140,42.1,199,59,140,42.1
34010, 천안시,095004, 93세,2016,203,51,152,33.6,202,51,151,33.8
34010, 천안시,095005, 94세,2016,157,37,120,30.8,155,37,118,31.4
34010, 천안시,100,95~99세,2016,255,53,202,26.2,253,52,201,25.9
34010, 천안시,100001, 95세,2016,94,26,68,38.2,93,26,67,38.8
34010, 천안시,100002, 96세,2016,76,12,64,18.8,75,11,64,17.2
34010, 천안시,100003, 97세,2016,41,9,32,28.1,41,9,32,28.1
34010, 천안시,100004, 98세,2016,27,X,25,8,27,X,25,8
34010, 천안시,100005, 99세,2016,17,X,13,30.8,17,X,13,30.8
34010, 천안시,101,100세이상,2016,28,X,28,0,27,X,27,0
34010, 천안시,102,15세미만,2016,97496,50358,47138,106.8,96754,49963,46791,106.8
34010, 천안시,103,15~64세,2016,484496,253180,231316,109.5,462288,239516,222772,107.5
34010, 천안시,104,65세이상,2016,56760,23767,32993,72,56148,23497,32651,72
34010, 천안시,086,85세이상,2016,5041,1334,3707,36,5019,1331,3688,36.1
34010, 천안시,126,평균연령,2016,37.3,36.5,38.1,,37.3,36.5,38.1,
34010, 천안시,127,중위연령,2016,36.9,36.3,37.6,,37,36.5,37.7,
34011, 동남구,000,합계,2016,276627,141194,135433,104.3,265906,134854,131052,102.9
34011, 동남구,005,0~4세,2016,12173,6242,5931,105.2,12007,6152,5855,105.1
34011, 동남구,005001, 0세,2016,2157,1102,1055,104.5,2115,1076,1039,103.6
34011, 동남구,005002, 1세,2016,2414,1220,1194,102.2,2376,1203,1173,102.6
34011, 동남구,005003, 2세,2016,2359,1230,1129,108.9,2326,1216,1110,109.5
34011, 동남구,005004, 3세,2016,2552,1307,1245,105,2523,1288,1235,104.3
34011, 동남구,005005, 4세,2016,2691,1383,1308,105.7,2667,1369,1298,105.5
34011, 동남구,010,5~9세,2016,13463,6959,6504,107,13364,6901,6463,106.8
34011, 동남구,010001, 5세,2016,2726,1424,1302,109.4,2700,1407,1293,108.8
34011, 동남구,010002, 6세,2016,2642,1362,1280,106.4,2614,1350,1264,106.8
34011, 동남구,010003, 7세,2016,2601,1358,1243,109.3,2588,1353,1235,109.6
34011, 동남구,010004, 8세,2016,2718,1395,1323,105.4,2701,1383,1318,104.9
34011, 동남구,010005, 9세,2016,2776,1420,1356,104.7,2761,1408,1353,104.1
34011, 동남구,015,10~14세,2016,12921,6770,6151,110.1,12874,6747,6127,110.1
34011, 동남구,015001, 10세,2016,2526,1346,1180,114.1,2511,1339,1172,114.2
34011, 동남구,015002, 11세,2016,2507,1278,1229,104,2494,1271,1223,103.9
34011, 동남구,015003, 12세,2016,2611,1380,1231,112.1,2603,1376,1227,112.1
34011, 동남구,015004, 13세,2016,2619,1366,1253,109,2613,1363,1250,109
34011, 동남구,015005, 14세,2016,2658,1400,1258,111.3,2653,1398,1255,111.4
34011, 동남구,020,15~19세,2016,20860,10898,9962,109.4,20496,10750,9746,110.3
34011, 동남구,020001, 15세,2016,3284,1725,1559,110.6,3277,1720,1557,110.5
34011, 동남구,020002, 16세,2016,3650,2117,1533,138.1,3637,2110,1527,138.2
34011, 동남구,020003, 17세,2016,3527,1949,1578,123.5,3497,1932,1565,123.5
34011, 동남구,020004, 18세,2016,4426,2320,2106,110.2,4323,2282,2041,111.8
34011, 동남구,020005, 19세,2016,5973,2787,3186,87.5,5762,2706,3056,88.5
34011, 동남구,025,20~24세,2016,25438,13127,12311,106.6,24150,12414,11736,105.8
34011, 동남구,025001, 20세,2016,5356,2376,2980,79.7,5145,2279,2866,79.5
34011, 동남구,025002, 21세,2016,4974,2302,2672,86.2,4729,2184,2545,85.8
34011, 동남구,025003, 22세,2016,5163,2717,2446,111.1,4924,2595,2329,111.4
34011, 동남구,025004, 23세,2016,5089,2879,2210,130.3,4825,2709,2116,128
34011, 동남구,025005, 24세,2016,4856,2853,2003,142.4,4527,2647,1880,140.8
34011, 동남구,030,25~29세,2016,18083,9962,8121,122.7,16289,8805,7484,117.7
34011, 동남구,030001, 25세,2016,4061,2295,1766,130,3747,2120,1627,130.3
34011, 동남구,030002, 26세,2016,3654,2047,1607,127.4,3286,1801,1485,121.3
34011, 동남구,030003, 27세,2016,3466,1921,1545,124.3,3127,1687,1440,117.2
34011, 동남구,030004, 28세,2016,3424,1806,1618,111.6,3061,1581,1480,106.8
34011, 동남구,030005, 29세,2016,3478,1893,1585,119.4,3068,1616,1452,111.3
34011, 동남구,035,30~34세,2016,19308,10298,9010,114.3,17787,9291,8496,109.4
34011, 동남구,035001, 30세,2016,3421,1837,1584,116,3112,1639,1473,111.3
34011, 동남구,035002, 31세,2016,3559,1947,1612,120.8,3239,1730,1509,114.6
34011, 동남구,035003, 32세,2016,3739,2007,1732,115.9,3439,1802,1637,110.1
34011, 동남구,035004, 33세,2016,4058,2111,1947,108.4,3764,1911,1853,103.1
34011, 동남구,035005, 34세,2016,4531,2396,2135,112.2,4233,2209,2024,109.1
34011, 동남구,040,35~39세,2016,22079,11583,10496,110.4,20972,10844,10128,107.1
34011, 동남구,040001, 35세,2016,4451,2359,2092,112.8,4210,2201,2009,109.6
34011, 동남구,040002, 36세,2016,4750,2433,2317,105,4493,2272,2221,102.3
34011, 동남구,040003, 37세,2016,4506,2306,2200,104.8,4289,2160,2129,101.5
34011, 동남구,040004, 38세,2016,4105,2232,1873,119.2,3897,2082,1815,114.7
34011, 동남구,040005, 39세,2016,4267,2253,2014,111.9,4083,2129,1954,109
34011, 동남구,045,40~44세,2016,22676,11796,10880,108.4,21726,11205,10521,106.5
34011, 동남구,045001, 40세,2016,4235,2218,2017,110,4041,2087,1954,106.8
34011, 동남구,045002, 41세,2016,4491,2313,2178,106.2,4277,2177,2100,103.7
34011, 동남구,045003, 42세,2016,4736,2497,2239,111.5,4567,2386,2181,109.4
34011, 동남구,045004, 43세,2016,4771,2497,2274,109.8,4596,2392,2204,108.5
34011, 동남구,045005, 44세,2016,4443,2271,2172,104.6,4245,2163,2082,103.9
34011, 동남구,050,45~49세,2016,23559,12102,11457,105.6,22574,11507,11067,104
34011, 동남구,050001, 45세,2016,4828,2489,2339,106.4,4638,2371,2267,104.6
34011, 동남구,050002, 46세,2016,4698,2444,2254,108.4,4497,2310,2187,105.6
34011, 동남구,050003, 47세,2016,4865,2495,2370,105.3,4642,2377,2265,104.9
34011, 동남구,050004, 48세,2016,4764,2427,2337,103.9,4560,2299,2261,101.7
34011, 동남구,050005, 49세,2016,4404,2247,2157,104.2,4237,2150,2087,103
34011, 동남구,055,50~54세,2016,21430,11134,10296,108.1,20429,10610,9819,108.1
34011, 동남구,055001, 50세,2016,4120,2182,1938,112.6,3908,2062,1846,111.7
34011, 동남구,055002, 51세,2016,4558,2342,2216,105.7,4357,2243,2114,106.1
34011, 동남구,055003, 52세,2016,4098,2091,2007,104.2,3907,2002,1905,105.1
34011, 동남구,055004, 53세,2016,4257,2213,2044,108.3,4019,2074,1945,106.6
34011, 동남구,055005, 54세,2016,4397,2306,2091,110.3,4238,2229,2009,111
34011, 동남구,060,55~59세,2016,20472,10553,9919,106.4,19835,10217,9618,106.2
34011, 동남구,060001, 55세,2016,4870,2534,2336,108.5,4767,2482,2285,108.6
34011, 동남구,060002, 56세,2016,4639,2356,2283,103.2,4481,2274,2207,103
34011, 동남구,060003, 57세,2016,3923,2019,1904,106,3790,1961,1829,107.2
34011, 동남구,060004, 58세,2016,3582,1852,1730,107.1,3459,1782,1677,106.3
34011, 동남구,060005, 59세,2016,3458,1792,1666,107.6,3338,1718,1620,106
34011, 동남구,065,60~64세,2016,13982,7021,6961,100.9,13527,6795,6732,100.9
34011, 동남구,065001, 60세,2016,3205,1599,1606,99.6,3099,1552,1547,100.3
34011, 동남구,065002, 61세,2016,3308,1659,1649,100.6,3190,1604,1586,101.1
34011, 동남구,065003, 62세,2016,2696,1348,1348,100,2609,1302,1307,99.6
34011, 동남구,065004, 63세,2016,2233,1140,1093,104.3,2151,1099,1052,104.5
34011, 동남구,065005, 64세,2016,2540,1275,1265,100.8,2478,1238,1240,99.8
34011, 동남구,070,65~69세,2016,9499,4662,4837,96.4,9320,4574,4746,96.4
34011, 동남구,070001, 65세,2016,1778,917,861,106.5,1731,889,842,105.6
34011, 동남구,070002, 66세,2016,2045,997,1048,95.1,2005,970,1035,93.7
34011, 동남구,070003, 67세,2016,1973,966,1007,95.9,1940,951,989,96.2
34011, 동남구,070004, 68세,2016,1843,909,934,97.3,1814,899,915,98.3
34011, 동남구,070005, 69세,2016,1860,873,987,88.4,1830,865,965,89.6
34011, 동남구,075,70~74세,2016,7204,3243,3961,81.9,7151,3221,3930,82
34011, 동남구,075001, 70세,2016,1318,648,670,96.7,1299,639,660,96.8
34011, 동남구,075002, 71세,2016,1363,652,711,91.7,1356,647,709,91.3
34011, 동남구,075003, 72세,2016,1451,654,797,82.1,1439,649,790,82.2
34011, 동남구,075004, 73세,2016,1386,579,807,71.7,1378,578,800,72.3
34011, 동남구,075005, 74세,2016,1686,710,976,72.7,1679,708,971,72.9
34011, 동남구,080,75~79세,2016,6284,2574,3710,69.4,6241,2560,3681,69.5
34011, 동남구,080001, 75세,2016,1341,567,774,73.3,1329,560,769,72.8
34011, 동남구,080002, 76세,2016,1288,558,730,76.4,1276,555,721,77
34011, 동남구,080003, 77세,2016,1318,539,779,69.2,1313,539,774,69.6
34011, 동남구,080004, 78세,2016,1192,472,720,65.6,1188,469,719,65.2
34011, 동남구,080005, 79세,2016,1145,438,707,62,1135,437,698,62.6
34011, 동남구,085,80~84세,2016,4370,1524,2846,53.5,4350,1516,2834,53.5
34011, 동남구,085001, 80세,2016,1039,381,658,57.9,1034,378,656,57.6
34011, 동남구,085002, 81세,2016,1024,370,654,56.6,1020,369,651,56.7
34011, 동남구,085003, 82세,2016,846,305,541,56.4,839,303,536,56.5
34011, 동남구,085004, 83세,2016,753,257,496,51.8,752,256,496,51.6
34011, 동남구,085005, 84세,2016,708,211,497,42.5,705,210,495,42.4
34011, 동남구,090,85~89세,2016,1979,551,1428,38.6,1973,551,1422,38.7
34011, 동남구,090001, 85세,2016,487,135,352,38.4,484,135,349,38.7
34011, 동남구,090002, 86세,2016,449,147,302,48.7,448,147,301,48.8
34011, 동남구,090003, 87세,2016,418,113,305,37,417,113,304,37.2
34011, 동남구,090004, 88세,2016,343,88,255,34.5,342,88,254,34.6
34011, 동남구,090005, 89세,2016,282,68,214,31.8,282,68,214,31.8
34011, 동남구,095,90~94세,2016,689,166,523,31.7,686,166,520,31.9
34011, 동남구,095001, 90세,2016,199,40,159,25.2,197,40,157,25.5
34011, 동남구,095002, 91세,2016,163,43,120,35.8,162,43,119,36.1
34011, 동남구,095003, 92세,2016,108,33,75,44,108,33,75,44
34011, 동남구,095004, 93세,2016,122,29,93,31.2,122,29,93,31.2
34011, 동남구,095005, 94세,2016,97,21,76,27.6,97,21,76,27.6
34011, 동남구,100,95~99세,2016,144,29,115,25.2,142,28,114,24.6
34011, 동남구,100001, 95세,2016,55,17,38,44.7,54,17,37,45.9
34011, 동남구,100002, 96세,2016,41,8,33,24.2,40,7,33,21.2
34011, 동남구,100003, 97세,2016,22,X,20,10,22,X,20,10
34011, 동남구,100004, 98세,2016,18,X,17,5.9,18,X,17,5.9
34011, 동남구,100005, 99세,2016,8,X,7,14.3,8,X,7,14.3
34011, 동남구,101,100세이상,2016,14,X,14,0,13,X,13,0
34011, 동남구,102,15세미만,2016,38557,19971,18586,107.5,38245,19800,18445,107.3
34011, 동남구,103,15~64세,2016,207887,108474,99413,109.1,197785,102438,95347,107.4
34011, 동남구,104,65세이상,2016,30183,12749,17434,73.1,29876,12616,17260,73.1
34011, 동남구,086,85세이상,2016,2826,746,2080,35.9,2814,745,2069,36
34011, 동남구,126,평균연령,2016,38.7,37.7,39.7,,38.7,37.8,39.7,
34011, 동남구,127,중위연령,2016,38.6,37.7,39.6,,38.8,37.9,39.7,
34012, 서북구,000,합계,2016,362125,186111,176014,105.7,349284,178122,171162,104.1
34012, 서북구,005,0~4세,2016,20521,10434,10087,103.4,20290,10313,9977,103.4
34012, 서북구,005001, 0세,2016,4095,2067,2028,101.9,4039,2040,1999,102.1
34012, 서북구,005002, 1세,2016,4112,2148,1964,109.4,4073,2131,1942,109.7
34012, 서북구,005003, 2세,2016,3950,1996,1954,102.1,3912,1972,1940,101.6
34012, 서북구,005004, 3세,2016,3985,2041,1944,105,3937,2009,1928,104.2
34012, 서북구,005005, 4세,2016,4379,2182,2197,99.3,4329,2161,2168,99.7
34012, 서북구,010,5~9세,2016,19465,10078,9387,107.4,19332,10007,9325,107.3
34012, 서북구,010001, 5세,2016,4044,2095,1949,107.5,3994,2071,1923,107.7
34012, 서북구,010002, 6세,2016,3906,2011,1895,106.1,3874,1992,1882,105.8
34012, 서북구,010003, 7세,2016,3713,1920,1793,107.1,3700,1912,1788,106.9
34012, 서북구,010004, 8세,2016,3892,2052,1840,111.5,3873,2042,1831,111.5
34012, 서북구,010005, 9세,2016,3910,2000,1910,104.7,3891,1990,1901,104.7
34012, 서북구,015,10~14세,2016,18953,9875,9078,108.8,18887,9843,9044,108.8
34012, 서북구,015001, 10세,2016,3589,1871,1718,108.9,3576,1868,1708,109.4
34012, 서북구,015002, 11세,2016,3572,1856,1716,108.2,3557,1848,1709,108.1
34012, 서북구,015003, 12세,2016,3927,2080,1847,112.6,3909,2069,1840,112.4
34012, 서북구,015004, 13세,2016,3841,1981,1860,106.5,3831,1975,1856,106.4
34012, 서북구,015005, 14세,2016,4024,2087,1937,107.7,4014,2083,1931,107.9
34012, 서북구,020,15~19세,2016,23952,12192,11760,103.7,23746,12087,11659,103.7
34012, 서북구,020001, 15세,2016,4581,2351,2230,105.4,4565,2340,2225,105.2
34012, 서북구,020002, 16세,2016,4666,2365,2301,102.8,4651,2359,2292,102.9
34012, 서북구,020003, 17세,2016,4493,2292,2201,104.1,4480,2286,2194,104.2
34012, 서북구,020004, 18세,2016,4784,2453,2331,105.2,4734,2433,2301,105.7
34012, 서북구,020005, 19세,2016,5428,2731,2697,101.3,5316,2669,2647,100.8
34012, 서북구,025,20~24세,2016,28537,14636,13901,105.3,27212,13821,13391,103.2
34012, 서북구,025001, 20세,2016,5521,2829,2692,105.1,5345,2742,2603,105.3
34012, 서북구,025002, 21세,2016,5535,2813,2722,103.3,5321,2691,2630,102.3
34012, 서북구,025003, 22세,2016,5655,2923,2732,107,5379,2750,2629,104.6
34012, 서북구,025004, 23세,2016,5844,2964,2880,102.9,5536,2767,2769,99.9
34012, 서북구,025005, 24세,2016,5982,3107,2875,108.1,5631,2871,2760,104
34012, 서북구,030,25~29세,2016,28335,14890,13445,110.7,26052,13377,12675,105.5
34012, 서북구,030001, 25세,2016,5201,2649,2552,103.8,4826,2409,2417,99.7
34012, 서북구,030002, 26세,2016,5357,2797,2560,109.3,4900,2490,2410,103.3
34012, 서북구,030003, 27세,2016,5468,2937,2531,116,5006,2613,2393,109.2
34012, 서북구,030004, 28세,2016,5943,3176,2767,114.8,5475,2870,2605,110.2
34012, 서북구,030005, 29세,2016,6366,3331,3035,109.8,5845,2995,2850,105.1
34012, 서북구,035,30~34세,2016,34406,18636,15770,118.2,32216,17163,15053,114
34012, 서북구,035001, 30세,2016,6456,3523,2933,120.1,6001,3228,2773,116.4
34012, 서북구,035002, 31세,2016,6334,3434,2900,118.4,5866,3118,2748,113.5
34012, 서북구,035003, 32세,2016,6578,3602,2976,121,6127,3289,2838,115.9
34012, 서북구,035004, 33세,2016,7355,3953,3402,116.2,6936,3684,3252,113.3
34012, 서북구,035005, 34세,2016,7683,4124,3559,115.9,7286,3844,3442,111.7
34012, 서북구,040,35~39세,2016,33595,18344,15251,120.3,31979,17229,14750,116.8
34012, 서북구,040001, 35세,2016,7386,4070,3316,122.7,7034,3831,3203,119.6
34012, 서북구,040002, 36세,2016,7293,4041,3252,124.3,6923,3784,3139,120.5
34012, 서북구,040003, 37세,2016,6596,3614,2982,121.2,6278,3395,2883,117.8
34012, 서북구,040004, 38세,2016,6139,3377,2762,122.3,5854,3169,2685,118
34012, 서북구,040005, 39세,2016,6181,3242,2939,110.3,5890,3050,2840,107.4
34012, 서북구,045,40~44세,2016,31638,16087,15551,103.4,30364,15248,15116,100.9
34012, 서북구,045001, 40세,2016,5978,3087,2891,106.8,5697,2900,2797,103.7
34012, 서북구,045002, 41세,2016,6084,3037,3047,99.7,5822,2855,2967,96.2
34012, 서북구,045003, 42세,2016,6650,3380,3270,103.4,6436,3234,3202,101
34012, 서북구,045004, 43세,2016,6478,3284,3194,102.8,6227,3135,3092,101.4
34012, 서북구,045005, 44세,2016,6448,3299,3149,104.8,6182,3124,3058,102.2
34012, 서북구,050,45~49세,2016,33085,16898,16187,104.4,31948,16233,15715,103.3
34012, 서북구,050001, 45세,2016,7012,3682,3330,110.6,6747,3511,3236,108.5
34012, 서북구,050002, 46세,2016,6637,3416,3221,106.1,6416,3277,3139,104.4
34012, 서북구,050003, 47세,2016,6834,3480,3354,103.8,6596,3350,3246,103.2
34012, 서북구,050004, 48세,2016,6794,3439,3355,102.5,6567,3317,3250,102.1
34012, 서북구,050005, 49세,2016,5808,2881,2927,98.4,5622,2778,2844,97.7
34012, 서북구,055,50~54세,2016,26925,14200,12725,111.6,25965,13677,12288,111.3
34012, 서북구,055001, 50세,2016,5355,2757,2598,106.1,5160,2661,2499,106.5
34012, 서북구,055002, 51세,2016,5907,3078,2829,108.8,5686,2950,2736,107.8
34012, 서북구,055003, 52세,2016,5160,2685,2475,108.5,4974,2581,2393,107.9
34012, 서북구,055004, 53세,2016,5186,2766,2420,114.3,4999,2664,2335,114.1
34012, 서북구,055005, 54세,2016,5317,2914,2403,121.3,5146,2821,2325,121.3
34012, 서북구,060,55~59세,2016,22491,11841,10650,111.2,21887,11534,10353,111.4
34012, 서북구,060001, 55세,2016,5431,2890,2541,113.7,5328,2834,2494,113.6
34012, 서북구,060002, 56세,2016,5247,2750,2497,110.1,5104,2678,2426,110.4
34012, 서북구,060003, 57세,2016,4421,2242,2179,102.9,4298,2181,2117,103
34012, 서북구,060004, 58세,2016,3834,2044,1790,114.2,3713,1988,1725,115.2
34012, 서북구,060005, 59세,2016,3558,1915,1643,116.6,3444,1853,1591,116.5
34012, 서북구,065,60~64세,2016,13645,6982,6663,104.8,13134,6709,6425,104.4
34012, 서북구,065001, 60세,2016,3182,1670,1512,110.4,3061,1609,1452,110.8
34012, 서북구,065002, 61세,2016,3297,1682,1615,104.1,3168,1612,1556,103.6
34012, 서북구,065003, 62세,2016,2620,1314,1306,100.6,2515,1258,1257,100.1
34012, 서북구,065004, 63세,2016,2133,1110,1023,108.5,2041,1062,979,108.5
34012, 서북구,065005, 64세,2016,2413,1206,1207,99.9,2349,1168,1181,98.9
34012, 서북구,070,65~69세,2016,8617,4121,4496,91.7,8445,4031,4414,91.3
34012, 서북구,070001, 65세,2016,1647,814,833,97.7,1591,781,810,96.4
34012, 서북구,070002, 66세,2016,1799,837,962,87,1767,822,945,87
34012, 서북구,070003, 67세,2016,1780,843,937,90,1743,822,921,89.3
34012, 서북구,070004, 68세,2016,1727,844,883,95.6,1697,833,864,96.4
34012, 서북구,070005, 69세,2016,1664,783,881,88.9,1647,773,874,88.4
34012, 서북구,075,70~74세,2016,6584,2892,3692,78.3,6528,2873,3655,78.6
34012, 서북구,075001, 70세,2016,1255,631,624,101.1,1241,626,615,101.8
34012, 서북구,075002, 71세,2016,1186,522,664,78.6,1175,521,654,79.7
34012, 서북구,075003, 72세,2016,1286,534,752,71,1270,526,744,70.7
34012, 서북구,075004, 73세,2016,1298,560,738,75.9,1292,556,736,75.5
34012, 서북구,075005, 74세,2016,1559,645,914,70.6,1550,644,906,71.1
34012, 서북구,080,75~79세,2016,5544,2177,3367,64.7,5496,2159,3337,64.7
34012, 서북구,080001, 75세,2016,1185,474,711,66.7,1176,470,706,66.6
34012, 서북구,080002, 76세,2016,1140,467,673,69.4,1130,461,669,68.9
34012, 서북구,080003, 77세,2016,1167,445,722,61.6,1161,445,716,62.2
34012, 서북구,080004, 78세,2016,1072,427,645,66.2,1062,425,637,66.7
34012, 서북구,080005, 79세,2016,980,364,616,59.1,967,358,609,58.8
34012, 서북구,085,80~84세,2016,3617,1240,2377,52.2,3598,1232,2366,52.1
34012, 서북구,085001, 80세,2016,884,311,573,54.3,877,306,571,53.6
34012, 서북구,085002, 81세,2016,826,271,555,48.8,823,271,552,49.1
34012, 서북구,085003, 82세,2016,774,277,497,55.7,772,276,496,55.6
34012, 서북구,085004, 83세,2016,585,203,382,53.1,580,202,378,53.4
34012, 서북구,085005, 84세,2016,548,178,370,48.1,546,177,369,48
34012, 서북구,090,85~89세,2016,1581,437,1144,38.2,1574,435,1139,38.2
34012, 서북구,090001, 85세,2016,419,122,297,41.1,414,120,294,40.8
34012, 서북구,090002, 86세,2016,366,105,261,40.2,365,105,260,40.4
34012, 서북구,090003, 87세,2016,319,84,235,35.7,318,84,234,35.9
34012, 서북구,090004, 88세,2016,269,75,194,38.7,269,75,194,38.7
34012, 서북구,090005, 89세,2016,208,51,157,32.5,208,51,157,32.5
34012, 서북구,095,90~94세,2016,509,127,382,33.2,506,127,379,33.5
34012, 서북구,095001, 90세,2016,146,28,118,23.7,146,28,118,23.7
34012, 서북구,095002, 91세,2016,131,35,96,36.5,131,35,96,36.5
34012, 서북구,095003, 92세,2016,91,26,65,40,91,26,65,40
34012, 서북구,095004, 93세,2016,81,22,59,37.3,80,22,58,37.9
34012, 서북구,095005, 94세,2016,60,16,44,36.4,58,16,42,38.1
34012, 서북구,100,95~99세,2016,111,24,87,27.6,111,24,87,27.6
34012, 서북구,100001, 95세,2016,39,9,30,30,39,9,30,30
34012, 서북구,100002, 96세,2016,35,X,31,12.9,35,X,31,12.9
34012, 서북구,100003, 97세,2016,19,7,12,58.3,19,7,12,58.3
34012, 서북구,100004, 98세,2016,9,X,8,12.5,9,X,8,12.5
34012, 서북구,100005, 99세,2016,9,X,6,50,9,X,6,50
34012, 서북구,101,100세이상,2016,14,X,14,0,14,X,14,0
34012, 서북구,102,15세미만,2016,58939,30387,28552,106.4,58509,30163,28346,106.4
34012, 서북구,103,15~64세,2016,276609,144706,131903,109.7,264503,137078,127425,107.6
34012, 서북구,104,65세이상,2016,26577,11018,15559,70.8,26272,10881,15391,70.7
34012, 서북구,086,85세이상,2016,2215,588,1627,36.1,2205,586,1619,36.2
34012, 서북구,126,평균연령,2016,36.2,35.6,36.8,,36.2,35.6,36.8,
34012, 서북구,127,중위연령,2016,35.9,35.6,36.4,,36,35.6,36.4,
34020, 공주시,000,합계,2016,112928,55991,56937,98.3,110709,54877,55832,98.3
34020, 공주시,005,0~4세,2016,3193,1664,1529,108.8,3182,1657,1525,108.7
34020, 공주시,005001, 0세,2016,518,263,255,103.1,516,261,255,102.4
34020, 공주시,005002, 1세,2016,615,306,309,99,611,304,307,99
34020, 공주시,005003, 2세,2016,607,335,272,123.2,607,335,272,123.2
34020, 공주시,005004, 3세,2016,707,376,331,113.6,703,374,329,113.7
34020, 공주시,005005, 4세,2016,746,384,362,106.1,745,383,362,105.8
34020, 공주시,010,5~9세,2016,3839,1979,1860,106.4,3829,1974,1855,106.4
34020, 공주시,010001, 5세,2016,756,391,365,107.1,751,387,364,106.3
34020, 공주시,010002, 6세,2016,742,381,361,105.5,740,381,359,106.1
34020, 공주시,010003, 7세,2016,739,380,359,105.8,738,379,359,105.6
34020, 공주시,010004, 8세,2016,782,392,390,100.5,780,392,388,101
34020, 공주시,010005, 9세,2016,820,435,385,113,820,435,385,113
34020, 공주시,015,10~14세,2016,4291,2226,2065,107.8,4282,2222,2060,107.9
34020, 공주시,015001, 10세,2016,796,391,405,96.5,794,391,403,97
34020, 공주시,015002, 11세,2016,791,400,391,102.3,788,398,390,102.1
34020, 공주시,015003, 12세,2016,821,418,403,103.7,820,418,402,104
34020, 공주시,015004, 13세,2016,898,483,415,116.4,897,483,414,116.7
34020, 공주시,015005, 14세,2016,985,534,451,118.4,983,532,451,118
34020, 공주시,020,15~19세,2016,8159,4202,3957,106.2,8077,4178,3899,107.2
34020, 공주시,020001, 15세,2016,1095,563,532,105.8,1095,563,532,105.8
34020, 공주시,020002, 16세,2016,1372,773,599,129,1367,770,597,129
34020, 공주시,020003, 17세,2016,1636,952,684,139.2,1624,948,676,140.2
34020, 공주시,020004, 18세,2016,1831,973,858,113.4,1800,967,833,116.1
34020, 공주시,020005, 19세,2016,2225,941,1284,73.3,2191,930,1261,73.8
34020, 공주시,025,20~24세,2016,9866,4733,5133,92.2,9448,4540,4908,92.5
34020, 공주시,025001, 20세,2016,2216,844,1372,61.5,2175,827,1348,61.4
34020, 공주시,025002, 21세,2016,2231,941,1290,72.9,2162,910,1252,72.7
34020, 공주시,025003, 22세,2016,2087,1000,1087,92,1994,959,1035,92.7
34020, 공주시,025004, 23세,2016,1770,1007,763,132,1668,962,706,136.3
34020, 공주시,025005, 24세,2016,1562,941,621,151.5,1449,882,567,155.6
34020, 공주시,030,25~29세,2016,5990,3388,2602,130.2,5514,3152,2362,133.4
34020, 공주시,030001, 25세,2016,1399,826,573,144.2,1301,774,527,146.9
34020, 공주시,030002, 26세,2016,1266,697,569,122.5,1162,654,508,128.7
34020, 공주시,030003, 27세,2016,1143,653,490,133.3,1047,610,437,139.6
34020, 공주시,030004, 28세,2016,1071,578,493,117.2,982,537,445,120.7
34020, 공주시,030005, 29세,2016,1111,634,477,132.9,1022,577,445,129.7
34020, 공주시,035,30~34세,2016,5391,2927,2464,118.8,5091,2756,2335,118
34020, 공주시,035001, 30세,2016,1072,575,497,115.7,999,538,461,116.7
34020, 공주시,035002, 31세,2016,1017,568,449,126.5,955,535,420,127.4
34020, 공주시,035003, 32세,2016,1030,576,454,126.9,967,536,431,124.4
34020, 공주시,035004, 33세,2016,1140,620,520,119.2,1087,588,499,117.8
34020, 공주시,035005, 34세,2016,1132,588,544,108.1,1083,559,524,106.7
34020, 공주시,040,35~39세,2016,6086,3228,2858,112.9,5891,3108,2783,111.7
34020, 공주시,040001, 35세,2016,1258,664,594,111.8,1203,634,569,111.4
34020, 공주시,040002, 36세,2016,1265,664,601,110.5,1231,642,589,109
34020, 공주시,040003, 37세,2016,1171,613,558,109.9,1127,586,541,108.3
34020, 공주시,040004, 38세,2016,1213,664,549,120.9,1180,645,535,120.6
34020, 공주시,040005, 39세,2016,1179,623,556,112.1,1150,601,549,109.5
34020, 공주시,045,40~44세,2016,6746,3531,3215,109.8,6610,3445,3165,108.8
34020, 공주시,045001, 40세,2016,1180,629,551,114.2,1153,615,538,114.3
34020, 공주시,045002, 41세,2016,1276,683,593,115.2,1249,664,585,113.5
34020, 공주시,045003, 42세,2016,1456,782,674,116,1428,760,668,113.8
34020, 공주시,045004, 43세,2016,1493,748,745,100.4,1470,736,734,100.3
34020, 공주시,045005, 44세,2016,1341,689,652,105.7,1310,670,640,104.7
34020, 공주시,050,45~49세,2016,8392,4386,4006,109.5,8231,4306,3925,109.7
34020, 공주시,050001, 45세,2016,1605,850,755,112.6,1578,839,739,113.5
34020, 공주시,050002, 46세,2016,1614,833,781,106.7,1576,814,762,106.8
34020, 공주시,050003, 47세,2016,1750,910,840,108.3,1719,892,827,107.9
34020, 공주시,050004, 48세,2016,1773,923,850,108.6,1740,906,834,108.6
34020, 공주시,050005, 49세,2016,1650,870,780,111.5,1618,855,763,112.1
34020, 공주시,055,50~54세,2016,8750,4474,4276,104.6,8583,4396,4187,105
34020, 공주시,055001, 50세,2016,1444,746,698,106.9,1409,729,680,107.2
34020, 공주시,055002, 51세,2016,1814,919,895,102.7,1775,896,879,101.9
34020, 공주시,055003, 52세,2016,1709,883,826,106.9,1676,867,809,107.2
34020, 공주시,055004, 53세,2016,1782,897,885,101.4,1750,884,866,102.1
34020, 공주시,055005, 54세,2016,2001,1029,972,105.9,1973,1020,953,107
34020, 공주시,060,55~59세,2016,10264,5147,5117,100.6,10159,5098,5061,100.7
34020, 공주시,060001, 55세,2016,2314,1195,1119,106.8,2301,1191,1110,107.3
34020, 공주시,060002, 56세,2016,2158,1062,1096,96.9,2131,1051,1080,97.3
34020, 공주시,060003, 57세,2016,1973,978,995,98.3,1950,968,982,98.6
34020, 공주시,060004, 58세,2016,1930,968,962,100.6,1905,954,951,100.3
34020, 공주시,060005, 59세,2016,1889,944,945,99.9,1872,934,938,99.6
34020, 공주시,065,60~64세,2016,8280,4133,4147,99.7,8210,4101,4109,99.8
34020, 공주시,065001, 60세,2016,1817,927,890,104.2,1799,919,880,104.4
34020, 공주시,065002, 61세,2016,1983,1010,973,103.8,1965,1001,964,103.8
34020, 공주시,065003, 62세,2016,1569,744,825,90.2,1559,741,818,90.6
34020, 공주시,065004, 63세,2016,1338,662,676,97.9,1327,655,672,97.5
34020, 공주시,065005, 64세,2016,1573,790,783,100.9,1560,785,775,101.3
34020, 공주시,070,65~69세,2016,6402,3244,3158,102.7,6356,3224,3132,102.9
34020, 공주시,070001, 65세,2016,1160,597,563,106,1151,593,558,106.3
34020, 공주시,070002, 66세,2016,1426,731,695,105.2,1412,725,687,105.5
34020, 공주시,070003, 67세,2016,1360,690,670,103,1350,687,663,103.6
34020, 공주시,070004, 68세,2016,1260,625,635,98.4,1252,621,631,98.4
34020, 공주시,070005, 69세,2016,1196,601,595,101,1191,598,593,100.8
34020, 공주시,075,70~74세,2016,5460,2395,3065,78.1,5439,2390,3049,78.4
34020, 공주시,075001, 70세,2016,886,424,462,91.8,879,422,457,92.3
34020, 공주시,075002, 71세,2016,985,429,556,77.2,981,429,552,77.7
34020, 공주시,075003, 72세,2016,1107,476,631,75.4,1104,475,629,75.5
34020, 공주시,075004, 73세,2016,981,442,539,82,977,440,537,81.9
34020, 공주시,075005, 74세,2016,1501,624,877,71.2,1498,624,874,71.4
34020, 공주시,080,75~79세,2016,5355,2167,3188,68,5348,2165,3183,68
34020, 공주시,080001, 75세,2016,1117,494,623,79.3,1117,494,623,79.3
34020, 공주시,080002, 76세,2016,1050,436,614,71,1047,436,611,71.4
34020, 공주시,080003, 77세,2016,1174,449,725,61.9,1173,448,725,61.8
34020, 공주시,080004, 78세,2016,1008,386,622,62.1,1007,386,621,62.2
34020, 공주시,080005, 79세,2016,1006,402,604,66.6,1004,401,603,66.5
34020, 공주시,085,80~84세,2016,3969,1457,2512,58,3965,1455,2510,58
34020, 공주시,085001, 80세,2016,948,353,595,59.3,947,352,595,59.2
34020, 공주시,085002, 81세,2016,908,358,550,65.1,906,357,549,65
34020, 공주시,085003, 82세,2016,798,291,507,57.4,798,291,507,57.4
34020, 공주시,085004, 83세,2016,701,258,443,58.2,700,258,442,58.4
34020, 공주시,085005, 84세,2016,614,197,417,47.2,614,197,417,47.2
34020, 공주시,090,85~89세,2016,1792,538,1254,42.9,1791,538,1253,42.9
34020, 공주시,090001, 85세,2016,496,165,331,49.8,496,165,331,49.8
34020, 공주시,090002, 86세,2016,413,129,284,45.4,413,129,284,45.4
34020, 공주시,090003, 87세,2016,397,115,282,40.8,397,115,282,40.8
34020, 공주시,090004, 88세,2016,280,85,195,43.6,280,85,195,43.6
34020, 공주시,090005, 89세,2016,206,44,162,27.2,205,44,161,27.3
34020, 공주시,095,90~94세,2016,554,135,419,32.2,554,135,419,32.2
34020, 공주시,095001, 90세,2016,165,44,121,36.4,165,44,121,36.4
34020, 공주시,095002, 91세,2016,121,34,87,39.1,121,34,87,39.1
34020, 공주시,095003, 92세,2016,86,20,66,30.3,86,20,66,30.3
34020, 공주시,095004, 93세,2016,100,23,77,29.9,100,23,77,29.9
34020, 공주시,095005, 94세,2016,82,14,68,20.6,82,14,68,20.6
34020, 공주시,100,95~99세,2016,139,37,102,36.3,139,37,102,36.3
34020, 공주시,100001, 95세,2016,52,13,39,33.3,52,13,39,33.3
34020, 공주시,100002, 96세,2016,34,9,25,36,34,9,25,36
34020, 공주시,100003, 97세,2016,29,6,23,26.1,29,6,23,26.1
34020, 공주시,100004, 98세,2016,14,5,9,55.6,14,5,9,55.6
34020, 공주시,100005, 99세,2016,10,X,6,66.7,10,X,6,66.7
34020, 공주시,101,100세이상,2016,10,X,10,0,10,X,10,0
34020, 공주시,102,15세미만,2016,11323,5869,5454,107.6,11293,5853,5440,107.6
34020, 공주시,103,15~64세,2016,77924,40149,37775,106.3,75814,39080,36734,106.4
34020, 공주시,104,65세이상,2016,23681,9973,13708,72.8,23602,9944,13658,72.8
34020, 공주시,086,85세이상,2016,2495,710,1785,39.8,2494,710,1784,39.8
34020, 공주시,126,평균연령,2016,44.9,43.4,46.4,,45.1,43.5,46.6,
34020, 공주시,127,중위연령,2016,46.8,45.1,48.5,,47.2,45.5,48.8,
34030, 보령시,000,합계,2016,101161,51976,49185,105.7,98077,49663,48414,102.6
34030, 보령시,005,0~4세,2016,3407,1725,1682,102.6,3396,1722,1674,102.9
34030, 보령시,005001, 0세,2016,619,309,310,99.7,617,308,309,99.7
34030, 보령시,005002, 1세,2016,668,341,327,104.3,665,340,325,104.6
34030, 보령시,005003, 2세,2016,670,330,340,97.1,667,329,338,97.3
34030, 보령시,005004, 3세,2016,711,363,348,104.3,710,363,347,104.6
34030, 보령시,005005, 4세,2016,739,382,357,107,737,382,355,107.6
34030, 보령시,010,5~9세,2016,4091,2085,2006,103.9,4085,2082,2003,103.9
34030, 보령시,010001, 5세,2016,842,415,427,97.2,841,414,427,97
34030, 보령시,010002, 6세,2016,814,426,388,109.8,814,426,388,109.8
34030, 보령시,010003, 7세,2016,777,404,373,108.3,775,404,371,108.9
34030, 보령시,010004, 8세,2016,850,420,430,97.7,847,418,429,97.4
34030, 보령시,010005, 9세,2016,808,420,388,108.2,808,420,388,108.2
34030, 보령시,015,10~14세,2016,4223,2185,2038,107.2,4215,2182,2033,107.3
34030, 보령시,015001, 10세,2016,805,414,391,105.9,802,413,389,106.2
34030, 보령시,015002, 11세,2016,807,448,359,124.8,806,448,358,125.1
34030, 보령시,015003, 12세,2016,873,455,418,108.9,871,453,418,108.4
34030, 보령시,015004, 13세,2016,842,406,436,93.1,842,406,436,93.1
34030, 보령시,015005, 14세,2016,896,462,434,106.5,894,462,432,106.9
34030, 보령시,020,15~19세,2016,5065,2839,2226,127.5,5041,2819,2222,126.9
34030, 보령시,020001, 15세,2016,1045,550,495,111.1,1043,549,494,111.1
34030, 보령시,020002, 16세,2016,1004,503,501,100.4,1001,500,501,99.8
34030, 보령시,020003, 17세,2016,1016,532,484,109.9,1012,529,483,109.5
34030, 보령시,020004, 18세,2016,1093,645,448,144,1088,640,448,142.9
34030, 보령시,020005, 19세,2016,907,609,298,204.4,897,601,296,203
34030, 보령시,025,20~24세,2016,5252,3354,1898,176.7,4871,3055,1816,168.2
34030, 보령시,025001, 20세,2016,997,642,355,180.8,970,621,349,177.9
34030, 보령시,025002, 21세,2016,1078,673,405,166.2,1025,631,394,160.2
34030, 보령시,025003, 22세,2016,1136,740,396,186.9,1068,686,382,179.6
34030, 보령시,025004, 23세,2016,1050,683,367,186.1,958,611,347,176.1
34030, 보령시,025005, 24세,2016,991,616,375,164.3,850,506,344,147.1
34030, 보령시,030,25~29세,2016,4881,2892,1989,145.4,4213,2361,1852,127.5
34030, 보령시,030001, 25세,2016,980,580,400,145,863,495,368,134.5
34030, 보령시,030002, 26세,2016,964,559,405,138,827,441,386,114.2
34030, 보령시,030003, 27세,2016,983,603,380,158.7,842,487,355,137.2
34030, 보령시,030004, 28세,2016,947,562,385,146,809,457,352,129.8
34030, 보령시,030005, 29세,2016,1007,588,419,140.3,872,481,391,123
34030, 보령시,035,30~34세,2016,5525,3173,2352,134.9,4906,2685,2221,120.9
34030, 보령시,035001, 30세,2016,1000,596,404,147.5,854,485,369,131.4
34030, 보령시,035002, 31세,2016,989,569,420,135.5,853,461,392,117.6
34030, 보령시,035003, 32세,2016,1063,598,465,128.6,949,510,439,116.2
34030, 보령시,035004, 33세,2016,1196,697,499,139.7,1070,594,476,124.8
34030, 보령시,035005, 34세,2016,1277,713,564,126.4,1180,635,545,116.5
34030, 보령시,040,35~39세,2016,6500,3674,2826,130,6028,3292,2736,120.3
34030, 보령시,040001, 35세,2016,1270,712,558,127.6,1152,618,534,115.7
34030, 보령시,040002, 36세,2016,1398,786,612,128.4,1292,703,589,119.4
34030, 보령시,040003, 37세,2016,1301,718,583,123.2,1221,652,569,114.6
34030, 보령시,040004, 38세,2016,1226,702,524,134,1134,621,513,121.1
34030, 보령시,040005, 39세,2016,1305,756,549,137.7,1229,698,531,131.5
34030, 보령시,045,40~44세,2016,7361,4064,3297,123.3,6997,3776,3221,117.2
34030, 보령시,045001, 40세,2016,1303,710,593,119.7,1222,642,580,110.7
34030, 보령시,045002, 41세,2016,1386,761,625,121.8,1318,704,614,114.7
34030, 보령시,045003, 42세,2016,1570,878,692,126.9,1491,820,671,122.2
34030, 보령시,045004, 43세,2016,1592,881,711,123.9,1526,827,699,118.3
34030, 보령시,045005, 44세,2016,1510,834,676,123.4,1440,783,657,119.2
34030, 보령시,050,45~49세,2016,7922,4264,3658,116.6,7708,4126,3582,115.2
34030, 보령시,050001, 45세,2016,1602,882,720,122.5,1552,845,707,119.5
34030, 보령시,050002, 46세,2016,1526,827,699,118.3,1469,789,680,116
34030, 보령시,050003, 47세,2016,1579,841,738,114,1534,812,722,112.5
34030, 보령시,050004, 48세,2016,1708,918,790,116.2,1676,903,773,116.8
34030, 보령시,050005, 49세,2016,1507,796,711,112,1477,777,700,111
34030, 보령시,055,50~54세,2016,7863,4130,3733,110.6,7731,4062,3669,110.7
34030, 보령시,055001, 50세,2016,1374,772,602,128.2,1351,760,591,128.6
34030, 보령시,055002, 51세,2016,1590,817,773,105.7,1568,804,764,105.2
34030, 보령시,055003, 52세,2016,1632,863,769,112.2,1593,843,750,112.4
34030, 보령시,055004, 53세,2016,1509,768,741,103.6,1482,757,725,104.4
34030, 보령시,055005, 54세,2016,1758,910,848,107.3,1737,898,839,107
34030, 보령시,060,55~59세,2016,9220,4574,4646,98.5,9144,4537,4607,98.5
34030, 보령시,060001, 55세,2016,2063,1052,1011,104.1,2050,1045,1005,104
34030, 보령시,060002, 56세,2016,1972,971,1001,97,1952,965,987,97.8
34030, 보령시,060003, 57세,2016,1779,853,926,92.1,1766,849,917,92.6
34030, 보령시,060004, 58세,2016,1742,847,895,94.6,1724,836,888,94.1
34030, 보령시,060005, 59세,2016,1664,851,813,104.7,1652,842,810,104
34030, 보령시,065,60~64세,2016,7715,3737,3978,93.9,7662,3714,3948,94.1
34030, 보령시,065001, 60세,2016,1669,843,826,102.1,1657,836,821,101.8
34030, 보령시,065002, 61세,2016,1816,907,909,99.8,1801,904,897,100.8
34030, 보령시,065003, 62세,2016,1595,783,812,96.4,1588,779,809,96.3
34030, 보령시,065004, 63세,2016,1229,573,656,87.3,1218,567,651,87.1
34030, 보령시,065005, 64세,2016,1406,631,775,81.4,1398,628,770,81.6
34030, 보령시,070,65~69세,2016,6603,3157,3446,91.6,6574,3144,3430,91.7
34030, 보령시,070001, 65세,2016,1249,625,624,100.2,1244,622,622,100
34030, 보령시,070002, 66세,2016,1368,651,717,90.8,1360,647,713,90.7
34030, 보령시,070003, 67세,2016,1423,690,733,94.1,1415,686,729,94.1
34030, 보령시,070004, 68세,2016,1294,618,676,91.4,1291,617,674,91.5
34030, 보령시,070005, 69세,2016,1269,573,696,82.3,1264,572,692,82.7
34030, 보령시,075,70~74세,2016,5285,2376,2909,81.7,5272,2367,2905,81.5
34030, 보령시,075001, 70세,2016,901,444,457,97.2,896,440,456,96.5
34030, 보령시,075002, 71세,2016,963,429,534,80.3,960,426,534,79.8
34030, 보령시,075003, 72세,2016,1062,474,588,80.6,1060,473,587,80.6
34030, 보령시,075004, 73세,2016,1080,507,573,88.5,1078,506,572,88.5
34030, 보령시,075005, 74세,2016,1279,522,757,69,1278,522,756,69
34030, 보령시,080,75~79세,2016,4864,2007,2857,70.2,4854,2000,2854,70.1
34030, 보령시,080001, 75세,2016,1029,425,604,70.4,1027,424,603,70.3
34030, 보령시,080002, 76세,2016,937,399,538,74.2,937,399,538,74.2
34030, 보령시,080003, 77세,2016,1030,433,597,72.5,1026,430,596,72.1
34030, 보령시,080004, 78세,2016,1003,381,622,61.3,1001,379,622,60.9
34030, 보령시,080005, 79세,2016,865,369,496,74.4,863,368,495,74.3
34030, 보령시,085,80~84세,2016,3361,1204,2157,55.8,3359,1203,2156,55.8
34030, 보령시,085001, 80세,2016,826,306,520,58.8,825,306,519,59
34030, 보령시,085002, 81세,2016,807,285,522,54.6,806,284,522,54.4
34030, 보령시,085003, 82세,2016,648,232,416,55.8,648,232,416,55.8
34030, 보령시,085004, 83세,2016,556,220,336,65.5,556,220,336,65.5
34030, 보령시,085005, 84세,2016,524,161,363,44.4,524,161,363,44.4
34030, 보령시,090,85~89세,2016,1453,420,1033,40.7,1452,420,1032,40.7
34030, 보령시,090001, 85세,2016,375,128,247,51.8,374,128,246,52
34030, 보령시,090002, 86세,2016,346,96,250,38.4,346,96,250,38.4
34030, 보령시,090003, 87세,2016,318,83,235,35.3,318,83,235,35.3
34030, 보령시,090004, 88세,2016,230,59,171,34.5,230,59,171,34.5
34030, 보령시,090005, 89세,2016,184,54,130,41.5,184,54,130,41.5
34030, 보령시,095,90~94세,2016,457,100,357,28,456,100,356,28.1
34030, 보령시,095001, 90세,2016,146,35,111,31.5,145,35,110,31.8
34030, 보령시,095002, 91세,2016,97,20,77,26,97,20,77,26
34030, 보령시,095003, 92세,2016,80,19,61,31.1,80,19,61,31.1
34030, 보령시,095004, 93세,2016,82,17,65,26.2,82,17,65,26.2
34030, 보령시,095005, 94세,2016,52,9,43,20.9,52,9,43,20.9
34030, 보령시,100,95~99세,2016,101,15,86,17.4,101,15,86,17.4
34030, 보령시,100001, 95세,2016,37,X,33,12.1,37,X,33,12.1
34030, 보령시,100002, 96세,2016,27,X,23,17.4,27,X,23,17.4
34030, 보령시,100003, 97세,2016,19,X,16,18.8,19,X,16,18.8
34030, 보령시,100004, 98세,2016,11,X,9,22.2,11,X,9,22.2
34030, 보령시,100005, 99세,2016,7,X,5,40,7,X,5,40
34030, 보령시,101,100세이상,2016,12,X,11,9.1,12,X,11,9.1
34030, 보령시,102,15세미만,2016,11721,5995,5726,104.7,11696,5986,5710,104.8
34030, 보령시,103,15~64세,2016,67304,36701,30603,119.9,64301,34427,29874,115.2
34030, 보령시,104,65세이상,2016,22136,9280,12856,72.2,22080,9250,12830,72.1
34030, 보령시,086,85세이상,2016,2023,536,1487,36,2021,536,1485,36.1
34030, 보령시,126,평균연령,2016,45.8,43.6,48.1,,46.1,44.1,48.2,
34030, 보령시,127,중위연령,2016,47.7,45,51,,48.4,46,51.3,
34040, 아산시,000,합계,2016,328287,171258,157029,109.1,308555,158733,149822,105.9
34040, 아산시,005,0~4세,2016,19599,10088,9511,106.1,19248,9915,9333,106.2
34040, 아산시,005001, 0세,2016,3644,1841,1803,102.1,3552,1797,1755,102.4
34040, 아산시,005002, 1세,2016,3866,1990,1876,106.1,3797,1963,1834,107
34040, 아산시,005003, 2세,2016,3803,1983,1820,109,3742,1952,1790,109.1
34040, 아산시,005004, 3세,2016,3977,2044,1933,105.7,3923,2018,1905,105.9
34040, 아산시,005005, 4세,2016,4309,2230,2079,107.3,4234,2185,2049,106.6
34040, 아산시,010,5~9세,2016,19182,9904,9278,106.7,18975,9804,9171,106.9
34040, 아산시,010001, 5세,2016,4219,2161,2058,105,4158,2135,2023,105.5
34040, 아산시,010002, 6세,2016,3875,2058,1817,113.3,3838,2039,1799,113.3
34040, 아산시,010003, 7세,2016,3692,1898,1794,105.8,3651,1878,1773,105.9
34040, 아산시,010004, 8세,2016,3762,1890,1872,101,3727,1870,1857,100.7
34040, 아산시,010005, 9세,2016,3634,1897,1737,109.2,3601,1882,1719,109.5
34040, 아산시,015,10~14세,2016,15905,8156,7749,105.3,15805,8104,7701,105.2
34040, 아산시,015001, 10세,2016,3294,1676,1618,103.6,3269,1661,1608,103.3
34040, 아산시,015002, 11세,2016,3081,1621,1460,111,3059,1609,1450,111
34040, 아산시,015003, 12세,2016,3253,1630,1623,100.4,3230,1618,1612,100.4
34040, 아산시,015004, 13세,2016,3196,1669,1527,109.3,3176,1659,1517,109.4
34040, 아산시,015005, 14세,2016,3081,1560,1521,102.6,3071,1557,1514,102.8
34040, 아산시,020,15~19세,2016,21190,10804,10386,104,20860,10676,10184,104.8
34040, 아산시,020001, 15세,2016,3415,1780,1635,108.9,3395,1773,1622,109.3
34040, 아산시,020002, 16세,2016,3908,1933,1975,97.9,3877,1920,1957,98.1
34040, 아산시,020003, 17세,2016,3601,1774,1827,97.1,3574,1765,1809,97.6
34040, 아산시,020004, 18세,2016,4362,2228,2134,104.4,4310,2206,2104,104.8
34040, 아산시,020005, 19세,2016,5904,3089,2815,109.7,5704,3012,2692,111.9
34040, 아산시,025,20~24세,2016,24905,12875,12030,107,22505,11519,10986,104.9
34040, 아산시,025001, 20세,2016,5155,2439,2716,89.8,4728,2260,2468,91.6
34040, 아산시,025002, 21세,2016,4741,2282,2459,92.8,4240,2065,2175,94.9
34040, 아산시,025003, 22세,2016,4984,2656,2328,114.1,4511,2398,2113,113.5
34040, 아산시,025004, 23세,2016,5053,2761,2292,120.5,4559,2415,2144,112.6
34040, 아산시,025005, 24세,2016,4972,2737,2235,122.5,4467,2381,2086,114.1
34040, 아산시,030,25~29세,2016,23282,12919,10363,124.7,19833,10495,9338,112.4
34040, 아산시,030001, 25세,2016,4316,2408,1908,126.2,3776,2031,1745,116.4
34040, 아산시,030002, 26세,2016,4485,2449,2036,120.3,3790,1959,1831,107
34040, 아산시,030003, 27세,2016,4667,2600,2067,125.8,3945,2079,1866,111.4
34040, 아산시,030004, 28세,2016,4811,2653,2158,122.9,4059,2121,1938,109.4
34040, 아산시,030005, 29세,2016,5003,2809,2194,128,4263,2305,1958,117.7
34040, 아산시,035,30~34세,2016,29136,16182,12954,124.9,25672,13706,11966,114.5
34040, 아산시,035001, 30세,2016,5134,2818,2316,121.7,4384,2279,2105,108.3
34040, 아산시,035002, 31세,2016,5242,3006,2236,134.4,4507,2491,2016,123.6
34040, 아산시,035003, 32세,2016,5549,3037,2512,120.9,4902,2579,2323,111
34040, 아산시,035004, 33세,2016,6171,3403,2768,122.9,5483,2908,2575,112.9
34040, 아산시,035005, 34세,2016,7040,3918,3122,125.5,6396,3449,2947,117
34040, 아산시,040,35~39세,2016,31805,17771,14034,126.6,29265,15966,13299,120.1
34040, 아산시,040001, 35세,2016,6809,3831,2978,128.6,6244,3412,2832,120.5
34040, 아산시,040002, 36세,2016,6920,3803,3117,122,6393,3429,2964,115.7
34040, 아산시,040003, 37세,2016,6494,3643,2851,127.8,5954,3264,2690,121.3
34040, 아산시,040004, 38세,2016,5790,3246,2544,127.6,5309,2915,2394,121.8
34040, 아산시,040005, 39세,2016,5792,3248,2544,127.7,5365,2946,2419,121.8
34040, 아산시,045,40~44세,2016,27573,15201,12372,122.9,25660,13937,11723,118.9
34040, 아산시,045001, 40세,2016,5535,3002,2533,118.5,5112,2706,2406,112.5
34040, 아산시,045002, 41세,2016,5364,2906,2458,118.2,4997,2651,2346,113
34040, 아산시,045003, 42세,2016,5748,3182,2566,124,5377,2932,2445,119.9
34040, 아산시,045004, 43세,2016,5557,3045,2512,121.2,5221,2844,2377,119.6
34040, 아산시,045005, 44세,2016,5369,3066,2303,133.1,4953,2804,2149,130.5
34040, 아산시,050,45~49세,2016,26185,14318,11867,120.7,24430,13268,11162,118.9
34040, 아산시,050001, 45세,2016,5885,3296,2589,127.3,5469,3035,2434,124.7
34040, 아산시,050002, 46세,2016,5306,2984,2322,128.5,4902,2734,2168,126.1
34040, 아산시,050003, 47세,2016,5423,2951,2472,119.4,5074,2747,2327,118
34040, 아산시,050004, 48세,2016,5036,2638,2398,110,4705,2447,2258,108.4
34040, 아산시,050005, 49세,2016,4535,2449,2086,117.4,4280,2305,1975,116.7
34040, 아산시,055,50~54세,2016,21413,11676,9737,119.9,20018,10915,9103,119.9
34040, 아산시,055001, 50세,2016,4304,2366,1938,122.1,4014,2209,1805,122.4
34040, 아산시,055002, 51세,2016,4604,2504,2100,119.2,4283,2322,1961,118.4
34040, 아산시,055003, 52세,2016,4007,2181,1826,119.4,3747,2030,1717,118.2
34040, 아산시,055004, 53세,2016,4152,2265,1887,120,3842,2110,1732,121.8
34040, 아산시,055005, 54세,2016,4346,2360,1986,118.8,4132,2244,1888,118.9
34040, 아산시,060,55~59세,2016,19661,10213,9448,108.1,18814,9758,9056,107.8
34040, 아산시,060001, 55세,2016,4634,2493,2141,116.4,4483,2416,2067,116.9
34040, 아산시,060002, 56세,2016,4518,2370,2148,110.3,4292,2250,2042,110.2
34040, 아산시,060003, 57세,2016,3719,1889,1830,103.2,3562,1815,1747,103.9
34040, 아산시,060004, 58세,2016,3373,1727,1646,104.9,3215,1638,1577,103.9
34040, 아산시,060005, 59세,2016,3417,1734,1683,103,3262,1639,1623,101
34040, 아산시,065,60~64세,2016,13924,6855,7069,97,13358,6567,6791,96.7
34040, 아산시,065001, 60세,2016,3128,1567,1561,100.4,2997,1495,1502,99.5
34040, 아산시,065002, 61세,2016,3285,1645,1640,100.3,3160,1581,1579,100.1
34040, 아산시,065003, 62세,2016,2718,1345,1373,98,2587,1273,1314,96.9
34040, 아산시,065004, 63세,2016,2258,1114,1144,97.4,2172,1068,1104,96.7
34040, 아산시,065005, 64세,2016,2535,1184,1351,87.6,2442,1150,1292,89
34040, 아산시,070,65~69세,2016,10291,4899,5392,90.9,10073,4780,5293,90.3
34040, 아산시,070001, 65세,2016,1880,902,978,92.2,1812,863,949,90.9
34040, 아산시,070002, 66세,2016,2168,1009,1159,87.1,2121,986,1135,86.9
34040, 아산시,070003, 67세,2016,2121,1018,1103,92.3,2070,989,1081,91.5
34040, 아산시,070004, 68세,2016,2098,1006,1092,92.1,2070,992,1078,92
34040, 아산시,070005, 69세,2016,2024,964,1060,90.9,2000,950,1050,90.5
34040, 아산시,075,70~74세,2016,8396,3675,4721,77.8,8315,3640,4675,77.9
34040, 아산시,075001, 70세,2016,1517,692,825,83.9,1499,683,816,83.7
34040, 아산시,075002, 71세,2016,1530,674,856,78.7,1508,664,844,78.7
34040, 아산시,075003, 72세,2016,1635,724,911,79.5,1616,718,898,80
34040, 아산시,075004, 73세,2016,1689,727,962,75.6,1676,721,955,75.5
34040, 아산시,075005, 74세,2016,2025,858,1167,73.5,2016,854,1162,73.5
34040, 아산시,080,75~79세,2016,7543,3043,4500,67.6,7478,3023,4455,67.9
34040, 아산시,080001, 75세,2016,1583,682,901,75.7,1565,676,889,76
34040, 아산시,080002, 76세,2016,1447,577,870,66.3,1436,572,864,66.2
34040, 아산시,080003, 77세,2016,1608,646,962,67.2,1596,642,954,67.3
34040, 아산시,080004, 78세,2016,1465,594,871,68.2,1450,592,858,69
34040, 아산시,080005, 79세,2016,1440,544,896,60.7,1431,541,890,60.8
34040, 아산시,085,80~84세,2016,5261,1897,3364,56.4,5230,1887,3343,56.4
34040, 아산시,085001, 80세,2016,1319,523,796,65.7,1310,522,788,66.2
34040, 아산시,085002, 81세,2016,1210,442,768,57.6,1200,439,761,57.7
34040, 아산시,085003, 82세,2016,1015,350,665,52.6,1007,345,662,52.1
34040, 아산시,085004, 83세,2016,892,289,603,47.9,890,289,601,48.1
34040, 아산시,085005, 84세,2016,825,293,532,55.1,823,292,531,55
34040, 아산시,090,85~89세,2016,2153,586,1567,37.4,2144,581,1563,37.2
34040, 아산시,090001, 85세,2016,581,168,413,40.7,577,166,411,40.4
34040, 아산시,090002, 86세,2016,517,137,380,36.1,516,137,379,36.1
34040, 아산시,090003, 87세,2016,419,125,294,42.5,417,124,293,42.3
34040, 아산시,090004, 88세,2016,369,93,276,33.7,368,92,276,33.3
34040, 아산시,090005, 89세,2016,267,63,204,30.9,266,62,204,30.4
34040, 아산시,095,90~94세,2016,681,160,521,30.7,677,160,517,30.9
34040, 아산시,095001, 90세,2016,190,43,147,29.3,190,43,147,29.3
34040, 아산시,095002, 91세,2016,161,37,124,29.8,160,37,123,30.1
34040, 아산시,095003, 92세,2016,128,29,99,29.3,128,29,99,29.3
34040, 아산시,095004, 93세,2016,106,27,79,34.2,105,27,78,34.6
34040, 아산시,095005, 94세,2016,96,24,72,33.3,94,24,70,34.3
34040, 아산시,100,95~99세,2016,187,36,151,23.8,181,32,149,21.5
34040, 아산시,100001, 95세,2016,72,12,60,20,68,10,58,17.2
34040, 아산시,100002, 96세,2016,45,13,32,40.6,44,12,32,37.5
34040, 아산시,100003, 97세,2016,30,5,25,20,30,5,25,20
34040, 아산시,100004, 98세,2016,28,6,22,27.3,27,5,22,22.7
34040, 아산시,100005, 99세,2016,12,X,12,0,12,X,12,0
34040, 아산시,101,100세이상,2016,15,X,15,0,14,X,14,0
34040, 아산시,102,15세미만,2016,54686,28148,26538,106.1,54028,27823,26205,106.2
34040, 아산시,103,15~64세,2016,239074,128814,110260,116.8,220415,116807,103608,112.7
34040, 아산시,104,65세이상,2016,34527,14296,20231,70.7,34112,14103,20009,70.5
34040, 아산시,086,85세이상,2016,3036,782,2254,34.7,3016,773,2243,34.5
34040, 아산시,126,평균연령,2016,37.3,36.4,38.2,,37.3,36.5,38.2,
34040, 아산시,127,중위연령,2016,36.6,36.2,37.1,,36.8,36.5,37.2,
34050, 서산시,000,합계,2016,169643,87634,82009,106.9,164510,84725,79785,106.2
34050, 서산시,005,0~4세,2016,8469,4358,4111,106,8375,4315,4060,106.3
34050, 서산시,005001, 0세,2016,1599,827,772,107.1,1581,821,760,108
34050, 서산시,005002, 1세,2016,1676,864,812,106.4,1651,852,799,106.6
34050, 서산시,005003, 2세,2016,1689,887,802,110.6,1667,878,789,111.3
34050, 서산시,005004, 3세,2016,1688,835,853,97.9,1670,827,843,98.1
34050, 서산시,005005, 4세,2016,1817,945,872,108.4,1806,937,869,107.8
34050, 서산시,010,5~9세,2016,8697,4574,4123,110.9,8652,4552,4100,111
34050, 서산시,010001, 5세,2016,1745,919,826,111.3,1735,915,820,111.6
34050, 서산시,010002, 6세,2016,1743,895,848,105.5,1730,891,839,106.2
34050, 서산시,010003, 7세,2016,1641,879,762,115.4,1634,873,761,114.7
34050, 서산시,010004, 8세,2016,1734,926,808,114.6,1729,924,805,114.8
34050, 서산시,010005, 9세,2016,1834,955,879,108.6,1824,949,875,108.5
34050, 서산시,015,10~14세,2016,8337,4407,3930,112.1,8307,4395,3912,112.3
34050, 서산시,015001, 10세,2016,1620,817,803,101.7,1614,816,798,102.3
34050, 서산시,015002, 11세,2016,1506,789,717,110,1497,784,713,110
34050, 서산시,015003, 12세,2016,1736,938,798,117.5,1727,935,792,118.1
34050, 서산시,015004, 13세,2016,1682,879,803,109.5,1679,876,803,109.1
34050, 서산시,015005, 14세,2016,1793,984,809,121.6,1790,984,806,122.1
34050, 서산시,020,15~19세,2016,9674,5103,4571,111.6,9553,5051,4502,112.2
34050, 서산시,020001, 15세,2016,2072,1070,1002,106.8,2068,1069,999,107
34050, 서산시,020002, 16세,2016,2052,1063,989,107.5,2048,1061,987,107.5
34050, 서산시,020003, 17세,2016,1932,1025,907,113,1921,1018,903,112.7
34050, 서산시,020004, 18세,2016,1907,1029,878,117.2,1881,1014,867,117
34050, 서산시,020005, 19세,2016,1711,916,795,115.2,1635,889,746,119.2
34050, 서산시,025,20~24세,2016,9212,5268,3944,133.6,8517,4927,3590,137.2
34050, 서산시,025001, 20세,2016,1855,1021,834,122.4,1722,979,743,131.8
34050, 서산시,025002, 21세,2016,1803,1070,733,146,1644,994,650,152.9
34050, 서산시,025003, 22세,2016,1816,1035,781,132.5,1660,951,709,134.1
34050, 서산시,025004, 23세,2016,1816,1035,781,132.5,1699,969,730,132.7
34050, 서산시,025005, 24세,2016,1922,1107,815,135.8,1792,1034,758,136.4
34050, 서산시,030,25~29세,2016,9564,5645,3919,144,8823,5224,3599,145.2
34050, 서산시,030001, 25세,2016,1804,1048,756,138.6,1669,973,696,139.8
34050, 서산시,030002, 26세,2016,1894,1123,771,145.7,1746,1038,708,146.6
34050, 서산시,030003, 27세,2016,1961,1177,784,150.1,1811,1091,720,151.5
34050, 서산시,030004, 28세,2016,1945,1149,796,144.3,1800,1065,735,144.9
34050, 서산시,030005, 29세,2016,1960,1148,812,141.4,1797,1057,740,142.8
34050, 서산시,035,30~34세,2016,11312,6226,5086,122.4,10559,5785,4774,121.2
34050, 서산시,035001, 30세,2016,2001,1132,869,130.3,1845,1050,795,132.1
34050, 서산시,035002, 31세,2016,2014,1126,888,126.8,1860,1037,823,126
34050, 서산시,035003, 32세,2016,2206,1205,1001,120.4,2049,1116,933,119.6
34050, 서산시,035004, 33세,2016,2432,1298,1134,114.5,2280,1207,1073,112.5
34050, 서산시,035005, 34세,2016,2659,1465,1194,122.7,2525,1375,1150,119.6
34050, 서산시,040,35~39세,2016,13315,7077,6238,113.4,12693,6657,6036,110.3
34050, 서산시,040001, 35세,2016,2680,1459,1221,119.5,2544,1369,1175,116.5
34050, 서산시,040002, 36세,2016,2812,1479,1333,111,2665,1382,1283,107.7
34050, 서산시,040003, 37세,2016,2648,1400,1248,112.2,2521,1312,1209,108.5
34050, 서산시,040004, 38세,2016,2593,1391,1202,115.7,2483,1318,1165,113.1
34050, 서산시,040005, 39세,2016,2582,1348,1234,109.2,2480,1276,1204,106
34050, 서산시,045,40~44세,2016,13700,7310,6390,114.4,13213,6993,6220,112.4
34050, 서산시,045001, 40세,2016,2525,1349,1176,114.7,2427,1283,1144,112.2
34050, 서산시,045002, 41세,2016,2601,1322,1279,103.4,2510,1262,1248,101.1
34050, 서산시,045003, 42세,2016,2874,1574,1300,121.1,2767,1500,1267,118.4
34050, 서산시,045004, 43세,2016,2958,1580,1378,114.7,2863,1524,1339,113.8
34050, 서산시,045005, 44세,2016,2742,1485,1257,118.1,2646,1424,1222,116.5
34050, 서산시,050,45~49세,2016,14432,7733,6699,115.4,13954,7460,6494,114.9
34050, 서산시,050001, 45세,2016,3071,1684,1387,121.4,2968,1619,1349,120
34050, 서산시,050002, 46세,2016,2787,1491,1296,115,2674,1427,1247,114.4
34050, 서산시,050003, 47세,2016,3018,1622,1396,116.2,2922,1566,1356,115.5
34050, 서산시,050004, 48세,2016,2902,1505,1397,107.7,2825,1461,1364,107.1
34050, 서산시,050005, 49세,2016,2654,1431,1223,117,2565,1387,1178,117.7
34050, 서산시,055,50~54세,2016,12989,7003,5986,117,12588,6780,5808,116.7
34050, 서산시,055001, 50세,2016,2510,1349,1161,116.2,2429,1302,1127,115.5
34050, 서산시,055002, 51세,2016,2813,1532,1281,119.6,2723,1483,1240,119.6
34050, 서산시,055003, 52세,2016,2415,1305,1110,117.6,2337,1261,1076,117.2
34050, 서산시,055004, 53세,2016,2532,1365,1167,117,2442,1314,1128,116.5
34050, 서산시,055005, 54세,2016,2719,1452,1267,114.6,2657,1420,1237,114.8
34050, 서산시,060,55~59세,2016,13032,6667,6365,104.7,12755,6512,6243,104.3
34050, 서산시,060001, 55세,2016,3053,1592,1461,109,3002,1566,1436,109.1
34050, 서산시,060002, 56세,2016,2967,1499,1468,102.1,2898,1458,1440,101.3
34050, 서산시,060003, 57세,2016,2481,1269,1212,104.7,2421,1229,1192,103.1
34050, 서산시,060004, 58세,2016,2300,1181,1119,105.5,2244,1155,1089,106.1
34050, 서산시,060005, 59세,2016,2231,1126,1105,101.9,2190,1104,1086,101.7
34050, 서산시,065,60~64세,2016,9470,4686,4784,98,9257,4577,4680,97.8
34050, 서산시,065001, 60세,2016,2125,1068,1057,101,2085,1043,1042,100.1
34050, 서산시,065002, 61세,2016,2110,1031,1079,95.6,2062,1011,1051,96.2
34050, 서산시,065003, 62세,2016,1866,903,963,93.8,1814,879,935,94
34050, 서산시,065004, 63세,2016,1528,772,756,102.1,1491,753,738,102
34050, 서산시,065005, 64세,2016,1841,912,929,98.2,1805,891,914,97.5
34050, 서산시,070,65~69세,2016,7946,3924,4022,97.6,7847,3878,3969,97.7
34050, 서산시,070001, 65세,2016,1465,728,737,98.8,1445,714,731,97.7
34050, 서산시,070002, 66세,2016,1701,834,867,96.2,1678,825,853,96.7
34050, 서산시,070003, 67세,2016,1748,895,853,104.9,1726,886,840,105.5
34050, 서산시,070004, 68세,2016,1592,796,796,100,1575,791,784,100.9
34050, 서산시,070005, 69세,2016,1440,671,769,87.3,1423,662,761,87
34050, 서산시,075,70~74세,2016,6581,3034,3547,85.5,6534,3012,3522,85.5
34050, 서산시,075001, 70세,2016,1205,608,597,101.8,1191,599,592,101.2
34050, 서산시,075002, 71세,2016,1084,523,561,93.2,1078,519,559,92.8
34050, 서산시,075003, 72세,2016,1230,551,679,81.1,1222,547,675,81
34050, 서산시,075004, 73세,2016,1296,624,672,92.9,1284,620,664,93.4
34050, 서산시,075005, 74세,2016,1766,728,1038,70.1,1759,727,1032,70.4
34050, 서산시,080,75~79세,2016,5740,2371,3369,70.4,5723,2365,3358,70.4
34050, 서산시,080001, 75세,2016,1159,488,671,72.7,1157,487,670,72.7
34050, 서산시,080002, 76세,2016,1083,461,622,74.1,1077,457,620,73.7
34050, 서산시,080003, 77세,2016,1204,501,703,71.3,1204,501,703,71.3
34050, 서산시,080004, 78세,2016,1217,498,719,69.3,1210,497,713,69.7
34050, 서산시,080005, 79세,2016,1077,423,654,64.7,1075,423,652,64.9
34050, 서산시,085,80~84세,2016,4487,1590,2897,54.9,4479,1587,2892,54.9
34050, 서산시,085001, 80세,2016,1055,396,659,60.1,1053,395,658,60
34050, 서산시,085002, 81세,2016,1061,379,682,55.6,1058,378,680,55.6
34050, 서산시,085003, 82세,2016,856,308,548,56.2,855,308,547,56.3
34050, 서산시,085004, 83세,2016,778,265,513,51.7,777,264,513,51.5
34050, 서산시,085005, 84세,2016,737,242,495,48.9,736,242,494,49
34050, 서산시,090,85~89세,2016,1845,490,1355,36.2,1842,489,1353,36.1
34050, 서산시,090001, 85세,2016,482,134,348,38.5,482,134,348,38.5
34050, 서산시,090002, 86세,2016,405,109,296,36.8,405,109,296,36.8
34050, 서산시,090003, 87세,2016,400,113,287,39.4,400,113,287,39.4
34050, 서산시,090004, 88세,2016,309,65,244,26.6,308,65,243,26.7
34050, 서산시,090005, 89세,2016,249,69,180,38.3,247,68,179,38
34050, 서산시,095,90~94세,2016,689,143,546,26.2,687,141,546,25.8
34050, 서산시,095001, 90세,2016,193,38,155,24.5,192,37,155,23.9
34050, 서산시,095002, 91세,2016,172,41,131,31.3,172,41,131,31.3
34050, 서산시,095003, 92세,2016,133,30,103,29.1,132,29,103,28.2
34050, 서산시,095004, 93세,2016,103,20,83,24.1,103,20,83,24.1
34050, 서산시,095005, 94세,2016,88,14,74,18.9,88,14,74,18.9
34050, 서산시,100,95~99세,2016,127,24,103,23.3,127,24,103,23.3
34050, 서산시,100001, 95세,2016,41,7,34,20.6,41,7,34,20.6
34050, 서산시,100002, 96세,2016,23,5,18,27.8,23,5,18,27.8
34050, 서산시,100003, 97세,2016,32,6,26,23.1,32,6,26,23.1
34050, 서산시,100004, 98세,2016,19,X,15,26.7,19,X,15,26.7
34050, 서산시,100005, 99세,2016,12,X,10,20,12,X,10,20
34050, 서산시,101,100세이상,2016,25,X,24,4.2,25,X,24,4.2
34050, 서산시,102,15세미만,2016,25503,13339,12164,109.7,25334,13262,12072,109.9
34050, 서산시,103,15~64세,2016,116700,62718,53982,116.2,111912,59966,51946,115.4
34050, 서산시,104,65세이상,2016,27440,11577,15863,73,27264,11497,15767,72.9
34050, 서산시,086,85세이상,2016,2686,658,2028,32.4,2681,655,2026,32.3
34050, 서산시,126,평균연령,2016,41.6,40.1,43.2,,41.7,40.1,43.4,
34050, 서산시,127,중위연령,2016,42.4,40.9,44,,42.7,41.1,44.3,
34060, 논산시,000,합계,2016,124202,62317,61885,100.7,119605,59850,59755,100.2
34060, 논산시,005,0~4세,2016,4000,2006,1994,100.6,3970,1988,1982,100.3
34060, 논산시,005001, 0세,2016,720,369,351,105.1,714,365,349,104.6
34060, 논산시,005002, 1세,2016,808,392,416,94.2,797,386,411,93.9
34060, 논산시,005003, 2세,2016,766,384,382,100.5,760,380,380,100
34060, 논산시,005004, 3세,2016,818,408,410,99.5,815,406,409,99.3
34060, 논산시,005005, 4세,2016,888,453,435,104.1,884,451,433,104.2
34060, 논산시,010,5~9세,2016,4675,2429,2246,108.1,4659,2418,2241,107.9
34060, 논산시,010001, 5세,2016,892,465,427,108.9,887,463,424,109.2
34060, 논산시,010002, 6세,2016,885,463,422,109.7,881,459,422,108.8
34060, 논산시,010003, 7세,2016,884,444,440,100.9,883,443,440,100.7
34060, 논산시,010004, 8세,2016,1011,506,505,100.2,1008,504,504,100
34060, 논산시,010005, 9세,2016,1003,551,452,121.9,1000,549,451,121.7
34060, 논산시,015,10~14세,2016,4930,2495,2435,102.5,4921,2492,2429,102.6
34060, 논산시,015001, 10세,2016,947,469,478,98.1,946,469,477,98.3
34060, 논산시,015002, 11세,2016,925,474,451,105.1,923,473,450,105.1
34060, 논산시,015003, 12세,2016,1017,500,517,96.7,1013,498,515,96.7
34060, 논산시,015004, 13세,2016,971,482,489,98.6,970,482,488,98.8
34060, 논산시,015005, 14세,2016,1070,570,500,114,1069,570,499,114.2
34060, 논산시,020,15~19세,2016,8429,4584,3845,119.2,8366,4556,3810,119.6
34060, 논산시,020001, 15세,2016,1348,749,599,125,1343,749,594,126.1
34060, 논산시,020002, 16세,2016,1758,1032,726,142.1,1756,1032,724,142.5
34060, 논산시,020003, 17세,2016,1675,928,747,124.2,1669,924,745,124
34060, 논산시,020004, 18세,2016,1771,950,821,115.7,1759,940,819,114.8
34060, 논산시,020005, 19세,2016,1877,925,952,97.2,1839,911,928,98.2
34060, 논산시,025,20~24세,2016,8654,4599,4055,113.4,7608,4150,3458,120
34060, 논산시,025001, 20세,2016,1756,867,889,97.5,1645,826,819,100.9
34060, 논산시,025002, 21세,2016,1794,937,857,109.3,1599,865,734,117.8
34060, 논산시,025003, 22세,2016,1806,954,852,112,1577,849,728,116.6
34060, 논산시,025004, 23세,2016,1644,921,723,127.4,1401,812,589,137.9
34060, 논산시,025005, 24세,2016,1654,920,734,125.3,1386,798,588,135.7
34060, 논산시,030,25~29세,2016,6505,3725,2780,134,5422,3147,2275,138.3
34060, 논산시,030001, 25세,2016,1424,813,611,133.1,1190,695,495,140.4
34060, 논산시,030002, 26세,2016,1360,799,561,142.4,1129,689,440,156.6
34060, 논산시,030003, 27세,2016,1284,735,549,133.9,1076,619,457,135.4
34060, 논산시,030004, 28세,2016,1256,712,544,130.9,1040,588,452,130.1
34060, 논산시,030005, 29세,2016,1181,666,515,129.3,987,556,431,129
34060, 논산시,035,30~34세,2016,6437,3465,2972,116.6,5628,3009,2619,114.9
34060, 논산시,035001, 30세,2016,1218,643,575,111.8,1039,545,494,110.3
34060, 논산시,035002, 31세,2016,1148,609,539,113,993,523,470,111.3
34060, 논산시,035003, 32세,2016,1250,663,587,112.9,1086,565,521,108.4
34060, 논산시,035004, 33세,2016,1374,760,614,123.8,1237,684,553,123.7
34060, 논산시,035005, 34세,2016,1447,790,657,120.2,1273,692,581,119.1
34060, 논산시,040,35~39세,2016,6996,3686,3310,111.4,6522,3387,3135,108
34060, 논산시,040001, 35세,2016,1452,770,682,112.9,1350,708,642,110.3
34060, 논산시,040002, 36세,2016,1441,753,688,109.4,1322,677,645,105
34060, 논산시,040003, 37세,2016,1389,733,656,111.7,1293,670,623,107.5
34060, 논산시,040004, 38세,2016,1290,699,591,118.3,1198,640,558,114.7
34060, 논산시,040005, 39세,2016,1424,731,693,105.5,1359,692,667,103.7
34060, 논산시,045,40~44세,2016,8011,4340,3671,118.2,7721,4157,3564,116.6
34060, 논산시,045001, 40세,2016,1366,742,624,118.9,1301,708,593,119.4
34060, 논산시,045002, 41세,2016,1559,836,723,115.6,1491,791,700,113
34060, 논산시,045003, 42세,2016,1690,959,731,131.2,1641,920,721,127.6
34060, 논산시,045004, 43세,2016,1706,891,815,109.3,1646,857,789,108.6
34060, 논산시,045005, 44세,2016,1690,912,778,117.2,1642,881,761,115.8
34060, 논산시,050,45~49세,2016,9070,4866,4204,115.7,8838,4726,4112,114.9
34060, 논산시,050001, 45세,2016,1887,989,898,110.1,1831,957,874,109.5
34060, 논산시,050002, 46세,2016,1716,969,747,129.7,1661,936,725,129.1
34060, 논산시,050003, 47세,2016,1849,983,866,113.5,1808,959,849,113
34060, 논산시,050004, 48세,2016,1829,976,853,114.4,1791,951,840,113.2
34060, 논산시,050005, 49세,2016,1789,949,840,113,1747,923,824,112
34060, 논산시,055,50~54세,2016,9244,4815,4429,108.7,9027,4690,4337,108.1
34060, 논산시,055001, 50세,2016,1612,852,760,112.1,1576,836,740,113
34060, 논산시,055002, 51세,2016,1898,936,962,97.3,1858,911,947,96.2
34060, 논산시,055003, 52세,2016,1835,980,855,114.6,1785,951,834,114
34060, 논산시,055004, 53세,2016,1867,1000,867,115.3,1813,968,845,114.6
34060, 논산시,055005, 54세,2016,2032,1047,985,106.3,1995,1024,971,105.5
34060, 논산시,060,55~59세,2016,10903,5544,5359,103.5,10747,5460,5287,103.3
34060, 논산시,060001, 55세,2016,2330,1175,1155,101.7,2297,1158,1139,101.7
34060, 논산시,060002, 56세,2016,2343,1164,1179,98.7,2307,1146,1161,98.7
34060, 논산시,060003, 57세,2016,2148,1089,1059,102.8,2122,1074,1048,102.5
34060, 논산시,060004, 58세,2016,2080,1063,1017,104.5,2048,1046,1002,104.4
34060, 논산시,060005, 59세,2016,2002,1053,949,111,1973,1036,937,110.6
34060, 논산시,065,60~64세,2016,9101,4555,4546,100.2,8992,4493,4499,99.9
34060, 논산시,065001, 60세,2016,2013,1014,999,101.5,1978,998,980,101.8
34060, 논산시,065002, 61세,2016,2078,1098,980,112,2052,1083,969,111.8
34060, 논산시,065003, 62세,2016,1909,926,983,94.2,1887,909,978,92.9
34060, 논산시,065004, 63세,2016,1534,761,773,98.4,1519,753,766,98.3
34060, 논산시,065005, 64세,2016,1567,756,811,93.2,1556,750,806,93.1
34060, 논산시,070,65~69세,2016,7253,3521,3732,94.3,7223,3504,3719,94.2
34060, 논산시,070001, 65세,2016,1360,658,702,93.7,1349,652,697,93.5
34060, 논산시,070002, 66세,2016,1541,772,769,100.4,1532,765,767,99.7
34060, 논산시,070003, 67세,2016,1501,716,785,91.2,1496,715,781,91.5
34060, 논산시,070004, 68세,2016,1438,683,755,90.5,1438,683,755,90.5
34060, 논산시,070005, 69세,2016,1413,692,721,96,1408,689,719,95.8
34060, 논산시,075,70~74세,2016,6276,2788,3488,79.9,6267,2782,3485,79.8
34060, 논산시,075001, 70세,2016,1011,487,524,92.9,1008,484,524,92.4
34060, 논산시,075002, 71세,2016,1128,501,627,79.9,1127,500,627,79.7
34060, 논산시,075003, 72세,2016,1238,534,704,75.9,1237,534,703,76
34060, 논산시,075004, 73세,2016,1228,546,682,80.1,1227,546,681,80.2
34060, 논산시,075005, 74세,2016,1671,720,951,75.7,1668,718,950,75.6
34060, 논산시,080,75~79세,2016,6198,2411,3787,63.7,6188,2406,3782,63.6
34060, 논산시,080001, 75세,2016,1315,507,808,62.7,1313,507,806,62.9
34060, 논산시,080002, 76세,2016,1185,485,700,69.3,1182,484,698,69.3
34060, 논산시,080003, 77세,2016,1318,527,791,66.6,1315,524,791,66.2
34060, 논산시,080004, 78세,2016,1203,423,780,54.2,1201,422,779,54.2
34060, 논산시,080005, 79세,2016,1177,469,708,66.2,1177,469,708,66.2
34060, 논산시,085,80~84세,2016,4651,1666,2985,55.8,4646,1665,2981,55.9
34060, 논산시,085001, 80세,2016,1096,409,687,59.5,1094,408,686,59.5
34060, 논산시,085002, 81세,2016,1109,381,728,52.3,1108,381,727,52.4
34060, 논산시,085003, 82세,2016,947,357,590,60.5,947,357,590,60.5
34060, 논산시,085004, 83세,2016,790,274,516,53.1,788,274,514,53.3
34060, 논산시,085005, 84세,2016,709,245,464,52.8,709,245,464,52.8
34060, 논산시,090,85~89세,2016,2078,611,1467,41.6,2070,609,1461,41.7
34060, 논산시,090001, 85세,2016,524,165,359,46,523,165,358,46.1
34060, 논산시,090002, 86세,2016,468,137,331,41.4,466,137,329,41.6
34060, 논산시,090003, 87세,2016,386,114,272,41.9,382,112,270,41.5
34060, 논산시,090004, 88세,2016,384,105,279,37.6,384,105,279,37.6
34060, 논산시,090005, 89세,2016,316,90,226,39.8,315,90,225,40
34060, 논산시,095,90~94세,2016,635,173,462,37.4,634,173,461,37.5
34060, 논산시,095001, 90세,2016,189,55,134,41,189,55,134,41
34060, 논산시,095002, 91세,2016,153,41,112,36.6,153,41,112,36.6
34060, 논산시,095003, 92세,2016,92,27,65,41.5,92,27,65,41.5
34060, 논산시,095004, 93세,2016,112,28,84,33.3,111,28,83,33.7
34060, 논산시,095005, 94세,2016,89,22,67,32.8,89,22,67,32.8
34060, 논산시,100,95~99세,2016,137,35,102,34.3,137,35,102,34.3
34060, 논산시,100001, 95세,2016,51,13,38,34.2,51,13,38,34.2
34060, 논산시,100002, 96세,2016,40,9,31,29,40,9,31,29
34060, 논산시,100003, 97세,2016,29,7,22,31.8,29,7,22,31.8
34060, 논산시,100004, 98세,2016,9,6,X,200,9,6,X,200
34060, 논산시,100005, 99세,2016,8,X,8,0,8,X,8,0
34060, 논산시,101,100세이상,2016,19,X,16,18.8,19,X,16,18.8
34060, 논산시,102,15세미만,2016,13605,6930,6675,103.8,13550,6898,6652,103.7
34060, 논산시,103,15~64세,2016,83350,44179,39171,112.8,78871,41775,37096,112.6
34060, 논산시,104,65세이상,2016,27247,11208,16039,69.9,27184,11177,16007,69.8
34060, 논산시,086,85세이상,2016,2869,822,2047,40.2,2860,820,2040,40.2
34060, 논산시,126,평균연령,2016,45.2,43.3,47.1,,45.7,43.7,47.6,
34060, 논산시,127,중위연령,2016,46.9,44.8,49.3,,47.8,45.6,50.3,
34070, 계룡시,000,합계,2016,40576,20119,20457,98.3,40329,19999,20330,98.4
34070, 계룡시,005,0~4세,2016,2033,991,1042,95.1,2031,990,1041,95.1
34070, 계룡시,005001, 0세,2016,388,201,187,107.5,387,200,187,107
34070, 계룡시,005002, 1세,2016,367,156,211,73.9,367,156,211,73.9
34070, 계룡시,005003, 2세,2016,371,177,194,91.2,371,177,194,91.2
34070, 계룡시,005004, 3세,2016,441,226,215,105.1,441,226,215,105.1
34070, 계룡시,005005, 4세,2016,466,231,235,98.3,465,231,234,98.7
34070, 계룡시,010,5~9세,2016,2692,1441,1251,115.2,2689,1439,1250,115.1
34070, 계룡시,010001, 5세,2016,520,283,237,119.4,518,281,237,118.6
34070, 계룡시,010002, 6세,2016,515,275,240,114.6,514,275,239,115.1
34070, 계룡시,010003, 7세,2016,496,273,223,122.4,496,273,223,122.4
34070, 계룡시,010004, 8세,2016,559,295,264,111.7,559,295,264,111.7
34070, 계룡시,010005, 9세,2016,602,315,287,109.8,602,315,287,109.8
34070, 계룡시,015,10~14세,2016,3056,1573,1483,106.1,3056,1573,1483,106.1
34070, 계룡시,015001, 10세,2016,614,317,297,106.7,614,317,297,106.7
34070, 계룡시,015002, 11세,2016,544,275,269,102.2,544,275,269,102.2
34070, 계룡시,015003, 12세,2016,592,312,280,111.4,592,312,280,111.4
34070, 계룡시,015004, 13세,2016,672,353,319,110.7,672,353,319,110.7
34070, 계룡시,015005, 14세,2016,634,316,318,99.4,634,316,318,99.4
34070, 계룡시,020,15~19세,2016,2991,1536,1455,105.6,2984,1532,1452,105.5
34070, 계룡시,020001, 15세,2016,697,337,360,93.6,693,334,359,93
34070, 계룡시,020002, 16세,2016,661,328,333,98.5,659,328,331,99.1
34070, 계룡시,020003, 17세,2016,653,329,324,101.5,653,329,324,101.5
34070, 계룡시,020004, 18세,2016,548,278,270,103,548,278,270,103
34070, 계룡시,020005, 19세,2016,432,264,168,157.1,431,263,168,156.5
34070, 계룡시,025,20~24세,2016,2186,1269,917,138.4,2159,1256,903,139.1
34070, 계룡시,025001, 20세,2016,474,295,179,164.8,469,292,177,165
34070, 계룡시,025002, 21세,2016,477,306,171,178.9,473,303,170,178.2
34070, 계룡시,025003, 22세,2016,427,235,192,122.4,420,233,187,124.6
34070, 계룡시,025004, 23세,2016,412,212,200,106,407,211,196,107.7
34070, 계룡시,025005, 24세,2016,396,221,175,126.3,390,217,173,125.4
34070, 계룡시,030,25~29세,2016,1671,910,761,119.6,1630,891,739,120.6
34070, 계룡시,030001, 25세,2016,331,171,160,106.9,323,167,156,107.1
34070, 계룡시,030002, 26세,2016,368,218,150,145.3,354,209,145,144.1
34070, 계룡시,030003, 27세,2016,321,176,145,121.4,313,172,141,122
34070, 계룡시,030004, 28세,2016,318,173,145,119.3,316,173,143,121
34070, 계룡시,030005, 29세,2016,333,172,161,106.8,324,170,154,110.4
34070, 계룡시,035,30~34세,2016,2128,1008,1120,90,2100,999,1101,90.7
34070, 계룡시,035001, 30세,2016,311,166,145,114.5,308,165,143,115.4
34070, 계룡시,035002, 31세,2016,369,183,186,98.4,362,178,184,96.7
34070, 계룡시,035003, 32세,2016,420,200,220,90.9,417,199,218,91.3
34070, 계룡시,035004, 33세,2016,477,221,256,86.3,473,221,252,87.7
34070, 계룡시,035005, 34세,2016,551,238,313,76,540,236,304,77.6
34070, 계룡시,040,35~39세,2016,3315,1545,1770,87.3,3294,1534,1760,87.2
34070, 계룡시,040001, 35세,2016,606,297,309,96.1,603,296,307,96.4
34070, 계룡시,040002, 36세,2016,707,330,377,87.5,703,327,376,87
34070, 계룡시,040003, 37세,2016,672,279,393,71,666,276,390,70.8
34070, 계룡시,040004, 38세,2016,629,313,316,99.1,625,311,314,99
34070, 계룡시,040005, 39세,2016,701,326,375,86.9,697,324,373,86.9
34070, 계룡시,045,40~44세,2016,4143,1991,2152,92.5,4121,1979,2142,92.4
34070, 계룡시,045001, 40세,2016,717,352,365,96.4,713,350,363,96.4
34070, 계룡시,045002, 41세,2016,715,338,377,89.7,709,335,374,89.6
34070, 계룡시,045003, 42세,2016,903,424,479,88.5,898,420,478,87.9
34070, 계룡시,045004, 43세,2016,854,386,468,82.5,850,384,466,82.4
34070, 계룡시,045005, 44세,2016,954,491,463,106,951,490,461,106.3
34070, 계룡시,050,45~49세,2016,4665,2311,2354,98.2,4643,2300,2343,98.2
34070, 계룡시,050001, 45세,2016,1066,517,549,94.2,1064,516,548,94.2
34070, 계룡시,050002, 46세,2016,946,451,495,91.1,939,447,492,90.9
34070, 계룡시,050003, 47세,2016,986,497,489,101.6,980,494,486,101.6
34070, 계룡시,050004, 48세,2016,922,453,469,96.6,919,451,468,96.4
34070, 계룡시,050005, 49세,2016,745,393,352,111.6,741,392,349,112.3
34070, 계룡시,055,50~54세,2016,3186,1673,1513,110.6,3157,1661,1496,111
34070, 계룡시,055001, 50세,2016,728,401,327,122.6,721,397,324,122.5
34070, 계룡시,055002, 51세,2016,689,358,331,108.2,685,356,329,108.2
34070, 계룡시,055003, 52세,2016,595,315,280,112.5,589,314,275,114.2
34070, 계룡시,055004, 53세,2016,586,292,294,99.3,580,290,290,100
34070, 계룡시,055005, 54세,2016,588,307,281,109.3,582,304,278,109.4
34070, 계룡시,060,55~59세,2016,2801,1384,1417,97.7,2791,1376,1415,97.2
34070, 계룡시,060001, 55세,2016,644,325,319,101.9,641,323,318,101.6
34070, 계룡시,060002, 56세,2016,607,298,309,96.4,606,297,309,96.1
34070, 계룡시,060003, 57세,2016,532,260,272,95.6,530,259,271,95.6
34070, 계룡시,060004, 58세,2016,520,250,270,92.6,517,247,270,91.5
34070, 계룡시,060005, 59세,2016,498,251,247,101.6,497,250,247,101.2
34070, 계룡시,065,60~64세,2016,1942,971,971,100,1929,966,963,100.3
34070, 계룡시,065001, 60세,2016,445,214,231,92.6,444,213,231,92.2
34070, 계룡시,065002, 61세,2016,443,226,217,104.1,441,225,216,104.2
34070, 계룡시,065003, 62세,2016,393,198,195,101.5,390,198,192,103.1
34070, 계룡시,065004, 63세,2016,355,186,169,110.1,350,184,166,110.8
34070, 계룡시,065005, 64세,2016,306,147,159,92.5,304,146,158,92.4
34070, 계룡시,070,65~69세,2016,1179,594,585,101.5,1165,586,579,101.2
34070, 계룡시,070001, 65세,2016,230,120,110,109.1,226,119,107,111.2
34070, 계룡시,070002, 66세,2016,243,118,125,94.4,238,115,123,93.5
34070, 계룡시,070003, 67세,2016,257,116,141,82.3,252,112,140,80
34070, 계룡시,070004, 68세,2016,224,110,114,96.5,224,110,114,96.5
34070, 계룡시,070005, 69세,2016,225,130,95,136.8,225,130,95,136.8
34070, 계룡시,075,70~74세,2016,845,371,474,78.3,843,370,473,78.2
34070, 계룡시,075001, 70세,2016,138,72,66,109.1,137,72,65,110.8
34070, 계룡시,075002, 71세,2016,160,70,90,77.8,160,70,90,77.8
34070, 계룡시,075003, 72세,2016,184,82,102,80.4,184,82,102,80.4
34070, 계룡시,075004, 73세,2016,177,82,95,86.3,177,82,95,86.3
34070, 계룡시,075005, 74세,2016,186,65,121,53.7,185,64,121,52.9
34070, 계룡시,080,75~79세,2016,767,285,482,59.1,764,283,481,58.8
34070, 계룡시,080001, 75세,2016,159,52,107,48.6,158,51,107,47.7
34070, 계룡시,080002, 76세,2016,133,68,65,104.6,133,68,65,104.6
34070, 계룡시,080003, 77세,2016,180,58,122,47.5,179,57,122,46.7
34070, 계룡시,080004, 78세,2016,151,58,93,62.4,151,58,93,62.4
34070, 계룡시,080005, 79세,2016,144,49,95,51.6,143,49,94,52.1
34070, 계룡시,085,80~84세,2016,590,176,414,42.5,588,175,413,42.4
34070, 계룡시,085001, 80세,2016,134,38,96,39.6,134,38,96,39.6
34070, 계룡시,085002, 81세,2016,131,39,92,42.4,131,39,92,42.4
34070, 계룡시,085003, 82세,2016,125,38,87,43.7,124,38,86,44.2
34070, 계룡시,085004, 83세,2016,111,31,80,38.8,111,31,80,38.8
34070, 계룡시,085005, 84세,2016,89,30,59,50.8,88,29,59,49.2
34070, 계룡시,090,85~89세,2016,272,65,207,31.4,271,64,207,30.9
34070, 계룡시,090001, 85세,2016,55,11,44,25,54,10,44,22.7
34070, 계룡시,090002, 86세,2016,64,16,48,33.3,64,16,48,33.3
34070, 계룡시,090003, 87세,2016,62,13,49,26.5,62,13,49,26.5
34070, 계룡시,090004, 88세,2016,41,9,32,28.1,41,9,32,28.1
34070, 계룡시,090005, 89세,2016,50,16,34,47.1,50,16,34,47.1
34070, 계룡시,095,90~94세,2016,92,20,72,27.8,92,20,72,27.8
34070, 계룡시,095001, 90세,2016,23,10,13,76.9,23,10,13,76.9
34070, 계룡시,095002, 91세,2016,26,5,21,23.8,26,5,21,23.8
34070, 계룡시,095003, 92세,2016,12,X,12,0,12,X,12,0
34070, 계룡시,095004, 93세,2016,20,X,16,25,20,X,16,25
34070, 계룡시,095005, 94세,2016,11,X,10,10,11,X,10,10
34070, 계룡시,100,95~99세,2016,22,5,17,29.4,22,5,17,29.4
34070, 계룡시,100001, 95세,2016,6,X,X,50,6,X,X,50
34070, 계룡시,100002, 96세,2016,6,X,5,20,6,X,5,20
34070, 계룡시,100003, 97세,2016,5,X,X,66.7,5,X,X,66.7
34070, 계룡시,100004, 98세,2016,X,X,X,0,X,X,X,0
34070, 계룡시,100005, 99세,2016,X,X,X,0,X,X,X,0
34070, 계룡시,101,100세이상,2016,X,X,X,,X,X,X,
34070, 계룡시,102,15세미만,2016,7781,4005,3776,106.1,7776,4002,3774,106
34070, 계룡시,103,15~64세,2016,29028,14598,14430,101.2,28808,14494,14314,101.3
34070, 계룡시,104,65세이상,2016,3767,1516,2251,67.3,3745,1503,2242,67
34070, 계룡시,086,85세이상,2016,386,90,296,30.4,385,89,296,30.1
34070, 계룡시,126,평균연령,2016,37.8,36.7,38.9,,37.8,36.6,38.9,
34070, 계룡시,127,중위연령,2016,40.3,39.3,41.2,,40.3,39.3,41.2,
34080, 당진시,000,합계,2016,166043,88082,77961,113,159267,83476,75791,110.1
34080, 당진시,005,0~4세,2016,9267,4717,4550,103.7,9196,4677,4519,103.5
34080, 당진시,005001, 0세,2016,1708,866,842,102.9,1698,861,837,102.9
34080, 당진시,005002, 1세,2016,1905,957,948,100.9,1891,950,941,101
34080, 당진시,005003, 2세,2016,1890,964,926,104.1,1876,955,921,103.7
34080, 당진시,005004, 3세,2016,1862,963,899,107.1,1842,952,890,107
34080, 당진시,005005, 4세,2016,1902,967,935,103.4,1889,959,930,103.1
34080, 당진시,010,5~9세,2016,8870,4623,4247,108.9,8827,4594,4233,108.5
34080, 당진시,010001, 5세,2016,1934,999,935,106.8,1923,991,932,106.3
34080, 당진시,010002, 6세,2016,1831,956,875,109.3,1820,949,871,109
34080, 당진시,010003, 7세,2016,1677,837,840,99.6,1670,831,839,99
34080, 당진시,010004, 8세,2016,1735,920,815,112.9,1726,915,811,112.8
34080, 당진시,010005, 9세,2016,1693,911,782,116.5,1688,908,780,116.4
34080, 당진시,015,10~14세,2016,7256,3803,3453,110.1,7236,3794,3442,110.2
34080, 당진시,015001, 10세,2016,1496,789,707,111.6,1492,789,703,112.2
34080, 당진시,015002, 11세,2016,1426,741,685,108.2,1419,738,681,108.4
34080, 당진시,015003, 12세,2016,1481,745,736,101.2,1478,744,734,101.4
34080, 당진시,015004, 13세,2016,1398,746,652,114.4,1394,742,652,113.8
34080, 당진시,015005, 14세,2016,1455,782,673,116.2,1453,781,672,116.2
34080, 당진시,020,15~19세,2016,8658,4505,4153,108.5,8601,4478,4123,108.6
34080, 당진시,020001, 15세,2016,1712,876,836,104.8,1701,868,833,104.2
34080, 당진시,020002, 16세,2016,1843,996,847,117.6,1832,988,844,117.1
34080, 당진시,020003, 17세,2016,1644,837,807,103.7,1637,834,803,103.9
34080, 당진시,020004, 18세,2016,1687,895,792,113,1677,891,786,113.4
34080, 당진시,020005, 19세,2016,1772,901,871,103.4,1754,897,857,104.7
34080, 당진시,025,20~24세,2016,8484,4876,3608,135.1,7927,4465,3462,129
34080, 당진시,025001, 20세,2016,1791,1011,780,129.6,1745,978,767,127.5
34080, 당진시,025002, 21세,2016,1715,956,759,126,1634,887,747,118.7
34080, 당진시,025003, 22세,2016,1600,949,651,145.8,1479,863,616,140.1
34080, 당진시,025004, 23세,2016,1657,938,719,130.5,1509,831,678,122.6
34080, 당진시,025005, 24세,2016,1721,1022,699,146.2,1560,906,654,138.5
34080, 당진시,030,25~29세,2016,9945,5985,3960,151.1,8776,5145,3631,141.7
34080, 당진시,030001, 25세,2016,1773,1075,698,154,1594,947,647,146.4
34080, 당진시,030002, 26세,2016,1854,1150,704,163.4,1625,986,639,154.3
34080, 당진시,030003, 27세,2016,2035,1211,824,147,1796,1043,753,138.5
34080, 당진시,030004, 28세,2016,2074,1261,813,155.1,1826,1083,743,145.8
34080, 당진시,030005, 29세,2016,2209,1288,921,139.8,1935,1086,849,127.9
34080, 당진시,035,30~34세,2016,13199,7702,5497,140.1,12001,6811,5190,131.2
34080, 당진시,035001, 30세,2016,2246,1319,927,142.3,1996,1149,847,135.7
34080, 당진시,035002, 31세,2016,2429,1455,974,149.4,2151,1244,907,137.2
34080, 당진시,035003, 32세,2016,2541,1462,1079,135.5,2333,1305,1028,126.9
34080, 당진시,035004, 33세,2016,2850,1679,1171,143.4,2606,1483,1123,132.1
34080, 당진시,035005, 34세,2016,3133,1787,1346,132.8,2915,1630,1285,126.8
34080, 당진시,040,35~39세,2016,14258,7989,6269,127.4,13371,7332,6039,121.4
34080, 당진시,040001, 35세,2016,3062,1721,1341,128.3,2860,1558,1302,119.7
34080, 당진시,040002, 36세,2016,3086,1688,1398,120.7,2886,1538,1348,114.1
34080, 당진시,040003, 37세,2016,2810,1605,1205,133.2,2651,1491,1160,128.5
34080, 당진시,040004, 38세,2016,2581,1463,1118,130.9,2409,1333,1076,123.9
34080, 당진시,040005, 39세,2016,2719,1512,1207,125.3,2565,1412,1153,122.5
34080, 당진시,045,40~44세,2016,13045,7397,5648,131,12356,6909,5447,126.8
34080, 당진시,045001, 40세,2016,2478,1357,1121,121.1,2343,1262,1081,116.7
34080, 당진시,045002, 41세,2016,2534,1454,1080,134.6,2398,1360,1038,131
34080, 당진시,045003, 42세,2016,2740,1589,1151,138.1,2603,1498,1105,135.6
34080, 당진시,045004, 43세,2016,2780,1536,1244,123.5,2633,1424,1209,117.8
34080, 당진시,045005, 44세,2016,2513,1461,1052,138.9,2379,1365,1014,134.6
34080, 당진시,050,45~49세,2016,13059,7352,5707,128.8,12426,6961,5465,127.4
34080, 당진시,050001, 45세,2016,2782,1613,1169,138,2628,1510,1118,135.1
34080, 당진시,050002, 46세,2016,2478,1373,1105,124.3,2334,1286,1048,122.7
34080, 당진시,050003, 47세,2016,2713,1530,1183,129.3,2601,1465,1136,129
34080, 당진시,050004, 48세,2016,2631,1498,1133,132.2,2505,1427,1078,132.4
34080, 당진시,050005, 49세,2016,2455,1338,1117,119.8,2358,1273,1085,117.3
34080, 당진시,055,50~54세,2016,12012,6696,5316,126,11402,6339,5063,125.2
34080, 당진시,055001, 50세,2016,2193,1226,967,126.8,2088,1171,917,127.7
34080, 당진시,055002, 51세,2016,2631,1476,1155,127.8,2490,1395,1095,127.4
34080, 당진시,055003, 52세,2016,2318,1321,997,132.5,2197,1250,947,132
34080, 당진시,055004, 53세,2016,2336,1290,1046,123.3,2206,1207,999,120.8
34080, 당진시,055005, 54세,2016,2534,1383,1151,120.2,2421,1316,1105,119.1
34080, 당진시,060,55~59세,2016,12194,6380,5814,109.7,11820,6164,5656,109
34080, 당진시,060001, 55세,2016,2762,1451,1311,110.7,2693,1408,1285,109.6
34080, 당진시,060002, 56세,2016,2689,1401,1288,108.8,2593,1356,1237,109.6
34080, 당진시,060003, 57세,2016,2358,1232,1126,109.4,2281,1190,1091,109.1
34080, 당진시,060004, 58세,2016,2192,1139,1053,108.2,2122,1095,1027,106.6
34080, 당진시,060005, 59세,2016,2193,1157,1036,111.7,2131,1115,1016,109.7
34080, 당진시,065,60~64세,2016,9345,4688,4657,100.7,9074,4540,4534,100.1
34080, 당진시,065001, 60세,2016,2119,1079,1040,103.8,2047,1033,1014,101.9
34080, 당진시,065002, 61세,2016,2170,1087,1083,100.4,2116,1058,1058,100
34080, 당진시,065003, 62세,2016,1748,850,898,94.7,1694,822,872,94.3
34080, 당진시,065004, 63세,2016,1490,742,748,99.2,1441,717,724,99
34080, 당진시,065005, 64세,2016,1818,930,888,104.7,1776,910,866,105.1
34080, 당진시,070,65~69세,2016,7592,3769,3823,98.6,7498,3717,3781,98.3
34080, 당진시,070001, 65세,2016,1359,687,672,102.2,1337,672,665,101.1
34080, 당진시,070002, 66세,2016,1646,778,868,89.6,1623,766,857,89.4
34080, 당진시,070003, 67세,2016,1615,808,807,100.1,1591,792,799,99.1
34080, 당진시,070004, 68세,2016,1482,738,744,99.2,1469,732,737,99.3
34080, 당진시,070005, 69세,2016,1490,758,732,103.6,1478,755,723,104.4
34080, 당진시,075,70~74세,2016,6115,2871,3244,88.5,6060,2842,3218,88.3
34080, 당진시,075001, 70세,2016,1071,527,544,96.9,1054,517,537,96.3
34080, 당진시,075002, 71세,2016,1043,524,519,101,1034,520,514,101.2
34080, 당진시,075003, 72세,2016,1153,521,632,82.4,1143,519,624,83.2
34080, 당진시,075004, 73세,2016,1210,576,634,90.9,1198,567,631,89.9
34080, 당진시,075005, 74세,2016,1638,723,915,79,1631,719,912,78.8
34080, 당진시,080,75~79세,2016,5897,2432,3465,70.2,5868,2419,3449,70.1
34080, 당진시,080001, 75세,2016,1207,523,684,76.5,1199,518,681,76.1
34080, 당진시,080002, 76세,2016,1110,471,639,73.7,1103,467,636,73.4
34080, 당진시,080003, 77세,2016,1254,509,745,68.3,1250,508,742,68.5
34080, 당진시,080004, 78세,2016,1224,506,718,70.5,1217,504,713,70.7
34080, 당진시,080005, 79세,2016,1102,423,679,62.3,1099,422,677,62.3
34080, 당진시,085,80~84세,2016,4291,1581,2710,58.3,4275,1576,2699,58.4
34080, 당진시,085001, 80세,2016,1092,438,654,67,1087,437,650,67.2
34080, 당진시,085002, 81세,2016,1030,385,645,59.7,1024,383,641,59.8
34080, 당진시,085003, 82세,2016,854,331,523,63.3,851,330,521,63.3
34080, 당진시,085004, 83세,2016,709,236,473,49.9,707,235,472,49.8
34080, 당진시,085005, 84세,2016,606,191,415,46,606,191,415,46
34080, 당진시,090,85~89세,2016,1786,548,1238,44.3,1783,545,1238,44
34080, 당진시,090001, 85세,2016,422,132,290,45.5,422,132,290,45.5
34080, 당진시,090002, 86세,2016,448,142,306,46.4,447,141,306,46.1
34080, 당진시,090003, 87세,2016,367,106,261,40.6,366,105,261,40.2
34080, 당진시,090004, 88세,2016,310,99,211,46.9,310,99,211,46.9
34080, 당진시,090005, 89세,2016,239,69,170,40.6,238,68,170,40
34080, 당진시,095,90~94세,2016,600,140,460,30.4,600,140,460,30.4
34080, 당진시,095001, 90세,2016,143,45,98,45.9,143,45,98,45.9
34080, 당진시,095002, 91세,2016,123,37,86,43,123,37,86,43
34080, 당진시,095003, 92세,2016,125,22,103,21.4,125,22,103,21.4
34080, 당진시,095004, 93세,2016,119,23,96,24,119,23,96,24
34080, 당진시,095005, 94세,2016,90,13,77,16.9,90,13,77,16.9
34080, 당진시,100,95~99세,2016,155,25,130,19.2,155,25,130,19.2
34080, 당진시,100001, 95세,2016,54,7,47,14.9,54,7,47,14.9
34080, 당진시,100002, 96세,2016,43,8,35,22.9,43,8,35,22.9
34080, 당진시,100003, 97세,2016,28,6,22,27.3,28,6,22,27.3
34080, 당진시,100004, 98세,2016,17,X,15,13.3,17,X,15,13.3
34080, 당진시,100005, 99세,2016,13,X,11,18.2,13,X,11,18.2
34080, 당진시,101,100세이상,2016,15,X,12,25,15,X,12,25
34080, 당진시,102,15세미만,2016,25393,13143,12250,107.3,25259,13065,12194,107.1
34080, 당진시,103,15~64세,2016,114199,63570,50629,125.6,107754,59144,48610,121.7
34080, 당진시,104,65세이상,2016,26451,11369,15082,75.4,26254,11267,14987,75.2
34080, 당진시,086,85세이상,2016,2556,716,1840,38.9,2553,713,1840,38.8
34080, 당진시,126,평균연령,2016,41.2,39.9,42.7,,41.3,40,42.7,
34080, 당진시,127,중위연령,2016,41.2,39.9,42.9,,41.6,40.3,43,
34310, 금산군,000,합계,2016,56697,28688,28009,102.4,54804,27663,27141,101.9
34310, 금산군,005,0~4세,2016,1512,772,740,104.3,1508,768,740,103.8
34310, 금산군,005001, 0세,2016,261,126,135,93.3,261,126,135,93.3
34310, 금산군,005002, 1세,2016,287,136,151,90.1,285,134,151,88.7
34310, 금산군,005003, 2세,2016,304,150,154,97.4,303,149,154,96.8
34310, 금산군,005004, 3세,2016,319,180,139,129.5,319,180,139,129.5
34310, 금산군,005005, 4세,2016,341,180,161,111.8,340,179,161,111.2
34310, 금산군,010,5~9세,2016,2000,1037,963,107.7,1990,1033,957,107.9
34310, 금산군,010001, 5세,2016,390,192,198,97,387,190,197,96.4
34310, 금산군,010002, 6세,2016,416,226,190,118.9,414,225,189,119
34310, 금산군,010003, 7세,2016,361,184,177,104,358,183,175,104.6
34310, 금산군,010004, 8세,2016,391,215,176,122.2,390,215,175,122.9
34310, 금산군,010005, 9세,2016,442,220,222,99.1,441,220,221,99.5
34310, 금산군,015,10~14세,2016,1929,987,942,104.8,1926,986,940,104.9
34310, 금산군,015001, 10세,2016,352,186,166,112,352,186,166,112
34310, 금산군,015002, 11세,2016,366,187,179,104.5,366,187,179,104.5
34310, 금산군,015003, 12세,2016,357,184,173,106.4,355,184,171,107.6
34310, 금산군,015004, 13세,2016,429,207,222,93.2,429,207,222,93.2
34310, 금산군,015005, 14세,2016,425,223,202,110.4,424,222,202,109.9
34310, 금산군,020,15~19세,2016,3337,1816,1521,119.4,3305,1792,1513,118.4
34310, 금산군,020001, 15세,2016,552,301,251,119.9,551,300,251,119.5
34310, 금산군,020002, 16세,2016,581,319,262,121.8,579,317,262,121
34310, 금산군,020003, 17세,2016,578,316,262,120.6,576,314,262,119.8
34310, 금산군,020004, 18세,2016,673,369,304,121.4,667,364,303,120.1
34310, 금산군,020005, 19세,2016,953,511,442,115.6,932,497,435,114.3
34310, 금산군,025,20~24세,2016,5328,2931,2397,122.3,4766,2638,2128,124
34310, 금산군,025001, 20세,2016,895,363,532,68.2,834,339,495,68.5
34310, 금산군,025002, 21세,2016,1097,423,674,62.8,975,370,605,61.2
34310, 금산군,025003, 22세,2016,1274,675,599,112.7,1098,582,516,112.8
34310, 금산군,025004, 23세,2016,1095,767,328,233.8,991,702,289,242.9
34310, 금산군,025005, 24세,2016,967,703,264,266.3,868,645,223,289.2
34310, 금산군,030,25~29세,2016,2640,1595,1045,152.6,2304,1409,895,157.4
34310, 금산군,030001, 25세,2016,709,467,242,193,634,427,207,206.3
34310, 금산군,030002, 26세,2016,592,368,224,164.3,500,319,181,176.2
34310, 금산군,030003, 27세,2016,463,277,186,148.9,404,248,156,159
34310, 금산군,030004, 28세,2016,457,265,192,138,394,223,171,130.4
34310, 금산군,030005, 29세,2016,419,218,201,108.5,372,192,180,106.7
34310, 금산군,035,30~34세,2016,2367,1285,1082,118.8,2114,1152,962,119.8
34310, 금산군,035001, 30세,2016,453,246,207,118.8,400,219,181,121
34310, 금산군,035002, 31세,2016,398,212,186,114,351,190,161,118
34310, 금산군,035003, 32세,2016,456,252,204,123.5,407,225,182,123.6
34310, 금산군,035004, 33세,2016,484,268,216,124.1,432,237,195,121.5
34310, 금산군,035005, 34세,2016,576,307,269,114.1,524,281,243,115.6
34310, 금산군,040,35~39세,2016,2791,1513,1278,118.4,2633,1418,1215,116.7
34310, 금산군,040001, 35세,2016,566,309,257,120.2,529,288,241,119.5
34310, 금산군,040002, 36세,2016,579,305,274,111.3,542,288,254,113.4
34310, 금산군,040003, 37세,2016,569,301,268,112.3,535,277,258,107.4
34310, 금산군,040004, 38세,2016,539,296,243,121.8,512,278,234,118.8
34310, 금산군,040005, 39세,2016,538,302,236,128,515,287,228,125.9
34310, 금산군,045,40~44세,2016,3220,1846,1374,134.4,3095,1772,1323,133.9
34310, 금산군,045001, 40세,2016,586,308,278,110.8,559,294,265,110.9
34310, 금산군,045002, 41세,2016,615,365,250,146,596,354,242,146.3
34310, 금산군,045003, 42세,2016,653,395,258,153.1,628,380,248,153.2
34310, 금산군,045004, 43세,2016,693,382,311,122.8,666,363,303,119.8
34310, 금산군,045005, 44세,2016,673,396,277,143,646,381,265,143.8
34310, 금산군,050,45~49세,2016,3935,2158,1777,121.4,3810,2093,1717,121.9
34310, 금산군,050001, 45세,2016,793,438,355,123.4,768,424,344,123.3
34310, 금산군,050002, 46세,2016,774,434,340,127.6,748,423,325,130.2
34310, 금산군,050003, 47세,2016,749,421,328,128.4,725,407,318,128
34310, 금산군,050004, 48세,2016,793,431,362,119.1,766,418,348,120.1
34310, 금산군,050005, 49세,2016,826,434,392,110.7,803,421,382,110.2
34310, 금산군,055,50~54세,2016,4126,2223,1903,116.8,4006,2161,1845,117.1
34310, 금산군,055001, 50세,2016,707,379,328,115.5,676,359,317,113.2
34310, 금산군,055002, 51세,2016,838,458,380,120.5,812,447,365,122.5
34310, 금산군,055003, 52세,2016,811,434,377,115.1,789,423,366,115.6
34310, 금산군,055004, 53세,2016,860,463,397,116.6,838,454,384,118.2
34310, 금산군,055005, 54세,2016,910,489,421,116.2,891,478,413,115.7
34310, 금산군,060,55~59세,2016,5089,2584,2505,103.2,5017,2554,2463,103.7
34310, 금산군,060001, 55세,2016,1090,581,509,114.1,1074,575,499,115.2
34310, 금산군,060002, 56세,2016,1121,572,549,104.2,1104,563,541,104.1
34310, 금산군,060003, 57세,2016,893,422,471,89.6,881,419,462,90.7
34310, 금산군,060004, 58세,2016,965,469,496,94.6,951,461,490,94.1
34310, 금산군,060005, 59세,2016,1020,540,480,112.5,1007,536,471,113.8
34310, 금산군,065,60~64세,2016,4388,2185,2203,99.2,4334,2152,2182,98.6
34310, 금산군,065001, 60세,2016,923,488,435,112.2,909,478,431,110.9
34310, 금산군,065002, 61세,2016,946,452,494,91.5,935,445,490,90.8
34310, 금산군,065003, 62세,2016,960,487,473,103,951,482,469,102.8
34310, 금산군,065004, 63세,2016,701,333,368,90.5,688,325,363,89.5
34310, 금산군,065005, 64세,2016,858,425,433,98.2,851,422,429,98.4
34310, 금산군,070,65~69세,2016,3678,1805,1873,96.4,3653,1791,1862,96.2
34310, 금산군,070001, 65세,2016,697,341,356,95.8,693,338,355,95.2
34310, 금산군,070002, 66세,2016,763,379,384,98.7,756,374,382,97.9
34310, 금산군,070003, 67세,2016,741,379,362,104.7,735,376,359,104.7
34310, 금산군,070004, 68세,2016,727,351,376,93.4,722,348,374,93
34310, 금산군,070005, 69세,2016,750,355,395,89.9,747,355,392,90.6
34310, 금산군,075,70~74세,2016,3413,1506,1907,79,3407,1503,1904,78.9
34310, 금산군,075001, 70세,2016,580,285,295,96.6,579,285,294,96.9
34310, 금산군,075002, 71세,2016,566,240,326,73.6,565,239,326,73.3
34310, 금산군,075003, 72세,2016,588,251,337,74.5,586,250,336,74.4
34310, 금산군,075004, 73세,2016,723,311,412,75.5,722,311,411,75.7
34310, 금산군,075005, 74세,2016,956,419,537,78,955,418,537,77.8
34310, 금산군,080,75~79세,2016,3239,1240,1999,62,3234,1237,1997,61.9
34310, 금산군,080001, 75세,2016,622,246,376,65.4,621,246,375,65.6
34310, 금산군,080002, 76세,2016,662,256,406,63.1,661,255,406,62.8
34310, 금산군,080003, 77세,2016,729,280,449,62.4,728,279,449,62.1
34310, 금산군,080004, 78세,2016,671,245,426,57.5,669,244,425,57.4
34310, 금산군,080005, 79세,2016,555,213,342,62.3,555,213,342,62.3
34310, 금산군,085,80~84세,2016,2399,857,1542,55.6,2398,857,1541,55.6
34310, 금산군,085001, 80세,2016,561,207,354,58.5,561,207,354,58.5
34310, 금산군,085002, 81세,2016,577,215,362,59.4,577,215,362,59.4
34310, 금산군,085003, 82세,2016,479,175,304,57.6,479,175,304,57.6
34310, 금산군,085004, 83세,2016,398,135,263,51.3,398,135,263,51.3
34310, 금산군,085005, 84세,2016,384,125,259,48.3,383,125,258,48.4
34310, 금산군,090,85~89세,2016,950,262,688,38.1,949,261,688,37.9
34310, 금산군,090001, 85세,2016,255,87,168,51.8,255,87,168,51.8
34310, 금산군,090002, 86세,2016,231,52,179,29.1,230,51,179,28.5
34310, 금산군,090003, 87세,2016,165,47,118,39.8,165,47,118,39.8
34310, 금산군,090004, 88세,2016,156,39,117,33.3,156,39,117,33.3
34310, 금산군,090005, 89세,2016,143,37,106,34.9,143,37,106,34.9
34310, 금산군,095,90~94세,2016,293,76,217,35,292,76,216,35.2
34310, 금산군,095001, 90세,2016,84,23,61,37.7,84,23,61,37.7
34310, 금산군,095002, 91세,2016,73,20,53,37.7,72,20,52,38.5
34310, 금산군,095003, 92세,2016,40,14,26,53.8,40,14,26,53.8
34310, 금산군,095004, 93세,2016,60,12,48,25,60,12,48,25
34310, 금산군,095005, 94세,2016,36,7,29,24.1,36,7,29,24.1
34310, 금산군,100,95~99세,2016,55,8,47,17,55,8,47,17
34310, 금산군,100001, 95세,2016,24,X,21,14.3,24,X,21,14.3
34310, 금산군,100002, 96세,2016,16,X,13,23.1,16,X,13,23.1
34310, 금산군,100003, 97세,2016,6,X,6,0,6,X,6,0
34310, 금산군,100004, 98세,2016,8,X,7,14.3,8,X,7,14.3
34310, 금산군,100005, 99세,2016,X,X,X,,X,X,X,
34310, 금산군,101,100세이상,2016,8,X,6,33.3,8,X,6,33.3
34310, 금산군,102,15세미만,2016,5441,2796,2645,105.7,5424,2787,2637,105.7
34310, 금산군,103,15~64세,2016,37221,20136,17085,117.9,35384,19141,16243,117.8
34310, 금산군,104,65세이상,2016,14035,5756,8279,69.5,13996,5735,8261,69.4
34310, 금산군,086,85세이상,2016,1306,348,958,36.3,1304,347,957,36.3
34310, 금산군,126,평균연령,2016,46.6,44.4,48.9,,47.1,44.8,49.4,
34310, 금산군,127,중위연령,2016,49.1,46.3,52.5,,49.9,47,53.3,
34330, 부여군,000,합계,2016,68152,33776,34376,98.3,66471,32852,33619,97.7
34330, 부여군,005,0~4세,2016,1699,891,808,110.3,1692,887,805,110.2
34330, 부여군,005001, 0세,2016,297,145,152,95.4,297,145,152,95.4
34330, 부여군,005002, 1세,2016,335,175,160,109.4,333,175,158,110.8
34330, 부여군,005003, 2세,2016,327,177,150,118,327,177,150,118
34330, 부여군,005004, 3세,2016,331,178,153,116.3,329,176,153,115
34330, 부여군,005005, 4세,2016,409,216,193,111.9,406,214,192,111.5
34330, 부여군,010,5~9세,2016,1992,1056,936,112.8,1980,1050,930,112.9
34330, 부여군,010001, 5세,2016,355,199,156,127.6,354,199,155,128.4
34330, 부여군,010002, 6세,2016,408,215,193,111.4,403,213,190,112.1
34330, 부여군,010003, 7세,2016,380,206,174,118.4,378,204,174,117.2
34330, 부여군,010004, 8세,2016,415,207,208,99.5,413,206,207,99.5
34330, 부여군,010005, 9세,2016,434,229,205,111.7,432,228,204,111.8
34330, 부여군,015,10~14세,2016,2412,1256,1156,108.7,2408,1254,1154,108.7
34330, 부여군,015001, 10세,2016,449,236,213,110.8,448,235,213,110.3
34330, 부여군,015002, 11세,2016,456,221,235,94,454,220,234,94
34330, 부여군,015003, 12세,2016,458,251,207,121.3,458,251,207,121.3
34330, 부여군,015004, 13세,2016,519,276,243,113.6,519,276,243,113.6
34330, 부여군,015005, 14세,2016,530,272,258,105.4,529,272,257,105.8
34330, 부여군,020,15~19세,2016,3511,1950,1561,124.9,3505,1947,1558,125
34330, 부여군,020001, 15세,2016,655,367,288,127.4,655,367,288,127.4
34330, 부여군,020002, 16세,2016,818,420,398,105.5,817,419,398,105.3
34330, 부여군,020003, 17세,2016,771,430,341,126.1,770,430,340,126.5
34330, 부여군,020004, 18세,2016,663,378,285,132.6,661,377,284,132.7
34330, 부여군,020005, 19세,2016,604,355,249,142.6,602,354,248,142.7
34330, 부여군,025,20~24세,2016,3557,2002,1555,128.7,3367,1900,1467,129.5
34330, 부여군,025001, 20세,2016,730,395,335,117.9,720,394,326,120.9
34330, 부여군,025002, 21세,2016,748,432,316,136.7,726,422,304,138.8
34330, 부여군,025003, 22세,2016,749,425,324,131.2,707,406,301,134.9
34330, 부여군,025004, 23세,2016,653,365,288,126.7,599,336,263,127.8
34330, 부여군,025005, 24세,2016,677,385,292,131.8,615,342,273,125.3
34330, 부여군,030,25~29세,2016,2898,1613,1285,125.5,2492,1394,1098,127
34330, 부여군,030001, 25세,2016,580,306,274,111.7,516,273,243,112.3
34330, 부여군,030002, 26세,2016,613,359,254,141.3,521,309,212,145.8
34330, 부여군,030003, 27세,2016,570,306,264,115.9,485,258,227,113.7
34330, 부여군,030004, 28세,2016,561,323,238,135.7,472,274,198,138.4
34330, 부여군,030005, 29세,2016,574,319,255,125.1,498,280,218,128.4
34330, 부여군,035,30~34세,2016,2694,1480,1214,121.9,2411,1324,1087,121.8
34330, 부여군,035001, 30세,2016,493,269,224,120.1,432,238,194,122.7
34330, 부여군,035002, 31세,2016,517,296,221,133.9,456,259,197,131.5
34330, 부여군,035003, 32세,2016,526,279,247,113,463,240,223,107.6
34330, 부여군,035004, 33세,2016,561,307,254,120.9,515,287,228,125.9
34330, 부여군,035005, 34세,2016,597,329,268,122.8,545,300,245,122.4
34330, 부여군,040,35~39세,2016,3033,1669,1364,122.4,2852,1564,1288,121.4
34330, 부여군,040001, 35세,2016,582,329,253,130,540,308,232,132.8
34330, 부여군,040002, 36세,2016,628,343,285,120.4,588,319,269,118.6
34330, 부여군,040003, 37세,2016,582,321,261,123,544,300,244,123
34330, 부여군,040004, 38세,2016,603,337,266,126.7,572,320,252,127
34330, 부여군,040005, 39세,2016,638,339,299,113.4,608,317,291,108.9
34330, 부여군,045,40~44세,2016,3825,2099,1726,121.6,3663,2001,1662,120.4
34330, 부여군,045001, 40세,2016,692,381,311,122.5,658,363,295,123.1
34330, 부여군,045002, 41세,2016,712,393,319,123.2,686,379,307,123.5
34330, 부여군,045003, 42세,2016,793,428,365,117.3,756,404,352,114.8
34330, 부여군,045004, 43세,2016,813,453,360,125.8,782,434,348,124.7
34330, 부여군,045005, 44세,2016,815,444,371,119.7,781,421,360,116.9
34330, 부여군,050,45~49세,2016,4613,2490,2123,117.3,4479,2413,2066,116.8
34330, 부여군,050001, 45세,2016,894,494,400,123.5,867,479,388,123.5
34330, 부여군,050002, 46세,2016,874,483,391,123.5,851,470,381,123.4
34330, 부여군,050003, 47세,2016,950,481,469,102.6,914,459,455,100.9
34330, 부여군,050004, 48세,2016,973,518,455,113.8,940,500,440,113.6
34330, 부여군,050005, 49세,2016,922,514,408,126,907,505,402,125.6
34330, 부여군,055,50~54세,2016,5079,2633,2446,107.6,4958,2566,2392,107.3
34330, 부여군,055001, 50세,2016,850,454,396,114.6,831,444,387,114.7
34330, 부여군,055002, 51세,2016,1026,550,476,115.5,1005,537,468,114.7
34330, 부여군,055003, 52세,2016,1015,515,500,103,979,491,488,100.6
34330, 부여군,055004, 53세,2016,1003,490,513,95.5,976,480,496,96.8
34330, 부여군,055005, 54세,2016,1185,624,561,111.2,1167,614,553,111
34330, 부여군,060,55~59세,2016,6778,3396,3382,100.4,6688,3350,3338,100.4
34330, 부여군,060001, 55세,2016,1411,712,699,101.9,1386,699,687,101.7
34330, 부여군,060002, 56세,2016,1476,706,770,91.7,1448,692,756,91.5
34330, 부여군,060003, 57세,2016,1299,642,657,97.7,1286,635,651,97.5
34330, 부여군,060004, 58세,2016,1263,636,627,101.4,1251,631,620,101.8
34330, 부여군,060005, 59세,2016,1329,700,629,111.3,1317,693,624,111.1
34330, 부여군,065,60~64세,2016,5963,2940,3023,97.3,5912,2916,2996,97.3
34330, 부여군,065001, 60세,2016,1367,691,676,102.2,1356,685,671,102.1
34330, 부여군,065002, 61세,2016,1310,642,668,96.1,1305,641,664,96.5
34330, 부여군,065003, 62세,2016,1223,598,625,95.7,1211,591,620,95.3
34330, 부여군,065004, 63세,2016,950,461,489,94.3,938,457,481,95
34330, 부여군,065005, 64세,2016,1113,548,565,97,1102,542,560,96.8
34330, 부여군,070,65~69세,2016,5125,2466,2659,92.7,5110,2457,2653,92.6
34330, 부여군,070001, 65세,2016,925,450,475,94.7,922,447,475,94.1
34330, 부여군,070002, 66세,2016,1092,538,554,97.1,1089,537,552,97.3
34330, 부여군,070003, 67세,2016,1141,546,595,91.8,1136,543,593,91.6
34330, 부여군,070004, 68세,2016,988,469,519,90.4,985,467,518,90.2
34330, 부여군,070005, 69세,2016,979,463,516,89.7,978,463,515,89.9
34330, 부여군,075,70~74세,2016,4488,2037,2451,83.1,4478,2032,2446,83.1
34330, 부여군,075001, 70세,2016,696,352,344,102.3,692,350,342,102.3
34330, 부여군,075002, 71세,2016,852,413,439,94.1,849,411,438,93.8
34330, 부여군,075003, 72세,2016,877,367,510,72,876,366,510,71.8
34330, 부여군,075004, 73세,2016,914,412,502,82.1,914,412,502,82.1
34330, 부여군,075005, 74세,2016,1149,493,656,75.2,1147,493,654,75.4
34330, 부여군,080,75~79세,2016,4655,1856,2799,66.3,4650,1856,2794,66.4
34330, 부여군,080001, 75세,2016,966,408,558,73.1,965,408,557,73.2
34330, 부여군,080002, 76세,2016,893,371,522,71.1,893,371,522,71.1
34330, 부여군,080003, 77세,2016,998,384,614,62.5,997,384,613,62.6
34330, 부여군,080004, 78세,2016,905,340,565,60.2,903,340,563,60.4
34330, 부여군,080005, 79세,2016,893,353,540,65.4,892,353,539,65.5
34330, 부여군,085,80~84세,2016,3582,1322,2260,58.5,3581,1322,2259,58.5
34330, 부여군,085001, 80세,2016,845,336,509,66,845,336,509,66
34330, 부여군,085002, 81세,2016,863,302,561,53.8,863,302,561,53.8
34330, 부여군,085003, 82세,2016,704,264,440,60,704,264,440,60
34330, 부여군,085004, 83세,2016,594,218,376,58,593,218,375,58.1
34330, 부여군,085005, 84세,2016,576,202,374,54,576,202,374,54
34330, 부여군,090,85~89세,2016,1600,495,1105,44.8,1598,495,1103,44.9
34330, 부여군,090001, 85세,2016,401,122,279,43.7,401,122,279,43.7
34330, 부여군,090002, 86세,2016,372,134,238,56.3,371,134,237,56.5
34330, 부여군,090003, 87세,2016,296,90,206,43.7,295,90,205,43.9
34330, 부여군,090004, 88세,2016,306,101,205,49.3,306,101,205,49.3
34330, 부여군,090005, 89세,2016,225,48,177,27.1,225,48,177,27.1
34330, 부여군,095,90~94세,2016,533,109,424,25.7,533,109,424,25.7
34330, 부여군,095001, 90세,2016,190,45,145,31,190,45,145,31
34330, 부여군,095002, 91세,2016,134,26,108,24.1,134,26,108,24.1
34330, 부여군,095003, 92세,2016,74,18,56,32.1,74,18,56,32.1
34330, 부여군,095004, 93세,2016,84,12,72,16.7,84,12,72,16.7
34330, 부여군,095005, 94세,2016,51,8,43,18.6,51,8,43,18.6
34330, 부여군,100,95~99세,2016,103,14,89,15.7,102,13,89,14.6
34330, 부여군,100001, 95세,2016,45,11,34,32.4,45,11,34,32.4
34330, 부여군,100002, 96세,2016,22,X,21,4.8,21,X,21,0
34330, 부여군,100003, 97세,2016,16,X,15,6.7,16,X,15,6.7
34330, 부여군,100004, 98세,2016,12,X,12,0,12,X,12,0
34330, 부여군,100005, 99세,2016,8,X,7,14.3,8,X,7,14.3
34330, 부여군,101,100세이상,2016,12,X,10,20,12,X,10,20
34330, 부여군,102,15세미만,2016,6103,3203,2900,110.4,6080,3191,2889,110.5
34330, 부여군,103,15~64세,2016,41951,22272,19679,113.2,40327,21375,18952,112.8
34330, 부여군,104,65세이상,2016,20098,8301,11797,70.4,20064,8286,11778,70.4
34330, 부여군,086,85세이상,2016,2248,620,1628,38.1,2245,619,1626,38.1
34330, 부여군,126,평균연령,2016,50,47.6,52.5,,50.4,47.9,52.8,
34330, 부여군,127,중위연령,2016,53.9,50.8,56.4,,54.5,51.5,56.8,
34340, 서천군,000,합계,2016,53880,26727,27153,98.4,52357,25646,26711,96
34340, 서천군,005,0~4세,2016,1335,664,671,99,1330,662,668,99.1
34340, 서천군,005001, 0세,2016,233,118,115,102.6,233,118,115,102.6
34340, 서천군,005002, 1세,2016,239,117,122,95.9,237,117,120,97.5
34340, 서천군,005003, 2세,2016,276,144,132,109.1,274,142,132,107.6
34340, 서천군,005004, 3세,2016,278,132,146,90.4,277,132,145,91
34340, 서천군,005005, 4세,2016,309,153,156,98.1,309,153,156,98.1
34340, 서천군,010,5~9세,2016,1559,788,771,102.2,1550,785,765,102.6
34340, 서천군,010001, 5세,2016,316,167,149,112.1,315,167,148,112.8
34340, 서천군,010002, 6세,2016,310,150,160,93.8,308,150,158,94.9
34340, 서천군,010003, 7세,2016,284,150,134,111.9,284,150,134,111.9
34340, 서천군,010004, 8세,2016,332,165,167,98.8,329,163,166,98.2
34340, 서천군,010005, 9세,2016,317,156,161,96.9,314,155,159,97.5
34340, 서천군,015,10~14세,2016,1775,902,873,103.3,1769,898,871,103.1
34340, 서천군,015001, 10세,2016,312,162,150,108,311,162,149,108.7
34340, 서천군,015002, 11세,2016,336,166,170,97.6,335,165,170,97.1
34340, 서천군,015003, 12세,2016,334,159,175,90.9,332,158,174,90.8
34340, 서천군,015004, 13세,2016,410,205,205,100,410,205,205,100
34340, 서천군,015005, 14세,2016,383,210,173,121.4,381,208,173,120.2
34340, 서천군,020,15~19세,2016,2511,1340,1171,114.4,2501,1335,1166,114.5
34340, 서천군,020001, 15세,2016,493,250,243,102.9,490,249,241,103.3
34340, 서천군,020002, 16세,2016,563,289,274,105.5,562,288,274,105.1
34340, 서천군,020003, 17세,2016,583,302,281,107.5,581,301,280,107.5
34340, 서천군,020004, 18세,2016,545,309,236,130.9,545,309,236,130.9
34340, 서천군,020005, 19세,2016,327,190,137,138.7,323,188,135,139.3
34340, 서천군,025,20~24세,2016,2249,1393,856,162.7,2064,1254,810,154.8
34340, 서천군,025001, 20세,2016,408,268,140,191.4,400,264,136,194.1
34340, 서천군,025002, 21세,2016,478,314,164,191.5,458,297,161,184.5
34340, 서천군,025003, 22세,2016,442,277,165,167.9,405,248,157,158
34340, 서천군,025004, 23세,2016,470,273,197,138.6,420,238,182,130.8
34340, 서천군,025005, 24세,2016,451,261,190,137.4,381,207,174,119
34340, 서천군,030,25~29세,2016,2110,1273,837,152.1,1747,1000,747,133.9
34340, 서천군,030001, 25세,2016,454,257,197,130.5,383,210,173,121.4
34340, 서천군,030002, 26세,2016,424,256,168,152.4,352,204,148,137.8
34340, 서천군,030003, 27세,2016,433,258,175,147.4,352,190,162,117.3
34340, 서천군,030004, 28세,2016,387,238,149,159.7,313,179,134,133.6
34340, 서천군,030005, 29세,2016,412,264,148,178.4,347,217,130,166.9
34340, 서천군,035,30~34세,2016,2154,1250,904,138.3,1886,1056,830,127.2
34340, 서천군,035001, 30세,2016,413,242,171,141.5,351,197,154,127.9
34340, 서천군,035002, 31세,2016,394,240,154,155.8,332,195,137,142.3
34340, 서천군,035003, 32세,2016,419,226,193,117.1,368,191,177,107.9
34340, 서천군,035004, 33세,2016,453,263,190,138.4,407,230,177,129.9
34340, 서천군,035005, 34세,2016,475,279,196,142.3,428,243,185,131.4
34340, 서천군,040,35~39세,2016,2560,1431,1129,126.7,2342,1260,1082,116.5
34340, 서천군,040001, 35세,2016,527,300,227,132.2,477,259,218,118.8
34340, 서천군,040002, 36세,2016,522,295,227,130,474,256,218,117.4
34340, 서천군,040003, 37세,2016,503,275,228,120.6,461,246,215,114.4
34340, 서천군,040004, 38세,2016,493,281,212,132.5,449,246,203,121.2
34340, 서천군,040005, 39세,2016,515,280,235,119.1,481,253,228,111
34340, 서천군,045,40~44세,2016,2995,1680,1315,127.8,2818,1550,1268,122.2
34340, 서천군,045001, 40세,2016,565,345,220,156.8,524,313,211,148.3
34340, 서천군,045002, 41세,2016,541,296,245,120.8,500,264,236,111.9
34340, 서천군,045003, 42세,2016,623,324,299,108.4,590,300,290,103.4
34340, 서천군,045004, 43세,2016,629,356,273,130.4,590,331,259,127.8
34340, 서천군,045005, 44세,2016,637,359,278,129.1,614,342,272,125.7
34340, 서천군,050,45~49세,2016,3776,2070,1706,121.3,3647,1983,1664,119.2
34340, 서천군,050001, 45세,2016,790,448,342,131,757,420,337,124.6
34340, 서천군,050002, 46세,2016,742,413,329,125.5,711,396,315,125.7
34340, 서천군,050003, 47세,2016,765,428,337,127,737,409,328,124.7
34340, 서천군,050004, 48세,2016,734,378,356,106.2,716,367,349,105.2
34340, 서천군,050005, 49세,2016,745,403,342,117.8,726,391,335,116.7
34340, 서천군,055,50~54세,2016,3954,2141,1813,118.1,3901,2111,1790,117.9
34340, 서천군,055001, 50세,2016,641,352,289,121.8,630,344,286,120.3
34340, 서천군,055002, 51세,2016,802,418,384,108.9,792,414,378,109.5
34340, 서천군,055003, 52세,2016,757,423,334,126.6,746,416,330,126.1
34340, 서천군,055004, 53세,2016,808,448,360,124.4,797,443,354,125.1
34340, 서천군,055005, 54세,2016,946,500,446,112.1,936,494,442,111.8
34340, 서천군,060,55~59세,2016,5077,2476,2601,95.2,5037,2461,2576,95.5
34340, 서천군,060001, 55세,2016,988,472,516,91.5,980,470,510,92.2
34340, 서천군,060002, 56세,2016,1086,521,565,92.2,1078,518,560,92.5
34340, 서천군,060003, 57세,2016,1041,517,524,98.7,1035,515,520,99
34340, 서천군,060004, 58세,2016,1011,486,525,92.6,1005,484,521,92.9
34340, 서천군,060005, 59세,2016,951,480,471,101.9,939,474,465,101.9
34340, 서천군,065,60~64세,2016,4784,2327,2457,94.7,4754,2309,2445,94.4
34340, 서천군,065001, 60세,2016,1004,513,491,104.5,998,509,489,104.1
34340, 서천군,065002, 61세,2016,1108,569,539,105.6,1102,564,538,104.8
34340, 서천군,065003, 62세,2016,1006,467,539,86.6,999,463,536,86.4
34340, 서천군,065004, 63세,2016,746,337,409,82.4,737,334,403,82.9
34340, 서천군,065005, 64세,2016,920,441,479,92.1,918,439,479,91.6
34340, 서천군,070,65~69세,2016,4487,2173,2314,93.9,4472,2167,2305,94
34340, 서천군,070001, 65세,2016,818,390,428,91.1,812,385,427,90.2
34340, 서천군,070002, 66세,2016,922,445,477,93.3,917,444,473,93.9
34340, 서천군,070003, 67세,2016,865,420,445,94.4,862,420,442,95
34340, 서천군,070004, 68세,2016,894,430,464,92.7,893,430,463,92.9
34340, 서천군,070005, 69세,2016,988,488,500,97.6,988,488,500,97.6
34340, 서천군,075,70~74세,2016,3792,1657,2135,77.6,3785,1655,2130,77.7
34340, 서천군,075001, 70세,2016,593,278,315,88.3,592,277,315,87.9
34340, 서천군,075002, 71세,2016,682,332,350,94.9,678,331,347,95.4
34340, 서천군,075003, 72세,2016,698,296,402,73.6,697,296,401,73.8
34340, 서천군,075004, 73세,2016,838,332,506,65.6,837,332,505,65.7
34340, 서천군,075005, 74세,2016,981,419,562,74.6,981,419,562,74.6
34340, 서천군,080,75~79세,2016,3907,1554,2353,66,3901,1552,2349,66.1
34340, 서천군,080001, 75세,2016,778,317,461,68.8,777,317,460,68.9
34340, 서천군,080002, 76세,2016,753,287,466,61.6,752,286,466,61.4
34340, 서천군,080003, 77세,2016,849,338,511,66.1,849,338,511,66.1
34340, 서천군,080004, 78세,2016,792,297,495,60,788,296,492,60.2
34340, 서천군,080005, 79세,2016,735,315,420,75,735,315,420,75
34340, 서천군,085,80~84세,2016,2952,1114,1838,60.6,2951,1114,1837,60.6
34340, 서천군,085001, 80세,2016,717,285,432,66,717,285,432,66
34340, 서천군,085002, 81세,2016,642,243,399,60.9,642,243,399,60.9
34340, 서천군,085003, 82세,2016,527,208,319,65.2,526,208,318,65.4
34340, 서천군,085004, 83세,2016,548,199,349,57,548,199,349,57
34340, 서천군,085005, 84세,2016,518,179,339,52.8,518,179,339,52.8
34340, 서천군,090,85~89세,2016,1389,385,1004,38.3,1388,385,1003,38.4
34340, 서천군,090001, 85세,2016,337,109,228,47.8,337,109,228,47.8
34340, 서천군,090002, 86세,2016,354,98,256,38.3,353,98,255,38.4
34340, 서천군,090003, 87세,2016,295,78,217,35.9,295,78,217,35.9
34340, 서천군,090004, 88세,2016,216,55,161,34.2,216,55,161,34.2
34340, 서천군,090005, 89세,2016,187,45,142,31.7,187,45,142,31.7
34340, 서천군,095,90~94세,2016,413,94,319,29.5,413,94,319,29.5
34340, 서천군,095001, 90세,2016,115,31,84,36.9,115,31,84,36.9
34340, 서천군,095002, 91세,2016,92,18,74,24.3,92,18,74,24.3
34340, 서천군,095003, 92세,2016,75,21,54,38.9,75,21,54,38.9
34340, 서천군,095004, 93세,2016,83,14,69,20.3,83,14,69,20.3
34340, 서천군,095005, 94세,2016,48,10,38,26.3,48,10,38,26.3
34340, 서천군,100,95~99세,2016,81,13,68,19.1,81,13,68,19.1
34340, 서천군,100001, 95세,2016,34,7,27,25.9,34,7,27,25.9
34340, 서천군,100002, 96세,2016,19,X,17,11.8,19,X,17,11.8
34340, 서천군,100003, 97세,2016,15,X,14,7.1,15,X,14,7.1
34340, 서천군,100004, 98세,2016,10,X,8,25,10,X,8,25
34340, 서천군,100005, 99세,2016,X,X,X,50,X,X,X,50
34340, 서천군,101,100세이상,2016,20,X,18,11.1,20,X,18,11.1
34340, 서천군,102,15세미만,2016,4669,2354,2315,101.7,4649,2345,2304,101.8
34340, 서천군,103,15~64세,2016,32170,17381,14789,117.5,30697,16319,14378,113.5
34340, 서천군,104,65세이상,2016,17041,6992,10049,69.6,17011,6982,10029,69.6
34340, 서천군,086,85세이상,2016,1903,494,1409,35.1,1902,494,1408,35.1
34340, 서천군,126,평균연령,2016,51.1,48.5,53.7,,51.6,49.1,54,
34340, 서천군,127,중위연령,2016,55,51.5,57.9,,55.6,52.7,58.2,
34350, 청양군,000,합계,2016,31440,15722,15718,100,30755,15382,15373,100.1
34350, 청양군,005,0~4세,2016,776,391,385,101.6,772,387,385,100.5
34350, 청양군,005001, 0세,2016,126,64,62,103.2,125,63,62,101.6
34350, 청양군,005002, 1세,2016,157,78,79,98.7,157,78,79,98.7
34350, 청양군,005003, 2세,2016,147,63,84,75,146,62,84,73.8
34350, 청양군,005004, 3세,2016,169,94,75,125.3,169,94,75,125.3
34350, 청양군,005005, 4세,2016,177,92,85,108.2,175,90,85,105.9
34350, 청양군,010,5~9세,2016,845,425,420,101.2,844,425,419,101.4
34350, 청양군,010001, 5세,2016,178,98,80,122.5,177,98,79,124.1
34350, 청양군,010002, 6세,2016,174,79,95,83.2,174,79,95,83.2
34350, 청양군,010003, 7세,2016,152,78,74,105.4,152,78,74,105.4
34350, 청양군,010004, 8세,2016,168,94,74,127,168,94,74,127
34350, 청양군,010005, 9세,2016,173,76,97,78.4,173,76,97,78.4
34350, 청양군,015,10~14세,2016,950,489,461,106.1,947,488,459,106.3
34350, 청양군,015001, 10세,2016,178,95,83,114.5,178,95,83,114.5
34350, 청양군,015002, 11세,2016,168,81,87,93.1,168,81,87,93.1
34350, 청양군,015003, 12세,2016,190,97,93,104.3,189,97,92,105.4
34350, 청양군,015004, 13세,2016,192,96,96,100,192,96,96,100
34350, 청양군,015005, 14세,2016,222,120,102,117.6,220,119,101,117.8
34350, 청양군,020,15~19세,2016,1665,855,810,105.6,1661,852,809,105.3
34350, 청양군,020001, 15세,2016,269,162,107,151.4,269,162,107,151.4
34350, 청양군,020002, 16세,2016,271,133,138,96.4,271,133,138,96.4
34350, 청양군,020003, 17세,2016,290,127,163,77.9,289,127,162,78.4
34350, 청양군,020004, 18세,2016,374,182,192,94.8,373,181,192,94.3
34350, 청양군,020005, 19세,2016,461,251,210,119.5,459,249,210,118.6
34350, 청양군,025,20~24세,2016,1612,936,676,138.5,1515,891,624,142.8
34350, 청양군,025001, 20세,2016,380,200,180,111.1,372,195,177,110.2
34350, 청양군,025002, 21세,2016,329,204,125,163.2,320,200,120,166.7
34350, 청양군,025003, 22세,2016,320,200,120,166.7,301,191,110,173.6
34350, 청양군,025004, 23세,2016,304,186,118,157.6,276,174,102,170.6
34350, 청양군,025005, 24세,2016,279,146,133,109.8,246,131,115,113.9
34350, 청양군,030,25~29세,2016,1323,748,575,130.1,1147,669,478,140
34350, 청양군,030001, 25세,2016,271,152,119,127.7,235,133,102,130.4
34350, 청양군,030002, 26세,2016,248,139,109,127.5,216,130,86,151.2
34350, 청양군,030003, 27세,2016,274,150,124,121,242,138,104,132.7
34350, 청양군,030004, 28세,2016,259,148,111,133.3,223,129,94,137.2
34350, 청양군,030005, 29세,2016,271,159,112,142,231,139,92,151.1
34350, 청양군,035,30~34세,2016,1219,711,508,140,1102,638,464,137.5
34350, 청양군,035001, 30세,2016,240,140,100,140,218,127,91,139.6
34350, 청양군,035002, 31세,2016,231,133,98,135.7,205,118,87,135.6
34350, 청양군,035003, 32세,2016,239,147,92,159.8,213,130,83,156.6
34350, 청양군,035004, 33세,2016,271,150,121,124,246,135,111,121.6
34350, 청양군,035005, 34세,2016,238,141,97,145.4,220,128,92,139.1
34350, 청양군,040,35~39세,2016,1315,753,562,134,1249,712,537,132.6
34350, 청양군,040001, 35세,2016,273,157,116,135.3,259,148,111,133.3
34350, 청양군,040002, 36세,2016,259,149,110,135.5,250,144,106,135.8
34350, 청양군,040003, 37세,2016,261,149,112,133,245,138,107,129
34350, 청양군,040004, 38세,2016,255,152,103,147.6,239,142,97,146.4
34350, 청양군,040005, 39세,2016,267,146,121,120.7,256,140,116,120.7
34350, 청양군,045,40~44세,2016,1653,955,698,136.8,1609,931,678,137.3
34350, 청양군,045001, 40세,2016,296,186,110,169.1,288,180,108,166.7
34350, 청양군,045002, 41세,2016,317,172,145,118.6,311,169,142,119
34350, 청양군,045003, 42세,2016,322,190,132,143.9,309,182,127,143.3
34350, 청양군,045004, 43세,2016,353,209,144,145.1,342,204,138,147.8
34350, 청양군,045005, 44세,2016,365,198,167,118.6,359,196,163,120.2
34350, 청양군,050,45~49세,2016,2038,1140,898,126.9,1987,1120,867,129.2
34350, 청양군,050001, 45세,2016,389,230,159,144.7,385,228,157,145.2
34350, 청양군,050002, 46세,2016,389,213,176,121,380,211,169,124.9
34350, 청양군,050003, 47세,2016,421,243,178,136.5,407,235,172,136.6
34350, 청양군,050004, 48세,2016,435,234,201,116.4,424,232,192,120.8
34350, 청양군,050005, 49세,2016,404,220,184,119.6,391,214,177,120.9
34350, 청양군,055,50~54세,2016,2323,1231,1092,112.7,2280,1215,1065,114.1
34350, 청양군,055001, 50세,2016,378,210,168,125,368,208,160,130
34350, 청양군,055002, 51세,2016,504,280,224,125,497,277,220,125.9
34350, 청양군,055003, 52세,2016,440,238,202,117.8,431,231,200,115.5
34350, 청양군,055004, 53세,2016,446,224,222,100.9,440,224,216,103.7
34350, 청양군,055005, 54세,2016,555,279,276,101.1,544,275,269,102.2
34350, 청양군,060,55~59세,2016,3092,1573,1519,103.6,3055,1557,1498,103.9
34350, 청양군,060001, 55세,2016,653,343,310,110.6,648,342,306,111.8
34350, 청양군,060002, 56세,2016,688,370,318,116.4,677,367,310,118.4
34350, 청양군,060003, 57세,2016,607,302,305,99,596,295,301,98
34350, 청양군,060004, 58세,2016,554,256,298,85.9,550,253,297,85.2
34350, 청양군,060005, 59세,2016,590,302,288,104.9,584,300,284,105.6
34350, 청양군,065,60~64세,2016,2677,1343,1334,100.7,2660,1339,1321,101.4
34350, 청양군,065001, 60세,2016,548,261,287,90.9,542,260,282,92.2
34350, 청양군,065002, 61세,2016,636,311,325,95.7,633,311,322,96.6
34350, 청양군,065003, 62세,2016,548,286,262,109.2,543,284,259,109.7
34350, 청양군,065004, 63세,2016,458,242,216,112,456,241,215,112.1
34350, 청양군,065005, 64세,2016,487,243,244,99.6,486,243,243,100
34350, 청양군,070,65~69세,2016,2401,1207,1194,101.1,2384,1198,1186,101
34350, 청양군,070001, 65세,2016,427,234,193,121.2,426,234,192,121.9
34350, 청양군,070002, 66세,2016,530,263,267,98.5,526,261,265,98.5
34350, 청양군,070003, 67세,2016,508,253,255,99.2,504,250,254,98.4
34350, 청양군,070004, 68세,2016,502,257,245,104.9,499,255,244,104.5
34350, 청양군,070005, 69세,2016,434,200,234,85.5,429,198,231,85.7
34350, 청양군,075,70~74세,2016,2186,957,1229,77.9,2184,956,1228,77.9
34350, 청양군,075001, 70세,2016,359,188,171,109.9,359,188,171,109.9
34350, 청양군,075002, 71세,2016,379,182,197,92.4,379,182,197,92.4
34350, 청양군,075003, 72세,2016,427,166,261,63.6,425,165,260,63.5
34350, 청양군,075004, 73세,2016,422,180,242,74.4,422,180,242,74.4
34350, 청양군,075005, 74세,2016,599,241,358,67.3,599,241,358,67.3
34350, 청양군,080,75~79세,2016,2393,955,1438,66.4,2388,952,1436,66.3
34350, 청양군,080001, 75세,2016,489,211,278,75.9,488,210,278,75.5
34350, 청양군,080002, 76세,2016,445,162,283,57.2,444,162,282,57.4
34350, 청양군,080003, 77세,2016,510,218,292,74.7,510,218,292,74.7
34350, 청양군,080004, 78세,2016,464,182,282,64.5,463,182,281,64.8
34350, 청양군,080005, 79세,2016,485,182,303,60.1,483,180,303,59.4
34350, 청양군,085,80~84세,2016,1933,748,1185,63.1,1932,747,1185,63
34350, 청양군,085001, 80세,2016,482,207,275,75.3,481,206,275,74.9
34350, 청양군,085002, 81세,2016,464,165,299,55.2,464,165,299,55.2
34350, 청양군,085003, 82세,2016,384,149,235,63.4,384,149,235,63.4
34350, 청양군,085004, 83세,2016,314,128,186,68.8,314,128,186,68.8
34350, 청양군,085005, 84세,2016,289,99,190,52.1,289,99,190,52.1
34350, 청양군,090,85~89세,2016,774,228,546,41.8,774,228,546,41.8
34350, 청양군,090001, 85세,2016,188,57,131,43.5,188,57,131,43.5
34350, 청양군,090002, 86세,2016,193,66,127,52,193,66,127,52
34350, 청양군,090003, 87세,2016,180,53,127,41.7,180,53,127,41.7
34350, 청양군,090004, 88세,2016,131,31,100,31,131,31,100,31
34350, 청양군,090005, 89세,2016,82,21,61,34.4,82,21,61,34.4
34350, 청양군,095,90~94세,2016,231,70,161,43.5,231,70,161,43.5
34350, 청양군,095001, 90세,2016,73,27,46,58.7,73,27,46,58.7
34350, 청양군,095002, 91세,2016,65,24,41,58.5,65,24,41,58.5
34350, 청양군,095003, 92세,2016,33,5,28,17.9,33,5,28,17.9
34350, 청양군,095004, 93세,2016,23,5,18,27.8,23,5,18,27.8
34350, 청양군,095005, 94세,2016,37,9,28,32.1,37,9,28,32.1
34350, 청양군,100,95~99세,2016,25,7,18,38.9,25,7,18,38.9
34350, 청양군,100001, 95세,2016,10,X,7,42.9,10,X,7,42.9
34350, 청양군,100002, 96세,2016,7,X,X,75,7,X,X,75
34350, 청양군,100003, 97세,2016,X,X,X,0,X,X,X,0
34350, 청양군,100004, 98세,2016,5,X,X,25,5,X,X,25
34350, 청양군,100005, 99세,2016,X,X,X,,X,X,X,
34350, 청양군,101,100세이상,2016,9,X,9,0,9,X,9,0
34350, 청양군,102,15세미만,2016,2571,1305,1266,103.1,2563,1300,1263,102.9
34350, 청양군,103,15~64세,2016,18917,10245,8672,118.1,18265,9924,8341,119
34350, 청양군,104,65세이상,2016,9952,4172,5780,72.2,9927,4158,5769,72.1
34350, 청양군,086,85세이상,2016,1039,305,734,41.6,1039,305,734,41.6
34350, 청양군,126,평균연령,2016,51,48.7,53.3,,51.3,49,53.7,
34350, 청양군,127,중위연령,2016,55,51.9,57.5,,55.4,52.4,57.9,
34360, 홍성군,000,합계,2016,100739,50375,50364,100,98267,48742,49525,98.4
34360, 홍성군,005,0~4세,2016,4054,2112,1942,108.8,4039,2101,1938,108.4
34360, 홍성군,005001, 0세,2016,711,364,347,104.9,708,361,347,104
34360, 홍성군,005002, 1세,2016,811,407,404,100.7,809,405,404,100.2
34360, 홍성군,005003, 2세,2016,794,426,368,115.8,790,424,366,115.8
34360, 홍성군,005004, 3세,2016,836,440,396,111.1,832,437,395,110.6
34360, 홍성군,005005, 4세,2016,902,475,427,111.2,900,474,426,111.3
34360, 홍성군,010,5~9세,2016,4576,2310,2266,101.9,4556,2301,2255,102
34360, 홍성군,010001, 5세,2016,909,470,439,107.1,902,467,435,107.4
34360, 홍성군,010002, 6세,2016,894,444,450,98.7,891,442,449,98.4
34360, 홍성군,010003, 7세,2016,911,463,448,103.3,906,461,445,103.6
34360, 홍성군,010004, 8세,2016,915,461,454,101.5,911,459,452,101.5
34360, 홍성군,010005, 9세,2016,947,472,475,99.4,946,472,474,99.6
34360, 홍성군,015,10~14세,2016,4460,2302,2158,106.7,4451,2297,2154,106.6
34360, 홍성군,015001, 10세,2016,850,445,405,109.9,848,445,403,110.4
34360, 홍성군,015002, 11세,2016,819,408,411,99.3,819,408,411,99.3
34360, 홍성군,015003, 12세,2016,936,478,458,104.4,932,476,456,104.4
34360, 홍성군,015004, 13세,2016,946,503,443,113.5,946,503,443,113.5
34360, 홍성군,015005, 14세,2016,909,468,441,106.1,906,465,441,105.4
34360, 홍성군,020,15~19세,2016,6584,3354,3230,103.8,6556,3342,3214,104
34360, 홍성군,020001, 15세,2016,1091,582,509,114.3,1090,581,509,114.1
34360, 홍성군,020002, 16세,2016,1323,711,612,116.2,1321,710,611,116.2
34360, 홍성군,020003, 17세,2016,1154,635,519,122.4,1153,634,519,122.2
34360, 홍성군,020004, 18세,2016,1304,641,663,96.7,1298,637,661,96.4
34360, 홍성군,020005, 19세,2016,1712,785,927,84.7,1694,780,914,85.3
34360, 홍성군,025,20~24세,2016,6790,3593,3197,112.4,6464,3395,3069,110.6
34360, 홍성군,025001, 20세,2016,1491,659,832,79.2,1468,648,820,79
34360, 홍성군,025002, 21세,2016,1442,716,726,98.6,1387,688,699,98.4
34360, 홍성군,025003, 22세,2016,1431,788,643,122.6,1359,738,621,118.8
34360, 홍성군,025004, 23세,2016,1195,702,493,142.4,1114,654,460,142.2
34360, 홍성군,025005, 24세,2016,1231,728,503,144.7,1136,667,469,142.2
34360, 홍성군,030,25~29세,2016,4869,2746,2123,129.3,4374,2377,1997,119
34360, 홍성군,030001, 25세,2016,1077,621,456,136.2,985,557,428,130.1
34360, 홍성군,030002, 26세,2016,965,531,434,122.4,858,460,398,115.6
34360, 홍성군,030003, 27세,2016,923,534,389,137.3,816,453,363,124.8
34360, 홍성군,030004, 28세,2016,978,538,440,122.3,883,464,419,110.7
34360, 홍성군,030005, 29세,2016,926,522,404,129.2,832,443,389,113.9
34360, 홍성군,035,30~34세,2016,5578,2986,2592,115.2,5133,2652,2481,106.9
34360, 홍성군,035001, 30세,2016,996,555,441,125.9,886,476,410,116.1
34360, 홍성군,035002, 31세,2016,1046,555,491,113,938,470,468,100.4
34360, 홍성군,035003, 32세,2016,1078,590,488,120.9,1003,530,473,112.1
34360, 홍성군,035004, 33세,2016,1167,649,518,125.3,1088,589,499,118
34360, 홍성군,035005, 34세,2016,1291,637,654,97.4,1218,587,631,93
34360, 홍성군,040,35~39세,2016,6516,3412,3104,109.9,6234,3203,3031,105.7
34360, 홍성군,040001, 35세,2016,1328,724,604,119.9,1256,677,579,116.9
34360, 홍성군,040002, 36세,2016,1369,714,655,109,1301,660,641,103
34360, 홍성군,040003, 37세,2016,1278,646,632,102.2,1228,605,623,97.1
34360, 홍성군,040004, 38세,2016,1273,652,621,105,1225,615,610,100.8
34360, 홍성군,040005, 39세,2016,1268,676,592,114.2,1224,646,578,111.8
34360, 홍성군,045,40~44세,2016,7169,3804,3365,113,6981,3679,3302,111.4
34360, 홍성군,045001, 40세,2016,1270,649,621,104.5,1228,622,606,102.6
34360, 홍성군,045002, 41세,2016,1383,699,684,102.2,1354,676,678,99.7
34360, 홍성군,045003, 42세,2016,1519,811,708,114.5,1481,787,694,113.4
34360, 홍성군,045004, 43세,2016,1502,806,696,115.8,1469,785,684,114.8
34360, 홍성군,045005, 44세,2016,1495,839,656,127.9,1449,809,640,126.4
34360, 홍성군,050,45~49세,2016,7587,4061,3526,115.2,7388,3941,3447,114.3
34360, 홍성군,050001, 45세,2016,1550,857,693,123.7,1511,830,681,121.9
34360, 홍성군,050002, 46세,2016,1512,818,694,117.9,1472,793,679,116.8
34360, 홍성군,050003, 47세,2016,1535,822,713,115.3,1491,794,697,113.9
34360, 홍성군,050004, 48세,2016,1557,830,727,114.2,1516,809,707,114.4
34360, 홍성군,050005, 49세,2016,1433,734,699,105,1398,715,683,104.7
34360, 홍성군,055,50~54세,2016,7405,3787,3618,104.7,7231,3703,3528,105
34360, 홍성군,055001, 50세,2016,1254,635,619,102.6,1227,622,605,102.8
34360, 홍성군,055002, 51세,2016,1568,806,762,105.8,1523,785,738,106.4
34360, 홍성군,055003, 52세,2016,1432,723,709,102,1405,712,693,102.7
34360, 홍성군,055004, 53세,2016,1525,785,740,106.1,1485,762,723,105.4
34360, 홍성군,055005, 54세,2016,1626,838,788,106.3,1591,822,769,106.9
34360, 홍성군,060,55~59세,2016,8042,4104,3938,104.2,7913,4033,3880,103.9
34360, 홍성군,060001, 55세,2016,1815,922,893,103.2,1797,912,885,103.1
34360, 홍성군,060002, 56세,2016,1795,906,889,101.9,1762,882,880,100.2
34360, 홍성군,060003, 57세,2016,1521,790,731,108.1,1498,784,714,109.8
34360, 홍성군,060004, 58세,2016,1453,730,723,101,1424,715,709,100.8
34360, 홍성군,060005, 59세,2016,1458,756,702,107.7,1432,740,692,106.9
34360, 홍성군,065,60~64세,2016,6590,3190,3400,93.8,6504,3146,3358,93.7
34360, 홍성군,065001, 60세,2016,1422,685,737,92.9,1400,673,727,92.6
34360, 홍성군,065002, 61세,2016,1519,750,769,97.5,1498,739,759,97.4
34360, 홍성군,065003, 62세,2016,1352,670,682,98.2,1334,662,672,98.5
34360, 홍성군,065004, 63세,2016,1086,527,559,94.3,1070,519,551,94.2
34360, 홍성군,065005, 64세,2016,1211,558,653,85.5,1202,553,649,85.2
34360, 홍성군,070,65~69세,2016,5665,2739,2926,93.6,5619,2710,2909,93.2
34360, 홍성군,070001, 65세,2016,1099,539,560,96.3,1087,532,555,95.9
34360, 홍성군,070002, 66세,2016,1113,511,602,84.9,1103,505,598,84.4
34360, 홍성군,070003, 67세,2016,1294,643,651,98.8,1285,637,648,98.3
34360, 홍성군,070004, 68세,2016,1109,534,575,92.9,1102,530,572,92.7
34360, 홍성군,070005, 69세,2016,1050,512,538,95.2,1042,506,536,94.4
34360, 홍성군,075,70~74세,2016,4713,2117,2596,81.5,4699,2109,2590,81.4
34360, 홍성군,075001, 70세,2016,811,415,396,104.8,804,411,393,104.6
34360, 홍성군,075002, 71세,2016,761,366,395,92.7,758,365,393,92.9
34360, 홍성군,075003, 72세,2016,936,400,536,74.6,934,398,536,74.3
34360, 홍성군,075004, 73세,2016,967,404,563,71.8,967,404,563,71.8
34360, 홍성군,075005, 74세,2016,1238,532,706,75.4,1236,531,705,75.3
34360, 홍성군,080,75~79세,2016,4578,1831,2747,66.7,4569,1827,2742,66.6
34360, 홍성군,080001, 75세,2016,935,380,555,68.5,933,379,554,68.4
34360, 홍성군,080002, 76세,2016,840,329,511,64.4,837,327,510,64.1
34360, 홍성군,080003, 77세,2016,995,417,578,72.1,994,417,577,72.3
34360, 홍성군,080004, 78세,2016,972,379,593,63.9,971,378,593,63.7
34360, 홍성군,080005, 79세,2016,836,326,510,63.9,834,326,508,64.2
34360, 홍성군,085,80~84세,2016,3588,1352,2236,60.5,3585,1352,2233,60.5
34360, 홍성군,085001, 80세,2016,929,366,563,65,929,366,563,65
34360, 홍성군,085002, 81세,2016,811,311,500,62.2,810,311,499,62.3
34360, 홍성군,085003, 82세,2016,703,274,429,63.9,702,274,428,64
34360, 홍성군,085004, 83세,2016,583,187,396,47.2,582,187,395,47.3
34360, 홍성군,085005, 84세,2016,562,214,348,61.5,562,214,348,61.5
34360, 홍성군,090,85~89세,2016,1419,452,967,46.7,1417,452,965,46.8
34360, 홍성군,090001, 85세,2016,366,115,251,45.8,365,115,250,46
34360, 홍성군,090002, 86세,2016,343,114,229,49.8,343,114,229,49.8
34360, 홍성군,090003, 87세,2016,297,93,204,45.6,297,93,204,45.6
34360, 홍성군,090004, 88세,2016,242,84,158,53.2,241,84,157,53.5
34360, 홍성군,090005, 89세,2016,171,46,125,36.8,171,46,125,36.8
34360, 홍성군,095,90~94세,2016,475,109,366,29.8,473,108,365,29.6
34360, 홍성군,095001, 90세,2016,139,38,101,37.6,139,38,101,37.6
34360, 홍성군,095002, 91세,2016,101,30,71,42.3,100,29,71,40.8
34360, 홍성군,095003, 92세,2016,85,16,69,23.2,85,16,69,23.2
34360, 홍성군,095004, 93세,2016,93,17,76,22.4,92,17,75,22.7
34360, 홍성군,095005, 94세,2016,57,8,49,16.3,57,8,49,16.3
34360, 홍성군,100,95~99세,2016,72,13,59,22,72,13,59,22
34360, 홍성군,100001, 95세,2016,27,7,20,35,27,7,20,35
34360, 홍성군,100002, 96세,2016,14,X,11,27.3,14,X,11,27.3
34360, 홍성군,100003, 97세,2016,14,X,13,7.7,14,X,13,7.7
34360, 홍성군,100004, 98세,2016,11,X,9,22.2,11,X,9,22.2
34360, 홍성군,100005, 99세,2016,6,X,6,0,6,X,6,0
34360, 홍성군,101,100세이상,2016,9,X,8,12.5,9,X,8,12.5
34360, 홍성군,102,15세미만,2016,13090,6724,6366,105.6,13046,6699,6347,105.5
34360, 홍성군,103,15~64세,2016,67130,35037,32093,109.2,64778,33471,31307,106.9
34360, 홍성군,104,65세이상,2016,20519,8614,11905,72.4,20443,8572,11871,72.2
34360, 홍성군,086,85세이상,2016,1975,575,1400,41.1,1971,574,1397,41.1
34360, 홍성군,126,평균연령,2016,43.7,42.1,45.3,,43.9,42.3,45.4,
34360, 홍성군,127,중위연령,2016,44.8,43.3,46.7,,45.2,43.8,46.9,
34370, 예산군,000,합계,2016,79425,40161,39264,102.3,76935,38524,38411,100.3
34370, 예산군,005,0~4세,2016,1979,1019,960,106.1,1963,1008,955,105.5
34370, 예산군,005001, 0세,2016,315,160,155,103.2,313,158,155,101.9
34370, 예산군,005002, 1세,2016,384,213,171,124.6,379,209,170,122.9
34370, 예산군,005003, 2세,2016,374,184,190,96.8,371,182,189,96.3
34370, 예산군,005004, 3세,2016,428,205,223,91.9,423,202,221,91.4
34370, 예산군,005005, 4세,2016,478,257,221,116.3,477,257,220,116.8
34370, 예산군,010,5~9세,2016,2511,1319,1192,110.7,2504,1316,1188,110.8
34370, 예산군,010001, 5세,2016,484,255,229,111.4,482,254,228,111.4
34370, 예산군,010002, 6세,2016,487,252,235,107.2,485,252,233,108.2
34370, 예산군,010003, 7세,2016,460,243,217,112,459,242,217,111.5
34370, 예산군,010004, 8세,2016,484,243,241,100.8,483,243,240,101.3
34370, 예산군,010005, 9세,2016,596,326,270,120.7,595,325,270,120.4
34370, 예산군,015,10~14세,2016,2705,1372,1333,102.9,2698,1369,1329,103
34370, 예산군,015001, 10세,2016,509,239,270,88.5,507,238,269,88.5
34370, 예산군,015002, 11세,2016,499,259,240,107.9,496,257,239,107.5
34370, 예산군,015003, 12세,2016,518,275,243,113.2,518,275,243,113.2
34370, 예산군,015004, 13세,2016,547,273,274,99.6,545,273,272,100.4
34370, 예산군,015005, 14세,2016,632,326,306,106.5,632,326,306,106.5
34370, 예산군,020,15~19세,2016,4083,2127,1956,108.7,4073,2120,1953,108.6
34370, 예산군,020001, 15세,2016,745,384,361,106.4,744,383,361,106.1
34370, 예산군,020002, 16세,2016,794,402,392,102.6,791,399,392,101.8
34370, 예산군,020003, 17세,2016,895,483,412,117.2,895,483,412,117.2
34370, 예산군,020004, 18세,2016,861,452,409,110.5,861,452,409,110.5
34370, 예산군,020005, 19세,2016,788,406,382,106.3,782,403,379,106.3
34370, 예산군,025,20~24세,2016,4387,2454,1933,127,4147,2294,1853,123.8
34370, 예산군,025001, 20세,2016,934,488,446,109.4,913,476,437,108.9
34370, 예산군,025002, 21세,2016,912,544,368,147.8,882,519,363,143
34370, 예산군,025003, 22세,2016,811,438,373,117.4,778,416,362,114.9
34370, 예산군,025004, 23세,2016,873,480,393,122.1,809,435,374,116.3
34370, 예산군,025005, 24세,2016,857,504,353,142.8,765,448,317,141.3
34370, 예산군,030,25~29세,2016,3635,2153,1482,145.3,3127,1796,1331,134.9
34370, 예산군,030001, 25세,2016,774,451,323,139.6,689,395,294,134.4
34370, 예산군,030002, 26세,2016,787,479,308,155.5,673,399,274,145.6
34370, 예산군,030003, 27세,2016,667,410,257,159.5,579,346,233,148.5
34370, 예산군,030004, 28세,2016,697,404,293,137.9,590,327,263,124.3
34370, 예산군,030005, 29세,2016,710,409,301,135.9,596,329,267,123.2
34370, 예산군,035,30~34세,2016,3551,2104,1447,145.4,3096,1783,1313,135.8
34370, 예산군,035001, 30세,2016,668,414,254,163,567,340,227,149.8
34370, 예산군,035002, 31세,2016,672,389,283,137.5,583,331,252,131.3
34370, 예산군,035003, 32세,2016,697,411,286,143.7,607,351,256,137.1
34370, 예산군,035004, 33세,2016,743,443,300,147.7,651,374,277,135
34370, 예산군,035005, 34세,2016,771,447,324,138,688,387,301,128.6
34370, 예산군,040,35~39세,2016,4008,2252,1756,128.2,3665,2002,1663,120.4
34370, 예산군,040001, 35세,2016,790,454,336,135.1,710,394,316,124.7
34370, 예산군,040002, 36세,2016,861,481,380,126.6,786,421,365,115.3
34370, 예산군,040003, 37세,2016,780,428,352,121.6,714,385,329,117
34370, 예산군,040004, 38세,2016,764,425,339,125.4,706,387,319,121.3
34370, 예산군,040005, 39세,2016,813,464,349,133,749,415,334,124.3
34370, 예산군,045,40~44세,2016,4980,2787,2193,127.1,4738,2620,2118,123.7
34370, 예산군,045001, 40세,2016,889,511,378,135.2,834,468,366,127.9
34370, 예산군,045002, 41세,2016,927,522,405,128.9,872,485,387,125.3
34370, 예산군,045003, 42세,2016,1050,560,490,114.3,1009,532,477,111.5
34370, 예산군,045004, 43세,2016,1106,634,472,134.3,1057,603,454,132.8
34370, 예산군,045005, 44세,2016,1008,560,448,125,966,532,434,122.6
34370, 예산군,050,45~49세,2016,5836,3251,2585,125.8,5626,3117,2509,124.2
34370, 예산군,050001, 45세,2016,1123,631,492,128.3,1071,597,474,125.9
34370, 예산군,050002, 46세,2016,1132,630,502,125.5,1095,607,488,124.4
34370, 예산군,050003, 47세,2016,1224,701,523,134,1184,676,508,133.1
34370, 예산군,050004, 48세,2016,1251,671,580,115.7,1202,636,566,112.4
34370, 예산군,050005, 49세,2016,1106,618,488,126.6,1074,601,473,127.1
34370, 예산군,055,50~54세,2016,6255,3251,3004,108.2,6044,3141,2903,108.2
34370, 예산군,055001, 50세,2016,1053,551,502,109.8,1012,526,486,108.2
34370, 예산군,055002, 51세,2016,1304,675,629,107.3,1261,660,601,109.8
34370, 예산군,055003, 52세,2016,1208,651,557,116.9,1171,634,537,118.1
34370, 예산군,055004, 53세,2016,1209,614,595,103.2,1169,590,579,101.9
34370, 예산군,055005, 54세,2016,1481,760,721,105.4,1431,731,700,104.4
34370, 예산군,060,55~59세,2016,7821,3871,3950,98,7709,3814,3895,97.9
34370, 예산군,060001, 55세,2016,1761,888,873,101.7,1749,881,868,101.5
34370, 예산군,060002, 56세,2016,1727,816,911,89.6,1700,801,899,89.1
34370, 예산군,060003, 57세,2016,1436,706,730,96.7,1412,694,718,96.7
34370, 예산군,060004, 58세,2016,1457,728,729,99.9,1429,715,714,100.1
34370, 예산군,060005, 59세,2016,1440,733,707,103.7,1419,723,696,103.9
34370, 예산군,065,60~64세,2016,6634,3316,3318,99.9,6563,3281,3282,100
34370, 예산군,065001, 60세,2016,1401,733,668,109.7,1378,726,652,111.3
34370, 예산군,065002, 61세,2016,1514,761,753,101.1,1497,753,744,101.2
34370, 예산군,065003, 62세,2016,1339,654,685,95.5,1329,649,680,95.4
34370, 예산군,065004, 63세,2016,1098,537,561,95.7,1081,525,556,94.4
34370, 예산군,065005, 64세,2016,1282,631,651,96.9,1278,628,650,96.6
34370, 예산군,070,65~69세,2016,5680,2744,2936,93.5,5658,2733,2925,93.4
34370, 예산군,070001, 65세,2016,1034,467,567,82.4,1026,462,564,81.9
34370, 예산군,070002, 66세,2016,1201,570,631,90.3,1196,567,629,90.1
34370, 예산군,070003, 67세,2016,1176,581,595,97.6,1171,580,591,98.1
34370, 예산군,070004, 68세,2016,1145,563,582,96.7,1142,561,581,96.6
34370, 예산군,070005, 69세,2016,1124,563,561,100.4,1123,563,560,100.5
34370, 예산군,075,70~74세,2016,4868,2169,2699,80.4,4855,2163,2692,80.3
34370, 예산군,075001, 70세,2016,800,404,396,102,796,403,393,102.5
34370, 예산군,075002, 71세,2016,794,321,473,67.9,789,318,471,67.5
34370, 예산군,075003, 72세,2016,959,415,544,76.3,957,414,543,76.2
34370, 예산군,075004, 73세,2016,1002,468,534,87.6,1000,467,533,87.6
34370, 예산군,075005, 74세,2016,1313,561,752,74.6,1313,561,752,74.6
34370, 예산군,080,75~79세,2016,4899,2041,2858,71.4,4885,2038,2847,71.6
34370, 예산군,080001, 75세,2016,994,419,575,72.9,992,419,573,73.1
34370, 예산군,080002, 76세,2016,928,403,525,76.8,926,403,523,77.1
34370, 예산군,080003, 77세,2016,1026,419,607,69,1024,419,605,69.3
34370, 예산군,080004, 78세,2016,1019,408,611,66.8,1015,407,608,66.9
34370, 예산군,080005, 79세,2016,932,392,540,72.6,928,390,538,72.5
34370, 예산군,085,80~84세,2016,3662,1385,2277,60.8,3656,1384,2272,60.9
34370, 예산군,085001, 80세,2016,908,368,540,68.1,908,368,540,68.1
34370, 예산군,085002, 81세,2016,833,318,515,61.7,833,318,515,61.7
34370, 예산군,085003, 82세,2016,726,282,444,63.5,725,282,443,63.7
34370, 예산군,085004, 83세,2016,658,238,420,56.7,656,238,418,56.9
34370, 예산군,085005, 84세,2016,537,179,358,50,534,178,356,50
34370, 예산군,090,85~89세,2016,1425,429,996,43.1,1424,429,995,43.1
34370, 예산군,090001, 85세,2016,392,118,274,43.1,392,118,274,43.1
34370, 예산군,090002, 86세,2016,329,91,238,38.2,329,91,238,38.2
34370, 예산군,090003, 87세,2016,293,95,198,48,293,95,198,48
34370, 예산군,090004, 88세,2016,228,59,169,34.9,228,59,169,34.9
34370, 예산군,090005, 89세,2016,183,66,117,56.4,182,66,116,56.9
34370, 예산군,095,90~94세,2016,391,94,297,31.6,389,93,296,31.4
34370, 예산군,095001, 90세,2016,111,33,78,42.3,111,33,78,42.3
34370, 예산군,095002, 91세,2016,103,31,72,43.1,103,31,72,43.1
34370, 예산군,095003, 92세,2016,68,11,57,19.3,68,11,57,19.3
34370, 예산군,095004, 93세,2016,59,15,44,34.1,59,15,44,34.1
34370, 예산군,095005, 94세,2016,50,X,46,8.7,48,X,45,6.7
34370, 예산군,100,95~99세,2016,101,21,80,26.3,101,21,80,26.3
34370, 예산군,100001, 95세,2016,42,13,29,44.8,42,13,29,44.8
34370, 예산군,100002, 96세,2016,31,X,27,14.8,31,X,27,14.8
34370, 예산군,100003, 97세,2016,14,X,12,16.7,14,X,12,16.7
34370, 예산군,100004, 98세,2016,6,X,5,20,6,X,5,20
34370, 예산군,100005, 99세,2016,8,X,7,14.3,8,X,7,14.3
34370, 예산군,101,100세이상,2016,14,X,12,16.7,14,X,12,16.7
34370, 예산군,102,15세미만,2016,7195,3710,3485,106.5,7165,3693,3472,106.4
34370, 예산군,103,15~64세,2016,51190,27566,23624,116.7,48788,25968,22820,113.8
34370, 예산군,104,65세이상,2016,21040,8885,12155,73.1,20982,8863,12119,73.1
34370, 예산군,086,85세이상,2016,1931,546,1385,39.4,1928,545,1383,39.4
34370, 예산군,126,평균연령,2016,48.7,46.6,50.8,,49,47,51,
34370, 예산군,127,중위연령,2016,51.8,48.8,54.7,,52.5,49.7,55.1,
34380, 태안군,000,합계,2016,60641,30960,29681,104.3,59202,29941,29261,102.3
34380, 태안군,005,0~4세,2016,1811,890,921,96.6,1806,886,920,96.3
34380, 태안군,005001, 0세,2016,334,164,170,96.5,333,163,170,95.9
34380, 태안군,005002, 1세,2016,337,170,167,101.8,336,169,167,101.2
34380, 태안군,005003, 2세,2016,334,151,183,82.5,333,151,182,83
34380, 태안군,005004, 3세,2016,389,200,189,105.8,389,200,189,105.8
34380, 태안군,005005, 4세,2016,417,205,212,96.7,415,203,212,95.8
34380, 태안군,010,5~9세,2016,2077,1086,991,109.6,2073,1085,988,109.8
34380, 태안군,010001, 5세,2016,412,215,197,109.1,411,215,196,109.7
34380, 태안군,010002, 6세,2016,361,195,166,117.5,360,194,166,116.9
34380, 태안군,010003, 7세,2016,409,216,193,111.9,409,216,193,111.9
34380, 태안군,010004, 8세,2016,455,233,222,105,454,233,221,105.4
34380, 태안군,010005, 9세,2016,440,227,213,106.6,439,227,212,107.1
34380, 태안군,015,10~14세,2016,2196,1109,1087,102,2192,1106,1086,101.8
34380, 태안군,015001, 10세,2016,433,224,209,107.2,433,224,209,107.2
34380, 태안군,015002, 11세,2016,412,194,218,89,410,193,217,88.9
34380, 태안군,015003, 12세,2016,426,212,214,99.1,425,211,214,98.6
34380, 태안군,015004, 13세,2016,457,237,220,107.7,456,236,220,107.3
34380, 태안군,015005, 14세,2016,468,242,226,107.1,468,242,226,107.1
34380, 태안군,020,15~19세,2016,2818,1502,1316,114.1,2812,1497,1315,113.8
34380, 태안군,020001, 15세,2016,528,265,263,100.8,528,265,263,100.8
34380, 태안군,020002, 16세,2016,551,256,295,86.8,551,256,295,86.8
34380, 태안군,020003, 17세,2016,538,245,293,83.6,538,245,293,83.6
34380, 태안군,020004, 18세,2016,590,320,270,118.5,587,318,269,118.2
34380, 태안군,020005, 19세,2016,611,416,195,213.3,608,413,195,211.8
34380, 태안군,025,20~24세,2016,2823,1846,977,188.9,2672,1743,929,187.6
34380, 태안군,025001, 20세,2016,610,419,191,219.4,600,414,186,222.6
34380, 태안군,025002, 21세,2016,600,413,187,220.9,582,399,183,218
34380, 태안군,025003, 22세,2016,542,374,168,222.6,503,343,160,214.4
34380, 태안군,025004, 23세,2016,498,288,210,137.1,465,272,193,140.9
34380, 태안군,025005, 24세,2016,573,352,221,159.3,522,315,207,152.2
34380, 태안군,030,25~29세,2016,2560,1480,1080,137,2301,1299,1002,129.6
34380, 태안군,030001, 25세,2016,500,286,214,133.6,454,256,198,129.3
34380, 태안군,030002, 26세,2016,503,293,210,139.5,444,248,196,126.5
34380, 태안군,030003, 27세,2016,527,293,234,125.2,479,262,217,120.7
34380, 태안군,030004, 28세,2016,500,289,211,137,450,255,195,130.8
34380, 태안군,030005, 29세,2016,530,319,211,151.2,474,278,196,141.8
34380, 태안군,035,30~34세,2016,2899,1700,1199,141.8,2621,1491,1130,131.9
34380, 태안군,035001, 30세,2016,492,300,192,156.3,432,258,174,148.3
34380, 태안군,035002, 31세,2016,551,331,220,150.5,491,289,202,143.1
34380, 태안군,035003, 32세,2016,537,301,236,127.5,483,261,222,117.6
34380, 태안군,035004, 33세,2016,620,376,244,154.1,569,336,233,144.2
34380, 태안군,035005, 34세,2016,699,392,307,127.7,646,347,299,116.1
34380, 태안군,040,35~39세,2016,3512,2023,1489,135.9,3295,1842,1453,126.8
34380, 태안군,040001, 35세,2016,681,406,275,147.6,638,370,268,138.1
34380, 태안군,040002, 36세,2016,793,459,334,137.4,757,429,328,130.8
34380, 태안군,040003, 37세,2016,664,380,284,133.8,612,335,277,120.9
34380, 태안군,040004, 38세,2016,690,383,307,124.8,644,344,300,114.7
34380, 태안군,040005, 39세,2016,684,395,289,136.7,644,364,280,130
34380, 태안군,045,40~44세,2016,3778,2162,1616,133.8,3613,2035,1578,129
34380, 태안군,045001, 40세,2016,702,405,297,136.4,680,387,293,132.1
34380, 태안군,045002, 41세,2016,713,408,305,133.8,677,378,299,126.4
34380, 태안군,045003, 42세,2016,785,423,362,116.9,750,397,353,112.5
34380, 태안군,045004, 43세,2016,800,461,339,136,770,440,330,133.3
34380, 태안군,045005, 44세,2016,778,465,313,148.6,736,433,303,142.9
34380, 태안군,050,45~49세,2016,4294,2387,1907,125.2,4172,2305,1867,123.5
34380, 태안군,050001, 45세,2016,836,491,345,142.3,806,468,338,138.5
34380, 태안군,050002, 46세,2016,826,461,365,126.3,805,446,359,124.2
34380, 태안군,050003, 47세,2016,873,476,397,119.9,847,459,388,118.3
34380, 태안군,050004, 48세,2016,901,496,405,122.5,880,482,398,121.1
34380, 태안군,050005, 49세,2016,858,463,395,117.2,834,450,384,117.2
34380, 태안군,055,50~54세,2016,4756,2486,2270,109.5,4676,2440,2236,109.1
34380, 태안군,055001, 50세,2016,873,450,423,106.4,855,442,413,107
34380, 태안군,055002, 51세,2016,975,515,460,112,965,510,455,112.1
34380, 태안군,055003, 52세,2016,899,470,429,109.6,883,457,426,107.3
34380, 태안군,055004, 53세,2016,964,506,458,110.5,942,494,448,110.3
34380, 태안군,055005, 54세,2016,1045,545,500,109,1031,537,494,108.7
34380, 태안군,060,55~59세,2016,5927,2883,3044,94.7,5862,2848,3014,94.5
34380, 태안군,060001, 55세,2016,1257,623,634,98.3,1249,618,631,97.9
34380, 태안군,060002, 56세,2016,1260,636,624,101.9,1238,627,611,102.6
34380, 태안군,060003, 57세,2016,1137,535,602,88.9,1124,530,594,89.2
34380, 태안군,060004, 58세,2016,1176,580,596,97.3,1161,569,592,96.1
34380, 태안군,060005, 59세,2016,1097,509,588,86.6,1090,504,586,86
34380, 태안군,065,60~64세,2016,5199,2477,2722,91,5148,2450,2698,90.8
34380, 태안군,065001, 60세,2016,1131,532,599,88.8,1120,527,593,88.9
34380, 태안군,065002, 61세,2016,1095,516,579,89.1,1085,513,572,89.7
34380, 태안군,065003, 62세,2016,1007,486,521,93.3,997,479,518,92.5
34380, 태안군,065004, 63세,2016,939,434,505,85.9,929,430,499,86.2
34380, 태안군,065005, 64세,2016,1027,509,518,98.3,1017,501,516,97.1
34380, 태안군,070,65~69세,2016,4781,2399,2382,100.7,4764,2388,2376,100.5
34380, 태안군,070001, 65세,2016,840,417,423,98.6,834,412,422,97.6
34380, 태안군,070002, 66세,2016,993,520,473,109.9,988,518,470,110.2
34380, 태안군,070003, 67세,2016,1021,513,508,101,1016,510,506,100.8
34380, 태안군,070004, 68세,2016,952,448,504,88.9,951,447,504,88.7
34380, 태안군,070005, 69세,2016,975,501,474,105.7,975,501,474,105.7
34380, 태안군,075,70~74세,2016,4120,1934,2186,88.5,4110,1932,2178,88.7
34380, 태안군,075001, 70세,2016,713,380,333,114.1,712,380,332,114.5
34380, 태안군,075002, 71세,2016,718,349,369,94.6,717,349,368,94.8
34380, 태안군,075003, 72세,2016,824,384,440,87.3,820,383,437,87.6
34380, 태안군,075004, 73세,2016,825,357,468,76.3,824,356,468,76.1
34380, 태안군,075005, 74세,2016,1040,464,576,80.6,1037,464,573,81
34380, 태안군,080,75~79세,2016,3299,1388,1911,72.6,3296,1386,1910,72.6
34380, 태안군,080001, 75세,2016,682,290,392,74,681,289,392,73.7
34380, 태안군,080002, 76세,2016,662,275,387,71.1,661,274,387,70.8
34380, 태안군,080003, 77세,2016,733,305,428,71.3,732,305,427,71.4
34380, 태안군,080004, 78세,2016,650,279,371,75.2,650,279,371,75.2
34380, 태안군,080005, 79세,2016,572,239,333,71.8,572,239,333,71.8
34380, 태안군,085,80~84세,2016,2428,858,1570,54.6,2428,858,1570,54.6
34380, 태안군,085001, 80세,2016,590,224,366,61.2,590,224,366,61.2
34380, 태안군,085002, 81세,2016,550,195,355,54.9,550,195,355,54.9
34380, 태안군,085003, 82세,2016,443,149,294,50.7,443,149,294,50.7
34380, 태안군,085004, 83세,2016,458,155,303,51.2,458,155,303,51.2
34380, 태안군,085005, 84세,2016,387,135,252,53.6,387,135,252,53.6
34380, 태안군,090,85~89세,2016,947,266,681,39.1,946,266,680,39.1
34380, 태안군,090001, 85세,2016,256,83,173,48,256,83,173,48
34380, 태안군,090002, 86세,2016,200,54,146,37,199,54,145,37.2
34380, 태안군,090003, 87세,2016,188,42,146,28.8,188,42,146,28.8
34380, 태안군,090004, 88세,2016,180,57,123,46.3,180,57,123,46.3
34380, 태안군,090005, 89세,2016,123,30,93,32.3,123,30,93,32.3
34380, 태안군,095,90~94세,2016,346,69,277,24.9,346,69,277,24.9
34380, 태안군,095001, 90세,2016,93,20,73,27.4,93,20,73,27.4
34380, 태안군,095002, 91세,2016,97,19,78,24.4,97,19,78,24.4
34380, 태안군,095003, 92세,2016,68,14,54,25.9,68,14,54,25.9
34380, 태안군,095004, 93세,2016,46,11,35,31.4,46,11,35,31.4
34380, 태안군,095005, 94세,2016,42,5,37,13.5,42,5,37,13.5
34380, 태안군,100,95~99세,2016,67,15,52,28.8,66,15,51,29.4
34380, 태안군,100001, 95세,2016,23,7,16,43.8,22,7,15,46.7
34380, 태안군,100002, 96세,2016,20,X,17,17.6,20,X,17,17.6
34380, 태안군,100003, 97세,2016,6,X,X,100,6,X,X,100
34380, 태안군,100004, 98세,2016,7,X,7,0,7,X,7,0
34380, 태안군,100005, 99세,2016,11,X,9,22.2,11,X,9,22.2
34380, 태안군,101,100세이상,2016,X,X,X,0,X,X,X,0
34380, 태안군,102,15세미만,2016,6084,3085,2999,102.9,6071,3077,2994,102.8
34380, 태안군,103,15~64세,2016,38566,20946,17620,118.9,37172,19950,17222,115.8
34380, 태안군,104,65세이상,2016,15991,6929,9062,76.5,15959,6914,9045,76.4
34380, 태안군,086,85세이상,2016,1363,350,1013,34.6,1361,350,1011,34.6
34380, 태안군,126,평균연령,2016,48.4,46.3,50.7,,48.7,46.6,50.8,
34380, 태안군,127,중위연령,2016,51.7,48.5,55,,52.3,49.3,55.2,
35,전라북도,000,합계,2016,1833168,915493,917675,99.8,1801619,898232,903387,99.4
35,전라북도,005,0~4세,2016,73369,37751,35618,106,73054,37585,35469,106
35,전라북도,005001, 0세,2016,13080,6716,6364,105.5,13021,6682,6339,105.4
35,전라북도,005002, 1세,2016,14281,7311,6970,104.9,14221,7275,6946,104.7
35,전라북도,005003, 2세,2016,14410,7398,7012,105.5,14343,7368,6975,105.6
35,전라북도,005004, 3세,2016,15137,7908,7229,109.4,15071,7870,7201,109.3
35,전라북도,005005, 4세,2016,16461,8418,8043,104.7,16398,8390,8008,104.8
35,전라북도,010,5~9세,2016,80588,41516,39072,106.3,80342,41395,38947,106.3
35,전라북도,010001, 5세,2016,16677,8546,8131,105.1,16611,8511,8100,105.1
35,전라북도,010002, 6세,2016,15770,8162,7608,107.3,15713,8135,7578,107.4
35,전라북도,010003, 7세,2016,15230,7851,7379,106.4,15187,7830,7357,106.4
35,전라북도,010004, 8세,2016,16201,8356,7845,106.5,16155,8334,7821,106.6
35,전라북도,010005, 9세,2016,16710,8601,8109,106.1,16676,8585,8091,106.1
35,전라북도,015,10~14세,2016,84666,44064,40602,108.5,84513,43980,40533,108.5
35,전라북도,015001, 10세,2016,15469,8037,7432,108.1,15442,8022,7420,108.1
35,전라북도,015002, 11세,2016,15734,8247,7487,110.2,15708,8230,7478,110.1
35,전라북도,015003, 12세,2016,16965,8786,8179,107.4,16929,8766,8163,107.4
35,전라북도,015004, 13세,2016,17673,9126,8547,106.8,17644,9112,8532,106.8
35,전라북도,015005, 14세,2016,18825,9868,8957,110.2,18790,9850,8940,110.2
35,전라북도,020,15~19세,2016,120958,63887,57071,111.9,120269,63533,56736,112
35,전라북도,020001, 15세,2016,21973,11305,10668,106,21948,11291,10657,105.9
35,전라북도,020002, 16세,2016,24819,13064,11755,111.1,24773,13037,11736,111.1
35,전라북도,020003, 17세,2016,23480,12338,11142,110.7,23398,12297,11101,110.8
35,전라북도,020004, 18세,2016,24907,13186,11721,112.5,24743,13101,11642,112.5
35,전라북도,020005, 19세,2016,25779,13994,11785,118.7,25407,13807,11600,119
35,전라북도,025,20~24세,2016,128596,70624,57972,121.8,123315,68071,55244,123.2
35,전라북도,025001, 20세,2016,26647,14341,12306,116.5,25983,14057,11926,117.9
35,전라북도,025002, 21세,2016,26566,14439,12127,119.1,25608,14011,11597,120.8
35,전라북도,025003, 22세,2016,26532,14601,11931,122.4,25428,14082,11346,124.1
35,전라북도,025004, 23세,2016,24784,13817,10967,126,23522,13203,10319,127.9
35,전라북도,025005, 24세,2016,24067,13426,10641,126.2,22774,12718,10056,126.5
35,전라북도,030,25~29세,2016,97731,52950,44781,118.2,91187,49076,42111,116.5
35,전라북도,030001, 25세,2016,21775,11964,9811,121.9,20455,11212,9243,121.3
35,전라북도,030002, 26세,2016,20194,11125,9069,122.7,18791,10293,8498,121.1
35,전라북도,030003, 27세,2016,18922,10285,8637,119.1,17654,9534,8120,117.4
35,전라북도,030004, 28세,2016,18468,9809,8659,113.3,17149,9036,8113,111.4
35,전라북도,030005, 29세,2016,18372,9767,8605,113.5,17138,9001,8137,110.6
35,전라북도,035,30~34세,2016,103957,54309,49648,109.4,98994,51287,47707,107.5
35,전라북도,035001, 30세,2016,19051,10061,8990,111.9,17874,9347,8527,109.6
35,전라북도,035002, 31세,2016,18527,9667,8860,109.1,17495,9044,8451,107
35,전라북도,035003, 32세,2016,20428,10705,9723,110.1,19396,10078,9318,108.2
35,전라북도,035004, 33세,2016,21944,11406,10538,108.2,21055,10877,10178,106.9
35,전라북도,035005, 34세,2016,24007,12470,11537,108.1,23174,11941,11233,106.3
35,전라북도,040,35~39세,2016,120642,62417,58225,107.2,117433,60431,57002,106
35,전라북도,040001, 35세,2016,24054,12613,11441,110.2,23299,12151,11148,109
35,전라북도,040002, 36세,2016,25128,12918,12210,105.8,24406,12469,11937,104.5
35,전라북도,040003, 37세,2016,24291,12627,11664,108.3,23617,12206,11411,107
35,전라북도,040004, 38세,2016,23157,11902,11255,105.7,22588,11565,11023,104.9
35,전라북도,040005, 39세,2016,24012,12357,11655,106,23523,12040,11483,104.9
35,전라북도,045,40~44세,2016,136336,70471,65865,107,134006,69142,64864,106.6
35,전라북도,045001, 40세,2016,24281,12619,11662,108.2,23794,12315,11479,107.3
35,전라북도,045002, 41세,2016,25241,12955,12286,105.4,24798,12714,12084,105.2
35,전라북도,045003, 42세,2016,29198,15048,14150,106.3,28756,14803,13953,106.1
35,전라북도,045004, 43세,2016,28992,14826,14166,104.7,28531,14553,13978,104.1
35,전라북도,045005, 44세,2016,28624,15023,13601,110.5,28127,14757,13370,110.4
35,전라북도,050,45~49세,2016,149650,77422,72228,107.2,147359,76262,71097,107.3
35,전라북도,050001, 45세,2016,31302,16382,14920,109.8,30825,16139,14686,109.9
35,전라북도,050002, 46세,2016,29576,15394,14182,108.5,29080,15128,13952,108.4
35,전라북도,050003, 47세,2016,30080,15510,14570,106.5,29634,15271,14363,106.3
35,전라북도,050004, 48세,2016,30552,15753,14799,106.4,30096,15534,14562,106.7
35,전라북도,050005, 49세,2016,28140,14383,13757,104.6,27724,14190,13534,104.8
35,전라북도,055,50~54세,2016,141728,73288,68440,107.1,139518,72249,67269,107.4
35,전라북도,055001, 50세,2016,28448,14850,13598,109.2,28016,14647,13369,109.6
35,전라북도,055002, 51세,2016,28607,14641,13966,104.8,28137,14430,13707,105.3
35,전라북도,055003, 52세,2016,26732,13897,12835,108.3,26290,13682,12608,108.5
35,전라북도,055004, 53세,2016,28103,14496,13607,106.5,27636,14272,13364,106.8
35,전라북도,055005, 54세,2016,29838,15404,14434,106.7,29439,15218,14221,107
35,전라북도,060,55~59세,2016,148028,73974,74054,99.9,146522,73283,73239,100.1
35,전라북도,060001, 55세,2016,31979,16037,15942,100.6,31698,15927,15771,101
35,전라북도,060002, 56세,2016,33595,16640,16955,98.1,33225,16470,16755,98.3
35,전라북도,060003, 57세,2016,28749,14215,14534,97.8,28465,14089,14376,98
35,전라북도,060004, 58세,2016,26547,13324,13223,100.8,26253,13169,13084,100.6
35,전라북도,060005, 59세,2016,27158,13758,13400,102.7,26881,13628,13253,102.8
35,전라북도,065,60~64세,2016,114907,56920,57987,98.2,113955,56446,57509,98.2
35,전라북도,065001, 60세,2016,25230,12721,12509,101.7,24986,12593,12393,101.6
35,전라북도,065002, 61세,2016,26609,13170,13439,98,26376,13057,13319,98
35,전라북도,065003, 62세,2016,23296,11477,11819,97.1,23106,11383,11723,97.1
35,전라북도,065004, 63세,2016,18767,9191,9576,96,18617,9122,9495,96.1
35,전라북도,065005, 64세,2016,21005,10361,10644,97.3,20870,10291,10579,97.3
35,전라북도,070,65~69세,2016,97553,46831,50722,92.3,97098,46605,50493,92.3
35,전라북도,070001, 65세,2016,18565,9093,9472,96,18430,9031,9399,96.1
35,전라북도,070002, 66세,2016,20895,10075,10820,93.1,20784,10018,10766,93.1
35,전라북도,070003, 67세,2016,18995,8921,10074,88.6,18923,8890,10033,88.6
35,전라북도,070004, 68세,2016,18728,8958,9770,91.7,18658,8915,9743,91.5
35,전라북도,070005, 69세,2016,20370,9784,10586,92.4,20303,9751,10552,92.4
35,전라북도,075,70~74세,2016,81216,35692,45524,78.4,81006,35593,45413,78.4
35,전라북도,075001, 70세,2016,15509,7399,8110,91.2,15452,7372,8080,91.2
35,전라북도,075002, 71세,2016,14088,6291,7797,80.7,14039,6260,7779,80.5
35,전라북도,075003, 72세,2016,14258,6285,7973,78.8,14219,6269,7950,78.9
35,전라북도,075004, 73세,2016,15430,6586,8844,74.5,15395,6573,8822,74.5
35,전라북도,075005, 74세,2016,21931,9131,12800,71.3,21901,9119,12782,71.3
35,전라북도,080,75~79세,2016,71315,28124,43191,65.1,71207,28083,43124,65.1
35,전라북도,080001, 75세,2016,15293,6294,8999,69.9,15275,6289,8986,70
35,전라북도,080002, 76세,2016,14260,5693,8567,66.5,14230,5678,8552,66.4
35,전라북도,080003, 77세,2016,15019,6011,9008,66.7,14995,6003,8992,66.8
35,전라북도,080004, 78세,2016,13831,5262,8569,61.4,13816,5256,8560,61.4
35,전라북도,080005, 79세,2016,12912,4864,8048,60.4,12891,4857,8034,60.5
35,전라북도,085,80~84세,2016,49965,17066,32899,51.9,49915,17041,32874,51.8
35,전라북도,085001, 80세,2016,11730,4289,7441,57.6,11719,4284,7435,57.6
35,전라북도,085002, 81세,2016,11789,4108,7681,53.5,11771,4099,7672,53.4
35,전라북도,085003, 82세,2016,10217,3515,6702,52.4,10206,3511,6695,52.4
35,전라북도,085004, 83세,2016,8736,2862,5874,48.7,8727,2856,5871,48.6
35,전라북도,085005, 84세,2016,7493,2292,5201,44.1,7492,2291,5201,44
35,전라북도,090,85~89세,2016,23326,6319,17007,37.2,23304,6310,16994,37.1
35,전라북도,090001, 85세,2016,5955,1714,4241,40.4,5948,1709,4239,40.3
35,전라북도,090002, 86세,2016,5516,1446,4070,35.5,5509,1444,4065,35.5
35,전라북도,090003, 87세,2016,4568,1328,3240,41,4563,1327,3236,41
35,전라북도,090004, 88세,2016,4020,1018,3002,33.9,4018,1017,3001,33.9
35,전라북도,090005, 89세,2016,3267,813,2454,33.1,3266,813,2453,33.1
35,전라북도,095,90~94세,2016,6883,1586,5297,29.9,6873,1580,5293,29.9
35,전라북도,095001, 90세,2016,2029,505,1524,33.1,2025,504,1521,33.1
35,전라북도,095002, 91세,2016,1490,349,1141,30.6,1487,346,1141,30.3
35,전라북도,095003, 92세,2016,1161,282,879,32.1,1159,281,878,32
35,전라북도,095004, 93세,2016,1274,255,1019,25,1274,255,1019,25
35,전라북도,095005, 94세,2016,929,195,734,26.6,928,194,734,26.4
35,전라북도,100,95~99세,2016,1570,256,1314,19.5,1566,254,1312,19.4
35,전라북도,100001, 95세,2016,540,101,439,23,539,101,438,23.1
35,전라북도,100002, 96세,2016,441,62,379,16.4,440,62,378,16.4
35,전라북도,100003, 97세,2016,273,42,231,18.2,273,42,231,18.2
35,전라북도,100004, 98세,2016,194,36,158,22.8,192,34,158,21.5
35,전라북도,100005, 99세,2016,122,15,107,14,122,15,107,14
35,전라북도,101,100세이상,2016,184,26,158,16.5,183,26,157,16.6
35,전라북도,102,15세미만,2016,238623,123331,115292,107,237909,122960,114949,107
35,전라북도,103,15~64세,2016,1262533,656262,606271,108.2,1232558,639780,592778,107.9
35,전라북도,104,65세이상,2016,332012,135900,196112,69.3,331152,135492,195660,69.2
35,전라북도,086,85세이상,2016,31963,8187,23776,34.4,31926,8170,23756,34.4
35,전라북도,126,평균연령,2016,42.8,41.1,44.5,,42.9,41.2,44.6,
35,전라북도,127,중위연령,2016,43.9,42.3,45.7,,44.2,42.6,45.9,
35004, 읍부,000,합계,2016,157965,79408,78557,101.1,154259,77431,76828,100.8
35004, 읍부,005,0~4세,2016,7036,3648,3388,107.7,7018,3635,3383,107.4
35004, 읍부,005001, 0세,2016,1237,648,589,110,1233,644,589,109.3
35004, 읍부,005002, 1세,2016,1348,700,648,108,1346,698,648,107.7
35004, 읍부,005003, 2세,2016,1322,696,626,111.2,1319,693,626,110.7
35004, 읍부,005004, 3세,2016,1531,786,745,105.5,1525,784,741,105.8
35004, 읍부,005005, 4세,2016,1598,818,780,104.9,1595,816,779,104.7
35004, 읍부,010,5~9세,2016,7773,4009,3764,106.5,7757,4000,3757,106.5
35004, 읍부,010001, 5세,2016,1668,871,797,109.3,1661,868,793,109.5
35004, 읍부,010002, 6세,2016,1503,817,686,119.1,1500,815,685,119
35004, 읍부,010003, 7세,2016,1470,724,746,97.1,1466,722,744,97
35004, 읍부,010004, 8세,2016,1576,802,774,103.6,1575,801,774,103.5
35004, 읍부,010005, 9세,2016,1556,795,761,104.5,1555,794,761,104.3
35004, 읍부,015,10~14세,2016,7279,3793,3486,108.8,7265,3784,3481,108.7
35004, 읍부,015001, 10세,2016,1432,755,677,111.5,1428,751,677,110.9
35004, 읍부,015002, 11세,2016,1425,715,710,100.7,1424,714,710,100.6
35004, 읍부,015003, 12세,2016,1461,784,677,115.8,1456,781,675,115.7
35004, 읍부,015004, 13세,2016,1430,745,685,108.8,1428,745,683,109.1
35004, 읍부,015005, 14세,2016,1531,794,737,107.7,1529,793,736,107.7
35004, 읍부,020,15~19세,2016,10550,5675,4875,116.4,10479,5636,4843,116.4
35004, 읍부,020001, 15세,2016,1903,994,909,109.4,1901,993,908,109.4
35004, 읍부,020002, 16세,2016,2273,1208,1065,113.4,2272,1208,1064,113.5
35004, 읍부,020003, 17세,2016,2054,1081,973,111.1,2045,1078,967,111.5
35004, 읍부,020004, 18세,2016,2121,1135,986,115.1,2105,1124,981,114.6
35004, 읍부,020005, 19세,2016,2199,1257,942,133.4,2156,1233,923,133.6
35004, 읍부,025,20~24세,2016,10188,5747,4441,129.4,9497,5422,4075,133.1
35004, 읍부,025001, 20세,2016,2313,1233,1080,114.2,2203,1194,1009,118.3
35004, 읍부,025002, 21세,2016,2092,1188,904,131.4,1976,1142,834,136.9
35004, 읍부,025003, 22세,2016,2099,1179,920,128.2,1952,1103,849,129.9
35004, 읍부,025004, 23세,2016,1870,1098,772,142.2,1703,1020,683,149.3
35004, 읍부,025005, 24세,2016,1814,1049,765,137.1,1663,963,700,137.6
35004, 읍부,030,25~29세,2016,7568,4163,3405,122.3,6784,3712,3072,120.8
35004, 읍부,030001, 25세,2016,1598,919,679,135.3,1442,832,610,136.4
35004, 읍부,030002, 26세,2016,1540,876,664,131.9,1380,781,599,130.4
35004, 읍부,030003, 27세,2016,1464,807,657,122.8,1302,708,594,119.2
35004, 읍부,030004, 28세,2016,1487,775,712,108.8,1325,680,645,105.4
35004, 읍부,030005, 29세,2016,1479,786,693,113.4,1335,711,624,113.9
35004, 읍부,035,30~34세,2016,8523,4324,4199,103,7991,4028,3963,101.6
35004, 읍부,035001, 30세,2016,1508,776,732,106,1404,721,683,105.6
35004, 읍부,035002, 31세,2016,1477,747,730,102.3,1366,690,676,102.1
35004, 읍부,035003, 32세,2016,1672,849,823,103.2,1544,777,767,101.3
35004, 읍부,035004, 33세,2016,1808,910,898,101.3,1707,852,855,99.6
35004, 읍부,035005, 34세,2016,2058,1042,1016,102.6,1970,988,982,100.6
35004, 읍부,040,35~39세,2016,10608,5548,5060,109.6,10262,5337,4925,108.4
35004, 읍부,040001, 35세,2016,2149,1111,1038,107,2072,1067,1005,106.2
35004, 읍부,040002, 36세,2016,2258,1172,1086,107.9,2171,1120,1051,106.6
35004, 읍부,040003, 37세,2016,2167,1145,1022,112,2093,1097,996,110.1
35004, 읍부,040004, 38세,2016,1982,1009,973,103.7,1918,971,947,102.5
35004, 읍부,040005, 39세,2016,2052,1111,941,118.1,2008,1082,926,116.8
35004, 읍부,045,40~44세,2016,11261,6124,5137,119.2,10998,5977,5021,119
35004, 읍부,045001, 40세,2016,2086,1145,941,121.7,2040,1115,925,120.5
35004, 읍부,045002, 41세,2016,2083,1134,949,119.5,2032,1104,928,119
35004, 읍부,045003, 42세,2016,2508,1369,1139,120.2,2452,1339,1113,120.3
35004, 읍부,045004, 43세,2016,2307,1230,1077,114.2,2260,1198,1062,112.8
35004, 읍부,045005, 44세,2016,2277,1246,1031,120.9,2214,1221,993,123
35004, 읍부,050,45~49세,2016,11814,6450,5364,120.2,11542,6318,5224,120.9
35004, 읍부,050001, 45세,2016,2510,1379,1131,121.9,2449,1350,1099,122.8
35004, 읍부,050002, 46세,2016,2312,1238,1074,115.3,2251,1206,1045,115.4
35004, 읍부,050003, 47세,2016,2285,1271,1014,125.3,2239,1250,989,126.4
35004, 읍부,050004, 48세,2016,2479,1372,1107,123.9,2424,1348,1076,125.3
35004, 읍부,050005, 49세,2016,2228,1190,1038,114.6,2179,1164,1015,114.7
35004, 읍부,055,50~54세,2016,11232,6040,5192,116.3,10955,5903,5052,116.8
35004, 읍부,055001, 50세,2016,2248,1229,1019,120.6,2182,1198,984,121.7
35004, 읍부,055002, 51세,2016,2262,1253,1009,124.2,2204,1226,978,125.4
35004, 읍부,055003, 52세,2016,2165,1157,1008,114.8,2116,1129,987,114.4
35004, 읍부,055004, 53세,2016,2132,1111,1021,108.8,2077,1086,991,109.6
35004, 읍부,055005, 54세,2016,2425,1290,1135,113.7,2376,1264,1112,113.7
35004, 읍부,060,55~59세,2016,12222,6230,5992,104,12023,6132,5891,104.1
35004, 읍부,060001, 55세,2016,2579,1300,1279,101.6,2543,1287,1256,102.5
35004, 읍부,060002, 56세,2016,2777,1407,1370,102.7,2727,1379,1348,102.3
35004, 읍부,060003, 57세,2016,2353,1218,1135,107.3,2311,1197,1114,107.5
35004, 읍부,060004, 58세,2016,2219,1136,1083,104.9,2180,1114,1066,104.5
35004, 읍부,060005, 59세,2016,2294,1169,1125,103.9,2262,1155,1107,104.3
35004, 읍부,065,60~64세,2016,10013,4988,5025,99.3,9901,4932,4969,99.3
35004, 읍부,065001, 60세,2016,2232,1127,1105,102,2208,1115,1093,102
35004, 읍부,065002, 61세,2016,2298,1135,1163,97.6,2269,1121,1148,97.6
35004, 읍부,065003, 62세,2016,2052,1001,1051,95.2,2031,990,1041,95.1
35004, 읍부,065004, 63세,2016,1586,822,764,107.6,1565,811,754,107.6
35004, 읍부,065005, 64세,2016,1845,903,942,95.9,1828,895,933,95.9
35004, 읍부,070,65~69세,2016,8729,4141,4588,90.3,8676,4115,4561,90.2
35004, 읍부,070001, 65세,2016,1624,779,845,92.2,1608,770,838,91.9
35004, 읍부,070002, 66세,2016,1844,885,959,92.3,1832,883,949,93
35004, 읍부,070003, 67세,2016,1721,808,913,88.5,1711,802,909,88.2
35004, 읍부,070004, 68세,2016,1695,795,900,88.3,1689,789,900,87.7
35004, 읍부,070005, 69세,2016,1845,874,971,90,1836,871,965,90.3
35004, 읍부,075,70~74세,2016,7500,3206,4294,74.7,7469,3191,4278,74.6
35004, 읍부,075001, 70세,2016,1428,679,749,90.7,1421,676,745,90.7
35004, 읍부,075002, 71세,2016,1323,563,760,74.1,1314,555,759,73.1
35004, 읍부,075003, 72세,2016,1310,581,729,79.7,1306,579,727,79.6
35004, 읍부,075004, 73세,2016,1394,575,819,70.2,1387,574,813,70.6
35004, 읍부,075005, 74세,2016,2045,808,1237,65.3,2041,807,1234,65.4
35004, 읍부,080,75~79세,2016,7135,2751,4384,62.8,7115,2742,4373,62.7
35004, 읍부,080001, 75세,2016,1496,596,900,66.2,1490,594,896,66.3
35004, 읍부,080002, 76세,2016,1442,557,885,62.9,1437,555,882,62.9
35004, 읍부,080003, 77세,2016,1530,589,941,62.6,1524,586,938,62.5
35004, 읍부,080004, 78세,2016,1424,560,864,64.8,1423,559,864,64.7
35004, 읍부,080005, 79세,2016,1243,449,794,56.5,1241,448,793,56.5
35004, 읍부,085,80~84세,2016,5187,1727,3460,49.9,5183,1724,3459,49.8
35004, 읍부,085001, 80세,2016,1268,450,818,55,1268,450,818,55
35004, 읍부,085002, 81세,2016,1235,432,803,53.8,1233,430,803,53.5
35004, 읍부,085003, 82세,2016,1031,325,706,46,1030,324,706,45.9
35004, 읍부,085004, 83세,2016,872,278,594,46.8,871,278,593,46.9
35004, 읍부,085005, 84세,2016,781,242,539,44.9,781,242,539,44.9
35004, 읍부,090,85~89세,2016,2423,651,1772,36.7,2422,651,1771,36.8
35004, 읍부,090001, 85세,2016,590,171,419,40.8,590,171,419,40.8
35004, 읍부,090002, 86세,2016,591,152,439,34.6,590,152,438,34.7
35004, 읍부,090003, 87세,2016,481,134,347,38.6,481,134,347,38.6
35004, 읍부,090004, 88세,2016,411,107,304,35.2,411,107,304,35.2
35004, 읍부,090005, 89세,2016,350,87,263,33.1,350,87,263,33.1
35004, 읍부,095,90~94세,2016,737,157,580,27.1,735,156,579,26.9
35004, 읍부,095001, 90세,2016,216,46,170,27.1,215,46,169,27.2
35004, 읍부,095002, 91세,2016,165,42,123,34.1,164,41,123,33.3
35004, 읍부,095003, 92세,2016,115,23,92,25,115,23,92,25
35004, 읍부,095004, 93세,2016,139,26,113,23,139,26,113,23
35004, 읍부,095005, 94세,2016,102,20,82,24.4,102,20,82,24.4
35004, 읍부,100,95~99세,2016,171,34,137,24.8,171,34,137,24.8
35004, 읍부,100001, 95세,2016,52,15,37,40.5,52,15,37,40.5
35004, 읍부,100002, 96세,2016,58,9,49,18.4,58,9,49,18.4
35004, 읍부,100003, 97세,2016,29,6,23,26.1,29,6,23,26.1
35004, 읍부,100004, 98세,2016,16,X,15,6.7,16,X,15,6.7
35004, 읍부,100005, 99세,2016,16,X,13,23.1,16,X,13,23.1
35004, 읍부,101,100세이상,2016,16,X,14,14.3,16,X,14,14.3
35004, 읍부,102,15세미만,2016,22088,11450,10638,107.6,22040,11419,10621,107.5
35004, 읍부,103,15~64세,2016,103979,55289,48690,113.6,100432,53397,47035,113.5
35004, 읍부,104,65세이상,2016,31898,12669,19229,65.9,31787,12615,19172,65.8
35004, 읍부,086,85세이상,2016,3347,844,2503,33.7,3344,843,2501,33.7
35004, 읍부,126,평균연령,2016,43.2,41.2,45.3,,43.4,41.4,45.5,
35004, 읍부,127,중위연령,2016,44.2,42.4,46.4,,44.6,42.7,46.8,
35005, 면부,000,합계,2016,376315,187122,189193,98.9,367237,181912,185325,98.2
35005, 면부,005,0~4세,2016,8898,4561,4337,105.2,8865,4544,4321,105.2
35005, 면부,005001, 0세,2016,1674,844,830,101.7,1668,840,828,101.4
35005, 면부,005002, 1세,2016,1723,887,836,106.1,1720,886,834,106.2
35005, 면부,005003, 2세,2016,1787,886,901,98.3,1780,884,896,98.7
35005, 면부,005004, 3세,2016,1763,916,847,108.1,1756,911,845,107.8
35005, 면부,005005, 4세,2016,1951,1028,923,111.4,1941,1023,918,111.4
35005, 면부,010,5~9세,2016,9148,4819,4329,111.3,9126,4809,4317,111.4
35005, 면부,010001, 5세,2016,1970,1062,908,117,1966,1060,906,117
35005, 면부,010002, 6세,2016,1735,920,815,112.9,1732,919,813,113
35005, 면부,010003, 7세,2016,1752,922,830,111.1,1749,920,829,111
35005, 면부,010004, 8세,2016,1815,932,883,105.5,1808,929,879,105.7
35005, 면부,010005, 9세,2016,1876,983,893,110.1,1871,981,890,110.2
35005, 면부,015,10~14세,2016,9836,5282,4554,116,9810,5265,4545,115.8
35005, 면부,015001, 10세,2016,1787,945,842,112.2,1782,943,839,112.4
35005, 면부,015002, 11세,2016,1786,945,841,112.4,1780,940,840,111.9
35005, 면부,015003, 12세,2016,1819,1001,818,122.4,1817,1000,817,122.4
35005, 면부,015004, 13세,2016,2059,1107,952,116.3,2053,1103,950,116.1
35005, 면부,015005, 14세,2016,2385,1284,1101,116.6,2378,1279,1099,116.4
35005, 면부,020,15~19세,2016,14870,8339,6531,127.7,14779,8292,6487,127.8
35005, 면부,020001, 15세,2016,2884,1563,1321,118.3,2881,1560,1321,118.1
35005, 면부,020002, 16세,2016,3173,1794,1379,130.1,3163,1786,1377,129.7
35005, 면부,020003, 17세,2016,2837,1544,1293,119.4,2825,1539,1286,119.7
35005, 면부,020004, 18세,2016,2857,1593,1264,126,2845,1589,1256,126.5
35005, 면부,020005, 19세,2016,3119,1845,1274,144.8,3065,1818,1247,145.8
35005, 면부,025,20~24세,2016,17683,10356,7327,141.3,16296,9613,6683,143.8
35005, 면부,025001, 20세,2016,3541,2037,1504,135.4,3399,1974,1425,138.5
35005, 면부,025002, 21세,2016,3688,2219,1469,151.1,3480,2117,1363,155.3
35005, 면부,025003, 22세,2016,3638,2155,1483,145.3,3350,2011,1339,150.2
35005, 면부,025004, 23세,2016,3384,1961,1423,137.8,3028,1766,1262,139.9
35005, 면부,025005, 24세,2016,3432,1984,1448,137,3039,1745,1294,134.9
35005, 면부,030,25~29세,2016,15681,9126,6555,139.2,13506,7717,5789,133.3
35005, 면부,030001, 25세,2016,3312,1904,1408,135.2,2891,1638,1253,130.7
35005, 면부,030002, 26세,2016,3327,1919,1408,136.3,2867,1630,1237,131.8
35005, 면부,030003, 27세,2016,3026,1745,1281,136.2,2601,1463,1138,128.6
35005, 면부,030004, 28세,2016,3088,1823,1265,144.1,2633,1542,1091,141.3
35005, 면부,030005, 29세,2016,2928,1735,1193,145.4,2514,1444,1070,135
35005, 면부,035,30~34세,2016,14912,8574,6338,135.3,13166,7490,5676,132
35005, 면부,035001, 30세,2016,3040,1764,1276,138.2,2587,1478,1109,133.3
35005, 면부,035002, 31세,2016,2733,1588,1145,138.7,2375,1361,1014,134.2
35005, 면부,035003, 32세,2016,3014,1723,1291,133.5,2678,1519,1159,131.1
35005, 면부,035004, 33세,2016,2969,1674,1295,129.3,2647,1477,1170,126.2
35005, 면부,035005, 34세,2016,3156,1825,1331,137.1,2879,1655,1224,135.2
35005, 면부,040,35~39세,2016,15488,9249,6239,148.2,14504,8619,5885,146.5
35005, 면부,040001, 35세,2016,3130,1846,1284,143.8,2903,1705,1198,142.3
35005, 면부,040002, 36세,2016,3163,1815,1348,134.6,2954,1682,1272,132.2
35005, 면부,040003, 37세,2016,3093,1878,1215,154.6,2878,1742,1136,153.3
35005, 면부,040004, 38세,2016,2993,1834,1159,158.2,2816,1720,1096,156.9
35005, 면부,040005, 39세,2016,3109,1876,1233,152.1,2953,1770,1183,149.6
35005, 면부,045,40~44세,2016,18744,11245,7499,150,18103,10892,7211,151
35005, 면부,045001, 40세,2016,3284,1978,1306,151.5,3129,1886,1243,151.7
35005, 면부,045002, 41세,2016,3313,2021,1292,156.4,3197,1960,1237,158.4
35005, 면부,045003, 42세,2016,3973,2409,1564,154,3864,2353,1511,155.7
35005, 면부,045004, 43세,2016,4107,2438,1669,146.1,3976,2363,1613,146.5
35005, 면부,045005, 44세,2016,4067,2399,1668,143.8,3937,2330,1607,145
35005, 면부,050,45~49세,2016,23850,13683,10167,134.6,23258,13406,9852,136.1
35005, 면부,050001, 45세,2016,4458,2684,1774,151.3,4338,2620,1718,152.5
35005, 면부,050002, 46세,2016,4339,2517,1822,138.1,4212,2453,1759,139.5
35005, 면부,050003, 47세,2016,4853,2772,2081,133.2,4738,2715,2023,134.2
35005, 면부,050004, 48세,2016,5245,2988,2257,132.4,5128,2939,2189,134.3
35005, 면부,050005, 49세,2016,4955,2722,2233,121.9,4842,2679,2163,123.9
35005, 면부,055,50~54세,2016,28751,15626,13125,119.1,28182,15373,12809,120
35005, 면부,055001, 50세,2016,5318,2956,2362,125.1,5225,2917,2308,126.4
35005, 면부,055002, 51세,2016,5540,2992,2548,117.4,5417,2942,2475,118.9
35005, 면부,055003, 52세,2016,5410,2969,2441,121.6,5292,2908,2384,122
35005, 면부,055004, 53세,2016,5776,3127,2649,118,5644,3066,2578,118.9
35005, 면부,055005, 54세,2016,6707,3582,3125,114.6,6604,3540,3064,115.5
35005, 면부,060,55~59세,2016,36288,18526,17762,104.3,35944,18382,17562,104.7
35005, 면부,060001, 55세,2016,7443,3885,3558,109.2,7364,3852,3512,109.7
35005, 면부,060002, 56세,2016,7987,4000,3987,100.3,7908,3967,3941,100.7
35005, 면부,060003, 57세,2016,7015,3552,3463,102.6,6957,3527,3430,102.8
35005, 면부,060004, 58세,2016,6723,3399,3324,102.3,6663,3371,3292,102.4
35005, 면부,060005, 59세,2016,7120,3690,3430,107.6,7052,3665,3387,108.2
35005, 면부,065,60~64세,2016,32570,16250,16320,99.6,32319,16127,16192,99.6
35005, 면부,065001, 60세,2016,6817,3502,3315,105.6,6751,3469,3282,105.7
35005, 면부,065002, 61세,2016,7314,3687,3627,101.7,7254,3655,3599,101.6
35005, 면부,065003, 62세,2016,6690,3322,3368,98.6,6645,3302,3343,98.8
35005, 면부,065004, 63세,2016,5421,2690,2731,98.5,5382,2673,2709,98.7
35005, 면부,065005, 64세,2016,6328,3049,3279,93,6287,3028,3259,92.9
35005, 면부,070,65~69세,2016,31585,15240,16345,93.2,31460,15176,16284,93.2
35005, 면부,070001, 65세,2016,5802,2806,2996,93.7,5770,2795,2975,93.9
35005, 면부,070002, 66세,2016,6583,3209,3374,95.1,6552,3190,3362,94.9
35005, 면부,070003, 67세,2016,6115,2888,3227,89.5,6095,2877,3218,89.4
35005, 면부,070004, 68세,2016,6241,3050,3191,95.6,6219,3036,3183,95.4
35005, 면부,070005, 69세,2016,6844,3287,3557,92.4,6824,3278,3546,92.4
35005, 면부,075,70~74세,2016,30565,13078,17487,74.8,30520,13057,17463,74.8
35005, 면부,075001, 70세,2016,5288,2501,2787,89.7,5277,2497,2780,89.8
35005, 면부,075002, 71세,2016,5020,2224,2796,79.5,5008,2218,2790,79.5
35005, 면부,075003, 72세,2016,5248,2221,3027,73.4,5241,2218,3023,73.4
35005, 면부,075004, 73세,2016,6032,2525,3507,72,6025,2520,3505,71.9
35005, 면부,075005, 74세,2016,8977,3607,5370,67.2,8969,3604,5365,67.2
35005, 면부,080,75~79세,2016,30656,11722,18934,61.9,30629,11712,18917,61.9
35005, 면부,080001, 75세,2016,6388,2522,3866,65.2,6382,2522,3860,65.3
35005, 면부,080002, 76세,2016,5961,2316,3645,63.5,5952,2312,3640,63.5
35005, 면부,080003, 77세,2016,6562,2525,4037,62.5,6558,2522,4036,62.5
35005, 면부,080004, 78세,2016,6002,2227,3775,59,5997,2225,3772,59
35005, 면부,080005, 79세,2016,5743,2132,3611,59,5740,2131,3609,59
35005, 면부,085,80~84세,2016,22504,7642,14862,51.4,22492,7637,14855,51.4
35005, 면부,085001, 80세,2016,5191,1867,3324,56.2,5186,1865,3321,56.2
35005, 면부,085002, 81세,2016,5235,1774,3461,51.3,5230,1773,3457,51.3
35005, 면부,085003, 82세,2016,4690,1643,3047,53.9,4689,1642,3047,53.9
35005, 면부,085004, 83세,2016,3992,1311,2681,48.9,3991,1310,2681,48.9
35005, 면부,085005, 84세,2016,3396,1047,2349,44.6,3396,1047,2349,44.6
35005, 면부,090,85~89세,2016,10453,2911,7542,38.6,10449,2909,7540,38.6
35005, 면부,090001, 85세,2016,2724,806,1918,42,2724,806,1918,42
35005, 면부,090002, 86세,2016,2419,646,1773,36.4,2416,644,1772,36.3
35005, 면부,090003, 87세,2016,1986,590,1396,42.3,1985,590,1395,42.3
35005, 면부,090004, 88세,2016,1852,485,1367,35.5,1852,485,1367,35.5
35005, 면부,090005, 89세,2016,1472,384,1088,35.3,1472,384,1088,35.3
35005, 면부,095,90~94세,2016,3055,763,2292,33.3,3054,763,2291,33.3
35005, 면부,095001, 90세,2016,918,258,660,39.1,918,258,660,39.1
35005, 면부,095002, 91세,2016,669,174,495,35.2,669,174,495,35.2
35005, 면부,095003, 92세,2016,502,127,375,33.9,501,127,374,34
35005, 면부,095004, 93세,2016,558,112,446,25.1,558,112,446,25.1
35005, 면부,095005, 94세,2016,408,92,316,29.1,408,92,316,29.1
35005, 면부,100,95~99세,2016,698,120,578,20.8,695,119,576,20.7
35005, 면부,100001, 95세,2016,238,45,193,23.3,237,45,192,23.4
35005, 면부,100002, 96세,2016,199,26,173,15,198,26,172,15.1
35005, 면부,100003, 97세,2016,119,25,94,26.6,119,25,94,26.6
35005, 면부,100004, 98세,2016,99,19,80,23.8,98,18,80,22.5
35005, 면부,100005, 99세,2016,43,5,38,13.2,43,5,38,13.2
35005, 면부,101,100세이상,2016,80,10,70,14.3,80,10,70,14.3
35005, 면부,102,15세미만,2016,27882,14662,13220,110.9,27801,14618,13183,110.9
35005, 면부,103,15~64세,2016,218837,120974,97863,123.6,210057,115911,94146,123.1
35005, 면부,104,65세이상,2016,129596,51486,78110,65.9,129379,51383,77996,65.9
35005, 면부,086,85세이상,2016,14286,3804,10482,36.3,14278,3801,10477,36.3
35005, 면부,126,평균연령,2016,52.6,49.4,55.7,,53,49.9,56.1,
35005, 면부,127,중위연령,2016,56.4,52.8,60,,56.8,53.5,60.5,
35003, 동부,000,합계,2016,1298888,648963,649925,99.9,1280123,638889,641234,99.6
35003, 동부,005,0~4세,2016,57435,29542,27893,105.9,57171,29406,27765,105.9
35003, 동부,005001, 0세,2016,10169,5224,4945,105.6,10120,5198,4922,105.6
35003, 동부,005002, 1세,2016,11210,5724,5486,104.3,11155,5691,5464,104.2
35003, 동부,005003, 2세,2016,11301,5816,5485,106,11244,5791,5453,106.2
35003, 동부,005004, 3세,2016,11843,6206,5637,110.1,11790,6175,5615,110
35003, 동부,005005, 4세,2016,12912,6572,6340,103.7,12862,6551,6311,103.8
35003, 동부,010,5~9세,2016,63667,32688,30979,105.5,63459,32586,30873,105.5
35003, 동부,010001, 5세,2016,13039,6613,6426,102.9,12984,6583,6401,102.8
35003, 동부,010002, 6세,2016,12532,6425,6107,105.2,12481,6401,6080,105.3
35003, 동부,010003, 7세,2016,12008,6205,5803,106.9,11972,6188,5784,107
35003, 동부,010004, 8세,2016,12810,6622,6188,107,12772,6604,6168,107.1
35003, 동부,010005, 9세,2016,13278,6823,6455,105.7,13250,6810,6440,105.7
35003, 동부,015,10~14세,2016,67551,34989,32562,107.5,67438,34931,32507,107.5
35003, 동부,015001, 10세,2016,12250,6337,5913,107.2,12232,6328,5904,107.2
35003, 동부,015002, 11세,2016,12523,6587,5936,111,12504,6576,5928,110.9
35003, 동부,015003, 12세,2016,13685,7001,6684,104.7,13656,6985,6671,104.7
35003, 동부,015004, 13세,2016,14184,7274,6910,105.3,14163,7264,6899,105.3
35003, 동부,015005, 14세,2016,14909,7790,7119,109.4,14883,7778,7105,109.5
35003, 동부,020,15~19세,2016,95538,49873,45665,109.2,95011,49605,45406,109.2
35003, 동부,020001, 15세,2016,17186,8748,8438,103.7,17166,8738,8428,103.7
35003, 동부,020002, 16세,2016,19373,10062,9311,108.1,19338,10043,9295,108
35003, 동부,020003, 17세,2016,18589,9713,8876,109.4,18528,9680,8848,109.4
35003, 동부,020004, 18세,2016,19929,10458,9471,110.4,19793,10388,9405,110.5
35003, 동부,020005, 19세,2016,20461,10892,9569,113.8,20186,10756,9430,114.1
35003, 동부,025,20~24세,2016,100725,54521,46204,118,97522,53036,44486,119.2
35003, 동부,025001, 20세,2016,20793,11071,9722,113.9,20381,10889,9492,114.7
35003, 동부,025002, 21세,2016,20786,11032,9754,113.1,20152,10752,9400,114.4
35003, 동부,025003, 22세,2016,20795,11267,9528,118.3,20126,10968,9158,119.8
35003, 동부,025004, 23세,2016,19530,10758,8772,122.6,18791,10417,8374,124.4
35003, 동부,025005, 24세,2016,18821,10393,8428,123.3,18072,10010,8062,124.2
35003, 동부,030,25~29세,2016,74482,39661,34821,113.9,70897,37647,33250,113.2
35003, 동부,030001, 25세,2016,16865,9141,7724,118.3,16122,8742,7380,118.5
35003, 동부,030002, 26세,2016,15327,8330,6997,119.1,14544,7882,6662,118.3
35003, 동부,030003, 27세,2016,14432,7733,6699,115.4,13751,7363,6388,115.3
35003, 동부,030004, 28세,2016,13893,7211,6682,107.9,13191,6814,6377,106.9
35003, 동부,030005, 29세,2016,13965,7246,6719,107.8,13289,6846,6443,106.3
35003, 동부,035,30~34세,2016,80522,41411,39111,105.9,77837,39769,38068,104.5
35003, 동부,035001, 30세,2016,14503,7521,6982,107.7,13883,7148,6735,106.1
35003, 동부,035002, 31세,2016,14317,7332,6985,105,13754,6993,6761,103.4
35003, 동부,035003, 32세,2016,15742,8133,7609,106.9,15174,7782,7392,105.3
35003, 동부,035004, 33세,2016,17167,8822,8345,105.7,16701,8548,8153,104.8
35003, 동부,035005, 34세,2016,18793,9603,9190,104.5,18325,9298,9027,103
35003, 동부,040,35~39세,2016,94546,47620,46926,101.5,92667,46475,46192,100.6
35003, 동부,040001, 35세,2016,18775,9656,9119,105.9,18324,9379,8945,104.9
35003, 동부,040002, 36세,2016,19707,9931,9776,101.6,19281,9667,9614,100.6
35003, 동부,040003, 37세,2016,19031,9604,9427,101.9,18646,9367,9279,100.9
35003, 동부,040004, 38세,2016,18182,9059,9123,99.3,17854,8874,8980,98.8
35003, 동부,040005, 39세,2016,18851,9370,9481,98.8,18562,9188,9374,98
35003, 동부,045,40~44세,2016,106331,53102,53229,99.8,104905,52273,52632,99.3
35003, 동부,045001, 40세,2016,18911,9496,9415,100.9,18625,9314,9311,100
35003, 동부,045002, 41세,2016,19845,9800,10045,97.6,19569,9650,9919,97.3
35003, 동부,045003, 42세,2016,22717,11270,11447,98.5,22440,11111,11329,98.1
35003, 동부,045004, 43세,2016,22578,11158,11420,97.7,22295,10992,11303,97.2
35003, 동부,045005, 44세,2016,22280,11378,10902,104.4,21976,11206,10770,104
35003, 동부,050,45~49세,2016,113986,57289,56697,101,112559,56538,56021,100.9
35003, 동부,050001, 45세,2016,24334,12319,12015,102.5,24038,12169,11869,102.5
35003, 동부,050002, 46세,2016,22925,11639,11286,103.1,22617,11469,11148,102.9
35003, 동부,050003, 47세,2016,22942,11467,11475,99.9,22657,11306,11351,99.6
35003, 동부,050004, 48세,2016,22828,11393,11435,99.6,22544,11247,11297,99.6
35003, 동부,050005, 49세,2016,20957,10471,10486,99.9,20703,10347,10356,99.9
35003, 동부,055,50~54세,2016,101745,51622,50123,103,100381,50973,49408,103.2
35003, 동부,055001, 50세,2016,20882,10665,10217,104.4,20609,10532,10077,104.5
35003, 동부,055002, 51세,2016,20805,10396,10409,99.9,20516,10262,10254,100.1
35003, 동부,055003, 52세,2016,19157,9771,9386,104.1,18882,9645,9237,104.4
35003, 동부,055004, 53세,2016,20195,10258,9937,103.2,19915,10120,9795,103.3
35003, 동부,055005, 54세,2016,20706,10532,10174,103.5,20459,10414,10045,103.7
35003, 동부,060,55~59세,2016,99518,49218,50300,97.8,98555,48769,49786,98
35003, 동부,060001, 55세,2016,21957,10852,11105,97.7,21791,10788,11003,98
35003, 동부,060002, 56세,2016,22831,11233,11598,96.9,22590,11124,11466,97
35003, 동부,060003, 57세,2016,19381,9445,9936,95.1,19197,9365,9832,95.3
35003, 동부,060004, 58세,2016,17605,8789,8816,99.7,17410,8684,8726,99.5
35003, 동부,060005, 59세,2016,17744,8899,8845,100.6,17567,8808,8759,100.6
35003, 동부,065,60~64세,2016,72324,35682,36642,97.4,71735,35387,36348,97.4
35003, 동부,065001, 60세,2016,16181,8092,8089,100,16027,8009,8018,99.9
35003, 동부,065002, 61세,2016,16997,8348,8649,96.5,16853,8281,8572,96.6
35003, 동부,065003, 62세,2016,14554,7154,7400,96.7,14430,7091,7339,96.6
35003, 동부,065004, 63세,2016,11760,5679,6081,93.4,11670,5638,6032,93.5
35003, 동부,065005, 64세,2016,12832,6409,6423,99.8,12755,6368,6387,99.7
35003, 동부,070,65~69세,2016,57239,27450,29789,92.1,56962,27314,29648,92.1
35003, 동부,070001, 65세,2016,11139,5508,5631,97.8,11052,5466,5586,97.9
35003, 동부,070002, 66세,2016,12468,5981,6487,92.2,12400,5945,6455,92.1
35003, 동부,070003, 67세,2016,11159,5225,5934,88.1,11117,5211,5906,88.2
35003, 동부,070004, 68세,2016,10792,5113,5679,90,10750,5090,5660,89.9
35003, 동부,070005, 69세,2016,11681,5623,6058,92.8,11643,5602,6041,92.7
35003, 동부,075,70~74세,2016,43151,19408,23743,81.7,43017,19345,23672,81.7
35003, 동부,075001, 70세,2016,8793,4219,4574,92.2,8754,4199,4555,92.2
35003, 동부,075002, 71세,2016,7745,3504,4241,82.6,7717,3487,4230,82.4
35003, 동부,075003, 72세,2016,7700,3483,4217,82.6,7672,3472,4200,82.7
35003, 동부,075004, 73세,2016,8004,3486,4518,77.2,7983,3479,4504,77.2
35003, 동부,075005, 74세,2016,10909,4716,6193,76.2,10891,4708,6183,76.1
35003, 동부,080,75~79세,2016,33524,13651,19873,68.7,33463,13629,19834,68.7
35003, 동부,080001, 75세,2016,7409,3176,4233,75,7403,3173,4230,75
35003, 동부,080002, 76세,2016,6857,2820,4037,69.9,6841,2811,4030,69.8
35003, 동부,080003, 77세,2016,6927,2897,4030,71.9,6913,2895,4018,72.1
35003, 동부,080004, 78세,2016,6405,2475,3930,63,6396,2472,3924,63
35003, 동부,080005, 79세,2016,5926,2283,3643,62.7,5910,2278,3632,62.7
35003, 동부,085,80~84세,2016,22274,7697,14577,52.8,22240,7680,14560,52.7
35003, 동부,085001, 80세,2016,5271,1972,3299,59.8,5265,1969,3296,59.7
35003, 동부,085002, 81세,2016,5319,1902,3417,55.7,5308,1896,3412,55.6
35003, 동부,085003, 82세,2016,4496,1547,2949,52.5,4487,1545,2942,52.5
35003, 동부,085004, 83세,2016,3872,1273,2599,49,3865,1268,2597,48.8
35003, 동부,085005, 84세,2016,3316,1003,2313,43.4,3315,1002,2313,43.3
35003, 동부,090,85~89세,2016,10450,2757,7693,35.8,10433,2750,7683,35.8
35003, 동부,090001, 85세,2016,2641,737,1904,38.7,2634,732,1902,38.5
35003, 동부,090002, 86세,2016,2506,648,1858,34.9,2503,648,1855,34.9
35003, 동부,090003, 87세,2016,2101,604,1497,40.3,2097,603,1494,40.4
35003, 동부,090004, 88세,2016,1757,426,1331,32,1755,425,1330,32
35003, 동부,090005, 89세,2016,1445,342,1103,31,1444,342,1102,31
35003, 동부,095,90~94세,2016,3091,666,2425,27.5,3084,661,2423,27.3
35003, 동부,095001, 90세,2016,895,201,694,29,892,200,692,28.9
35003, 동부,095002, 91세,2016,656,133,523,25.4,654,131,523,25
35003, 동부,095003, 92세,2016,544,132,412,32,543,131,412,31.8
35003, 동부,095004, 93세,2016,577,117,460,25.4,577,117,460,25.4
35003, 동부,095005, 94세,2016,419,83,336,24.7,418,82,336,24.4
35003, 동부,100,95~99세,2016,701,102,599,17,700,101,599,16.9
35003, 동부,100001, 95세,2016,250,41,209,19.6,250,41,209,19.6
35003, 동부,100002, 96세,2016,184,27,157,17.2,184,27,157,17.2
35003, 동부,100003, 97세,2016,125,11,114,9.6,125,11,114,9.6
35003, 동부,100004, 98세,2016,79,16,63,25.4,78,15,63,23.8
35003, 동부,100005, 99세,2016,63,7,56,12.5,63,7,56,12.5
35003, 동부,101,100세이상,2016,88,14,74,18.9,87,14,73,19.2
35003, 동부,102,15세미만,2016,188653,97219,91434,106.3,188068,96923,91145,106.3
35003, 동부,103,15~64세,2016,939717,479999,459718,104.4,922069,470472,451597,104.2
35003, 동부,104,65세이상,2016,170518,71745,98773,72.6,169986,71494,98492,72.6
35003, 동부,086,85세이상,2016,14330,3539,10791,32.8,14304,3526,10778,32.7
35003, 동부,126,평균연령,2016,39.9,38.7,41.1,,40,38.7,41.2,
35003, 동부,127,중위연령,2016,40.8,39.4,42.1,,41,39.6,42.3,
35010, 전주시,000,합계,2016,657766,325061,332705,97.7,650454,321604,328850,97.8
35010, 전주시,005,0~4세,2016,28496,14597,13899,105,28360,14534,13826,105.1
35010, 전주시,005001, 0세,2016,5078,2636,2442,107.9,5047,2619,2428,107.9
35010, 전주시,005002, 1세,2016,5586,2823,2763,102.2,5557,2806,2751,102
35010, 전주시,005003, 2세,2016,5623,2879,2744,104.9,5593,2870,2723,105.4
35010, 전주시,005004, 3세,2016,5837,3061,2776,110.3,5813,3048,2765,110.2
35010, 전주시,005005, 4세,2016,6372,3198,3174,100.8,6350,3191,3159,101
35010, 전주시,010,5~9세,2016,32023,16562,15461,107.1,31922,16515,15407,107.2
35010, 전주시,010001, 5세,2016,6406,3286,3120,105.3,6376,3268,3108,105.1
35010, 전주시,010002, 6세,2016,6359,3299,3060,107.8,6331,3287,3044,108
35010, 전주시,010003, 7세,2016,6063,3118,2945,105.9,6049,3114,2935,106.1
35010, 전주시,010004, 8세,2016,6500,3350,3150,106.3,6481,3343,3138,106.5
35010, 전주시,010005, 9세,2016,6695,3509,3186,110.1,6685,3503,3182,110.1
35010, 전주시,015,10~14세,2016,34464,17901,16563,108.1,34409,17871,16538,108.1
35010, 전주시,015001, 10세,2016,6158,3225,2933,110,6148,3219,2929,109.9
35010, 전주시,015002, 11세,2016,6378,3369,3009,112,6370,3363,3007,111.8
35010, 전주시,015003, 12세,2016,7004,3569,3435,103.9,6989,3560,3429,103.8
35010, 전주시,015004, 13세,2016,7271,3774,3497,107.9,7260,3769,3491,108
35010, 전주시,015005, 14세,2016,7653,3964,3689,107.5,7642,3960,3682,107.6
35010, 전주시,020,15~19세,2016,49725,25495,24230,105.2,49425,25341,24084,105.2
35010, 전주시,020001, 15세,2016,8805,4456,4349,102.5,8798,4452,4346,102.4
35010, 전주시,020002, 16세,2016,10006,5095,4911,103.7,9987,5085,4902,103.7
35010, 전주시,020003, 17세,2016,9573,4952,4621,107.2,9545,4936,4609,107.1
35010, 전주시,020004, 18세,2016,10367,5356,5011,106.9,10291,5315,4976,106.8
35010, 전주시,020005, 19세,2016,10974,5636,5338,105.6,10804,5553,5251,105.8
35010, 전주시,025,20~24세,2016,53232,28000,25232,111,51488,27260,24228,112.5
35010, 전주시,025001, 20세,2016,11069,5751,5318,108.1,10803,5642,5161,109.3
35010, 전주시,025002, 21세,2016,10967,5712,5255,108.7,10581,5543,5038,110
35010, 전주시,025003, 22세,2016,10878,5692,5186,109.8,10518,5548,4970,111.6
35010, 전주시,025004, 23세,2016,10335,5498,4837,113.7,9972,5341,4631,115.3
35010, 전주시,025005, 24세,2016,9983,5347,4636,115.3,9614,5186,4428,117.1
35010, 전주시,030,25~29세,2016,39732,20585,19147,107.5,38340,19908,18432,108
35010, 전주시,030001, 25세,2016,9012,4773,4239,112.6,8703,4623,4080,113.3
35010, 전주시,030002, 26세,2016,8149,4323,3826,113,7848,4170,3678,113.4
35010, 전주시,030003, 27세,2016,7715,4006,3709,108,7445,3882,3563,109
35010, 전주시,030004, 28세,2016,7353,3722,3631,102.5,7099,3601,3498,102.9
35010, 전주시,030005, 29세,2016,7503,3761,3742,100.5,7245,3632,3613,100.5
35010, 전주시,035,30~34세,2016,41554,20898,20656,101.2,40690,20486,20204,101.4
35010, 전주시,035001, 30세,2016,7659,3862,3797,101.7,7446,3761,3685,102.1
35010, 전주시,035002, 31세,2016,7480,3775,3705,101.9,7282,3691,3591,102.8
35010, 전주시,035003, 32세,2016,8089,4012,4077,98.4,7921,3933,3988,98.6
35010, 전주시,035004, 33세,2016,8821,4491,4330,103.7,8678,4426,4252,104.1
35010, 전주시,035005, 34세,2016,9505,4758,4747,100.2,9363,4675,4688,99.7
35010, 전주시,040,35~39세,2016,47474,23550,23924,98.4,46881,23233,23648,98.2
35010, 전주시,040001, 35세,2016,9340,4712,4628,101.8,9197,4647,4550,102.1
35010, 전주시,040002, 36세,2016,9905,4901,5004,97.9,9768,4821,4947,97.5
35010, 전주시,040003, 37세,2016,9641,4825,4816,100.2,9510,4750,4760,99.8
35010, 전주시,040004, 38세,2016,9127,4473,4654,96.1,9037,4428,4609,96.1
35010, 전주시,040005, 39세,2016,9461,4639,4822,96.2,9369,4587,4782,95.9
35010, 전주시,045,40~44세,2016,53581,26178,27403,95.5,53125,25937,27188,95.4
35010, 전주시,045001, 40세,2016,9471,4640,4831,96,9393,4592,4801,95.6
35010, 전주시,045002, 41세,2016,10042,4882,5160,94.6,9961,4846,5115,94.7
35010, 전주시,045003, 42세,2016,11337,5517,5820,94.8,11252,5470,5782,94.6
35010, 전주시,045004, 43세,2016,11456,5499,5957,92.3,11347,5440,5907,92.1
35010, 전주시,045005, 44세,2016,11275,5640,5635,100.1,11172,5589,5583,100.1
35010, 전주시,050,45~49세,2016,58185,28815,29370,98.1,57694,28578,29116,98.2
35010, 전주시,050001, 45세,2016,12421,6210,6211,100,12312,6159,6153,100.1
35010, 전주시,050002, 46세,2016,11693,5840,5853,99.8,11588,5785,5803,99.7
35010, 전주시,050003, 47세,2016,11703,5714,5989,95.4,11605,5669,5936,95.5
35010, 전주시,050004, 48세,2016,11652,5739,5913,97.1,11563,5692,5871,97
35010, 전주시,050005, 49세,2016,10716,5312,5404,98.3,10626,5273,5353,98.5
35010, 전주시,055,50~54세,2016,51920,25837,26083,99.1,51458,25628,25830,99.2
35010, 전주시,055001, 50세,2016,10756,5374,5382,99.9,10656,5324,5332,99.8
35010, 전주시,055002, 51세,2016,10709,5218,5491,95,10609,5174,5435,95.2
35010, 전주시,055003, 52세,2016,9779,4907,4872,100.7,9681,4871,4810,101.3
35010, 전주시,055004, 53세,2016,10252,5137,5115,100.4,10164,5093,5071,100.4
35010, 전주시,055005, 54세,2016,10424,5201,5223,99.6,10348,5166,5182,99.7
35010, 전주시,060,55~59세,2016,49574,24264,25310,95.9,49255,24122,25133,96
35010, 전주시,060001, 55세,2016,11013,5413,5600,96.7,10961,5393,5568,96.9
35010, 전주시,060002, 56세,2016,11589,5690,5899,96.5,11501,5651,5850,96.6
35010, 전주시,060003, 57세,2016,9778,4668,5110,91.4,9721,4645,5076,91.5
35010, 전주시,060004, 58세,2016,8489,4244,4245,100,8422,4209,4213,99.9
35010, 전주시,060005, 59세,2016,8705,4249,4456,95.4,8650,4224,4426,95.4
35010, 전주시,065,60~64세,2016,35832,17518,18314,95.7,35621,17415,18206,95.7
35010, 전주시,065001, 60세,2016,7959,3977,3982,99.9,7905,3950,3955,99.9
35010, 전주시,065002, 61세,2016,8417,4102,4315,95.1,8360,4074,4286,95.1
35010, 전주시,065003, 62세,2016,7178,3510,3668,95.7,7138,3495,3643,95.9
35010, 전주시,065004, 63세,2016,5972,2841,3131,90.7,5938,2822,3116,90.6
35010, 전주시,065005, 64세,2016,6306,3088,3218,96,6280,3074,3206,95.9
35010, 전주시,070,65~69세,2016,27991,13360,14631,91.3,27894,13320,14574,91.4
35010, 전주시,070001, 65세,2016,5315,2628,2687,97.8,5284,2616,2668,98.1
35010, 전주시,070002, 66세,2016,6206,2940,3266,90,6189,2931,3258,90
35010, 전주시,070003, 67세,2016,5491,2534,2957,85.7,5474,2531,2943,86
35010, 전주시,070004, 68세,2016,5350,2545,2805,90.7,5336,2539,2797,90.8
35010, 전주시,070005, 69세,2016,5629,2713,2916,93,5611,2703,2908,93
35010, 전주시,075,70~74세,2016,20700,9425,11275,83.6,20650,9398,11252,83.5
35010, 전주시,075001, 70세,2016,4272,2042,2230,91.6,4251,2031,2220,91.5
35010, 전주시,075002, 71세,2016,3679,1693,1986,85.2,3672,1688,1984,85.1
35010, 전주시,075003, 72세,2016,3690,1705,1985,85.9,3678,1699,1979,85.9
35010, 전주시,075004, 73세,2016,3808,1688,2120,79.6,3804,1686,2118,79.6
35010, 전주시,075005, 74세,2016,5251,2297,2954,77.8,5245,2294,2951,77.7
35010, 전주시,080,75~79세,2016,16060,6694,9366,71.5,16041,6688,9353,71.5
35010, 전주시,080001, 75세,2016,3552,1564,1988,78.7,3550,1563,1987,78.7
35010, 전주시,080002, 76세,2016,3220,1352,1868,72.4,3215,1349,1866,72.3
35010, 전주시,080003, 77세,2016,3396,1456,1940,75.1,3392,1456,1936,75.2
35010, 전주시,080004, 78세,2016,3040,1189,1851,64.2,3038,1188,1850,64.2
35010, 전주시,080005, 79세,2016,2852,1133,1719,65.9,2846,1132,1714,66
35010, 전주시,085,80~84세,2016,10507,3675,6832,53.8,10498,3669,6829,53.7
35010, 전주시,085001, 80세,2016,2539,953,1586,60.1,2539,953,1586,60.1
35010, 전주시,085002, 81세,2016,2472,872,1600,54.5,2471,872,1599,54.5
35010, 전주시,085003, 82세,2016,2138,763,1375,55.5,2135,761,1374,55.4
35010, 전주시,085004, 83세,2016,1768,599,1169,51.2,1763,595,1168,50.9
35010, 전주시,085005, 84세,2016,1590,488,1102,44.3,1590,488,1102,44.3
35010, 전주시,090,85~89세,2016,4841,1362,3479,39.1,4832,1357,3475,39.1
35010, 전주시,090001, 85세,2016,1222,355,867,40.9,1218,352,866,40.6
35010, 전주시,090002, 86세,2016,1132,309,823,37.5,1130,309,821,37.6
35010, 전주시,090003, 87세,2016,972,291,681,42.7,970,290,680,42.6
35010, 전주시,090004, 88세,2016,835,218,617,35.3,834,217,617,35.2
35010, 전주시,090005, 89세,2016,680,189,491,38.5,680,189,491,38.5
35010, 전주시,095,90~94세,2016,1467,294,1173,25.1,1464,293,1171,25
35010, 전주시,095001, 90세,2016,435,90,345,26.1,433,90,343,26.2
35010, 전주시,095002, 91세,2016,312,63,249,25.3,312,63,249,25.3
35010, 전주시,095003, 92세,2016,247,50,197,25.4,246,49,197,24.9
35010, 전주시,095004, 93세,2016,269,53,216,24.5,269,53,216,24.5
35010, 전주시,095005, 94세,2016,204,38,166,22.9,204,38,166,22.9
35010, 전주시,100,95~99세,2016,371,45,326,13.8,371,45,326,13.8
35010, 전주시,100001, 95세,2016,131,18,113,15.9,131,18,113,15.9
35010, 전주시,100002, 96세,2016,89,11,78,14.1,89,11,78,14.1
35010, 전주시,100003, 97세,2016,71,6,65,9.2,71,6,65,9.2
35010, 전주시,100004, 98세,2016,42,6,36,16.7,42,6,36,16.7
35010, 전주시,100005, 99세,2016,38,X,34,11.8,38,X,34,11.8
35010, 전주시,101,100세이상,2016,37,6,31,19.4,36,6,30,20
35010, 전주시,102,15세미만,2016,94983,49060,45923,106.8,94691,48920,45771,106.9
35010, 전주시,103,15~64세,2016,480809,241140,239669,100.6,473977,237908,236069,100.8
35010, 전주시,104,65세이상,2016,81974,34861,47113,74,81786,34776,47010,74
35010, 전주시,086,85세이상,2016,6716,1707,5009,34.1,6703,1701,5002,34
35010, 전주시,126,평균연령,2016,39.5,38.4,40.6,,39.6,38.4,40.7,
35010, 전주시,127,중위연령,2016,40.2,38.9,41.5,,40.4,39.1,41.6,
35011, 완산구,000,합계,2016,365260,179224,186036,96.3,362189,177791,184398,96.4
35011, 완산구,005,0~4세,2016,15211,7778,7433,104.6,15178,7763,7415,104.7
35011, 완산구,005001, 0세,2016,2737,1424,1313,108.5,2729,1421,1308,108.6
35011, 완산구,005002, 1세,2016,2927,1433,1494,95.9,2923,1431,1492,95.9
35011, 완산구,005003, 2세,2016,3073,1574,1499,105,3067,1572,1495,105.2
35011, 완산구,005004, 3세,2016,3107,1622,1485,109.2,3097,1617,1480,109.3
35011, 완산구,005005, 4세,2016,3367,1725,1642,105.1,3362,1722,1640,105
35011, 완산구,010,5~9세,2016,17013,8860,8153,108.7,16975,8838,8137,108.6
35011, 완산구,010001, 5세,2016,3375,1744,1631,106.9,3365,1737,1628,106.7
35011, 완산구,010002, 6세,2016,3368,1788,1580,113.2,3357,1781,1576,113
35011, 완산구,010003, 7세,2016,3225,1687,1538,109.7,3218,1684,1534,109.8
35011, 완산구,010004, 8세,2016,3460,1782,1678,106.2,3454,1781,1673,106.5
35011, 완산구,010005, 9세,2016,3585,1859,1726,107.7,3581,1855,1726,107.5
35011, 완산구,015,10~14세,2016,19142,10031,9111,110.1,19114,10016,9098,110.1
35011, 완산구,015001, 10세,2016,3324,1738,1586,109.6,3318,1734,1584,109.5
35011, 완산구,015002, 11세,2016,3491,1842,1649,111.7,3489,1841,1648,111.7
35011, 완산구,015003, 12세,2016,3866,2015,1851,108.9,3860,2010,1850,108.6
35011, 완산구,015004, 13세,2016,4102,2171,1931,112.4,4097,2168,1929,112.4
35011, 완산구,015005, 14세,2016,4359,2265,2094,108.2,4350,2263,2087,108.4
35011, 완산구,020,15~19세,2016,28886,14992,13894,107.9,28766,14924,13842,107.8
35011, 완산구,020001, 15세,2016,5032,2566,2466,104.1,5028,2563,2465,104
35011, 완산구,020002, 16세,2016,5883,3034,2849,106.5,5872,3026,2846,106.3
35011, 완산구,020003, 17세,2016,5698,3002,2696,111.4,5682,2995,2687,111.5
35011, 완산구,020004, 18세,2016,6197,3258,2939,110.9,6161,3237,2924,110.7
35011, 완산구,020005, 19세,2016,6076,3132,2944,106.4,6023,3103,2920,106.3
35011, 완산구,025,20~24세,2016,29048,15168,13880,109.3,28344,14857,13487,110.2
35011, 완산구,025001, 20세,2016,6217,3244,2973,109.1,6098,3196,2902,110.1
35011, 완산구,025002, 21세,2016,6166,3243,2923,110.9,6007,3165,2842,111.4
35011, 완산구,025003, 22세,2016,5903,3059,2844,107.6,5754,2998,2756,108.8
35011, 완산구,025004, 23세,2016,5413,2798,2615,107,5272,2739,2533,108.1
35011, 완산구,025005, 24세,2016,5349,2824,2525,111.8,5213,2759,2454,112.4
35011, 완산구,030,25~29세,2016,21385,10912,10473,104.2,20869,10685,10184,104.9
35011, 완산구,030001, 25세,2016,4779,2483,2296,108.1,4651,2424,2227,108.8
35011, 완산구,030002, 26세,2016,4360,2273,2087,108.9,4251,2227,2024,110
35011, 완산구,030003, 27세,2016,4093,2082,2011,103.5,4010,2043,1967,103.9
35011, 완산구,030004, 28세,2016,4040,2011,2029,99.1,3950,1970,1980,99.5
35011, 완산구,030005, 29세,2016,4113,2063,2050,100.6,4007,2021,1986,101.8
35011, 완산구,035,30~34세,2016,22459,11260,11199,100.5,22139,11117,11022,100.9
35011, 완산구,035001, 30세,2016,4123,2081,2042,101.9,4040,2041,1999,102.1
35011, 완산구,035002, 31세,2016,4015,2033,1982,102.6,3944,2008,1936,103.7
35011, 완산구,035003, 32세,2016,4418,2196,2222,98.8,4357,2170,2187,99.2
35011, 완산구,035004, 33세,2016,4780,2403,2377,101.1,4728,2381,2347,101.4
35011, 완산구,035005, 34세,2016,5123,2547,2576,98.9,5070,2517,2553,98.6
35011, 완산구,040,35~39세,2016,25459,12506,12953,96.5,25204,12378,12826,96.5
35011, 완산구,040001, 35세,2016,5011,2541,2470,102.9,4945,2514,2431,103.4
35011, 완산구,040002, 36세,2016,5339,2593,2746,94.4,5285,2565,2720,94.3
35011, 완산구,040003, 37세,2016,5157,2530,2627,96.3,5097,2497,2600,96
35011, 완산구,040004, 38세,2016,4840,2396,2444,98,4808,2379,2429,97.9
35011, 완산구,040005, 39세,2016,5112,2446,2666,91.7,5069,2423,2646,91.6
35011, 완산구,045,40~44세,2016,29543,14112,15431,91.5,29324,13995,15329,91.3
35011, 완산구,045001, 40세,2016,5085,2467,2618,94.2,5046,2441,2605,93.7
35011, 완산구,045002, 41세,2016,5510,2597,2913,89.2,5463,2579,2884,89.4
35011, 완산구,045003, 42세,2016,6278,2980,3298,90.4,6236,2960,3276,90.4
35011, 완산구,045004, 43세,2016,6384,2982,3402,87.7,6334,2953,3381,87.3
35011, 완산구,045005, 44세,2016,6286,3086,3200,96.4,6245,3062,3183,96.2
35011, 완산구,050,45~49세,2016,33071,16210,16861,96.1,32841,16091,16750,96.1
35011, 완산구,050001, 45세,2016,7045,3423,3622,94.5,6993,3395,3598,94.4
35011, 완산구,050002, 46세,2016,6635,3331,3304,100.8,6591,3306,3285,100.6
35011, 완산구,050003, 47세,2016,6632,3186,3446,92.5,6573,3162,3411,92.7
35011, 완산구,050004, 48세,2016,6680,3276,3404,96.2,6648,3255,3393,95.9
35011, 완산구,050005, 49세,2016,6079,2994,3085,97.1,6036,2973,3063,97.1
35011, 완산구,055,50~54세,2016,29594,14518,15076,96.3,29341,14405,14936,96.4
35011, 완산구,055001, 50세,2016,6043,2977,3066,97.1,5987,2947,3040,96.9
35011, 완산구,055002, 51세,2016,6170,2973,3197,93,6113,2951,3162,93.3
35011, 완산구,055003, 52세,2016,5620,2794,2826,98.9,5565,2774,2791,99.4
35011, 완산구,055004, 53세,2016,5884,2860,3024,94.6,5834,2834,3000,94.5
35011, 완산구,055005, 54세,2016,5877,2914,2963,98.3,5842,2899,2943,98.5
35011, 완산구,060,55~59세,2016,28436,13750,14686,93.6,28280,13683,14597,93.7
35011, 완산구,060001, 55세,2016,6356,3082,3274,94.1,6329,3073,3256,94.4
35011, 완산구,060002, 56세,2016,6508,3141,3367,93.3,6459,3121,3338,93.5
35011, 완산구,060003, 57세,2016,5582,2635,2947,89.4,5562,2628,2934,89.6
35011, 완산구,060004, 58세,2016,4919,2430,2489,97.6,4884,2412,2472,97.6
35011, 완산구,060005, 59세,2016,5071,2462,2609,94.4,5046,2449,2597,94.3
35011, 완산구,065,60~64세,2016,20454,9963,10491,95,20346,9914,10432,95
35011, 완산구,065001, 60세,2016,4552,2234,2318,96.4,4525,2221,2304,96.4
35011, 완산구,065002, 61세,2016,4781,2343,2438,96.1,4755,2331,2424,96.2
35011, 완산구,065003, 62세,2016,4124,2010,2114,95.1,4102,2002,2100,95.3
35011, 완산구,065004, 63세,2016,3408,1598,1810,88.3,3390,1589,1801,88.2
35011, 완산구,065005, 64세,2016,3589,1778,1811,98.2,3574,1771,1803,98.2
35011, 완산구,070,65~69세,2016,15636,7476,8160,91.6,15598,7460,8138,91.7
35011, 완산구,070001, 65세,2016,2994,1452,1542,94.2,2985,1447,1538,94.1
35011, 완산구,070002, 66세,2016,3462,1638,1824,89.8,3454,1635,1819,89.9
35011, 완산구,070003, 67세,2016,3084,1426,1658,86,3078,1426,1652,86.3
35011, 완산구,070004, 68세,2016,2949,1446,1503,96.2,2943,1443,1500,96.2
35011, 완산구,070005, 69세,2016,3147,1514,1633,92.7,3138,1509,1629,92.6
35011, 완산구,075,70~74세,2016,11368,5151,6217,82.9,11338,5134,6204,82.8
35011, 완산구,075001, 70세,2016,2379,1169,1210,96.6,2365,1161,1204,96.4
35011, 완산구,075002, 71세,2016,2044,917,1127,81.4,2039,913,1126,81.1
35011, 완산구,075003, 72세,2016,1993,914,1079,84.7,1988,911,1077,84.6
35011, 완산구,075004, 73세,2016,2102,929,1173,79.2,2101,929,1172,79.3
35011, 완산구,075005, 74세,2016,2850,1222,1628,75.1,2845,1220,1625,75.1
35011, 완산구,080,75~79세,2016,8764,3598,5166,69.6,8753,3596,5157,69.7
35011, 완산구,080001, 75세,2016,1934,842,1092,77.1,1934,842,1092,77.1
35011, 완산구,080002, 76세,2016,1765,727,1038,70,1762,726,1036,70.1
35011, 완산구,080003, 77세,2016,1851,792,1059,74.8,1848,792,1056,75
35011, 완산구,080004, 78세,2016,1655,616,1039,59.3,1653,615,1038,59.2
35011, 완산구,080005, 79세,2016,1559,621,938,66.2,1556,621,935,66.4
35011, 완산구,085,80~84세,2016,5914,1995,3919,50.9,5909,1993,3916,50.9
35011, 완산구,085001, 80세,2016,1374,499,875,57,1374,499,875,57
35011, 완산구,085002, 81세,2016,1406,466,940,49.6,1405,466,939,49.6
35011, 완산구,085003, 82세,2016,1224,420,804,52.2,1223,420,803,52.3
35011, 완산구,085004, 83세,2016,991,326,665,49,988,324,664,48.8
35011, 완산구,085005, 84세,2016,919,284,635,44.7,919,284,635,44.7
35011, 완산구,090,85~89세,2016,2785,745,2040,36.5,2781,744,2037,36.5
35011, 완산구,090001, 85세,2016,723,198,525,37.7,721,197,524,37.6
35011, 완산구,090002, 86세,2016,655,174,481,36.2,653,174,479,36.3
35011, 완산구,090003, 87세,2016,545,161,384,41.9,545,161,384,41.9
35011, 완산구,090004, 88세,2016,471,113,358,31.6,471,113,358,31.6
35011, 완산구,090005, 89세,2016,391,99,292,33.9,391,99,292,33.9
35011, 완산구,095,90~94세,2016,838,168,670,25.1,836,167,669,25
35011, 완산구,095001, 90세,2016,254,53,201,26.4,253,53,200,26.5
35011, 완산구,095002, 91세,2016,180,37,143,25.9,180,37,143,25.9
35011, 완산구,095003, 92세,2016,127,23,104,22.1,126,22,104,21.2
35011, 완산구,095004, 93세,2016,160,31,129,24,160,31,129,24
35011, 완산구,095005, 94세,2016,117,24,93,25.8,117,24,93,25.8
35011, 완산구,100,95~99세,2016,228,26,202,12.9,228,26,202,12.9
35011, 완산구,100001, 95세,2016,76,10,66,15.2,76,10,66,15.2
35011, 완산구,100002, 96세,2016,55,5,50,10,55,5,50,10
35011, 완산구,100003, 97세,2016,46,X,42,9.5,46,X,42,9.5
35011, 완산구,100004, 98세,2016,28,5,23,21.7,28,5,23,21.7
35011, 완산구,100005, 99세,2016,23,X,21,9.5,23,X,21,9.5
35011, 완산구,101,100세이상,2016,26,5,21,23.8,25,5,20,25
35011, 완산구,102,15세미만,2016,51366,26669,24697,108,51267,26617,24650,108
35011, 완산구,103,15~64세,2016,268335,133391,134944,98.8,265454,132049,133405,99
35011, 완산구,104,65세이상,2016,45559,19164,26395,72.6,45468,19125,26343,72.6
35011, 완산구,086,85세이상,2016,3877,944,2933,32.2,3870,942,2928,32.2
35011, 완산구,126,평균연령,2016,39.7,38.5,41,,39.8,38.5,41,
35011, 완산구,127,중위연령,2016,40.8,39.2,42.1,,40.9,39.3,42.2,
35012, 덕진구,000,합계,2016,292506,145837,146669,99.4,288265,143813,144452,99.6
35012, 덕진구,005,0~4세,2016,13285,6819,6466,105.5,13182,6771,6411,105.6
35012, 덕진구,005001, 0세,2016,2341,1212,1129,107.4,2318,1198,1120,107
35012, 덕진구,005002, 1세,2016,2659,1390,1269,109.5,2634,1375,1259,109.2
35012, 덕진구,005003, 2세,2016,2550,1305,1245,104.8,2526,1298,1228,105.7
35012, 덕진구,005004, 3세,2016,2730,1439,1291,111.5,2716,1431,1285,111.4
35012, 덕진구,005005, 4세,2016,3005,1473,1532,96.1,2988,1469,1519,96.7
35012, 덕진구,010,5~9세,2016,15010,7702,7308,105.4,14947,7677,7270,105.6
35012, 덕진구,010001, 5세,2016,3031,1542,1489,103.6,3011,1531,1480,103.4
35012, 덕진구,010002, 6세,2016,2991,1511,1480,102.1,2974,1506,1468,102.6
35012, 덕진구,010003, 7세,2016,2838,1431,1407,101.7,2831,1430,1401,102.1
35012, 덕진구,010004, 8세,2016,3040,1568,1472,106.5,3027,1562,1465,106.6
35012, 덕진구,010005, 9세,2016,3110,1650,1460,113,3104,1648,1456,113.2
35012, 덕진구,015,10~14세,2016,15322,7870,7452,105.6,15295,7855,7440,105.6
35012, 덕진구,015001, 10세,2016,2834,1487,1347,110.4,2830,1485,1345,110.4
35012, 덕진구,015002, 11세,2016,2887,1527,1360,112.3,2881,1522,1359,112
35012, 덕진구,015003, 12세,2016,3138,1554,1584,98.1,3129,1550,1579,98.2
35012, 덕진구,015004, 13세,2016,3169,1603,1566,102.4,3163,1601,1562,102.5
35012, 덕진구,015005, 14세,2016,3294,1699,1595,106.5,3292,1697,1595,106.4
35012, 덕진구,020,15~19세,2016,20839,10503,10336,101.6,20659,10417,10242,101.7
35012, 덕진구,020001, 15세,2016,3773,1890,1883,100.4,3770,1889,1881,100.4
35012, 덕진구,020002, 16세,2016,4123,2061,2062,100,4115,2059,2056,100.1
35012, 덕진구,020003, 17세,2016,3875,1950,1925,101.3,3863,1941,1922,101
35012, 덕진구,020004, 18세,2016,4170,2098,2072,101.3,4130,2078,2052,101.3
35012, 덕진구,020005, 19세,2016,4898,2504,2394,104.6,4781,2450,2331,105.1
35012, 덕진구,025,20~24세,2016,24184,12832,11352,113,23144,12403,10741,115.5
35012, 덕진구,025001, 20세,2016,4852,2507,2345,106.9,4705,2446,2259,108.3
35012, 덕진구,025002, 21세,2016,4801,2469,2332,105.9,4574,2378,2196,108.3
35012, 덕진구,025003, 22세,2016,4975,2633,2342,112.4,4764,2550,2214,115.2
35012, 덕진구,025004, 23세,2016,4922,2700,2222,121.5,4700,2602,2098,124
35012, 덕진구,025005, 24세,2016,4634,2523,2111,119.5,4401,2427,1974,122.9
35012, 덕진구,030,25~29세,2016,18347,9673,8674,111.5,17471,9223,8248,111.8
35012, 덕진구,030001, 25세,2016,4233,2290,1943,117.9,4052,2199,1853,118.7
35012, 덕진구,030002, 26세,2016,3789,2050,1739,117.9,3597,1943,1654,117.5
35012, 덕진구,030003, 27세,2016,3622,1924,1698,113.3,3435,1839,1596,115.2
35012, 덕진구,030004, 28세,2016,3313,1711,1602,106.8,3149,1631,1518,107.4
35012, 덕진구,030005, 29세,2016,3390,1698,1692,100.4,3238,1611,1627,99
35012, 덕진구,035,30~34세,2016,19095,9638,9457,101.9,18551,9369,9182,102
35012, 덕진구,035001, 30세,2016,3536,1781,1755,101.5,3406,1720,1686,102
35012, 덕진구,035002, 31세,2016,3465,1742,1723,101.1,3338,1683,1655,101.7
35012, 덕진구,035003, 32세,2016,3671,1816,1855,97.9,3564,1763,1801,97.9
35012, 덕진구,035004, 33세,2016,4041,2088,1953,106.9,3950,2045,1905,107.3
35012, 덕진구,035005, 34세,2016,4382,2211,2171,101.8,4293,2158,2135,101.1
35012, 덕진구,040,35~39세,2016,22015,11044,10971,100.7,21677,10855,10822,100.3
35012, 덕진구,040001, 35세,2016,4329,2171,2158,100.6,4252,2133,2119,100.7
35012, 덕진구,040002, 36세,2016,4566,2308,2258,102.2,4483,2256,2227,101.3
35012, 덕진구,040003, 37세,2016,4484,2295,2189,104.8,4413,2253,2160,104.3
35012, 덕진구,040004, 38세,2016,4287,2077,2210,94,4229,2049,2180,94
35012, 덕진구,040005, 39세,2016,4349,2193,2156,101.7,4300,2164,2136,101.3
35012, 덕진구,045,40~44세,2016,24038,12066,11972,100.8,23801,11942,11859,100.7
35012, 덕진구,045001, 40세,2016,4386,2173,2213,98.2,4347,2151,2196,98
35012, 덕진구,045002, 41세,2016,4532,2285,2247,101.7,4498,2267,2231,101.6
35012, 덕진구,045003, 42세,2016,5059,2537,2522,100.6,5016,2510,2506,100.2
35012, 덕진구,045004, 43세,2016,5072,2517,2555,98.5,5013,2487,2526,98.5
35012, 덕진구,045005, 44세,2016,4989,2554,2435,104.9,4927,2527,2400,105.3
35012, 덕진구,050,45~49세,2016,25114,12605,12509,100.8,24853,12487,12366,101
35012, 덕진구,050001, 45세,2016,5376,2787,2589,107.6,5319,2764,2555,108.2
35012, 덕진구,050002, 46세,2016,5058,2509,2549,98.4,4997,2479,2518,98.5
35012, 덕진구,050003, 47세,2016,5071,2528,2543,99.4,5032,2507,2525,99.3
35012, 덕진구,050004, 48세,2016,4972,2463,2509,98.2,4915,2437,2478,98.3
35012, 덕진구,050005, 49세,2016,4637,2318,2319,100,4590,2300,2290,100.4
35012, 덕진구,055,50~54세,2016,22326,11319,11007,102.8,22117,11223,10894,103
35012, 덕진구,055001, 50세,2016,4713,2397,2316,103.5,4669,2377,2292,103.7
35012, 덕진구,055002, 51세,2016,4539,2245,2294,97.9,4496,2223,2273,97.8
35012, 덕진구,055003, 52세,2016,4159,2113,2046,103.3,4116,2097,2019,103.9
35012, 덕진구,055004, 53세,2016,4368,2277,2091,108.9,4330,2259,2071,109.1
35012, 덕진구,055005, 54세,2016,4547,2287,2260,101.2,4506,2267,2239,101.3
35012, 덕진구,060,55~59세,2016,21138,10514,10624,99,20975,10439,10536,99.1
35012, 덕진구,060001, 55세,2016,4657,2331,2326,100.2,4632,2320,2312,100.3
35012, 덕진구,060002, 56세,2016,5081,2549,2532,100.7,5042,2530,2512,100.7
35012, 덕진구,060003, 57세,2016,4196,2033,2163,94,4159,2017,2142,94.2
35012, 덕진구,060004, 58세,2016,3570,1814,1756,103.3,3538,1797,1741,103.2
35012, 덕진구,060005, 59세,2016,3634,1787,1847,96.8,3604,1775,1829,97
35012, 덕진구,065,60~64세,2016,15378,7555,7823,96.6,15275,7501,7774,96.5
35012, 덕진구,065001, 60세,2016,3407,1743,1664,104.7,3380,1729,1651,104.7
35012, 덕진구,065002, 61세,2016,3636,1759,1877,93.7,3605,1743,1862,93.6
35012, 덕진구,065003, 62세,2016,3054,1500,1554,96.5,3036,1493,1543,96.8
35012, 덕진구,065004, 63세,2016,2564,1243,1321,94.1,2548,1233,1315,93.8
35012, 덕진구,065005, 64세,2016,2717,1310,1407,93.1,2706,1303,1403,92.9
35012, 덕진구,070,65~69세,2016,12355,5884,6471,90.9,12296,5860,6436,91.1
35012, 덕진구,070001, 65세,2016,2321,1176,1145,102.7,2299,1169,1130,103.5
35012, 덕진구,070002, 66세,2016,2744,1302,1442,90.3,2735,1296,1439,90.1
35012, 덕진구,070003, 67세,2016,2407,1108,1299,85.3,2396,1105,1291,85.6
35012, 덕진구,070004, 68세,2016,2401,1099,1302,84.4,2393,1096,1297,84.5
35012, 덕진구,070005, 69세,2016,2482,1199,1283,93.5,2473,1194,1279,93.4
35012, 덕진구,075,70~74세,2016,9332,4274,5058,84.5,9312,4264,5048,84.5
35012, 덕진구,075001, 70세,2016,1893,873,1020,85.6,1886,870,1016,85.6
35012, 덕진구,075002, 71세,2016,1635,776,859,90.3,1633,775,858,90.3
35012, 덕진구,075003, 72세,2016,1697,791,906,87.3,1690,788,902,87.4
35012, 덕진구,075004, 73세,2016,1706,759,947,80.1,1703,757,946,80
35012, 덕진구,075005, 74세,2016,2401,1075,1326,81.1,2400,1074,1326,81
35012, 덕진구,080,75~79세,2016,7296,3096,4200,73.7,7288,3092,4196,73.7
35012, 덕진구,080001, 75세,2016,1618,722,896,80.6,1616,721,895,80.6
35012, 덕진구,080002, 76세,2016,1455,625,830,75.3,1453,623,830,75.1
35012, 덕진구,080003, 77세,2016,1545,664,881,75.4,1544,664,880,75.5
35012, 덕진구,080004, 78세,2016,1385,573,812,70.6,1385,573,812,70.6
35012, 덕진구,080005, 79세,2016,1293,512,781,65.6,1290,511,779,65.6
35012, 덕진구,085,80~84세,2016,4593,1680,2913,57.7,4589,1676,2913,57.5
35012, 덕진구,085001, 80세,2016,1165,454,711,63.9,1165,454,711,63.9
35012, 덕진구,085002, 81세,2016,1066,406,660,61.5,1066,406,660,61.5
35012, 덕진구,085003, 82세,2016,914,343,571,60.1,912,341,571,59.7
35012, 덕진구,085004, 83세,2016,777,273,504,54.2,775,271,504,53.8
35012, 덕진구,085005, 84세,2016,671,204,467,43.7,671,204,467,43.7
35012, 덕진구,090,85~89세,2016,2056,617,1439,42.9,2051,613,1438,42.6
35012, 덕진구,090001, 85세,2016,499,157,342,45.9,497,155,342,45.3
35012, 덕진구,090002, 86세,2016,477,135,342,39.5,477,135,342,39.5
35012, 덕진구,090003, 87세,2016,427,130,297,43.8,425,129,296,43.6
35012, 덕진구,090004, 88세,2016,364,105,259,40.5,363,104,259,40.2
35012, 덕진구,090005, 89세,2016,289,90,199,45.2,289,90,199,45.2
35012, 덕진구,095,90~94세,2016,629,126,503,25,628,126,502,25.1
35012, 덕진구,095001, 90세,2016,181,37,144,25.7,180,37,143,25.9
35012, 덕진구,095002, 91세,2016,132,26,106,24.5,132,26,106,24.5
35012, 덕진구,095003, 92세,2016,120,27,93,29,120,27,93,29
35012, 덕진구,095004, 93세,2016,109,22,87,25.3,109,22,87,25.3
35012, 덕진구,095005, 94세,2016,87,14,73,19.2,87,14,73,19.2
35012, 덕진구,100,95~99세,2016,143,19,124,15.3,143,19,124,15.3
35012, 덕진구,100001, 95세,2016,55,8,47,17,55,8,47,17
35012, 덕진구,100002, 96세,2016,34,6,28,21.4,34,6,28,21.4
35012, 덕진구,100003, 97세,2016,25,X,23,8.7,25,X,23,8.7
35012, 덕진구,100004, 98세,2016,14,X,13,7.7,14,X,13,7.7
35012, 덕진구,100005, 99세,2016,15,X,13,15.4,15,X,13,15.4
35012, 덕진구,101,100세이상,2016,11,X,10,10,11,X,10,10
35012, 덕진구,102,15세미만,2016,43617,22391,21226,105.5,43424,22303,21121,105.6
35012, 덕진구,103,15~64세,2016,212474,107749,104725,102.9,208523,105859,102664,103.1
35012, 덕진구,104,65세이상,2016,36415,15697,20718,75.8,36318,15651,20667,75.7
35012, 덕진구,086,85세이상,2016,2839,763,2076,36.8,2833,759,2074,36.6
35012, 덕진구,126,평균연령,2016,39.2,38.2,40.2,,39.3,38.3,40.3,
35012, 덕진구,127,중위연령,2016,39.6,38.5,40.6,,39.8,38.8,40.9,
35020, 군산시,000,합계,2016,276394,141847,134547,105.4,269799,137556,132243,104
35020, 군산시,005,0~4세,2016,12790,6541,6249,104.7,12710,6494,6216,104.5
35020, 군산시,005001, 0세,2016,2196,1103,1093,100.9,2187,1099,1088,101
35020, 군산시,005002, 1세,2016,2533,1283,1250,102.6,2520,1273,1247,102.1
35020, 군산시,005003, 2세,2016,2577,1339,1238,108.2,2558,1328,1230,108
35020, 군산시,005004, 3세,2016,2722,1396,1326,105.3,2702,1383,1319,104.9
35020, 군산시,005005, 4세,2016,2762,1420,1342,105.8,2743,1411,1332,105.9
35020, 군산시,010,5~9세,2016,13246,6800,6446,105.5,13190,6769,6421,105.4
35020, 군산시,010001, 5세,2016,2817,1464,1353,108.2,2804,1456,1348,108
35020, 군산시,010002, 6세,2016,2655,1336,1319,101.3,2646,1329,1317,100.9
35020, 군산시,010003, 7세,2016,2521,1282,1239,103.5,2511,1277,1234,103.5
35020, 군산시,010004, 8세,2016,2556,1355,1201,112.8,2542,1347,1195,112.7
35020, 군산시,010005, 9세,2016,2697,1363,1334,102.2,2687,1360,1327,102.5
35020, 군산시,015,10~14세,2016,12955,6727,6228,108,12924,6710,6214,108
35020, 군산시,015001, 10세,2016,2439,1258,1181,106.5,2434,1257,1177,106.8
35020, 군산시,015002, 11세,2016,2414,1267,1147,110.5,2409,1265,1144,110.6
35020, 군산시,015003, 12세,2016,2626,1357,1269,106.9,2621,1354,1267,106.9
35020, 군산시,015004, 13세,2016,2655,1356,1299,104.4,2651,1353,1298,104.2
35020, 군산시,015005, 14세,2016,2821,1489,1332,111.8,2809,1481,1328,111.5
35020, 군산시,020,15~19세,2016,17776,9365,8411,111.3,17687,9333,8354,111.7
35020, 군산시,020001, 15세,2016,3244,1640,1604,102.2,3239,1639,1600,102.4
35020, 군산시,020002, 16세,2016,3381,1692,1689,100.2,3372,1687,1685,100.1
35020, 군산시,020003, 17세,2016,3353,1732,1621,106.8,3335,1726,1609,107.3
35020, 군산시,020004, 18세,2016,3656,1903,1753,108.6,3639,1896,1743,108.8
35020, 군산시,020005, 19세,2016,4142,2398,1744,137.5,4102,2385,1717,138.9
35020, 군산시,025,20~24세,2016,18926,10673,8253,129.3,18195,10262,7933,129.4
35020, 군산시,025001, 20세,2016,3969,2122,1847,114.9,3885,2087,1798,116.1
35020, 군산시,025002, 21세,2016,3911,2091,1820,114.9,3820,2049,1771,115.7
35020, 군산시,025003, 22세,2016,3823,2222,1601,138.8,3684,2142,1542,138.9
35020, 군산시,025004, 23세,2016,3667,2128,1539,138.3,3479,2021,1458,138.6
35020, 군산시,025005, 24세,2016,3556,2110,1446,145.9,3327,1963,1364,143.9
35020, 군산시,030,25~29세,2016,14767,8440,6327,133.4,13417,7446,5971,124.7
35020, 군산시,030001, 25세,2016,3144,1819,1325,137.3,2896,1656,1240,133.5
35020, 군산시,030002, 26세,2016,2946,1706,1240,137.6,2673,1504,1169,128.7
35020, 군산시,030003, 27세,2016,2884,1628,1256,129.6,2635,1441,1194,120.7
35020, 군산시,030004, 28세,2016,2860,1624,1236,131.4,2566,1406,1160,121.2
35020, 군산시,030005, 29세,2016,2933,1663,1270,130.9,2647,1439,1208,119.1
35020, 군산시,035,30~34세,2016,18084,9846,8238,119.5,16860,8928,7932,112.6
35020, 군산시,035001, 30세,2016,3123,1744,1379,126.5,2820,1518,1302,116.6
35020, 군산시,035002, 31세,2016,3115,1689,1426,118.4,2868,1490,1378,108.1
35020, 군산시,035003, 32세,2016,3528,1961,1567,125.1,3278,1774,1504,118
35020, 군산시,035004, 33세,2016,3869,2072,1797,115.3,3655,1924,1731,111.1
35020, 군산시,035005, 34세,2016,4449,2380,2069,115,4239,2222,2017,110.2
35020, 군산시,040,35~39세,2016,21233,11377,9856,115.4,20462,10842,9620,112.7
35020, 군산시,040001, 35세,2016,4389,2380,2009,118.5,4209,2244,1965,114.2
35020, 군산시,040002, 36세,2016,4471,2404,2067,116.3,4294,2278,2016,113
35020, 군산시,040003, 37세,2016,4299,2315,1984,116.7,4140,2205,1935,114
35020, 군산시,040004, 38세,2016,3960,2096,1864,112.4,3827,2018,1809,111.6
35020, 군산시,040005, 39세,2016,4114,2182,1932,112.9,3992,2097,1895,110.7
35020, 군산시,045,40~44세,2016,22510,11973,10537,113.6,21931,11585,10346,112
35020, 군산시,045001, 40세,2016,3965,2083,1882,110.7,3825,1987,1838,108.1
35020, 군산시,045002, 41세,2016,4306,2256,2050,110,4191,2180,2011,108.4
35020, 군산시,045003, 42세,2016,4820,2506,2314,108.3,4717,2436,2281,106.8
35020, 군산시,045004, 43세,2016,4681,2528,2153,117.4,4586,2463,2123,116
35020, 군산시,045005, 44세,2016,4738,2600,2138,121.6,4612,2519,2093,120.4
35020, 군산시,050,45~49세,2016,23161,12243,10918,112.1,22645,11929,10716,111.3
35020, 군산시,050001, 45세,2016,5054,2708,2346,115.4,4948,2644,2304,114.8
35020, 군산시,050002, 46세,2016,4802,2588,2214,116.9,4680,2507,2173,115.4
35020, 군산시,050003, 47세,2016,4599,2450,2149,114,4504,2388,2116,112.9
35020, 군산시,050004, 48세,2016,4588,2404,2184,110.1,4485,2350,2135,110.1
35020, 군산시,050005, 49세,2016,4118,2093,2025,103.4,4028,2040,1988,102.6
35020, 군산시,055,50~54세,2016,20786,10909,9877,110.4,20288,10638,9650,110.2
35020, 군산시,055001, 50세,2016,4137,2184,1953,111.8,4043,2133,1910,111.7
35020, 군산시,055002, 51세,2016,4106,2134,1972,108.2,4001,2079,1922,108.2
35020, 군산시,055003, 52세,2016,4035,2152,1883,114.3,3931,2094,1837,114
35020, 군산시,055004, 53세,2016,4148,2149,1999,107.5,4039,2087,1952,106.9
35020, 군산시,055005, 54세,2016,4360,2290,2070,110.6,4274,2245,2029,110.6
35020, 군산시,060,55~59세,2016,21795,10863,10932,99.4,21500,10721,10779,99.5
35020, 군산시,060001, 55세,2016,4654,2369,2285,103.7,4595,2344,2251,104.1
35020, 군산시,060002, 56세,2016,4753,2314,2439,94.9,4685,2279,2406,94.7
35020, 군산시,060003, 57세,2016,4252,2080,2172,95.8,4187,2055,2132,96.4
35020, 군산시,060004, 58세,2016,4046,1986,2060,96.4,3999,1958,2041,95.9
35020, 군산시,060005, 59세,2016,4090,2114,1976,107,4034,2085,1949,107
35020, 군산시,065,60~64세,2016,16823,8545,8278,103.2,16646,8450,8196,103.1
35020, 군산시,065001, 60세,2016,3747,1901,1846,103,3693,1870,1823,102.6
35020, 군산시,065002, 61세,2016,3917,1965,1952,100.7,3878,1945,1933,100.6
35020, 군산시,065003, 62세,2016,3464,1773,1691,104.8,3424,1752,1672,104.8
35020, 군산시,065004, 63세,2016,2687,1336,1351,98.9,2664,1326,1338,99.1
35020, 군산시,065005, 64세,2016,3008,1570,1438,109.2,2987,1557,1430,108.9
35020, 군산시,070,65~69세,2016,13718,6669,7049,94.6,13613,6619,6994,94.6
35020, 군산시,070001, 65세,2016,2830,1404,1426,98.5,2793,1388,1405,98.8
35020, 군산시,070002, 66세,2016,2912,1440,1472,97.8,2891,1429,1462,97.7
35020, 군산시,070003, 67세,2016,2600,1249,1351,92.5,2586,1242,1344,92.4
35020, 군산시,070004, 68세,2016,2507,1184,1323,89.5,2492,1176,1316,89.4
35020, 군산시,070005, 69세,2016,2869,1392,1477,94.2,2851,1384,1467,94.3
35020, 군산시,075,70~74세,2016,10713,4890,5823,84,10659,4861,5798,83.8
35020, 군산시,075001, 70세,2016,2170,1076,1094,98.4,2157,1067,1090,97.9
35020, 군산시,075002, 71세,2016,1966,901,1065,84.6,1950,892,1058,84.3
35020, 군산시,075003, 72세,2016,1933,857,1076,79.6,1923,854,1069,79.9
35020, 군산시,075004, 73세,2016,1962,893,1069,83.5,1954,889,1065,83.5
35020, 군산시,075005, 74세,2016,2682,1163,1519,76.6,2675,1159,1516,76.5
35020, 군산시,080,75~79세,2016,8020,3267,4753,68.7,8001,3259,4742,68.7
35020, 군산시,080001, 75세,2016,1736,729,1007,72.4,1734,728,1006,72.4
35020, 군산시,080002, 76세,2016,1663,663,1000,66.3,1657,659,998,66
35020, 군산시,080003, 77세,2016,1638,715,923,77.5,1633,714,919,77.7
35020, 군산시,080004, 78세,2016,1579,581,998,58.2,1577,580,997,58.2
35020, 군산시,080005, 79세,2016,1404,579,825,70.2,1400,578,822,70.3
35020, 군산시,085,80~84세,2016,5432,1861,3571,52.1,5416,1855,3561,52.1
35020, 군산시,085001, 80세,2016,1278,486,792,61.4,1274,484,790,61.3
35020, 군산시,085002, 81세,2016,1242,429,813,52.8,1236,426,810,52.6
35020, 군산시,085003, 82세,2016,1001,347,654,53.1,997,347,650,53.4
35020, 군산시,085004, 83세,2016,1046,350,696,50.3,1045,350,695,50.4
35020, 군산시,085005, 84세,2016,865,249,616,40.4,864,248,616,40.3
35020, 군산시,090,85~89세,2016,2688,645,2043,31.6,2686,644,2042,31.5
35020, 군산시,090001, 85세,2016,701,169,532,31.8,700,168,532,31.6
35020, 군산시,090002, 86세,2016,678,171,507,33.7,678,171,507,33.7
35020, 군산시,090003, 87세,2016,507,139,368,37.8,507,139,368,37.8
35020, 군산시,090004, 88세,2016,454,89,365,24.4,454,89,365,24.4
35020, 군산시,090005, 89세,2016,348,77,271,28.4,347,77,270,28.5
35020, 군산시,095,90~94세,2016,786,173,613,28.2,785,172,613,28.1
35020, 군산시,095001, 90세,2016,220,49,171,28.7,220,49,171,28.7
35020, 군산시,095002, 91세,2016,166,32,134,23.9,166,32,134,23.9
35020, 군산시,095003, 92세,2016,141,34,107,31.8,141,34,107,31.8
35020, 군산시,095004, 93세,2016,161,39,122,32,161,39,122,32
35020, 군산시,095005, 94세,2016,98,19,79,24.1,97,18,79,22.8
35020, 군산시,100,95~99세,2016,162,35,127,27.6,161,34,127,26.8
35020, 군산시,100001, 95세,2016,57,11,46,23.9,57,11,46,23.9
35020, 군산시,100002, 96세,2016,40,11,29,37.9,40,11,29,37.9
35020, 군산시,100003, 97세,2016,29,5,24,20.8,29,5,24,20.8
35020, 군산시,100004, 98세,2016,26,7,19,36.8,25,6,19,31.6
35020, 군산시,100005, 99세,2016,10,X,9,11.1,10,X,9,11.1
35020, 군산시,101,100세이상,2016,23,5,18,27.8,23,5,18,27.8
35020, 군산시,102,15세미만,2016,38991,20068,18923,106.1,38824,19973,18851,106
35020, 군산시,103,15~64세,2016,195861,104234,91627,113.8,189631,100134,89497,111.9
35020, 군산시,104,65세이상,2016,41542,17545,23997,73.1,41344,17449,23895,73
35020, 군산시,086,85세이상,2016,3659,858,2801,30.6,3655,855,2800,30.5
35020, 군산시,126,평균연령,2016,41.1,39.8,42.6,,41.2,39.9,42.6,
35020, 군산시,127,중위연령,2016,42,40.6,43.5,,42.3,41,43.6,
35030, 익산시,000,합계,2016,300929,151324,149605,101.1,295741,148563,147178,100.9
35030, 익산시,005,0~4세,2016,11845,6137,5708,107.5,11810,6115,5695,107.4
35030, 익산시,005001, 0세,2016,2122,1070,1052,101.7,2114,1065,1049,101.5
35030, 익산시,005002, 1세,2016,2279,1200,1079,111.2,2272,1195,1077,111
35030, 익산시,005003, 2세,2016,2238,1154,1084,106.5,2232,1150,1082,106.3
35030, 익산시,005004, 3세,2016,2395,1265,1130,111.9,2390,1263,1127,112.1
35030, 익산시,005005, 4세,2016,2811,1448,1363,106.2,2802,1442,1360,106
35030, 익산시,010,5~9세,2016,13004,6577,6427,102.3,12970,6561,6409,102.4
35030, 익산시,010001, 5세,2016,2684,1343,1341,100.1,2674,1341,1333,100.6
35030, 익산시,010002, 6세,2016,2521,1271,1250,101.7,2514,1268,1246,101.8
35030, 익산시,010003, 7세,2016,2451,1261,1190,106,2441,1254,1187,105.6
35030, 익산시,010004, 8세,2016,2623,1322,1301,101.6,2620,1320,1300,101.5
35030, 익산시,010005, 9세,2016,2725,1380,1345,102.6,2721,1378,1343,102.6
35030, 익산시,015,10~14세,2016,13976,7185,6791,105.8,13953,7175,6778,105.9
35030, 익산시,015001, 10세,2016,2546,1305,1241,105.2,2544,1303,1241,105
35030, 익산시,015002, 11세,2016,2604,1372,1232,111.4,2599,1370,1229,111.5
35030, 익산시,015003, 12세,2016,2831,1440,1391,103.5,2823,1437,1386,103.7
35030, 익산시,015004, 13세,2016,2959,1484,1475,100.6,2954,1482,1472,100.7
35030, 익산시,015005, 14세,2016,3036,1584,1452,109.1,3033,1583,1450,109.2
35030, 익산시,020,15~19세,2016,21437,11721,9716,120.6,21317,11657,9660,120.7
35030, 익산시,020001, 15세,2016,3689,1924,1765,109,3683,1921,1762,109
35030, 익산시,020002, 16세,2016,4303,2453,1850,132.6,4298,2449,1849,132.4
35030, 익산시,020003, 17세,2016,4053,2259,1794,125.9,4042,2250,1792,125.6
35030, 익산시,020004, 18세,2016,4418,2426,1992,121.8,4382,2411,1971,122.3
35030, 익산시,020005, 19세,2016,4974,2659,2315,114.9,4912,2626,2286,114.9
35030, 익산시,025,20~24세,2016,25399,14033,11366,123.5,24398,13526,10872,124.4
35030, 익산시,025001, 20세,2016,5112,2648,2464,107.5,5007,2603,2404,108.3
35030, 익산시,025002, 21세,2016,5196,2753,2443,112.7,5003,2674,2329,114.8
35030, 익산시,025003, 22세,2016,5421,2982,2439,122.3,5177,2863,2314,123.7
35030, 익산시,025004, 23세,2016,4954,2905,2049,141.8,4718,2780,1938,143.4
35030, 익산시,025005, 24세,2016,4716,2745,1971,139.3,4493,2606,1887,138.1
35030, 익산시,030,25~29세,2016,17324,9614,7710,124.7,16243,8990,7253,123.9
35030, 익산시,030001, 25세,2016,4132,2313,1819,127.2,3902,2185,1717,127.3
35030, 익산시,030002, 26세,2016,3678,2057,1621,126.9,3439,1922,1517,126.7
35030, 익산시,030003, 27세,2016,3349,1908,1441,132.4,3133,1784,1349,132.2
35030, 익산시,030004, 28세,2016,3159,1698,1461,116.2,2958,1579,1379,114.5
35030, 익산시,030005, 29세,2016,3006,1638,1368,119.7,2811,1520,1291,117.7
35030, 익산시,035,30~34세,2016,16882,8914,7968,111.9,16135,8486,7649,110.9
35030, 익산시,035001, 30세,2016,3135,1672,1463,114.3,2968,1576,1392,113.2
35030, 익산시,035002, 31세,2016,3016,1589,1427,111.4,2856,1493,1363,109.5
35030, 익산시,035003, 32세,2016,3348,1783,1565,113.9,3199,1696,1503,112.8
35030, 익산시,035004, 33세,2016,3626,1874,1752,107,3483,1793,1690,106.1
35030, 익산시,035005, 34세,2016,3757,1996,1761,113.3,3629,1928,1701,113.3
35030, 익산시,040,35~39세,2016,19511,10050,9461,106.2,18977,9726,9251,105.1
35030, 익산시,040001, 35세,2016,3890,2028,1862,108.9,3768,1962,1806,108.6
35030, 익산시,040002, 36세,2016,4047,2072,1975,104.9,3934,2007,1927,104.2
35030, 익산시,040003, 37세,2016,3847,1983,1864,106.4,3732,1910,1822,104.8
35030, 익산시,040004, 38세,2016,3811,1941,1870,103.8,3714,1878,1836,102.3
35030, 익산시,040005, 39세,2016,3916,2026,1890,107.2,3829,1969,1860,105.9
35030, 익산시,045,40~44세,2016,22227,11325,10902,103.9,21869,11136,10733,103.8
35030, 익산시,045001, 40세,2016,4054,2139,1915,111.7,3976,2093,1883,111.2
35030, 익산시,045002, 41세,2016,4027,2055,1972,104.2,3959,2015,1944,103.7
35030, 익산시,045003, 42세,2016,4815,2445,2370,103.2,4747,2413,2334,103.4
35030, 익산시,045004, 43세,2016,4750,2365,2385,99.2,4671,2329,2342,99.4
35030, 익산시,045005, 44세,2016,4581,2321,2260,102.7,4516,2286,2230,102.5
35030, 익산시,050,45~49세,2016,25035,12516,12519,100,24680,12347,12333,100.1
35030, 익산시,050001, 45세,2016,5155,2634,2521,104.5,5088,2601,2487,104.6
35030, 익산시,050002, 46세,2016,4890,2445,2445,100,4821,2412,2409,100.1
35030, 익산시,050003, 47세,2016,5061,2525,2536,99.6,4985,2481,2504,99.1
35030, 익산시,050004, 48세,2016,5094,2535,2559,99.1,5023,2504,2519,99.4
35030, 익산시,050005, 49세,2016,4835,2377,2458,96.7,4763,2349,2414,97.3
35030, 익산시,055,50~54세,2016,24026,12348,11678,105.7,23656,12173,11483,106
35030, 익산시,055001, 50세,2016,4821,2530,2291,110.4,4743,2490,2253,110.5
35030, 익산시,055002, 51세,2016,4811,2426,2385,101.7,4748,2398,2350,102
35030, 익산시,055003, 52세,2016,4529,2335,2194,106.4,4456,2296,2160,106.3
35030, 익산시,055004, 53세,2016,4799,2460,2339,105.2,4716,2422,2294,105.6
35030, 익산시,055005, 54세,2016,5066,2597,2469,105.2,4993,2567,2426,105.8
35030, 익산시,060,55~59세,2016,24498,12268,12230,100.3,24236,12153,12083,100.6
35030, 익산시,060001, 55세,2016,5325,2633,2692,97.8,5278,2618,2660,98.4
35030, 익산시,060002, 56세,2016,5605,2756,2849,96.7,5542,2729,2813,97
35030, 익산시,060003, 57세,2016,4736,2398,2338,102.6,4678,2371,2307,102.8
35030, 익산시,060004, 58세,2016,4345,2177,2168,100.4,4298,2151,2147,100.2
35030, 익산시,060005, 59세,2016,4487,2304,2183,105.5,4440,2284,2156,105.9
35030, 익산시,065,60~64세,2016,18447,9152,9295,98.5,18299,9083,9216,98.6
35030, 익산시,065001, 60세,2016,4232,2176,2056,105.8,4199,2161,2038,106
35030, 익산시,065002, 61세,2016,4276,2105,2171,97,4243,2091,2152,97.2
35030, 익산시,065003, 62세,2016,3637,1752,1885,92.9,3607,1739,1868,93.1
35030, 익산시,065004, 63세,2016,2995,1499,1496,100.2,2970,1488,1482,100.4
35030, 익산시,065005, 64세,2016,3307,1620,1687,96,3280,1604,1676,95.7
35030, 익산시,070,65~69세,2016,14582,7098,7484,94.8,14522,7068,7454,94.8
35030, 익산시,070001, 65세,2016,2889,1453,1436,101.2,2870,1443,1427,101.1
35030, 익산시,070002, 66세,2016,3198,1555,1643,94.6,3180,1548,1632,94.9
35030, 익산시,070003, 67세,2016,2790,1319,1471,89.7,2785,1318,1467,89.8
35030, 익산시,070004, 68세,2016,2768,1330,1438,92.5,2757,1322,1435,92.1
35030, 익산시,070005, 69세,2016,2937,1441,1496,96.3,2930,1437,1493,96.2
35030, 익산시,075,70~74세,2016,11632,5172,6460,80.1,11604,5164,6440,80.2
35030, 익산시,075001, 70세,2016,2181,1030,1151,89.5,2175,1028,1147,89.6
35030, 익산시,075002, 71세,2016,2013,923,1090,84.7,2009,920,1089,84.5
35030, 익산시,075003, 72세,2016,2019,896,1123,79.8,2014,895,1119,80
35030, 익산시,075004, 73세,2016,2265,954,1311,72.8,2259,954,1305,73.1
35030, 익산시,075005, 74세,2016,3154,1369,1785,76.7,3147,1367,1780,76.8
35030, 익산시,080,75~79세,2016,9655,3702,5953,62.2,9635,3696,5939,62.2
35030, 익산시,080001, 75세,2016,2030,825,1205,68.5,2028,825,1203,68.6
35030, 익산시,080002, 76세,2016,1926,757,1169,64.8,1918,754,1164,64.8
35030, 익산시,080003, 77세,2016,2033,793,1240,64,2028,792,1236,64.1
35030, 익산시,080004, 78세,2016,1889,692,1197,57.8,1887,692,1195,57.9
35030, 익산시,080005, 79세,2016,1777,635,1142,55.6,1774,633,1141,55.5
35030, 익산시,085,80~84세,2016,6889,2361,4528,52.1,6882,2358,4524,52.1
35030, 익산시,085001, 80세,2016,1556,572,984,58.1,1554,571,983,58.1
35030, 익산시,085002, 81세,2016,1579,552,1027,53.7,1576,551,1025,53.8
35030, 익산시,085003, 82세,2016,1385,490,895,54.7,1384,490,894,54.8
35030, 익산시,085004, 83세,2016,1306,404,902,44.8,1305,403,902,44.7
35030, 익산시,085005, 84세,2016,1063,343,720,47.6,1063,343,720,47.6
35030, 익산시,090,85~89세,2016,3364,884,2480,35.6,3359,882,2477,35.6
35030, 익산시,090001, 85세,2016,872,235,637,36.9,870,234,636,36.8
35030, 익산시,090002, 86세,2016,799,220,579,38,798,219,579,37.8
35030, 익산시,090003, 87세,2016,682,187,495,37.8,681,187,494,37.9
35030, 익산시,090004, 88세,2016,542,135,407,33.2,541,135,406,33.3
35030, 익산시,090005, 89세,2016,469,107,362,29.6,469,107,362,29.6
35030, 익산시,095,90~94세,2016,988,236,752,31.4,988,236,752,31.4
35030, 익산시,095001, 90세,2016,298,83,215,38.6,298,83,215,38.6
35030, 익산시,095002, 91세,2016,214,41,173,23.7,214,41,173,23.7
35030, 익산시,095003, 92세,2016,170,47,123,38.2,170,47,123,38.2
35030, 익산시,095004, 93세,2016,172,32,140,22.9,172,32,140,22.9
35030, 익산시,095005, 94세,2016,134,33,101,32.7,134,33,101,32.7
35030, 익산시,100,95~99세,2016,178,27,151,17.9,178,27,151,17.9
35030, 익산시,100001, 95세,2016,58,8,50,16,58,8,50,16
35030, 익산시,100002, 96세,2016,50,8,42,19,50,8,42,19
35030, 익산시,100003, 97세,2016,31,6,25,24,31,6,25,24
35030, 익산시,100004, 98세,2016,22,X,19,15.8,22,X,19,15.8
35030, 익산시,100005, 99세,2016,17,X,15,13.3,17,X,15,13.3
35030, 익산시,101,100세이상,2016,30,X,26,15.4,30,X,26,15.4
35030, 익산시,102,15세미만,2016,38825,19899,18926,105.1,38733,19851,18882,105.1
35030, 익산시,103,15~64세,2016,214786,111941,102845,108.8,209810,109277,100533,108.7
35030, 익산시,104,65세이상,2016,47318,19484,27834,70,47198,19435,27763,70
35030, 익산시,086,85세이상,2016,4560,1151,3409,33.8,4555,1149,3406,33.7
35030, 익산시,126,평균연령,2016,41.6,39.9,43.2,,41.7,40,43.3,
35030, 익산시,127,중위연령,2016,42.6,40.7,44.4,,42.9,41,44.7,
35040, 정읍시,000,합계,2016,109968,54687,55281,98.9,107363,53114,54249,97.9
35040, 정읍시,005,0~4세,2016,3638,1877,1761,106.6,3624,1870,1754,106.6
35040, 정읍시,005001, 0세,2016,642,332,310,107.1,641,332,309,107.4
35040, 정읍시,005002, 1세,2016,691,372,319,116.6,687,371,316,117.4
35040, 정읍시,005003, 2세,2016,724,354,370,95.7,721,353,368,95.9
35040, 정읍시,005004, 3세,2016,715,374,341,109.7,710,370,340,108.8
35040, 정읍시,005005, 4세,2016,866,445,421,105.7,865,444,421,105.5
35040, 정읍시,010,5~9세,2016,4224,2207,2017,109.4,4211,2202,2009,109.6
35040, 정읍시,010001, 5세,2016,892,457,435,105.1,889,456,433,105.3
35040, 정읍시,010002, 6세,2016,787,419,368,113.9,781,417,364,114.6
35040, 정읍시,010003, 7세,2016,750,420,330,127.3,750,420,330,127.3
35040, 정읍시,010004, 8세,2016,876,451,425,106.1,874,450,424,106.1
35040, 정읍시,010005, 9세,2016,919,460,459,100.2,917,459,458,100.2
35040, 정읍시,015,10~14세,2016,4857,2592,2265,114.4,4848,2587,2261,114.4
35040, 정읍시,015001, 10세,2016,845,449,396,113.4,843,449,394,114
35040, 정읍시,015002, 11세,2016,866,439,427,102.8,865,438,427,102.6
35040, 정읍시,015003, 12세,2016,956,516,440,117.3,956,516,440,117.3
35040, 정읍시,015004, 13세,2016,1019,557,462,120.6,1015,554,461,120.2
35040, 정읍시,015005, 14세,2016,1171,631,540,116.9,1169,630,539,116.9
35040, 정읍시,020,15~19세,2016,6421,3335,3086,108.1,6388,3310,3078,107.5
35040, 정읍시,020001, 15세,2016,1218,640,578,110.7,1216,639,577,110.7
35040, 정읍시,020002, 16세,2016,1459,763,696,109.6,1454,761,693,109.8
35040, 정읍시,020003, 17세,2016,1386,690,696,99.1,1383,687,696,98.7
35040, 정읍시,020004, 18세,2016,1381,714,667,107,1375,708,667,106.1
35040, 정읍시,020005, 19세,2016,977,528,449,117.6,960,515,445,115.7
35040, 정읍시,025,20~24세,2016,5751,3320,2431,136.6,5401,3107,2294,135.4
35040, 정읍시,025001, 20세,2016,1244,777,467,166.4,1205,754,451,167.2
35040, 정읍시,025002, 21세,2016,1244,764,480,159.2,1179,719,460,156.3
35040, 정읍시,025003, 22세,2016,1201,695,506,137.4,1134,651,483,134.8
35040, 정읍시,025004, 23세,2016,992,535,457,117.1,910,486,424,114.6
35040, 정읍시,025005, 24세,2016,1070,549,521,105.4,973,497,476,104.4
35040, 정읍시,030,25~29세,2016,4925,2751,2174,126.5,4326,2382,1944,122.5
35040, 정읍시,030001, 25세,2016,1038,572,466,122.7,930,496,434,114.3
35040, 정읍시,030002, 26세,2016,1049,595,454,131.1,905,506,399,126.8
35040, 정읍시,030003, 27세,2016,959,530,429,123.5,841,464,377,123.1
35040, 정읍시,030004, 28세,2016,961,536,425,126.1,841,471,370,127.3
35040, 정읍시,030005, 29세,2016,918,518,400,129.5,809,445,364,122.3
35040, 정읍시,035,30~34세,2016,5021,2729,2292,119.1,4597,2440,2157,113.1
35040, 정읍시,035001, 30세,2016,927,509,418,121.8,854,457,397,115.1
35040, 정읍시,035002, 31세,2016,881,475,406,117,799,421,378,111.4
35040, 정읍시,035003, 32세,2016,1007,544,463,117.5,898,478,420,113.8
35040, 정읍시,035004, 33세,2016,1070,594,476,124.8,988,535,453,118.1
35040, 정읍시,035005, 34세,2016,1136,607,529,114.7,1058,549,509,107.9
35040, 정읍시,040,35~39세,2016,6257,3311,2946,112.4,5972,3117,2855,109.2
35040, 정읍시,040001, 35세,2016,1214,666,548,121.5,1140,614,526,116.7
35040, 정읍시,040002, 36세,2016,1232,633,599,105.7,1173,599,574,104.4
35040, 정읍시,040003, 37세,2016,1253,664,589,112.7,1201,631,570,110.7
35040, 정읍시,040004, 38세,2016,1252,665,587,113.3,1193,622,571,108.9
35040, 정읍시,040005, 39세,2016,1306,683,623,109.6,1265,651,614,106
35040, 정읍시,045,40~44세,2016,7600,4008,3592,111.6,7410,3895,3515,110.8
35040, 정읍시,045001, 40세,2016,1338,712,626,113.7,1288,682,606,112.5
35040, 정읍시,045002, 41세,2016,1408,712,696,102.3,1375,698,677,103.1
35040, 정읍시,045003, 42세,2016,1620,873,747,116.9,1582,847,735,115.2
35040, 정읍시,045004, 43세,2016,1635,844,791,106.7,1594,816,778,104.9
35040, 정읍시,045005, 44세,2016,1599,867,732,118.4,1571,852,719,118.5
35040, 정읍시,050,45~49세,2016,8621,4623,3998,115.6,8426,4514,3912,115.4
35040, 정읍시,050001, 45세,2016,1753,904,849,106.5,1713,884,829,106.6
35040, 정읍시,050002, 46세,2016,1669,900,769,117,1629,884,745,118.7
35040, 정읍시,050003, 47세,2016,1748,950,798,119,1708,926,782,118.4
35040, 정읍시,050004, 48세,2016,1783,955,828,115.3,1740,927,813,114
35040, 정읍시,050005, 49세,2016,1668,914,754,121.2,1636,893,743,120.2
35040, 정읍시,055,50~54세,2016,8601,4614,3987,115.7,8416,4523,3893,116.2
35040, 정읍시,055001, 50세,2016,1690,918,772,118.9,1657,905,752,120.3
35040, 정읍시,055002, 51세,2016,1763,943,820,115,1724,925,799,115.8
35040, 정읍시,055003, 52세,2016,1656,872,784,111.2,1620,852,768,110.9
35040, 정읍시,055004, 53세,2016,1714,913,801,114,1672,893,779,114.6
35040, 정읍시,055005, 54세,2016,1778,968,810,119.5,1743,948,795,119.2
35040, 정읍시,060,55~59세,2016,9448,4872,4576,106.5,9303,4806,4497,106.9
35040, 정읍시,060001, 55세,2016,2081,1056,1025,103,2063,1051,1012,103.9
35040, 정읍시,060002, 56세,2016,2024,1012,1012,100,1983,994,989,100.5
35040, 정읍시,060003, 57세,2016,1773,947,826,114.6,1752,938,814,115.2
35040, 정읍시,060004, 58세,2016,1724,868,856,101.4,1684,847,837,101.2
35040, 정읍시,060005, 59세,2016,1846,989,857,115.4,1821,976,845,115.5
35040, 정읍시,065,60~64세,2016,7465,3601,3864,93.2,7377,3550,3827,92.8
35040, 정읍시,065001, 60세,2016,1529,764,765,99.9,1509,751,758,99.1
35040, 정읍시,065002, 61세,2016,1809,889,920,96.6,1785,876,909,96.4
35040, 정읍시,065003, 62세,2016,1536,732,804,91,1516,716,800,89.5
35040, 정읍시,065004, 63세,2016,1178,540,638,84.6,1165,535,630,84.9
35040, 정읍시,065005, 64세,2016,1413,676,737,91.7,1402,672,730,92.1
35040, 정읍시,070,65~69세,2016,7084,3408,3676,92.7,7045,3386,3659,92.5
35040, 정읍시,070001, 65세,2016,1244,582,662,87.9,1237,577,660,87.4
35040, 정읍시,070002, 66세,2016,1438,698,740,94.3,1426,690,736,93.8
35040, 정읍시,070003, 67세,2016,1461,698,763,91.5,1451,693,758,91.4
35040, 정읍시,070004, 68세,2016,1413,709,704,100.7,1407,707,700,101
35040, 정읍시,070005, 69세,2016,1528,721,807,89.3,1524,719,805,89.3
35040, 정읍시,075,70~74세,2016,6544,2785,3759,74.1,6525,2778,3747,74.1
35040, 정읍시,075001, 70세,2016,1189,571,618,92.4,1186,571,615,92.8
35040, 정읍시,075002, 71세,2016,1121,464,657,70.6,1115,461,654,70.5
35040, 정읍시,075003, 72세,2016,1145,492,653,75.3,1141,490,651,75.3
35040, 정읍시,075004, 73세,2016,1284,532,752,70.7,1282,532,750,70.9
35040, 정읍시,075005, 74세,2016,1805,726,1079,67.3,1801,724,1077,67.2
35040, 정읍시,080,75~79세,2016,6166,2431,3735,65.1,6151,2425,3726,65.1
35040, 정읍시,080001, 75세,2016,1305,520,785,66.2,1301,520,781,66.6
35040, 정읍시,080002, 76세,2016,1264,509,755,67.4,1262,509,753,67.6
35040, 정읍시,080003, 77세,2016,1282,491,791,62.1,1279,490,789,62.1
35040, 정읍시,080004, 78세,2016,1192,472,720,65.6,1190,470,720,65.3
35040, 정읍시,080005, 79세,2016,1123,439,684,64.2,1119,436,683,63.8
35040, 정읍시,085,80~84세,2016,4580,1538,3042,50.6,4578,1537,3041,50.5
35040, 정읍시,085001, 80세,2016,1063,376,687,54.7,1063,376,687,54.7
35040, 정읍시,085002, 81세,2016,1120,369,751,49.1,1118,368,750,49.1
35040, 정읍시,085003, 82세,2016,957,332,625,53.1,957,332,625,53.1
35040, 정읍시,085004, 83세,2016,814,281,533,52.7,814,281,533,52.7
35040, 정읍시,085005, 84세,2016,626,180,446,40.4,626,180,446,40.4
35040, 정읍시,090,85~89세,2016,2084,537,1547,34.7,2084,537,1547,34.7
35040, 정읍시,090001, 85세,2016,517,145,372,39,517,145,372,39
35040, 정읍시,090002, 86세,2016,473,106,367,28.9,473,106,367,28.9
35040, 정읍시,090003, 87세,2016,430,129,301,42.9,430,129,301,42.9
35040, 정읍시,090004, 88세,2016,370,94,276,34.1,370,94,276,34.1
35040, 정읍시,090005, 89세,2016,294,63,231,27.3,294,63,231,27.3
35040, 정읍시,095,90~94세,2016,520,124,396,31.3,520,124,396,31.3
35040, 정읍시,095001, 90세,2016,134,36,98,36.7,134,36,98,36.7
35040, 정읍시,095002, 91세,2016,107,31,76,40.8,107,31,76,40.8
35040, 정읍시,095003, 92세,2016,90,23,67,34.3,90,23,67,34.3
35040, 정읍시,095004, 93세,2016,117,18,99,18.2,117,18,99,18.2
35040, 정읍시,095005, 94세,2016,72,16,56,28.6,72,16,56,28.6
35040, 정읍시,100,95~99세,2016,153,23,130,17.7,153,23,130,17.7
35040, 정읍시,100001, 95세,2016,56,14,42,33.3,56,14,42,33.3
35040, 정읍시,100002, 96세,2016,39,X,37,5.4,39,X,37,5.4
35040, 정읍시,100003, 97세,2016,35,X,31,12.9,35,X,31,12.9
35040, 정읍시,100004, 98세,2016,15,X,13,15.4,15,X,13,15.4
35040, 정읍시,100005, 99세,2016,8,X,7,14.3,8,X,7,14.3
35040, 정읍시,101,100세이상,2016,8,X,7,14.3,8,X,7,14.3
35040, 정읍시,102,15세미만,2016,12719,6676,6043,110.5,12683,6659,6024,110.5
35040, 정읍시,103,15~64세,2016,70110,37164,32946,112.8,67616,35644,31972,111.5
35040, 정읍시,104,65세이상,2016,27139,10847,16292,66.6,27064,10811,16253,66.5
35040, 정읍시,086,85세이상,2016,2765,685,2080,32.9,2765,685,2080,32.9
35040, 정읍시,126,평균연령,2016,46.6,44.3,48.9,,46.8,44.5,49.1,
35040, 정읍시,127,중위연령,2016,48.6,46.3,51.4,,49.1,46.9,51.7,
35050, 남원시,000,합계,2016,80076,39215,40861,96,78985,38753,40232,96.3
35050, 남원시,005,0~4세,2016,2666,1412,1254,112.6,2658,1409,1249,112.8
35050, 남원시,005001, 0세,2016,490,250,240,104.2,489,249,240,103.8
35050, 남원시,005002, 1세,2016,490,266,224,118.8,488,265,223,118.8
35050, 남원시,005003, 2세,2016,536,277,259,106.9,534,276,258,107
35050, 남원시,005004, 3세,2016,571,304,267,113.9,570,304,266,114.3
35050, 남원시,005005, 4세,2016,579,315,264,119.3,577,315,262,120.2
35050, 남원시,010,5~9세,2016,3230,1672,1558,107.3,3222,1668,1554,107.3
35050, 남원시,010001, 5세,2016,670,330,340,97.1,668,328,340,96.5
35050, 남원시,010002, 6세,2016,603,311,292,106.5,603,311,292,106.5
35050, 남원시,010003, 7세,2016,612,346,266,130.1,611,346,265,130.6
35050, 남원시,010004, 8세,2016,682,353,329,107.3,680,353,327,108
35050, 남원시,010005, 9세,2016,663,332,331,100.3,660,330,330,100
35050, 남원시,015,10~14세,2016,3660,1872,1788,104.7,3657,1870,1787,104.6
35050, 남원시,015001, 10세,2016,650,333,317,105,649,332,317,104.7
35050, 남원시,015002, 11세,2016,690,346,344,100.6,690,346,344,100.6
35050, 남원시,015003, 12세,2016,723,382,341,112,721,381,340,112.1
35050, 남원시,015004, 13세,2016,780,405,375,108,780,405,375,108
35050, 남원시,015005, 14세,2016,817,406,411,98.8,817,406,411,98.8
35050, 남원시,020,15~19세,2016,4376,2347,2029,115.7,4358,2337,2021,115.6
35050, 남원시,020001, 15세,2016,970,496,474,104.6,970,496,474,104.6
35050, 남원시,020002, 16세,2016,938,479,459,104.4,938,479,459,104.4
35050, 남원시,020003, 17세,2016,939,488,451,108.2,935,487,448,108.7
35050, 남원시,020004, 18세,2016,887,484,403,120.1,884,484,400,121
35050, 남원시,020005, 19세,2016,642,400,242,165.3,631,391,240,162.9
35050, 남원시,025,20~24세,2016,4078,2372,1706,139,3944,2324,1620,143.5
35050, 남원시,025001, 20세,2016,892,567,325,174.5,882,562,320,175.6
35050, 남원시,025002, 21세,2016,841,530,311,170.4,819,522,297,175.8
35050, 남원시,025003, 22세,2016,820,452,368,122.8,798,448,350,128
35050, 남원시,025004, 23세,2016,757,404,353,114.4,714,390,324,120.4
35050, 남원시,025005, 24세,2016,768,419,349,120.1,731,402,329,122.2
35050, 남원시,030,25~29세,2016,3242,1730,1512,114.4,3061,1649,1412,116.8
35050, 남원시,030001, 25세,2016,690,364,326,111.7,651,356,295,120.7
35050, 남원시,030002, 26세,2016,648,356,292,121.9,614,339,275,123.3
35050, 남원시,030003, 27세,2016,643,329,314,104.8,614,310,304,102
35050, 남원시,030004, 28세,2016,658,348,310,112.3,609,326,283,115.2
35050, 남원시,030005, 29세,2016,603,333,270,123.3,573,318,255,124.7
35050, 남원시,035,30~34세,2016,3362,1751,1611,108.7,3206,1690,1516,111.5
35050, 남원시,035001, 30세,2016,605,298,307,97.1,567,284,283,100.4
35050, 남원시,035002, 31세,2016,618,321,297,108.1,588,309,279,110.8
35050, 남원시,035003, 32세,2016,690,376,314,119.7,657,364,293,124.2
35050, 남원시,035004, 33세,2016,703,366,337,108.6,677,354,323,109.6
35050, 남원시,035005, 34세,2016,746,390,356,109.6,717,379,338,112.1
35050, 남원시,040,35~39세,2016,4252,2090,2162,96.7,4130,2036,2094,97.2
35050, 남원시,040001, 35세,2016,791,408,383,106.5,766,398,368,108.2
35050, 남원시,040002, 36세,2016,871,421,450,93.6,845,413,432,95.6
35050, 남원시,040003, 37세,2016,869,430,439,97.9,846,420,426,98.6
35050, 남원시,040004, 38세,2016,821,408,413,98.8,798,395,403,98
35050, 남원시,040005, 39세,2016,900,423,477,88.7,875,410,465,88.2
35050, 남원시,045,40~44세,2016,5607,2934,2673,109.8,5498,2884,2614,110.3
35050, 남원시,045001, 40세,2016,968,490,478,102.5,951,480,471,101.9
35050, 남원시,045002, 41세,2016,981,476,505,94.3,961,472,489,96.5
35050, 남원시,045003, 42세,2016,1210,641,569,112.7,1183,629,554,113.5
35050, 남원시,045004, 43세,2016,1235,681,554,122.9,1221,670,551,121.6
35050, 남원시,045005, 44세,2016,1213,646,567,113.9,1182,633,549,115.3
35050, 남원시,050,45~49세,2016,6456,3406,3050,111.7,6362,3363,2999,112.1
35050, 남원시,050001, 45세,2016,1311,683,628,108.8,1293,675,618,109.2
35050, 남원시,050002, 46세,2016,1183,666,517,128.8,1160,653,507,128.8
35050, 남원시,050003, 47세,2016,1376,739,637,116,1357,731,626,116.8
35050, 남원시,050004, 48세,2016,1345,684,661,103.5,1328,678,650,104.3
35050, 남원시,050005, 49세,2016,1241,634,607,104.4,1224,626,598,104.7
35050, 남원시,055,50~54세,2016,6179,3310,2869,115.4,6090,3283,2807,117
35050, 남원시,055001, 50세,2016,1249,635,614,103.4,1240,634,606,104.6
35050, 남원시,055002, 51세,2016,1261,677,584,115.9,1233,669,564,118.6
35050, 남원시,055003, 52세,2016,1050,584,466,125.3,1031,579,452,128.1
35050, 남원시,055004, 53세,2016,1206,656,550,119.3,1186,647,539,120
35050, 남원시,055005, 54세,2016,1413,758,655,115.7,1400,754,646,116.7
35050, 남원시,060,55~59세,2016,6973,3528,3445,102.4,6899,3492,3407,102.5
35050, 남원시,060001, 55세,2016,1493,734,759,96.7,1476,724,752,96.3
35050, 남원시,060002, 56세,2016,1615,825,790,104.4,1604,821,783,104.9
35050, 남원시,060003, 57세,2016,1354,665,689,96.5,1345,660,685,96.4
35050, 남원시,060004, 58세,2016,1257,653,604,108.1,1238,647,591,109.5
35050, 남원시,060005, 59세,2016,1254,651,603,108,1236,640,596,107.4
35050, 남원시,065,60~64세,2016,5785,2845,2940,96.8,5733,2822,2911,96.9
35050, 남원시,065001, 60세,2016,1226,567,659,86,1208,560,648,86.4
35050, 남원시,065002, 61세,2016,1315,645,670,96.3,1300,638,662,96.4
35050, 남원시,065003, 62세,2016,1162,591,571,103.5,1155,587,568,103.3
35050, 남원시,065004, 63세,2016,963,491,472,104,959,490,469,104.5
35050, 남원시,065005, 64세,2016,1119,551,568,97,1111,547,564,97
35050, 남원시,070,65~69세,2016,5320,2493,2827,88.2,5296,2482,2814,88.2
35050, 남원시,070001, 65세,2016,958,463,495,93.5,950,461,489,94.3
35050, 남원시,070002, 66세,2016,1052,507,545,93,1046,503,543,92.6
35050, 남원시,070003, 67세,2016,1013,445,568,78.3,1010,443,567,78.1
35050, 남원시,070004, 68세,2016,1104,486,618,78.6,1100,484,616,78.6
35050, 남원시,070005, 69세,2016,1193,592,601,98.5,1190,591,599,98.7
35050, 남원시,075,70~74세,2016,4662,1905,2757,69.1,4653,1901,2752,69.1
35050, 남원시,075001, 70세,2016,862,405,457,88.6,860,405,455,89
35050, 남원시,075002, 71세,2016,779,334,445,75.1,776,332,444,74.8
35050, 남원시,075003, 72세,2016,758,296,462,64.1,756,295,461,64
35050, 남원시,075004, 73세,2016,873,353,520,67.9,872,352,520,67.7
35050, 남원시,075005, 74세,2016,1390,517,873,59.2,1389,517,872,59.3
35050, 남원시,080,75~79세,2016,4618,1792,2826,63.4,4614,1791,2823,63.4
35050, 남원시,080001, 75세,2016,1004,412,592,69.6,1004,412,592,69.6
35050, 남원시,080002, 76세,2016,878,357,521,68.5,877,356,521,68.3
35050, 남원시,080003, 77세,2016,963,373,590,63.2,962,373,589,63.3
35050, 남원시,080004, 78세,2016,878,343,535,64.1,876,343,533,64.4
35050, 남원시,080005, 79세,2016,895,307,588,52.2,895,307,588,52.2
35050, 남원시,085,80~84세,2016,3418,1150,2268,50.7,3416,1149,2267,50.7
35050, 남원시,085001, 80세,2016,750,291,459,63.4,750,291,459,63.4
35050, 남원시,085002, 81세,2016,832,278,554,50.2,831,277,554,50
35050, 남원시,085003, 82세,2016,762,230,532,43.2,761,230,531,43.3
35050, 남원시,085004, 83세,2016,551,188,363,51.8,551,188,363,51.8
35050, 남원시,085005, 84세,2016,523,163,360,45.3,523,163,360,45.3
35050, 남원시,090,85~89세,2016,1548,455,1093,41.6,1547,455,1092,41.7
35050, 남원시,090001, 85세,2016,388,117,271,43.2,388,117,271,43.2
35050, 남원시,090002, 86세,2016,321,89,232,38.4,321,89,232,38.4
35050, 남원시,090003, 87세,2016,289,92,197,46.7,288,92,196,46.9
35050, 남원시,090004, 88세,2016,311,86,225,38.2,311,86,225,38.2
35050, 남원시,090005, 89세,2016,239,71,168,42.3,239,71,168,42.3
35050, 남원시,095,90~94세,2016,514,134,380,35.3,511,131,380,34.5
35050, 남원시,095001, 90세,2016,162,37,125,29.6,161,36,125,28.8
35050, 남원시,095002, 91세,2016,103,27,76,35.5,101,25,76,32.9
35050, 남원시,095003, 92세,2016,84,17,67,25.4,84,17,67,25.4
35050, 남원시,095004, 93세,2016,96,32,64,50,96,32,64,50
35050, 남원시,095005, 94세,2016,69,21,48,43.8,69,21,48,43.8
35050, 남원시,100,95~99세,2016,120,17,103,16.5,120,17,103,16.5
35050, 남원시,100001, 95세,2016,36,6,30,20,36,6,30,20
35050, 남원시,100002, 96세,2016,41,6,35,17.1,41,6,35,17.1
35050, 남원시,100003, 97세,2016,15,X,13,15.4,15,X,13,15.4
35050, 남원시,100004, 98세,2016,19,X,17,11.8,19,X,17,11.8
35050, 남원시,100005, 99세,2016,9,X,8,12.5,9,X,8,12.5
35050, 남원시,101,100세이상,2016,10,X,10,0,10,X,10,0
35050, 남원시,102,15세미만,2016,9556,4956,4600,107.7,9537,4947,4590,107.8
35050, 남원시,103,15~64세,2016,50310,26313,23997,109.7,49281,25880,23401,110.6
35050, 남원시,104,65세이상,2016,20210,7946,12264,64.8,20167,7926,12241,64.7
35050, 남원시,086,85세이상,2016,2192,606,1586,38.2,2188,603,1585,38
35050, 남원시,126,평균연령,2016,47,44.7,49.3,,47.2,44.7,49.5,
35050, 남원시,127,중위연령,2016,49.3,47.1,51.8,,49.5,47.2,52.2,
35060, 김제시,000,합계,2016,82888,41139,41749,98.5,80658,39643,41015,96.7
35060, 김제시,005,0~4세,2016,2478,1273,1205,105.6,2466,1270,1196,106.2
35060, 김제시,005001, 0세,2016,430,219,211,103.8,428,219,209,104.8
35060, 김제시,005002, 1세,2016,477,221,256,86.3,475,221,254,87
35060, 김제시,005003, 2세,2016,464,246,218,112.8,462,246,216,113.9
35060, 김제시,005004, 3세,2016,511,278,233,119.3,509,276,233,118.5
35060, 김제시,005005, 4세,2016,596,309,287,107.7,592,308,284,108.5
35060, 김제시,010,5~9세,2016,2838,1444,1394,103.6,2826,1437,1389,103.5
35060, 김제시,010001, 5세,2016,613,287,326,88,611,286,325,88
35060, 김제시,010002, 6세,2016,536,275,261,105.4,532,273,259,105.4
35060, 김제시,010003, 7세,2016,568,295,273,108.1,565,293,272,107.7
35060, 김제시,010004, 8세,2016,549,289,260,111.2,548,288,260,110.8
35060, 김제시,010005, 9세,2016,572,298,274,108.8,570,297,273,108.8
35060, 김제시,015,10~14세,2016,2898,1494,1404,106.4,2892,1491,1401,106.4
35060, 김제시,015001, 10세,2016,551,289,262,110.3,551,289,262,110.3
35060, 김제시,015002, 11세,2016,547,297,250,118.8,544,295,249,118.5
35060, 김제시,015003, 12세,2016,534,260,274,94.9,532,259,273,94.9
35060, 김제시,015004, 13세,2016,601,299,302,99,600,299,301,99.3
35060, 김제시,015005, 14세,2016,665,349,316,110.4,665,349,316,110.4
35060, 김제시,020,15~19세,2016,3777,2000,1777,112.5,3754,1987,1767,112.5
35060, 김제시,020001, 15세,2016,760,384,376,102.1,758,382,376,101.6
35060, 김제시,020002, 16세,2016,793,395,398,99.2,789,392,397,98.7
35060, 김제시,020003, 17세,2016,742,387,355,109,737,384,353,108.8
35060, 김제시,020004, 18세,2016,830,449,381,117.8,826,446,380,117.4
35060, 김제시,020005, 19세,2016,652,385,267,144.2,644,383,261,146.7
35060, 김제시,025,20~24세,2016,4199,2476,1723,143.7,3886,2280,1606,142
35060, 김제시,025001, 20세,2016,761,452,309,146.3,743,441,302,146
35060, 김제시,025002, 21세,2016,867,510,357,142.9,828,488,340,143.5
35060, 김제시,025003, 22세,2016,957,603,354,170.3,886,553,333,166.1
35060, 김제시,025004, 23세,2016,831,471,360,130.8,743,422,321,131.5
35060, 김제시,025005, 24세,2016,783,440,343,128.3,686,376,310,121.3
35060, 김제시,030,25~29세,2016,3833,2189,1644,133.2,3278,1805,1473,122.5
35060, 김제시,030001, 25세,2016,793,446,347,128.5,691,377,314,120.1
35060, 김제시,030002, 26세,2016,821,496,325,152.6,703,411,292,140.8
35060, 김제시,030003, 27세,2016,723,426,297,143.4,607,345,262,131.7
35060, 김제시,030004, 28세,2016,733,403,330,122.1,616,329,287,114.6
35060, 김제시,030005, 29세,2016,763,418,345,121.2,661,343,318,107.9
35060, 김제시,035,30~34세,2016,3867,2204,1663,132.5,3402,1855,1547,119.9
35060, 김제시,035001, 30세,2016,752,440,312,141,648,358,290,123.4
35060, 김제시,035002, 31세,2016,671,385,286,134.6,577,315,262,120.2
35060, 김제시,035003, 32세,2016,786,458,328,139.6,689,386,303,127.4
35060, 김제시,035004, 33세,2016,752,408,344,118.6,665,346,319,108.5
35060, 김제시,035005, 34세,2016,906,513,393,130.5,823,450,373,120.6
35060, 김제시,040,35~39세,2016,4334,2425,1909,127,4048,2208,1840,120
35060, 김제시,040001, 35세,2016,905,530,375,141.3,842,477,365,130.7
35060, 김제시,040002, 36세,2016,878,485,393,123.4,809,431,378,114
35060, 김제시,040003, 37세,2016,838,460,378,121.7,773,413,360,114.7
35060, 김제시,040004, 38세,2016,828,466,362,128.7,781,436,345,126.4
35060, 김제시,040005, 39세,2016,885,484,401,120.7,843,451,392,115.1
35060, 김제시,045,40~44세,2016,5031,2854,2177,131.1,4870,2736,2134,128.2
35060, 김제시,045001, 40세,2016,914,538,376,143.1,880,510,370,137.8
35060, 김제시,045002, 41세,2016,902,511,391,130.7,868,483,385,125.5
35060, 김제시,045003, 42세,2016,1096,613,483,126.9,1070,598,472,126.7
35060, 김제시,045004, 43세,2016,1028,560,468,119.7,1000,539,461,116.9
35060, 김제시,045005, 44세,2016,1091,632,459,137.7,1052,606,446,135.9
35060, 김제시,050,45~49세,2016,5673,3162,2511,125.9,5533,3085,2448,126
35060, 김제시,050001, 45세,2016,1092,633,459,137.9,1052,610,442,138
35060, 김제시,050002, 46세,2016,1139,639,500,127.8,1114,624,490,127.3
35060, 김제시,050003, 47세,2016,1113,616,497,123.9,1090,602,488,123.4
35060, 김제시,050004, 48세,2016,1224,655,569,115.1,1190,638,552,115.6
35060, 김제시,050005, 49세,2016,1105,619,486,127.4,1087,611,476,128.4
35060, 김제시,055,50~54세,2016,6234,3306,2928,112.9,6139,3260,2879,113.2
35060, 김제시,055001, 50세,2016,1142,644,498,129.3,1122,636,486,130.9
35060, 김제시,055002, 51세,2016,1233,668,565,118.2,1213,657,556,118.2
35060, 김제시,055003, 52세,2016,1218,647,571,113.3,1197,635,562,113
35060, 김제시,055004, 53세,2016,1275,656,619,106,1259,649,610,106.4
35060, 김제시,055005, 54세,2016,1366,691,675,102.4,1348,683,665,102.7
35060, 김제시,060,55~59세,2016,7487,3746,3741,100.1,7420,3713,3707,100.2
35060, 김제시,060001, 55세,2016,1524,786,738,106.5,1511,779,732,106.4
35060, 김제시,060002, 56세,2016,1698,833,865,96.3,1681,826,855,96.6
35060, 김제시,060003, 57세,2016,1420,696,724,96.1,1410,694,716,96.9
35060, 김제시,060004, 58세,2016,1429,705,724,97.4,1413,695,718,96.8
35060, 김제시,060005, 59세,2016,1416,726,690,105.2,1405,719,686,104.8
35060, 김제시,065,60~64세,2016,6472,3190,3282,97.2,6420,3169,3251,97.5
35060, 김제시,065001, 60세,2016,1432,737,695,106,1422,731,691,105.8
35060, 김제시,065002, 61세,2016,1470,723,747,96.8,1461,721,740,97.4
35060, 김제시,065003, 62세,2016,1300,624,676,92.3,1283,620,663,93.5
35060, 김제시,065004, 63세,2016,1030,513,517,99.2,1025,510,515,99
35060, 김제시,065005, 64세,2016,1240,593,647,91.7,1229,587,642,91.4
35060, 김제시,070,65~69세,2016,6146,2889,3257,88.7,6117,2868,3249,88.3
35060, 김제시,070001, 65세,2016,1200,576,624,92.3,1191,570,621,91.8
35060, 김제시,070002, 66세,2016,1323,603,720,83.8,1311,595,716,83.1
35060, 김제시,070003, 67세,2016,1149,530,619,85.6,1146,527,619,85.1
35060, 김제시,070004, 68세,2016,1113,560,553,101.3,1109,557,552,100.9
35060, 김제시,070005, 69세,2016,1361,620,741,83.7,1360,619,741,83.5
35060, 김제시,075,70~74세,2016,5520,2397,3123,76.8,5514,2392,3122,76.6
35060, 김제시,075001, 70세,2016,974,465,509,91.4,972,464,508,91.3
35060, 김제시,075002, 71세,2016,926,407,519,78.4,924,405,519,78
35060, 김제시,075003, 72세,2016,956,402,554,72.6,955,401,554,72.4
35060, 김제시,075004, 73세,2016,1046,446,600,74.3,1045,445,600,74.2
35060, 김제시,075005, 74세,2016,1618,677,941,71.9,1618,677,941,71.9
35060, 김제시,080,75~79세,2016,5325,2036,3289,61.9,5323,2035,3288,61.9
35060, 김제시,080001, 75세,2016,1097,452,645,70.1,1096,451,645,69.9
35060, 김제시,080002, 76세,2016,1047,416,631,65.9,1047,416,631,65.9
35060, 김제시,080003, 77세,2016,1132,415,717,57.9,1132,415,717,57.9
35060, 김제시,080004, 78세,2016,1037,383,654,58.6,1037,383,654,58.6
35060, 김제시,080005, 79세,2016,1012,370,642,57.6,1011,370,641,57.7
35060, 김제시,085,80~84세,2016,4133,1342,2791,48.1,4129,1340,2789,48
35060, 김제시,085001, 80세,2016,913,307,606,50.7,912,307,605,50.7
35060, 김제시,085002, 81세,2016,949,341,608,56.1,947,340,607,56
35060, 김제시,085003, 82세,2016,817,267,550,48.5,817,267,550,48.5
35060, 김제시,085004, 83세,2016,825,235,590,39.8,824,234,590,39.7
35060, 김제시,085005, 84세,2016,629,192,437,43.9,629,192,437,43.9
35060, 김제시,090,85~89세,2016,1958,552,1406,39.3,1957,552,1405,39.3
35060, 김제시,090001, 85세,2016,466,146,320,45.6,466,146,320,45.6
35060, 김제시,090002, 86세,2016,495,124,371,33.4,494,124,370,33.5
35060, 김제시,090003, 87세,2016,408,125,283,44.2,408,125,283,44.2
35060, 김제시,090004, 88세,2016,342,96,246,39,342,96,246,39
35060, 김제시,090005, 89세,2016,247,61,186,32.8,247,61,186,32.8
35060, 김제시,095,90~94세,2016,556,140,416,33.7,556,140,416,33.7
35060, 김제시,095001, 90세,2016,177,51,126,40.5,177,51,126,40.5
35060, 김제시,095002, 91세,2016,127,35,92,38,127,35,92,38
35060, 김제시,095003, 92세,2016,88,23,65,35.4,88,23,65,35.4
35060, 김제시,095004, 93세,2016,94,20,74,27,94,20,74,27
35060, 김제시,095005, 94세,2016,70,11,59,18.6,70,11,59,18.6
35060, 김제시,100,95~99세,2016,111,19,92,20.7,110,19,91,20.9
35060, 김제시,100001, 95세,2016,46,8,38,21.1,46,8,38,21.1
35060, 김제시,100002, 96세,2016,41,8,33,24.2,40,8,32,25
35060, 김제시,100003, 97세,2016,8,X,8,0,8,X,8,0
35060, 김제시,100004, 98세,2016,12,X,9,33.3,12,X,9,33.3
35060, 김제시,100005, 99세,2016,X,X,X,0,X,X,X,0
35060, 김제시,101,100세이상,2016,18,X,17,5.9,18,X,17,5.9
35060, 김제시,102,15세미만,2016,8214,4211,4003,105.2,8184,4198,3986,105.3
35060, 김제시,103,15~64세,2016,50907,27552,23355,118,48750,26098,22652,115.2
35060, 김제시,104,65세이상,2016,23767,9376,14391,65.2,23724,9347,14377,65
35060, 김제시,086,85세이상,2016,2643,712,1931,36.9,2641,712,1929,36.9
35060, 김제시,126,평균연령,2016,49.1,46.3,51.8,,49.5,46.8,52.1,
35060, 김제시,127,중위연령,2016,52.1,48.5,55.7,,52.9,49.5,56.1,
35310, 완주군,000,합계,2016,97340,49858,47482,105,94786,48464,46322,104.6
35310, 완주군,005,0~4세,2016,4611,2323,2288,101.5,4594,2310,2284,101.1
35310, 완주군,005001, 0세,2016,809,412,397,103.8,804,407,397,102.5
35310, 완주군,005002, 1세,2016,933,472,461,102.4,931,471,460,102.4
35310, 완주군,005003, 2세,2016,866,430,436,98.6,862,427,435,98.2
35310, 완주군,005004, 3세,2016,983,492,491,100.2,978,489,489,100
35310, 완주군,005005, 4세,2016,1020,517,503,102.8,1019,516,503,102.6
35310, 완주군,010,5~9세,2016,4565,2394,2171,110.3,4558,2391,2167,110.3
35310, 완주군,010001, 5세,2016,977,530,447,118.6,974,529,445,118.9
35310, 완주군,010002, 6세,2016,927,507,420,120.7,926,507,419,121
35310, 완주군,010003, 7세,2016,845,421,424,99.3,844,421,423,99.5
35310, 완주군,010004, 8세,2016,913,474,439,108,911,472,439,107.5
35310, 완주군,010005, 9세,2016,903,462,441,104.8,903,462,441,104.8
35310, 완주군,015,10~14세,2016,3985,2122,1863,113.9,3978,2118,1860,113.9
35310, 완주군,015001, 10세,2016,819,436,383,113.8,817,434,383,113.3
35310, 완주군,015002, 11세,2016,777,392,385,101.8,776,391,385,101.6
35310, 완주군,015003, 12세,2016,774,436,338,129,772,435,337,129.1
35310, 완주군,015004, 13세,2016,770,409,361,113.3,768,409,359,113.9
35310, 완주군,015005, 14세,2016,845,449,396,113.4,845,449,396,113.4
35310, 완주군,020,15~19세,2016,6340,3388,2952,114.8,6271,3351,2920,114.8
35310, 완주군,020001, 15세,2016,1016,525,491,106.9,1015,524,491,106.7
35310, 완주군,020002, 16세,2016,1199,652,547,119.2,1198,651,547,119
35310, 완주군,020003, 17세,2016,1018,528,490,107.8,1014,528,486,108.6
35310, 완주군,020004, 18세,2016,1227,659,568,116,1215,651,564,115.4
35310, 완주군,020005, 19세,2016,1880,1024,856,119.6,1829,997,832,119.8
35310, 완주군,025,20~24세,2016,7562,4184,3378,123.9,6969,3908,3061,127.7
35310, 완주군,025001, 20세,2016,1774,838,936,89.5,1676,802,874,91.8
35310, 완주군,025002, 21세,2016,1492,752,740,101.6,1378,706,672,105.1
35310, 완주군,025003, 22세,2016,1563,899,664,135.4,1438,840,598,140.5
35310, 완주군,025004, 23세,2016,1444,887,557,159.2,1309,823,486,169.3
35310, 완주군,025005, 24세,2016,1289,808,481,168,1168,737,431,171
35310, 완주군,030,25~29세,2016,4932,2727,2205,123.7,4376,2404,1972,121.9
35310, 완주군,030001, 25세,2016,1085,663,422,157.1,965,591,374,158
35310, 완주군,030002, 26세,2016,1037,577,460,125.4,913,507,406,124.9
35310, 완주군,030003, 27세,2016,898,492,406,121.2,792,427,365,117
35310, 완주군,030004, 28세,2016,963,499,464,107.5,850,432,418,103.3
35310, 완주군,030005, 29세,2016,949,496,453,109.5,856,447,409,109.3
35310, 완주군,035,30~34세,2016,6027,3179,2848,111.6,5653,2952,2701,109.3
35310, 완주군,035001, 30세,2016,1056,561,495,113.3,962,508,454,111.9
35310, 완주군,035002, 31세,2016,1106,586,520,112.7,1029,538,491,109.6
35310, 완주군,035003, 32세,2016,1135,618,517,119.5,1064,569,495,114.9
35310, 완주군,035004, 33세,2016,1225,618,607,101.8,1154,579,575,100.7
35310, 완주군,035005, 34세,2016,1505,796,709,112.3,1444,758,686,110.5
35310, 완주군,040,35~39세,2016,6898,3757,3141,119.6,6675,3617,3058,118.3
35310, 완주군,040001, 35세,2016,1426,756,670,112.8,1374,728,646,112.7
35310, 완주군,040002, 36세,2016,1567,850,717,118.5,1508,811,697,116.4
35310, 완주군,040003, 37세,2016,1385,762,623,122.3,1341,735,606,121.3
35310, 완주군,040004, 38세,2016,1243,687,556,123.6,1203,663,540,122.8
35310, 완주군,040005, 39세,2016,1277,702,575,122.1,1249,680,569,119.5
35310, 완주군,045,40~44세,2016,6859,3855,3004,128.3,6684,3760,2924,128.6
35310, 완주군,045001, 40세,2016,1308,740,568,130.3,1268,714,554,128.9
35310, 완주군,045002, 41세,2016,1291,726,565,128.5,1261,710,551,128.9
35310, 완주군,045003, 42세,2016,1470,847,623,136,1432,824,608,135.5
35310, 완주군,045004, 43세,2016,1378,746,632,118,1347,733,614,119.4
35310, 완주군,045005, 44세,2016,1412,796,616,129.2,1376,779,597,130.5
35310, 완주군,050,45~49세,2016,6899,3866,3033,127.5,6735,3777,2958,127.7
35310, 완주군,050001, 45세,2016,1482,834,648,128.7,1453,821,632,129.9
35310, 완주군,050002, 46세,2016,1336,752,584,128.8,1294,726,568,127.8
35310, 완주군,050003, 47세,2016,1282,714,568,125.7,1256,698,558,125.1
35310, 완주군,050004, 48세,2016,1517,869,648,134.1,1483,851,632,134.7
35310, 완주군,050005, 49세,2016,1282,697,585,119.1,1249,681,568,119.9
35310, 완주군,055,50~54세,2016,6771,3671,3100,118.4,6622,3595,3027,118.8
35310, 완주군,055001, 50세,2016,1341,756,585,129.2,1309,739,570,129.6
35310, 완주군,055002, 51세,2016,1336,713,623,114.4,1299,695,604,115.1
35310, 완주군,055003, 52세,2016,1243,693,550,126,1215,678,537,126.3
35310, 완주군,055004, 53세,2016,1338,702,636,110.4,1311,690,621,111.1
35310, 완주군,055005, 54세,2016,1513,807,706,114.3,1488,793,695,114.1
35310, 완주군,060,55~59세,2016,7410,3785,3625,104.4,7317,3735,3582,104.3
35310, 완주군,060001, 55세,2016,1631,836,795,105.2,1609,825,784,105.2
35310, 완주군,060002, 56세,2016,1690,876,814,107.6,1669,864,805,107.3
35310, 완주군,060003, 57세,2016,1402,727,675,107.7,1384,718,666,107.8
35310, 완주군,060004, 58세,2016,1321,670,651,102.9,1304,659,645,102.2
35310, 완주군,060005, 59세,2016,1366,676,690,98,1351,669,682,98.1
35310, 완주군,065,60~64세,2016,6019,3073,2946,104.3,5956,3039,2917,104.2
35310, 완주군,065001, 60세,2016,1371,725,646,112.2,1353,717,636,112.7
35310, 완주군,065002, 61세,2016,1371,702,669,104.9,1358,695,663,104.8
35310, 완주군,065003, 62세,2016,1256,610,646,94.4,1245,601,644,93.3
35310, 완주군,065004, 63세,2016,948,498,450,110.7,936,493,443,111.3
35310, 완주군,065005, 64세,2016,1073,538,535,100.6,1064,533,531,100.4
35310, 완주군,070,65~69세,2016,5117,2523,2594,97.3,5083,2508,2575,97.4
35310, 완주군,070001, 65세,2016,959,486,473,102.7,951,482,469,102.8
35310, 완주군,070002, 66세,2016,1126,564,562,100.4,1118,562,556,101.1
35310, 완주군,070003, 67세,2016,999,483,516,93.6,994,480,514,93.4
35310, 완주군,070004, 68세,2016,960,460,500,92,956,456,500,91.2
35310, 완주군,070005, 69세,2016,1073,530,543,97.6,1064,528,536,98.5
35310, 완주군,075,70~74세,2016,4434,1952,2482,78.6,4419,1947,2472,78.8
35310, 완주군,075001, 70세,2016,859,436,423,103.1,857,436,421,103.6
35310, 완주군,075002, 71세,2016,745,325,420,77.4,741,322,419,76.8
35310, 완주군,075003, 72세,2016,792,355,437,81.2,791,355,436,81.4
35310, 완주군,075004, 73세,2016,789,332,457,72.6,785,331,454,72.9
35310, 완주군,075005, 74세,2016,1249,504,745,67.7,1245,503,742,67.8
35310, 완주군,080,75~79세,2016,4060,1573,2487,63.2,4051,1569,2482,63.2
35310, 완주군,080001, 75세,2016,848,349,499,69.9,846,348,498,69.9
35310, 완주군,080002, 76세,2016,808,316,492,64.2,806,315,491,64.2
35310, 완주군,080003, 77세,2016,847,331,516,64.1,845,329,516,63.8
35310, 완주군,080004, 78세,2016,826,314,512,61.3,825,314,511,61.4
35310, 완주군,080005, 79세,2016,731,263,468,56.2,729,263,466,56.4
35310, 완주군,085,80~84세,2016,2894,1005,1889,53.2,2891,1003,1888,53.1
35310, 완주군,085001, 80세,2016,716,259,457,56.7,716,259,457,56.7
35310, 완주군,085002, 81세,2016,698,245,453,54.1,697,244,453,53.9
35310, 완주군,085003, 82세,2016,581,211,370,57,580,210,370,56.8
35310, 완주군,085004, 83세,2016,491,157,334,47,490,157,333,47.1
35310, 완주군,085005, 84세,2016,408,133,275,48.4,408,133,275,48.4
35310, 완주군,090,85~89세,2016,1421,376,1045,36,1419,376,1043,36
35310, 완주군,090001, 85세,2016,385,110,275,40,385,110,275,40
35310, 완주군,090002, 86세,2016,325,85,240,35.4,323,85,238,35.7
35310, 완주군,090003, 87세,2016,261,63,198,31.8,261,63,198,31.8
35310, 완주군,090004, 88세,2016,225,55,170,32.4,225,55,170,32.4
35310, 완주군,090005, 89세,2016,225,63,162,38.9,225,63,162,38.9
35310, 완주군,095,90~94세,2016,416,81,335,24.2,416,81,335,24.2
35310, 완주군,095001, 90세,2016,129,25,104,24,129,25,104,24
35310, 완주군,095002, 91세,2016,93,19,74,25.7,93,19,74,25.7
35310, 완주군,095003, 92세,2016,69,17,52,32.7,69,17,52,32.7
35310, 완주군,095004, 93세,2016,75,12,63,19,75,12,63,19
35310, 완주군,095005, 94세,2016,50,8,42,19,50,8,42,19
35310, 완주군,100,95~99세,2016,111,23,88,26.1,110,22,88,25
35310, 완주군,100001, 95세,2016,33,5,28,17.9,33,5,28,17.9
35310, 완주군,100002, 96세,2016,29,6,23,26.1,29,6,23,26.1
35310, 완주군,100003, 97세,2016,22,X,19,15.8,22,X,19,15.8
35310, 완주군,100004, 98세,2016,17,6,11,54.5,16,5,11,45.5
35310, 완주군,100005, 99세,2016,10,X,7,42.9,10,X,7,42.9
35310, 완주군,101,100세이상,2016,9,X,8,12.5,9,X,8,12.5
35310, 완주군,102,15세미만,2016,13161,6839,6322,108.2,13130,6819,6311,108
35310, 완주군,103,15~64세,2016,65717,35485,30232,117.4,63258,34138,29120,117.2
35310, 완주군,104,65세이상,2016,18462,7534,10928,68.9,18398,7507,10891,68.9
35310, 완주군,086,85세이상,2016,1957,481,1476,32.6,1954,480,1474,32.6
35310, 완주군,126,평균연령,2016,42.5,40.7,44.3,,42.7,40.9,44.6,
35310, 완주군,127,중위연령,2016,42.8,41.2,44.8,,43.3,41.7,45.3,
35320, 진안군,000,합계,2016,22847,11295,11552,97.8,22473,11139,11334,98.3
35320, 진안군,005,0~4세,2016,798,377,421,89.5,796,376,420,89.5
35320, 진안군,005001, 0세,2016,166,72,94,76.6,166,72,94,76.6
35320, 진안군,005002, 1세,2016,160,73,87,83.9,160,73,87,83.9
35320, 진안군,005003, 2세,2016,153,71,82,86.6,153,71,82,86.6
35320, 진안군,005004, 3세,2016,148,72,76,94.7,148,72,76,94.7
35320, 진안군,005005, 4세,2016,171,89,82,108.5,169,88,81,108.6
35320, 진안군,010,5~9세,2016,713,372,341,109.1,709,370,339,109.1
35320, 진안군,010001, 5세,2016,171,92,79,116.5,171,92,79,116.5
35320, 진안군,010002, 6세,2016,145,79,66,119.7,145,79,66,119.7
35320, 진안군,010003, 7세,2016,134,68,66,103,132,67,65,103.1
35320, 진안군,010004, 8세,2016,129,63,66,95.5,127,62,65,95.4
35320, 진안군,010005, 9세,2016,134,70,64,109.4,134,70,64,109.4
35320, 진안군,015,10~14세,2016,701,378,323,117,699,376,323,116.4
35320, 진안군,015001, 10세,2016,149,75,74,101.4,148,74,74,100
35320, 진안군,015002, 11세,2016,136,80,56,142.9,136,80,56,142.9
35320, 진안군,015003, 12세,2016,141,73,68,107.4,140,72,68,105.9
35320, 진안군,015004, 13세,2016,137,72,65,110.8,137,72,65,110.8
35320, 진안군,015005, 14세,2016,138,78,60,130,138,78,60,130
35320, 진안군,020,15~19세,2016,936,507,429,118.2,928,504,424,118.9
35320, 진안군,020001, 15세,2016,171,94,77,122.1,171,94,77,122.1
35320, 진안군,020002, 16세,2016,223,122,101,120.8,223,122,101,120.8
35320, 진안군,020003, 17세,2016,203,105,98,107.1,201,104,97,107.2
35320, 진안군,020004, 18세,2016,191,96,95,101.1,187,95,92,103.3
35320, 진안군,020005, 19세,2016,148,90,58,155.2,146,89,57,156.1
35320, 진안군,025,20~24세,2016,851,478,373,128.2,819,468,351,133.3
35320, 진안군,025001, 20세,2016,189,116,73,158.9,181,112,69,162.3
35320, 진안군,025002, 21세,2016,185,112,73,153.4,179,109,70,155.7
35320, 진안군,025003, 22세,2016,169,90,79,113.9,160,89,71,125.4
35320, 진안군,025004, 23세,2016,142,73,69,105.8,138,71,67,106
35320, 진안군,025005, 24세,2016,166,87,79,110.1,161,87,74,117.6
35320, 진안군,030,25~29세,2016,765,414,351,117.9,705,392,313,125.2
35320, 진안군,030001, 25세,2016,160,95,65,146.2,149,91,58,156.9
35320, 진안군,030002, 26세,2016,180,96,84,114.3,167,93,74,125.7
35320, 진안군,030003, 27세,2016,131,71,60,118.3,121,68,53,128.3
35320, 진안군,030004, 28세,2016,154,79,75,105.3,139,71,68,104.4
35320, 진안군,030005, 29세,2016,140,73,67,109,129,69,60,115
35320, 진안군,035,30~34세,2016,865,412,453,90.9,794,377,417,90.4
35320, 진안군,035001, 30세,2016,147,72,75,96,126,61,65,93.8
35320, 진안군,035002, 31세,2016,162,79,83,95.2,148,75,73,102.7
35320, 진안군,035003, 32세,2016,181,83,98,84.7,167,78,89,87.6
35320, 진안군,035004, 33세,2016,191,91,100,91,178,83,95,87.4
35320, 진안군,035005, 34세,2016,184,87,97,89.7,175,80,95,84.2
35320, 진안군,040,35~39세,2016,1018,551,467,118,983,537,446,120.4
35320, 진안군,040001, 35세,2016,200,97,103,94.2,192,93,99,93.9
35320, 진안군,040002, 36세,2016,220,118,102,115.7,213,113,100,113
35320, 진안군,040003, 37세,2016,192,104,88,118.2,183,101,82,123.2
35320, 진안군,040004, 38세,2016,182,98,84,116.7,175,96,79,121.5
35320, 진안군,040005, 39세,2016,224,134,90,148.9,220,134,86,155.8
35320, 진안군,045,40~44세,2016,1275,746,529,141,1248,736,512,143.8
35320, 진안군,045001, 40세,2016,205,115,90,127.8,204,115,89,129.2
35320, 진안군,045002, 41세,2016,226,126,100,126,216,122,94,129.8
35320, 진안군,045003, 42세,2016,289,179,110,162.7,282,177,105,168.6
35320, 진안군,045004, 43세,2016,277,152,125,121.6,270,148,122,121.3
35320, 진안군,045005, 44세,2016,278,174,104,167.3,276,174,102,170.6
35320, 진안군,050,45~49세,2016,1496,875,621,140.9,1470,864,606,142.6
35320, 진안군,050001, 45세,2016,276,168,108,155.6,270,165,105,157.1
35320, 진안군,050002, 46세,2016,282,142,140,101.4,273,140,133,105.3
35320, 진안군,050003, 47세,2016,311,193,118,163.6,306,190,116,163.8
35320, 진안군,050004, 48세,2016,304,179,125,143.2,303,178,125,142.4
35320, 진안군,050005, 49세,2016,323,193,130,148.5,318,191,127,150.4
35320, 진안군,055,50~54세,2016,1776,982,794,123.7,1724,962,762,126.2
35320, 진안군,055001, 50세,2016,331,187,144,129.9,322,184,138,133.3
35320, 진안군,055002, 51세,2016,358,203,155,131,343,196,147,133.3
35320, 진안군,055003, 52세,2016,330,175,155,112.9,326,174,152,114.5
35320, 진안군,055004, 53세,2016,348,190,158,120.3,337,187,150,124.7
35320, 진안군,055005, 54세,2016,409,227,182,124.7,396,221,175,126.3
35320, 진안군,060,55~59세,2016,2188,1149,1039,110.6,2163,1139,1024,111.2
35320, 진안군,060001, 55세,2016,472,262,210,124.8,469,260,209,124.4
35320, 진안군,060002, 56세,2016,503,259,244,106.1,499,257,242,106.2
35320, 진안군,060003, 57세,2016,427,223,204,109.3,423,221,202,109.4
35320, 진안군,060004, 58세,2016,386,189,197,95.9,379,187,192,97.4
35320, 진안군,060005, 59세,2016,400,216,184,117.4,393,214,179,119.6
35320, 진안군,065,60~64세,2016,1909,974,935,104.2,1893,966,927,104.2
35320, 진안군,065001, 60세,2016,383,193,190,101.6,381,192,189,101.6
35320, 진안군,065002, 61세,2016,430,218,212,102.8,424,217,207,104.8
35320, 진안군,065003, 62세,2016,381,201,180,111.7,381,201,180,111.7
35320, 진안군,065004, 63세,2016,340,161,179,89.9,335,158,177,89.3
35320, 진안군,065005, 64세,2016,375,201,174,115.5,372,198,174,113.8
35320, 진안군,070,65~69세,2016,1874,895,979,91.4,1866,890,976,91.2
35320, 진안군,070001, 65세,2016,301,149,152,98,297,147,150,98
35320, 진안군,070002, 66세,2016,412,192,220,87.3,411,191,220,86.8
35320, 진안군,070003, 67세,2016,393,187,206,90.8,391,186,205,90.7
35320, 진안군,070004, 68세,2016,377,182,195,93.3,376,181,195,92.8
35320, 진안군,070005, 69세,2016,391,185,206,89.8,391,185,206,89.8
35320, 진안군,075,70~74세,2016,1784,809,975,83,1781,808,973,83
35320, 진안군,075001, 70세,2016,310,151,159,95,308,150,158,94.9
35320, 진안군,075002, 71세,2016,345,164,181,90.6,344,164,180,91.1
35320, 진안군,075003, 72세,2016,284,129,155,83.2,284,129,155,83.2
35320, 진안군,075004, 73세,2016,341,135,206,65.5,341,135,206,65.5
35320, 진안군,075005, 74세,2016,504,230,274,83.9,504,230,274,83.9
35320, 진안군,080,75~79세,2016,1776,684,1092,62.6,1775,683,1092,62.5
35320, 진안군,080001, 75세,2016,369,154,215,71.6,369,154,215,71.6
35320, 진안군,080002, 76세,2016,352,145,207,70,351,144,207,69.6
35320, 진안군,080003, 77세,2016,375,138,237,58.2,375,138,237,58.2
35320, 진안군,080004, 78세,2016,342,130,212,61.3,342,130,212,61.3
35320, 진안군,080005, 79세,2016,338,117,221,52.9,338,117,221,52.9
35320, 진안군,085,80~84세,2016,1341,476,865,55,1340,475,865,54.9
35320, 진안군,085001, 80세,2016,340,122,218,56,339,121,218,55.5
35320, 진안군,085002, 81세,2016,291,108,183,59,291,108,183,59
35320, 진안군,085003, 82세,2016,274,94,180,52.2,274,94,180,52.2
35320, 진안군,085004, 83세,2016,230,84,146,57.5,230,84,146,57.5
35320, 진안군,085005, 84세,2016,206,68,138,49.3,206,68,138,49.3
35320, 진안군,090,85~89세,2016,559,158,401,39.4,559,158,401,39.4
35320, 진안군,090001, 85세,2016,138,36,102,35.3,138,36,102,35.3
35320, 진안군,090002, 86세,2016,134,32,102,31.4,134,32,102,31.4
35320, 진안군,090003, 87세,2016,122,43,79,54.4,122,43,79,54.4
35320, 진안군,090004, 88세,2016,87,21,66,31.8,87,21,66,31.8
35320, 진안군,090005, 89세,2016,78,26,52,50,78,26,52,50
35320, 진안군,095,90~94세,2016,183,49,134,36.6,183,49,134,36.6
35320, 진안군,095001, 90세,2016,52,18,34,52.9,52,18,34,52.9
35320, 진안군,095002, 91세,2016,40,12,28,42.9,40,12,28,42.9
35320, 진안군,095003, 92세,2016,33,9,24,37.5,33,9,24,37.5
35320, 진안군,095004, 93세,2016,28,X,24,16.7,28,X,24,16.7
35320, 진안군,095005, 94세,2016,30,6,24,25,30,6,24,25
35320, 진안군,100,95~99세,2016,32,9,23,39.1,31,9,22,40.9
35320, 진안군,100001, 95세,2016,16,6,10,60,15,6,9,66.7
35320, 진안군,100002, 96세,2016,10,X,8,25,10,X,8,25
35320, 진안군,100003, 97세,2016,X,X,X,0,X,X,X,0
35320, 진안군,100004, 98세,2016,X,X,X,0,X,X,X,0
35320, 진안군,100005, 99세,2016,X,X,X,100,X,X,X,100
35320, 진안군,101,100세이상,2016,7,X,7,0,7,X,7,0
35320, 진안군,102,15세미만,2016,2212,1127,1085,103.9,2204,1122,1082,103.7
35320, 진안군,103,15~64세,2016,13079,7088,5991,118.3,12727,6945,5782,120.1
35320, 진안군,104,65세이상,2016,7556,3080,4476,68.8,7542,3072,4470,68.7
35320, 진안군,086,85세이상,2016,781,216,565,38.2,780,216,564,38.3
35320, 진안군,126,평균연령,2016,51.5,49.2,53.7,,51.7,49.3,54,
35320, 진안군,127,중위연령,2016,55.5,52.8,58.1,,55.8,53.1,58.5,
35330, 무주군,000,합계,2016,23129,11416,11713,97.5,22858,11329,11529,98.3
35330, 무주군,005,0~4세,2016,671,377,294,128.2,669,377,292,129.1
35330, 무주군,005001, 0세,2016,116,63,53,118.9,116,63,53,118.9
35330, 무주군,005002, 1세,2016,129,72,57,126.3,129,72,57,126.3
35330, 무주군,005003, 2세,2016,142,89,53,167.9,142,89,53,167.9
35330, 무주군,005004, 3세,2016,143,76,67,113.4,141,76,65,116.9
35330, 무주군,005005, 4세,2016,141,77,64,120.3,141,77,64,120.3
35330, 무주군,010,5~9세,2016,848,421,427,98.6,848,421,427,98.6
35330, 무주군,010001, 5세,2016,192,103,89,115.7,192,103,89,115.7
35330, 무주군,010002, 6세,2016,140,70,70,100,140,70,70,100
35330, 무주군,010003, 7세,2016,170,74,96,77.1,170,74,96,77.1
35330, 무주군,010004, 8세,2016,165,88,77,114.3,165,88,77,114.3
35330, 무주군,010005, 9세,2016,181,86,95,90.5,181,86,95,90.5
35330, 무주군,015,10~14세,2016,803,408,395,103.3,802,407,395,103
35330, 무주군,015001, 10세,2016,161,87,74,117.6,161,87,74,117.6
35330, 무주군,015002, 11세,2016,168,77,91,84.6,167,76,91,83.5
35330, 무주군,015003, 12세,2016,150,80,70,114.3,150,80,70,114.3
35330, 무주군,015004, 13세,2016,139,72,67,107.5,139,72,67,107.5
35330, 무주군,015005, 14세,2016,185,92,93,98.9,185,92,93,98.9
35330, 무주군,020,15~19세,2016,961,529,432,122.5,956,528,428,123.4
35330, 무주군,020001, 15세,2016,198,105,93,112.9,197,104,93,111.8
35330, 무주군,020002, 16세,2016,191,108,83,130.1,191,108,83,130.1
35330, 무주군,020003, 17세,2016,224,118,106,111.3,223,118,105,112.4
35330, 무주군,020004, 18세,2016,206,114,92,123.9,206,114,92,123.9
35330, 무주군,020005, 19세,2016,142,84,58,144.8,139,84,55,152.7
35330, 무주군,025,20~24세,2016,917,534,383,139.4,886,523,363,144.1
35330, 무주군,025001, 20세,2016,165,122,43,283.7,163,121,42,288.1
35330, 무주군,025002, 21세,2016,218,137,81,169.1,216,137,79,173.4
35330, 무주군,025003, 22세,2016,172,96,76,126.3,167,96,71,135.2
35330, 무주군,025004, 23세,2016,186,91,95,95.8,173,86,87,98.9
35330, 무주군,025005, 24세,2016,176,88,88,100,167,83,84,98.8
35330, 무주군,030,25~29세,2016,837,465,372,125,793,453,340,133.2
35330, 무주군,030001, 25세,2016,178,92,86,107,171,90,81,111.1
35330, 무주군,030002, 26세,2016,162,93,69,134.8,158,92,66,139.4
35330, 무주군,030003, 27세,2016,151,88,63,139.7,142,87,55,158.2
35330, 무주군,030004, 28세,2016,161,91,70,130,148,85,63,134.9
35330, 무주군,030005, 29세,2016,185,101,84,120.2,174,99,75,132
35330, 무주군,035,30~34세,2016,860,444,416,106.7,819,439,380,115.5
35330, 무주군,035001, 30세,2016,168,95,73,130.1,156,91,65,140
35330, 무주군,035002, 31세,2016,151,76,75,101.3,143,76,67,113.4
35330, 무주군,035003, 32세,2016,170,75,95,78.9,163,75,88,85.2
35330, 무주군,035004, 33세,2016,187,96,91,105.5,181,95,86,110.5
35330, 무주군,035005, 34세,2016,184,102,82,124.4,176,102,74,137.8
35330, 무주군,040,35~39세,2016,1135,596,539,110.6,1111,584,527,110.8
35330, 무주군,040001, 35세,2016,230,113,117,96.6,220,107,113,94.7
35330, 무주군,040002, 36세,2016,225,120,105,114.3,223,118,105,112.4
35330, 무주군,040003, 37세,2016,232,126,106,118.9,228,123,105,117.1
35330, 무주군,040004, 38세,2016,210,105,105,100,204,104,100,104
35330, 무주군,040005, 39세,2016,238,132,106,124.5,236,132,104,126.9
35330, 무주군,045,40~44세,2016,1414,804,610,131.8,1391,797,594,134.2
35330, 무주군,045001, 40세,2016,254,130,124,104.8,250,130,120,108.3
35330, 무주군,045002, 41세,2016,252,153,99,154.5,247,152,95,160
35330, 무주군,045003, 42세,2016,324,180,144,125,321,179,142,126.1
35330, 무주군,045004, 43세,2016,312,184,128,143.8,308,180,128,140.6
35330, 무주군,045005, 44세,2016,272,157,115,136.5,265,156,109,143.1
35330, 무주군,050,45~49세,2016,1662,948,714,132.8,1638,939,699,134.3
35330, 무주군,050001, 45세,2016,320,184,136,135.3,316,182,134,135.8
35330, 무주군,050002, 46세,2016,304,180,124,145.2,298,177,121,146.3
35330, 무주군,050003, 47세,2016,324,173,151,114.6,320,173,147,117.7
35330, 무주군,050004, 48세,2016,351,211,140,150.7,347,210,137,153.3
35330, 무주군,050005, 49세,2016,363,200,163,122.7,357,197,160,123.1
35330, 무주군,055,50~54세,2016,1819,991,828,119.7,1786,981,805,121.9
35330, 무주군,055001, 50세,2016,356,190,166,114.5,349,188,161,116.8
35330, 무주군,055002, 51세,2016,350,196,154,127.3,342,193,149,129.5
35330, 무주군,055003, 52세,2016,311,172,139,123.7,305,168,137,122.6
35330, 무주군,055004, 53세,2016,347,193,154,125.3,341,193,148,130.4
35330, 무주군,055005, 54세,2016,455,240,215,111.6,449,239,210,113.8
35330, 무주군,060,55~59세,2016,2184,1126,1058,106.4,2166,1120,1046,107.1
35330, 무주군,060001, 55세,2016,456,244,212,115.1,453,243,210,115.7
35330, 무주군,060002, 56세,2016,467,240,227,105.7,462,239,223,107.2
35330, 무주군,060003, 57세,2016,417,223,194,114.9,414,221,193,114.5
35330, 무주군,060004, 58세,2016,417,204,213,95.8,412,203,209,97.1
35330, 무주군,060005, 59세,2016,427,215,212,101.4,425,214,211,101.4
35330, 무주군,065,60~64세,2016,1864,940,924,101.7,1847,933,914,102.1
35330, 무주군,065001, 60세,2016,370,192,178,107.9,366,191,175,109.1
35330, 무주군,065002, 61세,2016,421,214,207,103.4,415,210,205,102.4
35330, 무주군,065003, 62세,2016,418,219,199,110.1,415,217,198,109.6
35330, 무주군,065004, 63세,2016,278,133,145,91.7,276,133,143,93
35330, 무주군,065005, 64세,2016,377,182,195,93.3,375,182,193,94.3
35330, 무주군,070,65~69세,2016,1659,766,893,85.8,1655,764,891,85.7
35330, 무주군,070001, 65세,2016,329,156,173,90.2,327,155,172,90.1
35330, 무주군,070002, 66세,2016,362,162,200,81,361,162,199,81.4
35330, 무주군,070003, 67세,2016,273,137,136,100.7,273,137,136,100.7
35330, 무주군,070004, 68세,2016,344,159,185,85.9,343,158,185,85.4
35330, 무주군,070005, 69세,2016,351,152,199,76.4,351,152,199,76.4
35330, 무주군,075,70~74세,2016,1706,691,1015,68.1,1704,689,1015,67.9
35330, 무주군,075001, 70세,2016,315,132,183,72.1,315,132,183,72.1
35330, 무주군,075002, 71세,2016,265,109,156,69.9,265,109,156,69.9
35330, 무주군,075003, 72세,2016,292,134,158,84.8,292,134,158,84.8
35330, 무주군,075004, 73세,2016,357,134,223,60.1,355,132,223,59.2
35330, 무주군,075005, 74세,2016,477,182,295,61.7,477,182,295,61.7
35330, 무주군,080,75~79세,2016,1800,728,1072,67.9,1800,728,1072,67.9
35330, 무주군,080001, 75세,2016,404,173,231,74.9,404,173,231,74.9
35330, 무주군,080002, 76세,2016,359,153,206,74.3,359,153,206,74.3
35330, 무주군,080003, 77세,2016,360,135,225,60,360,135,225,60
35330, 무주군,080004, 78세,2016,349,143,206,69.4,349,143,206,69.4
35330, 무주군,080005, 79세,2016,328,124,204,60.8,328,124,204,60.8
35330, 무주군,085,80~84세,2016,1222,432,790,54.7,1221,431,790,54.6
35330, 무주군,085001, 80세,2016,303,122,181,67.4,302,121,181,66.9
35330, 무주군,085002, 81세,2016,281,97,184,52.7,281,97,184,52.7
35330, 무주군,085003, 82세,2016,246,78,168,46.4,246,78,168,46.4
35330, 무주군,085004, 83세,2016,212,68,144,47.2,212,68,144,47.2
35330, 무주군,085005, 84세,2016,180,67,113,59.3,180,67,113,59.3
35330, 무주군,090,85~89세,2016,532,153,379,40.4,532,153,379,40.4
35330, 무주군,090001, 85세,2016,147,52,95,54.7,147,52,95,54.7
35330, 무주군,090002, 86세,2016,117,27,90,30,117,27,90,30
35330, 무주군,090003, 87세,2016,100,25,75,33.3,100,25,75,33.3
35330, 무주군,090004, 88세,2016,92,25,67,37.3,92,25,67,37.3
35330, 무주군,090005, 89세,2016,76,24,52,46.2,76,24,52,46.2
35330, 무주군,095,90~94세,2016,187,56,131,42.7,186,55,131,42
35330, 무주군,095001, 90세,2016,62,18,44,40.9,62,18,44,40.9
35330, 무주군,095002, 91세,2016,48,16,32,50,47,15,32,46.9
35330, 무주군,095003, 92세,2016,27,7,20,35,27,7,20,35
35330, 무주군,095004, 93세,2016,28,8,20,40,28,8,20,40
35330, 무주군,095005, 94세,2016,22,7,15,46.7,22,7,15,46.7
35330, 무주군,100,95~99세,2016,45,7,38,18.4,45,7,38,18.4
35330, 무주군,100001, 95세,2016,12,X,10,20,12,X,10,20
35330, 무주군,100002, 96세,2016,19,X,18,5.6,19,X,18,5.6
35330, 무주군,100003, 97세,2016,7,X,5,40,7,X,5,40
35330, 무주군,100004, 98세,2016,X,X,X,33.3,X,X,X,33.3
35330, 무주군,100005, 99세,2016,X,X,X,50,X,X,X,50
35330, 무주군,101,100세이상,2016,X,X,X,0,X,X,X,0
35330, 무주군,102,15세미만,2016,2322,1206,1116,108.1,2319,1205,1114,108.2
35330, 무주군,103,15~64세,2016,13653,7377,6276,117.5,13393,7297,6096,119.7
35330, 무주군,104,65세이상,2016,7154,2833,4321,65.6,7146,2827,4319,65.5
35330, 무주군,086,85세이상,2016,767,216,551,39.2,766,215,551,39
35330, 무주군,126,평균연령,2016,50.6,48,53.1,,50.7,48,53.4,
35330, 무주군,127,중위연령,2016,54.2,51,57,,54.4,51,57.4,
35340, 장수군,000,합계,2016,21607,10643,10964,97.1,21140,10423,10717,97.3
35340, 장수군,005,0~4세,2016,716,384,332,115.7,715,383,332,115.4
35340, 장수군,005001, 0세,2016,127,74,53,139.6,126,73,53,137.7
35340, 장수군,005002, 1세,2016,123,61,62,98.4,123,61,62,98.4
35340, 장수군,005003, 2세,2016,140,67,73,91.8,140,67,73,91.8
35340, 장수군,005004, 3세,2016,174,101,73,138.4,174,101,73,138.4
35340, 장수군,005005, 4세,2016,152,81,71,114.1,152,81,71,114.1
35340, 장수군,010,5~9세,2016,840,419,421,99.5,840,419,421,99.5
35340, 장수군,010001, 5세,2016,172,84,88,95.5,172,84,88,95.5
35340, 장수군,010002, 6세,2016,163,84,79,106.3,163,84,79,106.3
35340, 장수군,010003, 7세,2016,149,82,67,122.4,149,82,67,122.4
35340, 장수군,010004, 8세,2016,179,88,91,96.7,179,88,91,96.7
35340, 장수군,010005, 9세,2016,177,81,96,84.4,177,81,96,84.4
35340, 장수군,015,10~14세,2016,754,379,375,101.1,753,378,375,100.8
35340, 장수군,015001, 10세,2016,139,69,70,98.6,139,69,70,98.6
35340, 장수군,015002, 11세,2016,167,86,81,106.2,167,86,81,106.2
35340, 장수군,015003, 12세,2016,154,69,85,81.2,154,69,85,81.2
35340, 장수군,015004, 13세,2016,152,78,74,105.4,152,78,74,105.4
35340, 장수군,015005, 14세,2016,142,77,65,118.5,141,76,65,116.9
35340, 장수군,020,15~19세,2016,1082,588,494,119,1081,588,493,119.3
35340, 장수군,020001, 15세,2016,219,110,109,100.9,219,110,109,100.9
35340, 장수군,020002, 16세,2016,300,157,143,109.8,300,157,143,109.8
35340, 장수군,020003, 17세,2016,225,120,105,114.3,225,120,105,114.3
35340, 장수군,020004, 18세,2016,196,109,87,125.3,195,109,86,126.7
35340, 장수군,020005, 19세,2016,142,92,50,184,142,92,50,184
35340, 장수군,025,20~24세,2016,830,486,344,141.3,782,469,313,149.8
35340, 장수군,025001, 20세,2016,164,100,64,156.3,157,95,62,153.2
35340, 장수군,025002, 21세,2016,175,113,62,182.3,170,110,60,183.3
35340, 장수군,025003, 22세,2016,181,101,80,126.3,171,99,72,137.5
35340, 장수군,025004, 23세,2016,149,94,55,170.9,136,91,45,202.2
35340, 장수군,025005, 24세,2016,161,78,83,94,148,74,74,100
35340, 장수군,030,25~29세,2016,851,458,393,116.5,727,388,339,114.5
35340, 장수군,030001, 25세,2016,179,95,84,113.1,148,77,71,108.5
35340, 장수군,030002, 26세,2016,177,97,80,121.3,153,83,70,118.6
35340, 장수군,030003, 27세,2016,173,92,81,113.6,145,79,66,119.7
35340, 장수군,030004, 28세,2016,160,90,70,128.6,138,76,62,122.6
35340, 장수군,030005, 29세,2016,162,84,78,107.7,143,73,70,104.3
35340, 장수군,035,30~34세,2016,870,459,411,111.7,779,421,358,117.6
35340, 장수군,035001, 30세,2016,190,106,84,126.2,168,93,75,124
35340, 장수군,035002, 31세,2016,144,73,71,102.8,122,67,55,121.8
35340, 장수군,035003, 32세,2016,166,83,83,100,146,76,70,108.6
35340, 장수군,035004, 33세,2016,180,103,77,133.8,167,98,69,142
35340, 장수군,035005, 34세,2016,190,94,96,97.9,176,87,89,97.8
35340, 장수군,040,35~39세,2016,1069,589,480,122.7,1033,566,467,121.2
35340, 장수군,040001, 35세,2016,192,99,93,106.5,186,95,91,104.4
35340, 장수군,040002, 36세,2016,228,118,110,107.3,215,110,105,104.8
35340, 장수군,040003, 37세,2016,217,128,89,143.8,208,123,85,144.7
35340, 장수군,040004, 38세,2016,196,105,91,115.4,193,103,90,114.4
35340, 장수군,040005, 39세,2016,236,139,97,143.3,231,135,96,140.6
35340, 장수군,045,40~44세,2016,1185,659,526,125.3,1152,641,511,125.4
35340, 장수군,045001, 40세,2016,196,104,92,113,189,102,87,117.2
35340, 장수군,045002, 41세,2016,223,129,94,137.2,216,124,92,134.8
35340, 장수군,045003, 42세,2016,233,130,103,126.2,230,129,101,127.7
35340, 장수군,045004, 43세,2016,276,161,115,140,269,155,114,136
35340, 장수군,045005, 44세,2016,257,135,122,110.7,248,131,117,112
35340, 장수군,050,45~49세,2016,1478,843,635,132.8,1440,826,614,134.5
35340, 장수군,050001, 45세,2016,279,164,115,142.6,272,160,112,142.9
35340, 장수군,050002, 46세,2016,245,141,104,135.6,239,137,102,134.3
35340, 장수군,050003, 47세,2016,307,178,129,138,301,175,126,138.9
35340, 장수군,050004, 48세,2016,332,185,147,125.9,318,180,138,130.4
35340, 장수군,050005, 49세,2016,315,175,140,125,310,174,136,127.9
35340, 장수군,055,50~54세,2016,1576,866,710,122,1541,854,687,124.3
35340, 장수군,055001, 50세,2016,295,160,135,118.5,289,160,129,124
35340, 장수군,055002, 51세,2016,352,201,151,133.1,348,199,149,133.6
35340, 장수군,055003, 52세,2016,281,144,137,105.1,276,143,133,107.5
35340, 장수군,055004, 53세,2016,279,157,122,128.7,271,154,117,131.6
35340, 장수군,055005, 54세,2016,369,204,165,123.6,357,198,159,124.5
35340, 장수군,060,55~59세,2016,1950,976,974,100.2,1927,969,958,101.1
35340, 장수군,060001, 55세,2016,394,207,187,110.7,387,206,181,113.8
35340, 장수군,060002, 56세,2016,455,234,221,105.9,452,232,220,105.5
35340, 장수군,060003, 57세,2016,375,180,195,92.3,370,178,192,92.7
35340, 장수군,060004, 58세,2016,356,184,172,107,352,183,169,108.3
35340, 장수군,060005, 59세,2016,370,171,199,85.9,366,170,196,86.7
35340, 장수군,065,60~64세,2016,1823,910,913,99.7,1803,901,902,99.9
35340, 장수군,065001, 60세,2016,350,169,181,93.4,349,169,180,93.9
35340, 장수군,065002, 61세,2016,429,216,213,101.4,421,212,209,101.4
35340, 장수군,065003, 62세,2016,355,177,178,99.4,350,174,176,98.9
35340, 장수군,065004, 63세,2016,323,174,149,116.8,319,172,147,117
35340, 장수군,065005, 64세,2016,366,174,192,90.6,364,174,190,91.6
35340, 장수군,070,65~69세,2016,1668,829,839,98.8,1662,827,835,99
35340, 장수군,070001, 65세,2016,334,163,171,95.3,334,163,171,95.3
35340, 장수군,070002, 66세,2016,347,184,163,112.9,346,184,162,113.6
35340, 장수군,070003, 67세,2016,317,162,155,104.5,313,161,152,105.9
35340, 장수군,070004, 68세,2016,352,165,187,88.2,352,165,187,88.2
35340, 장수군,070005, 69세,2016,318,155,163,95.1,317,154,163,94.5
35340, 장수군,075,70~74세,2016,1479,614,865,71,1474,610,864,70.6
35340, 장수군,075001, 70세,2016,235,111,124,89.5,233,109,124,87.9
35340, 장수군,075002, 71세,2016,230,101,129,78.3,229,100,129,77.5
35340, 장수군,075003, 72세,2016,278,114,164,69.5,276,113,163,69.3
35340, 장수군,075004, 73세,2016,307,124,183,67.8,307,124,183,67.8
35340, 장수군,075005, 74세,2016,429,164,265,61.9,429,164,265,61.9
35340, 장수군,080,75~79세,2016,1614,596,1018,58.5,1610,595,1015,58.6
35340, 장수군,080001, 75세,2016,352,127,225,56.4,352,127,225,56.4
35340, 장수군,080002, 76세,2016,331,135,196,68.9,330,134,196,68.4
35340, 장수군,080003, 77세,2016,375,134,241,55.6,374,134,240,55.8
35340, 장수군,080004, 78세,2016,286,103,183,56.3,285,103,182,56.6
35340, 장수군,080005, 79세,2016,270,97,173,56.1,269,97,172,56.4
35340, 장수군,085,80~84세,2016,1161,397,764,52,1160,397,763,52
35340, 장수군,085001, 80세,2016,277,99,178,55.6,276,99,177,55.9
35340, 장수군,085002, 81세,2016,267,89,178,50,267,89,178,50
35340, 장수군,085003, 82세,2016,267,94,173,54.3,267,94,173,54.3
35340, 장수군,085004, 83세,2016,176,58,118,49.2,176,58,118,49.2
35340, 장수군,085005, 84세,2016,174,57,117,48.7,174,57,117,48.7
35340, 장수군,090,85~89세,2016,469,142,327,43.4,469,142,327,43.4
35340, 장수군,090001, 85세,2016,112,48,64,75,112,48,64,75
35340, 장수군,090002, 86세,2016,108,25,83,30.1,108,25,83,30.1
35340, 장수군,090003, 87세,2016,76,18,58,31,76,18,58,31
35340, 장수군,090004, 88세,2016,95,32,63,50.8,95,32,63,50.8
35340, 장수군,090005, 89세,2016,78,19,59,32.2,78,19,59,32.2
35340, 장수군,095,90~94세,2016,156,41,115,35.7,156,41,115,35.7
35340, 장수군,095001, 90세,2016,43,14,29,48.3,43,14,29,48.3
35340, 장수군,095002, 91세,2016,42,13,29,44.8,42,13,29,44.8
35340, 장수군,095003, 92세,2016,29,6,23,26.1,29,6,23,26.1
35340, 장수군,095004, 93세,2016,23,X,19,21.1,23,X,19,21.1
35340, 장수군,095005, 94세,2016,19,X,15,26.7,19,X,15,26.7
35340, 장수군,100,95~99세,2016,31,5,26,19.2,31,5,26,19.2
35340, 장수군,100001, 95세,2016,11,X,9,22.2,11,X,9,22.2
35340, 장수군,100002, 96세,2016,11,X,10,10,11,X,10,10
35340, 장수군,100003, 97세,2016,5,X,X,66.7,5,X,X,66.7
35340, 장수군,100004, 98세,2016,X,X,X,0,X,X,X,0
35340, 장수군,100005, 99세,2016,X,X,X,0,X,X,X,0
35340, 장수군,101,100세이상,2016,5,X,X,150,5,X,X,150
35340, 장수군,102,15세미만,2016,2310,1182,1128,104.8,2308,1180,1128,104.6
35340, 장수군,103,15~64세,2016,12714,6834,5880,116.2,12265,6623,5642,117.4
35340, 장수군,104,65세이상,2016,6583,2627,3956,66.4,6567,2620,3947,66.4
35340, 장수군,086,85세이상,2016,661,191,470,40.6,661,191,470,40.6
35340, 장수군,126,평균연령,2016,49.8,47.2,52.3,,50.1,47.4,52.6,
35340, 장수군,127,중위연령,2016,53.7,50.4,56.8,,54.2,50.8,57.2,
35350, 임실군,000,합계,2016,26229,13131,13098,100.3,25814,12943,12871,100.6
35350, 임실군,005,0~4세,2016,812,426,386,110.4,812,426,386,110.4
35350, 임실군,005001, 0세,2016,161,86,75,114.7,161,86,75,114.7
35350, 임실군,005002, 1세,2016,162,88,74,118.9,162,88,74,118.9
35350, 임실군,005003, 2세,2016,151,80,71,112.7,151,80,71,112.7
35350, 임실군,005004, 3세,2016,172,86,86,100,172,86,86,100
35350, 임실군,005005, 4세,2016,166,86,80,107.5,166,86,80,107.5
35350, 임실군,010,5~9세,2016,794,421,373,112.9,794,421,373,112.9
35350, 임실군,010001, 5세,2016,166,91,75,121.3,166,91,75,121.3
35350, 임실군,010002, 6세,2016,140,74,66,112.1,140,74,66,112.1
35350, 임실군,010003, 7세,2016,147,77,70,110,147,77,70,110
35350, 임실군,010004, 8세,2016,179,93,86,108.1,179,93,86,108.1
35350, 임실군,010005, 9세,2016,162,86,76,113.2,162,86,76,113.2
35350, 임실군,015,10~14세,2016,786,418,368,113.6,785,417,368,113.3
35350, 임실군,015001, 10세,2016,146,65,81,80.2,146,65,81,80.2
35350, 임실군,015002, 11세,2016,144,82,62,132.3,143,81,62,130.6
35350, 임실군,015003, 12세,2016,165,93,72,129.2,165,93,72,129.2
35350, 임실군,015004, 13세,2016,171,90,81,111.1,171,90,81,111.1
35350, 임실군,015005, 14세,2016,160,88,72,122.2,160,88,72,122.2
35350, 임실군,020,15~19세,2016,1046,581,465,124.9,1040,576,464,124.1
35350, 임실군,020001, 15세,2016,192,101,91,111,191,100,91,109.9
35350, 임실군,020002, 16세,2016,187,107,80,133.8,186,106,80,132.5
35350, 임실군,020003, 17세,2016,184,95,89,106.7,183,95,88,108
35350, 임실군,020004, 18세,2016,213,122,91,134.1,213,122,91,134.1
35350, 임실군,020005, 19세,2016,270,156,114,136.8,267,153,114,134.2
35350, 임실군,025,20~24세,2016,1307,766,541,141.6,1253,740,513,144.2
35350, 임실군,025001, 20세,2016,295,157,138,113.8,285,151,134,112.7
35350, 임실군,025002, 21세,2016,279,181,98,184.7,274,179,95,188.4
35350, 임실군,025003, 22세,2016,249,141,108,130.6,241,140,101,138.6
35350, 임실군,025004, 23세,2016,213,129,84,153.6,198,121,77,157.1
35350, 임실군,025005, 24세,2016,271,158,113,139.8,255,149,106,140.6
35350, 임실군,030,25~29세,2016,1129,646,483,133.7,1050,616,434,141.9
35350, 임실군,030001, 25세,2016,250,147,103,142.7,235,140,95,147.4
35350, 임실군,030002, 26세,2016,225,134,91,147.3,212,129,83,155.4
35350, 임실군,030003, 27세,2016,223,131,92,142.4,206,123,83,148.2
35350, 임실군,030004, 28세,2016,230,120,110,109.1,214,117,97,120.6
35350, 임실군,030005, 29세,2016,201,114,87,131,183,107,76,140.8
35350, 임실군,035,30~34세,2016,1032,553,479,115.4,975,533,442,120.6
35350, 임실군,035001, 30세,2016,195,110,85,129.4,181,106,75,141.3
35350, 임실군,035002, 31세,2016,190,104,86,120.9,177,99,78,126.9
35350, 임실군,035003, 32세,2016,217,111,106,104.7,204,107,97,110.3
35350, 임실군,035004, 33세,2016,198,101,97,104.1,188,98,90,108.9
35350, 임실군,035005, 34세,2016,232,127,105,121,225,123,102,120.6
35350, 임실군,040,35~39세,2016,1167,688,479,143.6,1120,662,458,144.5
35350, 임실군,040001, 35세,2016,228,134,94,142.6,214,125,89,140.4
35350, 임실군,040002, 36세,2016,227,124,103,120.4,221,122,99,123.2
35350, 임실군,040003, 37세,2016,238,139,99,140.4,228,134,94,142.6
35350, 임실군,040004, 38세,2016,257,154,103,149.5,247,148,99,149.5
35350, 임실군,040005, 39세,2016,217,137,80,171.3,210,133,77,172.7
35350, 임실군,045,40~44세,2016,1350,785,565,138.9,1320,772,548,140.9
35350, 임실군,045001, 40세,2016,261,158,103,153.4,256,156,100,156
35350, 임실군,045002, 41세,2016,241,140,101,138.6,233,137,96,142.7
35350, 임실군,045003, 42세,2016,272,147,125,117.6,267,145,122,118.9
35350, 임실군,045004, 43세,2016,298,175,123,142.3,294,173,121,143
35350, 임실군,045005, 44세,2016,278,165,113,146,270,161,109,147.7
35350, 임실군,050,45~49세,2016,1712,996,716,139.1,1677,983,694,141.6
35350, 임실군,050001, 45세,2016,310,203,107,189.7,307,202,105,192.4
35350, 임실군,050002, 46세,2016,311,179,132,135.6,301,175,126,138.9
35350, 임실군,050003, 47세,2016,350,190,160,118.8,342,186,156,119.2
35350, 임실군,050004, 48세,2016,387,223,164,136,377,220,157,140.1
35350, 임실군,050005, 49세,2016,354,201,153,131.4,350,200,150,133.3
35350, 임실군,055,50~54세,2016,1945,1091,854,127.8,1909,1075,834,128.9
35350, 임실군,055001, 50세,2016,371,195,176,110.8,368,194,174,111.5
35350, 임실군,055002, 51세,2016,390,232,158,146.8,380,230,150,153.3
35350, 임실군,055003, 52세,2016,360,200,160,125,355,198,157,126.1
35350, 임실군,055004, 53세,2016,392,230,162,142,380,223,157,142
35350, 임실군,055005, 54세,2016,432,234,198,118.2,426,230,196,117.3
35350, 임실군,060,55~59세,2016,2285,1194,1091,109.4,2257,1180,1077,109.6
35350, 임실군,060001, 55세,2016,452,239,213,112.2,443,236,207,114
35350, 임실군,060002, 56세,2016,540,281,259,108.5,533,277,256,108.2
35350, 임실군,060003, 57세,2016,473,233,240,97.1,470,231,239,96.7
35350, 임실군,060004, 58세,2016,393,210,183,114.8,388,207,181,114.4
35350, 임실군,060005, 59세,2016,427,231,196,117.9,423,229,194,118
35350, 임실군,065,60~64세,2016,2003,1054,949,111.1,1976,1040,936,111.1
35350, 임실군,065001, 60세,2016,433,231,202,114.4,425,225,200,112.5
35350, 임실군,065002, 61세,2016,417,230,187,123,411,228,183,124.6
35350, 임실군,065003, 62세,2016,423,214,209,102.4,418,211,207,101.9
35350, 임실군,065004, 63세,2016,338,181,157,115.3,332,178,154,115.6
35350, 임실군,065005, 64세,2016,392,198,194,102.1,390,198,192,103.1
35350, 임실군,070,65~69세,2016,2081,986,1095,90,2075,982,1093,89.8
35350, 임실군,070001, 65세,2016,359,157,202,77.7,356,154,202,76.2
35350, 임실군,070002, 66세,2016,448,223,225,99.1,446,222,224,99.1
35350, 임실군,070003, 67세,2016,377,166,211,78.7,377,166,211,78.7
35350, 임실군,070004, 68세,2016,439,217,222,97.7,439,217,222,97.7
35350, 임실군,070005, 69세,2016,458,223,235,94.9,457,223,234,95.3
35350, 임실군,075,70~74세,2016,1981,821,1160,70.8,1977,819,1158,70.7
35350, 임실군,075001, 70세,2016,337,154,183,84.2,337,154,183,84.2
35350, 임실군,075002, 71세,2016,340,141,199,70.9,339,141,198,71.2
35350, 임실군,075003, 72세,2016,311,143,168,85.1,310,142,168,84.5
35350, 임실군,075004, 73세,2016,392,160,232,69,390,159,231,68.8
35350, 임실군,075005, 74세,2016,601,223,378,59,601,223,378,59
35350, 임실군,080,75~79세,2016,2242,858,1384,62,2239,855,1384,61.8
35350, 임실군,080001, 75세,2016,467,187,280,66.8,467,187,280,66.8
35350, 임실군,080002, 76세,2016,450,159,291,54.6,450,159,291,54.6
35350, 임실군,080003, 77세,2016,470,195,275,70.9,469,194,275,70.5
35350, 임실군,080004, 78세,2016,409,154,255,60.4,407,152,255,59.6
35350, 임실군,080005, 79세,2016,446,163,283,57.6,446,163,283,57.6
35350, 임실군,085,80~84세,2016,1545,552,993,55.6,1544,551,993,55.5
35350, 임실군,085001, 80세,2016,379,145,234,62,379,145,234,62
35350, 임실군,085002, 81세,2016,368,135,233,57.9,367,134,233,57.5
35350, 임실군,085003, 82세,2016,341,116,225,51.6,341,116,225,51.6
35350, 임실군,085004, 83세,2016,227,77,150,51.3,227,77,150,51.3
35350, 임실군,085005, 84세,2016,230,79,151,52.3,230,79,151,52.3
35350, 임실군,090,85~89세,2016,758,237,521,45.5,758,237,521,45.5
35350, 임실군,090001, 85세,2016,190,62,128,48.4,190,62,128,48.4
35350, 임실군,090002, 86세,2016,162,49,113,43.4,162,49,113,43.4
35350, 임실군,090003, 87세,2016,155,55,100,55,155,55,100,55
35350, 임실군,090004, 88세,2016,140,42,98,42.9,140,42,98,42.9
35350, 임실군,090005, 89세,2016,111,29,82,35.4,111,29,82,35.4
35350, 임실군,095,90~94세,2016,203,51,152,33.6,202,51,151,33.8
35350, 임실군,095001, 90세,2016,74,18,56,32.1,73,18,55,32.7
35350, 임실군,095002, 91세,2016,42,9,33,27.3,42,9,33,27.3
35350, 임실군,095003, 92세,2016,35,11,24,45.8,35,11,24,45.8
35350, 임실군,095004, 93세,2016,30,7,23,30.4,30,7,23,30.4
35350, 임실군,095005, 94세,2016,22,6,16,37.5,22,6,16,37.5
35350, 임실군,100,95~99세,2016,46,7,39,17.9,46,7,39,17.9
35350, 임실군,100001, 95세,2016,10,X,9,11.1,10,X,9,11.1
35350, 임실군,100002, 96세,2016,9,X,8,12.5,9,X,8,12.5
35350, 임실군,100003, 97세,2016,13,5,8,62.5,13,5,8,62.5
35350, 임실군,100004, 98세,2016,9,X,9,0,9,X,9,0
35350, 임실군,100005, 99세,2016,5,X,5,0,5,X,5,0
35350, 임실군,101,100세이상,2016,5,X,5,0,5,X,5,0
35350, 임실군,102,15세미만,2016,2392,1265,1127,112.2,2391,1264,1127,112.2
35350, 임실군,103,15~64세,2016,14976,8354,6622,126.2,14577,8177,6400,127.8
35350, 임실군,104,65세이상,2016,8861,3512,5349,65.7,8846,3502,5344,65.5
35350, 임실군,086,85세이상,2016,1012,295,717,41.1,1011,295,716,41.2
35350, 임실군,126,평균연령,2016,51.3,48.4,54.3,,51.5,48.5,54.6,
35350, 임실군,127,중위연령,2016,55.1,51.4,58.7,,55.4,51.6,59.2,
35360, 순창군,000,합계,2016,26814,12799,14015,91.3,26416,12648,13768,91.9
35360, 순창군,005,0~4세,2016,880,454,426,106.6,880,454,426,106.6
35360, 순창군,005001, 0세,2016,231,121,110,110,231,121,110,110
35360, 순창군,005002, 1세,2016,168,89,79,112.7,168,89,79,112.7
35360, 순창군,005003, 2세,2016,148,78,70,111.4,148,78,70,111.4
35360, 순창군,005004, 3세,2016,165,86,79,108.9,165,86,79,108.9
35360, 순창군,005005, 4세,2016,168,80,88,90.9,168,80,88,90.9
35360, 순창군,010,5~9세,2016,927,471,456,103.3,923,468,455,102.9
35360, 순창군,010001, 5세,2016,182,90,92,97.8,182,90,92,97.8
35360, 순창군,010002, 6세,2016,171,93,78,119.2,169,92,77,119.5
35360, 순창군,010003, 7세,2016,177,96,81,118.5,175,94,81,116
35360, 순창군,010004, 8세,2016,183,83,100,83,183,83,100,83
35360, 순창군,010005, 9세,2016,214,109,105,103.8,214,109,105,103.8
35360, 순창군,015,10~14세,2016,988,520,468,111.1,987,520,467,111.3
35360, 순창군,015001, 10세,2016,201,107,94,113.8,200,107,93,115.1
35360, 순창군,015002, 11세,2016,185,102,83,122.9,185,102,83,122.9
35360, 순창군,015003, 12세,2016,196,101,95,106.3,196,101,95,106.3
35360, 순창군,015004, 13세,2016,191,93,98,94.9,191,93,98,94.9
35360, 순창군,015005, 14세,2016,215,117,98,119.4,215,117,98,119.4
35360, 순창군,020,15~19세,2016,1184,616,568,108.5,1182,615,567,108.5
35360, 순창군,020001, 15세,2016,248,133,115,115.7,248,133,115,115.7
35360, 순창군,020002, 16세,2016,288,127,161,78.9,288,127,161,78.9
35360, 순창군,020003, 17세,2016,253,124,129,96.1,253,124,129,96.1
35360, 순창군,020004, 18세,2016,228,128,100,128,227,127,100,127
35360, 순창군,020005, 19세,2016,167,104,63,165.1,166,104,62,167.7
35360, 순창군,025,20~24세,2016,1004,589,415,141.9,963,574,389,147.6
35360, 순창군,025001, 20세,2016,180,118,62,190.3,176,117,59,198.3
35360, 순창군,025002, 21세,2016,237,160,77,207.8,230,156,74,210.8
35360, 순창군,025003, 22세,2016,198,113,85,132.9,191,111,80,138.8
35360, 순창군,025004, 23세,2016,184,97,87,111.5,171,94,77,122.1
35360, 순창군,025005, 24세,2016,205,101,104,97.1,195,96,99,97
35360, 순창군,030,25~29세,2016,958,461,497,92.8,880,434,446,97.3
35360, 순창군,030001, 25세,2016,186,87,99,87.9,176,84,92,91.3
35360, 순창군,030002, 26세,2016,207,101,106,95.3,183,92,91,101.1
35360, 순창군,030003, 27세,2016,172,70,102,68.6,160,67,93,72
35360, 순창군,030004, 28세,2016,204,103,101,102,184,95,89,106.7
35360, 순창군,030005, 29세,2016,189,100,89,112.4,177,96,81,118.5
35360, 순창군,035,30~34세,2016,1078,512,566,90.5,1028,493,535,92.1
35360, 순창군,035001, 30세,2016,220,95,125,76,207,90,117,76.9
35360, 순창군,035002, 31세,2016,194,97,97,100,187,94,93,101.1
35360, 순창군,035003, 32세,2016,203,97,106,91.5,191,94,97,96.9
35360, 순창군,035004, 33세,2016,215,93,122,76.2,203,87,116,75
35360, 순창군,035005, 34세,2016,246,130,116,112.1,240,128,112,114.3
35360, 순창군,040,35~39세,2016,1331,692,639,108.3,1289,677,612,110.6
35360, 순창군,040001, 35세,2016,264,138,126,109.5,253,133,120,110.8
35360, 순창군,040002, 36세,2016,265,132,133,99.2,256,130,126,103.2
35360, 순창군,040003, 37세,2016,273,139,134,103.7,264,136,128,106.3
35360, 순창군,040004, 38세,2016,260,144,116,124.1,252,140,112,125
35360, 순창군,040005, 39세,2016,269,139,130,106.9,264,138,126,109.5
35360, 순창군,045,40~44세,2016,1543,890,653,136.3,1511,877,634,138.3
35360, 순창군,045001, 40세,2016,265,165,100,165,259,164,95,172.6
35360, 순창군,045002, 41세,2016,267,154,113,136.3,265,153,112,136.6
35360, 순창군,045003, 42세,2016,356,195,161,121.1,348,193,155,124.5
35360, 순창군,045004, 43세,2016,330,190,140,135.7,319,183,136,134.6
35360, 순창군,045005, 44세,2016,325,186,139,133.8,320,184,136,135.3
35360, 순창군,050,45~49세,2016,1837,1051,786,133.7,1798,1038,760,136.6
35360, 순창군,050001, 45세,2016,379,220,159,138.4,371,218,153,142.5
35360, 순창군,050002, 46세,2016,301,177,124,142.7,293,174,119,146.2
35360, 순창군,050003, 47세,2016,406,229,177,129.4,396,225,171,131.6
35360, 순창군,050004, 48세,2016,397,235,162,145.1,389,233,156,149.4
35360, 순창군,050005, 49세,2016,354,190,164,115.9,349,188,161,116.8
35360, 순창군,055,50~54세,2016,1869,973,896,108.6,1821,955,866,110.3
35360, 순창군,055001, 50세,2016,385,199,186,107,375,196,179,109.5
35360, 순창군,055002, 51세,2016,347,184,163,112.9,340,181,159,113.8
35360, 순창군,055003, 52세,2016,340,173,167,103.6,330,168,162,103.7
35360, 순창군,055004, 53세,2016,364,194,170,114.1,350,190,160,118.8
35360, 순창군,055005, 54세,2016,433,223,210,106.2,426,220,206,106.8
35360, 순창군,060,55~59세,2016,2312,1189,1123,105.9,2276,1174,1102,106.5
35360, 순창군,060001, 55세,2016,459,241,218,110.6,452,240,212,113.2
35360, 순창군,060002, 56세,2016,568,292,276,105.8,559,288,271,106.3
35360, 순창군,060003, 57세,2016,453,227,226,100.4,446,223,223,100
35360, 순창군,060004, 58세,2016,415,214,201,106.5,412,212,200,106
35360, 순창군,060005, 59세,2016,417,215,202,106.4,407,211,196,107.7
35360, 순창군,065,60~64세,2016,2060,1010,1050,96.2,2050,1006,1044,96.4
35360, 순창군,065001, 60세,2016,434,212,222,95.5,433,212,221,95.9
35360, 순창군,065002, 61세,2016,447,231,216,106.9,444,230,214,107.5
35360, 순창군,065003, 62세,2016,433,219,214,102.3,433,219,214,102.3
35360, 순창군,065004, 63세,2016,348,161,187,86.1,345,160,185,86.5
35360, 순창군,065005, 64세,2016,398,187,211,88.6,395,185,210,88.1
35360, 순창군,070,65~69세,2016,1981,913,1068,85.5,1973,907,1066,85.1
35360, 순창군,070001, 65세,2016,323,159,164,97,323,159,164,97
35360, 순창군,070002, 66세,2016,369,179,190,94.2,366,177,189,93.7
35360, 순창군,070003, 67세,2016,413,181,232,78,411,179,232,77.2
35360, 순창군,070004, 68세,2016,429,194,235,82.6,426,192,234,82.1
35360, 순창군,070005, 69세,2016,447,200,247,81,447,200,247,81
35360, 순창군,075,70~74세,2016,2109,813,1296,62.7,2108,813,1295,62.8
35360, 순창군,075001, 70세,2016,378,163,215,75.8,377,163,214,76.2
35360, 순창군,075002, 71세,2016,349,151,198,76.3,349,151,198,76.3
35360, 순창군,075003, 72세,2016,356,138,218,63.3,356,138,218,63.3
35360, 순창군,075004, 73세,2016,409,150,259,57.9,409,150,259,57.9
35360, 순창군,075005, 74세,2016,617,211,406,52,617,211,406,52
35360, 순창군,080,75~79세,2016,2262,853,1409,60.5,2258,852,1406,60.6
35360, 순창군,080001, 75세,2016,483,185,298,62.1,482,185,297,62.3
35360, 순창군,080002, 76세,2016,467,167,300,55.7,465,167,298,56
35360, 순창군,080003, 77세,2016,473,181,292,62,472,180,292,61.6
35360, 순창군,080004, 78세,2016,463,169,294,57.5,463,169,294,57.5
35360, 순창군,080005, 79세,2016,376,151,225,67.1,376,151,225,67.1
35360, 순창군,085,80~84세,2016,1510,524,986,53.1,1508,523,985,53.1
35360, 순창군,085001, 80세,2016,388,147,241,61,387,147,240,61.3
35360, 순창군,085002, 81세,2016,364,138,226,61.1,364,138,226,61.1
35360, 순창군,085003, 82세,2016,307,93,214,43.5,306,92,214,43
35360, 순창군,085004, 83세,2016,213,80,133,60.2,213,80,133,60.2
35360, 순창군,085005, 84세,2016,238,66,172,38.4,238,66,172,38.4
35360, 순창군,090,85~89세,2016,681,197,484,40.7,681,197,484,40.7
35360, 순창군,090001, 85세,2016,171,52,119,43.7,171,52,119,43.7
35360, 순창군,090002, 86세,2016,160,43,117,36.8,160,43,117,36.8
35360, 순창군,090003, 87세,2016,115,36,79,45.6,115,36,79,45.6
35360, 순창군,090004, 88세,2016,126,41,85,48.2,126,41,85,48.2
35360, 순창군,090005, 89세,2016,109,25,84,29.8,109,25,84,29.8
35360, 순창군,095,90~94세,2016,236,55,181,30.4,236,55,181,30.4
35360, 순창군,095001, 90세,2016,51,17,34,50,51,17,34,50
35360, 순창군,095002, 91세,2016,48,14,34,41.2,48,14,34,41.2
35360, 순창군,095003, 92세,2016,45,9,36,25,45,9,36,25
35360, 순창군,095004, 93세,2016,51,9,42,21.4,51,9,42,21.4
35360, 순창군,095005, 94세,2016,41,6,35,17.1,41,6,35,17.1
35360, 순창군,100,95~99세,2016,54,14,40,35,54,14,40,35
35360, 순창군,100001, 95세,2016,15,6,9,66.7,15,6,9,66.7
35360, 순창군,100002, 96세,2016,23,X,19,21.1,23,X,19,21.1
35360, 순창군,100003, 97세,2016,6,X,X,50,6,X,X,50
35360, 순창군,100004, 98세,2016,7,X,5,40,7,X,5,40
35360, 순창군,100005, 99세,2016,X,X,X,0,X,X,X,0
35360, 순창군,101,100세이상,2016,10,X,8,25,10,X,8,25
35360, 순창군,102,15세미만,2016,2795,1445,1350,107,2790,1442,1348,107
35360, 순창군,103,15~64세,2016,15176,7983,7193,111,14798,7843,6955,112.8
35360, 순창군,104,65세이상,2016,8843,3371,5472,61.6,8828,3363,5465,61.5
35360, 순창군,086,85세이상,2016,981,268,713,37.6,981,268,713,37.6
35360, 순창군,126,평균연령,2016,50.8,48,53.4,,51,48.1,53.7,
35360, 순창군,127,중위연령,2016,54.6,50.7,57.6,,54.9,50.9,58.1,
35370, 고창군,000,합계,2016,55326,27440,27886,98.4,54211,26851,27360,98.1
35370, 고창군,005,0~4세,2016,1479,790,689,114.7,1474,785,689,113.9
35370, 고창군,005001, 0세,2016,249,136,113,120.4,248,135,113,119.5
35370, 고창군,005002, 1세,2016,281,143,138,103.6,281,143,138,103.6
35370, 고창군,005003, 2세,2016,334,177,157,112.7,333,176,157,112.1
35370, 고창군,005004, 3세,2016,294,158,136,116.2,293,157,136,115.4
35370, 고창군,005005, 4세,2016,321,176,145,121.4,319,174,145,120
35370, 고창군,010,5~9세,2016,1702,901,801,112.5,1699,900,799,112.6
35370, 고창군,010001, 5세,2016,376,197,179,110.1,375,197,178,110.7
35370, 고창군,010002, 6세,2016,317,177,140,126.4,317,177,140,126.4
35370, 고창군,010003, 7세,2016,330,165,165,100,330,165,165,100
35370, 고창군,010004, 8세,2016,354,188,166,113.3,354,188,166,113.3
35370, 고창군,010005, 9세,2016,325,174,151,115.2,323,173,150,115.3
35370, 고창군,015,10~14세,2016,2053,1123,930,120.8,2049,1122,927,121
35370, 고창군,015001, 10세,2016,345,176,169,104.1,344,176,168,104.8
35370, 고창군,015002, 11세,2016,328,173,155,111.6,327,172,155,111
35370, 고창군,015003, 12세,2016,353,205,148,138.5,353,205,148,138.5
35370, 고창군,015004, 13세,2016,463,254,209,121.5,462,254,208,122.1
35370, 고창군,015005, 14세,2016,564,315,249,126.5,563,315,248,127
35370, 고창군,020,15~19세,2016,3401,1979,1422,139.2,3395,1977,1418,139.4
35370, 고창군,020001, 15세,2016,737,397,340,116.8,737,397,340,116.8
35370, 고창군,020002, 16세,2016,950,575,375,153.3,949,575,374,153.7
35370, 고창군,020003, 17세,2016,734,424,310,136.8,732,423,309,136.9
35370, 고창군,020004, 18세,2016,627,365,262,139.3,625,364,261,139.5
35370, 고창군,020005, 19세,2016,353,218,135,161.5,352,218,134,162.7
35370, 고창군,025,20~24세,2016,2364,1420,944,150.4,2236,1359,877,155
35370, 고창군,025001, 20세,2016,422,288,134,214.9,415,287,128,224.2
35370, 고창군,025002, 21세,2016,500,328,172,190.7,489,325,164,198.2
35370, 고창군,025003, 22세,2016,468,269,199,135.2,444,257,187,137.4
35370, 고창군,025004, 23세,2016,480,268,212,126.4,437,248,189,131.2
35370, 고창군,025005, 24세,2016,494,267,227,117.6,451,242,209,115.8
35370, 고창군,030,25~29세,2016,2259,1252,1007,124.3,2000,1091,909,120
35370, 고창군,030001, 25세,2016,458,258,200,129,410,231,179,129.1
35370, 고창군,030002, 26세,2016,485,261,224,116.5,431,227,204,111.3
35370, 고창군,030003, 27세,2016,461,262,199,131.7,407,228,179,127.4
35370, 고창군,030004, 28세,2016,445,242,203,119.2,398,215,183,117.5
35370, 고창군,030005, 29세,2016,410,229,181,126.5,354,190,164,115.9
35370, 고창군,035,30~34세,2016,2257,1252,1005,124.6,2028,1127,901,125.1
35370, 고창군,035001, 30세,2016,444,259,185,140,386,229,157,145.9
35370, 고창군,035002, 31세,2016,434,216,218,99.1,384,193,191,101
35370, 고창군,035003, 32세,2016,461,261,200,130.5,412,231,181,127.6
35370, 고창군,035004, 33세,2016,450,257,193,133.2,414,235,179,131.3
35370, 고창군,035005, 34세,2016,468,259,209,123.9,432,239,193,123.8
35370, 고창군,040,35~39세,2016,2425,1351,1074,125.8,2324,1289,1035,124.5
35370, 고창군,040001, 35세,2016,504,280,224,125,486,267,219,121.9
35370, 고창군,040002, 36세,2016,446,239,207,115.5,423,228,195,116.9
35370, 고창군,040003, 37세,2016,509,294,215,136.7,481,278,203,136.9
35370, 고창군,040004, 38세,2016,471,264,207,127.5,452,250,202,123.8
35370, 고창군,040005, 39세,2016,495,274,221,124,482,266,216,123.1
35370, 고창군,045,40~44세,2016,3097,1744,1353,128.9,3019,1709,1310,130.5
35370, 고창군,045001, 40세,2016,529,291,238,122.3,515,283,232,122
35370, 고창군,045002, 41세,2016,550,336,214,157,531,327,204,160.3
35370, 고창군,045003, 42세,2016,655,369,286,129,643,365,278,131.3
35370, 고창군,045004, 43세,2016,694,398,296,134.5,679,391,288,135.8
35370, 고창군,045005, 44세,2016,669,350,319,109.7,651,343,308,111.4
35370, 고창군,050,45~49세,2016,3767,2066,1701,121.5,3679,2037,1642,124.1
35370, 고창군,050001, 45세,2016,734,425,309,137.5,710,415,295,140.7
35370, 고창군,050002, 46세,2016,720,380,340,111.8,707,376,331,113.6
35370, 고창군,050003, 47세,2016,771,416,355,117.2,753,411,342,120.2
35370, 고창군,050004, 48세,2016,806,451,355,127,793,448,345,129.9
35370, 고창군,050005, 49세,2016,736,394,342,115.2,716,387,329,117.6
35370, 고창군,055,50~54세,2016,4168,2215,1953,113.4,4093,2177,1916,113.6
35370, 고창군,055001, 50세,2016,800,444,356,124.7,784,437,347,125.9
35370, 고창군,055002, 51세,2016,834,443,391,113.3,819,438,381,115
35370, 고창군,055003, 52세,2016,801,428,373,114.7,780,417,363,114.9
35370, 고창군,055004, 53세,2016,821,430,391,110,807,420,387,108.5
35370, 고창군,055005, 54세,2016,912,470,442,106.3,903,465,438,106.2
35370, 고창군,060,55~59세,2016,5104,2587,2517,102.8,5041,2556,2485,102.9
35370, 고창군,060001, 55세,2016,1064,563,501,112.4,1051,558,493,113.2
35370, 고창군,060002, 56세,2016,1076,523,553,94.6,1058,516,542,95.2
35370, 고창군,060003, 57세,2016,970,487,483,100.8,956,479,477,100.4
35370, 고창군,060004, 58세,2016,1016,529,487,108.6,1009,524,485,108
35370, 고창군,060005, 59세,2016,978,485,493,98.4,967,479,488,98.2
35370, 고창군,065,60~64세,2016,4230,2048,2182,93.9,4189,2025,2164,93.6
35370, 고창군,065001, 60세,2016,899,436,463,94.2,888,427,461,92.6
35370, 고창군,065002, 61세,2016,964,486,478,101.7,955,480,475,101.1
35370, 고창군,065003, 62세,2016,872,423,449,94.2,865,421,444,94.8
35370, 고창군,065004, 63세,2016,688,321,367,87.5,679,316,363,87.1
35370, 고창군,065005, 64세,2016,807,382,425,89.9,802,381,421,90.5
35370, 고창군,070,65~69세,2016,4215,2051,2164,94.8,4197,2041,2156,94.7
35370, 고창군,070001, 65세,2016,758,367,391,93.9,755,367,388,94.6
35370, 고창군,070002, 66세,2016,856,430,426,100.9,852,428,424,100.9
35370, 고창군,070003, 67세,2016,875,419,456,91.9,871,417,454,91.9
35370, 고창군,070004, 68세,2016,807,385,422,91.2,802,380,422,90
35370, 고창군,070005, 69세,2016,919,450,469,95.9,917,449,468,95.9
35370, 고창군,075,70~74세,2016,4205,1793,2412,74.3,4196,1790,2406,74.4
35370, 고창군,075001, 70세,2016,729,336,393,85.5,727,335,392,85.5
35370, 고창군,075002, 71세,2016,684,292,392,74.5,682,290,392,74
35370, 고창군,075003, 72세,2016,753,331,422,78.4,753,331,422,78.4
35370, 고창군,075004, 73세,2016,862,364,498,73.1,858,364,494,73.7
35370, 고창군,075005, 74세,2016,1177,470,707,66.5,1176,470,706,66.6
35370, 고창군,080,75~79세,2016,4139,1534,2605,58.9,4132,1532,2600,58.9
35370, 고창군,080001, 75세,2016,914,352,562,62.6,910,351,559,62.8
35370, 고창군,080002, 76세,2016,817,297,520,57.1,816,297,519,57.2
35370, 고창군,080003, 77세,2016,890,351,539,65.1,889,350,539,64.9
35370, 고창군,080004, 78세,2016,808,303,505,60,807,303,504,60.1
35370, 고창군,080005, 79세,2016,710,231,479,48.2,710,231,479,48.2
35370, 고창군,085,80~84세,2016,2740,924,1816,50.9,2739,924,1815,50.9
35370, 고창군,085001, 80세,2016,626,209,417,50.1,626,209,417,50.1
35370, 고창군,085002, 81세,2016,703,256,447,57.3,702,256,446,57.4
35370, 고창군,085003, 82세,2016,590,213,377,56.5,590,213,377,56.5
35370, 고창군,085004, 83세,2016,411,129,282,45.7,411,129,282,45.7
35370, 고창군,085005, 84세,2016,410,117,293,39.9,410,117,293,39.9
35370, 고창군,090,85~89세,2016,1256,317,939,33.8,1256,317,939,33.8
35370, 고창군,090001, 85세,2016,336,96,240,40,336,96,240,40
35370, 고창군,090002, 86세,2016,332,85,247,34.4,332,85,247,34.4
35370, 고창군,090003, 87세,2016,219,56,163,34.4,219,56,163,34.4
35370, 고창군,090004, 88세,2016,217,50,167,29.9,217,50,167,29.9
35370, 고창군,090005, 89세,2016,152,30,122,24.6,152,30,122,24.6
35370, 고창군,095,90~94세,2016,373,82,291,28.2,373,82,291,28.2
35370, 고창군,095001, 90세,2016,116,27,89,30.3,116,27,89,30.3
35370, 고창군,095002, 91세,2016,72,19,53,35.8,72,19,53,35.8
35370, 고창군,095003, 92세,2016,61,18,43,41.9,61,18,43,41.9
35370, 고창군,095004, 93세,2016,68,9,59,15.3,68,9,59,15.3
35370, 고창군,095005, 94세,2016,56,9,47,19.1,56,9,47,19.1
35370, 고창군,100,95~99세,2016,83,10,73,13.7,83,10,73,13.7
35370, 고창군,100001, 95세,2016,31,7,24,29.2,31,7,24,29.2
35370, 고창군,100002, 96세,2016,24,X,24,0,24,X,24,0
35370, 고창군,100003, 97세,2016,16,X,14,14.3,16,X,14,14.3
35370, 고창군,100004, 98세,2016,6,X,5,20,6,X,5,20
35370, 고창군,100005, 99세,2016,6,X,6,0,6,X,6,0
35370, 고창군,101,100세이상,2016,9,X,8,12.5,9,X,8,12.5
35370, 고창군,102,15세미만,2016,5234,2814,2420,116.3,5222,2807,2415,116.2
35370, 고창군,103,15~64세,2016,33072,17914,15158,118.2,32004,17347,14657,118.4
35370, 고창군,104,65세이상,2016,17020,6712,10308,65.1,16985,6697,10288,65.1
35370, 고창군,086,85세이상,2016,1721,410,1311,31.3,1721,410,1311,31.3
35370, 고창군,126,평균연령,2016,49.8,46.6,53,,50.1,46.9,53.3,
35370, 고창군,127,중위연령,2016,53.5,49.6,57,,54,50.1,57.5,
35380, 부안군,000,합계,2016,51855,25638,26217,97.8,50921,25202,25719,98
35380, 부안군,005,0~4세,2016,1489,783,706,110.9,1486,782,704,111.1
35380, 부안군,005001, 0세,2016,263,142,121,117.4,263,142,121,117.4
35380, 부안군,005002, 1세,2016,269,148,121,122.3,268,147,121,121.5
35380, 부안군,005003, 2세,2016,314,157,157,100,314,157,157,100
35380, 부안군,005004, 3세,2016,307,159,148,107.4,306,159,147,108.2
35380, 부안군,005005, 4세,2016,336,177,159,111.3,335,177,158,112
35380, 부안군,010,5~9세,2016,1634,855,779,109.8,1630,853,777,109.8
35380, 부안군,010001, 5세,2016,359,192,167,115,357,190,167,113.8
35380, 부안군,010002, 6세,2016,306,167,139,120.1,306,167,139,120.1
35380, 부안군,010003, 7세,2016,313,146,167,87.4,313,146,167,87.4
35380, 부안군,010004, 8세,2016,313,159,154,103.2,312,159,153,103.9
35380, 부안군,010005, 9세,2016,343,191,152,125.7,342,191,151,126.5
35380, 부안군,015,10~14세,2016,1786,945,841,112.4,1777,938,839,111.8
35380, 부안군,015001, 10세,2016,320,163,157,103.8,318,161,157,102.5
35380, 부안군,015002, 11세,2016,330,165,165,100,330,165,165,100
35380, 부안군,015003, 12세,2016,358,205,153,134,357,204,153,133.3
35380, 부안군,015004, 13세,2016,365,183,182,100.5,364,182,182,100
35380, 부안군,015005, 14세,2016,413,229,184,124.5,408,226,182,124.2
35380, 부안군,020,15~19세,2016,2496,1436,1060,135.5,2487,1429,1058,135.1
35380, 부안군,020001, 15세,2016,506,300,206,145.6,506,300,206,145.6
35380, 부안군,020002, 16세,2016,601,339,262,129.4,600,338,262,129
35380, 부안군,020003, 17세,2016,593,316,277,114.1,590,315,275,114.5
35380, 부안군,020004, 18세,2016,480,261,219,119.2,478,259,219,118.3
35380, 부안군,020005, 19세,2016,316,220,96,229.2,313,217,96,226
35380, 부안군,025,20~24세,2016,2176,1293,883,146.4,2095,1271,824,154.2
35380, 부안군,025001, 20세,2016,411,285,126,226.2,405,283,122,232
35380, 부안군,025002, 21세,2016,454,296,158,187.3,442,294,148,198.6
35380, 부안군,025003, 22세,2016,432,246,186,132.3,419,245,174,140.8
35380, 부안군,025004, 23세,2016,450,237,213,111.3,424,229,195,117.4
35380, 부안군,025005, 24세,2016,429,229,200,114.5,405,220,185,118.9
35380, 부안군,030,25~29세,2016,2177,1218,959,127,1991,1118,873,128.1
35380, 부안군,030001, 25세,2016,470,240,230,104.3,428,215,213,100.9
35380, 부안군,030002, 26세,2016,430,233,197,118.3,392,218,174,125.3
35380, 부안군,030003, 27세,2016,440,252,188,134,406,229,177,129.4
35380, 부안군,030004, 28세,2016,427,254,173,146.8,389,233,156,149.4
35380, 부안군,030005, 29세,2016,410,239,171,139.8,376,223,153,145.8
35380, 부안군,035,30~34세,2016,2198,1156,1042,110.9,2028,1060,968,109.5
35380, 부안군,035001, 30세,2016,430,238,192,124,385,215,170,126.5
35380, 부안군,035002, 31세,2016,365,202,163,123.9,335,183,152,120.4
35380, 부안군,035003, 32세,2016,447,243,204,119.1,407,217,190,114.2
35380, 부안군,035004, 33세,2016,457,242,215,112.6,424,224,200,112
35380, 부안군,035005, 34세,2016,499,231,268,86.2,477,221,256,86.3
35380, 부안군,040,35~39세,2016,2538,1390,1148,121.1,2428,1337,1091,122.5
35380, 부안군,040001, 35세,2016,481,272,209,130.1,452,261,191,136.6
35380, 부안군,040002, 36세,2016,546,301,245,122.9,524,288,236,122
35380, 부안군,040003, 37세,2016,498,258,240,107.5,482,247,235,105.1
35380, 부안군,040004, 38세,2016,539,296,243,121.8,512,284,228,124.6
35380, 부안군,040005, 39세,2016,474,263,211,124.6,458,257,201,127.9
35380, 부안군,045,40~44세,2016,3057,1716,1341,128,2978,1677,1301,128.9
35380, 부안군,045001, 40세,2016,553,314,239,131.4,540,307,233,131.8
35380, 부안군,045002, 41세,2016,525,299,226,132.3,514,295,219,134.7
35380, 부안군,045003, 42세,2016,701,406,295,137.6,682,398,284,140.1
35380, 부안군,045004, 43세,2016,642,343,299,114.7,626,333,293,113.7
35380, 부안군,045005, 44세,2016,636,354,282,125.5,616,344,272,126.5
35380, 부안군,050,45~49세,2016,3668,2012,1656,121.5,3582,1982,1600,123.9
35380, 부안군,050001, 45세,2016,736,412,324,127.2,720,403,317,127.1
35380, 부안군,050002, 46세,2016,701,365,336,108.6,683,358,325,110.2
35380, 부안군,050003, 47세,2016,729,423,306,138.2,711,416,295,141
35380, 부안군,050004, 48세,2016,772,428,344,124.4,757,425,332,128
35380, 부안군,050005, 49세,2016,730,384,346,111,711,380,331,114.8
35380, 부안군,055,50~54세,2016,4058,2175,1883,115.5,3975,2145,1830,117.2
35380, 부안군,055001, 50세,2016,774,434,340,127.6,759,427,332,128.6
35380, 부안군,055002, 51세,2016,757,403,354,113.8,738,396,342,115.8
35380, 부안군,055003, 52세,2016,799,415,384,108.1,787,409,378,108.2
35380, 부안군,055004, 53세,2016,820,429,391,109.7,803,424,379,111.9
35380, 부안군,055005, 54세,2016,908,494,414,119.3,888,489,399,122.6
35380, 부안군,060,55~59세,2016,4820,2427,2393,101.4,4762,2403,2359,101.9
35380, 부안군,060001, 55세,2016,961,454,507,89.5,950,450,500,90
35380, 부안군,060002, 56세,2016,1012,505,507,99.6,997,497,500,99.4
35380, 부안군,060003, 57세,2016,919,461,458,100.7,909,455,454,100.2
35380, 부안군,060004, 58세,2016,953,491,462,106.3,943,487,456,106.8
35380, 부안군,060005, 59세,2016,975,516,459,112.4,963,514,449,114.5
35380, 부안군,065,60~64세,2016,4175,2060,2115,97.4,4145,2047,2098,97.6
35380, 부안군,065001, 60세,2016,865,441,424,104,855,437,418,104.5
35380, 부안군,065002, 61세,2016,926,444,482,92.1,921,440,481,91.5
35380, 부안군,065003, 62세,2016,881,432,449,96.2,876,430,446,96.4
35380, 부안군,065004, 63세,2016,679,342,337,101.5,674,341,333,102.4
35380, 부안군,065005, 64세,2016,824,401,423,94.8,819,399,420,95
35380, 부안군,070,65~69세,2016,4117,1951,2166,90.1,4100,1943,2157,90.1
35380, 부안군,070001, 65세,2016,766,350,416,84.1,762,349,413,84.5
35380, 부안군,070002, 66세,2016,846,398,448,88.8,841,396,445,89
35380, 부안군,070003, 67세,2016,844,411,433,94.9,841,410,431,95.1
35380, 부안군,070004, 68세,2016,765,382,383,99.7,763,381,382,99.7
35380, 부안군,070005, 69세,2016,896,410,486,84.4,893,407,486,83.7
35380, 부안군,075,70~74세,2016,3747,1625,2122,76.6,3742,1623,2119,76.6
35380, 부안군,075001, 70세,2016,698,327,371,88.1,697,327,370,88.4
35380, 부안군,075002, 71세,2016,646,286,360,79.4,644,285,359,79.4
35380, 부안군,075003, 72세,2016,691,293,398,73.6,690,293,397,73.8
35380, 부안군,075004, 73세,2016,735,321,414,77.5,734,320,414,77.3
35380, 부안군,075005, 74세,2016,977,398,579,68.7,977,398,579,68.7
35380, 부안군,080,75~79세,2016,3578,1376,2202,62.5,3577,1375,2202,62.4
35380, 부안군,080001, 75세,2016,732,265,467,56.7,732,265,467,56.7
35380, 부안군,080002, 76세,2016,678,267,411,65,677,266,411,64.7
35380, 부안군,080003, 77세,2016,785,303,482,62.9,785,303,482,62.9
35380, 부안군,080004, 78세,2016,733,286,447,64,733,286,447,64
35380, 부안군,080005, 79세,2016,650,255,395,64.6,650,255,395,64.6
35380, 부안군,085,80~84세,2016,2593,829,1764,47,2593,829,1764,47
35380, 부안군,085001, 80세,2016,602,201,401,50.1,602,201,401,50.1
35380, 부안군,085002, 81세,2016,623,199,424,46.9,623,199,424,46.9
35380, 부안군,085003, 82세,2016,551,187,364,51.4,551,187,364,51.4
35380, 부안군,085004, 83세,2016,466,152,314,48.4,466,152,314,48.4
35380, 부안군,085005, 84세,2016,351,90,261,34.5,351,90,261,34.5
35380, 부안군,090,85~89세,2016,1167,304,863,35.2,1165,303,862,35.2
35380, 부안군,090001, 85세,2016,310,91,219,41.6,310,91,219,41.6
35380, 부안군,090002, 86세,2016,280,81,199,40.7,279,80,199,40.2
35380, 부안군,090003, 87세,2016,232,69,163,42.3,231,69,162,42.6
35380, 부안군,090004, 88세,2016,184,34,150,22.7,184,34,150,22.7
35380, 부안군,090005, 89세,2016,161,29,132,22,161,29,132,22
35380, 부안군,095,90~94세,2016,298,70,228,30.7,297,70,227,30.8
35380, 부안군,095001, 90세,2016,76,22,54,40.7,76,22,54,40.7
35380, 부안군,095002, 91세,2016,76,18,58,31,76,18,58,31
35380, 부안군,095003, 92세,2016,42,11,31,35.5,41,11,30,36.7
35380, 부안군,095004, 93세,2016,62,8,54,14.8,62,8,54,14.8
35380, 부안군,095005, 94세,2016,42,11,31,35.5,42,11,31,35.5
35380, 부안군,100,95~99세,2016,73,15,58,25.9,73,15,58,25.9
35380, 부안군,100001, 95세,2016,28,7,21,33.3,28,7,21,33.3
35380, 부안군,100002, 96세,2016,16,X,15,6.7,16,X,15,6.7
35380, 부안군,100003, 97세,2016,14,X,11,27.3,14,X,11,27.3
35380, 부안군,100004, 98세,2016,11,X,8,37.5,11,X,8,37.5
35380, 부안군,100005, 99세,2016,X,X,X,33.3,X,X,X,33.3
35380, 부안군,101,100세이상,2016,10,X,8,25,10,X,8,25
35380, 부안군,102,15세미만,2016,4909,2583,2326,111,4893,2573,2320,110.9
35380, 부안군,103,15~64세,2016,31363,16883,14480,116.6,30471,16469,14002,117.6
35380, 부안군,104,65세이상,2016,15583,6172,9411,65.6,15557,6160,9397,65.6
35380, 부안군,086,85세이상,2016,1548,391,1157,33.8,1545,390,1155,33.8
35380, 부안군,126,평균연령,2016,50,47.1,52.8,,50.2,47.3,53,
35380, 부안군,127,중위연령,2016,53.5,50,56.6,,53.9,50.4,57,
36,전라남도,000,합계,2016,1796017,901500,894517,100.8,1759387,879099,880288,99.9
36,전라남도,005,0~4세,2016,74841,38156,36685,104,74620,38040,36580,104
36,전라남도,005001, 0세,2016,14046,7171,6875,104.3,13997,7144,6853,104.2
36,전라남도,005002, 1세,2016,14788,7585,7203,105.3,14751,7568,7183,105.4
36,전라남도,005003, 2세,2016,14388,7316,7072,103.5,14352,7300,7052,103.5
36,전라남도,005004, 3세,2016,15205,7804,7401,105.4,15155,7779,7376,105.5
36,전라남도,005005, 4세,2016,16414,8280,8134,101.8,16365,8249,8116,101.6
36,전라남도,010,5~9세,2016,77182,39664,37518,105.7,76991,39568,37423,105.7
36,전라남도,010001, 5세,2016,16432,8305,8127,102.2,16387,8285,8102,102.3
36,전라남도,010002, 6세,2016,14979,7823,7156,109.3,14949,7808,7141,109.3
36,전라남도,010003, 7세,2016,14650,7537,7113,106,14607,7515,7092,106
36,전라남도,010004, 8세,2016,15301,7861,7440,105.7,15256,7838,7418,105.7
36,전라남도,010005, 9세,2016,15820,8138,7682,105.9,15792,8122,7670,105.9
36,전라남도,015,10~14세,2016,79137,41058,38079,107.8,79019,41000,38019,107.8
36,전라남도,015001, 10세,2016,14665,7564,7101,106.5,14638,7556,7082,106.7
36,전라남도,015002, 11세,2016,14432,7419,7013,105.8,14407,7403,7004,105.7
36,전라남도,015003, 12세,2016,15995,8374,7621,109.9,15964,8357,7607,109.9
36,전라남도,015004, 13세,2016,16457,8543,7914,107.9,16439,8537,7902,108
36,전라남도,015005, 14세,2016,17588,9158,8430,108.6,17571,9147,8424,108.6
36,전라남도,020,15~19세,2016,107750,57555,50195,114.7,107285,57327,49958,114.8
36,전라남도,020001, 15세,2016,20729,10922,9807,111.4,20709,10911,9798,111.4
36,전라남도,020002, 16세,2016,23532,12241,11291,108.4,23494,12222,11272,108.4
36,전라남도,020003, 17세,2016,22500,11756,10744,109.4,22460,11733,10727,109.4
36,전라남도,020004, 18세,2016,21717,11497,10220,112.5,21608,11452,10156,112.8
36,전라남도,020005, 19세,2016,19272,11139,8133,137,19014,11009,8005,137.5
36,전라남도,025,20~24세,2016,101073,58731,42342,138.7,95427,55215,40212,137.3
36,전라남도,025001, 20세,2016,21096,12913,8183,157.8,20554,12607,7947,158.6
36,전라남도,025002, 21세,2016,21460,13070,8390,155.8,20589,12566,8023,156.6
36,전라남도,025003, 22세,2016,20119,11704,8415,139.1,19020,10995,8025,137
36,전라남도,025004, 23세,2016,19151,10614,8537,124.3,17709,9733,7976,122
36,전라남도,025005, 24세,2016,19247,10430,8817,118.3,17555,9314,8241,113
36,전라남도,030,25~29세,2016,84706,46084,38622,119.3,76435,40700,35735,113.9
36,전라남도,030001, 25세,2016,17698,9674,8024,120.6,15979,8567,7412,115.6
36,전라남도,030002, 26세,2016,17437,9576,7861,121.8,15672,8433,7239,116.5
36,전라남도,030003, 27세,2016,16542,9052,7490,120.9,14874,7970,6904,115.4
36,전라남도,030004, 28세,2016,16289,8880,7409,119.9,14727,7838,6889,113.8
36,전라남도,030005, 29세,2016,16740,8902,7838,113.6,15183,7892,7291,108.2
36,전라남도,035,30~34세,2016,99547,52943,46604,113.6,93402,48828,44574,109.5
36,전라남도,035001, 30세,2016,17375,9311,8064,115.5,15928,8368,7560,110.7
36,전라남도,035002, 31세,2016,17754,9463,8291,114.1,16463,8605,7858,109.5
36,전라남도,035003, 32세,2016,19281,10164,9117,111.5,18105,9379,8726,107.5
36,전라남도,035004, 33세,2016,21398,11327,10071,112.5,20287,10558,9729,108.5
36,전라남도,035005, 34세,2016,23739,12678,11061,114.6,22619,11918,10701,111.4
36,전라남도,040,35~39세,2016,114648,60637,54011,112.3,110555,57811,52744,109.6
36,전라남도,040001, 35세,2016,22554,12146,10408,116.7,21576,11459,10117,113.3
36,전라남도,040002, 36세,2016,24116,12687,11429,111,23267,12114,11153,108.6
36,전라남도,040003, 37세,2016,23409,12307,11102,110.9,22555,11711,10844,108
36,전라남도,040004, 38세,2016,21853,11631,10222,113.8,21110,11134,9976,111.6
36,전라남도,040005, 39세,2016,22716,11866,10850,109.4,22047,11393,10654,106.9
36,전라남도,045,40~44세,2016,126353,67487,58866,114.6,123211,65457,57754,113.3
36,전라남도,045001, 40세,2016,22472,12094,10378,116.5,21768,11628,10140,114.7
36,전라남도,045002, 41세,2016,23383,12408,10975,113.1,22791,12007,10784,111.3
36,전라남도,045003, 42세,2016,26196,13975,12221,114.4,25583,13579,12004,113.1
36,전라남도,045004, 43세,2016,27074,14366,12708,113,26451,13962,12489,111.8
36,전라남도,045005, 44세,2016,27228,14644,12584,116.4,26618,14281,12337,115.8
36,전라남도,050,45~49세,2016,145244,77597,67647,114.7,142563,76210,66353,114.9
36,전라남도,050001, 45세,2016,29565,15898,13667,116.3,28977,15572,13405,116.2
36,전라남도,050002, 46세,2016,28450,15178,13272,114.4,27875,14848,13027,114
36,전라남도,050003, 47세,2016,28773,15296,13477,113.5,28211,15019,13192,113.8
36,전라남도,050004, 48세,2016,30316,16240,14076,115.4,29811,15984,13827,115.6
36,전라남도,050005, 49세,2016,28140,14985,13155,113.9,27689,14787,12902,114.6
36,전라남도,055,50~54세,2016,143411,76193,67218,113.4,141081,75133,65948,113.9
36,전라남도,055001, 50세,2016,28987,15846,13141,120.6,28483,15611,12872,121.3
36,전라남도,055002, 51세,2016,28870,15375,13495,113.9,28364,15147,13217,114.6
36,전라남도,055003, 52세,2016,27157,14242,12915,110.3,26709,14052,12657,111
36,전라남도,055004, 53세,2016,29700,15670,14030,111.7,29192,15446,13746,112.4
36,전라남도,055005, 54세,2016,28697,15060,13637,110.4,28333,14877,13456,110.6
36,전라남도,060,55~59세,2016,151448,76939,74509,103.3,149821,76179,73642,103.4
36,전라남도,060001, 55세,2016,31739,16060,15679,102.4,31400,15908,15492,102.7
36,전라남도,060002, 56세,2016,33614,16997,16617,102.3,33207,16792,16415,102.3
36,전라남도,060003, 57세,2016,30456,15326,15130,101.3,30162,15203,14959,101.6
36,전라남도,060004, 58세,2016,27912,14362,13550,106,27610,14231,13379,106.4
36,전라남도,060005, 59세,2016,27727,14194,13533,104.9,27442,14045,13397,104.8
36,전라남도,065,60~64세,2016,114484,56849,57635,98.6,113563,56400,57163,98.7
36,전라남도,065001, 60세,2016,24208,12253,11955,102.5,23988,12145,11843,102.6
36,전라남도,065002, 61세,2016,26142,13103,13039,100.5,25908,12987,12921,100.5
36,전라남도,065003, 62세,2016,22042,10895,11147,97.7,21864,10814,11050,97.9
36,전라남도,065004, 63세,2016,19272,9451,9821,96.2,19118,9370,9748,96.1
36,전라남도,065005, 64세,2016,22820,11147,11673,95.5,22685,11084,11601,95.5
36,전라남도,070,65~69세,2016,103813,50344,53469,94.2,103368,50129,53239,94.2
36,전라남도,070001, 65세,2016,20095,9936,10159,97.8,19972,9878,10094,97.9
36,전라남도,070002, 66세,2016,20768,10151,10617,95.6,20652,10101,10551,95.7
36,전라남도,070003, 67세,2016,20842,10219,10623,96.2,20747,10166,10581,96.1
36,전라남도,070004, 68세,2016,20336,9789,10547,92.8,20273,9758,10515,92.8
36,전라남도,070005, 69세,2016,21772,10249,11523,88.9,21724,10226,11498,88.9
36,전라남도,075,70~74세,2016,92203,40068,52135,76.9,92052,39997,52055,76.8
36,전라남도,075001, 70세,2016,16588,7711,8877,86.9,16544,7691,8853,86.9
36,전라남도,075002, 71세,2016,16959,7488,9471,79.1,16933,7477,9456,79.1
36,전라남도,075003, 72세,2016,16220,7033,9187,76.6,16194,7018,9176,76.5
36,전라남도,075004, 73세,2016,18459,7792,10667,73,18424,7777,10647,73
36,전라남도,075005, 74세,2016,23977,10044,13933,72.1,23957,10034,13923,72.1
36,전라남도,080,75~79세,2016,87988,34230,53758,63.7,87885,34175,53710,63.6
36,전라남도,080001, 75세,2016,19565,8060,11505,70.1,19533,8044,11489,70
36,전라남도,080002, 76세,2016,18641,7303,11338,64.4,18625,7296,11329,64.4
36,전라남도,080003, 77세,2016,17916,7022,10894,64.5,17894,7010,10884,64.4
36,전라남도,080004, 78세,2016,16643,6236,10407,59.9,16626,6226,10400,59.9
36,전라남도,080005, 79세,2016,15223,5609,9614,58.3,15207,5599,9608,58.3
36,전라남도,085,80~84세,2016,55794,18128,37666,48.1,55751,18106,37645,48.1
36,전라남도,085001, 80세,2016,13213,4671,8542,54.7,13201,4664,8537,54.6
36,전라남도,085002, 81세,2016,12841,4314,8527,50.6,12828,4307,8521,50.5
36,전라남도,085003, 82세,2016,11551,3730,7821,47.7,11545,3726,7819,47.7
36,전라남도,085004, 83세,2016,9639,2902,6737,43.1,9632,2899,6733,43.1
36,전라남도,085005, 84세,2016,8550,2511,6039,41.6,8545,2510,6035,41.6
36,전라남도,090,85~89세,2016,26682,6829,19853,34.4,26663,6824,19839,34.4
36,전라남도,090001, 85세,2016,6965,1858,5107,36.4,6960,1858,5102,36.4
36,전라남도,090002, 86세,2016,7294,1774,5520,32.1,7289,1772,5517,32.1
36,전라남도,090003, 87세,2016,5264,1422,3842,37,5260,1421,3839,37
36,전라남도,090004, 88세,2016,4085,1041,3044,34.2,4082,1040,3042,34.2
36,전라남도,090005, 89세,2016,3074,734,2340,31.4,3072,733,2339,31.3
36,전라남도,095,90~94세,2016,7784,1704,6080,28,7772,1699,6073,28
36,전라남도,095001, 90세,2016,2203,547,1656,33,2199,544,1655,32.9
36,전라남도,095002, 91세,2016,1770,427,1343,31.8,1766,426,1340,31.8
36,전라남도,095003, 92세,2016,1296,301,995,30.3,1295,301,994,30.3
36,전라남도,095004, 93세,2016,1524,244,1280,19.1,1522,244,1278,19.1
36,전라남도,095005, 94세,2016,991,185,806,23,990,184,806,22.8
36,전라남도,100,95~99세,2016,1724,280,1444,19.4,1719,278,1441,19.3
36,전라남도,100001, 95세,2016,642,107,535,20,641,107,534,20
36,전라남도,100002, 96세,2016,458,67,391,17.1,458,67,391,17.1
36,전라남도,100003, 97세,2016,290,53,237,22.4,288,52,236,22
36,전라남도,100004, 98세,2016,210,34,176,19.3,208,33,175,18.9
36,전라남도,100005, 99세,2016,124,19,105,18.1,124,19,105,18.1
36,전라남도,101,100세이상,2016,205,24,181,13.3,204,23,181,12.7
36,전라남도,102,15세미만,2016,231160,118878,112282,105.9,230630,118608,112022,105.9
36,전라남도,103,15~64세,2016,1188664,631015,557649,113.2,1153343,609260,544083,112
36,전라남도,104,65세이상,2016,376193,151607,224586,67.5,375414,151231,224183,67.5
36,전라남도,086,85세이상,2016,36395,8837,27558,32.1,36358,8824,27534,32
36,전라남도,126,평균연령,2016,44.4,42.4,46.4,,44.6,42.6,46.6,
36,전라남도,127,중위연령,2016,46.1,44.2,48.3,,46.5,44.7,48.5,
36004, 읍부,000,합계,2016,431532,217441,214091,101.6,419207,209425,209782,99.8
36004, 읍부,005,0~4세,2016,20517,10488,10029,104.6,20414,10432,9982,104.5
36004, 읍부,005001, 0세,2016,3794,1950,1844,105.7,3774,1939,1835,105.7
36004, 읍부,005002, 1세,2016,3998,2038,1960,104,3975,2024,1951,103.7
36004, 읍부,005003, 2세,2016,3956,2009,1947,103.2,3944,2006,1938,103.5
36004, 읍부,005004, 3세,2016,4278,2217,2061,107.6,4255,2206,2049,107.7
36004, 읍부,005005, 4세,2016,4491,2274,2217,102.6,4466,2257,2209,102.2
36004, 읍부,010,5~9세,2016,20700,10608,10092,105.1,20621,10571,10050,105.2
36004, 읍부,010001, 5세,2016,4511,2282,2229,102.4,4491,2275,2216,102.7
36004, 읍부,010002, 6세,2016,3964,2057,1907,107.9,3949,2049,1900,107.8
36004, 읍부,010003, 7세,2016,3952,2036,1916,106.3,3936,2029,1907,106.4
36004, 읍부,010004, 8세,2016,4077,2076,2001,103.7,4061,2067,1994,103.7
36004, 읍부,010005, 9세,2016,4196,2157,2039,105.8,4184,2151,2033,105.8
36004, 읍부,015,10~14세,2016,20679,10739,9940,108,20632,10708,9924,107.9
36004, 읍부,015001, 10세,2016,3945,2058,1887,109.1,3933,2051,1882,109
36004, 읍부,015002, 11세,2016,3864,1996,1868,106.9,3852,1987,1865,106.5
36004, 읍부,015003, 12세,2016,4141,2172,1969,110.3,4131,2165,1966,110.1
36004, 읍부,015004, 13세,2016,4199,2179,2020,107.9,4193,2175,2018,107.8
36004, 읍부,015005, 14세,2016,4530,2334,2196,106.3,4523,2330,2193,106.2
36004, 읍부,020,15~19세,2016,29135,15228,13907,109.5,28988,15158,13830,109.6
36004, 읍부,020001, 15세,2016,5733,2918,2815,103.7,5726,2915,2811,103.7
36004, 읍부,020002, 16세,2016,6858,3506,3352,104.6,6844,3501,3343,104.7
36004, 읍부,020003, 17세,2016,6315,3265,3050,107,6297,3258,3039,107.2
36004, 읍부,020004, 18세,2016,5727,2957,2770,106.8,5701,2950,2751,107.2
36004, 읍부,020005, 19세,2016,4502,2582,1920,134.5,4420,2534,1886,134.4
36004, 읍부,025,20~24세,2016,23296,13634,9662,141.1,21581,12498,9083,137.6
36004, 읍부,025001, 20세,2016,4997,3092,1905,162.3,4830,2998,1832,163.6
36004, 읍부,025002, 21세,2016,5000,3007,1993,150.9,4726,2851,1875,152.1
36004, 읍부,025003, 22세,2016,4661,2734,1927,141.9,4337,2504,1833,136.6
36004, 읍부,025004, 23세,2016,4302,2394,1908,125.5,3868,2099,1769,118.7
36004, 읍부,025005, 24세,2016,4336,2407,1929,124.8,3820,2046,1774,115.3
36004, 읍부,030,25~29세,2016,19813,10601,9212,115.1,17130,8732,8398,104
36004, 읍부,030001, 25세,2016,4046,2172,1874,115.9,3503,1801,1702,105.8
36004, 읍부,030002, 26세,2016,3994,2209,1785,123.8,3450,1833,1617,113.4
36004, 읍부,030003, 27세,2016,3792,2057,1735,118.6,3275,1698,1577,107.7
36004, 읍부,030004, 28세,2016,3902,2073,1829,113.3,3378,1697,1681,101
36004, 읍부,030005, 29세,2016,4079,2090,1989,105.1,3524,1703,1821,93.5
36004, 읍부,035,30~34세,2016,24788,13085,11703,111.8,22717,11554,11163,103.5
36004, 읍부,035001, 30세,2016,4245,2277,1968,115.7,3766,1922,1844,104.2
36004, 읍부,035002, 31세,2016,4411,2317,2094,110.6,3977,1992,1985,100.4
36004, 읍부,035003, 32세,2016,4718,2425,2293,105.8,4301,2136,2165,98.7
36004, 읍부,035004, 33세,2016,5328,2828,2500,113.1,4954,2540,2414,105.2
36004, 읍부,035005, 34세,2016,6086,3238,2848,113.7,5719,2964,2755,107.6
36004, 읍부,040,35~39세,2016,29480,15421,14059,109.7,28113,14416,13697,105.2
36004, 읍부,040001, 35세,2016,5764,3087,2677,115.3,5392,2806,2586,108.5
36004, 읍부,040002, 36세,2016,6170,3188,2982,106.9,5884,2981,2903,102.7
36004, 읍부,040003, 37세,2016,6020,3119,2901,107.5,5765,2933,2832,103.6
36004, 읍부,040004, 38세,2016,5678,2997,2681,111.8,5444,2835,2609,108.7
36004, 읍부,040005, 39세,2016,5848,3030,2818,107.5,5628,2861,2767,103.4
36004, 읍부,045,40~44세,2016,31992,17059,14933,114.2,30935,16359,14576,112.2
36004, 읍부,045001, 40세,2016,5736,3081,2655,116,5492,2908,2584,112.5
36004, 읍부,045002, 41세,2016,5946,3152,2794,112.8,5733,3005,2728,110.2
36004, 읍부,045003, 42세,2016,6798,3616,3182,113.6,6588,3477,3111,111.8
36004, 읍부,045004, 43세,2016,6797,3624,3173,114.2,6598,3495,3103,112.6
36004, 읍부,045005, 44세,2016,6715,3586,3129,114.6,6524,3474,3050,113.9
36004, 읍부,050,45~49세,2016,35034,19167,15867,120.8,34048,18622,15426,120.7
36004, 읍부,050001, 45세,2016,7453,4101,3352,122.3,7234,3981,3253,122.4
36004, 읍부,050002, 46세,2016,7034,3831,3203,119.6,6814,3702,3112,119
36004, 읍부,050003, 47세,2016,6905,3777,3128,120.7,6708,3670,3038,120.8
36004, 읍부,050004, 48세,2016,7156,3959,3197,123.8,6963,3850,3113,123.7
36004, 읍부,050005, 49세,2016,6486,3499,2987,117.1,6329,3419,2910,117.5
36004, 읍부,055,50~54세,2016,32775,17434,15341,113.6,31905,16998,14907,114
36004, 읍부,055001, 50세,2016,6806,3770,3036,124.2,6602,3668,2934,125
36004, 읍부,055002, 51세,2016,6439,3426,3013,113.7,6253,3319,2934,113.1
36004, 읍부,055003, 52세,2016,6112,3227,2885,111.9,5952,3152,2800,112.6
36004, 읍부,055004, 53세,2016,6750,3533,3217,109.8,6573,3452,3121,110.6
36004, 읍부,055005, 54세,2016,6668,3478,3190,109,6525,3407,3118,109.3
36004, 읍부,060,55~59세,2016,34218,17651,16567,106.5,33627,17337,16290,106.4
36004, 읍부,060001, 55세,2016,7229,3683,3546,103.9,7122,3631,3491,104
36004, 읍부,060002, 56세,2016,7609,3945,3664,107.7,7443,3852,3591,107.3
36004, 읍부,060003, 57세,2016,6767,3466,3301,105,6675,3422,3253,105.2
36004, 읍부,060004, 58세,2016,6307,3290,3017,109,6191,3231,2960,109.2
36004, 읍부,060005, 59세,2016,6306,3267,3039,107.5,6196,3201,2995,106.9
36004, 읍부,065,60~64세,2016,25669,12618,13051,96.7,25326,12448,12878,96.7
36004, 읍부,065001, 60세,2016,5463,2827,2636,107.2,5377,2783,2594,107.3
36004, 읍부,065002, 61세,2016,5810,2877,2933,98.1,5732,2834,2898,97.8
36004, 읍부,065003, 62세,2016,4966,2401,2565,93.6,4892,2370,2522,94
36004, 읍부,065004, 63세,2016,4351,2082,2269,91.8,4298,2053,2245,91.4
36004, 읍부,065005, 64세,2016,5079,2431,2648,91.8,5027,2408,2619,91.9
36004, 읍부,070,65~69세,2016,23475,11320,12155,93.1,23323,11248,12075,93.2
36004, 읍부,070001, 65세,2016,4583,2230,2353,94.8,4542,2214,2328,95.1
36004, 읍부,070002, 66세,2016,4697,2235,2462,90.8,4660,2220,2440,91
36004, 읍부,070003, 67세,2016,4710,2299,2411,95.4,4673,2277,2396,95
36004, 읍부,070004, 68세,2016,4569,2193,2376,92.3,4548,2183,2365,92.3
36004, 읍부,070005, 69세,2016,4916,2363,2553,92.6,4900,2354,2546,92.5
36004, 읍부,075,70~74세,2016,20451,8972,11479,78.2,20402,8953,11449,78.2
36004, 읍부,075001, 70세,2016,3780,1773,2007,88.3,3767,1770,1997,88.6
36004, 읍부,075002, 71세,2016,3793,1710,2083,82.1,3785,1708,2077,82.2
36004, 읍부,075003, 72세,2016,3559,1587,1972,80.5,3549,1580,1969,80.2
36004, 읍부,075004, 73세,2016,4068,1706,2362,72.2,4056,1701,2355,72.2
36004, 읍부,075005, 74세,2016,5251,2196,3055,71.9,5245,2194,3051,71.9
36004, 읍부,080,75~79세,2016,19062,7417,11645,63.7,19024,7401,11623,63.7
36004, 읍부,080001, 75세,2016,4244,1760,2484,70.9,4231,1753,2478,70.7
36004, 읍부,080002, 76세,2016,4073,1575,2498,63.1,4067,1574,2493,63.1
36004, 읍부,080003, 77세,2016,3856,1509,2347,64.3,3850,1508,2342,64.4
36004, 읍부,080004, 78세,2016,3604,1368,2236,61.2,3598,1365,2233,61.1
36004, 읍부,080005, 79세,2016,3285,1205,2080,57.9,3278,1201,2077,57.8
36004, 읍부,085,80~84세,2016,12222,4043,8179,49.4,12209,4037,8172,49.4
36004, 읍부,085001, 80세,2016,2856,1036,1820,56.9,2853,1034,1819,56.8
36004, 읍부,085002, 81세,2016,2776,975,1801,54.1,2771,973,1798,54.1
36004, 읍부,085003, 82세,2016,2574,865,1709,50.6,2573,864,1709,50.6
36004, 읍부,085004, 83세,2016,2088,617,1471,41.9,2087,617,1470,42
36004, 읍부,085005, 84세,2016,1928,550,1378,39.9,1925,549,1376,39.9
36004, 읍부,090,85~89세,2016,5996,1491,4505,33.1,5988,1490,4498,33.1
36004, 읍부,090001, 85세,2016,1587,415,1172,35.4,1584,415,1169,35.5
36004, 읍부,090002, 86세,2016,1590,377,1213,31.1,1588,376,1212,31
36004, 읍부,090003, 87세,2016,1173,307,866,35.5,1172,307,865,35.5
36004, 읍부,090004, 88세,2016,942,224,718,31.2,941,224,717,31.2
36004, 읍부,090005, 89세,2016,704,168,536,31.3,703,168,535,31.4
36004, 읍부,095,90~94세,2016,1787,395,1392,28.4,1783,395,1388,28.5
36004, 읍부,095001, 90세,2016,469,113,356,31.7,469,113,356,31.7
36004, 읍부,095002, 91세,2016,391,108,283,38.2,388,108,280,38.6
36004, 읍부,095003, 92세,2016,335,79,256,30.9,334,79,255,31
36004, 읍부,095004, 93세,2016,352,51,301,16.9,352,51,301,16.9
36004, 읍부,095005, 94세,2016,240,44,196,22.4,240,44,196,22.4
36004, 읍부,100,95~99세,2016,389,61,328,18.6,388,60,328,18.3
36004, 읍부,100001, 95세,2016,147,29,118,24.6,147,29,118,24.6
36004, 읍부,100002, 96세,2016,95,14,81,17.3,95,14,81,17.3
36004, 읍부,100003, 97세,2016,67,8,59,13.6,66,7,59,11.9
36004, 읍부,100004, 98세,2016,52,10,42,23.8,52,10,42,23.8
36004, 읍부,100005, 99세,2016,28,X,28,0,28,X,28,0
36004, 읍부,101,100세이상,2016,54,9,45,20,53,8,45,17.8
36004, 읍부,102,15세미만,2016,61896,31835,30061,105.9,61667,31711,29956,105.9
36004, 읍부,103,15~64세,2016,286200,151898,134302,113.1,274370,144122,130248,110.7
36004, 읍부,104,65세이상,2016,83436,33708,49728,67.8,83170,33592,49578,67.8
36004, 읍부,086,85세이상,2016,8226,1956,6270,31.2,8212,1953,6259,31.2
36004, 읍부,126,평균연령,2016,43,41.2,44.8,,43.2,41.4,45,
36004, 읍부,127,중위연령,2016,44.3,42.7,46,,44.8,43.4,46.3,
36005, 면부,000,합계,2016,577515,285353,292162,97.7,563021,276330,286691,96.4
36005, 면부,005,0~4세,2016,17192,8726,8466,103.1,17162,8709,8453,103
36005, 면부,005001, 0세,2016,3528,1795,1733,103.6,3525,1793,1732,103.5
36005, 면부,005002, 1세,2016,3602,1812,1790,101.2,3600,1812,1788,101.3
36005, 면부,005003, 2세,2016,3248,1642,1606,102.2,3241,1638,1603,102.2
36005, 면부,005004, 3세,2016,3345,1713,1632,105,3337,1709,1628,105
36005, 면부,005005, 4세,2016,3469,1764,1705,103.5,3459,1757,1702,103.2
36005, 면부,010,5~9세,2016,15570,8059,7511,107.3,15536,8043,7493,107.3
36005, 면부,010001, 5세,2016,3364,1733,1631,106.3,3358,1732,1626,106.5
36005, 면부,010002, 6세,2016,2956,1538,1418,108.5,2950,1535,1415,108.5
36005, 면부,010003, 7세,2016,2913,1527,1386,110.2,2905,1523,1382,110.2
36005, 면부,010004, 8세,2016,3099,1614,1485,108.7,3091,1610,1481,108.7
36005, 면부,010005, 9세,2016,3238,1647,1591,103.5,3232,1643,1589,103.4
36005, 면부,015,10~14세,2016,16634,8721,7913,110.2,16611,8712,7899,110.3
36005, 면부,015001, 10세,2016,2951,1531,1420,107.8,2946,1530,1416,108.1
36005, 면부,015002, 11세,2016,3002,1567,1435,109.2,2998,1565,1433,109.2
36005, 면부,015003, 12세,2016,3316,1763,1553,113.5,3307,1759,1548,113.6
36005, 면부,015004, 13세,2016,3505,1844,1661,111,3503,1844,1659,111.2
36005, 면부,015005, 14세,2016,3860,2016,1844,109.3,3857,2014,1843,109.3
36005, 면부,020,15~19세,2016,23214,12823,10391,123.4,23058,12749,10309,123.7
36005, 면부,020001, 15세,2016,4363,2344,2019,116.1,4360,2344,2016,116.3
36005, 면부,020002, 16세,2016,4812,2609,2203,118.4,4803,2604,2199,118.4
36005, 면부,020003, 17세,2016,4610,2453,2157,113.7,4600,2447,2153,113.7
36005, 면부,020004, 18세,2016,4680,2581,2099,123,4646,2569,2077,123.7
36005, 면부,020005, 19세,2016,4749,2836,1913,148.2,4649,2785,1864,149.4
36005, 면부,025,20~24세,2016,25571,15380,10191,150.9,22932,13605,9327,145.9
36005, 면부,025001, 20세,2016,5158,3251,1907,170.5,4935,3103,1832,169.4
36005, 면부,025002, 21세,2016,5365,3417,1948,175.4,4967,3155,1812,174.1
36005, 면부,025003, 22세,2016,5058,3037,2021,150.3,4529,2666,1863,143.1
36005, 면부,025004, 23세,2016,4979,2855,2124,134.4,4273,2411,1862,129.5
36005, 면부,025005, 24세,2016,5011,2820,2191,128.7,4228,2270,1958,115.9
36005, 면부,030,25~29세,2016,22696,12810,9886,129.6,19019,10332,8687,118.9
36005, 면부,030001, 25세,2016,4700,2677,2023,132.3,3919,2133,1786,119.4
36005, 면부,030002, 26세,2016,4761,2696,2065,130.6,3951,2159,1792,120.5
36005, 면부,030003, 27세,2016,4436,2495,1941,128.5,3675,1978,1697,116.6
36005, 면부,030004, 28세,2016,4388,2512,1876,133.9,3713,2053,1660,123.7
36005, 면부,030005, 29세,2016,4411,2430,1981,122.7,3761,2009,1752,114.7
36005, 면부,035,30~34세,2016,24048,13406,10642,126,21451,11689,9762,119.7
36005, 면부,035001, 30세,2016,4542,2505,2037,123,3923,2108,1815,116.1
36005, 면부,035002, 31세,2016,4362,2420,1942,124.6,3804,2059,1745,118
36005, 면부,035003, 32세,2016,4710,2633,2077,126.8,4224,2307,1917,120.3
36005, 면부,035004, 33세,2016,4998,2763,2235,123.6,4539,2452,2087,117.5
36005, 면부,035005, 34세,2016,5436,3085,2351,131.2,4961,2763,2198,125.7
36005, 면부,040,35~39세,2016,25684,14715,10969,134.2,24077,13630,10447,130.5
36005, 면부,040001, 35세,2016,5028,2835,2193,129.3,4675,2605,2070,125.8
36005, 면부,040002, 36세,2016,5338,3037,2301,132,4992,2804,2188,128.2
36005, 면부,040003, 37세,2016,5139,2950,2189,134.8,4796,2717,2079,130.7
36005, 면부,040004, 38세,2016,5031,2959,2072,142.8,4721,2742,1979,138.6
36005, 면부,040005, 39세,2016,5148,2934,2214,132.5,4893,2762,2131,129.6
36005, 면부,045,40~44세,2016,29590,17577,12013,146.3,28551,16942,11609,145.9
36005, 면부,045001, 40세,2016,5158,3055,2103,145.3,4921,2912,2009,144.9
36005, 면부,045002, 41세,2016,5301,3108,2193,141.7,5113,2982,2131,139.9
36005, 면부,045003, 42세,2016,6205,3721,2484,149.8,6005,3599,2406,149.6
36005, 면부,045004, 43세,2016,6468,3828,2640,145,6248,3691,2557,144.3
36005, 면부,045005, 44세,2016,6458,3865,2593,149.1,6264,3758,2506,150
36005, 면부,050,45~49세,2016,37612,21527,16085,133.8,36802,21147,15655,135.1
36005, 면부,050001, 45세,2016,7108,4206,2902,144.9,6949,4128,2821,146.3
36005, 면부,050002, 46세,2016,7096,4121,2975,138.5,6932,4038,2894,139.5
36005, 면부,050003, 47세,2016,7398,4164,3234,128.8,7219,4087,3132,130.5
36005, 면부,050004, 48세,2016,8164,4667,3497,133.5,8001,4590,3411,134.6
36005, 면부,050005, 49세,2016,7846,4369,3477,125.7,7701,4304,3397,126.7
36005, 면부,055,50~54세,2016,44295,24472,19823,123.5,43482,24131,19351,124.7
36005, 면부,055001, 50세,2016,8366,4724,3642,129.7,8204,4651,3553,130.9
36005, 면부,055002, 51세,2016,8701,4853,3848,126.1,8513,4785,3728,128.4
36005, 면부,055003, 52세,2016,8517,4739,3778,125.4,8368,4680,3688,126.9
36005, 면부,055004, 53세,2016,9354,5141,4213,122,9160,5058,4102,123.3
36005, 면부,055005, 54세,2016,9357,5015,4342,115.5,9237,4957,4280,115.8
36005, 면부,060,55~59세,2016,53965,27846,26119,106.6,53420,27618,25802,107
36005, 면부,060001, 55세,2016,10700,5580,5120,109,10572,5523,5049,109.4
36005, 면부,060002, 56세,2016,11698,6055,5643,107.3,11573,5995,5578,107.5
36005, 면부,060003, 57세,2016,11056,5671,5385,105.3,10947,5635,5312,106.1
36005, 면부,060004, 58세,2016,10266,5308,4958,107.1,10177,5273,4904,107.5
36005, 면부,060005, 59세,2016,10245,5232,5013,104.4,10151,5192,4959,104.7
36005, 면부,065,60~64세,2016,45218,22360,22858,97.8,44935,22220,22715,97.8
36005, 면부,065001, 60세,2016,9157,4649,4508,103.1,9089,4614,4475,103.1
36005, 면부,065002, 61세,2016,10130,5068,5062,100.1,10046,5030,5016,100.3
36005, 면부,065003, 62세,2016,8598,4210,4388,95.9,8546,4186,4360,96
36005, 면부,065004, 63세,2016,7841,3831,4010,95.5,7798,3812,3986,95.6
36005, 면부,065005, 64세,2016,9492,4602,4890,94.1,9456,4578,4878,93.8
36005, 면부,070,65~69세,2016,46539,22325,24214,92.2,46394,22253,24141,92.2
36005, 면부,070001, 65세,2016,8476,4114,4362,94.3,8435,4092,4343,94.2
36005, 면부,070002, 66세,2016,9174,4422,4752,93.1,9130,4402,4728,93.1
36005, 면부,070003, 67세,2016,9336,4599,4737,97.1,9309,4586,4723,97.1
36005, 면부,070004, 68세,2016,9402,4504,4898,92,9382,4493,4889,91.9
36005, 면부,070005, 69세,2016,10151,4686,5465,85.7,10138,4680,5458,85.7
36005, 면부,075,70~74세,2016,47038,19853,27185,73,46992,19828,27164,73
36005, 면부,075001, 70세,2016,7794,3551,4243,83.7,7781,3543,4238,83.6
36005, 면부,075002, 71세,2016,8387,3552,4835,73.5,8380,3548,4832,73.4
36005, 면부,075003, 72세,2016,8265,3443,4822,71.4,8259,3442,4817,71.5
36005, 면부,075004, 73세,2016,9584,3926,5658,69.4,9573,3920,5653,69.3
36005, 면부,075005, 74세,2016,13008,5381,7627,70.6,12999,5375,7624,70.5
36005, 면부,080,75~79세,2016,49795,19157,30638,62.5,49770,19140,30630,62.5
36005, 면부,080001, 75세,2016,10892,4446,6446,69,10883,4441,6442,68.9
36005, 면부,080002, 76세,2016,10384,3994,6390,62.5,10381,3992,6389,62.5
36005, 면부,080003, 77세,2016,10270,3991,6279,63.6,10263,3985,6278,63.5
36005, 면부,080004, 78세,2016,9487,3540,5947,59.5,9482,3537,5945,59.5
36005, 면부,080005, 79세,2016,8762,3186,5576,57.1,8761,3185,5576,57.1
36005, 면부,085,80~84세,2016,32361,10468,21893,47.8,32347,10460,21887,47.8
36005, 면부,085001, 80세,2016,7687,2695,4992,54,7683,2692,4991,53.9
36005, 면부,085002, 81세,2016,7558,2462,5096,48.3,7555,2461,5094,48.3
36005, 면부,085003, 82세,2016,6661,2140,4521,47.3,6657,2138,4519,47.3
36005, 면부,085004, 83세,2016,5603,1699,3904,43.5,5600,1697,3903,43.5
36005, 면부,085005, 84세,2016,4852,1472,3380,43.6,4852,1472,3380,43.6
36005, 면부,090,85~89세,2016,15058,3953,11105,35.6,15052,3951,11101,35.6
36005, 면부,090001, 85세,2016,3885,1045,2840,36.8,3883,1045,2838,36.8
36005, 면부,090002, 86세,2016,4175,1062,3113,34.1,4174,1062,3112,34.1
36005, 면부,090003, 87세,2016,3024,833,2191,38,3023,832,2191,38
36005, 면부,090004, 88세,2016,2311,615,1696,36.3,2309,614,1695,36.2
36005, 면부,090005, 89세,2016,1663,398,1265,31.5,1663,398,1265,31.5
36005, 면부,095,90~94세,2016,4344,992,3352,29.6,4341,989,3352,29.5
36005, 면부,095001, 90세,2016,1269,333,936,35.6,1267,331,936,35.4
36005, 면부,095002, 91세,2016,989,236,753,31.3,989,236,753,31.3
36005, 면부,095003, 92세,2016,689,170,519,32.8,689,170,519,32.8
36005, 면부,095004, 93세,2016,852,155,697,22.2,852,155,697,22.2
36005, 면부,095005, 94세,2016,545,98,447,21.9,544,97,447,21.7
36005, 면부,100,95~99세,2016,972,169,803,21,970,168,802,20.9
36005, 면부,100001, 95세,2016,352,59,293,20.1,352,59,293,20.1
36005, 면부,100002, 96세,2016,251,38,213,17.8,251,38,213,17.8
36005, 면부,100003, 97세,2016,176,35,141,24.8,176,35,141,24.8
36005, 면부,100004, 98세,2016,119,21,98,21.4,117,20,97,20.6
36005, 면부,100005, 99세,2016,74,16,58,27.6,74,16,58,27.6
36005, 면부,101,100세이상,2016,119,14,105,13.3,119,14,105,13.3
36005, 면부,102,15세미만,2016,49396,25506,23890,106.8,49309,25464,23845,106.8
36005, 면부,103,15~64세,2016,331893,182916,148977,122.8,317727,174063,143664,121.2
36005, 면부,104,65세이상,2016,196226,76931,119295,64.5,195985,76803,119182,64.4
36005, 면부,086,85세이상,2016,20493,5128,15365,33.4,20482,5122,15360,33.3
36005, 면부,126,평균연령,2016,51.8,48.7,54.8,,52.3,49.2,55.2,
36005, 면부,127,중위연령,2016,55.6,51.9,59.2,,56.2,52.7,59.7,
36003, 동부,000,합계,2016,786970,398706,388264,102.7,777159,393344,383815,102.5
36003, 동부,005,0~4세,2016,37132,18942,18190,104.1,37044,18899,18145,104.2
36003, 동부,005001, 0세,2016,6724,3426,3298,103.9,6698,3412,3286,103.8
36003, 동부,005002, 1세,2016,7188,3735,3453,108.2,7176,3732,3444,108.4
36003, 동부,005003, 2세,2016,7184,3665,3519,104.1,7167,3656,3511,104.1
36003, 동부,005004, 3세,2016,7582,3874,3708,104.5,7563,3864,3699,104.5
36003, 동부,005005, 4세,2016,8454,4242,4212,100.7,8440,4235,4205,100.7
36003, 동부,010,5~9세,2016,40912,20997,19915,105.4,40834,20954,19880,105.4
36003, 동부,010001, 5세,2016,8557,4290,4267,100.5,8538,4278,4260,100.4
36003, 동부,010002, 6세,2016,8059,4228,3831,110.4,8050,4224,3826,110.4
36003, 동부,010003, 7세,2016,7785,3974,3811,104.3,7766,3963,3803,104.2
36003, 동부,010004, 8세,2016,8125,4171,3954,105.5,8104,4161,3943,105.5
36003, 동부,010005, 9세,2016,8386,4334,4052,107,8376,4328,4048,106.9
36003, 동부,015,10~14세,2016,41824,21598,20226,106.8,41776,21580,20196,106.9
36003, 동부,015001, 10세,2016,7769,3975,3794,104.8,7759,3975,3784,105
36003, 동부,015002, 11세,2016,7566,3856,3710,103.9,7557,3851,3706,103.9
36003, 동부,015003, 12세,2016,8538,4439,4099,108.3,8526,4433,4093,108.3
36003, 동부,015004, 13세,2016,8753,4520,4233,106.8,8743,4518,4225,106.9
36003, 동부,015005, 14세,2016,9198,4808,4390,109.5,9191,4803,4388,109.5
36003, 동부,020,15~19세,2016,55401,29504,25897,113.9,55239,29420,25819,113.9
36003, 동부,020001, 15세,2016,10633,5660,4973,113.8,10623,5652,4971,113.7
36003, 동부,020002, 16세,2016,11862,6126,5736,106.8,11847,6117,5730,106.8
36003, 동부,020003, 17세,2016,11575,6038,5537,109,11563,6028,5535,108.9
36003, 동부,020004, 18세,2016,11310,5959,5351,111.4,11261,5933,5328,111.4
36003, 동부,020005, 19세,2016,10021,5721,4300,133,9945,5690,4255,133.7
36003, 동부,025,20~24세,2016,52206,29717,22489,132.1,50914,29112,21802,133.5
36003, 동부,025001, 20세,2016,10941,6570,4371,150.3,10789,6506,4283,151.9
36003, 동부,025002, 21세,2016,11095,6646,4449,149.4,10896,6560,4336,151.3
36003, 동부,025003, 22세,2016,10400,5933,4467,132.8,10154,5825,4329,134.6
36003, 동부,025004, 23세,2016,9870,5365,4505,119.1,9568,5223,4345,120.2
36003, 동부,025005, 24세,2016,9900,5203,4697,110.8,9507,4998,4509,110.8
36003, 동부,030,25~29세,2016,42197,22673,19524,116.1,40286,21636,18650,116
36003, 동부,030001, 25세,2016,8952,4825,4127,116.9,8557,4633,3924,118.1
36003, 동부,030002, 26세,2016,8682,4671,4011,116.5,8271,4441,3830,116
36003, 동부,030003, 27세,2016,8314,4500,3814,118,7924,4294,3630,118.3
36003, 동부,030004, 28세,2016,7999,4295,3704,116,7636,4088,3548,115.2
36003, 동부,030005, 29세,2016,8250,4382,3868,113.3,7898,4180,3718,112.4
36003, 동부,035,30~34세,2016,50711,26452,24259,109,49234,25585,23649,108.2
36003, 동부,035001, 30세,2016,8588,4529,4059,111.6,8239,4338,3901,111.2
36003, 동부,035002, 31세,2016,8981,4726,4255,111.1,8682,4554,4128,110.3
36003, 동부,035003, 32세,2016,9853,5106,4747,107.6,9580,4936,4644,106.3
36003, 동부,035004, 33세,2016,11072,5736,5336,107.5,10794,5566,5228,106.5
36003, 동부,035005, 34세,2016,12217,6355,5862,108.4,11939,6191,5748,107.7
36003, 동부,040,35~39세,2016,59484,30501,28983,105.2,58365,29765,28600,104.1
36003, 동부,040001, 35세,2016,11762,6224,5538,112.4,11509,6048,5461,110.7
36003, 동부,040002, 36세,2016,12608,6462,6146,105.1,12391,6329,6062,104.4
36003, 동부,040003, 37세,2016,12250,6238,6012,103.8,11994,6061,5933,102.2
36003, 동부,040004, 38세,2016,11144,5675,5469,103.8,10945,5557,5388,103.1
36003, 동부,040005, 39세,2016,11720,5902,5818,101.4,11526,5770,5756,100.2
36003, 동부,045,40~44세,2016,64771,32851,31920,102.9,63725,32156,31569,101.9
36003, 동부,045001, 40세,2016,11578,5958,5620,106,11355,5808,5547,104.7
36003, 동부,045002, 41세,2016,12136,6148,5988,102.7,11945,6020,5925,101.6
36003, 동부,045003, 42세,2016,13193,6638,6555,101.3,12990,6503,6487,100.2
36003, 동부,045004, 43세,2016,13809,6914,6895,100.3,13605,6776,6829,99.2
36003, 동부,045005, 44세,2016,14055,7193,6862,104.8,13830,7049,6781,104
36003, 동부,050,45~49세,2016,72598,36903,35695,103.4,71713,36441,35272,103.3
36003, 동부,050001, 45세,2016,15004,7591,7413,102.4,14794,7463,7331,101.8
36003, 동부,050002, 46세,2016,14320,7226,7094,101.9,14129,7108,7021,101.2
36003, 동부,050003, 47세,2016,14470,7355,7115,103.4,14284,7262,7022,103.4
36003, 동부,050004, 48세,2016,14996,7614,7382,103.1,14847,7544,7303,103.3
36003, 동부,050005, 49세,2016,13808,7117,6691,106.4,13659,7064,6595,107.1
36003, 동부,055,50~54세,2016,66341,34287,32054,107,65694,34004,31690,107.3
36003, 동부,055001, 50세,2016,13815,7352,6463,113.8,13677,7292,6385,114.2
36003, 동부,055002, 51세,2016,13730,7096,6634,107,13598,7043,6555,107.4
36003, 동부,055003, 52세,2016,12528,6276,6252,100.4,12389,6220,6169,100.8
36003, 동부,055004, 53세,2016,13596,6996,6600,106,13459,6936,6523,106.3
36003, 동부,055005, 54세,2016,12672,6567,6105,107.6,12571,6513,6058,107.5
36003, 동부,060,55~59세,2016,63265,31442,31823,98.8,62774,31224,31550,99
36003, 동부,060001, 55세,2016,13810,6797,7013,96.9,13706,6754,6952,97.2
36003, 동부,060002, 56세,2016,14307,6997,7310,95.7,14191,6945,7246,95.8
36003, 동부,060003, 57세,2016,12633,6189,6444,96,12540,6146,6394,96.1
36003, 동부,060004, 58세,2016,11339,5764,5575,103.4,11242,5727,5515,103.8
36003, 동부,060005, 59세,2016,11176,5695,5481,103.9,11095,5652,5443,103.8
36003, 동부,065,60~64세,2016,43597,21871,21726,100.7,43302,21732,21570,100.8
36003, 동부,065001, 60세,2016,9588,4777,4811,99.3,9522,4748,4774,99.5
36003, 동부,065002, 61세,2016,10202,5158,5044,102.3,10130,5123,5007,102.3
36003, 동부,065003, 62세,2016,8478,4284,4194,102.1,8426,4258,4168,102.2
36003, 동부,065004, 63세,2016,7080,3538,3542,99.9,7022,3505,3517,99.7
36003, 동부,065005, 64세,2016,8249,4114,4135,99.5,8202,4098,4104,99.9
36003, 동부,070,65~69세,2016,33799,16699,17100,97.7,33651,16628,17023,97.7
36003, 동부,070001, 65세,2016,7036,3592,3444,104.3,6995,3572,3423,104.4
36003, 동부,070002, 66세,2016,6897,3494,3403,102.7,6862,3479,3383,102.8
36003, 동부,070003, 67세,2016,6796,3321,3475,95.6,6765,3303,3462,95.4
36003, 동부,070004, 68세,2016,6365,3092,3273,94.5,6343,3082,3261,94.5
36003, 동부,070005, 69세,2016,6705,3200,3505,91.3,6686,3192,3494,91.4
36003, 동부,075,70~74세,2016,24714,11243,13471,83.5,24658,11216,13442,83.4
36003, 동부,075001, 70세,2016,5014,2387,2627,90.9,4996,2378,2618,90.8
36003, 동부,075002, 71세,2016,4779,2226,2553,87.2,4768,2221,2547,87.2
36003, 동부,075003, 72세,2016,4396,2003,2393,83.7,4386,1996,2390,83.5
36003, 동부,075004, 73세,2016,4807,2160,2647,81.6,4795,2156,2639,81.7
36003, 동부,075005, 74세,2016,5718,2467,3251,75.9,5713,2465,3248,75.9
36003, 동부,080,75~79세,2016,19131,7656,11475,66.7,19091,7634,11457,66.6
36003, 동부,080001, 75세,2016,4429,1854,2575,72,4419,1850,2569,72
36003, 동부,080002, 76세,2016,4184,1734,2450,70.8,4177,1730,2447,70.7
36003, 동부,080003, 77세,2016,3790,1522,2268,67.1,3781,1517,2264,67
36003, 동부,080004, 78세,2016,3552,1328,2224,59.7,3546,1324,2222,59.6
36003, 동부,080005, 79세,2016,3176,1218,1958,62.2,3168,1213,1955,62
36003, 동부,085,80~84세,2016,11211,3617,7594,47.6,11195,3609,7586,47.6
36003, 동부,085001, 80세,2016,2670,940,1730,54.3,2665,938,1727,54.3
36003, 동부,085002, 81세,2016,2507,877,1630,53.8,2502,873,1629,53.6
36003, 동부,085003, 82세,2016,2316,725,1591,45.6,2315,724,1591,45.5
36003, 동부,085004, 83세,2016,1948,586,1362,43,1945,585,1360,43
36003, 동부,085005, 84세,2016,1770,489,1281,38.2,1768,489,1279,38.2
36003, 동부,090,85~89세,2016,5628,1385,4243,32.6,5623,1383,4240,32.6
36003, 동부,090001, 85세,2016,1493,398,1095,36.3,1493,398,1095,36.3
36003, 동부,090002, 86세,2016,1529,335,1194,28.1,1527,334,1193,28
36003, 동부,090003, 87세,2016,1067,282,785,35.9,1065,282,783,36
36003, 동부,090004, 88세,2016,832,202,630,32.1,832,202,630,32.1
36003, 동부,090005, 89세,2016,707,168,539,31.2,706,167,539,31
36003, 동부,095,90~94세,2016,1653,317,1336,23.7,1648,315,1333,23.6
36003, 동부,095001, 90세,2016,465,101,364,27.7,463,100,363,27.5
36003, 동부,095002, 91세,2016,390,83,307,27,389,82,307,26.7
36003, 동부,095003, 92세,2016,272,52,220,23.6,272,52,220,23.6
36003, 동부,095004, 93세,2016,320,38,282,13.5,318,38,280,13.6
36003, 동부,095005, 94세,2016,206,43,163,26.4,206,43,163,26.4
36003, 동부,100,95~99세,2016,363,50,313,16,361,50,311,16.1
36003, 동부,100001, 95세,2016,143,19,124,15.3,142,19,123,15.4
36003, 동부,100002, 96세,2016,112,15,97,15.5,112,15,97,15.5
36003, 동부,100003, 97세,2016,47,10,37,27,46,10,36,27.8
36003, 동부,100004, 98세,2016,39,X,36,8.3,39,X,36,8.3
36003, 동부,100005, 99세,2016,22,X,19,15.8,22,X,19,15.8
36003, 동부,101,100세이상,2016,32,X,31,3.2,32,X,31,3.2
36003, 동부,102,15세미만,2016,119868,61537,58331,105.5,119654,61433,58221,105.5
36003, 동부,103,15~64세,2016,570571,296201,274370,108,561246,291075,270171,107.7
36003, 동부,104,65세이상,2016,96531,40968,55563,73.7,96259,40836,55423,73.7
36003, 동부,086,85세이상,2016,7676,1753,5923,29.6,7664,1749,5915,29.6
36003, 동부,126,평균연령,2016,39.8,38.6,41,,39.8,38.6,41,
36003, 동부,127,중위연령,2016,41.2,39.8,42.5,,41.3,40,42.6,
36010, 목포시,000,합계,2016,237484,119424,118060,101.2,234221,117588,116633,100.8
36010, 목포시,005,0~4세,2016,10835,5563,5272,105.5,10801,5547,5254,105.6
36010, 목포시,005001, 0세,2016,1891,972,919,105.8,1881,966,915,105.6
36010, 목포시,005002, 1세,2016,1968,1065,903,117.9,1964,1063,901,118
36010, 목포시,005003, 2세,2016,2102,1067,1035,103.1,2095,1064,1031,103.2
36010, 목포시,005004, 3세,2016,2264,1144,1120,102.1,2257,1141,1116,102.2
36010, 목포시,005005, 4세,2016,2610,1315,1295,101.5,2604,1313,1291,101.7
36010, 목포시,010,5~9세,2016,12778,6577,6201,106.1,12748,6560,6188,106
36010, 목포시,010001, 5세,2016,2633,1317,1316,100.1,2625,1313,1312,100.1
36010, 목포시,010002, 6세,2016,2590,1357,1233,110.1,2588,1356,1232,110.1
36010, 목포시,010003, 7세,2016,2466,1267,1199,105.7,2459,1262,1197,105.4
36010, 목포시,010004, 8세,2016,2484,1273,1211,105.1,2474,1269,1205,105.3
36010, 목포시,010005, 9세,2016,2605,1363,1242,109.7,2602,1360,1242,109.5
36010, 목포시,015,10~14세,2016,12587,6429,6158,104.4,12578,6423,6155,104.4
36010, 목포시,015001, 10세,2016,2351,1184,1167,101.5,2350,1184,1166,101.5
36010, 목포시,015002, 11세,2016,2297,1171,1126,104,2296,1170,1126,103.9
36010, 목포시,015003, 12세,2016,2546,1297,1249,103.8,2542,1294,1248,103.7
36010, 목포시,015004, 13세,2016,2655,1370,1285,106.6,2654,1370,1284,106.7
36010, 목포시,015005, 14세,2016,2738,1407,1331,105.7,2736,1405,1331,105.6
36010, 목포시,020,15~19세,2016,15842,8479,7363,115.2,15820,8467,7353,115.2
36010, 목포시,020001, 15세,2016,3062,1600,1462,109.4,3061,1599,1462,109.4
36010, 목포시,020002, 16세,2016,3254,1695,1559,108.7,3251,1693,1558,108.7
36010, 목포시,020003, 17세,2016,3283,1727,1556,111,3282,1726,1556,110.9
36010, 목포시,020004, 18세,2016,3282,1771,1511,117.2,3278,1769,1509,117.2
36010, 목포시,020005, 19세,2016,2961,1686,1275,132.2,2948,1680,1268,132.5
36010, 목포시,025,20~24세,2016,15582,8788,6794,129.3,15220,8614,6606,130.4
36010, 목포시,025001, 20세,2016,3384,2018,1366,147.7,3362,2008,1354,148.3
36010, 목포시,025002, 21세,2016,3378,2004,1374,145.9,3327,1982,1345,147.4
36010, 목포시,025003, 22세,2016,3206,1834,1372,133.7,3124,1795,1329,135.1
36010, 목포시,025004, 23세,2016,2795,1471,1324,111.1,2705,1428,1277,111.8
36010, 목포시,025005, 24세,2016,2819,1461,1358,107.6,2702,1401,1301,107.7
36010, 목포시,030,25~29세,2016,11722,6027,5695,105.8,11078,5656,5422,104.3
36010, 목포시,030001, 25세,2016,2495,1307,1188,110,2367,1237,1130,109.5
36010, 목포시,030002, 26세,2016,2396,1231,1165,105.7,2244,1145,1099,104.2
36010, 목포시,030003, 27세,2016,2258,1149,1109,103.6,2125,1077,1048,102.8
36010, 목포시,030004, 28세,2016,2198,1136,1062,107,2088,1069,1019,104.9
36010, 목포시,030005, 29세,2016,2375,1204,1171,102.8,2254,1128,1126,100.2
36010, 목포시,035,30~34세,2016,15401,8047,7354,109.4,14907,7750,7157,108.3
36010, 목포시,035001, 30세,2016,2467,1286,1181,108.9,2354,1217,1137,107
36010, 목포시,035002, 31세,2016,2699,1384,1315,105.2,2599,1327,1272,104.3
36010, 목포시,035003, 32세,2016,3026,1579,1447,109.1,2928,1518,1410,107.7
36010, 목포시,035004, 33세,2016,3408,1757,1651,106.4,3318,1704,1614,105.6
36010, 목포시,035005, 34세,2016,3801,2041,1760,116,3708,1984,1724,115.1
36010, 목포시,040,35~39세,2016,18810,9829,8981,109.4,18429,9572,8857,108.1
36010, 목포시,040001, 35세,2016,3704,2004,1700,117.9,3618,1940,1678,115.6
36010, 목포시,040002, 36세,2016,3971,2044,1927,106.1,3905,2007,1898,105.7
36010, 목포시,040003, 37세,2016,3902,2037,1865,109.2,3814,1976,1838,107.5
36010, 목포시,040004, 38세,2016,3557,1873,1684,111.2,3481,1827,1654,110.5
36010, 목포시,040005, 39세,2016,3676,1871,1805,103.7,3611,1822,1789,101.8
36010, 목포시,045,40~44세,2016,20040,10453,9587,109,19686,10217,9469,107.9
36010, 목포시,045001, 40세,2016,3663,1956,1707,114.6,3582,1899,1683,112.8
36010, 목포시,045002, 41세,2016,3849,2018,1831,110.2,3782,1977,1805,109.5
36010, 목포시,045003, 42세,2016,4041,2090,1951,107.1,3989,2057,1932,106.5
36010, 목포시,045004, 43세,2016,4223,2161,2062,104.8,4148,2106,2042,103.1
36010, 목포시,045005, 44세,2016,4264,2228,2036,109.4,4185,2178,2007,108.5
36010, 목포시,050,45~49세,2016,20297,10504,9793,107.3,19974,10333,9641,107.2
36010, 목포시,050001, 45세,2016,4369,2296,2073,110.8,4288,2250,2038,110.4
36010, 목포시,050002, 46세,2016,4146,2131,2015,105.8,4063,2080,1983,104.9
36010, 목포시,050003, 47세,2016,4089,2115,1974,107.1,4023,2085,1938,107.6
36010, 목포시,050004, 48세,2016,3957,2053,1904,107.8,3913,2028,1885,107.6
36010, 목포시,050005, 49세,2016,3736,1909,1827,104.5,3687,1890,1797,105.2
36010, 목포시,055,50~54세,2016,18621,9353,9268,100.9,18378,9244,9134,101.2
36010, 목포시,055001, 50세,2016,3823,2020,1803,112,3772,1999,1773,112.7
36010, 목포시,055002, 51세,2016,3852,1974,1878,105.1,3809,1955,1854,105.4
36010, 목포시,055003, 52세,2016,3510,1694,1816,93.3,3453,1669,1784,93.6
36010, 목포시,055004, 53세,2016,3812,1852,1960,94.5,3762,1830,1932,94.7
36010, 목포시,055005, 54세,2016,3624,1813,1811,100.1,3582,1791,1791,100
36010, 목포시,060,55~59세,2016,19013,9316,9697,96.1,18844,9234,9610,96.1
36010, 목포시,060001, 55세,2016,4065,1964,2101,93.5,4029,1947,2082,93.5
36010, 목포시,060002, 56세,2016,4192,1988,2204,90.2,4144,1966,2178,90.3
36010, 목포시,060003, 57세,2016,3848,1879,1969,95.4,3817,1862,1955,95.2
36010, 목포시,060004, 58세,2016,3474,1744,1730,100.8,3449,1734,1715,101.1
36010, 목포시,060005, 59세,2016,3434,1741,1693,102.8,3405,1725,1680,102.7
36010, 목포시,065,60~64세,2016,13475,6556,6919,94.8,13373,6507,6866,94.8
36010, 목포시,065001, 60세,2016,3020,1463,1557,94,3004,1455,1549,93.9
36010, 목포시,065002, 61세,2016,3136,1496,1640,91.2,3105,1480,1625,91.1
36010, 목포시,065003, 62세,2016,2434,1234,1200,102.8,2416,1226,1190,103
36010, 목포시,065004, 63세,2016,2280,1135,1145,99.1,2259,1122,1137,98.7
36010, 목포시,065005, 64세,2016,2605,1228,1377,89.2,2589,1224,1365,89.7
36010, 목포시,070,65~69세,2016,10973,5211,5762,90.4,10914,5187,5727,90.6
36010, 목포시,070001, 65세,2016,2319,1104,1215,90.9,2303,1096,1207,90.8
36010, 목포시,070002, 66세,2016,2161,1054,1107,95.2,2149,1051,1098,95.7
36010, 목포시,070003, 67세,2016,2245,1030,1215,84.8,2232,1026,1206,85.1
36010, 목포시,070004, 68세,2016,2036,974,1062,91.7,2027,968,1059,91.4
36010, 목포시,070005, 69세,2016,2212,1049,1163,90.2,2203,1046,1157,90.4
36010, 목포시,075,70~74세,2016,8856,3976,4880,81.5,8841,3970,4871,81.5
36010, 목포시,075001, 70세,2016,1903,872,1031,84.6,1895,870,1025,84.9
36010, 목포시,075002, 71세,2016,1795,833,962,86.6,1792,832,960,86.7
36010, 목포시,075003, 72세,2016,1555,679,876,77.5,1552,677,875,77.4
36010, 목포시,075004, 73세,2016,1540,701,839,83.6,1539,700,839,83.4
36010, 목포시,075005, 74세,2016,2063,891,1172,76,2063,891,1172,76
36010, 목포시,080,75~79세,2016,6676,2618,4058,64.5,6660,2610,4050,64.4
36010, 목포시,080001, 75세,2016,1555,641,914,70.1,1550,640,910,70.3
36010, 목포시,080002, 76세,2016,1467,590,877,67.3,1466,590,876,67.4
36010, 목포시,080003, 77세,2016,1263,513,750,68.4,1256,508,748,67.9
36010, 목포시,080004, 78세,2016,1292,456,836,54.5,1290,455,835,54.5
36010, 목포시,080005, 79세,2016,1099,418,681,61.4,1098,417,681,61.2
36010, 목포시,085,80~84세,2016,3593,1135,2458,46.2,3589,1134,2455,46.2
36010, 목포시,085001, 80세,2016,858,291,567,51.3,857,291,566,51.4
36010, 목포시,085002, 81세,2016,808,268,540,49.6,807,268,539,49.7
36010, 목포시,085003, 82세,2016,757,239,518,46.1,756,238,518,45.9
36010, 목포시,085004, 83세,2016,616,182,434,41.9,616,182,434,41.9
36010, 목포시,085005, 84세,2016,554,155,399,38.8,553,155,398,38.9
36010, 목포시,090,85~89세,2016,1742,443,1299,34.1,1741,443,1298,34.1
36010, 목포시,090001, 85세,2016,449,124,325,38.2,449,124,325,38.2
36010, 목포시,090002, 86세,2016,481,108,373,29,481,108,373,29
36010, 목포시,090003, 87세,2016,330,89,241,36.9,329,89,240,37.1
36010, 목포시,090004, 88세,2016,261,66,195,33.8,261,66,195,33.8
36010, 목포시,090005, 89세,2016,221,56,165,33.9,221,56,165,33.9
36010, 목포시,095,90~94세,2016,526,100,426,23.5,525,100,425,23.5
36010, 목포시,095001, 90세,2016,147,39,108,36.1,146,39,107,36.4
36010, 목포시,095002, 91세,2016,119,28,91,30.8,119,28,91,30.8
36010, 목포시,095003, 92세,2016,95,10,85,11.8,95,10,85,11.8
36010, 목포시,095004, 93세,2016,109,8,101,7.9,109,8,101,7.9
36010, 목포시,095005, 94세,2016,56,15,41,36.6,56,15,41,36.6
36010, 목포시,100,95~99세,2016,103,20,83,24.1,103,20,83,24.1
36010, 목포시,100001, 95세,2016,40,8,32,25,40,8,32,25
36010, 목포시,100002, 96세,2016,36,7,29,24.1,36,7,29,24.1
36010, 목포시,100003, 97세,2016,9,X,6,50,9,X,6,50
36010, 목포시,100004, 98세,2016,12,X,11,9.1,12,X,11,9.1
36010, 목포시,100005, 99세,2016,6,X,5,20,6,X,5,20
36010, 목포시,101,100세이상,2016,12,X,12,0,12,X,12,0
36010, 목포시,102,15세미만,2016,36200,18569,17631,105.3,36127,18530,17597,105.3
36010, 목포시,103,15~64세,2016,168803,87352,81451,107.2,165709,85594,80115,106.8
36010, 목포시,104,65세이상,2016,32481,13503,18978,71.2,32385,13464,18921,71.2
36010, 목포시,086,85세이상,2016,2383,563,1820,30.9,2381,563,1818,31
36010, 목포시,126,평균연령,2016,40.3,38.9,41.7,,40.3,39,41.7,
36010, 목포시,127,중위연령,2016,41.4,40,42.9,,41.5,40.1,43,
36020, 여수시,000,합계,2016,273925,140153,133772,104.8,269252,136960,132292,103.5
36020, 여수시,005,0~4세,2016,12018,6086,5932,102.6,12003,6080,5923,102.7
36020, 여수시,005001, 0세,2016,2327,1193,1134,105.2,2322,1190,1132,105.1
36020, 여수시,005002, 1세,2016,2401,1191,1210,98.4,2399,1191,1208,98.6
36020, 여수시,005003, 2세,2016,2322,1212,1110,109.2,2319,1212,1107,109.5
36020, 여수시,005004, 3세,2016,2412,1267,1145,110.7,2411,1267,1144,110.8
36020, 여수시,005005, 4세,2016,2556,1223,1333,91.7,2552,1220,1332,91.6
36020, 여수시,010,5~9세,2016,12353,6266,6087,102.9,12333,6258,6075,103
36020, 여수시,010001, 5세,2016,2716,1364,1352,100.9,2710,1364,1346,101.3
36020, 여수시,010002, 6세,2016,2339,1211,1128,107.4,2335,1209,1126,107.4
36020, 여수시,010003, 7세,2016,2295,1176,1119,105.1,2291,1173,1118,104.9
36020, 여수시,010004, 8세,2016,2460,1246,1214,102.6,2458,1245,1213,102.6
36020, 여수시,010005, 9세,2016,2543,1269,1274,99.6,2539,1267,1272,99.6
36020, 여수시,015,10~14세,2016,12951,6731,6220,108.2,12933,6725,6208,108.3
36020, 여수시,015001, 10세,2016,2349,1232,1117,110.3,2346,1232,1114,110.6
36020, 여수시,015002, 11세,2016,2337,1203,1134,106.1,2335,1203,1132,106.3
36020, 여수시,015003, 12세,2016,2709,1442,1267,113.8,2702,1439,1263,113.9
36020, 여수시,015004, 13세,2016,2669,1377,1292,106.6,2666,1376,1290,106.7
36020, 여수시,015005, 14세,2016,2887,1477,1410,104.8,2884,1475,1409,104.7
36020, 여수시,020,15~19세,2016,16354,9001,7353,122.4,16324,8984,7340,122.4
36020, 여수시,020001, 15세,2016,3287,1805,1482,121.8,3285,1803,1482,121.7
36020, 여수시,020002, 16세,2016,3520,1888,1632,115.7,3519,1888,1631,115.8
36020, 여수시,020003, 17세,2016,3527,1853,1674,110.7,3521,1848,1673,110.5
36020, 여수시,020004, 18세,2016,3303,1754,1549,113.2,3297,1751,1546,113.3
36020, 여수시,020005, 19세,2016,2717,1701,1016,167.4,2702,1694,1008,168.1
36020, 여수시,025,20~24세,2016,15608,9391,6217,151.1,15062,9029,6033,149.7
36020, 여수시,025001, 20세,2016,3104,2036,1068,190.6,3070,2015,1055,191
36020, 여수시,025002, 21세,2016,3121,2032,1089,186.6,3051,1992,1059,188.1
36020, 여수시,025003, 22세,2016,2959,1770,1189,148.9,2859,1702,1157,147.1
36020, 여수시,025004, 23세,2016,3125,1771,1354,130.8,2977,1677,1300,129
36020, 여수시,025005, 24세,2016,3299,1782,1517,117.5,3105,1643,1462,112.4
36020, 여수시,030,25~29세,2016,14436,8116,6320,128.4,13451,7408,6043,122.6
36020, 여수시,030001, 25세,2016,2982,1633,1349,121.1,2796,1502,1294,116.1
36020, 여수시,030002, 26세,2016,2982,1667,1315,126.8,2763,1517,1246,121.7
36020, 여수시,030003, 27세,2016,2836,1627,1209,134.6,2640,1485,1155,128.6
36020, 여수시,030004, 28세,2016,2785,1580,1205,131.1,2600,1441,1159,124.3
36020, 여수시,030005, 29세,2016,2851,1609,1242,129.5,2652,1463,1189,123
36020, 여수시,035,30~34세,2016,16982,9254,7728,119.7,16113,8619,7494,115
36020, 여수시,035001, 30세,2016,3002,1678,1324,126.7,2810,1539,1271,121.1
36020, 여수시,035002, 31세,2016,3035,1694,1341,126.3,2842,1551,1291,120.1
36020, 여수시,035003, 32세,2016,3222,1740,1482,117.4,3072,1627,1445,112.6
36020, 여수시,035004, 33세,2016,3671,1952,1719,113.6,3491,1820,1671,108.9
36020, 여수시,035005, 34세,2016,4052,2190,1862,117.6,3898,2082,1816,114.6
36020, 여수시,040,35~39세,2016,19240,10199,9041,112.8,18576,9684,8892,108.9
36020, 여수시,040001, 35세,2016,3859,2104,1755,119.9,3718,1990,1728,115.2
36020, 여수시,040002, 36세,2016,4006,2131,1875,113.7,3868,2023,1845,109.6
36020, 여수시,040003, 37세,2016,3959,2067,1892,109.2,3808,1950,1858,105
36020, 여수시,040004, 38세,2016,3667,1919,1748,109.8,3551,1835,1716,106.9
36020, 여수시,040005, 39세,2016,3749,1978,1771,111.7,3631,1886,1745,108.1
36020, 여수시,045,40~44세,2016,20922,11095,9827,112.9,20346,10650,9696,109.8
36020, 여수시,045001, 40세,2016,3771,2042,1729,118.1,3660,1962,1698,115.5
36020, 여수시,045002, 41세,2016,3814,2014,1800,111.9,3692,1918,1774,108.1
36020, 여수시,045003, 42세,2016,4323,2252,2071,108.7,4197,2149,2048,104.9
36020, 여수시,045004, 43세,2016,4490,2359,2131,110.7,4392,2286,2106,108.5
36020, 여수시,045005, 44세,2016,4524,2428,2096,115.8,4405,2335,2070,112.8
36020, 여수시,050,45~49세,2016,23514,12250,11264,108.8,23122,12003,11119,108
36020, 여수시,050001, 45세,2016,4886,2557,2329,109.8,4782,2481,2301,107.8
36020, 여수시,050002, 46세,2016,4638,2464,2174,113.3,4541,2399,2142,112
36020, 여수시,050003, 47세,2016,4613,2458,2155,114.1,4534,2414,2120,113.9
36020, 여수시,050004, 48세,2016,4880,2496,2384,104.7,4819,2458,2361,104.1
36020, 여수시,050005, 49세,2016,4497,2275,2222,102.4,4446,2251,2195,102.6
36020, 여수시,055,50~54세,2016,23049,12041,11008,109.4,22801,11933,10868,109.8
36020, 여수시,055001, 50세,2016,4613,2433,2180,111.6,4561,2406,2155,111.6
36020, 여수시,055002, 51세,2016,4573,2400,2173,110.4,4515,2375,2140,111
36020, 여수시,055003, 52세,2016,4315,2242,2073,108.2,4265,2227,2038,109.3
36020, 여수시,055004, 53세,2016,4984,2592,2392,108.4,4929,2562,2367,108.2
36020, 여수시,055005, 54세,2016,4564,2374,2190,108.4,4531,2363,2168,109
36020, 여수시,060,55~59세,2016,23710,11719,11991,97.7,23567,11659,11908,97.9
36020, 여수시,060001, 55세,2016,4975,2410,2565,94,4938,2395,2543,94.2
36020, 여수시,060002, 56세,2016,5294,2602,2692,96.7,5268,2590,2678,96.7
36020, 여수시,060003, 57세,2016,4775,2353,2422,97.2,4752,2346,2406,97.5
36020, 여수시,060004, 58세,2016,4298,2158,2140,100.8,4269,2145,2124,101
36020, 여수시,060005, 59세,2016,4368,2196,2172,101.1,4340,2183,2157,101.2
36020, 여수시,065,60~64세,2016,18101,9037,9064,99.7,18013,9001,9012,99.9
36020, 여수시,065001, 60세,2016,3739,1865,1874,99.5,3716,1861,1855,100.3
36020, 여수시,065002, 61세,2016,4228,2140,2088,102.5,4208,2130,2078,102.5
36020, 여수시,065003, 62세,2016,3638,1827,1811,100.9,3620,1816,1804,100.7
36020, 여수시,065004, 63세,2016,2867,1402,1465,95.7,2853,1394,1459,95.5
36020, 여수시,065005, 64세,2016,3629,1803,1826,98.7,3616,1800,1816,99.1
36020, 여수시,070,65~69세,2016,15178,7557,7621,99.2,15137,7537,7600,99.2
36020, 여수시,070001, 65세,2016,3110,1625,1485,109.4,3097,1620,1477,109.7
36020, 여수시,070002, 66세,2016,3100,1559,1541,101.2,3091,1554,1537,101.1
36020, 여수시,070003, 67세,2016,2992,1511,1481,102,2984,1505,1479,101.8
36020, 여수시,070004, 68세,2016,2893,1402,1491,94,2888,1401,1487,94.2
36020, 여수시,070005, 69세,2016,3083,1460,1623,90,3077,1457,1620,89.9
36020, 여수시,075,70~74세,2016,11083,5061,6022,84,11066,5051,6015,84
36020, 여수시,075001, 70세,2016,2182,1076,1106,97.3,2178,1074,1104,97.3
36020, 여수시,075002, 71세,2016,2039,932,1107,84.2,2036,930,1106,84.1
36020, 여수시,075003, 72세,2016,2002,942,1060,88.9,1998,940,1058,88.8
36020, 여수시,075004, 73세,2016,2290,1014,1276,79.5,2286,1011,1275,79.3
36020, 여수시,075005, 74세,2016,2570,1097,1473,74.5,2568,1096,1472,74.5
36020, 여수시,080,75~79세,2016,9062,3708,5354,69.3,9053,3703,5350,69.2
36020, 여수시,080001, 75세,2016,2089,882,1207,73.1,2088,881,1207,73
36020, 여수시,080002, 76세,2016,2028,836,1192,70.1,2026,835,1191,70.1
36020, 여수시,080003, 77세,2016,1842,767,1075,71.3,1839,766,1073,71.4
36020, 여수시,080004, 78세,2016,1620,631,989,63.8,1619,630,989,63.7
36020, 여수시,080005, 79세,2016,1483,592,891,66.4,1481,591,890,66.4
36020, 여수시,085,80~84세,2016,5476,1811,3665,49.4,5470,1808,3662,49.4
36020, 여수시,085001, 80세,2016,1268,457,811,56.4,1263,454,809,56.1
36020, 여수시,085002, 81세,2016,1203,432,771,56,1203,432,771,56
36020, 여수시,085003, 82세,2016,1093,358,735,48.7,1093,358,735,48.7
36020, 여수시,085004, 83세,2016,982,303,679,44.6,981,303,678,44.7
36020, 여수시,085005, 84세,2016,930,261,669,39,930,261,669,39
36020, 여수시,090,85~89세,2016,2821,654,2167,30.2,2818,653,2165,30.2
36020, 여수시,090001, 85세,2016,771,194,577,33.6,770,194,576,33.7
36020, 여수시,090002, 86세,2016,767,176,591,29.8,765,175,590,29.7
36020, 여수시,090003, 87세,2016,517,123,394,31.2,517,123,394,31.2
36020, 여수시,090004, 88세,2016,428,93,335,27.8,428,93,335,27.8
36020, 여수시,090005, 89세,2016,338,68,270,25.2,338,68,270,25.2
36020, 여수시,095,90~94세,2016,858,149,709,21,856,148,708,20.9
36020, 여수시,095001, 90세,2016,232,37,195,19,232,37,195,19
36020, 여수시,095002, 91세,2016,203,41,162,25.3,201,40,161,24.8
36020, 여수시,095003, 92세,2016,122,31,91,34.1,122,31,91,34.1
36020, 여수시,095004, 93세,2016,196,28,168,16.7,196,28,168,16.7
36020, 여수시,095005, 94세,2016,105,12,93,12.9,105,12,93,12.9
36020, 여수시,100,95~99세,2016,189,25,164,15.2,188,25,163,15.3
36020, 여수시,100001, 95세,2016,74,11,63,17.5,73,11,62,17.7
36020, 여수시,100002, 96세,2016,50,8,42,19,50,8,42,19
36020, 여수시,100003, 97세,2016,30,X,26,15.4,30,X,26,15.4
36020, 여수시,100004, 98세,2016,20,X,20,0,20,X,20,0
36020, 여수시,100005, 99세,2016,15,X,13,15.4,15,X,13,15.4
36020, 여수시,101,100세이상,2016,20,X,18,11.1,20,X,18,11.1
36020, 여수시,102,15세미만,2016,37322,19083,18239,104.6,37269,19063,18206,104.7
36020, 여수시,103,15~64세,2016,191916,102103,89813,113.7,187375,98970,88405,112
36020, 여수시,104,65세이상,2016,44687,18967,25720,73.7,44608,18927,25681,73.7
36020, 여수시,086,85세이상,2016,3888,830,3058,27.1,3882,828,3054,27.1
36020, 여수시,126,평균연령,2016,42.5,40.9,44.1,,42.6,41,44.2,
36020, 여수시,127,중위연령,2016,44.1,42.4,45.9,,44.4,42.8,46.1,
36030, 순천시,000,합계,2016,266519,132865,133654,99.4,264441,131966,132475,99.6
36030, 순천시,005,0~4세,2016,11869,6071,5798,104.7,11848,6058,5790,104.6
36030, 순천시,005001, 0세,2016,2056,1016,1040,97.7,2050,1014,1036,97.9
36030, 순천시,005002, 1세,2016,2301,1231,1070,115,2298,1231,1067,115.4
36030, 순천시,005003, 2세,2016,2355,1205,1150,104.8,2349,1200,1149,104.4
36030, 순천시,005004, 3세,2016,2458,1241,1217,102,2455,1238,1217,101.7
36030, 순천시,005005, 4세,2016,2699,1378,1321,104.3,2696,1375,1321,104.1
36030, 순천시,010,5~9세,2016,13578,7068,6510,108.6,13559,7055,6504,108.5
36030, 순천시,010001, 5세,2016,2717,1398,1319,106,2712,1393,1319,105.6
36030, 순천시,010002, 6세,2016,2621,1415,1206,117.3,2618,1414,1204,117.4
36030, 순천시,010003, 7세,2016,2646,1346,1300,103.5,2643,1345,1298,103.6
36030, 순천시,010004, 8세,2016,2742,1434,1308,109.6,2736,1429,1307,109.3
36030, 순천시,010005, 9세,2016,2852,1475,1377,107.1,2850,1474,1376,107.1
36030, 순천시,015,10~14세,2016,14492,7542,6950,108.5,14481,7539,6942,108.6
36030, 순천시,015001, 10세,2016,2671,1358,1313,103.4,2666,1358,1308,103.8
36030, 순천시,015002, 11세,2016,2624,1381,1243,111.1,2623,1381,1242,111.2
36030, 순천시,015003, 12세,2016,2993,1525,1468,103.9,2992,1524,1468,103.8
36030, 순천시,015004, 13세,2016,3042,1581,1461,108.2,3041,1581,1460,108.3
36030, 순천시,015005, 14세,2016,3162,1697,1465,115.8,3159,1695,1464,115.8
36030, 순천시,020,15~19세,2016,19331,10287,9044,113.7,19282,10262,9020,113.8
36030, 순천시,020001, 15세,2016,3729,2049,1680,122,3727,2048,1679,122
36030, 순천시,020002, 16세,2016,3965,2085,1880,110.9,3957,2079,1878,110.7
36030, 순천시,020003, 17세,2016,3890,2023,1867,108.4,3885,2018,1867,108.1
36030, 순천시,020004, 18세,2016,3950,2069,1881,110,3939,2063,1876,110
36030, 순천시,020005, 19세,2016,3797,2061,1736,118.7,3774,2054,1720,119.4
36030, 순천시,025,20~24세,2016,18697,10337,8360,123.6,18414,10234,8180,125.1
36030, 순천시,025001, 20세,2016,3867,2213,1654,133.8,3826,2198,1628,135
36030, 순천시,025002, 21세,2016,4088,2313,1775,130.3,4042,2296,1746,131.5
36030, 순천시,025003, 22세,2016,3821,2134,1687,126.5,3764,2115,1649,128.3
36030, 순천시,025004, 23세,2016,3577,1945,1632,119.2,3505,1918,1587,120.9
36030, 순천시,025005, 24세,2016,3344,1732,1612,107.4,3277,1707,1570,108.7
36030, 순천시,030,25~29세,2016,13808,7299,6509,112.1,13347,7092,6255,113.4
36030, 순천시,030001, 25세,2016,3103,1692,1411,119.9,3016,1653,1363,121.3
36030, 순천시,030002, 26세,2016,2876,1537,1339,114.8,2776,1489,1287,115.7
36030, 순천시,030003, 27세,2016,2710,1444,1266,114.1,2610,1404,1206,116.4
36030, 순천시,030004, 28세,2016,2553,1332,1221,109.1,2463,1288,1175,109.6
36030, 순천시,030005, 29세,2016,2566,1294,1272,101.7,2482,1258,1224,102.8
36030, 순천시,035,30~34세,2016,15673,7858,7815,100.6,15382,7743,7639,101.4
36030, 순천시,035001, 30세,2016,2656,1320,1336,98.8,2584,1294,1290,100.3
36030, 순천시,035002, 31세,2016,2767,1404,1363,103,2705,1380,1325,104.2
36030, 순천시,035003, 32세,2016,3161,1570,1591,98.7,3111,1548,1563,99
36030, 순천시,035004, 33세,2016,3373,1704,1669,102.1,3326,1687,1639,102.9
36030, 순천시,035005, 34세,2016,3716,1860,1856,100.2,3656,1834,1822,100.7
36030, 순천시,040,35~39세,2016,18294,8996,9298,96.8,18104,8902,9202,96.7
36030, 순천시,040001, 35세,2016,3470,1714,1756,97.6,3426,1696,1730,98
36030, 순천시,040002, 36세,2016,3897,1954,1943,100.6,3854,1928,1926,100.1
36030, 순천시,040003, 37세,2016,3714,1854,1860,99.7,3677,1831,1846,99.2
36030, 순천시,040004, 38세,2016,3480,1694,1786,94.8,3444,1679,1765,95.1
36030, 순천시,040005, 39세,2016,3733,1780,1953,91.1,3703,1768,1935,91.4
36030, 순천시,045,40~44세,2016,21390,10382,11008,94.3,21217,10301,10916,94.4
36030, 순천시,045001, 40세,2016,3739,1767,1972,89.6,3701,1752,1949,89.9
36030, 순천시,045002, 41세,2016,3943,1886,2057,91.7,3917,1870,2047,91.4
36030, 순천시,045003, 42세,2016,4474,2220,2254,98.5,4436,2200,2236,98.4
36030, 순천시,045004, 43세,2016,4636,2226,2410,92.4,4604,2211,2393,92.4
36030, 순천시,045005, 44세,2016,4598,2283,2315,98.6,4559,2268,2291,99
36030, 순천시,050,45~49세,2016,24677,12260,12417,98.7,24509,12191,12318,99
36030, 순천시,050001, 45세,2016,4943,2479,2464,100.6,4906,2465,2441,101
36030, 순천시,050002, 46세,2016,4788,2382,2406,99,4765,2368,2397,98.8
36030, 순천시,050003, 47세,2016,4922,2396,2526,94.9,4876,2376,2500,95
36030, 순천시,050004, 48세,2016,5365,2650,2715,97.6,5334,2638,2696,97.8
36030, 순천시,050005, 49세,2016,4659,2353,2306,102,4628,2344,2284,102.6
36030, 순천시,055,50~54세,2016,22824,11685,11139,104.9,22674,11633,11041,105.4
36030, 순천시,055001, 50세,2016,4703,2404,2299,104.6,4675,2398,2277,105.3
36030, 순천시,055002, 51세,2016,4749,2344,2405,97.5,4711,2331,2380,97.9
36030, 순천시,055003, 52세,2016,4352,2221,2131,104.2,4321,2210,2111,104.7
36030, 순천시,055004, 53세,2016,4647,2417,2230,108.4,4619,2408,2211,108.9
36030, 순천시,055005, 54세,2016,4373,2299,2074,110.8,4348,2286,2062,110.9
36030, 순천시,060,55~59세,2016,21422,10799,10623,101.7,21288,10745,10543,101.9
36030, 순천시,060001, 55세,2016,4744,2385,2359,101.1,4720,2376,2344,101.4
36030, 순천시,060002, 56세,2016,4993,2528,2465,102.6,4957,2514,2443,102.9
36030, 순천시,060003, 57세,2016,4309,2103,2206,95.3,4281,2090,2191,95.4
36030, 순천시,060004, 58세,2016,3792,1992,1800,110.7,3764,1983,1781,111.3
36030, 순천시,060005, 59세,2016,3584,1791,1793,99.9,3566,1782,1784,99.9
36030, 순천시,065,60~64세,2016,14046,7110,6936,102.5,13984,7078,6906,102.5
36030, 순천시,065001, 60세,2016,3065,1546,1519,101.8,3050,1538,1512,101.7
36030, 순천시,065002, 61세,2016,3264,1696,1568,108.2,3246,1688,1558,108.3
36030, 순천시,065003, 62세,2016,2803,1384,1419,97.5,2796,1380,1416,97.5
36030, 순천시,065004, 63세,2016,2273,1169,1104,105.9,2264,1166,1098,106.2
36030, 순천시,065005, 64세,2016,2641,1315,1326,99.2,2628,1306,1322,98.8
36030, 순천시,070,65~69세,2016,11255,5586,5669,98.5,11221,5567,5654,98.5
36030, 순천시,070001, 65세,2016,2228,1139,1089,104.6,2223,1136,1087,104.5
36030, 순천시,070002, 66세,2016,2351,1202,1149,104.6,2338,1196,1142,104.7
36030, 순천시,070003, 67세,2016,2284,1130,1154,97.9,2277,1125,1152,97.7
36030, 순천시,070004, 68세,2016,2146,1052,1094,96.2,2140,1049,1091,96.2
36030, 순천시,070005, 69세,2016,2246,1063,1183,89.9,2243,1061,1182,89.8
36030, 순천시,075,70~74세,2016,8629,3835,4794,80,8613,3827,4786,80
36030, 순천시,075001, 70세,2016,1591,777,814,95.5,1588,774,814,95.1
36030, 순천시,075002, 71세,2016,1521,689,832,82.8,1517,689,828,83.2
36030, 순천시,075003, 72세,2016,1533,694,839,82.7,1529,691,838,82.5
36030, 순천시,075004, 73세,2016,1875,787,1088,72.3,1871,786,1085,72.4
36030, 순천시,075005, 74세,2016,2109,888,1221,72.7,2108,887,1221,72.6
36030, 순천시,080,75~79세,2016,7788,3130,4658,67.2,7780,3124,4656,67.1
36030, 순천시,080001, 75세,2016,1779,756,1023,73.9,1778,755,1023,73.8
36030, 순천시,080002, 76세,2016,1607,666,941,70.8,1605,665,940,70.7
36030, 순천시,080003, 77세,2016,1569,637,932,68.3,1569,637,932,68.3
36030, 순천시,080004, 78세,2016,1471,570,901,63.3,1468,568,900,63.1
36030, 순천시,080005, 79세,2016,1362,501,861,58.2,1360,499,861,58
36030, 순천시,085,80~84세,2016,5222,1719,3503,49.1,5216,1715,3501,49
36030, 순천시,085001, 80세,2016,1230,427,803,53.2,1228,426,802,53.1
36030, 순천시,085002, 81세,2016,1208,421,787,53.5,1206,419,787,53.2
36030, 순천시,085003, 82세,2016,1100,354,746,47.5,1100,354,746,47.5
36030, 순천시,085004, 83세,2016,892,272,620,43.9,891,271,620,43.7
36030, 순천시,085005, 84세,2016,792,245,547,44.8,791,245,546,44.9
36030, 순천시,090,85~89세,2016,2579,704,1875,37.5,2579,704,1875,37.5
36030, 순천시,090001, 85세,2016,657,193,464,41.6,657,193,464,41.6
36030, 순천시,090002, 86세,2016,699,179,520,34.4,699,179,520,34.4
36030, 순천시,090003, 87세,2016,541,153,388,39.4,541,153,388,39.4
36030, 순천시,090004, 88세,2016,365,104,261,39.8,365,104,261,39.8
36030, 순천시,090005, 89세,2016,317,75,242,31,317,75,242,31
36030, 순천시,095,90~94세,2016,766,171,595,28.7,764,170,594,28.6
36030, 순천시,095001, 90세,2016,213,54,159,34,212,53,159,33.3
36030, 순천시,095002, 91세,2016,192,46,146,31.5,192,46,146,31.5
36030, 순천시,095003, 92세,2016,122,28,94,29.8,122,28,94,29.8
36030, 순천시,095004, 93세,2016,129,24,105,22.9,128,24,104,23.1
36030, 순천시,095005, 94세,2016,110,19,91,20.9,110,19,91,20.9
36030, 순천시,100,95~99세,2016,161,23,138,16.7,161,23,138,16.7
36030, 순천시,100001, 95세,2016,60,6,54,11.1,60,6,54,11.1
36030, 순천시,100002, 96세,2016,41,6,35,17.1,41,6,35,17.1
36030, 순천시,100003, 97세,2016,26,8,18,44.4,26,8,18,44.4
36030, 순천시,100004, 98세,2016,18,X,16,12.5,18,X,16,12.5
36030, 순천시,100005, 99세,2016,16,X,15,6.7,16,X,15,6.7
36030, 순천시,101,100세이상,2016,18,X,15,20,18,X,15,20
36030, 순천시,102,15세미만,2016,39939,20681,19258,107.4,39888,20652,19236,107.4
36030, 순천시,103,15~64세,2016,190162,97013,93149,104.1,188201,96181,92020,104.5
36030, 순천시,104,65세이상,2016,36418,15171,21247,71.4,36352,15133,21219,71.3
36030, 순천시,086,85세이상,2016,3524,901,2623,34.3,3522,900,2622,34.3
36030, 순천시,126,평균연령,2016,40.4,39,41.7,,40.4,39.1,41.8,
36030, 순천시,127,중위연령,2016,42,40.6,43.1,,42,40.6,43.2,
36040, 나주시,000,합계,2016,98221,48778,49443,98.7,95358,47116,48242,97.7
36040, 나주시,005,0~4세,2016,4755,2483,2272,109.3,4735,2470,2265,109.1
36040, 나주시,005001, 0세,2016,966,485,481,100.8,961,482,479,100.6
36040, 나주시,005002, 1세,2016,959,491,468,104.9,957,491,466,105.4
36040, 나주시,005003, 2세,2016,894,483,411,117.5,892,481,411,117
36040, 나주시,005004, 3세,2016,928,487,441,110.4,922,483,439,110
36040, 나주시,005005, 4세,2016,1008,537,471,114,1003,533,470,113.4
36040, 나주시,010,5~9세,2016,3991,2030,1961,103.5,3977,2022,1955,103.4
36040, 나주시,010001, 5세,2016,866,418,448,93.3,863,415,448,92.6
36040, 나주시,010002, 6세,2016,762,413,349,118.3,760,412,348,118.4
36040, 나주시,010003, 7세,2016,773,391,382,102.4,770,390,380,102.6
36040, 나주시,010004, 8세,2016,799,403,396,101.8,794,401,393,102
36040, 나주시,010005, 9세,2016,791,405,386,104.9,790,404,386,104.7
36040, 나주시,015,10~14세,2016,3566,1857,1709,108.7,3554,1853,1701,108.9
36040, 나주시,015001, 10세,2016,708,390,318,122.6,707,390,317,123
36040, 나주시,015002, 11세,2016,666,344,322,106.8,660,341,319,106.9
36040, 나주시,015003, 12세,2016,694,369,325,113.5,692,369,323,114.2
36040, 나주시,015004, 13세,2016,741,360,381,94.5,739,360,379,95
36040, 나주시,015005, 14세,2016,757,394,363,108.5,756,393,363,108.3
36040, 나주시,020,15~19세,2016,5655,2839,2816,100.8,5560,2791,2769,100.8
36040, 나주시,020001, 15세,2016,902,457,445,102.7,899,455,444,102.5
36040, 나주시,020002, 16세,2016,1376,673,703,95.7,1371,670,701,95.6
36040, 나주시,020003, 17세,2016,1130,588,542,108.5,1129,587,542,108.3
36040, 나주시,020004, 18세,2016,1124,553,571,96.8,1091,537,554,96.9
36040, 나주시,020005, 19세,2016,1123,568,555,102.3,1070,542,528,102.7
36040, 나주시,025,20~24세,2016,5860,3116,2744,113.6,5220,2731,2489,109.7
36040, 나주시,025001, 20세,2016,1195,605,590,102.5,1082,547,535,102.2
36040, 나주시,025002, 21세,2016,1220,676,544,124.3,1105,607,498,121.9
36040, 나주시,025003, 22세,2016,1182,631,551,114.5,1068,552,516,107
36040, 나주시,025004, 23세,2016,1126,609,517,117.8,992,530,462,114.7
36040, 나주시,025005, 24세,2016,1137,595,542,109.8,973,495,478,103.6
36040, 나주시,030,25~29세,2016,5270,2758,2512,109.8,4676,2416,2260,106.9
36040, 나주시,030001, 25세,2016,1053,555,498,111.4,926,486,440,110.5
36040, 나주시,030002, 26세,2016,1035,547,488,112.1,910,471,439,107.3
36040, 나주시,030003, 27세,2016,1063,538,525,102.5,946,474,472,100.4
36040, 나주시,030004, 28세,2016,1047,552,495,111.5,918,472,446,105.8
36040, 나주시,030005, 29세,2016,1072,566,506,111.9,976,513,463,110.8
36040, 나주시,035,30~34세,2016,6173,3243,2930,110.7,5725,2959,2766,107
36040, 나주시,035001, 30세,2016,1077,550,527,104.4,985,500,485,103.1
36040, 나주시,035002, 31세,2016,1154,607,547,111,1043,542,501,108.2
36040, 나주시,035003, 32세,2016,1182,626,556,112.6,1097,568,529,107.4
36040, 나주시,035004, 33세,2016,1307,698,609,114.6,1235,646,589,109.7
36040, 나주시,035005, 34세,2016,1453,762,691,110.3,1365,703,662,106.2
36040, 나주시,040,35~39세,2016,6858,3706,3152,117.6,6576,3519,3057,115.1
36040, 나주시,040001, 35세,2016,1418,774,644,120.2,1348,728,620,117.4
36040, 나주시,040002, 36세,2016,1440,754,686,109.9,1387,719,668,107.6
36040, 나주시,040003, 37세,2016,1426,778,648,120.1,1364,734,630,116.5
36040, 나주시,040004, 38세,2016,1300,701,599,117,1243,667,576,115.8
36040, 나주시,040005, 39세,2016,1274,699,575,121.6,1234,671,563,119.2
36040, 나주시,045,40~44세,2016,6511,3715,2796,132.9,6296,3583,2713,132.1
36040, 나주시,045001, 40세,2016,1222,704,518,135.9,1160,663,497,133.4
36040, 나주시,045002, 41세,2016,1324,742,582,127.5,1285,719,566,127
36040, 나주시,045003, 42세,2016,1289,718,571,125.7,1255,696,559,124.5
36040, 나주시,045004, 43세,2016,1320,769,551,139.6,1279,744,535,139.1
36040, 나주시,045005, 44세,2016,1356,782,574,136.2,1317,761,556,136.9
36040, 나주시,050,45~49세,2016,6626,3656,2970,123.1,6442,3562,2880,123.7
36040, 나주시,050001, 45세,2016,1394,790,604,130.8,1355,762,593,128.5
36040, 나주시,050002, 46세,2016,1326,762,564,135.1,1286,742,544,136.4
36040, 나주시,050003, 47세,2016,1243,653,590,110.7,1206,630,576,109.4
36040, 나주시,050004, 48세,2016,1330,709,621,114.2,1297,696,601,115.8
36040, 나주시,050005, 49세,2016,1333,742,591,125.5,1298,732,566,129.3
36040, 나주시,055,50~54세,2016,6856,3709,3147,117.9,6718,3650,3068,119
36040, 나주시,055001, 50세,2016,1355,733,622,117.8,1317,715,602,118.8
36040, 나주시,055002, 51세,2016,1380,776,604,128.5,1355,767,588,130.4
36040, 나주시,055003, 52세,2016,1311,664,647,102.6,1285,653,632,103.3
36040, 나주시,055004, 53세,2016,1425,783,642,122,1395,772,623,123.9
36040, 나주시,055005, 54세,2016,1385,753,632,119.1,1366,743,623,119.3
36040, 나주시,060,55~59세,2016,7861,3999,3862,103.5,7764,3955,3809,103.8
36040, 나주시,060001, 55세,2016,1583,806,777,103.7,1564,796,768,103.6
36040, 나주시,060002, 56세,2016,1713,863,850,101.5,1684,848,836,101.4
36040, 나주시,060003, 57세,2016,1585,813,772,105.3,1567,807,760,106.2
36040, 나주시,060004, 58세,2016,1498,741,757,97.9,1480,736,744,98.9
36040, 나주시,060005, 59세,2016,1482,776,706,109.9,1469,768,701,109.6
36040, 나주시,065,60~64세,2016,6215,3075,3140,97.9,6147,3040,3107,97.8
36040, 나주시,065001, 60세,2016,1313,671,642,104.5,1295,660,635,103.9
36040, 나주시,065002, 61세,2016,1409,708,701,101,1392,700,692,101.2
36040, 나주시,065003, 62세,2016,1259,619,640,96.7,1247,612,635,96.4
36040, 나주시,065004, 63세,2016,1021,494,527,93.7,1012,488,524,93.1
36040, 나주시,065005, 64세,2016,1213,583,630,92.5,1201,580,621,93.4
36040, 나주시,070,65~69세,2016,5574,2690,2884,93.3,5547,2676,2871,93.2
36040, 나주시,070001, 65세,2016,1012,496,516,96.1,1000,490,510,96.1
36040, 나주시,070002, 66세,2016,1097,540,557,96.9,1093,537,556,96.6
36040, 나주시,070003, 67세,2016,1177,556,621,89.5,1171,553,618,89.5
36040, 나주시,070004, 68세,2016,1115,541,574,94.3,1113,540,573,94.2
36040, 나주시,070005, 69세,2016,1173,557,616,90.4,1170,556,614,90.6
36040, 나주시,075,70~74세,2016,5488,2304,3184,72.4,5474,2297,3177,72.3
36040, 나주시,075001, 70세,2016,899,401,498,80.5,895,398,497,80.1
36040, 나주시,075002, 71세,2016,1067,448,619,72.4,1065,447,618,72.3
36040, 나주시,075003, 72세,2016,976,421,555,75.9,976,421,555,75.9
36040, 나주시,075004, 73세,2016,1110,455,655,69.5,1105,453,652,69.5
36040, 나주시,075005, 74세,2016,1436,579,857,67.6,1433,578,855,67.6
36040, 나주시,080,75~79세,2016,5174,1923,3251,59.2,5166,1919,3247,59.1
36040, 나주시,080001, 75세,2016,1118,462,656,70.4,1116,462,654,70.6
36040, 나주시,080002, 76세,2016,1066,411,655,62.7,1063,408,655,62.3
36040, 나주시,080003, 77세,2016,1016,353,663,53.2,1016,353,663,53.2
36040, 나주시,080004, 78세,2016,1015,363,652,55.7,1015,363,652,55.7
36040, 나주시,080005, 79세,2016,959,334,625,53.4,956,333,623,53.5
36040, 나주시,085,80~84세,2016,3401,1100,2301,47.8,3398,1099,2299,47.8
36040, 나주시,085001, 80세,2016,785,281,504,55.8,785,281,504,55.8
36040, 나주시,085002, 81세,2016,790,264,526,50.2,789,264,525,50.3
36040, 나주시,085003, 82세,2016,723,226,497,45.5,722,225,497,45.3
36040, 나주시,085004, 83세,2016,600,175,425,41.2,599,175,424,41.3
36040, 나주시,085005, 84세,2016,503,154,349,44.1,503,154,349,44.1
36040, 나주시,090,85~89세,2016,1708,412,1296,31.8,1706,411,1295,31.7
36040, 나주시,090001, 85세,2016,434,102,332,30.7,434,102,332,30.7
36040, 나주시,090002, 86세,2016,471,99,372,26.6,471,99,372,26.6
36040, 나주시,090003, 87세,2016,337,89,248,35.9,336,89,247,36
36040, 나주시,090004, 88세,2016,273,73,200,36.5,273,73,200,36.5
36040, 나주시,090005, 89세,2016,193,49,144,34,192,48,144,33.3
36040, 나주시,095,90~94세,2016,526,130,396,32.8,525,130,395,32.9
36040, 나주시,095001, 90세,2016,165,40,125,32,165,40,125,32
36040, 나주시,095002, 91세,2016,126,37,89,41.6,126,37,89,41.6
36040, 나주시,095003, 92세,2016,77,22,55,40,77,22,55,40
36040, 나주시,095004, 93세,2016,98,16,82,19.5,97,16,81,19.8
36040, 나주시,095005, 94세,2016,60,15,45,33.3,60,15,45,33.3
36040, 나주시,100,95~99세,2016,144,33,111,29.7,143,33,110,30
36040, 나주시,100001, 95세,2016,55,9,46,19.6,55,9,46,19.6
36040, 나주시,100002, 96세,2016,37,7,30,23.3,37,7,30,23.3
36040, 나주시,100003, 97세,2016,24,11,13,84.6,23,11,12,91.7
36040, 나주시,100004, 98세,2016,23,X,19,21.1,23,X,19,21.1
36040, 나주시,100005, 99세,2016,5,X,X,66.7,5,X,X,66.7
36040, 나주시,101,100세이상,2016,9,X,9,0,9,X,9,0
36040, 나주시,102,15세미만,2016,12312,6370,5942,107.2,12266,6345,5921,107.2
36040, 나주시,103,15~64세,2016,63885,33816,30069,112.5,61124,32206,28918,111.4
36040, 나주시,104,65세이상,2016,22024,8592,13432,64,21968,8565,13403,63.9
36040, 나주시,086,85세이상,2016,2387,575,1812,31.7,2383,574,1809,31.7
36040, 나주시,126,평균연령,2016,44.6,42.5,46.7,,44.9,42.8,47,
36040, 나주시,127,중위연령,2016,45.3,43.3,48.1,,46,44,48.7,
36060, 광양시,000,합계,2016,144364,74452,69912,106.5,142563,73591,68972,106.7
36060, 광양시,005,0~4세,2016,7844,3957,3887,101.8,7830,3948,3882,101.7
36060, 광양시,005001, 0세,2016,1398,730,668,109.3,1397,729,668,109.1
36060, 광양시,005002, 1세,2016,1599,800,799,100.1,1595,797,798,99.9
36060, 광양시,005003, 2세,2016,1508,716,792,90.4,1505,714,791,90.3
36060, 광양시,005004, 3세,2016,1659,848,811,104.6,1656,847,809,104.7
36060, 광양시,005005, 4세,2016,1680,863,817,105.6,1677,861,816,105.5
36060, 광양시,010,5~9세,2016,7740,3989,3751,106.3,7729,3986,3743,106.5
36060, 광양시,010001, 5세,2016,1673,835,838,99.6,1672,835,837,99.8
36060, 광양시,010002, 6세,2016,1594,836,758,110.3,1591,836,755,110.7
36060, 광양시,010003, 7세,2016,1432,735,697,105.5,1427,732,695,105.3
36060, 광양시,010004, 8세,2016,1540,788,752,104.8,1540,788,752,104.8
36060, 광양시,010005, 9세,2016,1501,795,706,112.6,1499,795,704,112.9
36060, 광양시,015,10~14세,2016,7587,3937,3650,107.9,7576,3932,3644,107.9
36060, 광양시,015001, 10세,2016,1442,727,715,101.7,1440,727,713,102
36060, 광양시,015002, 11세,2016,1423,702,721,97.4,1420,700,720,97.2
36060, 광양시,015003, 12세,2016,1498,795,703,113.1,1497,794,703,112.9
36060, 광양시,015004, 13세,2016,1542,835,707,118.1,1538,834,704,118.5
36060, 광양시,015005, 14세,2016,1682,878,804,109.2,1681,877,804,109.1
36060, 광양시,020,15~19세,2016,10184,5384,4800,112.2,10166,5377,4789,112.3
36060, 광양시,020001, 15세,2016,1955,986,969,101.8,1952,984,968,101.7
36060, 광양시,020002, 16세,2016,2339,1191,1148,103.7,2335,1189,1146,103.8
36060, 광양시,020003, 17세,2016,2247,1168,1079,108.2,2245,1167,1078,108.3
36060, 광양시,020004, 18세,2016,2057,1093,964,113.4,2055,1092,963,113.4
36060, 광양시,020005, 19세,2016,1586,946,640,147.8,1579,945,634,149.1
36060, 광양시,025,20~24세,2016,8645,5166,3479,148.5,8451,5066,3385,149.7
36060, 광양시,025001, 20세,2016,1817,1192,625,190.7,1811,1191,620,192.1
36060, 광양시,025002, 21세,2016,1914,1219,695,175.4,1879,1200,679,176.7
36060, 광양시,025003, 22세,2016,1662,970,692,140.2,1626,951,675,140.9
36060, 광양시,025004, 23세,2016,1618,881,737,119.5,1565,855,710,120.4
36060, 광양시,025005, 24세,2016,1634,904,730,123.8,1570,869,701,124
36060, 광양시,030,25~29세,2016,7687,4264,3423,124.6,7345,4108,3237,126.9
36060, 광양시,030001, 25세,2016,1578,884,694,127.4,1505,851,654,130.1
36060, 광양시,030002, 26세,2016,1566,865,701,123.4,1503,832,671,124
36060, 광양시,030003, 27세,2016,1502,845,657,128.6,1440,823,617,133.4
36060, 광양시,030004, 28세,2016,1514,853,661,129,1442,822,620,132.6
36060, 광양시,030005, 29세,2016,1527,817,710,115.1,1455,780,675,115.6
36060, 광양시,035,30~34세,2016,9674,5072,4602,110.2,9392,4930,4462,110.5
36060, 광양시,035001, 30세,2016,1731,917,814,112.7,1657,884,773,114.4
36060, 광양시,035002, 31세,2016,1728,898,830,108.2,1666,864,802,107.7
36060, 광양시,035003, 32세,2016,1797,918,879,104.4,1744,890,854,104.2
36060, 광양시,035004, 33세,2016,2102,1127,975,115.6,2052,1099,953,115.3
36060, 광양시,035005, 34세,2016,2316,1212,1104,109.8,2273,1193,1080,110.5
36060, 광양시,040,35~39세,2016,10951,5694,5257,108.3,10771,5604,5167,108.5
36060, 광양시,040001, 35세,2016,2153,1169,984,118.8,2109,1148,961,119.5
36060, 광양시,040002, 36세,2016,2366,1242,1124,110.5,2333,1224,1109,110.4
36060, 광양시,040003, 37세,2016,2252,1154,1098,105.1,2207,1131,1076,105.1
36060, 광양시,040004, 38세,2016,2048,1067,981,108.8,2018,1054,964,109.3
36060, 광양시,040005, 39세,2016,2132,1062,1070,99.3,2104,1047,1057,99.1
36060, 광양시,045,40~44세,2016,11483,5726,5757,99.5,11315,5639,5676,99.3
36060, 광양시,045001, 40세,2016,2010,997,1013,98.4,1973,972,1001,97.1
36060, 광양시,045002, 41세,2016,2117,1060,1057,100.3,2091,1048,1043,100.5
36060, 광양시,045003, 42세,2016,2333,1181,1152,102.5,2304,1169,1135,103
36060, 광양시,045004, 43세,2016,2513,1224,1289,95,2473,1203,1270,94.7
36060, 광양시,045005, 44세,2016,2510,1264,1246,101.4,2474,1247,1227,101.6
36060, 광양시,050,45~49세,2016,15320,7882,7438,106,15147,7806,7341,106.3
36060, 광양시,050001, 45세,2016,2970,1424,1546,92.1,2932,1404,1528,91.9
36060, 광양시,050002, 46세,2016,2871,1398,1473,94.9,2841,1381,1460,94.6
36060, 광양시,050003, 47세,2016,3052,1548,1504,102.9,3024,1541,1483,103.9
36060, 광양시,050004, 48세,2016,3332,1814,1518,119.5,3292,1799,1493,120.5
36060, 광양시,050005, 49세,2016,3095,1698,1397,121.5,3058,1681,1377,122.1
36060, 광양시,055,50~54세,2016,12989,7291,5698,128,12836,7216,5620,128.4
36060, 광양시,055001, 50세,2016,2949,1746,1203,145.1,2923,1735,1188,146
36060, 광양시,055002, 51세,2016,2787,1555,1232,126.2,2754,1541,1213,127
36060, 광양시,055003, 52세,2016,2347,1267,1080,117.3,2319,1254,1065,117.7
36060, 광양시,055004, 53세,2016,2544,1430,1114,128.4,2506,1413,1093,129.3
36060, 광양시,055005, 54세,2016,2362,1293,1069,121,2334,1273,1061,120
36060, 광양시,060,55~59세,2016,11096,5795,5301,109.3,10978,5749,5229,109.9
36060, 광양시,060001, 55세,2016,2569,1330,1239,107.3,2545,1321,1224,107.9
36060, 광양시,060002, 56세,2016,2561,1299,1262,102.9,2535,1289,1246,103.5
36060, 광양시,060003, 57세,2016,2145,1078,1067,101,2124,1072,1052,101.9
36060, 광양시,060004, 58세,2016,1957,1058,899,117.7,1930,1046,884,118.3
36060, 광양시,060005, 59세,2016,1864,1030,834,123.5,1844,1021,823,124.1
36060, 광양시,065,60~64세,2016,6935,3663,3272,111.9,6861,3625,3236,112
36060, 광양시,065001, 60세,2016,1569,841,728,115.5,1549,830,719,115.4
36060, 광양시,065002, 61세,2016,1635,845,790,107,1619,838,781,107.3
36060, 광양시,065003, 62세,2016,1437,743,694,107.1,1424,737,687,107.3
36060, 광양시,065004, 63세,2016,1112,592,520,113.8,1092,581,511,113.7
36060, 광양시,065005, 64세,2016,1182,642,540,118.9,1177,639,538,118.8
36060, 광양시,070,65~69세,2016,5153,2647,2506,105.6,5115,2628,2487,105.7
36060, 광양시,070001, 65세,2016,1091,584,507,115.2,1079,577,502,114.9
36060, 광양시,070002, 66세,2016,1062,566,496,114.1,1052,560,492,113.8
36060, 광양시,070003, 67세,2016,977,500,477,104.8,971,497,474,104.9
36060, 광양시,070004, 68세,2016,1004,497,507,98,1000,497,503,98.8
36060, 광양시,070005, 69세,2016,1019,500,519,96.3,1013,497,516,96.3
36060, 광양시,075,70~74세,2016,3532,1517,2015,75.3,3520,1515,2005,75.6
36060, 광양시,075001, 70세,2016,624,306,318,96.2,619,305,314,97.1
36060, 광양시,075002, 71세,2016,630,283,347,81.6,628,282,346,81.5
36060, 광양시,075003, 72세,2016,641,254,387,65.6,641,254,387,65.6
36060, 광양시,075004, 73세,2016,750,316,434,72.8,747,316,431,73.3
36060, 광양시,075005, 74세,2016,887,358,529,67.7,885,358,527,67.9
36060, 광양시,080,75~79세,2016,3517,1340,2177,61.6,3509,1337,2172,61.6
36060, 광양시,080001, 75세,2016,761,289,472,61.2,757,287,470,61.1
36060, 광양시,080002, 76세,2016,707,271,436,62.2,705,271,434,62.4
36060, 광양시,080003, 77세,2016,748,295,453,65.1,747,295,452,65.3
36060, 광양시,080004, 78세,2016,669,248,421,58.9,669,248,421,58.9
36060, 광양시,080005, 79세,2016,632,237,395,60,631,236,395,59.7
36060, 광양시,085,80~84세,2016,2381,766,1615,47.4,2378,763,1615,47.2
36060, 광양시,085001, 80세,2016,606,225,381,59.1,606,225,381,59.1
36060, 광양시,085002, 81세,2016,539,173,366,47.3,536,170,366,46.4
36060, 광양시,085003, 82세,2016,450,147,303,48.5,450,147,303,48.5
36060, 광양시,085004, 83세,2016,404,111,293,37.9,404,111,293,37.9
36060, 광양시,085005, 84세,2016,382,110,272,40.4,382,110,272,40.4
36060, 광양시,090,85~89세,2016,1201,285,916,31.1,1199,285,914,31.2
36060, 광양시,090001, 85세,2016,340,82,258,31.8,340,82,258,31.8
36060, 광양시,090002, 86세,2016,285,63,222,28.4,285,63,222,28.4
36060, 광양시,090003, 87세,2016,225,59,166,35.5,224,59,165,35.8
36060, 광양시,090004, 88세,2016,211,51,160,31.9,210,51,159,32.1
36060, 광양시,090005, 89세,2016,140,30,110,27.3,140,30,110,27.3
36060, 광양시,095,90~94세,2016,360,64,296,21.6,360,64,296,21.6
36060, 광양시,095001, 90세,2016,115,23,92,25,115,23,92,25
36060, 광양시,095002, 91세,2016,79,14,65,21.5,79,14,65,21.5
36060, 광양시,095003, 92세,2016,64,11,53,20.8,64,11,53,20.8
36060, 광양시,095004, 93세,2016,57,6,51,11.8,57,6,51,11.8
36060, 광양시,095005, 94세,2016,45,10,35,28.6,45,10,35,28.6
36060, 광양시,100,95~99세,2016,76,12,64,18.8,76,12,64,18.8
36060, 광양시,100001, 95세,2016,40,7,33,21.2,40,7,33,21.2
36060, 광양시,100002, 96세,2016,17,X,15,13.3,17,X,15,13.3
36060, 광양시,100003, 97세,2016,7,X,7,0,7,X,7,0
36060, 광양시,100004, 98세,2016,9,X,6,50,9,X,6,50
36060, 광양시,100005, 99세,2016,X,X,X,0,X,X,X,0
36060, 광양시,101,100세이상,2016,9,X,8,12.5,9,X,8,12.5
36060, 광양시,102,15세미만,2016,23171,11883,11288,105.3,23135,11866,11269,105.3
36060, 광양시,103,15~64세,2016,104964,55937,49027,114.1,103262,55120,48142,114.5
36060, 광양시,104,65세이상,2016,16229,6632,9597,69.1,16166,6605,9561,69.1
36060, 광양시,086,85세이상,2016,1646,362,1284,28.2,1644,362,1282,28.2
36060, 광양시,126,평균연령,2016,39.3,38.2,40.4,,39.3,38.2,40.4,
36060, 광양시,127,중위연령,2016,40.9,39.8,42,,41,39.9,42.1,
36310, 담양군,000,합계,2016,43519,21482,22037,97.5,42302,20834,21468,97
36310, 담양군,005,0~4세,2016,1353,681,672,101.3,1350,679,671,101.2
36310, 담양군,005001, 0세,2016,287,151,136,111,287,151,136,111
36310, 담양군,005002, 1세,2016,274,114,160,71.3,274,114,160,71.3
36310, 담양군,005003, 2세,2016,283,153,130,117.7,283,153,130,117.7
36310, 담양군,005004, 3세,2016,246,124,122,101.6,244,123,121,101.7
36310, 담양군,005005, 4세,2016,263,139,124,112.1,262,138,124,111.3
36310, 담양군,010,5~9세,2016,1174,610,564,108.2,1171,609,562,108.4
36310, 담양군,010001, 5세,2016,239,135,104,129.8,239,135,104,129.8
36310, 담양군,010002, 6세,2016,248,113,135,83.7,246,113,133,85
36310, 담양군,010003, 7세,2016,229,127,102,124.5,229,127,102,124.5
36310, 담양군,010004, 8세,2016,242,129,113,114.2,242,129,113,114.2
36310, 담양군,010005, 9세,2016,216,106,110,96.4,215,105,110,95.5
36310, 담양군,015,10~14세,2016,1249,640,609,105.1,1246,639,607,105.3
36310, 담양군,015001, 10세,2016,226,114,112,101.8,224,114,110,103.6
36310, 담양군,015002, 11세,2016,253,133,120,110.8,253,133,120,110.8
36310, 담양군,015003, 12세,2016,249,129,120,107.5,248,128,120,106.7
36310, 담양군,015004, 13세,2016,243,120,123,97.6,243,120,123,97.6
36310, 담양군,015005, 14세,2016,278,144,134,107.5,278,144,134,107.5
36310, 담양군,020,15~19세,2016,2976,1585,1391,113.9,2966,1579,1387,113.8
36310, 담양군,020001, 15세,2016,448,235,213,110.3,448,235,213,110.3
36310, 담양군,020002, 16세,2016,761,380,381,99.7,761,380,381,99.7
36310, 담양군,020003, 17세,2016,650,352,298,118.1,650,352,298,118.1
36310, 담양군,020004, 18세,2016,624,335,289,115.9,621,335,286,117.1
36310, 담양군,020005, 19세,2016,493,283,210,134.8,486,277,209,132.5
36310, 담양군,025,20~24세,2016,2322,1347,975,138.2,2022,1188,834,142.4
36310, 담양군,025001, 20세,2016,536,319,217,147,514,302,212,142.5
36310, 담양군,025002, 21세,2016,439,270,169,159.8,390,245,145,169
36310, 담양군,025003, 22세,2016,429,249,180,138.3,370,220,150,146.7
36310, 담양군,025004, 23세,2016,425,230,195,117.9,350,198,152,130.3
36310, 담양군,025005, 24세,2016,493,279,214,130.4,398,223,175,127.4
36310, 담양군,030,25~29세,2016,2047,1044,1003,104.1,1741,885,856,103.4
36310, 담양군,030001, 25세,2016,430,224,206,108.7,365,192,173,111
36310, 담양군,030002, 26세,2016,423,217,206,105.3,357,187,170,110
36310, 담양군,030003, 27세,2016,393,188,205,91.7,322,148,174,85.1
36310, 담양군,030004, 28세,2016,409,212,197,107.6,357,183,174,105.2
36310, 담양군,030005, 29세,2016,392,203,189,107.4,340,175,165,106.1
36310, 담양군,035,30~34세,2016,1954,1015,939,108.1,1757,906,851,106.5
36310, 담양군,035001, 30세,2016,389,202,187,108,334,172,162,106.2
36310, 담양군,035002, 31세,2016,369,186,183,101.6,326,163,163,100
36310, 담양군,035003, 32세,2016,394,211,183,115.3,354,189,165,114.5
36310, 담양군,035004, 33세,2016,405,207,198,104.5,377,193,184,104.9
36310, 담양군,035005, 34세,2016,397,209,188,111.2,366,189,177,106.8
36310, 담양군,040,35~39세,2016,1958,1082,876,123.5,1836,1014,822,123.4
36310, 담양군,040001, 35세,2016,409,217,192,113,382,202,180,112.2
36310, 담양군,040002, 36세,2016,422,236,186,126.9,394,221,173,127.7
36310, 담양군,040003, 37세,2016,373,209,164,127.4,344,193,151,127.8
36310, 담양군,040004, 38세,2016,373,213,160,133.1,350,199,151,131.8
36310, 담양군,040005, 39세,2016,381,207,174,119,366,199,167,119.2
36310, 담양군,045,40~44세,2016,2356,1399,957,146.2,2257,1335,922,144.8
36310, 담양군,045001, 40세,2016,371,224,147,152.4,355,214,141,151.8
36310, 담양군,045002, 41세,2016,449,263,186,141.4,424,243,181,134.3
36310, 담양군,045003, 42세,2016,539,325,214,151.9,512,310,202,153.5
36310, 담양군,045004, 43세,2016,471,270,201,134.3,453,259,194,133.5
36310, 담양군,045005, 44세,2016,526,317,209,151.7,513,309,204,151.5
36310, 담양군,050,45~49세,2016,2918,1636,1282,127.6,2875,1615,1260,128.2
36310, 담양군,050001, 45세,2016,598,365,233,156.7,586,359,227,158.1
36310, 담양군,050002, 46세,2016,554,296,258,114.7,547,292,255,114.5
36310, 담양군,050003, 47세,2016,556,288,268,107.5,547,283,264,107.2
36310, 담양군,050004, 48세,2016,641,364,277,131.4,631,360,271,132.8
36310, 담양군,050005, 49세,2016,569,323,246,131.3,564,321,243,132.1
36310, 담양군,055,50~54세,2016,3414,1810,1604,112.8,3367,1790,1577,113.5
36310, 담양군,055001, 50세,2016,623,349,274,127.4,613,345,268,128.7
36310, 담양군,055002, 51세,2016,666,343,323,106.2,651,339,312,108.7
36310, 담양군,055003, 52세,2016,663,337,326,103.4,656,332,324,102.5
36310, 담양군,055004, 53세,2016,725,382,343,111.4,718,379,339,111.8
36310, 담양군,055005, 54세,2016,737,399,338,118,729,395,334,118.3
36310, 담양군,060,55~59세,2016,4048,2062,1986,103.8,4005,2042,1963,104
36310, 담양군,060001, 55세,2016,835,403,432,93.3,825,398,427,93.2
36310, 담양군,060002, 56세,2016,882,454,428,106.1,872,450,422,106.6
36310, 담양군,060003, 57세,2016,804,434,370,117.3,794,427,367,116.3
36310, 담양군,060004, 58세,2016,748,377,371,101.6,743,375,368,101.9
36310, 담양군,060005, 59세,2016,779,394,385,102.3,771,392,379,103.4
36310, 담양군,065,60~64세,2016,3274,1606,1668,96.3,3260,1599,1661,96.3
36310, 담양군,065001, 60세,2016,634,319,315,101.3,633,319,314,101.6
36310, 담양군,065002, 61세,2016,713,344,369,93.2,709,342,367,93.2
36310, 담양군,065003, 62세,2016,686,326,360,90.6,681,324,357,90.8
36310, 담양군,065004, 63세,2016,569,273,296,92.2,566,271,295,91.9
36310, 담양군,065005, 64세,2016,672,344,328,104.9,671,343,328,104.6
36310, 담양군,070,65~69세,2016,3128,1492,1636,91.2,3107,1484,1623,91.4
36310, 담양군,070001, 65세,2016,542,251,291,86.3,535,248,287,86.4
36310, 담양군,070002, 66세,2016,631,303,328,92.4,627,302,325,92.9
36310, 담양군,070003, 67세,2016,602,278,324,85.8,596,276,320,86.3
36310, 담양군,070004, 68세,2016,626,309,317,97.5,624,308,316,97.5
36310, 담양군,070005, 69세,2016,727,351,376,93.4,725,350,375,93.3
36310, 담양군,075,70~74세,2016,3017,1282,1735,73.9,3014,1281,1733,73.9
36310, 담양군,075001, 70세,2016,501,238,263,90.5,499,237,262,90.5
36310, 담양군,075002, 71세,2016,484,221,263,84,484,221,263,84
36310, 담양군,075003, 72세,2016,499,185,314,58.9,498,185,313,59.1
36310, 담양군,075004, 73세,2016,632,269,363,74.1,632,269,363,74.1
36310, 담양군,075005, 74세,2016,901,369,532,69.4,901,369,532,69.4
36310, 담양군,080,75~79세,2016,3020,1189,1831,64.9,3018,1187,1831,64.8
36310, 담양군,080001, 75세,2016,676,283,393,72,675,282,393,71.8
36310, 담양군,080002, 76세,2016,611,235,376,62.5,611,235,376,62.5
36310, 담양군,080003, 77세,2016,674,274,400,68.5,674,274,400,68.5
36310, 담양군,080004, 78세,2016,564,215,349,61.6,564,215,349,61.6
36310, 담양군,080005, 79세,2016,495,182,313,58.1,494,181,313,57.8
36310, 담양군,085,80~84세,2016,1955,642,1313,48.9,1955,642,1313,48.9
36310, 담양군,085001, 80세,2016,471,167,304,54.9,471,167,304,54.9
36310, 담양군,085002, 81세,2016,443,145,298,48.7,443,145,298,48.7
36310, 담양군,085003, 82세,2016,401,134,267,50.2,401,134,267,50.2
36310, 담양군,085004, 83세,2016,345,104,241,43.2,345,104,241,43.2
36310, 담양군,085005, 84세,2016,295,92,203,45.3,295,92,203,45.3
36310, 담양군,090,85~89세,2016,949,274,675,40.6,949,274,675,40.6
36310, 담양군,090001, 85세,2016,231,67,164,40.9,231,67,164,40.9
36310, 담양군,090002, 86세,2016,260,80,180,44.4,260,80,180,44.4
36310, 담양군,090003, 87세,2016,187,59,128,46.1,187,59,128,46.1
36310, 담양군,090004, 88세,2016,161,39,122,32,161,39,122,32
36310, 담양군,090005, 89세,2016,110,29,81,35.8,110,29,81,35.8
36310, 담양군,095,90~94세,2016,311,71,240,29.6,310,71,239,29.7
36310, 담양군,095001, 90세,2016,97,22,75,29.3,97,22,75,29.3
36310, 담양군,095002, 91세,2016,69,14,55,25.5,68,14,54,25.9
36310, 담양군,095003, 92세,2016,49,12,37,32.4,49,12,37,32.4
36310, 담양군,095004, 93세,2016,54,12,42,28.6,54,12,42,28.6
36310, 담양군,095005, 94세,2016,42,11,31,35.5,42,11,31,35.5
36310, 담양군,100,95~99세,2016,90,15,75,20,90,15,75,20
36310, 담양군,100001, 95세,2016,29,7,22,31.8,29,7,22,31.8
36310, 담양군,100002, 96세,2016,17,X,16,6.3,17,X,16,6.3
36310, 담양군,100003, 97세,2016,23,X,21,9.5,23,X,21,9.5
36310, 담양군,100004, 98세,2016,16,5,11,45.5,16,5,11,45.5
36310, 담양군,100005, 99세,2016,5,X,5,0,5,X,5,0
36310, 담양군,101,100세이상,2016,6,X,6,0,6,X,6,0
36310, 담양군,102,15세미만,2016,3776,1931,1845,104.7,3767,1927,1840,104.7
36310, 담양군,103,15~64세,2016,27267,14586,12681,115,26086,13953,12133,115
36310, 담양군,104,65세이상,2016,12476,4965,7511,66.1,12449,4954,7495,66.1
36310, 담양군,086,85세이상,2016,1356,360,996,36.1,1355,360,995,36.2
36310, 담양군,126,평균연령,2016,48.9,46.4,51.3,,49.3,46.8,51.8,
36310, 담양군,127,중위연령,2016,52.2,49.1,55.3,,53,49.9,55.9,
36320, 곡성군,000,합계,2016,28718,13938,14780,94.3,28256,13712,14544,94.3
36320, 곡성군,005,0~4세,2016,682,350,332,105.4,680,349,331,105.4
36320, 곡성군,005001, 0세,2016,141,66,75,88,140,65,75,86.7
36320, 곡성군,005002, 1세,2016,134,62,72,86.1,134,62,72,86.1
36320, 곡성군,005003, 2세,2016,124,66,58,113.8,124,66,58,113.8
36320, 곡성군,005004, 3세,2016,138,73,65,112.3,137,73,64,114.1
36320, 곡성군,005005, 4세,2016,145,83,62,133.9,145,83,62,133.9
36320, 곡성군,010,5~9세,2016,775,403,372,108.3,774,402,372,108.1
36320, 곡성군,010001, 5세,2016,179,87,92,94.6,178,86,92,93.5
36320, 곡성군,010002, 6세,2016,133,62,71,87.3,133,62,71,87.3
36320, 곡성군,010003, 7세,2016,142,84,58,144.8,142,84,58,144.8
36320, 곡성군,010004, 8세,2016,159,94,65,144.6,159,94,65,144.6
36320, 곡성군,010005, 9세,2016,162,76,86,88.4,162,76,86,88.4
36320, 곡성군,015,10~14세,2016,890,470,420,111.9,890,470,420,111.9
36320, 곡성군,015001, 10세,2016,162,89,73,121.9,162,89,73,121.9
36320, 곡성군,015002, 11세,2016,168,87,81,107.4,168,87,81,107.4
36320, 곡성군,015003, 12세,2016,172,91,81,112.3,172,91,81,112.3
36320, 곡성군,015004, 13세,2016,185,98,87,112.6,185,98,87,112.6
36320, 곡성군,015005, 14세,2016,203,105,98,107.1,203,105,98,107.1
36320, 곡성군,020,15~19세,2016,2055,1092,963,113.4,2048,1087,961,113.1
36320, 곡성군,020001, 15세,2016,270,133,137,97.1,270,133,137,97.1
36320, 곡성군,020002, 16세,2016,426,200,226,88.5,425,199,226,88.1
36320, 곡성군,020003, 17세,2016,350,169,181,93.4,350,169,181,93.4
36320, 곡성군,020004, 18세,2016,399,218,181,120.4,398,217,181,119.9
36320, 곡성군,020005, 19세,2016,610,372,238,156.3,605,369,236,156.4
36320, 곡성군,025,20~24세,2016,1884,1061,823,128.9,1806,1017,789,128.9
36320, 곡성군,025001, 20세,2016,535,315,220,143.2,521,306,215,142.3
36320, 곡성군,025002, 21세,2016,417,224,193,116.1,404,218,186,117.2
36320, 곡성군,025003, 22세,2016,330,175,155,112.9,316,167,149,112.1
36320, 곡성군,025004, 23세,2016,317,177,140,126.4,298,165,133,124.1
36320, 곡성군,025005, 24세,2016,285,170,115,147.8,267,161,106,151.9
36320, 곡성군,030,25~29세,2016,1038,575,463,124.2,939,527,412,127.9
36320, 곡성군,030001, 25세,2016,250,138,112,123.2,234,127,107,118.7
36320, 곡성군,030002, 26세,2016,237,146,91,160.4,213,137,76,180.3
36320, 곡성군,030003, 27세,2016,175,92,83,110.8,156,82,74,110.8
36320, 곡성군,030004, 28세,2016,187,100,87,114.9,166,91,75,121.3
36320, 곡성군,030005, 29세,2016,189,99,90,110,170,90,80,112.5
36320, 곡성군,035,30~34세,2016,960,524,436,120.2,905,495,410,120.7
36320, 곡성군,035001, 30세,2016,172,94,78,120.5,159,89,70,127.1
36320, 곡성군,035002, 31세,2016,176,100,76,131.6,171,97,74,131.1
36320, 곡성군,035003, 32세,2016,188,92,96,95.8,177,88,89,98.9
36320, 곡성군,035004, 33세,2016,215,120,95,126.3,202,111,91,122
36320, 곡성군,035005, 34세,2016,209,118,91,129.7,196,110,86,127.9
36320, 곡성군,040,35~39세,2016,1162,633,529,119.7,1124,609,515,118.3
36320, 곡성군,040001, 35세,2016,230,127,103,123.3,219,119,100,119
36320, 곡성군,040002, 36세,2016,224,125,99,126.3,215,121,94,128.7
36320, 곡성군,040003, 37세,2016,223,112,111,100.9,216,107,109,98.2
36320, 곡성군,040004, 38세,2016,231,142,89,159.6,226,138,88,156.8
36320, 곡성군,040005, 39세,2016,254,127,127,100,248,124,124,100
36320, 곡성군,045,40~44세,2016,1567,884,683,129.4,1517,859,658,130.5
36320, 곡성군,045001, 40세,2016,267,154,113,136.3,255,148,107,138.3
36320, 곡성군,045002, 41세,2016,292,150,142,105.6,288,148,140,105.7
36320, 곡성군,045003, 42세,2016,338,184,154,119.5,324,176,148,118.9
36320, 곡성군,045004, 43세,2016,317,191,126,151.6,308,187,121,154.5
36320, 곡성군,045005, 44세,2016,353,205,148,138.5,342,200,142,140.8
36320, 곡성군,050,45~49세,2016,1860,1020,840,121.4,1818,1009,809,124.7
36320, 곡성군,050001, 45세,2016,363,178,185,96.2,356,176,180,97.8
36320, 곡성군,050002, 46세,2016,367,204,163,125.2,355,202,153,132
36320, 곡성군,050003, 47세,2016,385,216,169,127.8,378,213,165,129.1
36320, 곡성군,050004, 48세,2016,378,207,171,121.1,371,205,166,123.5
36320, 곡성군,050005, 49세,2016,367,215,152,141.4,358,213,145,146.9
36320, 곡성군,055,50~54세,2016,2057,1095,962,113.8,2020,1079,941,114.7
36320, 곡성군,055001, 50세,2016,397,215,182,118.1,388,210,178,118
36320, 곡성군,055002, 51세,2016,410,234,176,133,403,231,172,134.3
36320, 곡성군,055003, 52세,2016,390,198,192,103.1,383,195,188,103.7
36320, 곡성군,055004, 53세,2016,415,219,196,111.7,406,215,191,112.6
36320, 곡성군,055005, 54세,2016,445,229,216,106,440,228,212,107.5
36320, 곡성군,060,55~59세,2016,2514,1322,1192,110.9,2488,1313,1175,111.7
36320, 곡성군,060001, 55세,2016,505,258,247,104.5,502,257,245,104.9
36320, 곡성군,060002, 56세,2016,543,282,261,108,537,279,258,108.1
36320, 곡성군,060003, 57세,2016,524,264,260,101.5,514,261,253,103.2
36320, 곡성군,060004, 58세,2016,477,270,207,130.4,474,270,204,132.4
36320, 곡성군,060005, 59세,2016,465,248,217,114.3,461,246,215,114.4
36320, 곡성군,065,60~64세,2016,1972,961,1011,95.1,1954,955,999,95.6
36320, 곡성군,065001, 60세,2016,366,182,184,98.9,363,181,182,99.5
36320, 곡성군,065002, 61세,2016,446,218,228,95.6,441,215,226,95.1
36320, 곡성군,065003, 62세,2016,384,180,204,88.2,379,179,200,89.5
36320, 곡성군,065004, 63세,2016,348,178,170,104.7,346,178,168,106
36320, 곡성군,065005, 64세,2016,428,203,225,90.2,425,202,223,90.6
36320, 곡성군,070,65~69세,2016,2098,983,1115,88.2,2092,979,1113,88
36320, 곡성군,070001, 65세,2016,384,174,210,82.9,384,174,210,82.9
36320, 곡성군,070002, 66세,2016,399,196,203,96.6,398,195,203,96.1
36320, 곡성군,070003, 67세,2016,426,208,218,95.4,424,206,218,94.5
36320, 곡성군,070004, 68세,2016,436,195,241,80.9,434,194,240,80.8
36320, 곡성군,070005, 69세,2016,453,210,243,86.4,452,210,242,86.8
36320, 곡성군,075,70~74세,2016,2070,837,1233,67.9,2069,836,1233,67.8
36320, 곡성군,075001, 70세,2016,363,155,208,74.5,363,155,208,74.5
36320, 곡성군,075002, 71세,2016,338,134,204,65.7,337,133,204,65.2
36320, 곡성군,075003, 72세,2016,345,141,204,69.1,345,141,204,69.1
36320, 곡성군,075004, 73세,2016,416,171,245,69.8,416,171,245,69.8
36320, 곡성군,075005, 74세,2016,608,236,372,63.4,608,236,372,63.4
36320, 곡성군,080,75~79세,2016,2375,897,1478,60.7,2373,895,1478,60.6
36320, 곡성군,080001, 75세,2016,502,191,311,61.4,501,190,311,61.1
36320, 곡성군,080002, 76세,2016,471,171,300,57,470,170,300,56.7
36320, 곡성군,080003, 77세,2016,488,185,303,61.1,488,185,303,61.1
36320, 곡성군,080004, 78세,2016,459,176,283,62.2,459,176,283,62.2
36320, 곡성군,080005, 79세,2016,455,174,281,61.9,455,174,281,61.9
36320, 곡성군,085,80~84세,2016,1697,568,1129,50.3,1697,568,1129,50.3
36320, 곡성군,085001, 80세,2016,407,137,270,50.7,407,137,270,50.7
36320, 곡성군,085002, 81세,2016,418,134,284,47.2,418,134,284,47.2
36320, 곡성군,085003, 82세,2016,349,132,217,60.8,349,132,217,60.8
36320, 곡성군,085004, 83세,2016,257,80,177,45.2,257,80,177,45.2
36320, 곡성군,085005, 84세,2016,266,85,181,47,266,85,181,47
36320, 곡성군,090,85~89세,2016,769,195,574,34,769,195,574,34
36320, 곡성군,090001, 85세,2016,210,46,164,28,210,46,164,28
36320, 곡성군,090002, 86세,2016,191,53,138,38.4,191,53,138,38.4
36320, 곡성군,090003, 87세,2016,153,46,107,43,153,46,107,43
36320, 곡성군,090004, 88세,2016,127,22,105,21,127,22,105,21
36320, 곡성군,090005, 89세,2016,88,28,60,46.7,88,28,60,46.7
36320, 곡성군,095,90~94세,2016,244,63,181,34.8,244,63,181,34.8
36320, 곡성군,095001, 90세,2016,86,21,65,32.3,86,21,65,32.3
36320, 곡성군,095002, 91세,2016,46,15,31,48.4,46,15,31,48.4
36320, 곡성군,095003, 92세,2016,35,11,24,45.8,35,11,24,45.8
36320, 곡성군,095004, 93세,2016,50,10,40,25,50,10,40,25
36320, 곡성군,095005, 94세,2016,27,6,21,28.6,27,6,21,28.6
36320, 곡성군,100,95~99세,2016,43,5,38,13.2,43,5,38,13.2
36320, 곡성군,100001, 95세,2016,15,X,14,7.1,15,X,14,7.1
36320, 곡성군,100002, 96세,2016,12,X,9,33.3,12,X,9,33.3
36320, 곡성군,100003, 97세,2016,7,X,7,0,7,X,7,0
36320, 곡성군,100004, 98세,2016,5,X,5,0,5,X,5,0
36320, 곡성군,100005, 99세,2016,X,X,X,33.3,X,X,X,33.3
36320, 곡성군,101,100세이상,2016,6,X,6,0,6,X,6,0
36320, 곡성군,102,15세미만,2016,2347,1223,1124,108.8,2344,1221,1123,108.7
36320, 곡성군,103,15~64세,2016,17069,9167,7902,116,16619,8950,7669,116.7
36320, 곡성군,104,65세이상,2016,9302,3548,5754,61.7,9293,3541,5752,61.6
36320, 곡성군,086,85세이상,2016,1062,263,799,32.9,1062,263,799,32.9
36320, 곡성군,126,평균연령,2016,50.2,47.1,53.1,,50.4,47.3,53.4,
36320, 곡성군,127,중위연령,2016,53.7,49.8,57.2,,54.1,50.2,57.6,
36330, 구례군,000,합계,2016,24278,11718,12560,93.3,24005,11625,12380,93.9
36330, 구례군,005,0~4세,2016,706,342,364,94,705,342,363,94.2
36330, 구례군,005001, 0세,2016,141,66,75,88,141,66,75,88
36330, 구례군,005002, 1세,2016,131,65,66,98.5,131,65,66,98.5
36330, 구례군,005003, 2세,2016,119,62,57,108.8,118,62,56,110.7
36330, 구례군,005004, 3세,2016,161,80,81,98.8,161,80,81,98.8
36330, 구례군,005005, 4세,2016,154,69,85,81.2,154,69,85,81.2
36330, 구례군,010,5~9세,2016,777,418,359,116.4,775,417,358,116.5
36330, 구례군,010001, 5세,2016,165,84,81,103.7,165,84,81,103.7
36330, 구례군,010002, 6세,2016,138,75,63,119,138,75,63,119
36330, 구례군,010003, 7세,2016,147,82,65,126.2,146,81,65,124.6
36330, 구례군,010004, 8세,2016,158,91,67,135.8,157,91,66,137.9
36330, 구례군,010005, 9세,2016,169,86,83,103.6,169,86,83,103.6
36330, 구례군,015,10~14세,2016,843,442,401,110.2,841,440,401,109.7
36330, 구례군,015001, 10세,2016,154,74,80,92.5,154,74,80,92.5
36330, 구례군,015002, 11세,2016,161,84,77,109.1,161,84,77,109.1
36330, 구례군,015003, 12세,2016,158,88,70,125.7,156,86,70,122.9
36330, 구례군,015004, 13세,2016,179,93,86,108.1,179,93,86,108.1
36330, 구례군,015005, 14세,2016,191,103,88,117,191,103,88,117
36330, 구례군,020,15~19세,2016,962,502,460,109.1,961,501,460,108.9
36330, 구례군,020001, 15세,2016,225,114,111,102.7,225,114,111,102.7
36330, 구례군,020002, 16세,2016,225,109,116,94,225,109,116,94
36330, 구례군,020003, 17세,2016,205,115,90,127.8,205,115,90,127.8
36330, 구례군,020004, 18세,2016,181,85,96,88.5,181,85,96,88.5
36330, 구례군,020005, 19세,2016,126,79,47,168.1,125,78,47,166
36330, 구례군,025,20~24세,2016,944,555,389,142.7,912,539,373,144.5
36330, 구례군,025001, 20세,2016,190,130,60,216.7,185,126,59,213.6
36330, 구례군,025002, 21세,2016,219,143,76,188.2,210,137,73,187.7
36330, 구례군,025003, 22세,2016,195,111,84,132.1,194,111,83,133.7
36330, 구례군,025004, 23세,2016,172,87,85,102.4,162,85,77,110.4
36330, 구례군,025005, 24세,2016,168,84,84,100,161,80,81,98.8
36330, 구례군,030,25~29세,2016,790,408,382,106.8,734,397,337,117.8
36330, 구례군,030001, 25세,2016,156,67,89,75.3,145,64,81,79
36330, 구례군,030002, 26세,2016,162,99,63,157.1,148,96,52,184.6
36330, 구례군,030003, 27세,2016,155,86,69,124.6,148,84,64,131.3
36330, 구례군,030004, 28세,2016,146,64,82,78,135,64,71,90.1
36330, 구례군,030005, 29세,2016,171,92,79,116.5,158,89,69,129
36330, 구례군,035,30~34세,2016,950,494,456,108.3,907,485,422,114.9
36330, 구례군,035001, 30세,2016,166,74,92,80.4,154,69,85,81.2
36330, 구례군,035002, 31세,2016,169,86,83,103.6,161,86,75,114.7
36330, 구례군,035003, 32세,2016,165,89,76,117.1,155,87,68,127.9
36330, 구례군,035004, 33세,2016,212,116,96,120.8,205,116,89,130.3
36330, 구례군,035005, 34세,2016,238,129,109,118.3,232,127,105,121
36330, 구례군,040,35~39세,2016,1120,613,507,120.9,1103,607,496,122.4
36330, 구례군,040001, 35세,2016,210,127,83,153,206,126,80,157.5
36330, 구례군,040002, 36세,2016,237,126,111,113.5,230,123,107,115
36330, 구례군,040003, 37세,2016,225,115,110,104.5,222,114,108,105.6
36330, 구례군,040004, 38세,2016,232,130,102,127.5,231,130,101,128.7
36330, 구례군,040005, 39세,2016,216,115,101,113.9,214,114,100,114
36330, 구례군,045,40~44세,2016,1369,734,635,115.6,1351,728,623,116.9
36330, 구례군,045001, 40세,2016,228,113,115,98.3,226,113,113,100
36330, 구례군,045002, 41세,2016,241,126,115,109.6,239,125,114,109.6
36330, 구례군,045003, 42세,2016,295,165,130,126.9,290,163,127,128.3
36330, 구례군,045004, 43세,2016,315,173,142,121.8,312,172,140,122.9
36330, 구례군,045005, 44세,2016,290,157,133,118,284,155,129,120.2
36330, 구례군,050,45~49세,2016,1847,1050,797,131.7,1822,1041,781,133.3
36330, 구례군,050001, 45세,2016,338,210,128,164.1,333,207,126,164.3
36330, 구례군,050002, 46세,2016,343,187,156,119.9,340,185,155,119.4
36330, 구례군,050003, 47세,2016,404,224,180,124.4,400,223,177,126
36330, 구례군,050004, 48세,2016,376,215,161,133.5,370,214,156,137.2
36330, 구례군,050005, 49세,2016,386,214,172,124.4,379,212,167,126.9
36330, 구례군,055,50~54세,2016,1966,1050,916,114.6,1932,1040,892,116.6
36330, 구례군,055001, 50세,2016,384,205,179,114.5,376,203,173,117.3
36330, 구례군,055002, 51세,2016,392,207,185,111.9,385,205,180,113.9
36330, 구례군,055003, 52세,2016,367,200,167,119.8,364,198,166,119.3
36330, 구례군,055004, 53세,2016,374,201,173,116.2,366,198,168,117.9
36330, 구례군,055005, 54세,2016,449,237,212,111.8,441,236,205,115.1
36330, 구례군,060,55~59세,2016,2369,1188,1181,100.6,2345,1175,1170,100.4
36330, 구례군,060001, 55세,2016,508,261,247,105.7,503,260,243,107
36330, 구례군,060002, 56세,2016,536,282,254,111,529,276,253,109.1
36330, 구례군,060003, 57세,2016,487,240,247,97.2,484,239,245,97.6
36330, 구례군,060004, 58세,2016,430,202,228,88.6,426,200,226,88.5
36330, 구례군,060005, 59세,2016,408,203,205,99,403,200,203,98.5
36330, 구례군,065,60~64세,2016,1889,914,975,93.7,1880,910,970,93.8
36330, 구례군,065001, 60세,2016,370,176,194,90.7,367,175,192,91.1
36330, 구례군,065002, 61세,2016,415,219,196,111.7,414,218,196,111.2
36330, 구례군,065003, 62세,2016,395,182,213,85.4,391,180,211,85.3
36330, 구례군,065004, 63세,2016,311,140,171,81.9,310,140,170,82.4
36330, 구례군,065005, 64세,2016,398,197,201,98,398,197,201,98
36330, 구례군,070,65~69세,2016,1817,840,977,86,1811,837,974,85.9
36330, 구례군,070001, 65세,2016,356,165,191,86.4,355,164,191,85.9
36330, 구례군,070002, 66세,2016,360,172,188,91.5,358,172,186,92.5
36330, 구례군,070003, 67세,2016,363,169,194,87.1,362,168,194,86.6
36330, 구례군,070004, 68세,2016,336,162,174,93.1,334,161,173,93.1
36330, 구례군,070005, 69세,2016,402,172,230,74.8,402,172,230,74.8
36330, 구례군,075,70~74세,2016,1910,779,1131,68.9,1909,779,1130,68.9
36330, 구례군,075001, 70세,2016,352,164,188,87.2,352,164,188,87.2
36330, 구례군,075002, 71세,2016,311,130,181,71.8,311,130,181,71.8
36330, 구례군,075003, 72세,2016,353,150,203,73.9,353,150,203,73.9
36330, 구례군,075004, 73세,2016,361,134,227,59,360,134,226,59.3
36330, 구례군,075005, 74세,2016,533,201,332,60.5,533,201,332,60.5
36330, 구례군,080,75~79세,2016,1968,760,1208,62.9,1967,759,1208,62.8
36330, 구례군,080001, 75세,2016,439,183,256,71.5,438,182,256,71.1
36330, 구례군,080002, 76세,2016,403,144,259,55.6,403,144,259,55.6
36330, 구례군,080003, 77세,2016,418,164,254,64.6,418,164,254,64.6
36330, 구례군,080004, 78세,2016,352,144,208,69.2,352,144,208,69.2
36330, 구례군,080005, 79세,2016,356,125,231,54.1,356,125,231,54.1
36330, 구례군,085,80~84세,2016,1232,425,807,52.7,1231,424,807,52.5
36330, 구례군,085001, 80세,2016,294,106,188,56.4,294,106,188,56.4
36330, 구례군,085002, 81세,2016,289,102,187,54.5,288,101,187,54
36330, 구례군,085003, 82세,2016,252,86,166,51.8,252,86,166,51.8
36330, 구례군,085004, 83세,2016,193,59,134,44,193,59,134,44
36330, 구례군,085005, 84세,2016,204,72,132,54.5,204,72,132,54.5
36330, 구례군,090,85~89세,2016,621,160,461,34.7,621,160,461,34.7
36330, 구례군,090001, 85세,2016,134,42,92,45.7,134,42,92,45.7
36330, 구례군,090002, 86세,2016,189,49,140,35,189,49,140,35
36330, 구례군,090003, 87세,2016,118,25,93,26.9,118,25,93,26.9
36330, 구례군,090004, 88세,2016,103,25,78,32.1,103,25,78,32.1
36330, 구례군,090005, 89세,2016,77,19,58,32.8,77,19,58,32.8
36330, 구례군,095,90~94세,2016,158,37,121,30.6,158,37,121,30.6
36330, 구례군,095001, 90세,2016,47,10,37,27,47,10,37,27
36330, 구례군,095002, 91세,2016,46,13,33,39.4,46,13,33,39.4
36330, 구례군,095003, 92세,2016,24,7,17,41.2,24,7,17,41.2
36330, 구례군,095004, 93세,2016,19,X,16,18.8,19,X,16,18.8
36330, 구례군,095005, 94세,2016,22,X,18,22.2,22,X,18,22.2
36330, 구례군,100,95~99세,2016,33,6,27,22.2,33,6,27,22.2
36330, 구례군,100001, 95세,2016,13,5,8,62.5,13,5,8,62.5
36330, 구례군,100002, 96세,2016,12,X,11,9.1,12,X,11,9.1
36330, 구례군,100003, 97세,2016,X,X,X,0,X,X,X,0
36330, 구례군,100004, 98세,2016,X,X,X,0,X,X,X,0
36330, 구례군,100005, 99세,2016,X,X,X,0,X,X,X,0
36330, 구례군,101,100세이상,2016,7,X,6,16.7,7,X,6,16.7
36330, 구례군,102,15세미만,2016,2326,1202,1124,106.9,2321,1199,1122,106.9
36330, 구례군,103,15~64세,2016,14206,7508,6698,112.1,13947,7423,6524,113.8
36330, 구례군,104,65세이상,2016,7746,3008,4738,63.5,7737,3003,4734,63.4
36330, 구례군,086,85세이상,2016,819,204,615,33.2,819,204,615,33.2
36330, 구례군,126,평균연령,2016,51.2,48.4,53.7,,51.3,48.5,53.9,
36330, 구례군,127,중위연령,2016,54.7,51.5,57.5,,54.9,51.5,57.8,
36350, 고흥군,000,합계,2016,61690,29849,31841,93.7,60710,29242,31468,92.9
36350, 고흥군,005,0~4세,2016,1330,673,657,102.4,1326,669,657,101.8
36350, 고흥군,005001, 0세,2016,252,122,130,93.8,252,122,130,93.8
36350, 고흥군,005002, 1세,2016,243,116,127,91.3,243,116,127,91.3
36350, 고흥군,005003, 2세,2016,243,120,123,97.6,243,120,123,97.6
36350, 고흥군,005004, 3세,2016,271,149,122,122.1,268,146,122,119.7
36350, 고흥군,005005, 4세,2016,321,166,155,107.1,320,165,155,106.5
36350, 고흥군,010,5~9세,2016,1549,810,739,109.6,1546,809,737,109.8
36350, 고흥군,010001, 5세,2016,312,160,152,105.3,311,160,151,106
36350, 고흥군,010002, 6세,2016,299,153,146,104.8,299,153,146,104.8
36350, 고흥군,010003, 7세,2016,299,163,136,119.9,298,162,136,119.1
36350, 고흥군,010004, 8세,2016,299,151,148,102,298,151,147,102.7
36350, 고흥군,010005, 9세,2016,340,183,157,116.6,340,183,157,116.6
36350, 고흥군,015,10~14세,2016,1848,1008,840,120,1844,1006,838,120
36350, 고흥군,015001, 10세,2016,337,186,151,123.2,335,185,150,123.3
36350, 고흥군,015002, 11세,2016,354,183,171,107,352,182,170,107.1
36350, 고흥군,015003, 12세,2016,337,193,144,134,337,193,144,134
36350, 고흥군,015004, 13세,2016,373,213,160,133.1,373,213,160,133.1
36350, 고흥군,015005, 14세,2016,447,233,214,108.9,447,233,214,108.9
36350, 고흥군,020,15~19세,2016,2093,1112,981,113.4,2089,1110,979,113.4
36350, 고흥군,020001, 15세,2016,463,246,217,113.4,463,246,217,113.4
36350, 고흥군,020002, 16세,2016,434,219,215,101.9,433,218,215,101.4
36350, 고흥군,020003, 17세,2016,478,254,224,113.4,478,254,224,113.4
36350, 고흥군,020004, 18세,2016,435,217,218,99.5,434,216,218,99.1
36350, 고흥군,020005, 19세,2016,283,176,107,164.5,281,176,105,167.6
36350, 고흥군,025,20~24세,2016,2080,1284,796,161.3,1898,1152,746,154.4
36350, 고흥군,025001, 20세,2016,412,284,128,221.9,405,280,125,224
36350, 고흥군,025002, 21세,2016,436,293,143,204.9,416,283,133,212.8
36350, 고흥군,025003, 22세,2016,439,270,169,159.8,398,243,155,156.8
36350, 고흥군,025004, 23세,2016,401,226,175,129.1,344,185,159,116.4
36350, 고흥군,025005, 24세,2016,392,211,181,116.6,335,161,174,92.5
36350, 고흥군,030,25~29세,2016,1872,1020,852,119.7,1633,852,781,109.1
36350, 고흥군,030001, 25세,2016,365,184,181,101.7,307,145,162,89.5
36350, 고흥군,030002, 26세,2016,391,214,177,120.9,345,180,165,109.1
36350, 고흥군,030003, 27세,2016,335,192,143,134.3,300,165,135,122.2
36350, 고흥군,030004, 28세,2016,379,218,161,135.4,327,182,145,125.5
36350, 고흥군,030005, 29세,2016,402,212,190,111.6,354,180,174,103.4
36350, 고흥군,035,30~34세,2016,1948,1072,876,122.4,1775,961,814,118.1
36350, 고흥군,035001, 30세,2016,393,224,169,132.5,344,193,151,127.8
36350, 고흥군,035002, 31세,2016,320,173,147,117.7,283,150,133,112.8
36350, 고흥군,035003, 32세,2016,398,217,181,119.9,362,192,170,112.9
36350, 고흥군,035004, 33세,2016,378,188,190,98.9,353,172,181,95
36350, 고흥군,035005, 34세,2016,459,270,189,142.9,433,254,179,141.9
36350, 고흥군,040,35~39세,2016,2354,1268,1086,116.8,2266,1216,1050,115.8
36350, 고흥군,040001, 35세,2016,445,251,194,129.4,424,241,183,131.7
36350, 고흥군,040002, 36세,2016,468,237,231,102.6,444,221,223,99.1
36350, 고흥군,040003, 37세,2016,477,244,233,104.7,462,237,225,105.3
36350, 고흥군,040004, 38세,2016,450,265,185,143.2,440,258,182,141.8
36350, 고흥군,040005, 39세,2016,514,271,243,111.5,496,259,237,109.3
36350, 고흥군,045,40~44세,2016,3016,1770,1246,142.1,2955,1733,1222,141.8
36350, 고흥군,045001, 40세,2016,534,319,215,148.4,524,311,213,146
36350, 고흥군,045002, 41세,2016,509,288,221,130.3,491,276,215,128.4
36350, 고흥군,045003, 42세,2016,680,391,289,135.3,671,387,284,136.3
36350, 고흥군,045004, 43세,2016,647,400,247,161.9,632,390,242,161.2
36350, 고흥군,045005, 44세,2016,646,372,274,135.8,637,369,268,137.7
36350, 고흥군,050,45~49세,2016,3870,2246,1624,138.3,3801,2220,1581,140.4
36350, 고흥군,050001, 45세,2016,720,431,289,149.1,708,429,279,153.8
36350, 고흥군,050002, 46세,2016,772,436,336,129.8,766,432,334,129.3
36350, 고흥군,050003, 47세,2016,754,454,300,151.3,737,450,287,156.8
36350, 고흥군,050004, 48세,2016,880,519,361,143.8,861,507,354,143.2
36350, 고흥군,050005, 49세,2016,744,406,338,120.1,729,402,327,122.9
36350, 고흥군,055,50~54세,2016,4548,2462,2086,118,4486,2436,2050,118.8
36350, 고흥군,055001, 50세,2016,833,467,366,127.6,816,461,355,129.9
36350, 고흥군,055002, 51세,2016,871,472,399,118.3,859,466,393,118.6
36350, 고흥군,055003, 52세,2016,851,435,416,104.6,838,430,408,105.4
36350, 고흥군,055004, 53세,2016,997,548,449,122,985,543,442,122.9
36350, 고흥군,055005, 54세,2016,996,540,456,118.4,988,536,452,118.6
36350, 고흥군,060,55~59세,2016,5991,3029,2962,102.3,5954,3012,2942,102.4
36350, 고흥군,060001, 55세,2016,1170,584,586,99.7,1161,580,581,99.8
36350, 고흥군,060002, 56세,2016,1261,642,619,103.7,1252,637,615,103.6
36350, 고흥군,060003, 57세,2016,1290,666,624,106.7,1284,664,620,107.1
36350, 고흥군,060004, 58세,2016,1135,569,566,100.5,1130,568,562,101.1
36350, 고흥군,060005, 59세,2016,1135,568,567,100.2,1127,563,564,99.8
36350, 고흥군,065,60~64세,2016,5358,2593,2765,93.8,5322,2572,2750,93.5
36350, 고흥군,065001, 60세,2016,991,481,510,94.3,984,476,508,93.7
36350, 고흥군,065002, 61세,2016,1216,595,621,95.8,1207,591,616,95.9
36350, 고흥군,065003, 62세,2016,1062,515,547,94.1,1054,510,544,93.8
36350, 고흥군,065004, 63세,2016,965,457,508,90,961,454,507,89.5
36350, 고흥군,065005, 64세,2016,1124,545,579,94.1,1116,541,575,94.1
36350, 고흥군,070,65~69세,2016,5884,2841,3043,93.4,5874,2837,3037,93.4
36350, 고흥군,070001, 65세,2016,1126,569,557,102.2,1124,569,555,102.5
36350, 고흥군,070002, 66세,2016,1162,541,621,87.1,1158,539,619,87.1
36350, 고흥군,070003, 67세,2016,1151,558,593,94.1,1149,556,593,93.8
36350, 고흥군,070004, 68세,2016,1115,554,561,98.8,1114,554,560,98.9
36350, 고흥군,070005, 69세,2016,1330,619,711,87.1,1329,619,710,87.2
36350, 고흥군,075,70~74세,2016,5418,2362,3056,77.3,5414,2360,3054,77.3
36350, 고흥군,075001, 70세,2016,863,383,480,79.8,862,382,480,79.6
36350, 고흥군,075002, 71세,2016,990,413,577,71.6,990,413,577,71.6
36350, 고흥군,075003, 72세,2016,952,420,532,78.9,952,420,532,78.9
36350, 고흥군,075004, 73세,2016,1140,497,643,77.3,1140,497,643,77.3
36350, 고흥군,075005, 74세,2016,1473,649,824,78.8,1470,648,822,78.8
36350, 고흥군,080,75~79세,2016,5753,2211,3542,62.4,5751,2210,3541,62.4
36350, 고흥군,080001, 75세,2016,1273,534,739,72.3,1273,534,739,72.3
36350, 고흥군,080002, 76세,2016,1222,475,747,63.6,1222,475,747,63.6
36350, 고흥군,080003, 77세,2016,1190,437,753,58,1190,437,753,58
36350, 고흥군,080004, 78세,2016,986,364,622,58.5,986,364,622,58.5
36350, 고흥군,080005, 79세,2016,1082,401,681,58.9,1080,400,680,58.8
36350, 고흥군,085,80~84세,2016,4050,1373,2677,51.3,4049,1372,2677,51.3
36350, 고흥군,085001, 80세,2016,941,359,582,61.7,940,358,582,61.5
36350, 고흥군,085002, 81세,2016,848,306,542,56.5,848,306,542,56.5
36350, 고흥군,085003, 82세,2016,820,260,560,46.4,820,260,560,46.4
36350, 고흥군,085004, 83세,2016,763,251,512,49,763,251,512,49
36350, 고흥군,085005, 84세,2016,678,197,481,41,678,197,481,41
36350, 고흥군,090,85~89세,2016,1980,565,1415,39.9,1979,565,1414,40
36350, 고흥군,090001, 85세,2016,482,132,350,37.7,481,132,349,37.8
36350, 고흥군,090002, 86세,2016,549,155,394,39.3,549,155,394,39.3
36350, 고흥군,090003, 87세,2016,473,144,329,43.8,473,144,329,43.8
36350, 고흥군,090004, 88세,2016,259,83,176,47.2,259,83,176,47.2
36350, 고흥군,090005, 89세,2016,217,51,166,30.7,217,51,166,30.7
36350, 고흥군,095,90~94세,2016,589,130,459,28.3,589,130,459,28.3
36350, 고흥군,095001, 90세,2016,159,37,122,30.3,159,37,122,30.3
36350, 고흥군,095002, 91세,2016,128,30,98,30.6,128,30,98,30.6
36350, 고흥군,095003, 92세,2016,94,23,71,32.4,94,23,71,32.4
36350, 고흥군,095004, 93세,2016,129,19,110,17.3,129,19,110,17.3
36350, 고흥군,095005, 94세,2016,79,21,58,36.2,79,21,58,36.2
36350, 고흥군,100,95~99세,2016,143,17,126,13.5,143,17,126,13.5
36350, 고흥군,100001, 95세,2016,57,9,48,18.8,57,9,48,18.8
36350, 고흥군,100002, 96세,2016,33,X,32,3.1,33,X,32,3.1
36350, 고흥군,100003, 97세,2016,26,X,24,8.3,26,X,24,8.3
36350, 고흥군,100004, 98세,2016,17,X,15,13.3,17,X,15,13.3
36350, 고흥군,100005, 99세,2016,10,X,7,42.9,10,X,7,42.9
36350, 고흥군,101,100세이상,2016,16,X,13,23.1,16,X,13,23.1
36350, 고흥군,102,15세미만,2016,4727,2491,2236,111.4,4716,2484,2232,111.3
36350, 고흥군,103,15~64세,2016,33130,17856,15274,116.9,32179,17264,14915,115.7
36350, 고흥군,104,65세이상,2016,23833,9502,14331,66.3,23815,9494,14321,66.3
36350, 고흥군,086,85세이상,2016,2728,715,2013,35.5,2727,715,2012,35.5
36350, 고흥군,126,평균연령,2016,54.6,51.5,57.5,,54.9,51.9,57.7,
36350, 고흥군,127,중위연령,2016,58.5,55.3,62.1,,58.9,55.8,62.4,
36360, 보성군,000,합계,2016,40125,19257,20868,92.3,39592,19048,20544,92.7
36360, 보성군,005,0~4세,2016,1300,681,619,110,1298,680,618,110
36360, 보성군,005001, 0세,2016,243,119,124,96,243,119,124,96
36360, 보성군,005002, 1세,2016,283,148,135,109.6,283,148,135,109.6
36360, 보성군,005003, 2세,2016,263,138,125,110.4,263,138,125,110.4
36360, 보성군,005004, 3세,2016,247,131,116,112.9,246,131,115,113.9
36360, 보성군,005005, 4세,2016,264,145,119,121.8,263,144,119,121
36360, 보성군,010,5~9세,2016,1147,560,587,95.4,1143,560,583,96.1
36360, 보성군,010001, 5세,2016,286,143,143,100,286,143,143,100
36360, 보성군,010002, 6세,2016,209,99,110,90,209,99,110,90
36360, 보성군,010003, 7세,2016,197,89,108,82.4,196,89,107,83.2
36360, 보성군,010004, 8세,2016,206,93,113,82.3,205,93,112,83
36360, 보성군,010005, 9세,2016,249,136,113,120.4,247,136,111,122.5
36360, 보성군,015,10~14세,2016,1333,695,638,108.9,1332,695,637,109.1
36360, 보성군,015001, 10세,2016,223,114,109,104.6,223,114,109,104.6
36360, 보성군,015002, 11세,2016,221,111,110,100.9,221,111,110,100.9
36360, 보성군,015003, 12세,2016,242,131,111,118,242,131,111,118
36360, 보성군,015004, 13세,2016,327,179,148,120.9,327,179,148,120.9
36360, 보성군,015005, 14세,2016,320,160,160,100,319,160,159,100.6
36360, 보성군,020,15~19세,2016,1926,998,928,107.5,1912,996,916,108.7
36360, 보성군,020001, 15세,2016,403,202,201,100.5,402,202,200,101
36360, 보성군,020002, 16세,2016,480,244,236,103.4,476,244,232,105.2
36360, 보성군,020003, 17세,2016,401,216,185,116.8,395,216,179,120.7
36360, 보성군,020004, 18세,2016,376,182,194,93.8,375,181,194,93.3
36360, 보성군,020005, 19세,2016,266,154,112,137.5,264,153,111,137.8
36360, 보성군,025,20~24세,2016,1510,937,573,163.5,1412,890,522,170.5
36360, 보성군,025001, 20세,2016,313,219,94,233,307,217,90,241.1
36360, 보성군,025002, 21세,2016,313,212,101,209.9,303,208,95,218.9
36360, 보성군,025003, 22세,2016,318,194,124,156.5,301,184,117,157.3
36360, 보성군,025004, 23세,2016,266,152,114,133.3,240,136,104,130.8
36360, 보성군,025005, 24세,2016,300,160,140,114.3,261,145,116,125
36360, 보성군,030,25~29세,2016,1337,661,676,97.8,1190,604,586,103.1
36360, 보성군,030001, 25세,2016,261,126,135,93.3,238,117,121,96.7
36360, 보성군,030002, 26세,2016,284,155,129,120.2,242,134,108,124.1
36360, 보성군,030003, 27세,2016,242,127,115,110.4,214,112,102,109.8
36360, 보성군,030004, 28세,2016,248,115,133,86.5,223,109,114,95.6
36360, 보성군,030005, 29세,2016,302,138,164,84.1,273,132,141,93.6
36360, 보성군,035,30~34세,2016,1500,758,742,102.2,1427,727,700,103.9
36360, 보성군,035001, 30세,2016,302,163,139,117.3,284,154,130,118.5
36360, 보성군,035002, 31세,2016,254,123,131,93.9,242,116,126,92.1
36360, 보성군,035003, 32세,2016,274,134,140,95.7,263,132,131,100.8
36360, 보성군,035004, 33세,2016,304,158,146,108.2,292,153,139,110.1
36360, 보성군,035005, 34세,2016,366,180,186,96.8,346,172,174,98.9
36360, 보성군,040,35~39세,2016,1649,888,761,116.7,1610,875,735,119
36360, 보성군,040001, 35세,2016,308,166,142,116.9,298,163,135,120.7
36360, 보성군,040002, 36세,2016,333,171,162,105.6,329,170,159,106.9
36360, 보성군,040003, 37세,2016,299,161,138,116.7,289,156,133,117.3
36360, 보성군,040004, 38세,2016,344,191,153,124.8,334,188,146,128.8
36360, 보성군,040005, 39세,2016,365,199,166,119.9,360,198,162,122.2
36360, 보성군,045,40~44세,2016,1933,1130,803,140.7,1903,1117,786,142.1
36360, 보성군,045001, 40세,2016,343,194,149,130.2,337,191,146,130.8
36360, 보성군,045002, 41세,2016,282,165,117,141,278,162,116,139.7
36360, 보성군,045003, 42세,2016,429,245,184,133.2,422,244,178,137.1
36360, 보성군,045004, 43세,2016,427,271,156,173.7,421,268,153,175.2
36360, 보성군,045005, 44세,2016,452,255,197,129.4,445,252,193,130.6
36360, 보성군,050,45~49세,2016,2584,1463,1121,130.5,2547,1445,1102,131.1
36360, 보성군,050001, 45세,2016,478,271,207,130.9,474,269,205,131.2
36360, 보성군,050002, 46세,2016,490,285,205,139,485,282,203,138.9
36360, 보성군,050003, 47세,2016,512,289,223,129.6,501,282,219,128.8
36360, 보성군,050004, 48세,2016,582,331,251,131.9,574,330,244,135.2
36360, 보성군,050005, 49세,2016,522,287,235,122.1,513,282,231,122.1
36360, 보성군,055,50~54세,2016,2946,1586,1360,116.6,2911,1575,1336,117.9
36360, 보성군,055001, 50세,2016,545,327,218,150,540,324,216,150
36360, 보성군,055002, 51세,2016,549,284,265,107.2,537,282,255,110.6
36360, 보성군,055003, 52세,2016,588,327,261,125.3,583,325,258,126
36360, 보성군,055004, 53세,2016,628,321,307,104.6,618,318,300,106
36360, 보성군,055005, 54세,2016,636,327,309,105.8,633,326,307,106.2
36360, 보성군,060,55~59세,2016,3623,1835,1788,102.6,3602,1830,1772,103.3
36360, 보성군,060001, 55세,2016,665,341,324,105.2,660,340,320,106.3
36360, 보성군,060002, 56세,2016,718,353,365,96.7,713,353,360,98.1
36360, 보성군,060003, 57세,2016,788,403,385,104.7,785,402,383,105
36360, 보성군,060004, 58세,2016,700,355,345,102.9,698,354,344,102.9
36360, 보성군,060005, 59세,2016,752,383,369,103.8,746,381,365,104.4
36360, 보성군,065,60~64세,2016,3154,1531,1623,94.3,3137,1525,1612,94.6
36360, 보성군,065001, 60세,2016,617,310,307,101,611,308,303,101.7
36360, 보성군,065002, 61세,2016,717,364,353,103.1,713,363,350,103.7
36360, 보성군,065003, 62세,2016,605,287,318,90.3,601,285,316,90.2
36360, 보성군,065004, 63세,2016,553,255,298,85.6,551,255,296,86.1
36360, 보성군,065005, 64세,2016,662,315,347,90.8,661,314,347,90.5
36360, 보성군,070,65~69세,2016,3324,1568,1756,89.3,3311,1563,1748,89.4
36360, 보성군,070001, 65세,2016,642,309,333,92.8,640,308,332,92.8
36360, 보성군,070002, 66세,2016,633,289,344,84,630,288,342,84.2
36360, 보성군,070003, 67세,2016,667,314,353,89,665,313,352,88.9
36360, 보성군,070004, 68세,2016,662,325,337,96.4,660,325,335,97
36360, 보성군,070005, 69세,2016,720,331,389,85.1,716,329,387,85
36360, 보성군,075,70~74세,2016,3216,1333,1883,70.8,3215,1333,1882,70.8
36360, 보성군,075001, 70세,2016,514,247,267,92.5,514,247,267,92.5
36360, 보성군,075002, 71세,2016,547,227,320,70.9,547,227,320,70.9
36360, 보성군,075003, 72세,2016,527,225,302,74.5,527,225,302,74.5
36360, 보성군,075004, 73세,2016,718,272,446,61,718,272,446,61
36360, 보성군,075005, 74세,2016,910,362,548,66.1,909,362,547,66.2
36360, 보성군,080,75~79세,2016,3572,1382,2190,63.1,3571,1382,2189,63.1
36360, 보성군,080001, 75세,2016,765,307,458,67,765,307,458,67
36360, 보성군,080002, 76세,2016,712,273,439,62.2,712,273,439,62.2
36360, 보성군,080003, 77세,2016,756,311,445,69.9,756,311,445,69.9
36360, 보성군,080004, 78세,2016,689,259,430,60.2,688,259,429,60.4
36360, 보성군,080005, 79세,2016,650,232,418,55.5,650,232,418,55.5
36360, 보성군,085,80~84세,2016,2482,820,1662,49.3,2482,820,1662,49.3
36360, 보성군,085001, 80세,2016,574,201,373,53.9,574,201,373,53.9
36360, 보성군,085002, 81세,2016,555,186,369,50.4,555,186,369,50.4
36360, 보성군,085003, 82세,2016,506,160,346,46.2,506,160,346,46.2
36360, 보성군,085004, 83세,2016,419,149,270,55.2,419,149,270,55.2
36360, 보성군,085005, 84세,2016,428,124,304,40.8,428,124,304,40.8
36360, 보성군,090,85~89세,2016,1177,324,853,38,1177,324,853,38
36360, 보성군,090001, 85세,2016,318,91,227,40.1,318,91,227,40.1
36360, 보성군,090002, 86세,2016,335,91,244,37.3,335,91,244,37.3
36360, 보성군,090003, 87세,2016,210,58,152,38.2,210,58,152,38.2
36360, 보성군,090004, 88세,2016,197,49,148,33.1,197,49,148,33.1
36360, 보성군,090005, 89세,2016,117,35,82,42.7,117,35,82,42.7
36360, 보성군,095,90~94세,2016,328,85,243,35,328,85,243,35
36360, 보성군,095001, 90세,2016,99,30,69,43.5,99,30,69,43.5
36360, 보성군,095002, 91세,2016,63,14,49,28.6,63,14,49,28.6
36360, 보성군,095003, 92세,2016,56,16,40,40,56,16,40,40
36360, 보성군,095004, 93세,2016,63,17,46,37,63,17,46,37
36360, 보성군,095005, 94세,2016,47,8,39,20.5,47,8,39,20.5
36360, 보성군,100,95~99세,2016,68,20,48,41.7,68,20,48,41.7
36360, 보성군,100001, 95세,2016,14,7,7,100,14,7,7,100
36360, 보성군,100002, 96세,2016,23,5,18,27.8,23,5,18,27.8
36360, 보성군,100003, 97세,2016,9,X,7,28.6,9,X,7,28.6
36360, 보성군,100004, 98세,2016,11,X,7,57.1,11,X,7,57.1
36360, 보성군,100005, 99세,2016,11,X,9,22.2,11,X,9,22.2
36360, 보성군,101,100세이상,2016,16,X,14,14.3,16,X,14,14.3
36360, 보성군,102,15세미만,2016,3780,1936,1844,105,3773,1935,1838,105.3
36360, 보성군,103,15~64세,2016,22162,11787,10375,113.6,21651,11584,10067,115.1
36360, 보성군,104,65세이상,2016,14183,5534,8649,64,14168,5529,8639,64
36360, 보성군,086,85세이상,2016,1589,431,1158,37.2,1589,431,1158,37.2
36360, 보성군,126,평균연령,2016,52.1,49.2,54.8,,52.3,49.3,55.1,
36360, 보성군,127,중위연령,2016,56.3,52.8,59.6,,56.6,53,59.9,
36370, 화순군,000,합계,2016,61018,29499,31519,93.6,59971,28997,30974,93.6
36370, 화순군,005,0~4세,2016,1951,976,975,100.1,1944,971,973,99.8
36370, 화순군,005001, 0세,2016,321,162,159,101.9,320,162,158,102.5
36370, 화순군,005002, 1세,2016,368,180,188,95.7,366,178,188,94.7
36370, 화순군,005003, 2세,2016,384,184,200,92,382,183,199,92
36370, 화순군,005004, 3세,2016,416,223,193,115.5,416,223,193,115.5
36370, 화순군,005005, 4세,2016,462,227,235,96.6,460,225,235,95.7
36370, 화순군,010,5~9세,2016,2431,1261,1170,107.8,2421,1255,1166,107.6
36370, 화순군,010001, 5세,2016,486,252,234,107.7,484,252,232,108.6
36370, 화순군,010002, 6세,2016,441,228,213,107,438,225,213,105.6
36370, 화순군,010003, 7세,2016,480,253,227,111.5,478,252,226,111.5
36370, 화순군,010004, 8세,2016,476,250,226,110.6,474,248,226,109.7
36370, 화순군,010005, 9세,2016,548,278,270,103,547,278,269,103.3
36370, 화순군,015,10~14세,2016,2832,1464,1368,107,2827,1459,1368,106.7
36370, 화순군,015001, 10세,2016,500,264,236,111.9,500,264,236,111.9
36370, 화순군,015002, 11세,2016,499,265,234,113.2,498,264,234,112.8
36370, 화순군,015003, 12세,2016,604,323,281,114.9,603,322,281,114.6
36370, 화순군,015004, 13세,2016,586,304,282,107.8,585,303,282,107.4
36370, 화순군,015005, 14세,2016,643,308,335,91.9,641,306,335,91.3
36370, 화순군,020,15~19세,2016,3957,2081,1876,110.9,3941,2072,1869,110.9
36370, 화순군,020001, 15세,2016,754,370,384,96.4,753,370,383,96.6
36370, 화순군,020002, 16세,2016,941,516,425,121.4,940,516,424,121.7
36370, 화순군,020003, 17세,2016,862,435,427,101.9,861,434,427,101.6
36370, 화순군,020004, 18세,2016,767,411,356,115.4,765,410,355,115.5
36370, 화순군,020005, 19세,2016,633,349,284,122.9,622,342,280,122.1
36370, 화순군,025,20~24세,2016,3234,1769,1465,120.8,3053,1677,1376,121.9
36370, 화순군,025001, 20세,2016,689,403,286,140.9,665,389,276,140.9
36370, 화순군,025002, 21세,2016,637,351,286,122.7,614,340,274,124.1
36370, 화순군,025003, 22세,2016,630,356,274,129.9,601,346,255,135.7
36370, 화순군,025004, 23세,2016,651,333,318,104.7,592,303,289,104.8
36370, 화순군,025005, 24세,2016,627,326,301,108.3,581,299,282,106
36370, 화순군,030,25~29세,2016,2472,1273,1199,106.2,2255,1161,1094,106.1
36370, 화순군,030001, 25세,2016,548,278,270,103,495,251,244,102.9
36370, 화순군,030002, 26세,2016,532,288,244,118,489,264,225,117.3
36370, 화순군,030003, 27세,2016,472,254,218,116.5,433,236,197,119.8
36370, 화순군,030004, 28세,2016,491,249,242,102.9,444,221,223,99.1
36370, 화순군,030005, 29세,2016,429,204,225,90.7,394,189,205,92.2
36370, 화순군,035,30~34세,2016,2574,1348,1226,110,2432,1278,1154,110.7
36370, 화순군,035001, 30세,2016,444,229,215,106.5,406,211,195,108.2
36370, 화순군,035002, 31세,2016,472,252,220,114.5,442,239,203,117.7
36370, 화순군,035003, 32세,2016,501,273,228,119.7,480,266,214,124.3
36370, 화순군,035004, 33세,2016,550,294,256,114.8,527,278,249,111.6
36370, 화순군,035005, 34세,2016,607,300,307,97.7,577,284,293,96.9
36370, 화순군,040,35~39세,2016,3280,1617,1663,97.2,3186,1566,1620,96.7
36370, 화순군,040001, 35세,2016,614,299,315,94.9,590,285,305,93.4
36370, 화순군,040002, 36세,2016,650,327,323,101.2,629,317,312,101.6
36370, 화순군,040003, 37세,2016,682,334,348,96,667,326,341,95.6
36370, 화순군,040004, 38세,2016,643,310,333,93.1,623,300,323,92.9
36370, 화순군,040005, 39세,2016,691,347,344,100.9,677,338,339,99.7
36370, 화순군,045,40~44세,2016,4190,2107,2083,101.2,4108,2064,2044,101
36370, 화순군,045001, 40세,2016,679,343,336,102.1,656,335,321,104.4
36370, 화순군,045002, 41세,2016,762,391,371,105.4,747,384,363,105.8
36370, 화순군,045003, 42세,2016,940,484,456,106.1,922,473,449,105.3
36370, 화순군,045004, 43세,2016,883,415,468,88.7,872,407,465,87.5
36370, 화순군,045005, 44세,2016,926,474,452,104.9,911,465,446,104.3
36370, 화순군,050,45~49세,2016,5236,2805,2431,115.4,5161,2777,2384,116.5
36370, 화순군,050001, 45세,2016,1069,574,495,116,1057,570,487,117
36370, 화순군,050002, 46세,2016,1049,559,490,114.1,1031,551,480,114.8
36370, 화순군,050003, 47세,2016,1029,536,493,108.7,1011,530,481,110.2
36370, 화순군,050004, 48세,2016,1072,602,470,128.1,1058,596,462,129
36370, 화순군,050005, 49세,2016,1017,534,483,110.6,1004,530,474,111.8
36370, 화순군,055,50~54세,2016,4964,2651,2313,114.6,4877,2626,2251,116.7
36370, 화순군,055001, 50세,2016,1002,542,460,117.8,982,536,446,120.2
36370, 화순군,055002, 51세,2016,970,540,430,125.6,954,535,419,127.7
36370, 화순군,055003, 52세,2016,971,520,451,115.3,947,516,431,119.7
36370, 화순군,055004, 53세,2016,1042,570,472,120.8,1022,561,461,121.7
36370, 화순군,055005, 54세,2016,979,479,500,95.8,972,478,494,96.8
36370, 화순군,060,55~59세,2016,5151,2657,2494,106.5,5079,2630,2449,107.4
36370, 화순군,060001, 55세,2016,1102,595,507,117.4,1085,588,497,118.3
36370, 화순군,060002, 56세,2016,1139,583,556,104.9,1123,576,547,105.3
36370, 화순군,060003, 57세,2016,1018,536,482,111.2,1006,532,474,112.2
36370, 화순군,060004, 58세,2016,933,464,469,98.9,920,460,460,100
36370, 화순군,060005, 59세,2016,959,479,480,99.8,945,474,471,100.6
36370, 화순군,065,60~64세,2016,3784,1866,1918,97.3,3748,1848,1900,97.3
36370, 화순군,065001, 60세,2016,747,382,365,104.7,742,378,364,103.8
36370, 화순군,065002, 61세,2016,843,436,407,107.1,834,431,403,106.9
36370, 화순군,065003, 62세,2016,713,335,378,88.6,707,334,373,89.5
36370, 화순군,065004, 63세,2016,686,337,349,96.6,681,334,347,96.3
36370, 화순군,065005, 64세,2016,795,376,419,89.7,784,371,413,89.8
36370, 화순군,070,65~69세,2016,3645,1672,1973,84.7,3634,1667,1967,84.7
36370, 화순군,070001, 65세,2016,645,305,340,89.7,642,304,338,89.9
36370, 화순군,070002, 66세,2016,712,343,369,93,709,342,367,93.2
36370, 화순군,070003, 67세,2016,731,345,386,89.4,730,344,386,89.1
36370, 화순군,070004, 68세,2016,758,334,424,78.8,755,332,423,78.5
36370, 화순군,070005, 69세,2016,799,345,454,76,798,345,453,76.2
36370, 화순군,075,70~74세,2016,3668,1442,2226,64.8,3663,1439,2224,64.7
36370, 화순군,075001, 70세,2016,579,249,330,75.5,579,249,330,75.5
36370, 화순군,075002, 71세,2016,654,242,412,58.7,652,240,412,58.3
36370, 화순군,075003, 72세,2016,630,251,379,66.2,629,251,378,66.4
36370, 화순군,075004, 73세,2016,763,296,467,63.4,762,296,466,63.5
36370, 화순군,075005, 74세,2016,1042,404,638,63.3,1041,403,638,63.2
36370, 화순군,080,75~79세,2016,3724,1344,2380,56.5,3718,1342,2376,56.5
36370, 화순군,080001, 75세,2016,830,322,508,63.4,826,322,504,63.9
36370, 화순군,080002, 76세,2016,761,268,493,54.4,761,268,493,54.4
36370, 화순군,080003, 77세,2016,758,275,483,56.9,758,275,483,56.9
36370, 화순군,080004, 78세,2016,716,240,476,50.4,714,238,476,50
36370, 화순군,080005, 79세,2016,659,239,420,56.9,659,239,420,56.9
36370, 화순군,085,80~84세,2016,2377,745,1632,45.6,2376,744,1632,45.6
36370, 화순군,085001, 80세,2016,608,211,397,53.1,608,211,397,53.1
36370, 화순군,085002, 81세,2016,560,177,383,46.2,560,177,383,46.2
36370, 화순군,085003, 82세,2016,476,150,326,46,475,149,326,45.7
36370, 화순군,085004, 83세,2016,377,105,272,38.6,377,105,272,38.6
36370, 화순군,085005, 84세,2016,356,102,254,40.2,356,102,254,40.2
36370, 화순군,090,85~89세,2016,1119,327,792,41.3,1119,327,792,41.3
36370, 화순군,090001, 85세,2016,284,80,204,39.2,284,80,204,39.2
36370, 화순군,090002, 86세,2016,313,79,234,33.8,313,79,234,33.8
36370, 화순군,090003, 87세,2016,208,72,136,52.9,208,72,136,52.9
36370, 화순군,090004, 88세,2016,163,51,112,45.5,163,51,112,45.5
36370, 화순군,090005, 89세,2016,151,45,106,42.5,151,45,106,42.5
36370, 화순군,095,90~94세,2016,348,80,268,29.9,348,80,268,29.9
36370, 화순군,095001, 90세,2016,108,29,79,36.7,108,29,79,36.7
36370, 화순군,095002, 91세,2016,79,19,60,31.7,79,19,60,31.7
36370, 화순군,095003, 92세,2016,53,17,36,47.2,53,17,36,47.2
36370, 화순군,095004, 93세,2016,77,10,67,14.9,77,10,67,14.9
36370, 화순군,095005, 94세,2016,31,5,26,19.2,31,5,26,19.2
36370, 화순군,100,95~99세,2016,71,13,58,22.4,71,13,58,22.4
36370, 화순군,100001, 95세,2016,29,7,22,31.8,29,7,22,31.8
36370, 화순군,100002, 96세,2016,16,X,12,33.3,16,X,12,33.3
36370, 화순군,100003, 97세,2016,12,X,10,20,12,X,10,20
36370, 화순군,100004, 98세,2016,9,X,9,0,9,X,9,0
36370, 화순군,100005, 99세,2016,5,X,5,0,5,X,5,0
36370, 화순군,101,100세이상,2016,10,X,9,11.1,10,X,9,11.1
36370, 화순군,102,15세미만,2016,7214,3701,3513,105.4,7192,3685,3507,105.1
36370, 화순군,103,15~64세,2016,38842,20174,18668,108.1,37840,19699,18141,108.6
36370, 화순군,104,65세이상,2016,14962,5624,9338,60.2,14939,5613,9326,60.2
36370, 화순군,086,85세이상,2016,1548,421,1127,37.4,1548,421,1127,37.4
36370, 화순군,126,평균연령,2016,46.4,44,48.6,,46.6,44.1,48.8,
36370, 화순군,127,중위연령,2016,48.4,46.5,50.7,,48.7,46.8,51,
36380, 장흥군,000,합계,2016,36481,17664,18817,93.9,35847,17403,18444,94.4
36380, 장흥군,005,0~4세,2016,1083,545,538,101.3,1083,545,538,101.3
36380, 장흥군,005001, 0세,2016,173,95,78,121.8,173,95,78,121.8
36380, 장흥군,005002, 1세,2016,224,109,115,94.8,224,109,115,94.8
36380, 장흥군,005003, 2세,2016,205,96,109,88.1,205,96,109,88.1
36380, 장흥군,005004, 3세,2016,252,123,129,95.3,252,123,129,95.3
36380, 장흥군,005005, 4세,2016,229,122,107,114,229,122,107,114
36380, 장흥군,010,5~9세,2016,1120,580,540,107.4,1117,578,539,107.2
36380, 장흥군,010001, 5세,2016,231,128,103,124.3,231,128,103,124.3
36380, 장흥군,010002, 6세,2016,204,105,99,106.1,204,105,99,106.1
36380, 장흥군,010003, 7세,2016,217,110,107,102.8,217,110,107,102.8
36380, 장흥군,010004, 8세,2016,227,111,116,95.7,224,109,115,94.8
36380, 장흥군,010005, 9세,2016,241,126,115,109.6,241,126,115,109.6
36380, 장흥군,015,10~14세,2016,1341,702,639,109.9,1340,702,638,110
36380, 장흥군,015001, 10세,2016,238,130,108,120.4,237,130,107,121.5
36380, 장흥군,015002, 11세,2016,228,121,107,113.1,228,121,107,113.1
36380, 장흥군,015003, 12세,2016,264,144,120,120,264,144,120,120
36380, 장흥군,015004, 13세,2016,291,141,150,94,291,141,150,94
36380, 장흥군,015005, 14세,2016,320,166,154,107.8,320,166,154,107.8
36380, 장흥군,020,15~19세,2016,1669,907,762,119,1662,904,758,119.3
36380, 장흥군,020001, 15세,2016,358,178,180,98.9,356,177,179,98.9
36380, 장흥군,020002, 16세,2016,370,208,162,128.4,367,206,161,128
36380, 장흥군,020003, 17세,2016,397,203,194,104.6,396,203,193,105.2
36380, 장흥군,020004, 18세,2016,328,177,151,117.2,328,177,151,117.2
36380, 장흥군,020005, 19세,2016,216,141,75,188,215,141,74,190.5
36380, 장흥군,025,20~24세,2016,1479,874,605,144.5,1399,838,561,149.4
36380, 장흥군,025001, 20세,2016,303,205,98,209.2,295,199,96,207.3
36380, 장흥군,025002, 21세,2016,323,213,110,193.6,311,206,105,196.2
36380, 장흥군,025003, 22세,2016,300,184,116,158.6,284,179,105,170.5
36380, 장흥군,025004, 23세,2016,273,138,135,102.2,247,126,121,104.1
36380, 장흥군,025005, 24세,2016,280,134,146,91.8,262,128,134,95.5
36380, 장흥군,030,25~29세,2016,1335,683,652,104.8,1191,619,572,108.2
36380, 장흥군,030001, 25세,2016,272,147,125,117.6,249,134,115,116.5
36380, 장흥군,030002, 26세,2016,273,137,136,100.7,233,119,114,104.4
36380, 장흥군,030003, 27세,2016,261,133,128,103.9,232,122,110,110.9
36380, 장흥군,030004, 28세,2016,275,139,136,102.2,245,127,118,107.6
36380, 장흥군,030005, 29세,2016,254,127,127,100,232,117,115,101.7
36380, 장흥군,035,30~34세,2016,1408,742,666,111.4,1307,696,611,113.9
36380, 장흥군,035001, 30세,2016,268,133,135,98.5,247,118,129,91.5
36380, 장흥군,035002, 31세,2016,227,114,113,100.9,212,108,104,103.8
36380, 장흥군,035003, 32세,2016,266,137,129,106.2,245,125,120,104.2
36380, 장흥군,035004, 33세,2016,292,160,132,121.2,268,154,114,135.1
36380, 장흥군,035005, 34세,2016,355,198,157,126.1,335,191,144,132.6
36380, 장흥군,040,35~39세,2016,1671,915,756,121,1604,886,718,123.4
36380, 장흥군,040001, 35세,2016,344,195,149,130.9,328,184,144,127.8
36380, 장흥군,040002, 36세,2016,374,206,168,122.6,357,198,159,124.5
36380, 장흥군,040003, 37세,2016,326,175,151,115.9,312,173,139,124.5
36380, 장흥군,040004, 38세,2016,291,148,143,103.5,282,145,137,105.8
36380, 장흥군,040005, 39세,2016,336,191,145,131.7,325,186,139,133.8
36380, 장흥군,045,40~44세,2016,1994,1071,923,116,1945,1058,887,119.3
36380, 장흥군,045001, 40세,2016,343,199,144,138.2,337,196,141,139
36380, 장흥군,045002, 41세,2016,353,188,165,113.9,340,185,155,119.4
36380, 장흥군,045003, 42세,2016,417,225,192,117.2,403,221,182,121.4
36380, 장흥군,045004, 43세,2016,441,225,216,104.2,437,224,213,105.2
36380, 장흥군,045005, 44세,2016,440,234,206,113.6,428,232,196,118.4
36380, 장흥군,050,45~49세,2016,2589,1415,1174,120.5,2543,1400,1143,122.5
36380, 장흥군,050001, 45세,2016,515,276,239,115.5,500,270,230,117.4
36380, 장흥군,050002, 46세,2016,504,284,220,129.1,493,280,213,131.5
36380, 장흥군,050003, 47세,2016,524,286,238,120.2,519,286,233,122.7
36380, 장흥군,050004, 48세,2016,502,277,225,123.1,496,275,221,124.4
36380, 장흥군,050005, 49세,2016,544,292,252,115.9,535,289,246,117.5
36380, 장흥군,055,50~54세,2016,2921,1557,1364,114.1,2872,1546,1326,116.6
36380, 장흥군,055001, 50세,2016,564,314,250,125.6,553,313,240,130.4
36380, 장흥군,055002, 51세,2016,589,308,281,109.6,584,307,277,110.8
36380, 장흥군,055003, 52세,2016,556,305,251,121.5,545,302,243,124.3
36380, 장흥군,055004, 53세,2016,599,316,283,111.7,582,312,270,115.6
36380, 장흥군,055005, 54세,2016,613,314,299,105,608,312,296,105.4
36380, 장흥군,060,55~59세,2016,3428,1739,1689,103,3385,1719,1666,103.2
36380, 장흥군,060001, 55세,2016,689,342,347,98.6,681,339,342,99.1
36380, 장흥군,060002, 56세,2016,732,384,348,110.3,719,379,340,111.5
36380, 장흥군,060003, 57세,2016,697,353,344,102.6,690,350,340,102.9
36380, 장흥군,060004, 58세,2016,665,328,337,97.3,656,323,333,97
36380, 장흥군,060005, 59세,2016,645,332,313,106.1,639,328,311,105.5
36380, 장흥군,065,60~64세,2016,2795,1362,1433,95,2773,1352,1421,95.1
36380, 장흥군,065001, 60세,2016,598,298,300,99.3,594,296,298,99.3
36380, 장흥군,065002, 61세,2016,627,313,314,99.7,620,309,311,99.4
36380, 장흥군,065003, 62세,2016,531,238,293,81.2,525,237,288,82.3
36380, 장흥군,065004, 63세,2016,483,224,259,86.5,481,223,258,86.4
36380, 장흥군,065005, 64세,2016,556,289,267,108.2,553,287,266,107.9
36380, 장흥군,070,65~69세,2016,2738,1299,1439,90.3,2726,1292,1434,90.1
36380, 장흥군,070001, 65세,2016,505,263,242,108.7,500,259,241,107.5
36380, 장흥군,070002, 66세,2016,549,263,286,92,546,263,283,92.9
36380, 장흥군,070003, 67세,2016,523,241,282,85.5,520,239,281,85.1
36380, 장흥군,070004, 68세,2016,573,265,308,86,572,264,308,85.7
36380, 장흥군,070005, 69세,2016,588,267,321,83.2,588,267,321,83.2
36380, 장흥군,075,70~74세,2016,2643,1140,1503,75.8,2642,1139,1503,75.8
36380, 장흥군,075001, 70세,2016,456,200,256,78.1,456,200,256,78.1
36380, 장흥군,075002, 71세,2016,475,216,259,83.4,474,215,259,83
36380, 장흥군,075003, 72세,2016,462,225,237,94.9,462,225,237,94.9
36380, 장흥군,075004, 73세,2016,521,206,315,65.4,521,206,315,65.4
36380, 장흥군,075005, 74세,2016,729,293,436,67.2,729,293,436,67.2
36380, 장흥군,080,75~79세,2016,2873,1130,1743,64.8,2870,1128,1742,64.8
36380, 장흥군,080001, 75세,2016,608,268,340,78.8,606,266,340,78.2
36380, 장흥군,080002, 76세,2016,619,245,374,65.5,619,245,374,65.5
36380, 장흥군,080003, 77세,2016,615,229,386,59.3,614,229,385,59.5
36380, 장흥군,080004, 78세,2016,545,216,329,65.7,545,216,329,65.7
36380, 장흥군,080005, 79세,2016,486,172,314,54.8,486,172,314,54.8
36380, 장흥군,085,80~84세,2016,2085,674,1411,47.8,2081,673,1408,47.8
36380, 장흥군,085001, 80세,2016,506,167,339,49.3,505,166,339,49
36380, 장흥군,085002, 81세,2016,481,165,316,52.2,479,165,314,52.5
36380, 장흥군,085003, 82세,2016,435,133,302,44,434,133,301,44.2
36380, 장흥군,085004, 83세,2016,338,104,234,44.4,338,104,234,44.4
36380, 장흥군,085005, 84세,2016,325,105,220,47.7,325,105,220,47.7
36380, 장흥군,090,85~89세,2016,989,260,729,35.7,988,260,728,35.7
36380, 장흥군,090001, 85세,2016,260,67,193,34.7,260,67,193,34.7
36380, 장흥군,090002, 86세,2016,251,60,191,31.4,250,60,190,31.6
36380, 장흥군,090003, 87세,2016,225,65,160,40.6,225,65,160,40.6
36380, 장흥군,090004, 88세,2016,150,41,109,37.6,150,41,109,37.6
36380, 장흥군,090005, 89세,2016,103,27,76,35.5,103,27,76,35.5
36380, 장흥군,095,90~94세,2016,252,59,193,30.6,252,59,193,30.6
36380, 장흥군,095001, 90세,2016,68,17,51,33.3,68,17,51,33.3
36380, 장흥군,095002, 91세,2016,50,11,39,28.2,50,11,39,28.2
36380, 장흥군,095003, 92세,2016,45,12,33,36.4,45,12,33,36.4
36380, 장흥군,095004, 93세,2016,58,13,45,28.9,58,13,45,28.9
36380, 장흥군,095005, 94세,2016,31,6,25,24,31,6,25,24
36380, 장흥군,100,95~99세,2016,60,9,51,17.6,60,9,51,17.6
36380, 장흥군,100001, 95세,2016,23,X,21,9.5,23,X,21,9.5
36380, 장흥군,100002, 96세,2016,12,X,11,9.1,12,X,11,9.1
36380, 장흥군,100003, 97세,2016,11,X,9,22.2,11,X,9,22.2
36380, 장흥군,100004, 98세,2016,8,X,5,60,8,X,5,60
36380, 장흥군,100005, 99세,2016,6,X,5,20,6,X,5,20
36380, 장흥군,101,100세이상,2016,8,X,7,14.3,7,X,7,0
36380, 장흥군,102,15세미만,2016,3544,1827,1717,106.4,3540,1825,1715,106.4
36380, 장흥군,103,15~64세,2016,21289,11265,10024,112.4,20681,11018,9663,114
36380, 장흥군,104,65세이상,2016,11648,4572,7076,64.6,11626,4560,7066,64.5
36380, 장흥군,086,85세이상,2016,1309,329,980,33.6,1307,328,979,33.5
36380, 장흥군,126,평균연령,2016,50.9,48.1,53.5,,51.1,48.2,53.8,
36380, 장흥군,127,중위연령,2016,54.4,51.3,57.3,,54.8,51.5,57.7,
36390, 강진군,000,합계,2016,34102,16399,17703,92.6,33614,16177,17437,92.8
36390, 강진군,005,0~4세,2016,1262,642,620,103.5,1260,640,620,103.2
36390, 강진군,005001, 0세,2016,259,139,120,115.8,259,139,120,115.8
36390, 강진군,005002, 1세,2016,259,131,128,102.3,259,131,128,102.3
36390, 강진군,005003, 2세,2016,248,115,133,86.5,247,114,133,85.7
36390, 강진군,005004, 3세,2016,235,131,104,126,235,131,104,126
36390, 강진군,005005, 4세,2016,261,126,135,93.3,260,125,135,92.6
36390, 강진군,010,5~9세,2016,1144,594,550,108,1141,593,548,108.2
36390, 강진군,010001, 5세,2016,283,152,131,116,283,152,131,116
36390, 강진군,010002, 6세,2016,192,96,96,100,191,96,95,101.1
36390, 강진군,010003, 7세,2016,192,99,93,106.5,192,99,93,106.5
36390, 강진군,010004, 8세,2016,241,124,117,106,240,124,116,106.9
36390, 강진군,010005, 9세,2016,236,123,113,108.8,235,122,113,108
36390, 강진군,015,10~14세,2016,1225,641,584,109.8,1223,640,583,109.8
36390, 강진군,015001, 10세,2016,212,107,105,101.9,211,106,105,101
36390, 강진군,015002, 11세,2016,203,115,88,130.7,203,115,88,130.7
36390, 강진군,015003, 12세,2016,250,133,117,113.7,249,133,116,114.7
36390, 강진군,015004, 13세,2016,279,138,141,97.9,279,138,141,97.9
36390, 강진군,015005, 14세,2016,281,148,133,111.3,281,148,133,111.3
36390, 강진군,020,15~19세,2016,1721,952,769,123.8,1718,951,767,124
36390, 강진군,020001, 15세,2016,376,198,178,111.2,376,198,178,111.2
36390, 강진군,020002, 16세,2016,424,232,192,120.8,424,232,192,120.8
36390, 강진군,020003, 17세,2016,350,185,165,112.1,350,185,165,112.1
36390, 강진군,020004, 18세,2016,329,179,150,119.3,327,178,149,119.5
36390, 강진군,020005, 19세,2016,242,158,84,188.1,241,158,83,190.4
36390, 강진군,025,20~24세,2016,1323,799,524,152.5,1258,770,488,157.8
36390, 강진군,025001, 20세,2016,242,168,74,227,238,167,71,235.2
36390, 강진군,025002, 21세,2016,296,210,86,244.2,288,206,82,251.2
36390, 강진군,025003, 22세,2016,277,161,116,138.8,262,152,110,138.2
36390, 강진군,025004, 23세,2016,240,120,120,100,228,116,112,103.6
36390, 강진군,025005, 24세,2016,268,140,128,109.4,242,129,113,114.2
36390, 강진군,030,25~29세,2016,1294,668,626,106.7,1172,610,562,108.5
36390, 강진군,030001, 25세,2016,259,132,127,103.9,236,123,113,108.8
36390, 강진군,030002, 26세,2016,280,139,141,98.6,259,130,129,100.8
36390, 강진군,030003, 27세,2016,246,127,119,106.7,214,111,103,107.8
36390, 강진군,030004, 28세,2016,268,139,129,107.8,247,127,120,105.8
36390, 강진군,030005, 29세,2016,241,131,110,119.1,216,119,97,122.7
36390, 강진군,035,30~34세,2016,1419,704,715,98.5,1344,663,681,97.4
36390, 강진군,035001, 30세,2016,288,141,147,95.9,269,129,140,92.1
36390, 강진군,035002, 31세,2016,241,136,105,129.5,231,130,101,128.7
36390, 강진군,035003, 32세,2016,248,122,126,96.8,232,116,116,100
36390, 강진군,035004, 33세,2016,305,143,162,88.3,296,139,157,88.5
36390, 강진군,035005, 34세,2016,337,162,175,92.6,316,149,167,89.2
36390, 강진군,040,35~39세,2016,1485,759,726,104.5,1439,736,703,104.7
36390, 강진군,040001, 35세,2016,290,152,138,110.1,282,149,133,112
36390, 강진군,040002, 36세,2016,317,148,169,87.6,308,145,163,89
36390, 강진군,040003, 37세,2016,297,154,143,107.7,285,146,139,105
36390, 강진군,040004, 38세,2016,278,138,140,98.6,268,132,136,97.1
36390, 강진군,040005, 39세,2016,303,167,136,122.8,296,164,132,124.2
36390, 강진군,045,40~44세,2016,1840,1009,831,121.4,1811,994,817,121.7
36390, 강진군,045001, 40세,2016,323,177,146,121.2,319,176,143,123.1
36390, 강진군,045002, 41세,2016,344,177,167,106,339,174,165,105.5
36390, 강진군,045003, 42세,2016,347,195,152,128.3,341,193,148,130.4
36390, 강진군,045004, 43세,2016,398,222,176,126.1,390,217,173,125.4
36390, 강진군,045005, 44세,2016,428,238,190,125.3,422,234,188,124.5
36390, 강진군,050,45~49세,2016,2193,1225,968,126.5,2156,1217,939,129.6
36390, 강진군,050001, 45세,2016,480,279,201,138.8,472,277,195,142.1
36390, 강진군,050002, 46세,2016,399,218,181,120.4,391,218,173,126
36390, 강진군,050003, 47세,2016,427,222,205,108.3,423,220,203,108.4
36390, 강진군,050004, 48세,2016,471,264,207,127.5,463,262,201,130.3
36390, 강진군,050005, 49세,2016,416,242,174,139.1,407,240,167,143.7
36390, 강진군,055,50~54세,2016,2637,1379,1258,109.6,2598,1365,1233,110.7
36390, 강진군,055001, 50세,2016,481,262,219,119.6,471,259,212,122.2
36390, 강진군,055002, 51세,2016,528,288,240,120,519,285,234,121.8
36390, 강진군,055003, 52세,2016,498,250,248,100.8,491,247,244,101.2
36390, 강진군,055004, 53세,2016,554,272,282,96.5,545,268,277,96.8
36390, 강진군,055005, 54세,2016,576,307,269,114.1,572,306,266,115
36390, 강진군,060,55~59세,2016,3214,1598,1616,98.9,3179,1582,1597,99.1
36390, 강진군,060001, 55세,2016,607,303,304,99.7,601,299,302,99
36390, 강진군,060002, 56세,2016,675,327,348,94,665,325,340,95.6
36390, 강진군,060003, 57세,2016,703,358,345,103.8,698,356,342,104.1
36390, 강진군,060004, 58세,2016,608,308,300,102.7,600,304,296,102.7
36390, 강진군,060005, 59세,2016,621,302,319,94.7,615,298,317,94
36390, 강진군,065,60~64세,2016,2555,1253,1302,96.2,2540,1247,1293,96.4
36390, 강진군,065001, 60세,2016,527,257,270,95.2,522,255,267,95.5
36390, 강진군,065002, 61세,2016,558,275,283,97.2,552,272,280,97.1
36390, 강진군,065003, 62세,2016,467,233,234,99.6,467,233,234,99.6
36390, 강진군,065004, 63세,2016,457,237,220,107.7,454,237,217,109.2
36390, 강진군,065005, 64세,2016,546,251,295,85.1,545,250,295,84.7
36390, 강진군,070,65~69세,2016,2635,1231,1404,87.7,2625,1227,1398,87.8
36390, 강진군,070001, 65세,2016,457,215,242,88.8,453,214,239,89.5
36390, 강진군,070002, 66세,2016,534,256,278,92.1,530,253,277,91.3
36390, 강진군,070003, 67세,2016,530,264,266,99.2,530,264,266,99.2
36390, 강진군,070004, 68세,2016,574,257,317,81.1,572,257,315,81.6
36390, 강진군,070005, 69세,2016,540,239,301,79.4,540,239,301,79.4
36390, 강진군,075,70~74세,2016,2548,1080,1468,73.6,2546,1079,1467,73.6
36390, 강진군,075001, 70세,2016,456,195,261,74.7,455,195,260,75
36390, 강진군,075002, 71세,2016,482,201,281,71.5,482,201,281,71.5
36390, 강진군,075003, 72세,2016,439,200,239,83.7,439,200,239,83.7
36390, 강진군,075004, 73세,2016,483,214,269,79.6,482,213,269,79.2
36390, 강진군,075005, 74세,2016,688,270,418,64.6,688,270,418,64.6
36390, 강진군,080,75~79세,2016,2761,1067,1694,63,2758,1065,1693,62.9
36390, 강진군,080001, 75세,2016,563,230,333,69.1,561,229,332,69
36390, 강진군,080002, 76세,2016,607,225,382,58.9,607,225,382,58.9
36390, 강진군,080003, 77세,2016,562,218,344,63.4,561,217,344,63.1
36390, 강진군,080004, 78세,2016,554,217,337,64.4,554,217,337,64.4
36390, 강진군,080005, 79세,2016,475,177,298,59.4,475,177,298,59.4
36390, 강진군,085,80~84세,2016,1698,539,1159,46.5,1698,539,1159,46.5
36390, 강진군,085001, 80세,2016,394,135,259,52.1,394,135,259,52.1
36390, 강진군,085002, 81세,2016,408,153,255,60,408,153,255,60
36390, 강진군,085003, 82세,2016,345,96,249,38.6,345,96,249,38.6
36390, 강진군,085004, 83세,2016,286,84,202,41.6,286,84,202,41.6
36390, 강진군,085005, 84세,2016,265,71,194,36.6,265,71,194,36.6
36390, 강진군,090,85~89세,2016,888,192,696,27.6,888,192,696,27.6
36390, 강진군,090001, 85세,2016,257,59,198,29.8,257,59,198,29.8
36390, 강진군,090002, 86세,2016,246,55,191,28.8,246,55,191,28.8
36390, 강진군,090003, 87세,2016,155,35,120,29.2,155,35,120,29.2
36390, 강진군,090004, 88세,2016,135,26,109,23.9,135,26,109,23.9
36390, 강진군,090005, 89세,2016,95,17,78,21.8,95,17,78,21.8
36390, 강진군,095,90~94세,2016,209,56,153,36.6,209,56,153,36.6
36390, 강진군,095001, 90세,2016,56,17,39,43.6,56,17,39,43.6
36390, 강진군,095002, 91세,2016,49,22,27,81.5,49,22,27,81.5
36390, 강진군,095003, 92세,2016,47,6,41,14.6,47,6,41,14.6
36390, 강진군,095004, 93세,2016,33,5,28,17.9,33,5,28,17.9
36390, 강진군,095005, 94세,2016,24,6,18,33.3,24,6,18,33.3
36390, 강진군,100,95~99세,2016,44,11,33,33.3,44,11,33,33.3
36390, 강진군,100001, 95세,2016,20,6,14,42.9,20,6,14,42.9
36390, 강진군,100002, 96세,2016,11,X,8,37.5,11,X,8,37.5
36390, 강진군,100003, 97세,2016,5,X,X,66.7,5,X,X,66.7
36390, 강진군,100004, 98세,2016,6,X,6,0,6,X,6,0
36390, 강진군,100005, 99세,2016,X,X,X,0,X,X,X,0
36390, 강진군,101,100세이상,2016,7,X,7,0,7,X,7,0
36390, 강진군,102,15세미만,2016,3631,1877,1754,107,3624,1873,1751,107
36390, 강진군,103,15~64세,2016,19681,10346,9335,110.8,19215,10135,9080,111.6
36390, 강진군,104,65세이상,2016,10790,4176,6614,63.1,10775,4169,6606,63.1
36390, 강진군,086,85세이상,2016,1148,259,889,29.1,1148,259,889,29.1
36390, 강진군,126,평균연령,2016,50.1,47.2,52.8,,50.3,47.3,53,
36390, 강진군,127,중위연령,2016,54.1,50.8,57.1,,54.5,51.1,57.4,
36400, 해남군,000,합계,2016,68342,33556,34786,96.5,66751,32589,34162,95.4
36400, 해남군,005,0~4세,2016,3085,1510,1575,95.9,3082,1507,1575,95.7
36400, 해남군,005001, 0세,2016,754,376,378,99.5,754,376,378,99.5
36400, 해남군,005002, 1세,2016,758,398,360,110.6,757,397,360,110.3
36400, 해남군,005003, 2세,2016,540,266,274,97.1,540,266,274,97.1
36400, 해남군,005004, 3세,2016,517,230,287,80.1,516,229,287,79.8
36400, 해남군,005005, 4세,2016,516,240,276,87,515,239,276,86.6
36400, 해남군,010,5~9세,2016,2225,1125,1100,102.3,2219,1122,1097,102.3
36400, 해남군,010001, 5세,2016,488,248,240,103.3,486,248,238,104.2
36400, 해남군,010002, 6세,2016,395,202,193,104.7,392,200,192,104.2
36400, 해남군,010003, 7세,2016,415,224,191,117.3,415,224,191,117.3
36400, 해남군,010004, 8세,2016,489,235,254,92.5,489,235,254,92.5
36400, 해남군,010005, 9세,2016,438,216,222,97.3,437,215,222,96.8
36400, 해남군,015,10~14세,2016,2397,1231,1166,105.6,2396,1230,1166,105.5
36400, 해남군,015001, 10세,2016,465,238,227,104.8,465,238,227,104.8
36400, 해남군,015002, 11세,2016,417,204,213,95.8,416,203,213,95.3
36400, 해남군,015003, 12세,2016,478,262,216,121.3,478,262,216,121.3
36400, 해남군,015004, 13세,2016,492,241,251,96,492,241,251,96
36400, 해남군,015005, 14세,2016,545,286,259,110.4,545,286,259,110.4
36400, 해남군,020,15~19세,2016,2977,1659,1318,125.9,2967,1654,1313,126
36400, 해남군,020001, 15세,2016,677,367,310,118.4,677,367,310,118.4
36400, 해남군,020002, 16세,2016,646,363,283,128.3,645,363,282,128.7
36400, 해남군,020003, 17세,2016,672,356,316,112.7,672,356,316,112.7
36400, 해남군,020004, 18세,2016,565,318,247,128.7,564,318,246,129.3
36400, 해남군,020005, 19세,2016,417,255,162,157.4,409,250,159,157.2
36400, 해남군,025,20~24세,2016,2673,1605,1068,150.3,2464,1483,981,151.2
36400, 해남군,025001, 20세,2016,538,377,161,234.2,524,367,157,233.8
36400, 해남군,025002, 21세,2016,592,406,186,218.3,560,388,172,225.6
36400, 해남군,025003, 22세,2016,493,289,204,141.7,452,264,188,140.4
36400, 해남군,025004, 23세,2016,500,250,250,100,456,229,227,100.9
36400, 해남군,025005, 24세,2016,550,283,267,106,472,235,237,99.2
36400, 해남군,030,25~29세,2016,2632,1373,1259,109.1,2225,1101,1124,98
36400, 해남군,030001, 25세,2016,483,251,232,108.2,408,205,203,101
36400, 해남군,030002, 26세,2016,534,275,259,106.2,438,221,217,101.8
36400, 해남군,030003, 27세,2016,520,284,236,120.3,441,224,217,103.2
36400, 해남군,030004, 28세,2016,513,268,245,109.4,430,208,222,93.7
36400, 해남군,030005, 29세,2016,582,295,287,102.8,508,243,265,91.7
36400, 해남군,035,30~34세,2016,3212,1606,1606,100,2905,1388,1517,91.5
36400, 해남군,035001, 30세,2016,562,294,268,109.7,501,258,243,106.2
36400, 해남군,035002, 31세,2016,559,286,273,104.8,483,229,254,90.2
36400, 해남군,035003, 32세,2016,646,310,336,92.3,585,268,317,84.5
36400, 해남군,035004, 33세,2016,660,331,329,100.6,602,288,314,91.7
36400, 해남군,035005, 34세,2016,785,385,400,96.3,734,345,389,88.7
36400, 해남군,040,35~39세,2016,3525,1803,1722,104.7,3343,1682,1661,101.3
36400, 해남군,040001, 35세,2016,697,331,366,90.4,658,307,351,87.5
36400, 해남군,040002, 36세,2016,714,356,358,99.4,673,332,341,97.4
36400, 해남군,040003, 37세,2016,708,361,347,104,671,338,333,101.5
36400, 해남군,040004, 38세,2016,691,378,313,120.8,654,349,305,114.4
36400, 해남군,040005, 39세,2016,715,377,338,111.5,687,356,331,107.6
36400, 해남군,045,40~44세,2016,3999,2259,1740,129.8,3907,2209,1698,130.1
36400, 해남군,045001, 40세,2016,765,438,327,133.9,742,423,319,132.6
36400, 해남군,045002, 41세,2016,729,408,321,127.1,712,400,312,128.2
36400, 해남군,045003, 42세,2016,790,461,329,140.1,768,451,317,142.3
36400, 해남군,045004, 43세,2016,868,477,391,122,854,467,387,120.7
36400, 해남군,045005, 44세,2016,847,475,372,127.7,831,468,363,128.9
36400, 해남군,050,45~49세,2016,4775,2663,2112,126.1,4664,2617,2047,127.8
36400, 해남군,050001, 45세,2016,961,562,399,140.9,937,554,383,144.6
36400, 해남군,050002, 46세,2016,895,505,390,129.5,871,496,375,132.3
36400, 해남군,050003, 47세,2016,936,518,418,123.9,909,506,403,125.6
36400, 해남군,050004, 48세,2016,991,541,450,120.2,968,530,438,121
36400, 해남군,050005, 49세,2016,992,537,455,118,979,531,448,118.5
36400, 해남군,055,50~54세,2016,5311,2904,2407,120.6,5197,2844,2353,120.9
36400, 해남군,055001, 50세,2016,1048,587,461,127.3,1030,576,454,126.9
36400, 해남군,055002, 51세,2016,1038,606,432,140.3,1006,589,417,141.2
36400, 해남군,055003, 52세,2016,1037,537,500,107.4,1018,532,486,109.5
36400, 해남군,055004, 53세,2016,1089,604,485,124.5,1067,591,476,124.2
36400, 해남군,055005, 54세,2016,1099,570,529,107.8,1076,556,520,106.9
36400, 해남군,060,55~59세,2016,6379,3330,3049,109.2,6301,3293,3008,109.5
36400, 해남군,060001, 55세,2016,1225,633,592,106.9,1210,628,582,107.9
36400, 해남군,060002, 56세,2016,1375,771,604,127.6,1360,761,599,127
36400, 해남군,060003, 57세,2016,1325,647,678,95.4,1313,638,675,94.5
36400, 해남군,060004, 58세,2016,1203,630,573,109.9,1182,623,559,111.4
36400, 해남군,060005, 59세,2016,1251,649,602,107.8,1236,643,593,108.4
36400, 해남군,065,60~64세,2016,5152,2517,2635,95.5,5109,2502,2607,96
36400, 해남군,065001, 60세,2016,1116,557,559,99.6,1103,555,548,101.3
36400, 해남군,065002, 61세,2016,1092,544,548,99.3,1080,536,544,98.5
36400, 해남군,065003, 62세,2016,946,458,488,93.9,940,456,484,94.2
36400, 해남군,065004, 63세,2016,913,422,491,85.9,905,420,485,86.6
36400, 해남군,065005, 64세,2016,1085,536,549,97.6,1081,535,546,98
36400, 해남군,070,65~69세,2016,5145,2489,2656,93.7,5129,2479,2650,93.5
36400, 해남군,070001, 65세,2016,972,444,528,84.1,965,441,524,84.2
36400, 해남군,070002, 66세,2016,1005,498,507,98.2,1001,494,507,97.4
36400, 해남군,070003, 67세,2016,1087,549,538,102,1084,547,537,101.9
36400, 해남군,070004, 68세,2016,1011,497,514,96.7,1010,496,514,96.5
36400, 해남군,070005, 69세,2016,1070,501,569,88,1069,501,568,88.2
36400, 해남군,075,70~74세,2016,4950,2143,2807,76.3,4946,2141,2805,76.3
36400, 해남군,075001, 70세,2016,841,388,453,85.7,839,387,452,85.6
36400, 해남군,075002, 71세,2016,934,410,524,78.2,934,410,524,78.2
36400, 해남군,075003, 72세,2016,856,361,495,72.9,855,361,494,73.1
36400, 해남군,075004, 73세,2016,1027,441,586,75.3,1027,441,586,75.3
36400, 해남군,075005, 74세,2016,1292,543,749,72.5,1291,542,749,72.4
36400, 해남군,080,75~79세,2016,4945,1962,2983,65.8,4940,1961,2979,65.8
36400, 해남군,080001, 75세,2016,1070,436,634,68.8,1069,436,633,68.9
36400, 해남군,080002, 76세,2016,1074,437,637,68.6,1073,437,636,68.7
36400, 해남군,080003, 77세,2016,1015,420,595,70.6,1013,419,594,70.5
36400, 해남군,080004, 78세,2016,899,339,560,60.5,899,339,560,60.5
36400, 해남군,080005, 79세,2016,887,330,557,59.2,886,330,556,59.4
36400, 해남군,085,80~84세,2016,3000,929,2071,44.9,2999,929,2070,44.9
36400, 해남군,085001, 80세,2016,723,236,487,48.5,723,236,487,48.5
36400, 해남군,085002, 81세,2016,670,208,462,45,670,208,462,45
36400, 해남군,085003, 82세,2016,620,202,418,48.3,620,202,418,48.3
36400, 해남군,085004, 83세,2016,537,156,381,40.9,537,156,381,40.9
36400, 해남군,085005, 84세,2016,450,127,323,39.3,449,127,322,39.4
36400, 해남군,090,85~89세,2016,1457,346,1111,31.1,1457,346,1111,31.1
36400, 해남군,090001, 85세,2016,403,92,311,29.6,403,92,311,29.6
36400, 해남군,090002, 86세,2016,406,94,312,30.1,406,94,312,30.1
36400, 해남군,090003, 87세,2016,280,76,204,37.3,280,76,204,37.3
36400, 해남군,090004, 88세,2016,211,53,158,33.5,211,53,158,33.5
36400, 해남군,090005, 89세,2016,157,31,126,24.6,157,31,126,24.6
36400, 해남군,095,90~94세,2016,400,88,312,28.2,398,87,311,28
36400, 해남군,095001, 90세,2016,114,31,83,37.3,113,30,83,36.1
36400, 해남군,095002, 91세,2016,77,16,61,26.2,76,16,60,26.7
36400, 해남군,095003, 92세,2016,88,21,67,31.3,88,21,67,31.3
36400, 해남군,095004, 93세,2016,72,11,61,18,72,11,61,18
36400, 해남군,095005, 94세,2016,49,9,40,22.5,49,9,40,22.5
36400, 해남군,100,95~99세,2016,94,13,81,16,94,13,81,16
36400, 해남군,100001, 95세,2016,28,X,25,12,28,X,25,12
36400, 해남군,100002, 96세,2016,32,X,29,10.3,32,X,29,10.3
36400, 해남군,100003, 97세,2016,18,X,14,28.6,18,X,14,28.6
36400, 해남군,100004, 98세,2016,10,X,7,42.9,10,X,7,42.9
36400, 해남군,100005, 99세,2016,6,X,6,0,6,X,6,0
36400, 해남군,101,100세이상,2016,9,X,8,12.5,9,X,8,12.5
36400, 해남군,102,15세미만,2016,7707,3866,3841,100.7,7697,3859,3838,100.5
36400, 해남군,103,15~64세,2016,40635,21719,18916,114.8,39082,20773,18309,113.5
36400, 해남군,104,65세이상,2016,20000,7971,12029,66.3,19972,7957,12015,66.2
36400, 해남군,086,85세이상,2016,1960,448,1512,29.6,1958,447,1511,29.6
36400, 해남군,126,평균연령,2016,49,46.6,51.3,,49.3,47,51.6,
36400, 해남군,127,중위연령,2016,52.6,49.9,55.5,,53.1,50.5,55.9,
36410, 영암군,000,합계,2016,60329,32389,27940,115.9,54390,27935,26455,105.6
36410, 영암군,005,0~4세,2016,2652,1381,1271,108.7,2579,1346,1233,109.2
36410, 영암군,005001, 0세,2016,538,278,260,106.9,523,269,254,105.9
36410, 영암군,005002, 1세,2016,551,285,266,107.1,534,277,257,107.8
36410, 영암군,005003, 2세,2016,510,262,248,105.6,501,260,241,107.9
36410, 영암군,005004, 3세,2016,532,279,253,110.3,514,271,243,111.5
36410, 영암군,005005, 4세,2016,521,277,244,113.5,507,269,238,113
36410, 영암군,010,5~9세,2016,2312,1194,1118,106.8,2272,1175,1097,107.1
36410, 영암군,010001, 5세,2016,527,252,275,91.6,516,247,269,91.8
36410, 영암군,010002, 6세,2016,451,239,212,112.7,445,235,210,111.9
36410, 영암군,010003, 7세,2016,446,238,208,114.4,437,235,202,116.3
36410, 영암군,010004, 8세,2016,413,223,190,117.4,407,221,186,118.8
36410, 영암군,010005, 9세,2016,475,242,233,103.9,467,237,230,103
36410, 영암군,015,10~14세,2016,2270,1200,1070,112.1,2242,1183,1059,111.7
36410, 영암군,015001, 10세,2016,425,224,201,111.4,416,218,198,110.1
36410, 영암군,015002, 11세,2016,429,224,205,109.3,424,220,204,107.8
36410, 영암군,015003, 12세,2016,450,229,221,103.6,443,225,218,103.2
36410, 영암군,015004, 13세,2016,461,252,209,120.6,457,249,208,119.7
36410, 영암군,015005, 14세,2016,505,271,234,115.8,502,271,231,117.3
36410, 영암군,020,15~19세,2016,3169,1593,1576,101.1,3111,1563,1548,101
36410, 영암군,020001, 15세,2016,516,260,256,101.6,513,259,254,102
36410, 영암군,020002, 16세,2016,610,281,329,85.4,607,279,328,85.1
36410, 영암군,020003, 17세,2016,622,300,322,93.2,615,296,319,92.8
36410, 영암군,020004, 18세,2016,619,319,300,106.3,608,316,292,108.2
36410, 영암군,020005, 19세,2016,802,433,369,117.3,768,413,355,116.3
36410, 영암군,025,20~24세,2016,3842,2324,1518,153.1,3178,1803,1375,131.1
36410, 영암군,025001, 20세,2016,871,510,361,141.3,797,462,335,137.9
36410, 영암군,025002, 21세,2016,766,426,340,125.3,671,364,307,118.6
36410, 영암군,025003, 22세,2016,738,451,287,157.1,624,356,268,132.8
36410, 영암군,025004, 23세,2016,746,472,274,172.3,569,331,238,139.1
36410, 영암군,025005, 24세,2016,721,465,256,181.6,517,290,227,127.8
36410, 영암군,030,25~29세,2016,3351,2149,1202,178.8,2089,1118,971,115.1
36410, 영암군,030001, 25세,2016,623,419,204,205.4,397,234,163,143.6
36410, 영암군,030002, 26세,2016,681,414,267,155.1,443,224,219,102.3
36410, 영암군,030003, 27세,2016,639,426,213,200,374,207,167,124
36410, 영암군,030004, 28세,2016,671,427,244,175,418,219,199,110.1
36410, 영암군,030005, 29세,2016,737,463,274,169,457,234,223,104.9
36410, 영암군,035,30~34세,2016,4189,2629,1560,168.5,3063,1688,1375,122.8
36410, 영암군,035001, 30세,2016,726,455,271,167.9,474,246,228,107.9
36410, 영암군,035002, 31세,2016,784,487,297,164,545,287,258,111.2
36410, 영암군,035003, 32세,2016,842,515,327,157.5,618,337,281,119.9
36410, 영암군,035004, 33세,2016,859,563,296,190.2,656,382,274,139.4
36410, 영암군,035005, 34세,2016,978,609,369,165,770,436,334,130.5
36410, 영암군,040,35~39세,2016,4205,2647,1558,169.9,3453,2037,1416,143.9
36410, 영암군,040001, 35세,2016,912,598,314,190.4,704,428,276,155.1
36410, 영암군,040002, 36세,2016,864,541,323,167.5,713,416,297,140.1
36410, 영암군,040003, 37세,2016,866,526,340,154.7,726,415,311,133.4
36410, 영암군,040004, 38세,2016,786,513,273,187.9,656,409,247,165.6
36410, 영암군,040005, 39세,2016,777,469,308,152.3,654,369,285,129.5
36410, 영암군,045,40~44세,2016,4280,2615,1665,157.1,3725,2209,1516,145.7
36410, 영암군,045001, 40세,2016,775,484,291,166.3,647,384,263,146
36410, 영암군,045002, 41세,2016,778,473,305,155.1,677,389,288,135.1
36410, 영암군,045003, 42세,2016,862,523,339,154.3,757,447,310,144.2
36410, 영암군,045004, 43세,2016,931,567,364,155.8,806,479,327,146.5
36410, 영암군,045005, 44세,2016,934,568,366,155.2,838,510,328,155.5
36410, 영암군,050,45~49세,2016,4661,2772,1889,146.7,4169,2445,1724,141.8
36410, 영암군,050001, 45세,2016,910,525,385,136.4,814,464,350,132.6
36410, 영암군,050002, 46세,2016,940,565,375,150.7,821,486,335,145.1
36410, 영암군,050003, 47세,2016,954,560,394,142.1,856,494,362,136.5
36410, 영암군,050004, 48세,2016,946,572,374,152.9,847,507,340,149.1
36410, 영암군,050005, 49세,2016,911,550,361,152.4,831,494,337,146.6
36410, 영암군,055,50~54세,2016,4668,2665,2003,133.1,4248,2413,1835,131.5
36410, 영암군,055001, 50세,2016,971,563,408,138,865,498,367,135.7
36410, 영암군,055002, 51세,2016,938,554,384,144.3,850,495,355,139.4
36410, 영암군,055003, 52세,2016,877,521,356,146.3,802,476,326,146
36410, 영암군,055004, 53세,2016,969,545,424,128.5,884,503,381,132
36410, 영암군,055005, 54세,2016,913,482,431,111.8,847,441,406,108.6
36410, 영암군,060,55~59세,2016,4553,2502,2051,122,4302,2344,1958,119.7
36410, 영암군,060001, 55세,2016,979,564,415,135.9,935,537,398,134.9
36410, 영암군,060002, 56세,2016,971,525,446,117.7,900,474,426,111.3
36410, 영암군,060003, 57세,2016,931,502,429,117,885,475,410,115.9
36410, 영암군,060004, 58세,2016,829,469,360,130.3,781,442,339,130.4
36410, 영암군,060005, 59세,2016,843,442,401,110.2,801,416,385,108.1
36410, 영암군,065,60~64세,2016,3466,1725,1741,99.1,3344,1660,1684,98.6
36410, 영암군,065001, 60세,2016,779,403,376,107.2,749,386,363,106.3
36410, 영암군,065002, 61세,2016,760,389,371,104.9,737,373,364,102.5
36410, 영암군,065003, 62세,2016,681,326,355,91.8,651,315,336,93.8
36410, 영암군,065004, 63세,2016,592,288,304,94.7,574,278,296,93.9
36410, 영암군,065005, 64세,2016,654,319,335,95.2,633,308,325,94.8
36410, 영암군,070,65~69세,2016,3112,1473,1639,89.9,3065,1450,1615,89.8
36410, 영암군,070001, 65세,2016,579,262,317,82.6,570,258,312,82.7
36410, 영암군,070002, 66세,2016,627,294,333,88.3,617,291,326,89.3
36410, 영암군,070003, 67세,2016,655,336,319,105.3,644,330,314,105.1
36410, 영암군,070004, 68세,2016,611,291,320,90.9,600,285,315,90.5
36410, 영암군,070005, 69세,2016,640,290,350,82.9,634,286,348,82.2
36410, 영암군,075,70~74세,2016,3142,1332,1810,73.6,3119,1322,1797,73.6
36410, 영암군,075001, 70세,2016,540,222,318,69.8,535,221,314,70.4
36410, 영암군,075002, 71세,2016,589,267,322,82.9,586,267,319,83.7
36410, 영암군,075003, 72세,2016,588,237,351,67.5,582,232,350,66.3
36410, 영암군,075004, 73세,2016,589,232,357,65,584,230,354,65
36410, 영암군,075005, 74세,2016,836,374,462,81,832,372,460,80.9
36410, 영암군,080,75~79세,2016,3176,1222,1954,62.5,3161,1215,1946,62.4
36410, 영암군,080001, 75세,2016,691,267,424,63,685,263,422,62.3
36410, 영암군,080002, 76세,2016,679,260,419,62.1,678,260,418,62.2
36410, 영암군,080003, 77세,2016,668,271,397,68.3,663,268,395,67.8
36410, 영암군,080004, 78세,2016,600,220,380,57.9,597,220,377,58.4
36410, 영암군,080005, 79세,2016,538,204,334,61.1,538,204,334,61.1
36410, 영암군,085,80~84세,2016,2080,673,1407,47.8,2075,672,1403,47.9
36410, 영암군,085001, 80세,2016,486,164,322,50.9,484,163,321,50.8
36410, 영암군,085002, 81세,2016,487,156,331,47.1,486,156,330,47.3
36410, 영암군,085003, 82세,2016,438,146,292,50,438,146,292,50
36410, 영암군,085004, 83세,2016,370,117,253,46.2,369,117,252,46.4
36410, 영암군,085005, 84세,2016,299,90,209,43.1,298,90,208,43.3
36410, 영암군,090,85~89세,2016,910,232,678,34.2,905,231,674,34.3
36410, 영암군,090001, 85세,2016,259,66,193,34.2,256,66,190,34.7
36410, 영암군,090002, 86세,2016,248,69,179,38.5,246,68,178,38.2
36410, 영암군,090003, 87세,2016,184,41,143,28.7,184,41,143,28.7
36410, 영암군,090004, 88세,2016,122,34,88,38.6,122,34,88,38.6
36410, 영암군,090005, 89세,2016,97,22,75,29.3,97,22,75,29.3
36410, 영암군,095,90~94세,2016,230,50,180,27.8,229,50,179,27.9
36410, 영암군,095001, 90세,2016,58,16,42,38.1,58,16,42,38.1
36410, 영암군,095002, 91세,2016,46,10,36,27.8,46,10,36,27.8
36410, 영암군,095003, 92세,2016,58,10,48,20.8,57,10,47,21.3
36410, 영암군,095004, 93세,2016,42,10,32,31.3,42,10,32,31.3
36410, 영암군,095005, 94세,2016,26,X,22,18.2,26,X,22,18.2
36410, 영암군,100,95~99세,2016,53,9,44,20.5,53,9,44,20.5
36410, 영암군,100001, 95세,2016,23,X,19,21.1,23,X,19,21.1
36410, 영암군,100002, 96세,2016,14,X,11,27.3,14,X,11,27.3
36410, 영암군,100003, 97세,2016,9,X,9,0,9,X,9,0
36410, 영암군,100004, 98세,2016,7,X,5,40,7,X,5,40
36410, 영암군,100005, 99세,2016,X,X,X,,X,X,X,
36410, 영암군,101,100세이상,2016,8,X,6,33.3,8,X,6,33.3
36410, 영암군,102,15세미만,2016,7234,3775,3459,109.1,7093,3704,3389,109.3
36410, 영암군,103,15~64세,2016,40384,23621,16763,140.9,34682,19280,15402,125.2
36410, 영암군,104,65세이상,2016,12711,4993,7718,64.7,12615,4951,7664,64.6
36410, 영암군,086,85세이상,2016,1201,293,908,32.3,1195,292,903,32.3
36410, 영암군,126,평균연령,2016,44.2,41.9,46.9,,45.1,43,47.4,
36410, 영암군,127,중위연령,2016,44.9,42.2,48.7,,46.8,44.7,49.7,
36420, 무안군,000,합계,2016,81280,41016,40264,101.9,79372,39998,39374,101.6
36420, 무안군,005,0~4세,2016,3763,1939,1824,106.3,3754,1937,1817,106.6
36420, 무안군,005001, 0세,2016,598,320,278,115.1,595,319,276,115.6
36420, 무안군,005002, 1세,2016,694,366,328,111.6,692,365,327,111.6
36420, 무안군,005003, 2세,2016,690,340,350,97.1,689,340,349,97.4
36420, 무안군,005004, 3세,2016,840,442,398,111.1,838,442,396,111.6
36420, 무안군,005005, 4세,2016,941,471,470,100.2,940,471,469,100.4
36420, 무안군,010,5~9세,2016,4347,2218,2129,104.2,4339,2214,2125,104.2
36420, 무안군,010001, 5세,2016,885,438,447,98,882,436,446,97.8
36420, 무안군,010002, 6세,2016,898,445,453,98.2,897,444,453,98
36420, 무안군,010003, 7세,2016,867,455,412,110.4,864,454,410,110.7
36420, 무안군,010004, 8세,2016,831,420,411,102.2,831,420,411,102.2
36420, 무안군,010005, 9세,2016,866,460,406,113.3,865,460,405,113.6
36420, 무안군,015,10~14세,2016,3913,2000,1913,104.5,3910,1999,1911,104.6
36420, 무안군,015001, 10세,2016,742,372,370,100.5,742,372,370,100.5
36420, 무안군,015002, 11세,2016,739,356,383,93,738,355,383,92.7
36420, 무안군,015003, 12세,2016,804,419,385,108.8,803,419,384,109.1
36420, 무안군,015004, 13세,2016,797,418,379,110.3,796,418,378,110.6
36420, 무안군,015005, 14세,2016,831,435,396,109.8,831,435,396,109.8
36420, 무안군,020,15~19세,2016,5975,3214,2761,116.4,5903,3178,2725,116.6
36420, 무안군,020001, 15세,2016,1057,567,490,115.7,1056,566,490,115.5
36420, 무안군,020002, 16세,2016,1062,554,508,109.1,1061,554,507,109.3
36420, 무안군,020003, 17세,2016,967,485,482,100.6,966,485,481,100.8
36420, 무안군,020004, 18세,2016,1227,660,567,116.4,1206,653,553,118.1
36420, 무안군,020005, 19세,2016,1662,948,714,132.8,1614,920,694,132.6
36420, 무안군,025,20~24세,2016,6256,3552,2704,131.4,5758,3291,2467,133.4
36420, 무안군,025001, 20세,2016,1423,728,695,104.7,1339,683,656,104.1
36420, 무안군,025002, 21세,2016,1322,681,641,106.2,1221,629,592,106.3
36420, 무안군,025003, 22세,2016,1342,784,558,140.5,1243,724,519,139.5
36420, 무안군,025004, 23세,2016,1141,725,416,174.3,1027,668,359,186.1
36420, 무안군,025005, 24세,2016,1028,634,394,160.9,928,587,341,172.1
36420, 무안군,030,25~29세,2016,3581,1948,1633,119.3,3173,1704,1469,116
36420, 무안군,030001, 25세,2016,839,488,351,139,723,424,299,141.8
36420, 무안군,030002, 26세,2016,706,395,311,127,621,335,286,117.1
36420, 무안군,030003, 27세,2016,681,365,316,115.5,613,328,285,115.1
36420, 무안군,030004, 28세,2016,638,339,299,113.4,567,295,272,108.5
36420, 무안군,030005, 29세,2016,717,361,356,101.4,649,322,327,98.5
36420, 무안군,035,30~34세,2016,4789,2470,2319,106.5,4525,2328,2197,106
36420, 무안군,035001, 30세,2016,738,394,344,114.5,663,355,308,115.3
36420, 무안군,035002, 31세,2016,842,438,404,108.4,799,416,383,108.6
36420, 무안군,035003, 32세,2016,942,462,480,96.3,890,437,453,96.5
36420, 무안군,035004, 33세,2016,1080,539,541,99.6,1028,513,515,99.6
36420, 무안군,035005, 34세,2016,1187,637,550,115.8,1145,607,538,112.8
36420, 무안군,040,35~39세,2016,5994,3056,2938,104,5801,2943,2858,103
36420, 무안군,040001, 35세,2016,1148,590,558,105.7,1107,566,541,104.6
36420, 무안군,040002, 36세,2016,1301,655,646,101.4,1263,638,625,102.1
36420, 무안군,040003, 37세,2016,1190,631,559,112.9,1153,607,546,111.2
36420, 무안군,040004, 38세,2016,1164,593,571,103.9,1126,569,557,102.2
36420, 무안군,040005, 39세,2016,1191,587,604,97.2,1152,563,589,95.6
36420, 무안군,045,40~44세,2016,5871,3139,2732,114.9,5769,3086,2683,115
36420, 무안군,045001, 40세,2016,1130,606,524,115.6,1105,593,512,115.8
36420, 무안군,045002, 41세,2016,1109,577,532,108.5,1086,564,522,108
36420, 무안군,045003, 42세,2016,1251,664,587,113.1,1235,656,579,113.3
36420, 무안군,045004, 43세,2016,1225,665,560,118.8,1205,657,548,119.9
36420, 무안군,045005, 44세,2016,1156,627,529,118.5,1138,616,522,118
36420, 무안군,050,45~49세,2016,6141,3364,2777,121.1,6028,3315,2713,122.2
36420, 무안군,050001, 45세,2016,1343,766,577,132.8,1322,757,565,134
36420, 무안군,050002, 46세,2016,1212,653,559,116.8,1185,638,547,116.6
36420, 무안군,050003, 47세,2016,1207,671,536,125.2,1182,660,522,126.4
36420, 무안군,050004, 48세,2016,1237,669,568,117.8,1212,658,554,118.8
36420, 무안군,050005, 49세,2016,1142,605,537,112.7,1127,602,525,114.7
36420, 무안군,055,50~54세,2016,5449,2931,2518,116.4,5348,2885,2463,117.1
36420, 무안군,055001, 50세,2016,1122,612,510,120,1098,602,496,121.4
36420, 무안군,055002, 51세,2016,1083,578,505,114.5,1062,568,494,115
36420, 무안군,055003, 52세,2016,1037,579,458,126.4,1023,572,451,126.8
36420, 무안군,055004, 53세,2016,1082,556,526,105.7,1054,542,512,105.9
36420, 무안군,055005, 54세,2016,1125,606,519,116.8,1111,601,510,117.8
36420, 무안군,060,55~59세,2016,5701,2911,2790,104.3,5625,2876,2749,104.6
36420, 무안군,060001, 55세,2016,1189,617,572,107.9,1173,610,563,108.3
36420, 무안군,060002, 56세,2016,1248,646,602,107.3,1225,635,590,107.6
36420, 무안군,060003, 57세,2016,1097,548,549,99.8,1082,543,539,100.7
36420, 무안군,060004, 58세,2016,1122,587,535,109.7,1109,581,528,110
36420, 무안군,060005, 59세,2016,1045,513,532,96.4,1036,507,529,95.8
36420, 무안군,065,60~64세,2016,4459,2199,2260,97.3,4431,2185,2246,97.3
36420, 무안군,065001, 60세,2016,939,472,467,101.1,930,468,462,101.3
36420, 무안군,065002, 61세,2016,988,469,519,90.4,982,467,515,90.7
36420, 무안군,065003, 62세,2016,854,413,441,93.7,847,410,437,93.8
36420, 무안군,065004, 63세,2016,764,399,365,109.3,762,397,365,108.8
36420, 무안군,065005, 64세,2016,914,446,468,95.3,910,443,467,94.9
36420, 무안군,070,65~69세,2016,4235,2075,2160,96.1,4220,2067,2153,96
36420, 무안군,070001, 65세,2016,829,409,420,97.4,827,408,419,97.4
36420, 무안군,070002, 66세,2016,820,389,431,90.3,816,387,429,90.2
36420, 무안군,070003, 67세,2016,870,435,435,100,862,431,431,100
36420, 무안군,070004, 68세,2016,872,438,434,100.9,871,437,434,100.7
36420, 무안군,070005, 69세,2016,844,404,440,91.8,844,404,440,91.8
36420, 무안군,075,70~74세,2016,3800,1685,2115,79.7,3791,1681,2110,79.7
36420, 무안군,075001, 70세,2016,716,330,386,85.5,714,329,385,85.5
36420, 무안군,075002, 71세,2016,729,338,391,86.4,727,337,390,86.4
36420, 무안군,075003, 72세,2016,666,290,376,77.1,663,288,375,76.8
36420, 무안군,075004, 73세,2016,679,296,383,77.3,677,296,381,77.7
36420, 무안군,075005, 74세,2016,1010,431,579,74.4,1010,431,579,74.4
36420, 무안군,080,75~79세,2016,3483,1347,2136,63.1,3479,1345,2134,63
36420, 무안군,080001, 75세,2016,798,324,474,68.4,798,324,474,68.4
36420, 무안군,080002, 76세,2016,743,285,458,62.2,741,284,457,62.1
36420, 무안군,080003, 77세,2016,684,266,418,63.6,682,265,417,63.5
36420, 무안군,080004, 78세,2016,682,267,415,64.3,682,267,415,64.3
36420, 무안군,080005, 79세,2016,576,205,371,55.3,576,205,371,55.3
36420, 무안군,085,80~84세,2016,2151,670,1481,45.2,2148,667,1481,45
36420, 무안군,085001, 80세,2016,470,162,308,52.6,470,162,308,52.6
36420, 무안군,085002, 81세,2016,508,163,345,47.2,507,162,345,47
36420, 무안군,085003, 82세,2016,471,149,322,46.3,470,148,322,46
36420, 무안군,085004, 83세,2016,393,108,285,37.9,392,107,285,37.5
36420, 무안군,085005, 84세,2016,309,88,221,39.8,309,88,221,39.8
36420, 무안군,090,85~89세,2016,1002,229,773,29.6,1001,229,772,29.7
36420, 무안군,090001, 85세,2016,250,65,185,35.1,250,65,185,35.1
36420, 무안군,090002, 86세,2016,287,59,228,25.9,287,59,228,25.9
36420, 무안군,090003, 87세,2016,203,51,152,33.6,203,51,152,33.6
36420, 무안군,090004, 88세,2016,162,36,126,28.6,161,36,125,28.8
36420, 무안군,090005, 89세,2016,100,18,82,22,100,18,82,22
36420, 무안군,095,90~94세,2016,296,59,237,24.9,296,59,237,24.9
36420, 무안군,095001, 90세,2016,81,21,60,35,81,21,60,35
36420, 무안군,095002, 91세,2016,71,17,54,31.5,71,17,54,31.5
36420, 무안군,095003, 92세,2016,45,7,38,18.4,45,7,38,18.4
36420, 무안군,095004, 93세,2016,66,9,57,15.8,66,9,57,15.8
36420, 무안군,095005, 94세,2016,33,5,28,17.9,33,5,28,17.9
36420, 무안군,100,95~99세,2016,68,9,59,15.3,67,8,59,13.6
36420, 무안군,100001, 95세,2016,23,X,21,9.5,23,X,21,9.5
36420, 무안군,100002, 96세,2016,12,X,8,50,12,X,8,50
36420, 무안군,100003, 97세,2016,18,X,16,12.5,17,X,16,6.3
36420, 무안군,100004, 98세,2016,7,X,6,16.7,7,X,6,16.7
36420, 무안군,100005, 99세,2016,8,X,8,0,8,X,8,0
36420, 무안군,101,100세이상,2016,6,X,5,20,6,X,5,20
36420, 무안군,102,15세미만,2016,12023,6157,5866,105,12003,6150,5853,105.1
36420, 무안군,103,15~64세,2016,54216,28784,25432,113.2,52361,27791,24570,113.1
36420, 무안군,104,65세이상,2016,15041,6075,8966,67.8,15008,6057,8951,67.7
36420, 무안군,086,85세이상,2016,1372,298,1074,27.7,1370,297,1073,27.7
36420, 무안군,126,평균연령,2016,41.6,39.8,43.4,,41.8,40,43.6,
36420, 무안군,127,중위연령,2016,41.8,40.2,43.5,,42.3,40.7,43.9,
36430, 함평군,000,합계,2016,30829,15249,15580,97.9,30116,14841,15275,97.2
36430, 함평군,005,0~4세,2016,910,484,426,113.6,910,484,426,113.6
36430, 함평군,005001, 0세,2016,185,109,76,143.4,185,109,76,143.4
36430, 함평군,005002, 1세,2016,169,83,86,96.5,169,83,86,96.5
36430, 함평군,005003, 2세,2016,180,84,96,87.5,180,84,96,87.5
36430, 함평군,005004, 3세,2016,182,105,77,136.4,182,105,77,136.4
36430, 함평군,005005, 4세,2016,194,103,91,113.2,194,103,91,113.2
36430, 함평군,010,5~9세,2016,840,457,383,119.3,839,457,382,119.6
36430, 함평군,010001, 5세,2016,203,118,85,138.8,203,118,85,138.8
36430, 함평군,010002, 6세,2016,152,84,68,123.5,152,84,68,123.5
36430, 함평군,010003, 7세,2016,144,82,62,132.3,143,82,61,134.4
36430, 함평군,010004, 8세,2016,169,85,84,101.2,169,85,84,101.2
36430, 함평군,010005, 9세,2016,172,88,84,104.8,172,88,84,104.8
36430, 함평군,015,10~14세,2016,933,506,427,118.5,932,506,426,118.8
36430, 함평군,015001, 10세,2016,158,81,77,105.2,158,81,77,105.2
36430, 함평군,015002, 11세,2016,163,88,75,117.3,163,88,75,117.3
36430, 함평군,015003, 12세,2016,176,98,78,125.6,175,98,77,127.3
36430, 함평군,015004, 13세,2016,211,115,96,119.8,211,115,96,119.8
36430, 함평군,015005, 14세,2016,225,124,101,122.8,225,124,101,122.8
36430, 함평군,020,15~19세,2016,1647,826,821,100.6,1642,824,818,100.7
36430, 함평군,020001, 15세,2016,302,153,149,102.7,302,153,149,102.7
36430, 함평군,020002, 16세,2016,435,198,237,83.5,435,198,237,83.5
36430, 함평군,020003, 17세,2016,382,196,186,105.4,382,196,186,105.4
36430, 함평군,020004, 18세,2016,332,166,166,100,330,165,165,100
36430, 함평군,020005, 19세,2016,196,113,83,136.1,193,112,81,138.3
36430, 함평군,025,20~24세,2016,1249,820,429,191.1,1127,733,394,186
36430, 함평군,025001, 20세,2016,236,157,79,198.7,233,155,78,198.7
36430, 함평군,025002, 21세,2016,281,204,77,264.9,260,189,71,266.2
36430, 함평군,025003, 22세,2016,238,155,83,186.7,218,143,75,190.7
36430, 함평군,025004, 23세,2016,238,145,93,155.9,203,121,82,147.6
36430, 함평군,025005, 24세,2016,256,159,97,163.9,213,125,88,142
36430, 함평군,030,25~29세,2016,1108,588,520,113.1,940,497,443,112.2
36430, 함평군,030001, 25세,2016,227,124,103,120.4,182,100,82,122
36430, 함평군,030002, 26세,2016,217,112,105,106.7,180,92,88,104.5
36430, 함평군,030003, 27세,2016,224,119,105,113.3,188,98,90,108.9
36430, 함평군,030004, 28세,2016,224,122,102,119.6,195,105,90,116.7
36430, 함평군,030005, 29세,2016,216,111,105,105.7,195,102,93,109.7
36430, 함평군,035,30~34세,2016,1174,656,518,126.6,1059,584,475,122.9
36430, 함평군,035001, 30세,2016,229,131,98,133.7,203,116,87,133.3
36430, 함평군,035002, 31세,2016,223,128,95,134.7,199,111,88,126.1
36430, 함평군,035003, 32세,2016,203,109,94,116,180,93,87,106.9
36430, 함평군,035004, 33세,2016,257,143,114,125.4,235,132,103,128.2
36430, 함평군,035005, 34세,2016,262,145,117,123.9,242,132,110,120
36430, 함평군,040,35~39세,2016,1293,719,574,125.3,1221,683,538,127
36430, 함평군,040001, 35세,2016,258,143,115,124.3,246,137,109,125.7
36430, 함평군,040002, 36세,2016,271,158,113,139.8,256,153,103,148.5
36430, 함평군,040003, 37세,2016,244,133,111,119.8,227,124,103,120.4
36430, 함평군,040004, 38세,2016,255,143,112,127.7,237,136,101,134.7
36430, 함평군,040005, 39세,2016,265,142,123,115.4,255,133,122,109
36430, 함평군,045,40~44세,2016,1673,986,687,143.5,1601,935,666,140.4
36430, 함평군,045001, 40세,2016,291,168,123,136.6,269,152,117,129.9
36430, 함평군,045002, 41세,2016,332,182,150,121.3,316,171,145,117.9
36430, 함평군,045003, 42세,2016,337,208,129,161.2,331,204,127,160.6
36430, 함평군,045004, 43세,2016,356,208,148,140.5,343,198,145,136.6
36430, 함평군,045005, 44세,2016,357,220,137,160.6,342,210,132,159.1
36430, 함평군,050,45~49세,2016,2042,1181,861,137.2,1998,1163,835,139.3
36430, 함평군,050001, 45세,2016,383,229,154,148.7,376,226,150,150.7
36430, 함평군,050002, 46세,2016,370,213,157,135.7,366,211,155,136.1
36430, 함평군,050003, 47세,2016,410,222,188,118.1,400,219,181,121
36430, 함평군,050004, 48세,2016,420,250,170,147.1,412,247,165,149.7
36430, 함평군,050005, 49세,2016,459,267,192,139.1,444,260,184,141.3
36430, 함평군,055,50~54세,2016,2331,1313,1018,129,2286,1298,988,131.4
36430, 함평군,055001, 50세,2016,467,281,186,151.1,457,276,181,152.5
36430, 함평군,055002, 51세,2016,445,245,200,122.5,436,243,193,125.9
36430, 함평군,055003, 52세,2016,418,234,184,127.2,408,231,177,130.5
36430, 함평군,055004, 53세,2016,508,273,235,116.2,499,270,229,117.9
36430, 함평군,055005, 54세,2016,493,280,213,131.5,486,278,208,133.7
36430, 함평군,060,55~59세,2016,2807,1503,1304,115.3,2780,1490,1290,115.5
36430, 함평군,060001, 55세,2016,571,302,269,112.3,564,301,263,114.4
36430, 함평군,060002, 56세,2016,587,323,264,122.3,581,320,261,122.6
36430, 함평군,060003, 57세,2016,563,312,251,124.3,558,310,248,125
36430, 함평군,060004, 58세,2016,512,262,250,104.8,509,259,250,103.6
36430, 함평군,060005, 59세,2016,574,304,270,112.6,568,300,268,111.9
36430, 함평군,065,60~64세,2016,2411,1159,1252,92.6,2386,1146,1240,92.4
36430, 함평군,065001, 60세,2016,487,256,231,110.8,480,254,226,112.4
36430, 함평군,065002, 61세,2016,545,257,288,89.2,536,254,282,90.1
36430, 함평군,065003, 62세,2016,439,226,213,106.1,435,223,212,105.2
36430, 함평군,065004, 63세,2016,430,190,240,79.2,429,189,240,78.8
36430, 함평군,065005, 64세,2016,510,230,280,82.1,506,226,280,80.7
36430, 함평군,070,65~69세,2016,2378,1122,1256,89.3,2367,1116,1251,89.2
36430, 함평군,070001, 65세,2016,411,201,210,95.7,408,199,209,95.2
36430, 함평군,070002, 66세,2016,484,220,264,83.3,482,220,262,84
36430, 함평군,070003, 67세,2016,481,240,241,99.6,480,239,241,99.2
36430, 함평군,070004, 68세,2016,492,222,270,82.2,489,220,269,81.8
36430, 함평군,070005, 69세,2016,510,239,271,88.2,508,238,270,88.1
36430, 함평군,075,70~74세,2016,2568,1083,1485,72.9,2567,1082,1485,72.9
36430, 함평군,075001, 70세,2016,485,216,269,80.3,485,216,269,80.3
36430, 함평군,075002, 71세,2016,425,172,253,68,425,172,253,68
36430, 함평군,075003, 72세,2016,445,171,274,62.4,445,171,274,62.4
36430, 함평군,075004, 73세,2016,488,212,276,76.8,487,211,276,76.4
36430, 함평군,075005, 74세,2016,725,312,413,75.5,725,312,413,75.5
36430, 함평군,080,75~79세,2016,2705,1008,1697,59.4,2703,1006,1697,59.3
36430, 함평군,080001, 75세,2016,576,228,348,65.5,576,228,348,65.5
36430, 함평군,080002, 76세,2016,596,232,364,63.7,596,232,364,63.7
36430, 함평군,080003, 77세,2016,529,196,333,58.9,529,196,333,58.9
36430, 함평군,080004, 78세,2016,550,198,352,56.3,548,196,352,55.7
36430, 함평군,080005, 79세,2016,454,154,300,51.3,454,154,300,51.3
36430, 함평군,085,80~84세,2016,1674,553,1121,49.3,1674,553,1121,49.3
36430, 함평군,085001, 80세,2016,396,154,242,63.6,396,154,242,63.6
36430, 함평군,085002, 81세,2016,417,130,287,45.3,417,130,287,45.3
36430, 함평군,085003, 82세,2016,357,116,241,48.1,357,116,241,48.1
36430, 함평군,085004, 83세,2016,280,90,190,47.4,280,90,190,47.4
36430, 함평군,085005, 84세,2016,224,63,161,39.1,224,63,161,39.1
36430, 함평군,090,85~89세,2016,798,218,580,37.6,798,218,580,37.6
36430, 함평군,090001, 85세,2016,206,60,146,41.1,206,60,146,41.1
36430, 함평군,090002, 86세,2016,214,57,157,36.3,214,57,157,36.3
36430, 함평군,090003, 87세,2016,165,47,118,39.8,165,47,118,39.8
36430, 함평군,090004, 88세,2016,126,32,94,34,126,32,94,34
36430, 함평군,090005, 89세,2016,87,22,65,33.8,87,22,65,33.8
36430, 함평군,095,90~94세,2016,233,58,175,33.1,232,57,175,32.6
36430, 함평군,095001, 90세,2016,66,21,45,46.7,65,20,45,44.4
36430, 함평군,095002, 91세,2016,57,14,43,32.6,57,14,43,32.6
36430, 함평군,095003, 92세,2016,30,7,23,30.4,30,7,23,30.4
36430, 함평군,095004, 93세,2016,53,11,42,26.2,53,11,42,26.2
36430, 함평군,095005, 94세,2016,27,5,22,22.7,27,5,22,22.7
36430, 함평군,100,95~99세,2016,53,9,44,20.5,52,9,43,20.9
36430, 함평군,100001, 95세,2016,18,X,15,20,18,X,15,20
36430, 함평군,100002, 96세,2016,16,X,13,23.1,16,X,13,23.1
36430, 함평군,100003, 97세,2016,9,X,7,28.6,9,X,7,28.6
36430, 함평군,100004, 98세,2016,7,X,6,16.7,6,X,5,20
36430, 함평군,100005, 99세,2016,X,X,X,0,X,X,X,0
36430, 함평군,101,100세이상,2016,X,X,X,0,X,X,X,0
36430, 함평군,102,15세미만,2016,2683,1447,1236,117.1,2681,1447,1234,117.3
36430, 함평군,103,15~64세,2016,17735,9751,7984,122.1,17040,9353,7687,121.7
36430, 함평군,104,65세이상,2016,10411,4051,6360,63.7,10395,4041,6354,63.6
36430, 함평군,086,85세이상,2016,1086,285,801,35.6,1084,284,800,35.5
36430, 함평군,126,평균연령,2016,51.5,48.3,54.6,,51.9,48.7,54.9,
36430, 함평군,127,중위연령,2016,55.4,51.5,59.3,,55.9,52.2,59.8,
36440, 영광군,000,합계,2016,49992,24859,25133,98.9,49135,24393,24742,98.6
36440, 영광군,005,0~4세,2016,1958,1000,958,104.4,1955,998,957,104.3
36440, 영광군,005001, 0세,2016,419,216,203,106.4,417,215,202,106.4
36440, 영광군,005002, 1세,2016,360,178,182,97.8,360,178,182,97.8
36440, 영광군,005003, 2세,2016,364,192,172,111.6,364,192,172,111.6
36440, 영광군,005004, 3세,2016,366,191,175,109.1,366,191,175,109.1
36440, 영광군,005005, 4세,2016,449,223,226,98.7,448,222,226,98.2
36440, 영광군,010,5~9세,2016,1845,923,922,100.1,1841,921,920,100.1
36440, 영광군,010001, 5세,2016,395,190,205,92.7,393,190,203,93.6
36440, 영광군,010002, 6세,2016,339,185,154,120.1,339,185,154,120.1
36440, 영광군,010003, 7세,2016,338,158,180,87.8,337,157,180,87.2
36440, 영광군,010004, 8세,2016,381,190,191,99.5,380,189,191,99
36440, 영광군,010005, 9세,2016,392,200,192,104.2,392,200,192,104.2
36440, 영광군,015,10~14세,2016,1904,992,912,108.8,1902,990,912,108.6
36440, 영광군,015001, 10세,2016,351,181,170,106.5,351,181,170,106.5
36440, 영광군,015002, 11세,2016,332,175,157,111.5,331,174,157,110.8
36440, 영광군,015003, 12세,2016,376,196,180,108.9,375,195,180,108.3
36440, 영광군,015004, 13세,2016,392,207,185,111.9,392,207,185,111.9
36440, 영광군,015005, 14세,2016,453,233,220,105.9,453,233,220,105.9
36440, 영광군,020,15~19세,2016,2792,1513,1279,118.3,2789,1513,1276,118.6
36440, 영광군,020001, 15세,2016,569,280,289,96.9,569,280,289,96.9
36440, 영광군,020002, 16세,2016,680,365,315,115.9,680,365,315,115.9
36440, 영광군,020003, 17세,2016,610,333,277,120.2,610,333,277,120.2
36440, 영광군,020004, 18세,2016,558,315,243,129.6,556,315,241,130.7
36440, 영광군,020005, 19세,2016,375,220,155,141.9,374,220,154,142.9
36440, 영광군,025,20~24세,2016,2153,1294,859,150.6,2002,1192,810,147.2
36440, 영광군,025001, 20세,2016,425,287,138,208,420,284,136,208.8
36440, 영광군,025002, 21세,2016,470,313,157,199.4,447,300,147,204.1
36440, 영광군,025003, 22세,2016,425,255,170,150,392,231,161,143.5
36440, 영광군,025004, 23세,2016,436,240,196,122.4,391,208,183,113.7
36440, 영광군,025005, 24세,2016,397,199,198,100.5,352,169,183,92.3
36440, 영광군,030,25~29세,2016,2147,1156,991,116.6,1959,1063,896,118.6
36440, 영광군,030001, 25세,2016,420,226,194,116.5,382,205,177,115.8
36440, 영광군,030002, 26세,2016,444,243,201,120.9,409,222,187,118.7
36440, 영광군,030003, 27세,2016,430,238,192,124,389,218,171,127.5
36440, 영광군,030004, 28세,2016,420,237,183,129.5,389,221,168,131.5
36440, 영광군,030005, 29세,2016,433,212,221,95.9,390,197,193,102.1
36440, 영광군,035,30~34세,2016,2280,1190,1090,109.2,2175,1140,1035,110.1
36440, 영광군,035001, 30세,2016,393,212,181,117.1,373,203,170,119.4
36440, 영광군,035002, 31세,2016,431,209,222,94.1,408,201,207,97.1
36440, 영광군,035003, 32세,2016,445,238,207,115,415,223,192,116.1
36440, 영광군,035004, 33세,2016,474,242,232,104.3,462,237,225,105.3
36440, 영광군,035005, 34세,2016,537,289,248,116.5,517,276,241,114.5
36440, 영광군,040,35~39세,2016,2750,1480,1270,116.5,2664,1422,1242,114.5
36440, 영광군,040001, 35세,2016,537,273,264,103.4,512,256,256,100
36440, 영광군,040002, 36세,2016,557,292,265,110.2,539,282,257,109.7
36440, 영광군,040003, 37세,2016,615,328,287,114.3,602,316,286,110.5
36440, 영광군,040004, 38세,2016,523,280,243,115.2,512,273,239,114.2
36440, 영광군,040005, 39세,2016,518,307,211,145.5,499,295,204,144.6
36440, 영광군,045,40~44세,2016,3101,1733,1368,126.7,3027,1687,1340,125.9
36440, 영광군,045001, 40세,2016,507,290,217,133.6,489,279,210,132.9
36440, 영광군,045002, 41세,2016,582,324,258,125.6,567,314,253,124.1
36440, 영광군,045003, 42세,2016,671,369,302,122.2,663,363,300,121
36440, 영광군,045004, 43세,2016,684,389,295,131.9,667,380,287,132.4
36440, 영광군,045005, 44세,2016,657,361,296,122,641,351,290,121
36440, 영광군,050,45~49세,2016,3616,2023,1593,127,3556,2003,1553,129
36440, 영광군,050001, 45세,2016,769,421,348,121,759,420,339,123.9
36440, 영광군,050002, 46세,2016,709,406,303,134,691,397,294,135
36440, 영광군,050003, 47세,2016,677,394,283,139.2,665,388,277,140.1
36440, 영광군,050004, 48세,2016,733,401,332,120.8,722,399,323,123.5
36440, 영광군,050005, 49세,2016,728,401,327,122.6,719,399,320,124.7
36440, 영광군,055,50~54세,2016,3846,2038,1808,112.7,3777,2004,1773,113
36440, 영광군,055001, 50세,2016,738,395,343,115.2,725,388,337,115.1
36440, 영광군,055002, 51세,2016,760,410,350,117.1,744,399,345,115.7
36440, 영광군,055003, 52세,2016,780,424,356,119.1,765,419,346,121.1
36440, 영광군,055004, 53세,2016,790,397,393,101,778,396,382,103.7
36440, 영광군,055005, 54세,2016,778,412,366,112.6,765,402,363,110.7
36440, 영광군,060,55~59세,2016,4378,2278,2100,108.5,4329,2255,2074,108.7
36440, 영광군,060001, 55세,2016,900,471,429,109.8,890,467,423,110.4
36440, 영광군,060002, 56세,2016,944,496,448,110.7,936,493,443,111.3
36440, 영광군,060003, 57세,2016,834,416,418,99.5,827,413,414,99.8
36440, 영광군,060004, 58세,2016,892,478,414,115.5,880,471,409,115.2
36440, 영광군,060005, 59세,2016,808,417,391,106.6,796,411,385,106.8
36440, 영광군,065,60~64세,2016,3594,1759,1835,95.9,3557,1739,1818,95.7
36440, 영광군,065001, 60세,2016,768,403,365,110.4,760,396,364,108.8
36440, 영광군,065002, 61세,2016,815,399,416,95.9,807,396,411,96.4
36440, 영광군,065003, 62세,2016,655,335,320,104.7,648,331,317,104.4
36440, 영광군,065004, 63세,2016,633,273,360,75.8,624,270,354,76.3
36440, 영광군,065005, 64세,2016,723,349,374,93.3,718,346,372,93
36440, 영광군,070,65~69세,2016,3593,1696,1897,89.4,3574,1686,1888,89.3
36440, 영광군,070001, 65세,2016,636,293,343,85.4,631,291,340,85.6
36440, 영광군,070002, 66세,2016,736,345,391,88.2,731,342,389,87.9
36440, 영광군,070003, 67세,2016,723,347,376,92.3,717,344,373,92.2
36440, 영광군,070004, 68세,2016,698,330,368,89.7,697,330,367,89.9
36440, 영광군,070005, 69세,2016,800,381,419,90.9,798,379,419,90.5
36440, 영광군,075,70~74세,2016,3559,1533,2026,75.7,3555,1531,2024,75.6
36440, 영광군,075001, 70세,2016,638,281,357,78.7,636,280,356,78.7
36440, 영광군,075002, 71세,2016,629,280,349,80.2,629,280,349,80.2
36440, 영광군,075003, 72세,2016,634,266,368,72.3,632,265,367,72.2
36440, 영광군,075004, 73세,2016,692,287,405,70.9,692,287,405,70.9
36440, 영광군,075005, 74세,2016,966,419,547,76.6,966,419,547,76.6
36440, 영광군,080,75~79세,2016,3345,1289,2056,62.7,3344,1288,2056,62.6
36440, 영광군,080001, 75세,2016,761,318,443,71.8,761,318,443,71.8
36440, 영광군,080002, 76세,2016,702,266,436,61,702,266,436,61
36440, 영광군,080003, 77세,2016,696,270,426,63.4,696,270,426,63.4
36440, 영광군,080004, 78세,2016,638,249,389,64,638,249,389,64
36440, 영광군,080005, 79세,2016,548,186,362,51.4,547,185,362,51.1
36440, 영광군,085,80~84세,2016,1967,685,1282,53.4,1965,684,1281,53.4
36440, 영광군,085001, 80세,2016,472,183,289,63.3,472,183,289,63.3
36440, 영광군,085002, 81세,2016,533,179,354,50.6,533,179,354,50.6
36440, 영광군,085003, 82세,2016,406,157,249,63.1,406,157,249,63.1
36440, 영광군,085004, 83세,2016,307,87,220,39.5,306,87,219,39.7
36440, 영광군,085005, 84세,2016,249,79,170,46.5,248,78,170,45.9
36440, 영광군,090,85~89세,2016,827,218,609,35.8,827,218,609,35.8
36440, 영광군,090001, 85세,2016,195,68,127,53.5,195,68,127,53.5
36440, 영광군,090002, 86세,2016,223,44,179,24.6,223,44,179,24.6
36440, 영광군,090003, 87세,2016,172,53,119,44.5,172,53,119,44.5
36440, 영광군,090004, 88세,2016,134,30,104,28.8,134,30,104,28.8
36440, 영광군,090005, 89세,2016,103,23,80,28.8,103,23,80,28.8
36440, 영광군,095,90~94세,2016,274,50,224,22.3,274,50,224,22.3
36440, 영광군,095001, 90세,2016,52,10,42,23.8,52,10,42,23.8
36440, 영광군,095002, 91세,2016,68,12,56,21.4,68,12,56,21.4
36440, 영광군,095003, 92세,2016,52,13,39,33.3,52,13,39,33.3
36440, 영광군,095004, 93세,2016,65,11,54,20.4,65,11,54,20.4
36440, 영광군,095005, 94세,2016,37,X,33,12.1,37,X,33,12.1
36440, 영광군,100,95~99세,2016,54,9,45,20,54,9,45,20
36440, 영광군,100001, 95세,2016,20,X,18,11.1,20,X,18,11.1
36440, 영광군,100002, 96세,2016,10,X,9,11.1,10,X,9,11.1
36440, 영광군,100003, 97세,2016,10,X,7,42.9,10,X,7,42.9
36440, 영광군,100004, 98세,2016,7,X,6,16.7,7,X,6,16.7
36440, 영광군,100005, 99세,2016,7,X,5,40,7,X,5,40
36440, 영광군,101,100세이상,2016,9,X,9,0,9,X,9,0
36440, 영광군,102,15세미만,2016,5707,2915,2792,104.4,5698,2909,2789,104.3
36440, 영광군,103,15~64세,2016,30657,16464,14193,116,29835,16018,13817,115.9
36440, 영광군,104,65세이상,2016,13628,5480,8148,67.3,13602,5466,8136,67.2
36440, 영광군,086,85세이상,2016,1164,277,887,31.2,1164,277,887,31.2
36440, 영광군,126,평균연령,2016,47.7,45.3,50,,47.9,45.5,50.2,
36440, 영광군,127,중위연령,2016,50.6,47.8,53.7,,51,48.2,54.1,
36450, 장성군,000,합계,2016,41159,20621,20538,100.4,39884,19828,20056,98.9
36450, 장성군,005,0~4세,2016,1654,821,833,98.6,1652,821,831,98.8
36450, 장성군,005001, 0세,2016,356,169,187,90.4,356,169,187,90.4
36450, 장성군,005002, 1세,2016,378,188,190,98.9,378,188,190,98.9
36450, 장성군,005003, 2세,2016,305,163,142,114.8,305,163,142,114.8
36450, 장성군,005004, 3세,2016,302,146,156,93.6,302,146,156,93.6
36450, 장성군,005005, 4세,2016,313,155,158,98.1,311,155,156,99.4
36450, 장성군,010,5~9세,2016,1553,806,747,107.9,1550,805,745,108.1
36450, 장성군,010001, 5세,2016,343,178,165,107.9,343,178,165,107.9
36450, 장성군,010002, 6세,2016,321,174,147,118.4,321,174,147,118.4
36450, 장성군,010003, 7세,2016,281,135,146,92.5,280,135,145,93.1
36450, 장성군,010004, 8세,2016,310,165,145,113.8,308,164,144,113.9
36450, 장성군,010005, 9세,2016,298,154,144,106.9,298,154,144,106.9
36450, 장성군,015,10~14세,2016,1508,784,724,108.3,1504,782,722,108.3
36450, 장성군,015001, 10세,2016,281,155,126,123,281,155,126,123
36450, 장성군,015002, 11세,2016,285,143,142,100.7,284,142,142,100
36450, 장성군,015003, 12세,2016,302,161,141,114.2,301,161,140,115
36450, 장성군,015004, 13세,2016,303,152,151,100.7,302,152,150,101.3
36450, 장성군,015005, 14세,2016,337,173,164,105.5,336,172,164,104.9
36450, 장성군,020,15~19세,2016,2331,1266,1065,118.9,2319,1260,1059,119
36450, 장성군,020001, 15세,2016,445,233,212,109.9,444,233,211,110.4
36450, 장성군,020002, 16세,2016,612,320,292,109.6,611,320,291,110
36450, 장성군,020003, 17세,2016,523,272,251,108.4,520,270,250,108
36450, 장성군,020004, 18세,2016,446,244,202,120.8,443,243,200,121.5
36450, 장성군,020005, 19세,2016,305,197,108,182.4,301,194,107,181.3
36450, 장성군,025,20~24세,2016,1723,1003,720,139.3,1544,903,641,140.9
36450, 장성군,025001, 20세,2016,315,205,110,186.4,302,196,106,184.9
36450, 장성군,025002, 21세,2016,369,227,142,159.9,350,219,131,167.2
36450, 장성군,025003, 22세,2016,335,192,143,134.3,299,171,128,133.6
36450, 장성군,025004, 23세,2016,342,181,161,112.4,291,154,137,112.4
36450, 장성군,025005, 24세,2016,362,198,164,120.7,302,163,139,117.3
36450, 장성군,030,25~29세,2016,1882,1072,810,132.3,1606,878,728,120.6
36450, 장성군,030001, 25세,2016,403,214,189,113.2,330,167,163,102.5
36450, 장성군,030002, 26세,2016,418,249,169,147.3,351,203,148,137.2
36450, 장성군,030003, 27세,2016,379,211,168,125.6,329,175,154,113.6
36450, 장성군,030004, 28세,2016,376,220,156,141,334,187,147,127.2
36450, 장성군,030005, 29세,2016,306,178,128,139.1,262,146,116,125.9
36450, 장성군,035,30~34세,2016,2028,1090,938,116.2,1781,924,857,107.8
36450, 장성군,035001, 30세,2016,376,198,178,111.2,320,164,156,105.1
36450, 장성군,035002, 31세,2016,342,176,166,106,300,147,153,96.1
36450, 장성군,035003, 32세,2016,373,212,161,131.7,321,181,140,129.3
36450, 장성군,035004, 33세,2016,458,250,208,120.2,400,202,198,102
36450, 장성군,035005, 34세,2016,479,254,225,112.9,440,230,210,109.5
36450, 장성군,040,35~39세,2016,2326,1304,1022,127.6,2179,1194,985,121.2
36450, 장성군,040001, 35세,2016,458,242,216,112,425,218,207,105.3
36450, 장성군,040002, 36세,2016,491,268,223,120.2,460,246,214,115
36450, 장성군,040003, 37세,2016,468,273,195,140,438,249,189,131.7
36450, 장성군,040004, 38세,2016,443,258,185,139.5,422,242,180,134.4
36450, 장성군,040005, 39세,2016,466,263,203,129.6,434,239,195,122.6
36450, 장성군,045,40~44세,2016,2419,1395,1024,136.2,2286,1306,980,133.3
36450, 장성군,045001, 40세,2016,432,254,178,142.7,405,234,171,136.8
36450, 장성군,045002, 41세,2016,407,231,176,131.3,389,218,171,127.5
36450, 장성군,045003, 42세,2016,499,275,224,122.8,471,255,216,118.1
36450, 장성군,045004, 43세,2016,545,328,217,151.2,509,306,203,150.7
36450, 장성군,045005, 44세,2016,536,307,229,134.1,512,293,219,133.8
36450, 장성군,050,45~49세,2016,2827,1627,1200,135.6,2746,1584,1162,136.3
36450, 장성군,050001, 45세,2016,595,351,244,143.9,576,338,238,142
36450, 장성군,050002, 46세,2016,558,313,245,127.8,546,307,239,128.5
36450, 장성군,050003, 47세,2016,553,321,232,138.4,535,313,222,141
36450, 장성군,050004, 48세,2016,575,331,244,135.7,557,320,237,135
36450, 장성군,050005, 49세,2016,546,311,235,132.3,532,306,226,135.4
36450, 장성군,055,50~54세,2016,3087,1668,1419,117.5,3009,1639,1370,119.6
36450, 장성군,055001, 50세,2016,592,328,264,124.2,582,325,257,126.5
36450, 장성군,055002, 51세,2016,603,325,278,116.9,581,318,263,120.9
36450, 장성군,055003, 52세,2016,595,323,272,118.8,580,317,263,120.5
36450, 장성군,055004, 53세,2016,686,376,310,121.3,668,367,301,121.9
36450, 장성군,055005, 54세,2016,611,316,295,107.1,598,312,286,109.1
36450, 장성군,060,55~59세,2016,3505,1798,1707,105.3,3446,1772,1674,105.9
36450, 장성군,060001, 55세,2016,736,381,355,107.3,718,372,346,107.5
36450, 장성군,060002, 56세,2016,802,415,387,107.2,789,408,381,107.1
36450, 장성군,060003, 57세,2016,663,328,335,97.9,653,327,326,100.3
36450, 장성군,060004, 58세,2016,631,320,311,102.9,624,317,307,103.3
36450, 장성군,060005, 59세,2016,673,354,319,111,662,348,314,110.8
36450, 장성군,065,60~64세,2016,2891,1442,1449,99.5,2859,1428,1431,99.8
36450, 장성군,065001, 60세,2016,577,309,268,115.3,569,306,263,116.3
36450, 장성군,065002, 61세,2016,689,341,348,98,680,338,342,98.8
36450, 장성군,065003, 62세,2016,481,238,243,97.9,475,235,240,97.9
36450, 장성군,065004, 63세,2016,543,274,269,101.9,536,270,266,101.5
36450, 장성군,065005, 64세,2016,601,280,321,87.2,599,279,320,87.2
36450, 장성군,070,65~69세,2016,2817,1301,1516,85.8,2807,1298,1509,86
36450, 장성군,070001, 65세,2016,495,231,264,87.5,492,230,262,87.8
36450, 장성군,070002, 66세,2016,559,242,317,76.3,553,240,313,76.7
36450, 장성군,070003, 67세,2016,583,279,304,91.8,582,279,303,92.1
36450, 장성군,070004, 68세,2016,594,272,322,84.5,594,272,322,84.5
36450, 장성군,070005, 69세,2016,586,277,309,89.6,586,277,309,89.6
36450, 장성군,075,70~74세,2016,2831,1223,1608,76.1,2825,1218,1607,75.8
36450, 장성군,075001, 70세,2016,509,236,273,86.4,508,235,273,86.1
36450, 장성군,075002, 71세,2016,467,211,256,82.4,465,210,255,82.4
36450, 장성군,075003, 72세,2016,493,206,287,71.8,493,206,287,71.8
36450, 장성군,075004, 73세,2016,579,234,345,67.8,578,233,345,67.5
36450, 장성군,075005, 74세,2016,783,336,447,75.2,781,334,447,74.7
36450, 장성군,080,75~79세,2016,2883,1122,1761,63.7,2880,1120,1760,63.6
36450, 장성군,080001, 75세,2016,676,304,372,81.7,676,304,372,81.7
36450, 장성군,080002, 76세,2016,590,224,366,61.2,589,224,365,61.4
36450, 장성군,080003, 77세,2016,559,206,353,58.4,559,206,353,58.4
36450, 장성군,080004, 78세,2016,565,211,354,59.6,564,210,354,59.3
36450, 장성군,080005, 79세,2016,493,177,316,56,492,176,316,55.7
36450, 장성군,085,80~84세,2016,1837,621,1216,51.1,1836,620,1216,51
36450, 장성군,085001, 80세,2016,423,163,260,62.7,423,163,260,62.7
36450, 장성군,085002, 81세,2016,478,163,315,51.7,478,163,315,51.7
36450, 장성군,085003, 82세,2016,402,130,272,47.8,402,130,272,47.8
36450, 장성군,085004, 83세,2016,317,97,220,44.1,316,96,220,43.6
36450, 장성군,085005, 84세,2016,217,68,149,45.6,217,68,149,45.6
36450, 장성군,090,85~89세,2016,778,210,568,37,776,208,568,36.6
36450, 장성군,090001, 85세,2016,202,59,143,41.3,202,59,143,41.3
36450, 장성군,090002, 86세,2016,198,52,146,35.6,198,52,146,35.6
36450, 장성군,090003, 87세,2016,149,39,110,35.5,148,38,110,34.5
36450, 장성군,090004, 88세,2016,133,38,95,40,132,37,95,38.9
36450, 장성군,090005, 89세,2016,96,22,74,29.7,96,22,74,29.7
36450, 장성군,095,90~94세,2016,224,58,166,34.9,224,58,166,34.9
36450, 장성군,095001, 90세,2016,64,17,47,36.2,64,17,47,36.2
36450, 장성군,095002, 91세,2016,54,16,38,42.1,54,16,38,42.1
36450, 장성군,095003, 92세,2016,42,15,27,55.6,42,15,27,55.6
36450, 장성군,095004, 93세,2016,33,7,26,26.9,33,7,26,26.9
36450, 장성군,095005, 94세,2016,31,X,28,10.7,31,X,28,10.7
36450, 장성군,100,95~99세,2016,47,9,38,23.7,47,9,38,23.7
36450, 장성군,100001, 95세,2016,15,X,12,25,15,X,12,25
36450, 장성군,100002, 96세,2016,11,X,9,22.2,11,X,9,22.2
36450, 장성군,100003, 97세,2016,10,X,8,25,10,X,8,25
36450, 장성군,100004, 98세,2016,9,X,9,0,9,X,9,0
36450, 장성군,100005, 99세,2016,X,X,X,,X,X,X,
36450, 장성군,101,100세이상,2016,8,X,7,14.3,8,X,7,14.3
36450, 장성군,102,15세미만,2016,4715,2411,2304,104.6,4706,2408,2298,104.8
36450, 장성군,103,15~64세,2016,25019,13665,11354,120.4,23775,12888,10887,118.4
36450, 장성군,104,65세이상,2016,11425,4545,6880,66.1,11403,4532,6871,66
36450, 장성군,086,85세이상,2016,1057,278,779,35.7,1055,276,779,35.4
36450, 장성군,126,평균연령,2016,47.7,45.2,50.2,,48.1,45.6,50.5,
36450, 장성군,127,중위연령,2016,50.6,47.3,54.2,,51.3,48.3,54.8,
36460, 완도군,000,합계,2016,48349,24784,23565,105.2,46479,23336,23143,100.8
36460, 완도군,005,0~4세,2016,1870,967,903,107.1,1868,966,902,107.1
36460, 완도군,005001, 0세,2016,370,200,170,117.6,370,200,170,117.6
36460, 완도군,005002, 1세,2016,336,181,155,116.8,336,181,155,116.8
36460, 완도군,005003, 2세,2016,388,199,189,105.3,388,199,189,105.3
36460, 완도군,005004, 3세,2016,364,185,179,103.4,364,185,179,103.4
36460, 완도군,005005, 4세,2016,412,202,210,96.2,410,201,209,96.2
36460, 완도군,010,5~9세,2016,1673,858,815,105.3,1670,855,815,104.9
36460, 완도군,010001, 5세,2016,363,199,164,121.3,363,199,164,121.3
36460, 완도군,010002, 6세,2016,349,168,181,92.8,349,168,181,92.8
36460, 완도군,010003, 7세,2016,292,148,144,102.8,291,147,144,102.1
36460, 완도군,010004, 8세,2016,322,175,147,119,321,174,147,118.4
36460, 완도군,010005, 9세,2016,347,168,179,93.9,346,167,179,93.3
36460, 완도군,015,10~14세,2016,1693,870,823,105.7,1693,870,823,105.7
36460, 완도군,015001, 10세,2016,346,178,168,106,346,178,168,106
36460, 완도군,015002, 11세,2016,326,170,156,109,326,170,156,109
36460, 완도군,015003, 12세,2016,362,186,176,105.7,362,186,176,105.7
36460, 완도군,015004, 13세,2016,307,161,146,110.3,307,161,146,110.3
36460, 완도군,015005, 14세,2016,352,175,177,98.9,352,175,177,98.9
36460, 완도군,020,15~19세,2016,1819,1012,807,125.4,1802,1008,794,127
36460, 완도군,020001, 15세,2016,426,225,201,111.9,426,225,201,111.9
36460, 완도군,020002, 16세,2016,427,236,191,123.6,426,236,190,124.2
36460, 완도군,020003, 17세,2016,403,238,165,144.2,399,237,162,146.3
36460, 완도군,020004, 18세,2016,366,191,175,109.1,364,191,173,110.4
36460, 완도군,020005, 19세,2016,197,122,75,162.7,187,119,68,175
36460, 완도군,025,20~24세,2016,1669,1147,522,219.7,1306,841,465,180.9
36460, 완도군,025001, 20세,2016,300,230,70,328.6,285,222,63,352.4
36460, 완도군,025002, 21세,2016,352,274,78,351.3,291,222,69,321.7
36460, 완도군,025003, 22세,2016,340,228,112,203.6,262,163,99,164.6
36460, 완도군,025004, 23세,2016,314,194,120,161.7,225,119,106,112.3
36460, 완도군,025005, 24세,2016,363,221,142,155.6,243,115,128,89.8
36460, 완도군,030,25~29세,2016,2007,1209,798,151.5,1484,777,707,109.9
36460, 완도군,030001, 25세,2016,391,234,157,149,268,132,136,97.1
36460, 완도군,030002, 26세,2016,388,252,136,185.3,284,165,119,138.7
36460, 완도군,030003, 27세,2016,422,246,176,139.8,304,150,154,97.4
36460, 완도군,030004, 28세,2016,396,229,167,137.1,310,161,149,108.1
36460, 완도군,030005, 29세,2016,410,248,162,153.1,318,169,149,113.4
36460, 완도군,035,30~34세,2016,2469,1458,1011,144.2,2117,1152,965,119.4
36460, 완도군,035001, 30세,2016,463,278,185,150.3,378,202,176,114.8
36460, 완도군,035002, 31세,2016,469,267,202,132.2,394,204,190,107.4
36460, 완도군,035003, 32세,2016,448,279,169,165.1,381,216,165,130.9
36460, 완도군,035004, 33세,2016,522,307,215,142.8,455,251,204,123
36460, 완도군,035005, 34세,2016,567,327,240,136.3,509,279,230,121.3
36460, 완도군,040,35~39세,2016,2738,1599,1139,140.4,2522,1417,1105,128.2
36460, 완도군,040001, 35세,2016,543,328,215,152.6,482,276,206,134
36460, 완도군,040002, 36세,2016,575,333,242,137.6,523,287,236,121.6
36460, 완도군,040003, 37세,2016,566,306,260,117.7,524,272,252,107.9
36460, 완도군,040004, 38세,2016,512,304,208,146.2,479,274,205,133.7
36460, 완도군,040005, 39세,2016,542,328,214,153.3,514,308,206,149.5
36460, 완도군,045,40~44세,2016,2867,1675,1192,140.5,2778,1613,1165,138.5
36460, 완도군,045001, 40세,2016,500,300,200,150,474,281,193,145.6
36460, 완도군,045002, 41세,2016,508,308,200,154,493,298,195,152.8
36460, 완도군,045003, 42세,2016,613,362,251,144.2,591,344,247,139.3
36460, 완도군,045004, 43세,2016,603,346,257,134.6,588,336,252,133.3
36460, 완도군,045005, 44세,2016,643,359,284,126.4,632,354,278,127.3
36460, 완도군,050,45~49세,2016,3376,1966,1410,139.4,3290,1919,1371,140
36460, 완도군,050001, 45세,2016,673,406,267,152.1,657,397,260,152.7
36460, 완도군,050002, 46세,2016,668,388,280,138.6,651,380,271,140.2
36460, 완도군,050003, 47세,2016,659,390,269,145,638,380,258,147.3
36460, 완도군,050004, 48세,2016,718,425,293,145.1,700,416,284,146.5
36460, 완도군,050005, 49세,2016,658,357,301,118.6,644,346,298,116.1
36460, 완도군,055,50~54세,2016,3686,1994,1692,117.8,3585,1946,1639,118.7
36460, 완도군,055001, 50세,2016,708,427,281,152,690,418,272,153.7
36460, 완도군,055002, 51세,2016,670,351,319,110,646,340,306,111.1
36460, 완도군,055003, 52세,2016,684,372,312,119.2,669,365,304,120.1
36460, 완도군,055004, 53세,2016,789,422,367,115,768,411,357,115.1
36460, 완도군,055005, 54세,2016,835,422,413,102.2,812,412,400,103
36460, 완도군,060,55~59세,2016,4445,2208,2237,98.7,4391,2185,2206,99
36460, 완도군,060001, 55세,2016,853,430,423,101.7,839,426,413,103.1
36460, 완도군,060002, 56세,2016,1055,518,537,96.5,1041,511,530,96.4
36460, 완도군,060003, 57세,2016,882,434,448,96.9,873,433,440,98.4
36460, 완도군,060004, 58세,2016,810,397,413,96.1,802,393,409,96.1
36460, 완도군,060005, 59세,2016,845,429,416,103.1,836,422,414,101.9
36460, 완도군,065,60~64세,2016,3679,1841,1838,100.2,3648,1825,1823,100.1
36460, 완도군,065001, 60세,2016,838,448,390,114.9,830,441,389,113.4
36460, 완도군,065002, 61세,2016,873,437,436,100.2,866,434,432,100.5
36460, 완도군,065003, 62세,2016,655,326,329,99.1,650,324,326,99.4
36460, 완도군,065004, 63세,2016,569,273,296,92.2,562,270,292,92.5
36460, 완도군,065005, 64세,2016,744,357,387,92.2,740,356,384,92.7
36460, 완도군,070,65~69세,2016,3782,1850,1932,95.8,3763,1839,1924,95.6
36460, 완도군,070001, 65세,2016,766,393,373,105.4,758,389,369,105.4
36460, 완도군,070002, 66세,2016,734,340,394,86.3,727,337,390,86.4
36460, 완도군,070003, 67세,2016,733,381,352,108.2,731,379,352,107.7
36460, 완도군,070004, 68세,2016,732,352,380,92.6,731,351,380,92.4
36460, 완도군,070005, 69세,2016,817,384,433,88.7,816,383,433,88.5
36460, 완도군,075,70~74세,2016,3672,1690,1982,85.3,3665,1686,1979,85.2
36460, 완도군,075001, 70세,2016,594,294,300,98,590,292,298,98
36460, 완도군,075002, 71세,2016,757,342,415,82.4,757,342,415,82.4
36460, 완도군,075003, 72세,2016,706,326,380,85.8,706,326,380,85.8
36460, 완도군,075004, 73세,2016,698,301,397,75.8,695,299,396,75.5
36460, 완도군,075005, 74세,2016,917,427,490,87.1,917,427,490,87.1
36460, 완도군,080,75~79세,2016,3551,1444,2107,68.5,3548,1443,2105,68.6
36460, 완도군,080001, 75세,2016,788,337,451,74.7,788,337,451,74.7
36460, 완도군,080002, 76세,2016,759,316,443,71.3,759,316,443,71.3
36460, 완도군,080003, 77세,2016,732,288,444,64.9,732,288,444,64.9
36460, 완도군,080004, 78세,2016,685,275,410,67.1,683,274,409,67
36460, 완도군,080005, 79세,2016,587,228,359,63.5,586,228,358,63.7
36460, 완도군,085,80~84세,2016,2119,714,1405,50.8,2118,714,1404,50.9
36460, 완도군,085001, 80세,2016,510,189,321,58.9,510,189,321,58.9
36460, 완도군,085002, 81세,2016,436,155,281,55.2,436,155,281,55.2
36460, 완도군,085003, 82세,2016,449,133,316,42.1,448,133,315,42.2
36460, 완도군,085004, 83세,2016,378,128,250,51.2,378,128,250,51.2
36460, 완도군,085005, 84세,2016,346,109,237,46,346,109,237,46
36460, 완도군,090,85~89세,2016,919,226,693,32.6,918,226,692,32.7
36460, 완도군,090001, 85세,2016,259,77,182,42.3,259,77,182,42.3
36460, 완도군,090002, 86세,2016,246,54,192,28.1,246,54,192,28.1
36460, 완도군,090003, 87세,2016,176,41,135,30.4,176,41,135,30.4
36460, 완도군,090004, 88세,2016,140,35,105,33.3,140,35,105,33.3
36460, 완도군,090005, 89세,2016,98,19,79,24.1,97,19,78,24.4
36460, 완도군,095,90~94세,2016,249,49,200,24.5,248,48,200,24
36460, 완도군,095001, 90세,2016,72,19,53,35.8,72,19,53,35.8
36460, 완도군,095002, 91세,2016,50,13,37,35.1,50,13,37,35.1
36460, 완도군,095003, 92세,2016,41,8,33,24.2,41,8,33,24.2
36460, 완도군,095004, 93세,2016,46,X,43,7,46,X,43,7
36460, 완도군,095005, 94세,2016,40,6,34,17.6,39,5,34,14.7
36460, 완도군,100,95~99세,2016,58,5,53,9.4,57,X,53,7.5
36460, 완도군,100001, 95세,2016,24,X,21,14.3,24,X,21,14.3
36460, 완도군,100002, 96세,2016,18,X,17,5.9,18,X,17,5.9
36460, 완도군,100003, 97세,2016,9,X,9,0,9,X,9,0
36460, 완도군,100004, 98세,2016,X,X,X,50,X,X,X,0
36460, 완도군,100005, 99세,2016,X,X,X,0,X,X,X,0
36460, 완도군,101,100세이상,2016,8,X,6,33.3,8,X,6,33.3
36460, 완도군,102,15세미만,2016,5236,2695,2541,106.1,5231,2691,2540,105.9
36460, 완도군,103,15~64세,2016,28755,16109,12646,127.4,26923,14683,12240,120
36460, 완도군,104,65세이상,2016,14358,5980,8378,71.4,14325,5962,8363,71.3
36460, 완도군,086,85세이상,2016,1234,282,952,29.6,1231,280,951,29.4
36460, 완도군,126,평균연령,2016,49.4,46.7,52.2,,50,47.6,52.5,
36460, 완도군,127,중위연령,2016,52.9,49,56.5,,53.9,50.6,56.8,
36470, 진도군,000,합계,2016,29504,14867,14637,101.6,28159,13775,14384,95.8
36470, 진도군,005,0~4세,2016,946,482,464,103.9,943,482,461,104.6
36470, 진도군,005001, 0세,2016,172,83,89,93.3,172,83,89,93.3
36470, 진도군,005002, 1세,2016,201,99,102,97.1,201,99,102,97.1
36470, 진도군,005003, 2세,2016,173,89,84,106,172,89,83,107.2
36470, 진도군,005004, 3세,2016,196,96,100,96,195,96,99,97
36470, 진도군,005005, 4세,2016,204,115,89,129.2,203,115,88,130.7
36470, 진도군,010,5~9세,2016,994,501,493,101.6,992,500,492,101.6
36470, 진도군,010001, 5세,2016,233,105,128,82,233,105,128,82
36470, 진도군,010002, 6세,2016,159,92,67,137.3,159,92,67,137.3
36470, 진도군,010003, 7세,2016,201,105,96,109.4,201,105,96,109.4
36470, 진도군,010004, 8세,2016,176,90,86,104.7,174,89,85,104.7
36470, 진도군,010005, 9세,2016,225,109,116,94,225,109,116,94
36470, 진도군,015,10~14세,2016,993,504,489,103.1,993,504,489,103.1
36470, 진도군,015001, 10세,2016,183,95,88,108,183,95,88,108
36470, 진도군,015002, 11세,2016,177,96,81,118.5,177,96,81,118.5
36470, 진도군,015003, 12세,2016,178,80,98,81.6,178,80,98,81.6
36470, 진도군,015004, 13세,2016,216,102,114,89.5,216,102,114,89.5
36470, 진도군,015005, 14세,2016,239,131,108,121.3,239,131,108,121.3
36470, 진도군,020,15~19세,2016,1131,617,514,120,1126,615,511,120.4
36470, 진도군,020001, 15세,2016,274,146,128,114.1,274,146,128,114.1
36470, 진도군,020002, 16세,2016,246,134,112,119.6,246,134,112,119.6
36470, 진도군,020003, 17세,2016,283,151,132,114.4,282,150,132,113.6
36470, 진도군,020004, 18세,2016,215,109,106,102.8,215,109,106,102.8
36470, 진도군,020005, 19세,2016,113,77,36,213.9,109,76,33,230.3
36470, 진도군,025,20~24세,2016,1147,787,360,218.6,852,535,317,168.8
36470, 진도군,025001, 20세,2016,189,143,46,310.9,166,126,40,315
36470, 진도군,025002, 21세,2016,227,178,49,363.3,189,147,42,350
36470, 진도군,025003, 22세,2016,229,156,73,213.7,161,95,66,143.9
36470, 진도군,025004, 23세,2016,230,147,83,177.1,154,81,73,111
36470, 진도군,025005, 24세,2016,272,163,109,149.5,182,86,96,89.6
36470, 진도군,030,25~29세,2016,1345,859,486,176.7,903,471,432,109
36470, 진도군,030001, 25세,2016,260,172,88,195.5,157,78,79,98.7
36470, 진도군,030002, 26세,2016,291,199,92,216.3,190,109,81,134.6
36470, 진도군,030003, 27세,2016,271,169,102,165.7,183,93,90,103.3
36470, 진도군,030004, 28세,2016,251,160,91,175.8,182,95,87,109.2
36470, 진도군,030005, 29세,2016,272,159,113,140.7,191,96,95,101.1
36470, 진도군,035,30~34세,2016,1304,793,511,155.2,1059,587,472,124.4
36470, 진도군,035001, 30세,2016,254,158,96,164.6,184,97,87,111.5
36470, 진도군,035002, 31세,2016,228,139,89,156.2,179,101,78,129.5
36470, 진도군,035003, 32세,2016,269,160,109,146.8,231,126,105,120
36470, 진도군,035004, 33세,2016,245,150,95,157.9,207,119,88,135.2
36470, 진도군,035005, 34세,2016,308,186,122,152.5,258,144,114,126.3
36470, 진도군,040,35~39세,2016,1459,834,625,133.4,1335,729,606,120.3
36470, 진도군,040001, 35세,2016,267,158,109,145,239,135,104,129.8
36470, 진도군,040002, 36세,2016,328,185,143,129.4,298,162,136,119.1
36470, 진도군,040003, 37세,2016,281,158,123,128.5,255,134,121,110.7
36470, 진도군,040004, 38세,2016,279,162,117,138.5,251,137,114,120.2
36470, 진도군,040005, 39세,2016,304,171,133,128.6,292,161,131,122.9
36470, 진도군,045,40~44세,2016,1677,982,695,141.3,1617,939,678,138.5
36470, 진도군,045001, 40세,2016,269,151,118,128,258,143,115,124.3
36470, 진도군,045002, 41세,2016,338,213,125,170.4,327,205,122,168
36470, 진도군,045003, 42세,2016,344,194,150,129.3,330,184,146,126
36470, 진도군,045004, 43세,2016,361,206,155,132.9,350,198,152,130.3
36470, 진도군,045005, 44세,2016,365,218,147,148.3,352,209,143,146.2
36470, 진도군,050,45~49세,2016,1930,1098,832,132,1880,1065,815,130.7
36470, 진도군,050001, 45세,2016,381,230,151,152.3,367,220,147,149.7
36470, 진도군,050002, 46세,2016,365,215,150,143.3,360,210,150,140
36470, 진도군,050003, 47세,2016,383,222,161,137.9,371,217,154,140.9
36470, 진도군,050004, 48세,2016,439,239,200,119.5,426,229,197,116.2
36470, 진도군,050005, 49세,2016,362,192,170,112.9,356,189,167,113.2
36470, 진도군,055,50~54세,2016,2302,1273,1029,123.7,2261,1251,1010,123.9
36470, 진도군,055001, 50세,2016,475,281,194,144.8,464,273,191,142.9
36470, 진도군,055002, 51세,2016,451,243,208,116.8,445,240,205,117.1
36470, 진도군,055003, 52세,2016,462,258,204,126.5,453,254,199,127.6
36470, 진도군,055004, 53세,2016,427,233,194,120.1,416,229,187,122.5
36470, 진도군,055005, 54세,2016,487,258,229,112.7,483,255,228,111.8
36470, 진도군,060,55~59세,2016,2707,1384,1323,104.6,2663,1362,1301,104.7
36470, 진도군,060001, 55세,2016,559,284,275,103.3,548,276,272,101.5
36470, 진도군,060002, 56세,2016,630,311,319,97.5,622,307,315,97.5
36470, 진도군,060003, 57세,2016,498,249,249,100,492,247,245,100.8
36470, 진도군,060004, 58세,2016,515,275,240,114.6,507,271,236,114.8
36470, 진도군,060005, 59세,2016,505,265,240,110.4,494,261,233,112
36470, 진도군,065,60~64세,2016,2175,1096,1079,101.6,2158,1084,1074,100.9
36470, 진도군,065001, 60세,2016,514,283,231,122.5,510,280,230,121.7
36470, 진도군,065002, 61세,2016,478,246,232,106,473,245,228,107.5
36470, 진도군,065003, 62세,2016,349,174,175,99.4,347,172,175,98.3
36470, 진도군,065004, 63세,2016,374,170,204,83.3,369,165,204,80.9
36470, 진도군,065005, 64세,2016,460,223,237,94.1,459,222,237,93.7
36470, 진도군,070,65~69세,2016,2309,1142,1167,97.9,2296,1137,1159,98.1
36470, 진도군,070001, 65세,2016,420,196,224,87.5,418,195,223,87.4
36470, 진도군,070002, 66세,2016,482,245,237,103.4,477,245,232,105.6
36470, 진도군,070003, 67세,2016,450,239,211,113.3,446,237,209,113.4
36470, 진도군,070004, 68세,2016,462,219,243,90.1,460,217,243,89.3
36470, 진도군,070005, 69세,2016,495,243,252,96.4,495,243,252,96.4
36470, 진도군,075,70~74세,2016,2377,995,1382,72,2374,994,1380,72
36470, 진도군,075001, 70세,2016,385,182,203,89.7,385,182,203,89.7
36470, 진도군,075002, 71세,2016,501,218,283,77,500,218,282,77.3
36470, 진도군,075003, 72세,2016,403,180,223,80.7,402,180,222,81.1
36470, 진도군,075004, 73세,2016,434,171,263,65,433,170,263,64.6
36470, 진도군,075005, 74세,2016,654,244,410,59.5,654,244,410,59.5
36470, 진도군,080,75~79세,2016,2460,929,1531,60.7,2460,929,1531,60.7
36470, 진도군,080001, 75세,2016,554,210,344,61,554,210,344,61
36470, 진도군,080002, 76세,2016,565,228,337,67.7,565,228,337,67.7
36470, 진도군,080003, 77세,2016,492,207,285,72.6,492,207,285,72.6
36470, 진도군,080004, 78세,2016,483,146,337,43.3,483,146,337,43.3
36470, 진도군,080005, 79세,2016,366,138,228,60.5,366,138,228,60.5
36470, 진도군,085,80~84세,2016,1397,389,1008,38.6,1396,389,1007,38.6
36470, 진도군,085001, 80세,2016,330,112,218,51.4,330,112,218,51.4
36470, 진도군,085002, 81세,2016,320,99,221,44.8,319,99,220,45
36470, 진도군,085003, 82세,2016,291,80,211,37.9,291,80,211,37.9
36470, 진도군,085004, 83세,2016,240,49,191,25.7,240,49,191,25.7
36470, 진도군,085005, 84세,2016,216,49,167,29.3,216,49,167,29.3
36470, 진도군,090,85~89세,2016,642,161,481,33.5,642,161,481,33.5
36470, 진도군,090001, 85세,2016,158,44,114,38.6,158,44,114,38.6
36470, 진도군,090002, 86세,2016,185,42,143,29.4,185,42,143,29.4
36470, 진도군,090003, 87세,2016,118,27,91,29.7,118,27,91,29.7
36470, 진도군,090004, 88세,2016,112,32,80,40,112,32,80,40
36470, 진도군,090005, 89세,2016,69,16,53,30.2,69,16,53,30.2
36470, 진도군,095,90~94세,2016,171,37,134,27.6,171,37,134,27.6
36470, 진도군,095001, 90세,2016,49,12,37,32.4,49,12,37,32.4
36470, 진도군,095002, 91세,2016,45,9,36,25,45,9,36,25
36470, 진도군,095003, 92세,2016,25,6,19,31.6,25,6,19,31.6
36470, 진도군,095004, 93세,2016,26,6,20,30,26,6,20,30
36470, 진도군,095005, 94세,2016,26,X,22,18.2,26,X,22,18.2
36470, 진도군,100,95~99세,2016,33,X,30,10,33,X,30,10
36470, 진도군,100001, 95세,2016,12,X,11,9.1,12,X,11,9.1
36470, 진도군,100002, 96세,2016,11,X,10,10,11,X,10,10
36470, 진도군,100003, 97세,2016,7,X,6,16.7,7,X,6,16.7
36470, 진도군,100004, 98세,2016,X,X,X,0,X,X,X,0
36470, 진도군,100005, 99세,2016,X,X,X,0,X,X,X,0
36470, 진도군,101,100세이상,2016,5,X,X,25,5,X,X,25
36470, 진도군,102,15세미만,2016,2933,1487,1446,102.8,2928,1486,1442,103.1
36470, 진도군,103,15~64세,2016,17177,9723,7454,130.4,15854,8638,7216,119.7
36470, 진도군,104,65세이상,2016,9394,3657,5737,63.7,9377,3651,5726,63.8
36470, 진도군,086,85세이상,2016,851,202,649,31.1,851,202,649,31.1
36470, 진도군,126,평균연령,2016,50.4,47.1,53.7,,51.3,48.3,54,
36470, 진도군,127,중위연령,2016,54,49.9,57.9,,55.2,51.8,58.3,
36480, 신안군,000,합계,2016,35789,18681,17108,109.2,34969,18145,16824,107.9
36480, 신안군,005,0~4세,2016,1015,522,493,105.9,1014,521,493,105.7
36480, 신안군,005001, 0세,2016,199,104,95,109.5,199,104,95,109.5
36480, 신안군,005002, 1세,2016,197,104,93,111.8,197,104,93,111.8
36480, 신안군,005003, 2세,2016,188,104,84,123.8,188,104,84,123.8
36480, 신안군,005004, 3세,2016,219,109,110,99.1,218,108,110,98.2
36480, 신안군,005005, 4세,2016,212,101,111,91,212,101,111,91
36480, 신안군,010,5~9세,2016,836,416,420,99,835,415,420,98.8
36480, 신안군,010001, 5세,2016,209,104,105,99,209,104,105,99
36480, 신안군,010002, 6세,2016,145,71,74,95.9,145,71,74,95.9
36480, 신안군,010003, 7세,2016,151,70,81,86.4,151,70,81,86.4
36480, 신안군,010004, 8세,2016,177,91,86,105.8,176,90,86,104.7
36480, 신안군,010005, 9세,2016,154,80,74,108.1,154,80,74,108.1
36480, 신안군,015,10~14세,2016,782,413,369,111.9,782,413,369,111.9
36480, 신안군,015001, 10세,2016,141,71,70,101.4,141,71,70,101.4
36480, 신안군,015002, 11세,2016,130,63,67,94,130,63,67,94
36480, 신안군,015003, 12세,2016,153,83,70,118.6,153,83,70,118.6
36480, 신안군,015004, 13세,2016,166,86,80,107.5,166,86,80,107.5
36480, 신안군,015005, 14세,2016,192,110,82,134.1,192,110,82,134.1
36480, 신안군,020,15~19세,2016,1184,636,548,116.1,1177,631,546,115.6
36480, 신안군,020001, 15세,2016,231,118,113,104.4,231,118,113,104.4
36480, 신안군,020002, 16세,2016,299,150,149,100.7,299,150,149,100.7
36480, 신안군,020003, 17세,2016,268,137,131,104.6,267,136,131,103.8
36480, 신안군,020004, 18세,2016,234,131,103,127.2,233,131,102,128.4
36480, 신안군,020005, 19세,2016,152,100,52,192.3,147,96,51,188.2
36480, 신안군,025,20~24세,2016,1193,775,418,185.4,1069,689,380,181.3
36480, 신안군,025001, 20세,2016,212,169,43,393,207,167,40,417.5
36480, 신안군,025002, 21세,2016,280,201,79,254.4,260,188,72,261.1
36480, 신안군,025003, 22세,2016,231,155,76,203.9,202,131,71,184.5
36480, 신안군,025004, 23세,2016,218,120,98,122.4,188,100,88,113.6
36480, 신안군,025005, 24세,2016,252,130,122,106.6,212,103,109,94.5
36480, 신안군,030,25~29세,2016,1545,934,611,152.9,1304,756,548,138
36480, 신안군,030001, 25세,2016,300,179,121,147.9,253,140,113,123.9
36480, 신안군,030002, 26세,2016,321,195,126,154.8,274,161,113,142.5
36480, 신안군,030003, 27세,2016,328,192,136,141.2,273,154,119,129.4
36480, 신안군,030004, 28세,2016,300,189,111,170.3,247,151,96,157.3
36480, 신안군,030005, 29세,2016,296,179,117,153,257,150,107,140.2
36480, 신안군,035,30~34세,2016,1486,920,566,162.5,1345,825,520,158.7
36480, 신안군,035001, 30세,2016,279,180,99,181.8,245,158,87,181.6
36480, 신안군,035002, 31세,2016,265,176,89,197.8,233,156,77,202.6
36480, 신안군,035003, 32세,2016,291,171,120,142.5,264,152,112,135.7
36480, 신안군,035004, 33세,2016,321,178,143,124.5,300,162,138,117.4
36480, 신안군,035005, 34세,2016,330,215,115,187,303,197,106,185.8
36480, 신안군,040,35~39세,2016,1526,996,530,187.9,1413,914,499,183.2
36480, 신안군,040001, 35세,2016,280,184,96,191.7,255,165,90,183.3
36480, 신안군,040002, 36세,2016,310,198,112,176.8,289,181,108,167.6
36480, 신안군,040003, 37세,2016,316,197,119,165.5,292,182,110,165.5
36480, 신안군,040004, 38세,2016,306,209,97,215.5,282,193,89,216.9
36480, 신안군,040005, 39세,2016,314,208,106,196.2,295,193,102,189.2
36480, 신안군,045,40~44세,2016,1855,1228,627,195.9,1794,1195,599,199.5
36480, 신안군,045001, 40세,2016,310,214,96,222.9,294,207,87,237.9
36480, 신안군,045002, 41세,2016,321,224,97,230.9,311,219,92,238
36480, 신안군,045003, 42세,2016,384,244,140,174.3,371,237,134,176.9
36480, 신안군,045004, 43세,2016,420,274,146,187.7,408,267,141,189.4
36480, 신안군,045005, 44세,2016,420,272,148,183.8,410,265,145,182.8
36480, 신안군,050,45~49세,2016,2345,1491,854,174.6,2315,1480,835,177.2
36480, 신안군,050001, 45세,2016,427,278,149,186.6,420,277,143,193.7
36480, 신안군,050002, 46세,2016,486,314,172,182.6,480,311,169,184
36480, 신안군,050003, 47세,2016,484,313,171,183,476,309,167,185
36480, 신안군,050004, 48세,2016,491,311,180,172.8,488,310,178,174.2
36480, 신안군,050005, 49세,2016,457,275,182,151.1,451,273,178,153.4
36480, 신안군,055,50~54세,2016,2939,1738,1201,144.7,2900,1720,1180,145.8
36480, 신안군,055001, 50세,2016,594,355,239,148.5,585,351,234,150
36480, 신안군,055002, 51세,2016,566,338,228,148.2,558,336,222,151.4
36480, 신안군,055003, 52세,2016,548,334,214,156.1,541,328,213,154
36480, 신안군,055004, 53세,2016,614,361,253,142.7,605,358,247,144.9
36480, 신안군,055005, 54세,2016,617,350,267,131.1,611,347,264,131.4
36480, 신안군,060,55~59세,2016,3533,1967,1566,125.6,3506,1957,1549,126.3
36480, 신안군,060001, 55세,2016,710,396,314,126.1,709,395,314,125.8
36480, 신안군,060002, 56세,2016,763,405,358,113.1,755,401,354,113.3
36480, 신안군,060003, 57세,2016,690,410,280,146.4,683,409,274,149.3
36480, 신안군,060004, 58세,2016,683,378,305,123.9,677,376,301,124.9
36480, 신안군,060005, 59세,2016,687,378,309,122.3,682,376,306,122.9
36480, 신안군,065,60~64세,2016,3104,1584,1520,104.2,3079,1572,1507,104.3
36480, 신안군,065001, 60세,2016,634,331,303,109.2,627,327,300,109
36480, 신안군,065002, 61세,2016,695,372,323,115.2,687,367,320,114.7
36480, 신안군,065003, 62세,2016,568,296,272,108.8,563,295,268,110.1
36480, 신안군,065004, 63세,2016,529,269,260,103.5,527,268,259,103.5
36480, 신안군,065005, 64세,2016,678,316,362,87.3,675,315,360,87.5
36480, 신안군,070,65~69세,2016,3040,1579,1461,108.1,3033,1576,1457,108.2
36480, 신안군,070001, 65세,2016,570,308,262,117.6,568,308,260,118.5
36480, 신안군,070002, 66세,2016,570,294,276,106.5,569,293,276,106.2
36480, 신안군,070003, 67세,2016,592,309,283,109.2,590,308,282,109.2
36480, 신안군,070004, 68세,2016,590,301,289,104.2,588,300,288,104.2
36480, 신안군,070005, 69세,2016,718,367,351,104.6,718,367,351,104.6
36480, 신안군,075,70~74세,2016,3226,1436,1790,80.2,3224,1436,1788,80.3
36480, 신안군,075001, 70세,2016,597,299,298,100.3,597,299,298,100.3
36480, 신안군,075002, 71세,2016,595,281,314,89.5,595,281,314,89.5
36480, 신안군,075003, 72세,2016,515,209,306,68.3,515,209,306,68.3
36480, 신안군,075004, 73세,2016,674,286,388,73.7,672,286,386,74.1
36480, 신안군,075005, 74세,2016,845,361,484,74.6,845,361,484,74.6
36480, 신안군,080,75~79세,2016,3177,1208,1969,61.4,3176,1207,1969,61.3
36480, 신안군,080001, 75세,2016,693,288,405,71.1,692,287,405,70.9
36480, 신안군,080002, 76세,2016,652,245,407,60.2,652,245,407,60.2
36480, 신안군,080003, 77세,2016,642,240,402,59.7,642,240,402,59.7
36480, 신안군,080004, 78세,2016,609,232,377,61.5,609,232,377,61.5
36480, 신안군,080005, 79세,2016,581,203,378,53.7,581,203,378,53.7
36480, 신안군,085,80~84세,2016,1920,577,1343,43,1920,577,1343,43
36480, 신안군,085001, 80세,2016,461,144,317,45.4,461,144,317,45.4
36480, 신안군,085002, 81세,2016,442,135,307,44,442,135,307,44
36480, 신안군,085003, 82세,2016,410,142,268,53,410,142,268,53
36480, 신안군,085004, 83세,2016,345,91,254,35.8,345,91,254,35.8
36480, 신안군,085005, 84세,2016,262,65,197,33,262,65,197,33
36480, 신안군,090,85~89세,2016,806,194,612,31.7,806,194,612,31.7
36480, 신안군,090001, 85세,2016,206,48,158,30.4,206,48,158,30.4
36480, 신안군,090002, 86세,2016,250,56,194,28.9,250,56,194,28.9
36480, 신안군,090003, 87세,2016,138,30,108,27.8,138,30,108,27.8
36480, 신안군,090004, 88세,2016,112,28,84,33.3,112,28,84,33.3
36480, 신안군,090005, 89세,2016,100,32,68,47.1,100,32,68,47.1
36480, 신안군,095,90~94세,2016,232,60,172,34.9,232,60,172,34.9
36480, 신안군,095001, 90세,2016,55,24,31,77.4,55,24,31,77.4
36480, 신안군,095002, 91세,2016,53,16,37,43.2,53,16,37,43.2
36480, 신안군,095003, 92세,2016,32,8,24,33.3,32,8,24,33.3
36480, 신안군,095004, 93세,2016,49,5,44,11.4,49,5,44,11.4
36480, 신안군,095005, 94세,2016,43,7,36,19.4,43,7,36,19.4
36480, 신안군,100,95~99세,2016,39,5,34,14.7,39,5,34,14.7
36480, 신안군,100001, 95세,2016,10,X,9,11.1,10,X,9,11.1
36480, 신안군,100002, 96세,2016,17,X,17,0,17,X,17,0
36480, 신안군,100003, 97세,2016,7,X,6,16.7,7,X,6,16.7
36480, 신안군,100004, 98세,2016,X,X,X,50,X,X,X,50
36480, 신안군,100005, 99세,2016,X,X,X,,X,X,X,
36480, 신안군,101,100세이상,2016,6,X,X,50,6,X,X,50
36480, 신안군,102,15세미만,2016,2633,1351,1282,105.4,2631,1349,1282,105.2
36480, 신안군,103,15~64세,2016,20710,12269,8441,145.4,19902,11739,8163,143.8
36480, 신안군,104,65세이상,2016,12446,5061,7385,68.5,12436,5057,7379,68.5
36480, 신안군,086,85세이상,2016,1083,261,822,31.8,1083,261,822,31.8
36480, 신안군,126,평균연령,2016,53,49.9,56.3,,53.4,50.4,56.6,
36480, 신안군,127,중위연령,2016,56.6,52.9,61.1,,57.1,53.6,61.5,
37,경상북도,000,합계,2016,2682169,1354997,1327172,102.1,2621463,1316296,1305167,100.9
37,경상북도,005,0~4세,2016,110450,57006,53444,106.7,109878,56724,53154,106.7
37,경상북도,005001, 0세,2016,20989,10817,10172,106.3,20859,10751,10108,106.4
37,경상북도,005002, 1세,2016,22251,11425,10826,105.5,22141,11371,10770,105.6
37,경상북도,005003, 2세,2016,21472,11135,10337,107.7,21375,11090,10285,107.8
37,경상북도,005004, 3세,2016,22100,11386,10714,106.3,21969,11313,10656,106.2
37,경상북도,005005, 4세,2016,23638,12243,11395,107.4,23534,12199,11335,107.6
37,경상북도,010,5~9세,2016,109851,57121,52730,108.3,109442,56917,52525,108.4
37,경상북도,010001, 5세,2016,22991,12004,10987,109.3,22889,11962,10927,109.5
37,경상북도,010002, 6세,2016,21569,11131,10438,106.6,21480,11086,10394,106.7
37,경상북도,010003, 7세,2016,20860,10914,9946,109.7,20780,10872,9908,109.7
37,경상북도,010004, 8세,2016,22057,11481,10576,108.6,21979,11442,10537,108.6
37,경상북도,010005, 9세,2016,22374,11591,10783,107.5,22314,11555,10759,107.4
37,경상북도,015,10~14세,2016,109567,57730,51837,111.4,109372,57630,51742,111.4
37,경상북도,015001, 10세,2016,20711,10913,9798,111.4,20664,10893,9771,111.5
37,경상북도,015002, 11세,2016,20417,10616,9801,108.3,20373,10592,9781,108.3
37,경상북도,015003, 12세,2016,22010,11674,10336,112.9,21975,11655,10320,112.9
37,경상북도,015004, 13세,2016,22512,11821,10691,110.6,22483,11805,10678,110.6
37,경상북도,015005, 14세,2016,23917,12706,11211,113.3,23877,12685,11192,113.3
37,경상북도,020,15~19세,2016,158144,85047,73097,116.3,156872,84447,72425,116.6
37,경상북도,020001, 15세,2016,28045,14881,13164,113,28016,14869,13147,113.1
37,경상북도,020002, 16세,2016,32069,17283,14786,116.9,32009,17258,14751,117
37,경상북도,020003, 17세,2016,30662,16509,14153,116.6,30559,16452,14107,116.6
37,경상북도,020004, 18세,2016,32401,17369,15032,115.5,32115,17238,14877,115.9
37,경상북도,020005, 19세,2016,34967,19005,15962,119.1,34173,18630,15543,119.9
37,경상북도,025,20~24세,2016,173588,98237,75351,130.4,164667,92959,71708,129.6
37,경상북도,025001, 20세,2016,35176,19230,15946,120.6,34024,18701,15323,122
37,경상북도,025002, 21세,2016,35294,19702,15592,126.4,33841,18969,14872,127.5
37,경상북도,025003, 22세,2016,35062,20017,15045,133,33350,18981,14369,132.1
37,경상북도,025004, 23세,2016,34011,19723,14288,138,31924,18386,13538,135.8
37,경상북도,025005, 24세,2016,34045,19565,14480,135.1,31528,17922,13606,131.7
37,경상북도,030,25~29세,2016,148881,84582,64299,131.5,135395,75613,59782,126.5
37,경상북도,030001, 25세,2016,30974,17703,13271,133.4,28387,15965,12422,128.5
37,경상북도,030002, 26세,2016,30047,17262,12785,135,27242,15396,11846,130
37,경상북도,030003, 27세,2016,28984,16671,12313,135.4,26290,14869,11421,130.2
37,경상북도,030004, 28세,2016,28875,16379,12496,131.1,26179,14630,11549,126.7
37,경상북도,030005, 29세,2016,30001,16567,13434,123.3,27297,14753,12544,117.6
37,경상북도,035,30~34세,2016,165123,89308,75815,117.8,153786,81323,72463,112.2
37,경상북도,035001, 30세,2016,29812,16564,13248,125,27362,14856,12506,118.8
37,경상북도,035002, 31세,2016,30352,16752,13600,123.2,27839,15008,12831,117
37,경상북도,035003, 32세,2016,31513,17000,14513,117.1,29252,15393,13859,111.1
37,경상북도,035004, 33세,2016,35018,18613,16405,113.5,32966,17169,15797,108.7
37,경상북도,035005, 34세,2016,38428,20379,18049,112.9,36367,18897,17470,108.2
37,경상북도,040,35~39세,2016,182569,96826,85743,112.9,175114,91484,83630,109.4
37,경상북도,040001, 35세,2016,38281,20393,17888,114,36537,19138,17399,110
37,경상북도,040002, 36세,2016,39021,20720,18301,113.2,37372,19554,17818,109.7
37,경상북도,040003, 37세,2016,36342,19247,17095,112.6,34829,18163,16666,109
37,경상북도,040004, 38세,2016,33723,17990,15733,114.3,32380,17022,15358,110.8
37,경상북도,040005, 39세,2016,35202,18476,16726,110.5,33996,17607,16389,107.4
37,경상북도,045,40~44세,2016,194693,101680,93013,109.3,189542,98168,91374,107.4
37,경상북도,045001, 40세,2016,34813,18373,16440,111.8,33648,17548,16100,109
37,경상북도,045002, 41세,2016,37370,19398,17972,107.9,36336,18688,17648,105.9
37,경상북도,045003, 42세,2016,40348,21010,19338,108.6,39320,20319,19001,106.9
37,경상북도,045004, 43세,2016,41088,21197,19891,106.6,40137,20549,19588,104.9
37,경상북도,045005, 44세,2016,41074,21702,19372,112,40101,21064,19037,110.6
37,경상북도,050,45~49세,2016,217960,112990,104970,107.6,213883,110589,103294,107.1
37,경상북도,050001, 45세,2016,43341,22874,20467,111.8,42417,22293,20124,110.8
37,경상북도,050002, 46세,2016,43344,22494,20850,107.9,42457,21955,20502,107.1
37,경상북도,050003, 47세,2016,43908,22851,21057,108.5,43096,22380,20716,108
37,경상북도,050004, 48세,2016,45762,23560,22202,106.1,44975,23111,21864,105.7
37,경상북도,050005, 49세,2016,41605,21211,20394,104,40938,20850,20088,103.8
37,경상북도,055,50~54세,2016,216891,112019,104872,106.8,213705,110323,103382,106.7
37,경상북도,055001, 50세,2016,42455,22350,20105,111.2,41811,22015,19796,111.2
37,경상북도,055002, 51세,2016,42880,21785,21095,103.3,42203,21426,20777,103.1
37,경상북도,055003, 52세,2016,41345,21419,19926,107.5,40676,21069,19607,107.5
37,경상북도,055004, 53세,2016,43778,22507,21271,105.8,43126,22144,20982,105.5
37,경상북도,055005, 54세,2016,46433,23958,22475,106.6,45889,23669,22220,106.5
37,경상북도,060,55~59세,2016,230618,116305,114313,101.7,228464,115208,113256,101.7
37,경상북도,060001, 55세,2016,50505,25771,24734,104.2,50066,25536,24530,104.1
37,경상북도,060002, 56세,2016,50328,25068,25260,99.2,49815,24824,24991,99.3
37,경상북도,060003, 57세,2016,45354,22616,22738,99.5,44946,22411,22535,99.4
37,경상북도,060004, 58세,2016,41951,21303,20648,103.2,41513,21062,20451,103
37,경상북도,060005, 59세,2016,42480,21547,20933,102.9,42124,21375,20749,103
37,경상북도,065,60~64세,2016,184790,90674,94116,96.3,183407,89950,93457,96.2
37,경상북도,065001, 60세,2016,40741,20426,20315,100.5,40384,20233,20151,100.4
37,경상북도,065002, 61세,2016,39559,19288,20271,95.2,39262,19125,20137,95
37,경상북도,065003, 62세,2016,35568,17612,17956,98.1,35277,17460,17817,98
37,경상북도,065004, 63세,2016,33533,16335,17198,95,33299,16217,17082,94.9
37,경상북도,065005, 64세,2016,35389,17013,18376,92.6,35185,16915,18270,92.6
37,경상북도,070,65~69세,2016,141104,68592,72512,94.6,140488,68284,72204,94.6
37,경상북도,070001, 65세,2016,27493,13321,14172,94,27343,13236,14107,93.8
37,경상북도,070002, 66세,2016,28131,13711,14420,95.1,27958,13625,14333,95.1
37,경상북도,070003, 67세,2016,30103,14846,15257,97.3,29993,14792,15201,97.3
37,경상북도,070004, 68세,2016,28587,13892,14695,94.5,28480,13840,14640,94.5
37,경상북도,070005, 69세,2016,26790,12822,13968,91.8,26714,12791,13923,91.9
37,경상북도,075,70~74세,2016,113652,49674,63978,77.6,113426,49567,63859,77.6
37,경상북도,075001, 70세,2016,17642,8406,9236,91,17579,8377,9202,91
37,경상북도,075002, 71세,2016,19333,8624,10709,80.5,19279,8596,10683,80.5
37,경상북도,075003, 72세,2016,22495,9606,12889,74.5,22445,9584,12861,74.5
37,경상북도,075004, 73세,2016,25406,10825,14581,74.2,25373,10808,14565,74.2
37,경상북도,075005, 74세,2016,28776,12213,16563,73.7,28750,12202,16548,73.7
37,경상북도,080,75~79세,2016,107542,41900,65642,63.8,107396,41838,65558,63.8
37,경상북도,080001, 75세,2016,23040,9369,13671,68.5,23012,9354,13658,68.5
37,경상북도,080002, 76세,2016,22261,8876,13385,66.3,22225,8860,13365,66.3
37,경상북도,080003, 77세,2016,23372,9163,14209,64.5,23343,9152,14191,64.5
37,경상북도,080004, 78세,2016,20246,7604,12642,60.1,20221,7593,12628,60.1
37,경상북도,080005, 79세,2016,18623,6888,11735,58.7,18595,6879,11716,58.7
37,경상북도,085,80~84세,2016,72154,24318,47836,50.8,72093,24303,47790,50.9
37,경상북도,085001, 80세,2016,17731,6436,11295,57,17714,6433,11281,57
37,경상북도,085002, 81세,2016,17038,5864,11174,52.5,17026,5862,11164,52.5
37,경상북도,085003, 82세,2016,14549,4934,9615,51.3,14534,4931,9603,51.3
37,경상북도,085004, 83세,2016,12030,3827,8203,46.7,12021,3823,8198,46.6
37,경상북도,085005, 84세,2016,10806,3257,7549,43.1,10798,3254,7544,43.1
37,경상북도,090,85~89세,2016,31846,8353,23493,35.6,31810,8339,23471,35.5
37,경상북도,090001, 85세,2016,8364,2369,5995,39.5,8356,2364,5992,39.5
37,경상북도,090002, 86세,2016,7500,1997,5503,36.3,7495,1994,5501,36.2
37,경상북도,090003, 87세,2016,6257,1656,4601,36,6246,1652,4594,36
37,경상북도,090004, 88세,2016,5311,1260,4051,31.1,5304,1259,4045,31.1
37,경상북도,090005, 89세,2016,4414,1071,3343,32,4409,1070,3339,32
37,경상북도,095,90~94세,2016,10346,2241,8105,27.6,10334,2240,8094,27.7
37,경상북도,095001, 90세,2016,2965,682,2283,29.9,2962,681,2281,29.9
37,경상북도,095002, 91세,2016,2667,622,2045,30.4,2664,622,2042,30.5
37,경상북도,095003, 92세,2016,1793,382,1411,27.1,1793,382,1411,27.1
37,경상북도,095004, 93세,2016,1640,329,1311,25.1,1636,329,1307,25.2
37,경상북도,095005, 94세,2016,1281,226,1055,21.4,1279,226,1053,21.5
37,경상북도,100,95~99세,2016,2158,363,1795,20.2,2148,359,1789,20.1
37,경상북도,100001, 95세,2016,782,145,637,22.8,779,143,636,22.5
37,경상북도,100002, 96세,2016,577,98,479,20.5,574,96,478,20.1
37,경상북도,100003, 97세,2016,365,59,306,19.3,364,59,305,19.3
37,경상북도,100004, 98세,2016,262,39,223,17.5,259,39,220,17.7
37,경상북도,100005, 99세,2016,172,22,150,14.7,172,22,150,14.7
37,경상북도,101,100세이상,2016,242,31,211,14.7,241,31,210,14.8
37,경상북도,102,15세미만,2016,329868,171857,158011,108.8,328692,171271,157421,108.8
37,경상북도,103,15~64세,2016,1873257,987668,885589,111.5,1814835,950064,864771,109.9
37,경상북도,104,65세이상,2016,479044,195472,283572,68.9,477936,194961,282975,68.9
37,경상북도,086,85세이상,2016,44592,10988,33604,32.7,44533,10969,33564,32.7
37,경상북도,126,평균연령,2016,43.4,41.5,45.3,,43.6,41.7,45.4,
37,경상북도,127,중위연령,2016,44.7,42.7,46.9,,45.2,43.2,47.2,
37004, 읍부,000,합계,2016,606125,309209,296916,104.1,587277,296547,290730,102
37004, 읍부,005,0~4세,2016,25676,13305,12371,107.5,25507,13223,12284,107.6
37004, 읍부,005001, 0세,2016,4850,2482,2368,104.8,4813,2465,2348,105
37004, 읍부,005002, 1세,2016,5180,2705,2475,109.3,5148,2687,2461,109.2
37004, 읍부,005003, 2세,2016,5026,2581,2445,105.6,4994,2566,2428,105.7
37004, 읍부,005004, 3세,2016,5150,2622,2528,103.7,5111,2601,2510,103.6
37004, 읍부,005005, 4세,2016,5470,2915,2555,114.1,5441,2904,2537,114.5
37004, 읍부,010,5~9세,2016,26139,13533,12606,107.4,26023,13477,12546,107.4
37004, 읍부,010001, 5세,2016,5488,2865,2623,109.2,5456,2853,2603,109.6
37004, 읍부,010002, 6세,2016,5055,2653,2402,110.4,5034,2641,2393,110.4
37004, 읍부,010003, 7세,2016,5032,2603,2429,107.2,5001,2588,2413,107.3
37004, 읍부,010004, 8세,2016,5148,2658,2490,106.7,5133,2651,2482,106.8
37004, 읍부,010005, 9세,2016,5416,2754,2662,103.5,5399,2744,2655,103.4
37004, 읍부,015,10~14세,2016,26080,13795,12285,112.3,26023,13762,12261,112.2
37004, 읍부,015001, 10세,2016,5052,2654,2398,110.7,5038,2647,2391,110.7
37004, 읍부,015002, 11세,2016,4887,2565,2322,110.5,4875,2556,2319,110.2
37004, 읍부,015003, 12세,2016,5185,2790,2395,116.5,5173,2783,2390,116.4
37004, 읍부,015004, 13세,2016,5361,2810,2551,110.2,5352,2806,2546,110.2
37004, 읍부,015005, 14세,2016,5595,2976,2619,113.6,5585,2970,2615,113.6
37004, 읍부,020,15~19세,2016,38636,20009,18627,107.4,38244,19821,18423,107.6
37004, 읍부,020001, 15세,2016,6534,3379,3155,107.1,6519,3374,3145,107.3
37004, 읍부,020002, 16세,2016,7555,3889,3666,106.1,7539,3883,3656,106.2
37004, 읍부,020003, 17세,2016,7220,3748,3472,107.9,7164,3720,3444,108
37004, 읍부,020004, 18세,2016,7937,4126,3811,108.3,7841,4079,3762,108.4
37004, 읍부,020005, 19세,2016,9390,4867,4523,107.6,9181,4765,4416,107.9
37004, 읍부,025,20~24세,2016,42670,23682,18988,124.7,40070,22105,17965,123
37004, 읍부,025001, 20세,2016,8880,4486,4394,102.1,8605,4358,4247,102.6
37004, 읍부,025002, 21세,2016,8659,4568,4091,111.7,8273,4384,3889,112.7
37004, 읍부,025003, 22세,2016,8706,4936,3770,130.9,8196,4632,3564,130
37004, 읍부,025004, 23세,2016,8415,4969,3446,144.2,7748,4529,3219,140.7
37004, 읍부,025005, 24세,2016,8010,4723,3287,143.7,7248,4202,3046,138
37004, 읍부,030,25~29세,2016,33809,19646,14163,138.7,29643,16697,12946,129
37004, 읍부,030001, 25세,2016,7019,4084,2935,139.1,6228,3523,2705,130.2
37004, 읍부,030002, 26세,2016,6747,3934,2813,139.9,5902,3330,2572,129.5
37004, 읍부,030003, 27세,2016,6604,3870,2734,141.6,5748,3264,2484,131.4
37004, 읍부,030004, 28세,2016,6480,3806,2674,142.3,5661,3234,2427,133.3
37004, 읍부,030005, 29세,2016,6959,3952,3007,131.4,6104,3346,2758,121.3
37004, 읍부,035,30~34세,2016,37955,20908,17047,122.6,34281,18185,16096,113
37004, 읍부,035001, 30세,2016,6878,3895,2983,130.6,6089,3316,2773,119.6
37004, 읍부,035002, 31세,2016,6962,3982,2980,133.6,6173,3413,2760,123.7
37004, 읍부,035003, 32세,2016,7265,4000,3265,122.5,6512,3429,3083,111.2
37004, 읍부,035004, 33세,2016,7936,4233,3703,114.3,7294,3757,3537,106.2
37004, 읍부,035005, 34세,2016,8914,4798,4116,116.6,8213,4270,3943,108.3
37004, 읍부,040,35~39세,2016,43134,23022,20112,114.5,40732,21218,19514,108.7
37004, 읍부,040001, 35세,2016,9006,4855,4151,117,8430,4409,4021,109.6
37004, 읍부,040002, 36세,2016,9192,4895,4297,113.9,8672,4512,4160,108.5
37004, 읍부,040003, 37세,2016,8607,4548,4059,112,8137,4205,3932,106.9
37004, 읍부,040004, 38세,2016,7940,4284,3656,117.2,7502,3953,3549,111.4
37004, 읍부,040005, 39세,2016,8389,4440,3949,112.4,7991,4139,3852,107.5
37004, 읍부,045,40~44세,2016,45806,24541,21265,115.4,44138,23348,20790,112.3
37004, 읍부,045001, 40세,2016,8070,4379,3691,118.6,7688,4095,3593,114
37004, 읍부,045002, 41세,2016,8637,4603,4034,114.1,8312,4380,3932,111.4
37004, 읍부,045003, 42세,2016,9668,5179,4489,115.4,9343,4943,4400,112.3
37004, 읍부,045004, 43세,2016,9698,5126,4572,112.1,9394,4917,4477,109.8
37004, 읍부,045005, 44세,2016,9733,5254,4479,117.3,9401,5013,4388,114.2
37004, 읍부,050,45~49세,2016,50333,26683,23650,112.8,49054,25884,23170,111.7
37004, 읍부,050001, 45세,2016,10232,5459,4773,114.4,9918,5256,4662,112.7
37004, 읍부,050002, 46세,2016,9960,5257,4703,111.8,9697,5083,4614,110.2
37004, 읍부,050003, 47세,2016,10150,5467,4683,116.7,9896,5312,4584,115.9
37004, 읍부,050004, 48세,2016,10506,5552,4954,112.1,10250,5401,4849,111.4
37004, 읍부,050005, 49세,2016,9485,4948,4537,109.1,9293,4832,4461,108.3
37004, 읍부,055,50~54세,2016,48532,25596,22936,111.6,47560,25058,22502,111.4
37004, 읍부,055001, 50세,2016,9701,5191,4510,115.1,9507,5088,4419,115.1
37004, 읍부,055002, 51세,2016,9543,4942,4601,107.4,9354,4836,4518,107
37004, 읍부,055003, 52세,2016,9331,4903,4428,110.7,9126,4799,4327,110.9
37004, 읍부,055004, 53세,2016,9686,5094,4592,110.9,9488,4980,4508,110.5
37004, 읍부,055005, 54세,2016,10271,5466,4805,113.8,10085,5355,4730,113.2
37004, 읍부,060,55~59세,2016,49277,25339,23938,105.9,48634,24989,23645,105.7
37004, 읍부,060001, 55세,2016,10891,5727,5164,110.9,10764,5650,5114,110.5
37004, 읍부,060002, 56세,2016,10766,5454,5312,102.7,10602,5373,5229,102.8
37004, 읍부,060003, 57세,2016,9641,4938,4703,105,9520,4882,4638,105.3
37004, 읍부,060004, 58세,2016,8949,4631,4318,107.2,8821,4554,4267,106.7
37004, 읍부,060005, 59세,2016,9030,4589,4441,103.3,8927,4530,4397,103
37004, 읍부,065,60~64세,2016,38165,18868,19297,97.8,37763,18640,19123,97.5
37004, 읍부,065001, 60세,2016,8349,4217,4132,102.1,8251,4153,4098,101.3
37004, 읍부,065002, 61세,2016,8264,4048,4216,96,8178,3996,4182,95.6
37004, 읍부,065003, 62세,2016,7337,3570,3767,94.8,7250,3528,3722,94.8
37004, 읍부,065004, 63세,2016,6920,3455,3465,99.7,6863,3422,3441,99.4
37004, 읍부,065005, 64세,2016,7295,3578,3717,96.3,7221,3541,3680,96.2
37004, 읍부,070,65~69세,2016,29417,14189,15228,93.2,29228,14090,15138,93.1
37004, 읍부,070001, 65세,2016,5741,2775,2966,93.6,5688,2745,2943,93.3
37004, 읍부,070002, 66세,2016,5810,2817,2993,94.1,5753,2783,2970,93.7
37004, 읍부,070003, 67세,2016,6325,3071,3254,94.4,6298,3061,3237,94.6
37004, 읍부,070004, 68세,2016,5896,2840,3056,92.9,5863,2820,3043,92.7
37004, 읍부,070005, 69세,2016,5645,2686,2959,90.8,5626,2681,2945,91
37004, 읍부,075,70~74세,2016,23783,10209,13574,75.2,23723,10187,13536,75.3
37004, 읍부,075001, 70세,2016,3741,1772,1969,90,3725,1765,1960,90.1
37004, 읍부,075002, 71세,2016,4087,1776,2311,76.8,4073,1774,2299,77.2
37004, 읍부,075003, 72세,2016,4721,1996,2725,73.2,4706,1988,2718,73.1
37004, 읍부,075004, 73세,2016,5305,2180,3125,69.8,5295,2176,3119,69.8
37004, 읍부,075005, 74세,2016,5929,2485,3444,72.2,5924,2484,3440,72.2
37004, 읍부,080,75~79세,2016,22532,8627,13905,62,22498,8614,13884,62
37004, 읍부,080001, 75세,2016,4782,1883,2899,65,4771,1879,2892,65
37004, 읍부,080002, 76세,2016,4657,1852,2805,66,4647,1849,2798,66.1
37004, 읍부,080003, 77세,2016,4983,1888,3095,61,4979,1886,3093,61
37004, 읍부,080004, 78세,2016,4204,1578,2626,60.1,4201,1576,2625,60
37004, 읍부,080005, 79세,2016,3906,1426,2480,57.5,3900,1424,2476,57.5
37004, 읍부,085,80~84세,2016,14936,5001,9935,50.3,14920,4998,9922,50.4
37004, 읍부,085001, 80세,2016,3803,1399,2404,58.2,3799,1398,2401,58.2
37004, 읍부,085002, 81세,2016,3486,1187,2299,51.6,3483,1187,2296,51.7
37004, 읍부,085003, 82세,2016,2934,981,1953,50.2,2931,981,1950,50.3
37004, 읍부,085004, 83세,2016,2454,772,1682,45.9,2451,770,1681,45.8
37004, 읍부,085005, 84세,2016,2259,662,1597,41.5,2256,662,1594,41.5
37004, 읍부,090,85~89세,2016,6527,1693,4834,35,6521,1689,4832,35
37004, 읍부,090001, 85세,2016,1689,477,1212,39.4,1688,476,1212,39.3
37004, 읍부,090002, 86세,2016,1494,396,1098,36.1,1492,394,1098,35.9
37004, 읍부,090003, 87세,2016,1291,325,966,33.6,1290,324,966,33.5
37004, 읍부,090004, 88세,2016,1096,263,833,31.6,1095,263,832,31.6
37004, 읍부,090005, 89세,2016,957,232,725,32,956,232,724,32
37004, 읍부,095,90~94세,2016,2212,479,1733,27.6,2211,479,1732,27.7
37004, 읍부,095001, 90세,2016,649,144,505,28.5,649,144,505,28.5
37004, 읍부,095002, 91세,2016,589,131,458,28.6,589,131,458,28.6
37004, 읍부,095003, 92세,2016,370,88,282,31.2,370,88,282,31.2
37004, 읍부,095004, 93세,2016,328,70,258,27.1,327,70,257,27.2
37004, 읍부,095005, 94세,2016,276,46,230,20,276,46,230,20
37004, 읍부,100,95~99세,2016,449,78,371,21,447,77,370,20.8
37004, 읍부,100001, 95세,2016,155,29,126,23,155,29,126,23
37004, 읍부,100002, 96세,2016,110,20,90,22.2,109,19,90,21.1
37004, 읍부,100003, 97세,2016,96,22,74,29.7,95,22,73,30.1
37004, 읍부,100004, 98세,2016,50,X,46,8.7,50,X,46,8.7
37004, 읍부,100005, 99세,2016,38,X,35,8.6,38,X,35,8.6
37004, 읍부,101,100세이상,2016,57,6,51,11.8,57,6,51,11.8
37004, 읍부,102,15세미만,2016,77895,40633,37262,109,77553,40462,37091,109.1
37004, 읍부,103,15~64세,2016,428317,228294,200023,114.1,410119,215945,194174,111.2
37004, 읍부,104,65세이상,2016,99913,40282,59631,67.6,99605,40140,59465,67.5
37004, 읍부,086,85세이상,2016,9245,2256,6989,32.3,9236,2251,6985,32.2
37004, 읍부,126,평균연령,2016,42.3,40.6,44,,42.5,40.8,44.2,
37004, 읍부,127,중위연령,2016,43.3,41.5,45.2,,43.8,42.3,45.5,
37005, 면부,000,합계,2016,633468,317269,316199,100.3,613095,302723,310372,97.5
37005, 면부,005,0~4세,2016,14538,7530,7008,107.4,14493,7511,6982,107.6
37005, 면부,005001, 0세,2016,2872,1478,1394,106,2865,1474,1391,106
37005, 면부,005002, 1세,2016,2965,1543,1422,108.5,2958,1539,1419,108.5
37005, 면부,005003, 2세,2016,2734,1390,1344,103.4,2724,1387,1337,103.7
37005, 면부,005004, 3세,2016,2976,1564,1412,110.8,2965,1558,1407,110.7
37005, 면부,005005, 4세,2016,2991,1555,1436,108.3,2981,1553,1428,108.8
37005, 면부,010,5~9세,2016,13379,6937,6442,107.7,13323,6907,6416,107.7
37005, 면부,010001, 5세,2016,2744,1388,1356,102.4,2728,1382,1346,102.7
37005, 면부,010002, 6세,2016,2556,1322,1234,107.1,2545,1316,1229,107.1
37005, 면부,010003, 7세,2016,2476,1303,1173,111.1,2469,1298,1171,110.8
37005, 면부,010004, 8세,2016,2837,1518,1319,115.1,2826,1512,1314,115.1
37005, 면부,010005, 9세,2016,2766,1406,1360,103.4,2755,1399,1356,103.2
37005, 면부,015,10~14세,2016,13672,7274,6398,113.7,13641,7258,6383,113.7
37005, 면부,015001, 10세,2016,2523,1348,1175,114.7,2517,1345,1172,114.8
37005, 면부,015002, 11세,2016,2514,1317,1197,110,2507,1314,1193,110.1
37005, 면부,015003, 12세,2016,2697,1424,1273,111.9,2692,1419,1273,111.5
37005, 면부,015004, 13세,2016,2711,1467,1244,117.9,2707,1465,1242,118
37005, 면부,015005, 14세,2016,3227,1718,1509,113.9,3218,1715,1503,114.1
37005, 면부,020,15~19세,2016,21738,11944,9794,122,21501,11825,9676,122.2
37005, 면부,020001, 15세,2016,3853,2135,1718,124.3,3852,2134,1718,124.2
37005, 면부,020002, 16세,2016,4314,2410,1904,126.6,4304,2404,1900,126.5
37005, 면부,020003, 17세,2016,3931,2166,1765,122.7,3919,2161,1758,122.9
37005, 면부,020004, 18세,2016,4392,2362,2030,116.4,4321,2330,1991,117
37005, 면부,020005, 19세,2016,5248,2871,2377,120.8,5105,2796,2309,121.1
37005, 면부,025,20~24세,2016,28006,16695,11311,147.6,24962,14543,10419,139.6
37005, 면부,025001, 20세,2016,5458,3141,2317,135.6,5206,2999,2207,135.9
37005, 면부,025002, 21세,2016,5739,3413,2326,146.7,5314,3127,2187,143
37005, 면부,025003, 22세,2016,5585,3339,2246,148.7,5001,2922,2079,140.5
37005, 면부,025004, 23세,2016,5398,3306,2092,158,4627,2738,1889,144.9
37005, 면부,025005, 24세,2016,5826,3496,2330,150,4814,2757,2057,134
37005, 면부,030,25~29세,2016,27409,16741,10668,156.9,22358,13008,9350,139.1
37005, 면부,030001, 25세,2016,5573,3331,2242,148.6,4585,2566,2019,127.1
37005, 면부,030002, 26세,2016,5528,3385,2143,158,4459,2598,1861,139.6
37005, 면부,030003, 27세,2016,5413,3361,2052,163.8,4424,2623,1801,145.6
37005, 면부,030004, 28세,2016,5366,3290,2076,158.5,4368,2579,1789,144.2
37005, 면부,030005, 29세,2016,5529,3374,2155,156.6,4522,2642,1880,140.5
37005, 면부,035,30~34세,2016,26889,16216,10673,151.9,22713,12996,9717,133.7
37005, 면부,035001, 30세,2016,5215,3229,1986,162.6,4312,2537,1775,142.9
37005, 면부,035002, 31세,2016,5161,3172,1989,159.5,4213,2441,1772,137.8
37005, 면부,035003, 32세,2016,5161,3120,2041,152.9,4324,2477,1847,134.1
37005, 면부,035004, 33세,2016,5570,3301,2269,145.5,4800,2712,2088,129.9
37005, 면부,035005, 34세,2016,5782,3394,2388,142.1,5064,2829,2235,126.6
37005, 면부,040,35~39세,2016,26699,16209,10490,154.5,24008,14082,9926,141.9
37005, 면부,040001, 35세,2016,5557,3332,2225,149.8,4946,2857,2089,136.8
37005, 면부,040002, 36세,2016,5662,3427,2235,153.3,5029,2932,2097,139.8
37005, 면부,040003, 37세,2016,5354,3278,2076,157.9,4814,2837,1977,143.5
37005, 면부,040004, 38세,2016,4994,3030,1964,154.3,4509,2649,1860,142.4
37005, 면부,040005, 39세,2016,5132,3142,1990,157.9,4710,2807,1903,147.5
37005, 면부,045,40~44세,2016,30173,18228,11945,152.6,28501,16978,11523,147.3
37005, 면부,045001, 40세,2016,5357,3368,1989,169.3,4936,3035,1901,159.7
37005, 면부,045002, 41세,2016,5632,3431,2201,155.9,5284,3157,2127,148.4
37005, 면부,045003, 42세,2016,6112,3660,2452,149.3,5797,3440,2357,145.9
37005, 면부,045004, 43세,2016,6484,3865,2619,147.6,6193,3641,2552,142.7
37005, 면부,045005, 44세,2016,6588,3904,2684,145.5,6291,3705,2586,143.3
37005, 면부,050,45~49세,2016,40214,22681,17533,129.4,38996,21920,17076,128.4
37005, 면부,050001, 45세,2016,7356,4384,2972,147.5,7071,4192,2879,145.6
37005, 면부,050002, 46세,2016,7491,4294,3197,134.3,7211,4122,3089,133.4
37005, 면부,050003, 47세,2016,8087,4571,3516,130,7844,4410,3434,128.4
37005, 면부,050004, 48세,2016,8763,4818,3945,122.1,8554,4692,3862,121.5
37005, 면부,050005, 49세,2016,8517,4614,3903,118.2,8316,4504,3812,118.2
37005, 면부,055,50~54세,2016,50874,27200,23674,114.9,49982,26731,23251,115
37005, 면부,055001, 50세,2016,9115,5090,4025,126.5,8928,4991,3937,126.8
37005, 면부,055002, 51세,2016,9637,5108,4529,112.8,9463,5018,4445,112.9
37005, 면부,055003, 52세,2016,9691,5165,4526,114.1,9484,5057,4427,114.2
37005, 면부,055004, 53세,2016,10432,5479,4953,110.6,10251,5377,4874,110.3
37005, 면부,055005, 54세,2016,11999,6358,5641,112.7,11856,6288,5568,112.9
37005, 면부,060,55~59세,2016,65560,33459,32101,104.2,64948,33150,31798,104.3
37005, 면부,060001, 55세,2016,13501,7010,6491,108,13380,6954,6426,108.2
37005, 면부,060002, 56세,2016,13992,6993,6999,99.9,13847,6921,6926,99.9
37005, 면부,060003, 57세,2016,13035,6463,6572,98.3,12916,6398,6518,98.2
37005, 면부,060004, 58세,2016,12271,6398,5873,108.9,12143,6332,5811,109
37005, 면부,060005, 59세,2016,12761,6595,6166,107,12662,6545,6117,107
37005, 면부,065,60~64세,2016,61728,30461,31267,97.4,61361,30260,31101,97.3
37005, 면부,065001, 60세,2016,12928,6566,6362,103.2,12838,6516,6322,103.1
37005, 면부,065002, 61세,2016,12796,6239,6557,95.2,12719,6194,6525,94.9
37005, 면부,065003, 62세,2016,11977,5972,6005,99.5,11893,5927,5966,99.3
37005, 면부,065004, 63세,2016,11607,5744,5863,98,11542,5710,5832,97.9
37005, 면부,065005, 64세,2016,12420,5940,6480,91.7,12369,5913,6456,91.6
37005, 면부,070,65~69세,2016,53466,26144,27322,95.7,53302,26062,27240,95.7
37005, 면부,070001, 65세,2016,9934,4823,5111,94.4,9907,4804,5103,94.1
37005, 면부,070002, 66세,2016,10430,5019,5411,92.8,10385,5002,5383,92.9
37005, 면부,070003, 67세,2016,11475,5712,5763,99.1,11434,5690,5744,99.1
37005, 면부,070004, 68세,2016,11059,5490,5569,98.6,11028,5477,5551,98.7
37005, 면부,070005, 69세,2016,10568,5100,5468,93.3,10548,5089,5459,93.2
37005, 면부,075,70~74세,2016,48627,20992,27635,76,48562,20957,27605,75.9
37005, 면부,075001, 70세,2016,6885,3304,3581,92.3,6868,3297,3571,92.3
37005, 면부,075002, 71세,2016,7989,3520,4469,78.8,7972,3507,4465,78.5
37005, 면부,075003, 72세,2016,9446,3903,5543,70.4,9428,3893,5535,70.3
37005, 면부,075004, 73세,2016,11141,4722,6419,73.6,11135,4719,6416,73.6
37005, 면부,075005, 74세,2016,13166,5543,7623,72.7,13159,5541,7618,72.7
37005, 면부,080,75~79세,2016,51645,20200,31445,64.2,51619,20189,31430,64.2
37005, 면부,080001, 75세,2016,10730,4403,6327,69.6,10727,4400,6327,69.5
37005, 면부,080002, 76세,2016,10538,4194,6344,66.1,10531,4190,6341,66.1
37005, 면부,080003, 77세,2016,11296,4440,6856,64.8,11287,4438,6849,64.8
37005, 면부,080004, 78세,2016,9838,3725,6113,60.9,9834,3724,6110,60.9
37005, 면부,080005, 79세,2016,9243,3438,5805,59.2,9240,3437,5803,59.2
37005, 면부,085,80~84세,2016,36572,12621,23951,52.7,36561,12616,23945,52.7
37005, 면부,085001, 80세,2016,8810,3210,5600,57.3,8808,3210,5598,57.3
37005, 면부,085002, 81세,2016,8770,3056,5714,53.5,8768,3055,5713,53.5
37005, 면부,085003, 82세,2016,7470,2624,4846,54.1,7467,2622,4845,54.1
37005, 면부,085004, 83세,2016,6122,2029,4093,49.6,6120,2028,4092,49.6
37005, 면부,085005, 84세,2016,5400,1702,3698,46,5398,1701,3697,46
37005, 면부,090,85~89세,2016,15940,4353,11587,37.6,15930,4350,11580,37.6
37005, 면부,090001, 85세,2016,4202,1230,2972,41.4,4200,1229,2971,41.4
37005, 면부,090002, 86세,2016,3796,1037,2759,37.6,3795,1037,2758,37.6
37005, 면부,090003, 87세,2016,3157,888,2269,39.1,3154,886,2268,39.1
37005, 면부,090004, 88세,2016,2604,637,1967,32.4,2601,637,1964,32.4
37005, 면부,090005, 89세,2016,2181,561,1620,34.6,2180,561,1619,34.7
37005, 면부,095,90~94세,2016,5115,1171,3944,29.7,5113,1170,3943,29.7
37005, 면부,095001, 90세,2016,1438,343,1095,31.3,1437,342,1095,31.2
37005, 면부,095002, 91세,2016,1313,335,978,34.3,1313,335,978,34.3
37005, 면부,095003, 92세,2016,909,183,726,25.2,909,183,726,25.2
37005, 면부,095004, 93세,2016,818,186,632,29.4,817,186,631,29.5
37005, 면부,095005, 94세,2016,637,124,513,24.2,637,124,513,24.2
37005, 면부,100,95~99세,2016,1102,198,904,21.9,1099,195,904,21.6
37005, 면부,100001, 95세,2016,384,81,303,26.7,382,79,303,26.1
37005, 면부,100002, 96세,2016,322,52,270,19.3,321,51,270,18.9
37005, 면부,100003, 97세,2016,171,31,140,22.1,171,31,140,22.1
37005, 면부,100004, 98세,2016,137,18,119,15.1,137,18,119,15.1
37005, 면부,100005, 99세,2016,88,16,72,22.2,88,16,72,22.2
37005, 면부,101,100세이상,2016,122,15,107,14,122,15,107,14
37005, 면부,102,15세미만,2016,41589,21741,19848,109.5,41457,21676,19781,109.6
37005, 면부,103,15~64세,2016,379290,209834,169456,123.8,359330,195493,163837,119.3
37005, 면부,104,65세이상,2016,212589,85694,126895,67.5,212308,85554,126754,67.5
37005, 면부,086,85세이상,2016,22279,5737,16542,34.7,22264,5730,16534,34.7
37005, 면부,126,평균연령,2016,53,50,56.1,,53.6,50.8,56.5,
37005, 면부,127,중위연령,2016,56.7,53.5,60,,57.4,54.6,60.4,
37003, 동부,000,합계,2016,1442576,728519,714057,102,1421091,717026,704065,101.8
37003, 동부,005,0~4세,2016,70236,36171,34065,106.2,69878,35990,33888,106.2
37003, 동부,005001, 0세,2016,13267,6857,6410,107,13181,6812,6369,107
37003, 동부,005002, 1세,2016,14106,7177,6929,103.6,14035,7145,6890,103.7
37003, 동부,005003, 2세,2016,13712,7164,6548,109.4,13657,7137,6520,109.5
37003, 동부,005004, 3세,2016,13974,7200,6774,106.3,13893,7154,6739,106.2
37003, 동부,005005, 4세,2016,15177,7773,7404,105,15112,7742,7370,105
37003, 동부,010,5~9세,2016,70333,36651,33682,108.8,70096,36533,33563,108.8
37003, 동부,010001, 5세,2016,14759,7751,7008,110.6,14705,7727,6978,110.7
37003, 동부,010002, 6세,2016,13958,7156,6802,105.2,13901,7129,6772,105.3
37003, 동부,010003, 7세,2016,13352,7008,6344,110.5,13310,6986,6324,110.5
37003, 동부,010004, 8세,2016,14072,7305,6767,108,14020,7279,6741,108
37003, 동부,010005, 9세,2016,14192,7431,6761,109.9,14160,7412,6748,109.8
37003, 동부,015,10~14세,2016,69815,36661,33154,110.6,69708,36610,33098,110.6
37003, 동부,015001, 10세,2016,13136,6911,6225,111,13109,6901,6208,111.2
37003, 동부,015002, 11세,2016,13016,6734,6282,107.2,12991,6722,6269,107.2
37003, 동부,015003, 12세,2016,14128,7460,6668,111.9,14110,7453,6657,112
37003, 동부,015004, 13세,2016,14440,7544,6896,109.4,14424,7534,6890,109.3
37003, 동부,015005, 14세,2016,15095,8012,7083,113.1,15074,8000,7074,113.1
37003, 동부,020,15~19세,2016,97770,53094,44676,118.8,97127,52801,44326,119.1
37003, 동부,020001, 15세,2016,17658,9367,8291,113,17645,9361,8284,113
37003, 동부,020002, 16세,2016,20200,10984,9216,119.2,20166,10971,9195,119.3
37003, 동부,020003, 17세,2016,19511,10595,8916,118.8,19476,10571,8905,118.7
37003, 동부,020004, 18세,2016,20072,10881,9191,118.4,19953,10829,9124,118.7
37003, 동부,020005, 19세,2016,20329,11267,9062,124.3,19887,11069,8818,125.5
37003, 동부,025,20~24세,2016,102912,57860,45052,128.4,99635,56311,43324,130
37003, 동부,025001, 20세,2016,20838,11603,9235,125.6,20213,11344,8869,127.9
37003, 동부,025002, 21세,2016,20896,11721,9175,127.7,20254,11458,8796,130.3
37003, 동부,025003, 22세,2016,20771,11742,9029,130,20153,11427,8726,131
37003, 동부,025004, 23세,2016,20198,11448,8750,130.8,19549,11119,8430,131.9
37003, 동부,025005, 24세,2016,20209,11346,8863,128,19466,10963,8503,128.9
37003, 동부,030,25~29세,2016,87663,48195,39468,122.1,83394,45908,37486,122.5
37003, 동부,030001, 25세,2016,18382,10288,8094,127.1,17574,9876,7698,128.3
37003, 동부,030002, 26세,2016,17772,9943,7829,127,16881,9468,7413,127.7
37003, 동부,030003, 27세,2016,16967,9440,7527,125.4,16118,8982,7136,125.9
37003, 동부,030004, 28세,2016,17029,9283,7746,119.8,16150,8817,7333,120.2
37003, 동부,030005, 29세,2016,17513,9241,8272,111.7,16671,8765,7906,110.9
37003, 동부,035,30~34세,2016,100279,52184,48095,108.5,96792,50142,46650,107.5
37003, 동부,035001, 30세,2016,17719,9440,8279,114,16961,9003,7958,113.1
37003, 동부,035002, 31세,2016,18229,9598,8631,111.2,17453,9154,8299,110.3
37003, 동부,035003, 32세,2016,19087,9880,9207,107.3,18416,9487,8929,106.2
37003, 동부,035004, 33세,2016,21512,11079,10433,106.2,20872,10700,10172,105.2
37003, 동부,035005, 34세,2016,23732,12187,11545,105.6,23090,11798,11292,104.5
37003, 동부,040,35~39세,2016,112736,57595,55141,104.5,110374,56184,54190,103.7
37003, 동부,040001, 35세,2016,23718,12206,11512,106,23161,11872,11289,105.2
37003, 동부,040002, 36세,2016,24167,12398,11769,105.3,23671,12110,11561,104.7
37003, 동부,040003, 37세,2016,22381,11421,10960,104.2,21878,11121,10757,103.4
37003, 동부,040004, 38세,2016,20789,10676,10113,105.6,20369,10420,9949,104.7
37003, 동부,040005, 39세,2016,21681,10894,10787,101,21295,10661,10634,100.3
37003, 동부,045,40~44세,2016,118714,58911,59803,98.5,116903,57842,59061,97.9
37003, 동부,045001, 40세,2016,21386,10626,10760,98.8,21024,10418,10606,98.2
37003, 동부,045002, 41세,2016,23101,11364,11737,96.8,22740,11151,11589,96.2
37003, 동부,045003, 42세,2016,24568,12171,12397,98.2,24180,11936,12244,97.5
37003, 동부,045004, 43세,2016,24906,12206,12700,96.1,24550,11991,12559,95.5
37003, 동부,045005, 44세,2016,24753,12544,12209,102.7,24409,12346,12063,102.3
37003, 동부,050,45~49세,2016,127413,63626,63787,99.7,125833,62785,63048,99.6
37003, 동부,050001, 45세,2016,25753,13031,12722,102.4,25428,12845,12583,102.1
37003, 동부,050002, 46세,2016,25893,12943,12950,99.9,25549,12750,12799,99.6
37003, 동부,050003, 47세,2016,25671,12813,12858,99.7,25356,12658,12698,99.7
37003, 동부,050004, 48세,2016,26493,13190,13303,99.2,26171,13018,13153,99
37003, 동부,050005, 49세,2016,23603,11649,11954,97.4,23329,11514,11815,97.5
37003, 동부,055,50~54세,2016,117485,59223,58262,101.6,116163,58534,57629,101.6
37003, 동부,055001, 50세,2016,23639,12069,11570,104.3,23376,11936,11440,104.3
37003, 동부,055002, 51세,2016,23700,11735,11965,98.1,23386,11572,11814,98
37003, 동부,055003, 52세,2016,22323,11351,10972,103.5,22066,11213,10853,103.3
37003, 동부,055004, 53세,2016,23660,11934,11726,101.8,23387,11787,11600,101.6
37003, 동부,055005, 54세,2016,24163,12134,12029,100.9,23948,12026,11922,100.9
37003, 동부,060,55~59세,2016,115781,57507,58274,98.7,114882,57069,57813,98.7
37003, 동부,060001, 55세,2016,26113,13034,13079,99.7,25922,12932,12990,99.6
37003, 동부,060002, 56세,2016,25570,12621,12949,97.5,25366,12530,12836,97.6
37003, 동부,060003, 57세,2016,22678,11215,11463,97.8,22510,11131,11379,97.8
37003, 동부,060004, 58세,2016,20731,10274,10457,98.2,20549,10176,10373,98.1
37003, 동부,060005, 59세,2016,20689,10363,10326,100.4,20535,10300,10235,100.6
37003, 동부,065,60~64세,2016,84897,41345,43552,94.9,84283,41050,43233,95
37003, 동부,065001, 60세,2016,19464,9643,9821,98.2,19295,9564,9731,98.3
37003, 동부,065002, 61세,2016,18499,9001,9498,94.8,18365,8935,9430,94.8
37003, 동부,065003, 62세,2016,16254,8070,8184,98.6,16134,8005,8129,98.5
37003, 동부,065004, 63세,2016,15006,7136,7870,90.7,14894,7085,7809,90.7
37003, 동부,065005, 64세,2016,15674,7495,8179,91.6,15595,7461,8134,91.7
37003, 동부,070,65~69세,2016,58221,28259,29962,94.3,57958,28132,29826,94.3
37003, 동부,070001, 65세,2016,11818,5723,6095,93.9,11748,5687,6061,93.8
37003, 동부,070002, 66세,2016,11891,5875,6016,97.7,11820,5840,5980,97.7
37003, 동부,070003, 67세,2016,12303,6063,6240,97.2,12261,6041,6220,97.1
37003, 동부,070004, 68세,2016,11632,5562,6070,91.6,11589,5543,6046,91.7
37003, 동부,070005, 69세,2016,10577,5036,5541,90.9,10540,5021,5519,91
37003, 동부,075,70~74세,2016,41242,18473,22769,81.1,41141,18423,22718,81.1
37003, 동부,075001, 70세,2016,7016,3330,3686,90.3,6986,3315,3671,90.3
37003, 동부,075002, 71세,2016,7257,3328,3929,84.7,7234,3315,3919,84.6
37003, 동부,075003, 72세,2016,8328,3707,4621,80.2,8311,3703,4608,80.4
37003, 동부,075004, 73세,2016,8960,3923,5037,77.9,8943,3913,5030,77.8
37003, 동부,075005, 74세,2016,9681,4185,5496,76.1,9667,4177,5490,76.1
37003, 동부,080,75~79세,2016,33365,13073,20292,64.4,33279,13035,20244,64.4
37003, 동부,080001, 75세,2016,7528,3083,4445,69.4,7514,3075,4439,69.3
37003, 동부,080002, 76세,2016,7066,2830,4236,66.8,7047,2821,4226,66.8
37003, 동부,080003, 77세,2016,7093,2835,4258,66.6,7077,2828,4249,66.6
37003, 동부,080004, 78세,2016,6204,2301,3903,59,6186,2293,3893,58.9
37003, 동부,080005, 79세,2016,5474,2024,3450,58.7,5455,2018,3437,58.7
37003, 동부,085,80~84세,2016,20646,6696,13950,48,20612,6689,13923,48
37003, 동부,085001, 80세,2016,5118,1827,3291,55.5,5107,1825,3282,55.6
37003, 동부,085002, 81세,2016,4782,1621,3161,51.3,4775,1620,3155,51.3
37003, 동부,085003, 82세,2016,4145,1329,2816,47.2,4136,1328,2808,47.3
37003, 동부,085004, 83세,2016,3454,1026,2428,42.3,3450,1025,2425,42.3
37003, 동부,085005, 84세,2016,3147,893,2254,39.6,3144,891,2253,39.5
37003, 동부,090,85~89세,2016,9379,2307,7072,32.6,9359,2300,7059,32.6
37003, 동부,090001, 85세,2016,2473,662,1811,36.6,2468,659,1809,36.4
37003, 동부,090002, 86세,2016,2210,564,1646,34.3,2208,563,1645,34.2
37003, 동부,090003, 87세,2016,1809,443,1366,32.4,1802,442,1360,32.5
37003, 동부,090004, 88세,2016,1611,360,1251,28.8,1608,359,1249,28.7
37003, 동부,090005, 89세,2016,1276,278,998,27.9,1273,277,996,27.8
37003, 동부,095,90~94세,2016,3019,591,2428,24.3,3010,591,2419,24.4
37003, 동부,095001, 90세,2016,878,195,683,28.6,876,195,681,28.6
37003, 동부,095002, 91세,2016,765,156,609,25.6,762,156,606,25.7
37003, 동부,095003, 92세,2016,514,111,403,27.5,514,111,403,27.5
37003, 동부,095004, 93세,2016,494,73,421,17.3,492,73,419,17.4
37003, 동부,095005, 94세,2016,368,56,312,17.9,366,56,310,18.1
37003, 동부,100,95~99세,2016,607,87,520,16.7,602,87,515,16.9
37003, 동부,100001, 95세,2016,243,35,208,16.8,242,35,207,16.9
37003, 동부,100002, 96세,2016,145,26,119,21.8,144,26,118,22
37003, 동부,100003, 97세,2016,98,6,92,6.5,98,6,92,6.5
37003, 동부,100004, 98세,2016,75,17,58,29.3,72,17,55,30.9
37003, 동부,100005, 99세,2016,46,X,43,7,46,X,43,7
37003, 동부,101,100세이상,2016,63,10,53,18.9,62,10,52,19.2
37003, 동부,102,15세미만,2016,210384,109483,100901,108.5,209682,109133,100549,108.5
37003, 동부,103,15~64세,2016,1065650,549540,516110,106.5,1045386,538626,506760,106.3
37003, 동부,104,65세이상,2016,166542,69496,97046,71.6,166023,69267,96756,71.6
37003, 동부,086,85세이상,2016,13068,2995,10073,29.7,13033,2988,10045,29.7
37003, 동부,126,평균연령,2016,39.6,38.2,41,,39.6,38.2,41.1,
37003, 동부,127,중위연령,2016,40.4,38.7,42.1,,40.6,38.9,42.3,
37010, 포항시,000,합계,2016,510360,258761,251599,102.8,504416,255155,249261,102.4
37010, 포항시,005,0~4세,2016,22980,11967,11013,108.7,22882,11914,10968,108.6
37010, 포항시,005001, 0세,2016,4261,2202,2059,106.9,4245,2193,2052,106.9
37010, 포항시,005002, 1세,2016,4632,2409,2223,108.4,4610,2398,2212,108.4
37010, 포항시,005003, 2세,2016,4463,2292,2171,105.6,4451,2286,2165,105.6
37010, 포항시,005004, 3세,2016,4642,2384,2258,105.6,4610,2366,2244,105.4
37010, 포항시,005005, 4세,2016,4982,2680,2302,116.4,4966,2671,2295,116.4
37010, 포항시,010,5~9세,2016,23100,12005,11095,108.2,23031,11973,11058,108.3
37010, 포항시,010001, 5세,2016,4863,2552,2311,110.4,4843,2547,2296,110.9
37010, 포항시,010002, 6세,2016,4634,2429,2205,110.2,4623,2420,2203,109.9
37010, 포항시,010003, 7세,2016,4463,2326,2137,108.8,4445,2318,2127,109
37010, 포항시,010004, 8세,2016,4551,2327,2224,104.6,4543,2323,2220,104.6
37010, 포항시,010005, 9세,2016,4589,2371,2218,106.9,4577,2365,2212,106.9
37010, 포항시,015,10~14세,2016,22951,12133,10818,112.2,22922,12114,10808,112.1
37010, 포항시,015001, 10세,2016,4337,2274,2063,110.2,4329,2269,2060,110.1
37010, 포항시,015002, 11세,2016,4324,2310,2014,114.7,4320,2306,2014,114.5
37010, 포항시,015003, 12세,2016,4638,2436,2202,110.6,4633,2432,2201,110.5
37010, 포항시,015004, 13세,2016,4718,2470,2248,109.9,4712,2467,2245,109.9
37010, 포항시,015005, 14세,2016,4934,2643,2291,115.4,4928,2640,2288,115.4
37010, 포항시,020,15~19세,2016,29960,16165,13795,117.2,29838,16104,13734,117.3
37010, 포항시,020001, 15세,2016,5747,3046,2701,112.8,5743,3044,2699,112.8
37010, 포항시,020002, 16세,2016,6490,3456,3034,113.9,6483,3451,3032,113.8
37010, 포항시,020003, 17세,2016,6400,3416,2984,114.5,6390,3411,2979,114.5
37010, 포항시,020004, 18세,2016,6123,3248,2875,113,6105,3240,2865,113.1
37010, 포항시,020005, 19세,2016,5200,2999,2201,136.3,5117,2958,2159,137
37010, 포항시,025,20~24세,2016,30793,17920,12873,139.2,30033,17512,12521,139.9
37010, 포항시,025001, 20세,2016,6364,3847,2517,152.8,6272,3809,2463,154.6
37010, 포항시,025002, 21세,2016,6351,3849,2502,153.8,6242,3809,2433,156.6
37010, 포항시,025003, 22세,2016,5997,3505,2492,140.7,5845,3422,2423,141.2
37010, 포항시,025004, 23세,2016,6041,3327,2714,122.6,5868,3221,2647,121.7
37010, 포항시,025005, 24세,2016,6040,3392,2648,128.1,5806,3251,2555,127.2
37010, 포항시,030,25~29세,2016,27851,15708,12143,129.4,26628,14941,11687,127.8
37010, 포항시,030001, 25세,2016,5761,3304,2457,134.5,5521,3148,2373,132.7
37010, 포항시,030002, 26세,2016,5693,3262,2431,134.2,5460,3118,2342,133.1
37010, 포항시,030003, 27세,2016,5579,3182,2397,132.7,5317,3020,2297,131.5
37010, 포항시,030004, 28세,2016,5346,2991,2355,127,5097,2841,2256,125.9
37010, 포항시,030005, 29세,2016,5472,2969,2503,118.6,5233,2814,2419,116.3
37010, 포항시,035,30~34세,2016,32683,17220,15463,111.4,31677,16578,15099,109.8
37010, 포항시,035001, 30세,2016,5576,3058,2518,121.4,5389,2944,2445,120.4
37010, 포항시,035002, 31세,2016,5844,3063,2781,110.1,5602,2909,2693,108
37010, 포항시,035003, 32세,2016,6407,3330,3077,108.2,6189,3189,3000,106.3
37010, 포항시,035004, 33세,2016,7052,3748,3304,113.4,6874,3629,3245,111.8
37010, 포항시,035005, 34세,2016,7804,4021,3783,106.3,7623,3907,3716,105.1
37010, 포항시,040,35~39세,2016,37150,19111,18039,105.9,36421,18613,17808,104.5
37010, 포항시,040001, 35세,2016,7999,4172,3827,109,7836,4068,3768,108
37010, 포항시,040002, 36세,2016,7750,3997,3753,106.5,7614,3909,3705,105.5
37010, 포항시,040003, 37세,2016,7385,3740,3645,102.6,7222,3628,3594,100.9
37010, 포항시,040004, 38세,2016,6802,3541,3261,108.6,6665,3440,3225,106.7
37010, 포항시,040005, 39세,2016,7214,3661,3553,103,7084,3568,3516,101.5
37010, 포항시,045,40~44세,2016,39465,19978,19487,102.5,38868,19538,19330,101.1
37010, 포항시,045001, 40세,2016,6722,3456,3266,105.8,6585,3348,3237,103.4
37010, 포항시,045002, 41세,2016,7553,3870,3683,105.1,7439,3786,3653,103.6
37010, 포항시,045003, 42세,2016,8323,4172,4151,100.5,8215,4096,4119,99.4
37010, 포항시,045004, 43세,2016,8453,4210,4243,99.2,8325,4115,4210,97.7
37010, 포항시,045005, 44세,2016,8414,4270,4144,103,8304,4193,4111,102
37010, 포항시,050,45~49세,2016,45366,22855,22511,101.5,44936,22593,22343,101.1
37010, 포항시,050001, 45세,2016,8956,4486,4470,100.4,8849,4424,4425,100
37010, 포항시,050002, 46세,2016,9178,4575,4603,99.4,9080,4506,4574,98.5
37010, 포항시,050003, 47세,2016,9059,4627,4432,104.4,8973,4573,4400,103.9
37010, 포항시,050004, 48세,2016,9602,4874,4728,103.1,9522,4831,4691,103
37010, 포항시,050005, 49세,2016,8571,4293,4278,100.4,8512,4259,4253,100.1
37010, 포항시,055,50~54세,2016,44855,22388,22467,99.6,44527,22228,22299,99.7
37010, 포항시,055001, 50세,2016,8771,4468,4303,103.8,8716,4442,4274,103.9
37010, 포항시,055002, 51세,2016,9067,4432,4635,95.6,9005,4398,4607,95.5
37010, 포항시,055003, 52세,2016,8350,4119,4231,97.4,8288,4089,4199,97.4
37010, 포항시,055004, 53세,2016,9193,4551,4642,98,9097,4507,4590,98.2
37010, 포항시,055005, 54세,2016,9474,4818,4656,103.5,9421,4792,4629,103.5
37010, 포항시,060,55~59세,2016,48243,23666,24577,96.3,47999,23553,24446,96.3
37010, 포항시,060001, 55세,2016,10447,5171,5276,98,10405,5155,5250,98.2
37010, 포항시,060002, 56세,2016,10364,5061,5303,95.4,10303,5034,5269,95.5
37010, 포항시,060003, 57세,2016,9644,4632,5012,92.4,9596,4612,4984,92.5
37010, 포항시,060004, 58세,2016,8846,4292,4554,94.2,8795,4265,4530,94.2
37010, 포항시,060005, 59세,2016,8942,4510,4432,101.8,8900,4487,4413,101.7
37010, 포항시,065,60~64세,2016,37151,18665,18486,101,36974,18572,18402,100.9
37010, 포항시,065001, 60세,2016,8319,4064,4255,95.5,8274,4041,4233,95.5
37010, 포항시,065002, 61세,2016,8393,4166,4227,98.6,8354,4140,4214,98.2
37010, 포항시,065003, 62세,2016,7249,3770,3479,108.4,7210,3749,3461,108.3
37010, 포항시,065004, 63세,2016,6449,3271,3178,102.9,6421,3258,3163,103
37010, 포항시,065005, 64세,2016,6741,3394,3347,101.4,6715,3384,3331,101.6
37010, 포항시,070,65~69세,2016,24529,12406,12123,102.3,24448,12365,12083,102.3
37010, 포항시,070001, 65세,2016,5130,2608,2522,103.4,5106,2594,2512,103.3
37010, 포항시,070002, 66세,2016,5000,2577,2423,106.4,4976,2562,2414,106.1
37010, 포항시,070003, 67세,2016,5164,2609,2555,102.1,5156,2608,2548,102.4
37010, 포항시,070004, 68세,2016,4783,2406,2377,101.2,4768,2398,2370,101.2
37010, 포항시,070005, 69세,2016,4452,2206,2246,98.2,4442,2203,2239,98.4
37010, 포항시,075,70~74세,2016,16777,7723,9054,85.3,16759,7718,9041,85.4
37010, 포항시,075001, 70세,2016,2959,1464,1495,97.9,2954,1462,1492,98
37010, 포항시,075002, 71세,2016,3073,1440,1633,88.2,3069,1439,1630,88.3
37010, 포항시,075003, 72세,2016,3391,1562,1829,85.4,3387,1561,1826,85.5
37010, 포항시,075004, 73세,2016,3531,1570,1961,80.1,3528,1570,1958,80.2
37010, 포항시,075005, 74세,2016,3823,1687,2136,79,3821,1686,2135,79
37010, 포항시,080,75~79세,2016,13149,5246,7903,66.4,13128,5237,7891,66.4
37010, 포항시,080001, 75세,2016,3065,1317,1748,75.3,3062,1315,1747,75.3
37010, 포항시,080002, 76세,2016,2806,1135,1671,67.9,2799,1131,1668,67.8
37010, 포항시,080003, 77세,2016,2807,1151,1656,69.5,2803,1149,1654,69.5
37010, 포항시,080004, 78세,2016,2333,851,1482,57.4,2331,851,1480,57.5
37010, 포항시,080005, 79세,2016,2138,792,1346,58.8,2133,791,1342,58.9
37010, 포항시,085,80~84세,2016,8023,2495,5528,45.1,8015,2493,5522,45.1
37010, 포항시,085001, 80세,2016,1994,693,1301,53.3,1991,693,1298,53.4
37010, 포항시,085002, 81세,2016,1805,550,1255,43.8,1804,549,1255,43.7
37010, 포항시,085003, 82세,2016,1618,526,1092,48.2,1618,526,1092,48.2
37010, 포항시,085004, 83세,2016,1371,399,972,41,1369,399,970,41.1
37010, 포항시,085005, 84세,2016,1235,327,908,36,1233,326,907,35.9
37010, 포항시,090,85~89세,2016,3826,846,2980,28.4,3824,845,2979,28.4
37010, 포항시,090001, 85세,2016,972,240,732,32.8,972,240,732,32.8
37010, 포항시,090002, 86세,2016,865,201,664,30.3,865,201,664,30.3
37010, 포항시,090003, 87세,2016,780,179,601,29.8,778,178,600,29.7
37010, 포항시,090004, 88세,2016,647,127,520,24.4,647,127,520,24.4
37010, 포항시,090005, 89세,2016,562,99,463,21.4,562,99,463,21.4
37010, 포항시,095,90~94세,2016,1230,225,1005,22.4,1230,225,1005,22.4
37010, 포항시,095001, 90세,2016,341,58,283,20.5,341,58,283,20.5
37010, 포항시,095002, 91세,2016,321,59,262,22.5,321,59,262,22.5
37010, 포항시,095003, 92세,2016,223,48,175,27.4,223,48,175,27.4
37010, 포항시,095004, 93세,2016,192,38,154,24.7,192,38,154,24.7
37010, 포항시,095005, 94세,2016,153,22,131,16.8,153,22,131,16.8
37010, 포항시,100,95~99세,2016,254,36,218,16.5,252,36,216,16.7
37010, 포항시,100001, 95세,2016,82,10,72,13.9,82,10,72,13.9
37010, 포항시,100002, 96세,2016,83,12,71,16.9,83,12,71,16.9
37010, 포항시,100003, 97세,2016,44,8,36,22.2,44,8,36,22.2
37010, 포항시,100004, 98세,2016,30,X,26,15.4,28,X,24,16.7
37010, 포항시,100005, 99세,2016,15,X,13,15.4,15,X,13,15.4
37010, 포항시,101,100세이상,2016,24,X,21,14.3,24,X,21,14.3
37010, 포항시,102,15세미만,2016,69031,36105,32926,109.7,68835,36001,32834,109.6
37010, 포항시,103,15~64세,2016,373517,193676,179841,107.7,367901,190232,177669,107.1
37010, 포항시,104,65세이상,2016,67812,28980,38832,74.6,67680,28922,38758,74.6
37010, 포항시,086,85세이상,2016,5334,1110,4224,26.3,5330,1109,4221,26.3
37010, 포항시,126,평균연령,2016,41.7,40.2,43.1,,41.7,40.3,43.2,
37010, 포항시,127,중위연령,2016,43.6,42,45.2,,43.8,42.2,45.4,
37011, 남구,000,합계,2016,242145,125688,116457,107.9,238561,123331,115230,107
37011, 남구,005,0~4세,2016,10947,5708,5239,109,10892,5677,5215,108.9
37011, 남구,005001, 0세,2016,2052,1078,974,110.7,2043,1072,971,110.4
37011, 남구,005002, 1세,2016,2197,1134,1063,106.7,2185,1128,1057,106.7
37011, 남구,005003, 2세,2016,2132,1109,1023,108.4,2125,1105,1020,108.3
37011, 남구,005004, 3세,2016,2173,1119,1054,106.2,2155,1109,1046,106
37011, 남구,005005, 4세,2016,2393,1268,1125,112.7,2384,1263,1121,112.7
37011, 남구,010,5~9세,2016,10902,5630,5272,106.8,10866,5616,5250,107
37011, 남구,010001, 5세,2016,2289,1189,1100,108.1,2275,1186,1089,108.9
37011, 남구,010002, 6세,2016,2181,1133,1048,108.1,2177,1130,1047,107.9
37011, 남구,010003, 7세,2016,2100,1099,1001,109.8,2093,1096,997,109.9
37011, 남구,010004, 8세,2016,2158,1098,1060,103.6,2153,1096,1057,103.7
37011, 남구,010005, 9세,2016,2174,1111,1063,104.5,2168,1108,1060,104.5
37011, 남구,015,10~14세,2016,10627,5633,4994,112.8,10616,5626,4990,112.7
37011, 남구,015001, 10세,2016,2014,1047,967,108.3,2010,1045,965,108.3
37011, 남구,015002, 11세,2016,2053,1109,944,117.5,2053,1109,944,117.5
37011, 남구,015003, 12세,2016,2171,1130,1041,108.5,2169,1128,1041,108.4
37011, 남구,015004, 13세,2016,2140,1139,1001,113.8,2138,1138,1000,113.8
37011, 남구,015005, 14세,2016,2249,1208,1041,116,2246,1206,1040,116
37011, 남구,020,15~19세,2016,13605,7527,6078,123.8,13585,7515,6070,123.8
37011, 남구,020001, 15세,2016,2708,1436,1272,112.9,2707,1435,1272,112.8
37011, 남구,020002, 16세,2016,2893,1543,1350,114.3,2892,1543,1349,114.4
37011, 남구,020003, 17세,2016,3017,1639,1378,118.9,3013,1636,1377,118.8
37011, 남구,020004, 18세,2016,2797,1534,1263,121.5,2795,1534,1261,121.6
37011, 남구,020005, 19세,2016,2190,1375,815,168.7,2178,1367,811,168.6
37011, 남구,025,20~24세,2016,13954,8484,5470,155.1,13525,8221,5304,155
37011, 남구,025001, 20세,2016,2769,1778,991,179.4,2734,1762,972,181.3
37011, 남구,025002, 21세,2016,2743,1769,974,181.6,2697,1748,949,184.2
37011, 남구,025003, 22세,2016,2651,1671,980,170.5,2566,1614,952,169.5
37011, 남구,025004, 23세,2016,2825,1566,1259,124.4,2710,1494,1216,122.9
37011, 남구,025005, 24세,2016,2966,1700,1266,134.3,2818,1603,1215,131.9
37011, 남구,030,25~29세,2016,14166,8230,5936,138.6,13354,7677,5677,135.2
37011, 남구,030001, 25세,2016,2875,1676,1199,139.8,2710,1562,1148,136.1
37011, 남구,030002, 26세,2016,2834,1658,1176,141,2679,1560,1119,139.4
37011, 남구,030003, 27세,2016,2858,1687,1171,144.1,2683,1573,1110,141.7
37011, 남구,030004, 28세,2016,2743,1610,1133,142.1,2584,1497,1087,137.7
37011, 남구,030005, 29세,2016,2856,1599,1257,127.2,2698,1485,1213,122.4
37011, 남구,035,30~34세,2016,16310,8948,7362,121.5,15650,8498,7152,118.8
37011, 남구,035001, 30세,2016,2867,1635,1232,132.7,2740,1556,1184,131.4
37011, 남구,035002, 31세,2016,2958,1618,1340,120.7,2801,1514,1287,117.6
37011, 남구,035003, 32세,2016,3175,1750,1425,122.8,3029,1647,1382,119.2
37011, 남구,035004, 33세,2016,3471,1911,1560,122.5,3367,1836,1531,119.9
37011, 남구,035005, 34세,2016,3839,2034,1805,112.7,3713,1945,1768,110
37011, 남구,040,35~39세,2016,17936,9455,8481,111.5,17477,9112,8365,108.9
37011, 남구,040001, 35세,2016,3857,2049,1808,113.3,3751,1976,1775,111.3
37011, 남구,040002, 36세,2016,3780,1952,1828,106.8,3702,1894,1808,104.8
37011, 남구,040003, 37세,2016,3588,1868,1720,108.6,3482,1791,1691,105.9
37011, 남구,040004, 38세,2016,3285,1769,1516,116.7,3192,1695,1497,113.2
37011, 남구,040005, 39세,2016,3426,1817,1609,112.9,3350,1756,1594,110.2
37011, 남구,045,40~44세,2016,18898,9870,9028,109.3,18532,9585,8947,107.1
37011, 남구,045001, 40세,2016,3182,1706,1476,115.6,3087,1630,1457,111.9
37011, 남구,045002, 41세,2016,3636,1857,1779,104.4,3574,1811,1763,102.7
37011, 남구,045003, 42세,2016,4021,2082,1939,107.4,3958,2037,1921,106
37011, 남구,045004, 43세,2016,4066,2127,1939,109.7,3984,2060,1924,107.1
37011, 남구,045005, 44세,2016,3993,2098,1895,110.7,3929,2047,1882,108.8
37011, 남구,050,45~49세,2016,21776,11385,10391,109.6,21518,11223,10295,109
37011, 남구,050001, 45세,2016,4237,2182,2055,106.2,4170,2140,2030,105.4
37011, 남구,050002, 46세,2016,4371,2279,2092,108.9,4314,2238,2076,107.8
37011, 남구,050003, 47세,2016,4308,2291,2017,113.6,4257,2257,2000,112.9
37011, 남구,050004, 48세,2016,4660,2457,2203,111.5,4612,2431,2181,111.5
37011, 남구,050005, 49세,2016,4200,2176,2024,107.5,4165,2157,2008,107.4
37011, 남구,055,50~54세,2016,20896,10661,10235,104.2,20716,10576,10140,104.3
37011, 남구,055001, 50세,2016,4127,2151,1976,108.9,4092,2133,1959,108.9
37011, 남구,055002, 51세,2016,4229,2119,2110,100.4,4195,2100,2095,100.2
37011, 남구,055003, 52세,2016,3847,1935,1912,101.2,3812,1920,1892,101.5
37011, 남구,055004, 53세,2016,4244,2149,2095,102.6,4199,2133,2066,103.2
37011, 남구,055005, 54세,2016,4449,2307,2142,107.7,4418,2290,2128,107.6
37011, 남구,060,55~59세,2016,22931,11373,11558,98.4,22788,11297,11491,98.3
37011, 남구,060001, 55세,2016,4908,2488,2420,102.8,4883,2477,2406,103
37011, 남구,060002, 56세,2016,4928,2479,2449,101.2,4892,2457,2435,100.9
37011, 남구,060003, 57세,2016,4598,2227,2371,93.9,4575,2218,2357,94.1
37011, 남구,060004, 58세,2016,4204,2013,2191,91.9,4170,1993,2177,91.5
37011, 남구,060005, 59세,2016,4293,2166,2127,101.8,4268,2152,2116,101.7
37011, 남구,065,60~64세,2016,18016,9139,8877,103,17920,9089,8831,102.9
37011, 남구,065001, 60세,2016,4008,1962,2046,95.9,3982,1949,2033,95.9
37011, 남구,065002, 61세,2016,4032,2049,1983,103.3,4014,2037,1977,103
37011, 남구,065003, 62세,2016,3513,1857,1656,112.1,3495,1847,1648,112.1
37011, 남구,065004, 63세,2016,3116,1593,1523,104.6,3099,1586,1513,104.8
37011, 남구,065005, 64세,2016,3347,1678,1669,100.5,3330,1670,1660,100.6
37011, 남구,070,65~69세,2016,11738,6025,5713,105.5,11696,6004,5692,105.5
37011, 남구,070001, 65세,2016,2479,1271,1208,105.2,2464,1263,1201,105.2
37011, 남구,070002, 66세,2016,2353,1255,1098,114.3,2342,1248,1094,114.1
37011, 남구,070003, 67세,2016,2513,1259,1254,100.4,2508,1258,1250,100.6
37011, 남구,070004, 68세,2016,2268,1180,1088,108.5,2263,1177,1086,108.4
37011, 남구,070005, 69세,2016,2125,1060,1065,99.5,2119,1058,1061,99.7
37011, 남구,075,70~74세,2016,7822,3739,4083,91.6,7815,3737,4078,91.6
37011, 남구,075001, 70세,2016,1383,694,689,100.7,1381,693,688,100.7
37011, 남구,075002, 71세,2016,1453,695,758,91.7,1453,695,758,91.7
37011, 남구,075003, 72세,2016,1568,745,823,90.5,1565,744,821,90.6
37011, 남구,075004, 73세,2016,1655,783,872,89.8,1654,783,871,89.9
37011, 남구,075005, 74세,2016,1763,822,941,87.4,1762,822,940,87.4
37011, 남구,080,75~79세,2016,5918,2374,3544,67,5914,2373,3541,67
37011, 남구,080001, 75세,2016,1407,617,790,78.1,1407,617,790,78.1
37011, 남구,080002, 76세,2016,1272,513,759,67.6,1272,513,759,67.6
37011, 남구,080003, 77세,2016,1237,501,736,68.1,1236,500,736,67.9
37011, 남구,080004, 78세,2016,1008,377,631,59.7,1007,377,630,59.8
37011, 남구,080005, 79세,2016,994,366,628,58.3,992,366,626,58.5
37011, 남구,085,80~84세,2016,3512,1058,2454,43.1,3508,1056,2452,43.1
37011, 남구,085001, 80세,2016,897,292,605,48.3,896,292,604,48.3
37011, 남구,085002, 81세,2016,802,243,559,43.5,801,242,559,43.3
37011, 남구,085003, 82세,2016,690,222,468,47.4,690,222,468,47.4
37011, 남구,085004, 83세,2016,602,164,438,37.4,601,164,437,37.5
37011, 남구,085005, 84세,2016,521,137,384,35.7,520,136,384,35.4
37011, 남구,090,85~89세,2016,1554,342,1212,28.2,1554,342,1212,28.2
37011, 남구,090001, 85세,2016,394,109,285,38.2,394,109,285,38.2
37011, 남구,090002, 86세,2016,349,68,281,24.2,349,68,281,24.2
37011, 남구,090003, 87세,2016,304,69,235,29.4,304,69,235,29.4
37011, 남구,090004, 88세,2016,284,58,226,25.7,284,58,226,25.7
37011, 남구,090005, 89세,2016,223,38,185,20.5,223,38,185,20.5
37011, 남구,095,90~94세,2016,504,87,417,20.9,504,87,417,20.9
37011, 남구,095001, 90세,2016,150,23,127,18.1,150,23,127,18.1
37011, 남구,095002, 91세,2016,129,24,105,22.9,129,24,105,22.9
37011, 남구,095003, 92세,2016,92,16,76,21.1,92,16,76,21.1
37011, 남구,095004, 93세,2016,81,16,65,24.6,81,16,65,24.6
37011, 남구,095005, 94세,2016,52,8,44,18.2,52,8,44,18.2
37011, 남구,100,95~99세,2016,119,18,101,17.8,117,18,99,18.2
37011, 남구,100001, 95세,2016,42,X,38,10.5,42,X,38,10.5
37011, 남구,100002, 96세,2016,34,6,28,21.4,34,6,28,21.4
37011, 남구,100003, 97세,2016,19,X,15,26.7,19,X,15,26.7
37011, 남구,100004, 98세,2016,17,X,15,13.3,15,X,13,15.4
37011, 남구,100005, 99세,2016,7,X,5,40,7,X,5,40
37011, 남구,101,100세이상,2016,14,X,12,16.7,14,X,12,16.7
37011, 남구,102,15세미만,2016,32476,16971,15505,109.5,32374,16919,15455,109.5
37011, 남구,103,15~64세,2016,178488,95072,83416,114,175065,92793,82272,112.8
37011, 남구,104,65세이상,2016,31181,13645,17536,77.8,31122,13619,17503,77.8
37011, 남구,086,85세이상,2016,2191,449,1742,25.8,2189,449,1740,25.8
37011, 남구,126,평균연령,2016,41.6,40.2,43,,41.7,40.3,43.1,
37011, 남구,127,중위연령,2016,43.4,41.8,45.2,,43.7,42.1,45.3,
37012, 북구,000,합계,2016,268215,133073,135142,98.5,265855,131824,134031,98.4
37012, 북구,005,0~4세,2016,12033,6259,5774,108.4,11990,6237,5753,108.4
37012, 북구,005001, 0세,2016,2209,1124,1085,103.6,2202,1121,1081,103.7
37012, 북구,005002, 1세,2016,2435,1275,1160,109.9,2425,1270,1155,110
37012, 북구,005003, 2세,2016,2331,1183,1148,103,2326,1181,1145,103.1
37012, 북구,005004, 3세,2016,2469,1265,1204,105.1,2455,1257,1198,104.9
37012, 북구,005005, 4세,2016,2589,1412,1177,120,2582,1408,1174,119.9
37012, 북구,010,5~9세,2016,12198,6375,5823,109.5,12165,6357,5808,109.5
37012, 북구,010001, 5세,2016,2574,1363,1211,112.6,2568,1361,1207,112.8
37012, 북구,010002, 6세,2016,2453,1296,1157,112,2446,1290,1156,111.6
37012, 북구,010003, 7세,2016,2363,1227,1136,108,2352,1222,1130,108.1
37012, 북구,010004, 8세,2016,2393,1229,1164,105.6,2390,1227,1163,105.5
37012, 북구,010005, 9세,2016,2415,1260,1155,109.1,2409,1257,1152,109.1
37012, 북구,015,10~14세,2016,12324,6500,5824,111.6,12306,6488,5818,111.5
37012, 북구,015001, 10세,2016,2323,1227,1096,112,2319,1224,1095,111.8
37012, 북구,015002, 11세,2016,2271,1201,1070,112.2,2267,1197,1070,111.9
37012, 북구,015003, 12세,2016,2467,1306,1161,112.5,2464,1304,1160,112.4
37012, 북구,015004, 13세,2016,2578,1331,1247,106.7,2574,1329,1245,106.7
37012, 북구,015005, 14세,2016,2685,1435,1250,114.8,2682,1434,1248,114.9
37012, 북구,020,15~19세,2016,16355,8638,7717,111.9,16253,8589,7664,112.1
37012, 북구,020001, 15세,2016,3039,1610,1429,112.7,3036,1609,1427,112.8
37012, 북구,020002, 16세,2016,3597,1913,1684,113.6,3591,1908,1683,113.4
37012, 북구,020003, 17세,2016,3383,1777,1606,110.6,3377,1775,1602,110.8
37012, 북구,020004, 18세,2016,3326,1714,1612,106.3,3310,1706,1604,106.4
37012, 북구,020005, 19세,2016,3010,1624,1386,117.2,2939,1591,1348,118
37012, 북구,025,20~24세,2016,16839,9436,7403,127.5,16508,9291,7217,128.7
37012, 북구,025001, 20세,2016,3595,2069,1526,135.6,3538,2047,1491,137.3
37012, 북구,025002, 21세,2016,3608,2080,1528,136.1,3545,2061,1484,138.9
37012, 북구,025003, 22세,2016,3346,1834,1512,121.3,3279,1808,1471,122.9
37012, 북구,025004, 23세,2016,3216,1761,1455,121,3158,1727,1431,120.7
37012, 북구,025005, 24세,2016,3074,1692,1382,122.4,2988,1648,1340,123
37012, 북구,030,25~29세,2016,13685,7478,6207,120.5,13274,7264,6010,120.9
37012, 북구,030001, 25세,2016,2886,1628,1258,129.4,2811,1586,1225,129.5
37012, 북구,030002, 26세,2016,2859,1604,1255,127.8,2781,1558,1223,127.4
37012, 북구,030003, 27세,2016,2721,1495,1226,121.9,2634,1447,1187,121.9
37012, 북구,030004, 28세,2016,2603,1381,1222,113,2513,1344,1169,115
37012, 북구,030005, 29세,2016,2616,1370,1246,110,2535,1329,1206,110.2
37012, 북구,035,30~34세,2016,16373,8272,8101,102.1,16027,8080,7947,101.7
37012, 북구,035001, 30세,2016,2709,1423,1286,110.7,2649,1388,1261,110.1
37012, 북구,035002, 31세,2016,2886,1445,1441,100.3,2801,1395,1406,99.2
37012, 북구,035003, 32세,2016,3232,1580,1652,95.6,3160,1542,1618,95.3
37012, 북구,035004, 33세,2016,3581,1837,1744,105.3,3507,1793,1714,104.6
37012, 북구,035005, 34세,2016,3965,1987,1978,100.5,3910,1962,1948,100.7
37012, 북구,040,35~39세,2016,19214,9656,9558,101,18944,9501,9443,100.6
37012, 북구,040001, 35세,2016,4142,2123,2019,105.2,4085,2092,1993,105
37012, 북구,040002, 36세,2016,3970,2045,1925,106.2,3912,2015,1897,106.2
37012, 북구,040003, 37세,2016,3797,1872,1925,97.2,3740,1837,1903,96.5
37012, 북구,040004, 38세,2016,3517,1772,1745,101.5,3473,1745,1728,101
37012, 북구,040005, 39세,2016,3788,1844,1944,94.9,3734,1812,1922,94.3
37012, 북구,045,40~44세,2016,20567,10108,10459,96.6,20336,9953,10383,95.9
37012, 북구,045001, 40세,2016,3540,1750,1790,97.8,3498,1718,1780,96.5
37012, 북구,045002, 41세,2016,3917,2013,1904,105.7,3865,1975,1890,104.5
37012, 북구,045003, 42세,2016,4302,2090,2212,94.5,4257,2059,2198,93.7
37012, 북구,045004, 43세,2016,4387,2083,2304,90.4,4341,2055,2286,89.9
37012, 북구,045005, 44세,2016,4421,2172,2249,96.6,4375,2146,2229,96.3
37012, 북구,050,45~49세,2016,23590,11470,12120,94.6,23418,11370,12048,94.4
37012, 북구,050001, 45세,2016,4719,2304,2415,95.4,4679,2284,2395,95.4
37012, 북구,050002, 46세,2016,4807,2296,2511,91.4,4766,2268,2498,90.8
37012, 북구,050003, 47세,2016,4751,2336,2415,96.7,4716,2316,2400,96.5
37012, 북구,050004, 48세,2016,4942,2417,2525,95.7,4910,2400,2510,95.6
37012, 북구,050005, 49세,2016,4371,2117,2254,93.9,4347,2102,2245,93.6
37012, 북구,055,50~54세,2016,23959,11727,12232,95.9,23811,11652,12159,95.8
37012, 북구,055001, 50세,2016,4644,2317,2327,99.6,4624,2309,2315,99.7
37012, 북구,055002, 51세,2016,4838,2313,2525,91.6,4810,2298,2512,91.5
37012, 북구,055003, 52세,2016,4503,2184,2319,94.2,4476,2169,2307,94
37012, 북구,055004, 53세,2016,4949,2402,2547,94.3,4898,2374,2524,94.1
37012, 북구,055005, 54세,2016,5025,2511,2514,99.9,5003,2502,2501,100
37012, 북구,060,55~59세,2016,25312,12293,13019,94.4,25211,12256,12955,94.6
37012, 북구,060001, 55세,2016,5539,2683,2856,93.9,5522,2678,2844,94.2
37012, 북구,060002, 56세,2016,5436,2582,2854,90.5,5411,2577,2834,90.9
37012, 북구,060003, 57세,2016,5046,2405,2641,91.1,5021,2394,2627,91.1
37012, 북구,060004, 58세,2016,4642,2279,2363,96.4,4625,2272,2353,96.6
37012, 북구,060005, 59세,2016,4649,2344,2305,101.7,4632,2335,2297,101.7
37012, 북구,065,60~64세,2016,19135,9526,9609,99.1,19054,9483,9571,99.1
37012, 북구,065001, 60세,2016,4311,2102,2209,95.2,4292,2092,2200,95.1
37012, 북구,065002, 61세,2016,4361,2117,2244,94.3,4340,2103,2237,94
37012, 북구,065003, 62세,2016,3736,1913,1823,104.9,3715,1902,1813,104.9
37012, 북구,065004, 63세,2016,3333,1678,1655,101.4,3322,1672,1650,101.3
37012, 북구,065005, 64세,2016,3394,1716,1678,102.3,3385,1714,1671,102.6
37012, 북구,070,65~69세,2016,12791,6381,6410,99.5,12752,6361,6391,99.5
37012, 북구,070001, 65세,2016,2651,1337,1314,101.8,2642,1331,1311,101.5
37012, 북구,070002, 66세,2016,2647,1322,1325,99.8,2634,1314,1320,99.5
37012, 북구,070003, 67세,2016,2651,1350,1301,103.8,2648,1350,1298,104
37012, 북구,070004, 68세,2016,2515,1226,1289,95.1,2505,1221,1284,95.1
37012, 북구,070005, 69세,2016,2327,1146,1181,97,2323,1145,1178,97.2
37012, 북구,075,70~74세,2016,8955,3984,4971,80.1,8944,3981,4963,80.2
37012, 북구,075001, 70세,2016,1576,770,806,95.5,1573,769,804,95.6
37012, 북구,075002, 71세,2016,1620,745,875,85.1,1616,744,872,85.3
37012, 북구,075003, 72세,2016,1823,817,1006,81.2,1822,817,1005,81.3
37012, 북구,075004, 73세,2016,1876,787,1089,72.3,1874,787,1087,72.4
37012, 북구,075005, 74세,2016,2060,865,1195,72.4,2059,864,1195,72.3
37012, 북구,080,75~79세,2016,7231,2872,4359,65.9,7214,2864,4350,65.8
37012, 북구,080001, 75세,2016,1658,700,958,73.1,1655,698,957,72.9
37012, 북구,080002, 76세,2016,1534,622,912,68.2,1527,618,909,68
37012, 북구,080003, 77세,2016,1570,650,920,70.7,1567,649,918,70.7
37012, 북구,080004, 78세,2016,1325,474,851,55.7,1324,474,850,55.8
37012, 북구,080005, 79세,2016,1144,426,718,59.3,1141,425,716,59.4
37012, 북구,085,80~84세,2016,4511,1437,3074,46.7,4507,1437,3070,46.8
37012, 북구,085001, 80세,2016,1097,401,696,57.6,1095,401,694,57.8
37012, 북구,085002, 81세,2016,1003,307,696,44.1,1003,307,696,44.1
37012, 북구,085003, 82세,2016,928,304,624,48.7,928,304,624,48.7
37012, 북구,085004, 83세,2016,769,235,534,44,768,235,533,44.1
37012, 북구,085005, 84세,2016,714,190,524,36.3,713,190,523,36.3
37012, 북구,090,85~89세,2016,2272,504,1768,28.5,2270,503,1767,28.5
37012, 북구,090001, 85세,2016,578,131,447,29.3,578,131,447,29.3
37012, 북구,090002, 86세,2016,516,133,383,34.7,516,133,383,34.7
37012, 북구,090003, 87세,2016,476,110,366,30.1,474,109,365,29.9
37012, 북구,090004, 88세,2016,363,69,294,23.5,363,69,294,23.5
37012, 북구,090005, 89세,2016,339,61,278,21.9,339,61,278,21.9
37012, 북구,095,90~94세,2016,726,138,588,23.5,726,138,588,23.5
37012, 북구,095001, 90세,2016,191,35,156,22.4,191,35,156,22.4
37012, 북구,095002, 91세,2016,192,35,157,22.3,192,35,157,22.3
37012, 북구,095003, 92세,2016,131,32,99,32.3,131,32,99,32.3
37012, 북구,095004, 93세,2016,111,22,89,24.7,111,22,89,24.7
37012, 북구,095005, 94세,2016,101,14,87,16.1,101,14,87,16.1
37012, 북구,100,95~99세,2016,135,18,117,15.4,135,18,117,15.4
37012, 북구,100001, 95세,2016,40,6,34,17.6,40,6,34,17.6
37012, 북구,100002, 96세,2016,49,6,43,14,49,6,43,14
37012, 북구,100003, 97세,2016,25,X,21,19,25,X,21,19
37012, 북구,100004, 98세,2016,13,X,11,18.2,13,X,11,18.2
37012, 북구,100005, 99세,2016,8,X,8,0,8,X,8,0
37012, 북구,101,100세이상,2016,10,X,9,11.1,10,X,9,11.1
37012, 북구,102,15세미만,2016,36555,19134,17421,109.8,36461,19082,17379,109.8
37012, 북구,103,15~64세,2016,195029,98604,96425,102.3,192836,97439,95397,102.1
37012, 북구,104,65세이상,2016,36631,15335,21296,72,36558,15303,21255,72
37012, 북구,086,85세이상,2016,3143,661,2482,26.6,3141,660,2481,26.6
37012, 북구,126,평균연령,2016,41.7,40.2,43.2,,41.8,40.3,43.3,
37012, 북구,127,중위연령,2016,43.8,42.1,45.3,,43.9,42.2,45.4,
37020, 경주시,000,합계,2016,262769,133627,129142,103.5,250749,125601,125148,100.4
37020, 경주시,005,0~4세,2016,9049,4626,4423,104.6,8912,4545,4367,104.1
37020, 경주시,005001, 0세,2016,1699,857,842,101.8,1668,841,827,101.7
37020, 경주시,005002, 1세,2016,1742,861,881,97.7,1723,849,874,97.1
37020, 경주시,005003, 2세,2016,1792,943,849,111.1,1763,928,835,111.1
37020, 경주시,005004, 3세,2016,1796,940,856,109.8,1764,921,843,109.3
37020, 경주시,005005, 4세,2016,2020,1025,995,103,1994,1006,988,101.8
37020, 경주시,010,5~9세,2016,9917,5121,4796,106.8,9808,5062,4746,106.7
37020, 경주시,010001, 5세,2016,2037,1060,977,108.5,2008,1045,963,108.5
37020, 경주시,010002, 6세,2016,1918,981,937,104.7,1890,968,922,105
37020, 경주시,010003, 7세,2016,1871,974,897,108.6,1855,965,890,108.4
37020, 경주시,010004, 8세,2016,2043,1042,1001,104.1,2015,1028,987,104.2
37020, 경주시,010005, 9세,2016,2048,1064,984,108.1,2040,1056,984,107.3
37020, 경주시,015,10~14세,2016,10370,5448,4922,110.7,10318,5418,4900,110.6
37020, 경주시,015001, 10세,2016,2022,1051,971,108.2,2009,1045,964,108.4
37020, 경주시,015002, 11세,2016,1900,997,903,110.4,1888,992,896,110.7
37020, 경주시,015003, 12세,2016,2067,1122,945,118.7,2061,1119,942,118.8
37020, 경주시,015004, 13세,2016,2125,1090,1035,105.3,2118,1084,1034,104.8
37020, 경주시,015005, 14세,2016,2256,1188,1068,111.2,2242,1178,1064,110.7
37020, 경주시,020,15~19세,2016,15404,8356,7048,118.6,15115,8224,6891,119.3
37020, 경주시,020001, 15세,2016,2666,1448,1218,118.9,2661,1445,1216,118.8
37020, 경주시,020002, 16세,2016,3023,1605,1418,113.2,3006,1597,1409,113.3
37020, 경주시,020003, 17세,2016,2977,1624,1353,120,2959,1614,1345,120
37020, 경주시,020004, 18세,2016,3226,1778,1448,122.8,3172,1750,1422,123.1
37020, 경주시,020005, 19세,2016,3512,1901,1611,118,3317,1818,1499,121.3
37020, 경주시,025,20~24세,2016,18307,10587,7720,137.1,16786,9684,7102,136.4
37020, 경주시,025001, 20세,2016,3759,2093,1666,125.6,3493,1976,1517,130.3
37020, 경주시,025002, 21세,2016,3668,2020,1648,122.6,3401,1893,1508,125.5
37020, 경주시,025003, 22세,2016,3626,2060,1566,131.5,3340,1879,1461,128.6
37020, 경주시,025004, 23세,2016,3691,2223,1468,151.4,3345,2008,1337,150.2
37020, 경주시,025005, 24세,2016,3563,2191,1372,159.7,3207,1928,1279,150.7
37020, 경주시,030,25~29세,2016,14801,8715,6086,143.2,12496,7090,5406,131.2
37020, 경주시,030001, 25세,2016,3246,1941,1305,148.7,2847,1661,1186,140.1
37020, 경주시,030002, 26세,2016,3180,1912,1268,150.8,2709,1571,1138,138
37020, 경주시,030003, 27세,2016,2881,1719,1162,147.9,2422,1388,1034,134.2
37020, 경주시,030004, 28세,2016,2677,1519,1158,131.2,2207,1206,1001,120.5
37020, 경주시,030005, 29세,2016,2817,1624,1193,136.1,2311,1264,1047,120.7
37020, 경주시,035,30~34세,2016,14971,8439,6532,129.2,12650,6707,5943,112.9
37020, 경주시,035001, 30세,2016,2621,1511,1110,136.1,2137,1161,976,119
37020, 경주시,035002, 31세,2016,2683,1543,1140,135.4,2199,1180,1019,115.8
37020, 경주시,035003, 32세,2016,2907,1614,1293,124.8,2418,1253,1165,107.6
37020, 경주시,035004, 33세,2016,3220,1780,1440,123.6,2816,1481,1335,110.9
37020, 경주시,035005, 34세,2016,3540,1991,1549,128.5,3080,1632,1448,112.7
37020, 경주시,040,35~39세,2016,17184,9394,7790,120.6,15542,8164,7378,110.7
37020, 경주시,040001, 35세,2016,3580,1976,1604,123.2,3225,1707,1518,112.5
37020, 경주시,040002, 36세,2016,3637,1958,1679,116.6,3280,1689,1591,106.2
37020, 경주시,040003, 37세,2016,3393,1881,1512,124.4,3053,1637,1416,115.6
37020, 경주시,040004, 38세,2016,3238,1754,1484,118.2,2924,1514,1410,107.4
37020, 경주시,040005, 39세,2016,3336,1825,1511,120.8,3060,1617,1443,112.1
37020, 경주시,045,40~44세,2016,19636,10316,9320,110.7,18471,9518,8953,106.3
37020, 경주시,045001, 40세,2016,3333,1769,1564,113.1,3071,1590,1481,107.4
37020, 경주시,045002, 41세,2016,3657,1957,1700,115.1,3445,1810,1635,110.7
37020, 경주시,045003, 42세,2016,4123,2152,1971,109.2,3875,1989,1886,105.5
37020, 경주시,045004, 43세,2016,4211,2134,2077,102.7,4003,1992,2011,99.1
37020, 경주시,045005, 44세,2016,4312,2304,2008,114.7,4077,2137,1940,110.2
37020, 경주시,050,45~49세,2016,22210,11542,10668,108.2,21262,10956,10306,106.3
37020, 경주시,050001, 45세,2016,4434,2315,2119,109.2,4219,2175,2044,106.4
37020, 경주시,050002, 46세,2016,4399,2317,2082,111.3,4193,2188,2005,109.1
37020, 경주시,050003, 47세,2016,4385,2284,2101,108.7,4200,2174,2026,107.3
37020, 경주시,050004, 48세,2016,4712,2442,2270,107.6,4519,2327,2192,106.2
37020, 경주시,050005, 49세,2016,4280,2184,2096,104.2,4131,2092,2039,102.6
37020, 경주시,055,50~54세,2016,22277,11563,10714,107.9,21571,11156,10415,107.1
37020, 경주시,055001, 50세,2016,4347,2289,2058,111.2,4207,2206,2001,110.2
37020, 경주시,055002, 51세,2016,4299,2201,2098,104.9,4141,2110,2031,103.9
37020, 경주시,055003, 52세,2016,4273,2178,2095,104,4134,2101,2033,103.3
37020, 경주시,055004, 53세,2016,4569,2407,2162,111.3,4429,2326,2103,110.6
37020, 경주시,055005, 54세,2016,4789,2488,2301,108.1,4660,2413,2247,107.4
37020, 경주시,060,55~59세,2016,22797,11623,11174,104,22349,11365,10984,103.5
37020, 경주시,060001, 55세,2016,4919,2526,2393,105.6,4822,2463,2359,104.4
37020, 경주시,060002, 56세,2016,4831,2491,2340,106.5,4731,2435,2296,106.1
37020, 경주시,060003, 57세,2016,4551,2316,2235,103.6,4470,2275,2195,103.6
37020, 경주시,060004, 58세,2016,4269,2168,2101,103.2,4177,2111,2066,102.2
37020, 경주시,060005, 59세,2016,4227,2122,2105,100.8,4149,2081,2068,100.6
37020, 경주시,065,60~64세,2016,18402,8854,9548,92.7,18197,8739,9458,92.4
37020, 경주시,065001, 60세,2016,4163,2058,2105,97.8,4113,2030,2083,97.5
37020, 경주시,065002, 61세,2016,3981,1894,2087,90.8,3927,1866,2061,90.5
37020, 경주시,065003, 62세,2016,3513,1707,1806,94.5,3480,1688,1792,94.2
37020, 경주시,065004, 63세,2016,3360,1621,1739,93.2,3328,1604,1724,93
37020, 경주시,065005, 64세,2016,3385,1574,1811,86.9,3349,1551,1798,86.3
37020, 경주시,070,65~69세,2016,14491,6904,7587,91,14416,6869,7547,91
37020, 경주시,070001, 65세,2016,2933,1399,1534,91.2,2909,1388,1521,91.3
37020, 경주시,070002, 66세,2016,2891,1357,1534,88.5,2871,1349,1522,88.6
37020, 경주시,070003, 67세,2016,3129,1513,1616,93.6,3114,1505,1609,93.5
37020, 경주시,070004, 68세,2016,2837,1366,1471,92.9,2830,1361,1469,92.6
37020, 경주시,070005, 69세,2016,2701,1269,1432,88.6,2692,1266,1426,88.8
37020, 경주시,075,70~74세,2016,11590,5101,6489,78.6,11546,5080,6466,78.6
37020, 경주시,075001, 70세,2016,1829,872,957,91.1,1813,866,947,91.4
37020, 경주시,075002, 71세,2016,2098,934,1164,80.2,2091,931,1160,80.3
37020, 경주시,075003, 72세,2016,2202,951,1251,76,2191,946,1245,76
37020, 경주시,075004, 73세,2016,2495,1072,1423,75.3,2490,1069,1421,75.2
37020, 경주시,075005, 74세,2016,2966,1272,1694,75.1,2961,1268,1693,74.9
37020, 경주시,080,75~79세,2016,10317,3889,6428,60.5,10292,3880,6412,60.5
37020, 경주시,080001, 75세,2016,2181,857,1324,64.7,2176,855,1321,64.7
37020, 경주시,080002, 76세,2016,2110,818,1292,63.3,2105,818,1287,63.6
37020, 경주시,080003, 77세,2016,2240,836,1404,59.5,2236,835,1401,59.6
37020, 경주시,080004, 78세,2016,1924,694,1230,56.4,1919,689,1230,56
37020, 경주시,080005, 79세,2016,1862,684,1178,58.1,1856,683,1173,58.2
37020, 경주시,085,80~84세,2016,6900,2203,4697,46.9,6890,2201,4689,46.9
37020, 경주시,085001, 80세,2016,1685,574,1111,51.7,1682,572,1110,51.5
37020, 경주시,085002, 81세,2016,1530,495,1035,47.8,1529,495,1034,47.9
37020, 경주시,085003, 82세,2016,1375,446,929,48,1371,446,925,48.2
37020, 경주시,085004, 83세,2016,1247,366,881,41.5,1247,366,881,41.5
37020, 경주시,085005, 84세,2016,1063,322,741,43.5,1061,322,739,43.6
37020, 경주시,090,85~89세,2016,3004,721,2283,31.6,2995,719,2276,31.6
37020, 경주시,090001, 85세,2016,788,202,586,34.5,787,201,586,34.3
37020, 경주시,090002, 86세,2016,707,177,530,33.4,707,177,530,33.4
37020, 경주시,090003, 87세,2016,607,150,457,32.8,603,149,454,32.8
37020, 경주시,090004, 88세,2016,501,106,395,26.8,498,106,392,27
37020, 경주시,090005, 89세,2016,401,86,315,27.3,400,86,314,27.4
37020, 경주시,095,90~94세,2016,917,187,730,25.6,911,187,724,25.8
37020, 경주시,095001, 90세,2016,228,46,182,25.3,228,46,182,25.3
37020, 경주시,095002, 91세,2016,213,44,169,26,210,44,166,26.5
37020, 경주시,095003, 92세,2016,142,38,104,36.5,142,38,104,36.5
37020, 경주시,095004, 93세,2016,203,37,166,22.3,201,37,164,22.6
37020, 경주시,095005, 94세,2016,131,22,109,20.2,130,22,108,20.4
37020, 경주시,100,95~99세,2016,204,36,168,21.4,202,35,167,21
37020, 경주시,100001, 95세,2016,83,15,68,22.1,83,15,68,22.1
37020, 경주시,100002, 96세,2016,45,9,36,25,43,8,35,22.9
37020, 경주시,100003, 97세,2016,30,7,23,30.4,30,7,23,30.4
37020, 경주시,100004, 98세,2016,25,X,21,19,25,X,21,19
37020, 경주시,100005, 99세,2016,21,X,20,5,21,X,20,5
37020, 경주시,101,100세이상,2016,21,X,19,10.5,20,X,18,11.1
37020, 경주시,102,15세미만,2016,29336,15195,14141,107.5,29038,15025,14013,107.2
37020, 경주시,103,15~64세,2016,185989,99389,86600,114.8,174439,91603,82836,110.6
37020, 경주시,104,65세이상,2016,47444,19043,28401,67.1,47272,18973,28299,67
37020, 경주시,086,85세이상,2016,4146,946,3200,29.6,4128,943,3185,29.6
37020, 경주시,126,평균연령,2016,43.9,41.8,46,,44.3,42.2,46.3,
37020, 경주시,127,중위연령,2016,45.4,43.1,47.8,,46.3,44.2,48.4,
37030, 김천시,000,합계,2016,139709,69796,69913,99.8,137371,68420,68951,99.2
37030, 김천시,005,0~4세,2016,5798,2960,2838,104.3,5784,2952,2832,104.2
37030, 김천시,005001, 0세,2016,1168,593,575,103.1,1165,591,574,103
37030, 김천시,005002, 1세,2016,1127,562,565,99.5,1121,559,562,99.5
37030, 김천시,005003, 2세,2016,1112,571,541,105.5,1111,570,541,105.4
37030, 김천시,005004, 3세,2016,1170,616,554,111.2,1168,614,554,110.8
37030, 김천시,005005, 4세,2016,1221,618,603,102.5,1219,618,601,102.8
37030, 김천시,010,5~9세,2016,5552,2906,2646,109.8,5539,2900,2639,109.9
37030, 김천시,010001, 5세,2016,1178,609,569,107,1175,609,566,107.6
37030, 김천시,010002, 6세,2016,1097,554,543,102,1093,552,541,102
37030, 김천시,010003, 7세,2016,1048,552,496,111.3,1047,551,496,111.1
37030, 김천시,010004, 8세,2016,1151,631,520,121.3,1148,629,519,121.2
37030, 김천시,010005, 9세,2016,1078,560,518,108.1,1076,559,517,108.1
37030, 김천시,015,10~14세,2016,5395,2850,2545,112,5386,2846,2540,112
37030, 김천시,015001, 10세,2016,987,545,442,123.3,986,545,441,123.6
37030, 김천시,015002, 11세,2016,999,479,520,92.1,997,478,519,92.1
37030, 김천시,015003, 12세,2016,1106,583,523,111.5,1105,583,522,111.7
37030, 김천시,015004, 13세,2016,1082,584,498,117.3,1079,582,497,117.1
37030, 김천시,015005, 14세,2016,1221,659,562,117.3,1219,658,561,117.3
37030, 김천시,020,15~19세,2016,8336,4564,3772,121,8263,4536,3727,121.7
37030, 김천시,020001, 15세,2016,1445,772,673,114.7,1442,771,671,114.9
37030, 김천시,020002, 16세,2016,1877,1133,744,152.3,1877,1133,744,152.3
37030, 김천시,020003, 17세,2016,1700,974,726,134.2,1696,971,725,133.9
37030, 김천시,020004, 18세,2016,1568,851,717,118.7,1556,847,709,119.5
37030, 김천시,020005, 19세,2016,1746,834,912,91.4,1692,814,878,92.7
37030, 김천시,025,20~24세,2016,9086,4843,4243,114.1,8628,4624,4004,115.5
37030, 김천시,025001, 20세,2016,1900,915,985,92.9,1812,881,931,94.6
37030, 김천시,025002, 21세,2016,1875,929,946,98.2,1794,902,892,101.1
37030, 김천시,025003, 22세,2016,1823,1016,807,125.9,1733,972,761,127.7
37030, 김천시,025004, 23세,2016,1695,996,699,142.5,1606,947,659,143.7
37030, 김천시,025005, 24세,2016,1793,987,806,122.5,1683,922,761,121.2
37030, 김천시,030,25~29세,2016,7417,4199,3218,130.5,6870,3834,3036,126.3
37030, 김천시,030001, 25세,2016,1612,909,703,129.3,1486,819,667,122.8
37030, 김천시,030002, 26세,2016,1512,850,662,128.4,1395,772,623,123.9
37030, 김천시,030003, 27세,2016,1479,842,637,132.2,1362,769,593,129.7
37030, 김천시,030004, 28세,2016,1424,813,611,133.1,1324,743,581,127.9
37030, 김천시,030005, 29세,2016,1390,785,605,129.8,1303,731,572,127.8
37030, 김천시,035,30~34세,2016,8086,4301,3785,113.6,7732,4064,3668,110.8
37030, 김천시,035001, 30세,2016,1436,794,642,123.7,1346,742,604,122.8
37030, 김천시,035002, 31세,2016,1497,794,703,112.9,1418,739,679,108.8
37030, 김천시,035003, 32세,2016,1540,832,708,117.5,1482,793,689,115.1
37030, 김천시,035004, 33세,2016,1681,853,828,103,1616,808,808,100
37030, 김천시,035005, 34세,2016,1932,1028,904,113.7,1870,982,888,110.6
37030, 김천시,040,35~39세,2016,9053,4889,4164,117.4,8826,4733,4093,115.6
37030, 김천시,040001, 35세,2016,1924,1039,885,117.4,1865,1000,865,115.6
37030, 김천시,040002, 36세,2016,1940,1035,905,114.4,1895,1006,889,113.2
37030, 김천시,040003, 37세,2016,1742,938,804,116.7,1689,902,787,114.6
37030, 김천시,040004, 38세,2016,1657,898,759,118.3,1618,869,749,116
37030, 김천시,040005, 39세,2016,1790,979,811,120.7,1759,956,803,119.1
37030, 김천시,045,40~44세,2016,9330,4893,4437,110.3,9182,4791,4391,109.1
37030, 김천시,045001, 40세,2016,1679,893,786,113.6,1643,867,776,111.7
37030, 김천시,045002, 41세,2016,1769,929,840,110.6,1745,910,835,109
37030, 김천시,045003, 42세,2016,1900,988,912,108.3,1859,960,899,106.8
37030, 김천시,045004, 43세,2016,1982,1012,970,104.3,1961,998,963,103.6
37030, 김천시,045005, 44세,2016,2000,1071,929,115.3,1974,1056,918,115
37030, 김천시,050,45~49세,2016,10831,5629,5202,108.2,10696,5556,5140,108.1
37030, 김천시,050001, 45세,2016,2064,1071,993,107.9,2034,1053,981,107.3
37030, 김천시,050002, 46세,2016,2160,1128,1032,109.3,2134,1113,1021,109
37030, 김천시,050003, 47세,2016,2209,1146,1063,107.8,2181,1129,1052,107.3
37030, 김천시,050004, 48세,2016,2269,1169,1100,106.3,2241,1157,1084,106.7
37030, 김천시,050005, 49세,2016,2129,1115,1014,110,2106,1104,1002,110.2
37030, 김천시,055,50~54세,2016,11036,5771,5265,109.6,10895,5704,5191,109.9
37030, 김천시,055001, 50세,2016,2163,1141,1022,111.6,2131,1125,1006,111.8
37030, 김천시,055002, 51세,2016,2085,1083,1002,108.1,2045,1065,980,108.7
37030, 김천시,055003, 52세,2016,2084,1128,956,118,2048,1109,939,118.1
37030, 김천시,055004, 53세,2016,2314,1227,1087,112.9,2299,1217,1082,112.5
37030, 김천시,055005, 54세,2016,2390,1192,1198,99.5,2372,1188,1184,100.3
37030, 김천시,060,55~59세,2016,12008,6095,5913,103.1,11903,6036,5867,102.9
37030, 김천시,060001, 55세,2016,2688,1401,1287,108.9,2663,1390,1273,109.2
37030, 김천시,060002, 56세,2016,2575,1285,1290,99.6,2552,1269,1283,98.9
37030, 김천시,060003, 57세,2016,2319,1171,1148,102,2295,1157,1138,101.7
37030, 김천시,060004, 58세,2016,2191,1118,1073,104.2,2169,1106,1063,104
37030, 김천시,060005, 59세,2016,2235,1120,1115,100.4,2224,1114,1110,100.4
37030, 김천시,065,60~64세,2016,10109,4836,5273,91.7,10049,4814,5235,92
37030, 김천시,065001, 60세,2016,2189,1070,1119,95.6,2170,1066,1104,96.6
37030, 김천시,065002, 61세,2016,2089,994,1095,90.8,2081,989,1092,90.6
37030, 김천시,065003, 62세,2016,1949,925,1024,90.3,1941,922,1019,90.5
37030, 김천시,065004, 63세,2016,1858,878,980,89.6,1846,875,971,90.1
37030, 김천시,065005, 64세,2016,2024,969,1055,91.8,2011,962,1049,91.7
37030, 김천시,070,65~69세,2016,7761,3704,4057,91.3,7733,3688,4045,91.2
37030, 김천시,070001, 65세,2016,1411,655,756,86.6,1405,651,754,86.3
37030, 김천시,070002, 66세,2016,1540,756,784,96.4,1534,753,781,96.4
37030, 김천시,070003, 67세,2016,1677,795,882,90.1,1674,793,881,90
37030, 김천시,070004, 68세,2016,1605,777,828,93.8,1598,775,823,94.2
37030, 김천시,070005, 69세,2016,1528,721,807,89.3,1522,716,806,88.8
37030, 김천시,075,70~74세,2016,6222,2650,3572,74.2,6212,2643,3569,74.1
37030, 김천시,075001, 70세,2016,1028,468,560,83.6,1023,466,557,83.7
37030, 김천시,075002, 71세,2016,1027,475,552,86.1,1025,473,552,85.7
37030, 김천시,075003, 72세,2016,1259,540,719,75.1,1259,540,719,75.1
37030, 김천시,075004, 73세,2016,1417,577,840,68.7,1414,574,840,68.3
37030, 김천시,075005, 74세,2016,1491,590,901,65.5,1491,590,901,65.5
37030, 김천시,080,75~79세,2016,6445,2439,4006,60.9,6438,2436,4002,60.9
37030, 김천시,080001, 75세,2016,1339,513,826,62.1,1334,510,824,61.9
37030, 김천시,080002, 76세,2016,1353,525,828,63.4,1353,525,828,63.4
37030, 김천시,080003, 77세,2016,1361,508,853,59.6,1361,508,853,59.6
37030, 김천시,080004, 78세,2016,1235,468,767,61,1233,468,765,61.2
37030, 김천시,080005, 79세,2016,1157,425,732,58.1,1157,425,732,58.1
37030, 김천시,085,80~84세,2016,4414,1518,2896,52.4,4413,1517,2896,52.4
37030, 김천시,085001, 80세,2016,1114,406,708,57.3,1114,406,708,57.3
37030, 김천시,085002, 81세,2016,1066,386,680,56.8,1066,386,680,56.8
37030, 김천시,085003, 82세,2016,852,286,566,50.5,852,286,566,50.5
37030, 김천시,085004, 83세,2016,735,237,498,47.6,734,236,498,47.4
37030, 김천시,085005, 84세,2016,647,203,444,45.7,647,203,444,45.7
37030, 김천시,090,85~89세,2016,2072,592,1480,40,2065,589,1476,39.9
37030, 김천시,090001, 85세,2016,536,176,360,48.9,533,174,359,48.5
37030, 김천시,090002, 86세,2016,503,143,360,39.7,503,143,360,39.7
37030, 김천시,090003, 87세,2016,390,113,277,40.8,389,112,277,40.4
37030, 김천시,090004, 88세,2016,355,89,266,33.5,353,89,264,33.7
37030, 김천시,090005, 89세,2016,288,71,217,32.7,287,71,216,32.9
37030, 김천시,095,90~94세,2016,600,137,463,29.6,599,137,462,29.7
37030, 김천시,095001, 90세,2016,171,48,123,39,171,48,123,39
37030, 김천시,095002, 91세,2016,145,35,110,31.8,145,35,110,31.8
37030, 김천시,095003, 92세,2016,91,22,69,31.9,91,22,69,31.9
37030, 김천시,095004, 93세,2016,103,18,85,21.2,103,18,85,21.2
37030, 김천시,095005, 94세,2016,90,14,76,18.4,89,14,75,18.7
37030, 김천시,100,95~99세,2016,142,17,125,13.6,142,17,125,13.6
37030, 김천시,100001, 95세,2016,59,11,48,22.9,59,11,48,22.9
37030, 김천시,100002, 96세,2016,41,X,38,7.9,41,X,38,7.9
37030, 김천시,100003, 97세,2016,19,X,18,5.6,19,X,18,5.6
37030, 김천시,100004, 98세,2016,13,X,12,8.3,13,X,12,8.3
37030, 김천시,100005, 99세,2016,10,X,9,11.1,10,X,9,11.1
37030, 김천시,101,100세이상,2016,16,X,13,23.1,16,X,13,23.1
37030, 김천시,102,15세미만,2016,16745,8716,8029,108.6,16709,8698,8011,108.6
37030, 김천시,103,15~64세,2016,95292,50020,45272,110.5,93044,48692,44352,109.8
37030, 김천시,104,65세이상,2016,27672,11060,16612,66.6,27618,11030,16588,66.5
37030, 김천시,086,85세이상,2016,2830,749,2081,36,2822,746,2076,35.9
37030, 김천시,126,평균연령,2016,44.3,42.2,46.3,,44.4,42.4,46.5,
37030, 김천시,127,중위연령,2016,45.9,43.6,48.2,,46.2,44,48.5,
37040, 안동시,000,합계,2016,167664,82775,84889,97.5,166150,82088,84062,97.7
37040, 안동시,005,0~4세,2016,6869,3591,3278,109.5,6857,3583,3274,109.4
37040, 안동시,005001, 0세,2016,1326,707,619,114.2,1323,705,618,114.1
37040, 안동시,005002, 1세,2016,1474,765,709,107.9,1469,762,707,107.8
37040, 안동시,005003, 2세,2016,1230,619,611,101.3,1228,617,611,101
37040, 안동시,005004, 3세,2016,1378,725,653,111,1377,724,653,110.9
37040, 안동시,005005, 4세,2016,1461,775,686,113,1460,775,685,113.1
37040, 안동시,010,5~9세,2016,6675,3459,3216,107.6,6668,3455,3213,107.5
37040, 안동시,010001, 5세,2016,1349,715,634,112.8,1348,715,633,113
37040, 안동시,010002, 6세,2016,1334,697,637,109.4,1332,695,637,109.1
37040, 안동시,010003, 7세,2016,1262,637,625,101.9,1260,637,623,102.2
37040, 안동시,010004, 8세,2016,1367,700,667,104.9,1367,700,667,104.9
37040, 안동시,010005, 9세,2016,1363,710,653,108.7,1361,708,653,108.4
37040, 안동시,015,10~14세,2016,7033,3684,3349,110,7027,3683,3344,110.1
37040, 안동시,015001, 10세,2016,1307,696,611,113.9,1306,696,610,114.1
37040, 안동시,015002, 11세,2016,1276,665,611,108.8,1275,665,610,109
37040, 안동시,015003, 12세,2016,1422,747,675,110.7,1420,747,673,111
37040, 안동시,015004, 13세,2016,1443,742,701,105.8,1442,741,701,105.7
37040, 안동시,015005, 14세,2016,1585,834,751,111.1,1584,834,750,111.2
37040, 안동시,020,15~19세,2016,10770,5495,5275,104.2,10749,5486,5263,104.2
37040, 안동시,020001, 15세,2016,1771,915,856,106.9,1770,914,856,106.8
37040, 안동시,020002, 16세,2016,1973,997,976,102.2,1969,995,974,102.2
37040, 안동시,020003, 17세,2016,1926,1032,894,115.4,1925,1032,893,115.6
37040, 안동시,020004, 18세,2016,2250,1148,1102,104.2,2245,1147,1098,104.5
37040, 안동시,020005, 19세,2016,2850,1403,1447,97,2840,1398,1442,96.9
37040, 안동시,025,20~24세,2016,11523,6240,5283,118.1,11330,6154,5176,118.9
37040, 안동시,025001, 20세,2016,2502,1157,1345,86,2487,1152,1335,86.3
37040, 안동시,025002, 21세,2016,2480,1208,1272,95,2439,1187,1252,94.8
37040, 안동시,025003, 22세,2016,2402,1367,1035,132.1,2360,1347,1013,133
37040, 안동시,025004, 23세,2016,2182,1315,867,151.7,2139,1300,839,154.9
37040, 안동시,025005, 24세,2016,1957,1193,764,156.2,1905,1168,737,158.5
37040, 안동시,030,25~29세,2016,7804,4304,3500,123,7498,4177,3321,125.8
37040, 안동시,030001, 25세,2016,1703,1014,689,147.2,1647,986,661,149.2
37040, 안동시,030002, 26세,2016,1540,874,666,131.2,1482,849,633,134.1
37040, 안동시,030003, 27세,2016,1508,827,681,121.4,1443,799,644,124.1
37040, 안동시,030004, 28세,2016,1519,816,703,116.1,1451,788,663,118.9
37040, 안동시,030005, 29세,2016,1534,773,761,101.6,1475,755,720,104.9
37040, 안동시,035,30~34세,2016,8641,4303,4338,99.2,8420,4202,4218,99.6
37040, 안동시,035001, 30세,2016,1541,799,742,107.7,1484,771,713,108.1
37040, 안동시,035002, 31세,2016,1510,780,730,106.8,1452,754,698,108
37040, 안동시,035003, 32세,2016,1649,848,801,105.9,1605,830,775,107.1
37040, 안동시,035004, 33세,2016,1849,889,960,92.6,1817,875,942,92.9
37040, 안동시,035005, 34세,2016,2092,987,1105,89.3,2062,972,1090,89.2
37040, 안동시,040,35~39세,2016,10466,5243,5223,100.4,10325,5176,5149,100.5
37040, 안동시,040001, 35세,2016,2046,963,1083,88.9,2014,950,1064,89.3
37040, 안동시,040002, 36세,2016,2265,1139,1126,101.2,2233,1129,1104,102.3
37040, 안동시,040003, 37세,2016,2012,1028,984,104.5,1982,1014,968,104.8
37040, 안동시,040004, 38세,2016,1996,1038,958,108.4,1974,1023,951,107.6
37040, 안동시,040005, 39세,2016,2147,1075,1072,100.3,2122,1060,1062,99.8
37040, 안동시,045,40~44세,2016,11820,6154,5666,108.6,11690,6088,5602,108.7
37040, 안동시,045001, 40세,2016,2115,1085,1030,105.3,2088,1073,1015,105.7
37040, 안동시,045002, 41세,2016,2388,1173,1215,96.5,2364,1162,1202,96.7
37040, 안동시,045003, 42세,2016,2422,1326,1096,121,2393,1310,1083,121
37040, 안동시,045004, 43세,2016,2507,1311,1196,109.6,2476,1291,1185,108.9
37040, 안동시,045005, 44세,2016,2388,1259,1129,111.5,2369,1252,1117,112.1
37040, 안동시,050,45~49세,2016,13234,6907,6327,109.2,13106,6851,6255,109.5
37040, 안동시,050001, 45세,2016,2628,1406,1222,115.1,2609,1396,1213,115.1
37040, 안동시,050002, 46세,2016,2671,1379,1292,106.7,2642,1367,1275,107.2
37040, 안동시,050003, 47세,2016,2687,1410,1277,110.4,2660,1398,1262,110.8
37040, 안동시,050004, 48세,2016,2773,1437,1336,107.6,2749,1423,1326,107.3
37040, 안동시,050005, 49세,2016,2475,1275,1200,106.3,2446,1267,1179,107.5
37040, 안동시,055,50~54세,2016,12652,6408,6244,102.6,12515,6349,6166,103
37040, 안동시,055001, 50세,2016,2526,1294,1232,105,2501,1286,1215,105.8
37040, 안동시,055002, 51세,2016,2453,1238,1215,101.9,2422,1226,1196,102.5
37040, 안동시,055003, 52세,2016,2425,1248,1177,106,2395,1235,1160,106.5
37040, 안동시,055004, 53세,2016,2569,1302,1267,102.8,2549,1294,1255,103.1
37040, 안동시,055005, 54세,2016,2679,1326,1353,98,2648,1308,1340,97.6
37040, 안동시,060,55~59세,2016,14650,7281,7369,98.8,14556,7235,7321,98.8
37040, 안동시,060001, 55세,2016,3255,1600,1655,96.7,3240,1592,1648,96.6
37040, 안동시,060002, 56세,2016,3326,1630,1696,96.1,3305,1621,1684,96.3
37040, 안동시,060003, 57세,2016,2699,1327,1372,96.7,2682,1317,1365,96.5
37040, 안동시,060004, 58세,2016,2660,1338,1322,101.2,2643,1328,1315,101
37040, 안동시,060005, 59세,2016,2710,1386,1324,104.7,2686,1377,1309,105.2
37040, 안동시,065,60~64세,2016,11976,5714,6262,91.2,11899,5679,6220,91.3
37040, 안동시,065001, 60세,2016,2605,1338,1267,105.6,2584,1326,1258,105.4
37040, 안동시,065002, 61세,2016,2444,1158,1286,90,2424,1150,1274,90.3
37040, 안동시,065003, 62세,2016,2270,1099,1171,93.9,2256,1091,1165,93.6
37040, 안동시,065004, 63세,2016,2280,1006,1274,79,2268,1003,1265,79.3
37040, 안동시,065005, 64세,2016,2377,1113,1264,88.1,2367,1109,1258,88.2
37040, 안동시,070,65~69세,2016,9358,4615,4743,97.3,9333,4600,4733,97.2
37040, 안동시,070001, 65세,2016,1814,854,960,89,1807,848,959,88.4
37040, 안동시,070002, 66세,2016,1765,892,873,102.2,1756,889,867,102.5
37040, 안동시,070003, 67세,2016,1986,1017,969,105,1981,1014,967,104.9
37040, 안동시,070004, 68세,2016,1958,968,990,97.8,1954,965,989,97.6
37040, 안동시,070005, 69세,2016,1835,884,951,93,1835,884,951,93
37040, 안동시,075,70~74세,2016,8188,3619,4569,79.2,8182,3615,4567,79.2
37040, 안동시,075001, 70세,2016,1229,584,645,90.5,1228,583,645,90.4
37040, 안동시,075002, 71세,2016,1322,594,728,81.6,1320,592,728,81.3
37040, 안동시,075003, 72세,2016,1628,673,955,70.5,1627,673,954,70.5
37040, 안동시,075004, 73세,2016,1889,823,1066,77.2,1888,823,1065,77.3
37040, 안동시,075005, 74세,2016,2120,945,1175,80.4,2119,944,1175,80.3
37040, 안동시,080,75~79세,2016,7518,3067,4451,68.9,7514,3066,4448,68.9
37040, 안동시,080001, 75세,2016,1627,689,938,73.5,1627,689,938,73.5
37040, 안동시,080002, 76세,2016,1578,650,928,70,1576,650,926,70.2
37040, 안동시,080003, 77세,2016,1673,685,988,69.3,1673,685,988,69.3
37040, 안동시,080004, 78세,2016,1410,550,860,64,1409,549,860,63.8
37040, 안동시,080005, 79세,2016,1230,493,737,66.9,1229,493,736,67
37040, 안동시,085,80~84세,2016,5140,1838,3302,55.7,5137,1838,3299,55.7
37040, 안동시,085001, 80세,2016,1207,478,729,65.6,1205,478,727,65.7
37040, 안동시,085002, 81세,2016,1245,475,770,61.7,1245,475,770,61.7
37040, 안동시,085003, 82세,2016,1029,357,672,53.1,1028,357,671,53.2
37040, 안동시,085004, 83세,2016,863,277,586,47.3,863,277,586,47.3
37040, 안동시,085005, 84세,2016,796,251,545,46.1,796,251,545,46.1
37040, 안동시,090,85~89세,2016,2368,624,1744,35.8,2366,623,1743,35.7
37040, 안동시,090001, 85세,2016,604,169,435,38.9,603,168,435,38.6
37040, 안동시,090002, 86세,2016,552,124,428,29,551,124,427,29
37040, 안동시,090003, 87세,2016,479,154,325,47.4,479,154,325,47.4
37040, 안동시,090004, 88세,2016,411,91,320,28.4,411,91,320,28.4
37040, 안동시,090005, 89세,2016,322,86,236,36.4,322,86,236,36.4
37040, 안동시,095,90~94세,2016,794,192,602,31.9,794,192,602,31.9
37040, 안동시,095001, 90세,2016,257,71,186,38.2,257,71,186,38.2
37040, 안동시,095002, 91세,2016,212,56,156,35.9,212,56,156,35.9
37040, 안동시,095003, 92세,2016,117,24,93,25.8,117,24,93,25.8
37040, 안동시,095004, 93세,2016,136,28,108,25.9,136,28,108,25.9
37040, 안동시,095005, 94세,2016,72,13,59,22,72,13,59,22
37040, 안동시,100,95~99세,2016,165,34,131,26,164,33,131,25.2
37040, 안동시,100001, 95세,2016,61,13,48,27.1,60,12,48,25
37040, 안동시,100002, 96세,2016,37,10,27,37,37,10,27,37
37040, 안동시,100003, 97세,2016,29,X,25,16,29,X,25,16
37040, 안동시,100004, 98세,2016,20,X,17,17.6,20,X,17,17.6
37040, 안동시,100005, 99세,2016,18,X,14,28.6,18,X,14,28.6
37040, 안동시,101,100세이상,2016,20,X,17,17.6,20,X,17,17.6
37040, 안동시,102,15세미만,2016,20577,10734,9843,109.1,20552,10721,9831,109.1
37040, 안동시,103,15~64세,2016,113536,58049,55487,104.6,112088,57397,54691,104.9
37040, 안동시,104,65세이상,2016,33551,13992,19559,71.5,33510,13970,19540,71.5
37040, 안동시,086,85세이상,2016,3347,853,2494,34.2,3344,851,2493,34.1
37040, 안동시,126,평균연령,2016,44.2,42.5,45.9,,44.2,42.5,46,
37040, 안동시,127,중위연령,2016,45.8,44.1,47.6,,46,44.2,47.8,
37050, 구미시,000,합계,2016,422237,217689,204548,106.4,415437,213661,201776,105.9
37050, 구미시,005,0~4세,2016,23809,12270,11539,106.3,23727,12238,11489,106.5
37050, 구미시,005001, 0세,2016,4365,2238,2127,105.2,4340,2225,2115,105.2
37050, 구미시,005002, 1세,2016,4826,2469,2357,104.8,4811,2465,2346,105.1
37050, 구미시,005003, 2세,2016,4677,2459,2218,110.9,4663,2454,2209,111.1
37050, 구미시,005004, 3세,2016,4770,2466,2304,107,4757,2459,2298,107
37050, 구미시,005005, 4세,2016,5171,2638,2533,104.1,5156,2635,2521,104.5
37050, 구미시,010,5~9세,2016,23334,12168,11166,109,23286,12143,11143,109
37050, 구미시,010001, 5세,2016,4991,2652,2339,113.4,4986,2648,2338,113.3
37050, 구미시,010002, 6세,2016,4588,2347,2241,104.7,4577,2343,2234,104.9
37050, 구미시,010003, 7세,2016,4371,2319,2052,113,4362,2314,2048,113
37050, 구미시,010004, 8세,2016,4658,2388,2270,105.2,4648,2382,2266,105.1
37050, 구미시,010005, 9세,2016,4726,2462,2264,108.7,4713,2456,2257,108.8
37050, 구미시,015,10~14세,2016,22308,11612,10696,108.6,22287,11605,10682,108.6
37050, 구미시,015001, 10세,2016,4206,2173,2033,106.9,4200,2173,2027,107.2
37050, 구미시,015002, 11세,2016,4211,2165,2046,105.8,4205,2163,2042,105.9
37050, 구미시,015003, 12세,2016,4459,2344,2115,110.8,4457,2342,2115,110.7
37050, 구미시,015004, 13세,2016,4729,2473,2256,109.6,4725,2471,2254,109.6
37050, 구미시,015005, 14세,2016,4703,2457,2246,109.4,4700,2456,2244,109.4
37050, 구미시,020,15~19세,2016,29839,16477,13362,123.3,29754,16430,13324,123.3
37050, 구미시,020001, 15세,2016,5515,2895,2620,110.5,5512,2894,2618,110.5
37050, 구미시,020002, 16세,2016,6170,3299,2871,114.9,6164,3298,2866,115.1
37050, 구미시,020003, 17세,2016,6058,3273,2785,117.5,6051,3266,2785,117.3
37050, 구미시,020004, 18세,2016,5988,3373,2615,129,5974,3366,2608,129.1
37050, 구미시,020005, 19세,2016,6108,3637,2471,147.2,6053,3606,2447,147.4
37050, 구미시,025,20~24세,2016,32284,18143,14141,128.3,31489,17645,13844,127.5
37050, 구미시,025001, 20세,2016,5869,3434,2435,141,5797,3397,2400,141.5
37050, 구미시,025002, 21세,2016,6441,3728,2713,137.4,6322,3649,2673,136.5
37050, 구미시,025003, 22세,2016,6716,3743,2973,125.9,6549,3640,2909,125.1
37050, 구미시,025004, 23세,2016,6545,3615,2930,123.4,6356,3495,2861,122.2
37050, 구미시,025005, 24세,2016,6713,3623,3090,117.2,6465,3464,3001,115.4
37050, 구미시,030,25~29세,2016,30745,16727,14018,119.3,29240,15802,13438,117.6
37050, 구미시,030001, 25세,2016,6032,3273,2759,118.6,5785,3132,2653,118.1
37050, 구미시,030002, 26세,2016,6040,3308,2732,121.1,5715,3105,2610,119
37050, 구미시,030003, 27세,2016,5841,3259,2582,126.2,5549,3085,2464,125.2
37050, 구미시,030004, 28세,2016,6223,3419,2804,121.9,5889,3212,2677,120
37050, 구미시,030005, 29세,2016,6609,3468,3141,110.4,6302,3268,3034,107.7
37050, 구미시,035,30~34세,2016,36321,19265,17056,113,34964,18413,16551,111.3
37050, 구미시,035001, 30세,2016,6736,3625,3111,116.5,6453,3444,3009,114.5
37050, 구미시,035002, 31세,2016,6794,3650,3144,116.1,6493,3471,3022,114.9
37050, 구미시,035003, 32세,2016,6806,3538,3268,108.3,6543,3368,3175,106.1
37050, 구미시,035004, 33세,2016,7675,4057,3618,112.1,7422,3896,3526,110.5
37050, 구미시,035005, 34세,2016,8310,4395,3915,112.3,8053,4234,3819,110.9
37050, 구미시,040,35~39세,2016,38572,20036,18536,108.1,37653,19467,18186,107
37050, 구미시,040001, 35세,2016,8143,4253,3890,109.3,7925,4123,3802,108.4
37050, 구미시,040002, 36세,2016,8520,4467,4053,110.2,8303,4328,3975,108.9
37050, 구미시,040003, 37세,2016,7669,3997,3672,108.9,7505,3894,3611,107.8
37050, 구미시,040004, 38세,2016,6969,3625,3344,108.4,6806,3527,3279,107.6
37050, 구미시,040005, 39세,2016,7271,3694,3577,103.3,7114,3595,3519,102.2
37050, 구미시,045,40~44세,2016,37124,18335,18789,97.6,36511,17979,18532,97
37050, 구미시,045001, 40세,2016,7064,3509,3555,98.7,6943,3443,3500,98.4
37050, 구미시,045002, 41세,2016,7184,3478,3706,93.8,7069,3412,3657,93.3
37050, 구미시,045003, 42세,2016,7602,3742,3860,96.9,7459,3655,3804,96.1
37050, 구미시,045004, 43세,2016,7651,3735,3916,95.4,7534,3663,3871,94.6
37050, 구미시,045005, 44세,2016,7623,3871,3752,103.2,7506,3806,3700,102.9
37050, 구미시,050,45~49세,2016,38879,19379,19500,99.4,38389,19109,19280,99.1
37050, 구미시,050001, 45세,2016,7889,4134,3755,110.1,7786,4071,3715,109.6
37050, 구미시,050002, 46세,2016,7989,3990,3999,99.8,7880,3925,3955,99.2
37050, 구미시,050003, 47세,2016,8021,3998,4023,99.4,7912,3946,3966,99.5
37050, 구미시,050004, 48세,2016,7876,3854,4022,95.8,7788,3804,3984,95.5
37050, 구미시,050005, 49세,2016,7104,3403,3701,91.9,7023,3363,3660,91.9
37050, 구미시,055,50~54세,2016,33219,17486,15733,111.1,32861,17288,15573,111
37050, 구미시,055001, 50세,2016,6836,3563,3273,108.9,6759,3519,3240,108.6
37050, 구미시,055002, 51세,2016,6936,3597,3339,107.7,6860,3559,3301,107.8
37050, 구미시,055003, 52세,2016,6424,3435,2989,114.9,6355,3397,2958,114.8
37050, 구미시,055004, 53세,2016,6522,3458,3064,112.9,6447,3415,3032,112.6
37050, 구미시,055005, 54세,2016,6501,3433,3068,111.9,6440,3398,3042,111.7
37050, 구미시,060,55~59세,2016,27724,14525,13199,110,27487,14408,13079,110.2
37050, 구미시,060001, 55세,2016,6763,3554,3209,110.8,6717,3526,3191,110.5
37050, 구미시,060002, 56세,2016,6506,3405,3101,109.8,6454,3384,3070,110.2
37050, 구미시,060003, 57세,2016,5347,2787,2560,108.9,5306,2769,2537,109.1
37050, 구미시,060004, 58세,2016,4635,2447,2188,111.8,4575,2411,2164,111.4
37050, 구미시,060005, 59세,2016,4473,2332,2141,108.9,4435,2318,2117,109.5
37050, 구미시,065,60~64세,2016,16930,8745,8185,106.8,16761,8661,8100,106.9
37050, 구미시,065001, 60세,2016,4053,2195,1858,118.1,4008,2172,1836,118.3
37050, 구미시,065002, 61세,2016,3657,1879,1778,105.7,3624,1864,1760,105.9
37050, 구미시,065003, 62세,2016,3227,1661,1566,106.1,3190,1640,1550,105.8
37050, 구미시,065004, 63세,2016,2970,1507,1463,103,2943,1494,1449,103.1
37050, 구미시,065005, 64세,2016,3023,1503,1520,98.9,2996,1491,1505,99.1
37050, 구미시,070,65~69세,2016,10262,5028,5234,96.1,10204,5007,5197,96.3
37050, 구미시,070001, 65세,2016,2064,994,1070,92.9,2052,990,1062,93.2
37050, 구미시,070002, 66세,2016,2110,1051,1059,99.2,2097,1046,1051,99.5
37050, 구미시,070003, 67세,2016,2152,1100,1052,104.6,2139,1095,1044,104.9
37050, 구미시,070004, 68세,2016,2038,951,1087,87.5,2026,945,1081,87.4
37050, 구미시,070005, 69세,2016,1898,932,966,96.5,1890,931,959,97.1
37050, 구미시,075,70~74세,2016,7383,3144,4239,74.2,7352,3129,4223,74.1
37050, 구미시,075001, 70세,2016,1218,587,631,93,1210,583,627,93
37050, 구미시,075002, 71세,2016,1247,533,714,74.6,1238,528,710,74.4
37050, 구미시,075003, 72세,2016,1468,615,853,72.1,1462,614,848,72.4
37050, 구미시,075004, 73세,2016,1640,660,980,67.3,1636,657,979,67.1
37050, 구미시,075005, 74세,2016,1810,749,1061,70.6,1806,747,1059,70.5
37050, 구미시,080,75~79세,2016,6384,2325,4059,57.3,6364,2314,4050,57.1
37050, 구미시,080001, 75세,2016,1378,508,870,58.4,1375,507,868,58.4
37050, 구미시,080002, 76세,2016,1289,519,770,67.4,1285,516,769,67.1
37050, 구미시,080003, 77세,2016,1395,492,903,54.5,1389,489,900,54.3
37050, 구미시,080004, 78세,2016,1218,432,786,55,1215,431,784,55
37050, 구미시,080005, 79세,2016,1104,374,730,51.2,1100,371,729,50.9
37050, 구미시,085,80~84세,2016,4309,1376,2933,46.9,4304,1375,2929,46.9
37050, 구미시,085001, 80세,2016,1022,358,664,53.9,1021,358,663,54
37050, 구미시,085002, 81세,2016,1072,342,730,46.8,1070,342,728,47
37050, 구미시,085003, 82세,2016,868,279,589,47.4,867,279,588,47.4
37050, 구미시,085004, 83세,2016,687,205,482,42.5,687,205,482,42.5
37050, 구미시,085005, 84세,2016,660,192,468,41,659,191,468,40.8
37050, 구미시,090,85~89세,2016,1996,492,1504,32.7,1993,492,1501,32.8
37050, 구미시,090001, 85세,2016,540,155,385,40.3,539,155,384,40.4
37050, 구미시,090002, 86세,2016,450,110,340,32.4,450,110,340,32.4
37050, 구미시,090003, 87세,2016,379,79,300,26.3,378,79,299,26.4
37050, 구미시,090004, 88세,2016,340,78,262,29.8,340,78,262,29.8
37050, 구미시,090005, 89세,2016,287,70,217,32.3,286,70,216,32.4
37050, 구미시,095,90~94세,2016,650,130,520,25,648,130,518,25.1
37050, 구미시,095001, 90세,2016,203,48,155,31,202,48,154,31.2
37050, 구미시,095002, 91세,2016,143,34,109,31.2,143,34,109,31.2
37050, 구미시,095003, 92세,2016,108,18,90,20,108,18,90,20
37050, 구미시,095004, 93세,2016,96,18,78,23.1,95,18,77,23.4
37050, 구미시,095005, 94세,2016,100,12,88,13.6,100,12,88,13.6
37050, 구미시,100,95~99세,2016,146,25,121,20.7,144,25,119,21
37050, 구미시,100001, 95세,2016,48,8,40,20,47,8,39,20.5
37050, 구미시,100002, 96세,2016,46,10,36,27.8,46,10,36,27.8
37050, 구미시,100003, 97세,2016,31,X,27,14.8,30,X,26,15.4
37050, 구미시,100004, 98세,2016,14,X,12,16.7,14,X,12,16.7
37050, 구미시,100005, 99세,2016,7,X,6,16.7,7,X,6,16.7
37050, 구미시,101,100세이상,2016,19,X,18,5.6,19,X,18,5.6
37050, 구미시,102,15세미만,2016,69451,36050,33401,107.9,69300,35986,33314,108
37050, 구미시,103,15~64세,2016,321637,169118,152519,110.9,315109,165202,149907,110.2
37050, 구미시,104,65세이상,2016,31149,12521,18628,67.2,31028,12473,18555,67.2
37050, 구미시,086,85세이상,2016,2811,648,2163,30,2804,648,2156,30.1
37050, 구미시,126,평균연령,2016,36.4,35.4,37.5,,36.4,35.5,37.5,
37050, 구미시,127,중위연령,2016,36.5,35.5,37.6,,36.6,35.6,37.7,
37060, 영주시,000,합계,2016,108950,54801,54149,101.2,107839,54238,53601,101.2
37060, 영주시,005,0~4세,2016,3506,1833,1673,109.6,3504,1831,1673,109.4
37060, 영주시,005001, 0세,2016,637,327,310,105.5,636,326,310,105.2
37060, 영주시,005002, 1세,2016,663,349,314,111.1,663,349,314,111.1
37060, 영주시,005003, 2세,2016,691,380,311,122.2,690,379,311,121.9
37060, 영주시,005004, 3세,2016,683,347,336,103.3,683,347,336,103.3
37060, 영주시,005005, 4세,2016,832,430,402,107,832,430,402,107
37060, 영주시,010,5~9세,2016,4065,2032,2033,100,4056,2027,2029,99.9
37060, 영주시,010001, 5세,2016,780,393,387,101.6,776,391,385,101.6
37060, 영주시,010002, 6세,2016,821,422,399,105.8,820,421,399,105.5
37060, 영주시,010003, 7세,2016,789,402,387,103.9,787,402,385,104.4
37060, 영주시,010004, 8세,2016,846,404,442,91.4,845,403,442,91.2
37060, 영주시,010005, 9세,2016,829,411,418,98.3,828,410,418,98.1
37060, 영주시,015,10~14세,2016,4504,2403,2101,114.4,4501,2401,2100,114.3
37060, 영주시,015001, 10세,2016,833,462,371,124.5,832,461,371,124.3
37060, 영주시,015002, 11세,2016,844,462,382,120.9,844,462,382,120.9
37060, 영주시,015003, 12세,2016,923,499,424,117.7,922,498,424,117.5
37060, 영주시,015004, 13세,2016,921,456,465,98.1,921,456,465,98.1
37060, 영주시,015005, 14세,2016,983,524,459,114.2,982,524,458,114.4
37060, 영주시,020,15~19세,2016,7322,4182,3140,133.2,7255,4141,3114,133
37060, 영주시,020001, 15세,2016,1249,691,558,123.8,1247,691,556,124.3
37060, 영주시,020002, 16세,2016,1541,916,625,146.6,1540,915,625,146.4
37060, 영주시,020003, 17세,2016,1265,710,555,127.9,1261,707,554,127.6
37060, 영주시,020004, 18세,2016,1516,849,667,127.3,1495,838,657,127.5
37060, 영주시,020005, 19세,2016,1751,1016,735,138.2,1712,990,722,137.1
37060, 영주시,025,20~24세,2016,7220,4460,2760,161.6,7006,4351,2655,163.9
37060, 영주시,025001, 20세,2016,1614,912,702,129.9,1559,881,678,129.9
37060, 영주시,025002, 21세,2016,1509,855,654,130.7,1457,828,629,131.6
37060, 영주시,025003, 22세,2016,1491,962,529,181.9,1455,942,513,183.6
37060, 영주시,025004, 23세,2016,1332,875,457,191.5,1293,858,435,197.2
37060, 영주시,025005, 24세,2016,1274,856,418,204.8,1242,842,400,210.5
37060, 영주시,030,25~29세,2016,4341,2513,1828,137.5,4133,2417,1716,140.9
37060, 영주시,030001, 25세,2016,989,609,380,160.3,944,587,357,164.4
37060, 영주시,030002, 26세,2016,908,535,373,143.4,864,515,349,147.6
37060, 영주시,030003, 27세,2016,797,461,336,137.2,768,447,321,139.3
37060, 영주시,030004, 28세,2016,826,467,359,130.1,782,450,332,135.5
37060, 영주시,030005, 29세,2016,821,441,380,116.1,775,418,357,117.1
37060, 영주시,035,30~34세,2016,4700,2495,2205,113.2,4550,2421,2129,113.7
37060, 영주시,035001, 30세,2016,826,444,382,116.2,785,428,357,119.9
37060, 영주시,035002, 31세,2016,857,482,375,128.5,819,463,356,130.1
37060, 영주시,035003, 32세,2016,839,435,404,107.7,818,426,392,108.7
37060, 영주시,035004, 33세,2016,1038,534,504,106,1015,521,494,105.5
37060, 영주시,035005, 34세,2016,1140,600,540,111.1,1113,583,530,110
37060, 영주시,040,35~39세,2016,5964,3098,2866,108.1,5870,3043,2827,107.6
37060, 영주시,040001, 35세,2016,1160,597,563,106,1134,581,553,105.1
37060, 영주시,040002, 36세,2016,1212,613,599,102.3,1188,597,591,101
37060, 영주시,040003, 37세,2016,1212,651,561,116,1196,642,554,115.9
37060, 영주시,040004, 38세,2016,1147,593,554,107,1139,590,549,107.5
37060, 영주시,040005, 39세,2016,1233,644,589,109.3,1213,633,580,109.1
37060, 영주시,045,40~44세,2016,7209,3710,3499,106,7146,3678,3468,106.1
37060, 영주시,045001, 40세,2016,1289,648,641,101.1,1274,640,634,100.9
37060, 영주시,045002, 41세,2016,1400,699,701,99.7,1388,692,696,99.4
37060, 영주시,045003, 42세,2016,1435,724,711,101.8,1423,718,705,101.8
37060, 영주시,045004, 43세,2016,1579,822,757,108.6,1561,813,748,108.7
37060, 영주시,045005, 44세,2016,1506,817,689,118.6,1500,815,685,119
37060, 영주시,050,45~49세,2016,8455,4408,4047,108.9,8389,4382,4007,109.4
37060, 영주시,050001, 45세,2016,1596,857,739,116,1584,854,730,117
37060, 영주시,050002, 46세,2016,1662,868,794,109.3,1646,862,784,109.9
37060, 영주시,050003, 47세,2016,1761,945,816,115.8,1745,940,805,116.8
37060, 영주시,050004, 48세,2016,1835,966,869,111.2,1819,958,861,111.3
37060, 영주시,050005, 49세,2016,1601,772,829,93.1,1595,768,827,92.9
37060, 영주시,055,50~54세,2016,8524,4369,4155,105.2,8449,4335,4114,105.4
37060, 영주시,055001, 50세,2016,1672,879,793,110.8,1656,872,784,111.2
37060, 영주시,055002, 51세,2016,1637,826,811,101.8,1624,818,806,101.5
37060, 영주시,055003, 52세,2016,1614,825,789,104.6,1593,819,774,105.8
37060, 영주시,055004, 53세,2016,1695,858,837,102.5,1682,851,831,102.4
37060, 영주시,055005, 54세,2016,1906,981,925,106.1,1894,975,919,106.1
37060, 영주시,060,55~59세,2016,10121,5012,5109,98.1,10051,4980,5071,98.2
37060, 영주시,060001, 55세,2016,2211,1115,1096,101.7,2195,1108,1087,101.9
37060, 영주시,060002, 56세,2016,2254,1114,1140,97.7,2242,1109,1133,97.9
37060, 영주시,060003, 57세,2016,1862,919,943,97.5,1848,914,934,97.9
37060, 영주시,060004, 58세,2016,1815,886,929,95.4,1807,880,927,94.9
37060, 영주시,060005, 59세,2016,1979,978,1001,97.7,1959,969,990,97.9
37060, 영주시,065,60~64세,2016,8805,4182,4623,90.5,8749,4151,4598,90.3
37060, 영주시,065001, 60세,2016,1820,875,945,92.6,1805,866,939,92.2
37060, 영주시,065002, 61세,2016,1806,878,928,94.6,1797,872,925,94.3
37060, 영주시,065003, 62세,2016,1784,859,925,92.9,1767,851,916,92.9
37060, 영주시,065004, 63세,2016,1648,774,874,88.6,1641,770,871,88.4
37060, 영주시,065005, 64세,2016,1747,796,951,83.7,1739,792,947,83.6
37060, 영주시,070,65~69세,2016,6815,3362,3453,97.4,6792,3343,3449,96.9
37060, 영주시,070001, 65세,2016,1255,598,657,91,1250,594,656,90.5
37060, 영주시,070002, 66세,2016,1373,692,681,101.6,1367,688,679,101.3
37060, 영주시,070003, 67세,2016,1442,718,724,99.2,1436,712,724,98.3
37060, 영주시,070004, 68세,2016,1455,715,740,96.6,1452,713,739,96.5
37060, 영주시,070005, 69세,2016,1290,639,651,98.2,1287,636,651,97.7
37060, 영주시,075,70~74세,2016,5771,2545,3226,78.9,5768,2543,3225,78.9
37060, 영주시,075001, 70세,2016,796,367,429,85.5,796,367,429,85.5
37060, 영주시,075002, 71세,2016,959,433,526,82.3,958,432,526,82.1
37060, 영주시,075003, 72세,2016,1241,532,709,75,1241,532,709,75
37060, 영주시,075004, 73세,2016,1301,580,721,80.4,1299,579,720,80.4
37060, 영주시,075005, 74세,2016,1474,633,841,75.3,1474,633,841,75.3
37060, 영주시,080,75~79세,2016,5584,2302,3282,70.1,5581,2300,3281,70.1
37060, 영주시,080001, 75세,2016,1195,505,690,73.2,1194,505,689,73.3
37060, 영주시,080002, 76세,2016,1121,456,665,68.6,1120,455,665,68.4
37060, 영주시,080003, 77세,2016,1279,547,732,74.7,1279,547,732,74.7
37060, 영주시,080004, 78세,2016,1087,435,652,66.7,1086,434,652,66.6
37060, 영주시,080005, 79세,2016,902,359,543,66.1,902,359,543,66.1
37060, 영주시,085,80~84세,2016,3600,1273,2327,54.7,3596,1273,2323,54.8
37060, 영주시,085001, 80세,2016,898,362,536,67.5,898,362,536,67.5
37060, 영주시,085002, 81세,2016,845,309,536,57.6,844,309,535,57.8
37060, 영주시,085003, 82세,2016,732,261,471,55.4,730,261,469,55.7
37060, 영주시,085004, 83세,2016,584,182,402,45.3,584,182,402,45.3
37060, 영주시,085005, 84세,2016,541,159,382,41.6,540,159,381,41.7
37060, 영주시,090,85~89세,2016,1682,459,1223,37.5,1681,458,1223,37.4
37060, 영주시,090001, 85세,2016,444,130,314,41.4,444,130,314,41.4
37060, 영주시,090002, 86세,2016,385,116,269,43.1,384,115,269,42.8
37060, 영주시,090003, 87세,2016,345,84,261,32.2,345,84,261,32.2
37060, 영주시,090004, 88세,2016,294,66,228,28.9,294,66,228,28.9
37060, 영주시,090005, 89세,2016,214,63,151,41.7,214,63,151,41.7
37060, 영주시,095,90~94세,2016,586,131,455,28.8,586,131,455,28.8
37060, 영주시,095001, 90세,2016,167,41,126,32.5,167,41,126,32.5
37060, 영주시,095002, 91세,2016,150,33,117,28.2,150,33,117,28.2
37060, 영주시,095003, 92세,2016,121,21,100,21,121,21,100,21
37060, 영주시,095004, 93세,2016,79,17,62,27.4,79,17,62,27.4
37060, 영주시,095005, 94세,2016,69,19,50,38,69,19,50,38
37060, 영주시,100,95~99세,2016,159,29,130,22.3,159,29,130,22.3
37060, 영주시,100001, 95세,2016,42,9,33,27.3,42,9,33,27.3
37060, 영주시,100002, 96세,2016,51,11,40,27.5,51,11,40,27.5
37060, 영주시,100003, 97세,2016,28,X,24,16.7,28,X,24,16.7
37060, 영주시,100004, 98세,2016,25,5,20,25,25,5,20,25
37060, 영주시,100005, 99세,2016,13,X,13,0,13,X,13,0
37060, 영주시,101,100세이상,2016,17,X,14,21.4,17,X,14,21.4
37060, 영주시,102,15세미만,2016,12075,6268,5807,107.9,12061,6259,5802,107.9
37060, 영주시,103,15~64세,2016,72661,38429,34232,112.3,71598,37899,33699,112.5
37060, 영주시,104,65세이상,2016,24214,10104,14110,71.6,24180,10080,14100,71.5
37060, 영주시,086,85세이상,2016,2444,622,1822,34.1,2443,621,1822,34.1
37060, 영주시,126,평균연령,2016,45.9,43.5,48.2,,46,43.6,48.3,
37060, 영주시,127,중위연령,2016,48.3,45.8,51.2,,48.5,45.9,51.4,
37070, 영천시,000,합계,2016,97295,49542,47753,103.7,93645,46772,46873,99.8
37070, 영천시,005,0~4세,2016,3130,1591,1539,103.4,3111,1587,1524,104.1
37070, 영천시,005001, 0세,2016,606,304,302,100.7,598,303,295,102.7
37070, 영천시,005002, 1세,2016,672,358,314,114,671,357,314,113.7
37070, 영천시,005003, 2세,2016,617,322,295,109.2,615,322,293,109.9
37070, 영천시,005004, 3세,2016,591,303,288,105.2,587,302,285,106
37070, 영천시,005005, 4세,2016,644,304,340,89.4,640,303,337,89.9
37070, 영천시,010,5~9세,2016,3070,1641,1429,114.8,3057,1634,1423,114.8
37070, 영천시,010001, 5세,2016,617,326,291,112,614,324,290,111.7
37070, 영천시,010002, 6세,2016,578,292,286,102.1,576,292,284,102.8
37070, 영천시,010003, 7세,2016,591,332,259,128.2,586,328,258,127.1
37070, 영천시,010004, 8세,2016,608,331,277,119.5,608,331,277,119.5
37070, 영천시,010005, 9세,2016,676,360,316,113.9,673,359,314,114.3
37070, 영천시,015,10~14세,2016,3063,1604,1459,109.9,3056,1603,1453,110.3
37070, 영천시,015001, 10세,2016,559,274,285,96.1,557,274,283,96.8
37070, 영천시,015002, 11세,2016,580,274,306,89.5,579,274,305,89.8
37070, 영천시,015003, 12세,2016,622,332,290,114.5,621,332,289,114.9
37070, 영천시,015004, 13세,2016,638,352,286,123.1,637,351,286,122.7
37070, 영천시,015005, 14세,2016,664,372,292,127.4,662,372,290,128.3
37070, 영천시,020,15~19세,2016,4206,2297,1909,120.3,4183,2290,1893,121
37070, 영천시,020001, 15세,2016,836,466,370,125.9,833,465,368,126.4
37070, 영천시,020002, 16세,2016,883,515,368,139.9,879,515,364,141.5
37070, 영천시,020003, 17세,2016,897,468,429,109.1,895,466,429,108.6
37070, 영천시,020004, 18세,2016,884,444,440,100.9,882,444,438,101.4
37070, 영천시,020005, 19세,2016,706,404,302,133.8,694,400,294,136.1
37070, 영천시,025,20~24세,2016,4871,2964,1907,155.4,4433,2624,1809,145.1
37070, 영천시,025001, 20세,2016,923,582,341,170.7,898,568,330,172.1
37070, 영천시,025002, 21세,2016,988,612,376,162.8,934,570,364,156.6
37070, 영천시,025003, 22세,2016,941,567,374,151.6,854,502,352,142.6
37070, 영천시,025004, 23세,2016,971,578,393,147.1,857,486,371,131
37070, 영천시,025005, 24세,2016,1048,625,423,147.8,890,498,392,127
37070, 영천시,030,25~29세,2016,5076,3099,1977,156.8,4153,2364,1789,132.1
37070, 영천시,030001, 25세,2016,1017,603,414,145.7,825,452,373,121.2
37070, 영천시,030002, 26세,2016,1029,680,349,194.8,840,523,317,165
37070, 영천시,030003, 27세,2016,1025,624,401,155.6,854,493,361,136.6
37070, 영천시,030004, 28세,2016,983,594,389,152.7,799,446,353,126.3
37070, 영천시,030005, 29세,2016,1022,598,424,141,835,450,385,116.9
37070, 영천시,035,30~34세,2016,5425,3199,2226,143.7,4646,2555,2091,122.2
37070, 영천시,035001, 30세,2016,1008,611,397,153.9,834,462,372,124.2
37070, 영천시,035002, 31세,2016,1003,593,410,144.6,837,453,384,118
37070, 영천시,035003, 32세,2016,1004,605,399,151.6,860,490,370,132.4
37070, 영천시,035004, 33세,2016,1166,648,518,125.1,1010,526,484,108.7
37070, 영천시,035005, 34세,2016,1244,742,502,147.8,1105,624,481,129.7
37070, 영천시,040,35~39세,2016,5598,3134,2464,127.2,5065,2697,2368,113.9
37070, 영천시,040001, 35세,2016,1262,696,566,123,1141,596,545,109.4
37070, 영천시,040002, 36세,2016,1218,699,519,134.7,1084,588,496,118.5
37070, 영천시,040003, 37세,2016,1127,631,496,127.2,1016,536,480,111.7
37070, 영천시,040004, 38세,2016,996,568,428,132.7,905,497,408,121.8
37070, 영천시,040005, 39세,2016,995,540,455,118.7,919,480,439,109.3
37070, 영천시,045,40~44세,2016,6339,3480,2859,121.7,6029,3238,2791,116
37070, 영천시,045001, 40세,2016,1120,651,469,138.8,1043,587,456,128.7
37070, 영천시,045002, 41세,2016,1231,700,531,131.8,1164,645,519,124.3
37070, 영천시,045003, 42세,2016,1318,719,599,120,1269,678,591,114.7
37070, 영천시,045004, 43세,2016,1279,672,607,110.7,1220,625,595,105
37070, 영천시,045005, 44세,2016,1391,738,653,113,1333,703,630,111.6
37070, 영천시,050,45~49세,2016,7480,4004,3476,115.2,7257,3855,3402,113.3
37070, 영천시,050001, 45세,2016,1482,790,692,114.2,1423,748,675,110.8
37070, 영천시,050002, 46세,2016,1400,748,652,114.7,1361,723,638,113.3
37070, 영천시,050003, 47세,2016,1494,772,722,106.9,1443,734,709,103.5
37070, 영천시,050004, 48세,2016,1614,874,740,118.1,1565,843,722,116.8
37070, 영천시,050005, 49세,2016,1490,820,670,122.4,1465,807,658,122.6
37070, 영천시,055,50~54세,2016,7942,4136,3806,108.7,7781,4048,3733,108.4
37070, 영천시,055001, 50세,2016,1572,844,728,115.9,1543,826,717,115.2
37070, 영천시,055002, 51세,2016,1449,731,718,101.8,1417,715,702,101.9
37070, 영천시,055003, 52세,2016,1611,853,758,112.5,1571,828,743,111.4
37070, 영천시,055004, 53세,2016,1589,827,762,108.5,1548,810,738,109.8
37070, 영천시,055005, 54세,2016,1721,881,840,104.9,1702,869,833,104.3
37070, 영천시,060,55~59세,2016,9025,4548,4477,101.6,8918,4490,4428,101.4
37070, 영천시,060001, 55세,2016,1897,977,920,106.2,1876,964,912,105.7
37070, 영천시,060002, 56세,2016,1843,878,965,91,1819,867,952,91.1
37070, 영천시,060003, 57세,2016,1930,973,957,101.7,1903,958,945,101.4
37070, 영천시,060004, 58세,2016,1654,833,821,101.5,1634,824,810,101.7
37070, 영천시,060005, 59세,2016,1701,887,814,109,1686,877,809,108.4
37070, 영천시,065,60~64세,2016,8030,3909,4121,94.9,7966,3873,4093,94.6
37070, 영천시,065001, 60세,2016,1758,889,869,102.3,1743,879,864,101.7
37070, 영천시,065002, 61세,2016,1702,846,856,98.8,1686,835,851,98.1
37070, 영천시,065003, 62세,2016,1474,725,749,96.8,1464,719,745,96.5
37070, 영천시,065004, 63세,2016,1521,707,814,86.9,1505,701,804,87.2
37070, 영천시,065005, 64세,2016,1575,742,833,89.1,1568,739,829,89.1
37070, 영천시,070,65~69세,2016,6982,3417,3565,95.8,6950,3399,3551,95.7
37070, 영천시,070001, 65세,2016,1404,687,717,95.8,1399,684,715,95.7
37070, 영천시,070002, 66세,2016,1414,690,724,95.3,1403,685,718,95.4
37070, 영천시,070003, 67세,2016,1457,714,743,96.1,1449,708,741,95.5
37070, 영천시,070004, 68세,2016,1446,719,727,98.9,1442,717,725,98.9
37070, 영천시,070005, 69세,2016,1261,607,654,92.8,1257,605,652,92.8
37070, 영천시,075,70~74세,2016,5861,2543,3318,76.6,5854,2540,3314,76.6
37070, 영천시,075001, 70세,2016,861,399,462,86.4,858,398,460,86.5
37070, 영천시,075002, 71세,2016,1005,442,563,78.5,1003,441,562,78.5
37070, 영천시,075003, 72세,2016,1147,491,656,74.8,1146,490,656,74.7
37070, 영천시,075004, 73세,2016,1287,530,757,70,1287,530,757,70
37070, 영천시,075005, 74세,2016,1561,681,880,77.4,1560,681,879,77.5
37070, 영천시,080,75~79세,2016,5488,2149,3339,64.4,5481,2149,3332,64.5
37070, 영천시,080001, 75세,2016,1193,472,721,65.5,1192,472,720,65.6
37070, 영천시,080002, 76세,2016,1121,451,670,67.3,1120,451,669,67.4
37070, 영천시,080003, 77세,2016,1182,476,706,67.4,1182,476,706,67.4
37070, 영천시,080004, 78세,2016,1012,376,636,59.1,1009,376,633,59.4
37070, 영천시,080005, 79세,2016,980,374,606,61.7,978,374,604,61.9
37070, 영천시,085,80~84세,2016,3781,1303,2478,52.6,3778,1303,2475,52.6
37070, 영천시,085001, 80세,2016,933,339,594,57.1,932,339,593,57.2
37070, 영천시,085002, 81세,2016,886,306,580,52.8,886,306,580,52.8
37070, 영천시,085003, 82세,2016,794,281,513,54.8,793,281,512,54.9
37070, 영천시,085004, 83세,2016,597,184,413,44.6,596,184,412,44.7
37070, 영천시,085005, 84세,2016,571,193,378,51.1,571,193,378,51.1
37070, 영천시,090,85~89세,2016,1463,413,1050,39.3,1462,412,1050,39.2
37070, 영천시,090001, 85세,2016,414,117,297,39.4,414,117,297,39.4
37070, 영천시,090002, 86세,2016,374,122,252,48.4,374,122,252,48.4
37070, 영천시,090003, 87세,2016,280,71,209,34,280,71,209,34
37070, 영천시,090004, 88세,2016,243,63,180,35,243,63,180,35
37070, 영천시,090005, 89세,2016,152,40,112,35.7,151,39,112,34.8
37070, 영천시,095,90~94세,2016,387,97,290,33.4,387,97,290,33.4
37070, 영천시,095001, 90세,2016,125,35,90,38.9,125,35,90,38.9
37070, 영천시,095002, 91세,2016,107,32,75,42.7,107,32,75,42.7
37070, 영천시,095003, 92세,2016,68,16,52,30.8,68,16,52,30.8
37070, 영천시,095004, 93세,2016,46,8,38,21.1,46,8,38,21.1
37070, 영천시,095005, 94세,2016,41,6,35,17.1,41,6,35,17.1
37070, 영천시,100,95~99세,2016,72,14,58,24.1,72,14,58,24.1
37070, 영천시,100001, 95세,2016,28,6,22,27.3,28,6,22,27.3
37070, 영천시,100002, 96세,2016,16,X,13,23.1,16,X,13,23.1
37070, 영천시,100003, 97세,2016,15,X,12,25,15,X,12,25
37070, 영천시,100004, 98세,2016,6,X,5,20,6,X,5,20
37070, 영천시,100005, 99세,2016,7,X,6,16.7,7,X,6,16.7
37070, 영천시,101,100세이상,2016,6,X,6,0,6,X,6,0
37070, 영천시,102,15세미만,2016,9263,4836,4427,109.2,9224,4824,4400,109.6
37070, 영천시,103,15~64세,2016,63992,34770,29222,119,60431,32034,28397,112.8
37070, 영천시,104,65세이상,2016,24040,9936,14104,70.4,23990,9914,14076,70.4
37070, 영천시,086,85세이상,2016,1928,524,1404,37.3,1927,523,1404,37.3
37070, 영천시,126,평균연령,2016,47.7,45.3,50.2,,48.2,46,50.5,
37070, 영천시,127,중위연령,2016,50.2,47.3,53.6,,51.2,48.7,54,
37080, 상주시,000,합계,2016,99484,49042,50442,97.2,98377,48497,49880,97.2
37080, 상주시,005,0~4세,2016,2791,1466,1325,110.6,2784,1460,1324,110.3
37080, 상주시,005001, 0세,2016,505,265,240,110.4,505,265,240,110.4
37080, 상주시,005002, 1세,2016,556,287,269,106.7,553,284,269,105.6
37080, 상주시,005003, 2세,2016,523,275,248,110.9,521,273,248,110.1
37080, 상주시,005004, 3세,2016,586,297,289,102.8,585,296,289,102.4
37080, 상주시,005005, 4세,2016,621,342,279,122.6,620,342,278,123
37080, 상주시,010,5~9세,2016,3353,1759,1594,110.4,3344,1753,1591,110.2
37080, 상주시,010001, 5세,2016,637,330,307,107.5,635,329,306,107.5
37080, 상주시,010002, 6세,2016,630,329,301,109.3,629,328,301,109
37080, 상주시,010003, 7세,2016,651,327,324,100.9,650,326,324,100.6
37080, 상주시,010004, 8세,2016,718,389,329,118.2,716,387,329,117.6
37080, 상주시,010005, 9세,2016,717,384,333,115.3,714,383,331,115.7
37080, 상주시,015,10~14세,2016,3585,1908,1677,113.8,3583,1908,1675,113.9
37080, 상주시,015001, 10세,2016,672,337,335,100.6,672,337,335,100.6
37080, 상주시,015002, 11세,2016,671,348,323,107.7,671,348,323,107.7
37080, 상주시,015003, 12세,2016,677,357,320,111.6,677,357,320,111.6
37080, 상주시,015004, 13세,2016,775,422,353,119.5,775,422,353,119.5
37080, 상주시,015005, 14세,2016,790,444,346,128.3,788,444,344,129.1
37080, 상주시,020,15~19세,2016,5470,3059,2411,126.9,5458,3052,2406,126.8
37080, 상주시,020001, 15세,2016,983,516,467,110.5,983,516,467,110.5
37080, 상주시,020002, 16세,2016,1200,665,535,124.3,1199,665,534,124.5
37080, 상주시,020003, 17세,2016,1103,589,514,114.6,1103,589,514,114.6
37080, 상주시,020004, 18세,2016,1082,605,477,126.8,1082,605,477,126.8
37080, 상주시,020005, 19세,2016,1102,684,418,163.6,1091,677,414,163.5
37080, 상주시,025,20~24세,2016,5569,3432,2137,160.6,5401,3329,2072,160.7
37080, 상주시,025001, 20세,2016,1210,694,516,134.5,1191,682,509,134
37080, 상주시,025002, 21세,2016,1110,684,426,160.6,1086,668,418,159.8
37080, 상주시,025003, 22세,2016,1147,724,423,171.2,1112,703,409,171.9
37080, 상주시,025004, 23세,2016,1074,683,391,174.7,1030,653,377,173.2
37080, 상주시,025005, 24세,2016,1028,647,381,169.8,982,623,359,173.5
37080, 상주시,030,25~29세,2016,4094,2333,1761,132.5,3873,2237,1636,136.7
37080, 상주시,030001, 25세,2016,958,560,398,140.7,913,535,378,141.5
37080, 상주시,030002, 26세,2016,805,465,340,136.8,757,443,314,141.1
37080, 상주시,030003, 27세,2016,765,445,320,139.1,721,423,298,141.9
37080, 상주시,030004, 28세,2016,796,427,369,115.7,762,413,349,118.3
37080, 상주시,030005, 29세,2016,770,436,334,130.5,720,423,297,142.4
37080, 상주시,035,30~34세,2016,4138,2241,1897,118.1,3956,2153,1803,119.4
37080, 상주시,035001, 30세,2016,819,454,365,124.4,772,428,344,124.4
37080, 상주시,035002, 31세,2016,719,412,307,134.2,676,392,284,138
37080, 상주시,035003, 32세,2016,809,441,368,119.8,775,425,350,121.4
37080, 상주시,035004, 33세,2016,861,456,405,112.6,823,437,386,113.2
37080, 상주시,035005, 34세,2016,930,478,452,105.8,910,471,439,107.3
37080, 상주시,040,35~39세,2016,4650,2452,2198,111.6,4555,2407,2148,112.1
37080, 상주시,040001, 35세,2016,940,515,425,121.2,919,505,414,122
37080, 상주시,040002, 36세,2016,985,521,464,112.3,963,513,450,114
37080, 상주시,040003, 37세,2016,948,502,446,112.6,924,486,438,111
37080, 상주시,040004, 38세,2016,855,457,398,114.8,838,451,387,116.5
37080, 상주시,040005, 39세,2016,922,457,465,98.3,911,452,459,98.5
37080, 상주시,045,40~44세,2016,5848,3049,2799,108.9,5774,3011,2763,109
37080, 상주시,045001, 40세,2016,948,494,454,108.8,936,487,449,108.5
37080, 상주시,045002, 41세,2016,1147,585,562,104.1,1128,576,552,104.3
37080, 상주시,045003, 42세,2016,1235,656,579,113.3,1223,650,573,113.4
37080, 상주시,045004, 43세,2016,1257,660,597,110.6,1244,654,590,110.8
37080, 상주시,045005, 44세,2016,1261,654,607,107.7,1243,644,599,107.5
37080, 상주시,050,45~49세,2016,7089,3809,3280,116.1,7011,3774,3237,116.6
37080, 상주시,050001, 45세,2016,1417,777,640,121.4,1405,767,638,120.2
37080, 상주시,050002, 46세,2016,1353,733,620,118.2,1332,726,606,119.8
37080, 상주시,050003, 47세,2016,1362,750,612,122.5,1344,741,603,122.9
37080, 상주시,050004, 48세,2016,1546,822,724,113.5,1535,817,718,113.8
37080, 상주시,050005, 49세,2016,1411,727,684,106.3,1395,723,672,107.6
37080, 상주시,055,50~54세,2016,7992,4153,3839,108.2,7893,4103,3790,108.3
37080, 상주시,055001, 50세,2016,1478,803,675,119,1455,792,663,119.5
37080, 상주시,055002, 51세,2016,1478,724,754,96,1465,719,746,96.4
37080, 상주시,055003, 52세,2016,1597,823,774,106.3,1572,811,761,106.6
37080, 상주시,055004, 53세,2016,1695,903,792,114,1671,888,783,113.4
37080, 상주시,055005, 54세,2016,1744,900,844,106.6,1730,893,837,106.7
37080, 상주시,060,55~59세,2016,9631,4805,4826,99.6,9577,4784,4793,99.8
37080, 상주시,060001, 55세,2016,1942,969,973,99.6,1929,964,965,99.9
37080, 상주시,060002, 56세,2016,2109,1032,1077,95.8,2097,1028,1069,96.2
37080, 상주시,060003, 57세,2016,1911,938,973,96.4,1905,935,970,96.4
37080, 상주시,060004, 58세,2016,1867,939,928,101.2,1855,933,922,101.2
37080, 상주시,060005, 59세,2016,1802,927,875,105.9,1791,924,867,106.6
37080, 상주시,065,60~64세,2016,8378,4011,4367,91.8,8319,3983,4336,91.9
37080, 상주시,065001, 60세,2016,1789,874,915,95.5,1772,864,908,95.2
37080, 상주시,065002, 61세,2016,1746,846,900,94,1737,841,896,93.9
37080, 상주시,065003, 62세,2016,1633,770,863,89.2,1619,766,853,89.8
37080, 상주시,065004, 63세,2016,1516,730,786,92.9,1505,724,781,92.7
37080, 상주시,065005, 64세,2016,1694,791,903,87.6,1686,788,898,87.8
37080, 상주시,070,65~69세,2016,7005,3377,3628,93.1,6978,3366,3612,93.2
37080, 상주시,070001, 65세,2016,1195,567,628,90.3,1188,562,626,89.8
37080, 상주시,070002, 66세,2016,1394,665,729,91.2,1387,664,723,91.8
37080, 상주시,070003, 67세,2016,1577,797,780,102.2,1576,796,780,102.1
37080, 상주시,070004, 68세,2016,1447,690,757,91.1,1439,688,751,91.6
37080, 상주시,070005, 69세,2016,1392,658,734,89.6,1388,656,732,89.6
37080, 상주시,075,70~74세,2016,5985,2494,3491,71.4,5978,2489,3489,71.3
37080, 상주시,075001, 70세,2016,875,424,451,94,873,422,451,93.6
37080, 상주시,075002, 71세,2016,948,411,537,76.5,944,409,535,76.4
37080, 상주시,075003, 72세,2016,1126,427,699,61.1,1125,426,699,60.9
37080, 상주시,075004, 73세,2016,1347,568,779,72.9,1347,568,779,72.9
37080, 상주시,075005, 74세,2016,1689,664,1025,64.8,1689,664,1025,64.8
37080, 상주시,080,75~79세,2016,6540,2457,4083,60.2,6533,2453,4080,60.1
37080, 상주시,080001, 75세,2016,1335,505,830,60.8,1335,505,830,60.8
37080, 상주시,080002, 76세,2016,1367,510,857,59.5,1366,510,856,59.6
37080, 상주시,080003, 77세,2016,1412,532,880,60.5,1408,529,879,60.2
37080, 상주시,080004, 78세,2016,1238,474,764,62,1238,474,764,62
37080, 상주시,080005, 79세,2016,1188,436,752,58,1186,435,751,57.9
37080, 상주시,085,80~84세,2016,4484,1504,2980,50.5,4481,1503,2978,50.5
37080, 상주시,085001, 80세,2016,1110,368,742,49.6,1109,368,741,49.7
37080, 상주시,085002, 81세,2016,1056,381,675,56.4,1055,380,675,56.3
37080, 상주시,085003, 82세,2016,929,324,605,53.6,928,324,604,53.6
37080, 상주시,085004, 83세,2016,730,231,499,46.3,730,231,499,46.3
37080, 상주시,085005, 84세,2016,659,200,459,43.6,659,200,459,43.6
37080, 상주시,090,85~89세,2016,1990,544,1446,37.6,1987,543,1444,37.6
37080, 상주시,090001, 85세,2016,514,162,352,46,514,162,352,46
37080, 상주시,090002, 86세,2016,472,123,349,35.2,470,122,348,35.1
37080, 상주시,090003, 87세,2016,388,103,285,36.1,387,103,284,36.3
37080, 상주시,090004, 88세,2016,328,88,240,36.7,328,88,240,36.7
37080, 상주시,090005, 89세,2016,288,68,220,30.9,288,68,220,30.9
37080, 상주시,095,90~94세,2016,737,167,570,29.3,737,167,570,29.3
37080, 상주시,095001, 90세,2016,206,49,157,31.2,206,49,157,31.2
37080, 상주시,095002, 91세,2016,191,56,135,41.5,191,56,135,41.5
37080, 상주시,095003, 92세,2016,122,20,102,19.6,122,20,102,19.6
37080, 상주시,095004, 93세,2016,113,23,90,25.6,113,23,90,25.6
37080, 상주시,095005, 94세,2016,105,19,86,22.1,105,19,86,22.1
37080, 상주시,100,95~99세,2016,141,21,120,17.5,141,21,120,17.5
37080, 상주시,100001, 95세,2016,63,11,52,21.2,63,11,52,21.2
37080, 상주시,100002, 96세,2016,38,X,34,11.8,38,X,34,11.8
37080, 상주시,100003, 97세,2016,18,X,15,20,18,X,15,20
37080, 상주시,100004, 98세,2016,15,X,14,7.1,15,X,14,7.1
37080, 상주시,100005, 99세,2016,7,X,5,40,7,X,5,40
37080, 상주시,101,100세이상,2016,14,X,13,7.7,14,X,13,7.7
37080, 상주시,102,15세미만,2016,9729,5133,4596,111.7,9711,5121,4590,111.6
37080, 상주시,103,15~64세,2016,62859,33344,29515,113,61817,32833,28984,113.3
37080, 상주시,104,65세이상,2016,26896,10565,16331,64.7,26849,10543,16306,64.7
37080, 상주시,086,85세이상,2016,2882,733,2149,34.1,2879,732,2147,34.1
37080, 상주시,126,평균연령,2016,48.7,45.8,51.5,,48.8,45.9,51.7,
37080, 상주시,127,중위연령,2016,52.1,48.7,55.3,,52.3,48.9,55.5,
37090, 문경시,000,합계,2016,71038,34785,36253,96,70216,34397,35819,96
37090, 문경시,005,0~4세,2016,2383,1239,1144,108.3,2376,1235,1141,108.2
37090, 문경시,005001, 0세,2016,451,232,219,105.9,450,231,219,105.5
37090, 문경시,005002, 1세,2016,470,234,236,99.2,469,234,235,99.6
37090, 문경시,005003, 2세,2016,469,254,215,118.1,469,254,215,118.1
37090, 문경시,005004, 3세,2016,489,257,232,110.8,487,256,231,110.8
37090, 문경시,005005, 4세,2016,504,262,242,108.3,501,260,241,107.9
37090, 문경시,010,5~9세,2016,2462,1319,1143,115.4,2457,1318,1139,115.7
37090, 문경시,010001, 5세,2016,551,302,249,121.3,550,302,248,121.8
37090, 문경시,010002, 6세,2016,466,241,225,107.1,464,240,224,107.1
37090, 문경시,010003, 7세,2016,450,238,212,112.3,449,238,211,112.8
37090, 문경시,010004, 8세,2016,496,270,226,119.5,496,270,226,119.5
37090, 문경시,010005, 9세,2016,499,268,231,116,498,268,230,116.5
37090, 문경시,015,10~14세,2016,2691,1459,1232,118.4,2689,1457,1232,118.3
37090, 문경시,015001, 10세,2016,487,270,217,124.4,487,270,217,124.4
37090, 문경시,015002, 11세,2016,493,266,227,117.2,492,265,227,116.7
37090, 문경시,015003, 12세,2016,517,284,233,121.9,516,283,233,121.5
37090, 문경시,015004, 13세,2016,555,305,250,122,555,305,250,122
37090, 문경시,015005, 14세,2016,639,334,305,109.5,639,334,305,109.5
37090, 문경시,020,15~19세,2016,3943,2208,1735,127.3,3933,2205,1728,127.6
37090, 문경시,020001, 15세,2016,778,434,344,126.2,777,433,344,125.9
37090, 문경시,020002, 16세,2016,965,549,416,132,964,549,415,132.3
37090, 문경시,020003, 17세,2016,870,490,380,128.9,870,490,380,128.9
37090, 문경시,020004, 18세,2016,778,425,353,120.4,777,425,352,120.7
37090, 문경시,020005, 19세,2016,552,310,242,128.1,545,308,237,130
37090, 문경시,025,20~24세,2016,3046,1765,1281,137.8,2926,1702,1224,139.1
37090, 문경시,025001, 20세,2016,687,420,267,157.3,669,410,259,158.3
37090, 문경시,025002, 21세,2016,697,418,279,149.8,675,409,266,153.8
37090, 문경시,025003, 22세,2016,556,316,240,131.7,533,299,234,127.8
37090, 문경시,025004, 23세,2016,549,311,238,130.7,522,295,227,130
37090, 문경시,025005, 24세,2016,557,300,257,116.7,527,289,238,121.4
37090, 문경시,030,25~29세,2016,2692,1464,1228,119.2,2519,1380,1139,121.2
37090, 문경시,030001, 25세,2016,485,252,233,108.2,459,236,223,105.8
37090, 문경시,030002, 26세,2016,537,300,237,126.6,496,276,220,125.5
37090, 문경시,030003, 27세,2016,509,268,241,111.2,480,255,225,113.3
37090, 문경시,030004, 28세,2016,565,316,249,126.9,522,298,224,133
37090, 문경시,030005, 29세,2016,596,328,268,122.4,562,315,247,127.5
37090, 문경시,035,30~34세,2016,3205,1680,1525,110.2,3082,1614,1468,109.9
37090, 문경시,035001, 30세,2016,555,313,242,129.3,525,293,232,126.3
37090, 문경시,035002, 31세,2016,589,322,267,120.6,553,303,250,121.2
37090, 문경시,035003, 32세,2016,682,362,320,113.1,658,345,313,110.2
37090, 문경시,035004, 33세,2016,640,342,298,114.8,620,335,285,117.5
37090, 문경시,035005, 34세,2016,739,341,398,85.7,726,338,388,87.1
37090, 문경시,040,35~39세,2016,3744,1958,1786,109.6,3669,1925,1744,110.4
37090, 문경시,040001, 35세,2016,740,377,363,103.9,722,368,354,104
37090, 문경시,040002, 36세,2016,807,432,375,115.2,790,427,363,117.6
37090, 문경시,040003, 37세,2016,720,383,337,113.6,704,375,329,114
37090, 문경시,040004, 38세,2016,713,362,351,103.1,698,354,344,102.9
37090, 문경시,040005, 39세,2016,764,404,360,112.2,755,401,354,113.3
37090, 문경시,045,40~44세,2016,4478,2370,2108,112.4,4421,2344,2077,112.9
37090, 문경시,045001, 40세,2016,805,422,383,110.2,798,418,380,110
37090, 문경시,045002, 41세,2016,903,471,432,109,889,466,423,110.2
37090, 문경시,045003, 42세,2016,967,510,457,111.6,956,505,451,112
37090, 문경시,045004, 43세,2016,890,467,423,110.4,876,459,417,110.1
37090, 문경시,045005, 44세,2016,913,500,413,121.1,902,496,406,122.2
37090, 문경시,050,45~49세,2016,4998,2637,2361,111.7,4940,2609,2331,111.9
37090, 문경시,050001, 45세,2016,931,485,446,108.7,922,481,441,109.1
37090, 문경시,050002, 46세,2016,987,523,464,112.7,974,516,458,112.7
37090, 문경시,050003, 47세,2016,1016,545,471,115.7,1002,541,461,117.4
37090, 문경시,050004, 48세,2016,1049,559,490,114.1,1036,552,484,114
37090, 문경시,050005, 49세,2016,1015,525,490,107.1,1006,519,487,106.6
37090, 문경시,055,50~54세,2016,5641,2851,2790,102.2,5575,2828,2747,102.9
37090, 문경시,055001, 50세,2016,1036,526,510,103.1,1029,523,506,103.4
37090, 문경시,055002, 51세,2016,1046,514,532,96.6,1034,510,524,97.3
37090, 문경시,055003, 52세,2016,1108,572,536,106.7,1093,569,524,108.6
37090, 문경시,055004, 53세,2016,1201,595,606,98.2,1177,584,593,98.5
37090, 문경시,055005, 54세,2016,1250,644,606,106.3,1242,642,600,107
37090, 문경시,060,55~59세,2016,6909,3418,3491,97.9,6855,3399,3456,98.4
37090, 문경시,060001, 55세,2016,1394,686,708,96.9,1384,682,702,97.2
37090, 문경시,060002, 56세,2016,1476,741,735,100.8,1463,736,727,101.2
37090, 문경시,060003, 57세,2016,1312,639,673,94.9,1301,634,667,95.1
37090, 문경시,060004, 58세,2016,1346,680,666,102.1,1333,677,656,103.2
37090, 문경시,060005, 59세,2016,1381,672,709,94.8,1374,670,704,95.2
37090, 문경시,065,60~64세,2016,6200,2970,3230,92,6162,2952,3210,92
37090, 문경시,065001, 60세,2016,1372,677,695,97.4,1362,673,689,97.7
37090, 문경시,065002, 61세,2016,1275,625,650,96.2,1271,623,648,96.1
37090, 문경시,065003, 62세,2016,1183,564,619,91.1,1171,558,613,91
37090, 문경시,065004, 63세,2016,1174,536,638,84,1168,533,635,83.9
37090, 문경시,065005, 64세,2016,1196,568,628,90.4,1190,565,625,90.4
37090, 문경시,070,65~69세,2016,5074,2404,2670,90,5054,2395,2659,90.1
37090, 문경시,070001, 65세,2016,912,428,484,88.4,909,426,483,88.2
37090, 문경시,070002, 66세,2016,1062,502,560,89.6,1057,498,559,89.1
37090, 문경시,070003, 67세,2016,1111,533,578,92.2,1107,533,574,92.9
37090, 문경시,070004, 68세,2016,982,464,518,89.6,979,462,517,89.4
37090, 문경시,070005, 69세,2016,1007,477,530,90,1002,476,526,90.5
37090, 문경시,075,70~74세,2016,4400,1876,2524,74.3,4391,1869,2522,74.1
37090, 문경시,075001, 70세,2016,694,311,383,81.2,692,310,382,81.2
37090, 문경시,075002, 71세,2016,759,344,415,82.9,756,341,415,82.2
37090, 문경시,075003, 72세,2016,828,324,504,64.3,826,323,503,64.2
37090, 문경시,075004, 73세,2016,1002,409,593,69,1001,408,593,68.8
37090, 문경시,075005, 74세,2016,1117,488,629,77.6,1116,487,629,77.4
37090, 문경시,080,75~79세,2016,4457,1736,2721,63.8,4454,1734,2720,63.8
37090, 문경시,080001, 75세,2016,965,402,563,71.4,965,402,563,71.4
37090, 문경시,080002, 76세,2016,955,400,555,72.1,953,398,555,71.7
37090, 문경시,080003, 77세,2016,905,355,550,64.5,904,355,549,64.7
37090, 문경시,080004, 78세,2016,861,325,536,60.6,861,325,536,60.6
37090, 문경시,080005, 79세,2016,771,254,517,49.1,771,254,517,49.1
37090, 문경시,085,80~84세,2016,2857,965,1892,51,2856,965,1891,51
37090, 문경시,085001, 80세,2016,742,270,472,57.2,742,270,472,57.2
37090, 문경시,085002, 81세,2016,675,240,435,55.2,674,240,434,55.3
37090, 문경시,085003, 82세,2016,584,190,394,48.2,584,190,394,48.2
37090, 문경시,085004, 83세,2016,498,165,333,49.5,498,165,333,49.5
37090, 문경시,085005, 84세,2016,358,100,258,38.8,358,100,258,38.8
37090, 문경시,090,85~89세,2016,1295,350,945,37,1295,350,945,37
37090, 문경시,090001, 85세,2016,330,90,240,37.5,330,90,240,37.5
37090, 문경시,090002, 86세,2016,315,87,228,38.2,315,87,228,38.2
37090, 문경시,090003, 87세,2016,249,71,178,39.9,249,71,178,39.9
37090, 문경시,090004, 88세,2016,210,56,154,36.4,210,56,154,36.4
37090, 문경시,090005, 89세,2016,191,46,145,31.7,191,46,145,31.7
37090, 문경시,095,90~94세,2016,454,100,354,28.2,453,100,353,28.3
37090, 문경시,095001, 90세,2016,126,23,103,22.3,126,23,103,22.3
37090, 문경시,095002, 91세,2016,112,31,81,38.3,112,31,81,38.3
37090, 문경시,095003, 92세,2016,72,15,57,26.3,72,15,57,26.3
37090, 문경시,095004, 93세,2016,86,19,67,28.4,85,19,66,28.8
37090, 문경시,095005, 94세,2016,58,12,46,26.1,58,12,46,26.1
37090, 문경시,100,95~99세,2016,87,12,75,16,87,12,75,16
37090, 문경시,100001, 95세,2016,28,X,25,12,28,X,25,12
37090, 문경시,100002, 96세,2016,24,6,18,33.3,24,6,18,33.3
37090, 문경시,100003, 97세,2016,14,X,14,0,14,X,14,0
37090, 문경시,100004, 98세,2016,12,X,10,20,12,X,10,20
37090, 문경시,100005, 99세,2016,9,X,8,12.5,9,X,8,12.5
37090, 문경시,101,100세이상,2016,22,X,18,22.2,22,X,18,22.2
37090, 문경시,102,15세미만,2016,7536,4017,3519,114.2,7522,4010,3512,114.2
37090, 문경시,103,15~64세,2016,44856,23321,21535,108.3,44082,22958,21124,108.7
37090, 문경시,104,65세이상,2016,18646,7447,11199,66.5,18612,7429,11183,66.4
37090, 문경시,086,85세이상,2016,1858,466,1392,33.5,1857,466,1391,33.5
37090, 문경시,126,평균연령,2016,48.3,45.7,50.8,,48.4,45.8,51,
37090, 문경시,127,중위연령,2016,51.8,48.7,54.7,,52,48.9,54.9,
37100, 경산시,000,합계,2016,279751,141235,138516,102,270398,135514,134884,100.5
37100, 경산시,005,0~4세,2016,12233,6185,6048,102.3,12099,6127,5972,102.6
37100, 경산시,005001, 0세,2016,2484,1280,1204,106.3,2454,1263,1191,106
37100, 경산시,005002, 1세,2016,2380,1197,1183,101.2,2355,1186,1169,101.5
37100, 경산시,005003, 2세,2016,2436,1242,1194,104,2410,1232,1178,104.6
37100, 경산시,005004, 3세,2016,2441,1228,1213,101.2,2411,1213,1198,101.3
37100, 경산시,005005, 4세,2016,2492,1238,1254,98.7,2469,1233,1236,99.8
37100, 경산시,010,5~9세,2016,11259,5866,5393,108.8,11184,5829,5355,108.9
37100, 경산시,010001, 5세,2016,2483,1315,1168,112.6,2461,1305,1156,112.9
37100, 경산시,010002, 6세,2016,2179,1103,1076,102.5,2163,1097,1066,102.9
37100, 경산시,010003, 7세,2016,2162,1127,1035,108.9,2150,1119,1031,108.5
37100, 경산시,010004, 8세,2016,2178,1154,1024,112.7,2160,1147,1013,113.2
37100, 경산시,010005, 9세,2016,2257,1167,1090,107.1,2250,1161,1089,106.6
37100, 경산시,015,10~14세,2016,10656,5629,5027,112,10626,5612,5014,111.9
37100, 경산시,015001, 10세,2016,2040,1093,947,115.4,2035,1090,945,115.3
37100, 경산시,015002, 11세,2016,1910,961,949,101.3,1901,954,947,100.7
37100, 경산시,015003, 12세,2016,2217,1173,1044,112.4,2210,1170,1040,112.5
37100, 경산시,015004, 13세,2016,2135,1153,982,117.4,2132,1153,979,117.8
37100, 경산시,015005, 14세,2016,2354,1249,1105,113,2348,1245,1103,112.9
37100, 경산시,020,15~19세,2016,21440,10806,10634,101.6,21019,10617,10402,102.1
37100, 경산시,020001, 15세,2016,2805,1469,1336,110,2803,1469,1334,110.1
37100, 경산시,020002, 16세,2016,3013,1617,1396,115.8,3001,1614,1387,116.4
37100, 경산시,020003, 17세,2016,2894,1559,1335,116.8,2848,1537,1311,117.2
37100, 경산시,020004, 18세,2016,4677,2378,2299,103.4,4571,2331,2240,104.1
37100, 경산시,020005, 19세,2016,8051,3783,4268,88.6,7796,3666,4130,88.8
37100, 경산시,025,20~24세,2016,28185,14601,13584,107.5,25982,13454,12528,107.4
37100, 경산시,025001, 20세,2016,6256,2546,3710,68.6,5877,2393,3484,68.7
37100, 경산시,025002, 21세,2016,5704,2555,3149,81.1,5286,2379,2907,81.8
37100, 경산시,025003, 22세,2016,5754,3126,2628,118.9,5335,2904,2431,119.5
37100, 경산시,025004, 23세,2016,5435,3346,2089,160.2,4942,3049,1893,161.1
37100, 경산시,025005, 24세,2016,5036,3028,2008,150.8,4542,2729,1813,150.5
37100, 경산시,030,25~29세,2016,18898,10913,7985,136.7,16779,9585,7194,133.2
37100, 경산시,030001, 25세,2016,4351,2571,1780,144.4,3927,2328,1599,145.6
37100, 경산시,030002, 26세,2016,3898,2266,1632,138.8,3451,1998,1453,137.5
37100, 경산시,030003, 27세,2016,3647,2082,1565,133,3208,1795,1413,127
37100, 경산시,030004, 28세,2016,3448,2011,1437,139.9,3062,1764,1298,135.9
37100, 경산시,030005, 29세,2016,3554,1983,1571,126.2,3131,1700,1431,118.8
37100, 경산시,035,30~34세,2016,19168,10393,8775,118.4,17652,9294,8358,111.2
37100, 경산시,035001, 30세,2016,3442,1904,1538,123.8,3112,1665,1447,115.1
37100, 경산시,035002, 31세,2016,3662,2067,1595,129.6,3319,1817,1502,121
37100, 경산시,035003, 32세,2016,3578,1982,1596,124.2,3267,1762,1505,117.1
37100, 경산시,035004, 33세,2016,4142,2163,1979,109.3,3869,1966,1903,103.3
37100, 경산시,035005, 34세,2016,4344,2277,2067,110.2,4085,2084,2001,104.1
37100, 경산시,040,35~39세,2016,20422,10840,9582,113.1,19519,10182,9337,109.1
37100, 경산시,040001, 35세,2016,4378,2367,2011,117.7,4151,2198,1953,112.5
37100, 경산시,040002, 36세,2016,4388,2330,2058,113.2,4193,2184,2009,108.7
37100, 경산시,040003, 37세,2016,4117,2132,1985,107.4,3932,2002,1930,103.7
37100, 경산시,040004, 38세,2016,3768,2015,1753,114.9,3608,1904,1704,111.7
37100, 경산시,040005, 39세,2016,3771,1996,1775,112.5,3635,1894,1741,108.8
37100, 경산시,045,40~44세,2016,21295,11100,10195,108.9,20683,10683,10000,106.8
37100, 경산시,045001, 40세,2016,3919,2055,1864,110.2,3787,1965,1822,107.8
37100, 경산시,045002, 41세,2016,4033,2135,1898,112.5,3892,2036,1856,109.7
37100, 경산시,045003, 42세,2016,4431,2303,2128,108.2,4312,2221,2091,106.2
37100, 경산시,045004, 43세,2016,4504,2325,2179,106.7,4394,2254,2140,105.3
37100, 경산시,045005, 44세,2016,4408,2282,2126,107.3,4298,2207,2091,105.5
37100, 경산시,050,45~49세,2016,22360,11319,11041,102.5,21870,11009,10861,101.4
37100, 경산시,050001, 45세,2016,4743,2439,2304,105.9,4624,2356,2268,103.9
37100, 경산시,050002, 46세,2016,4333,2222,2111,105.3,4233,2156,2077,103.8
37100, 경산시,050003, 47세,2016,4350,2182,2168,100.6,4261,2134,2127,100.3
37100, 경산시,050004, 48세,2016,4707,2329,2378,97.9,4616,2275,2341,97.2
37100, 경산시,050005, 49세,2016,4227,2147,2080,103.2,4136,2088,2048,102
37100, 경산시,055,50~54세,2016,21106,10731,10375,103.4,20754,10531,10223,103
37100, 경산시,055001, 50세,2016,4226,2227,1999,111.4,4153,2190,1963,111.6
37100, 경산시,055002, 51세,2016,4278,2114,2164,97.7,4203,2069,2134,97
37100, 경산시,055003, 52세,2016,3978,2022,1956,103.4,3906,1981,1925,102.9
37100, 경산시,055004, 53세,2016,4150,2097,2053,102.1,4081,2053,2028,101.2
37100, 경산시,055005, 54세,2016,4474,2271,2203,103.1,4411,2238,2173,103
37100, 경산시,060,55~59세,2016,20716,10351,10365,99.9,20502,10227,10275,99.5
37100, 경산시,060001, 55세,2016,4670,2345,2325,100.9,4623,2317,2306,100.5
37100, 경산시,060002, 56세,2016,4485,2203,2282,96.5,4428,2173,2255,96.4
37100, 경산시,060003, 57세,2016,4250,2131,2119,100.6,4201,2100,2101,100
37100, 경산시,060004, 58세,2016,3566,1810,1756,103.1,3532,1791,1741,102.9
37100, 경산시,060005, 59세,2016,3745,1862,1883,98.9,3718,1846,1872,98.6
37100, 경산시,065,60~64세,2016,15648,7532,8116,92.8,15498,7448,8050,92.5
37100, 경산시,065001, 60세,2016,3469,1727,1742,99.1,3425,1702,1723,98.8
37100, 경산시,065002, 61세,2016,3447,1660,1787,92.9,3416,1645,1771,92.9
37100, 경산시,065003, 62세,2016,2956,1428,1528,93.5,2928,1409,1519,92.8
37100, 경산시,065004, 63세,2016,2791,1330,1461,91,2760,1314,1446,90.9
37100, 경산시,065005, 64세,2016,2985,1387,1598,86.8,2969,1378,1591,86.6
37100, 경산시,070,65~69세,2016,12035,5607,6428,87.2,11969,5578,6391,87.3
37100, 경산시,070001, 65세,2016,2403,1156,1247,92.7,2384,1149,1235,93
37100, 경산시,070002, 66세,2016,2359,1123,1236,90.9,2341,1111,1230,90.3
37100, 경산시,070003, 67세,2016,2589,1210,1379,87.7,2580,1206,1374,87.8
37100, 경산시,070004, 68세,2016,2430,1098,1332,82.4,2420,1096,1324,82.8
37100, 경산시,070005, 69세,2016,2254,1020,1234,82.7,2244,1016,1228,82.7
37100, 경산시,075,70~74세,2016,8872,3971,4901,81,8837,3958,4879,81.1
37100, 경산시,075001, 70세,2016,1429,699,730,95.8,1422,695,727,95.6
37100, 경산시,075002, 71세,2016,1540,698,842,82.9,1533,695,838,82.9
37100, 경산시,075003, 72세,2016,1830,796,1034,77,1822,793,1029,77.1
37100, 경산시,075004, 73세,2016,1942,854,1088,78.5,1936,851,1085,78.4
37100, 경산시,075005, 74세,2016,2131,924,1207,76.6,2124,924,1200,77
37100, 경산시,080,75~79세,2016,7659,2982,4677,63.8,7640,2973,4667,63.7
37100, 경산시,080001, 75세,2016,1696,701,995,70.5,1692,697,995,70.1
37100, 경산시,080002, 76세,2016,1636,618,1018,60.7,1631,616,1015,60.7
37100, 경산시,080003, 77세,2016,1640,659,981,67.2,1638,658,980,67.1
37100, 경산시,080004, 78세,2016,1426,546,880,62,1421,544,877,62
37100, 경산시,080005, 79세,2016,1261,458,803,57,1258,458,800,57.3
37100, 경산시,085,80~84세,2016,4984,1707,3277,52.1,4974,1706,3268,52.2
37100, 경산시,085001, 80세,2016,1224,463,761,60.8,1221,463,758,61.1
37100, 경산시,085002, 81세,2016,1162,408,754,54.1,1159,408,751,54.3
37100, 경산시,085003, 82세,2016,1014,336,678,49.6,1012,335,677,49.5
37100, 경산시,085004, 83세,2016,837,290,547,53,836,290,546,53.1
37100, 경산시,085005, 84세,2016,747,210,537,39.1,746,210,536,39.2
37100, 경산시,090,85~89세,2016,2017,546,1471,37.1,2015,545,1470,37.1
37100, 경산시,090001, 85세,2016,552,157,395,39.7,552,157,395,39.7
37100, 경산시,090002, 86세,2016,481,117,364,32.1,481,117,364,32.1
37100, 경산시,090003, 87세,2016,377,115,262,43.9,377,115,262,43.9
37100, 경산시,090004, 88세,2016,317,87,230,37.8,315,86,229,37.6
37100, 경산시,090005, 89세,2016,290,70,220,31.8,290,70,220,31.8
37100, 경산시,095,90~94세,2016,668,135,533,25.3,667,135,532,25.4
37100, 경산시,095001, 90세,2016,197,42,155,27.1,196,42,154,27.3
37100, 경산시,095002, 91세,2016,164,35,129,27.1,164,35,129,27.1
37100, 경산시,095003, 92세,2016,127,26,101,25.7,127,26,101,25.7
37100, 경산시,095004, 93세,2016,108,20,88,22.7,108,20,88,22.7
37100, 경산시,095005, 94세,2016,72,12,60,20,72,12,60,20
37100, 경산시,100,95~99세,2016,121,18,103,17.5,120,18,102,17.6
37100, 경산시,100001, 95세,2016,43,6,37,16.2,43,6,37,16.2
37100, 경산시,100002, 96세,2016,25,X,23,8.7,25,X,23,8.7
37100, 경산시,100003, 97세,2016,21,X,18,16.7,21,X,18,16.7
37100, 경산시,100004, 98세,2016,19,5,14,35.7,18,5,13,38.5
37100, 경산시,100005, 99세,2016,13,X,11,18.2,13,X,11,18.2
37100, 경산시,101,100세이상,2016,9,X,6,50,9,X,6,50
37100, 경산시,102,15세미만,2016,34148,17680,16468,107.4,33909,17568,16341,107.5
37100, 경산시,103,15~64세,2016,209238,108586,100652,107.9,200258,103030,97228,106
37100, 경산시,104,65세이상,2016,36365,14969,21396,70,36231,14916,21315,70
37100, 경산시,086,85세이상,2016,2815,702,2113,33.2,2811,701,2110,33.2
37100, 경산시,126,평균연령,2016,39.8,38.5,41.1,,40,38.7,41.4,
37100, 경산시,127,중위연령,2016,39.4,37.7,41.2,,40.1,38.4,41.8,
37310, 군위군,000,합계,2016,22079,11183,10896,102.6,21374,10649,10725,99.3
37310, 군위군,005,0~4세,2016,458,247,211,117.1,454,245,209,117.2
37310, 군위군,005001, 0세,2016,101,60,41,146.3,100,60,40,150
37310, 군위군,005002, 1세,2016,91,49,42,116.7,89,48,41,117.1
37310, 군위군,005003, 2세,2016,90,45,45,100,90,45,45,100
37310, 군위군,005004, 3세,2016,72,43,29,148.3,71,42,29,144.8
37310, 군위군,005005, 4세,2016,104,50,54,92.6,104,50,54,92.6
37310, 군위군,010,5~9세,2016,409,219,190,115.3,408,219,189,115.9
37310, 군위군,010001, 5세,2016,81,44,37,118.9,81,44,37,118.9
37310, 군위군,010002, 6세,2016,66,33,33,100,66,33,33,100
37310, 군위군,010003, 7세,2016,75,44,31,141.9,75,44,31,141.9
37310, 군위군,010004, 8세,2016,97,54,43,125.6,97,54,43,125.6
37310, 군위군,010005, 9세,2016,90,44,46,95.7,89,44,45,97.8
37310, 군위군,015,10~14세,2016,443,247,196,126,442,246,196,125.5
37310, 군위군,015001, 10세,2016,81,43,38,113.2,81,43,38,113.2
37310, 군위군,015002, 11세,2016,89,47,42,111.9,89,47,42,111.9
37310, 군위군,015003, 12세,2016,75,43,32,134.4,74,42,32,131.3
37310, 군위군,015004, 13세,2016,85,50,35,142.9,85,50,35,142.9
37310, 군위군,015005, 14세,2016,113,64,49,130.6,113,64,49,130.6
37310, 군위군,020,15~19세,2016,667,349,318,109.7,661,345,316,109.2
37310, 군위군,020001, 15세,2016,105,51,54,94.4,105,51,54,94.4
37310, 군위군,020002, 16세,2016,158,86,72,119.4,158,86,72,119.4
37310, 군위군,020003, 17세,2016,155,79,76,103.9,155,79,76,103.9
37310, 군위군,020004, 18세,2016,139,75,64,117.2,139,75,64,117.2
37310, 군위군,020005, 19세,2016,110,58,52,111.5,104,54,50,108
37310, 군위군,025,20~24세,2016,824,521,303,171.9,720,438,282,155.3
37310, 군위군,025001, 20세,2016,123,82,41,200,117,76,41,185.4
37310, 군위군,025002, 21세,2016,163,109,54,201.9,148,100,48,208.3
37310, 군위군,025003, 22세,2016,184,114,70,162.9,162,94,68,138.2
37310, 군위군,025004, 23세,2016,158,89,69,129,135,69,66,104.5
37310, 군위군,025005, 24세,2016,196,127,69,184.1,158,99,59,167.8
37310, 군위군,030,25~29세,2016,935,592,343,172.6,704,411,293,140.3
37310, 군위군,030001, 25세,2016,167,101,66,153,127,70,57,122.8
37310, 군위군,030002, 26세,2016,189,120,69,173.9,136,77,59,130.5
37310, 군위군,030003, 27세,2016,168,108,60,180,120,69,51,135.3
37310, 군위군,030004, 28세,2016,181,110,71,154.9,139,79,60,131.7
37310, 군위군,030005, 29세,2016,230,153,77,198.7,182,116,66,175.8
37310, 군위군,035,30~34세,2016,850,507,343,147.8,699,383,316,121.2
37310, 군위군,035001, 30세,2016,164,97,67,144.8,131,68,63,107.9
37310, 군위군,035002, 31세,2016,177,105,72,145.8,145,80,65,123.1
37310, 군위군,035003, 32세,2016,165,109,56,194.6,133,80,53,150.9
37310, 군위군,035004, 33세,2016,177,98,79,124.1,147,80,67,119.4
37310, 군위군,035005, 34세,2016,167,98,69,142,143,75,68,110.3
37310, 군위군,040,35~39세,2016,835,495,340,145.6,768,446,322,138.5
37310, 군위군,040001, 35세,2016,169,95,74,128.4,149,77,72,106.9
37310, 군위군,040002, 36세,2016,175,99,76,130.3,155,86,69,124.6
37310, 군위군,040003, 37세,2016,176,112,64,175,166,105,61,172.1
37310, 군위군,040004, 38세,2016,162,89,73,121.9,154,84,70,120
37310, 군위군,040005, 39세,2016,153,100,53,188.7,144,94,50,188
37310, 군위군,045,40~44세,2016,967,577,390,147.9,919,543,376,144.4
37310, 군위군,045001, 40세,2016,173,101,72,140.3,161,92,69,133.3
37310, 군위군,045002, 41세,2016,184,110,74,148.6,173,102,71,143.7
37310, 군위군,045003, 42세,2016,173,105,68,154.4,164,99,65,152.3
37310, 군위군,045004, 43세,2016,211,130,81,160.5,202,125,77,162.3
37310, 군위군,045005, 44세,2016,226,131,95,137.9,219,125,94,133
37310, 군위군,050,45~49세,2016,1291,745,546,136.4,1255,723,532,135.9
37310, 군위군,050001, 45세,2016,229,130,99,131.3,218,123,95,129.5
37310, 군위군,050002, 46세,2016,230,128,102,125.5,221,123,98,125.5
37310, 군위군,050003, 47세,2016,271,164,107,153.3,266,160,106,150.9
37310, 군위군,050004, 48세,2016,280,157,123,127.6,275,154,121,127.3
37310, 군위군,050005, 49세,2016,281,166,115,144.3,275,163,112,145.5
37310, 군위군,055,50~54세,2016,1809,991,818,121.1,1790,979,811,120.7
37310, 군위군,055001, 50세,2016,316,180,136,132.4,313,177,136,130.1
37310, 군위군,055002, 51세,2016,369,204,165,123.6,368,203,165,123
37310, 군위군,055003, 52세,2016,353,190,163,116.6,344,186,158,117.7
37310, 군위군,055004, 53세,2016,342,169,173,97.7,340,168,172,97.7
37310, 군위군,055005, 54세,2016,429,248,181,137,425,245,180,136.1
37310, 군위군,060,55~59세,2016,2230,1170,1060,110.4,2213,1161,1052,110.4
37310, 군위군,060001, 55세,2016,431,226,205,110.2,427,224,203,110.3
37310, 군위군,060002, 56세,2016,462,241,221,109,457,238,219,108.7
37310, 군위군,060003, 57세,2016,475,238,237,100.4,473,238,235,101.3
37310, 군위군,060004, 58세,2016,416,225,191,117.8,412,223,189,118
37310, 군위군,060005, 59세,2016,446,240,206,116.5,444,238,206,115.5
37310, 군위군,065,60~64세,2016,2297,1163,1134,102.6,2286,1157,1129,102.5
37310, 군위군,065001, 60세,2016,505,259,246,105.3,504,258,246,104.9
37310, 군위군,065002, 61세,2016,460,232,228,101.8,460,232,228,101.8
37310, 군위군,065003, 62세,2016,415,215,200,107.5,414,214,200,107
37310, 군위군,065004, 63세,2016,403,214,189,113.2,398,211,187,112.8
37310, 군위군,065005, 64세,2016,514,243,271,89.7,510,242,268,90.3
37310, 군위군,070,65~69세,2016,2024,993,1031,96.3,2020,991,1029,96.3
37310, 군위군,070001, 65세,2016,386,189,197,95.9,384,188,196,95.9
37310, 군위군,070002, 66세,2016,378,169,209,80.9,377,169,208,81.3
37310, 군위군,070003, 67세,2016,417,223,194,114.9,417,223,194,114.9
37310, 군위군,070004, 68세,2016,408,194,214,90.7,407,193,214,90.2
37310, 군위군,070005, 69세,2016,435,218,217,100.5,435,218,217,100.5
37310, 군위군,075,70~74세,2016,1879,831,1048,79.3,1876,828,1048,79
37310, 군위군,075001, 70세,2016,266,137,129,106.2,266,137,129,106.2
37310, 군위군,075002, 71세,2016,337,148,189,78.3,335,146,189,77.2
37310, 군위군,075003, 72세,2016,353,150,203,73.9,353,150,203,73.9
37310, 군위군,075004, 73세,2016,415,176,239,73.6,414,175,239,73.2
37310, 군위군,075005, 74세,2016,508,220,288,76.4,508,220,288,76.4
37310, 군위군,080,75~79세,2016,2000,806,1194,67.5,1999,805,1194,67.4
37310, 군위군,080001, 75세,2016,404,174,230,75.7,404,174,230,75.7
37310, 군위군,080002, 76세,2016,425,174,251,69.3,425,174,251,69.3
37310, 군위군,080003, 77세,2016,414,163,251,64.9,413,162,251,64.5
37310, 군위군,080004, 78세,2016,409,158,251,62.9,409,158,251,62.9
37310, 군위군,080005, 79세,2016,348,137,211,64.9,348,137,211,64.9
37310, 군위군,085,80~84세,2016,1454,535,919,58.2,1453,534,919,58.1
37310, 군위군,085001, 80세,2016,345,130,215,60.5,345,130,215,60.5
37310, 군위군,085002, 81세,2016,368,134,234,57.3,368,134,234,57.3
37310, 군위군,085003, 82세,2016,288,104,184,56.5,287,103,184,56
37310, 군위군,085004, 83세,2016,223,85,138,61.6,223,85,138,61.6
37310, 군위군,085005, 84세,2016,230,82,148,55.4,230,82,148,55.4
37310, 군위군,090,85~89세,2016,533,154,379,40.6,533,154,379,40.6
37310, 군위군,090001, 85세,2016,140,39,101,38.6,140,39,101,38.6
37310, 군위군,090002, 86세,2016,125,42,83,50.6,125,42,83,50.6
37310, 군위군,090003, 87세,2016,104,28,76,36.8,104,28,76,36.8
37310, 군위군,090004, 88세,2016,82,23,59,39,82,23,59,39
37310, 군위군,090005, 89세,2016,82,22,60,36.7,82,22,60,36.7
37310, 군위군,095,90~94세,2016,140,30,110,27.3,140,30,110,27.3
37310, 군위군,095001, 90세,2016,45,11,34,32.4,45,11,34,32.4
37310, 군위군,095002, 91세,2016,38,12,26,46.2,38,12,26,46.2
37310, 군위군,095003, 92세,2016,22,X,18,22.2,22,X,18,22.2
37310, 군위군,095004, 93세,2016,15,X,13,15.4,15,X,13,15.4
37310, 군위군,095005, 94세,2016,20,X,19,5.3,20,X,19,5.3
37310, 군위군,100,95~99세,2016,33,11,22,50,33,11,22,50
37310, 군위군,100001, 95세,2016,12,X,8,50,12,X,8,50
37310, 군위군,100002, 96세,2016,7,X,5,40,7,X,5,40
37310, 군위군,100003, 97세,2016,9,X,6,50,9,X,6,50
37310, 군위군,100004, 98세,2016,X,X,X,100,X,X,X,100
37310, 군위군,100005, 99세,2016,X,X,X,0,X,X,X,0
37310, 군위군,101,100세이상,2016,X,X,X,0,X,X,X,0
37310, 군위군,102,15세미만,2016,1310,713,597,119.4,1304,710,594,119.5
37310, 군위군,103,15~64세,2016,12705,7110,5595,127.1,12015,6586,5429,121.3
37310, 군위군,104,65세이상,2016,8064,3360,4704,71.4,8055,3353,4702,71.3
37310, 군위군,086,85세이상,2016,707,195,512,38.1,707,195,512,38.1
37310, 군위군,126,평균연령,2016,54.6,51.7,57.6,,55.3,52.6,57.9,
37310, 군위군,127,중위연령,2016,58.4,55.4,61.6,,59.2,56.5,62,
37320, 의성군,000,합계,2016,50683,24529,26154,93.8,49759,23961,25798,92.9
37320, 의성군,005,0~4세,2016,1106,585,521,112.3,1104,585,519,112.7
37320, 의성군,005001, 0세,2016,251,136,115,118.3,251,136,115,118.3
37320, 의성군,005002, 1세,2016,228,115,113,101.8,227,115,112,102.7
37320, 의성군,005003, 2세,2016,211,119,92,129.3,211,119,92,129.3
37320, 의성군,005004, 3세,2016,198,100,98,102,198,100,98,102
37320, 의성군,005005, 4세,2016,218,115,103,111.7,217,115,102,112.7
37320, 의성군,010,5~9세,2016,1037,542,495,109.5,1033,541,492,110
37320, 의성군,010001, 5세,2016,209,101,108,93.5,209,101,108,93.5
37320, 의성군,010002, 6세,2016,191,106,85,124.7,189,106,83,127.7
37320, 의성군,010003, 7세,2016,188,100,88,113.6,188,100,88,113.6
37320, 의성군,010004, 8세,2016,236,135,101,133.7,234,134,100,134
37320, 의성군,010005, 9세,2016,213,100,113,88.5,213,100,113,88.5
37320, 의성군,015,10~14세,2016,1143,603,540,111.7,1142,602,540,111.5
37320, 의성군,015001, 10세,2016,215,115,100,115,214,114,100,114
37320, 의성군,015002, 11세,2016,217,117,100,117,217,117,100,117
37320, 의성군,015003, 12세,2016,244,131,113,115.9,244,131,113,115.9
37320, 의성군,015004, 13세,2016,212,111,101,109.9,212,111,101,109.9
37320, 의성군,015005, 14세,2016,255,129,126,102.4,255,129,126,102.4
37320, 의성군,020,15~19세,2016,1350,722,628,115,1344,720,624,115.4
37320, 의성군,020001, 15세,2016,278,146,132,110.6,278,146,132,110.6
37320, 의성군,020002, 16세,2016,294,143,151,94.7,293,142,151,94
37320, 의성군,020003, 17세,2016,287,145,142,102.1,287,145,142,102.1
37320, 의성군,020004, 18세,2016,274,154,120,128.3,274,154,120,128.3
37320, 의성군,020005, 19세,2016,217,134,83,161.4,212,133,79,168.4
37320, 의성군,025,20~24세,2016,1692,1024,668,153.3,1559,937,622,150.6
37320, 의성군,025001, 20세,2016,275,194,81,239.5,265,184,81,227.2
37320, 의성군,025002, 21세,2016,358,212,146,145.2,334,202,132,153
37320, 의성군,025003, 22세,2016,351,213,138,154.3,318,191,127,150.4
37320, 의성군,025004, 23세,2016,359,196,163,120.2,322,172,150,114.7
37320, 의성군,025005, 24세,2016,349,209,140,149.3,320,188,132,142.4
37320, 의성군,030,25~29세,2016,1776,1043,733,142.3,1564,899,665,135.2
37320, 의성군,030001, 25세,2016,366,208,158,131.6,322,176,146,120.5
37320, 의성군,030002, 26세,2016,355,225,130,173.1,303,188,115,163.5
37320, 의성군,030003, 27세,2016,361,210,151,139.1,321,181,140,129.3
37320, 의성군,030004, 28세,2016,334,198,136,145.6,296,177,119,148.7
37320, 의성군,030005, 29세,2016,360,202,158,127.8,322,177,145,122.1
37320, 의성군,035,30~34세,2016,1760,983,777,126.5,1603,884,719,122.9
37320, 의성군,035001, 30세,2016,338,192,146,131.5,296,163,133,122.6
37320, 의성군,035002, 31세,2016,381,229,152,150.7,341,203,138,147.1
37320, 의성군,035003, 32세,2016,326,177,149,118.8,295,156,139,112.2
37320, 의성군,035004, 33세,2016,332,185,147,125.9,310,172,138,124.6
37320, 의성군,035005, 34세,2016,383,200,183,109.3,361,190,171,111.1
37320, 의성군,040,35~39세,2016,1837,1057,780,135.5,1733,986,747,132
37320, 의성군,040001, 35세,2016,381,222,159,139.6,354,203,151,134.4
37320, 의성군,040002, 36세,2016,343,199,144,138.2,323,185,138,134.1
37320, 의성군,040003, 37세,2016,386,212,174,121.8,367,202,165,122.4
37320, 의성군,040004, 38세,2016,358,215,143,150.3,338,201,137,146.7
37320, 의성군,040005, 39세,2016,369,209,160,130.6,351,195,156,125
37320, 의성군,045,40~44세,2016,2193,1282,911,140.7,2111,1233,878,140.4
37320, 의성군,045001, 40세,2016,354,223,131,170.2,337,215,122,176.2
37320, 의성군,045002, 41세,2016,408,234,174,134.5,391,222,169,131.4
37320, 의성군,045003, 42세,2016,422,249,173,143.9,406,236,170,138.8
37320, 의성군,045004, 43세,2016,495,276,219,126,481,268,213,125.8
37320, 의성군,045005, 44세,2016,514,300,214,140.2,496,292,204,143.1
37320, 의성군,050,45~49세,2016,2936,1642,1294,126.9,2877,1611,1266,127.3
37320, 의성군,050001, 45세,2016,514,279,235,118.7,502,274,228,120.2
37320, 의성군,050002, 46세,2016,532,296,236,125.4,520,289,231,125.1
37320, 의성군,050003, 47세,2016,607,342,265,129.1,603,338,265,127.5
37320, 의성군,050004, 48세,2016,639,360,279,129,622,351,271,129.5
37320, 의성군,050005, 49세,2016,644,365,279,130.8,630,359,271,132.5
37320, 의성군,055,50~54세,2016,3932,2044,1888,108.3,3875,2019,1856,108.8
37320, 의성군,055001, 50세,2016,679,396,283,139.9,669,391,278,140.6
37320, 의성군,055002, 51세,2016,781,402,379,106.1,770,397,373,106.4
37320, 의성군,055003, 52세,2016,701,337,364,92.6,690,334,356,93.8
37320, 의성군,055004, 53세,2016,761,388,373,104,753,383,370,103.5
37320, 의성군,055005, 54세,2016,1010,521,489,106.5,993,514,479,107.3
37320, 의성군,060,55~59세,2016,5425,2728,2697,101.1,5373,2701,2672,101.1
37320, 의성군,060001, 55세,2016,1010,504,506,99.6,1005,502,503,99.8
37320, 의성군,060002, 56세,2016,1163,573,590,97.1,1149,565,584,96.7
37320, 의성군,060003, 57세,2016,1044,528,516,102.3,1036,524,512,102.3
37320, 의성군,060004, 58세,2016,1089,545,544,100.2,1074,536,538,99.6
37320, 의성군,060005, 59세,2016,1119,578,541,106.8,1109,574,535,107.3
37320, 의성군,065,60~64세,2016,5269,2560,2709,94.5,5245,2545,2700,94.3
37320, 의성군,065001, 60세,2016,1078,555,523,106.1,1069,550,519,106
37320, 의성군,065002, 61세,2016,1074,500,574,87.1,1072,498,574,86.8
37320, 의성군,065003, 62세,2016,1035,502,533,94.2,1030,499,531,94
37320, 의성군,065004, 63세,2016,1020,492,528,93.2,1014,488,526,92.8
37320, 의성군,065005, 64세,2016,1062,511,551,92.7,1060,510,550,92.7
37320, 의성군,070,65~69세,2016,4659,2185,2474,88.3,4641,2175,2466,88.2
37320, 의성군,070001, 65세,2016,916,445,471,94.5,912,442,470,94
37320, 의성군,070002, 66세,2016,903,416,487,85.4,895,413,482,85.7
37320, 의성군,070003, 67세,2016,974,451,523,86.2,971,448,523,85.7
37320, 의성군,070004, 68세,2016,961,464,497,93.4,958,463,495,93.5
37320, 의성군,070005, 69세,2016,905,409,496,82.5,905,409,496,82.5
37320, 의성군,075,70~74세,2016,4426,1918,2508,76.5,4418,1916,2502,76.6
37320, 의성군,075001, 70세,2016,589,278,311,89.4,584,277,307,90.2
37320, 의성군,075002, 71세,2016,675,293,382,76.7,674,292,382,76.4
37320, 의성군,075003, 72세,2016,851,355,496,71.6,849,355,494,71.9
37320, 의성군,075004, 73세,2016,1071,455,616,73.9,1071,455,616,73.9
37320, 의성군,075005, 74세,2016,1240,537,703,76.4,1240,537,703,76.4
37320, 의성군,080,75~79세,2016,4790,1893,2897,65.3,4787,1891,2896,65.3
37320, 의성군,080001, 75세,2016,968,410,558,73.5,967,409,558,73.3
37320, 의성군,080002, 76세,2016,895,380,515,73.8,894,379,515,73.6
37320, 의성군,080003, 77세,2016,1123,456,667,68.4,1122,456,666,68.5
37320, 의성군,080004, 78세,2016,918,332,586,56.7,918,332,586,56.7
37320, 의성군,080005, 79세,2016,886,315,571,55.2,886,315,571,55.2
37320, 의성군,085,80~84세,2016,3393,1188,2205,53.9,3393,1188,2205,53.9
37320, 의성군,085001, 80세,2016,805,303,502,60.4,805,303,502,60.4
37320, 의성군,085002, 81세,2016,820,296,524,56.5,820,296,524,56.5
37320, 의성군,085003, 82세,2016,705,241,464,51.9,705,241,464,51.9
37320, 의성군,085004, 83세,2016,569,186,383,48.6,569,186,383,48.6
37320, 의성군,085005, 84세,2016,494,162,332,48.8,494,162,332,48.8
37320, 의성군,090,85~89세,2016,1408,411,997,41.2,1407,410,997,41.1
37320, 의성군,090001, 85세,2016,353,104,249,41.8,353,104,249,41.8
37320, 의성군,090002, 86세,2016,334,114,220,51.8,334,114,220,51.8
37320, 의성군,090003, 87세,2016,274,77,197,39.1,273,76,197,38.6
37320, 의성군,090004, 88세,2016,247,54,193,28,247,54,193,28
37320, 의성군,090005, 89세,2016,200,62,138,44.9,200,62,138,44.9
37320, 의성군,095,90~94세,2016,461,107,354,30.2,460,106,354,29.9
37320, 의성군,095001, 90세,2016,137,39,98,39.8,136,38,98,38.8
37320, 의성군,095002, 91세,2016,118,27,91,29.7,118,27,91,29.7
37320, 의성군,095003, 92세,2016,75,12,63,19,75,12,63,19
37320, 의성군,095004, 93세,2016,68,19,49,38.8,68,19,49,38.8
37320, 의성군,095005, 94세,2016,63,10,53,18.9,63,10,53,18.9
37320, 의성군,100,95~99세,2016,83,11,72,15.3,83,11,72,15.3
37320, 의성군,100001, 95세,2016,27,6,21,28.6,27,6,21,28.6
37320, 의성군,100002, 96세,2016,28,X,28,0,28,X,28,0
37320, 의성군,100003, 97세,2016,16,X,12,33.3,16,X,12,33.3
37320, 의성군,100004, 98세,2016,5,X,5,0,5,X,5,0
37320, 의성군,100005, 99세,2016,7,X,6,16.7,7,X,6,16.7
37320, 의성군,101,100세이상,2016,7,X,6,16.7,7,X,6,16.7
37320, 의성군,102,15세미만,2016,3286,1730,1556,111.2,3279,1728,1551,111.4
37320, 의성군,103,15~64세,2016,28170,15085,13085,115.3,27284,14535,12749,114
37320, 의성군,104,65세이상,2016,19227,7714,11513,67,19196,7698,11498,67
37320, 의성군,086,85세이상,2016,1959,530,1429,37.1,1957,528,1429,36.9
37320, 의성군,126,평균연령,2016,55.3,52.4,58.1,,55.7,52.8,58.4,
37320, 의성군,127,중위연령,2016,59.2,56.4,62.1,,59.6,56.8,62.4,
37330, 청송군,000,합계,2016,24593,12121,12472,97.2,24262,11973,12289,97.4
37330, 청송군,005,0~4세,2016,629,300,329,91.2,629,300,329,91.2
37330, 청송군,005001, 0세,2016,121,62,59,105.1,121,62,59,105.1
37330, 청송군,005002, 1세,2016,135,61,74,82.4,135,61,74,82.4
37330, 청송군,005003, 2세,2016,130,63,67,94,130,63,67,94
37330, 청송군,005004, 3세,2016,120,53,67,79.1,120,53,67,79.1
37330, 청송군,005005, 4세,2016,123,61,62,98.4,123,61,62,98.4
37330, 청송군,010,5~9세,2016,558,290,268,108.2,557,290,267,108.6
37330, 청송군,010001, 5세,2016,119,65,54,120.4,118,65,53,122.6
37330, 청송군,010002, 6세,2016,98,49,49,100,98,49,49,100
37330, 청송군,010003, 7세,2016,117,60,57,105.3,117,60,57,105.3
37330, 청송군,010004, 8세,2016,111,64,47,136.2,111,64,47,136.2
37330, 청송군,010005, 9세,2016,113,52,61,85.2,113,52,61,85.2
37330, 청송군,015,10~14세,2016,621,324,297,109.1,621,324,297,109.1
37330, 청송군,015001, 10세,2016,105,52,53,98.1,105,52,53,98.1
37330, 청송군,015002, 11세,2016,117,64,53,120.8,117,64,53,120.8
37330, 청송군,015003, 12세,2016,123,67,56,119.6,123,67,56,119.6
37330, 청송군,015004, 13세,2016,141,73,68,107.4,141,73,68,107.4
37330, 청송군,015005, 14세,2016,135,68,67,101.5,135,68,67,101.5
37330, 청송군,020,15~19세,2016,753,435,318,136.8,749,434,315,137.8
37330, 청송군,020001, 15세,2016,155,85,70,121.4,155,85,70,121.4
37330, 청송군,020002, 16세,2016,184,110,74,148.6,183,109,74,147.3
37330, 청송군,020003, 17세,2016,163,85,78,109,162,85,77,110.4
37330, 청송군,020004, 18세,2016,155,85,70,121.4,155,85,70,121.4
37330, 청송군,020005, 19세,2016,96,70,26,269.2,94,70,24,291.7
37330, 청송군,025,20~24세,2016,877,535,342,156.4,832,515,317,162.5
37330, 청송군,025001, 20세,2016,165,120,45,266.7,164,119,45,264.4
37330, 청송군,025002, 21세,2016,171,108,63,171.4,164,106,58,182.8
37330, 청송군,025003, 22세,2016,181,98,83,118.1,170,91,79,115.2
37330, 청송군,025004, 23세,2016,154,87,67,129.9,143,81,62,130.6
37330, 청송군,025005, 24세,2016,206,122,84,145.2,191,118,73,161.6
37330, 청송군,030,25~29세,2016,867,494,373,132.4,812,466,346,134.7
37330, 청송군,030001, 25세,2016,158,85,73,116.4,152,80,72,111.1
37330, 청송군,030002, 26세,2016,193,104,89,116.9,176,96,80,120
37330, 청송군,030003, 27세,2016,166,102,64,159.4,157,97,60,161.7
37330, 청송군,030004, 28세,2016,170,103,67,153.7,155,96,59,162.7
37330, 청송군,030005, 29세,2016,180,100,80,125,172,97,75,129.3
37330, 청송군,035,30~34세,2016,959,532,427,124.6,901,510,391,130.4
37330, 청송군,035001, 30세,2016,205,123,82,150,190,116,74,156.8
37330, 청송군,035002, 31세,2016,182,110,72,152.8,172,108,64,168.8
37330, 청송군,035003, 32세,2016,167,83,84,98.8,157,79,78,101.3
37330, 청송군,035004, 33세,2016,204,113,91,124.2,193,109,84,129.8
37330, 청송군,035005, 34세,2016,201,103,98,105.1,189,98,91,107.7
37330, 청송군,040,35~39세,2016,997,554,443,125.1,965,540,425,127.1
37330, 청송군,040001, 35세,2016,211,120,91,131.9,202,116,86,134.9
37330, 청송군,040002, 36세,2016,213,123,90,136.7,203,119,84,141.7
37330, 청송군,040003, 37세,2016,193,103,90,114.4,190,102,88,115.9
37330, 청송군,040004, 38세,2016,170,93,77,120.8,164,90,74,121.6
37330, 청송군,040005, 39세,2016,210,115,95,121.1,206,113,93,121.5
37330, 청송군,045,40~44세,2016,1189,672,517,130,1161,655,506,129.4
37330, 청송군,045001, 40세,2016,210,112,98,114.3,204,109,95,114.7
37330, 청송군,045002, 41세,2016,215,119,96,124,210,115,95,121.1
37330, 청송군,045003, 42세,2016,268,158,110,143.6,258,152,106,143.4
37330, 청송군,045004, 43세,2016,241,140,101,138.6,237,137,100,137
37330, 청송군,045005, 44세,2016,255,143,112,127.7,252,142,110,129.1
37330, 청송군,050,45~49세,2016,1681,917,764,120,1652,907,745,121.7
37330, 청송군,050001, 45세,2016,269,158,111,142.3,261,154,107,143.9
37330, 청송군,050002, 46세,2016,333,182,151,120.5,329,180,149,120.8
37330, 청송군,050003, 47세,2016,358,206,152,135.5,354,206,148,139.2
37330, 청송군,050004, 48세,2016,360,183,177,103.4,354,181,173,104.6
37330, 청송군,050005, 49세,2016,361,188,173,108.7,354,186,168,110.7
37330, 청송군,055,50~54세,2016,2125,1116,1009,110.6,2095,1103,992,111.2
37330, 청송군,055001, 50세,2016,392,221,171,129.2,383,217,166,130.7
37330, 청송군,055002, 51세,2016,404,215,189,113.8,398,212,186,114
37330, 청송군,055003, 52세,2016,391,199,192,103.6,386,195,191,102.1
37330, 청송군,055004, 53세,2016,431,227,204,111.3,428,226,202,111.9
37330, 청송군,055005, 54세,2016,507,254,253,100.4,500,253,247,102.4
37330, 청송군,060,55~59세,2016,2586,1292,1294,99.8,2570,1285,1285,100
37330, 청송군,060001, 55세,2016,529,277,252,109.9,524,276,248,111.3
37330, 청송군,060002, 56세,2016,545,270,275,98.2,541,270,271,99.6
37330, 청송군,060003, 57세,2016,506,244,262,93.1,504,242,262,92.4
37330, 청송군,060004, 58세,2016,500,257,243,105.8,497,254,243,104.5
37330, 청송군,060005, 59세,2016,506,244,262,93.1,504,243,261,93.1
37330, 청송군,065,60~64세,2016,2464,1201,1263,95.1,2447,1191,1256,94.8
37330, 청송군,065001, 60세,2016,535,252,283,89,531,248,283,87.6
37330, 청송군,065002, 61세,2016,490,247,243,101.6,486,245,241,101.7
37330, 청송군,065003, 62세,2016,473,242,231,104.8,467,239,228,104.8
37330, 청송군,065004, 63세,2016,467,233,234,99.6,466,233,233,100
37330, 청송군,065005, 64세,2016,499,227,272,83.5,497,226,271,83.4
37330, 청송군,070,65~69세,2016,2143,1058,1085,97.5,2139,1057,1082,97.7
37330, 청송군,070001, 65세,2016,422,214,208,102.9,422,214,208,102.9
37330, 청송군,070002, 66세,2016,406,206,200,103,406,206,200,103
37330, 청송군,070003, 67세,2016,425,214,211,101.4,423,213,210,101.4
37330, 청송군,070004, 68세,2016,453,221,232,95.3,452,221,231,95.7
37330, 청송군,070005, 69세,2016,437,203,234,86.8,436,203,233,87.1
37330, 청송군,075,70~74세,2016,2040,873,1167,74.8,2031,868,1163,74.6
37330, 청송군,075001, 70세,2016,288,124,164,75.6,286,123,163,75.5
37330, 청송군,075002, 71세,2016,346,163,183,89.1,344,162,182,89
37330, 청송군,075003, 72세,2016,429,182,247,73.7,426,180,246,73.2
37330, 청송군,075004, 73세,2016,448,196,252,77.8,447,196,251,78.1
37330, 청송군,075005, 74세,2016,529,208,321,64.8,528,207,321,64.5
37330, 청송군,080,75~79세,2016,1988,797,1191,66.9,1986,797,1189,67
37330, 청송군,080001, 75세,2016,439,178,261,68.2,439,178,261,68.2
37330, 청송군,080002, 76세,2016,419,176,243,72.4,418,176,242,72.7
37330, 청송군,080003, 77세,2016,457,185,272,68,457,185,272,68
37330, 청송군,080004, 78세,2016,355,145,210,69,354,145,209,69.4
37330, 청송군,080005, 79세,2016,318,113,205,55.1,318,113,205,55.1
37330, 청송군,085,80~84세,2016,1311,500,811,61.7,1311,500,811,61.7
37330, 청송군,085001, 80세,2016,337,133,204,65.2,337,133,204,65.2
37330, 청송군,085002, 81세,2016,328,120,208,57.7,328,120,208,57.7
37330, 청송군,085003, 82세,2016,253,96,157,61.1,253,96,157,61.1
37330, 청송군,085004, 83세,2016,190,75,115,65.2,190,75,115,65.2
37330, 청송군,085005, 84세,2016,203,76,127,59.8,203,76,127,59.8
37330, 청송군,090,85~89세,2016,575,181,394,45.9,574,181,393,46.1
37330, 청송군,090001, 85세,2016,165,54,111,48.6,165,54,111,48.6
37330, 청송군,090002, 86세,2016,119,35,84,41.7,119,35,84,41.7
37330, 청송군,090003, 87세,2016,109,33,76,43.4,109,33,76,43.4
37330, 청송군,090004, 88세,2016,107,34,73,46.6,107,34,73,46.6
37330, 청송군,090005, 89세,2016,75,25,50,50,74,25,49,51
37330, 청송군,095,90~94세,2016,179,42,137,30.7,179,42,137,30.7
37330, 청송군,095001, 90세,2016,66,18,48,37.5,66,18,48,37.5
37330, 청송군,095002, 91세,2016,44,11,33,33.3,44,11,33,33.3
37330, 청송군,095003, 92세,2016,33,5,28,17.9,33,5,28,17.9
37330, 청송군,095004, 93세,2016,19,X,16,18.8,19,X,16,18.8
37330, 청송군,095005, 94세,2016,17,5,12,41.7,17,5,12,41.7
37330, 청송군,100,95~99세,2016,48,8,40,20,48,8,40,20
37330, 청송군,100001, 95세,2016,21,X,17,23.5,21,X,17,23.5
37330, 청송군,100002, 96세,2016,9,X,6,50,9,X,6,50
37330, 청송군,100003, 97세,2016,10,X,9,11.1,10,X,9,11.1
37330, 청송군,100004, 98세,2016,6,X,6,0,6,X,6,0
37330, 청송군,100005, 99세,2016,X,X,X,0,X,X,X,0
37330, 청송군,101,100세이상,2016,X,X,X,0,X,X,X,0
37330, 청송군,102,15세미만,2016,1808,914,894,102.2,1807,914,893,102.4
37330, 청송군,103,15~64세,2016,14498,7748,6750,114.8,14184,7606,6578,115.6
37330, 청송군,104,65세이상,2016,8287,3459,4828,71.6,8271,3453,4818,71.7
37330, 청송군,086,85세이상,2016,805,231,574,40.2,804,231,573,40.3
37330, 청송군,126,평균연령,2016,53.3,50.8,55.6,,53.5,51,55.9,
37330, 청송군,127,중위연령,2016,56.9,54.6,59.4,,57.2,54.8,59.7,
37340, 영양군,000,합계,2016,16755,8064,8691,92.8,16519,7990,8529,93.7
37340, 영양군,005,0~4세,2016,460,247,213,116,460,247,213,116
37340, 영양군,005001, 0세,2016,75,47,28,167.9,75,47,28,167.9
37340, 영양군,005002, 1세,2016,102,46,56,82.1,102,46,56,82.1
37340, 영양군,005003, 2세,2016,99,49,50,98,99,49,50,98
37340, 영양군,005004, 3세,2016,101,55,46,119.6,101,55,46,119.6
37340, 영양군,005005, 4세,2016,83,50,33,151.5,83,50,33,151.5
37340, 영양군,010,5~9세,2016,472,254,218,116.5,472,254,218,116.5
37340, 영양군,010001, 5세,2016,85,53,32,165.6,85,53,32,165.6
37340, 영양군,010002, 6세,2016,99,49,50,98,99,49,50,98
37340, 영양군,010003, 7세,2016,76,45,31,145.2,76,45,31,145.2
37340, 영양군,010004, 8세,2016,105,52,53,98.1,105,52,53,98.1
37340, 영양군,010005, 9세,2016,107,55,52,105.8,107,55,52,105.8
37340, 영양군,015,10~14세,2016,462,234,228,102.6,462,234,228,102.6
37340, 영양군,015001, 10세,2016,80,43,37,116.2,80,43,37,116.2
37340, 영양군,015002, 11세,2016,91,44,47,93.6,91,44,47,93.6
37340, 영양군,015003, 12세,2016,83,41,42,97.6,83,41,42,97.6
37340, 영양군,015004, 13세,2016,97,47,50,94,97,47,50,94
37340, 영양군,015005, 14세,2016,111,59,52,113.5,111,59,52,113.5
37340, 영양군,020,15~19세,2016,761,300,461,65.1,760,300,460,65.2
37340, 영양군,020001, 15세,2016,139,56,83,67.5,139,56,83,67.5
37340, 영양군,020002, 16세,2016,233,73,160,45.6,233,73,160,45.6
37340, 영양군,020003, 17세,2016,168,63,105,60,167,63,104,60.6
37340, 영양군,020004, 18세,2016,161,71,90,78.9,161,71,90,78.9
37340, 영양군,020005, 19세,2016,60,37,23,160.9,60,37,23,160.9
37340, 영양군,025,20~24세,2016,541,330,211,156.4,510,315,195,161.5
37340, 영양군,025001, 20세,2016,86,59,27,218.5,86,59,27,218.5
37340, 영양군,025002, 21세,2016,122,89,33,269.7,115,88,27,325.9
37340, 영양군,025003, 22세,2016,114,77,37,208.1,108,74,34,217.6
37340, 영양군,025004, 23세,2016,96,49,47,104.3,89,45,44,102.3
37340, 영양군,025005, 24세,2016,123,56,67,83.6,112,49,63,77.8
37340, 영양군,030,25~29세,2016,547,290,257,112.8,504,282,222,127
37340, 영양군,030001, 25세,2016,115,56,59,94.9,102,53,49,108.2
37340, 영양군,030002, 26세,2016,101,47,54,87,92,46,46,100
37340, 영양군,030003, 27세,2016,108,66,42,157.1,100,63,37,170.3
37340, 영양군,030004, 28세,2016,98,54,44,122.7,92,54,38,142.1
37340, 영양군,030005, 29세,2016,125,67,58,115.5,118,66,52,126.9
37340, 영양군,035,30~34세,2016,570,283,287,98.6,537,276,261,105.7
37340, 영양군,035001, 30세,2016,132,67,65,103.1,121,63,58,108.6
37340, 영양군,035002, 31세,2016,71,35,36,97.2,66,34,32,106.3
37340, 영양군,035003, 32세,2016,101,60,41,146.3,99,60,39,153.8
37340, 영양군,035004, 33세,2016,133,59,74,79.7,124,58,66,87.9
37340, 영양군,035005, 34세,2016,133,62,71,87.3,127,61,66,92.4
37340, 영양군,040,35~39세,2016,659,358,301,118.9,642,355,287,123.7
37340, 영양군,040001, 35세,2016,125,74,51,145.1,121,73,48,152.1
37340, 영양군,040002, 36세,2016,139,63,76,82.9,138,63,75,84
37340, 영양군,040003, 37세,2016,120,64,56,114.3,118,63,55,114.5
37340, 영양군,040004, 38세,2016,138,81,57,142.1,133,80,53,150.9
37340, 영양군,040005, 39세,2016,137,76,61,124.6,132,76,56,135.7
37340, 영양군,045,40~44세,2016,870,511,359,142.3,849,505,344,146.8
37340, 영양군,045001, 40세,2016,142,87,55,158.2,139,85,54,157.4
37340, 영양군,045002, 41세,2016,154,84,70,120,149,83,66,125.8
37340, 영양군,045003, 42세,2016,184,110,74,148.6,179,110,69,159.4
37340, 영양군,045004, 43세,2016,189,116,73,158.9,186,115,71,162
37340, 영양군,045005, 44세,2016,201,114,87,131,196,112,84,133.3
37340, 영양군,050,45~49세,2016,1124,653,471,138.6,1095,644,451,142.8
37340, 영양군,050001, 45세,2016,218,132,86,153.5,217,132,85,155.3
37340, 영양군,050002, 46세,2016,223,117,106,110.4,219,117,102,114.7
37340, 영양군,050003, 47세,2016,240,152,88,172.7,237,150,87,172.4
37340, 영양군,050004, 48세,2016,233,132,101,130.7,224,129,95,135.8
37340, 영양군,050005, 49세,2016,210,120,90,133.3,198,116,82,141.5
37340, 영양군,055,50~54세,2016,1350,691,659,104.9,1329,680,649,104.8
37340, 영양군,055001, 50세,2016,277,148,129,114.7,273,147,126,116.7
37340, 영양군,055002, 51세,2016,235,119,116,102.6,232,116,116,100
37340, 영양군,055003, 52세,2016,245,136,109,124.8,238,133,105,126.7
37340, 영양군,055004, 53세,2016,289,137,152,90.1,285,135,150,90
37340, 영양군,055005, 54세,2016,304,151,153,98.7,301,149,152,98
37340, 영양군,060,55~59세,2016,1695,836,859,97.3,1672,828,844,98.1
37340, 영양군,060001, 55세,2016,396,208,188,110.6,392,207,185,111.9
37340, 영양군,060002, 56세,2016,379,181,198,91.4,373,179,194,92.3
37340, 영양군,060003, 57세,2016,280,151,129,117.1,273,149,124,120.2
37340, 영양군,060004, 58세,2016,331,166,165,100.6,326,164,162,101.2
37340, 영양군,060005, 59세,2016,309,130,179,72.6,308,129,179,72.1
37340, 영양군,065,60~64세,2016,1584,806,778,103.6,1575,802,773,103.8
37340, 영양군,065001, 60세,2016,340,166,174,95.4,339,166,173,96
37340, 영양군,065002, 61세,2016,349,186,163,114.1,345,184,161,114.3
37340, 영양군,065003, 62세,2016,306,156,150,104,304,155,149,104
37340, 영양군,065004, 63세,2016,288,150,138,108.7,287,149,138,108
37340, 영양군,065005, 64세,2016,301,148,153,96.7,300,148,152,97.4
37340, 영양군,070,65~69세,2016,1356,653,703,92.9,1351,650,701,92.7
37340, 영양군,070001, 65세,2016,245,114,131,87,245,114,131,87
37340, 영양군,070002, 66세,2016,252,118,134,88.1,250,117,133,88
37340, 영양군,070003, 67세,2016,328,167,161,103.7,326,166,160,103.8
37340, 영양군,070004, 68세,2016,292,144,148,97.3,292,144,148,97.3
37340, 영양군,070005, 69세,2016,239,110,129,85.3,238,109,129,84.5
37340, 영양군,075,70~74세,2016,1399,602,797,75.5,1397,602,795,75.7
37340, 영양군,075001, 70세,2016,205,94,111,84.7,204,94,110,85.5
37340, 영양군,075002, 71세,2016,236,96,140,68.6,236,96,140,68.6
37340, 영양군,075003, 72세,2016,262,106,156,67.9,262,106,156,67.9
37340, 영양군,075004, 73세,2016,318,142,176,80.7,317,142,175,81.1
37340, 영양군,075005, 74세,2016,378,164,214,76.6,378,164,214,76.6
37340, 영양군,080,75~79세,2016,1442,569,873,65.2,1441,569,872,65.3
37340, 영양군,080001, 75세,2016,329,137,192,71.4,329,137,192,71.4
37340, 영양군,080002, 76세,2016,305,129,176,73.3,304,129,175,73.7
37340, 영양군,080003, 77세,2016,308,131,177,74,308,131,177,74
37340, 영양군,080004, 78세,2016,254,88,166,53,254,88,166,53
37340, 영양군,080005, 79세,2016,246,84,162,51.9,246,84,162,51.9
37340, 영양군,085,80~84세,2016,888,291,597,48.7,888,291,597,48.7
37340, 영양군,085001, 80세,2016,208,73,135,54.1,208,73,135,54.1
37340, 영양군,085002, 81세,2016,225,76,149,51,225,76,149,51
37340, 영양군,085003, 82세,2016,181,52,129,40.3,181,52,129,40.3
37340, 영양군,085004, 83세,2016,144,48,96,50,144,48,96,50
37340, 영양군,085005, 84세,2016,130,42,88,47.7,130,42,88,47.7
37340, 영양군,090,85~89세,2016,410,109,301,36.2,410,109,301,36.2
37340, 영양군,090001, 85세,2016,120,25,95,26.3,120,25,95,26.3
37340, 영양군,090002, 86세,2016,89,28,61,45.9,89,28,61,45.9
37340, 영양군,090003, 87세,2016,80,26,54,48.1,80,26,54,48.1
37340, 영양군,090004, 88세,2016,74,19,55,34.5,74,19,55,34.5
37340, 영양군,090005, 89세,2016,47,11,36,30.6,47,11,36,30.6
37340, 영양군,095,90~94세,2016,134,41,93,44.1,134,41,93,44.1
37340, 영양군,095001, 90세,2016,46,11,35,31.4,46,11,35,31.4
37340, 영양군,095002, 91세,2016,27,8,19,42.1,27,8,19,42.1
37340, 영양군,095003, 92세,2016,26,11,15,73.3,26,11,15,73.3
37340, 영양군,095004, 93세,2016,20,5,15,33.3,20,5,15,33.3
37340, 영양군,095005, 94세,2016,15,6,9,66.7,15,6,9,66.7
37340, 영양군,100,95~99세,2016,27,6,21,28.6,27,6,21,28.6
37340, 영양군,100001, 95세,2016,10,X,7,42.9,10,X,7,42.9
37340, 영양군,100002, 96세,2016,7,X,7,0,7,X,7,0
37340, 영양군,100003, 97세,2016,X,X,X,100,X,X,X,100
37340, 영양군,100004, 98세,2016,5,X,X,66.7,5,X,X,66.7
37340, 영양군,100005, 99세,2016,X,X,X,0,X,X,X,0
37340, 영양군,101,100세이상,2016,X,X,X,0,X,X,X,0
37340, 영양군,102,15세미만,2016,1394,735,659,111.5,1394,735,659,111.5
37340, 영양군,103,15~64세,2016,9701,5058,4643,108.9,9473,4987,4486,111.2
37340, 영양군,104,65세이상,2016,5660,2271,3389,67,5652,2268,3384,67
37340, 영양군,086,85세이상,2016,575,156,419,37.2,575,156,419,37.2
37340, 영양군,126,평균연령,2016,52.6,50.3,54.7,,52.8,50.4,55,
37340, 영양군,127,중위연령,2016,56.4,54.2,59,,56.7,54.3,59.4,
37350, 영덕군,000,합계,2016,36765,17773,18992,93.6,35686,16946,18740,90.4
37350, 영덕군,005,0~4세,2016,972,497,475,104.6,971,497,474,104.9
37350, 영덕군,005001, 0세,2016,173,87,86,101.2,172,87,85,102.4
37350, 영덕군,005002, 1세,2016,199,102,97,105.2,199,102,97,105.2
37350, 영덕군,005003, 2세,2016,195,96,99,97,195,96,99,97
37350, 영덕군,005004, 3세,2016,201,105,96,109.4,201,105,96,109.4
37350, 영덕군,005005, 4세,2016,204,107,97,110.3,204,107,97,110.3
37350, 영덕군,010,5~9세,2016,950,488,462,105.6,950,488,462,105.6
37350, 영덕군,010001, 5세,2016,177,88,89,98.9,177,88,89,98.9
37350, 영덕군,010002, 6세,2016,203,101,102,99,203,101,102,99
37350, 영덕군,010003, 7세,2016,185,94,91,103.3,185,94,91,103.3
37350, 영덕군,010004, 8세,2016,158,81,77,105.2,158,81,77,105.2
37350, 영덕군,010005, 9세,2016,227,124,103,120.4,227,124,103,120.4
37350, 영덕군,015,10~14세,2016,1088,548,540,101.5,1084,546,538,101.5
37350, 영덕군,015001, 10세,2016,212,104,108,96.3,211,104,107,97.2
37350, 영덕군,015002, 11세,2016,207,103,104,99,204,101,103,98.1
37350, 영덕군,015003, 12세,2016,224,113,111,101.8,224,113,111,101.8
37350, 영덕군,015004, 13세,2016,213,109,104,104.8,213,109,104,104.8
37350, 영덕군,015005, 14세,2016,232,119,113,105.3,232,119,113,105.3
37350, 영덕군,020,15~19세,2016,1190,647,543,119.2,1190,647,543,119.2
37350, 영덕군,020001, 15세,2016,247,130,117,111.1,247,130,117,111.1
37350, 영덕군,020002, 16세,2016,274,142,132,107.6,274,142,132,107.6
37350, 영덕군,020003, 17세,2016,285,144,141,102.1,285,144,141,102.1
37350, 영덕군,020004, 18세,2016,237,124,113,109.7,237,124,113,109.7
37350, 영덕군,020005, 19세,2016,147,107,40,267.5,147,107,40,267.5
37350, 영덕군,025,20~24세,2016,1302,827,475,174.1,1140,699,441,158.5
37350, 영덕군,025001, 20세,2016,219,160,59,271.2,216,158,58,272.4
37350, 영덕군,025002, 21세,2016,261,190,71,267.6,242,171,71,240.8
37350, 영덕군,025003, 22세,2016,265,167,98,170.4,220,133,87,152.9
37350, 영덕군,025004, 23세,2016,247,140,107,130.8,215,114,101,112.9
37350, 영덕군,025005, 24세,2016,310,170,140,121.4,247,123,124,99.2
37350, 영덕군,030,25~29세,2016,1336,804,532,151.1,1089,618,471,131.2
37350, 영덕군,030001, 25세,2016,286,185,101,183.2,230,136,94,144.7
37350, 영덕군,030002, 26세,2016,280,172,108,159.3,230,134,96,139.6
37350, 영덕군,030003, 27세,2016,265,154,111,138.7,218,125,93,134.4
37350, 영덕군,030004, 28세,2016,233,139,94,147.9,188,106,82,129.3
37350, 영덕군,030005, 29세,2016,272,154,118,130.5,223,117,106,110.4
37350, 영덕군,035,30~34세,2016,1518,850,668,127.2,1312,690,622,110.9
37350, 영덕군,035001, 30세,2016,263,154,109,141.3,213,113,100,113
37350, 영덕군,035002, 31세,2016,282,157,125,125.6,242,127,115,110.4
37350, 영덕군,035003, 32세,2016,300,160,140,114.3,260,131,129,101.6
37350, 영덕군,035004, 33세,2016,319,183,136,134.6,281,151,130,116.2
37350, 영덕군,035005, 34세,2016,354,196,158,124.1,316,168,148,113.5
37350, 영덕군,040,35~39세,2016,1672,941,731,128.7,1513,802,711,112.8
37350, 영덕군,040001, 35세,2016,318,177,141,125.5,286,148,138,107.2
37350, 영덕군,040002, 36세,2016,332,191,141,135.5,299,162,137,118.2
37350, 영덕군,040003, 37세,2016,349,198,151,131.1,312,166,146,113.7
37350, 영덕군,040004, 38세,2016,334,189,145,130.3,301,161,140,115
37350, 영덕군,040005, 39세,2016,339,186,153,121.6,315,165,150,110
37350, 영덕군,045,40~44세,2016,2020,1212,808,150,1892,1103,789,139.8
37350, 영덕군,045001, 40세,2016,378,219,159,137.7,345,192,153,125.5
37350, 영덕군,045002, 41세,2016,333,192,141,136.2,306,168,138,121.7
37350, 영덕군,045003, 42세,2016,408,238,170,140,391,224,167,134.1
37350, 영덕군,045004, 43세,2016,447,279,168,166.1,423,258,165,156.4
37350, 영덕군,045005, 44세,2016,454,284,170,167.1,427,261,166,157.2
37350, 영덕군,050,45~49세,2016,2470,1423,1047,135.9,2407,1377,1030,133.7
37350, 영덕군,050001, 45세,2016,462,254,208,122.1,452,248,204,121.6
37350, 영덕군,050002, 46세,2016,482,302,180,167.8,463,284,179,158.7
37350, 영덕군,050003, 47세,2016,493,289,204,141.7,479,277,202,137.1
37350, 영덕군,050004, 48세,2016,563,317,246,128.9,549,308,241,127.8
37350, 영덕군,050005, 49세,2016,470,261,209,124.9,464,260,204,127.5
37350, 영덕군,055,50~54세,2016,2919,1511,1408,107.3,2875,1491,1384,107.7
37350, 영덕군,055001, 50세,2016,541,285,256,111.3,534,282,252,111.9
37350, 영덕군,055002, 51세,2016,542,287,255,112.5,529,284,245,115.9
37350, 영덕군,055003, 52세,2016,562,273,289,94.5,553,266,287,92.7
37350, 영덕군,055004, 53세,2016,630,325,305,106.6,622,321,301,106.6
37350, 영덕군,055005, 54세,2016,644,341,303,112.5,637,338,299,113
37350, 영덕군,060,55~59세,2016,3565,1732,1833,94.5,3529,1714,1815,94.4
37350, 영덕군,060001, 55세,2016,735,385,350,110,729,382,347,110.1
37350, 영덕군,060002, 56세,2016,756,363,393,92.4,748,356,392,90.8
37350, 영덕군,060003, 57세,2016,675,301,374,80.5,672,300,372,80.6
37350, 영덕군,060004, 58세,2016,698,363,335,108.4,689,360,329,109.4
37350, 영덕군,060005, 59세,2016,701,320,381,84,691,316,375,84.3
37350, 영덕군,065,60~64세,2016,3398,1597,1801,88.7,3382,1584,1798,88.1
37350, 영덕군,065001, 60세,2016,689,342,347,98.6,685,339,346,98
37350, 영덕군,065002, 61세,2016,703,329,374,88,698,325,373,87.1
37350, 영덕군,065003, 62세,2016,670,304,366,83.1,667,301,366,82.2
37350, 영덕군,065004, 63세,2016,673,321,352,91.2,671,319,352,90.6
37350, 영덕군,065005, 64세,2016,663,301,362,83.1,661,300,361,83.1
37350, 영덕군,070,65~69세,2016,3112,1435,1677,85.6,3104,1430,1674,85.4
37350, 영덕군,070001, 65세,2016,584,288,296,97.3,583,288,295,97.6
37350, 영덕군,070002, 66세,2016,563,249,314,79.3,559,245,314,78
37350, 영덕군,070003, 67세,2016,695,333,362,92,693,333,360,92.5
37350, 영덕군,070004, 68세,2016,664,281,383,73.4,663,280,383,73.1
37350, 영덕군,070005, 69세,2016,606,284,322,88.2,606,284,322,88.2
37350, 영덕군,075,70~74세,2016,3036,1204,1832,65.7,3033,1203,1830,65.7
37350, 영덕군,075001, 70세,2016,390,170,220,77.3,390,170,220,77.3
37350, 영덕군,075002, 71세,2016,470,179,291,61.5,469,179,290,61.7
37350, 영덕군,075003, 72세,2016,587,207,380,54.5,586,206,380,54.2
37350, 영덕군,075004, 73세,2016,787,328,459,71.5,786,328,458,71.6
37350, 영덕군,075005, 74세,2016,802,320,482,66.4,802,320,482,66.4
37350, 영덕군,080,75~79세,2016,3068,1124,1944,57.8,3066,1124,1942,57.9
37350, 영덕군,080001, 75세,2016,655,237,418,56.7,655,237,418,56.7
37350, 영덕군,080002, 76세,2016,621,239,382,62.6,620,239,381,62.7
37350, 영덕군,080003, 77세,2016,676,242,434,55.8,675,242,433,55.9
37350, 영덕군,080004, 78세,2016,594,215,379,56.7,594,215,379,56.7
37350, 영덕군,080005, 79세,2016,522,191,331,57.7,522,191,331,57.7
37350, 영덕군,085,80~84세,2016,1930,645,1285,50.2,1930,645,1285,50.2
37350, 영덕군,085001, 80세,2016,520,189,331,57.1,520,189,331,57.1
37350, 영덕군,085002, 81세,2016,430,136,294,46.3,430,136,294,46.3
37350, 영덕군,085003, 82세,2016,386,126,260,48.5,386,126,260,48.5
37350, 영덕군,085004, 83세,2016,320,99,221,44.8,320,99,221,44.8
37350, 영덕군,085005, 84세,2016,274,95,179,53.1,274,95,179,53.1
37350, 영덕군,090,85~89세,2016,874,208,666,31.2,874,208,666,31.2
37350, 영덕군,090001, 85세,2016,226,59,167,35.3,226,59,167,35.3
37350, 영덕군,090002, 86세,2016,195,48,147,32.7,195,48,147,32.7
37350, 영덕군,090003, 87세,2016,190,54,136,39.7,190,54,136,39.7
37350, 영덕군,090004, 88세,2016,137,26,111,23.4,137,26,111,23.4
37350, 영덕군,090005, 89세,2016,126,21,105,20,126,21,105,20
37350, 영덕군,095,90~94세,2016,290,69,221,31.2,290,69,221,31.2
37350, 영덕군,095001, 90세,2016,65,12,53,22.6,65,12,53,22.6
37350, 영덕군,095002, 91세,2016,99,21,78,26.9,99,21,78,26.9
37350, 영덕군,095003, 92세,2016,58,14,44,31.8,58,14,44,31.8
37350, 영덕군,095004, 93세,2016,37,9,28,32.1,37,9,28,32.1
37350, 영덕군,095005, 94세,2016,31,13,18,72.2,31,13,18,72.2
37350, 영덕군,100,95~99세,2016,51,11,40,27.5,51,11,40,27.5
37350, 영덕군,100001, 95세,2016,19,X,18,5.6,19,X,18,5.6
37350, 영덕군,100002, 96세,2016,10,X,7,42.9,10,X,7,42.9
37350, 영덕군,100003, 97세,2016,8,X,5,60,8,X,5,60
37350, 영덕군,100004, 98세,2016,6,X,X,50,6,X,X,50
37350, 영덕군,100005, 99세,2016,8,X,6,33.3,8,X,6,33.3
37350, 영덕군,101,100세이상,2016,X,X,X,0,X,X,X,0
37350, 영덕군,102,15세미만,2016,3010,1533,1477,103.8,3005,1531,1474,103.9
37350, 영덕군,103,15~64세,2016,21390,11544,9846,117.2,20329,10725,9604,111.7
37350, 영덕군,104,65세이상,2016,12365,4696,7669,61.2,12352,4690,7662,61.2
37350, 영덕군,086,85세이상,2016,1219,288,931,30.9,1219,288,931,30.9
37350, 영덕군,126,평균연령,2016,52.6,49.2,55.7,,53.1,49.9,55.9,
37350, 영덕군,127,중위연령,2016,56.3,52.3,59.9,,56.9,53.5,60.3,
37360, 청도군,000,합계,2016,41612,19993,21619,92.5,40447,19397,21050,92.1
37360, 청도군,005,0~4세,2016,808,414,394,105.1,808,414,394,105.1
37360, 청도군,005001, 0세,2016,161,84,77,109.1,161,84,77,109.1
37360, 청도군,005002, 1세,2016,167,84,83,101.2,167,84,83,101.2
37360, 청도군,005003, 2세,2016,142,72,70,102.9,142,72,70,102.9
37360, 청도군,005004, 3세,2016,164,82,82,100,164,82,82,100
37360, 청도군,005005, 4세,2016,174,92,82,112.2,174,92,82,112.2
37360, 청도군,010,5~9세,2016,937,470,467,100.6,934,468,466,100.4
37360, 청도군,010001, 5세,2016,198,94,104,90.4,197,93,104,89.4
37360, 청도군,010002, 6세,2016,169,93,76,122.4,169,93,76,122.4
37360, 청도군,010003, 7세,2016,172,82,90,91.1,172,82,90,91.1
37360, 청도군,010004, 8세,2016,198,104,94,110.6,196,103,93,110.8
37360, 청도군,010005, 9세,2016,200,97,103,94.2,200,97,103,94.2
37360, 청도군,015,10~14세,2016,1042,547,495,110.5,1039,545,494,110.3
37360, 청도군,015001, 10세,2016,186,94,92,102.2,185,93,92,101.1
37360, 청도군,015002, 11세,2016,184,87,97,89.7,183,87,96,90.6
37360, 청도군,015003, 12세,2016,209,123,86,143,209,123,86,143
37360, 청도군,015004, 13세,2016,214,115,99,116.2,214,115,99,116.2
37360, 청도군,015005, 14세,2016,249,128,121,105.8,248,127,121,105
37360, 청도군,020,15~19세,2016,2153,1060,1093,97,2152,1060,1092,97.1
37360, 청도군,020001, 15세,2016,362,183,179,102.2,362,183,179,102.2
37360, 청도군,020002, 16세,2016,609,265,344,77,609,265,344,77
37360, 청도군,020003, 17세,2016,491,263,228,115.4,490,263,227,115.9
37360, 청도군,020004, 18세,2016,456,219,237,92.4,456,219,237,92.4
37360, 청도군,020005, 19세,2016,235,130,105,123.8,235,130,105,123.8
37360, 청도군,025,20~24세,2016,1654,965,689,140.1,1425,873,552,158.2
37360, 청도군,025001, 20세,2016,300,190,110,172.7,291,185,106,174.5
37360, 청도군,025002, 21세,2016,296,186,110,169.1,271,176,95,185.3
37360, 청도군,025003, 22세,2016,348,196,152,128.9,307,181,126,143.7
37360, 청도군,025004, 23세,2016,332,189,143,132.2,271,166,105,158.1
37360, 청도군,025005, 24세,2016,378,204,174,117.2,285,165,120,137.5
37360, 청도군,030,25~29세,2016,1678,949,729,130.2,1315,754,561,134.4
37360, 청도군,030001, 25세,2016,334,184,150,122.7,250,140,110,127.3
37360, 청도군,030002, 26세,2016,371,198,173,114.5,294,160,134,119.4
37360, 청도군,030003, 27세,2016,324,186,138,134.8,262,153,109,140.4
37360, 청도군,030004, 28세,2016,302,171,131,130.5,230,131,99,132.3
37360, 청도군,030005, 29세,2016,347,210,137,153.3,279,170,109,156
37360, 청도군,035,30~34세,2016,1635,887,748,118.6,1434,767,667,115
37360, 청도군,035001, 30세,2016,318,175,143,122.4,259,138,121,114
37360, 청도군,035002, 31세,2016,274,152,122,124.6,236,128,108,118.5
37360, 청도군,035003, 32세,2016,327,183,144,127.1,283,155,128,121.1
37360, 청도군,035004, 33세,2016,327,181,146,124,292,160,132,121.2
37360, 청도군,035005, 34세,2016,389,196,193,101.6,364,186,178,104.5
37360, 청도군,040,35~39세,2016,1685,872,813,107.3,1575,811,764,106.2
37360, 청도군,040001, 35세,2016,370,171,199,85.9,350,160,190,84.2
37360, 청도군,040002, 36세,2016,355,182,173,105.2,326,165,161,102.5
37360, 청도군,040003, 37세,2016,340,181,159,113.8,315,166,149,111.4
37360, 청도군,040004, 38세,2016,304,161,143,112.6,286,152,134,113.4
37360, 청도군,040005, 39세,2016,316,177,139,127.3,298,168,130,129.2
37360, 청도군,045,40~44세,2016,2033,1130,903,125.1,1969,1098,871,126.1
37360, 청도군,045001, 40세,2016,360,207,153,135.3,346,201,145,138.6
37360, 청도군,045002, 41세,2016,362,200,162,123.5,347,195,152,128.3
37360, 청도군,045003, 42세,2016,399,236,163,144.8,386,227,159,142.8
37360, 청도군,045004, 43세,2016,444,239,205,116.6,435,233,202,115.3
37360, 청도군,045005, 44세,2016,468,248,220,112.7,455,242,213,113.6
37360, 청도군,050,45~49세,2016,2616,1384,1232,112.3,2561,1356,1205,112.5
37360, 청도군,050001, 45세,2016,463,258,205,125.9,455,256,199,128.6
37360, 청도군,050002, 46세,2016,511,273,238,114.7,498,266,232,114.7
37360, 청도군,050003, 47세,2016,551,293,258,113.6,533,283,250,113.2
37360, 청도군,050004, 48세,2016,574,316,258,122.5,566,311,255,122
37360, 청도군,050005, 49세,2016,517,244,273,89.4,509,240,269,89.2
37360, 청도군,055,50~54세,2016,3287,1732,1555,111.4,3226,1703,1523,111.8
37360, 청도군,055001, 50세,2016,577,313,264,118.6,566,308,258,119.4
37360, 청도군,055002, 51세,2016,603,322,281,114.6,592,316,276,114.5
37360, 청도군,055003, 52세,2016,678,363,315,115.2,665,359,306,117.3
37360, 청도군,055004, 53세,2016,640,314,326,96.3,624,305,319,95.6
37360, 청도군,055005, 54세,2016,789,420,369,113.8,779,415,364,114
37360, 청도군,060,55~59세,2016,4363,2162,2201,98.2,4325,2144,2181,98.3
37360, 청도군,060001, 55세,2016,831,414,417,99.3,824,410,414,99
37360, 청도군,060002, 56세,2016,975,445,530,84,967,444,523,84.9
37360, 청도군,060003, 57세,2016,937,482,455,105.9,928,476,452,105.3
37360, 청도군,060004, 58세,2016,800,392,408,96.1,791,387,404,95.8
37360, 청도군,060005, 59세,2016,820,429,391,109.7,815,427,388,110.1
37360, 청도군,065,60~64세,2016,4170,1998,2172,92,4152,1992,2160,92.2
37360, 청도군,065001, 60세,2016,828,407,421,96.7,823,407,416,97.8
37360, 청도군,065002, 61세,2016,873,393,480,81.9,867,390,477,81.8
37360, 청도군,065003, 62세,2016,791,377,414,91.1,789,376,413,91
37360, 청도군,065004, 63세,2016,779,385,394,97.7,778,385,393,98
37360, 청도군,065005, 64세,2016,899,436,463,94.2,895,434,461,94.1
37360, 청도군,070,65~69세,2016,3789,1849,1940,95.3,3775,1842,1933,95.3
37360, 청도군,070001, 65세,2016,757,342,415,82.4,754,339,415,81.7
37360, 청도군,070002, 66세,2016,794,373,421,88.6,791,371,420,88.3
37360, 청도군,070003, 67세,2016,831,415,416,99.8,827,413,414,99.8
37360, 청도군,070004, 68세,2016,715,378,337,112.2,713,378,335,112.8
37360, 청도군,070005, 69세,2016,692,341,351,97.2,690,341,349,97.7
37360, 청도군,075,70~74세,2016,2938,1286,1652,77.8,2935,1283,1652,77.7
37360, 청도군,075001, 70세,2016,444,210,234,89.7,443,209,234,89.3
37360, 청도군,075002, 71세,2016,444,212,232,91.4,444,212,232,91.4
37360, 청도군,075003, 72세,2016,568,233,335,69.6,568,233,335,69.6
37360, 청도군,075004, 73세,2016,705,309,396,78,704,308,396,77.8
37360, 청도군,075005, 74세,2016,777,322,455,70.8,776,321,455,70.5
37360, 청도군,080,75~79세,2016,3168,1218,1950,62.5,3166,1217,1949,62.4
37360, 청도군,080001, 75세,2016,664,274,390,70.3,663,273,390,70
37360, 청도군,080002, 76세,2016,640,249,391,63.7,640,249,391,63.7
37360, 청도군,080003, 77세,2016,616,235,381,61.7,615,235,380,61.8
37360, 청도군,080004, 78세,2016,646,237,409,57.9,646,237,409,57.9
37360, 청도군,080005, 79세,2016,602,223,379,58.8,602,223,379,58.8
37360, 청도군,085,80~84세,2016,2326,730,1596,45.7,2326,730,1596,45.7
37360, 청도군,085001, 80세,2016,572,189,383,49.3,572,189,383,49.3
37360, 청도군,085002, 81세,2016,505,159,346,46,505,159,346,46
37360, 청도군,085003, 82세,2016,455,161,294,54.8,455,161,294,54.8
37360, 청도군,085004, 83세,2016,430,131,299,43.8,430,131,299,43.8
37360, 청도군,085005, 84세,2016,364,90,274,32.8,364,90,274,32.8
37360, 청도군,090,85~89세,2016,941,251,690,36.4,941,251,690,36.4
37360, 청도군,090001, 85세,2016,252,69,183,37.7,252,69,183,37.7
37360, 청도군,090002, 86세,2016,219,61,158,38.6,219,61,158,38.6
37360, 청도군,090003, 87세,2016,186,40,146,27.4,186,40,146,27.4
37360, 청도군,090004, 88세,2016,149,47,102,46.1,149,47,102,46.1
37360, 청도군,090005, 89세,2016,135,34,101,33.7,135,34,101,33.7
37360, 청도군,095,90~94세,2016,329,78,251,31.1,329,78,251,31.1
37360, 청도군,095001, 90세,2016,90,23,67,34.3,90,23,67,34.3
37360, 청도군,095002, 91세,2016,88,18,70,25.7,88,18,70,25.7
37360, 청도군,095003, 92세,2016,64,18,46,39.1,64,18,46,39.1
37360, 청도군,095004, 93세,2016,55,12,43,27.9,55,12,43,27.9
37360, 청도군,095005, 94세,2016,32,7,25,28,32,7,25,28
37360, 청도군,100,95~99세,2016,52,11,41,26.8,52,11,41,26.8
37360, 청도군,100001, 95세,2016,21,X,18,16.7,21,X,18,16.7
37360, 청도군,100002, 96세,2016,14,X,10,40,14,X,10,40
37360, 청도군,100003, 97세,2016,8,X,5,60,8,X,5,60
37360, 청도군,100004, 98세,2016,7,X,6,16.7,7,X,6,16.7
37360, 청도군,100005, 99세,2016,X,X,X,0,X,X,X,0
37360, 청도군,101,100세이상,2016,8,X,8,0,8,X,8,0
37360, 청도군,102,15세미만,2016,2787,1431,1356,105.5,2781,1427,1354,105.4
37360, 청도군,103,15~64세,2016,25274,13139,12135,108.3,24134,12558,11576,108.5
37360, 청도군,104,65세이상,2016,13551,5423,8128,66.7,13532,5412,8120,66.7
37360, 청도군,086,85세이상,2016,1330,340,990,34.3,1330,340,990,34.3
37360, 청도군,126,평균연령,2016,52.4,49.8,54.7,,52.9,50.3,55.3,
37360, 청도군,127,중위연령,2016,56.5,54,58.7,,57,54.6,59.4,
37370, 고령군,000,합계,2016,33417,17432,15985,109.1,31231,15728,15503,101.5
37370, 고령군,005,0~4세,2016,1110,568,542,104.8,1106,565,541,104.4
37370, 고령군,005001, 0세,2016,197,109,88,123.9,196,108,88,122.7
37370, 고령군,005002, 1세,2016,236,122,114,107,234,121,113,107.1
37370, 고령군,005003, 2세,2016,227,119,108,110.2,227,119,108,110.2
37370, 고령군,005004, 3세,2016,223,100,123,81.3,222,99,123,80.5
37370, 고령군,005005, 4세,2016,227,118,109,108.3,227,118,109,108.3
37370, 고령군,010,5~9세,2016,1048,554,494,112.1,1041,553,488,113.3
37370, 고령군,010001, 5세,2016,181,82,99,82.8,178,82,96,85.4
37370, 고령군,010002, 6세,2016,215,121,94,128.7,215,121,94,128.7
37370, 고령군,010003, 7세,2016,207,107,100,107,205,107,98,109.2
37370, 고령군,010004, 8세,2016,220,120,100,120,219,120,99,121.2
37370, 고령군,010005, 9세,2016,225,124,101,122.8,224,123,101,121.8
37370, 고령군,015,10~14세,2016,1020,532,488,109,1016,531,485,109.5
37370, 고령군,015001, 10세,2016,208,99,109,90.8,206,99,107,92.5
37370, 고령군,015002, 11세,2016,198,116,82,141.5,197,116,81,143.2
37370, 고령군,015003, 12세,2016,188,105,83,126.5,188,105,83,126.5
37370, 고령군,015004, 13세,2016,217,109,108,100.9,216,108,108,100
37370, 고령군,015005, 14세,2016,209,103,106,97.2,209,103,106,97.2
37370, 고령군,020,15~19세,2016,1243,691,552,125.2,1237,689,548,125.7
37370, 고령군,020001, 15세,2016,266,139,127,109.4,264,138,126,109.5
37370, 고령군,020002, 16세,2016,230,143,87,164.4,230,143,87,164.4
37370, 고령군,020003, 17세,2016,293,155,138,112.3,293,155,138,112.3
37370, 고령군,020004, 18세,2016,260,143,117,122.2,259,143,116,123.3
37370, 고령군,020005, 19세,2016,194,111,83,133.7,191,110,81,135.8
37370, 고령군,025,20~24세,2016,1537,973,564,172.5,1267,752,515,146
37370, 고령군,025001, 20세,2016,269,162,107,151.4,249,145,104,139.4
37370, 고령군,025002, 21세,2016,312,204,108,188.9,278,179,99,180.8
37370, 고령군,025003, 22세,2016,274,171,103,166,233,136,97,140.2
37370, 고령군,025004, 23세,2016,338,220,118,186.4,262,154,108,142.6
37370, 고령군,025005, 24세,2016,344,216,128,168.8,245,138,107,129
37370, 고령군,030,25~29세,2016,1721,1094,627,174.5,1198,681,517,131.7
37370, 고령군,030001, 25세,2016,340,218,122,178.7,246,139,107,129.9
37370, 고령군,030002, 26세,2016,330,206,124,166.1,230,128,102,125.5
37370, 고령군,030003, 27세,2016,354,223,131,170.2,251,143,108,132.4
37370, 고령군,030004, 28세,2016,350,238,112,212.5,234,143,91,157.1
37370, 고령군,030005, 29세,2016,347,209,138,151.4,237,128,109,117.4
37370, 고령군,035,30~34세,2016,1821,1132,689,164.3,1314,706,608,116.1
37370, 고령군,035001, 30세,2016,349,218,131,166.4,248,136,112,121.4
37370, 고령군,035002, 31세,2016,342,219,123,178,231,124,107,115.9
37370, 고령군,035003, 32세,2016,342,223,119,187.4,240,134,106,126.4
37370, 고령군,035004, 33세,2016,362,224,138,162.3,270,146,124,117.7
37370, 고령군,035005, 34세,2016,426,248,178,139.3,325,166,159,104.4
37370, 고령군,040,35~39세,2016,1933,1130,803,140.7,1617,861,756,113.9
37370, 고령군,040001, 35세,2016,406,238,168,141.7,328,172,156,110.3
37370, 고령군,040002, 36세,2016,384,227,157,144.6,322,176,146,120.5
37370, 고령군,040003, 37세,2016,406,215,191,112.6,339,156,183,85.2
37370, 고령군,040004, 38세,2016,368,218,150,145.3,314,174,140,124.3
37370, 고령군,040005, 39세,2016,369,232,137,169.3,314,183,131,139.7
37370, 고령군,045,40~44세,2016,2199,1263,936,134.9,2007,1109,898,123.5
37370, 고령군,045001, 40세,2016,406,242,164,147.6,347,192,155,123.9
37370, 고령군,045002, 41세,2016,403,225,178,126.4,371,199,172,115.7
37370, 고령군,045003, 42세,2016,457,251,206,121.8,421,222,199,111.6
37370, 고령군,045004, 43세,2016,470,277,193,143.5,438,254,184,138
37370, 고령군,045005, 44세,2016,463,268,195,137.4,430,242,188,128.7
37370, 고령군,050,45~49세,2016,2491,1405,1086,129.4,2366,1316,1050,125.3
37370, 고령군,050001, 45세,2016,539,310,229,135.4,513,292,221,132.1
37370, 고령군,050002, 46세,2016,469,262,207,126.6,431,234,197,118.8
37370, 고령군,050003, 47세,2016,507,294,213,138,485,277,208,133.2
37370, 고령군,050004, 48세,2016,499,282,217,130,473,264,209,126.3
37370, 고령군,050005, 49세,2016,477,257,220,116.8,464,249,215,115.8
37370, 고령군,055,50~54세,2016,2856,1546,1310,118,2751,1484,1267,117.1
37370, 고령군,055001, 50세,2016,521,290,231,125.5,500,279,221,126.2
37370, 고령군,055002, 51세,2016,551,284,267,106.4,534,277,257,107.8
37370, 고령군,055003, 52세,2016,540,296,244,121.3,515,279,236,118.2
37370, 고령군,055004, 53세,2016,581,315,266,118.4,556,298,258,115.5
37370, 고령군,055005, 54세,2016,663,361,302,119.5,646,351,295,119
37370, 고령군,060,55~59세,2016,3188,1700,1488,114.2,3127,1669,1458,114.5
37370, 고령군,060001, 55세,2016,678,369,309,119.4,665,363,302,120.2
37370, 고령군,060002, 56세,2016,706,348,358,97.2,687,338,349,96.8
37370, 고령군,060003, 57세,2016,660,354,306,115.7,653,351,302,116.2
37370, 고령군,060004, 58세,2016,546,300,246,122,537,294,243,121
37370, 고령군,060005, 59세,2016,598,329,269,122.3,585,323,262,123.3
37370, 고령군,065,60~64세,2016,2735,1392,1343,103.6,2707,1379,1328,103.8
37370, 고령군,065001, 60세,2016,587,300,287,104.5,582,298,284,104.9
37370, 고령군,065002, 61세,2016,572,285,287,99.3,564,282,282,100
37370, 고령군,065003, 62세,2016,525,284,241,117.8,519,280,239,117.2
37370, 고령군,065004, 63세,2016,471,237,234,101.3,467,235,232,101.3
37370, 고령군,065005, 64세,2016,580,286,294,97.3,575,284,291,97.6
37370, 고령군,070,65~69세,2016,2342,1142,1200,95.2,2322,1130,1192,94.8
37370, 고령군,070001, 65세,2016,468,216,252,85.7,464,213,251,84.9
37370, 고령군,070002, 66세,2016,474,232,242,95.9,471,230,241,95.4
37370, 고령군,070003, 67세,2016,489,244,245,99.6,483,241,242,99.6
37370, 고령군,070004, 68세,2016,452,219,233,94,449,217,232,93.5
37370, 고령군,070005, 69세,2016,459,231,228,101.3,455,229,226,101.3
37370, 고령군,075,70~74세,2016,1919,827,1092,75.7,1911,824,1087,75.8
37370, 고령군,075001, 70세,2016,326,152,174,87.4,325,151,174,86.8
37370, 고령군,075002, 71세,2016,298,128,170,75.3,295,128,167,76.6
37370, 고령군,075003, 72세,2016,400,186,214,86.9,398,184,214,86
37370, 고령군,075004, 73세,2016,411,173,238,72.7,410,173,237,73
37370, 고령군,075005, 74세,2016,484,188,296,63.5,483,188,295,63.7
37370, 고령군,080,75~79세,2016,2030,764,1266,60.3,2024,761,1263,60.3
37370, 고령군,080001, 75세,2016,429,162,267,60.7,429,162,267,60.7
37370, 고령군,080002, 76세,2016,416,161,255,63.1,413,159,254,62.6
37370, 고령군,080003, 77세,2016,451,167,284,58.8,451,167,284,58.8
37370, 고령군,080004, 78세,2016,379,126,253,49.8,378,126,252,50
37370, 고령군,080005, 79세,2016,355,148,207,71.5,353,147,206,71.4
37370, 고령군,085,80~84세,2016,1432,504,928,54.3,1429,503,926,54.3
37370, 고령군,085001, 80세,2016,343,141,202,69.8,343,141,202,69.8
37370, 고령군,085002, 81세,2016,338,130,208,62.5,337,130,207,62.8
37370, 고령군,085003, 82세,2016,300,92,208,44.2,299,92,207,44.4
37370, 고령군,085004, 83세,2016,238,75,163,46,237,74,163,45.4
37370, 고령군,085005, 84세,2016,213,66,147,44.9,213,66,147,44.9
37370, 고령군,090,85~89세,2016,599,167,432,38.7,598,167,431,38.7
37370, 고령군,090001, 85세,2016,174,53,121,43.8,173,53,120,44.2
37370, 고령군,090002, 86세,2016,134,30,104,28.8,134,30,104,28.8
37370, 고령군,090003, 87세,2016,105,38,67,56.7,105,38,67,56.7
37370, 고령군,090004, 88세,2016,99,22,77,28.6,99,22,77,28.6
37370, 고령군,090005, 89세,2016,87,24,63,38.1,87,24,63,38.1
37370, 고령군,095,90~94세,2016,154,34,120,28.3,154,34,120,28.3
37370, 고령군,095001, 90세,2016,43,7,36,19.4,43,7,36,19.4
37370, 고령군,095002, 91세,2016,49,13,36,36.1,49,13,36,36.1
37370, 고령군,095003, 92세,2016,27,7,20,35,27,7,20,35
37370, 고령군,095004, 93세,2016,17,5,12,41.7,17,5,12,41.7
37370, 고령군,095005, 94세,2016,18,X,16,12.5,18,X,16,12.5
37370, 고령군,100,95~99세,2016,36,14,22,63.6,36,14,22,63.6
37370, 고령군,100001, 95세,2016,15,6,9,66.7,15,6,9,66.7
37370, 고령군,100002, 96세,2016,13,6,7,85.7,13,6,7,85.7
37370, 고령군,100003, 97세,2016,X,X,X,50,X,X,X,50
37370, 고령군,100004, 98세,2016,X,X,X,50,X,X,X,50
37370, 고령군,100005, 99세,2016,X,X,X,0,X,X,X,0
37370, 고령군,101,100세이상,2016,X,X,X,0,X,X,X,0
37370, 고령군,102,15세미만,2016,3178,1654,1524,108.5,3163,1649,1514,108.9
37370, 고령군,103,15~64세,2016,21724,12326,9398,131.2,19591,10646,8945,119
37370, 고령군,104,65세이상,2016,8515,3452,5063,68.2,8477,3433,5044,68.1
37370, 고령군,086,85세이상,2016,792,215,577,37.3,791,215,576,37.3
37370, 고령군,126,평균연령,2016,48.4,45.8,51.2,,49.3,47.1,51.6,
37370, 고령군,127,중위연령,2016,51.1,47.7,54.7,,52.8,50.4,55.3,
37380, 성주군,000,합계,2016,41388,21337,20051,106.4,39449,19909,19540,101.9
37380, 성주군,005,0~4세,2016,1218,609,609,100,1213,609,604,100.8
37380, 성주군,005001, 0세,2016,262,133,129,103.1,262,133,129,103.1
37380, 성주군,005002, 1세,2016,261,134,127,105.5,261,134,127,105.5
37380, 성주군,005003, 2세,2016,228,119,109,109.2,226,119,107,111.2
37380, 성주군,005004, 3세,2016,232,111,121,91.7,230,111,119,93.3
37380, 성주군,005005, 4세,2016,235,112,123,91.1,234,112,122,91.8
37380, 성주군,010,5~9세,2016,983,512,471,108.7,981,510,471,108.3
37380, 성주군,010001, 5세,2016,228,117,111,105.4,227,116,111,104.5
37380, 성주군,010002, 6세,2016,173,84,89,94.4,173,84,89,94.4
37380, 성주군,010003, 7세,2016,192,103,89,115.7,191,102,89,114.6
37380, 성주군,010004, 8세,2016,205,112,93,120.4,205,112,93,120.4
37380, 성주군,010005, 9세,2016,185,96,89,107.9,185,96,89,107.9
37380, 성주군,015,10~14세,2016,1010,569,441,129,1007,568,439,129.4
37380, 성주군,015001, 10세,2016,209,121,88,137.5,209,121,88,137.5
37380, 성주군,015002, 11세,2016,189,101,88,114.8,189,101,88,114.8
37380, 성주군,015003, 12세,2016,186,116,70,165.7,184,115,69,166.7
37380, 성주군,015004, 13세,2016,218,127,91,139.6,217,127,90,141.1
37380, 성주군,015005, 14세,2016,208,104,104,100,208,104,104,100
37380, 성주군,020,15~19세,2016,1466,771,695,110.9,1458,768,690,111.3
37380, 성주군,020001, 15세,2016,297,161,136,118.4,297,161,136,118.4
37380, 성주군,020002, 16세,2016,324,144,180,80,323,144,179,80.4
37380, 성주군,020003, 17세,2016,320,158,162,97.5,319,158,161,98.1
37380, 성주군,020004, 18세,2016,290,155,135,114.8,289,154,135,114.1
37380, 성주군,020005, 19세,2016,235,153,82,186.6,230,151,79,191.1
37380, 성주군,025,20~24세,2016,1889,1205,684,176.2,1628,1007,621,162.2
37380, 성주군,025001, 20세,2016,316,209,107,195.3,302,204,98,208.2
37380, 성주군,025002, 21세,2016,344,247,97,254.6,317,225,92,244.6
37380, 성주군,025003, 22세,2016,395,251,144,174.3,358,222,136,163.2
37380, 성주군,025004, 23세,2016,392,242,150,161.3,311,179,132,135.6
37380, 성주군,025005, 24세,2016,442,256,186,137.6,340,177,163,108.6
37380, 성주군,030,25~29세,2016,2169,1331,838,158.8,1655,932,723,128.9
37380, 성주군,030001, 25세,2016,446,260,186,139.8,338,175,163,107.4
37380, 성주군,030002, 26세,2016,451,278,173,160.7,340,194,146,132.9
37380, 성주군,030003, 27세,2016,428,260,168,154.8,313,170,143,118.9
37380, 성주군,030004, 28세,2016,449,283,166,170.5,353,208,145,143.4
37380, 성주군,030005, 29세,2016,395,250,145,172.4,311,185,126,146.8
37380, 성주군,035,30~34세,2016,2082,1213,869,139.6,1680,888,792,112.1
37380, 성주군,035001, 30세,2016,408,253,155,163.2,298,166,132,125.8
37380, 성주군,035002, 31세,2016,402,243,159,152.8,321,175,146,119.9
37380, 성주군,035003, 32세,2016,420,252,168,150,336,183,153,119.6
37380, 성주군,035004, 33세,2016,405,215,190,113.2,344,171,173,98.8
37380, 성주군,035005, 34세,2016,447,250,197,126.9,381,193,188,102.7
37380, 성주군,040,35~39세,2016,1972,1174,798,147.1,1719,974,745,130.7
37380, 성주군,040001, 35세,2016,357,207,150,138,300,157,143,109.8
37380, 성주군,040002, 36세,2016,434,260,174,149.4,369,210,159,132.1
37380, 성주군,040003, 37세,2016,415,243,172,141.3,368,207,161,128.6
37380, 성주군,040004, 38세,2016,374,223,151,147.7,332,189,143,132.2
37380, 성주군,040005, 39세,2016,392,241,151,159.6,350,211,139,151.8
37380, 성주군,045,40~44세,2016,2230,1329,901,147.5,2057,1201,856,140.3
37380, 성주군,045001, 40세,2016,395,252,143,176.2,356,220,136,161.8
37380, 성주군,045002, 41세,2016,417,233,184,126.6,378,203,175,116
37380, 성주군,045003, 42세,2016,464,266,198,134.3,434,246,188,130.9
37380, 성주군,045004, 43세,2016,460,286,174,164.4,422,260,162,160.5
37380, 성주군,045005, 44세,2016,494,292,202,144.6,467,272,195,139.5
37380, 성주군,050,45~49세,2016,2975,1644,1331,123.5,2850,1568,1282,122.3
37380, 성주군,050001, 45세,2016,516,294,222,132.4,480,271,209,129.7
37380, 성주군,050002, 46세,2016,553,308,245,125.7,529,295,234,126.1
37380, 성주군,050003, 47세,2016,591,335,256,130.9,571,322,249,129.3
37380, 성주군,050004, 48세,2016,653,356,297,119.9,635,345,290,119
37380, 성주군,050005, 49세,2016,662,351,311,112.9,635,335,300,111.7
37380, 성주군,055,50~54세,2016,3668,1972,1696,116.3,3577,1924,1653,116.4
37380, 성주군,055001, 50세,2016,658,359,299,120.1,635,347,288,120.5
37380, 성주군,055002, 51세,2016,739,395,344,114.8,714,385,329,117
37380, 성주군,055003, 52세,2016,699,373,326,114.4,685,367,318,115.4
37380, 성주군,055004, 53세,2016,723,392,331,118.4,706,381,325,117.2
37380, 성주군,055005, 54세,2016,849,453,396,114.4,837,444,393,113
37380, 성주군,060,55~59세,2016,4421,2314,2107,109.8,4367,2288,2079,110.1
37380, 성주군,060001, 55세,2016,976,527,449,117.4,964,521,443,117.6
37380, 성주군,060002, 56세,2016,969,461,508,90.7,954,455,499,91.2
37380, 성주군,060003, 57세,2016,942,479,463,103.5,938,477,461,103.5
37380, 성주군,060004, 58세,2016,753,424,329,128.9,739,416,323,128.8
37380, 성주군,060005, 59세,2016,781,423,358,118.2,772,419,353,118.7
37380, 성주군,065,60~64세,2016,3819,1900,1919,99,3784,1885,1899,99.3
37380, 성주군,065001, 60세,2016,780,422,358,117.9,771,417,354,117.8
37380, 성주군,065002, 61세,2016,816,379,437,86.7,808,377,431,87.5
37380, 성주군,065003, 62세,2016,691,343,348,98.6,682,339,343,98.8
37380, 성주군,065004, 63세,2016,725,380,345,110.1,719,376,343,109.6
37380, 성주군,065005, 64세,2016,807,376,431,87.2,804,376,428,87.9
37380, 성주군,070,65~69세,2016,3342,1657,1685,98.3,3333,1652,1681,98.3
37380, 성주군,070001, 65세,2016,625,298,327,91.1,623,296,327,90.5
37380, 성주군,070002, 66세,2016,688,328,360,91.1,684,326,358,91.1
37380, 성주군,070003, 67세,2016,701,362,339,106.8,699,361,338,106.8
37380, 성주군,070004, 68세,2016,685,345,340,101.5,684,345,339,101.8
37380, 성주군,070005, 69세,2016,643,324,319,101.6,643,324,319,101.6
37380, 성주군,075,70~74세,2016,2522,1155,1367,84.5,2519,1153,1366,84.4
37380, 성주군,075001, 70세,2016,416,196,220,89.1,415,196,219,89.5
37380, 성주군,075002, 71세,2016,399,199,200,99.5,398,198,200,99
37380, 성주군,075003, 72세,2016,498,223,275,81.1,498,223,275,81.1
37380, 성주군,075004, 73세,2016,576,259,317,81.7,575,258,317,81.4
37380, 성주군,075005, 74세,2016,633,278,355,78.3,633,278,355,78.3
37380, 성주군,080,75~79세,2016,2505,1071,1434,74.7,2505,1071,1434,74.7
37380, 성주군,080001, 75세,2016,534,252,282,89.4,534,252,282,89.4
37380, 성주군,080002, 76세,2016,513,210,303,69.3,513,210,303,69.3
37380, 성주군,080003, 77세,2016,565,251,314,79.9,565,251,314,79.9
37380, 성주군,080004, 78세,2016,480,196,284,69,480,196,284,69
37380, 성주군,080005, 79세,2016,413,162,251,64.5,413,162,251,64.5
37380, 성주군,085,80~84세,2016,1941,613,1328,46.2,1941,613,1328,46.2
37380, 성주군,085001, 80세,2016,465,150,315,47.6,465,150,315,47.6
37380, 성주군,085002, 81세,2016,449,139,310,44.8,449,139,310,44.8
37380, 성주군,085003, 82세,2016,386,129,257,50.2,386,129,257,50.2
37380, 성주군,085004, 83세,2016,325,98,227,43.2,325,98,227,43.2
37380, 성주군,085005, 84세,2016,316,97,219,44.3,316,97,219,44.3
37380, 성주군,090,85~89세,2016,855,233,622,37.5,854,233,621,37.5
37380, 성주군,090001, 85세,2016,212,63,149,42.3,212,63,149,42.3
37380, 성주군,090002, 86세,2016,209,53,156,34,209,53,156,34
37380, 성주군,090003, 87세,2016,169,48,121,39.7,168,48,120,40
37380, 성주군,090004, 88세,2016,152,39,113,34.5,152,39,113,34.5
37380, 성주군,090005, 89세,2016,113,30,83,36.1,113,30,83,36.1
37380, 성주군,095,90~94세,2016,270,57,213,26.8,270,57,213,26.8
37380, 성주군,095001, 90세,2016,79,14,65,21.5,79,14,65,21.5
37380, 성주군,095002, 91세,2016,68,16,52,30.8,68,16,52,30.8
37380, 성주군,095003, 92세,2016,52,12,40,30,52,12,40,30
37380, 성주군,095004, 93세,2016,38,7,31,22.6,38,7,31,22.6
37380, 성주군,095005, 94세,2016,33,8,25,32,33,8,25,32
37380, 성주군,100,95~99세,2016,48,8,40,20,48,8,40,20
37380, 성주군,100001, 95세,2016,17,X,13,30.8,17,X,13,30.8
37380, 성주군,100002, 96세,2016,15,X,12,25,15,X,12,25
37380, 성주군,100003, 97세,2016,10,X,10,0,10,X,10,0
37380, 성주군,100004, 98세,2016,X,X,X,0,X,X,X,0
37380, 성주군,100005, 99세,2016,X,X,X,100,X,X,X,100
37380, 성주군,101,100세이상,2016,X,X,X,0,X,X,X,0
37380, 성주군,102,15세미만,2016,3211,1690,1521,111.1,3201,1687,1514,111.4
37380, 성주군,103,15~64세,2016,26691,14853,11838,125.5,24775,13435,11340,118.5
37380, 성주군,104,65세이상,2016,11486,4794,6692,71.6,11473,4787,6686,71.6
37380, 성주군,086,85세이상,2016,1176,298,878,33.9,1175,298,877,34
37380, 성주군,126,평균연령,2016,50.3,47.7,53,,51.1,48.7,53.4,
37380, 성주군,127,중위연령,2016,53.8,50.9,56.5,,54.9,52.5,56.9,
37390, 칠곡군,000,합계,2016,122613,63820,58793,108.6,117603,60363,57240,105.5
37390, 칠곡군,005,0~4세,2016,6631,3463,3168,109.3,6597,3446,3151,109.4
37390, 칠곡군,005001, 0세,2016,1337,682,655,104.1,1329,680,649,104.8
37390, 칠곡군,005002, 1세,2016,1370,729,641,113.7,1365,726,639,113.6
37390, 칠곡군,005003, 2세,2016,1245,644,601,107.2,1241,642,599,107.2
37390, 칠곡군,005004, 3세,2016,1315,688,627,109.7,1306,682,624,109.3
37390, 칠곡군,005005, 4세,2016,1364,720,644,111.8,1356,716,640,111.9
37390, 칠곡군,010,5~9세,2016,6327,3253,3074,105.8,6301,3238,3063,105.7
37390, 칠곡군,010001, 5세,2016,1315,663,652,101.7,1311,662,649,102
37390, 칠곡군,010002, 6세,2016,1293,667,626,106.5,1285,661,624,105.9
37390, 칠곡군,010003, 7세,2016,1172,605,567,106.7,1165,601,564,106.6
37390, 칠곡군,010004, 8세,2016,1239,644,595,108.2,1237,643,594,108.2
37390, 칠곡군,010005, 9세,2016,1308,674,634,106.3,1303,671,632,106.2
37390, 칠곡군,015,10~14세,2016,5824,3088,2736,112.9,5811,3081,2730,112.9
37390, 칠곡군,015001, 10세,2016,1122,611,511,119.6,1119,609,510,119.4
37390, 칠곡군,015002, 11세,2016,1119,612,507,120.7,1116,610,506,120.6
37390, 칠곡군,015003, 12세,2016,1141,592,549,107.8,1137,590,547,107.9
37390, 칠곡군,015004, 13세,2016,1167,598,569,105.1,1165,598,567,105.5
37390, 칠곡군,015005, 14세,2016,1275,675,600,112.5,1274,674,600,112.3
37390, 칠곡군,020,15~19세,2016,6686,3599,3087,116.6,6580,3539,3041,116.4
37390, 칠곡군,020001, 15세,2016,1343,714,629,113.5,1342,713,629,113.4
37390, 칠곡군,020002, 16세,2016,1405,742,663,111.9,1402,740,662,111.8
37390, 칠곡군,020003, 17세,2016,1259,686,573,119.7,1253,682,571,119.4
37390, 칠곡군,020004, 18세,2016,1310,697,613,113.7,1261,674,587,114.8
37390, 칠곡군,020005, 19세,2016,1369,760,609,124.8,1322,730,592,123.3
37390, 칠곡군,025,20~24세,2016,7669,3940,3729,105.7,7136,3562,3574,99.7
37390, 칠곡군,025001, 20세,2016,1442,824,618,133.3,1400,799,601,132.9
37390, 칠곡군,025002, 21세,2016,1460,788,672,117.3,1386,736,650,113.2
37390, 칠곡군,025003, 22세,2016,1541,737,804,91.7,1448,674,774,87.1
37390, 칠곡군,025004, 23세,2016,1531,747,784,95.3,1407,653,754,86.6
37390, 칠곡군,025005, 24세,2016,1695,844,851,99.2,1495,700,795,88.1
37390, 칠곡군,030,25~29세,2016,8779,4952,3827,129.4,7581,4085,3496,116.8
37390, 칠곡군,030001, 25세,2016,1560,807,753,107.2,1332,628,704,89.2
37390, 칠곡군,030002, 26세,2016,1603,848,755,112.3,1357,674,683,98.7
37390, 칠곡군,030003, 27세,2016,1695,1013,682,148.5,1460,846,614,137.8
37390, 칠곡군,030004, 28세,2016,1863,1089,774,140.7,1612,924,688,134.3
37390, 칠곡군,030005, 29세,2016,2058,1195,863,138.5,1820,1013,807,125.5
37390, 칠곡군,035,30~34세,2016,10579,6012,4567,131.6,9439,5214,4225,123.4
37390, 칠곡군,035001, 30세,2016,1996,1140,856,133.2,1788,995,793,125.5
37390, 칠곡군,035002, 31세,2016,1998,1181,817,144.6,1735,1010,725,139.3
37390, 칠곡군,035003, 32세,2016,1973,1115,858,130,1760,957,803,119.2
37390, 칠곡군,035004, 33세,2016,2168,1197,971,123.3,1947,1035,912,113.5
37390, 칠곡군,035005, 34세,2016,2444,1379,1065,129.5,2209,1217,992,122.7
37390, 칠곡군,040,35~39세,2016,11142,6176,4966,124.4,10422,5635,4787,117.7
37390, 칠곡군,040001, 35세,2016,2389,1359,1030,131.9,2212,1224,988,123.9
37390, 칠곡군,040002, 36세,2016,2458,1390,1068,130.1,2306,1280,1026,124.8
37390, 칠곡군,040003, 37세,2016,2193,1214,979,124,2049,1103,946,116.6
37390, 칠곡군,040004, 38세,2016,2021,1100,921,119.4,1886,994,892,111.4
37390, 칠곡군,040005, 39세,2016,2081,1113,968,115,1969,1034,935,110.6
37390, 칠곡군,045,40~44세,2016,10693,5795,4898,118.3,10279,5508,4771,115.4
37390, 칠곡군,045001, 40세,2016,1965,1095,870,125.9,1866,1020,846,120.6
37390, 칠곡군,045002, 41세,2016,2155,1140,1015,112.3,2061,1084,977,111
37390, 칠곡군,045003, 42세,2016,2246,1213,1033,117.4,2169,1161,1008,115.2
37390, 칠곡군,045004, 43세,2016,2143,1149,994,115.6,2083,1109,974,113.9
37390, 칠곡군,045005, 44세,2016,2184,1198,986,121.5,2100,1134,966,117.4
37390, 칠곡군,050,45~49세,2016,10209,5481,4728,115.9,9895,5297,4598,115.2
37390, 칠곡군,050001, 45세,2016,2120,1172,948,123.6,2037,1127,910,123.8
37390, 칠곡군,050002, 46세,2016,2097,1145,952,120.3,2031,1107,924,119.8
37390, 칠곡군,050003, 47세,2016,2084,1101,983,112,2026,1067,959,111.3
37390, 칠곡군,050004, 48세,2016,2053,1085,968,112.1,1997,1052,945,111.3
37390, 칠곡군,050005, 49세,2016,1855,978,877,111.5,1804,944,860,109.8
37390, 칠곡군,055,50~54세,2016,8887,4821,4066,118.6,8685,4689,3996,117.3
37390, 칠곡군,055001, 50세,2016,1875,1035,840,123.2,1825,1007,818,123.1
37390, 칠곡군,055002, 51세,2016,1863,1001,862,116.1,1815,965,850,113.5
37390, 칠곡군,055003, 52세,2016,1669,927,742,124.9,1633,902,731,123.4
37390, 칠곡군,055004, 53세,2016,1652,880,772,114,1616,856,760,112.6
37390, 칠곡군,055005, 54세,2016,1828,978,850,115.1,1796,959,837,114.6
37390, 칠곡군,060,55~59세,2016,8164,4319,3845,112.3,8042,4259,3783,112.6
37390, 칠곡군,060001, 55세,2016,1874,1005,869,115.7,1853,991,862,115
37390, 칠곡군,060002, 56세,2016,1811,953,858,111.1,1779,942,837,112.5
37390, 칠곡군,060003, 57세,2016,1564,797,767,103.9,1536,781,755,103.4
37390, 칠곡군,060004, 58세,2016,1452,798,654,122,1426,786,640,122.8
37390, 칠곡군,060005, 59세,2016,1463,766,697,109.9,1448,759,689,110.2
37390, 칠곡군,065,60~64세,2016,5884,2890,2994,96.5,5790,2831,2959,95.7
37390, 칠곡군,065001, 60세,2016,1369,689,680,101.3,1342,668,674,99.1
37390, 칠곡군,065002, 61세,2016,1283,621,662,93.8,1261,605,656,92.2
37390, 칠곡군,065003, 62세,2016,1140,540,600,90,1118,532,586,90.8
37390, 칠곡군,065004, 63세,2016,972,476,496,96,960,467,493,94.7
37390, 칠곡군,065005, 64세,2016,1120,564,556,101.4,1109,559,550,101.6
37390, 칠곡군,070,65~69세,2016,4353,2110,2243,94.1,4290,2074,2216,93.6
37390, 칠곡군,070001, 65세,2016,826,399,427,93.4,814,390,424,92
37390, 칠곡군,070002, 66세,2016,853,431,422,102.1,837,422,415,101.7
37390, 칠곡군,070003, 67세,2016,960,450,510,88.2,948,446,502,88.8
37390, 칠곡군,070004, 68세,2016,886,445,441,100.9,871,434,437,99.3
37390, 칠곡군,070005, 69세,2016,828,385,443,86.9,820,382,438,87.2
37390, 칠곡군,075,70~74세,2016,3544,1455,2089,69.7,3531,1450,2081,69.7
37390, 칠곡군,075001, 70세,2016,556,247,309,79.9,553,245,308,79.5
37390, 칠곡군,075002, 71세,2016,637,266,371,71.7,635,266,369,72.1
37390, 칠곡군,075003, 72세,2016,665,291,374,77.8,659,288,371,77.6
37390, 칠곡군,075004, 73세,2016,784,300,484,62,783,300,483,62.1
37390, 칠곡군,075005, 74세,2016,902,351,551,63.7,901,351,550,63.8
37390, 칠곡군,080,75~79세,2016,3518,1313,2205,59.5,3508,1308,2200,59.5
37390, 칠곡군,080001, 75세,2016,739,290,449,64.6,736,289,447,64.7
37390, 칠곡군,080002, 76세,2016,736,284,452,62.8,735,283,452,62.6
37390, 칠곡군,080003, 77세,2016,796,272,524,51.9,794,272,522,52.1
37390, 칠곡군,080004, 78세,2016,629,239,390,61.3,628,238,390,61
37390, 칠곡군,080005, 79세,2016,618,228,390,58.5,615,226,389,58.1
37390, 칠곡군,085,80~84세,2016,2313,791,1522,52,2308,788,1520,51.8
37390, 칠곡군,085001, 80세,2016,566,201,365,55.1,564,200,364,54.9
37390, 칠곡군,085002, 81세,2016,540,184,356,51.7,539,184,355,51.8
37390, 칠곡군,085003, 82세,2016,469,177,292,60.6,469,177,292,60.6
37390, 칠곡군,085004, 83세,2016,384,126,258,48.8,382,124,258,48.1
37390, 칠곡군,085005, 84세,2016,354,103,251,41,354,103,251,41
37390, 칠곡군,090,85~89세,2016,970,275,695,39.6,968,273,695,39.3
37390, 칠곡군,090001, 85세,2016,261,86,175,49.1,260,85,175,48.6
37390, 칠곡군,090002, 86세,2016,220,66,154,42.9,219,65,154,42.2
37390, 칠곡군,090003, 87세,2016,197,55,142,38.7,197,55,142,38.7
37390, 칠곡군,090004, 88세,2016,153,31,122,25.4,153,31,122,25.4
37390, 칠곡군,090005, 89세,2016,139,37,102,36.3,139,37,102,36.3
37390, 칠곡군,095,90~94세,2016,361,76,285,26.7,361,76,285,26.7
37390, 칠곡군,095001, 90세,2016,86,25,61,41,86,25,61,41
37390, 칠곡군,095002, 91세,2016,103,27,76,35.5,103,27,76,35.5
37390, 칠곡군,095003, 92세,2016,66,15,51,29.4,66,15,51,29.4
37390, 칠곡군,095004, 93세,2016,59,7,52,13.5,59,7,52,13.5
37390, 칠곡군,095005, 94세,2016,47,X,45,4.4,47,X,45,4.4
37390, 칠곡군,100,95~99세,2016,70,10,60,16.7,69,9,60,15
37390, 칠곡군,100001, 95세,2016,28,5,23,21.7,28,5,23,21.7
37390, 칠곡군,100002, 96세,2016,18,X,15,20,17,X,15,13.3
37390, 칠곡군,100003, 97세,2016,9,X,8,12.5,9,X,8,12.5
37390, 칠곡군,100004, 98세,2016,7,X,6,16.7,7,X,6,16.7
37390, 칠곡군,100005, 99세,2016,8,X,8,0,8,X,8,0
37390, 칠곡군,101,100세이상,2016,10,X,9,11.1,10,X,9,11.1
37390, 칠곡군,102,15세미만,2016,18782,9804,8978,109.2,18709,9765,8944,109.2
37390, 칠곡군,103,15~64세,2016,88692,47985,40707,117.9,83849,44619,39230,113.7
37390, 칠곡군,104,65세이상,2016,15139,6031,9108,66.2,15045,5979,9066,65.9
37390, 칠곡군,086,85세이상,2016,1411,362,1049,34.5,1408,359,1049,34.2
37390, 칠곡군,126,평균연령,2016,39.2,37.9,40.7,,39.4,38.1,40.8,
37390, 칠곡군,127,중위연령,2016,38.9,37.7,40.3,,39.5,38.4,40.7,
37400, 예천군,000,합계,2016,44212,21586,22626,95.4,43658,21357,22301,95.8
37400, 예천군,005,0~4세,2016,1502,776,726,106.9,1497,774,723,107.1
37400, 예천군,005001, 0세,2016,273,141,132,106.8,272,140,132,106.1
37400, 예천군,005002, 1세,2016,312,159,153,103.9,311,159,152,104.6
37400, 예천군,005003, 2세,2016,274,141,133,106,274,141,133,106
37400, 예천군,005004, 3세,2016,324,168,156,107.7,323,168,155,108.4
37400, 예천군,005005, 4세,2016,319,167,152,109.9,317,166,151,109.9
37400, 예천군,010,5~9세,2016,1431,761,670,113.6,1430,761,669,113.8
37400, 예천군,010001, 5세,2016,302,146,156,93.6,302,146,156,93.6
37400, 예천군,010002, 6세,2016,268,141,127,111,267,141,126,111.9
37400, 예천군,010003, 7세,2016,293,164,129,127.1,293,164,129,127.1
37400, 예천군,010004, 8세,2016,268,154,114,135.1,268,154,114,135.1
37400, 예천군,010005, 9세,2016,300,156,144,108.3,300,156,144,108.3
37400, 예천군,015,10~14세,2016,1375,745,630,118.3,1374,744,630,118.1
37400, 예천군,015001, 10세,2016,272,154,118,130.5,272,154,118,130.5
37400, 예천군,015002, 11세,2016,253,131,122,107.4,253,131,122,107.4
37400, 예천군,015003, 12세,2016,282,142,140,101.4,281,141,140,100.7
37400, 예천군,015004, 13세,2016,257,136,121,112.4,257,136,121,112.4
37400, 예천군,015005, 14세,2016,311,182,129,141.1,311,182,129,141.1
37400, 예천군,020,15~19세,2016,1601,842,759,110.9,1595,841,754,111.5
37400, 예천군,020001, 15세,2016,326,165,161,102.5,324,165,159,103.8
37400, 예천군,020002, 16세,2016,336,179,157,114,336,179,157,114
37400, 예천군,020003, 17세,2016,315,151,164,92.1,314,150,164,91.5
37400, 예천군,020004, 18세,2016,298,148,150,98.7,297,148,149,99.3
37400, 예천군,020005, 19세,2016,326,199,127,156.7,324,199,125,159.2
37400, 예천군,025,20~24세,2016,1725,1015,710,143,1660,988,672,147
37400, 예천군,025001, 20세,2016,362,212,150,141.3,354,210,144,145.8
37400, 예천군,025002, 21세,2016,342,232,110,210.9,332,230,102,225.5
37400, 예천군,025003, 22세,2016,363,219,144,152.1,349,209,140,149.3
37400, 예천군,025004, 23세,2016,323,187,136,137.5,312,182,130,140
37400, 예천군,025005, 24세,2016,335,165,170,97.1,313,157,156,100.6
37400, 예천군,030,25~29세,2016,1575,825,750,110,1472,784,688,114
37400, 예천군,030001, 25세,2016,319,169,150,112.7,296,159,137,116.1
37400, 예천군,030002, 26세,2016,290,160,130,123.1,267,151,116,130.2
37400, 예천군,030003, 27세,2016,326,162,164,98.8,303,151,152,99.3
37400, 예천군,030004, 28세,2016,308,159,149,106.7,293,154,139,110.8
37400, 예천군,030005, 29세,2016,332,175,157,111.5,313,169,144,117.4
37400, 예천군,035,30~34세,2016,1841,972,869,111.9,1768,933,835,111.7
37400, 예천군,035001, 30세,2016,334,185,149,124.2,319,176,143,123.1
37400, 예천군,035002, 31세,2016,345,181,164,110.4,330,173,157,110.2
37400, 예천군,035003, 32세,2016,348,184,164,112.2,332,177,155,114.2
37400, 예천군,035004, 33세,2016,387,192,195,98.5,373,186,187,99.5
37400, 예천군,035005, 34세,2016,427,230,197,116.8,414,221,193,114.5
37400, 예천군,040,35~39세,2016,2116,1130,986,114.6,2052,1103,949,116.2
37400, 예천군,040001, 35세,2016,417,219,198,110.6,402,211,191,110.5
37400, 예천군,040002, 36세,2016,440,216,224,96.4,419,208,211,98.6
37400, 예천군,040003, 37세,2016,441,245,196,125,435,244,191,127.7
37400, 예천군,040004, 38세,2016,400,222,178,124.7,386,216,170,127.1
37400, 예천군,040005, 39세,2016,418,228,190,120,410,224,186,120.4
37400, 예천군,045,40~44세,2016,2284,1345,939,143.2,2241,1326,915,144.9
37400, 예천군,045001, 40세,2016,455,261,194,134.5,447,256,191,134
37400, 예천군,045002, 41세,2016,415,249,166,150,409,245,164,149.4
37400, 예천군,045003, 42세,2016,459,266,193,137.8,451,263,188,139.9
37400, 예천군,045004, 43세,2016,480,276,204,135.3,472,273,199,137.2
37400, 예천군,045005, 44세,2016,475,293,182,161,462,289,173,167.1
37400, 예천군,050,45~49세,2016,2628,1456,1172,124.2,2574,1439,1135,126.8
37400, 예천군,050001, 45세,2016,486,295,191,154.5,481,292,189,154.5
37400, 예천군,050002, 46세,2016,502,264,238,110.9,488,262,226,115.9
37400, 예천군,050003, 47세,2016,538,286,252,113.5,532,283,249,113.7
37400, 예천군,050004, 48세,2016,566,310,256,121.1,553,306,247,123.9
37400, 예천군,050005, 49세,2016,536,301,235,128.1,520,296,224,132.1
37400, 예천군,055,50~54세,2016,3225,1634,1591,102.7,3169,1613,1556,103.7
37400, 예천군,055001, 50세,2016,579,304,275,110.5,567,300,267,112.4
37400, 예천군,055002, 51세,2016,592,300,292,102.7,578,294,284,103.5
37400, 예천군,055003, 52세,2016,674,366,308,118.8,662,363,299,121.4
37400, 예천군,055004, 53세,2016,653,312,341,91.5,647,307,340,90.3
37400, 예천군,055005, 54세,2016,727,352,375,93.9,715,349,366,95.4
37400, 예천군,060,55~59세,2016,4198,2136,2062,103.6,4158,2115,2043,103.5
37400, 예천군,060001, 55세,2016,860,459,401,114.5,849,450,399,112.8
37400, 예천군,060002, 56세,2016,866,432,434,99.5,860,429,431,99.5
37400, 예천군,060003, 57세,2016,775,390,385,101.3,766,388,378,102.6
37400, 예천군,060004, 58세,2016,849,452,397,113.9,843,450,393,114.5
37400, 예천군,060005, 59세,2016,848,403,445,90.6,840,398,442,90
37400, 예천군,065,60~64세,2016,4080,2006,2074,96.7,4051,1996,2055,97.1
37400, 예천군,065001, 60세,2016,852,441,411,107.3,846,440,406,108.4
37400, 예천군,065002, 61세,2016,822,364,458,79.5,817,362,455,79.6
37400, 예천군,065003, 62세,2016,802,386,416,92.8,792,382,410,93.2
37400, 예천군,065004, 63세,2016,787,399,388,102.8,783,397,386,102.8
37400, 예천군,065005, 64세,2016,817,416,401,103.7,813,415,398,104.3
37400, 예천군,070,65~69세,2016,3553,1716,1837,93.4,3541,1714,1827,93.8
37400, 예천군,070001, 65세,2016,622,302,320,94.4,620,302,318,95
37400, 예천군,070002, 66세,2016,716,315,401,78.6,711,314,397,79.1
37400, 예천군,070003, 67세,2016,737,360,377,95.5,736,360,376,95.7
37400, 예천군,070004, 68세,2016,746,376,370,101.6,743,376,367,102.5
37400, 예천군,070005, 69세,2016,732,363,369,98.4,731,362,369,98.1
37400, 예천군,075,70~74세,2016,3239,1407,1832,76.8,3238,1407,1831,76.8
37400, 예천군,075001, 70세,2016,412,192,220,87.3,412,192,220,87.3
37400, 예천군,075002, 71세,2016,500,221,279,79.2,499,221,278,79.5
37400, 예천군,075003, 72세,2016,649,286,363,78.8,649,286,363,78.8
37400, 예천군,075004, 73세,2016,736,307,429,71.6,736,307,429,71.6
37400, 예천군,075005, 74세,2016,942,401,541,74.1,942,401,541,74.1
37400, 예천군,080,75~79세,2016,3677,1493,2184,68.4,3677,1493,2184,68.4
37400, 예천군,080001, 75세,2016,735,309,426,72.5,735,309,426,72.5
37400, 예천군,080002, 76세,2016,725,309,416,74.3,725,309,416,74.3
37400, 예천군,080003, 77세,2016,818,308,510,60.4,818,308,510,60.4
37400, 예천군,080004, 78세,2016,707,293,414,70.8,707,293,414,70.8
37400, 예천군,080005, 79세,2016,692,274,418,65.6,692,274,418,65.6
37400, 예천군,085,80~84세,2016,2617,949,1668,56.9,2616,948,1668,56.8
37400, 예천군,085001, 80세,2016,625,221,404,54.7,625,221,404,54.7
37400, 예천군,085002, 81세,2016,692,264,428,61.7,692,264,428,61.7
37400, 예천군,085003, 82세,2016,548,190,358,53.1,547,189,358,52.8
37400, 예천군,085004, 83세,2016,398,147,251,58.6,398,147,251,58.6
37400, 예천군,085005, 84세,2016,354,127,227,55.9,354,127,227,55.9
37400, 예천군,090,85~89세,2016,1073,281,792,35.5,1073,281,792,35.5
37400, 예천군,090001, 85세,2016,261,84,177,47.5,261,84,177,47.5
37400, 예천군,090002, 86세,2016,256,59,197,29.9,256,59,197,29.9
37400, 예천군,090003, 87세,2016,209,46,163,28.2,209,46,163,28.2
37400, 예천군,090004, 88세,2016,173,44,129,34.1,173,44,129,34.1
37400, 예천군,090005, 89세,2016,174,48,126,38.1,174,48,126,38.1
37400, 예천군,095,90~94세,2016,373,85,288,29.5,373,85,288,29.5
37400, 예천군,095001, 90세,2016,105,25,80,31.3,105,25,80,31.3
37400, 예천군,095002, 91세,2016,92,24,68,35.3,92,24,68,35.3
37400, 예천군,095003, 92세,2016,75,16,59,27.1,75,16,59,27.1
37400, 예천군,095004, 93세,2016,57,16,41,39,57,16,41,39
37400, 예천군,095005, 94세,2016,44,X,40,10,44,X,40,10
37400, 예천군,100,95~99세,2016,86,12,74,16.2,86,12,74,16.2
37400, 예천군,100001, 95세,2016,25,7,18,38.9,25,7,18,38.9
37400, 예천군,100002, 96세,2016,22,X,20,10,22,X,20,10
37400, 예천군,100003, 97세,2016,19,X,18,5.6,19,X,18,5.6
37400, 예천군,100004, 98세,2016,11,X,11,0,11,X,11,0
37400, 예천군,100005, 99세,2016,9,X,7,28.6,9,X,7,28.6
37400, 예천군,101,100세이상,2016,13,X,13,0,13,X,13,0
37400, 예천군,102,15세미만,2016,4308,2282,2026,112.6,4301,2279,2022,112.7
37400, 예천군,103,15~64세,2016,25273,13361,11912,112.2,24740,13138,11602,113.2
37400, 예천군,104,65세이상,2016,14631,5943,8688,68.4,14617,5940,8677,68.5
37400, 예천군,086,85세이상,2016,1545,378,1167,32.4,1545,378,1167,32.4
37400, 예천군,126,평균연령,2016,51.6,49,54.2,,51.8,49.1,54.4,
37400, 예천군,127,중위연령,2016,55.9,52.9,58.7,,56.2,53.1,59.1,
37410, 봉화군,000,합계,2016,31262,15391,15871,97,30920,15267,15653,97.5
37410, 봉화군,005,0~4세,2016,936,497,439,113.2,935,497,438,113.5
37410, 봉화군,005001, 0세,2016,171,91,80,113.8,171,91,80,113.8
37410, 봉화군,005002, 1세,2016,187,107,80,133.8,187,107,80,133.8
37410, 봉화군,005003, 2세,2016,183,93,90,103.3,182,93,89,104.5
37410, 봉화군,005004, 3세,2016,188,101,87,116.1,188,101,87,116.1
37410, 봉화군,005005, 4세,2016,207,105,102,102.9,207,105,102,102.9
37410, 봉화군,010,5~9세,2016,872,433,439,98.6,869,432,437,98.9
37410, 봉화군,010001, 5세,2016,199,90,109,82.6,199,90,109,82.6
37410, 봉화군,010002, 6세,2016,162,83,79,105.1,162,83,79,105.1
37410, 봉화군,010003, 7세,2016,162,95,67,141.8,160,94,66,142.4
37410, 봉화군,010004, 8세,2016,172,94,78,120.5,172,94,78,120.5
37410, 봉화군,010005, 9세,2016,177,71,106,67,176,71,105,67.6
37410, 봉화군,015,10~14세,2016,909,487,422,115.4,907,487,420,116
37410, 봉화군,015001, 10세,2016,183,88,95,92.6,182,88,94,93.6
37410, 봉화군,015002, 11세,2016,146,73,73,100,146,73,73,100
37410, 봉화군,015003, 12세,2016,188,101,87,116.1,187,101,86,117.4
37410, 봉화군,015004, 13세,2016,184,102,82,124.4,184,102,82,124.4
37410, 봉화군,015005, 14세,2016,208,123,85,144.7,208,123,85,144.7
37410, 봉화군,020,15~19세,2016,1050,577,473,122,1046,575,471,122.1
37410, 봉화군,020001, 15세,2016,221,117,104,112.5,221,117,104,112.5
37410, 봉화군,020002, 16세,2016,256,144,112,128.6,255,143,112,127.7
37410, 봉화군,020003, 17세,2016,230,119,111,107.2,230,119,111,107.2
37410, 봉화군,020004, 18세,2016,212,109,103,105.8,211,108,103,104.9
37410, 봉화군,020005, 19세,2016,131,88,43,204.7,129,88,41,214.6
37410, 봉화군,025,20~24세,2016,937,553,384,144,896,544,352,154.5
37410, 봉화군,025001, 20세,2016,180,122,58,210.3,175,121,54,224.1
37410, 봉화군,025002, 21세,2016,209,141,68,207.4,205,141,64,220.3
37410, 봉화군,025003, 22세,2016,179,108,71,152.1,171,107,64,167.2
37410, 봉화군,025004, 23세,2016,180,91,89,102.2,168,87,81,107.4
37410, 봉화군,025005, 24세,2016,189,91,98,92.9,177,88,89,98.9
37410, 봉화군,030,25~29세,2016,961,509,452,112.6,898,490,408,120.1
37410, 봉화군,030001, 25세,2016,186,86,100,86,173,81,92,88
37410, 봉화군,030002, 26세,2016,198,108,90,120,187,104,83,125.3
37410, 봉화군,030003, 27세,2016,192,107,85,125.9,183,103,80,128.8
37410, 봉화군,030004, 28세,2016,196,105,91,115.4,183,103,80,128.8
37410, 봉화군,030005, 29세,2016,189,103,86,119.8,172,99,73,135.6
37410, 봉화군,035,30~34세,2016,1170,603,567,106.3,1116,586,530,110.6
37410, 봉화군,035001, 30세,2016,229,125,104,120.2,217,120,97,123.7
37410, 봉화군,035002, 31세,2016,199,108,91,118.7,181,102,79,129.1
37410, 봉화군,035003, 32세,2016,239,126,113,111.5,227,123,104,118.3
37410, 봉화군,035004, 33세,2016,247,114,133,85.7,240,111,129,86
37410, 봉화군,035005, 34세,2016,256,130,126,103.2,251,130,121,107.4
37410, 봉화군,040,35~39세,2016,1334,762,572,133.2,1304,748,556,134.5
37410, 봉화군,040001, 35세,2016,257,142,115,123.5,242,134,108,124.1
37410, 봉화군,040002, 36세,2016,272,158,114,138.6,269,156,113,138.1
37410, 봉화군,040003, 37세,2016,287,166,121,137.2,282,165,117,141
37410, 봉화군,040004, 38세,2016,247,145,102,142.2,245,144,101,142.6
37410, 봉화군,040005, 39세,2016,271,151,120,125.8,266,149,117,127.4
37410, 봉화군,045,40~44세,2016,1621,942,679,138.7,1591,926,665,139.2
37410, 봉화군,045001, 40세,2016,284,173,111,155.9,277,169,108,156.5
37410, 봉화군,045002, 41세,2016,308,176,132,133.3,304,173,131,132.1
37410, 봉화군,045003, 42세,2016,345,192,153,125.5,339,190,149,127.5
37410, 봉화군,045004, 43세,2016,331,184,147,125.2,327,181,146,124
37410, 봉화군,045005, 44세,2016,353,217,136,159.6,344,213,131,162.6
37410, 봉화군,050,45~49세,2016,2060,1142,918,124.4,2026,1130,896,126.1
37410, 봉화군,050001, 45세,2016,380,230,150,153.3,375,226,149,151.7
37410, 봉화군,050002, 46세,2016,374,209,165,126.7,371,209,162,129
37410, 봉화군,050003, 47세,2016,430,227,203,111.8,420,225,195,115.4
37410, 봉화군,050004, 48세,2016,451,239,212,112.7,442,234,208,112.5
37410, 봉화군,050005, 49세,2016,425,237,188,126.1,418,236,182,129.7
37410, 봉화군,055,50~54세,2016,2680,1420,1260,112.7,2642,1401,1241,112.9
37410, 봉화군,055001, 50세,2016,472,257,215,119.5,465,254,211,120.4
37410, 봉화군,055002, 51세,2016,514,261,253,103.2,504,256,248,103.2
37410, 봉화군,055003, 52세,2016,469,253,216,117.1,458,247,211,117.1
37410, 봉화군,055004, 53세,2016,554,271,283,95.8,550,270,280,96.4
37410, 봉화군,055005, 54세,2016,671,378,293,129,665,374,291,128.5
37410, 봉화군,060,55~59세,2016,3390,1711,1679,101.9,3372,1704,1668,102.2
37410, 봉화군,060001, 55세,2016,716,379,337,112.5,711,378,333,113.5
37410, 봉화군,060002, 56세,2016,742,350,392,89.3,737,348,389,89.5
37410, 봉화군,060003, 57세,2016,611,297,314,94.6,607,296,311,95.2
37410, 봉화군,060004, 58세,2016,673,346,327,105.8,671,344,327,105.2
37410, 봉화군,060005, 59세,2016,648,339,309,109.7,646,338,308,109.7
37410, 봉화군,065,60~64세,2016,2980,1540,1440,106.9,2968,1536,1432,107.3
37410, 봉화군,065001, 60세,2016,601,330,271,121.8,599,330,269,122.7
37410, 봉화군,065002, 61세,2016,678,343,335,102.4,674,341,333,102.4
37410, 봉화군,065003, 62세,2016,587,313,274,114.2,584,312,272,114.7
37410, 봉화군,065004, 63세,2016,529,266,263,101.1,528,266,262,101.5
37410, 봉화군,065005, 64세,2016,585,288,297,97,583,287,296,97
37410, 봉화군,070,65~69세,2016,2589,1246,1343,92.8,2580,1243,1337,93
37410, 봉화군,070001, 65세,2016,501,255,246,103.7,498,254,244,104.1
37410, 봉화군,070002, 66세,2016,481,224,257,87.2,478,224,254,88.2
37410, 봉화군,070003, 67세,2016,517,259,258,100.4,516,258,258,100
37410, 봉화군,070004, 68세,2016,546,266,280,95,544,265,279,95
37410, 봉화군,070005, 69세,2016,544,242,302,80.1,544,242,302,80.1
37410, 봉화군,075,70~74세,2016,2304,990,1314,75.3,2304,990,1314,75.3
37410, 봉화군,075001, 70세,2016,280,150,130,115.4,280,150,130,115.4
37410, 봉화군,075002, 71세,2016,399,166,233,71.2,399,166,233,71.2
37410, 봉화군,075003, 72세,2016,490,213,277,76.9,490,213,277,76.9
37410, 봉화군,075004, 73세,2016,554,217,337,64.4,554,217,337,64.4
37410, 봉화군,075005, 74세,2016,581,244,337,72.4,581,244,337,72.4
37410, 봉화군,080,75~79세,2016,2533,1014,1519,66.8,2532,1014,1518,66.8
37410, 봉화군,080001, 75세,2016,515,211,304,69.4,515,211,304,69.4
37410, 봉화군,080002, 76세,2016,564,234,330,70.9,564,234,330,70.9
37410, 봉화군,080003, 77세,2016,518,231,287,80.5,517,231,286,80.8
37410, 봉화군,080004, 78세,2016,507,182,325,56,507,182,325,56
37410, 봉화군,080005, 79세,2016,429,156,273,57.1,429,156,273,57.1
37410, 봉화군,085,80~84세,2016,1797,653,1144,57.1,1795,652,1143,57
37410, 봉화군,085001, 80세,2016,450,184,266,69.2,449,184,265,69.4
37410, 봉화군,085002, 81세,2016,458,153,305,50.2,458,153,305,50.2
37410, 봉화군,085003, 82세,2016,356,132,224,58.9,356,132,224,58.9
37410, 봉화군,085004, 83세,2016,287,100,187,53.5,287,100,187,53.5
37410, 봉화군,085005, 84세,2016,246,84,162,51.9,245,83,162,51.2
37410, 봉화군,090,85~89세,2016,788,239,549,43.5,788,239,549,43.5
37410, 봉화군,090001, 85세,2016,194,57,137,41.6,194,57,137,41.6
37410, 봉화군,090002, 86세,2016,209,68,141,48.2,209,68,141,48.2
37410, 봉화군,090003, 87세,2016,151,47,104,45.2,151,47,104,45.2
37410, 봉화군,090004, 88세,2016,123,39,84,46.4,123,39,84,46.4
37410, 봉화군,090005, 89세,2016,111,28,83,33.7,111,28,83,33.7
37410, 봉화군,095,90~94세,2016,278,60,218,27.5,278,60,218,27.5
37410, 봉화군,095001, 90세,2016,76,13,63,20.6,76,13,63,20.6
37410, 봉화군,095002, 91세,2016,79,14,65,21.5,79,14,65,21.5
37410, 봉화군,095003, 92세,2016,43,12,31,38.7,43,12,31,38.7
37410, 봉화군,095004, 93세,2016,45,8,37,21.6,45,8,37,21.6
37410, 봉화군,095005, 94세,2016,35,13,22,59.1,35,13,22,59.1
37410, 봉화군,100,95~99세,2016,64,8,56,14.3,64,8,56,14.3
37410, 봉화군,100001, 95세,2016,26,X,23,13,26,X,23,13
37410, 봉화군,100002, 96세,2016,10,X,8,25,10,X,8,25
37410, 봉화군,100003, 97세,2016,10,X,9,11.1,10,X,9,11.1
37410, 봉화군,100004, 98세,2016,14,X,13,7.7,14,X,13,7.7
37410, 봉화군,100005, 99세,2016,X,X,X,33.3,X,X,X,33.3
37410, 봉화군,101,100세이상,2016,9,5,X,125,9,5,X,125
37410, 봉화군,102,15세미만,2016,2717,1417,1300,109,2711,1416,1295,109.3
37410, 봉화군,103,15~64세,2016,18183,9759,8424,115.8,17859,9640,8219,117.3
37410, 봉화군,104,65세이상,2016,10362,4215,6147,68.6,10350,4211,6139,68.6
37410, 봉화군,086,85세이상,2016,1139,312,827,37.7,1139,312,827,37.7
37410, 봉화군,126,평균연령,2016,52.8,50.3,55.2,,53,50.4,55.5,
37410, 봉화군,127,중위연령,2016,56.5,54.4,58.9,,56.7,54.5,59.2,
37420, 울진군,000,합계,2016,49043,25054,23989,104.4,47657,23898,23759,100.6
37420, 울진군,005,0~4세,2016,1840,956,884,108.1,1837,955,882,108.3
37420, 울진군,005001, 0세,2016,334,156,178,87.6,334,156,178,87.6
37420, 울진군,005002, 1세,2016,366,200,166,120.5,365,200,165,121.2
37420, 울진군,005003, 2세,2016,391,194,197,98.5,390,193,197,98
37420, 울진군,005004, 3세,2016,367,193,174,110.9,367,193,174,110.9
37420, 울진군,005005, 4세,2016,382,213,169,126,381,213,168,126.8
37420, 울진군,010,5~9세,2016,1799,946,853,110.9,1795,946,849,111.4
37420, 울진군,010001, 5세,2016,360,174,186,93.5,358,174,184,94.6
37420, 울진군,010002, 6세,2016,349,191,158,120.9,349,191,158,120.9
37420, 울진군,010003, 7세,2016,323,161,162,99.4,322,161,161,100
37420, 울진군,010004, 8세,2016,378,199,179,111.2,377,199,178,111.8
37420, 울진군,010005, 9세,2016,389,221,168,131.5,389,221,168,131.5
37420, 울진군,015,10~14세,2016,1839,952,887,107.3,1837,951,886,107.3
37420, 울진군,015001, 10세,2016,344,189,155,121.9,343,188,155,121.3
37420, 울진군,015002, 11세,2016,345,166,179,92.7,345,166,179,92.7
37420, 울진군,015003, 12세,2016,375,202,173,116.8,375,202,173,116.8
37420, 울진군,015004, 13세,2016,341,171,170,100.6,341,171,170,100.6
37420, 울진군,015005, 14세,2016,434,224,210,106.7,433,224,209,107.2
37420, 울진군,020,15~19세,2016,2280,1319,961,137.3,2279,1318,961,137.1
37420, 울진군,020001, 15세,2016,454,254,200,127,454,254,200,127
37420, 울진군,020002, 16세,2016,567,337,230,146.5,567,337,230,146.5
37420, 울진군,020003, 17세,2016,552,299,253,118.2,552,299,253,118.2
37420, 울진군,020004, 18세,2016,472,263,209,125.8,472,263,209,125.8
37420, 울진군,020005, 19세,2016,235,166,69,240.6,234,165,69,239.1
37420, 울진군,025,20~24세,2016,1737,1171,566,206.9,1575,1040,535,194.4
37420, 울진군,025001, 20세,2016,316,263,53,496.2,312,259,53,488.7
37420, 울진군,025002, 21세,2016,354,279,75,372,338,266,72,369.4
37420, 울진군,025003, 22세,2016,348,232,116,200,326,212,114,186
37420, 울진군,025004, 23세,2016,318,176,142,123.9,268,136,132,103
37420, 울진군,025005, 24세,2016,401,221,180,122.8,331,167,164,101.8
37420, 울진군,030,25~29세,2016,2353,1442,911,158.3,2007,1150,857,134.2
37420, 울진군,030001, 25세,2016,456,256,200,128,388,201,187,107.5
37420, 울진군,030002, 26세,2016,435,278,157,177.1,370,222,148,150
37420, 울진군,030003, 27세,2016,462,310,152,203.9,386,244,142,171.8
37420, 울진군,030004, 28세,2016,497,303,194,156.2,432,248,184,134.8
37420, 울진군,030005, 29세,2016,503,295,208,141.8,431,235,196,119.9
37420, 울진군,035,30~34세,2016,2519,1515,1004,150.9,2206,1233,973,126.7
37420, 울진군,035001, 30세,2016,438,271,167,162.3,375,219,156,140.4
37420, 울진군,035002, 31세,2016,451,272,179,152,390,218,172,126.7
37420, 울진군,035003, 32세,2016,481,290,191,151.8,418,232,186,124.7
37420, 울진군,035004, 33세,2016,538,325,213,152.6,473,264,209,126.3
37420, 울진군,035005, 34세,2016,611,357,254,140.6,550,300,250,120
37420, 울진군,040,35~39세,2016,3053,1706,1347,126.7,2852,1519,1333,114
37420, 울진군,040001, 35세,2016,595,344,251,137.1,551,302,249,121.3
37420, 울진군,040002, 36세,2016,643,350,293,119.5,597,310,287,108
37420, 울진군,040003, 37세,2016,622,356,266,133.8,581,318,263,120.9
37420, 울진군,040004, 38세,2016,600,345,255,135.3,562,310,252,123
37420, 울진군,040005, 39세,2016,593,311,282,110.3,561,279,282,98.9
37420, 울진군,045,40~44세,2016,3243,1865,1378,135.3,3095,1731,1364,126.9
37420, 울진군,045001, 40세,2016,582,356,226,157.5,543,318,225,141.3
37420, 울진군,045002, 41세,2016,652,369,283,130.4,617,336,281,119.6
37420, 울진군,045003, 42세,2016,624,346,278,124.5,598,322,276,116.7
37420, 울진군,045004, 43세,2016,736,421,315,133.7,712,399,313,127.5
37420, 울진군,045005, 44세,2016,649,373,276,135.1,625,356,269,132.3
37420, 울진군,050,45~49세,2016,3836,2147,1689,127.1,3735,2067,1668,123.9
37420, 울진군,050001, 45세,2016,848,498,350,142.3,815,469,346,135.5
37420, 울진군,050002, 46세,2016,764,442,322,137.3,742,424,318,133.3
37420, 울진군,050003, 47세,2016,752,408,344,118.6,729,389,340,114.4
37420, 울진군,050004, 48세,2016,746,397,349,113.8,733,389,344,113.1
37420, 울진군,050005, 49세,2016,726,402,324,124.1,716,396,320,123.8
37420, 울진군,055,50~54세,2016,4054,2183,1871,116.7,4021,2168,1853,117
37420, 울진군,055001, 50세,2016,767,428,339,126.3,759,426,333,127.9
37420, 울진군,055002, 51세,2016,787,423,364,116.2,783,421,362,116.3
37420, 울진군,055003, 52세,2016,754,420,334,125.7,746,416,330,126.1
37420, 울진군,055004, 53세,2016,846,456,390,116.9,840,453,387,117.1
37420, 울진군,055005, 54세,2016,900,456,444,102.7,893,452,441,102.5
37420, 울진군,060,55~59세,2016,4591,2363,2228,106.1,4558,2352,2206,106.6
37420, 울진군,060001, 55세,2016,1065,565,500,113,1053,563,490,114.9
37420, 울진군,060002, 56세,2016,990,498,492,101.2,979,494,485,101.9
37420, 울진군,060003, 57세,2016,860,422,438,96.3,856,419,437,95.9
37420, 울진군,060004, 58세,2016,816,430,386,111.4,814,430,384,112
37420, 울진군,060005, 59세,2016,860,448,412,108.7,856,446,410,108.8
37420, 울진군,065,60~64세,2016,3733,1818,1915,94.9,3710,1804,1906,94.6
37420, 울진군,065001, 60세,2016,877,409,468,87.4,876,408,468,87.2
37420, 울진군,065002, 61세,2016,748,380,368,103.3,745,379,366,103.6
37420, 울진군,065003, 62세,2016,758,372,386,96.4,752,369,383,96.3
37420, 울진군,065004, 63세,2016,700,347,353,98.3,693,342,351,97.4
37420, 울진군,065005, 64세,2016,650,310,340,91.2,644,306,338,90.5
37420, 울진군,070,65~69세,2016,2953,1432,1521,94.1,2942,1427,1515,94.2
37420, 울진군,070001, 65세,2016,492,239,253,94.5,488,237,251,94.4
37420, 울진군,070002, 66세,2016,605,300,305,98.4,601,299,302,99
37420, 울진군,070003, 67세,2016,645,315,330,95.5,643,313,330,94.8
37420, 울진군,070004, 68세,2016,677,340,337,100.9,676,340,336,101.2
37420, 울진군,070005, 69세,2016,534,238,296,80.4,534,238,296,80.4
37420, 울진군,075,70~74세,2016,2873,1226,1647,74.4,2871,1225,1646,74.4
37420, 울진군,075001, 70세,2016,455,233,222,105,455,233,222,105
37420, 울진군,075002, 71세,2016,516,205,311,65.9,516,205,311,65.9
37420, 울진군,075003, 72세,2016,526,215,311,69.1,524,214,310,69
37420, 울진군,075004, 73세,2016,667,282,385,73.2,667,282,385,73.2
37420, 울진군,075005, 74세,2016,709,291,418,69.6,709,291,418,69.6
37420, 울진군,080,75~79세,2016,2932,1088,1844,59,2931,1088,1843,59
37420, 울진군,080001, 75세,2016,577,227,350,64.9,577,227,350,64.9
37420, 울진군,080002, 76세,2016,596,215,381,56.4,596,215,381,56.4
37420, 울진군,080003, 77세,2016,656,241,415,58.1,655,241,414,58.2
37420, 울진군,080004, 78세,2016,565,220,345,63.8,565,220,345,63.8
37420, 울진군,080005, 79세,2016,538,185,353,52.4,538,185,353,52.4
37420, 울진군,085,80~84세,2016,2026,640,1386,46.2,2025,640,1385,46.2
37420, 울진군,085001, 80세,2016,502,178,324,54.9,502,178,324,54.9
37420, 울진군,085002, 81세,2016,489,153,336,45.5,489,153,336,45.5
37420, 울진군,085003, 82세,2016,381,132,249,53,381,132,249,53
37420, 울진군,085004, 83세,2016,339,112,227,49.3,338,112,226,49.6
37420, 울진군,085005, 84세,2016,315,65,250,26,315,65,250,26
37420, 울진군,090,85~89세,2016,991,222,769,28.9,991,222,769,28.9
37420, 울진군,090001, 85세,2016,279,67,212,31.6,279,67,212,31.6
37420, 울진군,090002, 86세,2016,250,62,188,33,250,62,188,33
37420, 울진군,090003, 87세,2016,188,38,150,25.3,188,38,150,25.3
37420, 울진군,090004, 88세,2016,153,29,124,23.4,153,29,124,23.4
37420, 울진군,090005, 89세,2016,121,26,95,27.4,121,26,95,27.4
37420, 울진군,095,90~94세,2016,327,52,275,18.9,327,52,275,18.9
37420, 울진군,095001, 90세,2016,98,18,80,22.5,98,18,80,22.5
37420, 울진군,095002, 91세,2016,96,15,81,18.5,96,15,81,18.5
37420, 울진군,095003, 92세,2016,56,6,50,12,56,6,50,12
37420, 울진군,095004, 93세,2016,43,9,34,26.5,43,9,34,26.5
37420, 울진군,095005, 94세,2016,34,X,30,13.3,34,X,30,13.3
37420, 울진군,100,95~99세,2016,56,10,46,21.7,55,9,46,19.6
37420, 울진군,100001, 95세,2016,19,7,12,58.3,18,6,12,50
37420, 울진군,100002, 96세,2016,12,X,12,0,12,X,12,0
37420, 울진군,100003, 97세,2016,12,X,9,33.3,12,X,9,33.3
37420, 울진군,100004, 98세,2016,9,X,9,0,9,X,9,0
37420, 울진군,100005, 99세,2016,X,X,X,0,X,X,X,0
37420, 울진군,101,100세이상,2016,8,X,7,14.3,8,X,7,14.3
37420, 울진군,102,15세미만,2016,5478,2854,2624,108.8,5469,2852,2617,109
37420, 울진군,103,15~64세,2016,31399,17529,13870,126.4,30038,16382,13656,120
37420, 울진군,104,65세이상,2016,12166,4671,7495,62.3,12150,4664,7486,62.3
37420, 울진군,086,85세이상,2016,1382,285,1097,26,1381,284,1097,25.9
37420, 울진군,126,평균연령,2016,47.6,44.6,50.8,,48,45.1,51,
37420, 울진군,127,중위연령,2016,50,46.4,54.2,,50.8,47.5,54.4,
37430, 울릉군,000,합계,2016,8490,4661,3829,121.7,8300,4515,3785,119.3
37430, 울릉군,005,0~4세,2016,232,119,113,105.3,231,118,113,104.4
37430, 울릉군,005001, 0세,2016,31,24,7,342.9,31,24,7,342.9
37430, 울릉군,005002, 1세,2016,55,26,29,89.7,54,25,29,86.2
37430, 울릉군,005003, 2세,2016,47,24,23,104.3,47,24,23,104.3
37430, 울릉군,005004, 3세,2016,49,24,25,96,49,24,25,96
37430, 울릉군,005005, 4세,2016,50,21,29,72.4,50,21,29,72.4
37430, 울릉군,010,5~9세,2016,241,123,118,104.2,241,123,118,104.2
37430, 울릉군,010001, 5세,2016,51,33,18,183.3,51,33,18,183.3
37430, 울릉군,010002, 6세,2016,38,18,20,90,38,18,20,90
37430, 울릉군,010003, 7세,2016,40,20,20,100,40,20,20,100
37430, 울릉군,010004, 8세,2016,54,32,22,145.5,54,32,22,145.5
37430, 울릉군,010005, 9세,2016,58,20,38,52.6,58,20,38,52.6
37430, 울릉군,015,10~14세,2016,235,124,111,111.7,235,124,111,111.7
37430, 울릉군,015001, 10세,2016,44,25,19,131.6,44,25,19,131.6
37430, 울릉군,015002, 11세,2016,54,28,26,107.7,54,28,26,107.7
37430, 울릉군,015003, 12세,2016,44,21,23,91.3,44,21,23,91.3
37430, 울릉군,015004, 13세,2016,45,26,19,136.8,45,26,19,136.8
37430, 울릉군,015005, 14세,2016,48,24,24,100,48,24,24,100
37430, 울릉군,020,15~19세,2016,254,126,128,98.4,254,126,128,98.4
37430, 울릉군,020001, 15세,2016,57,28,29,96.6,57,28,29,96.6
37430, 울릉군,020002, 16세,2016,64,23,41,56.1,64,23,41,56.1
37430, 울릉군,020003, 17세,2016,54,27,27,100,54,27,27,100
37430, 울릉군,020004, 18세,2016,45,27,18,150,45,27,18,150
37430, 울릉군,020005, 19세,2016,34,21,13,161.5,34,21,13,161.5
37430, 울릉군,025,20~24세,2016,320,223,97,229.9,305,210,95,221.1
37430, 울릉군,025001, 20세,2016,39,33,6,550,38,33,5,660
37430, 울릉군,025002, 21세,2016,79,59,20,295,75,55,20,275
37430, 울릉군,025003, 22세,2016,66,48,18,266.7,64,47,17,276.5
37430, 울릉군,025004, 23세,2016,68,41,27,151.9,63,36,27,133.3
37430, 울릉군,025005, 24세,2016,68,42,26,161.5,65,39,26,150
37430, 울릉군,030,25~29세,2016,465,282,183,154.1,407,234,173,135.3
37430, 울릉군,030001, 25세,2016,87,52,35,148.6,77,43,34,126.5
37430, 울릉군,030002, 26세,2016,109,66,43,153.5,91,52,39,133.3
37430, 울릉군,030003, 27세,2016,104,61,43,141.9,92,50,42,119
37430, 울릉군,030004, 28세,2016,87,54,33,163.6,77,46,31,148.4
37430, 울릉군,030005, 29세,2016,78,49,29,169,70,43,27,159.3
37430, 울릉군,035,30~34세,2016,481,283,198,142.9,448,252,196,128.6
37430, 울릉군,035001, 30세,2016,78,51,27,188.9,70,45,25,180
37430, 울릉군,035002, 31세,2016,90,54,36,150,81,45,36,125
37430, 울릉군,035003, 32세,2016,103,51,52,98.1,97,45,52,86.5
37430, 울릉군,035004, 33세,2016,95,57,38,150,90,52,38,136.8
37430, 울릉군,035005, 34세,2016,115,70,45,155.6,110,65,45,144.4
37430, 울릉군,040,35~39세,2016,531,316,215,147,507,297,210,141.4
37430, 울릉군,040001, 35세,2016,114,70,44,159.1,108,65,43,151.2
37430, 울릉군,040002, 36세,2016,111,71,40,177.5,103,64,39,164.1
37430, 울릉군,040003, 37세,2016,89,55,34,161.8,84,50,34,147.1
37430, 울릉군,040004, 38세,2016,106,58,48,120.8,104,58,46,126.1
37430, 울릉군,040005, 39세,2016,111,62,49,126.5,108,60,48,125
37430, 울릉군,045,40~44세,2016,607,372,235,158.3,596,362,234,154.7
37430, 울릉군,045001, 40세,2016,115,63,52,121.2,112,61,51,119.6
37430, 울릉군,045002, 41세,2016,99,70,29,241.4,97,68,29,234.5
37430, 울릉군,045003, 42세,2016,143,88,55,160,140,85,55,154.5
37430, 울릉군,045004, 43세,2016,128,76,52,146.2,125,73,52,140.4
37430, 울릉군,045005, 44세,2016,122,75,47,159.6,122,75,47,159.6
37430, 울릉군,050,45~49세,2016,741,462,279,165.6,734,460,274,167.9
37430, 울릉군,050001, 45세,2016,157,104,53,196.2,156,104,52,200
37430, 울릉군,050002, 46세,2016,142,83,59,140.7,140,83,57,145.6
37430, 울릉군,050003, 47세,2016,142,95,47,202.1,140,93,47,197.9
37430, 울릉군,050004, 48세,2016,162,100,62,161.3,162,100,62,161.3
37430, 울릉군,050005, 49세,2016,138,80,58,137.9,136,80,56,142.9
37430, 울릉군,055,50~54세,2016,855,502,353,142.2,849,499,350,142.6
37430, 울릉군,055001, 50세,2016,174,100,74,135.1,172,99,73,135.6
37430, 울릉군,055002, 51세,2016,172,112,60,186.7,170,111,59,188.1
37430, 울릉군,055003, 52세,2016,146,83,63,131.7,146,83,63,131.7
37430, 울릉군,055004, 53세,2016,179,96,83,115.7,179,96,83,115.7
37430, 울릉군,055005, 54세,2016,184,111,73,152.1,182,110,72,152.8
37430, 울릉군,060,55~59세,2016,978,518,460,112.6,961,511,450,113.6
37430, 울릉군,060001, 55세,2016,218,109,109,100,216,108,108,100
37430, 울릉군,060002, 56세,2016,195,113,82,137.8,190,110,80,137.5
37430, 울릉군,060003, 57세,2016,200,100,100,100,197,99,98,101
37430, 울릉군,060004, 58세,2016,179,94,85,110.6,174,92,82,112.2
37430, 울릉군,060005, 59세,2016,186,102,84,121.4,184,102,82,124.4
37430, 울릉군,065,60~64세,2016,748,385,363,106.1,736,376,360,104.4
37430, 울릉군,065001, 60세,2016,163,87,76,114.5,161,85,76,111.8
37430, 울릉군,065002, 61세,2016,151,83,68,122.1,148,80,68,117.6
37430, 울릉군,065003, 62세,2016,137,70,67,104.5,133,69,64,107.8
37430, 울릉군,065004, 63세,2016,152,75,77,97.4,150,73,77,94.8
37430, 울릉군,065005, 64세,2016,145,70,75,93.3,144,69,75,92
37430, 울릉군,070,65~69세,2016,577,292,285,102.5,573,289,284,101.8
37430, 울릉군,070001, 65세,2016,128,74,54,137,127,73,54,135.2
37430, 울릉군,070002, 66세,2016,110,45,65,69.2,109,44,65,67.7
37430, 울릉군,070003, 67세,2016,100,47,53,88.7,99,47,52,90.4
37430, 울릉군,070004, 68세,2016,121,65,56,116.1,120,64,56,114.3
37430, 울릉군,070005, 69세,2016,118,61,57,107,118,61,57,107
37430, 울릉군,075,70~74세,2016,484,234,250,93.6,483,234,249,94
37430, 울릉군,075001, 70세,2016,97,48,49,98,97,48,49,98
37430, 울릉군,075002, 71세,2016,98,44,54,81.5,98,44,54,81.5
37430, 울릉군,075003, 72세,2016,97,48,49,98,97,48,49,98
37430, 울릉군,075004, 73세,2016,83,38,45,84.4,83,38,45,84.4
37430, 울릉군,075005, 74세,2016,109,56,53,105.7,108,56,52,107.7
37430, 울릉군,080,75~79세,2016,350,158,192,82.3,349,158,191,82.7
37430, 울릉군,080001, 75세,2016,78,39,39,100,77,39,38,102.6
37430, 울릉군,080002, 76세,2016,70,34,36,94.4,70,34,36,94.4
37430, 울릉군,080003, 77세,2016,80,40,40,100,80,40,40,100
37430, 울릉군,080004, 78세,2016,59,22,37,59.5,59,22,37,59.5
37430, 울릉군,080005, 79세,2016,63,23,40,57.5,63,23,40,57.5
37430, 울릉군,085,80~84세,2016,234,97,137,70.8,234,97,137,70.8
37430, 울릉군,085001, 80세,2016,64,33,31,106.5,64,33,31,106.5
37430, 울릉군,085002, 81세,2016,54,28,26,107.7,54,28,26,107.7
37430, 울릉군,085003, 82세,2016,46,16,30,53.3,46,16,30,53.3
37430, 울릉군,085004, 83세,2016,34,9,25,36,34,9,25,36
37430, 울릉군,085005, 84세,2016,36,11,25,44,36,11,25,44
37430, 울릉군,090,85~89세,2016,116,35,81,43.2,116,35,81,43.2
37430, 울릉군,090001, 85세,2016,33,11,22,50,33,11,22,50
37430, 울릉군,090002, 86세,2016,37,11,26,42.3,37,11,26,42.3
37430, 울릉군,090003, 87세,2016,21,7,14,50,21,7,14,50
37430, 울릉군,090004, 88세,2016,16,X,14,14.3,16,X,14,14.3
37430, 울릉군,090005, 89세,2016,9,X,5,80,9,X,5,80
37430, 울릉군,095,90~94세,2016,27,9,18,50,27,9,18,50
37430, 울릉군,095001, 90세,2016,8,5,X,166.7,8,5,X,166.7
37430, 울릉군,095002, 91세,2016,8,X,7,14.3,8,X,7,14.3
37430, 울릉군,095003, 92세,2016,5,X,X,66.7,5,X,X,66.7
37430, 울릉군,095004, 93세,2016,5,X,X,25,5,X,X,25
37430, 울릉군,095005, 94세,2016,X,X,X,0,X,X,X,0
37430, 울릉군,100,95~99세,2016,13,X,12,8.3,13,X,12,8.3
37430, 울릉군,100001, 95세,2016,5,X,5,0,5,X,5,0
37430, 울릉군,100002, 96세,2016,6,X,6,0,6,X,6,0
37430, 울릉군,100003, 97세,2016,X,X,X,,X,X,X,
37430, 울릉군,100004, 98세,2016,X,X,X,100,X,X,X,100
37430, 울릉군,100005, 99세,2016,X,X,X,,X,X,X,
37430, 울릉군,101,100세이상,2016,X,X,X,0,X,X,X,0
37430, 울릉군,102,15세미만,2016,708,366,342,107,707,365,342,106.7
37430, 울릉군,103,15~64세,2016,5980,3469,2511,138.2,5797,3327,2470,134.7
37430, 울릉군,104,65세이상,2016,1802,826,976,84.6,1796,823,973,84.6
37430, 울릉군,086,85세이상,2016,157,45,112,40.2,157,45,112,40.2
37430, 울릉군,126,평균연령,2016,48.1,46.6,49.9,,48.3,47,49.9,
37430, 울릉군,127,중위연령,2016,50.8,48.8,53.5,,51.1,49.4,53.5,
38,경상남도,000,합계,2016,3339633,1701849,1637784,103.9,3247448,1636954,1610494,101.6
38,경상남도,005,0~4세,2016,152545,78417,74128,105.8,151512,77903,73609,105.8
38,경상남도,005001, 0세,2016,27742,14184,13558,104.6,27561,14094,13467,104.7
38,경상남도,005002, 1세,2016,29991,15392,14599,105.4,29771,15284,14487,105.5
38,경상남도,005003, 2세,2016,30497,15699,14798,106.1,30275,15594,14681,106.2
38,경상남도,005004, 3세,2016,30713,15862,14851,106.8,30507,15752,14755,106.8
38,경상남도,005005, 4세,2016,33602,17280,16322,105.9,33398,17179,16219,105.9
38,경상남도,010,5~9세,2016,161229,83329,77900,107,160456,82946,77510,107
38,경상남도,010001, 5세,2016,33253,17142,16111,106.4,33070,17049,16021,106.4
38,경상남도,010002, 6세,2016,31885,16538,15347,107.8,31708,16450,15258,107.8
38,경상남도,010003, 7세,2016,30819,16001,14818,108,30672,15931,14741,108.1
38,경상남도,010004, 8세,2016,32489,16665,15824,105.3,32335,16594,15741,105.4
38,경상남도,010005, 9세,2016,32783,16983,15800,107.5,32671,16922,15749,107.4
38,경상남도,015,10~14세,2016,156087,81997,74090,110.7,155633,81779,73854,110.7
38,경상남도,015001, 10세,2016,29780,15477,14303,108.2,29661,15421,14240,108.3
38,경상남도,015002, 11세,2016,29168,15197,13971,108.8,29076,15155,13921,108.9
38,경상남도,015003, 12세,2016,31588,16651,14937,111.5,31500,16610,14890,111.6
38,경상남도,015004, 13세,2016,32039,16977,15062,112.7,31953,16933,15020,112.7
38,경상남도,015005, 14세,2016,33512,17695,15817,111.9,33443,17660,15783,111.9
38,경상남도,020,15~19세,2016,199413,106634,92779,114.9,198603,106258,92345,115.1
38,경상남도,020001, 15세,2016,38378,20304,18074,112.3,38310,20268,18042,112.3
38,경상남도,020002, 16세,2016,42321,22226,20095,110.6,42238,22182,20056,110.6
38,경상남도,020003, 17세,2016,41288,21781,19507,111.7,41175,21723,19452,111.7
38,경상남도,020004, 18세,2016,40624,21636,18988,113.9,40452,21547,18905,114
38,경상남도,020005, 19세,2016,36802,20687,16115,128.4,36428,20538,15890,129.3
38,경상남도,025,20~24세,2016,205082,118416,86666,136.6,195198,111892,83306,134.3
38,경상남도,025001, 20세,2016,40715,23986,16729,143.4,39913,23599,16314,144.7
38,경상남도,025002, 21세,2016,41759,24766,16993,145.7,40455,24025,16430,146.2
38,경상남도,025003, 22세,2016,41186,23765,17421,136.4,39324,22568,16756,134.7
38,경상남도,025004, 23세,2016,40679,23179,17500,132.5,38043,21347,16696,127.9
38,경상남도,025005, 24세,2016,40743,22720,18023,126.1,37463,20353,17110,119
38,경상남도,030,25~29세,2016,190435,108016,82419,131.1,169649,92300,77349,119.3
38,경상남도,030001, 25세,2016,38877,21979,16898,130.1,35262,19331,15931,121.3
38,경상남도,030002, 26세,2016,38337,21983,16354,134.4,34092,18790,15302,122.8
38,경상남도,030003, 27세,2016,37652,21576,16076,134.2,33486,18398,15088,121.9
38,경상남도,030004, 28세,2016,37131,21022,16109,130.5,32827,17725,15102,117.4
38,경상남도,030005, 29세,2016,38438,21456,16982,126.3,33982,18056,15926,113.4
38,경상남도,035,30~34세,2016,226227,123978,102249,121.3,207206,109005,98201,111
38,경상남도,035001, 30세,2016,39653,22435,17218,130.3,35410,19164,16246,118
38,경상남도,035002, 31세,2016,40942,22960,17982,127.7,36783,19634,17149,114.5
38,경상남도,035003, 32세,2016,43995,24041,19954,120.5,40171,21015,19156,109.7
38,경상남도,035004, 33세,2016,48488,26197,22291,117.5,45023,23442,21581,108.6
38,경상남도,035005, 34세,2016,53149,28345,24804,114.3,49819,25750,24069,107
38,경상남도,040,35~39세,2016,260054,138078,121976,113.2,247969,128697,119272,107.9
38,경상남도,040001, 35세,2016,54054,29120,24934,116.8,51215,26876,24339,110.4
38,경상남도,040002, 36세,2016,55973,29508,26465,111.5,53340,27437,25903,105.9
38,경상남도,040003, 37세,2016,52372,27816,24556,113.3,49964,25969,23995,108.2
38,경상남도,040004, 38세,2016,48647,25861,22786,113.5,46376,24130,22246,108.5
38,경상남도,040005, 39세,2016,49008,25773,23235,110.9,47074,24285,22789,106.6
38,경상남도,045,40~44세,2016,270635,141078,129557,108.9,262255,135002,127253,106.1
38,경상남도,045001, 40세,2016,48630,25637,22993,111.5,46671,24144,22527,107.2
38,경상남도,045002, 41세,2016,51877,26860,25017,107.4,50141,25598,24543,104.3
38,경상남도,045003, 42세,2016,55799,29000,26799,108.2,54207,27845,26362,105.6
38,경상남도,045004, 43세,2016,58065,29916,28149,106.3,56541,28831,27710,104
38,경상남도,045005, 44세,2016,56264,29665,26599,111.5,54695,28584,26111,109.5
38,경상남도,050,45~49세,2016,297162,151815,145347,104.5,290360,147563,142797,103.3
38,경상남도,050001, 45세,2016,60655,31343,29312,106.9,59104,30288,28816,105.1
38,경상남도,050002, 46세,2016,60102,30921,29181,106,58609,29973,28636,104.7
38,경상남도,050003, 47세,2016,60149,30918,29231,105.8,58818,30120,28698,105
38,경상남도,050004, 48세,2016,60357,30479,29878,102,59078,29704,29374,101.1
38,경상남도,050005, 49세,2016,55899,28154,27745,101.5,54751,27478,27273,100.8
38,경상남도,055,50~54세,2016,272906,140932,131974,106.8,267481,137913,129568,106.4
38,경상남도,055001, 50세,2016,55277,28984,26293,110.2,54207,28374,25833,109.8
38,경상남도,055002, 51세,2016,55386,28180,27206,103.6,54231,27526,26705,103.1
38,경상남도,055003, 52세,2016,49605,25402,24203,105,48509,24797,23712,104.6
38,경상남도,055004, 53세,2016,54316,28364,25952,109.3,53147,27743,25404,109.2
38,경상남도,055005, 54세,2016,58322,30002,28320,105.9,57387,29473,27914,105.6
38,경상남도,060,55~59세,2016,276978,139961,137017,102.1,273780,138228,135552,102
38,경상남도,060001, 55세,2016,62471,31322,31149,100.6,61834,30983,30851,100.4
38,경상남도,060002, 56세,2016,60692,30410,30282,100.4,59880,29987,29893,100.3
38,경상남도,060003, 57세,2016,53271,27084,26187,103.4,52627,26730,25897,103.2
38,경상남도,060004, 58세,2016,50882,26018,24864,104.6,50302,25708,24594,104.5
38,경상남도,060005, 59세,2016,49662,25127,24535,102.4,49137,24820,24317,102.1
38,경상남도,065,60~64세,2016,203934,101137,102797,98.4,201854,100055,101799,98.3
38,경상남도,065001, 60세,2016,46283,23162,23121,100.2,45779,22902,22877,100.1
38,경상남도,065002, 61세,2016,46709,22877,23832,96,46259,22639,23620,95.8
38,경상남도,065003, 62세,2016,39520,19926,19594,101.7,39065,19699,19366,101.7
38,경상남도,065004, 63세,2016,34115,16798,17317,97,33739,16601,17138,96.9
38,경상남도,065005, 64세,2016,37307,18374,18933,97,37012,18214,18798,96.9
38,경상남도,070,65~69세,2016,147140,70997,76143,93.2,146316,70603,75713,93.3
38,경상남도,070001, 65세,2016,29707,14397,15310,94,29465,14284,15181,94.1
38,경상남도,070002, 66세,2016,29716,14515,15201,95.5,29501,14407,15094,95.4
38,경상남도,070003, 67세,2016,30247,14711,15536,94.7,30081,14624,15457,94.6
38,경상남도,070004, 68세,2016,29705,14351,15354,93.5,29605,14304,15301,93.5
38,경상남도,070005, 69세,2016,27765,13023,14742,88.3,27664,12984,14680,88.4
38,경상남도,075,70~74세,2016,112815,49123,63692,77.1,112522,48992,63530,77.1
38,경상남도,075001, 70세,2016,20515,9660,10855,89,20435,9622,10813,89
38,경상남도,075002, 71세,2016,21014,9408,11606,81.1,20952,9383,11569,81.1
38,경상남도,075003, 72세,2016,22216,9676,12540,77.2,22152,9646,12506,77.1
38,경상남도,075004, 73세,2016,23086,9719,13367,72.7,23037,9693,13344,72.6
38,경상남도,075005, 74세,2016,25984,10660,15324,69.6,25946,10648,15298,69.6
38,경상남도,080,75~79세,2016,100841,38147,62694,60.8,100652,38076,62576,60.8
38,경상남도,080001, 75세,2016,22713,9112,13601,67,22677,9098,13579,67
38,경상남도,080002, 76세,2016,21349,8227,13122,62.7,21296,8203,13093,62.7
38,경상남도,080003, 77세,2016,21073,7909,13164,60.1,21045,7899,13146,60.1
38,경상남도,080004, 78세,2016,17990,6583,11407,57.7,17947,6570,11377,57.7
38,경상남도,080005, 79세,2016,17716,6316,11400,55.4,17687,6306,11381,55.4
38,경상남도,085,80~84세,2016,65799,20646,45153,45.7,65702,20611,45091,45.7
38,경상남도,085001, 80세,2016,16125,5543,10582,52.4,16100,5531,10569,52.3
38,경상남도,085002, 81세,2016,15119,4947,10172,48.6,15094,4938,10156,48.6
38,경상남도,085003, 82세,2016,13185,4065,9120,44.6,13166,4057,9109,44.5
38,경상남도,085004, 83세,2016,11089,3279,7810,42,11072,3273,7799,42
38,경상남도,085005, 84세,2016,10281,2812,7469,37.6,10270,2812,7458,37.7
38,경상남도,090,85~89세,2016,29738,7126,22612,31.5,29708,7118,22590,31.5
38,경상남도,090001, 85세,2016,8079,2061,6018,34.2,8072,2059,6013,34.2
38,경상남도,090002, 86세,2016,7054,1621,5433,29.8,7047,1620,5427,29.9
38,경상남도,090003, 87세,2016,6157,1490,4667,31.9,6150,1488,4662,31.9
38,경상남도,090004, 88세,2016,4684,1086,3598,30.2,4680,1084,3596,30.1
38,경상남도,090005, 89세,2016,3764,868,2896,30,3759,867,2892,30
38,경상남도,095,90~94세,2016,8893,1740,7153,24.3,8880,1735,7145,24.3
38,경상남도,095001, 90세,2016,2679,561,2118,26.5,2677,559,2118,26.4
38,경상남도,095002, 91세,2016,2344,439,1905,23,2338,438,1900,23.1
38,경상남도,095003, 92세,2016,1516,313,1203,26,1513,312,1201,26
38,경상남도,095004, 93세,2016,1389,249,1140,21.8,1387,248,1139,21.8
38,경상남도,095005, 94세,2016,965,178,787,22.6,965,178,787,22.6
38,경상남도,100,95~99세,2016,1542,264,1278,20.7,1536,261,1275,20.5
38,경상남도,100001, 95세,2016,605,100,505,19.8,602,98,504,19.4
38,경상남도,100002, 96세,2016,426,68,358,19,423,67,356,18.8
38,경상남도,100003, 97세,2016,215,46,169,27.2,215,46,169,27.2
38,경상남도,100004, 98세,2016,174,34,140,24.3,174,34,140,24.3
38,경상남도,100005, 99세,2016,122,16,106,15.1,122,16,106,15.1
38,경상남도,101,100세이상,2016,178,18,160,11.3,176,17,159,10.7
38,경상남도,102,15세미만,2016,469861,243743,226118,107.8,467601,242628,224973,107.8
38,경상남도,103,15~64세,2016,2402826,1270045,1132781,112.1,2314355,1206913,1107442,109
38,경상남도,104,65세이상,2016,466946,188061,278885,67.4,465492,187413,278079,67.4
38,경상남도,086,85세이상,2016,40351,9148,31203,29.3,40300,9131,31169,29.3
38,경상남도,126,평균연령,2016,41.2,39.6,42.8,,41.3,39.7,42.9,
38,경상남도,127,중위연령,2016,42.3,40.5,44.1,,42.8,41.1,44.3,
38004, 읍부,000,합계,2016,474414,238842,235572,101.4,463986,231926,232060,99.9
38004, 읍부,005,0~4세,2016,24512,12543,11969,104.8,24385,12483,11902,104.9
38004, 읍부,005001, 0세,2016,4411,2265,2146,105.5,4391,2255,2136,105.6
38004, 읍부,005002, 1세,2016,4853,2489,2364,105.3,4825,2480,2345,105.8
38004, 읍부,005003, 2세,2016,4902,2473,2429,101.8,4875,2460,2415,101.9
38004, 읍부,005004, 3세,2016,4936,2540,2396,106,4910,2528,2382,106.1
38004, 읍부,005005, 4세,2016,5410,2776,2634,105.4,5384,2760,2624,105.2
38004, 읍부,010,5~9세,2016,25817,13413,12404,108.1,25722,13373,12349,108.3
38004, 읍부,010001, 5세,2016,5377,2779,2598,107,5360,2771,2589,107
38004, 읍부,010002, 6세,2016,5133,2661,2472,107.6,5113,2654,2459,107.9
38004, 읍부,010003, 7세,2016,4997,2569,2428,105.8,4977,2561,2416,106
38004, 읍부,010004, 8세,2016,5207,2696,2511,107.4,5183,2687,2496,107.7
38004, 읍부,010005, 9세,2016,5103,2708,2395,113.1,5089,2700,2389,113
38004, 읍부,015,10~14세,2016,24341,12758,11583,110.1,24291,12734,11557,110.2
38004, 읍부,015001, 10세,2016,4695,2418,2277,106.2,4681,2409,2272,106
38004, 읍부,015002, 11세,2016,4670,2417,2253,107.3,4660,2412,2248,107.3
38004, 읍부,015003, 12세,2016,4969,2591,2378,109,4960,2588,2372,109.1
38004, 읍부,015004, 13세,2016,4938,2634,2304,114.3,4925,2629,2296,114.5
38004, 읍부,015005, 14세,2016,5069,2698,2371,113.8,5065,2696,2369,113.8
38004, 읍부,020,15~19세,2016,30252,16243,14009,115.9,30167,16208,13959,116.1
38004, 읍부,020001, 15세,2016,5861,3140,2721,115.4,5852,3136,2716,115.5
38004, 읍부,020002, 16세,2016,6687,3457,3230,107,6672,3449,3223,107
38004, 읍부,020003, 17세,2016,6275,3382,2893,116.9,6262,3378,2884,117.1
38004, 읍부,020004, 18세,2016,6063,3260,2803,116.3,6051,3252,2799,116.2
38004, 읍부,020005, 19세,2016,5366,3004,2362,127.2,5330,2993,2337,128.1
38004, 읍부,025,20~24세,2016,27314,15763,11551,136.5,26361,15132,11229,134.8
38004, 읍부,025001, 20세,2016,5715,3362,2353,142.9,5655,3328,2327,143
38004, 읍부,025002, 21세,2016,5795,3513,2282,153.9,5685,3444,2241,153.7
38004, 읍부,025003, 22세,2016,5410,3205,2205,145.4,5236,3095,2141,144.6
38004, 읍부,025004, 23세,2016,5245,2921,2324,125.7,4988,2745,2243,122.4
38004, 읍부,025005, 24세,2016,5149,2762,2387,115.7,4797,2520,2277,110.7
38004, 읍부,030,25~29세,2016,24289,13044,11245,116,22048,11467,10581,108.4
38004, 읍부,030001, 25세,2016,4874,2643,2231,118.5,4488,2381,2107,113
38004, 읍부,030002, 26세,2016,4854,2622,2232,117.5,4391,2300,2091,110
38004, 읍부,030003, 27세,2016,4799,2607,2192,118.9,4381,2309,2072,111.4
38004, 읍부,030004, 28세,2016,4723,2542,2181,116.6,4252,2203,2049,107.5
38004, 읍부,030005, 29세,2016,5039,2630,2409,109.2,4536,2274,2262,100.5
38004, 읍부,035,30~34세,2016,31257,16218,15039,107.8,29127,14612,14515,100.7
38004, 읍부,035001, 30세,2016,5263,2747,2516,109.2,4778,2400,2378,100.9
38004, 읍부,035002, 31세,2016,5459,2912,2547,114.3,4981,2551,2430,105
38004, 읍부,035003, 32세,2016,6087,3143,2944,106.8,5657,2814,2843,99
38004, 읍부,035004, 33세,2016,6823,3479,3344,104,6424,3172,3252,97.5
38004, 읍부,035005, 34세,2016,7625,3937,3688,106.8,7287,3675,3612,101.7
38004, 읍부,040,35~39세,2016,38198,19499,18699,104.3,36867,18539,18328,101.2
38004, 읍부,040001, 35세,2016,7729,3926,3803,103.2,7420,3702,3718,99.6
38004, 읍부,040002, 36세,2016,8195,4195,4000,104.9,7912,3984,3928,101.4
38004, 읍부,040003, 37세,2016,7642,3872,3770,102.7,7376,3684,3692,99.8
38004, 읍부,040004, 38세,2016,7258,3710,3548,104.6,7014,3543,3471,102.1
38004, 읍부,040005, 39세,2016,7374,3796,3578,106.1,7145,3626,3519,103
38004, 읍부,045,40~44세,2016,39430,20343,19087,106.6,38475,19689,18786,104.8
38004, 읍부,045001, 40세,2016,7213,3733,3480,107.3,6999,3582,3417,104.8
38004, 읍부,045002, 41세,2016,7618,3904,3714,105.1,7407,3761,3646,103.2
38004, 읍부,045003, 42세,2016,8131,4215,3916,107.6,7948,4090,3858,106
38004, 읍부,045004, 43세,2016,8333,4240,4093,103.6,8158,4118,4040,101.9
38004, 읍부,045005, 44세,2016,8135,4251,3884,109.4,7963,4138,3825,108.2
38004, 읍부,050,45~49세,2016,41996,21651,20345,106.4,41150,21147,20003,105.7
38004, 읍부,050001, 45세,2016,8747,4553,4194,108.6,8581,4452,4129,107.8
38004, 읍부,050002, 46세,2016,8557,4419,4138,106.8,8364,4299,4065,105.8
38004, 읍부,050003, 47세,2016,8562,4455,4107,108.5,8382,4350,4032,107.9
38004, 읍부,050004, 48세,2016,8512,4356,4156,104.8,8341,4258,4083,104.3
38004, 읍부,050005, 49세,2016,7618,3868,3750,103.1,7482,3788,3694,102.5
38004, 읍부,055,50~54세,2016,37232,19456,17776,109.5,36536,19084,17452,109.4
38004, 읍부,055001, 50세,2016,7519,3983,3536,112.6,7369,3900,3469,112.4
38004, 읍부,055002, 51세,2016,7518,3871,3647,106.1,7398,3808,3590,106.1
38004, 읍부,055003, 52세,2016,6914,3609,3305,109.2,6755,3533,3222,109.7
38004, 읍부,055004, 53세,2016,7338,3840,3498,109.8,7200,3765,3435,109.6
38004, 읍부,055005, 54세,2016,7943,4153,3790,109.6,7814,4078,3736,109.2
38004, 읍부,060,55~59세,2016,37072,18713,18359,101.9,36611,18465,18146,101.8
38004, 읍부,060001, 55세,2016,8287,4175,4112,101.5,8196,4123,4073,101.2
38004, 읍부,060002, 56세,2016,8092,4067,4025,101,7978,4017,3961,101.4
38004, 읍부,060003, 57세,2016,7176,3640,3536,102.9,7091,3590,3501,102.5
38004, 읍부,060004, 58세,2016,6771,3447,3324,103.7,6689,3402,3287,103.5
38004, 읍부,060005, 59세,2016,6746,3384,3362,100.7,6657,3333,3324,100.3
38004, 읍부,065,60~64세,2016,27482,13457,14025,96,27196,13320,13876,96
38004, 읍부,065001, 60세,2016,6271,3095,3176,97.4,6201,3058,3143,97.3
38004, 읍부,065002, 61세,2016,6188,2999,3189,94,6117,2963,3154,93.9
38004, 읍부,065003, 62세,2016,5370,2666,2704,98.6,5309,2641,2668,99
38004, 읍부,065004, 63세,2016,4608,2272,2336,97.3,4559,2252,2307,97.6
38004, 읍부,065005, 64세,2016,5045,2425,2620,92.6,5010,2406,2604,92.4
38004, 읍부,070,65~69세,2016,20263,9646,10617,90.9,20157,9604,10553,91
38004, 읍부,070001, 65세,2016,4056,1910,2146,89,4023,1899,2124,89.4
38004, 읍부,070002, 66세,2016,4121,1962,2159,90.9,4089,1951,2138,91.3
38004, 읍부,070003, 67세,2016,4196,2036,2160,94.3,4178,2026,2152,94.1
38004, 읍부,070004, 68세,2016,4118,1980,2138,92.6,4104,1974,2130,92.7
38004, 읍부,070005, 69세,2016,3772,1758,2014,87.3,3763,1754,2009,87.3
38004, 읍부,075,70~74세,2016,15483,6616,8867,74.6,15455,6602,8853,74.6
38004, 읍부,075001, 70세,2016,2854,1366,1488,91.8,2842,1360,1482,91.8
38004, 읍부,075002, 71세,2016,2889,1272,1617,78.7,2883,1270,1613,78.7
38004, 읍부,075003, 72세,2016,3020,1293,1727,74.9,3017,1290,1727,74.7
38004, 읍부,075004, 73세,2016,3164,1299,1865,69.7,3160,1297,1863,69.6
38004, 읍부,075005, 74세,2016,3556,1386,2170,63.9,3553,1385,2168,63.9
38004, 읍부,080,75~79세,2016,14309,5303,9006,58.9,14290,5298,8992,58.9
38004, 읍부,080001, 75세,2016,3253,1285,1968,65.3,3249,1284,1965,65.3
38004, 읍부,080002, 76세,2016,2994,1153,1841,62.6,2988,1151,1837,62.7
38004, 읍부,080003, 77세,2016,2993,1087,1906,57,2990,1087,1903,57.1
38004, 읍부,080004, 78세,2016,2559,918,1641,55.9,2557,918,1639,56
38004, 읍부,080005, 79세,2016,2510,860,1650,52.1,2506,858,1648,52.1
38004, 읍부,085,80~84세,2016,9260,2860,6400,44.7,9248,2856,6392,44.7
38004, 읍부,085001, 80세,2016,2275,747,1528,48.9,2274,746,1528,48.8
38004, 읍부,085002, 81세,2016,2115,650,1465,44.4,2109,647,1462,44.3
38004, 읍부,085003, 82세,2016,1847,570,1277,44.6,1845,570,1275,44.7
38004, 읍부,085004, 83세,2016,1620,513,1107,46.3,1618,513,1105,46.4
38004, 읍부,085005, 84세,2016,1403,380,1023,37.1,1402,380,1022,37.2
38004, 읍부,090,85~89세,2016,4381,1040,3341,31.1,4375,1038,3337,31.1
38004, 읍부,090001, 85세,2016,1169,282,887,31.8,1169,282,887,31.8
38004, 읍부,090002, 86세,2016,1060,262,798,32.8,1060,262,798,32.8
38004, 읍부,090003, 87세,2016,899,220,679,32.4,896,219,677,32.3
38004, 읍부,090004, 88세,2016,676,146,530,27.5,674,145,529,27.4
38004, 읍부,090005, 89세,2016,577,130,447,29.1,576,130,446,29.1
38004, 읍부,095,90~94세,2016,1248,234,1014,23.1,1247,233,1014,23
38004, 읍부,095001, 90세,2016,378,68,310,21.9,378,68,310,21.9
38004, 읍부,095002, 91세,2016,314,59,255,23.1,314,59,255,23.1
38004, 읍부,095003, 92세,2016,216,48,168,28.6,215,47,168,28
38004, 읍부,095004, 93세,2016,205,37,168,22,205,37,168,22
38004, 읍부,095005, 94세,2016,135,22,113,19.5,135,22,113,19.5
38004, 읍부,100,95~99세,2016,248,41,207,19.8,248,41,207,19.8
38004, 읍부,100001, 95세,2016,97,14,83,16.9,97,14,83,16.9
38004, 읍부,100002, 96세,2016,63,11,52,21.2,63,11,52,21.2
38004, 읍부,100003, 97세,2016,33,8,25,32,33,8,25,32
38004, 읍부,100004, 98세,2016,34,X,30,13.3,34,X,30,13.3
38004, 읍부,100005, 99세,2016,21,X,17,23.5,21,X,17,23.5
38004, 읍부,101,100세이상,2016,30,X,29,3.4,30,X,29,3.4
38004, 읍부,102,15세미만,2016,74670,38714,35956,107.7,74398,38590,35808,107.8
38004, 읍부,103,15~64세,2016,334522,174387,160135,108.9,324538,167663,156875,106.9
38004, 읍부,104,65세이상,2016,65222,25741,39481,65.2,65050,25673,39377,65.2
38004, 읍부,086,85세이상,2016,5907,1316,4591,28.7,5900,1313,4587,28.6
38004, 읍부,126,평균연령,2016,40.4,38.8,42.1,,40.5,38.9,42.1,
38004, 읍부,127,중위연령,2016,41.5,40,43,,41.8,40.4,43.2,
38005, 면부,000,합계,2016,681147,347360,333787,104.1,646720,320492,326228,98.2
38005, 면부,005,0~4세,2016,23030,11836,11194,105.7,22921,11771,11150,105.6
38005, 면부,005001, 0세,2016,4134,2058,2076,99.1,4121,2052,2069,99.2
38005, 면부,005002, 1세,2016,4560,2301,2259,101.9,4539,2288,2251,101.6
38005, 면부,005003, 2세,2016,4621,2372,2249,105.5,4594,2358,2236,105.5
38005, 면부,005004, 3세,2016,4616,2445,2171,112.6,4597,2430,2167,112.1
38005, 면부,005005, 4세,2016,5099,2660,2439,109.1,5070,2643,2427,108.9
38005, 면부,010,5~9세,2016,23679,12209,11470,106.4,23584,12163,11421,106.5
38005, 면부,010001, 5세,2016,4924,2583,2341,110.3,4902,2570,2332,110.2
38005, 면부,010002, 6세,2016,4722,2456,2266,108.4,4705,2449,2256,108.6
38005, 면부,010003, 7세,2016,4586,2341,2245,104.3,4566,2331,2235,104.3
38005, 면부,010004, 8세,2016,4747,2410,2337,103.1,4727,2402,2325,103.3
38005, 면부,010005, 9세,2016,4700,2419,2281,106,4684,2411,2273,106.1
38005, 면부,015,10~14세,2016,20775,10916,9859,110.7,20710,10881,9829,110.7
38005, 면부,015001, 10세,2016,4092,2128,1964,108.4,4073,2116,1957,108.1
38005, 면부,015002, 11세,2016,3989,2025,1964,103.1,3978,2020,1958,103.2
38005, 면부,015003, 12세,2016,4095,2168,1927,112.5,4085,2162,1923,112.4
38005, 면부,015004, 13세,2016,4181,2224,1957,113.6,4168,2220,1948,114
38005, 면부,015005, 14세,2016,4418,2371,2047,115.8,4406,2363,2043,115.7
38005, 면부,020,15~19세,2016,27161,14801,12360,119.7,27027,14738,12289,119.9
38005, 면부,020001, 15세,2016,5211,2758,2453,112.4,5199,2752,2447,112.5
38005, 면부,020002, 16세,2016,6141,3212,2929,109.7,6129,3206,2923,109.7
38005, 면부,020003, 17세,2016,5907,3100,2807,110.4,5887,3087,2800,110.3
38005, 면부,020004, 18세,2016,5479,2992,2487,120.3,5460,2982,2478,120.3
38005, 면부,020005, 19세,2016,4423,2739,1684,162.6,4352,2711,1641,165.2
38005, 면부,025,20~24세,2016,29974,18980,10994,172.6,25606,15809,9797,161.4
38005, 면부,025001, 20세,2016,5593,3730,1863,200.2,5318,3589,1729,207.6
38005, 면부,025002, 21세,2016,5942,3924,2018,194.4,5381,3577,1804,198.3
38005, 면부,025003, 22세,2016,5877,3654,2223,164.4,5039,3058,1981,154.4
38005, 면부,025004, 23세,2016,6084,3708,2376,156.1,4840,2765,2075,133.3
38005, 면부,025005, 24세,2016,6478,3964,2514,157.7,5028,2820,2208,127.7
38005, 면부,030,25~29세,2016,33577,21069,12508,168.4,24634,13787,10847,127.1
38005, 면부,030001, 25세,2016,6540,4041,2499,161.7,5005,2849,2156,132.1
38005, 면부,030002, 26세,2016,6770,4251,2519,168.8,4892,2744,2148,127.7
38005, 면부,030003, 27세,2016,6693,4244,2449,173.3,4907,2762,2145,128.8
38005, 면부,030004, 28세,2016,6751,4254,2497,170.4,4908,2735,2173,125.9
38005, 면부,030005, 29세,2016,6823,4279,2544,168.2,4922,2697,2225,121.2
38005, 면부,035,30~34세,2016,39294,23707,15587,152.1,31354,16905,14449,117
38005, 면부,035001, 30세,2016,6963,4397,2566,171.4,5181,2902,2279,127.3
38005, 면부,035002, 31세,2016,7231,4514,2717,166.1,5427,2945,2482,118.7
38005, 면부,035003, 32세,2016,7857,4702,3155,149,6254,3317,2937,112.9
38005, 면부,035004, 33세,2016,8393,4905,3488,140.6,6946,3668,3278,111.9
38005, 면부,035005, 34세,2016,8850,5189,3661,141.7,7546,4073,3473,117.3
38005, 면부,040,35~39세,2016,41812,24467,17345,141.1,37139,20543,16596,123.8
38005, 면부,040001, 35세,2016,8864,5210,3654,142.6,7764,4270,3494,122.2
38005, 면부,040002, 36세,2016,9070,5250,3820,137.4,8008,4353,3655,119.1
38005, 면부,040003, 37세,2016,8388,4964,3424,145,7482,4213,3269,128.9
38005, 면부,040004, 38세,2016,7754,4550,3204,142,6891,3827,3064,124.9
38005, 면부,040005, 39세,2016,7736,4493,3243,138.5,6994,3880,3114,124.6
38005, 면부,045,40~44세,2016,41460,24396,17064,143,38556,22142,16414,134.9
38005, 면부,045001, 40세,2016,7618,4624,2994,154.4,6915,4040,2875,140.5
38005, 면부,045002, 41세,2016,8012,4657,3355,138.8,7395,4186,3209,130.4
38005, 면부,045003, 42세,2016,8327,4914,3413,144,7778,4476,3302,135.6
38005, 면부,045004, 43세,2016,8956,5147,3809,135.1,8414,4744,3670,129.3
38005, 면부,045005, 44세,2016,8547,5054,3493,144.7,8054,4696,3358,139.8
38005, 면부,050,45~49세,2016,47829,26795,21034,127.4,45852,25411,20441,124.3
38005, 면부,050001, 45세,2016,9234,5315,3919,135.6,8765,4956,3809,130.1
38005, 면부,050002, 46세,2016,9427,5388,4039,133.4,8988,5077,3911,129.8
38005, 면부,050003, 47세,2016,9607,5445,4162,130.8,9239,5208,4031,129.2
38005, 면부,050004, 48세,2016,9884,5435,4449,122.2,9536,5189,4347,119.4
38005, 면부,050005, 49세,2016,9677,5212,4465,116.7,9324,4981,4343,114.7
38005, 면부,055,50~54세,2016,52581,28094,24487,114.7,51129,27230,23899,113.9
38005, 면부,055001, 50세,2016,9996,5511,4485,122.9,9716,5336,4380,121.8
38005, 면부,055002, 51세,2016,10308,5507,4801,114.7,9975,5310,4665,113.8
38005, 면부,055003, 52세,2016,9519,5046,4473,112.8,9248,4878,4370,111.6
38005, 면부,055004, 53세,2016,10569,5614,4955,113.3,10229,5427,4802,113
38005, 면부,055005, 54세,2016,12189,6416,5773,111.1,11961,6279,5682,110.5
38005, 면부,060,55~59세,2016,64314,32710,31604,103.5,63422,32196,31226,103.1
38005, 면부,060001, 55세,2016,13676,6924,6752,102.5,13500,6827,6673,102.3
38005, 면부,060002, 56세,2016,13663,6915,6748,102.5,13426,6773,6653,101.8
38005, 면부,060003, 57세,2016,12236,6203,6033,102.8,12068,6111,5957,102.6
38005, 면부,060004, 58세,2016,12229,6326,5903,107.2,12059,6228,5831,106.8
38005, 면부,060005, 59세,2016,12510,6342,6168,102.8,12369,6257,6112,102.4
38005, 면부,065,60~64세,2016,55629,27684,27945,99.1,55091,27380,27711,98.8
38005, 면부,065001, 60세,2016,12024,6106,5918,103.2,11904,6045,5859,103.2
38005, 면부,065002, 61세,2016,12321,6112,6209,98.4,12195,6033,6162,97.9
38005, 면부,065003, 62세,2016,10724,5354,5370,99.7,10612,5297,5315,99.7
38005, 면부,065004, 63세,2016,9657,4721,4936,95.6,9559,4663,4896,95.2
38005, 면부,065005, 64세,2016,10903,5391,5512,97.8,10821,5342,5479,97.5
38005, 면부,070,65~69세,2016,46364,22547,23817,94.7,46174,22446,23728,94.6
38005, 면부,070001, 65세,2016,8990,4368,4622,94.5,8937,4344,4593,94.6
38005, 면부,070002, 66세,2016,9108,4441,4667,95.2,9060,4412,4648,94.9
38005, 면부,070003, 67세,2016,9585,4767,4818,98.9,9542,4739,4803,98.7
38005, 면부,070004, 68세,2016,9503,4627,4876,94.9,9481,4615,4866,94.8
38005, 면부,070005, 69세,2016,9178,4344,4834,89.9,9154,4336,4818,90
38005, 면부,075,70~74세,2016,41115,17356,23759,73.1,41039,17324,23715,73.1
38005, 면부,075001, 70세,2016,6815,3147,3668,85.8,6797,3137,3660,85.7
38005, 면부,075002, 71세,2016,7378,3192,4186,76.3,7363,3186,4177,76.3
38005, 면부,075003, 72세,2016,8016,3364,4652,72.3,8002,3360,4642,72.4
38005, 면부,075004, 73세,2016,8556,3498,5058,69.2,8540,3489,5051,69.1
38005, 면부,075005, 74세,2016,10350,4155,6195,67.1,10337,4152,6185,67.1
38005, 면부,080,75~79세,2016,42965,15846,27119,58.4,42923,15830,27093,58.4
38005, 면부,080001, 75세,2016,9245,3604,5641,63.9,9234,3599,5635,63.9
38005, 면부,080002, 76세,2016,8905,3320,5585,59.4,8891,3313,5578,59.4
38005, 면부,080003, 77세,2016,9038,3299,5739,57.5,9030,3298,5732,57.5
38005, 면부,080004, 78세,2016,7877,2837,5040,56.3,7874,2836,5038,56.3
38005, 면부,080005, 79세,2016,7900,2786,5114,54.5,7894,2784,5110,54.5
38005, 면부,085,80~84세,2016,30517,9509,21008,45.3,30502,9505,20997,45.3
38005, 면부,085001, 80세,2016,7244,2487,4757,52.3,7242,2487,4755,52.3
38005, 면부,085002, 81세,2016,6923,2245,4678,48,6920,2244,4676,48
38005, 면부,085003, 82세,2016,6241,1908,4333,44,6236,1906,4330,44
38005, 면부,085004, 83세,2016,5236,1514,3722,40.7,5233,1513,3720,40.7
38005, 면부,085005, 84세,2016,4873,1355,3518,38.5,4871,1355,3516,38.5
38005, 면부,090,85~89세,2016,14018,3445,10573,32.6,14009,3441,10568,32.6
38005, 면부,090001, 85세,2016,3870,1035,2835,36.5,3868,1034,2834,36.5
38005, 면부,090002, 86세,2016,3316,771,2545,30.3,3314,770,2544,30.3
38005, 면부,090003, 87세,2016,2828,684,2144,31.9,2827,684,2143,31.9
38005, 면부,090004, 88세,2016,2206,536,1670,32.1,2205,535,1670,32
38005, 면부,090005, 89세,2016,1798,419,1379,30.4,1795,418,1377,30.4
38005, 면부,095,90~94세,2016,4232,860,3372,25.5,4229,858,3371,25.5
38005, 면부,095001, 90세,2016,1289,282,1007,28,1288,281,1007,27.9
38005, 면부,095002, 91세,2016,1104,209,895,23.4,1104,209,895,23.4
38005, 면부,095003, 92세,2016,688,156,532,29.3,687,156,531,29.4
38005, 면부,095004, 93세,2016,687,122,565,21.6,686,121,565,21.4
38005, 면부,095005, 94세,2016,464,91,373,24.4,464,91,373,24.4
38005, 면부,100,95~99세,2016,739,122,617,19.8,739,122,617,19.8
38005, 면부,100001, 95세,2016,300,46,254,18.1,300,46,254,18.1
38005, 면부,100002, 96세,2016,203,34,169,20.1,203,34,169,20.1
38005, 면부,100003, 97세,2016,93,19,74,25.7,93,19,74,25.7
38005, 면부,100004, 98세,2016,81,15,66,22.7,81,15,66,22.7
38005, 면부,100005, 99세,2016,62,8,54,14.8,62,8,54,14.8
38005, 면부,101,100세이상,2016,82,11,71,15.5,80,10,70,14.3
38005, 면부,102,15세미만,2016,67484,34961,32523,107.5,67215,34815,32400,107.5
38005, 면부,103,15~64세,2016,433631,242703,190928,127.1,399810,216141,183669,117.7
38005, 면부,104,65세이상,2016,180032,69696,110336,63.2,179695,69536,110159,63.1
38005, 면부,086,85세이상,2016,19071,4438,14633,30.3,19057,4431,14626,30.3
38005, 면부,126,평균연령,2016,48.5,45.5,51.7,,49.2,46.4,52,
38005, 면부,127,중위연령,2016,51.2,47.1,55.4,,52.7,49.2,55.9,
38003, 동부,000,합계,2016,2184072,1115647,1068425,104.4,2136742,1084536,1052206,103.1
38003, 동부,005,0~4세,2016,105003,54038,50965,106,104206,53649,50557,106.1
38003, 동부,005001, 0세,2016,19197,9861,9336,105.6,19049,9787,9262,105.7
38003, 동부,005002, 1세,2016,20578,10602,9976,106.3,20407,10516,9891,106.3
38003, 동부,005003, 2세,2016,20974,10854,10120,107.3,20806,10776,10030,107.4
38003, 동부,005004, 3세,2016,21161,10877,10284,105.8,21000,10794,10206,105.8
38003, 동부,005005, 4세,2016,23093,11844,11249,105.3,22944,11776,11168,105.4
38003, 동부,010,5~9세,2016,111733,57707,54026,106.8,111150,57410,53740,106.8
38003, 동부,010001, 5세,2016,22952,11780,11172,105.4,22808,11708,11100,105.5
38003, 동부,010002, 6세,2016,22030,11421,10609,107.7,21890,11347,10543,107.6
38003, 동부,010003, 7세,2016,21236,11091,10145,109.3,21129,11039,10090,109.4
38003, 동부,010004, 8세,2016,22535,11559,10976,105.3,22425,11505,10920,105.4
38003, 동부,010005, 9세,2016,22980,11856,11124,106.6,22898,11811,11087,106.5
38003, 동부,015,10~14세,2016,110971,58323,52648,110.8,110632,58164,52468,110.9
38003, 동부,015001, 10세,2016,20993,10931,10062,108.6,20907,10896,10011,108.8
38003, 동부,015002, 11세,2016,20509,10755,9754,110.3,20438,10723,9715,110.4
38003, 동부,015003, 12세,2016,22524,11892,10632,111.9,22455,11860,10595,111.9
38003, 동부,015004, 13세,2016,22920,12119,10801,112.2,22860,12084,10776,112.1
38003, 동부,015005, 14세,2016,24025,12626,11399,110.8,23972,12601,11371,110.8
38003, 동부,020,15~19세,2016,142000,75590,66410,113.8,141409,75312,66097,113.9
38003, 동부,020001, 15세,2016,27306,14406,12900,111.7,27259,14380,12879,111.7
38003, 동부,020002, 16세,2016,29493,15557,13936,111.6,29437,15527,13910,111.6
38003, 동부,020003, 17세,2016,29106,15299,13807,110.8,29026,15258,13768,110.8
38003, 동부,020004, 18세,2016,29082,15384,13698,112.3,28941,15313,13628,112.4
38003, 동부,020005, 19세,2016,27013,14944,12069,123.8,26746,14834,11912,124.5
38003, 동부,025,20~24세,2016,147794,83673,64121,130.5,143231,80951,62280,130
38003, 동부,025001, 20세,2016,29407,16894,12513,135,28940,16682,12258,136.1
38003, 동부,025002, 21세,2016,30022,17329,12693,136.5,29389,17004,12385,137.3
38003, 동부,025003, 22세,2016,29899,16906,12993,130.1,29049,16415,12634,129.9
38003, 동부,025004, 23세,2016,29350,16550,12800,129.3,28215,15837,12378,127.9
38003, 동부,025005, 24세,2016,29116,15994,13122,121.9,27638,15013,12625,118.9
38003, 동부,030,25~29세,2016,132569,73903,58666,126,122967,67046,55921,119.9
38003, 동부,030001, 25세,2016,27463,15295,12168,125.7,25769,14101,11668,120.9
38003, 동부,030002, 26세,2016,26713,15110,11603,130.2,24809,13746,11063,124.3
38003, 동부,030003, 27세,2016,26160,14725,11435,128.8,24198,13327,10871,122.6
38003, 동부,030004, 28세,2016,25657,14226,11431,124.5,23667,12787,10880,117.5
38003, 동부,030005, 29세,2016,26576,14547,12029,120.9,24524,13085,11439,114.4
38003, 동부,035,30~34세,2016,155676,84053,71623,117.4,146725,77488,69237,111.9
38003, 동부,035001, 30세,2016,27427,15291,12136,126,25451,13862,11589,119.6
38003, 동부,035002, 31세,2016,28252,15534,12718,122.1,26375,14138,12237,115.5
38003, 동부,035003, 32세,2016,30051,16196,13855,116.9,28260,14884,13376,111.3
38003, 동부,035004, 33세,2016,33272,17813,15459,115.2,31653,16602,15051,110.3
38003, 동부,035005, 34세,2016,36674,19219,17455,110.1,34986,18002,16984,106
38003, 동부,040,35~39세,2016,180044,94112,85932,109.5,173963,89615,84348,106.2
38003, 동부,040001, 35세,2016,37461,19984,17477,114.3,36031,18904,17127,110.4
38003, 동부,040002, 36세,2016,38708,20063,18645,107.6,37420,19100,18320,104.3
38003, 동부,040003, 37세,2016,36342,18980,17362,109.3,35106,18072,17034,106.1
38003, 동부,040004, 38세,2016,33635,17601,16034,109.8,32471,16760,15711,106.7
38003, 동부,040005, 39세,2016,33898,17484,16414,106.5,32935,16779,16156,103.9
38003, 동부,045,40~44세,2016,189745,96339,93406,103.1,185224,93171,92053,101.2
38003, 동부,045001, 40세,2016,33799,17280,16519,104.6,32757,16522,16235,101.8
38003, 동부,045002, 41세,2016,36247,18299,17948,102,35339,17651,17688,99.8
38003, 동부,045003, 42세,2016,39341,19871,19470,102.1,38481,19279,19202,100.4
38003, 동부,045004, 43세,2016,40776,20529,20247,101.4,39969,19969,20000,99.8
38003, 동부,045005, 44세,2016,39582,20360,19222,105.9,38678,19750,18928,104.3
38003, 동부,050,45~49세,2016,207337,103369,103968,99.4,203358,101005,102353,98.7
38003, 동부,050001, 45세,2016,42674,21475,21199,101.3,41758,20880,20878,100
38003, 동부,050002, 46세,2016,42118,21114,21004,100.5,41257,20597,20660,99.7
38003, 동부,050003, 47세,2016,41980,21018,20962,100.3,41197,20562,20635,99.6
38003, 동부,050004, 48세,2016,41961,20688,21273,97.3,41201,20257,20944,96.7
38003, 동부,050005, 49세,2016,38604,19074,19530,97.7,37945,18709,19236,97.3
38003, 동부,055,50~54세,2016,183093,93382,89711,104.1,179816,91599,88217,103.8
38003, 동부,055001, 50세,2016,37762,19490,18272,106.7,37122,19138,17984,106.4
38003, 동부,055002, 51세,2016,37560,18802,18758,100.2,36858,18408,18450,99.8
38003, 동부,055003, 52세,2016,33172,16747,16425,102,32506,16386,16120,101.7
38003, 동부,055004, 53세,2016,36409,18910,17499,108.1,35718,18551,17167,108.1
38003, 동부,055005, 54세,2016,38190,19433,18757,103.6,37612,19116,18496,103.4
38003, 동부,060,55~59세,2016,175592,88538,87054,101.7,173747,87567,86180,101.6
38003, 동부,060001, 55세,2016,40508,20223,20285,99.7,40138,20033,20105,99.6
38003, 동부,060002, 56세,2016,38937,19428,19509,99.6,38476,19197,19279,99.6
38003, 동부,060003, 57세,2016,33859,17241,16618,103.7,33468,17029,16439,103.6
38003, 동부,060004, 58세,2016,31882,16245,15637,103.9,31554,16078,15476,103.9
38003, 동부,060005, 59세,2016,30406,15401,15005,102.6,30111,15230,14881,102.3
38003, 동부,065,60~64세,2016,120823,59996,60827,98.6,119567,59355,60212,98.6
38003, 동부,065001, 60세,2016,27988,13961,14027,99.5,27674,13799,13875,99.5
38003, 동부,065002, 61세,2016,28200,13766,14434,95.4,27947,13643,14304,95.4
38003, 동부,065003, 62세,2016,23426,11906,11520,103.4,23144,11761,11383,103.3
38003, 동부,065004, 63세,2016,19850,9805,10045,97.6,19621,9686,9935,97.5
38003, 동부,065005, 64세,2016,21359,10558,10801,97.8,21181,10466,10715,97.7
38003, 동부,070,65~69세,2016,80513,38804,41709,93,79985,38553,41432,93.1
38003, 동부,070001, 65세,2016,16661,8119,8542,95,16505,8041,8464,95
38003, 동부,070002, 66세,2016,16487,8112,8375,96.9,16352,8044,8308,96.8
38003, 동부,070003, 67세,2016,16466,7908,8558,92.4,16361,7859,8502,92.4
38003, 동부,070004, 68세,2016,16084,7744,8340,92.9,16020,7715,8305,92.9
38003, 동부,070005, 69세,2016,14815,6921,7894,87.7,14747,6894,7853,87.8
38003, 동부,075,70~74세,2016,56217,25151,31066,81,56028,25066,30962,81
38003, 동부,075001, 70세,2016,10846,5147,5699,90.3,10796,5125,5671,90.4
38003, 동부,075002, 71세,2016,10747,4944,5803,85.2,10706,4927,5779,85.3
38003, 동부,075003, 72세,2016,11180,5019,6161,81.5,11133,4996,6137,81.4
38003, 동부,075004, 73세,2016,11366,4922,6444,76.4,11337,4907,6430,76.3
38003, 동부,075005, 74세,2016,12078,5119,6959,73.6,12056,5111,6945,73.6
38003, 동부,080,75~79세,2016,43567,16998,26569,64,43439,16948,26491,64
38003, 동부,080001, 75세,2016,10215,4223,5992,70.5,10194,4215,5979,70.5
38003, 동부,080002, 76세,2016,9450,3754,5696,65.9,9417,3739,5678,65.9
38003, 동부,080003, 77세,2016,9042,3523,5519,63.8,9025,3514,5511,63.8
38003, 동부,080004, 78세,2016,7554,2828,4726,59.8,7516,2816,4700,59.9
38003, 동부,080005, 79세,2016,7306,2670,4636,57.6,7287,2664,4623,57.6
38003, 동부,085,80~84세,2016,26022,8277,17745,46.6,25952,8250,17702,46.6
38003, 동부,085001, 80세,2016,6606,2309,4297,53.7,6584,2298,4286,53.6
38003, 동부,085002, 81세,2016,6081,2052,4029,50.9,6065,2047,4018,50.9
38003, 동부,085003, 82세,2016,5097,1587,3510,45.2,5085,1581,3504,45.1
38003, 동부,085004, 83세,2016,4233,1252,2981,42,4221,1247,2974,41.9
38003, 동부,085005, 84세,2016,4005,1077,2928,36.8,3997,1077,2920,36.9
38003, 동부,090,85~89세,2016,11339,2641,8698,30.4,11324,2639,8685,30.4
38003, 동부,090001, 85세,2016,3040,744,2296,32.4,3035,743,2292,32.4
38003, 동부,090002, 86세,2016,2678,588,2090,28.1,2673,588,2085,28.2
38003, 동부,090003, 87세,2016,2430,586,1844,31.8,2427,585,1842,31.8
38003, 동부,090004, 88세,2016,1802,404,1398,28.9,1801,404,1397,28.9
38003, 동부,090005, 89세,2016,1389,319,1070,29.8,1388,319,1069,29.8
38003, 동부,095,90~94세,2016,3413,646,2767,23.3,3404,644,2760,23.3
38003, 동부,095001, 90세,2016,1012,211,801,26.3,1011,210,801,26.2
38003, 동부,095002, 91세,2016,926,171,755,22.6,920,170,750,22.7
38003, 동부,095003, 92세,2016,612,109,503,21.7,611,109,502,21.7
38003, 동부,095004, 93세,2016,497,90,407,22.1,496,90,406,22.2
38003, 동부,095005, 94세,2016,366,65,301,21.6,366,65,301,21.6
38003, 동부,100,95~99세,2016,555,101,454,22.2,549,98,451,21.7
38003, 동부,100001, 95세,2016,208,40,168,23.8,205,38,167,22.8
38003, 동부,100002, 96세,2016,160,23,137,16.8,157,22,135,16.3
38003, 동부,100003, 97세,2016,89,19,70,27.1,89,19,70,27.1
38003, 동부,100004, 98세,2016,59,15,44,34.1,59,15,44,34.1
38003, 동부,100005, 99세,2016,39,X,35,11.4,39,X,35,11.4
38003, 동부,101,100세이상,2016,66,6,60,10,66,6,60,10
38003, 동부,102,15세미만,2016,327707,170068,157639,107.9,325988,169223,156765,107.9
38003, 동부,103,15~64세,2016,1634673,852955,781718,109.1,1590007,823109,766898,107.3
38003, 동부,104,65세이상,2016,221692,92624,129068,71.8,220747,92204,128543,71.7
38003, 동부,086,85세이상,2016,15373,3394,11979,28.3,15343,3387,11956,28.3
38003, 동부,126,평균연령,2016,39.1,37.9,40.3,,39.1,37.9,40.3,
38003, 동부,127,중위연령,2016,40.2,38.7,41.7,,40.4,39,41.9,
38030, 진주시,000,합계,2016,352807,176431,176376,100,347667,173278,174389,99.4
38030, 진주시,005,0~4세,2016,14845,7755,7090,109.4,14798,7731,7067,109.4
38030, 진주시,005001, 0세,2016,2645,1404,1241,113.1,2634,1395,1239,112.6
38030, 진주시,005002, 1세,2016,2859,1464,1395,104.9,2853,1462,1391,105.1
38030, 진주시,005003, 2세,2016,3066,1585,1481,107,3051,1579,1472,107.3
38030, 진주시,005004, 3세,2016,2984,1623,1361,119.3,2979,1619,1360,119
38030, 진주시,005005, 4세,2016,3291,1679,1612,104.2,3281,1676,1605,104.4
38030, 진주시,010,5~9세,2016,16665,8715,7950,109.6,16623,8691,7932,109.6
38030, 진주시,010001, 5세,2016,3367,1797,1570,114.5,3356,1792,1564,114.6
38030, 진주시,010002, 6세,2016,3286,1751,1535,114.1,3277,1745,1532,113.9
38030, 진주시,010003, 7세,2016,3147,1658,1489,111.3,3140,1654,1486,111.3
38030, 진주시,010004, 8세,2016,3411,1766,1645,107.4,3402,1761,1641,107.3
38030, 진주시,010005, 9세,2016,3454,1743,1711,101.9,3448,1739,1709,101.8
38030, 진주시,015,10~14세,2016,17080,9113,7967,114.4,17063,9104,7959,114.4
38030, 진주시,015001, 10세,2016,3171,1666,1505,110.7,3169,1665,1504,110.7
38030, 진주시,015002, 11세,2016,3095,1633,1462,111.7,3094,1633,1461,111.8
38030, 진주시,015003, 12세,2016,3546,1923,1623,118.5,3540,1919,1621,118.4
38030, 진주시,015004, 13세,2016,3539,1855,1684,110.2,3537,1855,1682,110.3
38030, 진주시,015005, 14세,2016,3729,2036,1693,120.3,3723,2032,1691,120.2
38030, 진주시,020,15~19세,2016,24579,13039,11540,113,24449,12990,11459,113.4
38030, 진주시,020001, 15세,2016,4284,2288,1996,114.6,4280,2286,1994,114.6
38030, 진주시,020002, 16세,2016,4676,2570,2106,122,4671,2568,2103,122.1
38030, 진주시,020003, 17세,2016,4574,2465,2109,116.9,4555,2456,2099,117
38030, 진주시,020004, 18세,2016,5152,2714,2438,111.3,5120,2701,2419,111.7
38030, 진주시,020005, 19세,2016,5893,3002,2891,103.8,5823,2979,2844,104.7
38030, 진주시,025,20~24세,2016,28672,16081,12591,127.7,27875,15663,12212,128.3
38030, 진주시,025001, 20세,2016,5772,2960,2812,105.3,5680,2920,2760,105.8
38030, 진주시,025002, 21세,2016,5919,3147,2772,113.5,5795,3088,2707,114.1
38030, 진주시,025003, 22세,2016,6124,3525,2599,135.6,5949,3438,2511,136.9
38030, 진주시,025004, 23세,2016,5669,3386,2283,148.3,5482,3289,2193,150
38030, 진주시,025005, 24세,2016,5188,3063,2125,144.1,4969,2928,2041,143.5
38030, 진주시,030,25~29세,2016,20480,11376,9104,125,19321,10629,8692,122.3
38030, 진주시,030001, 25세,2016,4510,2650,1860,142.5,4302,2525,1777,142.1
38030, 진주시,030002, 26세,2016,4202,2365,1837,128.7,3925,2188,1737,126
38030, 진주시,030003, 27세,2016,4058,2243,1815,123.6,3828,2091,1737,120.4
38030, 진주시,030004, 28세,2016,3765,2057,1708,120.4,3543,1914,1629,117.5
38030, 진주시,030005, 29세,2016,3945,2061,1884,109.4,3723,1911,1812,105.5
38030, 진주시,035,30~34세,2016,21650,11151,10499,106.2,20697,10453,10244,102
38030, 진주시,035001, 30세,2016,4021,2163,1858,116.4,3807,2009,1798,111.7
38030, 진주시,035002, 31세,2016,3805,2009,1796,111.9,3591,1858,1733,107.2
38030, 진주시,035003, 32세,2016,4222,2121,2101,101,4038,1991,2047,97.3
38030, 진주시,035004, 33세,2016,4596,2328,2268,102.6,4425,2197,2228,98.6
38030, 진주시,035005, 34세,2016,5006,2530,2476,102.2,4836,2398,2438,98.4
38030, 진주시,040,35~39세,2016,25013,12682,12331,102.8,24445,12278,12167,100.9
38030, 진주시,040001, 35세,2016,4991,2516,2475,101.7,4841,2413,2428,99.4
38030, 진주시,040002, 36세,2016,5301,2716,2585,105.1,5169,2624,2545,103.1
38030, 진주시,040003, 37세,2016,5072,2605,2467,105.6,4964,2531,2433,104
38030, 진주시,040004, 38세,2016,4823,2411,2412,100,4715,2331,2384,97.8
38030, 진주시,040005, 39세,2016,4826,2434,2392,101.8,4756,2379,2377,100.1
38030, 진주시,045,40~44세,2016,27625,13859,13766,100.7,27249,13627,13622,100
38030, 진주시,045001, 40세,2016,5021,2510,2511,100,4919,2445,2474,98.8
38030, 진주시,045002, 41세,2016,5262,2641,2621,100.8,5193,2597,2596,100
38030, 진주시,045003, 42세,2016,5708,2818,2890,97.5,5646,2778,2868,96.9
38030, 진주시,045004, 43세,2016,5975,3012,2963,101.7,5920,2979,2941,101.3
38030, 진주시,045005, 44세,2016,5659,2878,2781,103.5,5571,2828,2743,103.1
38030, 진주시,050,45~49세,2016,30738,15240,15498,98.3,30402,15049,15353,98
38030, 진주시,050001, 45세,2016,6116,3054,3062,99.7,6054,3015,3039,99.2
38030, 진주시,050002, 46세,2016,6360,3157,3203,98.6,6284,3110,3174,98
38030, 진주시,050003, 47세,2016,6372,3180,3192,99.6,6306,3143,3163,99.4
38030, 진주시,050004, 48세,2016,6181,3091,3090,100,6114,3055,3059,99.9
38030, 진주시,050005, 49세,2016,5709,2758,2951,93.5,5644,2726,2918,93.4
38030, 진주시,055,50~54세,2016,27033,13536,13497,100.3,26741,13392,13349,100.3
38030, 진주시,055001, 50세,2016,5515,2851,2664,107,5463,2822,2641,106.9
38030, 진주시,055002, 51세,2016,5481,2699,2782,97,5426,2673,2753,97.1
38030, 진주시,055003, 52세,2016,4729,2306,2423,95.2,4655,2269,2386,95.1
38030, 진주시,055004, 53세,2016,5424,2737,2687,101.9,5364,2711,2653,102.2
38030, 진주시,055005, 54세,2016,5884,2943,2941,100.1,5833,2917,2916,100
38030, 진주시,060,55~59세,2016,28637,14027,14610,96,28444,13934,14510,96
38030, 진주시,060001, 55세,2016,6782,3319,3463,95.8,6744,3302,3442,95.9
38030, 진주시,060002, 56세,2016,6273,2973,3300,90.1,6227,2953,3274,90.2
38030, 진주시,060003, 57세,2016,5244,2594,2650,97.9,5212,2575,2637,97.6
38030, 진주시,060004, 58세,2016,5292,2595,2697,96.2,5250,2577,2673,96.4
38030, 진주시,060005, 59세,2016,5046,2546,2500,101.8,5011,2527,2484,101.7
38030, 진주시,065,60~64세,2016,21120,10259,10861,94.5,20989,10189,10800,94.3
38030, 진주시,065001, 60세,2016,4695,2377,2318,102.5,4661,2358,2303,102.4
38030, 진주시,065002, 61세,2016,4873,2275,2598,87.6,4845,2261,2584,87.5
38030, 진주시,065003, 62세,2016,4211,2131,2080,102.5,4186,2122,2064,102.8
38030, 진주시,065004, 63세,2016,3521,1665,1856,89.7,3503,1654,1849,89.5
38030, 진주시,065005, 64세,2016,3820,1811,2009,90.1,3794,1794,2000,89.7
38030, 진주시,070,65~69세,2016,15652,7416,8236,90,15592,7385,8207,90
38030, 진주시,070001, 65세,2016,3019,1464,1555,94.1,2998,1452,1546,93.9
38030, 진주시,070002, 66세,2016,3293,1566,1727,90.7,3274,1555,1719,90.5
38030, 진주시,070003, 67세,2016,3194,1472,1722,85.5,3187,1468,1719,85.4
38030, 진주시,070004, 68세,2016,3183,1498,1685,88.9,3176,1497,1679,89.2
38030, 진주시,070005, 69세,2016,2963,1416,1547,91.5,2957,1413,1544,91.5
38030, 진주시,075,70~74세,2016,12128,5335,6793,78.5,12105,5323,6782,78.5
38030, 진주시,075001, 70세,2016,2294,1069,1225,87.3,2287,1066,1221,87.3
38030, 진주시,075002, 71세,2016,2308,1058,1250,84.6,2303,1056,1247,84.7
38030, 진주시,075003, 72세,2016,2429,1074,1355,79.3,2424,1070,1354,79
38030, 진주시,075004, 73세,2016,2433,1031,1402,73.5,2430,1030,1400,73.6
38030, 진주시,075005, 74세,2016,2664,1103,1561,70.7,2661,1101,1560,70.6
38030, 진주시,080,75~79세,2016,10315,3996,6319,63.2,10307,3993,6314,63.2
38030, 진주시,080001, 75세,2016,2343,997,1346,74.1,2341,996,1345,74.1
38030, 진주시,080002, 76세,2016,2270,882,1388,63.5,2268,881,1387,63.5
38030, 진주시,080003, 77세,2016,2134,812,1322,61.4,2133,812,1321,61.5
38030, 진주시,080004, 78세,2016,1834,664,1170,56.8,1833,664,1169,56.8
38030, 진주시,080005, 79세,2016,1734,641,1093,58.6,1732,640,1092,58.6
38030, 진주시,085,80~84세,2016,6485,1961,4524,43.3,6481,1959,4522,43.3
38030, 진주시,085001, 80세,2016,1637,550,1087,50.6,1636,549,1087,50.5
38030, 진주시,085002, 81세,2016,1488,472,1016,46.5,1488,472,1016,46.5
38030, 진주시,085003, 82세,2016,1291,386,905,42.7,1291,386,905,42.7
38030, 진주시,085004, 83세,2016,1052,282,770,36.6,1050,281,769,36.5
38030, 진주시,085005, 84세,2016,1017,271,746,36.3,1016,271,745,36.4
38030, 진주시,090,85~89세,2016,2963,664,2299,28.9,2961,663,2298,28.9
38030, 진주시,090001, 85세,2016,803,197,606,32.5,802,197,605,32.6
38030, 진주시,090002, 86세,2016,700,143,557,25.7,700,143,557,25.7
38030, 진주시,090003, 87세,2016,604,143,461,31,604,143,461,31
38030, 진주시,090004, 88세,2016,485,107,378,28.3,484,106,378,28
38030, 진주시,090005, 89세,2016,371,74,297,24.9,371,74,297,24.9
38030, 진주시,095,90~94세,2016,933,184,749,24.6,933,184,749,24.6
38030, 진주시,095001, 90세,2016,281,57,224,25.4,281,57,224,25.4
38030, 진주시,095002, 91세,2016,261,46,215,21.4,261,46,215,21.4
38030, 진주시,095003, 92세,2016,160,40,120,33.3,160,40,120,33.3
38030, 진주시,095004, 93세,2016,126,24,102,23.5,126,24,102,23.5
38030, 진주시,095005, 94세,2016,105,17,88,19.3,105,17,88,19.3
38030, 진주시,100,95~99세,2016,178,39,139,28.1,176,38,138,27.5
38030, 진주시,100001, 95세,2016,74,17,57,29.8,73,16,57,28.1
38030, 진주시,100002, 96세,2016,48,9,39,23.1,47,9,38,23.7
38030, 진주시,100003, 97세,2016,20,6,14,42.9,20,6,14,42.9
38030, 진주시,100004, 98세,2016,21,X,17,23.5,21,X,17,23.5
38030, 진주시,100005, 99세,2016,15,X,12,25,15,X,12,25
38030, 진주시,101,100세이상,2016,16,X,13,23.1,16,X,13,23.1
38030, 진주시,102,15세미만,2016,48590,25583,23007,111.2,48484,25526,22958,111.2
38030, 진주시,103,15~64세,2016,255547,131250,124297,105.6,250612,128204,122408,104.7
38030, 진주시,104,65세이상,2016,48670,19598,29072,67.4,48571,19548,29023,67.4
38030, 진주시,086,85세이상,2016,4090,890,3200,27.8,4086,888,3198,27.8
38030, 진주시,126,평균연령,2016,40.5,38.8,42.3,,40.6,38.9,42.4,
38030, 진주시,127,중위연령,2016,41.5,39.3,43.4,,41.7,39.6,43.5,
38050, 통영시,000,합계,2016,136035,70259,65776,106.8,130995,66300,64695,102.5
38050, 통영시,005,0~4세,2016,6365,3221,3144,102.4,6345,3211,3134,102.5
38050, 통영시,005001, 0세,2016,1076,538,538,100,1074,538,536,100.4
38050, 통영시,005002, 1세,2016,1251,622,629,98.9,1249,620,629,98.6
38050, 통영시,005003, 2세,2016,1233,614,619,99.2,1229,613,616,99.5
38050, 통영시,005004, 3세,2016,1302,684,618,110.7,1298,681,617,110.4
38050, 통영시,005005, 4세,2016,1503,763,740,103.1,1495,759,736,103.1
38050, 통영시,010,5~9세,2016,7336,3768,3568,105.6,7311,3752,3559,105.4
38050, 통영시,010001, 5세,2016,1546,791,755,104.8,1535,782,753,103.9
38050, 통영시,010002, 6세,2016,1499,780,719,108.5,1498,779,719,108.3
38050, 통영시,010003, 7세,2016,1416,751,665,112.9,1413,750,663,113.1
38050, 통영시,010004, 8세,2016,1474,734,740,99.2,1467,732,735,99.6
38050, 통영시,010005, 9세,2016,1401,712,689,103.3,1398,709,689,102.9
38050, 통영시,015,10~14세,2016,6204,3247,2957,109.8,6191,3243,2948,110
38050, 통영시,015001, 10세,2016,1195,632,563,112.3,1192,631,561,112.5
38050, 통영시,015002, 11세,2016,1207,630,577,109.2,1206,630,576,109.4
38050, 통영시,015003, 12세,2016,1211,646,565,114.3,1206,644,562,114.6
38050, 통영시,015004, 13세,2016,1288,668,620,107.7,1285,668,617,108.3
38050, 통영시,015005, 14세,2016,1303,671,632,106.2,1302,670,632,106
38050, 통영시,020,15~19세,2016,6877,3680,3197,115.1,6856,3666,3190,114.9
38050, 통영시,020001, 15세,2016,1483,770,713,108,1482,769,713,107.9
38050, 통영시,020002, 16세,2016,1520,753,767,98.2,1517,752,765,98.3
38050, 통영시,020003, 17세,2016,1498,798,700,114,1494,795,699,113.7
38050, 통영시,020004, 18세,2016,1394,739,655,112.8,1390,736,654,112.5
38050, 통영시,020005, 19세,2016,982,620,362,171.3,973,614,359,171
38050, 통영시,025,20~24세,2016,6121,3703,2418,153.1,5663,3362,2301,146.1
38050, 통영시,025001, 20세,2016,1160,779,381,204.5,1139,767,372,206.2
38050, 통영시,025002, 21세,2016,1227,807,420,192.1,1182,784,398,197
38050, 통영시,025003, 22세,2016,1155,692,463,149.5,1076,633,443,142.9
38050, 통영시,025004, 23세,2016,1272,716,556,128.8,1123,600,523,114.7
38050, 통영시,025005, 24세,2016,1307,709,598,118.6,1143,578,565,102.3
38050, 통영시,030,25~29세,2016,6688,3820,2868,133.2,5655,2962,2693,110
38050, 통영시,030001, 25세,2016,1235,710,525,135.2,1062,568,494,115
38050, 통영시,030002, 26세,2016,1305,720,585,123.1,1089,544,545,99.8
38050, 통영시,030003, 27세,2016,1343,766,577,132.8,1138,596,542,110
38050, 통영시,030004, 28세,2016,1356,795,561,141.7,1145,612,533,114.8
38050, 통영시,030005, 29세,2016,1449,829,620,133.7,1221,642,579,110.9
38050, 통영시,035,30~34세,2016,9535,5383,4152,129.6,8450,4441,4009,110.8
38050, 통영시,035001, 30세,2016,1497,860,637,135,1279,677,602,112.5
38050, 통영시,035002, 31세,2016,1661,951,710,133.9,1424,741,683,108.5
38050, 통영시,035003, 32세,2016,1945,1115,830,134.3,1719,915,804,113.8
38050, 통영시,035004, 33세,2016,2054,1128,926,121.8,1859,953,906,105.2
38050, 통영시,035005, 34세,2016,2378,1329,1049,126.7,2169,1155,1014,113.9
38050, 통영시,040,35~39세,2016,11580,6467,5113,126.5,10823,5800,5023,115.5
38050, 통영시,040001, 35세,2016,2393,1307,1086,120.3,2221,1148,1073,107
38050, 통영시,040002, 36세,2016,2564,1445,1119,129.1,2415,1313,1102,119.1
38050, 통영시,040003, 37세,2016,2285,1285,1000,128.5,2136,1154,982,117.5
38050, 통영시,040004, 38세,2016,2150,1223,927,131.9,2001,1090,911,119.6
38050, 통영시,040005, 39세,2016,2188,1207,981,123,2050,1095,955,114.7
38050, 통영시,045,40~44세,2016,11437,6416,5021,127.8,10881,5978,4903,121.9
38050, 통영시,045001, 40세,2016,2092,1208,884,136.7,1969,1100,869,126.6
38050, 통영시,045002, 41세,2016,2277,1271,1006,126.3,2156,1176,980,120
38050, 통영시,045003, 42세,2016,2268,1288,980,131.4,2169,1210,959,126.2
38050, 통영시,045004, 43세,2016,2446,1330,1116,119.2,2342,1251,1091,114.7
38050, 통영시,045005, 44세,2016,2354,1319,1035,127.4,2245,1241,1004,123.6
38050, 통영시,050,45~49세,2016,11549,6173,5376,114.8,11128,5874,5254,111.8
38050, 통영시,050001, 45세,2016,2409,1294,1115,116.1,2300,1210,1090,111
38050, 통영시,050002, 46세,2016,2378,1304,1074,121.4,2289,1235,1054,117.2
38050, 통영시,050003, 47세,2016,2246,1196,1050,113.9,2172,1151,1021,112.7
38050, 통영시,050004, 48세,2016,2378,1280,1098,116.6,2297,1220,1077,113.3
38050, 통영시,050005, 49세,2016,2138,1099,1039,105.8,2070,1058,1012,104.5
38050, 통영시,055,50~54세,2016,10701,5458,5243,104.1,10388,5275,5113,103.2
38050, 통영시,055001, 50세,2016,2050,1044,1006,103.8,1996,1006,990,101.6
38050, 통영시,055002, 51세,2016,2105,1067,1038,102.8,2024,1024,1000,102.4
38050, 통영시,055003, 52세,2016,1929,997,932,107,1869,963,906,106.3
38050, 통영시,055004, 53세,2016,2175,1139,1036,109.9,2103,1096,1007,108.8
38050, 통영시,055005, 54세,2016,2442,1211,1231,98.4,2396,1186,1210,98
38050, 통영시,060,55~59세,2016,12044,5889,6155,95.7,11865,5790,6075,95.3
38050, 통영시,060001, 55세,2016,2647,1272,1375,92.5,2613,1252,1361,92
38050, 통영시,060002, 56세,2016,2658,1290,1368,94.3,2609,1266,1343,94.3
38050, 통영시,060003, 57세,2016,2371,1178,1193,98.7,2334,1156,1178,98.1
38050, 통영시,060004, 58세,2016,2214,1105,1109,99.6,2180,1085,1095,99.1
38050, 통영시,060005, 59세,2016,2154,1044,1110,94.1,2129,1031,1098,93.9
38050, 통영시,065,60~64세,2016,9343,4623,4720,97.9,9252,4569,4683,97.6
38050, 통영시,065001, 60세,2016,2146,1064,1082,98.3,2122,1051,1071,98.1
38050, 통영시,065002, 61세,2016,2098,1019,1079,94.4,2077,1005,1072,93.8
38050, 통영시,065003, 62세,2016,1778,873,905,96.5,1757,863,894,96.5
38050, 통영시,065004, 63세,2016,1546,754,792,95.2,1532,745,787,94.7
38050, 통영시,065005, 64세,2016,1775,913,862,105.9,1764,905,859,105.4
38050, 통영시,070,65~69세,2016,7001,3446,3555,96.9,6961,3426,3535,96.9
38050, 통영시,070001, 65세,2016,1500,742,758,97.9,1488,736,752,97.9
38050, 통영시,070002, 66세,2016,1298,635,663,95.8,1291,631,660,95.6
38050, 통영시,070003, 67세,2016,1457,747,710,105.2,1449,742,707,105
38050, 통영시,070004, 68세,2016,1461,699,762,91.7,1454,696,758,91.8
38050, 통영시,070005, 69세,2016,1285,623,662,94.1,1279,621,658,94.4
38050, 통영시,075,70~74세,2016,5096,2261,2835,79.8,5080,2253,2827,79.7
38050, 통영시,075001, 70세,2016,857,421,436,96.6,850,416,434,95.9
38050, 통영시,075002, 71세,2016,1041,486,555,87.6,1038,485,553,87.7
38050, 통영시,075003, 72세,2016,947,411,536,76.7,945,411,534,77
38050, 통영시,075004, 73세,2016,1078,472,606,77.9,1075,470,605,77.7
38050, 통영시,075005, 74세,2016,1173,471,702,67.1,1172,471,701,67.2
38050, 통영시,080,75~79세,2016,4126,1542,2584,59.7,4119,1539,2580,59.7
38050, 통영시,080001, 75세,2016,1004,394,610,64.6,1003,393,610,64.4
38050, 통영시,080002, 76세,2016,885,340,545,62.4,883,339,544,62.3
38050, 통영시,080003, 77세,2016,837,321,516,62.2,836,321,515,62.3
38050, 통영시,080004, 78세,2016,684,220,464,47.4,683,220,463,47.5
38050, 통영시,080005, 79세,2016,716,267,449,59.5,714,266,448,59.4
38050, 통영시,085,80~84세,2016,2505,824,1681,49,2502,822,1680,48.9
38050, 통영시,085001, 80세,2016,637,241,396,60.9,637,241,396,60.9
38050, 통영시,085002, 81세,2016,587,204,383,53.3,587,204,383,53.3
38050, 통영시,085003, 82세,2016,471,147,324,45.4,469,145,324,44.8
38050, 통영시,085004, 83세,2016,424,126,298,42.3,423,126,297,42.4
38050, 통영시,085005, 84세,2016,386,106,280,37.9,386,106,280,37.9
38050, 통영시,090,85~89세,2016,1148,278,870,32,1147,278,869,32
38050, 통영시,090001, 85세,2016,343,85,258,32.9,343,85,258,32.9
38050, 통영시,090002, 86세,2016,262,63,199,31.7,262,63,199,31.7
38050, 통영시,090003, 87세,2016,222,55,167,32.9,222,55,167,32.9
38050, 통영시,090004, 88세,2016,173,49,124,39.5,173,49,124,39.5
38050, 통영시,090005, 89세,2016,148,26,122,21.3,147,26,121,21.5
38050, 통영시,095,90~94세,2016,328,55,273,20.1,327,54,273,19.8
38050, 통영시,095001, 90세,2016,99,19,80,23.8,98,18,80,22.5
38050, 통영시,095002, 91세,2016,93,18,75,24,93,18,75,24
38050, 통영시,095003, 92세,2016,51,7,44,15.9,51,7,44,15.9
38050, 통영시,095004, 93세,2016,41,6,35,17.1,41,6,35,17.1
38050, 통영시,095005, 94세,2016,44,5,39,12.8,44,5,39,12.8
38050, 통영시,100,95~99세,2016,47,5,42,11.9,47,5,42,11.9
38050, 통영시,100001, 95세,2016,21,X,18,16.7,21,X,18,16.7
38050, 통영시,100002, 96세,2016,7,X,7,0,7,X,7,0
38050, 통영시,100003, 97세,2016,11,X,10,10,11,X,10,10
38050, 통영시,100004, 98세,2016,5,X,X,25,5,X,X,25
38050, 통영시,100005, 99세,2016,X,X,X,0,X,X,X,0
38050, 통영시,101,100세이상,2016,X,X,X,0,X,X,X,0
38050, 통영시,102,15세미만,2016,19905,10236,9669,105.9,19847,10206,9641,105.9
38050, 통영시,103,15~64세,2016,95875,51612,44263,116.6,90961,47717,43244,110.3
38050, 통영시,104,65세이상,2016,20255,8411,11844,71,20187,8377,11810,70.9
38050, 통영시,086,85세이상,2016,1527,338,1189,28.4,1525,337,1188,28.4
38050, 통영시,126,평균연령,2016,42,40.4,43.6,,42.2,40.7,43.7,
38050, 통영시,127,중위연령,2016,43.3,41.5,45.4,,43.8,42.4,45.5,
38060, 사천시,000,합계,2016,112394,57423,54971,104.5,108742,54640,54102,101
38060, 사천시,005,0~4세,2016,4958,2563,2395,107,4932,2549,2383,107
38060, 사천시,005001, 0세,2016,883,467,416,112.3,882,466,416,112
38060, 사천시,005002, 1세,2016,934,457,477,95.8,927,452,475,95.2
38060, 사천시,005003, 2세,2016,1026,526,500,105.2,1020,524,496,105.6
38060, 사천시,005004, 3세,2016,998,533,465,114.6,994,532,462,115.2
38060, 사천시,005005, 4세,2016,1117,580,537,108,1109,575,534,107.7
38060, 사천시,010,5~9세,2016,5639,2886,2753,104.8,5608,2870,2738,104.8
38060, 사천시,010001, 5세,2016,1147,619,528,117.2,1140,615,525,117.1
38060, 사천시,010002, 6세,2016,1137,574,563,102,1130,569,561,101.4
38060, 사천시,010003, 7세,2016,1128,559,569,98.2,1124,557,567,98.2
38060, 사천시,010004, 8세,2016,1136,581,555,104.7,1130,579,551,105.1
38060, 사천시,010005, 9세,2016,1091,553,538,102.8,1084,550,534,103
38060, 사천시,015,10~14세,2016,4984,2570,2414,106.5,4966,2561,2405,106.5
38060, 사천시,015001, 10세,2016,1009,521,488,106.8,1004,518,486,106.6
38060, 사천시,015002, 11세,2016,919,465,454,102.4,917,464,453,102.4
38060, 사천시,015003, 12세,2016,1008,522,486,107.4,1005,521,484,107.6
38060, 사천시,015004, 13세,2016,1004,531,473,112.3,999,530,469,113
38060, 사천시,015005, 14세,2016,1044,531,513,103.5,1041,528,513,102.9
38060, 사천시,020,15~19세,2016,5681,3212,2469,130.1,5664,3205,2459,130.3
38060, 사천시,020001, 15세,2016,1189,633,556,113.8,1187,633,554,114.3
38060, 사천시,020002, 16세,2016,1254,674,580,116.2,1252,672,580,115.9
38060, 사천시,020003, 17세,2016,1233,674,559,120.6,1229,672,557,120.6
38060, 사천시,020004, 18세,2016,1158,679,479,141.8,1156,678,478,141.8
38060, 사천시,020005, 19세,2016,847,552,295,187.1,840,550,290,189.7
38060, 사천시,025,20~24세,2016,5267,3455,1812,190.7,4955,3233,1722,187.7
38060, 사천시,025001, 20세,2016,932,668,264,253,917,661,256,258.2
38060, 사천시,025002, 21세,2016,1167,844,323,261.3,1139,823,316,260.4
38060, 사천시,025003, 22세,2016,1070,728,342,212.9,1012,687,325,211.4
38060, 사천시,025004, 23세,2016,1039,620,419,148,942,549,393,139.7
38060, 사천시,025005, 24세,2016,1059,595,464,128.2,945,513,432,118.8
38060, 사천시,030,25~29세,2016,5478,3334,2144,155.5,4688,2701,1987,135.9
38060, 사천시,030001, 25세,2016,1073,659,414,159.2,942,553,389,142.2
38060, 사천시,030002, 26세,2016,1141,687,454,151.3,974,555,419,132.5
38060, 사천시,030003, 27세,2016,1170,746,424,175.9,1003,617,386,159.8
38060, 사천시,030004, 28세,2016,1025,642,383,167.6,858,500,358,139.7
38060, 사천시,030005, 29세,2016,1069,600,469,127.9,911,476,435,109.4
38060, 사천시,035,30~34세,2016,7126,4031,3095,130.2,6346,3381,2965,114
38060, 사천시,035001, 30세,2016,1239,741,498,148.8,1063,598,465,128.6
38060, 사천시,035002, 31세,2016,1173,662,511,129.5,1013,534,479,111.5
38060, 사천시,035003, 32세,2016,1359,767,592,129.6,1214,645,569,113.4
38060, 사천시,035004, 33세,2016,1596,889,707,125.7,1440,757,683,110.8
38060, 사천시,035005, 34세,2016,1759,972,787,123.5,1616,847,769,110.1
38060, 사천시,040,35~39세,2016,8840,4686,4154,112.8,8317,4254,4063,104.7
38060, 사천시,040001, 35세,2016,1772,936,836,112,1644,836,808,103.5
38060, 사천시,040002, 36세,2016,1834,948,886,107,1722,849,873,97.3
38060, 사천시,040003, 37세,2016,1775,930,845,110.1,1681,855,826,103.5
38060, 사천시,040004, 38세,2016,1695,904,791,114.3,1593,820,773,106.1
38060, 사천시,040005, 39세,2016,1764,968,796,121.6,1677,894,783,114.2
38060, 사천시,045,40~44세,2016,9091,5046,4045,124.7,8637,4681,3956,118.3
38060, 사천시,045001, 40세,2016,1679,962,717,134.2,1578,881,697,126.4
38060, 사천시,045002, 41세,2016,1731,915,816,112.1,1635,836,799,104.6
38060, 사천시,045003, 42세,2016,1854,1026,828,123.9,1764,957,807,118.6
38060, 사천시,045004, 43세,2016,1981,1086,895,121.3,1893,1010,883,114.4
38060, 사천시,045005, 44세,2016,1846,1057,789,134,1767,997,770,129.5
38060, 사천시,050,45~49세,2016,9128,4884,4244,115.1,8853,4683,4170,112.3
38060, 사천시,050001, 45세,2016,1975,1093,882,123.9,1896,1030,866,118.9
38060, 사천시,050002, 46세,2016,1827,991,836,118.5,1766,946,820,115.4
38060, 사천시,050003, 47세,2016,1878,990,888,111.5,1831,957,874,109.5
38060, 사천시,050004, 48세,2016,1765,946,819,115.5,1718,911,807,112.9
38060, 사천시,050005, 49세,2016,1683,864,819,105.5,1642,839,803,104.5
38060, 사천시,055,50~54세,2016,8413,4469,3944,113.3,8218,4353,3865,112.6
38060, 사천시,055001, 50세,2016,1712,933,779,119.8,1677,910,767,118.6
38060, 사천시,055002, 51세,2016,1708,890,818,108.8,1660,859,801,107.2
38060, 사천시,055003, 52세,2016,1461,761,700,108.7,1433,749,684,109.5
38060, 사천시,055004, 53세,2016,1653,909,744,122.2,1600,876,724,121
38060, 사천시,055005, 54세,2016,1879,976,903,108.1,1848,959,889,107.9
38060, 사천시,060,55~59세,2016,9288,4544,4744,95.8,9170,4478,4692,95.4
38060, 사천시,060001, 55세,2016,2088,1041,1047,99.4,2057,1025,1032,99.3
38060, 사천시,060002, 56세,2016,2001,985,1016,96.9,1976,967,1009,95.8
38060, 사천시,060003, 57세,2016,1719,844,875,96.5,1695,833,862,96.6
38060, 사천시,060004, 58세,2016,1738,845,893,94.6,1718,833,885,94.1
38060, 사천시,060005, 59세,2016,1742,829,913,90.8,1724,820,904,90.7
38060, 사천시,065,60~64세,2016,7567,3660,3907,93.7,7509,3628,3881,93.5
38060, 사천시,065001, 60세,2016,1604,784,820,95.6,1591,776,815,95.2
38060, 사천시,065002, 61세,2016,1821,854,967,88.3,1807,848,959,88.4
38060, 사천시,065003, 62세,2016,1568,805,763,105.5,1558,800,758,105.5
38060, 사천시,065004, 63세,2016,1177,551,626,88,1166,543,623,87.2
38060, 사천시,065005, 64세,2016,1397,666,731,91.1,1387,661,726,91
38060, 사천시,070,65~69세,2016,6225,2891,3334,86.7,6197,2879,3318,86.8
38060, 사천시,070001, 65세,2016,1219,558,661,84.4,1212,556,656,84.8
38060, 사천시,070002, 66세,2016,1250,594,656,90.5,1245,592,653,90.7
38060, 사천시,070003, 67세,2016,1267,590,677,87.1,1260,587,673,87.2
38060, 사천시,070004, 68세,2016,1272,599,673,89,1267,596,671,88.8
38060, 사천시,070005, 69세,2016,1217,550,667,82.5,1213,548,665,82.4
38060, 사천시,075,70~74세,2016,5030,2095,2935,71.4,5018,2090,2928,71.4
38060, 사천시,075001, 70세,2016,932,423,509,83.1,925,420,505,83.2
38060, 사천시,075002, 71세,2016,994,402,592,67.9,994,402,592,67.9
38060, 사천시,075003, 72세,2016,975,409,566,72.3,974,409,565,72.4
38060, 사천시,075004, 73세,2016,1004,432,572,75.5,1001,430,571,75.3
38060, 사천시,075005, 74세,2016,1125,429,696,61.6,1124,429,695,61.7
38060, 사천시,080,75~79세,2016,4630,1772,2858,62,4618,1769,2849,62.1
38060, 사천시,080001, 75세,2016,1055,440,615,71.5,1053,439,614,71.5
38060, 사천시,080002, 76세,2016,952,343,609,56.3,949,342,607,56.3
38060, 사천시,080003, 77세,2016,975,388,587,66.1,973,388,585,66.3
38060, 사천시,080004, 78세,2016,801,283,518,54.6,798,282,516,54.7
38060, 사천시,080005, 79세,2016,847,318,529,60.1,845,318,527,60.3
38060, 사천시,085,80~84세,2016,3106,948,2158,43.9,3105,948,2157,43.9
38060, 사천시,085001, 80세,2016,819,274,545,50.3,818,274,544,50.4
38060, 사천시,085002, 81세,2016,670,215,455,47.3,670,215,455,47.3
38060, 사천시,085003, 82세,2016,602,182,420,43.3,602,182,420,43.3
38060, 사천시,085004, 83세,2016,494,147,347,42.4,494,147,347,42.4
38060, 사천시,085005, 84세,2016,521,130,391,33.2,521,130,391,33.2
38060, 사천시,090,85~89세,2016,1383,292,1091,26.8,1381,292,1089,26.8
38060, 사천시,090001, 85세,2016,394,87,307,28.3,393,87,306,28.4
38060, 사천시,090002, 86세,2016,303,69,234,29.5,303,69,234,29.5
38060, 사천시,090003, 87세,2016,276,49,227,21.6,275,49,226,21.7
38060, 사천시,090004, 88세,2016,210,44,166,26.5,210,44,166,26.5
38060, 사천시,090005, 89세,2016,200,43,157,27.4,200,43,157,27.4
38060, 사천시,095,90~94세,2016,467,69,398,17.3,467,69,398,17.3
38060, 사천시,095001, 90세,2016,139,20,119,16.8,139,20,119,16.8
38060, 사천시,095002, 91세,2016,136,23,113,20.4,136,23,113,20.4
38060, 사천시,095003, 92세,2016,74,8,66,12.1,74,8,66,12.1
38060, 사천시,095004, 93세,2016,64,13,51,25.5,64,13,51,25.5
38060, 사천시,095005, 94세,2016,54,5,49,10.2,54,5,49,10.2
38060, 사천시,100,95~99세,2016,81,16,65,24.6,81,16,65,24.6
38060, 사천시,100001, 95세,2016,30,5,25,20,30,5,25,20
38060, 사천시,100002, 96세,2016,22,6,16,37.5,22,6,16,37.5
38060, 사천시,100003, 97세,2016,15,X,11,36.4,15,X,11,36.4
38060, 사천시,100004, 98세,2016,8,X,7,14.3,8,X,7,14.3
38060, 사천시,100005, 99세,2016,6,X,6,0,6,X,6,0
38060, 사천시,101,100세이상,2016,12,X,12,0,12,X,12,0
38060, 사천시,102,15세미만,2016,15581,8019,7562,106,15506,7980,7526,106
38060, 사천시,103,15~64세,2016,75879,41321,34558,119.6,72357,38597,33760,114.3
38060, 사천시,104,65세이상,2016,20934,8083,12851,62.9,20879,8063,12816,62.9
38060, 사천시,086,85세이상,2016,1943,377,1566,24.1,1941,377,1564,24.1
38060, 사천시,126,평균연령,2016,43.5,41.1,46,,43.7,41.4,46.2,
38060, 사천시,127,중위연령,2016,44.5,42.1,47.5,,45.1,42.9,47.8,
38070, 김해시,000,합계,2016,532912,274082,258830,105.9,510485,257235,253250,101.6
38070, 김해시,005,0~4세,2016,26963,13707,13256,103.4,26751,13606,13145,103.5
38070, 김해시,005001, 0세,2016,4824,2466,2358,104.6,4786,2451,2335,105
38070, 김해시,005002, 1세,2016,5198,2687,2511,107,5153,2663,2490,106.9
38070, 김해시,005003, 2세,2016,5496,2801,2695,103.9,5450,2781,2669,104.2
38070, 김해시,005004, 3세,2016,5394,2738,2656,103.1,5352,2715,2637,103
38070, 김해시,005005, 4세,2016,6051,3015,3036,99.3,6010,2996,3014,99.4
38070, 김해시,010,5~9세,2016,29920,15378,14542,105.7,29785,15314,14471,105.8
38070, 김해시,010001, 5세,2016,5968,3012,2956,101.9,5935,2994,2941,101.8
38070, 김해시,010002, 6세,2016,5856,3043,2813,108.2,5823,3028,2795,108.3
38070, 김해시,010003, 7세,2016,5690,2938,2752,106.8,5667,2931,2736,107.1
38070, 김해시,010004, 8세,2016,6074,3154,2920,108,6046,3142,2904,108.2
38070, 김해시,010005, 9세,2016,6332,3231,3101,104.2,6314,3219,3095,104
38070, 김해시,015,10~14세,2016,30019,15791,14228,111,29922,15745,14177,111.1
38070, 김해시,015001, 10세,2016,5811,3014,2797,107.8,5788,3004,2784,107.9
38070, 김해시,015002, 11세,2016,5682,3014,2668,113,5659,3003,2656,113.1
38070, 김해시,015003, 12세,2016,6001,3167,2834,111.8,5988,3161,2827,111.8
38070, 김해시,015004, 13세,2016,6182,3270,2912,112.3,6163,3261,2902,112.4
38070, 김해시,015005, 14세,2016,6343,3326,3017,110.2,6324,3316,3008,110.2
38070, 김해시,020,15~19세,2016,35481,18495,16986,108.9,35319,18410,16909,108.9
38070, 김해시,020001, 15세,2016,7151,3759,3392,110.8,7136,3751,3385,110.8
38070, 김해시,020002, 16세,2016,7267,3735,3532,105.7,7251,3725,3526,105.6
38070, 김해시,020003, 17세,2016,7303,3782,3521,107.4,7282,3770,3512,107.3
38070, 김해시,020004, 18세,2016,7208,3697,3511,105.3,7177,3679,3498,105.2
38070, 김해시,020005, 19세,2016,6552,3522,3030,116.2,6473,3485,2988,116.6
38070, 김해시,025,20~24세,2016,36392,20713,15679,132.1,33924,18766,15158,123.8
38070, 김해시,025001, 20세,2016,7312,4150,3162,131.2,7134,4038,3096,130.4
38070, 김해시,025002, 21세,2016,7363,4235,3128,135.4,7056,4001,3055,131
38070, 김해시,025003, 22세,2016,7300,4115,3185,129.2,6824,3735,3089,120.9
38070, 김해시,025004, 23세,2016,7257,4179,3078,135.8,6597,3642,2955,123.2
38070, 김해시,025005, 24세,2016,7160,4034,3126,129,6313,3350,2963,113.1
38070, 김해시,030,25~29세,2016,31268,17853,13415,133.1,26075,13721,12354,111.1
38070, 김해시,030001, 25세,2016,6698,3790,2908,130.3,5821,3111,2710,114.8
38070, 김해시,030002, 26세,2016,6362,3743,2619,142.9,5304,2885,2419,119.3
38070, 김해시,030003, 27세,2016,6017,3474,2543,136.6,5002,2672,2330,114.7
38070, 김해시,030004, 28세,2016,6033,3366,2667,126.2,4942,2509,2433,103.1
38070, 김해시,030005, 29세,2016,6158,3480,2678,129.9,5006,2544,2462,103.3
38070, 김해시,035,30~34세,2016,37639,20557,17082,120.3,32692,16497,16195,101.9
38070, 김해시,035001, 30세,2016,6513,3673,2840,129.3,5421,2811,2610,107.7
38070, 김해시,035002, 31세,2016,6751,3835,2916,131.5,5646,2916,2730,106.8
38070, 김해시,035003, 32세,2016,7190,3920,3270,119.9,6213,3117,3096,100.7
38070, 김해시,035004, 33세,2016,8113,4343,3770,115.2,7185,3575,3610,99
38070, 김해시,035005, 34세,2016,9072,4786,4286,111.7,8227,4078,4149,98.3
38070, 김해시,040,35~39세,2016,46274,23975,22299,107.5,43233,21532,21701,99.2
38070, 김해시,040001, 35세,2016,9471,5031,4440,113.3,8729,4416,4313,102.4
38070, 김해시,040002, 36세,2016,9749,5029,4720,106.5,9115,4504,4611,97.7
38070, 김해시,040003, 37세,2016,9439,4914,4525,108.6,8807,4418,4389,100.7
38070, 김해시,040004, 38세,2016,8746,4487,4259,105.4,8192,4059,4133,98.2
38070, 김해시,040005, 39세,2016,8869,4514,4355,103.7,8390,4135,4255,97.2
38070, 김해시,045,40~44세,2016,50492,25379,25113,101.1,48509,23894,24615,97.1
38070, 김해시,045001, 40세,2016,8804,4508,4296,104.9,8329,4130,4199,98.4
38070, 김해시,045002, 41세,2016,9785,4899,4886,100.3,9349,4577,4772,95.9
38070, 김해시,045003, 42세,2016,10499,5245,5254,99.8,10110,4960,5150,96.3
38070, 김해시,045004, 43세,2016,10850,5370,5480,98,10510,5118,5392,94.9
38070, 김해시,045005, 44세,2016,10554,5357,5197,103.1,10211,5109,5102,100.1
38070, 김해시,050,45~49세,2016,54177,27481,26696,102.9,52557,26424,26133,101.1
38070, 김해시,050001, 45세,2016,11474,5850,5624,104,11109,5597,5512,101.5
38070, 김해시,050002, 46세,2016,10969,5575,5394,103.4,10618,5342,5276,101.3
38070, 김해시,050003, 47세,2016,10841,5500,5341,103,10534,5310,5224,101.6
38070, 김해시,050004, 48세,2016,10966,5515,5451,101.2,10649,5313,5336,99.6
38070, 김해시,050005, 49세,2016,9927,5041,4886,103.2,9647,4862,4785,101.6
38070, 김해시,055,50~54세,2016,44509,23426,21083,111.1,43245,22698,20547,110.5
38070, 김해시,055001, 50세,2016,9488,4957,4531,109.4,9229,4810,4419,108.8
38070, 김해시,055002, 51세,2016,9239,4774,4465,106.9,8981,4617,4364,105.8
38070, 김해시,055003, 52세,2016,8259,4279,3980,107.5,8001,4134,3867,106.9
38070, 김해시,055004, 53세,2016,8655,4672,3983,117.3,8398,4529,3869,117.1
38070, 김해시,055005, 54세,2016,8868,4744,4124,115,8636,4608,4028,114.4
38070, 김해시,060,55~59세,2016,37920,19846,18074,109.8,37306,19479,17827,109.3
38070, 김해시,060001, 55세,2016,8879,4609,4270,107.9,8762,4535,4227,107.3
38070, 김해시,060002, 56세,2016,8435,4444,3991,111.4,8268,4352,3916,111.1
38070, 김해시,060003, 57세,2016,7361,3875,3486,111.2,7240,3807,3433,110.9
38070, 김해시,060004, 58세,2016,6713,3525,3188,110.6,6603,3456,3147,109.8
38070, 김해시,060005, 59세,2016,6532,3393,3139,108.1,6433,3329,3104,107.2
38070, 김해시,065,60~64세,2016,24485,12427,12058,103.1,24068,12213,11855,103
38070, 김해시,065001, 60세,2016,5766,2974,2792,106.5,5675,2922,2753,106.1
38070, 김해시,065002, 61세,2016,5644,2878,2766,104,5554,2832,2722,104
38070, 김해시,065003, 62세,2016,4808,2472,2336,105.8,4716,2426,2290,105.9
38070, 김해시,065004, 63세,2016,4008,1988,2020,98.4,3928,1948,1980,98.4
38070, 김해시,065005, 64세,2016,4259,2115,2144,98.6,4195,2085,2110,98.8
38070, 김해시,070,65~69세,2016,16361,7714,8647,89.2,16210,7638,8572,89.1
38070, 김해시,070001, 65세,2016,3349,1615,1734,93.1,3309,1593,1716,92.8
38070, 김해시,070002, 66세,2016,3421,1684,1737,96.9,3379,1664,1715,97
38070, 김해시,070003, 67세,2016,3254,1557,1697,91.8,3222,1537,1685,91.2
38070, 김해시,070004, 68세,2016,3315,1500,1815,82.6,3299,1493,1806,82.7
38070, 김해시,070005, 69세,2016,3022,1358,1664,81.6,3001,1351,1650,81.9
38070, 김해시,075,70~74세,2016,11911,5205,6706,77.6,11861,5185,6676,77.7
38070, 김해시,075001, 70세,2016,2197,1036,1161,89.2,2179,1030,1149,89.6
38070, 김해시,075002, 71세,2016,2195,985,1210,81.4,2183,980,1203,81.5
38070, 김해시,075003, 72세,2016,2428,1068,1360,78.5,2420,1064,1356,78.5
38070, 김해시,075004, 73세,2016,2442,1043,1399,74.6,2437,1039,1398,74.3
38070, 김해시,075005, 74세,2016,2649,1073,1576,68.1,2642,1072,1570,68.3
38070, 김해시,080,75~79세,2016,9616,3561,6055,58.8,9575,3546,6029,58.8
38070, 김해시,080001, 75세,2016,2216,850,1366,62.2,2208,849,1359,62.5
38070, 김해시,080002, 76세,2016,2092,806,1286,62.7,2079,801,1278,62.7
38070, 김해시,080003, 77세,2016,2017,758,1259,60.2,2011,756,1255,60.2
38070, 김해시,080004, 78세,2016,1671,597,1074,55.6,1660,592,1068,55.4
38070, 김해시,080005, 79세,2016,1620,550,1070,51.4,1617,548,1069,51.3
38070, 김해시,085,80~84세,2016,5993,1804,4189,43.1,5970,1798,4172,43.1
38070, 김해시,085001, 80세,2016,1462,475,987,48.1,1457,472,985,47.9
38070, 김해시,085002, 81세,2016,1361,412,949,43.4,1356,410,946,43.3
38070, 김해시,085003, 82세,2016,1217,374,843,44.4,1212,373,839,44.5
38070, 김해시,085004, 83세,2016,1022,284,738,38.5,1018,284,734,38.7
38070, 김해시,085005, 84세,2016,931,259,672,38.5,927,259,668,38.8
38070, 김해시,090,85~89세,2016,2644,612,2032,30.1,2638,612,2026,30.2
38070, 김해시,090001, 85세,2016,682,175,507,34.5,681,175,506,34.6
38070, 김해시,090002, 86세,2016,653,143,510,28,651,143,508,28.1
38070, 김해시,090003, 87세,2016,541,126,415,30.4,541,126,415,30.4
38070, 김해시,090004, 88세,2016,423,87,336,25.9,422,87,335,26
38070, 김해시,090005, 89세,2016,345,81,264,30.7,343,81,262,30.9
38070, 김해시,095,90~94세,2016,705,135,570,23.7,705,135,570,23.7
38070, 김해시,095001, 90세,2016,218,51,167,30.5,218,51,167,30.5
38070, 김해시,095002, 91세,2016,185,30,155,19.4,185,30,155,19.4
38070, 김해시,095003, 92세,2016,105,26,79,32.9,105,26,79,32.9
38070, 김해시,095004, 93세,2016,120,16,104,15.4,120,16,104,15.4
38070, 김해시,095005, 94세,2016,77,12,65,18.5,77,12,65,18.5
38070, 김해시,100,95~99세,2016,132,22,110,20,129,21,108,19.4
38070, 김해시,100001, 95세,2016,49,6,43,14,48,6,42,14.3
38070, 김해시,100002, 96세,2016,41,6,35,17.1,39,5,34,14.7
38070, 김해시,100003, 97세,2016,17,X,15,13.3,17,X,15,13.3
38070, 김해시,100004, 98세,2016,14,5,9,55.6,14,5,9,55.6
38070, 김해시,100005, 99세,2016,11,X,8,37.5,11,X,8,37.5
38070, 김해시,101,100세이상,2016,11,X,10,10,11,X,10,10
38070, 김해시,102,15세미만,2016,86902,44876,42026,106.8,86458,44665,41793,106.9
38070, 김해시,103,15~64세,2016,398637,210152,188485,111.5,376928,193634,183294,105.6
38070, 김해시,104,65세이상,2016,47373,19054,28319,67.3,47099,18936,28163,67.2
38070, 김해시,086,85세이상,2016,3492,770,2722,28.3,3483,769,2714,28.3
38070, 김해시,126,평균연령,2016,37.9,36.9,39,,38,37.1,39,
38070, 김해시,127,중위연령,2016,39.2,37.9,40.4,,39.7,38.8,40.6,
38080, 밀양시,000,합계,2016,103941,50820,53121,95.7,101286,49428,51858,95.3
38080, 밀양시,005,0~4세,2016,3151,1585,1566,101.2,3146,1582,1564,101.2
38080, 밀양시,005001, 0세,2016,672,329,343,95.9,672,329,343,95.9
38080, 밀양시,005002, 1세,2016,595,307,288,106.6,594,306,288,106.3
38080, 밀양시,005003, 2세,2016,587,298,289,103.1,586,297,289,102.8
38080, 밀양시,005004, 3세,2016,619,292,327,89.3,618,292,326,89.6
38080, 밀양시,005005, 4세,2016,678,359,319,112.5,676,358,318,112.6
38080, 밀양시,010,5~9세,2016,3540,1798,1742,103.2,3535,1797,1738,103.4
38080, 밀양시,010001, 5세,2016,675,327,348,94,674,327,347,94.2
38080, 밀양시,010002, 6세,2016,685,362,323,112.1,685,362,323,112.1
38080, 밀양시,010003, 7세,2016,653,343,310,110.6,651,342,309,110.7
38080, 밀양시,010004, 8세,2016,776,381,395,96.5,774,381,393,96.9
38080, 밀양시,010005, 9세,2016,751,385,366,105.2,751,385,366,105.2
38080, 밀양시,015,10~14세,2016,3733,1950,1783,109.4,3726,1945,1781,109.2
38080, 밀양시,015001, 10세,2016,682,352,330,106.7,681,351,330,106.4
38080, 밀양시,015002, 11세,2016,698,354,344,102.9,698,354,344,102.9
38080, 밀양시,015003, 12세,2016,745,398,347,114.7,743,396,347,114.1
38080, 밀양시,015004, 13세,2016,780,392,388,101,776,390,386,101
38080, 밀양시,015005, 14세,2016,828,454,374,121.4,828,454,374,121.4
38080, 밀양시,020,15~19세,2016,4997,2647,2350,112.6,4970,2636,2334,112.9
38080, 밀양시,020001, 15세,2016,970,536,434,123.5,967,534,433,123.3
38080, 밀양시,020002, 16세,2016,1117,573,544,105.3,1115,571,544,105
38080, 밀양시,020003, 17세,2016,1075,538,537,100.2,1073,537,536,100.2
38080, 밀양시,020004, 18세,2016,990,529,461,114.8,987,528,459,115
38080, 밀양시,020005, 19세,2016,845,471,374,125.9,828,466,362,128.7
38080, 밀양시,025,20~24세,2016,5769,3380,2389,141.5,5091,3171,1920,165.2
38080, 밀양시,025001, 20세,2016,1157,707,450,157.1,1044,687,357,192.4
38080, 밀양시,025002, 21세,2016,1206,723,483,149.7,1052,693,359,193
38080, 밀양시,025003, 22세,2016,1198,691,507,136.3,1041,638,403,158.3
38080, 밀양시,025004, 23세,2016,1145,665,480,138.5,1016,613,403,152.1
38080, 밀양시,025005, 24세,2016,1063,594,469,126.7,938,540,398,135.7
38080, 밀양시,030,25~29세,2016,4687,2639,2048,128.9,4062,2243,1819,123.3
38080, 밀양시,030001, 25세,2016,993,566,427,132.6,863,489,374,130.7
38080, 밀양시,030002, 26세,2016,982,563,419,134.4,835,479,356,134.6
38080, 밀양시,030003, 27세,2016,929,527,402,131.1,805,439,366,119.9
38080, 밀양시,030004, 28세,2016,889,498,391,127.4,777,431,346,124.6
38080, 밀양시,030005, 29세,2016,894,485,409,118.6,782,405,377,107.4
38080, 밀양시,035,30~34세,2016,5182,2823,2359,119.7,4739,2527,2212,114.2
38080, 밀양시,035001, 30세,2016,1000,537,463,116,896,462,434,106.5
38080, 밀양시,035002, 31세,2016,956,530,426,124.4,855,464,391,118.7
38080, 밀양시,035003, 32세,2016,1043,569,474,120,948,509,439,115.9
38080, 밀양시,035004, 33세,2016,1042,560,482,116.2,972,516,456,113.2
38080, 밀양시,035005, 34세,2016,1141,627,514,122,1068,576,492,117.1
38080, 밀양시,040,35~39세,2016,5736,2998,2738,109.5,5493,2844,2649,107.4
38080, 밀양시,040001, 35세,2016,1203,646,557,116,1150,613,537,114.2
38080, 밀양시,040002, 36세,2016,1167,573,594,96.5,1114,539,575,93.7
38080, 밀양시,040003, 37세,2016,1175,636,539,118,1125,601,524,114.7
38080, 밀양시,040004, 38세,2016,1090,593,497,119.3,1055,575,480,119.8
38080, 밀양시,040005, 39세,2016,1101,550,551,99.8,1049,516,533,96.8
38080, 밀양시,045,40~44세,2016,6352,3370,2982,113,6185,3265,2920,111.8
38080, 밀양시,045001, 40세,2016,1085,579,506,114.4,1043,551,492,112
38080, 밀양시,045002, 41세,2016,1164,632,532,118.8,1133,610,523,116.6
38080, 밀양시,045003, 42세,2016,1321,699,622,112.4,1287,676,611,110.6
38080, 밀양시,045004, 43세,2016,1402,733,669,109.6,1370,715,655,109.2
38080, 밀양시,045005, 44세,2016,1380,727,653,111.3,1352,713,639,111.6
38080, 밀양시,050,45~49세,2016,7681,3933,3748,104.9,7543,3864,3679,105
38080, 밀양시,050001, 45세,2016,1518,789,729,108.2,1481,769,712,108
38080, 밀양시,050002, 46세,2016,1432,723,709,102,1407,709,698,101.6
38080, 밀양시,050003, 47세,2016,1523,803,720,111.5,1493,791,702,112.7
38080, 밀양시,050004, 48세,2016,1580,831,749,110.9,1557,818,739,110.7
38080, 밀양시,050005, 49세,2016,1628,787,841,93.6,1605,777,828,93.8
38080, 밀양시,055,50~54세,2016,8864,4440,4424,100.4,8742,4384,4358,100.6
38080, 밀양시,055001, 50세,2016,1696,859,837,102.6,1679,854,825,103.5
38080, 밀양시,055002, 51세,2016,1648,776,872,89,1628,768,860,89.3
38080, 밀양시,055003, 52세,2016,1697,861,836,103,1668,847,821,103.2
38080, 밀양시,055004, 53세,2016,1823,940,883,106.5,1796,925,871,106.2
38080, 밀양시,055005, 54세,2016,2000,1004,996,100.8,1971,990,981,100.9
38080, 밀양시,060,55~59세,2016,10609,5190,5419,95.8,10518,5146,5372,95.8
38080, 밀양시,060001, 55세,2016,2131,1065,1066,99.9,2115,1062,1053,100.9
38080, 밀양시,060002, 56세,2016,2125,1052,1073,98,2103,1042,1061,98.2
38080, 밀양시,060003, 57세,2016,2038,991,1047,94.7,2015,976,1039,93.9
38080, 밀양시,060004, 58세,2016,2118,1017,1101,92.4,2103,1009,1094,92.2
38080, 밀양시,060005, 59세,2016,2197,1065,1132,94.1,2182,1057,1125,94
38080, 밀양시,065,60~64세,2016,9230,4494,4736,94.9,9172,4469,4703,95
38080, 밀양시,065001, 60세,2016,2049,1015,1034,98.2,2042,1013,1029,98.4
38080, 밀양시,065002, 61세,2016,1995,988,1007,98.1,1982,981,1001,98
38080, 밀양시,065003, 62세,2016,1774,860,914,94.1,1753,852,901,94.6
38080, 밀양시,065004, 63세,2016,1601,756,845,89.5,1596,755,841,89.8
38080, 밀양시,065005, 64세,2016,1811,875,936,93.5,1799,868,931,93.2
38080, 밀양시,070,65~69세,2016,7232,3374,3858,87.5,7204,3362,3842,87.5
38080, 밀양시,070001, 65세,2016,1537,699,838,83.4,1526,695,831,83.6
38080, 밀양시,070002, 66세,2016,1397,671,726,92.4,1390,664,726,91.5
38080, 밀양시,070003, 67세,2016,1464,704,760,92.6,1461,703,758,92.7
38080, 밀양시,070004, 68세,2016,1420,661,759,87.1,1418,661,757,87.3
38080, 밀양시,070005, 69세,2016,1414,639,775,82.5,1409,639,770,83
38080, 밀양시,075,70~74세,2016,5816,2492,3324,75,5806,2490,3316,75.1
38080, 밀양시,075001, 70세,2016,993,458,535,85.6,991,457,534,85.6
38080, 밀양시,075002, 71세,2016,1072,502,570,88.1,1068,502,566,88.7
38080, 밀양시,075003, 72세,2016,1102,455,647,70.3,1102,455,647,70.3
38080, 밀양시,075004, 73세,2016,1236,501,735,68.2,1234,500,734,68.1
38080, 밀양시,075005, 74세,2016,1413,576,837,68.8,1411,576,835,69
38080, 밀양시,080,75~79세,2016,5519,1998,3521,56.7,5515,1996,3519,56.7
38080, 밀양시,080001, 75세,2016,1209,459,750,61.2,1208,459,749,61.3
38080, 밀양시,080002, 76세,2016,1073,407,666,61.1,1072,406,666,61
38080, 밀양시,080003, 77세,2016,1170,421,749,56.2,1170,421,749,56.2
38080, 밀양시,080004, 78세,2016,1019,347,672,51.6,1017,346,671,51.6
38080, 밀양시,080005, 79세,2016,1048,364,684,53.2,1048,364,684,53.2
38080, 밀양시,085,80~84세,2016,3743,1205,2538,47.5,3740,1204,2536,47.5
38080, 밀양시,085001, 80세,2016,858,289,569,50.8,858,289,569,50.8
38080, 밀양시,085002, 81세,2016,891,301,590,51,890,301,589,51.1
38080, 밀양시,085003, 82세,2016,772,255,517,49.3,771,254,517,49.1
38080, 밀양시,085004, 83세,2016,631,192,439,43.7,631,192,439,43.7
38080, 밀양시,085005, 84세,2016,591,168,423,39.7,590,168,422,39.8
38080, 밀양시,090,85~89세,2016,1582,403,1179,34.2,1581,402,1179,34.1
38080, 밀양시,090001, 85세,2016,425,123,302,40.7,425,123,302,40.7
38080, 밀양시,090002, 86세,2016,368,96,272,35.3,368,96,272,35.3
38080, 밀양시,090003, 87세,2016,346,85,261,32.6,345,84,261,32.2
38080, 밀양시,090004, 88세,2016,240,55,185,29.7,240,55,185,29.7
38080, 밀양시,090005, 89세,2016,203,44,159,27.7,203,44,159,27.7
38080, 밀양시,095,90~94세,2016,445,87,358,24.3,445,87,358,24.3
38080, 밀양시,095001, 90세,2016,137,31,106,29.2,137,31,106,29.2
38080, 밀양시,095002, 91세,2016,123,17,106,16,123,17,106,16
38080, 밀양시,095003, 92세,2016,61,17,44,38.6,61,17,44,38.6
38080, 밀양시,095004, 93세,2016,82,16,66,24.2,82,16,66,24.2
38080, 밀양시,095005, 94세,2016,42,6,36,16.7,42,6,36,16.7
38080, 밀양시,100,95~99세,2016,68,14,54,25.9,68,14,54,25.9
38080, 밀양시,100001, 95세,2016,26,7,19,36.8,26,7,19,36.8
38080, 밀양시,100002, 96세,2016,22,5,17,29.4,22,5,17,29.4
38080, 밀양시,100003, 97세,2016,12,X,12,0,12,X,12,0
38080, 밀양시,100004, 98세,2016,5,X,X,66.7,5,X,X,66.7
38080, 밀양시,100005, 99세,2016,X,X,X,0,X,X,X,0
38080, 밀양시,101,100세이상,2016,5,X,5,0,5,X,5,0
38080, 밀양시,102,15세미만,2016,10424,5333,5091,104.8,10407,5324,5083,104.7
38080, 밀양시,103,15~64세,2016,69107,35914,33193,108.2,66515,34549,31966,108.1
38080, 밀양시,104,65세이상,2016,24410,9573,14837,64.5,24364,9555,14809,64.5
38080, 밀양시,086,85세이상,2016,2100,504,1596,31.6,2099,503,1596,31.5
38080, 밀양시,126,평균연령,2016,47.4,45.1,49.7,,47.8,45.4,50.1,
38080, 밀양시,127,중위연령,2016,50.7,47.9,53.4,,51.3,48.5,53.9,
38090, 거제시,000,합계,2016,262986,143047,119939,119.3,250709,134058,116651,114.9
38090, 거제시,005,0~4세,2016,17767,9135,8632,105.8,17398,8948,8450,105.9
38090, 거제시,005001, 0세,2016,3368,1681,1687,99.6,3305,1652,1653,99.9
38090, 거제시,005002, 1세,2016,3697,1900,1797,105.7,3613,1856,1757,105.6
38090, 거제시,005003, 2세,2016,3477,1764,1713,103,3408,1727,1681,102.7
38090, 거제시,005004, 3세,2016,3546,1853,1693,109.5,3465,1813,1652,109.7
38090, 거제시,005005, 4세,2016,3679,1937,1742,111.2,3607,1900,1707,111.3
38090, 거제시,010,5~9세,2016,16162,8331,7831,106.4,15869,8192,7677,106.7
38090, 거제시,010001, 5세,2016,3607,1828,1779,102.8,3541,1800,1741,103.4
38090, 거제시,010002, 6세,2016,3342,1715,1627,105.4,3273,1684,1589,106
38090, 거제시,010003, 7세,2016,3043,1580,1463,108,2987,1548,1439,107.6
38090, 거제시,010004, 8세,2016,3090,1590,1500,106,3034,1563,1471,106.3
38090, 거제시,010005, 9세,2016,3080,1618,1462,110.7,3034,1597,1437,111.1
38090, 거제시,015,10~14세,2016,13534,7048,6486,108.7,13374,6971,6403,108.9
38090, 거제시,015001, 10세,2016,2727,1373,1354,101.4,2681,1353,1328,101.9
38090, 거제시,015002, 11세,2016,2508,1292,1216,106.3,2471,1276,1195,106.8
38090, 거제시,015003, 12세,2016,2730,1450,1280,113.3,2697,1434,1263,113.5
38090, 거제시,015004, 13세,2016,2734,1430,1304,109.7,2707,1413,1294,109.2
38090, 거제시,015005, 14세,2016,2835,1503,1332,112.8,2818,1495,1323,113
38090, 거제시,020,15~19세,2016,14835,8082,6753,119.7,14745,8036,6709,119.8
38090, 거제시,020001, 15세,2016,3161,1718,1443,119.1,3142,1708,1434,119.1
38090, 거제시,020002, 16세,2016,3504,1898,1606,118.2,3487,1889,1598,118.2
38090, 거제시,020003, 17세,2016,3215,1682,1533,109.7,3206,1678,1528,109.8
38090, 거제시,020004, 18세,2016,2924,1530,1394,109.8,2906,1520,1386,109.7
38090, 거제시,020005, 19세,2016,2031,1254,777,161.4,2004,1241,763,162.6
38090, 거제시,025,20~24세,2016,12667,7761,4906,158.2,11761,7115,4646,153.1
38090, 거제시,025001, 20세,2016,2394,1619,775,208.9,2345,1585,760,208.6
38090, 거제시,025002, 21세,2016,2590,1678,912,184,2502,1624,878,185
38090, 거제시,025003, 22세,2016,2463,1480,983,150.6,2301,1377,924,149
38090, 거제시,025004, 23세,2016,2495,1455,1040,139.9,2273,1298,975,133.1
38090, 거제시,025005, 24세,2016,2725,1529,1196,127.8,2340,1231,1109,111
38090, 거제시,030,25~29세,2016,17001,10136,6865,147.6,14491,8123,6368,127.6
38090, 거제시,030001, 25세,2016,2794,1606,1188,135.2,2376,1279,1097,116.6
38090, 거제시,030002, 26세,2016,3232,1968,1264,155.7,2736,1569,1167,134.4
38090, 거제시,030003, 27세,2016,3390,2058,1332,154.5,2865,1640,1225,133.9
38090, 거제시,030004, 28세,2016,3605,2155,1450,148.6,3079,1725,1354,127.4
38090, 거제시,030005, 29세,2016,3980,2349,1631,144,3435,1910,1525,125.2
38090, 거제시,035,30~34세,2016,26213,15219,10994,138.4,23567,13103,10464,125.2
38090, 거제시,035001, 30세,2016,4492,2683,1809,148.3,3933,2227,1706,130.5
38090, 거제시,035002, 31세,2016,4862,2827,2035,138.9,4330,2389,1941,123.1
38090, 거제시,035003, 32세,2016,5132,2937,2195,133.8,4611,2519,2092,120.4
38090, 거제시,035004, 33세,2016,5679,3294,2385,138.1,5163,2894,2269,127.5
38090, 거제시,035005, 34세,2016,6048,3478,2570,135.3,5530,3074,2456,125.2
38090, 거제시,040,35~39세,2016,27533,15872,11661,136.1,25748,14468,11280,128.3
38090, 거제시,040001, 35세,2016,6100,3585,2515,142.5,5672,3242,2430,133.4
38090, 거제시,040002, 36세,2016,6135,3546,2589,137,5722,3222,2500,128.9
38090, 거제시,040003, 37세,2016,5512,3175,2337,135.9,5165,2897,2268,127.7
38090, 거제시,040004, 38세,2016,4952,2839,2113,134.4,4615,2585,2030,127.3
38090, 거제시,040005, 39세,2016,4834,2727,2107,129.4,4574,2522,2052,122.9
38090, 거제시,045,40~44세,2016,25349,14132,11217,126,24149,13234,10915,121.2
38090, 거제시,045001, 40세,2016,4894,2702,2192,123.3,4611,2476,2135,116
38090, 거제시,045002, 41세,2016,4798,2647,2151,123.1,4565,2474,2091,118.3
38090, 거제시,045003, 42세,2016,5193,2849,2344,121.5,4954,2674,2280,117.3
38090, 거제시,045004, 43세,2016,5337,2975,2362,126,5110,2807,2303,121.9
38090, 거제시,045005, 44세,2016,5127,2959,2168,136.5,4909,2803,2106,133.1
38090, 거제시,050,45~49세,2016,23403,13095,10308,127,22564,12515,10049,124.5
38090, 거제시,050001, 45세,2016,5219,2984,2235,133.5,5028,2843,2185,130.1
38090, 거제시,050002, 46세,2016,4903,2774,2129,130.3,4706,2637,2069,127.5
38090, 거제시,050003, 47세,2016,4645,2600,2045,127.1,4478,2486,1992,124.8
38090, 거제시,050004, 48세,2016,4473,2427,2046,118.6,4332,2331,2001,116.5
38090, 거제시,050005, 49세,2016,4163,2310,1853,124.7,4020,2218,1802,123.1
38090, 거제시,055,50~54세,2016,18590,10174,8416,120.9,17975,9803,8172,120
38090, 거제시,055001, 50세,2016,4119,2389,1730,138.1,4006,2323,1683,138
38090, 거제시,055002, 51세,2016,3972,2183,1789,122,3817,2093,1724,121.4
38090, 거제시,055003, 52세,2016,3219,1754,1465,119.7,3106,1685,1421,118.6
38090, 거제시,055004, 53세,2016,3542,1911,1631,117.2,3408,1833,1575,116.4
38090, 거제시,055005, 54세,2016,3738,1937,1801,107.6,3638,1869,1769,105.7
38090, 거제시,060,55~59세,2016,17989,9504,8485,112,17562,9247,8315,111.2
38090, 거제시,060001, 55세,2016,4009,1946,2063,94.3,3918,1894,2024,93.6
38090, 거제시,060002, 56세,2016,3961,1996,1965,101.6,3850,1935,1915,101
38090, 거제시,060003, 57세,2016,3442,1885,1557,121.1,3355,1825,1530,119.3
38090, 거제시,060004, 58세,2016,3330,1846,1484,124.4,3275,1814,1461,124.2
38090, 거제시,060005, 59세,2016,3247,1831,1416,129.3,3164,1779,1385,128.4
38090, 거제시,065,60~64세,2016,11625,6064,5561,109,11373,5904,5469,108
38090, 거제시,065001, 60세,2016,2872,1531,1341,114.2,2810,1494,1316,113.5
38090, 거제시,065002, 61세,2016,2690,1404,1286,109.2,2632,1369,1263,108.4
38090, 거제시,065003, 62세,2016,2133,1130,1003,112.7,2070,1090,980,111.2
38090, 거제시,065004, 63세,2016,1840,933,907,102.9,1796,903,893,101.1
38090, 거제시,065005, 64세,2016,2090,1066,1024,104.1,2065,1048,1017,103
38090, 거제시,070,65~69세,2016,7188,3743,3445,108.7,7084,3686,3398,108.5
38090, 거제시,070001, 65세,2016,1504,788,716,110.1,1470,770,700,110
38090, 거제시,070002, 66세,2016,1436,757,679,111.5,1412,745,667,111.7
38090, 거제시,070003, 67세,2016,1513,776,737,105.3,1490,763,727,105
38090, 거제시,070004, 68세,2016,1422,770,652,118.1,1407,760,647,117.5
38090, 거제시,070005, 69세,2016,1313,652,661,98.6,1305,648,657,98.6
38090, 거제시,075,70~74세,2016,4801,2155,2646,81.4,4760,2133,2627,81.2
38090, 거제시,075001, 70세,2016,817,410,407,100.7,811,405,406,99.8
38090, 거제시,075002, 71세,2016,901,410,491,83.5,894,406,488,83.2
38090, 거제시,075003, 72세,2016,908,413,495,83.4,899,409,490,83.5
38090, 거제시,075004, 73세,2016,1033,457,576,79.3,1025,452,573,78.9
38090, 거제시,075005, 74세,2016,1142,465,677,68.7,1131,461,670,68.8
38090, 거제시,080,75~79세,2016,3899,1459,2440,59.8,3876,1449,2427,59.7
38090, 거제시,080001, 75세,2016,903,357,546,65.4,900,356,544,65.4
38090, 거제시,080002, 76세,2016,783,321,462,69.5,776,317,459,69.1
38090, 거제시,080003, 77세,2016,834,292,542,53.9,826,288,538,53.5
38090, 거제시,080004, 78세,2016,688,253,435,58.2,684,252,432,58.3
38090, 거제시,080005, 79세,2016,691,236,455,51.9,690,236,454,52
38090, 거제시,085,80~84세,2016,2679,794,1885,42.1,2665,789,1876,42.1
38090, 거제시,085001, 80세,2016,672,227,445,51,668,225,443,50.8
38090, 거제시,085002, 81세,2016,601,184,417,44.1,596,183,413,44.3
38090, 거제시,085003, 82세,2016,512,147,365,40.3,510,146,364,40.1
38090, 거제시,085004, 83세,2016,477,125,352,35.5,474,124,350,35.4
38090, 거제시,085005, 84세,2016,417,111,306,36.3,417,111,306,36.3
38090, 거제시,090,85~89세,2016,1283,267,1016,26.3,1281,266,1015,26.2
38090, 거제시,090001, 85세,2016,346,86,260,33.1,345,85,260,32.7
38090, 거제시,090002, 86세,2016,306,54,252,21.4,305,54,251,21.5
38090, 거제시,090003, 87세,2016,310,64,246,26,310,64,246,26
38090, 거제시,090004, 88세,2016,200,37,163,22.7,200,37,163,22.7
38090, 거제시,090005, 89세,2016,121,26,95,27.4,121,26,95,27.4
38090, 거제시,095,90~94세,2016,402,66,336,19.6,401,66,335,19.7
38090, 거제시,095001, 90세,2016,118,24,94,25.5,118,24,94,25.5
38090, 거제시,095002, 91세,2016,100,15,85,17.6,100,15,85,17.6
38090, 거제시,095003, 92세,2016,93,10,83,12,92,10,82,12.2
38090, 거제시,095004, 93세,2016,58,12,46,26.1,58,12,46,26.1
38090, 거제시,095005, 94세,2016,33,5,28,17.9,33,5,28,17.9
38090, 거제시,100,95~99세,2016,62,9,53,17,62,9,53,17
38090, 거제시,100001, 95세,2016,32,6,26,23.1,32,6,26,23.1
38090, 거제시,100002, 96세,2016,17,X,14,21.4,17,X,14,21.4
38090, 거제시,100003, 97세,2016,5,X,5,0,5,X,5,0
38090, 거제시,100004, 98세,2016,X,X,X,0,X,X,X,0
38090, 거제시,100005, 99세,2016,5,X,5,0,5,X,5,0
38090, 거제시,101,100세이상,2016,X,X,X,33.3,X,X,X,33.3
38090, 거제시,102,15세미만,2016,47463,24514,22949,106.8,46641,24111,22530,107
38090, 거제시,103,15~64세,2016,195205,110039,85166,129.2,183935,101548,82387,123.3
38090, 거제시,104,65세이상,2016,20318,8494,11824,71.8,20133,8399,11734,71.6
38090, 거제시,086,85세이상,2016,1751,343,1408,24.4,1748,342,1406,24.3
38090, 거제시,126,평균연령,2016,36.7,36,37.6,,36.8,36.1,37.7,
38090, 거제시,127,중위연령,2016,37.2,36.6,38,,37.5,37,38.2,
38100, 양산시,000,합계,2016,310731,156708,154023,101.7,303466,151807,151659,100.1
38100, 양산시,005,0~4세,2016,16899,8646,8253,104.8,16825,8609,8216,104.8
38100, 양산시,005001, 0세,2016,3043,1544,1499,103,3034,1539,1495,102.9
38100, 양산시,005002, 1세,2016,3397,1710,1687,101.4,3376,1700,1676,101.4
38100, 양산시,005003, 2세,2016,3436,1805,1631,110.7,3418,1795,1623,110.6
38100, 양산시,005004, 3세,2016,3354,1681,1673,100.5,3338,1673,1665,100.5
38100, 양산시,005005, 4세,2016,3669,1906,1763,108.1,3659,1902,1757,108.3
38100, 양산시,010,5~9세,2016,16707,8532,8175,104.4,16658,8513,8145,104.5
38100, 양산시,010001, 5세,2016,3616,1830,1786,102.5,3601,1823,1778,102.5
38100, 양산시,010002, 6세,2016,3333,1678,1655,101.4,3321,1674,1647,101.6
38100, 양산시,010003, 7세,2016,3158,1642,1516,108.3,3150,1638,1512,108.3
38100, 양산시,010004, 8세,2016,3342,1728,1614,107.1,3335,1727,1608,107.4
38100, 양산시,010005, 9세,2016,3258,1654,1604,103.1,3251,1651,1600,103.2
38100, 양산시,015,10~14세,2016,15041,7705,7336,105,15011,7690,7321,105
38100, 양산시,015001, 10세,2016,2961,1494,1467,101.8,2953,1491,1462,102
38100, 양산시,015002, 11세,2016,2870,1464,1406,104.1,2864,1460,1404,104
38100, 양산시,015003, 12세,2016,3064,1559,1505,103.6,3059,1557,1502,103.7
38100, 양산시,015004, 13세,2016,2982,1571,1411,111.3,2975,1566,1409,111.1
38100, 양산시,015005, 14세,2016,3164,1617,1547,104.5,3160,1616,1544,104.7
38100, 양산시,020,15~19세,2016,18651,9613,9038,106.4,18589,9589,9000,106.5
38100, 양산시,020001, 15세,2016,3623,1901,1722,110.4,3619,1898,1721,110.3
38100, 양산시,020002, 16세,2016,4005,1921,2084,92.2,3991,1914,2077,92.2
38100, 양산시,020003, 17세,2016,3805,1906,1899,100.4,3795,1903,1892,100.6
38100, 양산시,020004, 18세,2016,3676,1923,1753,109.7,3667,1920,1747,109.9
38100, 양산시,020005, 19세,2016,3542,1962,1580,124.2,3517,1954,1563,125
38100, 양산시,025,20~24세,2016,19040,10540,8500,124,18266,9998,8268,120.9
38100, 양산시,025001, 20세,2016,3981,2346,1635,143.5,3928,2307,1621,142.3
38100, 양산시,025002, 21세,2016,3838,2201,1637,134.5,3745,2135,1610,132.6
38100, 양산시,025003, 22세,2016,3649,2054,1595,128.8,3514,1959,1555,126
38100, 양산시,025004, 23세,2016,3770,2015,1755,114.8,3547,1859,1688,110.1
38100, 양산시,025005, 24세,2016,3802,1924,1878,102.4,3532,1738,1794,96.9
38100, 양산시,030,25~29세,2016,18343,9838,8505,115.7,16751,8673,8078,107.4
38100, 양산시,030001, 25세,2016,3802,2061,1741,118.4,3530,1854,1676,110.6
38100, 양산시,030002, 26세,2016,3679,1999,1680,119,3357,1761,1596,110.3
38100, 양산시,030003, 27세,2016,3617,1977,1640,120.5,3297,1738,1559,111.5
38100, 양산시,030004, 28세,2016,3571,1894,1677,112.9,3235,1660,1575,105.4
38100, 양산시,030005, 29세,2016,3674,1907,1767,107.9,3332,1660,1672,99.3
38100, 양산시,035,30~34세,2016,22473,11748,10725,109.5,21055,10706,10349,103.4
38100, 양산시,035001, 30세,2016,3625,1902,1723,110.4,3326,1685,1641,102.7
38100, 양산시,035002, 31세,2016,3848,2062,1786,115.5,3569,1857,1712,108.5
38100, 양산시,035003, 32세,2016,4452,2339,2113,110.7,4141,2106,2035,103.5
38100, 양산시,035004, 33세,2016,4953,2585,2368,109.2,4707,2398,2309,103.9
38100, 양산시,035005, 34세,2016,5595,2860,2735,104.6,5312,2660,2652,100.3
38100, 양산시,040,35~39세,2016,27421,14104,13317,105.9,26453,13389,13064,102.5
38100, 양산시,040001, 35세,2016,5626,2909,2717,107.1,5397,2735,2662,102.7
38100, 양산시,040002, 36세,2016,5949,3063,2886,106.1,5756,2921,2835,103
38100, 양산시,040003, 37세,2016,5564,2802,2762,101.4,5350,2648,2702,98
38100, 양산시,040004, 38세,2016,5056,2639,2417,109.2,4876,2506,2370,105.7
38100, 양산시,040005, 39세,2016,5226,2691,2535,106.2,5074,2579,2495,103.4
38100, 양산시,045,40~44세,2016,27180,13941,13239,105.3,26483,13449,13034,103.2
38100, 양산시,045001, 40세,2016,4971,2549,2422,105.2,4812,2434,2378,102.4
38100, 양산시,045002, 41세,2016,5454,2796,2658,105.2,5291,2682,2609,102.8
38100, 양산시,045003, 42세,2016,5571,2839,2732,103.9,5453,2756,2697,102.2
38100, 양산시,045004, 43세,2016,5627,2852,2775,102.8,5508,2771,2737,101.2
38100, 양산시,045005, 44세,2016,5557,2905,2652,109.5,5419,2806,2613,107.4
38100, 양산시,050,45~49세,2016,28405,14044,14361,97.8,27835,13722,14113,97.2
38100, 양산시,050001, 45세,2016,5747,2905,2842,102.2,5613,2823,2790,101.2
38100, 양산시,050002, 46세,2016,5817,2882,2935,98.2,5684,2803,2881,97.3
38100, 양산시,050003, 47세,2016,5740,2856,2884,99,5643,2804,2839,98.8
38100, 양산시,050004, 48세,2016,5730,2766,2964,93.3,5622,2703,2919,92.6
38100, 양산시,050005, 49세,2016,5371,2635,2736,96.3,5273,2589,2684,96.5
38100, 양산시,055,50~54세,2016,25206,13108,12098,108.3,24755,12865,11890,108.2
38100, 양산시,055001, 50세,2016,5169,2692,2477,108.7,5069,2634,2435,108.2
38100, 양산시,055002, 51세,2016,5181,2675,2506,106.7,5083,2619,2464,106.3
38100, 양산시,055003, 52세,2016,4703,2424,2279,106.4,4618,2380,2238,106.3
38100, 양산시,055004, 53세,2016,4994,2636,2358,111.8,4898,2594,2304,112.6
38100, 양산시,055005, 54세,2016,5159,2681,2478,108.2,5087,2638,2449,107.7
38100, 양산시,060,55~59세,2016,23966,12163,11803,103.1,23683,12014,11669,103
38100, 양산시,060001, 55세,2016,5454,2812,2642,106.4,5405,2786,2619,106.4
38100, 양산시,060002, 56세,2016,5251,2701,2550,105.9,5179,2664,2515,105.9
38100, 양산시,060003, 57세,2016,4703,2339,2364,98.9,4643,2308,2335,98.8
38100, 양산시,060004, 58세,2016,4380,2211,2169,101.9,4320,2178,2142,101.7
38100, 양산시,060005, 59세,2016,4178,2100,2078,101.1,4136,2078,2058,101
38100, 양산시,065,60~64세,2016,17007,8291,8716,95.1,16826,8203,8623,95.1
38100, 양산시,065001, 60세,2016,3770,1854,1916,96.8,3718,1832,1886,97.1
38100, 양산시,065002, 61세,2016,3925,1900,2025,93.8,3893,1885,2008,93.9
38100, 양산시,065003, 62세,2016,3332,1617,1715,94.3,3295,1597,1698,94.1
38100, 양산시,065004, 63세,2016,2895,1433,1462,98,2861,1417,1444,98.1
38100, 양산시,065005, 64세,2016,3085,1487,1598,93.1,3059,1472,1587,92.8
38100, 양산시,070,65~69세,2016,11812,5624,6188,90.9,11739,5596,6143,91.1
38100, 양산시,070001, 65세,2016,2412,1201,1211,99.2,2390,1192,1198,99.5
38100, 양산시,070002, 66세,2016,2501,1235,1266,97.6,2482,1228,1254,97.9
38100, 양산시,070003, 67세,2016,2338,1094,1244,87.9,2322,1088,1234,88.2
38100, 양산시,070004, 68세,2016,2413,1137,1276,89.1,2403,1133,1270,89.2
38100, 양산시,070005, 69세,2016,2148,957,1191,80.4,2142,955,1187,80.5
38100, 양산시,075,70~74세,2016,8925,3990,4935,80.9,8905,3981,4924,80.8
38100, 양산시,075001, 70세,2016,1672,745,927,80.4,1670,745,925,80.5
38100, 양산시,075002, 71세,2016,1681,787,894,88,1676,784,892,87.9
38100, 양산시,075003, 72세,2016,1712,790,922,85.7,1705,788,917,85.9
38100, 양산시,075004, 73세,2016,1916,830,1086,76.4,1912,828,1084,76.4
38100, 양산시,075005, 74세,2016,1944,838,1106,75.8,1942,836,1106,75.6
38100, 양산시,080,75~79세,2016,7065,2755,4310,63.9,7051,2748,4303,63.9
38100, 양산시,080001, 75세,2016,1597,660,937,70.4,1595,658,937,70.2
38100, 양산시,080002, 76세,2016,1594,613,981,62.5,1591,612,979,62.5
38100, 양산시,080003, 77세,2016,1517,607,910,66.7,1515,605,910,66.5
38100, 양산시,080004, 78세,2016,1212,463,749,61.8,1208,462,746,61.9
38100, 양산시,080005, 79세,2016,1145,412,733,56.2,1142,411,731,56.2
38100, 양산시,085,80~84세,2016,4110,1450,2660,54.5,4104,1448,2656,54.5
38100, 양산시,085001, 80세,2016,1032,398,634,62.8,1031,398,633,62.9
38100, 양산시,085002, 81세,2016,985,369,616,59.9,984,368,616,59.7
38100, 양산시,085003, 82세,2016,792,269,523,51.4,790,268,522,51.3
38100, 양산시,085004, 83세,2016,695,245,450,54.4,695,245,450,54.4
38100, 양산시,085005, 84세,2016,606,169,437,38.7,604,169,435,38.9
38100, 양산시,090,85~89세,2016,1807,482,1325,36.4,1806,482,1324,36.4
38100, 양산시,090001, 85세,2016,458,122,336,36.3,458,122,336,36.3
38100, 양산시,090002, 86세,2016,421,111,310,35.8,421,111,310,35.8
38100, 양산시,090003, 87세,2016,389,104,285,36.5,388,104,284,36.6
38100, 양산시,090004, 88세,2016,292,72,220,32.7,292,72,220,32.7
38100, 양산시,090005, 89세,2016,247,73,174,42,247,73,174,42
38100, 양산시,095,90~94세,2016,568,119,449,26.5,566,117,449,26.1
38100, 양산시,095001, 90세,2016,162,28,134,20.9,162,28,134,20.9
38100, 양산시,095002, 91세,2016,150,37,113,32.7,149,36,113,31.9
38100, 양산시,095003, 92세,2016,107,24,83,28.9,106,23,83,27.7
38100, 양산시,095004, 93세,2016,85,15,70,21.4,85,15,70,21.4
38100, 양산시,095005, 94세,2016,64,15,49,30.6,64,15,49,30.6
38100, 양산시,100,95~99세,2016,91,13,78,16.7,91,13,78,16.7
38100, 양산시,100001, 95세,2016,40,5,35,14.3,40,5,35,14.3
38100, 양산시,100002, 96세,2016,21,X,17,23.5,21,X,17,23.5
38100, 양산시,100003, 97세,2016,17,X,14,21.4,17,X,14,21.4
38100, 양산시,100004, 98세,2016,6,X,6,0,6,X,6,0
38100, 양산시,100005, 99세,2016,7,X,6,16.7,7,X,6,16.7
38100, 양산시,101,100세이상,2016,14,X,12,16.7,14,X,12,16.7
38100, 양산시,102,15세미만,2016,48647,24883,23764,104.7,48494,24812,23682,104.8
38100, 양산시,103,15~64세,2016,227692,117390,110302,106.4,220696,112608,108088,104.2
38100, 양산시,104,65세이상,2016,34392,14435,19957,72.3,34276,14387,19889,72.3
38100, 양산시,086,85세이상,2016,2480,616,1864,33,2477,614,1863,33
38100, 양산시,126,평균연령,2016,39.2,38.2,40.3,,39.3,38.3,40.3,
38100, 양산시,127,중위연령,2016,40.2,39.1,41.3,,40.4,39.5,41.4,
38110, 창원시,000,합계,2016,1053551,538272,515279,104.5,1034028,525276,508752,103.2
38110, 창원시,005,0~4세,2016,47775,24694,23081,107,47571,24598,22973,107.1
38110, 창원시,005001, 0세,2016,8717,4474,4243,105.4,8672,4451,4221,105.4
38110, 창원시,005002, 1세,2016,9415,4876,4539,107.4,9375,4861,4514,107.7
38110, 창원시,005003, 2세,2016,9452,4920,4532,108.6,9402,4897,4505,108.7
38110, 창원시,005004, 3세,2016,9668,4991,4677,106.7,9633,4971,4662,106.6
38110, 창원시,005005, 4세,2016,10523,5433,5090,106.7,10489,5418,5071,106.8
38110, 창원시,010,5~9세,2016,49350,25529,23821,107.2,49217,25454,23763,107.1
38110, 창원시,010001, 5세,2016,10151,5251,4900,107.2,10127,5237,4890,107.1
38110, 창원시,010002, 6세,2016,9692,4997,4695,106.4,9655,4973,4682,106.2
38110, 창원시,010003, 7세,2016,9491,4941,4550,108.6,9463,4929,4534,108.7
38110, 창원시,010004, 8세,2016,9898,5007,4891,102.4,9871,4992,4879,102.3
38110, 창원시,010005, 9세,2016,10118,5333,4785,111.5,10101,5323,4778,111.4
38110, 창원시,015,10~14세,2016,49108,25907,23201,111.7,49026,25869,23157,111.7
38110, 창원시,015001, 10세,2016,9239,4865,4374,111.2,9217,4855,4362,111.3
38110, 창원시,015002, 11세,2016,9058,4726,4332,109.1,9040,4718,4322,109.2
38110, 창원시,015003, 12세,2016,10041,5254,4787,109.8,10024,5247,4777,109.8
38110, 창원시,015004, 13세,2016,10181,5479,4702,116.5,10170,5472,4698,116.5
38110, 창원시,015005, 14세,2016,10589,5583,5006,111.5,10575,5577,4998,111.6
38110, 창원시,020,15~19세,2016,64784,34887,29897,116.7,64556,34774,29782,116.8
38110, 창원시,020001, 15세,2016,12173,6408,5765,111.2,12158,6400,5758,111.1
38110, 창원시,020002, 16세,2016,13399,7193,6206,115.9,13380,7183,6197,115.9
38110, 창원시,020003, 17세,2016,13300,7078,6222,113.8,13268,7058,6210,113.7
38110, 창원시,020004, 18세,2016,13245,7127,6118,116.5,13185,7092,6093,116.4
38110, 창원시,020005, 19세,2016,12667,7081,5586,126.8,12565,7041,5524,127.5
38110, 창원시,025,20~24세,2016,70787,40020,30767,130.1,68944,38912,30032,129.6
38110, 창원시,025001, 20세,2016,14000,8075,5925,136.3,13797,7992,5805,137.7
38110, 창원시,025002, 21세,2016,14214,8244,5970,138.1,13932,8098,5834,138.8
38110, 창원시,025003, 22세,2016,14197,7960,6237,127.6,13883,7783,6100,127.6
38110, 창원시,025004, 23세,2016,13970,7803,6167,126.5,13486,7476,6010,124.4
38110, 창원시,025005, 24세,2016,14406,7938,6468,122.7,13846,7563,6283,120.4
38110, 창원시,030,25~29세,2016,66747,37419,29328,127.6,62456,34296,28160,121.8
38110, 창원시,030001, 25세,2016,13758,7626,6132,124.4,13005,7084,5921,119.6
38110, 창원시,030002, 26세,2016,13486,7635,5851,130.5,12646,7030,5616,125.2
38110, 창원시,030003, 27세,2016,13200,7464,5736,130.1,12328,6818,5510,123.7
38110, 창원시,030004, 28세,2016,12975,7261,5714,127.1,12091,6606,5485,120.4
38110, 창원시,030005, 29세,2016,13328,7433,5895,126.1,12386,6758,5628,120.1
38110, 창원시,035,30~34세,2016,75030,40925,34105,120,71254,38102,33152,114.9
38110, 창원시,035001, 30세,2016,13306,7545,5761,131,12425,6894,5531,124.6
38110, 창원시,035002, 31세,2016,13937,7750,6187,125.3,13096,7100,5996,118.4
38110, 창원시,035003, 32세,2016,14434,7901,6533,120.9,13674,7321,6353,115.2
38110, 창원시,035004, 33세,2016,15997,8598,7399,116.2,15335,8101,7234,112
38110, 창원시,035005, 34세,2016,17356,9131,8225,111,16724,8686,8038,108.1
38110, 창원시,040,35~39세,2016,83568,43930,39638,110.8,81158,42126,39032,107.9
38110, 창원시,040001, 35세,2016,17586,9422,8164,115.4,17034,9003,8031,112.1
38110, 창원시,040002, 36세,2016,18125,9382,8743,107.3,17618,8991,8627,104.2
38110, 창원시,040003, 37세,2016,16700,8740,7960,109.8,16230,8397,7833,107.2
38110, 창원시,040004, 38세,2016,15589,8270,7319,113,15116,7925,7191,110.2
38110, 창원시,040005, 39세,2016,15568,8116,7452,108.9,15160,7810,7350,106.3
38110, 창원시,045,40~44세,2016,85236,43437,41799,103.9,83443,42197,41246,102.3
38110, 창원시,045001, 40세,2016,15297,7955,7342,108.3,14894,7664,7230,106
38110, 창원시,045002, 41세,2016,16151,8196,7955,103,15814,7961,7853,101.4
38110, 창원시,045003, 42세,2016,17741,9034,8707,103.8,17397,8791,8606,102.1
38110, 창원시,045004, 43세,2016,18252,9188,9064,101.4,17913,8968,8945,100.3
38110, 창원시,045005, 44세,2016,17795,9064,8731,103.8,17425,8813,8612,102.3
38110, 창원시,050,45~49세,2016,97093,47634,49459,96.3,95383,46622,48761,95.6
38110, 창원시,050001, 45세,2016,19405,9574,9831,97.4,18998,9311,9687,96.1
38110, 창원시,050002, 46세,2016,19451,9626,9825,98,19101,9430,9671,97.5
38110, 창원시,050003, 47세,2016,19826,9854,9972,98.8,19489,9652,9837,98.1
38110, 창원시,050004, 48세,2016,20081,9682,10399,93.1,19740,9496,10244,92.7
38110, 창원시,050005, 49세,2016,18330,8898,9432,94.3,18055,8733,9322,93.7
38110, 창원시,055,50~54세,2016,92186,46410,45776,101.4,90788,45639,45149,101.1
38110, 창원시,055001, 50세,2016,18456,9374,9082,103.2,18157,9212,8945,103
38110, 창원시,055002, 51세,2016,18789,9282,9507,97.6,18505,9120,9385,97.2
38110, 창원시,055003, 52세,2016,16702,8336,8366,99.6,16407,8161,8246,99
38110, 창원시,055004, 53세,2016,18609,9451,9158,103.2,18327,9304,9023,103.1
38110, 창원시,055005, 54세,2016,19630,9967,9663,103.1,19392,9842,9550,103.1
38110, 창원시,060,55~59세,2016,91681,46129,45552,101.3,90917,45743,45174,101.3
38110, 창원시,060001, 55세,2016,20887,10464,10423,100.4,20735,10393,10342,100.5
38110, 창원시,060002, 56세,2016,20460,10185,10275,99.1,20276,10092,10184,99.1
38110, 창원시,060003, 57세,2016,17797,9040,8757,103.2,17633,8959,8674,103.3
38110, 창원시,060004, 58세,2016,16608,8502,8106,104.9,16466,8431,8035,104.9
38110, 창원시,060005, 59세,2016,15929,7938,7991,99.3,15807,7868,7939,99.1
38110, 창원시,065,60~64세,2016,64718,32330,32388,99.8,64220,32087,32133,99.9
38110, 창원시,065001, 60세,2016,14905,7308,7597,96.2,14780,7245,7535,96.2
38110, 창원시,065002, 61세,2016,15108,7355,7753,94.9,15007,7310,7697,95
38110, 창원시,065003, 62세,2016,12438,6388,6050,105.6,12338,6339,5999,105.7
38110, 창원시,065004, 63세,2016,10839,5485,5354,102.4,10736,5434,5302,102.5
38110, 창원시,065005, 64세,2016,11428,5794,5634,102.8,11359,5759,5600,102.8
38110, 창원시,070,65~69세,2016,42281,20843,21438,97.2,42073,20748,21325,97.3
38110, 창원시,070001, 65세,2016,8843,4307,4536,95,8782,4279,4503,95
38110, 창원시,070002, 66세,2016,8637,4277,4360,98.1,8584,4252,4332,98.2
38110, 창원시,070003, 67세,2016,8793,4379,4414,99.2,8752,4362,4390,99.4
38110, 창원시,070004, 68세,2016,8301,4152,4149,100.1,8281,4142,4139,100.1
38110, 창원시,070005, 69세,2016,7707,3728,3979,93.7,7674,3713,3961,93.7
38110, 창원시,075,70~74세,2016,28607,13114,15493,84.6,28530,13082,15448,84.7
38110, 창원시,075001, 70세,2016,5607,2766,2841,97.4,5590,2757,2833,97.3
38110, 창원시,075002, 71세,2016,5444,2519,2925,86.1,5427,2513,2914,86.2
38110, 창원시,075003, 72세,2016,5762,2628,3134,83.9,5739,2618,3121,83.9
38110, 창원시,075004, 73세,2016,5708,2518,3190,78.9,5696,2514,3182,79
38110, 창원시,075005, 74세,2016,6086,2683,3403,78.8,6078,2680,3398,78.9
38110, 창원시,080,75~79세,2016,22393,8830,13563,65.1,22336,8810,13526,65.1
38110, 창원시,080001, 75세,2016,5270,2215,3055,72.5,5259,2209,3050,72.4
38110, 창원시,080002, 76세,2016,4797,1922,2875,66.9,4782,1916,2866,66.9
38110, 창원시,080003, 77세,2016,4570,1784,2786,64,4564,1782,2782,64.1
38110, 창원시,080004, 78세,2016,3940,1542,2398,64.3,3924,1538,2386,64.5
38110, 창원시,080005, 79세,2016,3816,1367,2449,55.8,3807,1365,2442,55.9
38110, 창원시,085,80~84세,2016,13866,4411,9455,46.7,13832,4397,9435,46.6
38110, 창원시,085001, 80세,2016,3453,1206,2247,53.7,3441,1200,2241,53.5
38110, 창원시,085002, 81세,2016,3229,1094,2135,51.2,3220,1091,2129,51.2
38110, 창원시,085003, 82세,2016,2766,849,1917,44.3,2761,847,1914,44.3
38110, 창원시,085004, 83세,2016,2268,677,1591,42.6,2262,674,1588,42.4
38110, 창원시,085005, 84세,2016,2150,585,1565,37.4,2148,585,1563,37.4
38110, 창원시,090,85~89세,2016,6113,1421,4692,30.3,6105,1420,4685,30.3
38110, 창원시,090001, 85세,2016,1656,392,1264,31,1654,392,1262,31.1
38110, 창원시,090002, 86세,2016,1458,322,1136,28.3,1455,322,1133,28.4
38110, 창원시,090003, 87세,2016,1303,317,986,32.2,1301,316,985,32.1
38110, 창원시,090004, 88세,2016,959,218,741,29.4,958,218,740,29.5
38110, 창원시,090005, 89세,2016,737,172,565,30.4,737,172,565,30.4
38110, 창원시,095,90~94세,2016,1878,359,1519,23.6,1870,358,1512,23.7
38110, 창원시,095001, 90세,2016,560,119,441,27,559,118,441,26.8
38110, 창원시,095002, 91세,2016,499,98,401,24.4,494,98,396,24.7
38110, 창원시,095003, 92세,2016,323,53,270,19.6,322,53,269,19.7
38110, 창원시,095004, 93세,2016,290,50,240,20.8,289,50,239,20.9
38110, 창원시,095005, 94세,2016,206,39,167,23.4,206,39,167,23.4
38110, 창원시,100,95~99세,2016,308,41,267,15.4,307,40,267,15
38110, 창원시,100001, 95세,2016,117,13,104,12.5,116,12,104,11.5
38110, 창원시,100002, 96세,2016,84,8,76,10.5,84,8,76,10.5
38110, 창원시,100003, 97세,2016,43,11,32,34.4,43,11,32,34.4
38110, 창원시,100004, 98세,2016,36,7,29,24.1,36,7,29,24.1
38110, 창원시,100005, 99세,2016,28,X,26,7.7,28,X,26,7.7
38110, 창원시,101,100세이상,2016,42,X,40,5,42,X,40,5
38110, 창원시,102,15세미만,2016,146233,76130,70103,108.6,145814,75921,69893,108.6
38110, 창원시,103,15~64세,2016,791830,413121,378709,109.1,773119,400498,372621,107.5
38110, 창원시,104,65세이상,2016,115488,49021,66467,73.8,115095,48857,66238,73.8
38110, 창원시,086,85세이상,2016,8341,1823,6518,28,8324,1820,6504,28
38110, 창원시,126,평균연령,2016,40,38.8,41.3,,40.1,38.8,41.4,
38110, 창원시,127,중위연령,2016,41.3,39.5,43,,41.5,39.8,43.1,
38111, 의창구,000,합계,2016,250789,128324,122465,104.8,246182,125433,120749,103.9
38111, 의창구,005,0~4세,2016,10903,5555,5348,103.9,10848,5527,5321,103.9
38111, 의창구,005001, 0세,2016,2041,1037,1004,103.3,2029,1030,999,103.1
38111, 의창구,005002, 1세,2016,2233,1140,1093,104.3,2224,1137,1087,104.6
38111, 의창구,005003, 2세,2016,2142,1118,1024,109.2,2127,1109,1018,108.9
38111, 의창구,005004, 3세,2016,2139,1071,1068,100.3,2131,1067,1064,100.3
38111, 의창구,005005, 4세,2016,2348,1189,1159,102.6,2337,1184,1153,102.7
38111, 의창구,010,5~9세,2016,10670,5528,5142,107.5,10639,5509,5130,107.4
38111, 의창구,010001, 5세,2016,2223,1170,1053,111.1,2218,1167,1051,111
38111, 의창구,010002, 6세,2016,2148,1104,1044,105.7,2136,1097,1039,105.6
38111, 의창구,010003, 7세,2016,2082,1044,1038,100.6,2078,1042,1036,100.6
38111, 의창구,010004, 8세,2016,2107,1097,1010,108.6,2098,1091,1007,108.3
38111, 의창구,010005, 9세,2016,2110,1113,997,111.6,2109,1112,997,111.5
38111, 의창구,015,10~14세,2016,10627,5730,4897,117,10605,5720,4885,117.1
38111, 의창구,015001, 10세,2016,1948,1023,925,110.6,1945,1023,922,111
38111, 의창구,015002, 11세,2016,1913,1048,865,121.2,1907,1045,862,121.2
38111, 의창구,015003, 12세,2016,2175,1139,1036,109.9,2171,1137,1034,110
38111, 의창구,015004, 13세,2016,2199,1178,1021,115.4,2196,1176,1020,115.3
38111, 의창구,015005, 14세,2016,2392,1342,1050,127.8,2386,1339,1047,127.9
38111, 의창구,020,15~19세,2016,16340,8727,7613,114.6,16286,8712,7574,115
38111, 의창구,020001, 15세,2016,2828,1454,1374,105.8,2823,1453,1370,106.1
38111, 의창구,020002, 16세,2016,3304,1795,1509,119,3301,1794,1507,119
38111, 의창구,020003, 17세,2016,3198,1681,1517,110.8,3194,1680,1514,111
38111, 의창구,020004, 18세,2016,3382,1786,1596,111.9,3372,1783,1589,112.2
38111, 의창구,020005, 19세,2016,3628,2011,1617,124.4,3596,2002,1594,125.6
38111, 의창구,025,20~24세,2016,19753,11135,8618,129.2,19330,10902,8428,129.4
38111, 의창구,025001, 20세,2016,3903,2174,1729,125.7,3847,2153,1694,127.1
38111, 의창구,025002, 21세,2016,3945,2283,1662,137.4,3887,2251,1636,137.6
38111, 의창구,025003, 22세,2016,4024,2229,1795,124.2,3954,2195,1759,124.8
38111, 의창구,025004, 23세,2016,3932,2219,1713,129.5,3818,2147,1671,128.5
38111, 의창구,025005, 24세,2016,3949,2230,1719,129.7,3824,2156,1668,129.3
38111, 의창구,030,25~29세,2016,16742,9303,7439,125.1,15794,8654,7140,121.2
38111, 의창구,030001, 25세,2016,3754,2056,1698,121.1,3590,1950,1640,118.9
38111, 의창구,030002, 26세,2016,3488,1947,1541,126.3,3286,1799,1487,121
38111, 의창구,030003, 27세,2016,3225,1816,1409,128.9,3036,1695,1341,126.4
38111, 의창구,030004, 28세,2016,3159,1732,1427,121.4,2991,1608,1383,116.3
38111, 의창구,030005, 29세,2016,3116,1752,1364,128.4,2891,1602,1289,124.3
38111, 의창구,035,30~34세,2016,17827,9630,8197,117.5,16990,9040,7950,113.7
38111, 의창구,035001, 30세,2016,3234,1833,1401,130.8,3047,1705,1342,127
38111, 의창구,035002, 31세,2016,3394,1870,1524,122.7,3209,1740,1469,118.4
38111, 의창구,035003, 32세,2016,3385,1796,1589,113,3216,1673,1543,108.4
38111, 의창구,035004, 33세,2016,3742,1977,1765,112,3603,1875,1728,108.5
38111, 의창구,035005, 34세,2016,4072,2154,1918,112.3,3915,2047,1868,109.6
38111, 의창구,040,35~39세,2016,18779,9994,8785,113.8,18194,9577,8617,111.1
38111, 의창구,040001, 35세,2016,4062,2143,1919,111.7,3935,2046,1889,108.3
38111, 의창구,040002, 36세,2016,4143,2193,1950,112.5,4015,2103,1912,110
38111, 의창구,040003, 37세,2016,3609,1930,1679,114.9,3494,1850,1644,112.5
38111, 의창구,040004, 38세,2016,3583,1939,1644,117.9,3453,1851,1602,115.5
38111, 의창구,040005, 39세,2016,3382,1789,1593,112.3,3297,1727,1570,110
38111, 의창구,045,40~44세,2016,19501,9872,9629,102.5,19051,9577,9474,101.1
38111, 의창구,045001, 40세,2016,3486,1818,1668,109,3390,1747,1643,106.3
38111, 의창구,045002, 41세,2016,3585,1852,1733,106.9,3500,1794,1706,105.2
38111, 의창구,045003, 42세,2016,4016,2022,1994,101.4,3925,1957,1968,99.4
38111, 의창구,045004, 43세,2016,4239,2074,2165,95.8,4150,2027,2123,95.5
38111, 의창구,045005, 44세,2016,4175,2106,2069,101.8,4086,2052,2034,100.9
38111, 의창구,050,45~49세,2016,24177,11404,12773,89.3,23740,11162,12578,88.7
38111, 의창구,050001, 45세,2016,4583,2155,2428,88.8,4500,2106,2394,88
38111, 의창구,050002, 46세,2016,4759,2258,2501,90.3,4669,2202,2467,89.3
38111, 의창구,050003, 47세,2016,4968,2384,2584,92.3,4873,2334,2539,91.9
38111, 의창구,050004, 48세,2016,5104,2373,2731,86.9,5015,2329,2686,86.7
38111, 의창구,050005, 49세,2016,4763,2234,2529,88.3,4683,2191,2492,87.9
38111, 의창구,055,50~54세,2016,23883,12007,11876,101.1,23504,11797,11707,100.8
38111, 의창구,055001, 50세,2016,4766,2364,2402,98.4,4689,2318,2371,97.8
38111, 의창구,055002, 51세,2016,5058,2492,2566,97.1,4971,2452,2519,97.3
38111, 의창구,055003, 52세,2016,4278,2096,2182,96.1,4199,2053,2146,95.7
38111, 의창구,055004, 53세,2016,4764,2434,2330,104.5,4684,2387,2297,103.9
38111, 의창구,055005, 54세,2016,5017,2621,2396,109.4,4961,2587,2374,109
38111, 의창구,060,55~59세,2016,22395,11514,10881,105.8,22221,11425,10796,105.8
38111, 의창구,060001, 55세,2016,5233,2698,2535,106.4,5202,2686,2516,106.8
38111, 의창구,060002, 56세,2016,5081,2585,2496,103.6,5037,2563,2474,103.6
38111, 의창구,060003, 57세,2016,4306,2238,2068,108.2,4273,2218,2055,107.9
38111, 의창구,060004, 58세,2016,4004,2104,1900,110.7,3971,2089,1882,111
38111, 의창구,060005, 59세,2016,3771,1889,1882,100.4,3738,1869,1869,100
38111, 의창구,065,60~64세,2016,14788,7503,7285,103,14669,7445,7224,103.1
38111, 의창구,065001, 60세,2016,3533,1757,1776,98.9,3506,1743,1763,98.9
38111, 의창구,065002, 61세,2016,3388,1687,1701,99.2,3365,1676,1689,99.2
38111, 의창구,065003, 62세,2016,2837,1458,1379,105.7,2818,1448,1370,105.7
38111, 의창구,065004, 63세,2016,2466,1273,1193,106.7,2440,1259,1181,106.6
38111, 의창구,065005, 64세,2016,2564,1328,1236,107.4,2540,1319,1221,108
38111, 의창구,070,65~69세,2016,8989,4630,4359,106.2,8928,4602,4326,106.4
38111, 의창구,070001, 65세,2016,1919,981,938,104.6,1901,973,928,104.8
38111, 의창구,070002, 66세,2016,1866,983,883,111.3,1853,977,876,111.5
38111, 의창구,070003, 67세,2016,1849,962,887,108.5,1837,957,880,108.8
38111, 의창구,070004, 68세,2016,1752,904,848,106.6,1743,897,846,106
38111, 의창구,070005, 69세,2016,1603,800,803,99.6,1594,798,796,100.3
38111, 의창구,075,70~74세,2016,5813,2716,3097,87.7,5806,2714,3092,87.8
38111, 의창구,075001, 70세,2016,1116,577,539,107.1,1113,576,537,107.3
38111, 의창구,075002, 71세,2016,1090,520,570,91.2,1090,520,570,91.2
38111, 의창구,075003, 72세,2016,1134,529,605,87.4,1132,528,604,87.4
38111, 의창구,075004, 73세,2016,1201,541,660,82,1199,541,658,82.2
38111, 의창구,075005, 74세,2016,1272,549,723,75.9,1272,549,723,75.9
38111, 의창구,080,75~79세,2016,4589,1724,2865,60.2,4574,1720,2854,60.3
38111, 의창구,080001, 75세,2016,1048,436,612,71.2,1044,434,610,71.1
38111, 의창구,080002, 76세,2016,1002,389,613,63.5,999,389,610,63.8
38111, 의창구,080003, 77세,2016,912,325,587,55.4,910,325,585,55.6
38111, 의창구,080004, 78세,2016,803,295,508,58.1,798,293,505,58
38111, 의창구,080005, 79세,2016,824,279,545,51.2,823,279,544,51.3
38111, 의창구,085,80~84세,2016,3126,957,2169,44.1,3120,956,2164,44.2
38111, 의창구,085001, 80세,2016,730,259,471,55,727,258,469,55
38111, 의창구,085002, 81세,2016,792,280,512,54.7,790,280,510,54.9
38111, 의창구,085003, 82세,2016,610,153,457,33.5,610,153,457,33.5
38111, 의창구,085004, 83세,2016,512,147,365,40.3,512,147,365,40.3
38111, 의창구,085005, 84세,2016,482,118,364,32.4,481,118,363,32.5
38111, 의창구,090,85~89세,2016,1367,297,1070,27.8,1366,297,1069,27.8
38111, 의창구,090001, 85세,2016,369,91,278,32.7,369,91,278,32.7
38111, 의창구,090002, 86세,2016,305,65,240,27.1,304,65,239,27.2
38111, 의창구,090003, 87세,2016,297,67,230,29.1,297,67,230,29.1
38111, 의창구,090004, 88세,2016,223,41,182,22.5,223,41,182,22.5
38111, 의창구,090005, 89세,2016,173,33,140,23.6,173,33,140,23.6
38111, 의창구,095,90~94세,2016,437,89,348,25.6,434,88,346,25.4
38111, 의창구,095001, 90세,2016,122,29,93,31.2,121,28,93,30.1
38111, 의창구,095002, 91세,2016,109,29,80,36.3,108,29,79,36.7
38111, 의창구,095003, 92세,2016,74,10,64,15.6,73,10,63,15.9
38111, 의창구,095004, 93세,2016,70,12,58,20.7,70,12,58,20.7
38111, 의창구,095005, 94세,2016,62,9,53,17,62,9,53,17
38111, 의창구,100,95~99세,2016,71,8,63,12.7,71,8,63,12.7
38111, 의창구,100001, 95세,2016,24,X,23,4.3,24,X,23,4.3
38111, 의창구,100002, 96세,2016,22,X,20,10,22,X,20,10
38111, 의창구,100003, 97세,2016,8,X,7,14.3,8,X,7,14.3
38111, 의창구,100004, 98세,2016,10,X,8,25,10,X,8,25
38111, 의창구,100005, 99세,2016,7,X,5,40,7,X,5,40
38111, 의창구,101,100세이상,2016,12,X,11,9.1,12,X,11,9.1
38111, 의창구,102,15세미만,2016,32200,16813,15387,109.3,32092,16756,15336,109.3
38111, 의창구,103,15~64세,2016,194185,101089,93096,108.6,189779,98291,91488,107.4
38111, 의창구,104,65세이상,2016,24404,10422,13982,74.5,24311,10386,13925,74.6
38111, 의창구,086,85세이상,2016,1887,395,1492,26.5,1883,394,1489,26.5
38111, 의창구,126,평균연령,2016,39.7,38.6,40.9,,39.8,38.6,41,
38111, 의창구,127,중위연령,2016,41.1,39.2,42.9,,41.3,39.5,43,
38112, 성산구,000,합계,2016,230552,120387,110165,109.3,225493,116624,108869,107.1
38112, 성산구,005,0~4세,2016,10137,5177,4960,104.4,10101,5161,4940,104.5
38112, 성산구,005001, 0세,2016,1904,974,930,104.7,1897,971,926,104.9
38112, 성산구,005002, 1세,2016,2038,1043,995,104.8,2031,1042,989,105.4
38112, 성산구,005003, 2세,2016,1977,1009,968,104.2,1967,1006,961,104.7
38112, 성산구,005004, 3세,2016,2022,1036,986,105.1,2016,1030,986,104.5
38112, 성산구,005005, 4세,2016,2196,1115,1081,103.1,2190,1112,1078,103.2
38112, 성산구,010,5~9세,2016,10939,5710,5229,109.2,10909,5691,5218,109.1
38112, 성산구,010001, 5세,2016,2172,1123,1049,107.1,2164,1117,1047,106.7
38112, 성산구,010002, 6세,2016,2072,1062,1010,105.1,2064,1058,1006,105.2
38112, 성산구,010003, 7세,2016,2086,1108,978,113.3,2079,1105,974,113.4
38112, 성산구,010004, 8세,2016,2249,1155,1094,105.6,2245,1152,1093,105.4
38112, 성산구,010005, 9세,2016,2360,1262,1098,114.9,2357,1259,1098,114.7
38112, 성산구,015,10~14세,2016,12218,6477,5741,112.8,12198,6468,5730,112.9
38112, 성산구,015001, 10세,2016,2165,1158,1007,115,2161,1156,1005,115
38112, 성산구,015002, 11세,2016,2229,1179,1050,112.3,2227,1177,1050,112.1
38112, 성산구,015003, 12세,2016,2431,1284,1147,111.9,2423,1281,1142,112.2
38112, 성산구,015004, 13세,2016,2617,1418,1199,118.3,2613,1416,1197,118.3
38112, 성산구,015005, 14세,2016,2776,1438,1338,107.5,2774,1438,1336,107.6
38112, 성산구,020,15~19세,2016,16401,9177,7224,127,16359,9153,7206,127
38112, 성산구,020001, 15세,2016,3252,1716,1536,111.7,3247,1712,1535,111.5
38112, 성산구,020002, 16세,2016,3573,2044,1529,133.7,3569,2041,1528,133.6
38112, 성산구,020003, 17세,2016,3578,2005,1573,127.5,3573,2002,1571,127.4
38112, 성산구,020004, 18세,2016,3428,1893,1535,123.3,3412,1885,1527,123.4
38112, 성산구,020005, 19세,2016,2570,1519,1051,144.5,2558,1513,1045,144.8
38112, 성산구,025,20~24세,2016,16777,9817,6960,141,16363,9512,6851,138.8
38112, 성산구,025001, 20세,2016,3261,2042,1219,167.5,3227,2019,1208,167.1
38112, 성산구,025002, 21세,2016,3287,2078,1209,171.9,3243,2044,1199,170.5
38112, 성산구,025003, 22세,2016,3376,1936,1440,134.4,3311,1891,1420,133.2
38112, 성산구,025004, 23세,2016,3311,1832,1479,123.9,3194,1749,1445,121
38112, 성산구,025005, 24세,2016,3542,1929,1613,119.6,3388,1809,1579,114.6
38112, 성산구,030,25~29세,2016,18137,10555,7582,139.2,16821,9474,7347,129
38112, 성산구,030001, 25세,2016,3671,2039,1632,124.9,3438,1848,1590,116.2
38112, 성산구,030002, 26세,2016,3540,2069,1471,140.7,3307,1883,1424,132.2
38112, 성산구,030003, 27세,2016,3616,2108,1508,139.8,3343,1881,1462,128.7
38112, 성산구,030004, 28세,2016,3616,2145,1471,145.8,3318,1898,1420,133.7
38112, 성산구,030005, 29세,2016,3694,2194,1500,146.3,3415,1964,1451,135.4
38112, 성산구,035,30~34세,2016,17646,10059,7587,132.6,16533,9145,7388,123.8
38112, 성산구,035001, 30세,2016,3485,2092,1393,150.2,3215,1867,1348,138.5
38112, 성산구,035002, 31세,2016,3471,2068,1403,147.4,3235,1871,1364,137.2
38112, 성산구,035003, 32세,2016,3417,1959,1458,134.4,3194,1771,1423,124.5
38112, 성산구,035004, 33세,2016,3610,2011,1599,125.8,3403,1842,1561,118
38112, 성산구,035005, 34세,2016,3663,1929,1734,111.2,3486,1794,1692,106
38112, 성산구,040,35~39세,2016,17486,8938,8548,104.6,16813,8403,8410,99.9
38112, 성산구,040001, 35세,2016,3644,1952,1692,115.4,3479,1820,1659,109.7
38112, 성산구,040002, 36세,2016,3671,1870,1801,103.8,3537,1761,1776,99.2
38112, 성산구,040003, 37세,2016,3506,1788,1718,104.1,3369,1674,1695,98.8
38112, 성산구,040004, 38세,2016,3264,1654,1610,102.7,3141,1557,1584,98.3
38112, 성산구,040005, 39세,2016,3401,1674,1727,96.9,3287,1591,1696,93.8
38112, 성산구,045,40~44세,2016,19639,9340,10299,90.7,19213,9025,10188,88.6
38112, 성산구,045001, 40세,2016,3355,1645,1710,96.2,3266,1578,1688,93.5
38112, 성산구,045002, 41세,2016,3562,1670,1892,88.3,3466,1602,1864,85.9
38112, 성산구,045003, 42세,2016,3997,1883,2114,89.1,3924,1829,2095,87.3
38112, 성산구,045004, 43세,2016,4300,2009,2291,87.7,4217,1945,2272,85.6
38112, 성산구,045005, 44세,2016,4425,2133,2292,93.1,4340,2071,2269,91.3
38112, 성산구,050,45~49세,2016,24851,11654,13197,88.3,24483,11426,13057,87.5
38112, 성산구,050001, 45세,2016,4941,2355,2586,91.1,4855,2294,2561,89.6
38112, 성산구,050002, 46세,2016,5005,2359,2646,89.2,4924,2316,2608,88.8
38112, 성산구,050003, 47세,2016,5049,2347,2702,86.9,4965,2292,2673,85.7
38112, 성산구,050004, 48세,2016,5170,2391,2779,86,5101,2351,2750,85.5
38112, 성산구,050005, 49세,2016,4686,2202,2484,88.6,4638,2173,2465,88.2
38112, 성산구,055,50~54세,2016,23274,11761,11513,102.2,22993,11603,11390,101.9
38112, 성산구,055001, 50세,2016,4689,2345,2344,100,4628,2312,2316,99.8
38112, 성산구,055002, 51세,2016,4894,2419,2475,97.7,4835,2380,2455,96.9
38112, 성산구,055003, 52세,2016,4238,2105,2133,98.7,4173,2066,2107,98.1
38112, 성산구,055004, 53세,2016,4696,2435,2261,107.7,4646,2407,2239,107.5
38112, 성산구,055005, 54세,2016,4757,2457,2300,106.8,4711,2438,2273,107.3
38112, 성산구,060,55~59세,2016,19621,10639,8982,118.4,19446,10551,8895,118.6
38112, 성산구,060001, 55세,2016,4966,2528,2438,103.7,4928,2510,2418,103.8
38112, 성산구,060002, 56세,2016,4683,2540,2143,118.5,4644,2523,2121,119
38112, 성산구,060003, 57세,2016,3767,2137,1630,131.1,3728,2120,1608,131.8
38112, 성산구,060004, 58세,2016,3312,1872,1440,130,3282,1857,1425,130.3
38112, 성산구,060005, 59세,2016,2893,1562,1331,117.4,2864,1541,1323,116.5
38112, 성산구,065,60~64세,2016,10061,5431,4630,117.3,9968,5393,4575,117.9
38112, 성산구,065001, 60세,2016,2517,1300,1217,106.8,2493,1291,1202,107.4
38112, 성산구,065002, 61세,2016,2434,1276,1158,110.2,2412,1266,1146,110.5
38112, 성산구,065003, 62세,2016,1845,1033,812,127.2,1826,1028,798,128.8
38112, 성산구,065004, 63세,2016,1676,926,750,123.5,1659,918,741,123.9
38112, 성산구,065005, 64세,2016,1589,896,693,129.3,1578,890,688,129.4
38112, 성산구,070,65~69세,2016,5295,2794,2501,111.7,5266,2779,2487,111.7
38112, 성산구,070001, 65세,2016,1249,669,580,115.3,1241,663,578,114.7
38112, 성산구,070002, 66세,2016,1059,600,459,130.7,1050,596,454,131.3
38112, 성산구,070003, 67세,2016,1069,537,532,100.9,1064,536,528,101.5
38112, 성산구,070004, 68세,2016,988,502,486,103.3,986,502,484,103.7
38112, 성산구,070005, 69세,2016,930,486,444,109.5,925,482,443,108.8
38112, 성산구,075,70~74세,2016,2984,1362,1622,84,2962,1354,1608,84.2
38112, 성산구,075001, 70세,2016,621,304,317,95.9,616,301,315,95.6
38112, 성산구,075002, 71세,2016,557,278,279,99.6,552,277,275,100.7
38112, 성산구,075003, 72세,2016,585,248,337,73.6,579,244,335,72.8
38112, 성산구,075004, 73세,2016,587,260,327,79.5,583,260,323,80.5
38112, 성산구,075005, 74세,2016,634,272,362,75.1,632,272,360,75.6
38112, 성산구,080,75~79세,2016,2392,864,1528,56.5,2380,858,1522,56.4
38112, 성산구,080001, 75세,2016,527,211,316,66.8,524,209,315,66.3
38112, 성산구,080002, 76세,2016,518,187,331,56.5,514,184,330,55.8
38112, 성산구,080003, 77세,2016,511,173,338,51.2,511,173,338,51.2
38112, 성산구,080004, 78세,2016,435,163,272,59.9,432,162,270,60
38112, 성산구,080005, 79세,2016,401,130,271,48,399,130,269,48.3
38112, 성산구,085,80~84세,2016,1659,425,1234,34.4,1654,422,1232,34.3
38112, 성산구,085001, 80세,2016,398,110,288,38.2,398,110,288,38.2
38112, 성산구,085002, 81세,2016,400,103,297,34.7,399,102,297,34.3
38112, 성산구,085003, 82세,2016,327,90,237,38,326,89,237,37.6
38112, 성산구,085004, 83세,2016,271,71,200,35.5,269,70,199,35.2
38112, 성산구,085005, 84세,2016,263,51,212,24.1,262,51,211,24.2
38112, 성산구,090,85~89세,2016,765,162,603,26.9,762,161,601,26.8
38112, 성산구,090001, 85세,2016,199,38,161,23.6,199,38,161,23.6
38112, 성산구,090002, 86세,2016,185,30,155,19.4,184,30,154,19.5
38112, 성산구,090003, 87세,2016,171,40,131,30.5,170,39,131,29.8
38112, 성산구,090004, 88세,2016,109,26,83,31.3,108,26,82,31.7
38112, 성산구,090005, 89세,2016,101,28,73,38.4,101,28,73,38.4
38112, 성산구,095,90~94세,2016,242,41,201,20.4,241,41,200,20.5
38112, 성산구,095001, 90세,2016,70,6,64,9.4,70,6,64,9.4
38112, 성산구,095002, 91세,2016,66,19,47,40.4,65,19,46,41.3
38112, 성산구,095003, 92세,2016,47,8,39,20.5,47,8,39,20.5
38112, 성산구,095004, 93세,2016,36,5,31,16.1,36,5,31,16.1
38112, 성산구,095005, 94세,2016,23,X,20,15,23,X,20,15
38112, 성산구,100,95~99세,2016,25,X,21,19,25,X,21,19
38112, 성산구,100001, 95세,2016,7,X,6,16.7,7,X,6,16.7
38112, 성산구,100002, 96세,2016,7,X,6,16.7,7,X,6,16.7
38112, 성산구,100003, 97세,2016,6,X,5,20,6,X,5,20
38112, 성산구,100004, 98세,2016,X,X,X,100,X,X,X,100
38112, 성산구,100005, 99세,2016,X,X,X,0,X,X,X,0
38112, 성산구,101,100세이상,2016,X,X,X,0,X,X,X,0
38112, 성산구,102,15세미만,2016,33294,17364,15930,109,33208,17320,15888,109
38112, 성산구,103,15~64세,2016,183893,97371,86522,112.5,178992,93685,85307,109.8
38112, 성산구,104,65세이상,2016,13365,5652,7713,73.3,13293,5619,7674,73.2
38112, 성산구,086,85세이상,2016,1035,207,828,25,1031,206,825,25
38112, 성산구,126,평균연령,2016,37.4,36.5,38.4,,37.5,36.6,38.4,
38112, 성산구,127,중위연령,2016,38.7,36.7,40.7,,39,37.1,40.8,
38113, 마산합포구,000,합계,2016,179019,89518,89501,100,176411,87876,88535,99.3
38113, 마산합포구,005,0~4세,2016,7137,3726,3411,109.2,7120,3718,3402,109.3
38113, 마산합포구,005001, 0세,2016,1284,691,593,116.5,1283,691,592,116.7
38113, 마산합포구,005002, 1세,2016,1385,714,671,106.4,1379,711,668,106.4
38113, 마산합포구,005003, 2세,2016,1422,752,670,112.2,1417,749,668,112.1
38113, 마산합포구,005004, 3세,2016,1489,767,722,106.2,1486,765,721,106.1
38113, 마산합포구,005005, 4세,2016,1557,802,755,106.2,1555,802,753,106.5
38113, 마산합포구,010,5~9세,2016,6895,3503,3392,103.3,6883,3496,3387,103.2
38113, 마산합포구,010001, 5세,2016,1508,746,762,97.9,1508,746,762,97.9
38113, 마산합포구,010002, 6세,2016,1339,680,659,103.2,1337,680,657,103.5
38113, 마산합포구,010003, 7세,2016,1350,700,650,107.7,1346,697,649,107.4
38113, 마산합포구,010004, 8세,2016,1314,671,643,104.4,1310,668,642,104
38113, 마산합포구,010005, 9세,2016,1384,706,678,104.1,1382,705,677,104.1
38113, 마산합포구,015,10~14세,2016,6584,3381,3203,105.6,6571,3376,3195,105.7
38113, 마산합포구,015001, 10세,2016,1252,639,613,104.2,1247,636,611,104.1
38113, 마산합포구,015002, 11세,2016,1195,628,567,110.8,1193,627,566,110.8
38113, 마산합포구,015003, 12세,2016,1350,686,664,103.3,1347,685,662,103.5
38113, 마산합포구,015004, 13세,2016,1341,719,622,115.6,1341,719,622,115.6
38113, 마산합포구,015005, 14세,2016,1446,709,737,96.2,1443,709,734,96.6
38113, 마산합포구,020,15~19세,2016,9992,5298,4694,112.9,9944,5267,4677,112.6
38113, 마산합포구,020001, 15세,2016,1631,854,777,109.9,1629,853,776,109.9
38113, 마산합포구,020002, 16세,2016,1973,1006,967,104,1971,1005,966,104
38113, 마산합포구,020003, 17세,2016,1962,982,980,100.2,1951,972,979,99.3
38113, 마산합포구,020004, 18세,2016,2105,1131,974,116.1,2092,1123,969,115.9
38113, 마산합포구,020005, 19세,2016,2321,1325,996,133,2301,1314,987,133.1
38113, 마산합포구,025,20~24세,2016,11650,6469,5181,124.9,11245,6278,4967,126.4
38113, 마산합포구,025001, 20세,2016,2267,1252,1015,123.3,2201,1231,970,126.9
38113, 마산합포구,025002, 21세,2016,2445,1301,1144,113.7,2349,1264,1085,116.5
38113, 마산합포구,025003, 22세,2016,2408,1322,1086,121.7,2337,1292,1045,123.6
38113, 마산합포구,025004, 23세,2016,2244,1300,944,137.7,2158,1246,912,136.6
38113, 마산합포구,025005, 24세,2016,2286,1294,992,130.4,2200,1245,955,130.4
38113, 마산합포구,030,25~29세,2016,9891,5562,4329,128.5,9365,5205,4160,125.1
38113, 마산합포구,030001, 25세,2016,2035,1176,859,136.9,1932,1105,827,133.6
38113, 마산합포구,030002, 26세,2016,2034,1164,870,133.8,1926,1093,833,131.2
38113, 마산합포구,030003, 27세,2016,1975,1121,854,131.3,1867,1046,821,127.4
38113, 마산합포구,030004, 28세,2016,1857,1043,814,128.1,1747,969,778,124.6
38113, 마산합포구,030005, 29세,2016,1990,1058,932,113.5,1893,992,901,110.1
38113, 마산합포구,035,30~34세,2016,11658,6284,5374,116.9,11199,5939,5260,112.9
38113, 마산합포구,035001, 30세,2016,2014,1115,899,124,1917,1047,870,120.3
38113, 마산합포구,035002, 31세,2016,2192,1202,990,121.4,2076,1105,971,113.8
38113, 마산합포구,035003, 32세,2016,2234,1229,1005,122.3,2146,1162,984,118.1
38113, 마산합포구,035004, 33세,2016,2481,1318,1163,113.3,2400,1258,1142,110.2
38113, 마산합포구,035005, 34세,2016,2737,1420,1317,107.8,2660,1367,1293,105.7
38113, 마산합포구,040,35~39세,2016,13152,7126,6026,118.3,12821,6886,5935,116
38113, 마산합포구,040001, 35세,2016,2827,1578,1249,126.3,2753,1526,1227,124.4
38113, 마산합포구,040002, 36세,2016,2897,1494,1403,106.5,2821,1433,1388,103.2
38113, 마산합포구,040003, 37세,2016,2699,1437,1262,113.9,2650,1407,1243,113.2
38113, 마산합포구,040004, 38세,2016,2389,1315,1074,122.4,2327,1269,1058,119.9
38113, 마산합포구,040005, 39세,2016,2340,1302,1038,125.4,2270,1251,1019,122.8
38113, 마산합포구,045,40~44세,2016,12446,6625,5821,113.8,12196,6458,5738,112.5
38113, 마산합포구,045001, 40세,2016,2238,1207,1031,117.1,2175,1162,1013,114.7
38113, 마산합포구,045002, 41세,2016,2426,1310,1116,117.4,2378,1276,1102,115.8
38113, 마산합포구,045003, 42세,2016,2546,1346,1200,112.2,2498,1318,1180,111.7
38113, 마산합포구,045004, 43세,2016,2704,1423,1281,111.1,2664,1401,1263,110.9
38113, 마산합포구,045005, 44세,2016,2532,1339,1193,112.2,2481,1301,1180,110.3
38113, 마산합포구,050,45~49세,2016,14205,7132,7073,100.8,14021,7018,7003,100.2
38113, 마산합포구,050001, 45세,2016,2809,1396,1413,98.8,2758,1364,1394,97.8
38113, 마산합포구,050002, 46세,2016,2814,1448,1366,106,2780,1434,1346,106.5
38113, 마산합포구,050003, 47세,2016,2901,1458,1443,101,2873,1440,1433,100.5
38113, 마산합포구,050004, 48세,2016,2970,1452,1518,95.7,2928,1423,1505,94.6
38113, 마산합포구,050005, 49세,2016,2711,1378,1333,103.4,2682,1357,1325,102.4
38113, 마산합포구,055,50~54세,2016,14169,6997,7172,97.6,14018,6927,7091,97.7
38113, 마산합포구,055001, 50세,2016,2699,1388,1311,105.9,2663,1372,1291,106.3
38113, 마산합포구,055002, 51세,2016,2824,1374,1450,94.8,2798,1361,1437,94.7
38113, 마산합포구,055003, 52세,2016,2526,1268,1258,100.8,2494,1251,1243,100.6
38113, 마산합포구,055004, 53세,2016,2880,1389,1491,93.2,2851,1382,1469,94.1
38113, 마산합포구,055005, 54세,2016,3240,1578,1662,94.9,3212,1561,1651,94.5
38113, 마산합포구,060,55~59세,2016,16950,8036,8914,90.2,16859,7989,8870,90.1
38113, 마산합포구,060001, 55세,2016,3544,1664,1880,88.5,3530,1657,1873,88.5
38113, 마산합포구,060002, 56세,2016,3544,1658,1886,87.9,3522,1646,1876,87.7
38113, 마산합포구,060003, 57세,2016,3421,1596,1825,87.5,3406,1588,1818,87.3
38113, 마산합포구,060004, 58세,2016,3226,1560,1666,93.6,3206,1547,1659,93.2
38113, 마산합포구,060005, 59세,2016,3215,1558,1657,94,3195,1551,1644,94.3
38113, 마산합포구,065,60~64세,2016,14381,6893,7488,92.1,14315,6862,7453,92.1
38113, 마산합포구,065001, 60세,2016,3169,1482,1687,87.8,3156,1478,1678,88.1
38113, 마산합포구,065002, 61세,2016,3351,1579,1772,89.1,3335,1570,1765,89
38113, 마산합포구,065003, 62세,2016,2818,1411,1407,100.3,2802,1402,1400,100.1
38113, 마산합포구,065004, 63세,2016,2404,1152,1252,92,2391,1147,1244,92.2
38113, 마산합포구,065005, 64세,2016,2639,1269,1370,92.6,2631,1265,1366,92.6
38113, 마산합포구,070,65~69세,2016,10328,4944,5384,91.8,10302,4930,5372,91.8
38113, 마산합포구,070001, 65세,2016,2022,960,1062,90.4,2015,956,1059,90.3
38113, 마산합포구,070002, 66세,2016,2146,1023,1123,91.1,2140,1019,1121,90.9
38113, 마산합포구,070003, 67세,2016,2173,1074,1099,97.7,2169,1072,1097,97.7
38113, 마산합포구,070004, 68세,2016,2056,998,1058,94.3,2054,997,1057,94.3
38113, 마산합포구,070005, 69세,2016,1931,889,1042,85.3,1924,886,1038,85.4
38113, 마산합포구,075,70~74세,2016,7529,3389,4140,81.9,7517,3381,4136,81.7
38113, 마산합포구,075001, 70세,2016,1426,655,771,85,1423,654,769,85
38113, 마산합포구,075002, 71세,2016,1457,656,801,81.9,1454,654,800,81.8
38113, 마산합포구,075003, 72세,2016,1529,701,828,84.7,1526,698,828,84.3
38113, 마산합포구,075004, 73세,2016,1510,645,865,74.6,1508,644,864,74.5
38113, 마산합포구,075005, 74세,2016,1607,732,875,83.7,1606,731,875,83.5
38113, 마산합포구,080,75~79세,2016,6041,2384,3657,65.2,6033,2379,3654,65.1
38113, 마산합포구,080001, 75세,2016,1484,624,860,72.6,1484,624,860,72.6
38113, 마산합포구,080002, 76세,2016,1258,514,744,69.1,1255,511,744,68.7
38113, 마산합포구,080003, 77세,2016,1216,460,756,60.8,1216,460,756,60.8
38113, 마산합포구,080004, 78세,2016,1033,405,628,64.5,1032,405,627,64.6
38113, 마산합포구,080005, 79세,2016,1050,381,669,57,1046,379,667,56.8
38113, 마산합포구,085,80~84세,2016,3676,1221,2455,49.7,3672,1220,2452,49.8
38113, 마산합포구,085001, 80세,2016,931,318,613,51.9,931,318,613,51.9
38113, 마산합포구,085002, 81세,2016,782,283,499,56.7,781,282,499,56.5
38113, 마산합포구,085003, 82세,2016,751,255,496,51.4,749,255,494,51.6
38113, 마산합포구,085004, 83세,2016,618,176,442,39.8,617,176,441,39.9
38113, 마산합포구,085005, 84세,2016,594,189,405,46.7,594,189,405,46.7
38113, 마산합포구,090,85~89세,2016,1722,435,1287,33.8,1721,435,1286,33.8
38113, 마산합포구,090001, 85세,2016,462,116,346,33.5,461,116,345,33.6
38113, 마산합포구,090002, 86세,2016,426,102,324,31.5,426,102,324,31.5
38113, 마산합포구,090003, 87세,2016,357,101,256,39.5,357,101,256,39.5
38113, 마산합포구,090004, 88세,2016,265,60,205,29.3,265,60,205,29.3
38113, 마산합포구,090005, 89세,2016,212,56,156,35.9,212,56,156,35.9
38113, 마산합포구,095,90~94세,2016,503,98,405,24.2,500,98,402,24.4
38113, 마산합포구,095001, 90세,2016,155,38,117,32.5,155,38,117,32.5
38113, 마산합포구,095002, 91세,2016,129,17,112,15.2,127,17,110,15.5
38113, 마산합포구,095003, 92세,2016,86,16,70,22.9,86,16,70,22.9
38113, 마산합포구,095004, 93세,2016,78,14,64,21.9,77,14,63,22.2
38113, 마산합포구,095005, 94세,2016,55,13,42,31,55,13,42,31
38113, 마산합포구,100,95~99세,2016,96,15,81,18.5,95,14,81,17.3
38113, 마산합포구,100001, 95세,2016,43,X,39,10.3,42,X,39,7.7
38113, 마산합포구,100002, 96세,2016,22,X,20,10,22,X,20,10
38113, 마산합포구,100003, 97세,2016,16,7,9,77.8,16,7,9,77.8
38113, 마산합포구,100004, 98세,2016,6,X,X,50,6,X,X,50
38113, 마산합포구,100005, 99세,2016,9,X,9,0,9,X,9,0
38113, 마산합포구,101,100세이상,2016,14,X,14,0,14,X,14,0
38113, 마산합포구,102,15세미만,2016,20616,10610,10006,106,20574,10590,9984,106.1
38113, 마산합포구,103,15~64세,2016,128494,66422,62072,107,125983,64829,61154,106
38113, 마산합포구,104,65세이상,2016,29909,12486,17423,71.7,29854,12457,17397,71.6
38113, 마산합포구,086,85세이상,2016,2335,548,1787,30.7,2330,547,1783,30.7
38113, 마산합포구,126,평균연령,2016,43.4,41.7,45.1,,43.5,41.8,45.2,
38113, 마산합포구,127,중위연령,2016,45,42.7,47.4,,45.3,43,47.6,
38114, 마산회원구,000,합계,2016,208288,104929,103359,101.5,205439,103222,102217,101
38114, 마산회원구,005,0~4세,2016,8364,4327,4037,107.2,8337,4313,4024,107.2
38114, 마산회원구,005001, 0세,2016,1460,729,731,99.7,1452,725,727,99.7
38114, 마산회원구,005002, 1세,2016,1624,821,803,102.2,1620,818,802,102
38114, 마산회원구,005003, 2세,2016,1654,877,777,112.9,1649,876,773,113.3
38114, 마산회원구,005004, 3세,2016,1699,880,819,107.4,1694,877,817,107.3
38114, 마산회원구,005005, 4세,2016,1927,1020,907,112.5,1922,1017,905,112.4
38114, 마산회원구,010,5~9세,2016,9457,4994,4463,111.9,9433,4982,4451,111.9
38114, 마산회원구,010001, 5세,2016,1910,1028,882,116.6,1907,1027,880,116.7
38114, 마산회원구,010002, 6세,2016,1866,957,909,105.3,1858,950,908,104.6
38114, 마산회원구,010003, 7세,2016,1772,972,800,121.5,1767,971,796,122
38114, 마산회원구,010004, 8세,2016,1917,969,948,102.2,1913,967,946,102.2
38114, 마산회원구,010005, 9세,2016,1992,1068,924,115.6,1988,1067,921,115.9
38114, 마산회원구,015,10~14세,2016,9673,5044,4629,109,9664,5041,4623,109
38114, 마산회원구,015001, 10세,2016,1826,953,873,109.2,1823,951,872,109.1
38114, 마산회원구,015002, 11세,2016,1816,912,904,100.9,1812,912,900,101.3
38114, 마산회원구,015003, 12세,2016,1975,1018,957,106.4,1974,1017,957,106.3
38114, 마산회원구,015004, 13세,2016,2036,1101,935,117.8,2035,1101,934,117.9
38114, 마산회원구,015005, 14세,2016,2020,1060,960,110.4,2020,1060,960,110.4
38114, 마산회원구,020,15~19세,2016,12406,6554,5852,112,12365,6534,5831,112.1
38114, 마산회원구,020001, 15세,2016,2304,1249,1055,118.4,2304,1249,1055,118.4
38114, 마산회원구,020002, 16세,2016,2413,1264,1149,110,2409,1263,1146,110.2
38114, 마산회원구,020003, 17세,2016,2464,1330,1134,117.3,2460,1327,1133,117.1
38114, 마산회원구,020004, 18세,2016,2545,1348,1197,112.6,2533,1339,1194,112.1
38114, 마산회원구,020005, 19세,2016,2680,1363,1317,103.5,2659,1356,1303,104.1
38114, 마산회원구,025,20~24세,2016,13840,7475,6365,117.4,13576,7332,6244,117.4
38114, 마산회원구,025001, 20세,2016,2888,1565,1323,118.3,2862,1555,1307,119
38114, 마산회원구,025002, 21세,2016,2895,1549,1346,115.1,2848,1529,1319,115.9
38114, 마산회원구,025003, 22세,2016,2673,1474,1199,122.9,2626,1454,1172,124.1
38114, 마산회원구,025004, 23세,2016,2705,1460,1245,117.3,2639,1416,1223,115.8
38114, 마산회원구,025005, 24세,2016,2679,1427,1252,114,2601,1378,1223,112.7
38114, 마산회원구,030,25~29세,2016,11871,6413,5458,117.5,11273,6023,5250,114.7
38114, 마산회원구,030001, 25세,2016,2475,1347,1128,119.4,2363,1277,1086,117.6
38114, 마산회원구,030002, 26세,2016,2434,1335,1099,121.5,2305,1245,1060,117.5
38114, 마산회원구,030003, 27세,2016,2384,1305,1079,120.9,2277,1233,1044,118.1
38114, 마산회원구,030004, 28세,2016,2264,1207,1057,114.2,2142,1132,1010,112.1
38114, 마산회원구,030005, 29세,2016,2314,1219,1095,111.3,2186,1136,1050,108.2
38114, 마산회원구,035,30~34세,2016,13280,7157,6123,116.9,12750,6800,5950,114.3
38114, 마산회원구,035001, 30세,2016,2263,1249,1014,123.2,2123,1146,977,117.3
38114, 마산회원구,035002, 31세,2016,2378,1257,1121,112.1,2268,1186,1082,109.6
38114, 마산회원구,035003, 32세,2016,2578,1408,1170,120.3,2471,1335,1136,117.5
38114, 마산회원구,035004, 33세,2016,2851,1527,1324,115.3,2765,1473,1292,114
38114, 마산회원구,035005, 34세,2016,3210,1716,1494,114.9,3123,1660,1463,113.5
38114, 마산회원구,040,35~39세,2016,15907,8241,7666,107.5,15644,8071,7573,106.6
38114, 마산회원구,040001, 35세,2016,3204,1691,1513,111.8,3139,1648,1491,110.5
38114, 마산회원구,040002, 36세,2016,3412,1770,1642,107.8,3362,1738,1624,107
38114, 마산회원구,040003, 37세,2016,3180,1657,1523,108.8,3121,1622,1499,108.2
38114, 마산회원구,040004, 38세,2016,3032,1577,1455,108.4,2985,1546,1439,107.4
38114, 마산회원구,040005, 39세,2016,3079,1546,1533,100.8,3037,1517,1520,99.8
38114, 마산회원구,045,40~44세,2016,16482,8402,8080,104,16239,8251,7988,103.3
38114, 마산회원구,045001, 40세,2016,2945,1517,1428,106.2,2894,1485,1409,105.4
38114, 마산회원구,045002, 41세,2016,3192,1580,1612,98,3146,1552,1594,97.4
38114, 마산회원구,045003, 42세,2016,3479,1801,1678,107.3,3442,1780,1662,107.1
38114, 마산회원구,045004, 43세,2016,3507,1789,1718,104.1,3461,1758,1703,103.2
38114, 마산회원구,045005, 44세,2016,3359,1715,1644,104.3,3296,1676,1620,103.5
38114, 마산회원구,050,45~49세,2016,18710,9343,9367,99.7,18426,9178,9248,99.2
38114, 마산회원구,050001, 45세,2016,3722,1862,1860,100.1,3644,1814,1830,99.1
38114, 마산회원구,050002, 46세,2016,3725,1875,1850,101.4,3671,1843,1828,100.8
38114, 마산회원구,050003, 47세,2016,3844,1981,1863,106.3,3791,1950,1841,105.9
38114, 마산회원구,050004, 48세,2016,3857,1884,1973,95.5,3805,1856,1949,95.2
38114, 마산회원구,050005, 49세,2016,3562,1741,1821,95.6,3515,1715,1800,95.3
38114, 마산회원구,055,50~54세,2016,17987,8974,9013,99.6,17714,8825,8889,99.3
38114, 마산회원구,055001, 50세,2016,3686,1915,1771,108.1,3622,1882,1740,108.2
38114, 마산회원구,055002, 51세,2016,3536,1704,1832,93,3489,1677,1812,92.5
38114, 마산회원구,055003, 52세,2016,3205,1587,1618,98.1,3156,1560,1596,97.7
38114, 마산회원구,055004, 53세,2016,3574,1801,1773,101.6,3508,1765,1743,101.3
38114, 마산회원구,055005, 54세,2016,3986,1967,2019,97.4,3939,1941,1998,97.1
38114, 마산회원구,060,55~59세,2016,19013,9279,9734,95.3,18882,9212,9670,95.3
38114, 마산회원구,060001, 55세,2016,4180,2126,2054,103.5,4156,2113,2043,103.4
38114, 마산회원구,060002, 56세,2016,4158,1996,2162,92.3,4126,1982,2144,92.4
38114, 마산회원구,060003, 57세,2016,3619,1769,1850,95.6,3591,1755,1836,95.6
38114, 마산회원구,060004, 58세,2016,3501,1686,1815,92.9,3474,1673,1801,92.9
38114, 마산회원구,060005, 59세,2016,3555,1702,1853,91.9,3535,1689,1846,91.5
38114, 마산회원구,065,60~64세,2016,14825,7219,7606,94.9,14736,7177,7559,94.9
38114, 마산회원구,065001, 60세,2016,3278,1574,1704,92.4,3253,1558,1695,91.9
38114, 마산회원구,065002, 61세,2016,3443,1630,1813,89.9,3427,1625,1802,90.2
38114, 마산회원구,065003, 62세,2016,2849,1406,1443,97.4,2828,1394,1434,97.2
38114, 마산회원구,065004, 63세,2016,2532,1238,1294,95.7,2514,1234,1280,96.4
38114, 마산회원구,065005, 64세,2016,2723,1371,1352,101.4,2714,1366,1348,101.3
38114, 마산회원구,070,65~69세,2016,10389,4965,5424,91.5,10353,4951,5402,91.7
38114, 마산회원구,070001, 65세,2016,2160,1000,1160,86.2,2148,996,1152,86.5
38114, 마산회원구,070002, 66세,2016,2116,971,1145,84.8,2106,965,1141,84.6
38114, 마산회원구,070003, 67세,2016,2168,1043,1125,92.7,2162,1042,1120,93
38114, 마산회원구,070004, 68세,2016,2075,1038,1037,100.1,2071,1037,1034,100.3
38114, 마산회원구,070005, 69세,2016,1870,913,957,95.4,1866,911,955,95.4
38114, 마산회원구,075,70~74세,2016,6861,3228,3633,88.9,6844,3223,3621,89
38114, 마산회원구,075001, 70세,2016,1358,687,671,102.4,1354,684,670,102.1
38114, 마산회원구,075002, 71세,2016,1308,623,685,90.9,1303,622,681,91.3
38114, 마산회원구,075003, 72세,2016,1456,675,781,86.4,1451,675,776,87
38114, 마산회원구,075004, 73세,2016,1363,620,743,83.4,1361,619,742,83.4
38114, 마산회원구,075005, 74세,2016,1376,623,753,82.7,1375,623,752,82.8
38114, 마산회원구,080,75~79세,2016,4971,2096,2875,72.9,4959,2095,2864,73.1
38114, 마산회원구,080001, 75세,2016,1240,548,692,79.2,1239,547,692,79
38114, 마산회원구,080002, 76세,2016,1067,450,617,72.9,1063,450,613,73.4
38114, 마산회원구,080003, 77세,2016,1033,450,583,77.2,1031,450,581,77.5
38114, 마산회원구,080004, 78세,2016,874,357,517,69.1,870,357,513,69.6
38114, 마산회원구,080005, 79세,2016,757,291,466,62.4,756,291,465,62.6
38114, 마산회원구,085,80~84세,2016,2748,924,1824,50.7,2741,920,1821,50.5
38114, 마산회원구,085001, 80세,2016,751,275,476,57.8,749,274,475,57.7
38114, 마산회원구,085002, 81세,2016,639,222,417,53.2,637,221,416,53.1
38114, 마산회원구,085003, 82세,2016,537,179,358,50,536,178,358,49.7
38114, 마산회원구,085004, 83세,2016,421,132,289,45.7,419,131,288,45.5
38114, 마산회원구,085005, 84세,2016,400,116,284,40.8,400,116,284,40.8
38114, 마산회원구,090,85~89세,2016,1112,230,882,26.1,1111,230,881,26.1
38114, 마산회원구,090001, 85세,2016,319,62,257,24.1,319,62,257,24.1
38114, 마산회원구,090002, 86세,2016,261,62,199,31.2,260,62,198,31.3
38114, 마산회원구,090003, 87세,2016,234,46,188,24.5,234,46,188,24.5
38114, 마산회원구,090004, 88세,2016,170,40,130,30.8,170,40,130,30.8
38114, 마산회원구,090005, 89세,2016,128,20,108,18.5,128,20,108,18.5
38114, 마산회원구,095,90~94세,2016,338,58,280,20.7,338,58,280,20.7
38114, 마산회원구,095001, 90세,2016,100,16,84,19,100,16,84,19
38114, 마산회원구,095002, 91세,2016,96,16,80,20,96,16,80,20
38114, 마산회원구,095003, 92세,2016,51,9,42,21.4,51,9,42,21.4
38114, 마산회원구,095004, 93세,2016,58,11,47,23.4,58,11,47,23.4
38114, 마산회원구,095005, 94세,2016,33,6,27,22.2,33,6,27,22.2
38114, 마산회원구,100,95~99세,2016,47,6,41,14.6,47,6,41,14.6
38114, 마산회원구,100001, 95세,2016,20,X,16,25,20,X,16,25
38114, 마산회원구,100002, 96세,2016,13,X,12,8.3,13,X,12,8.3
38114, 마산회원구,100003, 97세,2016,6,X,6,0,6,X,6,0
38114, 마산회원구,100004, 98세,2016,6,X,5,20,6,X,5,20
38114, 마산회원구,100005, 99세,2016,X,X,X,0,X,X,X,0
38114, 마산회원구,101,100세이상,2016,7,X,7,0,7,X,7,0
38114, 마산회원구,102,15세미만,2016,27494,14365,13129,109.4,27434,14336,13098,109.5
38114, 마산회원구,103,15~64세,2016,154321,79057,75264,105,151605,77403,74202,104.3
38114, 마산회원구,104,65세이상,2016,26473,11507,14966,76.9,26400,11483,14917,77
38114, 마산회원구,086,85세이상,2016,1504,294,1210,24.3,1503,294,1209,24.3
38114, 마산회원구,126,평균연령,2016,41.2,40,42.5,,41.3,40.1,42.5,
38114, 마산회원구,127,중위연령,2016,42.9,41.5,44.4,,43.1,41.7,44.5,
38115, 진해구,000,합계,2016,184903,95114,89789,105.9,180503,92121,88382,104.2
38115, 진해구,005,0~4세,2016,11234,5909,5325,111,11165,5879,5286,111.2
38115, 진해구,005001, 0세,2016,2028,1043,985,105.9,2011,1034,977,105.8
38115, 진해구,005002, 1세,2016,2135,1158,977,118.5,2121,1153,968,119.1
38115, 진해구,005003, 2세,2016,2257,1164,1093,106.5,2242,1157,1085,106.6
38115, 진해구,005004, 3세,2016,2319,1237,1082,114.3,2306,1232,1074,114.7
38115, 진해구,005005, 4세,2016,2495,1307,1188,110,2485,1303,1182,110.2
38115, 진해구,010,5~9세,2016,11389,5794,5595,103.6,11353,5776,5577,103.6
38115, 진해구,010001, 5세,2016,2338,1184,1154,102.6,2330,1180,1150,102.6
38115, 진해구,010002, 6세,2016,2267,1194,1073,111.3,2260,1188,1072,110.8
38115, 진해구,010003, 7세,2016,2201,1117,1084,103,2193,1114,1079,103.2
38115, 진해구,010004, 8세,2016,2311,1115,1196,93.2,2305,1114,1191,93.5
38115, 진해구,010005, 9세,2016,2272,1184,1088,108.8,2265,1180,1085,108.8
38115, 진해구,015,10~14세,2016,10006,5275,4731,111.5,9988,5264,4724,111.4
38115, 진해구,015001, 10세,2016,2048,1092,956,114.2,2041,1089,952,114.4
38115, 진해구,015002, 11세,2016,1905,959,946,101.4,1901,957,944,101.4
38115, 진해구,015003, 12세,2016,2110,1127,983,114.6,2109,1127,982,114.8
38115, 진해구,015004, 13세,2016,1988,1063,925,114.9,1985,1060,925,114.6
38115, 진해구,015005, 14세,2016,1955,1034,921,112.3,1952,1031,921,111.9
38115, 진해구,020,15~19세,2016,9645,5131,4514,113.7,9602,5108,4494,113.7
38115, 진해구,020001, 15세,2016,2158,1135,1023,110.9,2155,1133,1022,110.9
38115, 진해구,020002, 16세,2016,2136,1084,1052,103,2130,1080,1050,102.9
38115, 진해구,020003, 17세,2016,2098,1080,1018,106.1,2090,1077,1013,106.3
38115, 진해구,020004, 18세,2016,1785,969,816,118.8,1776,962,814,118.2
38115, 진해구,020005, 19세,2016,1468,863,605,142.6,1451,856,595,143.9
38115, 진해구,025,20~24세,2016,8767,5124,3643,140.7,8430,4888,3542,138
38115, 진해구,025001, 20세,2016,1681,1042,639,163.1,1660,1034,626,165.2
38115, 진해구,025002, 21세,2016,1642,1033,609,169.6,1605,1010,595,169.7
38115, 진해구,025003, 22세,2016,1716,999,717,139.3,1655,951,704,135.1
38115, 진해구,025004, 23세,2016,1778,992,786,126.2,1677,918,759,120.9
38115, 진해구,025005, 24세,2016,1950,1058,892,118.6,1833,975,858,113.6
38115, 진해구,030,25~29세,2016,10106,5586,4520,123.6,9203,4940,4263,115.9
38115, 진해구,030001, 25세,2016,1823,1008,815,123.7,1682,904,778,116.2
38115, 진해구,030002, 26세,2016,1990,1120,870,128.7,1822,1010,812,124.4
38115, 진해구,030003, 27세,2016,2000,1114,886,125.7,1805,963,842,114.4
38115, 진해구,030004, 28세,2016,2079,1134,945,120,1893,999,894,111.7
38115, 진해구,030005, 29세,2016,2214,1210,1004,120.5,2001,1064,937,113.6
38115, 진해구,035,30~34세,2016,14619,7795,6824,114.2,13782,7178,6604,108.7
38115, 진해구,035001, 30세,2016,2310,1256,1054,119.2,2123,1129,994,113.6
38115, 진해구,035002, 31세,2016,2502,1353,1149,117.8,2308,1198,1110,107.9
38115, 진해구,035003, 32세,2016,2820,1509,1311,115.1,2647,1380,1267,108.9
38115, 진해구,035004, 33세,2016,3313,1765,1548,114,3164,1653,1511,109.4
38115, 진해구,035005, 34세,2016,3674,1912,1762,108.5,3540,1818,1722,105.6
38115, 진해구,040,35~39세,2016,18244,9631,8613,111.8,17686,9189,8497,108.1
38115, 진해구,040001, 35세,2016,3849,2058,1791,114.9,3728,1963,1765,111.2
38115, 진해구,040002, 36세,2016,4002,2055,1947,105.5,3883,1956,1927,101.5
38115, 진해구,040003, 37세,2016,3706,1928,1778,108.4,3596,1844,1752,105.3
38115, 진해구,040004, 38세,2016,3321,1785,1536,116.2,3210,1702,1508,112.9
38115, 진해구,040005, 39세,2016,3366,1805,1561,115.6,3269,1724,1545,111.6
38115, 진해구,045,40~44세,2016,17168,9198,7970,115.4,16744,8886,7858,113.1
38115, 진해구,045001, 40세,2016,3273,1768,1505,117.5,3169,1692,1477,114.6
38115, 진해구,045002, 41세,2016,3386,1784,1602,111.4,3324,1737,1587,109.5
38115, 진해구,045003, 42세,2016,3703,1982,1721,115.2,3608,1907,1701,112.1
38115, 진해구,045004, 43세,2016,3502,1893,1609,117.7,3421,1837,1584,116
38115, 진해구,045005, 44세,2016,3304,1771,1533,115.5,3222,1713,1509,113.5
38115, 진해구,050,45~49세,2016,15150,8101,7049,114.9,14713,7838,6875,114
38115, 진해구,050001, 45세,2016,3350,1806,1544,117,3241,1733,1508,114.9
38115, 진해구,050002, 46세,2016,3148,1686,1462,115.3,3057,1635,1422,115
38115, 진해구,050003, 47세,2016,3064,1684,1380,122,2987,1636,1351,121.1
38115, 진해구,050004, 48세,2016,2980,1582,1398,113.2,2891,1537,1354,113.5
38115, 진해구,050005, 49세,2016,2608,1343,1265,106.2,2537,1297,1240,104.6
38115, 진해구,055,50~54세,2016,12873,6671,6202,107.6,12559,6487,6072,106.8
38115, 진해구,055001, 50세,2016,2616,1362,1254,108.6,2555,1328,1227,108.2
38115, 진해구,055002, 51세,2016,2477,1293,1184,109.2,2412,1250,1162,107.6
38115, 진해구,055003, 52세,2016,2455,1280,1175,108.9,2385,1231,1154,106.7
38115, 진해구,055004, 53세,2016,2695,1392,1303,106.8,2638,1363,1275,106.9
38115, 진해구,055005, 54세,2016,2630,1344,1286,104.5,2569,1315,1254,104.9
38115, 진해구,060,55~59세,2016,13702,6661,7041,94.6,13509,6566,6943,94.6
38115, 진해구,060001, 55세,2016,2964,1448,1516,95.5,2919,1427,1492,95.6
38115, 진해구,060002, 56세,2016,2994,1406,1588,88.5,2947,1378,1569,87.8
38115, 진해구,060003, 57세,2016,2684,1300,1384,93.9,2635,1278,1357,94.2
38115, 진해구,060004, 58세,2016,2565,1280,1285,99.6,2533,1265,1268,99.8
38115, 진해구,060005, 59세,2016,2495,1227,1268,96.8,2475,1218,1257,96.9
38115, 진해구,065,60~64세,2016,10663,5284,5379,98.2,10532,5210,5322,97.9
38115, 진해구,065001, 60세,2016,2408,1195,1213,98.5,2372,1175,1197,98.2
38115, 진해구,065002, 61세,2016,2492,1183,1309,90.4,2468,1173,1295,90.6
38115, 진해구,065003, 62세,2016,2089,1080,1009,107,2064,1067,997,107
38115, 진해구,065004, 63세,2016,1761,896,865,103.6,1732,876,856,102.3
38115, 진해구,065005, 64세,2016,1913,930,983,94.6,1896,919,977,94.1
38115, 진해구,070,65~69세,2016,7280,3510,3770,93.1,7224,3486,3738,93.3
38115, 진해구,070001, 65세,2016,1493,697,796,87.6,1477,691,786,87.9
38115, 진해구,070002, 66세,2016,1450,700,750,93.3,1435,695,740,93.9
38115, 진해구,070003, 67세,2016,1534,763,771,99,1520,755,765,98.7
38115, 진해구,070004, 68세,2016,1430,710,720,98.6,1427,709,718,98.7
38115, 진해구,070005, 69세,2016,1373,640,733,87.3,1365,636,729,87.2
38115, 진해구,075,70~74세,2016,5420,2419,3001,80.6,5401,2410,2991,80.6
38115, 진해구,075001, 70세,2016,1086,543,543,100,1084,542,542,100
38115, 진해구,075002, 71세,2016,1032,442,590,74.9,1028,440,588,74.8
38115, 진해구,075003, 72세,2016,1058,475,583,81.5,1051,473,578,81.8
38115, 진해구,075004, 73세,2016,1047,452,595,76,1045,450,595,75.6
38115, 진해구,075005, 74세,2016,1197,507,690,73.5,1193,505,688,73.4
38115, 진해구,080,75~79세,2016,4400,1762,2638,66.8,4390,1758,2632,66.8
38115, 진해구,080001, 75세,2016,971,396,575,68.9,968,395,573,68.9
38115, 진해구,080002, 76세,2016,952,382,570,67,951,382,569,67.1
38115, 진해구,080003, 77세,2016,898,376,522,72,896,374,522,71.6
38115, 진해구,080004, 78세,2016,795,322,473,68.1,792,321,471,68.2
38115, 진해구,080005, 79세,2016,784,286,498,57.4,783,286,497,57.5
38115, 진해구,085,80~84세,2016,2657,884,1773,49.9,2645,879,1766,49.8
38115, 진해구,085001, 80세,2016,643,244,399,61.2,636,240,396,60.6
38115, 진해구,085002, 81세,2016,616,206,410,50.2,613,206,407,50.6
38115, 진해구,085003, 82세,2016,541,172,369,46.6,540,172,368,46.7
38115, 진해구,085004, 83세,2016,446,151,295,51.2,445,150,295,50.8
38115, 진해구,085005, 84세,2016,411,111,300,37,411,111,300,37
38115, 진해구,090,85~89세,2016,1147,297,850,34.9,1145,297,848,35
38115, 진해구,090001, 85세,2016,307,85,222,38.3,306,85,221,38.5
38115, 진해구,090002, 86세,2016,281,63,218,28.9,281,63,218,28.9
38115, 진해구,090003, 87세,2016,244,63,181,34.8,243,63,180,35
38115, 진해구,090004, 88세,2016,192,51,141,36.2,192,51,141,36.2
38115, 진해구,090005, 89세,2016,123,35,88,39.8,123,35,88,39.8
38115, 진해구,095,90~94세,2016,358,73,285,25.6,357,73,284,25.7
38115, 진해구,095001, 90세,2016,113,30,83,36.1,113,30,83,36.1
38115, 진해구,095002, 91세,2016,99,17,82,20.7,98,17,81,21
38115, 진해구,095003, 92세,2016,65,10,55,18.2,65,10,55,18.2
38115, 진해구,095004, 93세,2016,48,8,40,20,48,8,40,20
38115, 진해구,095005, 94세,2016,33,8,25,32,33,8,25,32
38115, 진해구,100,95~99세,2016,69,8,61,13.1,69,8,61,13.1
38115, 진해구,100001, 95세,2016,23,X,20,15,23,X,20,15
38115, 진해구,100002, 96세,2016,20,X,18,11.1,20,X,18,11.1
38115, 진해구,100003, 97세,2016,7,X,5,40,7,X,5,40
38115, 진해구,100004, 98세,2016,12,X,11,9.1,12,X,11,9.1
38115, 진해구,100005, 99세,2016,7,X,7,0,7,X,7,0
38115, 진해구,101,100세이상,2016,6,X,5,20,6,X,5,20
38115, 진해구,102,15세미만,2016,32629,16978,15651,108.5,32506,16919,15587,108.5
38115, 진해구,103,15~64세,2016,130937,69182,61755,112,126760,66290,60470,109.6
38115, 진해구,104,65세이상,2016,21337,8954,12383,72.3,21237,8912,12325,72.3
38115, 진해구,086,85세이상,2016,1580,379,1201,31.6,1577,379,1198,31.6
38115, 진해구,126,평균연령,2016,39,37.7,40.2,,39,37.8,40.3,
38115, 진해구,127,중위연령,2016,39.5,38.5,40.8,,39.7,38.7,40.8,
38310, 의령군,000,합계,2016,26568,12858,13710,93.8,25642,12242,13400,91.4
38310, 의령군,005,0~4세,2016,683,376,307,122.5,677,373,304,122.7
38310, 의령군,005001, 0세,2016,124,52,72,72.2,124,52,72,72.2
38310, 의령군,005002, 1세,2016,135,77,58,132.8,134,77,57,135.1
38310, 의령군,005003, 2세,2016,133,82,51,160.8,131,81,50,162
38310, 의령군,005004, 3세,2016,129,72,57,126.3,127,70,57,122.8
38310, 의령군,005005, 4세,2016,162,93,69,134.8,161,93,68,136.8
38310, 의령군,010,5~9세,2016,679,344,335,102.7,677,343,334,102.7
38310, 의령군,010001, 5세,2016,145,72,73,98.6,145,72,73,98.6
38310, 의령군,010002, 6세,2016,122,59,63,93.7,122,59,63,93.7
38310, 의령군,010003, 7세,2016,142,80,62,129,140,79,61,129.5
38310, 의령군,010004, 8세,2016,133,70,63,111.1,133,70,63,111.1
38310, 의령군,010005, 9세,2016,137,63,74,85.1,137,63,74,85.1
38310, 의령군,015,10~14세,2016,764,405,359,112.8,763,404,359,112.5
38310, 의령군,015001, 10세,2016,126,73,53,137.7,125,72,53,135.8
38310, 의령군,015002, 11세,2016,133,70,63,111.1,133,70,63,111.1
38310, 의령군,015003, 12세,2016,176,87,89,97.8,176,87,89,97.8
38310, 의령군,015004, 13세,2016,147,83,64,129.7,147,83,64,129.7
38310, 의령군,015005, 14세,2016,182,92,90,102.2,182,92,90,102.2
38310, 의령군,020,15~19세,2016,1029,575,454,126.7,1026,575,451,127.5
38310, 의령군,020001, 15세,2016,194,110,84,131,194,110,84,131
38310, 의령군,020002, 16세,2016,261,144,117,123.1,260,144,116,124.1
38310, 의령군,020003, 17세,2016,239,123,116,106,239,123,116,106
38310, 의령군,020004, 18세,2016,184,93,91,102.2,184,93,91,102.2
38310, 의령군,020005, 19세,2016,151,105,46,228.3,149,105,44,238.6
38310, 의령군,025,20~24세,2016,1046,616,430,143.3,934,552,382,144.5
38310, 의령군,025001, 20세,2016,187,115,72,159.7,186,114,72,158.3
38310, 의령군,025002, 21세,2016,210,142,68,208.8,204,141,63,223.8
38310, 의령군,025003, 22세,2016,208,120,88,136.4,187,108,79,136.7
38310, 의령군,025004, 23세,2016,205,105,100,105,175,88,87,101.1
38310, 의령군,025005, 24세,2016,236,134,102,131.4,182,101,81,124.7
38310, 의령군,030,25~29세,2016,1101,609,492,123.8,864,447,417,107.2
38310, 의령군,030001, 25세,2016,224,114,110,103.6,184,89,95,93.7
38310, 의령군,030002, 26세,2016,224,123,101,121.8,179,92,87,105.7
38310, 의령군,030003, 27세,2016,217,116,101,114.9,166,81,85,95.3
38310, 의령군,030004, 28세,2016,226,127,99,128.3,173,88,85,103.5
38310, 의령군,030005, 29세,2016,210,129,81,159.3,162,97,65,149.2
38310, 의령군,035,30~34세,2016,1076,602,474,127,877,459,418,109.8
38310, 의령군,035001, 30세,2016,226,124,102,121.6,182,93,89,104.5
38310, 의령군,035002, 31세,2016,192,115,77,149.4,144,80,64,125
38310, 의령군,035003, 32세,2016,236,128,108,118.5,196,98,98,100
38310, 의령군,035004, 33세,2016,226,131,95,137.9,183,100,83,120.5
38310, 의령군,035005, 34세,2016,196,104,92,113,172,88,84,104.8
38310, 의령군,040,35~39세,2016,1166,670,496,135.1,1080,604,476,126.9
38310, 의령군,040001, 35세,2016,266,147,119,123.5,248,130,118,110.2
38310, 의령군,040002, 36세,2016,236,127,109,116.5,217,114,103,110.7
38310, 의령군,040003, 37세,2016,236,137,99,138.4,219,122,97,125.8
38310, 의령군,040004, 38세,2016,202,123,79,155.7,184,110,74,148.6
38310, 의령군,040005, 39세,2016,226,136,90,151.1,212,128,84,152.4
38310, 의령군,045,40~44세,2016,1412,805,607,132.6,1326,742,584,127.1
38310, 의령군,045001, 40세,2016,236,140,96,145.8,214,121,93,130.1
38310, 의령군,045002, 41세,2016,285,148,137,108,270,138,132,104.5
38310, 의령군,045003, 42세,2016,296,182,114,159.6,277,168,109,154.1
38310, 의령군,045004, 43세,2016,313,179,134,133.6,297,166,131,126.7
38310, 의령군,045005, 44세,2016,282,156,126,123.8,268,149,119,125.2
38310, 의령군,050,45~49세,2016,1783,1024,759,134.9,1717,983,734,133.9
38310, 의령군,050001, 45세,2016,337,196,141,139,331,193,138,139.9
38310, 의령군,050002, 46세,2016,325,191,134,142.5,305,179,126,142.1
38310, 의령군,050003, 47세,2016,384,238,146,163,368,227,141,161
38310, 의령군,050004, 48세,2016,365,192,173,111,356,188,168,111.9
38310, 의령군,050005, 49세,2016,372,207,165,125.5,357,196,161,121.7
38310, 의령군,055,50~54세,2016,1962,1055,907,116.3,1909,1028,881,116.7
38310, 의령군,055001, 50세,2016,362,196,166,118.1,352,192,160,120
38310, 의령군,055002, 51세,2016,391,212,179,118.4,379,205,174,117.8
38310, 의령군,055003, 52세,2016,346,185,161,114.9,333,179,154,116.2
38310, 의령군,055004, 53세,2016,375,205,170,120.6,365,201,164,122.6
38310, 의령군,055005, 54세,2016,488,257,231,111.3,480,251,229,109.6
38310, 의령군,060,55~59세,2016,2566,1342,1224,109.6,2530,1321,1209,109.3
38310, 의령군,060001, 55세,2016,547,296,251,117.9,538,291,247,117.8
38310, 의령군,060002, 56세,2016,540,273,267,102.2,532,267,265,100.8
38310, 의령군,060003, 57세,2016,484,257,227,113.2,480,254,226,112.4
38310, 의령군,060004, 58세,2016,496,247,249,99.2,486,243,243,100
38310, 의령군,060005, 59세,2016,499,269,230,117,494,266,228,116.7
38310, 의령군,065,60~64세,2016,2303,1143,1160,98.5,2276,1127,1149,98.1
38310, 의령군,065001, 60세,2016,485,250,235,106.4,480,248,232,106.9
38310, 의령군,065002, 61세,2016,523,262,261,100.4,517,257,260,98.8
38310, 의령군,065003, 62세,2016,432,206,226,91.2,428,205,223,91.9
38310, 의령군,065004, 63세,2016,365,172,193,89.1,359,168,191,88
38310, 의령군,065005, 64세,2016,498,253,245,103.3,492,249,243,102.5
38310, 의령군,070,65~69세,2016,1970,932,1038,89.8,1963,927,1036,89.5
38310, 의령군,070001, 65세,2016,353,165,188,87.8,352,164,188,87.2
38310, 의령군,070002, 66세,2016,398,187,211,88.6,395,184,211,87.2
38310, 의령군,070003, 67세,2016,436,201,235,85.5,436,201,235,85.5
38310, 의령군,070004, 68세,2016,397,198,199,99.5,394,197,197,100
38310, 의령군,070005, 69세,2016,386,181,205,88.3,386,181,205,88.3
38310, 의령군,075,70~74세,2016,1937,759,1178,64.4,1934,758,1176,64.5
38310, 의령군,075001, 70세,2016,304,141,163,86.5,302,140,162,86.4
38310, 의령군,075002, 71세,2016,323,134,189,70.9,323,134,189,70.9
38310, 의령군,075003, 72세,2016,365,136,229,59.4,364,136,228,59.6
38310, 의령군,075004, 73세,2016,429,152,277,54.9,429,152,277,54.9
38310, 의령군,075005, 74세,2016,516,196,320,61.3,516,196,320,61.3
38310, 의령군,080,75~79세,2016,2294,835,1459,57.2,2294,835,1459,57.2
38310, 의령군,080001, 75세,2016,505,180,325,55.4,505,180,325,55.4
38310, 의령군,080002, 76세,2016,462,167,295,56.6,462,167,295,56.6
38310, 의령군,080003, 77세,2016,466,170,296,57.4,466,170,296,57.4
38310, 의령군,080004, 78세,2016,409,153,256,59.8,409,153,256,59.8
38310, 의령군,080005, 79세,2016,452,165,287,57.5,452,165,287,57.5
38310, 의령군,085,80~84세,2016,1737,499,1238,40.3,1735,497,1238,40.1
38310, 의령군,085001, 80세,2016,423,125,298,41.9,423,125,298,41.9
38310, 의령군,085002, 81세,2016,402,127,275,46.2,400,125,275,45.5
38310, 의령군,085003, 82세,2016,328,85,243,35,328,85,243,35
38310, 의령군,085004, 83세,2016,287,90,197,45.7,287,90,197,45.7
38310, 의령군,085005, 84세,2016,297,72,225,32,297,72,225,32
38310, 의령군,090,85~89세,2016,799,198,601,32.9,799,198,601,32.9
38310, 의령군,090001, 85세,2016,215,53,162,32.7,215,53,162,32.7
38310, 의령군,090002, 86세,2016,199,47,152,30.9,199,47,152,30.9
38310, 의령군,090003, 87세,2016,168,39,129,30.2,168,39,129,30.2
38310, 의령군,090004, 88세,2016,130,39,91,42.9,130,39,91,42.9
38310, 의령군,090005, 89세,2016,87,20,67,29.9,87,20,67,29.9
38310, 의령군,095,90~94세,2016,216,57,159,35.8,216,57,159,35.8
38310, 의령군,095001, 90세,2016,67,17,50,34,67,17,50,34
38310, 의령군,095002, 91세,2016,50,12,38,31.6,50,12,38,31.6
38310, 의령군,095003, 92세,2016,37,9,28,32.1,37,9,28,32.1
38310, 의령군,095004, 93세,2016,36,9,27,33.3,36,9,27,33.3
38310, 의령군,095005, 94세,2016,26,10,16,62.5,26,10,16,62.5
38310, 의령군,100,95~99세,2016,42,12,30,40,42,12,30,40
38310, 의령군,100001, 95세,2016,14,X,11,27.3,14,X,11,27.3
38310, 의령군,100002, 96세,2016,13,X,9,44.4,13,X,9,44.4
38310, 의령군,100003, 97세,2016,7,X,X,75,7,X,X,75
38310, 의령군,100004, 98세,2016,7,X,5,40,7,X,5,40
38310, 의령군,100005, 99세,2016,X,X,X,0,X,X,X,0
38310, 의령군,101,100세이상,2016,X,X,X,0,X,X,X,0
38310, 의령군,102,15세미만,2016,2126,1125,1001,112.4,2117,1120,997,112.3
38310, 의령군,103,15~64세,2016,15444,8441,7003,120.5,14539,7838,6701,117
38310, 의령군,104,65세이상,2016,8998,3292,5706,57.7,8986,3284,5702,57.6
38310, 의령군,086,85세이상,2016,1060,267,793,33.7,1060,267,793,33.7
38310, 의령군,126,평균연령,2016,52.5,48.9,55.9,,53.1,49.5,56.3,
38310, 의령군,127,중위연령,2016,56.1,52,60,,56.8,53.3,60.6,
38320, 함안군,000,합계,2016,68799,35975,32824,109.6,64347,32314,32033,100.9
38320, 함안군,005,0~4세,2016,2709,1363,1346,101.3,2688,1353,1335,101.3
38320, 함안군,005001, 0세,2016,491,250,241,103.7,487,248,239,103.8
38320, 함안군,005002, 1세,2016,521,271,250,108.4,513,269,244,110.2
38320, 함안군,005003, 2세,2016,517,251,266,94.4,515,250,265,94.3
38320, 함안군,005004, 3세,2016,566,293,273,107.3,563,290,273,106.2
38320, 함안군,005005, 4세,2016,614,298,316,94.3,610,296,314,94.3
38320, 함안군,010,5~9세,2016,3195,1627,1568,103.8,3178,1619,1559,103.8
38320, 함안군,010001, 5세,2016,634,305,329,92.7,627,303,324,93.5
38320, 함안군,010002, 6세,2016,605,323,282,114.5,602,322,280,115
38320, 함안군,010003, 7세,2016,658,332,326,101.8,655,330,325,101.5
38320, 함안군,010004, 8세,2016,677,347,330,105.2,673,344,329,104.6
38320, 함안군,010005, 9세,2016,621,320,301,106.3,621,320,301,106.3
38320, 함안군,015,10~14세,2016,2850,1543,1307,118.1,2844,1540,1304,118.1
38320, 함안군,015001, 10세,2016,557,295,262,112.6,555,293,262,111.8
38320, 함안군,015002, 11세,2016,572,294,278,105.8,572,294,278,105.8
38320, 함안군,015003, 12세,2016,548,309,239,129.3,546,309,237,130.4
38320, 함안군,015004, 13세,2016,585,326,259,125.9,585,326,259,125.9
38320, 함안군,015005, 14세,2016,588,319,269,118.6,586,318,268,118.7
38320, 함안군,020,15~19세,2016,3404,1814,1590,114.1,3389,1809,1580,114.5
38320, 함안군,020001, 15세,2016,695,361,334,108.1,693,360,333,108.1
38320, 함안군,020002, 16세,2016,759,371,388,95.6,758,371,387,95.9
38320, 함안군,020003, 17세,2016,699,350,349,100.3,698,350,348,100.6
38320, 함안군,020004, 18세,2016,716,380,336,113.1,711,379,332,114.2
38320, 함안군,020005, 19세,2016,535,352,183,192.3,529,349,180,193.9
38320, 함안군,025,20~24세,2016,3473,2158,1315,164.1,2965,1735,1230,141.1
38320, 함안군,025001, 20세,2016,634,421,213,197.7,612,406,206,197.1
38320, 함안군,025002, 21세,2016,685,434,251,172.9,621,381,240,158.8
38320, 함안군,025003, 22세,2016,659,408,251,162.5,562,329,233,141.2
38320, 함안군,025004, 23세,2016,735,428,307,139.4,598,310,288,107.6
38320, 함안군,025005, 24세,2016,760,467,293,159.4,572,309,263,117.5
38320, 함안군,030,25~29세,2016,3810,2418,1392,173.7,2587,1359,1228,110.7
38320, 함안군,030001, 25세,2016,712,444,268,165.7,511,275,236,116.5
38320, 함안군,030002, 26세,2016,771,493,278,177.3,536,289,247,117
38320, 함안군,030003, 27세,2016,747,480,267,179.8,500,264,236,111.9
38320, 함안군,030004, 28세,2016,765,478,287,166.6,505,249,256,97.3
38320, 함안군,030005, 29세,2016,815,523,292,179.1,535,282,253,111.5
38320, 함안군,035,30~34세,2016,4355,2640,1715,153.9,3305,1710,1595,107.2
38320, 함안군,035001, 30세,2016,769,506,263,192.4,534,294,240,122.5
38320, 함안군,035002, 31세,2016,850,555,295,188.1,600,328,272,120.6
38320, 함안군,035003, 32세,2016,825,495,330,150,625,317,308,102.9
38320, 함안군,035004, 33세,2016,957,541,416,130,769,375,394,95.2
38320, 함안군,035005, 34세,2016,954,543,411,132.1,777,396,381,103.9
38320, 함안군,040,35~39세,2016,4911,2784,2127,130.9,4298,2274,2024,112.4
38320, 함안군,040001, 35세,2016,950,537,413,130,834,442,392,112.8
38320, 함안군,040002, 36세,2016,1069,602,467,128.9,927,484,443,109.3
38320, 함안군,040003, 37세,2016,960,557,403,138.2,839,460,379,121.4
38320, 함안군,040004, 38세,2016,940,519,421,123.3,807,405,402,100.7
38320, 함안군,040005, 39세,2016,992,569,423,134.5,891,483,408,118.4
38320, 함안군,045,40~44세,2016,5177,2942,2235,131.6,4806,2637,2169,121.6
38320, 함안군,045001, 40세,2016,966,547,419,130.5,870,467,403,115.9
38320, 함안군,045002, 41세,2016,1051,601,450,133.6,978,540,438,123.3
38320, 함안군,045003, 42세,2016,1031,584,447,130.6,962,523,439,119.1
38320, 함안군,045004, 43세,2016,1053,590,463,127.4,979,531,448,118.5
38320, 함안군,045005, 44세,2016,1076,620,456,136,1017,576,441,130.6
38320, 함안군,050,45~49세,2016,5377,3021,2356,128.2,5137,2845,2292,124.1
38320, 함안군,050001, 45세,2016,1108,619,489,126.6,1062,582,480,121.3
38320, 함안군,050002, 46세,2016,1090,615,475,129.5,1025,567,458,123.8
38320, 함안군,050003, 47세,2016,1053,594,459,129.4,1008,561,447,125.5
38320, 함안군,050004, 48세,2016,1077,613,464,132.1,1038,582,456,127.6
38320, 함안군,050005, 49세,2016,1049,580,469,123.7,1004,553,451,122.6
38320, 함안군,055,50~54세,2016,5292,2860,2432,117.6,5108,2746,2362,116.3
38320, 함안군,055001, 50세,2016,1070,586,484,121.1,1028,558,470,118.7
38320, 함안군,055002, 51세,2016,1048,542,506,107.1,1008,518,490,105.7
38320, 함안군,055003, 52세,2016,988,556,432,128.7,954,534,420,127.1
38320, 함안군,055004, 53세,2016,1036,567,469,120.9,995,545,450,121.1
38320, 함안군,055005, 54세,2016,1150,609,541,112.6,1123,591,532,111.1
38320, 함안군,060,55~59세,2016,5923,3100,2823,109.8,5836,3050,2786,109.5
38320, 함안군,060001, 55세,2016,1252,638,614,103.9,1232,627,605,103.6
38320, 함안군,060002, 56세,2016,1208,627,581,107.9,1185,612,573,106.8
38320, 함안군,060003, 57세,2016,1131,602,529,113.8,1116,593,523,113.4
38320, 함안군,060004, 58세,2016,1187,647,540,119.8,1173,639,534,119.7
38320, 함안군,060005, 59세,2016,1145,586,559,104.8,1130,579,551,105.1
38320, 함안군,065,60~64세,2016,4910,2475,2435,101.6,4829,2425,2404,100.9
38320, 함안군,065001, 60세,2016,1107,558,549,101.6,1088,547,541,101.1
38320, 함안군,065002, 61세,2016,1073,584,489,119.4,1056,571,485,117.7
38320, 함안군,065003, 62세,2016,997,486,511,95.1,974,474,500,94.8
38320, 함안군,065004, 63세,2016,853,438,415,105.5,840,430,410,104.9
38320, 함안군,065005, 64세,2016,880,409,471,86.8,871,403,468,86.1
38320, 함안군,070,65~69세,2016,3736,1874,1862,100.6,3711,1861,1850,100.6
38320, 함안군,070001, 65세,2016,689,355,334,106.3,683,353,330,107
38320, 함안군,070002, 66세,2016,797,387,410,94.4,789,384,405,94.8
38320, 함안군,070003, 67세,2016,747,377,370,101.9,742,374,368,101.6
38320, 함안군,070004, 68세,2016,801,419,382,109.7,797,416,381,109.2
38320, 함안군,070005, 69세,2016,702,336,366,91.8,700,334,366,91.3
38320, 함안군,075,70~74세,2016,3050,1286,1764,72.9,3046,1283,1763,72.8
38320, 함안군,075001, 70세,2016,501,234,267,87.6,500,233,267,87.3
38320, 함안군,075002, 71세,2016,541,222,319,69.6,540,221,319,69.3
38320, 함안군,075003, 72세,2016,625,271,354,76.6,624,270,354,76.3
38320, 함안군,075004, 73세,2016,626,258,368,70.1,625,258,367,70.3
38320, 함안군,075005, 74세,2016,757,301,456,66,757,301,456,66
38320, 함안군,080,75~79세,2016,3210,1141,2069,55.1,3205,1139,2066,55.1
38320, 함안군,080001, 75세,2016,738,277,461,60.1,737,277,460,60.2
38320, 함안군,080002, 76세,2016,667,248,419,59.2,665,247,418,59.1
38320, 함안군,080003, 77세,2016,633,218,415,52.5,633,218,415,52.5
38320, 함안군,080004, 78세,2016,578,196,382,51.3,578,196,382,51.3
38320, 함안군,080005, 79세,2016,594,202,392,51.5,592,201,391,51.4
38320, 함안군,085,80~84세,2016,2145,660,1485,44.4,2143,660,1483,44.5
38320, 함안군,085001, 80세,2016,480,163,317,51.4,480,163,317,51.4
38320, 함안군,085002, 81세,2016,495,153,342,44.7,494,153,341,44.9
38320, 함안군,085003, 82세,2016,459,146,313,46.6,458,146,312,46.8
38320, 함안군,085004, 83세,2016,375,104,271,38.4,375,104,271,38.4
38320, 함안군,085005, 84세,2016,336,94,242,38.8,336,94,242,38.8
38320, 함안군,090,85~89세,2016,975,211,764,27.6,975,211,764,27.6
38320, 함안군,090001, 85세,2016,266,63,203,31,266,63,203,31
38320, 함안군,090002, 86세,2016,221,52,169,30.8,221,52,169,30.8
38320, 함안군,090003, 87세,2016,211,44,167,26.3,211,44,167,26.3
38320, 함안군,090004, 88세,2016,172,31,141,22,172,31,141,22
38320, 함안군,090005, 89세,2016,105,21,84,25,105,21,84,25
38320, 함안군,095,90~94세,2016,251,52,199,26.1,251,52,199,26.1
38320, 함안군,095001, 90세,2016,83,17,66,25.8,83,17,66,25.8
38320, 함안군,095002, 91세,2016,62,13,49,26.5,62,13,49,26.5
38320, 함안군,095003, 92세,2016,50,9,41,22,50,9,41,22
38320, 함안군,095004, 93세,2016,33,X,30,10,33,X,30,10
38320, 함안군,095005, 94세,2016,23,10,13,76.9,23,10,13,76.9
38320, 함안군,100,95~99세,2016,43,6,37,16.2,43,6,37,16.2
38320, 함안군,100001, 95세,2016,17,X,15,13.3,17,X,15,13.3
38320, 함안군,100002, 96세,2016,9,X,7,28.6,9,X,7,28.6
38320, 함안군,100003, 97세,2016,6,X,6,0,6,X,6,0
38320, 함안군,100004, 98세,2016,8,X,7,14.3,8,X,7,14.3
38320, 함안군,100005, 99세,2016,X,X,X,50,X,X,X,50
38320, 함안군,101,100세이상,2016,X,X,X,0,X,X,X,0
38320, 함안군,102,15세미만,2016,8754,4533,4221,107.4,8710,4512,4198,107.5
38320, 함안군,103,15~64세,2016,46632,26212,20420,128.4,42260,22590,19670,114.8
38320, 함안군,104,65세이상,2016,13413,5230,8183,63.9,13377,5212,8165,63.8
38320, 함안군,086,85세이상,2016,1272,269,1003,26.8,1272,269,1003,26.8
38320, 함안군,126,평균연령,2016,44.3,42,46.8,,45,42.9,47.1,
38320, 함안군,127,중위연령,2016,45.5,42.8,48.8,,47,45.2,49.3,
38330, 창녕군,000,합계,2016,61979,31208,30771,101.4,59252,29349,29903,98.1
38330, 창녕군,005,0~4세,2016,1873,982,891,110.2,1842,964,878,109.8
38330, 창녕군,005001, 0세,2016,379,202,177,114.1,374,197,177,111.3
38330, 창녕군,005002, 1세,2016,338,173,165,104.8,335,171,164,104.3
38330, 창녕군,005003, 2세,2016,363,186,177,105.1,357,185,172,107.6
38330, 창녕군,005004, 3세,2016,396,205,191,107.3,387,201,186,108.1
38330, 창녕군,005005, 4세,2016,397,216,181,119.3,389,210,179,117.3
38330, 창녕군,010,5~9세,2016,1921,1031,890,115.8,1904,1022,882,115.9
38330, 창녕군,010001, 5세,2016,415,217,198,109.6,412,215,197,109.1
38330, 창녕군,010002, 6세,2016,365,197,168,117.3,363,197,166,118.7
38330, 창녕군,010003, 7세,2016,378,205,173,118.5,372,202,170,118.8
38330, 창녕군,010004, 8세,2016,368,185,183,101.1,366,184,182,101.1
38330, 창녕군,010005, 9세,2016,395,227,168,135.1,391,224,167,134.1
38330, 창녕군,015,10~14세,2016,1889,1016,873,116.4,1884,1015,869,116.8
38330, 창녕군,015001, 10세,2016,365,194,171,113.5,362,193,169,114.2
38330, 창녕군,015002, 11세,2016,346,194,152,127.6,345,194,151,128.5
38330, 창녕군,015003, 12세,2016,353,200,153,130.7,353,200,153,130.7
38330, 창녕군,015004, 13세,2016,391,198,193,102.6,390,198,192,103.1
38330, 창녕군,015005, 14세,2016,434,230,204,112.7,434,230,204,112.7
38330, 창녕군,020,15~19세,2016,3068,1674,1394,120.1,3059,1671,1388,120.4
38330, 창녕군,020001, 15세,2016,551,286,265,107.9,551,286,265,107.9
38330, 창녕군,020002, 16세,2016,741,380,361,105.3,740,380,360,105.6
38330, 창녕군,020003, 17세,2016,750,430,320,134.4,747,428,319,134.2
38330, 창녕군,020004, 18세,2016,644,353,291,121.3,643,352,291,121
38330, 창녕군,020005, 19세,2016,382,225,157,143.3,378,225,153,147.1
38330, 창녕군,025,20~24세,2016,2897,1789,1108,161.5,2584,1586,998,158.9
38330, 창녕군,025001, 20세,2016,538,363,175,207.4,524,355,169,210.1
38330, 창녕군,025002, 21세,2016,581,388,193,201,547,370,177,209
38330, 창녕군,025003, 22세,2016,559,338,221,152.9,502,299,203,147.3
38330, 창녕군,025004, 23세,2016,580,320,260,123.1,501,268,233,115
38330, 창녕군,025005, 24세,2016,639,380,259,146.7,510,294,216,136.1
38330, 창녕군,030,25~29세,2016,3121,1957,1164,168.1,2431,1453,978,148.6
38330, 창녕군,030001, 25세,2016,657,397,260,152.7,529,307,222,138.3
38330, 창녕군,030002, 26세,2016,650,397,253,156.9,511,297,214,138.8
38330, 창녕군,030003, 27세,2016,641,404,237,170.5,503,307,196,156.6
38330, 창녕군,030004, 28세,2016,594,396,198,200,437,273,164,166.5
38330, 창녕군,030005, 29세,2016,579,363,216,168.1,451,269,182,147.8
38330, 창녕군,035,30~34세,2016,3182,1854,1328,139.6,2658,1442,1216,118.6
38330, 창녕군,035001, 30세,2016,632,383,249,153.8,505,285,220,129.5
38330, 창녕군,035002, 31세,2016,573,354,219,161.6,454,259,195,132.8
38330, 창녕군,035003, 32세,2016,657,380,277,137.2,542,290,252,115.1
38330, 창녕군,035004, 33세,2016,624,351,273,128.6,531,274,257,106.6
38330, 창녕군,035005, 34세,2016,696,386,310,124.5,626,334,292,114.4
38330, 창녕군,040,35~39세,2016,3364,1929,1435,134.4,2994,1669,1325,126
38330, 창녕군,040001, 35세,2016,706,432,274,157.7,620,369,251,147
38330, 창녕군,040002, 36세,2016,765,421,344,122.4,666,354,312,113.5
38330, 창녕군,040003, 37세,2016,682,377,305,123.6,613,331,282,117.4
38330, 창녕군,040004, 38세,2016,615,341,274,124.5,554,299,255,117.3
38330, 창녕군,040005, 39세,2016,596,358,238,150.4,541,316,225,140.4
38330, 창녕군,045,40~44세,2016,3491,1974,1517,130.1,3249,1815,1434,126.6
38330, 창녕군,045001, 40세,2016,578,331,247,134,532,302,230,131.3
38330, 창녕군,045002, 41세,2016,654,369,285,129.5,589,329,260,126.5
38330, 창녕군,045003, 42세,2016,740,435,305,142.6,690,397,293,135.5
38330, 창녕군,045004, 43세,2016,754,422,332,127.1,721,397,324,122.5
38330, 창녕군,045005, 44세,2016,765,417,348,119.8,717,390,327,119.3
38330, 창녕군,050,45~49세,2016,4416,2493,1923,129.6,4252,2395,1857,129
38330, 창녕군,050001, 45세,2016,851,504,347,145.2,815,479,336,142.6
38330, 창녕군,050002, 46세,2016,856,511,345,148.1,826,493,333,148
38330, 창녕군,050003, 47세,2016,897,478,419,114.1,860,461,399,115.5
38330, 창녕군,050004, 48세,2016,921,520,401,129.7,890,503,387,130
38330, 창녕군,050005, 49세,2016,891,480,411,116.8,861,459,402,114.2
38330, 창녕군,055,50~54세,2016,5109,2673,2436,109.7,4964,2600,2364,110
38330, 창녕군,055001, 50세,2016,926,519,407,127.5,906,509,397,128.2
38330, 창녕군,055002, 51세,2016,941,518,423,122.5,908,502,406,123.6
38330, 창녕군,055003, 52세,2016,999,492,507,97,970,477,493,96.8
38330, 창녕군,055004, 53세,2016,1081,546,535,102.1,1042,526,516,101.9
38330, 창녕군,055005, 54세,2016,1162,598,564,106,1138,586,552,106.2
38330, 창녕군,060,55~59세,2016,6078,3056,3022,101.1,5959,2983,2976,100.2
38330, 창녕군,060001, 55세,2016,1181,569,612,93,1154,550,604,91.1
38330, 창녕군,060002, 56세,2016,1319,649,670,96.9,1292,635,657,96.7
38330, 창녕군,060003, 57세,2016,1203,617,586,105.3,1178,602,576,104.5
38330, 창녕군,060004, 58세,2016,1155,607,548,110.8,1134,596,538,110.8
38330, 창녕군,060005, 59세,2016,1220,614,606,101.3,1201,600,601,99.8
38330, 창녕군,065,60~64세,2016,5221,2523,2698,93.5,5151,2490,2661,93.6
38330, 창녕군,065001, 60세,2016,1158,580,578,100.3,1139,571,568,100.5
38330, 창녕군,065002, 61세,2016,1172,546,626,87.2,1152,535,617,86.7
38330, 창녕군,065003, 62세,2016,977,482,495,97.4,964,474,490,96.7
38330, 창녕군,065004, 63세,2016,884,424,460,92.2,872,419,453,92.5
38330, 창녕군,065005, 64세,2016,1030,491,539,91.1,1024,491,533,92.1
38330, 창녕군,070,65~69세,2016,4306,2071,2235,92.7,4290,2063,2227,92.6
38330, 창녕군,070001, 65세,2016,839,407,432,94.2,834,404,430,94
38330, 창녕군,070002, 66세,2016,875,412,463,89,868,409,459,89.1
38330, 창녕군,070003, 67세,2016,860,408,452,90.3,860,408,452,90.3
38330, 창녕군,070004, 68세,2016,857,421,436,96.6,854,420,434,96.8
38330, 창녕군,070005, 69세,2016,875,423,452,93.6,874,422,452,93.4
38330, 창녕군,075,70~74세,2016,3823,1572,2251,69.8,3817,1570,2247,69.9
38330, 창녕군,075001, 70세,2016,668,314,354,88.7,665,313,352,88.9
38330, 창녕군,075002, 71세,2016,656,289,367,78.7,656,289,367,78.7
38330, 창녕군,075003, 72세,2016,755,294,461,63.8,755,294,461,63.8
38330, 창녕군,075004, 73세,2016,792,303,489,62,791,302,489,61.8
38330, 창녕군,075005, 74세,2016,952,372,580,64.1,950,372,578,64.4
38330, 창녕군,080,75~79세,2016,4073,1464,2609,56.1,4071,1462,2609,56
38330, 창녕군,080001, 75세,2016,909,349,560,62.3,909,349,560,62.3
38330, 창녕군,080002, 76세,2016,813,294,519,56.6,812,293,519,56.5
38330, 창녕군,080003, 77세,2016,817,274,543,50.5,817,274,543,50.5
38330, 창녕군,080004, 78세,2016,833,287,546,52.6,833,287,546,52.6
38330, 창녕군,080005, 79세,2016,701,260,441,59,700,259,441,58.7
38330, 창녕군,085,80~84세,2016,2694,827,1867,44.3,2693,827,1866,44.3
38330, 창녕군,085001, 80세,2016,611,205,406,50.5,611,205,406,50.5
38330, 창녕군,085002, 81세,2016,607,211,396,53.3,606,211,395,53.4
38330, 창녕군,085003, 82세,2016,556,146,410,35.6,556,146,410,35.6
38330, 창녕군,085004, 83세,2016,481,133,348,38.2,481,133,348,38.2
38330, 창녕군,085005, 84세,2016,439,132,307,43,439,132,307,43
38330, 창녕군,090,85~89세,2016,1133,266,867,30.7,1131,266,865,30.8
38330, 창녕군,090001, 85세,2016,316,79,237,33.3,316,79,237,33.3
38330, 창녕군,090002, 86세,2016,271,67,204,32.8,271,67,204,32.8
38330, 창녕군,090003, 87세,2016,237,55,182,30.2,236,55,181,30.4
38330, 창녕군,090004, 88세,2016,187,40,147,27.2,187,40,147,27.2
38330, 창녕군,090005, 89세,2016,122,25,97,25.8,121,25,96,26
38330, 창녕군,095,90~94세,2016,272,48,224,21.4,271,47,224,21
38330, 창녕군,095001, 90세,2016,93,20,73,27.4,93,20,73,27.4
38330, 창녕군,095002, 91세,2016,61,12,49,24.5,61,12,49,24.5
38330, 창녕군,095003, 92세,2016,52,8,44,18.2,52,8,44,18.2
38330, 창녕군,095004, 93세,2016,38,X,35,8.6,37,X,35,5.7
38330, 창녕군,095005, 94세,2016,28,5,23,21.7,28,5,23,21.7
38330, 창녕군,100,95~99세,2016,42,9,33,27.3,42,9,33,27.3
38330, 창녕군,100001, 95세,2016,11,X,9,22.2,11,X,9,22.2
38330, 창녕군,100002, 96세,2016,17,X,15,13.3,17,X,15,13.3
38330, 창녕군,100003, 97세,2016,X,X,X,0,X,X,X,0
38330, 창녕군,100004, 98세,2016,9,X,6,50,9,X,6,50
38330, 창녕군,100005, 99세,2016,X,X,X,,X,X,X,
38330, 창녕군,101,100세이상,2016,6,X,6,0,6,X,6,0
38330, 창녕군,102,15세미만,2016,5683,3029,2654,114.1,5630,3001,2629,114.1
38330, 창녕군,103,15~64세,2016,39947,21922,18025,121.6,37301,20104,17197,116.9
38330, 창녕군,104,65세이상,2016,16349,6257,10092,62,16321,6244,10077,62
38330, 창녕군,086,85세이상,2016,1453,323,1130,28.6,1450,322,1128,28.5
38330, 창녕군,126,평균연령,2016,48.6,45.4,51.8,,49.2,46.1,52.3,
38330, 창녕군,127,중위연령,2016,51.9,47.8,55.7,,53,49.2,56.2,
38340, 고성군,000,합계,2016,53123,27181,25942,104.8,50983,25616,25367,101
38340, 고성군,005,0~4세,2016,1696,839,857,97.9,1690,835,855,97.7
38340, 고성군,005001, 0세,2016,279,154,125,123.2,278,153,125,122.4
38340, 고성군,005002, 1세,2016,325,150,175,85.7,324,149,175,85.1
38340, 고성군,005003, 2세,2016,342,168,174,96.6,340,167,173,96.5
38340, 고성군,005004, 3세,2016,361,172,189,91,360,172,188,91.5
38340, 고성군,005005, 4세,2016,389,195,194,100.5,388,194,194,100
38340, 고성군,010,5~9세,2016,1916,1038,878,118.2,1911,1036,875,118.4
38340, 고성군,010001, 5세,2016,398,210,188,111.7,398,210,188,111.7
38340, 고성군,010002, 6세,2016,397,222,175,126.9,397,222,175,126.9
38340, 고성군,010003, 7세,2016,361,190,171,111.1,360,190,170,111.8
38340, 고성군,010004, 8세,2016,391,198,193,102.6,389,197,192,102.6
38340, 고성군,010005, 9세,2016,369,218,151,144.4,367,217,150,144.7
38340, 고성군,015,10~14세,2016,1842,926,916,101.1,1836,922,914,100.9
38340, 고성군,015001, 10세,2016,351,178,173,102.9,349,176,173,101.7
38340, 고성군,015002, 11세,2016,360,173,187,92.5,359,172,187,92
38340, 고성군,015003, 12세,2016,354,177,177,100,354,177,177,100
38340, 고성군,015004, 13세,2016,372,184,188,97.9,370,183,187,97.9
38340, 고성군,015005, 14세,2016,405,214,191,112,404,214,190,112.6
38340, 고성군,020,15~19세,2016,2764,1681,1083,155.2,2758,1678,1080,155.4
38340, 고성군,020001, 15세,2016,525,305,220,138.6,525,305,220,138.6
38340, 고성군,020002, 16세,2016,759,454,305,148.9,759,454,305,148.9
38340, 고성군,020003, 17세,2016,601,361,240,150.4,599,361,238,151.7
38340, 고성군,020004, 18세,2016,549,328,221,148.4,549,328,221,148.4
38340, 고성군,020005, 19세,2016,330,233,97,240.2,326,230,96,239.6
38340, 고성군,025,20~24세,2016,2203,1396,807,173,1994,1253,741,169.1
38340, 고성군,025001, 20세,2016,437,298,139,214.4,432,294,138,213
38340, 고성군,025002, 21세,2016,426,296,130,227.7,405,284,121,234.7
38340, 고성군,025003, 22세,2016,442,264,178,148.3,399,234,165,141.8
38340, 고성군,025004, 23세,2016,440,252,188,134,362,204,158,129.1
38340, 고성군,025005, 24세,2016,458,286,172,166.3,396,237,159,149.1
38340, 고성군,030,25~29세,2016,2307,1417,890,159.2,1768,1004,764,131.4
38340, 고성군,030001, 25세,2016,458,275,183,150.3,365,209,156,134
38340, 고성군,030002, 26세,2016,443,278,165,168.5,329,192,137,140.1
38340, 고성군,030003, 27세,2016,494,298,196,152,383,211,172,122.7
38340, 고성군,030004, 28세,2016,444,265,179,148,345,185,160,115.6
38340, 고성군,030005, 29세,2016,468,301,167,180.2,346,207,139,148.9
38340, 고성군,035,30~34세,2016,2895,1757,1138,154.4,2396,1344,1052,127.8
38340, 고성군,035001, 30세,2016,495,307,188,163.3,386,221,165,133.9
38340, 고성군,035002, 31세,2016,546,321,225,142.7,424,219,205,106.8
38340, 고성군,035003, 32세,2016,571,331,240,137.9,463,244,219,111.4
38340, 고성군,035004, 33세,2016,612,375,237,158.2,535,311,224,138.8
38340, 고성군,035005, 34세,2016,671,423,248,170.6,588,349,239,146
38340, 고성군,040,35~39세,2016,3101,1820,1281,142.1,2825,1591,1234,128.9
38340, 고성군,040001, 35세,2016,642,360,282,127.7,589,314,275,114.2
38340, 고성군,040002, 36세,2016,706,419,287,146,630,355,275,129.1
38340, 고성군,040003, 37세,2016,632,394,238,165.5,580,350,230,152.2
38340, 고성군,040004, 38세,2016,573,345,228,151.3,522,302,220,137.3
38340, 고성군,040005, 39세,2016,548,302,246,122.8,504,270,234,115.4
38340, 고성군,045,40~44세,2016,3324,1887,1437,131.3,3146,1762,1384,127.3
38340, 고성군,045001, 40세,2016,596,339,257,131.9,557,309,248,124.6
38340, 고성군,045002, 41세,2016,641,352,289,121.8,601,323,278,116.2
38340, 고성군,045003, 42세,2016,652,368,284,129.6,620,345,275,125.5
38340, 고성군,045004, 43세,2016,725,409,316,129.4,694,386,308,125.3
38340, 고성군,045005, 44세,2016,710,419,291,144,674,399,275,145.1
38340, 고성군,050,45~49세,2016,3970,2243,1727,129.9,3818,2151,1667,129
38340, 고성군,050001, 45세,2016,821,435,386,112.7,786,411,375,109.6
38340, 고성군,050002, 46세,2016,845,482,363,132.8,803,457,346,132.1
38340, 고성군,050003, 47세,2016,754,443,311,142.4,720,424,296,143.2
38340, 고성군,050004, 48세,2016,770,425,345,123.2,745,411,334,123.1
38340, 고성군,050005, 49세,2016,780,458,322,142.2,764,448,316,141.8
38340, 고성군,055,50~54세,2016,4105,2172,1933,112.4,3980,2107,1873,112.5
38340, 고성군,055001, 50세,2016,766,415,351,118.2,745,402,343,117.2
38340, 고성군,055002, 51세,2016,806,411,395,104.1,779,396,383,103.4
38340, 고성군,055003, 52세,2016,767,432,335,129,738,420,318,132.1
38340, 고성군,055004, 53세,2016,812,432,380,113.7,787,420,367,114.4
38340, 고성군,055005, 54세,2016,954,482,472,102.1,931,469,462,101.5
38340, 고성군,060,55~59세,2016,4866,2470,2396,103.1,4800,2433,2367,102.8
38340, 고성군,060001, 55세,2016,1040,521,519,100.4,1026,510,516,98.8
38340, 고성군,060002, 56세,2016,1057,520,537,96.8,1042,513,529,97
38340, 고성군,060003, 57세,2016,946,479,467,102.6,936,476,460,103.5
38340, 고성군,060004, 58세,2016,896,460,436,105.5,883,453,430,105.3
38340, 고성군,060005, 59세,2016,927,490,437,112.1,913,481,432,111.3
38340, 고성군,065,60~64세,2016,4277,2088,2189,95.4,4231,2064,2167,95.2
38340, 고성군,065001, 60세,2016,932,476,456,104.4,918,469,449,104.5
38340, 고성군,065002, 61세,2016,903,420,483,87,895,415,480,86.5
38340, 고성군,065003, 62세,2016,856,424,432,98.1,842,417,425,98.1
38340, 고성군,065004, 63세,2016,745,361,384,94,738,359,379,94.7
38340, 고성군,065005, 64세,2016,841,407,434,93.8,838,404,434,93.1
38340, 고성군,070,65~69세,2016,3717,1814,1903,95.3,3701,1806,1895,95.3
38340, 고성군,070001, 65세,2016,741,367,374,98.1,738,365,373,97.9
38340, 고성군,070002, 66세,2016,701,323,378,85.4,692,319,373,85.5
38340, 고성군,070003, 67세,2016,761,387,374,103.5,760,386,374,103.2
38340, 고성군,070004, 68세,2016,770,386,384,100.5,768,385,383,100.5
38340, 고성군,070005, 69세,2016,744,351,393,89.3,743,351,392,89.5
38340, 고성군,075,70~74세,2016,3150,1335,1815,73.6,3143,1333,1810,73.6
38340, 고성군,075001, 70세,2016,539,234,305,76.7,538,234,304,77
38340, 고성군,075002, 71세,2016,628,265,363,73,625,264,361,73.1
38340, 고성군,075003, 72세,2016,577,261,316,82.6,575,261,314,83.1
38340, 고성군,075004, 73세,2016,660,281,379,74.1,659,280,379,73.9
38340, 고성군,075005, 74세,2016,746,294,452,65,746,294,452,65
38340, 고성군,080,75~79세,2016,3179,1194,1985,60.2,3178,1193,1985,60.1
38340, 고성군,080001, 75세,2016,686,269,417,64.5,686,269,417,64.5
38340, 고성군,080002, 76세,2016,671,273,398,68.6,671,273,398,68.6
38340, 고성군,080003, 77세,2016,690,250,440,56.8,690,250,440,56.8
38340, 고성군,080004, 78세,2016,555,196,359,54.6,555,196,359,54.6
38340, 고성군,080005, 79세,2016,577,206,371,55.5,576,205,371,55.3
38340, 고성군,085,80~84세,2016,2348,772,1576,49,2346,772,1574,49
38340, 고성군,085001, 80세,2016,558,212,346,61.3,557,212,345,61.4
38340, 고성군,085002, 81세,2016,540,199,341,58.4,540,199,341,58.4
38340, 고성군,085003, 82세,2016,464,148,316,46.8,463,148,315,47
38340, 고성군,085004, 83세,2016,418,130,288,45.1,418,130,288,45.1
38340, 고성군,085005, 84세,2016,368,83,285,29.1,368,83,285,29.1
38340, 고성군,090,85~89세,2016,1084,262,822,31.9,1083,262,821,31.9
38340, 고성군,090001, 85세,2016,292,74,218,33.9,292,74,218,33.9
38340, 고성군,090002, 86세,2016,270,63,207,30.4,270,63,207,30.4
38340, 고성군,090003, 87세,2016,229,62,167,37.1,228,62,166,37.3
38340, 고성군,090004, 88세,2016,165,38,127,29.9,165,38,127,29.9
38340, 고성군,090005, 89세,2016,128,25,103,24.3,128,25,103,24.3
38340, 고성군,095,90~94세,2016,314,62,252,24.6,314,62,252,24.6
38340, 고성군,095001, 90세,2016,115,21,94,22.3,115,21,94,22.3
38340, 고성군,095002, 91세,2016,72,14,58,24.1,72,14,58,24.1
38340, 고성군,095003, 92세,2016,45,12,33,36.4,45,12,33,36.4
38340, 고성군,095004, 93세,2016,52,8,44,18.2,52,8,44,18.2
38340, 고성군,095005, 94세,2016,30,7,23,30.4,30,7,23,30.4
38340, 고성군,100,95~99세,2016,57,8,49,16.3,57,8,49,16.3
38340, 고성군,100001, 95세,2016,26,X,22,18.2,26,X,22,18.2
38340, 고성군,100002, 96세,2016,14,X,12,16.7,14,X,12,16.7
38340, 고성군,100003, 97세,2016,6,X,X,50,6,X,X,50
38340, 고성군,100004, 98세,2016,8,X,8,0,8,X,8,0
38340, 고성군,100005, 99세,2016,X,X,X,0,X,X,X,0
38340, 고성군,101,100세이상,2016,8,X,8,0,8,X,8,0
38340, 고성군,102,15세미만,2016,5454,2803,2651,105.7,5437,2793,2644,105.6
38340, 고성군,103,15~64세,2016,33812,18931,14881,127.2,31716,17387,14329,121.3
38340, 고성군,104,65세이상,2016,13857,5447,8410,64.8,13830,5436,8394,64.8
38340, 고성군,086,85세이상,2016,1463,332,1131,29.4,1462,332,1130,29.4
38340, 고성군,126,평균연령,2016,48.1,45,51.3,,48.6,45.7,51.6,
38340, 고성군,127,중위연령,2016,50.7,46.8,55,,51.8,48.2,55.5,
38350, 남해군,000,합계,2016,43568,21120,22448,94.1,42573,20356,22217,91.6
38350, 남해군,005,0~4세,2016,814,419,395,106.1,812,417,395,105.6
38350, 남해군,005001, 0세,2016,138,56,82,68.3,138,56,82,68.3
38350, 남해군,005002, 1세,2016,161,92,69,133.3,161,92,69,133.3
38350, 남해군,005003, 2세,2016,181,99,82,120.7,181,99,82,120.7
38350, 남해군,005004, 3세,2016,150,74,76,97.4,150,74,76,97.4
38350, 남해군,005005, 4세,2016,184,98,86,114,182,96,86,111.6
38350, 남해군,010,5~9세,2016,1140,630,510,123.5,1135,628,507,123.9
38350, 남해군,010001, 5세,2016,204,129,75,172,204,129,75,172
38350, 남해군,010002, 6세,2016,229,117,112,104.5,226,116,110,105.5
38350, 남해군,010003, 7세,2016,222,124,98,126.5,220,123,97,126.8
38350, 남해군,010004, 8세,2016,236,135,101,133.7,236,135,101,133.7
38350, 남해군,010005, 9세,2016,249,125,124,100.8,249,125,124,100.8
38350, 남해군,015,10~14세,2016,1304,712,592,120.3,1302,710,592,119.9
38350, 남해군,015001, 10세,2016,217,108,109,99.1,217,108,109,99.1
38350, 남해군,015002, 11세,2016,237,124,113,109.7,237,124,113,109.7
38350, 남해군,015003, 12세,2016,273,145,128,113.3,273,145,128,113.3
38350, 남해군,015004, 13세,2016,267,137,130,105.4,266,136,130,104.6
38350, 남해군,015005, 14세,2016,310,198,112,176.8,309,197,112,175.9
38350, 남해군,020,15~19세,2016,2430,1302,1128,115.4,2421,1297,1124,115.4
38350, 남해군,020001, 15세,2016,399,198,201,98.5,399,198,201,98.5
38350, 남해군,020002, 16세,2016,602,320,282,113.5,602,320,282,113.5
38350, 남해군,020003, 17세,2016,521,274,247,110.9,519,273,246,111
38350, 남해군,020004, 18세,2016,509,275,234,117.5,509,275,234,117.5
38350, 남해군,020005, 19세,2016,399,235,164,143.3,392,231,161,143.5
38350, 남해군,025,20~24세,2016,1791,1221,570,214.2,1646,1099,547,200.9
38350, 남해군,025001, 20세,2016,356,238,118,201.7,342,231,111,208.1
38350, 남해군,025002, 21세,2016,393,289,104,277.9,374,275,99,277.8
38350, 남해군,025003, 22세,2016,365,253,112,225.9,339,230,109,211
38350, 남해군,025004, 23세,2016,360,250,110,227.3,313,209,104,201
38350, 남해군,025005, 24세,2016,317,191,126,151.6,278,154,124,124.2
38350, 남해군,030,25~29세,2016,1521,900,621,144.9,1288,703,585,120.2
38350, 남해군,030001, 25세,2016,315,177,138,128.3,270,142,128,110.9
38350, 남해군,030002, 26세,2016,319,193,126,153.2,274,149,125,119.2
38350, 남해군,030003, 27세,2016,291,178,113,157.5,245,142,103,137.9
38350, 남해군,030004, 28세,2016,297,174,123,141.5,256,139,117,118.8
38350, 남해군,030005, 29세,2016,299,178,121,147.1,243,131,112,117
38350, 남해군,035,30~34세,2016,1422,829,593,139.8,1211,655,556,117.8
38350, 남해군,035001, 30세,2016,276,162,114,142.1,231,126,105,120
38350, 남해군,035002, 31세,2016,246,156,90,173.3,201,119,82,145.1
38350, 남해군,035003, 32세,2016,291,169,122,138.5,250,137,113,121.2
38350, 남해군,035004, 33세,2016,290,164,126,130.2,247,125,122,102.5
38350, 남해군,035005, 34세,2016,319,178,141,126.2,282,148,134,110.4
38350, 남해군,040,35~39세,2016,1659,915,744,123,1551,819,732,111.9
38350, 남해군,040001, 35세,2016,353,199,154,129.2,321,173,148,116.9
38350, 남해군,040002, 36세,2016,341,183,158,115.8,314,160,154,103.9
38350, 남해군,040003, 37세,2016,328,178,150,118.7,310,161,149,108.1
38350, 남해군,040004, 38세,2016,304,170,134,126.9,290,156,134,116.4
38350, 남해군,040005, 39세,2016,333,185,148,125,316,169,147,115
38350, 남해군,045,40~44세,2016,2333,1292,1041,124.1,2243,1213,1030,117.8
38350, 남해군,045001, 40세,2016,387,217,170,127.6,363,197,166,118.7
38350, 남해군,045002, 41세,2016,429,232,197,117.8,409,213,196,108.7
38350, 남해군,045003, 42세,2016,457,260,197,132,439,245,194,126.3
38350, 남해군,045004, 43세,2016,533,283,250,113.2,518,270,248,108.9
38350, 남해군,045005, 44세,2016,527,300,227,132.2,514,288,226,127.4
38350, 남해군,050,45~49세,2016,2912,1614,1298,124.3,2859,1582,1277,123.9
38350, 남해군,050001, 45세,2016,606,358,248,144.4,596,349,247,141.3
38350, 남해군,050002, 46세,2016,553,308,245,125.7,547,303,244,124.2
38350, 남해군,050003, 47세,2016,625,336,289,116.3,608,325,283,114.8
38350, 남해군,050004, 48세,2016,574,312,262,119.1,564,307,257,119.5
38350, 남해군,050005, 49세,2016,554,300,254,118.1,544,298,246,121.1
38350, 남해군,055,50~54세,2016,3385,1771,1614,109.7,3357,1759,1598,110.1
38350, 남해군,055001, 50세,2016,619,355,264,134.5,615,353,262,134.7
38350, 남해군,055002, 51세,2016,633,334,299,111.7,628,330,298,110.7
38350, 남해군,055003, 52세,2016,619,307,312,98.4,612,304,308,98.7
38350, 남해군,055004, 53세,2016,662,344,318,108.2,655,342,313,109.3
38350, 남해군,055005, 54세,2016,852,431,421,102.4,847,430,417,103.1
38350, 남해군,060,55~59세,2016,4170,2050,2120,96.7,4133,2041,2092,97.6
38350, 남해군,060001, 55세,2016,904,431,473,91.1,899,431,468,92.1
38350, 남해군,060002, 56세,2016,896,454,442,102.7,886,451,435,103.7
38350, 남해군,060003, 57세,2016,737,345,392,88,724,342,382,89.5
38350, 남해군,060004, 58세,2016,802,413,389,106.2,793,410,383,107
38350, 남해군,060005, 59세,2016,831,407,424,96,831,407,424,96
38350, 남해군,065,60~64세,2016,3699,1765,1934,91.3,3660,1749,1911,91.5
38350, 남해군,065001, 60세,2016,763,370,393,94.1,754,367,387,94.8
38350, 남해군,065002, 61세,2016,834,393,441,89.1,825,388,437,88.8
38350, 남해군,065003, 62세,2016,662,321,341,94.1,651,316,335,94.3
38350, 남해군,065004, 63세,2016,663,321,342,93.9,659,320,339,94.4
38350, 남해군,065005, 64세,2016,777,360,417,86.3,771,358,413,86.7
38350, 남해군,070,65~69세,2016,3558,1690,1868,90.5,3545,1685,1860,90.6
38350, 남해군,070001, 65세,2016,733,337,396,85.1,731,337,394,85.5
38350, 남해군,070002, 66세,2016,606,301,305,98.7,604,300,304,98.7
38350, 남해군,070003, 67세,2016,804,387,417,92.8,802,386,416,92.8
38350, 남해군,070004, 68세,2016,685,317,368,86.1,681,314,367,85.6
38350, 남해군,070005, 69세,2016,730,348,382,91.1,727,348,379,91.8
38350, 남해군,075,70~74세,2016,3277,1407,1870,75.2,3267,1402,1865,75.2
38350, 남해군,075001, 70세,2016,617,296,321,92.2,614,295,319,92.5
38350, 남해군,075002, 71세,2016,604,282,322,87.6,603,282,321,87.9
38350, 남해군,075003, 72세,2016,561,248,313,79.2,558,245,313,78.3
38350, 남해군,075004, 73세,2016,636,245,391,62.7,634,244,390,62.6
38350, 남해군,075005, 74세,2016,859,336,523,64.2,858,336,522,64.4
38350, 남해군,080,75~79세,2016,3539,1340,2199,60.9,3532,1337,2195,60.9
38350, 남해군,080001, 75세,2016,765,298,467,63.8,761,297,464,64
38350, 남해군,080002, 76세,2016,751,289,462,62.6,749,287,462,62.1
38350, 남해군,080003, 77세,2016,738,277,461,60.1,737,277,460,60.2
38350, 남해군,080004, 78세,2016,625,245,380,64.5,625,245,380,64.5
38350, 남해군,080005, 79세,2016,660,231,429,53.8,660,231,429,53.8
38350, 남해군,085,80~84세,2016,2679,843,1836,45.9,2678,842,1836,45.9
38350, 남해군,085001, 80세,2016,587,198,389,50.9,587,198,389,50.9
38350, 남해군,085002, 81세,2016,602,182,420,43.3,602,182,420,43.3
38350, 남해군,085003, 82세,2016,559,188,371,50.7,559,188,371,50.7
38350, 남해군,085004, 83세,2016,457,149,308,48.4,456,148,308,48.1
38350, 남해군,085005, 84세,2016,474,126,348,36.2,474,126,348,36.2
38350, 남해군,090,85~89세,2016,1371,325,1046,31.1,1369,323,1046,30.9
38350, 남해군,090001, 85세,2016,378,92,286,32.2,378,92,286,32.2
38350, 남해군,090002, 86세,2016,340,88,252,34.9,339,87,252,34.5
38350, 남해군,090003, 87세,2016,269,54,215,25.1,269,54,215,25.1
38350, 남해군,090004, 88세,2016,198,47,151,31.1,198,47,151,31.1
38350, 남해군,090005, 89세,2016,186,44,142,31,185,43,142,30.3
38350, 남해군,095,90~94세,2016,484,87,397,21.9,484,87,397,21.9
38350, 남해군,095001, 90세,2016,138,28,110,25.5,138,28,110,25.5
38350, 남해군,095002, 91세,2016,129,27,102,26.5,129,27,102,26.5
38350, 남해군,095003, 92세,2016,82,11,71,15.5,82,11,71,15.5
38350, 남해군,095004, 93세,2016,69,13,56,23.2,69,13,56,23.2
38350, 남해군,095005, 94세,2016,66,8,58,13.8,66,8,58,13.8
38350, 남해군,100,95~99세,2016,70,8,62,12.9,70,8,62,12.9
38350, 남해군,100001, 95세,2016,30,X,26,15.4,30,X,26,15.4
38350, 남해군,100002, 96세,2016,17,X,16,6.3,17,X,16,6.3
38350, 남해군,100003, 97세,2016,5,X,X,66.7,5,X,X,66.7
38350, 남해군,100004, 98세,2016,10,X,10,0,10,X,10,0
38350, 남해군,100005, 99세,2016,8,X,7,14.3,8,X,7,14.3
38350, 남해군,101,100세이상,2016,10,X,10,0,10,X,10,0
38350, 남해군,102,15세미만,2016,3258,1761,1497,117.6,3249,1755,1494,117.5
38350, 남해군,103,15~64세,2016,25322,13659,11663,117.1,24369,12917,11452,112.8
38350, 남해군,104,65세이상,2016,14988,5700,9288,61.4,14955,5684,9271,61.3
38350, 남해군,086,85세이상,2016,1935,420,1515,27.7,1933,418,1515,27.6
38350, 남해군,126,평균연령,2016,52.6,48.8,56.2,,53,49.3,56.3,
38350, 남해군,127,중위연령,2016,56.2,52.1,60,,56.6,53.2,60.2,
38360, 하동군,000,합계,2016,43927,21499,22428,95.9,43337,21242,22095,96.1
38360, 하동군,005,0~4세,2016,1093,557,536,103.9,1093,557,536,103.9
38360, 하동군,005001, 0세,2016,215,93,122,76.2,215,93,122,76.2
38360, 하동군,005002, 1세,2016,224,126,98,128.6,224,126,98,128.6
38360, 하동군,005003, 2세,2016,222,114,108,105.6,222,114,108,105.6
38360, 하동군,005004, 3세,2016,196,107,89,120.2,196,107,89,120.2
38360, 하동군,005005, 4세,2016,236,117,119,98.3,236,117,119,98.3
38360, 하동군,010,5~9세,2016,1311,698,613,113.9,1310,697,613,113.7
38360, 하동군,010001, 5세,2016,256,143,113,126.5,255,142,113,125.7
38360, 하동군,010002, 6세,2016,265,144,121,119,265,144,121,119
38360, 하동군,010003, 7세,2016,235,102,133,76.7,235,102,133,76.7
38360, 하동군,010004, 8세,2016,296,164,132,124.2,296,164,132,124.2
38360, 하동군,010005, 9세,2016,259,145,114,127.2,259,145,114,127.2
38360, 하동군,015,10~14세,2016,1486,797,689,115.7,1486,797,689,115.7
38360, 하동군,015001, 10세,2016,276,148,128,115.6,276,148,128,115.6
38360, 하동군,015002, 11세,2016,287,150,137,109.5,287,150,137,109.5
38360, 하동군,015003, 12세,2016,303,167,136,122.8,303,167,136,122.8
38360, 하동군,015004, 13세,2016,282,151,131,115.3,282,151,131,115.3
38360, 하동군,015005, 14세,2016,338,181,157,115.3,338,181,157,115.3
38360, 하동군,020,15~19세,2016,1759,984,775,127,1751,982,769,127.7
38360, 하동군,020001, 15세,2016,365,190,175,108.6,365,190,175,108.6
38360, 하동군,020002, 16세,2016,361,200,161,124.2,360,199,161,123.6
38360, 하동군,020003, 17세,2016,412,222,190,116.8,411,222,189,117.5
38360, 하동군,020004, 18세,2016,384,213,171,124.6,382,213,169,126
38360, 하동군,020005, 19세,2016,237,159,78,203.8,233,158,75,210.7
38360, 하동군,025,20~24세,2016,1732,1103,629,175.4,1645,1070,575,186.1
38360, 하동군,025001, 20세,2016,382,296,86,344.2,377,293,84,348.8
38360, 하동군,025002, 21세,2016,349,247,102,242.2,341,245,96,255.2
38360, 하동군,025003, 22세,2016,319,190,129,147.3,305,187,118,158.5
38360, 하동군,025004, 23세,2016,339,187,152,123,309,176,133,132.3
38360, 하동군,025005, 24세,2016,343,183,160,114.4,313,169,144,117.4
38360, 하동군,030,25~29세,2016,1682,938,744,126.1,1536,874,662,132
38360, 하동군,030001, 25세,2016,366,216,150,144,336,203,133,152.6
38360, 하동군,030002, 26세,2016,316,166,150,110.7,278,151,127,118.9
38360, 하동군,030003, 27세,2016,343,185,158,117.1,318,172,146,117.8
38360, 하동군,030004, 28세,2016,347,194,153,126.8,314,180,134,134.3
38360, 하동군,030005, 29세,2016,310,177,133,133.1,290,168,122,137.7
38360, 하동군,035,30~34세,2016,1631,889,742,119.8,1546,849,697,121.8
38360, 하동군,035001, 30세,2016,299,163,136,119.9,280,153,127,120.5
38360, 하동군,035002, 31세,2016,256,144,112,128.6,236,135,101,133.7
38360, 하동군,035003, 32세,2016,360,199,161,123.6,343,191,152,125.7
38360, 하동군,035004, 33세,2016,310,165,145,113.8,293,157,136,115.4
38360, 하동군,035005, 34세,2016,406,218,188,116,394,213,181,117.7
38360, 하동군,040,35~39세,2016,1849,984,865,113.8,1792,955,837,114.1
38360, 하동군,040001, 35세,2016,354,189,165,114.5,338,182,156,116.7
38360, 하동군,040002, 36세,2016,366,197,169,116.6,351,188,163,115.3
38360, 하동군,040003, 37세,2016,384,216,168,128.6,374,210,164,128
38360, 하동군,040004, 38세,2016,390,196,194,101,381,191,190,100.5
38360, 하동군,040005, 39세,2016,355,186,169,110.1,348,184,164,112.2
38360, 하동군,045,40~44세,2016,2507,1382,1125,122.8,2471,1366,1105,123.6
38360, 하동군,045001, 40세,2016,421,249,172,144.8,415,246,169,145.6
38360, 하동군,045002, 41세,2016,462,239,223,107.2,451,234,217,107.8
38360, 하동군,045003, 42세,2016,491,266,225,118.2,484,265,219,121
38360, 하동군,045004, 43세,2016,597,325,272,119.5,589,322,267,120.6
38360, 하동군,045005, 44세,2016,536,303,233,130,532,299,233,128.3
38360, 하동군,050,45~49세,2016,3422,1905,1517,125.6,3380,1889,1491,126.7
38360, 하동군,050001, 45세,2016,619,337,282,119.5,613,335,278,120.5
38360, 하동군,050002, 46세,2016,700,395,305,129.5,698,394,304,129.6
38360, 하동군,050003, 47세,2016,692,407,285,142.8,681,402,279,144.1
38360, 하동군,050004, 48세,2016,708,388,320,121.3,696,385,311,123.8
38360, 하동군,050005, 49세,2016,703,378,325,116.3,692,373,319,116.9
38360, 하동군,055,50~54세,2016,3660,1924,1736,110.8,3608,1900,1708,111.2
38360, 하동군,055001, 50세,2016,660,355,305,116.4,647,349,298,117.1
38360, 하동군,055002, 51세,2016,678,344,334,103,672,340,332,102.4
38360, 하동군,055003, 52세,2016,648,336,312,107.7,641,334,307,108.8
38360, 하동군,055004, 53세,2016,763,415,348,119.3,748,408,340,120
38360, 하동군,055005, 54세,2016,911,474,437,108.5,900,469,431,108.8
38360, 하동군,060,55~59세,2016,4424,2266,2158,105,4384,2247,2137,105.1
38360, 하동군,060001, 55세,2016,948,466,482,96.7,945,465,480,96.9
38360, 하동군,060002, 56세,2016,961,510,451,113.1,948,505,443,114
38360, 하동군,060003, 57세,2016,810,413,397,104,801,409,392,104.3
38360, 하동군,060004, 58세,2016,861,453,408,111,851,446,405,110.1
38360, 하동군,060005, 59세,2016,844,424,420,101,839,422,417,101.2
38360, 하동군,065,60~64세,2016,3764,1869,1895,98.6,3741,1860,1881,98.9
38360, 하동군,065001, 60세,2016,819,443,376,117.8,812,441,371,118.9
38360, 하동군,065002, 61세,2016,842,410,432,94.9,840,408,432,94.4
38360, 하동군,065003, 62세,2016,757,376,381,98.7,752,375,377,99.5
38360, 하동군,065004, 63세,2016,655,310,345,89.9,651,309,342,90.4
38360, 하동군,065005, 64세,2016,691,330,361,91.4,686,327,359,91.1
38360, 하동군,070,65~69세,2016,3344,1569,1775,88.4,3335,1566,1769,88.5
38360, 하동군,070001, 65세,2016,647,306,341,89.7,643,305,338,90.2
38360, 하동군,070002, 66세,2016,652,316,336,94,650,314,336,93.5
38360, 하동군,070003, 67세,2016,670,313,357,87.7,667,313,354,88.4
38360, 하동군,070004, 68세,2016,701,332,369,90,701,332,369,90
38360, 하동군,070005, 69세,2016,674,302,372,81.2,674,302,372,81.2
38360, 하동군,075,70~74세,2016,3080,1290,1790,72.1,3078,1289,1789,72.1
38360, 하동군,075001, 70세,2016,523,242,281,86.1,521,241,280,86.1
38360, 하동군,075002, 71세,2016,547,224,323,69.3,547,224,323,69.3
38360, 하동군,075003, 72세,2016,612,256,356,71.9,612,256,356,71.9
38360, 하동군,075004, 73세,2016,605,266,339,78.5,605,266,339,78.5
38360, 하동군,075005, 74세,2016,793,302,491,61.5,793,302,491,61.5
38360, 하동군,080,75~79세,2016,3242,1205,2037,59.2,3240,1205,2035,59.2
38360, 하동군,080001, 75세,2016,647,256,391,65.5,647,256,391,65.5
38360, 하동군,080002, 76세,2016,686,249,437,57,686,249,437,57
38360, 하동군,080003, 77세,2016,728,272,456,59.6,727,272,455,59.8
38360, 하동군,080004, 78세,2016,566,203,363,55.9,566,203,363,55.9
38360, 하동군,080005, 79세,2016,615,225,390,57.7,614,225,389,57.8
38360, 하동군,085,80~84세,2016,2335,731,1604,45.6,2335,731,1604,45.6
38360, 하동군,085001, 80세,2016,569,183,386,47.4,569,183,386,47.4
38360, 하동군,085002, 81세,2016,546,171,375,45.6,546,171,375,45.6
38360, 하동군,085003, 82세,2016,474,157,317,49.5,474,157,317,49.5
38360, 하동군,085004, 83세,2016,353,104,249,41.8,353,104,249,41.8
38360, 하동군,085005, 84세,2016,393,116,277,41.9,393,116,277,41.9
38360, 하동군,090,85~89세,2016,1182,317,865,36.6,1182,317,865,36.6
38360, 하동군,090001, 85세,2016,340,102,238,42.9,340,102,238,42.9
38360, 하동군,090002, 86세,2016,273,69,204,33.8,273,69,204,33.8
38360, 하동군,090003, 87세,2016,217,54,163,33.1,217,54,163,33.1
38360, 하동군,090004, 88세,2016,171,43,128,33.6,171,43,128,33.6
38360, 하동군,090005, 89세,2016,181,49,132,37.1,181,49,132,37.1
38360, 하동군,095,90~94세,2016,349,74,275,26.9,349,74,275,26.9
38360, 하동군,095001, 90세,2016,118,27,91,29.7,118,27,91,29.7
38360, 하동군,095002, 91세,2016,88,12,76,15.8,88,12,76,15.8
38360, 하동군,095003, 92세,2016,57,16,41,39,57,16,41,39
38360, 하동군,095004, 93세,2016,57,10,47,21.3,57,10,47,21.3
38360, 하동군,095005, 94세,2016,29,9,20,45,29,9,20,45
38360, 하동군,100,95~99세,2016,65,16,49,32.7,65,16,49,32.7
38360, 하동군,100001, 95세,2016,22,8,14,57.1,22,8,14,57.1
38360, 하동군,100002, 96세,2016,17,X,13,30.8,17,X,13,30.8
38360, 하동군,100003, 97세,2016,13,X,11,18.2,13,X,11,18.2
38360, 하동군,100004, 98세,2016,7,X,5,40,7,X,5,40
38360, 하동군,100005, 99세,2016,6,X,6,0,6,X,6,0
38360, 하동군,101,100세이상,2016,10,X,9,11.1,10,X,9,11.1
38360, 하동군,102,15세미만,2016,3890,2052,1838,111.6,3889,2051,1838,111.6
38360, 하동군,103,15~64세,2016,26430,14244,12186,116.9,25854,13992,11862,118
38360, 하동군,104,65세이상,2016,13607,5203,8404,61.9,13594,5199,8395,61.9
38360, 하동군,086,85세이상,2016,1606,408,1198,34.1,1606,408,1198,34.1
38360, 하동군,126,평균연령,2016,51.4,48.2,54.4,,51.6,48.3,54.6,
38360, 하동군,127,중위연령,2016,54.8,51.5,57.8,,55.1,51.7,58.1,
38370, 산청군,000,합계,2016,33765,16262,17503,92.9,33087,15938,17149,92.9
38370, 산청군,005,0~4세,2016,921,493,428,115.2,916,489,427,114.5
38370, 산청군,005001, 0세,2016,195,92,103,89.3,195,92,103,89.3
38370, 산청군,005002, 1세,2016,208,122,86,141.9,208,122,86,141.9
38370, 산청군,005003, 2세,2016,166,88,78,112.8,165,87,78,111.5
38370, 산청군,005004, 3세,2016,177,94,83,113.3,175,93,82,113.4
38370, 산청군,005005, 4세,2016,175,97,78,124.4,173,95,78,121.8
38370, 산청군,010,5~9세,2016,899,497,402,123.6,895,496,399,124.3
38370, 산청군,010001, 5세,2016,170,105,65,161.5,170,105,65,161.5
38370, 산청군,010002, 6세,2016,177,97,80,121.3,177,97,80,121.3
38370, 산청군,010003, 7세,2016,163,85,78,109,161,85,76,111.8
38370, 산청군,010004, 8세,2016,171,104,67,155.2,171,104,67,155.2
38370, 산청군,010005, 9세,2016,218,106,112,94.6,216,105,111,94.6
38370, 산청군,015,10~14세,2016,1004,514,490,104.9,1003,514,489,105.1
38370, 산청군,015001, 10세,2016,177,90,87,103.4,177,90,87,103.4
38370, 산청군,015002, 11세,2016,201,96,105,91.4,201,96,105,91.4
38370, 산청군,015003, 12세,2016,174,93,81,114.8,174,93,81,114.8
38370, 산청군,015004, 13세,2016,218,118,100,118,217,118,99,119.2
38370, 산청군,015005, 14세,2016,234,117,117,100,234,117,117,100
38370, 산청군,020,15~19세,2016,1412,698,714,97.8,1407,697,710,98.2
38370, 산청군,020001, 15세,2016,240,129,111,116.2,239,129,110,117.3
38370, 산청군,020002, 16세,2016,323,145,178,81.5,322,145,177,81.9
38370, 산청군,020003, 17세,2016,347,158,189,83.6,346,157,189,83.1
38370, 산청군,020004, 18세,2016,309,156,153,102,307,156,151,103.3
38370, 산청군,020005, 19세,2016,193,110,83,132.5,193,110,83,132.5
38370, 산청군,025,20~24세,2016,1162,687,475,144.6,1052,655,397,165
38370, 산청군,025001, 20세,2016,215,148,67,220.9,208,148,60,246.7
38370, 산청군,025002, 21세,2016,249,166,83,200,233,162,71,228.2
38370, 산청군,025003, 22세,2016,236,141,95,148.4,220,137,83,165.1
38370, 산청군,025004, 23세,2016,234,114,120,95,201,105,96,109.4
38370, 산청군,025005, 24세,2016,228,118,110,107.3,190,103,87,118.4
38370, 산청군,030,25~29세,2016,1245,654,591,110.7,1042,560,482,116.2
38370, 산청군,030001, 25세,2016,251,123,128,96.1,206,107,99,108.1
38370, 산청군,030002, 26세,2016,233,121,112,108,195,106,89,119.1
38370, 산청군,030003, 27세,2016,262,132,130,101.5,228,115,113,101.8
38370, 산청군,030004, 28세,2016,266,156,110,141.8,219,131,88,148.9
38370, 산청군,030005, 29세,2016,233,122,111,109.9,194,101,93,108.6
38370, 산청군,035,30~34세,2016,1269,676,593,114,1159,619,540,114.6
38370, 산청군,035001, 30세,2016,217,109,108,100.9,185,98,87,112.6
38370, 산청군,035002, 31세,2016,253,138,115,120,227,124,103,120.4
38370, 산청군,035003, 32세,2016,248,136,112,121.4,223,120,103,116.5
38370, 산청군,035004, 33세,2016,253,129,124,104,242,123,119,103.4
38370, 산청군,035005, 34세,2016,298,164,134,122.4,282,154,128,120.3
38370, 산청군,040,35~39세,2016,1393,792,601,131.8,1328,747,581,128.6
38370, 산청군,040001, 35세,2016,304,183,121,151.2,283,168,115,146.1
38370, 산청군,040002, 36세,2016,288,162,126,128.6,272,150,122,123
38370, 산청군,040003, 37세,2016,276,148,128,115.6,266,142,124,114.5
38370, 산청군,040004, 38세,2016,265,157,108,145.4,252,147,105,140
38370, 산청군,040005, 39세,2016,260,142,118,120.3,255,140,115,121.7
38370, 산청군,045,40~44세,2016,1630,906,724,125.1,1596,886,710,124.8
38370, 산청군,045001, 40세,2016,242,132,110,120,235,127,108,117.6
38370, 산청군,045002, 41세,2016,290,155,135,114.8,283,149,134,111.2
38370, 산청군,045003, 42세,2016,349,192,157,122.3,345,191,154,124
38370, 산청군,045004, 43세,2016,386,208,178,116.9,376,204,172,118.6
38370, 산청군,045005, 44세,2016,363,219,144,152.1,357,215,142,151.4
38370, 산청군,050,45~49세,2016,2461,1339,1122,119.3,2430,1324,1106,119.7
38370, 산청군,050001, 45세,2016,423,246,177,139,418,244,174,140.2
38370, 산청군,050002, 46세,2016,494,262,232,112.9,482,256,226,113.3
38370, 산청군,050003, 47세,2016,521,295,226,130.5,513,290,223,130
38370, 산청군,050004, 48세,2016,502,262,240,109.2,498,261,237,110.1
38370, 산청군,050005, 49세,2016,521,274,247,110.9,519,273,246,111
38370, 산청군,055,50~54세,2016,2739,1494,1245,120,2701,1471,1230,119.6
38370, 산청군,055001, 50세,2016,535,309,226,136.7,527,304,223,136.3
38370, 산청군,055002, 51세,2016,541,290,251,115.5,532,287,245,117.1
38370, 산청군,055003, 52세,2016,469,252,217,116.1,465,248,217,114.3
38370, 산청군,055004, 53세,2016,537,295,242,121.9,527,288,239,120.5
38370, 산청군,055005, 54세,2016,657,348,309,112.6,650,344,306,112.4
38370, 산청군,060,55~59세,2016,3374,1713,1661,103.1,3346,1704,1642,103.8
38370, 산청군,060001, 55세,2016,763,395,368,107.3,756,392,364,107.7
38370, 산청군,060002, 56세,2016,708,358,350,102.3,700,353,347,101.7
38370, 산청군,060003, 57세,2016,612,295,317,93.1,608,295,313,94.2
38370, 산청군,060004, 58세,2016,653,341,312,109.3,647,341,306,111.4
38370, 산청군,060005, 59세,2016,638,324,314,103.2,635,323,312,103.5
38370, 산청군,065,60~64세,2016,3090,1530,1560,98.1,3064,1515,1549,97.8
38370, 산청군,065001, 60세,2016,653,329,324,101.5,647,326,321,101.6
38370, 산청군,065002, 61세,2016,691,345,346,99.7,683,341,342,99.7
38370, 산청군,065003, 62세,2016,623,299,324,92.3,618,296,322,91.9
38370, 산청군,065004, 63세,2016,543,267,276,96.7,542,266,276,96.4
38370, 산청군,065005, 64세,2016,580,290,290,100,574,286,288,99.3
38370, 산청군,070,65~69세,2016,2604,1315,1289,102,2591,1308,1283,101.9
38370, 산청군,070001, 65세,2016,479,242,237,102.1,477,241,236,102.1
38370, 산청군,070002, 66세,2016,501,241,260,92.7,498,239,259,92.3
38370, 산청군,070003, 67세,2016,522,279,243,114.8,516,275,241,114.1
38370, 산청군,070004, 68세,2016,547,290,257,112.8,547,290,257,112.8
38370, 산청군,070005, 69세,2016,555,263,292,90.1,553,263,290,90.7
38370, 산청군,075,70~74세,2016,2551,1028,1523,67.5,2548,1027,1521,67.5
38370, 산청군,075001, 70세,2016,424,183,241,75.9,423,183,240,76.3
38370, 산청군,075002, 71세,2016,446,182,264,68.9,444,181,263,68.8
38370, 산청군,075003, 72세,2016,515,213,302,70.5,515,213,302,70.5
38370, 산청군,075004, 73세,2016,505,191,314,60.8,505,191,314,60.8
38370, 산청군,075005, 74세,2016,661,259,402,64.4,661,259,402,64.4
38370, 산청군,080,75~79세,2016,2791,999,1792,55.7,2789,999,1790,55.8
38370, 산청군,080001, 75세,2016,592,233,359,64.9,592,233,359,64.9
38370, 산청군,080002, 76세,2016,577,200,377,53.1,576,200,376,53.2
38370, 산청군,080003, 77세,2016,562,205,357,57.4,562,205,357,57.4
38370, 산청군,080004, 78세,2016,568,199,369,53.9,568,199,369,53.9
38370, 산청군,080005, 79세,2016,492,162,330,49.1,491,162,329,49.2
38370, 산청군,085,80~84세,2016,1976,624,1352,46.2,1976,624,1352,46.2
38370, 산청군,085001, 80세,2016,485,157,328,47.9,485,157,328,47.9
38370, 산청군,085002, 81세,2016,454,147,307,47.9,454,147,307,47.9
38370, 산청군,085003, 82세,2016,383,118,265,44.5,383,118,265,44.5
38370, 산청군,085004, 83세,2016,343,102,241,42.3,343,102,241,42.3
38370, 산청군,085005, 84세,2016,311,100,211,47.4,311,100,211,47.4
38370, 산청군,090,85~89세,2016,902,232,670,34.6,902,232,670,34.6
38370, 산청군,090001, 85세,2016,237,64,173,37,237,64,173,37
38370, 산청군,090002, 86세,2016,211,46,165,27.9,211,46,165,27.9
38370, 산청군,090003, 87세,2016,186,62,124,50,186,62,124,50
38370, 산청군,090004, 88세,2016,154,34,120,28.3,154,34,120,28.3
38370, 산청군,090005, 89세,2016,114,26,88,29.5,114,26,88,29.5
38370, 산청군,095,90~94세,2016,280,60,220,27.3,280,60,220,27.3
38370, 산청군,095001, 90세,2016,72,16,56,28.6,72,16,56,28.6
38370, 산청군,095002, 91세,2016,82,12,70,17.1,82,12,70,17.1
38370, 산청군,095003, 92세,2016,41,13,28,46.4,41,13,28,46.4
38370, 산청군,095004, 93세,2016,53,10,43,23.3,53,10,43,23.3
38370, 산청군,095005, 94세,2016,32,9,23,39.1,32,9,23,39.1
38370, 산청군,100,95~99세,2016,55,9,46,19.6,55,9,46,19.6
38370, 산청군,100001, 95세,2016,21,X,18,16.7,21,X,18,16.7
38370, 산청군,100002, 96세,2016,15,X,12,25,15,X,12,25
38370, 산청군,100003, 97세,2016,8,X,7,14.3,8,X,7,14.3
38370, 산청군,100004, 98세,2016,7,X,6,16.7,7,X,6,16.7
38370, 산청군,100005, 99세,2016,X,X,X,33.3,X,X,X,33.3
38370, 산청군,101,100세이상,2016,7,X,5,40,7,X,5,40
38370, 산청군,102,15세미만,2016,2824,1504,1320,113.9,2814,1499,1315,114
38370, 산청군,103,15~64세,2016,19775,10489,9286,113,19125,10178,8947,113.8
38370, 산청군,104,65세이상,2016,11166,4269,6897,61.9,11148,4261,6887,61.9
38370, 산청군,086,85세이상,2016,1244,303,941,32.2,1244,303,941,32.2
38370, 산청군,126,평균연령,2016,52.4,49.3,55.2,,52.7,49.6,55.6,
38370, 산청군,127,중위연령,2016,56,53.1,59.1,,56.4,53.5,59.6,
38380, 함양군,000,합계,2016,38076,18167,19909,91.3,37566,17925,19641,91.3
38380, 함양군,005,0~4세,2016,1047,539,508,106.1,1046,539,507,106.3
38380, 함양군,005001, 0세,2016,180,92,88,104.5,179,92,87,105.7
38380, 함양군,005002, 1세,2016,204,95,109,87.2,204,95,109,87.2
38380, 함양군,005003, 2세,2016,203,102,101,101,203,102,101,101
38380, 함양군,005004, 3세,2016,226,118,108,109.3,226,118,108,109.3
38380, 함양군,005005, 4세,2016,234,132,102,129.4,234,132,102,129.4
38380, 함양군,010,5~9세,2016,1287,668,619,107.9,1282,665,617,107.8
38380, 함양군,010001, 5세,2016,214,108,106,101.9,212,106,106,100
38380, 함양군,010002, 6세,2016,269,144,125,115.2,268,144,124,116.1
38380, 함양군,010003, 7세,2016,235,115,120,95.8,235,115,120,95.8
38380, 함양군,010004, 8세,2016,283,145,138,105.1,281,144,137,105.1
38380, 함양군,010005, 9세,2016,286,156,130,120,286,156,130,120
38380, 함양군,015,10~14세,2016,1415,737,678,108.7,1411,736,675,109
38380, 함양군,015001, 10세,2016,283,148,135,109.6,282,147,135,108.9
38380, 함양군,015002, 11세,2016,272,144,128,112.5,271,144,127,113.4
38380, 함양군,015003, 12세,2016,277,153,124,123.4,277,153,124,123.4
38380, 함양군,015004, 13세,2016,286,143,143,100,284,143,141,101.4
38380, 함양군,015005, 14세,2016,297,149,148,100.7,297,149,148,100.7
38380, 함양군,020,15~19세,2016,1826,946,880,107.5,1823,945,878,107.6
38380, 함양군,020001, 15세,2016,385,197,188,104.8,385,197,188,104.8
38380, 함양군,020002, 16세,2016,458,218,240,90.8,458,218,240,90.8
38380, 함양군,020003, 17세,2016,384,183,201,91,383,183,200,91.5
38380, 함양군,020004, 18세,2016,363,196,167,117.4,363,196,167,117.4
38380, 함양군,020005, 19세,2016,236,152,84,181,234,151,83,181.9
38380, 함양군,025,20~24세,2016,1359,813,546,148.9,1315,798,517,154.4
38380, 함양군,025001, 20세,2016,301,196,105,186.7,299,195,104,187.5
38380, 함양군,025002, 21세,2016,303,211,92,229.3,296,210,86,244.2
38380, 함양군,025003, 22세,2016,271,157,114,137.7,263,155,108,143.5
38380, 함양군,025004, 23세,2016,239,119,120,99.2,223,113,110,102.7
38380, 함양군,025005, 24세,2016,245,130,115,113,234,125,109,114.7
38380, 함양군,030,25~29세,2016,1235,647,588,110,1152,609,543,112.2
38380, 함양군,030001, 25세,2016,253,127,126,100.8,236,120,116,103.4
38380, 함양군,030002, 26세,2016,260,139,121,114.9,238,129,109,118.3
38380, 함양군,030003, 27세,2016,217,110,107,102.8,204,103,101,102
38380, 함양군,030004, 28세,2016,262,149,113,131.9,242,138,104,132.7
38380, 함양군,030005, 29세,2016,243,122,121,100.8,232,119,113,105.3
38380, 함양군,035,30~34세,2016,1447,757,690,109.7,1347,694,653,106.3
38380, 함양군,035001, 30세,2016,257,147,110,133.6,237,136,101,134.7
38380, 함양군,035002, 31세,2016,302,166,136,122.1,274,147,127,115.7
38380, 함양군,035003, 32세,2016,261,132,129,102.3,238,116,122,95.1
38380, 함양군,035004, 33세,2016,302,158,144,109.7,286,148,138,107.2
38380, 함양군,035005, 34세,2016,325,154,171,90.1,312,147,165,89.1
38380, 함양군,040,35~39세,2016,1758,932,826,112.8,1691,897,794,113
38380, 함양군,040001, 35세,2016,346,204,142,143.7,333,196,137,143.1
38380, 함양군,040002, 36세,2016,355,180,175,102.9,341,172,169,101.8
38380, 함양군,040003, 37세,2016,355,185,170,108.8,339,175,164,106.7
38380, 함양군,040004, 38세,2016,344,175,169,103.6,333,173,160,108.1
38380, 함양군,040005, 39세,2016,358,188,170,110.6,345,181,164,110.4
38380, 함양군,045,40~44세,2016,2139,1199,940,127.6,2100,1183,917,129
38380, 함양군,045001, 40세,2016,335,172,163,105.5,323,167,156,107.1
38380, 함양군,045002, 41세,2016,420,236,184,128.3,408,232,176,131.8
38380, 함양군,045003, 42세,2016,447,257,190,135.3,441,256,185,138.4
38380, 함양군,045004, 43세,2016,486,274,212,129.2,479,269,210,128.1
38380, 함양군,045005, 44세,2016,451,260,191,136.1,449,259,190,136.3
38380, 함양군,050,45~49세,2016,2915,1583,1332,118.8,2869,1564,1305,119.8
38380, 함양군,050001, 45세,2016,554,313,241,129.9,549,311,238,130.7
38380, 함양군,050002, 46세,2016,572,311,261,119.2,561,305,256,119.1
38380, 함양군,050003, 47세,2016,619,319,300,106.3,608,317,291,108.9
38380, 함양군,050004, 48세,2016,607,339,268,126.5,600,334,266,125.6
38380, 함양군,050005, 49세,2016,563,301,262,114.9,551,297,254,116.9
38380, 함양군,055,50~54세,2016,3025,1632,1393,117.2,2985,1614,1371,117.7
38380, 함양군,055001, 50세,2016,540,298,242,123.1,536,295,241,122.4
38380, 함양군,055002, 51세,2016,641,367,274,133.9,638,366,272,134.6
38380, 함양군,055003, 52세,2016,581,308,273,112.8,570,305,265,115.1
38380, 함양군,055004, 53세,2016,584,307,277,110.8,572,300,272,110.3
38380, 함양군,055005, 54세,2016,679,352,327,107.6,669,348,321,108.4
38380, 함양군,060,55~59세,2016,3577,1788,1789,99.9,3548,1775,1773,100.1
38380, 함양군,060001, 55세,2016,774,393,381,103.1,766,391,375,104.3
38380, 함양군,060002, 56세,2016,788,397,391,101.5,780,393,387,101.6
38380, 함양군,060003, 57세,2016,690,359,331,108.5,685,355,330,107.6
38380, 함양군,060004, 58세,2016,628,292,336,86.9,625,291,334,87.1
38380, 함양군,060005, 59세,2016,697,347,350,99.1,692,345,347,99.4
38380, 함양군,065,60~64세,2016,3220,1542,1678,91.9,3190,1531,1659,92.3
38380, 함양군,065001, 60세,2016,737,340,397,85.6,731,339,392,86.5
38380, 함양군,065002, 61세,2016,735,356,379,93.9,729,353,376,93.9
38380, 함양군,065003, 62세,2016,574,280,294,95.2,569,279,290,96.2
38380, 함양군,065004, 63세,2016,511,248,263,94.3,507,245,262,93.5
38380, 함양군,065005, 64세,2016,663,318,345,92.2,654,315,339,92.9
38380, 함양군,070,65~69세,2016,2784,1274,1510,84.4,2774,1271,1503,84.6
38380, 함양군,070001, 65세,2016,497,224,273,82.1,493,224,269,83.3
38380, 함양군,070002, 66세,2016,538,253,285,88.8,536,252,284,88.7
38380, 함양군,070003, 67세,2016,585,287,298,96.3,582,285,297,96
38380, 함양군,070004, 68세,2016,581,266,315,84.4,581,266,315,84.4
38380, 함양군,070005, 69세,2016,583,244,339,72,582,244,338,72.2
38380, 함양군,075,70~74세,2016,2691,1043,1648,63.3,2686,1038,1648,63
38380, 함양군,075001, 70세,2016,434,190,244,77.9,433,189,244,77.5
38380, 함양군,075002, 71세,2016,458,177,281,63,457,176,281,62.6
38380, 함양군,075003, 72세,2016,544,223,321,69.5,542,221,321,68.8
38380, 함양군,075004, 73세,2016,552,172,380,45.3,551,171,380,45
38380, 함양군,075005, 74세,2016,703,281,422,66.6,703,281,422,66.6
38380, 함양군,080,75~79세,2016,3052,1174,1878,62.5,3050,1174,1876,62.6
38380, 함양군,080001, 75세,2016,635,246,389,63.2,635,246,389,63.2
38380, 함양군,080002, 76세,2016,632,251,381,65.9,631,251,380,66.1
38380, 함양군,080003, 77세,2016,644,242,402,60.2,644,242,402,60.2
38380, 함양군,080004, 78세,2016,571,211,360,58.6,571,211,360,58.6
38380, 함양군,080005, 79세,2016,570,224,346,64.7,569,224,345,64.9
38380, 함양군,085,80~84세,2016,1953,572,1381,41.4,1952,572,1380,41.4
38380, 함양군,085001, 80세,2016,500,160,340,47.1,500,160,340,47.1
38380, 함양군,085002, 81세,2016,434,126,308,40.9,434,126,308,40.9
38380, 함양군,085003, 82세,2016,418,132,286,46.2,418,132,286,46.2
38380, 함양군,085004, 83세,2016,312,73,239,30.5,312,73,239,30.5
38380, 함양군,085005, 84세,2016,289,81,208,38.9,288,81,207,39.1
38380, 함양군,090,85~89세,2016,968,229,739,31,967,228,739,30.9
38380, 함양군,090001, 85세,2016,274,70,204,34.3,273,69,204,33.8
38380, 함양군,090002, 86세,2016,230,50,180,27.8,230,50,180,27.8
38380, 함양군,090003, 87세,2016,167,44,123,35.8,167,44,123,35.8
38380, 함양군,090004, 88세,2016,155,34,121,28.1,155,34,121,28.1
38380, 함양군,090005, 89세,2016,142,31,111,27.9,142,31,111,27.9
38380, 함양군,095,90~94세,2016,317,82,235,34.9,317,82,235,34.9
38380, 함양군,095001, 90세,2016,92,28,64,43.8,92,28,64,43.8
38380, 함양군,095002, 91세,2016,79,17,62,27.4,79,17,62,27.4
38380, 함양군,095003, 92세,2016,56,14,42,33.3,56,14,42,33.3
38380, 함양군,095004, 93세,2016,59,15,44,34.1,59,15,44,34.1
38380, 함양군,095005, 94세,2016,31,8,23,34.8,31,8,23,34.8
38380, 함양군,100,95~99세,2016,53,8,45,17.8,53,8,45,17.8
38380, 함양군,100001, 95세,2016,17,X,14,21.4,17,X,14,21.4
38380, 함양군,100002, 96세,2016,14,X,12,16.7,14,X,12,16.7
38380, 함양군,100003, 97세,2016,10,X,8,25,10,X,8,25
38380, 함양군,100004, 98세,2016,5,X,5,0,5,X,5,0
38380, 함양군,100005, 99세,2016,7,X,6,16.7,7,X,6,16.7
38380, 함양군,101,100세이상,2016,8,X,6,33.3,8,X,6,33.3
38380, 함양군,102,15세미만,2016,3749,1944,1805,107.7,3739,1940,1799,107.8
38380, 함양군,103,15~64세,2016,22501,11839,10662,111,22020,11610,10410,111.5
38380, 함양군,104,65세이상,2016,11826,4384,7442,58.9,11807,4375,7432,58.9
38380, 함양군,086,85세이상,2016,1346,321,1025,31.3,1345,320,1025,31.2
38380, 함양군,126,평균연령,2016,50.8,47.7,53.6,,51,47.8,53.8,
38380, 함양군,127,중위연령,2016,54.4,50.9,57.5,,54.6,51.1,57.9,
38390, 거창군,000,합계,2016,60658,29778,30880,96.4,60081,29487,30594,96.4
38390, 거창군,005,0~4세,2016,2032,1050,982,106.9,2030,1050,980,107.1
38390, 거창군,005001, 0세,2016,355,193,162,119.1,354,193,161,119.9
38390, 거창군,005002, 1세,2016,367,178,189,94.2,366,178,188,94.7
38390, 거창군,005003, 2세,2016,413,211,202,104.5,413,211,202,104.5
38390, 거창군,005004, 3세,2016,425,214,211,101.4,425,214,211,101.4
38390, 거창군,005005, 4세,2016,472,254,218,116.5,472,254,218,116.5
38390, 거창군,010,5~9세,2016,2445,1281,1164,110.1,2443,1279,1164,109.9
38390, 거창군,010001, 5세,2016,501,269,232,115.9,500,268,232,115.5
38390, 거창군,010002, 6세,2016,448,245,203,120.7,448,245,203,120.7
38390, 거창군,010003, 7세,2016,491,256,235,108.9,491,256,235,108.9
38390, 거창군,010004, 8세,2016,496,252,244,103.3,495,251,244,102.9
38390, 거창군,010005, 9세,2016,509,259,250,103.6,509,259,250,103.6
38390, 거창군,015,10~14세,2016,2609,1372,1237,110.9,2604,1369,1235,110.9
38390, 거창군,015001, 10세,2016,427,219,208,105.3,427,219,208,105.3
38390, 거창군,015002, 11세,2016,498,261,237,110.1,497,260,237,109.7
38390, 거창군,015003, 12세,2016,539,284,255,111.4,537,283,254,111.4
38390, 거창군,015004, 13세,2016,537,293,244,120.1,536,292,244,119.7
38390, 거창군,015005, 14세,2016,608,315,293,107.5,607,315,292,107.9
38390, 거창군,020,15~19세,2016,4203,2417,1786,135.3,4192,2412,1780,135.5
38390, 거창군,020001, 15세,2016,671,356,315,113,669,355,314,113.1
38390, 거창군,020002, 16세,2016,983,496,487,101.8,983,496,487,101.8
38390, 거창군,020003, 17세,2016,949,553,396,139.6,949,553,396,139.6
38390, 거창군,020004, 18세,2016,868,526,342,153.8,866,524,342,153.2
38390, 거창군,020005, 19세,2016,732,486,246,197.6,725,484,241,200.8
38390, 거창군,025,20~24세,2016,3215,2066,1149,179.8,3162,2043,1119,182.6
38390, 거창군,025001, 20세,2016,644,398,246,161.8,639,397,242,164
38390, 거창군,025002, 21세,2016,725,502,223,225.1,720,500,220,227.3
38390, 거창군,025003, 22세,2016,695,486,209,232.5,685,481,204,235.8
38390, 거창군,025004, 23세,2016,642,401,241,166.4,628,396,232,170.7
38390, 거창군,025005, 24세,2016,509,279,230,121.3,490,269,221,121.7
38390, 거창군,030,25~29세,2016,2298,1264,1034,122.2,2178,1209,969,124.8
38390, 거창군,030001, 25세,2016,479,284,195,145.6,449,268,181,148.1
38390, 거창군,030002, 26세,2016,456,243,213,114.1,434,235,199,118.1
38390, 거창군,030003, 27세,2016,440,244,196,124.5,421,235,186,126.3
38390, 거창군,030004, 28세,2016,433,244,189,129.1,410,229,181,126.5
38390, 거창군,030005, 29세,2016,490,249,241,103.3,464,242,222,109
38390, 거창군,035,30~34세,2016,2607,1345,1262,106.6,2502,1278,1224,104.4
38390, 거창군,035001, 30세,2016,501,264,237,111.4,468,248,220,112.7
38390, 거창군,035002, 31세,2016,449,227,222,102.3,428,213,215,99.1
38390, 거창군,035003, 32세,2016,482,255,227,112.3,467,245,222,110.4
38390, 거창군,035004, 33세,2016,574,299,275,108.7,555,284,271,104.8
38390, 거창군,035005, 34세,2016,601,300,301,99.7,584,288,296,97.3
38390, 거창군,040,35~39세,2016,3097,1566,1531,102.3,3027,1519,1508,100.7
38390, 거창군,040001, 35세,2016,636,332,304,109.2,621,320,301,106.3
38390, 거창군,040002, 36세,2016,655,312,343,91,634,300,334,89.8
38390, 거창군,040003, 37세,2016,621,328,293,111.9,608,319,289,110.4
38390, 거창군,040004, 38세,2016,569,285,284,100.4,559,280,279,100.4
38390, 거창군,040005, 39세,2016,616,309,307,100.7,605,300,305,98.4
38390, 거창군,045,40~44세,2016,3743,1907,1836,103.9,3713,1893,1820,104
38390, 거창군,045001, 40세,2016,660,333,327,101.8,654,331,323,102.5
38390, 거창군,045002, 41세,2016,663,335,328,102.1,661,334,327,102.1
38390, 거창군,045003, 42세,2016,772,411,361,113.9,767,410,357,114.8
38390, 거창군,045004, 43세,2016,862,416,446,93.3,855,410,445,92.1
38390, 거창군,045005, 44세,2016,786,412,374,110.2,776,408,368,110.9
38390, 거창군,050,45~49세,2016,4772,2454,2318,105.9,4723,2436,2287,106.5
38390, 거창군,050001, 45세,2016,922,480,442,108.6,914,476,438,108.7
38390, 거창군,050002, 46세,2016,958,502,456,110.1,945,496,449,110.5
38390, 거창군,050003, 47세,2016,954,497,457,108.8,942,494,448,110.3
38390, 거창군,050004, 48세,2016,1033,517,516,100.2,1023,514,509,101
38390, 거창군,050005, 49세,2016,905,458,447,102.5,899,456,443,102.9
38390, 거창군,055,50~54세,2016,4774,2492,2282,109.2,4713,2466,2247,109.7
38390, 거창군,055001, 50세,2016,949,497,452,110,941,492,449,109.6
38390, 거창군,055002, 51세,2016,963,471,492,95.7,946,466,480,97.1
38390, 거창군,055003, 52세,2016,852,459,393,116.8,840,457,383,119.3
38390, 거창군,055004, 53세,2016,931,508,423,120.1,916,499,417,119.7
38390, 거창군,055005, 54세,2016,1079,557,522,106.7,1070,552,518,106.6
38390, 거창군,060,55~59세,2016,5399,2650,2749,96.4,5361,2631,2730,96.4
38390, 거창군,060001, 55세,2016,1168,574,594,96.6,1161,570,591,96.4
38390, 거창군,060002, 56세,2016,1139,566,573,98.8,1132,564,568,99.3
38390, 거창군,060003, 57세,2016,1097,525,572,91.8,1092,522,570,91.6
38390, 거창군,060004, 58세,2016,973,473,500,94.6,963,468,495,94.5
38390, 거창군,060005, 59세,2016,1022,512,510,100.4,1013,507,506,100.2
38390, 거창군,065,60~64세,2016,4531,2201,2330,94.5,4513,2195,2318,94.7
38390, 거창군,065001, 60세,2016,988,483,505,95.6,985,481,504,95.4
38390, 거창군,065002, 61세,2016,983,511,472,108.3,975,508,467,108.8
38390, 거창군,065003, 62세,2016,870,415,455,91.2,869,415,454,91.4
38390, 거창군,065004, 63세,2016,799,377,422,89.3,794,376,418,90
38390, 거창군,065005, 64세,2016,891,415,476,87.2,890,415,475,87.4
38390, 거창군,070,65~69세,2016,3677,1692,1985,85.2,3668,1687,1981,85.2
38390, 거창군,070001, 65세,2016,655,302,353,85.6,654,302,352,85.8
38390, 거창군,070002, 66세,2016,689,318,371,85.7,687,317,370,85.7
38390, 거창군,070003, 67세,2016,808,380,428,88.8,804,377,427,88.3
38390, 거창군,070004, 68세,2016,815,362,453,79.9,814,362,452,80.1
38390, 거창군,070005, 69세,2016,710,330,380,86.8,709,329,380,86.6
38390, 거창군,075,70~74세,2016,3381,1345,2036,66.1,3380,1345,2035,66.1
38390, 거창군,075001, 70세,2016,577,257,320,80.3,577,257,320,80.3
38390, 거창군,075002, 71세,2016,574,233,341,68.3,574,233,341,68.3
38390, 거창군,075003, 72세,2016,688,256,432,59.3,688,256,432,59.3
38390, 거창군,075004, 73세,2016,702,283,419,67.5,701,283,418,67.7
38390, 거창군,075005, 74세,2016,840,316,524,60.3,840,316,524,60.3
38390, 거창군,080,75~79세,2016,3710,1403,2307,60.8,3709,1403,2306,60.8
38390, 거창군,080001, 75세,2016,765,306,459,66.7,765,306,459,66.7
38390, 거창군,080002, 76세,2016,779,301,478,63,779,301,478,63
38390, 거창군,080003, 77세,2016,820,310,510,60.8,820,310,510,60.8
38390, 거창군,080004, 78세,2016,704,268,436,61.5,703,268,435,61.6
38390, 거창군,080005, 79세,2016,642,218,424,51.4,642,218,424,51.4
38390, 거창군,085,80~84세,2016,2518,822,1696,48.5,2518,822,1696,48.5
38390, 거창군,085001, 80세,2016,659,235,424,55.4,659,235,424,55.4
38390, 거창군,085002, 81세,2016,551,167,384,43.5,551,167,384,43.5
38390, 거창군,085003, 82세,2016,493,168,325,51.7,493,168,325,51.7
38390, 거창군,085004, 83세,2016,477,160,317,50.5,477,160,317,50.5
38390, 거창군,085005, 84세,2016,338,92,246,37.4,338,92,246,37.4
38390, 거창군,090,85~89세,2016,1202,347,855,40.6,1202,347,855,40.6
38390, 거창군,090001, 85세,2016,326,108,218,49.5,326,108,218,49.5
38390, 거창군,090002, 86세,2016,287,75,212,35.4,287,75,212,35.4
38390, 거창군,090003, 87세,2016,238,61,177,34.5,238,61,177,34.5
38390, 거창군,090004, 88세,2016,179,55,124,44.4,179,55,124,44.4
38390, 거창군,090005, 89세,2016,172,48,124,38.7,172,48,124,38.7
38390, 거창군,095,90~94세,2016,354,82,272,30.1,354,82,272,30.1
38390, 거창군,095001, 90세,2016,111,25,86,29.1,111,25,86,29.1
38390, 거창군,095002, 91세,2016,88,19,69,27.5,88,19,69,27.5
38390, 거창군,095003, 92세,2016,64,22,42,52.4,64,22,42,52.4
38390, 거창군,095004, 93세,2016,52,14,38,36.8,52,14,38,36.8
38390, 거창군,095005, 94세,2016,39,X,37,5.4,39,X,37,5.4
38390, 거창군,100,95~99세,2016,80,19,61,31.1,80,19,61,31.1
38390, 거창군,100001, 95세,2016,28,8,20,40,28,8,20,40
38390, 거창군,100002, 96세,2016,27,5,22,22.7,27,5,22,22.7
38390, 거창군,100003, 97세,2016,11,X,8,37.5,11,X,8,37.5
38390, 거창군,100004, 98세,2016,6,X,X,50,6,X,X,50
38390, 거창군,100005, 99세,2016,8,X,7,14.3,8,X,7,14.3
38390, 거창군,101,100세이상,2016,11,X,8,37.5,9,X,7,28.6
38390, 거창군,102,15세미만,2016,7086,3703,3383,109.5,7077,3698,3379,109.4
38390, 거창군,103,15~64세,2016,38639,20362,18277,111.4,38084,20082,18002,111.6
38390, 거창군,104,65세이상,2016,14933,5713,9220,62,14920,5707,9213,61.9
38390, 거창군,086,85세이상,2016,1647,451,1196,37.7,1645,450,1195,37.7
38390, 거창군,126,평균연령,2016,46.7,43.7,49.5,,46.8,43.8,49.6,
38390, 거창군,127,중위연령,2016,49.2,46.3,52.5,,49.4,46.4,52.7,
38400, 합천군,000,합계,2016,43813,20759,23054,90,43202,20463,22739,90
38400, 합천군,005,0~4세,2016,954,493,461,106.9,952,492,460,107
38400, 합천군,005001, 0세,2016,158,97,61,159,158,97,61,159
38400, 합천군,005002, 1세,2016,162,85,77,110.4,162,85,77,110.4
38400, 합천군,005003, 2세,2016,184,85,99,85.9,184,85,99,85.9
38400, 합천군,005004, 3세,2016,222,118,104,113.5,221,117,104,112.5
38400, 합천군,005005, 4세,2016,228,108,120,90,227,108,119,90.8
38400, 합천군,010,5~9세,2016,1117,578,539,107.2,1115,578,537,107.6
38400, 합천군,010001, 5세,2016,239,129,110,117.3,238,129,109,118.3
38400, 합천군,010002, 6세,2016,178,90,88,102.3,178,90,88,102.3
38400, 합천군,010003, 7세,2016,208,100,108,92.6,208,100,108,92.6
38400, 합천군,010004, 8세,2016,237,124,113,109.7,236,124,112,110.7
38400, 합천군,010005, 9세,2016,255,135,120,112.5,255,135,120,112.5
38400, 합천군,015,10~14세,2016,1221,644,577,111.6,1221,644,577,111.6
38400, 합천군,015001, 10세,2016,206,107,99,108.1,206,107,99,108.1
38400, 합천군,015002, 11세,2016,225,113,112,100.9,225,113,112,100.9
38400, 합천군,015003, 12세,2016,245,117,128,91.4,245,117,128,91.4
38400, 합천군,015004, 13세,2016,264,148,116,127.6,264,148,116,127.6
38400, 합천군,015005, 14세,2016,281,159,122,130.3,281,159,122,130.3
38400, 합천군,020,15~19세,2016,1633,888,745,119.2,1629,886,743,119.2
38400, 합천군,020001, 15세,2016,319,159,160,99.4,319,159,160,99.4
38400, 합천군,020002, 16세,2016,332,181,151,119.9,332,181,151,119.9
38400, 합천군,020003, 17세,2016,383,204,179,114,382,204,178,114.6
38400, 합천군,020004, 18세,2016,351,178,173,102.9,350,177,173,102.3
38400, 합천군,020005, 19세,2016,248,166,82,202.4,246,165,81,203.7
38400, 합천군,025,20~24세,2016,1489,914,575,159,1422,881,541,162.8
38400, 합천군,025001, 20세,2016,313,209,104,201,310,209,101,206.9
38400, 합천군,025002, 21세,2016,314,212,102,207.8,311,211,100,211
38400, 합천군,025003, 22세,2016,276,163,113,144.2,262,158,104,151.9
38400, 합천군,025004, 23세,2016,288,164,124,132.3,267,152,115,132.2
38400, 합천군,025005, 24세,2016,298,166,132,125.8,272,151,121,124.8
38400, 합천군,030,25~29세,2016,1423,797,626,127.3,1304,734,570,128.8
38400, 합천군,030001, 25세,2016,299,154,145,106.2,275,148,127,116.5
38400, 합천군,030002, 26세,2016,276,150,126,119,252,139,113,123
38400, 합천군,030003, 27세,2016,276,174,102,170.6,252,157,95,165.3
38400, 합천군,030004, 28세,2016,278,171,107,159.8,256,156,100,156
38400, 합천군,030005, 29세,2016,294,148,146,101.4,269,134,135,99.3
38400, 합천군,035,30~34세,2016,1495,792,703,112.7,1405,745,660,112.9
38400, 합천군,035001, 30세,2016,288,166,122,136.1,252,147,105,140
38400, 합천군,035002, 31세,2016,282,158,124,127.4,271,151,120,125.8
38400, 합천군,035003, 32세,2016,287,147,140,105,266,134,132,101.5
38400, 합천군,035004, 33세,2016,310,159,151,105.3,296,154,142,108.5
38400, 합천군,035005, 34세,2016,328,162,166,97.6,320,159,161,98.8
38400, 합천군,040,35~39세,2016,1791,972,819,118.7,1713,931,782,119.1
38400, 합천군,040001, 35세,2016,355,185,170,108.8,340,176,164,107.3
38400, 합천군,040002, 36세,2016,368,203,165,123,357,197,160,123.1
38400, 합천군,040003, 37세,2016,376,209,167,125.1,358,198,160,123.8
38400, 합천군,040004, 38세,2016,344,184,160,115,331,176,155,113.5
38400, 합천군,040005, 39세,2016,348,191,157,121.7,327,184,143,128.7
38400, 합천군,045,40~44세,2016,2117,1204,913,131.9,2069,1180,889,132.7
38400, 합천군,045001, 40세,2016,366,204,162,125.9,353,196,157,124.8
38400, 합천군,045002, 41세,2016,360,196,164,119.5,355,193,162,119.1
38400, 합천군,045003, 42세,2016,409,247,162,152.5,402,243,159,152.8
38400, 합천군,045004, 43세,2016,486,264,222,118.9,467,257,210,122.4
38400, 합천군,045005, 44세,2016,496,293,203,144.3,492,291,201,144.8
38400, 합천군,050,45~49세,2016,2960,1655,1305,126.8,2910,1641,1269,129.3
38400, 합천군,050001, 45세,2016,551,312,239,130.5,541,310,231,134.2
38400, 합천군,050002, 46세,2016,572,312,260,120,562,311,251,123.9
38400, 합천군,050003, 47세,2016,579,332,247,134.4,564,325,239,136
38400, 합천군,050004, 48세,2016,646,373,273,136.6,639,372,267,139.3
38400, 합천군,050005, 49세,2016,612,326,286,114,604,323,281,114.9
38400, 합천군,055,50~54세,2016,3353,1838,1515,121.3,3304,1813,1491,121.6
38400, 합천군,055001, 50세,2016,645,355,290,122.4,634,349,285,122.5
38400, 합천군,055002, 51세,2016,621,345,276,125,617,343,274,125.2
38400, 합천군,055003, 52세,2016,637,357,280,127.5,629,351,278,126.3
38400, 합천군,055004, 53세,2016,660,350,310,112.9,646,346,300,115.3
38400, 합천군,055005, 54세,2016,790,431,359,120.1,778,424,354,119.8
38400, 합천군,060,55~59세,2016,4467,2234,2233,100,4418,2212,2206,100.3
38400, 합천군,060001, 55세,2016,1017,511,506,101,1008,507,501,101.2
38400, 합천군,060002, 56세,2016,912,430,482,89.2,895,423,472,89.6
38400, 합천군,060003, 57세,2016,886,446,440,101.4,880,443,437,101.4
38400, 합천군,060004, 58세,2016,838,439,399,110,832,438,394,111.2
38400, 합천군,060005, 59세,2016,814,408,406,100.5,803,401,402,99.8
38400, 합천군,065,60~64세,2016,3824,1853,1971,94,3790,1837,1953,94.1
38400, 합천군,065001, 60세,2016,834,426,408,104.4,826,422,404,104.5
38400, 합천군,065002, 61세,2016,799,377,422,89.3,790,372,418,89
38400, 합천군,065003, 62세,2016,730,361,369,97.8,725,359,366,98.1
38400, 합천군,065004, 63세,2016,670,315,355,88.7,659,310,349,88.8
38400, 합천군,065005, 64세,2016,791,374,417,89.7,790,374,416,89.9
38400, 합천군,070,65~69세,2016,3692,1715,1977,86.7,3678,1709,1969,86.8
38400, 합천군,070001, 65세,2016,691,318,373,85.3,685,316,369,85.6
38400, 합천군,070002, 66세,2016,726,358,368,97.3,725,358,367,97.5
38400, 합천군,070003, 67세,2016,774,373,401,93,769,369,400,92.3
38400, 합천군,070004, 68세,2016,764,344,420,81.9,763,344,419,82.1
38400, 합천군,070005, 69세,2016,737,322,415,77.6,736,322,414,77.8
38400, 합천군,075,70~74세,2016,3561,1411,2150,65.6,3558,1410,2148,65.6
38400, 합천군,075001, 70세,2016,559,241,318,75.8,559,241,318,75.8
38400, 합천군,075002, 71세,2016,601,251,350,71.7,600,251,349,71.9
38400, 합천군,075003, 72세,2016,711,270,441,61.2,711,270,441,61.2
38400, 합천군,075004, 73세,2016,729,284,445,63.8,727,283,444,63.7
38400, 합천군,075005, 74세,2016,961,365,596,61.2,961,365,596,61.2
38400, 합천군,080,75~79세,2016,4188,1479,2709,54.6,4187,1479,2708,54.6
38400, 합천군,080001, 75세,2016,874,326,548,59.5,873,326,547,59.6
38400, 합천군,080002, 76세,2016,865,321,544,59,865,321,544,59
38400, 합천군,080003, 77세,2016,921,308,613,50.2,921,308,613,50.2
38400, 합천군,080004, 78세,2016,732,256,476,53.8,732,256,476,53.8
38400, 합천군,080005, 79세,2016,796,268,528,50.8,796,268,528,50.8
38400, 합천군,085,80~84세,2016,2927,899,2028,44.3,2927,899,2028,44.3
38400, 합천군,085001, 80세,2016,683,245,438,55.9,683,245,438,55.9
38400, 합천군,085002, 81세,2016,676,213,463,46,676,213,463,46
38400, 합천군,085003, 82세,2016,628,168,460,36.5,628,168,460,36.5
38400, 합천군,085004, 83세,2016,523,156,367,42.5,523,156,367,42.5
38400, 합천군,085005, 84세,2016,417,117,300,39,417,117,300,39
38400, 합천군,090,85~89세,2016,1199,320,879,36.4,1198,319,879,36.3
38400, 합천군,090001, 85세,2016,328,89,239,37.2,328,89,239,37.2
38400, 합천군,090002, 86세,2016,281,63,218,28.9,281,63,218,28.9
38400, 합천군,090003, 87세,2016,244,72,172,41.9,244,72,172,41.9
38400, 합천군,090004, 88세,2016,191,56,135,41.5,190,55,135,40.7
38400, 합천군,090005, 89세,2016,155,40,115,34.8,155,40,115,34.8
38400, 합천군,095,90~94세,2016,330,62,268,23.1,330,62,268,23.1
38400, 합천군,095001, 90세,2016,76,13,63,20.6,76,13,63,20.6
38400, 합천군,095002, 91세,2016,86,17,69,24.6,86,17,69,24.6
38400, 합천군,095003, 92세,2016,58,14,44,31.8,58,14,44,31.8
38400, 합천군,095004, 93세,2016,74,12,62,19.4,74,12,62,19.4
38400, 합천군,095005, 94세,2016,36,6,30,20,36,6,30,20
38400, 합천군,100,95~99세,2016,68,10,58,17.2,68,10,58,17.2
38400, 합천군,100001, 95세,2016,30,X,29,3.4,30,X,29,3.4
38400, 합천군,100002, 96세,2016,21,X,19,10.5,21,X,19,10.5
38400, 합천군,100003, 97세,2016,6,X,X,200,6,X,X,200
38400, 합천군,100004, 98세,2016,9,X,6,50,9,X,6,50
38400, 합천군,100005, 99세,2016,X,X,X,0,X,X,X,0
38400, 합천군,101,100세이상,2016,X,X,X,33.3,X,X,X,33.3
38400, 합천군,102,15세미만,2016,3292,1715,1577,108.8,3288,1714,1574,108.9
38400, 합천군,103,15~64세,2016,24552,13147,11405,115.3,23964,12860,11104,115.8
38400, 합천군,104,65세이상,2016,15969,5897,10072,58.5,15950,5889,10061,58.5
38400, 합천군,086,85세이상,2016,1601,393,1208,32.5,1600,392,1208,32.5
38400, 합천군,126,평균연령,2016,53.9,50.4,57.1,,54.1,50.6,57.3,
38400, 합천군,127,중위연령,2016,57.5,54.1,61.3,,57.7,54.3,61.6,
39,제주특별자치도,000,합계,2016,623332,314133,309199,101.6,605856,303939,301917,100.7
39,제주특별자치도,005,0~4세,2016,30639,15730,14909,105.5,30350,15569,14781,105.3
39,제주특별자치도,005001, 0세,2016,5658,2935,2723,107.8,5599,2904,2695,107.8
39,제주특별자치도,005002, 1세,2016,5820,3007,2813,106.9,5767,2979,2788,106.9
39,제주특별자치도,005003, 2세,2016,6122,3124,2998,104.2,6066,3091,2975,103.9
39,제주특별자치도,005004, 3세,2016,6197,3174,3023,105,6141,3139,3002,104.6
39,제주특별자치도,005005, 4세,2016,6842,3490,3352,104.1,6777,3456,3321,104.1
39,제주특별자치도,010,5~9세,2016,33262,17190,16072,107,33006,17061,15945,107
39,제주특별자치도,010001, 5세,2016,6668,3441,3227,106.6,6618,3418,3200,106.8
39,제주특별자치도,010002, 6세,2016,6541,3434,3107,110.5,6481,3405,3076,110.7
39,제주특별자치도,010003, 7세,2016,6379,3319,3060,108.5,6322,3287,3035,108.3
39,제주특별자치도,010004, 8세,2016,6615,3391,3224,105.2,6568,3371,3197,105.4
39,제주특별자치도,010005, 9세,2016,7059,3605,3454,104.4,7017,3580,3437,104.2
39,제주특별자치도,015,10~14세,2016,33393,17700,15693,112.8,33247,17626,15621,112.8
39,제주특별자치도,015001, 10세,2016,6419,3360,3059,109.8,6377,3340,3037,110
39,제주특별자치도,015002, 11세,2016,6313,3373,2940,114.7,6288,3359,2929,114.7
39,제주특별자치도,015003, 12세,2016,6741,3573,3168,112.8,6716,3556,3160,112.5
39,제주특별자치도,015004, 13세,2016,6967,3658,3309,110.5,6943,3648,3295,110.7
39,제주특별자치도,015005, 14세,2016,6953,3736,3217,116.1,6923,3723,3200,116.3
39,제주특별자치도,020,15~19세,2016,39089,20509,18580,110.4,38627,20264,18363,110.4
39,제주특별자치도,020001, 15세,2016,7782,4109,3673,111.9,7745,4093,3652,112.1
39,제주특별자치도,020002, 16세,2016,8434,4397,4037,108.9,8401,4379,4022,108.9
39,제주특별자치도,020003, 17세,2016,7950,4149,3801,109.2,7897,4120,3777,109.1
39,제주특별자치도,020004, 18세,2016,7819,4030,3789,106.4,7685,3962,3723,106.4
39,제주특별자치도,020005, 19세,2016,7104,3824,3280,116.6,6899,3710,3189,116.3
39,제주특별자치도,025,20~24세,2016,39452,21625,17827,121.3,36593,19881,16712,119
39,제주특별자치도,025001, 20세,2016,7712,4388,3324,132,7359,4201,3158,133
39,제주특별자치도,025002, 21세,2016,8128,4554,3574,127.4,7619,4255,3364,126.5
39,제주특별자치도,025003, 22세,2016,7976,4405,3571,123.4,7339,4004,3335,120.1
39,제주특별자치도,025004, 23세,2016,7883,4148,3735,111.1,7216,3711,3505,105.9
39,제주특별자치도,025005, 24세,2016,7753,4130,3623,114,7060,3710,3350,110.7
39,제주특별자치도,030,25~29세,2016,34342,17920,16422,109.1,30793,15854,14939,106.1
39,제주특별자치도,030001, 25세,2016,7319,3749,3570,105,6654,3337,3317,100.6
39,제주특별자치도,030002, 26세,2016,7053,3712,3341,111.1,6253,3265,2988,109.3
39,제주특별자치도,030003, 27세,2016,6724,3480,3244,107.3,6040,3097,2943,105.2
39,제주특별자치도,030004, 28세,2016,6446,3432,3014,113.9,5749,3005,2744,109.5
39,제주특별자치도,030005, 29세,2016,6800,3547,3253,109,6097,3150,2947,106.9
39,제주특별자치도,035,30~34세,2016,40097,20695,19402,106.7,37191,18929,18262,103.7
39,제주특별자치도,035001, 30세,2016,6874,3582,3292,108.8,6239,3215,3024,106.3
39,제주특별자치도,035002, 31세,2016,7219,3740,3479,107.5,6627,3386,3241,104.5
39,제주특별자치도,035003, 32세,2016,7729,4004,3725,107.5,7180,3658,3522,103.9
39,제주특별자치도,035004, 33세,2016,8537,4347,4190,103.7,8002,4019,3983,100.9
39,제주특별자치도,035005, 34세,2016,9738,5022,4716,106.5,9143,4651,4492,103.5
39,제주특별자치도,040,35~39세,2016,47616,24494,23122,105.9,45511,23106,22405,103.1
39,제주특별자치도,040001, 35세,2016,9792,5081,4711,107.9,9325,4755,4570,104
39,제주특별자치도,040002, 36세,2016,9922,5117,4805,106.5,9467,4822,4645,103.8
39,제주특별자치도,040003, 37세,2016,9831,4974,4857,102.4,9395,4708,4687,100.4
39,제주특별자치도,040004, 38세,2016,8699,4446,4253,104.5,8307,4180,4127,101.3
39,제주특별자치도,040005, 39세,2016,9372,4876,4496,108.5,9017,4641,4376,106.1
39,제주특별자치도,045,40~44세,2016,52708,27558,25150,109.6,51346,26696,24650,108.3
39,제주특별자치도,045001, 40세,2016,9413,5046,4367,115.5,9120,4848,4272,113.5
39,제주특별자치도,045002, 41세,2016,9742,5073,4669,108.7,9464,4894,4570,107.1
39,제주특별자치도,045003, 42세,2016,11000,5825,5175,112.6,10718,5646,5072,111.3
39,제주특별자치도,045004, 43세,2016,11056,5662,5394,105,10800,5507,5293,104
39,제주특별자치도,045005, 44세,2016,11497,5952,5545,107.3,11244,5801,5443,106.6
39,제주특별자치도,050,45~49세,2016,55643,29010,26633,108.9,54541,28382,26159,108.5
39,제주특별자치도,050001, 45세,2016,12114,6311,5803,108.8,11870,6160,5710,107.9
39,제주특별자치도,050002, 46세,2016,11323,5869,5454,107.6,11087,5732,5355,107
39,제주특별자치도,050003, 47세,2016,11110,5857,5253,111.5,10874,5727,5147,111.3
39,제주특별자치도,050004, 48세,2016,11038,5716,5322,107.4,10822,5601,5221,107.3
39,제주특별자치도,050005, 49세,2016,10058,5257,4801,109.5,9888,5162,4726,109.2
39,제주특별자치도,055,50~54세,2016,50250,26177,24073,108.7,49413,25781,23632,109.1
39,제주특별자치도,055001, 50세,2016,10435,5540,4895,113.2,10268,5460,4808,113.6
39,제주특별자치도,055002, 51세,2016,9738,5070,4668,108.6,9554,4980,4574,108.9
39,제주특별자치도,055003, 52세,2016,9739,5086,4653,109.3,9570,5019,4551,110.3
39,제주특별자치도,055004, 53세,2016,10408,5365,5043,106.4,10239,5277,4962,106.3
39,제주특별자치도,055005, 54세,2016,9930,5116,4814,106.3,9782,5045,4737,106.5
39,제주특별자치도,060,55~59세,2016,46084,23355,22729,102.8,45484,23081,22403,103
39,제주특별자치도,060001, 55세,2016,9841,4947,4894,101.1,9725,4895,4830,101.3
39,제주특별자치도,060002, 56세,2016,10026,5119,4907,104.3,9893,5053,4840,104.4
39,제주특별자치도,060003, 57세,2016,9125,4588,4537,101.1,8999,4537,4462,101.7
39,제주특별자치도,060004, 58세,2016,8699,4461,4238,105.3,8580,4407,4173,105.6
39,제주특별자치도,060005, 59세,2016,8393,4240,4153,102.1,8287,4189,4098,102.2
39,제주특별자치도,065,60~64세,2016,34033,16786,17247,97.3,33519,16558,16961,97.6
39,제주특별자치도,065001, 60세,2016,8023,4054,3969,102.1,7891,3994,3897,102.5
39,제주특별자치도,065002, 61세,2016,8091,3983,4108,97,7968,3925,4043,97.1
39,제주특별자치도,065003, 62세,2016,6575,3258,3317,98.2,6463,3210,3253,98.7
39,제주특별자치도,065004, 63세,2016,5485,2631,2854,92.2,5409,2592,2817,92
39,제주특별자치도,065005, 64세,2016,5859,2860,2999,95.4,5788,2837,2951,96.1
39,제주특별자치도,070,65~69세,2016,25877,12487,13390,93.3,25629,12375,13254,93.4
39,제주특별자치도,070001, 65세,2016,5077,2514,2563,98.1,5001,2480,2521,98.4
39,제주특별자치도,070002, 66세,2016,5075,2401,2674,89.8,5024,2377,2647,89.8
39,제주특별자치도,070003, 67세,2016,5129,2459,2670,92.1,5081,2436,2645,92.1
39,제주특별자치도,070004, 68세,2016,5395,2645,2750,96.2,5360,2629,2731,96.3
39,제주특별자치도,070005, 69세,2016,5201,2468,2733,90.3,5163,2453,2710,90.5
39,제주특별자치도,075,70~74세,2016,21536,9928,11608,85.5,21431,9868,11563,85.3
39,제주특별자치도,075001, 70세,2016,4569,2163,2406,89.9,4537,2144,2393,89.6
39,제주특별자치도,075002, 71세,2016,4212,2010,2202,91.3,4194,2000,2194,91.2
39,제주특별자치도,075003, 72세,2016,4240,1961,2279,86,4218,1947,2271,85.7
39,제주특별자치도,075004, 73세,2016,4102,1820,2282,79.8,4085,1809,2276,79.5
39,제주특별자치도,075005, 74세,2016,4413,1974,2439,80.9,4397,1968,2429,81
39,제주특별자치도,080,75~79세,2016,18203,7353,10850,67.8,18136,7325,10811,67.8
39,제주특별자치도,080001, 75세,2016,4195,1806,2389,75.6,4176,1798,2378,75.6
39,제주특별자치도,080002, 76세,2016,3716,1509,2207,68.4,3706,1507,2199,68.5
39,제주특별자치도,080003, 77세,2016,3693,1501,2192,68.5,3681,1497,2184,68.5
39,제주특별자치도,080004, 78세,2016,3431,1355,2076,65.3,3423,1351,2072,65.2
39,제주특별자치도,080005, 79세,2016,3168,1182,1986,59.5,3150,1172,1978,59.3
39,제주특별자치도,085,80~84세,2016,12566,4089,8477,48.2,12528,4071,8457,48.1
39,제주특별자치도,085001, 80세,2016,2821,1036,1785,58,2811,1031,1780,57.9
39,제주특별자치도,085002, 81세,2016,2767,975,1792,54.4,2755,969,1786,54.3
39,제주특별자치도,085003, 82세,2016,2662,881,1781,49.5,2660,879,1781,49.4
39,제주특별자치도,085004, 83세,2016,2415,697,1718,40.6,2408,694,1714,40.5
39,제주특별자치도,085005, 84세,2016,1901,500,1401,35.7,1894,498,1396,35.7
39,제주특별자치도,090,85~89세,2016,5578,1145,4433,25.8,5559,1136,4423,25.7
39,제주특별자치도,090001, 85세,2016,1436,362,1074,33.7,1432,362,1070,33.8
39,제주특별자치도,090002, 86세,2016,1457,302,1155,26.1,1450,296,1154,25.6
39,제주특별자치도,090003, 87세,2016,1113,224,889,25.2,1110,222,888,25
39,제주특별자치도,090004, 88세,2016,855,144,711,20.3,854,143,711,20.1
39,제주특별자치도,090005, 89세,2016,717,113,604,18.7,713,113,600,18.8
39,제주특별자치도,095,90~94세,2016,2195,313,1882,16.6,2188,310,1878,16.5
39,제주특별자치도,095001, 90세,2016,479,91,388,23.5,476,89,387,23
39,제주특별자치도,095002, 91세,2016,392,60,332,18.1,390,60,330,18.2
39,제주특별자치도,095003, 92세,2016,281,56,225,24.9,279,55,224,24.6
39,제주특별자치도,095004, 93세,2016,675,58,617,9.4,675,58,617,9.4
39,제주특별자치도,095005, 94세,2016,368,48,320,15,368,48,320,15
39,제주특별자치도,100,95~99세,2016,670,63,607,10.4,665,60,605,9.9
39,제주특별자치도,100001, 95세,2016,252,20,232,8.6,252,20,232,8.6
39,제주특별자치도,100002, 96세,2016,153,20,133,15,152,19,133,14.3
39,제주특별자치도,100003, 97세,2016,123,11,112,9.8,120,10,110,9.1
39,제주특별자치도,100004, 98세,2016,80,9,71,12.7,79,8,71,11.3
39,제주특별자치도,100005, 99세,2016,62,X,59,5.1,62,X,59,5.1
39,제주특별자치도,101,100세이상,2016,99,6,93,6.5,99,6,93,6.5
39,제주특별자치도,102,15세미만,2016,97294,50620,46674,108.5,96603,50256,46347,108.4
39,제주특별자치도,103,15~64세,2016,439314,228129,211185,108,423018,218532,204486,106.9
39,제주특별자치도,104,65세이상,2016,86724,35384,51340,68.9,86235,35151,51084,68.8
39,제주특별자치도,086,85세이상,2016,8542,1527,7015,21.8,8511,1512,6999,21.6
39,제주특별자치도,126,평균연령,2016,40.4,38.9,41.8,,40.5,39.1,42,
39,제주특별자치도,127,중위연령,2016,41.4,40.2,42.7,,41.9,40.8,43,
39004, 읍부,000,합계,2016,134561,69198,65363,105.9,128470,65032,63438,102.5
39004, 읍부,005,0~4세,2016,5173,2714,2459,110.4,5085,2669,2416,110.5
39004, 읍부,005001, 0세,2016,909,470,439,107.1,893,462,431,107.2
39004, 읍부,005002, 1세,2016,980,527,453,116.3,967,519,448,115.8
39004, 읍부,005003, 2세,2016,973,509,464,109.7,954,500,454,110.1
39004, 읍부,005004, 3세,2016,1098,568,530,107.2,1082,558,524,106.5
39004, 읍부,005005, 4세,2016,1213,640,573,111.7,1189,630,559,112.7
39004, 읍부,010,5~9세,2016,6203,3199,3004,106.5,6105,3153,2952,106.8
39004, 읍부,010001, 5세,2016,1230,649,581,111.7,1211,639,572,111.7
39004, 읍부,010002, 6세,2016,1162,623,539,115.6,1137,613,524,117
39004, 읍부,010003, 7세,2016,1259,670,589,113.8,1240,661,579,114.2
39004, 읍부,010004, 8세,2016,1245,616,629,97.9,1228,612,616,99.4
39004, 읍부,010005, 9세,2016,1307,641,666,96.2,1289,628,661,95
39004, 읍부,015,10~14세,2016,5989,3245,2744,118.3,5930,3212,2718,118.2
39004, 읍부,015001, 10세,2016,1217,663,554,119.7,1196,651,545,119.4
39004, 읍부,015002, 11세,2016,1156,621,535,116.1,1147,618,529,116.8
39004, 읍부,015003, 12세,2016,1206,655,551,118.9,1196,647,549,117.9
39004, 읍부,015004, 13세,2016,1171,626,545,114.9,1164,622,542,114.8
39004, 읍부,015005, 14세,2016,1239,680,559,121.6,1227,674,553,121.9
39004, 읍부,020,15~19세,2016,7158,3776,3382,111.6,6999,3697,3302,112
39004, 읍부,020001, 15세,2016,1366,720,646,111.5,1352,715,637,112.2
39004, 읍부,020002, 16세,2016,1487,764,723,105.7,1470,758,712,106.5
39004, 읍부,020003, 17세,2016,1427,753,674,111.7,1411,745,666,111.9
39004, 읍부,020004, 18세,2016,1499,766,733,104.5,1458,743,715,103.9
39004, 읍부,020005, 19세,2016,1379,773,606,127.6,1308,736,572,128.7
39004, 읍부,025,20~24세,2016,7611,4514,3097,145.8,6602,3746,2856,131.2
39004, 읍부,025001, 20세,2016,1488,884,604,146.4,1389,818,571,143.3
39004, 읍부,025002, 21세,2016,1515,909,606,150,1356,788,568,138.7
39004, 읍부,025003, 22세,2016,1515,922,593,155.5,1296,748,548,136.5
39004, 읍부,025004, 23세,2016,1604,929,675,137.6,1339,719,620,116
39004, 읍부,025005, 24세,2016,1489,870,619,140.5,1222,673,549,122.6
39004, 읍부,030,25~29세,2016,6681,3886,2795,139,5417,2946,2471,119.2
39004, 읍부,030001, 25세,2016,1431,792,639,123.9,1179,595,584,101.9
39004, 읍부,030002, 26세,2016,1389,786,603,130.3,1112,593,519,114.3
39004, 읍부,030003, 27세,2016,1332,800,532,150.4,1086,612,474,129.1
39004, 읍부,030004, 28세,2016,1208,733,475,154.3,963,541,422,128.2
39004, 읍부,030005, 29세,2016,1321,775,546,141.9,1077,605,472,128.2
39004, 읍부,035,30~34세,2016,7296,4056,3240,125.2,6249,3270,2979,109.8
39004, 읍부,035001, 30세,2016,1234,693,541,128.1,1012,535,477,112.2
39004, 읍부,035002, 31세,2016,1299,725,574,126.3,1081,568,513,110.7
39004, 읍부,035003, 32세,2016,1423,788,635,124.1,1226,635,591,107.4
39004, 읍부,035004, 33세,2016,1522,844,678,124.5,1325,695,630,110.3
39004, 읍부,035005, 34세,2016,1818,1006,812,123.9,1605,837,768,109
39004, 읍부,040,35~39세,2016,9276,5035,4241,118.7,8493,4449,4044,110
39004, 읍부,040001, 35세,2016,1849,1020,829,123,1652,866,786,110.2
39004, 읍부,040002, 36세,2016,1921,1027,894,114.9,1757,907,850,106.7
39004, 읍부,040003, 37세,2016,1903,1009,894,112.9,1740,890,850,104.7
39004, 읍부,040004, 38세,2016,1725,919,806,114,1597,825,772,106.9
39004, 읍부,040005, 39세,2016,1878,1060,818,129.6,1747,961,786,122.3
39004, 읍부,045,40~44세,2016,10524,5860,4664,125.6,9994,5510,4484,122.9
39004, 읍부,045001, 40세,2016,1896,1059,837,126.5,1751,948,803,118.1
39004, 읍부,045002, 41세,2016,1982,1091,891,122.4,1882,1022,860,118.8
39004, 읍부,045003, 42세,2016,2259,1289,970,132.9,2154,1221,933,130.9
39004, 읍부,045004, 43세,2016,2155,1170,985,118.8,2075,1127,948,118.9
39004, 읍부,045005, 44세,2016,2232,1251,981,127.5,2132,1192,940,126.8
39004, 읍부,050,45~49세,2016,11248,6264,4984,125.7,10906,6076,4830,125.8
39004, 읍부,050001, 45세,2016,2449,1380,1069,129.1,2380,1341,1039,129.1
39004, 읍부,050002, 46세,2016,2207,1257,950,132.3,2133,1210,923,131.1
39004, 읍부,050003, 47세,2016,2257,1254,1003,125,2185,1217,968,125.7
39004, 읍부,050004, 48세,2016,2307,1244,1063,117,2235,1207,1028,117.4
39004, 읍부,050005, 49세,2016,2028,1129,899,125.6,1973,1101,872,126.3
39004, 읍부,055,50~54세,2016,11189,6088,5101,119.3,10925,5954,4971,119.8
39004, 읍부,055001, 50세,2016,2249,1229,1020,120.5,2191,1199,992,120.9
39004, 읍부,055002, 51세,2016,2156,1183,973,121.6,2104,1156,948,121.9
39004, 읍부,055003, 52세,2016,2193,1207,986,122.4,2132,1181,951,124.2
39004, 읍부,055004, 53세,2016,2304,1248,1056,118.2,2257,1222,1035,118.1
39004, 읍부,055005, 54세,2016,2287,1221,1066,114.5,2241,1196,1045,114.4
39004, 읍부,060,55~59세,2016,10809,5660,5149,109.9,10631,5575,5056,110.3
39004, 읍부,060001, 55세,2016,2242,1147,1095,104.7,2212,1136,1076,105.6
39004, 읍부,060002, 56세,2016,2330,1219,1111,109.7,2283,1191,1092,109.1
39004, 읍부,060003, 57세,2016,2142,1134,1008,112.5,2107,1120,987,113.5
39004, 읍부,060004, 58세,2016,2077,1101,976,112.8,2039,1084,955,113.5
39004, 읍부,060005, 59세,2016,2018,1059,959,110.4,1990,1044,946,110.4
39004, 읍부,065,60~64세,2016,8428,4242,4186,101.3,8277,4175,4102,101.8
39004, 읍부,065001, 60세,2016,1933,1010,923,109.4,1894,995,899,110.7
39004, 읍부,065002, 61세,2016,1999,990,1009,98.1,1965,973,992,98.1
39004, 읍부,065003, 62세,2016,1659,851,808,105.3,1623,837,786,106.5
39004, 읍부,065004, 63세,2016,1356,670,686,97.7,1328,654,674,97
39004, 읍부,065005, 64세,2016,1481,721,760,94.9,1467,716,751,95.3
39004, 읍부,070,65~69세,2016,6937,3406,3531,96.5,6879,3379,3500,96.5
39004, 읍부,070001, 65세,2016,1358,692,666,103.9,1339,685,654,104.7
39004, 읍부,070002, 66세,2016,1276,592,684,86.5,1263,585,678,86.3
39004, 읍부,070003, 67세,2016,1415,693,722,96,1408,690,718,96.1
39004, 읍부,070004, 68세,2016,1445,721,724,99.6,1438,719,719,100
39004, 읍부,070005, 69세,2016,1443,708,735,96.3,1431,700,731,95.8
39004, 읍부,075,70~74세,2016,6415,2914,3501,83.2,6393,2900,3493,83
39004, 읍부,075001, 70세,2016,1353,646,707,91.4,1348,643,705,91.2
39004, 읍부,075002, 71세,2016,1230,564,666,84.7,1226,563,663,84.9
39004, 읍부,075003, 72세,2016,1230,548,682,80.4,1224,542,682,79.5
39004, 읍부,075004, 73세,2016,1237,537,700,76.7,1234,535,699,76.5
39004, 읍부,075005, 74세,2016,1365,619,746,83,1361,617,744,82.9
39004, 읍부,080,75~79세,2016,6166,2416,3750,64.4,6149,2411,3738,64.5
39004, 읍부,080001, 75세,2016,1364,569,795,71.6,1360,567,793,71.5
39004, 읍부,080002, 76세,2016,1249,477,772,61.8,1245,477,768,62.1
39004, 읍부,080003, 77세,2016,1289,525,764,68.7,1286,525,761,69
39004, 읍부,080004, 78세,2016,1210,454,756,60.1,1207,453,754,60.1
39004, 읍부,080005, 79세,2016,1054,391,663,59,1051,389,662,58.8
39004, 읍부,085,80~84세,2016,4468,1383,3085,44.8,4455,1374,3081,44.6
39004, 읍부,085001, 80세,2016,982,344,638,53.9,979,342,637,53.7
39004, 읍부,085002, 81세,2016,928,322,606,53.1,927,322,605,53.2
39004, 읍부,085003, 82세,2016,950,294,656,44.8,948,292,656,44.5
39004, 읍부,085004, 83세,2016,874,242,632,38.3,869,239,630,37.9
39004, 읍부,085005, 84세,2016,734,181,553,32.7,732,179,553,32.4
39004, 읍부,090,85~89세,2016,1951,399,1552,25.7,1946,397,1549,25.6
39004, 읍부,090001, 85세,2016,487,122,365,33.4,486,122,364,33.5
39004, 읍부,090002, 86세,2016,535,105,430,24.4,534,104,430,24.2
39004, 읍부,090003, 87세,2016,386,76,310,24.5,386,76,310,24.5
39004, 읍부,090004, 88세,2016,291,59,232,25.4,290,58,232,25
39004, 읍부,090005, 89세,2016,252,37,215,17.2,250,37,213,17.4
39004, 읍부,095,90~94세,2016,772,122,650,18.8,770,121,649,18.6
39004, 읍부,095001, 90세,2016,165,39,126,31,164,38,126,30.2
39004, 읍부,095002, 91세,2016,153,23,130,17.7,152,23,129,17.8
39004, 읍부,095003, 92세,2016,87,24,63,38.1,87,24,63,38.1
39004, 읍부,095004, 93세,2016,233,20,213,9.4,233,20,213,9.4
39004, 읍부,095005, 94세,2016,134,16,118,13.6,134,16,118,13.6
39004, 읍부,100,95~99세,2016,234,18,216,8.3,232,17,215,7.9
39004, 읍부,100001, 95세,2016,80,6,74,8.1,80,6,74,8.1
39004, 읍부,100002, 96세,2016,63,7,56,12.5,62,6,56,10.7
39004, 읍부,100003, 97세,2016,50,X,48,4.2,49,X,47,4.3
39004, 읍부,100004, 98세,2016,26,X,25,4,26,X,25,4
39004, 읍부,100005, 99세,2016,15,X,13,15.4,15,X,13,15.4
39004, 읍부,101,100세이상,2016,33,X,32,3.1,33,X,32,3.1
39004, 읍부,102,15세미만,2016,17365,9158,8207,111.6,17120,9034,8086,111.7
39004, 읍부,103,15~64세,2016,90220,49381,40839,120.9,84493,45398,39095,116.1
39004, 읍부,104,65세이상,2016,26976,10659,16317,65.3,26857,10600,16257,65.2
39004, 읍부,086,85세이상,2016,2990,540,2450,22,2981,536,2445,21.9
39004, 읍부,126,평균연령,2016,44.3,42.1,46.7,,44.8,42.7,47,
39004, 읍부,127,중위연령,2016,45.6,43.6,48,,46.5,44.9,48.6,
39005, 면부,000,합계,2016,31890,16534,15356,107.7,30436,15457,14979,103.2
39005, 면부,005,0~4세,2016,1096,568,528,107.6,1087,562,525,107
39005, 면부,005001, 0세,2016,207,106,101,105,207,106,101,105
39005, 면부,005002, 1세,2016,213,103,110,93.6,211,102,109,93.6
39005, 면부,005003, 2세,2016,210,110,100,110,209,109,100,109
39005, 면부,005004, 3세,2016,225,123,102,120.6,221,120,101,118.8
39005, 면부,005005, 4세,2016,241,126,115,109.6,239,125,114,109.6
39005, 면부,010,5~9세,2016,1161,616,545,113,1157,614,543,113.1
39005, 면부,010001, 5세,2016,232,115,117,98.3,232,115,117,98.3
39005, 면부,010002, 6세,2016,223,125,98,127.6,223,125,98,127.6
39005, 면부,010003, 7세,2016,204,97,107,90.7,202,96,106,90.6
39005, 면부,010004, 8세,2016,248,135,113,119.5,247,135,112,120.5
39005, 면부,010005, 9세,2016,254,144,110,130.9,253,143,110,130
39005, 면부,015,10~14세,2016,1114,608,506,120.2,1106,605,501,120.8
39005, 면부,015001, 10세,2016,202,117,85,137.6,202,117,85,137.6
39005, 면부,015002, 11세,2016,218,111,107,103.7,218,111,107,103.7
39005, 면부,015003, 12세,2016,215,122,93,131.2,213,121,92,131.5
39005, 면부,015004, 13세,2016,229,111,118,94.1,229,111,118,94.1
39005, 면부,015005, 14세,2016,250,147,103,142.7,244,145,99,146.5
39005, 면부,020,15~19세,2016,1488,748,740,101.1,1460,733,727,100.8
39005, 면부,020001, 15세,2016,290,147,143,102.8,286,146,140,104.3
39005, 면부,020002, 16세,2016,325,155,170,91.2,322,153,169,90.5
39005, 면부,020003, 17세,2016,294,149,145,102.8,287,145,142,102.1
39005, 면부,020004, 18세,2016,312,155,157,98.7,307,152,155,98.1
39005, 면부,020005, 19세,2016,267,142,125,113.6,258,137,121,113.2
39005, 면부,025,20~24세,2016,1736,1042,694,150.1,1512,867,645,134.4
39005, 면부,025001, 20세,2016,332,199,133,149.6,309,186,123,151.2
39005, 면부,025002, 21세,2016,364,224,140,160,329,199,130,153.1
39005, 면부,025003, 22세,2016,345,205,140,146.4,294,162,132,122.7
39005, 면부,025004, 23세,2016,361,216,145,149,303,163,140,116.4
39005, 면부,025005, 24세,2016,334,198,136,145.6,277,157,120,130.8
39005, 면부,030,25~29세,2016,1632,957,675,141.8,1293,700,593,118
39005, 면부,030001, 25세,2016,373,210,163,128.8,309,157,152,103.3
39005, 면부,030002, 26세,2016,380,216,164,131.7,301,159,142,112
39005, 면부,030003, 27세,2016,299,167,132,126.5,244,125,119,105
39005, 면부,030004, 28세,2016,289,178,111,160.4,218,128,90,142.2
39005, 면부,030005, 29세,2016,291,186,105,177.1,221,131,90,145.6
39005, 면부,035,30~34세,2016,1713,1012,701,144.4,1411,777,634,122.6
39005, 면부,035001, 30세,2016,301,171,130,131.5,242,131,111,118
39005, 면부,035002, 31세,2016,327,197,130,151.5,256,138,118,116.9
39005, 면부,035003, 32세,2016,311,189,122,154.9,256,147,109,134.9
39005, 면부,035004, 33세,2016,374,223,151,147.7,322,180,142,126.8
39005, 면부,035005, 34세,2016,400,232,168,138.1,335,181,154,117.5
39005, 면부,040,35~39세,2016,2034,1202,832,144.5,1821,1023,798,128.2
39005, 면부,040001, 35세,2016,418,242,176,137.5,376,206,170,121.2
39005, 면부,040002, 36세,2016,388,238,150,158.7,331,191,140,136.4
39005, 면부,040003, 37세,2016,432,242,190,127.4,389,207,182,113.7
39005, 면부,040004, 38세,2016,369,227,142,159.9,329,193,136,141.9
39005, 면부,040005, 39세,2016,427,253,174,145.4,396,226,170,132.9
39005, 면부,045,40~44세,2016,2295,1408,887,158.7,2178,1313,865,151.8
39005, 면부,045001, 40세,2016,419,257,162,158.6,397,241,156,154.5
39005, 면부,045002, 41세,2016,407,259,148,175,378,234,144,162.5
39005, 면부,045003, 42세,2016,488,307,181,169.6,462,284,178,159.6
39005, 면부,045004, 43세,2016,484,288,196,146.9,464,272,192,141.7
39005, 면부,045005, 44세,2016,497,297,200,148.5,477,282,195,144.6
39005, 면부,050,45~49세,2016,2598,1490,1108,134.5,2517,1440,1077,133.7
39005, 면부,050001, 45세,2016,540,308,232,132.8,519,291,228,127.6
39005, 면부,050002, 46세,2016,493,285,208,137,476,277,199,139.2
39005, 면부,050003, 47세,2016,509,312,197,158.4,489,298,191,156
39005, 면부,050004, 48세,2016,566,328,238,137.8,552,324,228,142.1
39005, 면부,050005, 49세,2016,490,257,233,110.3,481,250,231,108.2
39005, 면부,055,50~54세,2016,2703,1516,1187,127.7,2649,1490,1159,128.6
39005, 면부,055001, 50세,2016,523,312,211,147.9,515,307,208,147.6
39005, 면부,055002, 51세,2016,513,293,220,133.2,503,289,214,135
39005, 면부,055003, 52세,2016,512,291,221,131.7,501,287,214,134.1
39005, 면부,055004, 53세,2016,593,314,279,112.5,581,308,273,112.8
39005, 면부,055005, 54세,2016,562,306,256,119.5,549,299,250,119.6
39005, 면부,060,55~59세,2016,2729,1419,1310,108.3,2697,1406,1291,108.9
39005, 면부,060001, 55세,2016,529,278,251,110.8,525,277,248,111.7
39005, 면부,060002, 56세,2016,549,296,253,117,541,291,250,116.4
39005, 면부,060003, 57세,2016,545,270,275,98.2,538,270,268,100.7
39005, 면부,060004, 58세,2016,552,293,259,113.1,545,289,256,112.9
39005, 면부,060005, 59세,2016,554,282,272,103.7,548,279,269,103.7
39005, 면부,065,60~64세,2016,2278,1124,1154,97.4,2253,1112,1141,97.5
39005, 면부,065001, 60세,2016,543,277,266,104.1,536,272,264,103
39005, 면부,065002, 61세,2016,514,255,259,98.5,512,254,258,98.4
39005, 면부,065003, 62세,2016,462,218,244,89.3,456,215,241,89.2
39005, 면부,065004, 63세,2016,357,173,184,94,355,172,183,94
39005, 면부,065005, 64세,2016,402,201,201,100,394,199,195,102.1
39005, 면부,070,65~69세,2016,1902,928,974,95.3,1891,924,967,95.6
39005, 면부,070001, 65세,2016,351,189,162,116.7,346,187,159,117.6
39005, 면부,070002, 66세,2016,373,170,203,83.7,370,169,201,84.1
39005, 면부,070003, 67세,2016,381,176,205,85.9,378,175,203,86.2
39005, 면부,070004, 68세,2016,428,217,211,102.8,428,217,211,102.8
39005, 면부,070005, 69세,2016,369,176,193,91.2,369,176,193,91.2
39005, 면부,075,70~74세,2016,1765,796,969,82.1,1759,791,968,81.7
39005, 면부,075001, 70세,2016,367,175,192,91.1,364,172,192,89.6
39005, 면부,075002, 71세,2016,308,148,160,92.5,307,147,160,91.9
39005, 면부,075003, 72세,2016,350,149,201,74.1,350,149,201,74.1
39005, 면부,075004, 73세,2016,348,141,207,68.1,348,141,207,68.1
39005, 면부,075005, 74세,2016,392,183,209,87.6,390,182,208,87.5
39005, 면부,080,75~79세,2016,1704,627,1077,58.2,1703,627,1076,58.3
39005, 면부,080001, 75세,2016,386,158,228,69.3,386,158,228,69.3
39005, 면부,080002, 76세,2016,311,118,193,61.1,311,118,193,61.1
39005, 면부,080003, 77세,2016,351,132,219,60.3,351,132,219,60.3
39005, 면부,080004, 78세,2016,351,121,230,52.6,351,121,230,52.6
39005, 면부,080005, 79세,2016,305,98,207,47.3,304,98,206,47.6
39005, 면부,085,80~84세,2016,1201,369,832,44.4,1201,369,832,44.4
39005, 면부,085001, 80세,2016,274,108,166,65.1,274,108,166,65.1
39005, 면부,085002, 81세,2016,282,90,192,46.9,282,90,192,46.9
39005, 면부,085003, 82세,2016,244,67,177,37.9,244,67,177,37.9
39005, 면부,085004, 83세,2016,236,62,174,35.6,236,62,174,35.6
39005, 면부,085005, 84세,2016,165,42,123,34.1,165,42,123,34.1
39005, 면부,090,85~89세,2016,492,86,406,21.2,492,86,406,21.2
39005, 면부,090001, 85세,2016,142,26,116,22.4,142,26,116,22.4
39005, 면부,090002, 86세,2016,130,21,109,19.3,130,21,109,19.3
39005, 면부,090003, 87세,2016,105,18,87,20.7,105,18,87,20.7
39005, 면부,090004, 88세,2016,58,12,46,26.1,58,12,46,26.1
39005, 면부,090005, 89세,2016,57,9,48,18.8,57,9,48,18.8
39005, 면부,095,90~94세,2016,195,13,182,7.1,195,13,182,7.1
39005, 면부,095001, 90세,2016,38,X,35,8.6,38,X,35,8.6
39005, 면부,095002, 91세,2016,28,X,27,3.7,28,X,27,3.7
39005, 면부,095003, 92세,2016,23,X,21,9.5,23,X,21,9.5
39005, 면부,095004, 93세,2016,75,X,73,2.7,75,X,73,2.7
39005, 면부,095005, 94세,2016,31,5,26,19.2,31,5,26,19.2
39005, 면부,100,95~99세,2016,47,X,43,9.3,47,X,43,9.3
39005, 면부,100001, 95세,2016,21,X,20,5,21,X,20,5
39005, 면부,100002, 96세,2016,6,X,5,20,6,X,5,20
39005, 면부,100003, 97세,2016,5,X,X,25,5,X,X,25
39005, 면부,100004, 98세,2016,7,X,6,16.7,7,X,6,16.7
39005, 면부,100005, 99세,2016,8,X,8,0,8,X,8,0
39005, 면부,101,100세이상,2016,7,X,6,16.7,7,X,6,16.7
39005, 면부,102,15세미만,2016,3371,1792,1579,113.5,3350,1781,1569,113.5
39005, 면부,103,15~64세,2016,21206,11918,9288,128.3,19791,10861,8930,121.6
39005, 면부,104,65세이상,2016,7313,2824,4489,62.9,7295,2815,4480,62.8
39005, 면부,086,85세이상,2016,741,104,637,16.3,741,104,637,16.3
39005, 면부,126,평균연령,2016,46.5,43.8,49.4,,47.1,44.6,49.7,
39005, 면부,127,중위연령,2016,48.2,45.3,52.1,,49.3,46.9,52.7,
39003, 동부,000,합계,2016,456881,228401,228480,100,446950,223450,223500,100
39003, 동부,005,0~4세,2016,24370,12448,11922,104.4,24178,12338,11840,104.2
39003, 동부,005001, 0세,2016,4542,2359,2183,108.1,4499,2336,2163,108
39003, 동부,005002, 1세,2016,4627,2377,2250,105.6,4589,2358,2231,105.7
39003, 동부,005003, 2세,2016,4939,2505,2434,102.9,4903,2482,2421,102.5
39003, 동부,005004, 3세,2016,4874,2483,2391,103.8,4838,2461,2377,103.5
39003, 동부,005005, 4세,2016,5388,2724,2664,102.3,5349,2701,2648,102
39003, 동부,010,5~9세,2016,25898,13375,12523,106.8,25744,13294,12450,106.8
39003, 동부,010001, 5세,2016,5206,2677,2529,105.9,5175,2664,2511,106.1
39003, 동부,010002, 6세,2016,5156,2686,2470,108.7,5121,2667,2454,108.7
39003, 동부,010003, 7세,2016,4916,2552,2364,108,4880,2530,2350,107.7
39003, 동부,010004, 8세,2016,5122,2640,2482,106.4,5093,2624,2469,106.3
39003, 동부,010005, 9세,2016,5498,2820,2678,105.3,5475,2809,2666,105.4
39003, 동부,015,10~14세,2016,26290,13847,12443,111.3,26211,13809,12402,111.3
39003, 동부,015001, 10세,2016,5000,2580,2420,106.6,4979,2572,2407,106.9
39003, 동부,015002, 11세,2016,4939,2641,2298,114.9,4923,2630,2293,114.7
39003, 동부,015003, 12세,2016,5320,2796,2524,110.8,5307,2788,2519,110.7
39003, 동부,015004, 13세,2016,5567,2921,2646,110.4,5550,2915,2635,110.6
39003, 동부,015005, 14세,2016,5464,2909,2555,113.9,5452,2904,2548,114
39003, 동부,020,15~19세,2016,30443,15985,14458,110.6,30168,15834,14334,110.5
39003, 동부,020001, 15세,2016,6126,3242,2884,112.4,6107,3232,2875,112.4
39003, 동부,020002, 16세,2016,6622,3478,3144,110.6,6609,3468,3141,110.4
39003, 동부,020003, 17세,2016,6229,3247,2982,108.9,6199,3230,2969,108.8
39003, 동부,020004, 18세,2016,6008,3109,2899,107.2,5920,3067,2853,107.5
39003, 동부,020005, 19세,2016,5458,2909,2549,114.1,5333,2837,2496,113.7
39003, 동부,025,20~24세,2016,30105,16069,14036,114.5,28479,15268,13211,115.6
39003, 동부,025001, 20세,2016,5892,3305,2587,127.8,5661,3197,2464,129.7
39003, 동부,025002, 21세,2016,6249,3421,2828,121,5934,3268,2666,122.6
39003, 동부,025003, 22세,2016,6116,3278,2838,115.5,5749,3094,2655,116.5
39003, 동부,025004, 23세,2016,5918,3003,2915,103,5574,2829,2745,103.1
39003, 동부,025005, 24세,2016,5930,3062,2868,106.8,5561,2880,2681,107.4
39003, 동부,030,25~29세,2016,26029,13077,12952,101,24083,12208,11875,102.8
39003, 동부,030001, 25세,2016,5515,2747,2768,99.2,5166,2585,2581,100.2
39003, 동부,030002, 26세,2016,5284,2710,2574,105.3,4840,2513,2327,108
39003, 동부,030003, 27세,2016,5093,2513,2580,97.4,4710,2360,2350,100.4
39003, 동부,030004, 28세,2016,4949,2521,2428,103.8,4568,2336,2232,104.7
39003, 동부,030005, 29세,2016,5188,2586,2602,99.4,4799,2414,2385,101.2
39003, 동부,035,30~34세,2016,31088,15627,15461,101.1,29531,14882,14649,101.6
39003, 동부,035001, 30세,2016,5339,2718,2621,103.7,4985,2549,2436,104.6
39003, 동부,035002, 31세,2016,5593,2818,2775,101.5,5290,2680,2610,102.7
39003, 동부,035003, 32세,2016,5995,3027,2968,102,5698,2876,2822,101.9
39003, 동부,035004, 33세,2016,6641,3280,3361,97.6,6355,3144,3211,97.9
39003, 동부,035005, 34세,2016,7520,3784,3736,101.3,7203,3633,3570,101.8
39003, 동부,040,35~39세,2016,36306,18257,18049,101.2,35197,17634,17563,100.4
39003, 동부,040001, 35세,2016,7525,3819,3706,103,7297,3683,3614,101.9
39003, 동부,040002, 36세,2016,7613,3852,3761,102.4,7379,3724,3655,101.9
39003, 동부,040003, 37세,2016,7496,3723,3773,98.7,7266,3611,3655,98.8
39003, 동부,040004, 38세,2016,6605,3300,3305,99.8,6381,3162,3219,98.2
39003, 동부,040005, 39세,2016,7067,3563,3504,101.7,6874,3454,3420,101
39003, 동부,045,40~44세,2016,39889,20290,19599,103.5,39174,19873,19301,103
39003, 동부,045001, 40세,2016,7098,3730,3368,110.7,6972,3659,3313,110.4
39003, 동부,045002, 41세,2016,7353,3723,3630,102.6,7204,3638,3566,102
39003, 동부,045003, 42세,2016,8253,4229,4024,105.1,8102,4141,3961,104.5
39003, 동부,045004, 43세,2016,8417,4204,4213,99.8,8261,4108,4153,98.9
39003, 동부,045005, 44세,2016,8768,4404,4364,100.9,8635,4327,4308,100.4
39003, 동부,050,45~49세,2016,41797,21256,20541,103.5,41118,20866,20252,103
39003, 동부,050001, 45세,2016,9125,4623,4502,102.7,8971,4528,4443,101.9
39003, 동부,050002, 46세,2016,8623,4327,4296,100.7,8478,4245,4233,100.3
39003, 동부,050003, 47세,2016,8344,4291,4053,105.9,8200,4212,3988,105.6
39003, 동부,050004, 48세,2016,8165,4144,4021,103.1,8035,4070,3965,102.6
39003, 동부,050005, 49세,2016,7540,3871,3669,105.5,7434,3811,3623,105.2
39003, 동부,055,50~54세,2016,36358,18573,17785,104.4,35839,18337,17502,104.8
39003, 동부,055001, 50세,2016,7663,3999,3664,109.1,7562,3954,3608,109.6
39003, 동부,055002, 51세,2016,7069,3594,3475,103.4,6947,3535,3412,103.6
39003, 동부,055003, 52세,2016,7034,3588,3446,104.1,6937,3551,3386,104.9
39003, 동부,055004, 53세,2016,7511,3803,3708,102.6,7401,3747,3654,102.5
39003, 동부,055005, 54세,2016,7081,3589,3492,102.8,6992,3550,3442,103.1
39003, 동부,060,55~59세,2016,32546,16276,16270,100,32156,16100,16056,100.3
39003, 동부,060001, 55세,2016,7070,3522,3548,99.3,6988,3482,3506,99.3
39003, 동부,060002, 56세,2016,7147,3604,3543,101.7,7069,3571,3498,102.1
39003, 동부,060003, 57세,2016,6438,3184,3254,97.8,6354,3147,3207,98.1
39003, 동부,060004, 58세,2016,6070,3067,3003,102.1,5996,3034,2962,102.4
39003, 동부,060005, 59세,2016,5821,2899,2922,99.2,5749,2866,2883,99.4
39003, 동부,065,60~64세,2016,23327,11420,11907,95.9,22989,11271,11718,96.2
39003, 동부,065001, 60세,2016,5547,2767,2780,99.5,5461,2727,2734,99.7
39003, 동부,065002, 61세,2016,5578,2738,2840,96.4,5491,2698,2793,96.6
39003, 동부,065003, 62세,2016,4454,2189,2265,96.6,4384,2158,2226,96.9
39003, 동부,065004, 63세,2016,3772,1788,1984,90.1,3726,1766,1960,90.1
39003, 동부,065005, 64세,2016,3976,1938,2038,95.1,3927,1922,2005,95.9
39003, 동부,070,65~69세,2016,17038,8153,8885,91.8,16859,8072,8787,91.9
39003, 동부,070001, 65세,2016,3368,1633,1735,94.1,3316,1608,1708,94.1
39003, 동부,070002, 66세,2016,3426,1639,1787,91.7,3391,1623,1768,91.8
39003, 동부,070003, 67세,2016,3333,1590,1743,91.2,3295,1571,1724,91.1
39003, 동부,070004, 68세,2016,3522,1707,1815,94,3494,1693,1801,94
39003, 동부,070005, 69세,2016,3389,1584,1805,87.8,3363,1577,1786,88.3
39003, 동부,075,70~74세,2016,13356,6218,7138,87.1,13279,6177,7102,87
39003, 동부,075001, 70세,2016,2849,1342,1507,89.1,2825,1329,1496,88.8
39003, 동부,075002, 71세,2016,2674,1298,1376,94.3,2661,1290,1371,94.1
39003, 동부,075003, 72세,2016,2660,1264,1396,90.5,2644,1256,1388,90.5
39003, 동부,075004, 73세,2016,2517,1142,1375,83.1,2503,1133,1370,82.7
39003, 동부,075005, 74세,2016,2656,1172,1484,79,2646,1169,1477,79.1
39003, 동부,080,75~79세,2016,10333,4310,6023,71.6,10284,4287,5997,71.5
39003, 동부,080001, 75세,2016,2445,1079,1366,79,2430,1073,1357,79.1
39003, 동부,080002, 76세,2016,2156,914,1242,73.6,2150,912,1238,73.7
39003, 동부,080003, 77세,2016,2053,844,1209,69.8,2044,840,1204,69.8
39003, 동부,080004, 78세,2016,1870,780,1090,71.6,1865,777,1088,71.4
39003, 동부,080005, 79세,2016,1809,693,1116,62.1,1795,685,1110,61.7
39003, 동부,085,80~84세,2016,6897,2337,4560,51.3,6872,2328,4544,51.2
39003, 동부,085001, 80세,2016,1565,584,981,59.5,1558,581,977,59.5
39003, 동부,085002, 81세,2016,1557,563,994,56.6,1546,557,989,56.3
39003, 동부,085003, 82세,2016,1468,520,948,54.9,1468,520,948,54.9
39003, 동부,085004, 83세,2016,1305,393,912,43.1,1303,393,910,43.2
39003, 동부,085005, 84세,2016,1002,277,725,38.2,997,277,720,38.5
39003, 동부,090,85~89세,2016,3135,660,2475,26.7,3121,653,2468,26.5
39003, 동부,090001, 85세,2016,807,214,593,36.1,804,214,590,36.3
39003, 동부,090002, 86세,2016,792,176,616,28.6,786,171,615,27.8
39003, 동부,090003, 87세,2016,622,130,492,26.4,619,128,491,26.1
39003, 동부,090004, 88세,2016,506,73,433,16.9,506,73,433,16.9
39003, 동부,090005, 89세,2016,408,67,341,19.6,406,67,339,19.8
39003, 동부,095,90~94세,2016,1228,178,1050,17,1223,176,1047,16.8
39003, 동부,095001, 90세,2016,276,49,227,21.6,274,48,226,21.2
39003, 동부,095002, 91세,2016,211,36,175,20.6,210,36,174,20.7
39003, 동부,095003, 92세,2016,171,30,141,21.3,169,29,140,20.7
39003, 동부,095004, 93세,2016,367,36,331,10.9,367,36,331,10.9
39003, 동부,095005, 94세,2016,203,27,176,15.3,203,27,176,15.3
39003, 동부,100,95~99세,2016,389,41,348,11.8,386,39,347,11.2
39003, 동부,100001, 95세,2016,151,13,138,9.4,151,13,138,9.4
39003, 동부,100002, 96세,2016,84,12,72,16.7,84,12,72,16.7
39003, 동부,100003, 97세,2016,68,8,60,13.3,66,7,59,11.9
39003, 동부,100004, 98세,2016,47,7,40,17.5,46,6,40,15
39003, 동부,100005, 99세,2016,39,X,38,2.6,39,X,38,2.6
39003, 동부,101,100세이상,2016,59,X,55,7.3,59,X,55,7.3
39003, 동부,102,15세미만,2016,76558,39670,36888,107.5,76133,39441,36692,107.5
39003, 동부,103,15~64세,2016,327888,166830,161058,103.6,318734,162273,156461,103.7
39003, 동부,104,65세이상,2016,52435,21901,30534,71.7,52083,21736,30347,71.6
39003, 동부,086,85세이상,2016,4811,883,3928,22.5,4789,872,3917,22.3
39003, 동부,126,평균연령,2016,38.8,37.6,39.9,,38.8,37.7,40,
39003, 동부,127,중위연령,2016,39.7,38.7,40.7,,40,39,41,
39010, 제주시,000,합계,2016,462286,232228,230058,100.9,450108,225475,224633,100.4
39010, 제주시,005,0~4세,2016,23755,12229,11526,106.1,23555,12118,11437,106
39010, 제주시,005001, 0세,2016,4349,2257,2092,107.9,4305,2236,2069,108.1
39010, 제주시,005002, 1세,2016,4494,2329,2165,107.6,4458,2310,2148,107.5
39010, 제주시,005003, 2세,2016,4810,2480,2330,106.4,4768,2454,2314,106.1
39010, 제주시,005004, 3세,2016,4809,2490,2319,107.4,4776,2469,2307,107
39010, 제주시,005005, 4세,2016,5293,2673,2620,102,5248,2649,2599,101.9
39010, 제주시,010,5~9세,2016,25311,13118,12193,107.6,25136,13031,12105,107.6
39010, 제주시,010001, 5세,2016,5087,2606,2481,105,5048,2589,2459,105.3
39010, 제주시,010002, 6세,2016,5006,2635,2371,111.1,4971,2617,2354,111.2
39010, 제주시,010003, 7세,2016,4863,2554,2309,110.6,4822,2530,2292,110.4
39010, 제주시,010004, 8세,2016,5010,2584,2426,106.5,4977,2571,2406,106.9
39010, 제주시,010005, 9세,2016,5345,2739,2606,105.1,5318,2724,2594,105
39010, 제주시,015,10~14세,2016,25633,13547,12086,112.1,25538,13499,12039,112.1
39010, 제주시,015001, 10세,2016,4895,2527,2368,106.7,4872,2518,2354,107
39010, 제주시,015002, 11세,2016,4851,2596,2255,115.1,4834,2585,2249,114.9
39010, 제주시,015003, 12세,2016,5163,2720,2443,111.3,5146,2708,2438,111.1
39010, 제주시,015004, 13세,2016,5446,2847,2599,109.5,5424,2838,2586,109.7
39010, 제주시,015005, 14세,2016,5278,2857,2421,118,5262,2850,2412,118.2
39010, 제주시,020,15~19세,2016,30233,15868,14365,110.5,29853,15670,14183,110.5
39010, 제주시,020001, 15세,2016,5951,3131,2820,111,5923,3118,2805,111.2
39010, 제주시,020002, 16세,2016,6393,3364,3029,111.1,6370,3352,3018,111.1
39010, 제주시,020003, 17세,2016,6022,3139,2883,108.9,5983,3119,2864,108.9
39010, 제주시,020004, 18세,2016,6159,3180,2979,106.7,6046,3122,2924,106.8
39010, 제주시,020005, 19세,2016,5708,3054,2654,115.1,5531,2959,2572,115
39010, 제주시,025,20~24세,2016,30924,16819,14105,119.2,28771,15580,13191,118.1
39010, 제주시,025001, 20세,2016,6100,3388,2712,124.9,5810,3240,2570,126.1
39010, 제주시,025002, 21세,2016,6396,3547,2849,124.5,5982,3313,2669,124.1
39010, 제주시,025003, 22세,2016,6339,3506,2833,123.8,5848,3211,2637,121.8
39010, 제주시,025004, 23세,2016,6137,3219,2918,110.3,5666,2929,2737,107
39010, 제주시,025005, 24세,2016,5952,3159,2793,113.1,5465,2887,2578,112
39010, 제주시,030,25~29세,2016,26140,13444,12696,105.9,23719,12136,11583,104.8
39010, 제주시,030001, 25세,2016,5578,2837,2741,103.5,5129,2579,2550,101.1
39010, 제주시,030002, 26세,2016,5304,2773,2531,109.6,4754,2489,2265,109.9
39010, 제주시,030003, 27세,2016,5136,2597,2539,102.3,4668,2351,2317,101.5
39010, 제주시,030004, 28세,2016,4943,2579,2364,109.1,4465,2303,2162,106.5
39010, 제주시,030005, 29세,2016,5179,2658,2521,105.4,4703,2414,2289,105.5
39010, 제주시,035,30~34세,2016,30873,15761,15112,104.3,28939,14654,14285,102.6
39010, 제주시,035001, 30세,2016,5303,2737,2566,106.7,4854,2493,2361,105.6
39010, 제주시,035002, 31세,2016,5591,2874,2717,105.8,5204,2647,2557,103.5
39010, 제주시,035003, 32세,2016,5929,3031,2898,104.6,5576,2826,2750,102.8
39010, 제주시,035004, 33세,2016,6609,3314,3295,100.6,6251,3113,3138,99.2
39010, 제주시,035005, 34세,2016,7441,3805,3636,104.6,7054,3575,3479,102.8
39010, 제주시,040,35~39세,2016,36399,18534,17865,103.7,34952,17637,17315,101.9
39010, 제주시,040001, 35세,2016,7422,3787,3635,104.2,7098,3580,3518,101.8
39010, 제주시,040002, 36세,2016,7667,3941,3726,105.8,7353,3744,3609,103.7
39010, 제주시,040003, 37세,2016,7509,3762,3747,100.4,7215,3597,3618,99.4
39010, 제주시,040004, 38세,2016,6637,3346,3291,101.7,6369,3177,3192,99.5
39010, 제주시,040005, 39세,2016,7164,3698,3466,106.7,6917,3539,3378,104.8
39010, 제주시,045,40~44세,2016,39826,20467,19359,105.7,38942,19928,19014,104.8
39010, 제주시,045001, 40세,2016,7001,3752,3249,115.5,6820,3631,3189,113.9
39010, 제주시,045002, 41세,2016,7386,3743,3643,102.7,7202,3632,3570,101.7
39010, 제주시,045003, 42세,2016,8316,4319,3997,108.1,8129,4207,3922,107.3
39010, 제주시,045004, 43세,2016,8420,4236,4184,101.2,8252,4136,4116,100.5
39010, 제주시,045005, 44세,2016,8703,4417,4286,103.1,8539,4322,4217,102.5
39010, 제주시,050,45~49세,2016,41775,21462,20313,105.7,41020,21037,19983,105.3
39010, 제주시,050001, 45세,2016,9096,4646,4450,104.4,8915,4535,4380,103.5
39010, 제주시,050002, 46세,2016,8551,4336,4215,102.9,8390,4248,4142,102.6
39010, 제주시,050003, 47세,2016,8378,4369,4009,109,8217,4280,3937,108.7
39010, 제주시,050004, 48세,2016,8241,4222,4019,105.1,8105,4150,3955,104.9
39010, 제주시,050005, 49세,2016,7509,3889,3620,107.4,7393,3824,3569,107.1
39010, 제주시,055,50~54세,2016,36815,19023,17792,106.9,36246,18751,17495,107.2
39010, 제주시,055001, 50세,2016,7769,4115,3654,112.6,7652,4056,3596,112.8
39010, 제주시,055002, 51세,2016,7153,3676,3477,105.7,7031,3618,3413,106
39010, 제주시,055003, 52세,2016,7119,3687,3432,107.4,7005,3642,3363,108.3
39010, 제주시,055004, 53세,2016,7559,3892,3667,106.1,7446,3834,3612,106.1
39010, 제주시,055005, 54세,2016,7215,3653,3562,102.6,7112,3601,3511,102.6
39010, 제주시,060,55~59세,2016,32999,16701,16298,102.5,32569,16510,16059,102.8
39010, 제주시,060001, 55세,2016,7139,3581,3558,100.6,7058,3546,3512,101
39010, 제주시,060002, 56세,2016,7185,3650,3535,103.3,7091,3607,3484,103.5
39010, 제주시,060003, 57세,2016,6571,3298,3273,100.8,6480,3258,3222,101.1
39010, 제주시,060004, 58세,2016,6144,3137,3007,104.3,6060,3100,2960,104.7
39010, 제주시,060005, 59세,2016,5960,3035,2925,103.8,5880,2999,2881,104.1
39010, 제주시,065,60~64세,2016,23689,11679,12010,97.2,23323,11522,11801,97.6
39010, 제주시,065001, 60세,2016,5580,2799,2781,100.6,5486,2757,2729,101
39010, 제주시,065002, 61세,2016,5742,2819,2923,96.4,5654,2780,2874,96.7
39010, 제주시,065003, 62세,2016,4536,2258,2278,99.1,4456,2225,2231,99.7
39010, 제주시,065004, 63세,2016,3801,1824,1977,92.3,3744,1795,1949,92.1
39010, 제주시,065005, 64세,2016,4030,1979,2051,96.5,3983,1965,2018,97.4
39010, 제주시,070,65~69세,2016,17475,8388,9087,92.3,17285,8301,8984,92.4
39010, 제주시,070001, 65세,2016,3478,1707,1771,96.4,3421,1679,1742,96.4
39010, 제주시,070002, 66세,2016,3488,1662,1826,91,3448,1644,1804,91.1
39010, 제주시,070003, 67세,2016,3406,1631,1775,91.9,3369,1612,1757,91.7
39010, 제주시,070004, 68세,2016,3603,1751,1852,94.5,3578,1741,1837,94.8
39010, 제주시,070005, 69세,2016,3500,1637,1863,87.9,3469,1625,1844,88.1
39010, 제주시,075,70~74세,2016,14358,6636,7722,85.9,14275,6590,7685,85.8
39010, 제주시,075001, 70세,2016,3119,1481,1638,90.4,3094,1466,1628,90
39010, 제주시,075002, 71세,2016,2767,1334,1433,93.1,2753,1326,1427,92.9
39010, 제주시,075003, 72세,2016,2872,1330,1542,86.3,2855,1320,1535,86
39010, 제주시,075004, 73세,2016,2784,1234,1550,79.6,2770,1225,1545,79.3
39010, 제주시,075005, 74세,2016,2816,1257,1559,80.6,2803,1253,1550,80.8
39010, 제주시,080,75~79세,2016,11946,4820,7126,67.6,11897,4800,7097,67.6
39010, 제주시,080001, 75세,2016,2723,1186,1537,77.2,2707,1179,1528,77.2
39010, 제주시,080002, 76세,2016,2423,971,1452,66.9,2417,970,1447,67
39010, 제주시,080003, 77세,2016,2456,983,1473,66.7,2448,980,1468,66.8
39010, 제주시,080004, 78세,2016,2260,902,1358,66.4,2252,898,1354,66.3
39010, 제주시,080005, 79세,2016,2084,778,1306,59.6,2073,773,1300,59.5
39010, 제주시,085,80~84세,2016,8225,2668,5557,48,8199,2655,5544,47.9
39010, 제주시,085001, 80세,2016,1886,673,1213,55.5,1879,670,1209,55.4
39010, 제주시,085002, 81세,2016,1780,644,1136,56.7,1773,640,1133,56.5
39010, 제주시,085003, 82세,2016,1712,562,1150,48.9,1711,561,1150,48.8
39010, 제주시,085004, 83세,2016,1588,451,1137,39.7,1583,448,1135,39.5
39010, 제주시,085005, 84세,2016,1259,338,921,36.7,1253,336,917,36.6
39010, 제주시,090,85~89세,2016,3847,803,3044,26.4,3832,796,3036,26.2
39010, 제주시,090001, 85세,2016,985,267,718,37.2,981,267,714,37.4
39010, 제주시,090002, 86세,2016,1006,205,801,25.6,1000,200,800,25
39010, 제주시,090003, 87세,2016,760,153,607,25.2,758,152,606,25.1
39010, 제주시,090004, 88세,2016,580,90,490,18.4,579,89,490,18.2
39010, 제주시,090005, 89세,2016,516,88,428,20.6,514,88,426,20.7
39010, 제주시,095,90~94세,2016,1529,212,1317,16.1,1526,212,1314,16.1
39010, 제주시,095001, 90세,2016,328,60,268,22.4,328,60,268,22.4
39010, 제주시,095002, 91세,2016,274,43,231,18.6,272,43,229,18.8
39010, 제주시,095003, 92세,2016,202,40,162,24.7,201,40,161,24.8
39010, 제주시,095004, 93세,2016,473,37,436,8.5,473,37,436,8.5
39010, 제주시,095005, 94세,2016,252,32,220,14.5,252,32,220,14.5
39010, 제주시,100,95~99세,2016,465,44,421,10.5,462,43,419,10.3
39010, 제주시,100001, 95세,2016,174,16,158,10.1,174,16,158,10.1
39010, 제주시,100002, 96세,2016,111,17,94,18.1,110,16,94,17
39010, 제주시,100003, 97세,2016,84,5,79,6.3,82,5,77,6.5
39010, 제주시,100004, 98세,2016,47,X,43,9.3,47,X,43,9.3
39010, 제주시,100005, 99세,2016,49,X,47,4.3,49,X,47,4.3
39010, 제주시,101,100세이상,2016,69,5,64,7.8,69,5,64,7.8
39010, 제주시,102,15세미만,2016,74699,38894,35805,108.6,74229,38648,35581,108.6
39010, 제주시,103,15~64세,2016,329673,169758,159915,106.2,318334,163425,154909,105.5
39010, 제주시,104,65세이상,2016,57914,23576,34338,68.7,57545,23402,34143,68.5
39010, 제주시,086,85세이상,2016,5910,1064,4846,22,5889,1056,4833,21.8
39010, 제주시,126,평균연령,2016,39.4,38.1,40.8,,39.5,38.2,40.9,
39010, 제주시,127,중위연령,2016,40.3,39.1,41.5,,40.7,39.6,41.8,
39020, 서귀포시,000,합계,2016,161046,81905,79141,103.5,155748,78464,77284,101.5
39020, 서귀포시,005,0~4세,2016,6884,3501,3383,103.5,6795,3451,3344,103.2
39020, 서귀포시,005001, 0세,2016,1309,678,631,107.4,1294,668,626,106.7
39020, 서귀포시,005002, 1세,2016,1326,678,648,104.6,1309,669,640,104.5
39020, 서귀포시,005003, 2세,2016,1312,644,668,96.4,1298,637,661,96.4
39020, 서귀포시,005004, 3세,2016,1388,684,704,97.2,1365,670,695,96.4
39020, 서귀포시,005005, 4세,2016,1549,817,732,111.6,1529,807,722,111.8
39020, 서귀포시,010,5~9세,2016,7951,4072,3879,105,7870,4030,3840,104.9
39020, 서귀포시,010001, 5세,2016,1581,835,746,111.9,1570,829,741,111.9
39020, 서귀포시,010002, 6세,2016,1535,799,736,108.6,1510,788,722,109.1
39020, 서귀포시,010003, 7세,2016,1516,765,751,101.9,1500,757,743,101.9
39020, 서귀포시,010004, 8세,2016,1605,807,798,101.1,1591,800,791,101.1
39020, 서귀포시,010005, 9세,2016,1714,866,848,102.1,1699,856,843,101.5
39020, 서귀포시,015,10~14세,2016,7760,4153,3607,115.1,7709,4127,3582,115.2
39020, 서귀포시,015001, 10세,2016,1524,833,691,120.5,1505,822,683,120.4
39020, 서귀포시,015002, 11세,2016,1462,777,685,113.4,1454,774,680,113.8
39020, 서귀포시,015003, 12세,2016,1578,853,725,117.7,1570,848,722,117.5
39020, 서귀포시,015004, 13세,2016,1521,811,710,114.2,1519,810,709,114.2
39020, 서귀포시,015005, 14세,2016,1675,879,796,110.4,1661,873,788,110.8
39020, 서귀포시,020,15~19세,2016,8856,4641,4215,110.1,8774,4594,4180,109.9
39020, 서귀포시,020001, 15세,2016,1831,978,853,114.7,1822,975,847,115.1
39020, 서귀포시,020002, 16세,2016,2041,1033,1008,102.5,2031,1027,1004,102.3
39020, 서귀포시,020003, 17세,2016,1928,1010,918,110,1914,1001,913,109.6
39020, 서귀포시,020004, 18세,2016,1660,850,810,104.9,1639,840,799,105.1
39020, 서귀포시,020005, 19세,2016,1396,770,626,123,1368,751,617,121.7
39020, 서귀포시,025,20~24세,2016,8528,4806,3722,129.1,7822,4301,3521,122.2
39020, 서귀포시,025001, 20세,2016,1612,1000,612,163.4,1549,961,588,163.4
39020, 서귀포시,025002, 21세,2016,1732,1007,725,138.9,1637,942,695,135.5
39020, 서귀포시,025003, 22세,2016,1637,899,738,121.8,1491,793,698,113.6
39020, 서귀포시,025004, 23세,2016,1746,929,817,113.7,1550,782,768,101.8
39020, 서귀포시,025005, 24세,2016,1801,971,830,117,1595,823,772,106.6
39020, 서귀포시,030,25~29세,2016,8202,4476,3726,120.1,7074,3718,3356,110.8
39020, 서귀포시,030001, 25세,2016,1741,912,829,110,1525,758,767,98.8
39020, 서귀포시,030002, 26세,2016,1749,939,810,115.9,1499,776,723,107.3
39020, 서귀포시,030003, 27세,2016,1588,883,705,125.2,1372,746,626,119.2
39020, 서귀포시,030004, 28세,2016,1503,853,650,131.2,1284,702,582,120.6
39020, 서귀포시,030005, 29세,2016,1621,889,732,121.4,1394,736,658,111.9
39020, 서귀포시,035,30~34세,2016,9224,4934,4290,115,8252,4275,3977,107.5
39020, 서귀포시,035001, 30세,2016,1571,845,726,116.4,1385,722,663,108.9
39020, 서귀포시,035002, 31세,2016,1628,866,762,113.6,1423,739,684,108
39020, 서귀포시,035003, 32세,2016,1800,973,827,117.7,1604,832,772,107.8
39020, 서귀포시,035004, 33세,2016,1928,1033,895,115.4,1751,906,845,107.2
39020, 서귀포시,035005, 34세,2016,2297,1217,1080,112.7,2089,1076,1013,106.2
39020, 서귀포시,040,35~39세,2016,11217,5960,5257,113.4,10559,5469,5090,107.4
39020, 서귀포시,040001, 35세,2016,2370,1294,1076,120.3,2227,1175,1052,111.7
39020, 서귀포시,040002, 36세,2016,2255,1176,1079,109,2114,1078,1036,104.1
39020, 서귀포시,040003, 37세,2016,2322,1212,1110,109.2,2180,1111,1069,103.9
39020, 서귀포시,040004, 38세,2016,2062,1100,962,114.3,1938,1003,935,107.3
39020, 서귀포시,040005, 39세,2016,2208,1178,1030,114.4,2100,1102,998,110.4
39020, 서귀포시,045,40~44세,2016,12882,7091,5791,122.4,12404,6768,5636,120.1
39020, 서귀포시,045001, 40세,2016,2412,1294,1118,115.7,2300,1217,1083,112.4
39020, 서귀포시,045002, 41세,2016,2356,1330,1026,129.6,2262,1262,1000,126.2
39020, 서귀포시,045003, 42세,2016,2684,1506,1178,127.8,2589,1439,1150,125.1
39020, 서귀포시,045004, 43세,2016,2636,1426,1210,117.9,2548,1371,1177,116.5
39020, 서귀포시,045005, 44세,2016,2794,1535,1259,121.9,2705,1479,1226,120.6
39020, 서귀포시,050,45~49세,2016,13868,7548,6320,119.4,13521,7345,6176,118.9
39020, 서귀포시,050001, 45세,2016,3018,1665,1353,123.1,2955,1625,1330,122.2
39020, 서귀포시,050002, 46세,2016,2772,1533,1239,123.7,2697,1484,1213,122.3
39020, 서귀포시,050003, 47세,2016,2732,1488,1244,119.6,2657,1447,1210,119.6
39020, 서귀포시,050004, 48세,2016,2797,1494,1303,114.7,2717,1451,1266,114.6
39020, 서귀포시,050005, 49세,2016,2549,1368,1181,115.8,2495,1338,1157,115.6
39020, 서귀포시,055,50~54세,2016,13435,7154,6281,113.9,13167,7030,6137,114.6
39020, 서귀포시,055001, 50세,2016,2666,1425,1241,114.8,2616,1404,1212,115.8
39020, 서귀포시,055002, 51세,2016,2585,1394,1191,117,2523,1362,1161,117.3
39020, 서귀포시,055003, 52세,2016,2620,1399,1221,114.6,2565,1377,1188,115.9
39020, 서귀포시,055004, 53세,2016,2849,1473,1376,107,2793,1443,1350,106.9
39020, 서귀포시,055005, 54세,2016,2715,1463,1252,116.9,2670,1444,1226,117.8
39020, 서귀포시,060,55~59세,2016,13085,6654,6431,103.5,12915,6571,6344,103.6
39020, 서귀포시,060001, 55세,2016,2702,1366,1336,102.2,2667,1349,1318,102.4
39020, 서귀포시,060002, 56세,2016,2841,1469,1372,107.1,2802,1446,1356,106.6
39020, 서귀포시,060003, 57세,2016,2554,1290,1264,102.1,2519,1279,1240,103.1
39020, 서귀포시,060004, 58세,2016,2555,1324,1231,107.6,2520,1307,1213,107.7
39020, 서귀포시,060005, 59세,2016,2433,1205,1228,98.1,2407,1190,1217,97.8
39020, 서귀포시,065,60~64세,2016,10344,5107,5237,97.5,10196,5036,5160,97.6
39020, 서귀포시,065001, 60세,2016,2443,1255,1188,105.6,2405,1237,1168,105.9
39020, 서귀포시,065002, 61세,2016,2349,1164,1185,98.2,2314,1145,1169,97.9
39020, 서귀포시,065003, 62세,2016,2039,1000,1039,96.2,2007,985,1022,96.4
39020, 서귀포시,065004, 63세,2016,1684,807,877,92,1665,797,868,91.8
39020, 서귀포시,065005, 64세,2016,1829,881,948,92.9,1805,872,933,93.5
39020, 서귀포시,070,65~69세,2016,8402,4099,4303,95.3,8344,4074,4270,95.4
39020, 서귀포시,070001, 65세,2016,1599,807,792,101.9,1580,801,779,102.8
39020, 서귀포시,070002, 66세,2016,1587,739,848,87.1,1576,733,843,87
39020, 서귀포시,070003, 67세,2016,1723,828,895,92.5,1712,824,888,92.8
39020, 서귀포시,070004, 68세,2016,1792,894,898,99.6,1782,888,894,99.3
39020, 서귀포시,070005, 69세,2016,1701,831,870,95.5,1694,828,866,95.6
39020, 서귀포시,075,70~74세,2016,7178,3292,3886,84.7,7156,3278,3878,84.5
39020, 서귀포시,075001, 70세,2016,1450,682,768,88.8,1443,678,765,88.6
39020, 서귀포시,075002, 71세,2016,1445,676,769,87.9,1441,674,767,87.9
39020, 서귀포시,075003, 72세,2016,1368,631,737,85.6,1363,627,736,85.2
39020, 서귀포시,075004, 73세,2016,1318,586,732,80.1,1315,584,731,79.9
39020, 서귀포시,075005, 74세,2016,1597,717,880,81.5,1594,715,879,81.3
39020, 서귀포시,080,75~79세,2016,6257,2533,3724,68,6239,2525,3714,68
39020, 서귀포시,080001, 75세,2016,1472,620,852,72.8,1469,619,850,72.8
39020, 서귀포시,080002, 76세,2016,1293,538,755,71.3,1289,537,752,71.4
39020, 서귀포시,080003, 77세,2016,1237,518,719,72,1233,517,716,72.2
39020, 서귀포시,080004, 78세,2016,1171,453,718,63.1,1171,453,718,63.1
39020, 서귀포시,080005, 79세,2016,1084,404,680,59.4,1077,399,678,58.8
39020, 서귀포시,085,80~84세,2016,4341,1421,2920,48.7,4329,1416,2913,48.6
39020, 서귀포시,085001, 80세,2016,935,363,572,63.5,932,361,571,63.2
39020, 서귀포시,085002, 81세,2016,987,331,656,50.5,982,329,653,50.4
39020, 서귀포시,085003, 82세,2016,950,319,631,50.6,949,318,631,50.4
39020, 서귀포시,085004, 83세,2016,827,246,581,42.3,825,246,579,42.5
39020, 서귀포시,085005, 84세,2016,642,162,480,33.8,641,162,479,33.8
39020, 서귀포시,090,85~89세,2016,1731,342,1389,24.6,1727,340,1387,24.5
39020, 서귀포시,090001, 85세,2016,451,95,356,26.7,451,95,356,26.7
39020, 서귀포시,090002, 86세,2016,451,97,354,27.4,450,96,354,27.1
39020, 서귀포시,090003, 87세,2016,353,71,282,25.2,352,70,282,24.8
39020, 서귀포시,090004, 88세,2016,275,54,221,24.4,275,54,221,24.4
39020, 서귀포시,090005, 89세,2016,201,25,176,14.2,199,25,174,14.4
39020, 서귀포시,095,90~94세,2016,666,101,565,17.9,662,98,564,17.4
39020, 서귀포시,095001, 90세,2016,151,31,120,25.8,148,29,119,24.4
39020, 서귀포시,095002, 91세,2016,118,17,101,16.8,118,17,101,16.8
39020, 서귀포시,095003, 92세,2016,79,16,63,25.4,78,15,63,23.8
39020, 서귀포시,095004, 93세,2016,202,21,181,11.6,202,21,181,11.6
39020, 서귀포시,095005, 94세,2016,116,16,100,16,116,16,100,16
39020, 서귀포시,100,95~99세,2016,205,19,186,10.2,203,17,186,9.1
39020, 서귀포시,100001, 95세,2016,78,X,74,5.4,78,X,74,5.4
39020, 서귀포시,100002, 96세,2016,42,X,39,7.7,42,X,39,7.7
39020, 서귀포시,100003, 97세,2016,39,6,33,18.2,38,5,33,15.2
39020, 서귀포시,100004, 98세,2016,33,5,28,17.9,32,X,28,14.3
39020, 서귀포시,100005, 99세,2016,13,X,12,8.3,13,X,12,8.3
39020, 서귀포시,101,100세이상,2016,30,X,29,3.4,30,X,29,3.4
39020, 서귀포시,102,15세미만,2016,22595,11726,10869,107.9,22374,11608,10766,107.8
39020, 서귀포시,103,15~64세,2016,109641,58371,51270,113.9,104684,55107,49577,111.2
39020, 서귀포시,104,65세이상,2016,28810,11808,17002,69.5,28690,11749,16941,69.4
39020, 서귀포시,086,85세이상,2016,2632,463,2169,21.3,2622,456,2166,21.1
39020, 서귀포시,126,평균연령,2016,43.1,41.4,44.8,,43.4,41.7,45,
39020, 서귀포시,127,중위연령,2016,44.6,43.2,46.3,,45.2,44,46.6,
